30,r_50_13_171,seq4,r_78_122_116,r_78_122_116,0.77,55,171,116,0
50,seq1,seq99,r_9_94_22,r_9_94_22,0.74,23,45,22,0
43,r_69_93_64,seq11,r_129_26_11,r_69_93_64,1.0,0,64,64,0
54,seq11,r_70_113_188,r_17_145_32,r_17_145_32,1.0,156,188,32,0
37,r_96_63_93,seq105,seq16,r_96_63_93,1.0,-1,92,93,0
16,r_101_51_123,r_103_59_192,r_50_13_171,r_101_51_123,0.86,0,123,123,0
21,r_130_89_110,seq25,seq85,r_130_89_110,0.98,0,110,110,0
39,r_65_109_95,seq25,r_45_73_56,r_45_73_56,0.99,39,95,56,0
5,r_38_35_106,r_57_115_197,r_135_126_69,r_38_35_106,0.92,0,106,106,0
46,r_134_87_143,r_42_79_161,r_132_121_149,r_132_121_149,0.99,8,157,149,0
45,r_92_33_172,seq52,r_138_107_165,r_92_33_172,0.6,0,172,172,0
36,r_7_66_35,r_65_109_95,seq16,r_7_66_35,0.94,3,38,35,0
95,seq117,r_10_143_86,seq15,r_10_143_86,1.0,0,86,86,0
76,seq67,r_78_122_116,seq117,r_78_122_116,0.96,0,116,116,0
0,r_57_115_197,r_38_35_106,r_9_94_22,r_38_35_106,0.89,-71,35,106,0
31,r_141_41_65,r_74_30_130,r_36_149_41,r_141_41_65,1.0,0,65,65,0
3,r_56_111_142,seq16,seq12,r_56_111_142,0.82,1,143,142,0
1,r_17_145_32,r_74_30_130,seq58,r_17_145_32,0.78,1,33,32,0
10,r_74_30_130,r_27_48_179,r_101_51_123,r_27_48_179,0.54,-49,130,179,0
26,r_120_3_138,seq5,seq4,r_120_3_138,1.0,0,138,138,0
11,r_40_44_152,seq12,r_81_80_40,r_40_44_152,0.59,1,153,152,0
20,r_78_122_116,seq67,seq52,r_78_122_116,0.96,0,116,116,0
15,r_82_131_177,seq32,r_53_133_191,r_53_133_191,0.8,-13,178,191,0
48,r_2_140_62,r_68_8_118,seq118,r_2_140_62,0.64,1,63,62,0
72,seq58,seq29,r_17_145_32,r_17_145_32,1.0,1,33,32,0
6,r_132_121_149,seq84,r_75_124_58,r_75_124_58,1.0,29,87,58,0
27,r_45_73_56,r_56_111_142,seq110,r_45_73_56,1.0,0,56,56,0
36,r_7_66_35,seq16,r_46_31_66,r_46_31_66,0.99,59,125,66,0
16,r_101_51_123,r_50_13_171,r_74_30_130,r_50_13_171,0.98,-15,156,171,0
40,r_55_22_170,r_27_48_179,seq28,r_55_22_170,0.77,0,170,170,0
18,r_138_107_165,seq32,r_75_124_58,r_75_124_58,0.62,107,165,58,0
29,r_46_31_66,r_47_54_109,r_7_66_35,r_46_31_66,0.99,0,66,66,0
24,r_47_54_109,seq67,r_36_149_41,r_47_54_109,1.0,0,109,109,0
44,r_81_80_40,seq91,r_7_66_35,r_81_80_40,0.93,0,40,40,0
33,r_76_20_151,seq88,r_75_124_58,r_76_20_151,0.98,0,151,151,0
58,seq16,r_56_111_142,r_81_80_40,r_81_80_40,1.0,38,78,40,0
6,r_132_121_149,r_75_124_58,r_47_54_109,r_132_121_149,1.0,0,149,149,0
80,seq84,r_36_149_41,r_75_124_58,r_36_149_41,0.92,0,41,41,0
25,r_75_124_58,seq61,r_132_121_149,r_132_121_149,0.74,-91,58,149,0
32,r_10_143_86,seq117,r_2_140_62,r_10_143_86,1.0,0,86,86,0
52,seq5,r_120_3_138,r_65_109_95,r_120_3_138,0.67,0,138,138,0
74,seq61,r_75_124_58,r_129_26_11,r_129_26_11,0.73,18,29,11,0
35,r_36_149_41,seq84,seq34,r_36_149_41,1.0,0,41,41,0
17,r_70_113_188,seq11,r_123_112_178,r_123_112_178,0.61,10,188,178,0
25,r_75_124_58,r_132_121_149,seq84,r_132_121_149,1.0,0,149,149,0
9,r_98_19_126,seq25,r_123_112_178,r_98_19_126,0.59,5,131,126,0
14,r_116_0_34,seq148,seq102,r_116_0_34,1.0,-3,31,34,0
96,seq118,r_27_48_179,r_2_140_62,r_2_140_62,0.99,117,179,62,0
22,r_135_126_69,r_56_111_142,seq144,r_135_126_69,1.0,-3,66,69,0
91,seq144,seq110,r_135_126_69,r_135_126_69,1.0,7,76,69,0
49,r_95_6_85,seq90,seq108,r_95_6_85,0.98,0,85,85,0
82,seq88,r_76_20_151,r_46_31_66,r_46_31_66,0.96,86,152,66,0
88,seq102,seq97,r_116_0_34,r_116_0_34,1.0,-3,31,34,0
12,r_68_8_118,seq88,seq108,r_68_8_118,1.0,0,118,118,0
23,r_129_26_11,r_57_115_197,seq61,r_129_26_11,0.79,0,11,11,0
22,r_80_81_25,seq132,r_105_73_51,r_80_81_25,0.93,2,27,25,1
65,seq36,seq92,r_31_107_29,r_31_107_29,1.0,17,46,29,1
14,r_131_114_67,r_28_24_97,seq41,r_131_114_67,0.99,1,68,67,1
8,r_64_17_73,r_91_145_74,seq9,r_91_145_74,0.97,-1,73,74,1
53,seq9,seq124,r_64_17_73,r_64_17_73,0.93,16,89,73,1
43,r_54_93_115,r_122_126_199,r_31_107_29,r_54_93_115,0.98,0,115,115,1
21,r_63_30_122,seq32,r_44_102_7,r_63_30_122,0.93,0,122,122,1
1,r_39_142_182,seq48,r_64_17_73,r_64_17_73,0.61,109,182,73,1
33,r_8_119_20,r_34_3_151,r_62_50_191,r_8_119_20,0.99,0,20,20,1
5,r_7_21_146,r_6_104_135,seq85,r_7_21_146,0.91,0,146,146,1
46,r_10_129_76,seq124,seq38,r_10_129_76,0.99,0,76,76,1
42,r_69_72_106,seq68,seq59,r_69_72_106,1.0,1,107,106,1
16,r_51_133_13,r_111_148_154,seq138,r_51_133_13,0.98,0,13,13,1
23,r_105_73_51,r_80_81_25,seq98,r_105_73_51,0.89,0,51,51,1
93,seq106,r_62_50_191,r_128_33_137,r_128_33_137,0.66,0,137,137,1
19,r_61_43_72,r_100_4_24,seq42,r_61_43_72,1.0,0,72,72,1
33,r_8_119_20,r_62_50_191,r_28_24_97,r_28_24_97,1.0,9,106,97,1
13,r_34_3_151,r_8_119_20,seq85,r_8_119_20,0.87,1,21,20,1
2,r_141_5_112,r_7_21_146,seq12,r_141_5_112,0.49,-91,21,112,1
38,r_65_26_40,seq130,r_100_4_24,r_65_26_40,1.0,0,40,40,1
44,r_135_120_14,r_141_5_112,r_75_121_22,r_141_5_112,0.53,-88,24,112,1
3,r_122_126_199,r_57_20_64,r_95_116_33,r_122_126_199,0.88,-135,64,199,1
10,r_84_137_149,seq41,seq12,r_84_137_149,0.9,4,153,149,1
37,r_44_102_7,r_62_50_191,r_28_24_97,r_28_24_97,0.99,3,100,97,1
26,r_118_86_102,seq109,seq48,r_118_86_102,0.45,1,103,102,1
72,seq48,r_39_142_182,r_118_86_102,r_118_86_102,0.44,18,120,102,1
4,r_111_148_154,seq94,r_2_127_47,r_111_148_154,0.68,0,154,154,1
0,r_62_50_191,seq89,r_28_24_97,r_28_24_97,1.0,14,111,97,1
11,r_82_97_170,seq15,r_52_144_121,r_52_144_121,0.93,53,174,121,1
15,r_88_13_143,r_16_14_144,r_8_119_20,r_16_14_144,0.6,-1,143,144,1
48,r_28_24_97,seq42,r_44_102_7,r_28_24_97,1.0,0,97,97,1
57,seq15,r_82_97_170,r_57_20_64,r_57_20_64,1.0,110,174,64,1
13,r_34_3_151,seq85,seq46,r_34_3_151,0.87,-3,148,151,1
6,r_6_104_135,r_108_147_120,r_105_73_51,r_6_104_135,0.96,-15,120,135,1
62,seq25,seq11,r_79_35_53,r_79_35_53,1.0,10,63,53,1
20,r_67_140_48,seq11,seq101,r_67_140_48,1.0,0,48,48,1
85,seq89,r_62_50_191,r_28_24_97,r_28_24_97,1.0,9,106,97,1
2,r_141_5_112,seq12,r_61_43_72,r_141_5_112,1.0,0,112,112,1
23,r_105_73_51,r_31_107_29,r_80_81_25,r_105_73_51,0.91,-24,27,51,1
12,r_22_113_26,r_122_126_199,seq83,r_22_113_26,1.0,0,26,26,1
99,seq125,seq132,r_57_20_64,r_57_20_64,1.0,2,66,64,1
27,r_52_144_121,seq138,r_65_26_40,r_65_26_40,0.97,83,123,40,1
87,seq94,r_146_47_159,seq130,r_146_47_159,0.78,1,160,159,1
47,r_146_47_159,seq94,seq40,r_146_47_159,0.81,1,160,159,1
75,seq56,r_31_107_29,seq1,r_31_107_29,1.0,1,30,29,1
40,r_16_14_144,r_88_13_143,seq1,r_16_14_144,0.82,-1,143,144,1
18,r_57_20_64,r_122_126_199,seq125,r_57_20_64,1.0,0,64,64,1
29,r_91_145_74,seq78,r_75_121_22,r_91_145_74,1.0,0,74,74,1
89,seq98,r_7_21_146,r_105_73_51,r_105_73_51,0.96,1,52,51,1
24,r_70_77_35,r_112_134_88,seq46,r_112_134_88,1.0,0,88,88,1
45,r_100_4_24,seq138,r_65_26_40,r_65_26_40,1.0,-1,39,40,1
25,r_108_147_120,r_6_104_135,r_28_24_97,r_108_147_120,0.99,0,120,120,1
28,r_2_127_47,r_28_24_97,r_65_26_40,r_2_127_47,1.0,1,48,47,1
37,r_44_102_7,r_143_76_68,r_62_50_191,r_143_76_68,1.0,-2,66,68,1
50,seq1,r_45_29_167,r_16_14_144,r_16_14_144,0.71,26,170,144,1
31,r_31_107_29,seq56,seq36,r_31_107_29,0.94,1,30,29,1
32,r_90_136_101,r_63_30_122,seq109,r_90_136_101,0.7,0,101,101,1
22,r_80_81_25,r_105_73_51,seq1,r_105_73_51,0.78,0,51,51,1
76,seq58,seq89,r_90_136_101,r_90_136_101,0.82,52,153,101,1
34,r_75_121_22,r_88_13_143,r_91_145_74,r_91_145_74,0.86,69,143,74,1
17,r_117_0_118,seq40,r_91_145_74,r_117_0_118,0.78,0,118,118,1
94,seq109,r_118_86_102,r_90_136_101,r_90_136_101,0.95,2,103,101,1
9,r_45_29_167,seq1,r_111_148_154,r_111_148_154,0.84,16,170,154,1
41,r_143_76_68,r_44_102_7,r_105_73_51,r_143_76_68,1.0,0,68,68,1
49,r_128_33_137,r_45_29_167,r_112_134_88,r_112_134_88,0.88,-2,86,88,1
7,r_139_60_136,r_88_13_143,seq78,r_139_60_136,0.86,-1,135,136,1
39,r_95_116_33,seq83,r_122_126_199,r_95_116_33,1.0,0,33,33,1
49,r_128_33_137,r_112_134_88,seq106,r_128_33_137,0.9,2,139,137,1
35,r_112_134_88,r_70_77_35,r_128_33_137,r_112_134_88,0.76,0,88,88,1
35,r_112_134_88,r_128_33_137,r_45_29_167,r_128_33_137,0.68,5,142,137,1
30,r_11_125_88,seq65,r_127_19_80,r_127_19_80,0.99,8,88,80,2
34,r_0_91_96,r_72_99_176,r_13_51_7,r_0_91_96,1.0,0,96,96,2
47,r_148_131_37,r_140_82_34,r_111_105_30,r_148_131_37,0.65,0,37,37,2
14,r_127_19_80,seq22,r_79_123_16,r_127_19_80,1.0,0,80,80,2
8,r_31_135_189,r_46_107_143,r_52_77_40,r_52_77_40,0.94,105,145,40,2
43,r_122_73_70,r_92_55_123,seq101,r_122_73_70,1.0,4,74,70,2
92,seq93,seq9,r_44_49_26,r_44_49_26,0.96,25,51,26,2
71,seq35,r_141_12_153,r_106_114_60,r_106_114_60,1.0,93,153,60,2
16,r_72_99_176,seq137,seq138,r_72_99_176,0.67,0,176,176,2
1,r_126_56_107,r_10_76_130,r_110_112_84,r_110_112_84,1.0,27,111,84,2
5,r_133_28_135,seq147,r_145_61_102,r_133_28_135,0.86,0,135,135,2
46,r_129_7_157,r_45_116_151,r_124_39_104,r_124_39_104,0.79,18,122,104,2
42,r_141_12_153,seq35,r_111_105_30,r_141_12_153,0.75,0,153,153,2
80,seq137,r_72_99_176,seq132,r_72_99_176,1.0,-2,174,176,2
48,r_70_38_41,r_121_89_118,r_111_105_30,r_70_38_41,0.99,0,41,41,2
45,r_90_113_64,seq101,r_111_105_30,r_90_113_64,0.97,3,67,64,2
39,r_68_26_19,seq115,seq40,r_68_26_19,1.0,0,19,19,2
95,seq103,r_53_84_137,r_5_25_100,r_5_25_100,0.99,10,110,100,2
10,r_32_98_154,r_81_102_142,r_52_77_40,r_32_98_154,0.85,-1,153,154,2
41,r_145_61_102,seq15,r_81_102_142,r_145_61_102,0.8,-4,98,102,2
89,seq80,seq147,r_45_116_151,r_45_116_151,0.89,23,174,151,2
3,r_144_20_126,r_96_17_177,seq37,r_96_17_177,0.73,-46,131,177,2
10,r_32_98_154,r_45_116_151,r_81_102_142,r_45_116_151,0.37,-13,138,151,2
49,r_109_21_49,seq8,seq37,r_109_21_49,1.0,0,49,49,2
26,r_143_67_81,r_6_34_199,seq23,r_143_67_81,0.82,6,87,81,2
72,seq37,r_45_116_151,r_144_20_126,r_45_116_151,0.97,0,151,151,2
12,r_1_95_23,seq115,r_57_97_8,r_1_95_23,1.0,1,24,23,2
63,seq147,seq137,r_140_82_34,r_140_82_34,1.0,53,87,34,2
20,r_83_94_196,r_10_76_130,r_31_135_189,r_83_94_196,0.55,-13,183,196,2
13,r_29_74_185,seq33,r_81_102_142,r_81_102_142,0.96,45,187,142,2
98,seq117,seq147,r_139_24_167,r_139_24_167,0.6,1,168,167,2
29,r_44_49_26,r_121_89_118,seq93,r_44_49_26,0.93,0,26,26,2
37,r_140_82_34,seq14,seq147,r_140_82_34,1.0,3,37,34,2
6,r_110_112_84,seq147,seq9,r_110_112_84,0.96,0,84,84,2
15,r_85_104_56,r_5_25_100,seq130,r_85_104_56,1.0,0,56,56,2
27,r_18_36_187,r_31_135_189,r_127_19_80,r_18_36_187,0.33,0,187,187,2
38,r_119_69_54,seq40,seq146,r_119_69_54,1.0,2,56,54,2
2,r_139_24_167,seq23,r_53_84_137,r_139_24_167,0.81,0,167,167,2
74,seq41,r_129_7_157,r_144_20_126,r_144_20_126,0.36,-46,80,126,2
18,r_45_116_151,seq37,seq142,r_45_116_151,0.97,0,151,151,2
24,r_96_17_177,seq30,seq62,r_96_17_177,0.52,0,177,177,2
33,r_46_107_143,r_31_135_189,seq41,r_31_135_189,0.75,-40,149,189,2
65,seq22,r_127_19_80,r_145_61_102,r_127_19_80,0.85,0,80,80,2
70,seq33,r_53_84_137,r_79_123_16,r_79_123_16,1.0,1,17,16,2
41,r_145_61_102,r_81_102_142,r_133_28_135,r_145_61_102,1.0,40,142,102,2
32,r_86_60_115,r_81_102_142,r_90_113_64,r_81_102_142,0.82,-27,115,142,2
60,seq15,r_145_61_102,seq101,r_145_61_102,1.0,2,104,102,2
34,r_0_91_96,r_52_77_40,r_72_99_176,r_52_77_40,1.0,0,40,40,2
9,r_5_25_100,seq48,seq103,r_5_25_100,0.92,0,100,100,2
40,r_88_58_44,r_45_116_151,seq136,r_45_116_151,0.98,-97,54,151,2
36,r_111_105_30,seq9,r_79_123_16,r_111_105_30,0.77,0,30,30,2
28,r_10_76_130,r_83_94_196,seq9,r_83_94_196,0.52,-64,132,196,2
56,seq9,seq93,r_10_76_130,r_10_76_130,0.57,2,132,130,2
7,r_81_102_142,r_86_60_115,seq22,r_86_60_115,0.61,5,120,115,2
44,r_92_55_123,seq71,r_6_34_199,r_92_55_123,0.99,0,123,123,2
23,r_124_39_104,seq138,seq42,r_124_39_104,0.96,0,104,104,2
6,r_110_112_84,seq9,r_126_56_107,r_110_112_84,0.78,27,111,84,2
31,r_79_123_16,seq9,seq33,r_79_123_16,1.0,0,16,16,2
35,r_106_114_60,r_45_116_151,seq35,r_106_114_60,1.0,0,60,60,2
46,r_129_7_157,r_124_39_104,seq3,r_129_7_157,1.0,0,157,157,2
7,r_81_102_142,seq22,r_1_95_23,r_81_102_142,1.0,0,142,142,2
9,r_144_117_118,r_37_56_146,r_54_119_157,r_37_56_146,0.4,-45,101,146,3
14,r_116_112_150,r_138_147_72,r_118_65_60,r_116_112_150,1.0,-78,72,150,3
8,r_38_113_119,r_23_129_175,r_17_77_5,r_38_113_119,0.99,1,120,119,3
49,r_109_33_57,seq2,seq136,r_109_33_57,1.0,1,58,57,3
43,r_134_52_125,seq18,seq16,r_134_52_125,0.99,4,129,125,3
26,r_46_114_43,seq16,seq2,r_46_114_43,1.0,0,43,43,3
37,r_61_53_164,r_5_84_166,seq55,r_61_53_164,0.76,1,165,164,3
16,r_140_121_177,r_5_84_166,r_116_112_150,r_140_121_177,0.52,0,177,177,3
1,r_122_97_145,seq75,r_60_1_80,r_60_1_80,1.0,81,161,80,3
27,r_29_40_10,r_67_73_32,seq76,r_29_40_10,0.74,0,10,10,3
5,r_83_95_167,r_123_64_176,seq18,r_83_95_167,0.79,0,167,167,3
46,r_78_9_65,seq4,r_128_102_174,r_78_9_65,0.85,6,71,65,3
48,r_36_58_38,seq76,seq104,r_36_58_38,1.0,3,41,38,3
45,r_103_82_173,seq27,r_109_33_57,r_109_33_57,1.0,116,173,57,3
11,r_47_142_21,seq31,r_85_44_88,r_85_44_88,1.0,4,92,88,3
76,seq55,r_37_56_146,r_138_147_72,r_138_147_72,1.0,9,81,72,3
31,r_13_79_76,r_35_108_138,seq98,r_13_79_76,0.79,0,76,76,3
3,r_60_1_80,r_85_44_88,seq90,r_60_1_80,1.0,0,80,80,3
10,r_54_119_157,seq132,r_148_86_35,r_54_119_157,0.95,1,158,157,3
14,r_116_112_150,r_118_65_60,seq132,r_116_112_150,0.99,0,150,150,3
20,r_100_105_61,r_54_119_157,seq94,r_100_105_61,1.0,0,61,61,3
46,r_78_9_65,r_128_102_174,r_38_113_119,r_38_113_119,0.84,55,174,119,3
52,seq3,r_148_86_35,seq75,r_148_86_35,1.0,0,35,35,3
6,r_37_56_146,seq55,r_137_6_171,r_137_6_171,0.79,-1,170,171,3
11,r_47_142_21,r_26_124_116,seq31,r_47_142_21,1.0,0,21,21,3
30,r_93_96_17,r_146_49_26,seq16,r_93_96_17,0.98,0,17,17,3
17,r_115_25_59,seq136,seq132,r_115_25_59,1.0,0,59,59,3
22,r_42_28_48,r_139_24_172,seq7,r_139_24_172,0.9,0,172,172,3
2,r_143_131_112,seq32,seq43,r_143_131_112,0.4,1,113,112,3
47,r_70_125_74,r_12_34_190,seq133,r_70_125_74,1.0,0,74,74,3
40,r_14_22_143,seq76,r_143_131_112,r_14_22_143,0.95,0,143,143,3
18,r_118_65_60,seq72,seq106,r_118_65_60,1.0,0,60,60,3
25,r_5_84_166,seq111,r_100_105_61,r_100_105_61,1.0,75,136,61,3
36,r_69_145_30,r_146_49_26,r_21_39_34,r_69_145_30,1.0,1,31,30,3
33,r_80_62_169,seq81,seq8,r_80_62_169,0.81,1,170,169,3
47,r_70_125_74,seq133,r_26_124_116,r_26_124_116,0.74,18,134,116,3
65,seq27,r_103_82_173,r_128_102_174,r_128_102_174,0.79,0,174,174,3
32,r_137_6_171,seq94,r_37_56_146,r_137_6_171,0.5,0,171,171,3
41,r_21_39_34,r_139_24_172,r_69_145_30,r_21_39_34,0.94,-1,33,34,3
62,seq18,r_115_25_59,r_83_95_167,r_83_95_167,0.92,11,178,167,3
15,r_146_49_26,r_59_107_137,seq88,r_146_49_26,0.94,2,28,26,3
60,seq15,r_149_74_195,r_148_86_35,r_148_86_35,1.0,38,73,35,3
21,r_148_86_35,seq3,seq15,r_148_86_35,1.0,0,35,35,3
61,seq16,r_46_114_43,seq75,r_46_114_43,1.0,0,43,43,3
9,r_144_117_118,r_54_119_157,seq92,r_144_117_118,0.96,0,118,118,3
22,r_42_28_48,r_60_1_80,r_139_24_172,r_60_1_80,1.0,-25,55,80,3
28,r_138_147_72,r_116_112_150,seq55,r_138_147_72,1.0,0,72,72,3
91,seq92,seq111,r_144_117_118,r_144_117_118,1.0,2,120,118,3
44,r_26_124_116,seq104,r_70_125_74,r_70_125_74,1.0,42,116,74,3
35,r_35_108_138,seq0,r_143_131_112,r_35_108_138,0.95,0,138,138,3
39,r_68_20_40,r_118_65_60,r_59_107_137,r_68_20_40,1.0,2,42,40,3
36,r_71_10_77,seq51,r_27_66_33,r_71_10_77,1.0,2,79,77,4
14,r_97_75_61,seq49,seq105,r_97_75_61,0.88,0,61,61,4
8,r_58_95_114,r_33_140_148,r_67_104_67,r_58_95_114,0.93,0,114,114,4
59,seq18,r_91_47_115,seq17,r_91_47_115,0.84,0,115,115,4
16,r_137_94_127,seq110,r_131_83_11,r_131_83_11,0.9,129,140,11,4
21,r_144_38_151,seq56,r_117_73_2,r_144_38_151,0.74,-3,148,151,4
26,r_16_72_50,r_124_143_173,seq105,r_16_72_50,1.0,0,50,50,4
1,r_99_84_150,r_147_1_195,seq114,r_99_84_150,0.87,0,150,150,4
5,r_130_106_95,seq6,seq136,r_130_106_95,0.88,0,95,95,4
42,r_7_139_137,seq57,r_137_94_127,r_7_139_137,0.88,0,137,137,4
45,r_52_134_155,r_13_2_134,r_22_23_96,r_22_23_96,1.0,38,134,96,4
19,r_67_104_67,r_89_86_157,seq79,r_67_104_67,0.95,1,68,67,4
38,r_102_41_189,r_146_121_119,r_46_145_35,r_102_41_189,0.78,-157,32,189,4
45,r_52_134_155,r_22_23_96,seq14,r_52_134_155,0.86,3,158,155,4
38,r_102_41_189,r_46_145_35,r_148_59_135,r_46_145_35,0.45,154,189,35,4
39,r_11_128_180,r_27_66_33,r_43_0_177,r_27_66_33,0.28,147,180,33,4
31,r_8_44_136,r_96_103_190,seq129,r_8_44_136,0.67,6,142,136,4
41,r_45_64_81,seq26,seq141,r_45_64_81,1.0,1,82,81,4
3,r_116_135_161,seq28,r_35_112_86,r_116_135_161,0.82,1,162,161,4
4,r_108_100_164,seq6,seq70,r_108_100_164,0.62,3,167,164,4
44,r_12_4_116,r_85_142_168,r_11_128_180,r_85_142_168,0.83,0,168,168,4
73,seq51,r_71_10_77,seq49,r_71_10_77,1.0,-16,61,77,4
11,r_115_5_126,r_90_77_123,r_125_31_5,r_115_5_126,0.99,0,126,126,4
13,r_89_86_157,seq107,r_36_62_1,r_89_86_157,0.93,0,157,157,4
15,r_132_126_94,r_90_77_123,seq87,r_132_126_94,1.0,0,94,94,4
48,r_96_103_190,seq29,r_130_106_95,r_96_103_190,0.22,0,190,190,4
6,r_148_59_135,seq56,seq19,r_148_59_135,0.9,0,135,135,4
10,r_46_145_35,seq60,r_102_41_189,r_46_145_35,0.99,-2,33,35,4
88,seq92,r_16_72_50,seq87,r_16_72_50,1.0,0,50,50,4
10,r_46_145_35,r_102_41_189,r_97_75_61,r_46_145_35,0.62,154,189,35,4
27,r_90_77_123,r_115_5_126,r_108_100_164,r_115_5_126,0.96,-3,123,126,4
87,seq87,r_33_140_148,seq61,r_33_140_148,1.0,-20,128,148,4
49,r_69_80_17,seq9,seq110,r_69_80_17,0.86,-1,16,17,4
40,r_91_47_115,seq18,seq57,r_91_47_115,0.5,0,115,115,4
18,r_109_82_63,seq32,seq39,r_109_82_63,1.0,0,63,63,4
29,r_22_23_96,r_33_140_148,r_52_134_155,r_22_23_96,0.91,-1,95,96,4
46,r_27_66_33,r_88_53_32,seq136,r_27_66_33,0.84,0,33,33,4
25,r_35_112_86,seq50,seq141,r_35_112_86,0.41,9,95,86,4
65,seq28,r_116_135_161,seq65,r_116_135_161,1.0,1,162,161,4
46,r_27_66_33,seq136,r_71_10_77,r_71_10_77,1.0,0,77,77,4
32,r_85_142_168,r_90_77_123,r_12_4_116,r_12_4_116,0.45,9,125,116,4
27,r_90_77_123,r_108_100_164,r_13_2_134,r_108_100_164,0.94,-15,149,164,4
37,r_30_21_27,r_144_38_151,seq136,r_30_21_27,0.99,0,27,27,4
75,seq56,r_148_59_135,r_124_143_173,r_148_59_135,1.0,0,135,135,4
94,seq114,seq138,r_99_84_150,r_99_84_150,0.98,1,151,150,4
9,r_33_140_148,seq87,r_137_94_127,r_33_140_148,0.9,2,150,148,4
47,r_55_120_56,seq113,r_117_73_2,r_55_120_56,0.85,-7,49,56,4
29,r_22_23_96,r_52_134_155,seq65,r_52_134_155,0.94,3,158,155,4
22,r_146_121_119,seq105,seq79,r_146_121_119,1.0,0,119,119,4
28,r_13_2_134,r_52_134_155,r_90_77_123,r_90_77_123,0.53,11,134,123,4
32,r_85_142_168,r_12_4_116,seq49,r_85_142_168,0.99,0,168,168,4
30,r_111_98_54,seq136,seq105,r_111_98_54,1.0,0,54,54,4
7,r_43_0_177,seq51,r_11_128_180,r_43_0_177,0.51,5,182,177,4
23,r_15_40_59,seq113,r_97_75_61,r_15_40_59,1.0,2,61,59,4
12,r_133_68_159,seq61,seq18,r_133_68_159,0.94,0,159,159,4
39,r_11_128_180,r_46_145_35,r_27_66_33,r_46_145_35,0.59,1,36,35,4
36,r_117_99_161,seq70,seq17,r_117_99_161,0.68,1,162,161,5
29,r_115_5_27,r_90_79_109,seq44,r_115_5_27,1.0,0,27,27,5
14,r_59_121_84,seq129,seq12,r_59_121_84,0.52,3,87,84,5
8,r_97_110_92,r_95_28_94,seq2,r_97_110_92,0.92,0,92,92,5
53,seq6,r_137_122_130,seq114,r_137_122_130,0.88,0,130,130,5
43,r_30_72_162,seq66,r_142_46_114,r_142_46_114,0.86,48,162,114,5
28,r_16_43_25,r_113_13_111,seq73,r_16_43_25,0.95,7,32,25,5
37,r_61_10_100,r_119_52_133,r_103_63_14,r_103_63_14,0.74,88,102,14,5
55,seq136,r_113_13_111,r_91_123_64,r_91_123_64,1.0,28,92,64,5
16,r_33_3_68,seq31,seq148,r_33_3_68,1.0,0,68,68,5
39,r_36_88_149,seq93,seq128,r_36_88_149,0.87,2,151,149,5
5,r_67_56_119,r_108_20_177,seq2,r_67_56_119,0.99,0,119,119,5
42,r_7_41_89,seq11,r_139_21_15,r_7_41_89,0.94,21,110,89,5
2,r_50_25_166,r_67_56_119,r_57_62_9,r_50_25_166,0.92,0,166,166,5
30,r_42_38_179,r_60_4_1,r_53_85_21,r_53_85_21,0.87,1,22,21,5
4,r_49_124_52,seq18,seq136,r_49_124_52,1.0,-1,51,52,5
17,r_138_82_35,seq107,r_143_130_65,r_143_130_65,1.0,0,65,65,5
41,r_137_122_130,seq6,seq148,r_137_122_130,0.93,0,130,130,5
45,r_53_85_21,r_80_27_117,r_42_38_179,r_53_85_21,0.97,0,21,21,5
3,r_113_13_111,r_146_133_168,r_142_46_114,r_142_46_114,1.0,1,115,114,5
35,r_144_26_17,r_97_110_92,seq100,r_144_26_17,0.75,-3,14,17,5
26,r_78_0_75,r_36_88_149,seq66,r_78_0_75,0.9,0,75,75,5
38,r_139_21_15,seq45,seq18,r_139_21_15,0.99,-1,14,15,5
78,seq64,r_126_71_156,r_89_101_48,r_89_101_48,1.0,112,160,48,5
0,r_29_39_116,seq24,seq129,r_29_39_116,0.98,0,116,116,5
63,seq148,seq83,r_33_3_68,r_33_3_68,1.0,12,80,68,5
11,r_92_8_86,seq83,seq9,r_92_8_86,1.0,2,88,86,5
48,r_91_123_64,seq55,seq136,r_91_123_64,1.0,1,65,64,5
49,r_51_84_181,r_103_63_14,r_34_106_143,r_103_63_14,0.64,167,181,14,5
72,seq44,seq83,r_115_5_27,r_115_5_27,1.0,21,48,27,5
6,r_34_106_143,r_131_149_197,r_138_82_35,r_34_106_143,0.93,1,144,143,5
62,seq19,r_142_46_114,r_103_63_14,r_142_46_114,0.75,-8,106,114,5
31,r_89_101_48,seq2,seq64,r_89_101_48,1.0,0,48,48,5
10,r_103_63_14,r_51_84_181,r_105_104_137,r_105_104_137,0.53,44,181,137,5
49,r_51_84_181,r_142_46_114,r_103_63_14,r_103_63_14,0.72,0,14,14,5
27,r_80_27_117,seq73,r_33_3_68,r_80_27_117,0.9,0,117,117,5
30,r_42_38_179,r_53_85_21,r_16_43_25,r_42_38_179,0.41,0,179,179,5
2,r_50_25_166,r_75_65_144,r_67_56_119,r_67_56_119,0.95,25,144,119,5
47,r_111_134_106,seq17,r_59_121_84,r_111_134_106,0.61,7,113,106,5
40,r_119_52_133,seq64,r_32_127_47,r_119_52_133,0.6,0,133,133,5
18,r_146_133_168,seq136,seq68,r_146_133_168,0.5,2,170,168,5
1,r_147_87_22,r_115_5_27,seq120,r_115_5_27,0.75,-5,22,27,5
24,r_132_145_69,r_125_98_158,seq14,r_132_145_69,1.0,1,70,69,5
32,r_90_79_109,seq73,seq37,r_90_79_109,1.0,2,111,109,5
10,r_103_63_14,r_50_25_166,r_51_84_181,r_103_63_14,0.93,0,14,14,5
99,seq120,seq45,r_147_87_22,r_147_87_22,1.0,0,22,22,5
15,r_32_127_47,r_58_141_54,seq14,r_32_127_47,1.0,0,47,47,5
17,r_138_82_35,r_113_13_111,seq107,r_138_82_35,0.78,0,35,35,5
45,r_53_85_21,r_42_38_179,seq55,r_53_85_21,0.39,158,179,21,5
81,seq70,r_117_99_161,r_15_47_96,r_15_47_96,1.0,66,162,96,5
9,r_142_46_114,r_51_84_181,r_113_13_111,r_142_46_114,0.99,0,114,114,5
22,r_143_130_65,r_50_25_166,r_138_82_35,r_143_130_65,1.0,0,65,65,5
7,r_108_20_177,seq1,r_147_87_22,r_108_20_177,0.6,1,178,177,5
44,r_75_65_144,r_50_25_166,r_32_127_47,r_50_25_166,0.84,-22,144,166,5
23,r_105_104_137,seq37,r_103_63_14,r_105_104_137,0.71,0,137,137,5
82,seq73,r_90_79_109,r_16_43_25,r_90_79_109,0.84,2,111,109,5
12,r_131_149_197,r_34_106_143,seq1,r_34_106_143,1.0,-10,133,143,5
51,seq129,r_114_67_129,seq69,r_114_67_129,1.0,0,129,129,6
6,r_78_88_33,seq0,seq130,r_78_88_33,0.94,-1,32,33,6
14,r_52_59_108,seq41,r_11_141_59,r_11_141_59,0.99,49,108,59,6
8,r_72_100_76,seq4,seq56,r_72_100_76,0.9,1,77,76,6
43,r_29_102_151,r_124_90_150,seq32,r_29_102_151,0.78,0,151,151,6
83,seq66,r_124_90_150,r_34_101_99,r_34_101_99,1.0,52,151,99,6
37,r_2_79_120,seq6,r_52_59_108,r_2_79_120,1.0,0,120,120,6
55,seq6,r_2_79_120,seq15,r_2_79_120,1.0,4,124,120,6
16,r_121_133_103,seq131,seq66,r_121_133_103,0.95,3,106,103,6
21,r_28_125_130,seq69,r_60_143_20,r_28_125_130,0.97,3,133,130,6
39,r_80_27_123,seq18,seq120,r_80_27_123,0.85,2,125,123,6
1,r_132_81_161,r_5_45_78,seq4,r_5_45_78,0.88,-3,75,78,6
33,r_60_143_20,r_124_90_150,seq130,r_124_90_150,0.72,-130,20,150,6
46,r_5_45_78,r_132_81_161,r_117_76_199,r_5_45_78,0.96,-1,77,78,6
80,seq56,r_124_90_150,r_72_100_76,r_72_100_76,0.95,1,77,76,6
45,r_136_140_62,seq66,r_96_86_24,r_96_86_24,0.87,38,62,24,6
19,r_109_128_160,r_31_92_166,seq137,r_109_128_160,0.52,1,161,160,6
48,r_61_126_107,r_70_63_137,seq84,r_70_63_137,0.98,6,143,137,6
5,r_111_74_56,seq25,seq18,r_111_74_56,0.97,-4,52,56,6
38,r_107_82_54,r_91_118_141,seq104,r_107_82_54,1.0,0,54,54,6
35,r_11_141_59,seq57,seq62,r_11_141_59,1.0,-1,58,59,6
31,r_123_119_88,seq112,seq7,r_123_119_88,0.98,-1,87,88,6
41,r_26_14_67,r_64_13_2,r_20_55_18,r_26_14_67,1.0,0,67,67,6
61,seq18,r_80_27_123,r_96_86_24,r_96_86_24,0.96,4,28,24,6
66,seq25,r_111_74_56,r_9_127_193,r_111_74_56,0.61,-14,42,56,6
3,r_34_101_99,r_71_58_173,r_93_135_80,r_34_101_99,0.9,-2,97,99,6
10,r_124_90_150,r_29_102_151,seq4,r_124_90_150,0.83,1,151,150,6
4,r_1_65_118,seq8,r_114_67_129,r_114_67_129,0.89,-5,124,129,6
42,r_144_145_47,seq56,seq113,r_144_145_47,1.0,-1,46,47,6
11,r_70_63_137,r_93_135_80,r_114_67_129,r_70_63_137,0.79,-63,74,137,6
13,r_33_85_93,r_9_127_193,seq83,r_33_85_93,0.91,2,95,93,6
15,r_114_67_129,seq129,r_1_65_118,r_114_67_129,0.96,0,129,129,6
48,r_61_126_107,seq104,r_70_63_137,r_61_126_107,0.87,2,109,107,6
47,r_93_135_80,seq7,r_70_63_137,r_93_135_80,0.62,-30,50,80,6
11,r_70_63_137,r_61_126_107,seq137,r_70_63_137,0.97,4,141,137,6
62,seq19,r_89_105_154,r_37_99_51,r_89_105_154,0.99,-55,99,154,6
85,seq69,r_28_125_130,seq129,r_28_125_130,1.0,3,133,130,6
33,r_60_143_20,seq130,r_78_88_33,r_78_88_33,0.77,18,51,33,6
47,r_93_135_80,r_70_63_137,r_124_90_150,r_93_135_80,0.98,1,81,80,6
27,r_39_51_106,seq134,seq4,r_39_51_106,0.99,0,106,106,6
87,seq83,r_98_148_178,r_33_85_93,r_33_85_93,1.0,87,180,93,6
29,r_49_10_170,r_71_58_173,r_20_55_18,r_20_55_18,0.58,153,171,18,6
24,r_31_92_166,r_109_128_160,r_1_65_118,r_31_92_166,0.75,-5,161,166,6
47,r_93_135_80,r_124_90_150,r_34_101_99,r_93_135_80,0.6,71,151,80,6
11,r_70_63_137,r_114_67_129,r_61_126_107,r_70_63_137,0.55,-30,107,137,6
32,r_77_48_167,seq129,r_109_128_160,r_109_128_160,0.65,8,168,160,6
12,r_37_99_51,r_34_101_99,r_122_35_17,r_37_99_51,0.53,-7,44,51,6
33,r_60_143_20,r_78_88_33,r_28_125_130,r_28_125_130,0.96,-4,126,130,6
17,r_91_118_141,seq43,seq115,r_91_118_141,0.96,0,141,141,6
52,seq130,r_60_143_20,r_78_88_33,r_78_88_33,0.91,0,33,33,6
22,r_97_16_185,r_93_135_80,seq129,r_93_135_80,0.55,2,82,80,6
18,r_96_86_24,seq130,seq18,r_96_86_24,0.95,1,25,24,6
34,r_106_95_46,seq42,seq83,r_106_95_46,0.99,0,46,46,6
23,r_103_54_84,seq23,seq0,r_103_54_84,0.93,0,84,84,6
30,r_122_35_17,r_72_100_76,r_37_99_51,r_122_35_17,0.86,-3,14,17,6
93,seq111,seq41,r_100_13_153,r_100_13_153,0.31,6,159,153,7
36,r_88_127_173,seq86,r_141_82_34,r_141_82_34,1.0,35,69,34,7
92,seq108,seq42,r_126_43_47,r_126_43_47,0.97,33,80,47,7
8,r_84_96_199,r_11_135_130,r_10_129_131,r_84_96_199,0.96,-69,130,199,7
43,r_45_35_71,seq46,seq90,r_45_35_71,1.0,0,71,71,7
83,seq86,r_88_127_173,r_141_82_34,r_141_82_34,0.96,120,154,34,7
31,r_16_118_15,r_139_138_28,seq79,r_16_118_15,0.74,0,15,15,7
21,r_7_93_179,seq34,r_10_129_131,r_10_129_131,0.79,48,179,131,7
39,r_142_2_66,r_107_38_152,seq42,r_142_2_66,1.0,0,66,66,7
1,r_75_5_174,r_19_56_195,seq120,r_19_56_195,0.61,-21,174,195,7
97,seq119,seq37,r_70_125_77,r_70_125_77,1.0,27,104,77,7
5,r_122_65_156,seq148,seq34,r_122_65_156,0.53,2,158,156,7
46,r_109_50_178,seq55,r_145_12_19,r_145_12_19,0.38,159,178,19,7
42,r_72_59_82,seq89,seq55,r_72_59_82,0.99,0,82,82,7
2,r_130_85_50,r_92_87_133,seq55,r_130_85_50,1.0,0,50,50,7
19,r_30_94_78,r_100_13_153,r_130_85_50,r_30_94_78,0.77,1,79,78,7
41,r_117_149_68,r_122_65_156,seq14,r_117_149_68,1.0,0,68,68,7
67,seq40,seq101,r_73_3_108,r_73_3_108,1.0,10,118,108,7
89,seq104,seq114,r_24_27_160,r_24_27_160,1.0,3,163,160,7
3,r_92_87_133,seq54,r_32_147_129,r_92_87_133,1.0,1,134,133,7
0,r_123_58_196,r_31_78_132,seq20,r_31_78_132,1.0,1,133,132,7
11,r_31_78_132,r_123_58_196,r_141_82_34,r_31_78_132,0.86,0,132,132,7
26,r_126_43_47,r_28_29_96,seq108,r_126_43_47,0.82,4,51,47,7
13,r_73_3_108,seq14,seq40,r_73_3_108,0.98,0,108,108,7
15,r_70_125_77,r_103_74_121,seq119,r_70_125_77,0.99,0,77,77,7
4,r_141_82_34,r_88_127_173,r_31_78_132,r_31_78_132,0.9,17,149,132,7
17,r_24_27_160,r_136_52_37,r_139_138_28,r_136_52_37,0.99,0,37,37,7
6,r_10_129_131,seq101,r_70_125_77,r_10_129_131,0.51,2,133,131,7
85,seq90,r_62_146_175,r_45_35_71,r_45_35_71,1.0,104,175,71,7
36,r_88_127_173,r_141_82_34,seq23,r_141_82_34,0.66,143,177,34,7
4,r_141_82_34,r_10_129_131,r_88_127_173,r_141_82_34,1.0,0,34,34,7
9,r_124_133_35,seq119,seq148,r_124_133_35,1.0,0,35,35,7
25,r_139_138_28,r_88_127_173,r_24_27_160,r_139_138_28,0.84,-1,27,28,7
87,seq99,r_32_147_129,seq20,r_32_147_129,0.78,3,132,129,7
47,r_107_38_152,r_19_56_195,seq44,r_107_38_152,0.65,0,152,152,7
18,r_144_95_141,r_109_50_178,seq6,r_144_95_141,0.88,0,141,141,7
29,r_83_81_114,r_102_26_166,r_145_12_19,r_83_81_114,0.96,0,114,114,7
24,r_105_64_146,seq46,seq54,r_105_64_146,0.98,0,146,146,7
33,r_60_49_185,seq120,r_22_15_105,r_22_15_105,0.38,81,186,105,7
28,r_4_1_30,seq47,seq9,r_4_1_30,1.0,0,30,30,7
30,r_113_116_42,seq106,seq40,r_113_116_42,1.0,0,42,42,7
58,seq17,seq79,r_92_87_133,r_92_87_133,1.0,13,146,133,7
81,seq77,r_75_5_174,r_36_71_14,r_36_71_14,0.99,1,15,14,7
34,r_97_61_62,r_100_13_153,seq132,r_97_61_62,0.74,16,78,62,7
75,seq55,r_109_50_178,r_72_59_82,r_72_59_82,1.0,23,105,82,7
25,r_139_138_28,r_24_27_160,r_130_85_50,r_139_138_28,0.89,132,160,28,7
94,seq112,seq33,r_21_134_4,r_21_134_4,0.74,134,138,4,7
22,r_32_147_129,seq99,r_92_87_133,r_92_87_133,0.99,3,136,133,7
91,seq148,r_122_65_156,r_124_133_35,r_124_133_35,0.97,112,147,35,7
10,r_145_12_19,seq41,seq47,r_145_12_19,0.99,0,19,19,7
7,r_11_135_130,r_84_96_199,r_141_82_34,r_11_135_130,0.8,0,130,130,7
23,r_103_74_121,seq6,seq77,r_103_74_121,1.0,0,121,121,7
17,r_24_27_160,r_139_138_28,seq37,r_24_27_160,0.81,0,160,160,7
32,r_136_52_37,r_24_27_160,seq6,r_136_52_37,1.0,0,37,37,7
79,seq68,seq101,r_145_12_19,r_145_12_19,0.95,99,118,19,7
27,r_36_71_14,seq42,seq77,r_36_71_14,1.0,0,14,14,7
12,r_110_80_128,seq14,seq114,r_110_80_128,0.84,1,129,128,7
49,r_127_117_18,r_46_18_155,r_108_37_154,r_127_117_18,1.0,0,18,18,8
36,r_44_28_171,r_47_7_95,r_126_54_69,r_44_28_171,1.0,-92,79,171,8
9,r_70_41_167,r_27_64_54,r_69_91_46,r_70_41_167,0.9,3,170,167,8
8,r_143_39_68,seq87,r_11_111_1,r_143_39_68,1.0,0,68,68,8
43,r_2_123_66,seq34,r_137_3_29,r_2_123_66,0.97,0,66,66,8
29,r_109_61_11,seq67,r_121_10_72,r_121_10_72,1.0,1,73,72,8
30,r_29_135_38,r_126_54_69,r_71_86_24,r_29_135_38,0.99,0,38,38,8
37,r_46_18_155,seq147,r_88_15_199,r_46_18_155,0.68,1,156,155,8
5,r_69_91_46,r_108_37_154,seq21,r_69_91_46,0.99,0,46,46,8
86,seq80,r_57_134_188,r_6_122_71,r_6_122_71,1.0,108,179,71,8
21,r_6_122_71,seq102,seq87,r_6_122_71,1.0,1,72,71,8
1,r_33_130_116,seq148,seq31,r_33_130_116,0.85,2,118,116,8
42,r_72_16_143,seq82,r_89_13_141,r_72_16_143,0.9,1,144,143,8
19,r_81_0_79,seq56,r_133_84_5,r_81_0_79,0.88,3,82,79,8
14,r_49_107_49,seq43,seq34,r_49_107_49,1.0,0,49,49,8
67,seq35,r_46_18_155,r_47_7_95,r_47_7_95,1.0,0,95,95,8
89,seq97,seq73,r_126_54_69,r_126_54_69,1.0,26,95,69,8
23,r_108_37_154,r_90_25_91,r_127_117_18,r_108_37_154,0.96,-114,40,154,8
44,r_131_103_42,r_115_8_189,seq82,r_131_103_42,1.0,1,43,42,8
16,r_133_84_5,seq1,r_81_0_79,r_81_0_79,1.0,27,106,79,8
32,r_71_86_24,seq80,r_2_123_66,r_71_86_24,0.93,0,24,24,8
0,r_96_100_55,r_47_7_95,seq110,r_47_7_95,1.0,-23,72,95,8
63,seq132,seq1,r_5_129_120,r_5_129_120,0.89,7,127,120,8
20,r_144_85_126,seq80,r_121_10_72,r_144_85_126,0.84,0,126,126,8
13,r_142_112_195,r_70_41_167,r_38_60_6,r_70_41_167,0.69,-13,154,167,8
79,seq67,r_38_60_6,r_109_61_11,r_109_61_11,0.58,23,34,11,8
49,r_127_117_18,r_108_37_154,r_89_13_141,r_127_117_18,0.99,136,154,18,8
4,r_27_64_54,r_70_41_167,r_38_60_6,r_27_64_54,0.53,116,170,54,8
6,r_5_129_120,r_70_41_167,seq132,r_5_129_120,0.8,2,122,120,8
4,r_27_64_54,seq1,r_70_41_167,r_27_64_54,0.96,1,55,54,8
36,r_44_28_171,r_126_54_69,r_108_37_154,r_126_54_69,0.72,102,171,69,8
27,r_125_140_164,seq20,seq12,r_125_140_164,0.93,0,164,164,8
53,seq136,seq58,r_26_62_114,r_26_62_114,0.83,-2,112,114,8
29,r_109_61_11,seq102,seq67,r_109_61_11,0.86,8,19,11,8
87,seq82,r_72_16_143,seq50,r_72_16_143,1.0,1,144,143,8
2,r_121_10_72,seq147,r_109_61_11,r_121_10_72,1.0,1,73,72,8
38,r_138_92_22,r_143_39_68,seq118,r_138_92_22,0.82,0,22,22,8
40,r_126_54_69,seq128,seq97,r_126_54_69,0.93,0,69,69,8
39,r_137_3_29,r_125_140_164,r_2_123_66,r_137_3_29,0.52,56,85,29,8
18,r_115_8_189,seq78,r_47_7_95,r_47_7_95,0.97,94,189,95,8
24,r_65_22_62,seq23,seq75,r_65_22_62,1.0,0,62,62,8
25,r_95_66_139,r_125_140_164,seq128,r_95_66_139,0.81,0,139,139,8
33,r_26_62_114,seq145,seq136,r_26_62_114,0.9,4,118,114,8
48,r_93_105_14,seq24,r_99_63_78,r_99_63_78,1.0,25,103,78,8
58,seq147,r_46_18_155,r_47_7_95,r_47_7_95,1.0,39,134,95,8
39,r_137_3_29,r_5_129_120,r_125_140_164,r_137_3_29,0.92,1,30,29,8
48,r_93_105_14,seq136,seq24,r_93_105_14,0.84,5,19,14,8
26,r_51_141_12,r_121_10_72,seq104,r_51_141_12,0.72,0,12,12,8
11,r_116_30_30,seq23,seq102,r_116_30_30,1.0,0,30,30,8
70,seq43,r_49_107_49,r_52_98_19,r_49_107_49,0.98,0,49,49,8
94,seq110,r_108_37_154,r_96_100_55,r_108_37_154,0.81,-75,79,154,8
9,r_70_41_167,r_5_129_120,r_27_64_54,r_70_41_167,0.86,-81,86,167,8
22,r_90_25_91,r_108_37_154,r_65_22_62,r_90_25_91,0.96,0,91,91,8
10,r_52_98_19,seq9,seq43,r_52_98_19,1.0,0,19,19,8
32,r_71_86_24,r_2_123_66,r_29_135_38,r_2_123_66,0.93,0,66,66,8
7,r_89_13_141,seq31,r_126_54_69,r_89_13_141,0.72,0,141,141,8
55,seq139,r_137_3_29,r_38_60_6,r_137_3_29,0.98,-5,24,29,8
35,r_47_7_95,r_42_106_158,seq35,r_47_7_95,1.0,0,95,95,8
12,r_99_63_78,r_33_130_116,r_93_105_14,r_99_63_78,0.97,1,79,78,8
23,r_108_37_154,r_127_117_18,r_26_62_114,r_127_117_18,0.48,136,154,18,8
30,r_5_132_111,seq130,seq12,r_5_132_111,0.48,-31,80,111,9
36,r_11_96_131,seq20,r_144_89_41,r_144_89_41,0.6,91,132,41,9
53,seq133,r_80_111_77,seq72,r_80_111_77,1.0,1,78,77,9
37,r_44_147_182,r_0_39_65,seq113,r_44_147_182,0.64,0,182,182,9
71,seq129,r_106_66_56,r_69_52_30,r_69_52_30,0.97,39,69,30,9
39,r_119_75_143,seq130,seq79,r_119_75_143,0.86,0,143,143,9
1,r_101_51_32,r_6_98_33,r_137_93_146,r_137_93_146,0.99,16,162,146,9
60,seq142,seq43,r_56_4_18,r_56_4_18,0.97,3,21,18,9
46,r_73_31_190,seq60,r_59_65_118,r_59_65_118,0.98,14,132,118,9
42,r_8_77_164,r_40_102_168,r_139_125_23,r_139_125_23,0.8,144,167,23,9
11,r_6_98_33,seq72,r_101_51_32,r_6_98_33,0.96,0,33,33,9
14,r_78_135_15,r_87_103_43,seq13,r_78_135_15,0.91,0,15,15,9
46,r_73_31_190,r_59_65_118,r_116_91_76,r_73_31_190,0.89,0,190,190,9
27,r_84_17_40,r_137_93_146,r_107_121_134,r_137_93_146,0.65,0,146,146,9
45,r_67_148_55,r_30_94_54,seq79,r_67_148_55,0.91,0,55,55,9
14,r_78_135_15,r_0_39_65,r_145_37_135,r_145_37_135,0.79,0,135,135,9
32,r_100_3_28,seq43,r_92_122_72,r_92_122_72,1.0,6,78,72,9
0,r_87_103_43,r_73_31_190,seq47,r_87_103_43,1.0,0,43,43,9
41,r_59_65_118,seq76,r_71_34_19,r_59_65_118,0.96,0,118,118,9
3,r_105_146_98,r_40_102_168,r_0_39_65,r_105_146_98,1.0,0,98,98,9
1,r_101_51_32,r_118_18_58,r_6_98_33,r_101_51_32,0.98,1,33,32,9
10,r_40_102_168,r_8_77_164,seq32,r_40_102_168,0.59,-1,167,168,9
38,r_139_125_23,r_61_140_105,seq149,r_139_125_23,0.91,1,24,23,9
14,r_78_135_15,seq13,r_0_39_65,r_78_135_15,0.44,89,104,15,9
31,r_35_28_52,r_99_104_117,seq76,r_35_28_52,1.0,1,53,52,9
73,seq43,r_40_102_168,r_100_3_28,r_100_3_28,0.99,143,171,28,9
20,r_116_91_76,r_74_21_167,r_5_132_111,r_116_91_76,1.0,0,76,76,9
15,r_74_21_167,seq2,r_107_121_134,r_74_21_167,0.86,0,167,167,9
48,r_15_97_106,seq46,r_67_148_55,r_15_97_106,0.93,5,111,106,9
6,r_137_93_146,r_26_112_148,r_101_51_32,r_137_93_146,0.85,0,146,146,9
26,r_69_52_30,r_74_21_167,seq33,r_69_52_30,1.0,0,30,30,9
8,r_106_66_56,seq129,seq133,r_106_66_56,0.9,1,57,56,9
64,seq149,seq22,r_139_125_23,r_139_125_23,1.0,1,24,23,9
2,r_92_122_72,seq130,r_100_3_28,r_92_122_72,1.0,0,72,72,9
40,r_107_121_134,r_95_120_189,r_84_17_40,r_84_17_40,1.0,95,135,40,9
4,r_56_4_18,seq76,seq142,r_56_4_18,0.85,0,18,18,9
25,r_80_111_77,seq133,seq46,r_80_111_77,0.98,1,78,77,9
19,r_144_89_41,seq68,r_27_138_9,r_144_89_41,1.0,0,41,41,9
33,r_55_24_195,r_26_112_148,r_107_121_134,r_55_24_195,0.78,-46,149,195,9
52,seq2,r_74_21_167,r_87_103_43,r_87_103_43,0.85,124,167,43,9
34,r_61_140_105,r_127_38_172,r_67_148_55,r_61_140_105,1.0,0,105,105,9
75,seq47,r_63_131_187,r_87_103_43,r_87_103_43,1.0,141,184,43,9
47,r_118_18_58,seq29,seq113,r_118_18_58,1.0,1,59,58,9
45,r_67_148_55,seq79,r_15_97_106,r_15_97_106,0.97,19,125,106,9
17,r_90_86_110,seq110,r_35_28_52,r_90_86_110,0.93,1,111,110,9
27,r_84_17_40,r_11_96_131,r_137_93_146,r_84_17_40,1.0,0,40,40,9
32,r_100_3_28,seq9,seq43,r_100_3_28,0.93,1,29,28,9
9,r_127_38_172,r_14_45_186,r_11_96_131,r_14_45_186,0.73,-13,173,186,9
44,r_126_70_48,r_106_66_56,r_139_125_23,r_126_70_48,1.0,2,50,48,9
22,r_99_104_117,seq60,seq1,r_99_104_117,0.99,0,117,117,9
28,r_14_45_186,seq128,seq7,r_14_45_186,0.55,0,186,186,9
18,r_71_34_19,r_48_83_70,r_19_85_25,r_71_34_19,1.0,6,25,19,9
49,r_26_112_148,r_55_24_195,r_69_52_30,r_26_112_148,0.75,1,149,148,9
7,r_0_39_65,r_44_147_182,r_87_103_43,r_87_103_43,1.0,140,183,43,9
23,r_48_83_70,r_26_112_148,seq12,r_48_83_70,1.0,0,70,70,9
35,r_145_37_135,seq25,r_78_135_15,r_145_37_135,0.81,0,135,135,9
12,r_41_82_152,seq110,seq136,r_41_82_152,0.89,1,153,152,9
29,r_19_85_25,r_127_38_172,r_71_34_19,r_19_85_25,1.0,0,25,25,9
36,r_119_50_58,r_2_96_163,r_6_65_40,r_119_50_58,1.0,0,58,58,10
8,r_86_1_197,r_101_29_159,r_122_108_144,r_101_29_159,0.59,-4,155,159,10
34,r_109_123_23,r_28_40_63,r_13_70_87,r_28_40_63,0.99,-19,44,63,10
34,r_109_123_23,r_122_108_144,r_28_40_63,r_109_123_23,0.55,2,25,23,10
21,r_97_10_121,seq25,r_13_70_87,r_97_10_121,1.0,0,121,121,10
1,r_122_108_144,r_0_69_4,r_44_115_186,r_122_108_144,0.6,0,144,144,10
82,seq73,seq149,r_46_55_150,r_46_55_150,0.93,2,152,150,10
46,r_28_40_63,seq148,seq139,r_28_40_63,1.0,0,63,63,10
45,r_38_128_183,r_44_115_186,r_126_129_157,r_126_129_157,0.56,26,183,157,10
19,r_19_105_172,r_4_78_154,seq7,r_4_78_154,0.68,0,154,154,10
39,r_90_71_130,r_94_81_31,r_120_68_112,r_94_81_31,1.0,100,131,31,10
31,r_13_70_87,seq84,r_109_123_23,r_13_70_87,0.67,1,88,87,10
20,r_63_56_33,seq131,seq107,r_63_56_33,0.99,0,33,33,10
17,r_126_129_157,r_9_133_37,r_31_142_1,r_9_133_37,1.0,3,40,37,10
26,r_46_55_150,seq82,seq73,r_46_55_150,0.5,0,150,150,10
11,r_132_35_131,r_101_29_159,seq5,r_101_29_159,0.77,-27,132,159,10
23,r_125_146_55,r_120_68_112,seq25,r_125_146_55,1.0,2,57,55,10
13,r_6_65_40,r_132_35_131,r_119_50_58,r_6_65_40,0.7,92,132,40,10
0,r_9_133_37,r_126_129_157,seq42,r_9_133_37,0.82,3,40,37,10
5,r_94_81_31,r_90_71_130,seq107,r_90_71_130,1.0,1,131,130,10
27,r_58_111_113,r_38_128_183,seq82,r_58_111_113,0.6,2,115,113,10
43,r_41_36_52,seq26,seq82,r_41_36_52,1.0,1,53,52,10
39,r_90_71_130,r_19_105_172,r_94_81_31,r_94_81_31,0.99,10,41,31,10
40,r_4_78_154,r_19_105_172,r_144_37_48,r_4_78_154,0.67,0,154,154,10
33,r_99_102_148,seq121,seq100,r_99_102_148,0.37,3,151,148,10
6,r_57_114_54,r_24_135_179,seq137,r_57_114_54,1.0,0,54,54,10
70,seq139,seq118,r_28_40_63,r_28_40_63,1.0,2,65,63,10
65,seq26,seq66,r_60_75_93,r_60_75_93,1.0,43,136,93,10
61,seq131,r_20_91_126,r_130_22_115,r_20_91_126,1.0,-35,91,126,10
38,r_53_103_173,seq87,r_62_61_94,r_62_61_94,0.93,86,180,94,10
19,r_19_105_172,seq7,r_24_135_179,r_19_105_172,0.94,-1,171,172,10
12,r_43_92_14,r_24_135_179,seq82,r_43_92_14,0.97,2,16,14,10
48,r_140_113_16,seq8,seq131,r_140_113_16,1.0,0,16,16,10
22,r_143_64_81,r_90_71_130,seq51,r_143_64_81,0.95,0,81,81,10
10,r_17_77_49,r_136_23_91,r_9_133_37,r_17_77_49,0.95,2,51,49,10
28,r_79_12_123,r_101_29_159,r_31_142_1,r_101_29_159,0.74,-36,123,159,10
7,r_101_29_159,r_86_1_197,seq7,r_101_29_159,0.93,0,159,159,10
44,r_88_59_125,seq147,r_60_75_93,r_88_59_125,1.0,0,125,125,10
5,r_94_81_31,r_122_108_144,r_90_71_130,r_94_81_31,1.0,0,31,31,10
17,r_126_129_157,r_31_142_1,r_143_64_81,r_143_64_81,1.0,76,157,81,10
28,r_51_38_43,seq116,seq34,r_51_38_43,1.0,0,43,43,11
30,r_148_113_174,seq108,r_135_64_159,r_135_64_159,0.64,16,175,159,11
14,r_126_109_70,r_61_128_136,seq44,r_126_109_70,1.0,0,70,70,11
8,r_25_110_166,seq103,seq131,r_25_110_166,0.74,0,166,166,11
53,seq134,r_2_53_89,seq77,r_2_53_89,1.0,0,89,89,11
37,r_6_71_109,seq48,seq9,r_6_71_109,1.0,1,110,109,11
71,seq41,r_114_59_180,seq105,r_114_59_180,0.8,0,180,180,11
5,r_87_137_113,seq119,r_91_101_186,r_87_137_113,1.0,0,113,113,11
46,r_69_127_146,r_122_83_184,r_102_136_80,r_69_127_146,0.74,0,146,146,11
42,r_138_72_62,r_6_71_109,r_14_79_42,r_138_72_62,1.0,0,62,62,11
19,r_102_136_80,r_123_13_141,seq142,r_102_136_80,0.93,0,80,80,11
13,r_7_40_114,r_138_72_62,seq107,r_7_40_114,0.89,0,114,114,11
52,seq5,r_12_68_165,r_26_95_8,r_26_95_8,0.95,2,10,8,11
39,r_147_54_48,seq28,r_51_38_43,r_147_54_48,0.51,76,124,48,11
31,r_45_60_64,seq131,r_133_58_36,r_45_60_64,1.0,1,65,64,11
41,r_76_143_99,r_7_40_114,r_117_140_59,r_7_40_114,0.88,-14,100,114,11
17,r_133_58_36,seq9,r_45_60_64,r_45_60_64,0.97,28,92,64,11
90,seq104,r_120_30_198,r_98_82_82,r_98_82_82,1.0,72,154,82,11
26,r_130_15_149,seq43,seq77,r_130_15_149,0.45,2,151,149,11
72,seq43,r_130_15_149,r_52_89_98,r_52_89_98,1.0,53,151,98,11
40,r_84_11_1,r_133_58_36,seq105,r_133_58_36,1.0,1,37,36,11
4,r_2_53_89,seq134,seq16,r_2_53_89,1.0,0,89,89,11
11,r_23_37_63,r_61_128_136,seq116,r_23_37_63,0.79,2,65,63,11
20,r_18_63_84,r_61_128_136,seq10,r_61_128_136,1.0,-20,116,136,11
13,r_7_40_114,r_76_143_99,r_138_72_62,r_138_72_62,0.99,28,90,62,11
15,r_135_64_159,seq29,r_124_42_27,r_124_42_27,1.0,33,60,27,11
48,r_0_129_161,seq112,r_27_139_144,r_27_139_144,0.98,18,162,144,11
21,r_14_79_42,r_7_40_114,r_138_72_62,r_7_40_114,0.87,-10,104,114,11
16,r_49_57_34,seq107,r_126_109_70,r_126_109_70,0.66,-36,34,70,11
27,r_12_68_165,seq116,r_66_78_71,r_66_78_71,0.81,94,165,71,11
53,seq134,seq77,r_27_139_144,r_27_139_144,1.0,16,160,144,11
87,seq94,r_80_22_168,r_117_140_59,r_117_140_59,1.0,109,168,59,11
47,r_111_81_78,r_3_144_104,seq35,r_111_81_78,0.6,0,78,78,11
3,r_19_1_52,r_7_40_114,seq28,r_19_1_52,1.0,0,52,52,11
18,r_123_13_141,seq34,seq134,r_123_13_141,0.98,1,142,141,11
29,r_55_106_111,r_69_127_146,r_117_140_59,r_55_106_111,0.77,0,111,111,11
24,r_50_86_128,seq29,r_66_78_71,r_66_78_71,1.0,62,133,71,11
25,r_61_128_136,r_23_37_63,r_49_57_34,r_61_128_136,0.5,-71,65,136,11
82,seq77,seq134,r_130_15_149,r_130_15_149,1.0,10,159,149,11
58,seq142,seq119,r_102_136_80,r_102_136_80,1.0,34,114,80,11
32,r_27_139_144,seq48,seq134,r_27_139_144,0.46,0,144,144,11
38,r_36_146_130,r_122_83_184,seq90,r_36_146_130,0.99,1,131,130,11
34,r_3_144_104,seq24,r_124_42_27,r_3_144_104,0.91,0,104,104,11
16,r_49_57_34,r_126_109_70,seq17,r_126_109_70,1.0,0,70,70,11
25,r_61_128_136,r_49_57_34,seq85,r_61_128_136,1.0,0,136,136,11
9,r_80_22_168,seq94,seq17,r_80_22_168,0.67,0,168,168,11
6,r_124_42_27,seq9,r_135_64_159,r_124_42_27,1.0,0,27,27,11
22,r_66_78_71,r_39_67_179,seq16,r_66_78_71,1.0,1,72,71,11
49,r_117_140_59,seq35,seq94,r_117_140_59,1.0,0,59,59,11
7,r_52_89_98,seq29,seq43,r_52_89_98,1.0,0,98,98,11
39,r_147_54_48,r_125_115_49,seq28,r_147_54_48,1.0,0,48,48,11
44,r_122_83_184,r_91_101_186,r_124_42_27,r_124_42_27,0.52,157,184,27,11
23,r_98_82_82,seq44,seq116,r_98_82_82,1.0,1,83,82,11
82,seq77,r_7_40_114,seq134,r_7_40_114,1.0,-34,80,114,11
12,r_91_101_186,r_122_83_184,r_87_137_113,r_87_137_113,1.0,71,184,113,11
21,r_14_79_42,r_23_37_63,r_7_40_114,r_14_79_42,0.97,2,44,42,11
17,r_133_58_36,r_84_11_1,seq9,r_133_58_36,1.0,0,36,36,11
36,r_8_131_153,r_109_115_62,seq117,r_109_115_62,1.0,0,62,62,12
92,seq105,r_54_40_121,r_15_56_13,r_54_40_121,0.62,0,121,121,12
14,r_61_70_187,r_0_51_185,r_133_78_114,r_133_78_114,0.98,71,185,114,12
8,r_133_78_114,r_99_118_80,seq62,r_133_78_114,1.0,1,115,114,12
43,r_109_115_62,r_8_131_153,seq102,r_109_115_62,0.98,0,62,62,12
19,r_20_87_98,seq117,r_25_19_152,r_25_19_152,0.98,8,160,152,12
21,r_55_57_174,seq142,seq64,r_55_57_174,0.72,0,174,174,12
1,r_125_30_165,seq16,seq90,r_125_30_165,0.9,0,165,165,12
97,seq117,r_8_131_153,r_20_87_98,r_20_87_98,0.98,3,101,98,12
5,r_79_22_97,r_39_132_186,seq7,r_79_22_97,1.0,0,97,97,12
45,r_0_51_185,r_61_70_187,r_37_28_64,r_37_28_64,1.0,121,185,64,12
19,r_20_87_98,seq64,seq117,r_20_87_98,0.97,0,98,98,12
31,r_82_135_104,r_13_83_169,seq142,r_82_135_104,0.9,1,105,104,12
3,r_6_21_4,r_139_80_156,r_79_22_97,r_79_22_97,0.99,59,156,97,12
42,r_107_136_52,seq102,seq149,r_107_136_52,1.0,2,54,52,12
35,r_67_18_55,r_112_140_191,seq103,r_67_18_55,1.0,0,55,55,12
26,r_129_143_67,seq117,seq149,r_129_143_67,1.0,0,67,67,12
0,r_35_95_135,seq46,seq145,r_35_95_135,0.72,0,135,135,12
39,r_44_98_45,seq90,r_148_100_86,r_44_98_45,1.0,0,45,45,12
44,r_15_56_13,r_55_57_174,seq105,r_15_56_13,1.0,-1,12,13,12
6,r_112_140_191,r_68_86_161,r_35_95_135,r_112_140_191,0.54,-30,161,191,12
75,seq62,r_37_28_64,r_35_95_135,r_37_28_64,0.99,-8,56,64,12
48,r_111_126_37,seq7,seq65,r_111_126_37,1.0,0,37,37,12
23,r_66_75_35,r_11_134_142,seq122,r_66_75_35,1.0,0,35,35,12
27,r_68_86_161,r_112_140_191,r_82_135_104,r_68_86_161,0.47,0,161,161,12
87,seq90,r_61_70_187,r_125_30_165,r_125_30_165,0.96,6,171,165,12
2,r_39_132_186,seq94,r_13_83_169,r_13_83_169,0.74,17,186,169,12
47,r_3_121_118,r_31_141_122,seq46,r_3_121_118,0.84,1,119,118,12
40,r_31_141_122,seq74,seq29,r_31_141_122,0.94,1,123,122,12
74,seq138,r_42_124_179,r_24_1_14,r_42_124_179,0.64,8,187,179,12
18,r_146_106_63,r_139_80_156,seq74,r_146_106_63,1.0,1,64,63,12
29,r_13_83_169,r_82_135_104,r_37_28_64,r_37_28_64,0.73,14,78,64,12
24,r_139_80_156,r_6_21_4,r_11_134_142,r_139_80_156,0.82,0,156,156,12
33,r_91_96_113,seq108,seq85,r_91_96_113,0.95,0,113,113,12
49,r_11_134_142,r_43_81_141,r_139_80_156,r_11_134_142,0.66,17,159,142,12
88,seq94,r_39_132_186,r_146_106_63,r_146_106_63,1.0,123,186,63,12
58,seq16,r_125_30_165,r_14_128_54,r_14_128_54,0.88,109,163,54,12
25,r_32_9_58,seq16,seq74,r_32_9_58,1.0,0,58,58,12
61,seq149,seq84,r_82_135_104,r_82_135_104,1.0,44,148,104,12
32,r_92_52_110,seq5,seq108,r_92_52_110,0.93,0,110,110,12
38,r_45_12_68,seq138,seq142,r_45_12_68,1.0,0,68,68,12
77,seq64,r_20_87_98,r_42_124_179,r_20_87_98,0.54,5,103,98,12
34,r_120_127_125,seq137,r_109_115_62,r_120_127_125,0.98,0,125,125,12
17,r_47_113_183,seq64,r_68_86_161,r_68_86_161,0.75,23,184,161,12
9,r_148_100_86,r_112_140_191,r_44_98_45,r_44_98_45,1.0,42,87,45,12
37,r_24_1_14,seq105,seq119,r_24_1_14,0.98,-2,12,14,12
29,r_13_83_169,r_37_28_64,seq85,r_13_83_169,0.83,0,169,169,12
22,r_37_28_64,seq62,r_66_75_35,r_37_28_64,1.0,1,65,64,12
49,r_11_134_142,seq5,r_43_81_141,r_11_134_142,0.38,0,142,142,12
30,r_14_128_54,seq17,r_111_126_37,r_14_128_54,1.0,0,54,54,12
7,r_54_40_121,seq105,seq41,r_54_40_121,0.96,0,121,121,12
20,r_49_123_48,r_20_87_98,seq46,r_49_123_48,0.98,3,51,48,12
78,seq65,seq16,r_111_126_37,r_111_126_37,1.0,4,41,37,12
16,r_32_138_15,r_78_89_91,r_94_97_133,r_32_138_15,0.98,0,15,15,13
36,r_146_134_128,seq70,r_90_0_66,r_90_0_66,0.94,4,70,66,13
92,seq110,r_99_35_110,seq98,r_99_35_110,1.0,0,110,110,13
14,r_128_20_3,r_115_43_169,r_148_49_87,r_148_49_87,0.45,82,169,87,13
53,seq10,r_115_43_169,seq87,r_115_43_169,0.93,0,169,169,13
0,r_105_54_164,r_93_75_17,seq133,r_105_54_164,0.96,1,165,164,13
83,seq86,r_100_107_79,r_114_58_30,r_100_107_79,1.0,-11,68,79,13
36,r_146_134_128,r_90_0_66,seq55,r_146_134_128,0.67,1,129,128,13
55,seq140,r_52_122_126,r_128_20_3,r_52_122_126,0.71,0,126,126,13
21,r_3_125_100,seq101,seq28,r_3_125_100,1.0,0,100,100,13
1,r_21_56_149,r_93_75_17,r_59_135_106,r_21_56_149,0.92,0,149,149,13
5,r_120_117_129,r_21_56_149,seq66,r_120_117_129,0.69,0,129,129,13
46,r_115_43_169,r_128_20_3,r_25_106_142,r_128_20_3,0.74,166,169,3,13
42,r_52_122_126,seq140,r_11_9_140,r_52_122_126,0.98,0,126,126,13
45,r_136_12_141,seq77,r_120_117_129,r_120_117_129,0.8,14,143,129,13
8,r_53_102_56,r_11_9_140,seq103,r_53_102_56,0.99,3,59,56,13
20,r_33_51_21,r_1_65_189,seq5,r_33_51_21,1.0,0,21,21,13
38,r_60_67_177,r_142_76_4,r_94_97_133,r_94_97_133,0.85,49,182,133,13
39,r_93_75_17,r_21_56_149,r_25_106_142,r_93_75_17,1.0,132,149,17,13
31,r_62_29_115,r_11_9_140,seq149,r_62_29_115,1.0,2,117,115,13
3,r_59_135_106,seq149,seq14,r_59_135_106,0.99,1,107,106,13
8,r_53_102_56,seq103,r_111_109_92,r_111_109_92,0.98,24,116,92,13
16,r_32_138_15,r_94_97_133,r_145_19_88,r_32_138_15,0.96,119,134,15,13
0,r_105_54_164,r_21_56_149,r_93_75_17,r_105_54_164,0.79,-15,149,164,13
73,seq55,seq149,r_146_134_128,r_146_134_128,0.63,9,137,128,13
11,r_78_89_91,seq46,r_114_58_30,r_78_89_91,0.92,3,94,91,13
13,r_100_107_79,seq86,seq50,r_100_107_79,0.98,-1,78,79,13
98,seq124,r_38_68_116,seq24,r_38_68_116,0.97,0,116,116,13
4,r_94_97_133,r_32_138_15,r_78_89_91,r_94_97_133,1.0,0,133,133,13
41,r_57_79_19,r_23_2_156,seq133,r_57_79_19,0.98,1,20,19,13
6,r_145_19_88,r_11_9_140,seq96,r_145_19_88,1.0,0,88,88,13
27,r_88_41_120,seq66,r_11_9_140,r_88_41_120,0.99,2,122,120,13
32,r_64_72_23,r_115_43_169,seq104,r_64_72_23,0.99,-1,22,23,13
2,r_40_147_171,seq63,seq69,r_40_147_171,0.5,0,171,171,13
47,r_47_36_81,seq73,seq39,r_47_36_81,1.0,0,81,81,13
40,r_38_68_116,seq124,r_100_107_79,r_38_68_116,0.72,0,116,116,13
4,r_94_97_133,seq96,r_32_138_15,r_32_138_15,1.0,3,18,15,13
18,r_90_0_66,seq7,r_146_134_128,r_90_0_66,0.99,0,66,66,13
29,r_80_22_122,seq73,seq70,r_80_22_122,0.88,0,122,122,13
43,r_131_91_32,r_148_49_87,r_128_20_3,r_128_20_3,1.0,15,18,3,13
25,r_45_42_73,r_121_17_101,seq73,r_45_42_73,0.98,0,73,73,13
33,r_25_106_142,r_1_65_189,r_93_75_17,r_25_106_142,0.9,0,142,142,13
65,seq28,seq24,r_3_125_100,r_3_125_100,1.0,24,124,100,13
38,r_60_67_177,r_45_42_73,r_142_76_4,r_45_42_73,1.0,0,73,73,13
1,r_21_56_149,r_105_54_164,r_93_75_17,r_93_75_17,0.99,21,38,17,13
9,r_121_17_101,r_60_67_177,seq5,r_121_17_101,0.99,0,101,101,13
22,r_148_49_87,r_40_147_171,r_128_20_3,r_148_49_87,0.73,1,88,87,13
28,r_31_4_71,seq139,seq16,r_31_4_71,1.0,0,71,71,13
49,r_84_108_89,seq73,seq95,r_84_108_89,0.74,0,89,89,13
7,r_74_34_134,r_30_141_191,seq124,r_74_34_134,0.93,0,134,134,13
18,r_90_0_66,r_146_134_128,r_31_4_71,r_146_134_128,0.6,12,140,128,13
44,r_111_109_92,r_11_9_140,r_53_102_56,r_11_9_140,1.0,-48,92,140,13
84,seq87,r_132_61_170,seq10,r_132_61_170,1.0,0,170,170,13
30,r_127_19_95,r_141_29_19,r_23_125_81,r_127_19_95,1.0,0,95,95,14
51,seq3,r_55_73_133,r_31_84_70,r_31_84_70,0.94,63,133,70,14
33,r_32_103_44,seq77,seq51,r_32_103_44,0.97,7,51,44,14
14,r_107_148_143,r_47_146_184,r_28_114_4,r_47_146_184,0.55,-41,143,184,14
43,r_64_99_77,seq49,seq117,r_64_99_77,1.0,0,77,77,14
21,r_55_73_133,seq3,r_133_129_194,r_55_73_133,0.98,0,133,133,14
39,r_27_26_113,r_7_30_123,r_143_72_55,r_27_26_113,1.0,0,113,113,14
1,r_16_18_126,seq94,seq130,r_16_18_126,0.92,0,126,126,14
5,r_93_142_174,r_2_120_151,r_58_71_65,r_2_120_151,0.59,25,176,151,14
46,r_14_1_101,seq24,seq83,r_14_1_101,0.84,2,103,101,14
42,r_34_105_15,seq135,r_143_72_55,r_143_72_55,0.98,13,68,55,14
37,r_8_40_21,r_15_57_109,seq118,r_8_40_21,0.99,0,21,21,14
11,r_47_146_184,r_5_149_27,r_31_84_70,r_47_146_184,0.55,0,184,184,14
23,r_61_43_51,seq126,seq94,r_61_43_51,0.93,0,51,51,14
47,r_38_95_23,r_143_72_55,r_61_43_51,r_38_95_23,0.91,29,52,23,14
31,r_35_100_180,seq131,r_28_114_4,r_35_100_180,0.69,0,180,180,14
16,r_67_22_28,r_98_66_117,seq131,r_67_22_28,1.0,1,29,28,14
41,r_10_56_157,r_124_106_140,r_128_144_11,r_124_106_140,0.83,7,147,140,14
38,r_33_115_45,r_10_56_157,seq85,r_33_115_45,1.0,0,45,45,14
50,seq130,seq45,r_132_54_8,r_132_54_8,0.8,21,29,8,14
26,r_75_68_147,seq117,r_61_43_51,r_75_68_147,0.39,0,147,147,14
72,seq51,seq42,r_32_103_44,r_32_103_44,0.93,117,161,44,14
29,r_4_88_108,seq118,r_8_40_21,r_8_40_21,1.0,32,53,21,14
0,r_58_71_65,r_7_30_123,seq11,r_58_71_65,0.46,2,67,65,14
29,r_4_88_108,r_8_40_21,r_50_12_127,r_4_88_108,0.98,0,108,108,14
11,r_47_146_184,r_107_148_143,r_5_149_27,r_5_149_27,1.0,82,109,27,14
13,r_23_125_81,seq85,r_81_97_148,r_23_125_81,0.68,-17,64,81,14
15,r_31_84_70,seq42,seq69,r_31_84_70,1.0,0,70,70,14
48,r_76_113_116,seq137,r_15_57_109,r_15_57_109,0.95,9,118,109,14
9,r_15_57_109,r_16_18_126,r_23_125_81,r_15_57_109,1.0,0,109,109,14
12,r_81_97_148,r_23_125_81,r_16_18_126,r_81_97_148,0.96,0,148,148,14
71,seq49,r_143_72_55,r_145_104_83,r_145_104_83,1.0,0,83,83,14
32,r_119_74_48,r_7_30_123,seq118,r_119_74_48,0.81,3,51,48,14
36,r_5_149_27,r_107_148_143,r_38_95_23,r_107_148_143,0.89,0,143,143,14
36,r_5_149_27,r_93_142_174,r_107_148_143,r_5_149_27,1.0,0,27,27,14
2,r_60_109_175,seq69,r_61_43_51,r_61_43_51,0.86,124,175,51,14
18,r_145_104_83,r_81_97_148,seq49,r_145_104_83,1.0,0,83,83,14
24,r_52_17_154,r_141_29_19,r_15_57_109,r_141_29_19,0.93,137,156,19,14
34,r_143_72_55,r_133_129_194,seq49,r_143_72_55,0.89,3,58,55,14
34,r_143_72_55,seq49,r_27_26_113,r_27_26_113,1.0,5,118,113,14
25,r_124_106_140,r_10_56_157,r_27_26_113,r_27_26_113,0.83,27,140,113,14
86,seq85,r_23_125_81,r_33_115_45,r_33_115_45,1.0,0,45,45,14
13,r_23_125_81,r_81_97_148,r_15_57_109,r_23_125_81,1.0,38,119,81,14
81,seq78,r_50_12_127,r_76_113_116,r_76_113_116,0.52,4,120,116,14
17,r_70_147_96,r_52_17_154,seq135,r_52_17_154,0.7,-56,98,154,14
9,r_15_57_109,r_101_86_50,r_16_18_126,r_15_57_109,0.59,-42,67,109,14
96,seq117,r_75_68_147,r_64_99_77,r_64_99_77,1.0,70,147,77,14
22,r_123_6_63,r_127_19_95,seq96,r_123_6_63,0.93,0,63,63,14
91,seq96,r_2_120_151,r_123_6_63,r_123_6_63,1.0,10,73,63,14
49,r_121_36_132,seq112,seq37,r_121_36_132,0.98,0,132,132,14
56,seq138,r_25_111_145,r_15_57_109,r_15_57_109,0.9,36,145,109,14
7,r_98_66_117,seq92,seq45,r_98_66_117,0.57,0,117,117,14
44,r_101_86_50,r_15_57_109,seq134,r_15_57_109,0.94,-42,67,109,14
79,seq69,r_60_109_175,r_31_84_70,r_31_84_70,1.0,45,115,70,14
12,r_81_97_148,r_145_104_83,r_23_125_81,r_145_104_83,0.84,0,83,83,14
30,r_27_52_5,r_70_85_129,r_75_87_59,r_75_87_59,1.0,71,130,59,15
12,r_32_139_47,seq2,seq20,r_32_139_47,1.0,0,47,47,15
92,seq101,seq25,r_21_43_35,r_21_43_35,1.0,65,100,35,15
14,r_53_45_75,seq44,seq5,r_53_45_75,0.93,0,75,75,15
8,r_70_85_129,r_27_52_5,r_93_69_61,r_93_69_61,0.97,69,130,61,15
37,r_78_109_2,r_36_35_164,r_38_34_92,r_78_109_2,0.65,162,164,2,15
59,seq15,seq112,r_106_132_149,r_106_132_149,0.58,3,152,149,15
86,seq142,seq6,r_39_16_87,r_39_16_87,1.0,6,93,87,15
16,r_51_105_3,r_140_8_141,r_32_139_47,r_51_105_3,0.95,139,142,3,15
39,r_36_35_164,r_78_109_2,r_125_120_64,r_125_120_64,1.0,100,164,64,15
1,r_141_143_70,seq137,r_93_69_61,r_141_143_70,1.0,2,72,70,15
5,r_97_62_91,seq89,r_7_4_9,r_97_62_91,1.0,0,91,91,15
46,r_121_82_14,r_39_16_87,r_91_138_69,r_121_82_14,1.0,68,82,14,15
42,r_48_67_80,seq117,seq131,r_48_67_80,1.0,0,80,80,15
21,r_92_57_31,r_134_114_54,seq25,r_92_57_31,0.86,0,31,31,15
45,r_123_148_100,r_111_72_166,seq22,r_123_148_100,0.88,0,100,100,15
33,r_140_8_141,r_51_105_3,r_144_88_73,r_140_8_141,0.65,0,141,141,15
31,r_38_34_92,seq131,r_78_109_2,r_38_34_92,0.77,1,93,92,15
10,r_7_4_9,seq100,r_97_62_91,r_97_62_91,1.0,3,94,91,15
43,r_41_13_24,r_91_138_69,seq65,r_41_13_24,0.49,0,24,24,15
4,r_144_88_73,r_12_31_178,seq64,r_144_88_73,1.0,2,75,73,15
0,r_94_103_120,seq128,r_28_30_13,r_94_103_120,0.97,3,123,120,15
3,r_28_30_13,r_48_67_80,seq3,r_28_30_13,0.9,0,13,13,15
20,r_75_87_59,r_140_8_141,r_27_52_5,r_75_87_59,1.0,1,60,59,15
13,r_127_0_124,seq60,seq37,r_127_0_124,0.83,1,125,124,15
98,seq118,seq145,r_125_120_64,r_125_120_64,1.0,16,80,64,15
48,r_106_132_149,r_66_58_171,seq15,r_106_132_149,0.45,1,150,149,15
15,r_83_63_37,seq112,seq122,r_83_63_37,0.96,0,37,37,15
27,r_93_69_61,seq10,seq26,r_93_69_61,1.0,3,64,61,15
47,r_95_124_96,r_21_43_35,seq15,r_21_43_35,1.0,1,36,35,15
87,seq89,r_97_62_91,seq37,r_97_62_91,0.63,2,93,91,15
2,r_46_130_133,seq50,r_94_103_120,r_94_103_120,0.53,13,133,120,15
38,r_61_136_50,seq5,r_7_4_9,r_61_136_50,1.0,0,50,50,15
40,r_111_72_166,seq64,seq2,r_111_72_166,0.53,0,166,166,15
18,r_91_138_69,seq5,r_121_82_14,r_91_138_69,1.0,1,70,69,15
24,r_68_1_154,seq37,seq65,r_68_1_154,0.53,0,154,154,15
99,seq122,seq146,r_83_63_37,r_83_63_37,0.82,21,58,37,15
25,r_79_86_83,seq10,r_71_80_162,r_79_86_83,1.0,0,83,83,15
64,seq22,r_70_85_129,r_123_148_100,r_123_148_100,0.9,1,101,100,15
41,r_19_18_41,r_123_148_100,seq56,r_19_18_41,1.0,0,41,41,15
47,r_95_124_96,seq15,r_32_139_47,r_95_124_96,0.97,1,97,96,15
50,seq128,r_94_103_120,seq14,r_94_103_120,1.0,3,123,120,15
68,seq26,r_12_31_178,r_93_69_61,r_93_69_61,0.89,9,70,61,15
67,seq25,seq101,r_92_57_31,r_92_57_31,1.0,7,38,31,15
32,r_66_58_171,seq102,seq145,r_66_58_171,0.45,-4,167,171,15
34,r_116_49_107,seq9,r_125_120_64,r_125_120_64,1.0,52,116,64,15
17,r_129_84_144,seq5,seq128,r_129_84_144,0.98,0,144,144,15
25,r_79_86_83,r_71_80_162,r_91_138_69,r_79_86_83,0.63,79,162,83,15
33,r_140_8_141,r_104_59_123,r_51_105_3,r_140_8_141,0.69,-118,23,141,15
28,r_125_120_64,r_12_31_178,seq118,r_125_120_64,0.97,0,64,64,15
49,r_135_17_78,r_94_103_120,seq65,r_94_103_120,1.0,-34,86,120,15
56,seq10,r_93_69_61,seq24,r_93_69_61,1.0,3,64,61,15
7,r_126_54_169,r_12_31_178,r_144_88_73,r_144_88_73,1.0,96,169,73,15
44,r_71_80_162,r_94_103_120,r_79_86_83,r_71_80_162,0.92,-79,83,162,15
23,r_47_55_138,seq131,r_125_120_64,r_125_120_64,0.61,75,139,64,15
26,r_21_43_35,r_95_124_96,seq101,r_21_43_35,0.99,1,36,35,15
19,r_134_114_54,r_66_58_171,r_32_139_47,r_32_139_47,0.66,11,58,47,15
35,r_39_16_87,seq81,seq142,r_39_16_87,1.0,1,88,87,15
29,r_108_107_8,r_70_85_129,seq64,r_108_107_8,0.53,3,11,8,15
40,r_61_149_138,r_100_119_105,seq126,r_61_149_138,0.49,32,170,138,16
29,r_49_90_46,r_104_97_54,seq81,r_49_90_46,0.97,0,46,46,16
8,r_72_62_170,seq52,r_136_103_142,r_136_103_142,0.98,31,173,142,16
43,r_127_25_129,seq10,seq129,r_127_25_129,0.52,1,130,129,16
0,r_48_86_197,r_91_93_38,r_113_71_27,r_48_86_197,1.0,-170,27,197,16
37,r_20_57_32,seq115,seq5,r_20_57_32,0.45,54,86,32,16
45,r_0_29_21,r_104_97_54,r_13_146_28,r_104_97_54,0.73,0,54,54,16
55,seq7,r_102_42_89,seq132,r_102_42_89,0.98,-7,82,89,16
71,seq52,r_72_62_170,r_99_56_23,r_72_62_170,0.34,4,174,170,16
16,r_3_21_185,r_9_39_97,r_108_51_74,r_3_21_185,0.95,-88,97,185,16
39,r_8_66_100,r_61_149_138,r_13_146_28,r_8_66_100,0.64,0,100,100,16
46,r_76_134_183,seq60,r_99_56_23,r_99_56_23,0.59,160,183,23,16
42,r_43_116_137,r_144_11_4,r_135_143_180,r_43_116_137,0.92,1,138,137,16
49,r_120_59_48,r_104_97_54,seq79,r_120_59_48,1.0,0,48,48,16
20,r_34_19_26,seq81,r_98_58_69,r_98_58_69,0.76,11,80,69,16
31,r_104_97_54,r_49_90_46,r_13_146_28,r_13_146_28,0.52,14,42,28,16
19,r_9_39_97,r_3_21_185,seq117,r_9_39_97,1.0,0,97,97,16
11,r_54_128_13,r_138_145_177,seq4,r_54_128_13,0.98,0,13,13,16
41,r_87_17_190,r_139_22_151,r_127_25_129,r_87_17_190,0.57,-55,135,190,16
45,r_0_29_21,r_72_62_170,r_104_97_54,r_0_29_21,0.98,0,21,21,16
14,r_13_146_28,r_104_97_54,r_1_140_42,r_13_146_28,0.51,26,54,28,16
3,r_133_24_178,seq63,r_43_116_137,r_133_24_178,0.68,1,179,178,16
72,seq60,r_136_103_142,r_108_51_74,r_108_51_74,0.82,68,142,74,16
16,r_3_21_185,r_108_51_74,r_41_53_108,r_3_21_185,0.63,0,185,185,16
4,r_100_119_105,r_112_70_176,seq131,r_100_119_105,1.0,0,105,105,16
13,r_65_73_103,seq7,r_91_93_38,r_65_73_103,1.0,1,104,103,16
6,r_135_143_180,r_48_86_197,r_43_116_137,r_43_116_137,0.93,0,137,137,16
21,r_91_93_38,seq30,r_65_73_103,r_65_73_103,1.0,5,108,103,16
1,r_32_45_45,seq14,seq44,r_32_45_45,0.95,0,45,45,16
99,seq126,r_2_26_139,r_61_149_138,r_61_149_138,0.64,6,144,138,16
27,r_102_42_89,seq7,r_144_11_4,r_102_42_89,0.98,1,90,89,16
36,r_122_142_44,r_78_28_122,seq118,r_78_28_122,1.0,-77,45,122,16
2,r_121_82_140,seq10,r_2_26_139,r_121_82_140,1.0,0,140,140,16
47,r_23_111_82,seq40,seq95,r_23_111_82,1.0,0,82,82,16
15,r_125_35_40,r_133_24_178,r_99_56_23,r_125_35_40,1.0,-1,39,40,16
40,r_61_149_138,seq95,r_100_119_105,r_61_149_138,0.54,0,138,138,16
18,r_112_70_176,r_100_119_105,r_48_86_197,r_100_119_105,0.74,0,105,105,16
24,r_138_145_177,seq131,r_23_111_82,r_23_111_82,1.0,96,178,82,16
25,r_2_26_139,seq126,seq30,r_2_26_139,0.9,2,141,139,16
33,r_98_58_69,r_136_103_142,r_34_19_26,r_136_103_142,0.7,-73,69,142,16
6,r_135_143_180,r_43_116_137,r_139_22_151,r_135_143_180,1.0,0,180,180,16
64,seq30,r_34_19_26,seq89,r_34_19_26,0.82,1,27,26,16
32,r_113_71_27,r_49_90_46,r_48_86_197,r_113_71_27,1.0,-2,25,27,16
41,r_87_17_190,r_127_25_129,r_23_111_82,r_87_17_190,0.94,0,190,190,16
38,r_18_50_96,r_78_28_122,seq69,r_18_50_96,0.82,0,96,96,16
52,seq131,r_138_145_177,r_100_119_105,r_100_119_105,0.84,27,132,105,16
77,seq69,seq52,r_18_50_96,r_18_50_96,1.0,21,117,96,16
20,r_34_19_26,seq30,seq81,r_34_19_26,0.96,1,27,26,16
34,r_137_27_189,seq4,r_41_53_108,r_41_53_108,0.93,82,190,108,16
64,seq30,seq89,r_2_26_139,r_2_26_139,0.78,0,139,139,16
31,r_104_97_54,r_13_146_28,r_91_93_38,r_104_97_54,0.88,0,54,54,16
21,r_91_93_38,seq44,seq30,r_91_93_38,1.0,0,38,38,16
14,r_13_146_28,r_121_82_140,r_104_97_54,r_13_146_28,0.97,0,28,28,16
17,r_139_22_151,r_87_17_190,r_108_51_74,r_139_22_151,0.93,0,151,151,16
94,seq114,r_1_140_42,r_13_146_28,r_13_146_28,0.96,34,62,28,16
9,r_109_47_187,seq85,r_41_53_108,r_41_53_108,1.0,79,187,108,16
22,r_123_37_167,seq10,r_139_22_151,r_123_37_167,0.62,0,167,167,16
28,r_78_28_122,seq10,r_144_11_4,r_78_28_122,1.0,0,122,122,16
44,r_1_140_42,seq114,r_13_146_28,r_13_146_28,0.98,16,44,28,16
42,r_43_116_137,r_135_143_180,r_133_24_178,r_43_116_137,1.0,43,180,137,16
18,r_112_70_176,r_48_86_197,r_100_119_105,r_112_70_176,0.91,0,176,176,16
23,r_55_96_118,r_76_134_183,r_100_119_105,r_100_119_105,0.88,17,122,105,16
12,r_33_84_84,seq52,r_120_59_48,r_33_84_84,1.0,0,84,84,16
30,r_112_41_175,seq66,r_1_92_89,r_1_92_89,0.99,87,176,89,17
36,r_47_55_106,seq51,r_81_141_102,r_47_55_106,1.0,0,106,106,17
92,seq100,r_43_25_159,r_90_49_99,r_90_49_99,0.9,60,159,99,17
14,r_104_60_98,seq124,seq131,r_104_60_98,0.98,1,99,98,17
43,r_43_25_159,seq100,r_29_101_67,r_43_25_159,0.73,0,159,159,17
54,seq136,r_127_27_158,r_33_122_82,r_33_122_82,1.0,76,158,82,17
37,r_10_0_70,seq94,seq88,r_10_0_70,0.65,8,78,70,17
45,r_90_49_99,r_29_101_67,seq100,r_90_49_99,0.96,0,99,99,17
86,seq88,r_24_67_126,r_10_0_70,r_24_67_126,0.98,0,126,126,17
24,r_36_116_16,r_69_48_103,r_19_9_100,r_36_116_16,0.88,0,16,16,17
16,r_126_80_28,seq22,seq59,r_126_80_28,0.99,-2,26,28,17
97,seq123,r_147_74_127,seq28,r_147_74_127,1.0,0,127,127,17
46,r_113_64_132,seq40,r_105_144_199,r_113_64_132,1.0,0,132,132,17
42,r_17_135_108,r_107_73_109,seq6,r_107_73_109,0.96,0,109,109,17
80,seq68,r_45_35_192,r_4_42_105,r_4_42_105,1.0,3,108,105,17
69,seq40,r_113_64_132,seq65,r_113_64_132,1.0,0,132,132,17
45,r_90_49_99,r_33_122_82,r_29_101_67,r_90_49_99,0.82,-15,84,99,17
24,r_36_116_16,r_19_9_100,r_86_32_37,r_36_116_16,0.55,85,101,16,17
19,r_134_34_179,seq94,r_127_27_158,r_134_34_179,0.55,3,182,179,17
66,seq31,r_84_91_66,seq38,r_84_91_66,1.0,0,66,66,17
76,seq62,seq119,r_33_122_82,r_33_122_82,1.0,39,121,82,17
44,r_4_42_105,r_15_111_23,seq5,r_4_42_105,0.96,1,106,105,17
31,r_24_67_126,seq88,seq96,r_24_67_126,0.89,0,126,126,17
89,seq95,r_108_102_183,r_86_32_37,r_86_32_37,1.0,147,184,37,17
3,r_29_101_67,r_4_42_105,seq13,r_29_101_67,0.89,8,75,67,17
10,r_8_54_131,r_146_87_180,r_114_145_36,r_146_87_180,0.98,-49,131,180,17
90,seq96,r_17_135_108,r_24_67_126,r_24_67_126,0.9,12,138,126,17
26,r_121_129_20,seq72,r_18_93_113,r_18_93_113,0.76,14,127,113,17
0,r_97_44_95,seq59,seq68,r_97_44_95,1.0,0,95,95,17
39,r_20_83_44,seq124,seq72,r_20_83_44,0.89,1,45,44,17
11,r_99_103_12,r_79_70_85,r_143_37_47,r_143_37_47,0.83,32,79,47,17
20,r_140_2_186,r_81_141_102,r_105_144_199,r_81_141_102,0.74,0,102,102,17
66,seq31,seq38,r_146_87_180,r_146_87_180,0.6,-60,120,180,17
15,r_1_92_89,r_77_56_189,seq6,r_1_92_89,1.0,1,90,89,17
48,r_84_91_66,seq31,r_46_7_25,r_84_91_66,1.0,0,66,66,17
13,r_86_32_37,r_148_115_152,seq95,r_86_32_37,0.98,0,37,37,17
6,r_69_48_103,r_21_117_191,seq51,r_69_48_103,0.99,0,103,103,17
27,r_132_39_62,r_10_0_70,seq149,r_132_39_62,1.0,0,62,62,17
51,seq131,seq65,r_148_115_152,r_148_115_152,0.88,4,156,152,17
47,r_18_93_113,r_127_27_158,r_121_129_20,r_18_93_113,0.75,1,114,113,17
4,r_143_37_47,seq22,r_99_103_12,r_143_37_47,1.0,0,47,47,17
40,r_77_56_189,r_1_92_89,seq22,r_1_92_89,1.0,1,90,89,17
63,seq26,seq82,r_46_7_25,r_46_7_25,1.0,1,26,25,17
25,r_105_144_199,r_140_2_186,r_113_64_132,r_113_64_132,1.0,24,156,132,17
88,seq94,r_10_0_70,r_76_120_56,r_76_120_56,0.77,26,82,56,17
50,seq130,r_24_67_126,r_10_0_70,r_24_67_126,1.0,1,127,126,17
32,r_76_120_56,r_43_25_159,seq94,r_43_25_159,0.54,-96,63,159,17
38,r_81_141_102,r_140_2_186,seq119,r_81_141_102,0.67,0,102,102,17
2,r_46_7_25,r_11_23_19,seq26,r_46_7_25,0.97,0,25,25,17
81,seq72,r_121_129_20,r_3_137_83,r_3_137_83,0.88,8,91,83,17
5,r_61_53_41,seq149,seq95,r_61_53_41,1.0,0,41,41,17
9,r_107_73_109,r_17_135_108,r_99_103_12,r_107_73_109,0.99,0,109,109,17
28,r_15_111_23,r_8_54_131,r_4_42_105,r_15_111_23,1.0,0,23,23,17
17,r_19_9_100,r_108_102_183,r_36_116_16,r_36_116_16,0.99,0,16,16,17
28,r_15_111_23,r_4_42_105,r_109_71_79,r_15_111_23,0.56,83,106,23,17
22,r_3_137_83,r_10_0_70,r_20_83_44,r_3_137_83,0.81,0,83,83,17
34,r_114_145_36,seq125,seq139,r_114_145_36,1.0,1,37,36,17
49,r_79_70_85,r_99_103_12,seq65,r_99_103_12,0.49,74,86,12,17
7,r_108_102_183,seq95,r_69_48_103,r_69_48_103,0.68,82,185,103,17
44,r_4_42_105,r_29_101_67,r_15_111_23,r_4_42_105,0.75,-30,75,105,17
23,r_128_142_149,seq30,seq38,r_128_142_149,0.69,0,149,149,17
17,r_19_9_100,r_36_116_16,seq138,r_19_9_100,1.0,0,100,100,17
79,seq66,r_112_41_175,seq12,r_112_41_175,0.51,1,176,175,17
35,r_127_27_158,seq136,seq28,r_127_27_158,0.55,0,158,158,17
12,r_109_71_79,r_127_27_158,r_15_111_23,r_109_71_79,1.0,0,79,79,17
14,r_104_60_98,seq131,r_99_103_12,r_104_60_98,0.53,55,153,98,17
36,r_121_3_75,seq109,r_36_94_34,r_36_94_34,0.92,41,75,34,18
43,r_149_106_175,r_35_28_148,r_2_9_44,r_149_106_175,0.63,1,176,175,18
14,r_2_9_44,r_96_99_47,r_74_137_12,r_2_9_44,0.99,1,45,44,18
55,seq12,r_129_126_186,seq59,r_129_126_186,0.61,-73,113,186,18
16,r_46_25_127,r_125_21_185,seq31,r_125_21_185,0.74,-53,132,185,18
97,seq112,r_125_21_185,r_86_72_150,r_86_72_150,0.88,17,167,150,18
5,r_125_21_185,seq112,r_96_99_47,r_96_99_47,0.74,138,185,47,18
46,r_141_120_187,seq78,r_39_95_131,r_39_95_131,0.55,56,187,131,18
42,r_123_73_73,r_89_62_158,r_50_15_52,r_123_73_73,0.81,1,74,73,18
80,seq64,seq135,r_115_7_66,r_115_7_66,1.0,7,73,66,18
12,r_36_94_34,r_86_72_150,seq85,r_36_94_34,1.0,0,34,34,18
7,r_0_75_157,r_96_99_47,seq109,r_0_75_157,0.46,2,159,157,18
8,r_50_15_52,r_129_126_186,seq84,r_50_15_52,1.0,2,54,52,18
45,r_93_41_164,seq34,r_69_58_29,r_69_58_29,0.95,135,164,29,18
19,r_29_6_163,seq71,r_45_90_125,r_45_90_125,0.5,39,164,125,18
41,r_74_137_12,r_61_4_168,seq8,r_74_137_12,0.96,0,12,12,18
66,seq31,seq54,r_103_132_82,r_103_132_82,1.0,62,144,82,18
76,seq55,r_61_4_168,r_131_52_149,r_131_52_149,0.72,20,169,149,18
89,seq91,r_136_43_166,r_111_138_57,r_111_138_57,0.99,21,78,57,18
90,seq97,seq40,r_130_87_27,r_130_87_27,1.0,8,35,27,18
3,r_79_51_115,seq102,seq22,r_79_51_115,0.95,2,117,115,18
10,r_101_49_142,seq42,r_10_13_2,r_101_49_142,0.77,0,142,142,18
26,r_110_92_167,r_60_114_194,seq135,r_110_92_167,0.87,0,167,167,18
4,r_103_132_82,seq19,seq31,r_103_132_82,0.94,2,84,82,18
63,seq22,r_139_140_139,r_79_51_115,r_79_51_115,0.69,27,142,115,18
11,r_115_7_66,r_20_30_155,seq64,r_115_7_66,1.0,1,67,66,18
15,r_60_114_194,r_110_92_167,r_39_95_131,r_60_114_194,0.8,-27,167,194,18
48,r_17_23_106,r_144_68_193,r_36_94_34,r_17_23_106,0.95,0,106,106,18
13,r_37_118_37,r_117_116_161,seq77,r_37_118_37,0.98,0,37,37,18
6,r_86_72_150,r_60_114_194,seq112,r_86_72_150,0.95,1,151,150,18
0,r_119_44_32,seq47,seq27,r_119_44_32,0.54,8,40,32,18
85,seq80,r_0_75_157,r_96_99_47,r_96_99_47,1.0,37,84,47,18
31,r_96_99_47,r_2_9_44,r_0_75_157,r_96_99_47,0.98,1,48,47,18
27,r_56_127_5,r_39_95_131,seq128,r_39_95_131,0.75,0,131,131,18
25,r_69_58_29,r_35_28_148,seq135,r_69_58_29,1.0,0,29,29,18
2,r_129_126_186,seq8,r_119_44_32,r_119_44_32,0.64,154,186,32,18
47,r_89_62_158,r_123_73_73,seq22,r_123_73_73,1.0,3,76,73,18
40,r_33_88_126,r_139_140_139,r_37_118_37,r_33_88_126,0.61,16,142,126,18
24,r_139_140_139,seq22,seq80,r_139_140_139,0.67,3,142,139,18
9,r_117_116_161,r_37_118_37,seq143,r_117_116_161,0.82,-120,41,161,18
33,r_67_134_89,r_24_66_135,seq18,r_67_134_89,0.7,10,99,89,18
47,r_89_62_158,seq22,seq143,r_89_62_158,0.66,3,161,158,18
32,r_45_90_125,r_129_126_186,seq47,r_45_90_125,0.68,0,125,125,18
38,r_83_108_130,seq98,seq34,r_83_108_130,0.95,0,130,130,18
21,r_111_138_57,seq22,seq91,r_111_138_57,1.0,0,57,57,18
34,r_61_4_168,seq55,r_37_118_37,r_37_118_37,0.79,132,169,37,18
31,r_96_99_47,r_0_75_157,r_70_124_111,r_70_124_111,0.52,48,159,111,18
7,r_0_75_157,seq80,r_96_99_47,r_96_99_47,1.0,6,53,47,18
22,r_76_11_170,seq98,r_50_15_52,r_50_15_52,0.51,119,171,52,18
28,r_144_68_193,r_17_23_106,seq71,r_17_23_106,1.0,0,106,106,18
49,r_105_81_104,seq53,r_50_15_52,r_105_81_104,0.98,0,104,104,18
44,r_136_43_166,seq91,r_56_127_5,r_136_43_166,0.85,0,166,166,18
23,r_131_52_149,r_24_66_135,seq55,r_131_52_149,0.88,0,149,149,18
82,seq71,r_29_6_163,seq16,r_29_6_163,0.87,1,164,163,18
8,r_50_15_52,seq84,r_105_81_104,r_105_81_104,0.98,8,112,104,18
35,r_70_124_111,r_35_28_148,r_96_99_47,r_96_99_47,0.98,67,114,47,18
30,r_130_87_27,seq80,seq97,r_130_87_27,0.96,1,28,27,18
84,seq78,r_136_43_166,r_111_138_57,r_111_138_57,0.99,21,78,57,18
93,seq114,r_39_144_76,r_42_32_28,r_39_144_76,0.56,0,76,76,19
30,r_27_51_81,r_54_133_132,r_119_55_152,r_27_51_81,0.71,2,83,81,19
8,r_13_5_88,r_8_29_178,seq95,r_13_5_88,0.96,0,88,88,19
43,r_128_73_166,r_22_131_73,r_57_112_62,r_128_73_166,0.47,0,166,166,19
55,seq136,r_45_40_103,seq64,r_45_40_103,0.66,0,103,103,19
16,r_119_55_152,r_82_137_175,r_19_65_97,r_19_65_97,1.0,61,158,97,19
26,r_11_147_16,r_132_122_160,seq67,r_11_147_16,0.99,0,16,16,19
21,r_82_137_175,r_119_55_152,r_18_38_130,r_18_38_130,0.9,45,175,130,19
1,r_138_21_168,seq86,seq83,r_138_21_168,0.72,0,168,168,19
46,r_33_92_78,seq35,seq50,r_33_92_78,0.87,1,79,78,19
42,r_10_62_112,r_1_44_147,seq68,r_10_62_112,0.98,0,112,112,19
45,r_143_126_126,r_138_21_168,seq134,r_143_126_126,0.85,0,126,126,19
19,r_89_102_74,seq142,seq0,r_89_102_74,1.0,2,76,74,19
23,r_93_66_29,r_78_85_31,seq79,r_93_66_29,1.0,0,29,29,19
95,seq120,r_41_127_164,r_69_113_63,r_41_127_164,0.77,0,164,164,19
41,r_2_14_124,seq140,r_77_107_40,r_2_14_124,0.98,1,125,124,19
89,seq103,r_105_99_180,r_87_74_70,r_87_74_70,1.0,1,71,70,19
96,seq121,r_105_99_180,r_130_96_22,r_105_99_180,0.69,-19,161,180,19
7,r_130_96_22,r_13_5_88,seq72,r_130_96_22,1.0,0,22,22,19
4,r_49_20_68,seq72,seq95,r_49_20_68,1.0,2,70,68,19
0,r_54_133_132,r_105_99_180,seq23,r_54_133_132,0.99,0,132,132,19
11,r_53_97_179,seq61,r_54_133_132,r_53_97_179,0.52,0,179,179,19
55,seq136,seq64,r_143_126_126,r_143_126_126,0.91,18,144,126,19
13,r_57_112_62,r_132_122_160,seq16,r_57_112_62,0.98,0,62,62,19
15,r_8_29_178,seq114,r_119_55_152,r_119_55_152,0.57,27,179,152,19
48,r_6_94_172,seq110,r_22_131_73,r_22_131_73,0.5,101,174,73,19
34,r_1_44_147,r_69_113_63,r_42_32_28,r_1_44_147,1.0,0,147,147,19
57,seq141,r_105_99_180,r_130_96_22,r_130_96_22,0.7,160,182,22,19
6,r_9_24_107,seq95,r_11_147_16,r_9_24_107,0.99,0,107,107,19
27,r_60_90_149,seq106,r_58_48_46,r_58_48_46,1.0,96,142,46,19
2,r_109_98_91,seq121,r_49_20_68,r_109_98_91,0.91,0,91,91,19
47,r_132_122_160,seq76,r_89_102_74,r_89_102_74,1.0,91,165,74,19
40,r_22_131_73,r_128_73_166,r_6_94_172,r_22_131_73,0.76,93,166,73,19
10,r_87_74_70,r_132_122_160,seq103,r_87_74_70,1.0,0,70,70,19
29,r_19_65_97,seq106,r_146_63_171,r_19_65_97,0.99,1,98,97,19
5,r_42_32_28,seq103,seq114,r_42_32_28,1.0,0,28,28,19
25,r_30_7_92,seq140,seq25,r_30_7_92,1.0,0,92,92,19
33,r_108_59_109,seq110,r_119_55_152,r_108_59_109,0.99,0,109,109,19
88,seq101,r_130_96_22,seq23,r_130_96_22,0.51,122,144,22,19
3,r_58_48_46,r_18_38_130,seq68,r_58_48_46,0.6,1,47,46,19
38,r_75_80_61,r_9_24_107,seq50,r_75_80_61,1.0,2,63,61,19
34,r_1_44_147,r_10_62_112,r_69_113_63,r_10_62_112,0.66,0,112,112,19
75,seq68,seq25,r_58_48_46,r_58_48_46,1.0,84,130,46,19
28,r_115_37_50,r_87_74_70,seq140,r_115_37_50,1.0,0,50,50,19
60,seq16,r_41_127_164,r_57_112_62,r_57_112_62,0.95,102,164,62,19
17,r_69_113_63,seq134,r_1_44_147,r_69_113_63,0.54,0,63,63,19
9,r_104_47_101,seq64,r_19_65_97,r_104_47_101,1.0,0,101,101,19
14,r_78_85_31,r_31_100_191,r_130_96_22,r_78_85_31,1.0,0,31,31,19
96,seq121,r_109_98_91,r_105_99_180,r_109_98_91,0.98,-6,85,91,19
22,r_39_144_76,seq114,r_139_118_44,r_39_144_76,1.0,0,76,76,19
10,r_87_74_70,r_115_37_50,r_132_122_160,r_115_37_50,0.96,1,51,50,19
91,seq110,r_6_94_172,r_12_116_145,r_12_116_145,0.97,29,174,145,19
18,r_46_4_42,seq25,r_93_66_29,r_46_4_42,1.0,0,42,42,19
49,r_45_40_103,seq136,seq35,r_45_40_103,1.0,0,103,103,19
39,r_139_118_44,r_30_7_92,seq79,r_139_118_44,1.0,0,44,44,19
44,r_52_34_154,seq140,r_12_116_145,r_52_34_154,0.57,1,155,154,19
17,r_69_113_63,r_1_44_147,seq134,r_1_44_147,1.0,0,147,147,19
35,r_146_63_171,seq28,r_19_65_97,r_19_65_97,1.0,33,130,97,19
12,r_12_116_145,r_138_21_168,r_77_107_40,r_12_116_145,0.99,0,145,145,19
84,seq86,r_138_21_168,r_148_17_77,r_148_17_77,0.69,91,168,77,19
93,seq109,r_145_32_161,r_54_81_80,r_54_81_80,1.0,82,162,80,20
36,r_28_46_190,r_34_116_99,seq110,r_34_116_99,1.0,0,99,99,20
8,r_34_116_99,r_28_46_190,seq77,r_34_116_99,0.79,0,99,99,20
43,r_117_89_172,r_61_6_149,r_91_125_79,r_61_6_149,0.68,19,168,149,20
45,r_23_14_10,r_129_103_43,seq7,r_23_14_10,0.88,0,10,10,20
32,r_90_147_31,r_145_32_161,r_126_50_6,r_90_147_31,1.0,0,31,31,20
37,r_142_68_135,seq62,seq130,r_142_68_135,0.98,0,135,135,20
71,seq62,r_142_68_135,seq97,r_142_68_135,1.0,0,135,135,20
16,r_44_112_87,r_56_80_146,r_28_46_190,r_56_80_146,0.99,-36,110,146,20
21,r_131_66_152,seq109,r_57_96_77,r_57_96_77,0.86,75,152,77,20
39,r_58_49_83,seq29,r_39_132_20,r_58_49_83,0.59,0,83,83,20
5,r_111_53_144,seq15,r_4_139_61,r_111_53_144,0.97,0,144,144,20
46,r_25_127_150,r_78_137_74,r_86_63_59,r_25_127_150,0.98,-88,62,150,20
42,r_57_96_77,r_140_47_73,seq97,r_57_96_77,0.98,-1,76,77,20
29,r_102_136_33,r_111_53_144,seq128,r_102_136_33,0.67,0,33,33,20
3,r_146_143_23,seq67,seq19,r_146_143_23,1.0,1,24,23,20
19,r_27_141_64,seq77,seq26,r_27_141_64,1.0,0,64,64,20
83,seq87,r_12_42_25,seq121,r_12_42_25,1.0,-9,16,25,20
31,r_123_10_76,seq1,r_23_14_10,r_23_14_10,0.52,69,79,10,20
67,seq38,r_56_80_146,seq98,r_56_80_146,1.0,1,147,146,20
58,seq19,r_91_125_79,r_146_143_23,r_146_143_23,0.98,1,24,23,20
0,r_91_125_79,seq19,r_122_133_45,r_91_125_79,0.86,0,79,79,20
11,r_61_6_149,seq5,r_149_64_114,r_149_64_114,1.0,36,150,114,20
13,r_78_137_74,r_142_68_135,seq99,r_78_137_74,0.91,0,74,74,20
46,r_25_127_150,r_86_63_59,r_142_68_135,r_86_63_59,0.99,91,150,59,20
15,r_145_32_161,seq109,seq120,r_145_32_161,0.28,-4,157,161,20
48,r_51_69_128,seq24,r_146_143_23,r_51_69_128,0.93,1,129,128,20
6,r_86_63_59,seq99,r_25_127_150,r_86_63_59,1.0,3,62,59,20
62,seq26,r_3_0_193,r_27_141_64,r_27_141_64,1.0,14,78,64,20
27,r_149_64_114,seq73,r_39_132_20,r_149_64_114,0.99,0,114,114,20
2,r_54_81_80,seq20,seq109,r_54_81_80,1.0,1,81,80,20
30,r_122_133_45,seq128,seq65,r_122_133_45,0.75,6,51,45,20
18,r_55_9_98,r_148_59_162,r_41_83_5,r_55_9_98,0.99,0,98,98,20
24,r_134_71_86,r_142_68_135,seq79,r_134_71_86,0.67,2,88,86,20
25,r_8_100_159,seq79,r_28_46_190,r_8_100_159,0.94,0,159,159,20
33,r_140_47_73,r_57_96_77,seq2,r_57_96_77,1.0,-1,76,77,20
6,r_86_63_59,r_25_127_150,r_35_17_155,r_86_63_59,0.79,91,150,59,20
20,r_129_103_43,seq36,r_43_52_93,r_43_52_93,1.0,19,112,93,20
42,r_57_96_77,seq97,r_131_66_152,r_57_96_77,0.75,69,146,77,20
26,r_124_16_12,r_54_81_80,seq88,r_124_16_12,1.0,0,12,12,20
41,r_138_48_15,r_123_10_76,r_12_42_25,r_138_48_15,0.92,13,28,15,20
34,r_4_139_61,seq40,seq73,r_4_139_61,0.91,2,63,61,20
75,seq73,r_149_64_114,r_4_139_61,r_149_64_114,0.8,0,114,114,20
17,r_104_30_11,seq121,seq29,r_104_30_11,0.87,0,11,11,20
9,r_13_93_111,seq70,r_54_81_80,r_54_81_80,0.8,31,111,80,20
49,r_94_18_60,r_3_0_193,r_86_63_59,r_3_0_193,0.8,-127,66,193,20
7,r_22_108_184,seq20,r_146_143_23,r_146_143_23,0.82,162,185,23,20
54,seq7,r_114_60_191,r_23_14_10,r_23_14_10,1.0,2,12,10,20
23,r_43_52_93,seq45,r_129_103_43,r_43_52_93,1.0,0,93,93,20
10,r_12_42_25,seq87,r_138_48_15,r_12_42_25,0.9,-1,24,25,20
35,r_118_107_126,seq82,seq121,r_118_107_126,1.0,3,129,126,20
12,r_72_76_91,seq67,seq101,r_72_76_91,1.0,0,91,91,20
30,r_31_40_82,seq109,r_35_37_18,r_31_40_82,0.83,0,82,82,21
44,r_117_92_86,r_99_149_176,r_48_10_105,r_117_92_86,0.84,90,176,86,21
36,r_105_107_78,seq41,seq137,r_105_107_78,1.0,0,78,78,21
8,r_17_84_129,seq101,seq11,r_17_84_129,0.94,0,129,129,21
42,r_35_37_18,r_25_132_135,r_31_40_82,r_35_37_18,0.87,71,89,18,21
54,seq137,r_136_140_124,r_105_107_78,r_105_107_78,1.0,0,78,78,21
37,r_4_34_71,seq90,seq56,r_4_34_71,1.0,-1,70,71,21
16,r_79_62_117,seq127,seq119,r_79_62_117,1.0,0,117,117,21
21,r_19_33_181,seq104,r_123_36_167,r_123_36_167,0.53,14,181,167,21
1,r_60_142_187,seq111,r_108_49_149,r_60_142_187,0.41,0,187,187,21
5,r_120_50_171,seq26,seq109,r_120_50_171,0.72,0,171,171,21
46,r_43_133_73,seq22,r_124_53_74,r_43_133_73,0.99,0,73,73,21
18,r_134_122_25,r_43_133_73,seq0,r_134_122_25,1.0,1,26,25,21
32,r_130_55_69,seq6,r_79_62_117,r_79_62_117,1.0,31,148,117,21
69,seq42,r_136_140_124,r_97_100_60,r_97_100_60,1.0,18,78,60,21
29,r_124_53_74,r_9_13_121,seq75,r_9_13_121,0.59,-63,58,121,21
48,r_97_100_60,r_35_37_18,seq42,r_97_100_60,1.0,0,60,60,21
27,r_65_116_27,r_115_20_38,seq71,r_65_116_27,0.85,0,27,27,21
14,r_78_1_20,r_83_59_146,seq45,r_78_1_20,0.99,0,20,20,21
31,r_68_82_158,seq91,r_67_63_61,r_67_63_61,0.98,97,158,61,21
67,seq39,r_113_103_114,r_12_27_92,r_12_27_92,1.0,10,102,92,21
10,r_136_140_124,seq137,r_43_133_73,r_43_133_73,1.0,46,119,73,21
26,r_123_36_167,seq15,seq102,r_123_36_167,0.57,1,168,167,21
4,r_23_76_81,r_3_64_33,seq75,r_23_76_81,0.99,0,81,81,21
78,seq143,r_9_13_121,r_118_52_62,r_118_52_62,0.57,59,121,62,21
0,r_135_51_126,r_3_64_33,r_4_34_71,r_3_64_33,1.0,93,126,33,21
73,seq56,seq41,r_4_34_71,r_4_34_71,1.0,0,71,71,21
13,r_114_131_192,r_17_84_129,r_87_57_67,r_87_57_67,0.99,2,69,67,21
46,r_43_133_73,r_124_53_74,r_136_140_124,r_43_133_73,0.74,69,142,73,21
15,r_25_132_135,r_48_10_105,r_31_40_82,r_25_132_135,0.83,-53,82,135,21
6,r_48_10_105,r_25_132_135,r_24_5_11,r_48_10_105,0.98,0,105,105,21
48,r_97_100_60,r_48_10_105,r_35_37_18,r_35_37_18,1.0,0,18,18,21
19,r_18_95_55,r_93_54_191,seq75,r_18_95_55,1.0,0,55,55,21
99,seq127,r_79_62_117,seq102,r_79_62_117,1.0,0,117,117,21
87,seq98,r_108_49_149,r_67_63_61,r_67_63_61,1.0,88,149,61,21
75,seq71,seq0,r_65_116_27,r_65_116_27,1.0,1,28,27,21
2,r_108_49_149,seq98,r_29_73_8,r_108_49_149,0.82,0,149,149,21
47,r_99_149_176,seq8,r_117_92_86,r_117_92_86,0.99,3,89,86,21
34,r_32_46_93,r_31_40_82,r_83_59_146,r_83_59_146,1.0,0,146,146,21
40,r_9_13_121,seq143,seq11,r_9_13_121,0.81,0,121,121,21
24,r_126_21_166,seq112,r_79_62_117,r_126_21_166,0.71,0,166,166,21
25,r_113_103_114,seq39,seq147,r_113_103_114,0.61,-37,77,114,21
43,r_86_66_23,seq7,r_134_122_25,r_134_122_25,0.58,143,168,25,21
33,r_2_72_115,seq75,seq0,r_2_72_115,0.89,3,118,115,21
47,r_99_149_176,r_117_92_86,r_79_62_117,r_99_149_176,0.71,0,176,176,21
15,r_25_132_135,r_31_40_82,r_118_52_62,r_25_132_135,1.0,0,135,135,21
88,seq101,r_17_84_129,r_114_131_192,r_17_84_129,1.0,0,129,129,21
18,r_134_122_25,seq7,r_129_128_108,r_129_128_108,0.92,0,108,108,21
20,r_129_128_108,r_118_52_62,seq80,r_118_52_62,1.0,-6,56,62,21
32,r_130_55_69,r_68_82_158,seq6,r_130_55_69,0.86,-3,66,69,21
20,r_129_128_108,seq80,r_134_122_25,r_129_128_108,1.0,0,108,108,21
34,r_32_46_93,r_129_128_108,r_31_40_82,r_32_46_93,0.9,0,93,93,21
43,r_86_66_23,seq138,seq7,r_86_66_23,1.0,0,23,23,21
94,seq111,r_60_142_187,seq80,r_60_142_187,0.73,-56,131,187,21
9,r_83_59_146,seq104,r_32_46_93,r_83_59_146,0.98,0,146,146,21
45,r_81_139_41,r_48_10_105,seq143,r_81_139_41,1.0,1,42,41,21
22,r_69_70_170,seq148,seq127,r_69_70_170,0.76,0,170,170,21
86,seq144,r_124_53_74,r_115_20_38,r_115_20_38,1.0,0,38,38,21
28,r_87_57_67,r_2_72_115,r_114_131_192,r_87_57_67,1.0,0,67,67,21
49,r_146_58_164,seq38,seq14,r_146_58_164,0.51,0,164,164,21
42,r_35_37_18,r_97_100_60,r_25_132_135,r_97_100_60,1.0,0,60,60,21
56,seq11,r_3_64_33,r_17_84_129,r_17_84_129,1.0,0,129,129,21
7,r_67_63_61,r_23_76_81,seq98,r_67_63_61,1.0,0,61,61,21
18,r_134_122_25,seq0,seq7,r_134_122_25,0.49,65,90,25,21
44,r_117_92_86,r_79_62_117,r_99_149_176,r_117_92_86,0.99,1,87,86,21
23,r_118_52_62,r_129_128_108,seq28,r_118_52_62,1.0,0,62,62,21
82,seq90,r_4_34_71,seq61,r_4_34_71,1.0,-7,64,71,21
42,r_35_37_18,r_115_20_38,r_97_100_60,r_35_37_18,0.99,0,18,18,21
35,r_12_27_92,seq14,seq39,r_12_27_92,1.0,0,92,92,21
3,r_115_20_38,r_113_103_114,seq144,r_115_20_38,1.0,0,38,38,21
93,seq116,r_10_34_49,r_14_85_139,r_14_85_139,0.92,3,142,139,22
36,r_8_46_67,r_10_34_49,seq35,r_8_46_67,1.0,0,67,67,22
14,r_29_3_94,r_80_43_120,r_94_133_63,r_94_133_63,0.99,37,100,63,22
8,r_115_79_6,r_15_135_176,r_148_71_27,r_148_71_27,0.79,149,176,27,22
12,r_33_12_14,r_17_147_102,seq27,r_33_12_14,0.82,0,14,14,22
43,r_110_60_92,seq101,seq119,r_110_60_92,1.0,1,93,92,22
37,r_130_128_141,seq108,r_29_3_94,r_130_128_141,0.97,0,141,141,22
44,r_137_125_8,r_77_138_198,r_33_12_14,r_137_125_8,0.77,6,14,8,22
16,r_72_118_66,r_91_62_172,seq90,r_72_118_66,1.0,0,66,66,22
39,r_37_122_161,seq68,r_14_85_139,r_14_85_139,0.86,26,165,139,22
1,r_6_53_61,r_57_21_177,seq146,r_6_53_61,1.0,5,66,61,22
88,seq98,r_66_105_58,r_141_73_153,r_141_73_153,0.98,8,161,153,22
22,r_92_76_189,seq89,r_16_13_10,r_16_13_10,0.85,26,36,10,22
15,r_16_13_10,r_29_3_94,r_92_76_189,r_16_13_10,0.99,0,10,10,22
19,r_94_133_63,seq144,seq102,r_94_133_63,1.0,0,63,63,22
15,r_16_13_10,r_92_76_189,r_65_22_76,r_65_22_76,1.0,113,189,76,22
27,r_24_11_21,r_94_133_63,seq68,r_24_11_21,0.99,6,27,21,22
95,seq121,r_57_21_177,r_54_112_115,r_54_112_115,0.98,62,177,115,22
40,r_114_95_29,seq25,seq48,r_114_95_29,1.0,0,29,29,22
66,seq32,r_37_122_161,r_97_113_144,r_97_113_144,0.89,21,165,144,22
38,r_141_73_153,r_131_107_18,seq98,r_141_73_153,1.0,0,153,153,22
41,r_145_134_70,r_47_82_132,r_37_122_161,r_37_122_161,0.5,-90,71,161,22
9,r_66_105_58,seq149,seq144,r_66_105_58,1.0,0,58,58,22
89,seq101,r_110_60_92,seq90,r_110_60_92,1.0,1,93,92,22
13,r_19_69_65,r_97_113_144,r_104_20_100,r_19_69_65,0.98,38,103,65,22
90,seq102,seq61,r_94_133_63,r_94_133_63,1.0,2,65,63,22
26,r_80_43_120,r_29_3_94,r_10_34_49,r_80_43_120,0.56,1,121,120,22
4,r_83_38_117,seq144,r_66_105_58,r_66_105_58,1.0,6,64,58,22
0,r_17_147_102,r_97_113_144,r_6_53_61,r_17_147_102,0.99,3,105,102,22
31,r_148_71_27,r_17_147_102,seq31,r_148_71_27,0.99,0,27,27,22
3,r_136_117_13,r_33_12_14,seq68,r_136_117_13,0.97,0,13,13,22
20,r_54_112_115,seq109,seq2,r_54_112_115,0.47,-1,114,115,22
13,r_19_69_65,seq98,r_97_113_144,r_19_69_65,0.85,0,65,65,22
98,seq126,r_57_21_177,seq25,r_57_21_177,0.69,-98,79,177,22
48,r_47_82_132,r_145_134_70,r_66_105_58,r_47_82_132,0.71,-61,71,132,22
49,r_131_107_18,r_141_73_153,r_148_71_27,r_141_73_153,0.7,0,153,153,22
62,seq27,seq142,r_33_12_14,r_33_12_14,0.91,116,130,14,22
85,seq90,r_52_111_104,r_72_118_66,r_72_118_66,1.0,42,108,66,22
5,r_99_36_81,r_19_69_65,r_104_20_100,r_104_20_100,0.61,59,159,100,22
4,r_83_38_117,r_66_105_58,seq75,r_83_38_117,1.0,0,117,117,22
87,seq96,r_4_39_90,seq116,r_4_39_90,1.0,0,90,90,22
22,r_92_76_189,r_16_13_10,seq144,r_16_13_10,0.26,179,189,10,22
2,r_106_74_98,r_120_84_173,r_6_53_61,r_106_74_98,1.0,0,98,98,22
41,r_145_134_70,r_37_122_161,r_97_113_144,r_97_113_144,1.0,21,165,144,22
47,r_10_34_49,seq116,r_80_43_120,r_10_34_49,0.46,88,137,49,22
28,r_44_26_40,r_10_34_49,seq28,r_44_26_40,1.0,1,41,40,22
46,r_100_78_33,seq142,r_136_117_13,r_100_78_33,1.0,0,33,33,22
24,r_15_135_176,r_115_79_6,r_65_22_76,r_65_22_76,1.0,100,176,76,22
84,seq89,seq90,r_16_13_10,r_16_13_10,0.93,1,11,10,22
25,r_65_22_76,seq41,seq90,r_65_22_76,1.0,0,76,76,22
33,r_143_81_186,seq132,r_65_22_76,r_65_22_76,1.0,111,187,76,22
48,r_47_82_132,r_66_105_58,r_145_134_70,r_47_82_132,0.96,0,132,132,22
61,seq25,r_57_21_177,seq126,r_57_21_177,0.62,-10,167,177,22
32,r_57_21_177,seq121,r_66_105_58,r_66_105_58,0.82,119,177,58,22
17,r_91_62_172,r_72_118_66,seq9,r_72_118_66,0.98,0,66,66,22
38,r_141_73_153,seq31,r_131_107_18,r_131_107_18,0.99,31,49,18,22
49,r_131_107_18,seq129,r_141_73_153,r_131_107_18,0.99,1,19,18,22
91,seq108,r_130_128_141,seq2,r_130_128_141,0.98,0,141,141,22
7,r_97_113_144,seq140,r_120_84_173,r_97_113_144,0.77,0,144,144,22
23,r_120_84_173,r_59_50_193,r_97_113_144,r_97_113_144,0.97,34,178,144,22
17,r_91_62_172,seq9,seq140,r_91_62_172,0.95,0,172,172,22
35,r_104_20_100,r_120_84_173,r_99_36_81,r_120_84_173,0.7,-73,100,173,22
4,r_75_142_22,r_26_125_121,seq137,r_75_142_22,1.0,0,22,22,23
30,r_47_129_183,r_139_25_118,r_4_116_196,r_139_25_118,0.68,0,118,118,23
14,r_64_22_85,r_43_138_92,r_66_12_70,r_64_22_85,1.0,0,85,85,23
43,r_139_25_118,r_47_129_183,seq41,r_139_25_118,0.6,0,118,118,23
54,seq9,r_100_103_86,r_113_29_65,r_100_103_86,0.71,0,86,86,23
21,r_59_49_140,seq145,seq36,r_59_49_140,0.65,4,144,140,23
39,r_43_138_92,r_63_13_105,r_17_128_181,r_43_138_92,0.96,1,93,92,23
1,r_134_44_145,seq135,r_1_117_17,r_134_44_145,0.65,1,146,145,23
5,r_106_126_120,r_61_121_159,r_119_105_97,r_106_126_120,0.7,5,125,120,23
46,r_80_68_108,seq23,r_113_29_65,r_80_68_108,0.72,13,121,108,23
80,seq72,r_114_93_125,r_136_28_36,r_114_93_125,0.95,2,127,125,23
8,r_40_132_59,seq14,seq7,r_40_132_59,0.99,0,59,59,23
72,seq53,r_65_31_197,r_15_74_34,r_15_74_34,0.86,17,51,34,23
77,seq147,r_79_102_117,r_65_31_197,r_65_31_197,0.66,-59,138,197,23
39,r_43_138_92,r_17_128_181,r_59_49_140,r_43_138_92,0.94,89,181,92,23
31,r_81_143_93,r_61_121_159,seq14,r_81_143_93,0.97,2,95,93,23
41,r_124_33_115,r_119_105_97,r_69_108_73,r_119_105_97,0.71,0,97,97,23
3,r_149_94_63,r_92_67_127,seq50,r_149_94_63,1.0,0,63,63,23
26,r_113_29_65,r_96_3_160,seq120,r_113_29_65,0.99,4,69,65,23
11,r_130_46_72,seq23,seq45,r_130_46_72,0.99,1,73,72,23
20,r_79_102_117,seq99,seq0,r_79_102_117,0.54,4,121,117,23
37,r_58_91_166,r_127_88_16,r_119_105_97,r_127_88_16,0.82,6,22,16,23
13,r_83_84_94,seq148,seq42,r_83_84_94,1.0,1,95,94,23
33,r_1_117_17,r_134_44_145,seq145,r_1_117_17,0.92,-3,14,17,23
41,r_124_33_115,r_69_108_73,r_1_117_17,r_124_33_115,0.97,0,115,115,23
45,r_60_38_46,seq53,seq89,r_60_38_46,1.0,4,50,46,23
27,r_11_109_164,r_32_10_169,r_140_104_100,r_32_10_169,0.55,-59,110,169,23
30,r_47_129_183,r_4_116_196,r_136_28_36,r_47_129_183,0.87,0,183,183,23
22,r_119_105_97,r_58_91_166,r_106_126_120,r_58_91_166,0.93,-1,165,166,23
2,r_96_3_160,seq42,r_69_108_73,r_96_3_160,0.79,1,161,160,23
18,r_37_48_133,seq21,r_140_104_100,r_37_48_133,0.98,0,133,133,23
29,r_133_90_184,seq145,r_26_125_121,r_26_125_121,1.0,63,184,121,23
27,r_11_109_164,r_140_104_100,r_60_38_46,r_11_109_164,1.0,4,168,164,23
24,r_69_108_73,seq146,seq7,r_69_108_73,0.62,4,77,73,23
25,r_92_67_127,seq73,r_136_28_36,r_92_67_127,0.7,2,129,127,23
15,r_15_74_34,r_106_126_120,seq53,r_15_74_34,0.64,4,38,34,23
52,seq7,r_32_10_169,r_69_108_73,r_32_10_169,0.45,-52,117,169,23
17,r_114_93_125,seq72,seq135,r_114_93_125,0.99,2,127,125,23
9,r_17_128_181,seq36,r_119_105_97,r_17_128_181,0.44,0,181,181,23
95,seq115,r_60_38_46,seq0,r_60_38_46,1.0,0,46,46,23
28,r_127_88_16,r_119_105_97,r_111_27_110,r_127_88_16,0.7,-4,12,16,23
37,r_58_91_166,r_119_105_97,r_136_28_36,r_58_91_166,0.51,0,166,166,23
22,r_119_105_97,r_124_33_115,r_58_91_166,r_119_105_97,0.66,0,97,97,23
0,r_136_28_36,r_100_103_86,seq42,r_100_103_86,0.92,-40,46,86,23
49,r_63_13_105,seq77,r_60_38_46,r_63_13_105,0.51,0,105,105,23
36,r_86_56_40,r_64_22_85,seq123,r_86_56_40,0.66,0,40,40,23
7,r_26_125_121,seq145,seq23,r_26_125_121,0.99,0,121,121,23
12,r_61_121_159,r_111_27_110,seq21,r_61_121_159,1.0,0,159,159,23
44,r_140_104_100,seq82,r_37_48_133,r_37_48_133,1.0,9,142,133,23
23,r_52_16_69,seq23,seq34,r_52_16_69,1.0,2,71,69,23
35,r_100_103_86,seq9,r_1_117_17,r_100_103_86,1.0,0,86,86,23
12,r_61_121_159,r_106_126_120,r_111_27_110,r_106_126_120,0.94,1,121,120,23
14,r_21_69_145,seq56,r_118_137_71,r_118_137_71,0.88,5,76,71,24
8,r_119_82_63,r_102_89_109,seq16,r_119_82_63,1.0,0,63,63,24
43,r_118_137_71,seq51,r_21_69_145,r_118_137_71,0.97,5,76,71,24
30,r_37_34_38,seq2,r_4_90_119,r_37_34_38,1.0,0,38,38,24
71,seq39,r_60_75_182,r_44_49_111,r_44_49_111,1.0,8,119,111,24
16,r_132_9_65,seq98,r_11_95_21,r_132_9_65,1.0,1,66,65,24
21,r_4_90_119,seq1,r_114_65_104,r_4_90_119,1.0,0,119,119,24
1,r_70_130_76,r_18_42_79,r_23_35_4,r_70_130_76,1.0,3,79,76,24
46,r_43_149_112,seq36,seq126,r_43_149_112,1.0,0,112,112,24
42,r_129_0_82,seq71,seq28,r_129_0_82,1.0,0,82,82,24
37,r_58_30_14,r_18_42_79,r_131_54_141,r_58_30_14,0.99,0,14,14,24
35,r_41_86_49,r_17_59_180,seq71,r_41_86_49,1.0,1,50,49,24
69,seq134,r_31_20_61,r_53_122_156,r_53_122_156,0.7,-2,154,156,24
45,r_23_35_4,seq8,r_70_130_76,r_70_130_76,1.0,8,84,76,24
19,r_72_68_124,r_31_20_61,seq22,r_72_68_124,1.0,0,124,124,24
34,r_53_122_156,seq134,r_40_10_123,r_53_122_156,0.74,-31,125,156,24
76,seq55,r_63_25_190,r_44_49_111,r_44_49_111,1.0,79,190,111,24
38,r_131_54_141,r_58_30_14,r_72_68_124,r_131_54_141,0.61,0,141,141,24
51,seq1,r_4_90_119,r_11_95_21,r_11_95_21,0.66,0,21,21,24
41,r_80_145_89,seq22,r_21_69_145,r_80_145_89,0.61,31,120,89,24
3,r_125_3_174,seq116,r_70_130_76,r_70_130_76,0.55,98,174,76,24
26,r_87_81_188,seq56,r_132_9_65,r_132_9_65,1.0,123,188,65,24
38,r_131_54_141,r_66_77_73,r_58_30_14,r_131_54_141,0.84,-127,14,141,24
4,r_44_49_111,seq85,seq39,r_44_49_111,1.0,0,111,111,24
0,r_66_77_73,r_131_54_141,seq111,r_66_77_73,1.0,1,74,73,24
11,r_26_101_69,r_80_145_89,seq39,r_26_101_69,1.0,3,72,69,24
28,r_79_139_23,r_53_122_156,seq143,r_79_139_23,0.93,2,25,23,24
20,r_45_14_173,seq88,r_21_69_145,r_21_69_145,0.86,28,173,145,24
13,r_40_10_123,r_123_5_157,r_53_122_156,r_40_10_123,0.9,0,123,123,24
98,seq126,r_61_15_171,r_43_149_112,r_43_149_112,0.96,8,120,112,24
15,r_91_140_142,seq85,r_40_10_123,r_91_140_142,1.0,1,143,142,24
6,r_24_107_93,seq51,seq32,r_24_107_93,0.92,0,93,93,24
5,r_109_93_50,r_110_148_130,seq92,r_109_93_50,0.98,0,50,50,24
27,r_18_42_79,seq1,seq28,r_18_42_79,0.99,0,79,79,24
30,r_37_34_38,r_4_90_119,r_132_9_65,r_37_34_38,0.72,81,119,38,24
2,r_31_20_61,r_72_68_124,seq134,r_72_68_124,1.0,0,124,124,24
40,r_67_113_146,seq111,r_41_86_49,r_41_86_49,0.75,97,146,49,24
25,r_123_5_157,r_44_49_111,r_99_29_91,r_123_5_157,0.99,1,158,157,24
29,r_102_89_109,seq111,seq136,r_102_89_109,1.0,1,110,109,24
25,r_123_5_157,r_40_10_123,r_44_49_111,r_123_5_157,0.79,-34,123,157,24
33,r_50_64_125,r_110_148_130,r_58_30_14,r_58_30_14,0.99,109,123,14,24
64,seq27,r_114_65_104,seq126,r_114_65_104,1.0,0,104,104,24
13,r_40_10_123,r_53_122_156,r_91_140_142,r_40_10_123,0.53,35,158,123,24
65,seq28,seq13,r_18_42_79,r_18_42_79,1.0,64,143,79,24
6,r_24_107_93,seq32,r_102_89_109,r_102_89_109,0.79,26,135,109,24
34,r_53_122_156,r_40_10_123,seq134,r_53_122_156,0.56,-7,149,156,24
32,r_60_75_182,seq39,r_50_64_125,r_50_64_125,0.5,57,182,125,24
77,seq56,r_87_81_188,r_99_29_91,r_99_29_91,1.0,2,93,91,24
34,r_53_122_156,r_73_133_195,seq134,r_53_122_156,0.46,-54,102,156,24
17,r_114_65_104,r_61_15_171,r_124_103_6,r_114_65_104,0.9,0,104,104,24
94,seq111,r_67_113_146,r_66_77_73,r_66_77_73,0.92,23,96,73,24
96,seq116,r_125_3_174,r_18_42_79,r_18_42_79,1.0,96,175,79,24
37,r_58_30_14,r_131_54_141,r_43_149_112,r_43_149_112,0.47,9,121,112,24
22,r_99_29_91,seq46,seq56,r_99_29_91,1.0,0,91,91,24
36,r_112_47_41,seq13,seq143,r_112_47_41,1.0,0,41,41,24
49,r_61_15_171,seq85,r_44_49_111,r_44_49_111,1.0,61,172,111,24
44,r_17_59_180,seq111,r_109_93_50,r_17_59_180,0.75,0,180,180,24
82,seq76,seq46,r_26_101_69,r_26_101_69,1.0,32,101,69,24
10,r_74_121_16,r_63_25_190,seq143,r_74_121_16,1.0,0,16,16,24
23,r_11_95_21,seq7,seq1,r_11_95_21,0.99,0,21,21,24
40,r_26_19_35,r_122_128_173,seq138,r_122_128_173,0.99,-4,169,173,25
30,r_77_93_127,seq100,seq28,r_77_93_127,0.34,1,128,127,25
51,seq2,r_3_137_87,seq70,r_3_137_87,1.0,0,87,87,25
9,r_101_42_182,r_3_137_87,r_4_123_165,r_3_137_87,0.88,95,182,87,25
14,r_125_113_85,r_77_93_127,r_58_88_56,r_77_93_127,0.97,-42,85,127,25
37,r_12_53_155,r_64_108_162,r_51_121_80,r_51_121_80,1.0,77,157,80,25
59,seq15,r_141_20_180,r_0_99_102,r_0_99_102,1.0,72,174,102,25
55,seq9,r_16_73_183,r_84_68_52,r_84_68_52,1.0,131,183,52,25
16,r_141_20_180,seq15,seq95,r_141_20_180,0.48,0,180,180,25
21,r_91_49_130,r_80_126_194,r_72_45_48,r_91_49_130,0.56,0,130,130,25
39,r_16_73_183,seq9,r_8_36_146,r_8_36_146,0.85,37,183,146,25
1,r_8_36_146,r_16_73_183,r_58_88_56,r_58_88_56,0.97,91,147,56,25
13,r_130_62_42,seq136,seq103,r_130_62_42,1.0,0,42,42,25
25,r_97_109_41,seq149,seq15,r_97_109_41,0.99,0,41,41,25
34,r_119_55_50,seq94,r_117_135_195,r_119_55_50,1.0,-1,49,50,25
19,r_122_128_173,seq127,seq24,r_122_128_173,0.44,0,173,173,25
70,seq41,r_52_33_142,r_84_68_52,r_84_68_52,0.72,1,53,52,25
95,seq112,r_4_123_165,r_43_81_11,r_4_123_165,0.65,0,165,165,25
7,r_57_107_49,seq149,r_35_39_178,r_57_107_49,0.9,2,51,49,25
41,r_129_82_82,r_125_113_85,r_57_107_49,r_57_107_49,0.8,33,82,49,25
89,seq94,r_35_39_178,r_118_34_143,r_118_34_143,0.96,38,181,143,25
3,r_118_34_143,seq136,seq69,r_118_34_143,0.93,1,144,143,25
10,r_96_47_134,seq124,seq100,r_96_47_134,0.96,0,134,134,25
26,r_102_22_175,seq63,r_0_99_102,r_0_99_102,0.91,73,175,102,25
4,r_3_137_87,seq2,r_101_42_182,r_3_137_87,1.0,0,87,87,25
78,seq63,r_102_22_175,seq70,r_102_22_175,0.99,0,175,175,25
0,r_0_99_102,r_6_146_190,seq15,r_0_99_102,1.0,3,105,102,25
11,r_35_39_178,seq94,r_3_137_87,r_3_137_87,0.98,93,180,87,25
98,seq124,r_96_47_134,r_13_83_61,r_13_83_61,0.69,73,134,61,25
48,r_10_11_144,seq139,r_96_47_134,r_10_11_144,0.93,0,144,144,25
4,r_3_137_87,r_101_42_182,r_35_39_178,r_101_42_182,0.77,0,182,182,25
6,r_75_106_192,seq14,r_144_143_103,r_144_143_103,1.0,5,108,103,25
40,r_26_19_35,r_57_107_49,r_122_128_173,r_26_19_35,1.0,-2,33,35,25
85,seq86,r_67_134_171,r_98_44_166,r_67_134_171,0.9,0,171,171,25
43,r_72_45_48,r_67_134_171,r_144_143_103,r_72_45_48,1.0,-1,47,48,25
99,seq127,r_122_128_173,r_147_37_28,r_122_128_173,0.98,-4,169,173,25
8,r_117_135_195,seq30,r_119_55_50,r_119_55_50,1.0,-1,49,50,25
29,r_144_143_103,r_52_33_142,r_72_45_48,r_72_45_48,1.0,1,49,48,25
47,r_6_146_190,r_0_99_102,r_147_37_28,r_0_99_102,1.0,-35,67,102,25
18,r_133_105_65,seq59,r_130_62_42,r_133_105_65,1.0,0,65,65,25
24,r_4_123_165,seq112,seq40,r_4_123_165,0.72,0,165,165,25
7,r_57_107_49,r_35_39_178,r_129_82_82,r_129_82_82,1.0,4,86,82,25
36,r_84_68_52,seq138,seq41,r_84_68_52,1.0,0,52,52,25
43,r_72_45_48,r_144_143_103,r_52_33_142,r_144_143_103,0.92,5,108,103,25
33,r_5_27_147,seq69,seq59,r_5_27_147,0.91,0,147,147,25
64,seq25,r_79_104_109,seq7,r_79_104_109,1.0,-30,79,109,25
58,seq14,r_64_108_162,r_51_121_80,r_51_121_80,1.0,2,82,80,25
32,r_140_78_76,r_77_93_127,r_79_104_109,r_79_104_109,0.97,1,110,109,25
38,r_13_83_61,r_117_135_195,seq124,r_13_83_61,1.0,0,61,61,25
92,seq103,seq71,r_130_62_42,r_130_62_42,0.93,2,44,42,25
15,r_90_76_32,r_57_107_49,seq59,r_90_76_32,1.0,-1,31,32,25
43,r_72_45_48,r_52_33_142,r_91_49_130,r_72_45_48,0.93,81,129,48,25
9,r_101_42_182,seq21,r_3_137_87,r_3_137_87,0.99,0,87,87,25
22,r_64_108_162,seq85,r_8_36_146,r_8_36_146,1.0,16,162,146,25
91,seq100,r_77_93_127,r_96_47_134,r_96_47_134,1.0,11,145,134,25
44,r_51_121_80,r_66_110_125,seq14,r_51_121_80,1.0,2,82,80,25
23,r_52_33_142,seq41,r_79_104_109,r_52_33_142,0.79,2,144,142,25
12,r_79_104_109,seq25,r_140_78_76,r_79_104_109,1.0,0,109,109,25
29,r_144_143_103,r_72_45_48,r_75_106_192,r_144_143_103,1.0,5,108,103,25
45,r_58_88_56,r_117_135_195,seq21,r_58_88_56,1.0,-2,54,56,25
13,r_130_62_42,seq103,r_133_105_65,r_133_105_65,1.0,11,76,65,25
5,r_31_148_39,r_147_37_28,seq25,r_31_148_39,1.0,0,39,39,25
36,r_118_28_81,seq57,seq61,r_118_28_81,1.0,0,81,81,26
9,r_107_15_84,r_135_127_176,r_141_111_140,r_107_15_84,0.83,92,176,84,26
50,seq2,seq138,r_133_29_41,r_133_29_41,1.0,5,46,41,26
47,r_35_47_16,r_107_15_84,seq17,r_35_47_16,0.55,1,17,16,26
14,r_109_124_172,seq143,r_126_20_7,r_109_124_172,0.54,3,175,172,26
8,r_58_60_185,seq130,seq41,r_58_60_185,0.55,0,185,185,26
37,r_82_51_125,seq31,seq130,r_82_51_125,0.56,0,125,125,26
19,r_121_94_19,r_131_80_179,r_78_144_162,r_121_94_19,0.66,161,180,19,26
55,seq11,seq17,r_35_47_16,r_35_47_16,0.63,116,132,16,26
2,r_78_144_162,r_67_110_72,r_79_97_9,r_79_97_9,0.7,19,28,9,26
97,seq115,r_140_0_169,r_114_76_46,r_140_0_169,1.0,0,169,169,26
5,r_141_111_140,seq37,r_107_15_84,r_141_111_140,0.96,1,141,140,26
42,r_32_95_153,r_6_22_112,r_82_51_125,r_32_95_153,0.92,2,155,153,26
1,r_21_136_39,r_134_23_83,seq68,r_21_136_39,1.0,0,39,39,26
69,seq38,seq64,r_128_25_28,r_128_25_28,1.0,74,102,28,26
45,r_146_55_94,seq117,seq112,r_146_55_94,1.0,0,94,94,26
39,r_26_147_23,r_19_145_198,seq106,r_26_147_23,1.0,1,24,23,26
15,r_79_97_9,r_78_144_162,r_40_72_163,r_78_144_162,0.53,2,164,162,26
19,r_121_94_19,seq98,r_131_80_179,r_121_94_19,1.0,0,19,19,26
27,r_135_127_176,r_107_15_84,r_82_51_125,r_107_15_84,0.85,92,176,84,26
95,seq106,r_71_54_156,r_26_147_23,r_26_147_23,1.0,51,74,23,26
41,r_40_72_163,seq52,r_79_97_9,r_40_72_163,0.45,-2,161,163,26
10,r_44_93_98,r_131_80_179,r_114_76_46,r_44_93_98,1.0,0,98,98,26
33,r_134_23_83,r_59_91_118,r_107_15_84,r_59_91_118,1.0,0,118,118,26
0,r_75_9_92,seq18,r_26_147_23,r_75_9_92,0.99,2,94,92,26
20,r_132_123_165,r_146_55_94,r_86_66_93,r_132_123_165,1.0,-71,94,165,26
13,r_131_80_179,r_44_93_98,r_121_94_19,r_44_93_98,0.82,0,98,98,26
21,r_139_10_53,seq69,seq46,r_139_10_53,1.0,0,53,53,26
13,r_131_80_179,r_121_94_19,r_79_97_9,r_121_94_19,0.76,161,180,19,26
6,r_140_0_169,seq115,seq11,r_140_0_169,0.52,0,169,169,26
2,r_78_144_162,r_79_97_9,r_81_125_110,r_81_125_110,0.59,54,164,110,26
99,seq117,r_146_55_94,r_5_4_5,r_146_55_94,1.0,0,94,94,26
27,r_135_127_176,seq16,r_107_15_84,r_107_15_84,1.0,1,85,84,26
22,r_129_108_10,r_131_80_179,seq87,r_129_108_10,1.0,2,12,10,26
48,r_56_43_58,r_140_0_169,r_19_145_198,r_56_43_58,1.0,0,58,58,26
18,r_88_65_90,r_82_51_125,seq16,r_88_65_90,1.0,0,90,90,26
29,r_71_54_156,seq106,seq117,r_71_54_156,0.44,-2,154,156,26
24,r_142_14_133,seq49,seq69,r_142_14_133,0.94,0,133,133,26
81,seq69,r_139_10_53,seq24,r_139_10_53,1.0,3,56,53,26
44,r_149_1_157,r_44_93_98,r_5_4_5,r_149_1_157,0.97,0,157,157,26
25,r_8_101_123,seq98,r_75_9_92,r_8_101_123,0.98,2,125,123,26
17,r_81_125_110,r_79_97_9,seq50,r_81_125_110,1.0,1,111,110,26
33,r_134_23_83,r_82_51_125,r_59_91_118,r_59_91_118,0.8,-35,83,118,26
32,r_100_90_43,r_32_95_153,seq46,r_100_90_43,1.0,0,43,43,26
20,r_132_123_165,r_86_66_93,seq143,r_132_123_165,1.0,0,165,165,26
31,r_39_45_32,r_119_104_109,r_58_60_185,r_39_45_32,1.0,2,34,32,26
68,seq37,r_141_111_140,seq13,r_141_111_140,1.0,1,141,140,26
38,r_119_104_109,r_149_1_157,seq62,r_119_104_109,0.9,0,109,109,26
3,r_128_25_28,r_120_99_11,seq38,r_128_25_28,0.97,4,32,28,26
23,r_59_91_118,r_134_23_83,seq105,r_59_91_118,0.99,0,118,118,26
75,seq52,r_40_72_163,r_36_42_52,r_36_42_52,1.0,109,161,52,26
17,r_81_125_110,r_67_110_72,r_79_97_9,r_81_125_110,0.58,-36,74,110,26
9,r_107_15_84,r_146_55_94,r_135_127_176,r_107_15_84,1.0,0,84,84,26
31,r_39_45_32,r_58_60_185,r_82_51_125,r_39_45_32,0.64,153,185,32,26
28,r_84_92_175,r_114_76_46,r_79_97_9,r_114_76_46,0.61,129,175,46,26
44,r_149_1_157,r_119_104_109,r_44_93_98,r_149_1_157,0.99,-48,109,157,26
23,r_59_91_118,seq16,r_134_23_83,r_134_23_83,1.0,2,85,83,26
55,seq11,r_35_47_16,r_140_0_169,r_140_0_169,0.92,2,171,169,26
35,r_86_66_93,seq103,seq117,r_86_66_93,0.66,1,94,93,26
12,r_67_110_72,r_81_125_110,seq41,r_81_125_110,0.71,-4,106,110,26
84,seq74,seq61,r_118_28_81,r_118_28_81,1.0,16,97,81,26
30,r_19_120_61,seq66,r_123_5_46,r_123_5_46,0.73,34,80,46,27
36,r_30_113_60,r_125_132_138,r_101_32_7,r_30_113_60,0.92,3,63,60,27
92,seq99,r_82_81_153,seq85,r_82_81_153,0.63,15,168,153,27
43,r_34_86_71,r_125_132_138,r_45_4_163,r_34_86_71,0.8,2,73,71,27
54,seq138,r_56_22_111,seq143,r_56_22_111,0.62,-5,106,111,27
37,r_56_22_111,r_28_62_81,seq138,r_28_62_81,0.85,1,82,81,27
3,r_110_11_54,seq17,r_98_128_107,r_98_128_107,0.99,15,122,107,27
80,seq73,r_79_69_64,seq48,r_79_69_64,1.0,-16,48,64,27
71,seq51,seq40,r_148_134_67,r_148_134_67,1.0,12,79,67,27
16,r_125_132_138,r_104_137_166,r_28_62_81,r_28_62_81,0.94,12,93,81,27
21,r_0_60_133,seq91,seq74,r_0_60_133,0.99,0,133,133,27
39,r_36_75_93,seq66,r_54_140_48,r_36_75_93,0.78,1,94,93,27
42,r_84_35_167,r_116_83_3,r_100_129_157,r_84_35_167,0.73,1,168,167,27
13,r_47_142_10,r_45_4_163,r_33_24_161,r_47_142_10,0.83,3,13,10,27
19,r_104_137_166,r_125_132_138,r_2_20_114,r_125_132_138,1.0,-16,122,138,27
89,seq135,r_107_145_25,seq8,r_107_145_25,0.97,4,29,25,27
41,r_42_115_23,r_111_14_38,r_125_132_138,r_42_115_23,0.75,-1,22,23,27
2,r_55_76_21,r_28_62_81,r_33_24_161,r_33_24_161,0.75,-140,21,161,27
27,r_96_1_41,seq122,seq31,r_96_1_41,1.0,4,45,41,27
31,r_70_118_144,r_12_49_193,r_0_60_133,r_70_118_144,0.61,0,144,144,27
37,r_56_22_111,seq138,r_79_69_64,r_56_22_111,0.81,0,111,111,27
48,r_54_140_48,r_2_20_114,r_52_21_101,r_2_20_114,0.61,-59,55,114,27
26,r_33_24_161,r_114_67_80,r_55_76_21,r_114_67_80,0.93,-14,66,80,27
8,r_45_4_163,r_34_86_71,seq149,r_45_4_163,0.99,0,163,163,27
72,seq53,r_45_4_163,r_29_92_91,r_45_4_163,0.66,-23,140,163,27
4,r_98_128_107,seq126,r_110_11_54,r_98_128_107,0.61,4,111,107,27
0,r_79_69_64,seq73,seq17,r_79_69_64,1.0,0,64,64,27
5,r_80_68_34,seq143,r_55_76_21,r_80_68_34,0.64,1,35,34,27
11,r_141_16_151,seq108,r_28_62_81,r_141_16_151,0.82,0,151,151,27
98,seq126,r_98_128_107,seq88,r_98_128_107,0.62,7,114,107,27
46,r_123_5_46,seq130,r_19_120_61,r_123_5_46,0.56,82,128,46,27
65,seq40,seq23,r_107_145_25,r_107_145_25,1.0,5,30,25,27
15,r_148_134_67,seq144,seq51,r_148_134_67,0.99,4,71,67,27
57,seq17,r_106_89_99,r_79_69_64,r_79_69_64,1.0,23,87,64,27
13,r_47_142_10,r_33_24_161,seq58,r_33_24_161,0.89,-7,154,161,27
6,r_28_62_81,r_56_22_111,r_125_132_138,r_28_62_81,0.91,1,82,81,27
2,r_55_76_21,r_33_24_161,r_80_68_34,r_55_76_21,0.92,140,161,21,27
45,r_107_145_25,seq135,seq40,r_107_145_25,1.0,0,25,25,27
41,r_42_115_23,r_125_132_138,r_28_62_81,r_42_115_23,0.94,119,142,23,27
47,r_100_129_157,seq65,seq8,r_100_129_157,0.5,0,157,157,27
48,r_54_140_48,r_52_21_101,r_36_75_93,r_52_21_101,1.0,0,101,101,27
40,r_61_119_174,seq78,seq57,r_61_119_174,0.69,0,174,174,27
29,r_64_10_103,seq18,seq58,r_64_10_103,0.69,8,111,103,27
44,r_52_21_101,r_54_140_48,seq91,r_52_21_101,1.0,0,101,101,27
25,r_102_147_155,r_12_49_193,seq88,r_102_147_155,0.91,0,155,155,27
43,r_34_86_71,r_45_4_163,r_95_133_170,r_45_4_163,0.88,0,163,163,27
33,r_114_67_80,r_33_24_161,seq48,r_114_67_80,1.0,0,80,80,27
3,r_110_11_54,r_100_129_157,seq17,r_110_11_54,0.83,0,54,54,27
32,r_29_92_91,r_52_21_101,seq143,r_29_92_91,0.48,0,91,91,27
38,r_121_97_116,r_146_105_184,seq143,r_121_97_116,0.86,3,119,116,27
34,r_38_3_76,r_61_119_174,seq103,r_38_3_76,1.0,0,76,76,27
46,r_123_5_46,r_33_24_161,seq130,r_123_5_46,0.88,3,49,46,27
6,r_28_62_81,r_125_132_138,r_42_115_23,r_125_132_138,1.0,1,139,138,27
94,seq108,r_141_16_151,seq88,r_141_16_151,0.99,0,151,151,27
9,r_15_6_173,r_111_14_38,r_82_81_153,r_111_14_38,0.24,136,174,38,27
26,r_33_24_161,r_55_76_21,r_102_147_155,r_33_24_161,0.86,0,161,161,27
56,seq144,r_148_134_67,r_101_32_7,r_148_134_67,0.98,4,71,67,27
7,r_116_83_3,r_84_35_167,r_37_46_85,r_37_46_85,1.0,83,168,85,27
8,r_45_4_163,seq53,r_34_86_71,r_34_86_71,0.9,-25,46,71,27
35,r_37_46_85,r_125_132_138,r_116_83_3,r_37_46_85,1.0,3,88,85,27
44,r_52_21_101,seq103,r_54_140_48,r_52_21_101,0.6,-48,53,101,27
12,r_82_81_153,seq99,r_101_32_7,r_101_32_7,0.7,146,153,7,27
16,r_125_132_138,r_28_62_81,seq8,r_125_132_138,1.0,1,139,138,27
30,r_77_23_77,r_32_147_71,seq56,r_77_23_77,0.63,-6,71,77,28
43,r_86_123_82,seq24,r_135_109_21,r_86_123_82,1.0,0,82,82,28
83,seq84,r_62_61_188,r_2_108_155,r_62_61_188,0.79,0,188,188,28
9,r_68_53_11,r_49_19_173,r_67_38_37,r_67_38_37,0.99,1,38,37,28
11,r_133_27_9,r_18_35_40,seq128,r_133_27_9,0.97,1,10,9,28
55,seq7,seq89,r_140_115_4,r_140_115_4,0.6,69,73,4,28
16,r_36_9_122,seq116,r_145_148_10,r_36_9_122,1.0,0,122,122,28
21,r_34_1_138,seq126,r_107_22_52,r_34_1_138,0.77,3,141,138,28
39,r_130_103_109,seq0,r_78_50_80,r_130_103_109,1.0,0,109,109,28
25,r_18_35_40,r_55_85_178,seq45,r_18_35_40,1.0,0,40,40,28
1,r_132_111_92,seq37,r_36_9_122,r_132_111_92,0.89,1,93,92,28
46,r_97_144_136,r_29_87_119,r_18_35_40,r_18_35_40,0.82,79,119,40,28
5,r_26_114_83,r_62_61_188,r_112_60_46,r_112_60_46,1.0,2,48,46,28
45,r_122_120_137,seq45,r_62_61_188,r_122_120_137,0.65,11,148,137,28
9,r_68_53_11,r_95_93_61,r_49_19_173,r_68_53_11,0.98,0,11,11,28
15,r_145_148_10,r_94_143_133,seq96,r_145_148_10,0.97,0,10,10,28
58,seq138,r_135_109_21,seq90,r_135_109_21,0.7,-3,18,21,28
44,r_134_43_45,r_72_76_198,r_129_65_36,r_134_43_45,0.91,3,48,45,28
17,r_112_60_46,r_29_87_119,r_26_114_83,r_112_60_46,0.99,0,46,46,28
5,r_26_114_83,r_112_60_46,r_39_57_190,r_26_114_83,1.0,0,83,83,28
19,r_48_14_23,r_62_61_188,r_10_80_20,r_48_14_23,0.99,0,23,23,28
26,r_12_40_108,seq58,r_132_111_92,r_132_111_92,1.0,20,112,92,28
36,r_28_47_147,r_81_11_186,r_42_141_34,r_42_141_34,0.98,15,49,34,28
4,r_32_147_71,r_77_23_77,r_30_117_16,r_32_147_71,1.0,0,71,71,28
0,r_94_143_133,seq20,seq46,r_94_143_133,0.96,0,133,133,28
31,r_107_22_52,r_55_85_178,r_135_109_21,r_135_109_21,0.71,32,53,21,28
73,seq58,r_12_40_108,r_131_8_112,r_131_8_112,0.98,0,112,112,28
20,r_29_87_119,r_97_144_136,r_131_8_112,r_29_87_119,1.0,0,119,119,28
37,r_101_124_157,r_81_11_186,r_129_65_36,r_101_124_157,0.57,-135,22,157,28
41,r_129_65_36,seq136,r_134_43_45,r_129_65_36,0.86,23,59,36,28
48,r_39_57_190,r_49_19_173,r_26_114_83,r_26_114_83,1.0,54,137,83,28
6,r_16_25_107,seq128,r_67_38_37,r_67_38_37,1.0,81,118,37,28
36,r_28_47_147,r_42_141_34,r_41_88_6,r_28_47_147,0.98,0,147,147,28
13,r_81_11_186,r_28_47_147,r_42_141_34,r_81_11_186,0.95,-153,33,186,28
29,r_42_141_34,seq6,r_28_47_147,r_42_141_34,0.99,2,36,34,28
12,r_149_51_48,r_94_143_133,seq69,r_149_51_48,1.0,0,48,48,28
2,r_62_61_188,seq84,r_122_120_137,r_62_61_188,0.44,0,188,188,28
47,r_78_50_80,r_12_40_108,seq137,r_78_50_80,0.99,0,80,80,28
40,r_30_117_16,r_94_143_133,seq63,r_30_117_16,0.98,0,16,16,28
17,r_112_60_46,r_26_114_83,seq126,r_26_114_83,1.0,0,83,83,28
46,r_97_144_136,r_18_35_40,r_73_127_194,r_97_144_136,1.0,0,136,136,28
93,seq105,seq37,r_135_109_21,r_135_109_21,1.0,20,41,21,28
70,seq46,r_83_106_73,r_94_143_133,r_94_143_133,1.0,16,149,133,28
42,r_135_109_21,seq138,seq105,r_135_109_21,0.83,1,22,21,28
65,seq24,r_86_123_82,seq31,r_86_123_82,1.0,0,82,82,28
32,r_118_21_104,seq91,seq126,r_118_21_104,1.0,0,104,104,28
38,r_49_19_173,r_39_57_190,r_94_143_133,r_94_143_133,0.83,41,174,133,28
8,r_67_38_37,r_95_93_61,r_68_53_11,r_67_38_37,1.0,0,37,37,28
1,r_132_111_92,r_36_9_122,r_12_40_108,r_36_9_122,0.92,-11,111,122,28
31,r_107_22_52,r_135_109_21,r_34_1_138,r_107_22_52,0.44,90,142,52,28
37,r_101_124_157,r_129_65_36,r_130_103_109,r_130_103_109,0.64,48,157,109,28
29,r_42_141_34,r_28_47_147,r_81_11_186,r_28_47_147,1.0,0,147,147,28
22,r_131_8_112,seq69,seq58,r_131_8_112,1.0,0,112,112,28
23,r_139_44_127,seq3,seq137,r_139_44_127,1.0,0,127,127,28
35,r_95_93_61,seq74,seq116,r_95_93_61,1.0,1,62,61,28
9,r_126_18_78,r_90_45_186,r_0_139_110,r_0_139_110,0.82,76,186,110,29
92,seq145,r_24_86_86,r_10_120_24,r_24_86_86,0.96,1,87,86,29
8,r_5_11_98,seq101,r_78_54_161,r_5_11_98,0.6,5,103,98,29
53,seq4,seq111,r_10_120_24,r_10_120_24,0.9,42,66,24,29
43,r_55_28_93,r_113_110_107,r_103_77_190,r_55_28_93,0.76,14,107,93,29
80,seq71,seq35,r_124_107_22,r_124_107_22,1.0,12,34,22,29
83,seq141,r_138_30_89,r_96_121_76,r_138_30_89,0.52,-3,86,89,29
37,r_9_142_160,r_133_56_75,r_51_23_49,r_51_23_49,0.6,24,73,49,29
3,r_81_40_185,r_61_58_25,r_114_16_69,r_81_40_185,0.95,0,185,185,29
10,r_133_56_75,r_9_142_160,r_50_73_7,r_50_73_7,0.84,19,26,7,29
71,seq48,r_0_139_110,seq101,r_0_139_110,1.0,-13,97,110,29
86,seq91,r_33_128_149,seq8,r_33_128_149,0.8,1,150,149,29
16,r_59_38_99,r_43_105_141,seq66,r_59_38_99,0.72,0,99,99,29
21,r_132_60_171,seq69,r_51_23_49,r_51_23_49,0.68,122,171,49,29
39,r_144_136_120,seq141,seq35,r_144_136_120,0.99,0,120,120,29
1,r_90_45_186,r_126_18_78,r_24_86_86,r_126_18_78,0.48,108,186,78,29
1,r_90_45_186,r_67_52_95,r_126_18_78,r_90_45_186,0.63,-90,96,186,29
5,r_33_128_149,seq91,r_0_139_110,r_0_139_110,1.0,40,150,110,29
46,r_43_105_141,r_59_38_99,r_138_30_89,r_43_105_141,0.97,-42,99,141,29
22,r_10_120_24,r_82_118_71,seq4,r_10_120_24,0.99,0,24,24,29
10,r_133_56_75,r_50_73_7,r_59_38_99,r_133_56_75,0.66,0,75,75,29
45,r_117_98_166,seq87,r_55_28_93,r_117_98_166,0.72,0,166,166,29
24,r_115_99_178,seq146,r_43_105_141,r_115_99_178,0.66,0,178,178,29
19,r_0_139_110,seq17,seq129,r_0_139_110,1.0,0,110,110,29
2,r_78_54_161,r_5_11_98,r_138_30_89,r_78_54_161,0.9,0,161,161,29
31,r_42_12_101,r_90_45_186,seq36,r_42_12_101,0.99,0,101,101,29
3,r_81_40_185,r_148_37_14,r_61_58_25,r_61_58_25,1.0,94,119,25,29
0,r_27_106_17,r_137_34_114,r_59_38_99,r_27_106_17,1.0,0,17,17,29
90,seq101,r_5_11_98,seq3,r_5_11_98,0.99,5,103,98,29
26,r_137_34_114,seq87,seq20,r_137_34_114,0.86,0,114,114,29
72,seq49,r_93_76_197,r_65_6_106,r_65_6_106,0.37,19,125,106,29
12,r_127_74_11,r_27_106_17,r_114_16_69,r_27_106_17,0.74,-6,11,17,29
78,seq69,r_132_60_171,r_88_68_123,r_132_60_171,1.0,-12,159,171,29
73,seq53,seq41,r_114_16_69,r_114_16_69,1.0,44,113,69,29
11,r_82_118_71,r_115_99_178,seq135,r_82_118_71,1.0,1,72,71,29
20,r_84_62_163,seq66,r_5_11_98,r_84_62_163,0.54,1,164,163,29
15,r_138_30_89,seq141,r_133_56_75,r_138_30_89,1.0,0,89,89,29
4,r_51_23_49,r_9_142_160,r_50_73_7,r_9_142_160,0.84,1,161,160,29
2,r_78_54_161,seq15,r_5_11_98,r_5_11_98,0.64,31,129,98,29
48,r_143_97_59,r_59_38_99,seq53,r_143_97_59,0.47,0,59,59,29
0,r_27_106_17,r_59_38_99,r_138_30_89,r_27_106_17,1.0,82,99,17,29
10,r_133_56_75,r_59_38_99,r_138_30_89,r_59_38_99,0.46,0,99,99,29
36,r_61_58_25,r_81_40_185,r_148_37_14,r_81_40_185,0.62,-2,183,185,29
36,r_61_58_25,r_88_68_123,r_81_40_185,r_61_58_25,1.0,0,25,25,29
27,r_114_16_69,seq47,r_143_97_59,r_143_97_59,0.99,13,72,59,29
87,seq92,r_125_26_153,r_33_128_149,r_125_26_153,0.86,1,154,153,29
4,r_51_23_49,r_126_18_78,r_9_142_160,r_9_142_160,0.91,-111,49,160,29
38,r_83_13_55,r_131_46_187,seq35,r_83_13_55,0.99,1,56,55,29
47,r_119_1_91,r_149_7_189,r_29_80_13,r_119_1_91,1.0,0,91,91,29
40,r_125_26_153,seq92,seq146,r_125_26_153,0.86,0,153,153,29
18,r_131_46_187,seq57,r_27_106_17,r_131_46_187,0.44,1,188,187,29
24,r_115_99_178,r_82_118_71,seq146,r_82_118_71,1.0,1,72,71,29
43,r_55_28_93,r_103_77_190,r_117_98_166,r_117_98_166,1.0,2,168,166,29
65,seq35,seq71,r_83_13_55,r_83_13_55,1.0,9,64,55,29
98,seq122,r_103_77_190,r_61_58_25,r_61_58_25,0.98,19,44,25,29
32,r_22_19_80,r_103_77_190,r_61_58_25,r_61_58_25,0.94,41,66,25,29
34,r_14_85_67,r_82_118_71,seq3,r_14_85_67,1.0,0,67,67,29
46,r_43_105_141,r_138_30_89,seq101,r_43_105_141,0.95,0,141,141,29
94,seq108,r_132_60_171,r_88_68_123,r_132_60_171,0.97,-12,159,171,29
30,r_148_37_14,r_9_142_160,r_61_58_25,r_61_58_25,0.91,0,25,25,29
9,r_126_18_78,seq70,r_90_45_186,r_126_18_78,1.0,0,78,78,29
41,r_134_112_48,r_88_68_123,r_127_74_11,r_134_112_48,0.99,3,51,48,29
37,r_9_142_160,r_51_23_49,r_134_112_48,r_9_142_160,0.87,-1,159,160,29
28,r_113_110_107,seq2,seq70,r_113_110_107,1.0,0,107,107,29
49,r_31_94_179,seq146,r_103_77_190,r_31_94_179,0.45,0,179,179,29
7,r_96_121_76,seq66,seq87,r_96_121_76,1.0,2,78,76,29
12,r_127_74_11,r_114_16_69,r_134_112_48,r_127_74_11,0.88,44,55,11,29
44,r_24_86_86,seq145,seq35,r_24_86_86,1.0,0,86,86,29
23,r_67_52_95,r_90_45_186,r_82_118_71,r_67_52_95,0.92,1,96,95,29
17,r_50_73_7,r_133_56_75,r_51_23_49,r_50_73_7,0.94,66,73,7,29
82,seq75,seq141,r_96_121_76,r_96_121_76,1.0,22,98,76,29
8,r_5_11_98,r_78_54_161,r_84_62_163,r_78_54_161,0.82,0,161,161,29
35,r_88_68_123,r_132_60_171,seq69,r_132_60_171,1.0,-12,159,171,29
79,seq70,r_126_18_78,seq44,r_126_18_78,1.0,-23,55,78,29
7,r_142_99_16,r_8_18_95,seq6,r_142_99_16,0.85,2,18,16,30
30,r_4_130_116,seq149,r_134_17_4,r_4_130_116,0.72,2,118,116,30
51,seq129,r_51_33_109,r_67_50_77,r_67_50_77,1.0,51,128,77,30
36,r_89_139_186,seq86,seq149,r_89_139_186,0.44,0,186,186,30
37,r_119_82_87,seq7,r_64_110_198,r_119_82_87,0.89,7,94,87,30
41,r_87_14_18,r_138_146_185,r_142_99_16,r_87_14_18,0.99,0,18,18,30
39,r_140_36_163,seq40,r_113_23_154,r_140_36_163,0.7,1,164,163,30
1,r_108_101_99,r_52_13_196,r_142_99_16,r_108_101_99,0.98,2,101,99,30
46,r_59_135_148,r_89_139_186,r_124_100_161,r_59_135_148,0.93,4,152,148,30
45,r_46_15_142,r_107_79_182,r_4_130_116,r_46_15_142,0.61,4,146,142,30
16,r_91_68_22,r_103_38_125,seq93,r_91_68_22,0.83,2,24,22,30
95,seq137,r_64_110_198,r_8_18_95,r_8_18_95,0.98,20,115,95,30
31,r_52_13_196,r_25_39_180,r_92_37_53,r_25_39_180,0.74,2,182,180,30
3,r_21_56_149,seq88,seq7,r_21_56_149,0.71,0,149,149,30
10,r_51_33_109,seq129,r_94_41_131,r_51_33_109,0.33,19,128,109,30
26,r_0_3_151,seq88,r_142_99_16,r_0_3_151,0.87,1,152,151,30
11,r_85_132_111,r_103_38_125,r_43_121_85,r_85_132_111,0.94,3,114,111,30
20,r_133_104_188,r_124_100_161,r_21_56_149,r_133_104_188,0.54,0,188,188,30
13,r_44_122_124,seq5,seq27,r_44_122_124,0.79,12,136,124,30
15,r_106_111_179,seq28,r_72_10_173,r_106_111_179,0.39,1,180,179,30
48,r_74_83_164,r_64_110_198,r_108_101_99,r_108_101_99,0.73,65,164,99,30
34,r_90_131_54,r_144_31_117,seq102,r_90_131_54,0.92,1,55,54,30
16,r_91_68_22,seq97,r_58_141_97,r_91_68_22,0.98,63,85,22,30
6,r_25_39_180,r_52_13_196,r_145_75_40,r_25_39_180,0.41,3,183,180,30
2,r_145_75_40,seq24,r_76_84_91,r_76_84_91,1.0,96,187,91,30
99,seq127,r_133_104_188,r_12_80_48,r_12_80_48,1.0,23,71,48,30
27,r_45_34_132,seq16,r_43_121_85,r_45_34_132,0.87,0,132,132,30
87,seq97,r_26_19_60,seq96,r_26_19_60,1.0,3,63,60,30
47,r_76_84_91,r_45_34_132,r_145_75_40,r_45_34_132,0.62,-41,91,132,30
52,seq2,r_43_121_85,r_94_41_131,r_94_41_131,0.78,11,142,131,30
28,r_61_22_11,r_45_34_132,seq128,r_61_22_11,0.9,0,11,11,30
25,r_49_147_23,r_133_104_188,seq60,r_49_147_23,1.0,2,25,23,30
40,r_1_73_135,seq9,seq5,r_1_73_135,0.69,2,137,135,30
29,r_26_19_60,seq97,seq115,r_26_19_60,1.0,1,61,60,30
24,r_8_18_95,seq48,seq137,r_8_18_95,0.94,2,97,95,30
34,r_90_131_54,seq102,r_74_83_164,r_74_83_164,1.0,-3,161,164,30
18,r_117_71_14,r_26_19_60,seq88,r_117_71_14,1.0,0,14,14,30
30,r_4_130_116,r_134_17_4,r_46_15_142,r_46_15_142,0.92,5,147,142,30
65,seq28,r_106_111_179,r_114_98_134,r_114_98_134,0.63,41,175,134,30
32,r_113_23_154,r_25_39_180,r_1_73_135,r_25_39_180,0.63,-25,155,180,30
38,r_72_10_173,r_107_79_182,r_106_111_179,r_72_10_173,0.36,12,185,173,30
52,seq2,r_58_141_97,r_43_121_85,r_58_141_97,0.78,0,97,97,30
50,seq128,seq48,r_61_22_11,r_61_22_11,0.95,3,14,11,30
16,r_91_68_22,seq93,r_61_22_11,r_91_68_22,0.43,25,47,22,30
17,r_58_141_97,seq2,r_91_68_22,r_58_141_97,0.97,0,97,97,30
9,r_103_38_125,seq102,seq77,r_103_38_125,0.83,7,132,125,30
22,r_107_79_182,r_72_10_173,r_113_23_154,r_113_23_154,0.78,22,176,154,30
49,r_124_100_161,r_133_104_188,r_59_135_148,r_59_135_148,0.82,4,152,148,30
44,r_114_98_134,seq27,seq28,r_114_98_134,0.89,3,137,134,30
23,r_67_50_77,seq93,seq136,r_67_50_77,0.97,-1,76,77,30
5,r_12_80_48,seq24,seq127,r_12_80_48,1.0,1,49,48,30
42,r_109_66_50,seq123,seq60,r_109_66_50,1.0,0,50,50,30
33,r_30_65_29,seq63,seq16,r_30_65_29,1.0,0,29,29,30
35,r_144_31_117,seq115,seq9,r_144_31_117,0.97,0,117,117,30
12,r_43_121_85,r_94_41_131,seq20,r_43_121_85,0.85,2,87,85,30
84,seq93,seq97,r_4_130_116,r_4_130_116,1.0,4,120,116,30
2,r_145_75_40,r_21_56_149,seq24,r_145_75_40,1.0,5,45,40,30
30,r_24_147_167,r_17_118_29,seq40,r_24_147_167,0.99,1,168,167,31
30,r_24_147_167,r_86_64_108,r_17_118_29,r_17_118_29,0.98,82,111,29,31
92,seq97,r_102_116_117,r_105_123_12,r_102_116_117,0.72,-8,109,117,31
8,r_86_64_108,r_24_147_167,r_35_32_31,r_86_64_108,0.61,3,111,108,31
43,r_47_125_68,r_55_10_154,r_122_106_155,r_47_125_68,0.91,0,68,68,31
37,r_11_30_83,r_122_106_155,seq112,r_11_30_83,1.0,0,83,83,31
44,r_136_38_47,r_96_27_23,r_103_77_36,r_136_38_47,0.9,0,47,47,31
16,r_102_116_117,seq97,r_86_64_108,r_102_116_117,1.0,0,117,117,31
21,r_18_9_66,r_66_72_131,r_122_106_155,r_18_9_66,0.7,1,67,66,31
39,r_13_141_168,r_21_91_113,r_86_64_108,r_21_91_113,0.99,1,114,113,31
1,r_80_14_136,seq145,r_57_25_10,r_80_14_136,0.8,0,136,136,31
97,seq112,r_79_99_129,r_11_30_83,r_11_30_83,1.0,47,130,83,31
22,r_56_48_35,r_45_89_38,r_35_32_31,r_56_48_35,0.63,0,35,35,31
85,seq74,r_138_133_156,r_104_140_9,r_104_140_9,1.0,2,11,9,31
19,r_39_135_142,r_20_23_160,seq92,r_20_23_160,0.8,-10,150,160,31
38,r_138_133_156,r_15_119_25,seq129,r_138_133_156,0.85,0,156,156,31
38,r_138_133_156,seq74,r_15_119_25,r_15_119_25,1.0,20,45,25,31
10,r_96_27_23,seq59,r_78_110_85,r_78_110_85,0.98,49,134,85,31
90,seq93,r_108_90_171,r_121_52_16,r_108_90_171,0.99,0,171,171,31
26,r_78_110_85,seq97,seq42,r_78_110_85,0.9,0,85,85,31
4,r_20_23_160,seq73,r_78_110_85,r_20_23_160,0.49,1,161,160,31
11,r_66_72_131,seq145,r_121_52_16,r_66_72_131,1.0,0,131,131,31
15,r_144_115_91,r_66_72_131,r_143_34_15,r_144_115_91,0.69,4,95,91,31
48,r_128_60_138,seq126,r_78_110_85,r_128_60_138,0.73,1,139,138,31
99,seq126,r_128_60_138,seq62,r_128_60_138,0.94,1,139,138,31
5,r_45_89_38,seq16,seq3,r_45_89_38,0.53,70,108,38,31
71,seq43,r_45_89_38,r_144_115_91,r_45_89_38,0.74,54,92,38,31
5,r_45_89_38,seq3,r_55_10_154,r_45_89_38,0.47,108,146,38,31
20,r_130_63_14,r_45_89_38,seq4,r_130_63_14,0.86,0,14,14,31
42,r_2_81_24,r_39_135_142,seq146,r_2_81_24,1.0,0,24,24,31
14,r_82_124_41,seq146,seq37,r_82_124_41,1.0,1,42,41,31
13,r_127_65_50,r_11_30_83,seq93,r_11_30_83,0.56,-28,55,83,31
47,r_117_33_116,r_55_10_154,r_17_118_29,r_55_10_154,0.98,-38,116,154,31
40,r_69_137_147,r_149_50_1,r_132_107_32,r_149_50_1,0.53,149,150,1,31
18,r_8_87_144,seq145,seq83,r_8_87_144,0.5,2,146,144,31
46,r_75_51_170,r_113_100_28,r_17_118_29,r_17_118_29,1.0,1,30,29,31
25,r_0_148_126,seq6,r_47_125_68,r_47_125_68,0.99,61,129,68,31
33,r_108_90_171,seq93,r_143_34_15,r_143_34_15,0.88,156,171,15,31
28,r_17_118_29,r_69_137_147,r_75_51_170,r_17_118_29,1.0,1,30,29,31
68,seq40,seq12,r_24_147_167,r_24_147_167,0.74,4,171,167,31
32,r_134_95_187,r_26_1_194,r_75_51_170,r_75_51_170,0.73,17,187,170,31
45,r_35_32_31,r_88_120_56,r_13_141_168,r_13_141_168,1.0,-137,31,168,31
34,r_21_91_113,r_13_141_168,r_11_30_83,r_13_141_168,0.98,-54,114,168,31
9,r_113_100_28,r_75_51_170,seq93,r_113_100_28,0.8,2,30,28,31
41,r_143_34_15,r_121_52_16,seq12,r_143_34_15,1.0,0,15,15,31
45,r_35_32_31,r_13_141_168,r_86_64_108,r_86_64_108,0.57,18,126,108,31
7,r_88_120_56,r_61_84_133,r_2_81_24,r_88_120_56,1.0,0,56,56,31
43,r_47_125_68,r_122_106_155,r_0_148_126,r_0_148_126,0.53,-10,116,126,31
5,r_45_89_38,seq97,seq16,r_45_89_38,0.52,3,41,38,31
94,seq131,seq142,r_75_51_170,r_75_51_170,0.6,2,172,170,31
28,r_17_118_29,r_75_51_170,r_117_33_116,r_117_33_116,1.0,55,171,116,31
67,seq37,r_69_137_147,r_82_124_41,r_82_124_41,1.0,4,45,41,31
0,r_103_77_36,seq111,r_130_63_14,r_103_77_36,0.95,0,36,36,31
31,r_105_123_12,seq4,seq97,r_105_123_12,0.9,0,12,12,31
23,r_149_50_1,r_69_137_147,seq129,r_69_137_147,0.72,3,150,147,31
35,r_61_84_133,seq114,seq6,r_61_84_133,0.88,0,133,133,31
12,r_122_106_155,r_11_30_83,r_18_9_66,r_122_106_155,1.0,-72,83,155,31
29,r_15_119_25,r_39_135_142,r_104_140_9,r_15_119_25,1.0,0,25,25,31
84,seq73,r_20_23_160,seq71,r_20_23_160,0.77,1,161,160,31
40,r_41_48_6,r_125_74_173,seq103,r_125_74_173,0.71,6,179,173,32
30,r_77_57_178,seq91,r_125_74_173,r_77_57_178,0.5,0,178,178,32
0,r_38_144_110,r_129_75_35,r_67_21_167,r_129_75_35,0.63,-7,28,35,32
12,r_8_97_47,r_136_90_160,seq102,r_8_97_47,1.0,0,47,47,32
8,r_6_81_119,r_126_130_171,r_20_13_118,r_20_13_118,0.99,15,133,118,32
43,r_126_130_171,r_6_81_119,seq114,r_6_81_119,0.45,17,136,119,32
37,r_104_118_65,seq76,seq143,r_104_118_65,0.93,0,65,65,32
21,r_105_73_158,r_147_88_8,r_127_4_52,r_127_4_52,0.98,107,159,52,32
39,r_131_1_132,r_51_134_138,r_68_14_107,r_131_1_132,0.81,4,136,132,32
1,r_119_66_177,seq69,seq122,r_119_66_177,0.51,0,177,177,32
5,r_35_149_179,seq92,r_87_133_146,r_87_133_146,0.45,-17,129,146,32
69,seq50,seq7,r_117_85_93,r_117_85_93,1.0,1,94,93,32
34,r_18_33_12,r_125_74_173,seq111,r_18_33_12,0.85,-2,10,12,32
31,r_146_99_125,seq39,r_148_47_90,r_146_99_125,0.81,1,126,125,32
41,r_139_32_91,seq132,seq49,r_139_32_91,1.0,0,91,91,32
67,seq46,r_131_1_132,r_29_140_56,r_29_140_56,0.84,80,136,56,32
14,r_29_140_56,seq39,seq116,r_29_140_56,1.0,0,56,56,32
3,r_113_137_157,r_15_45_9,r_6_81_119,r_113_137_157,0.66,0,157,157,32
10,r_54_124_101,seq82,seq132,r_54_124_101,1.0,2,103,101,32
35,r_11_135_55,r_20_13_118,seq93,r_11_135_55,0.63,0,55,55,32
26,r_65_115_85,r_12_23_60,r_30_28_18,r_65_115_85,0.92,6,91,85,32
11,r_108_2_14,r_145_101_81,seq59,r_108_2_14,0.98,0,14,14,32
73,seq61,r_53_56_144,r_139_32_91,r_139_32_91,1.0,55,146,91,32
65,seq39,r_29_140_56,seq141,r_29_140_56,1.0,-2,54,56,32
98,seq122,r_6_81_119,r_54_124_101,r_54_124_101,0.98,35,136,101,32
15,r_5_44_115,seq72,r_68_14_107,r_5_44_115,0.98,0,115,115,32
65,seq39,seq141,r_68_14_107,r_68_14_107,1.0,0,107,107,32
57,seq143,seq55,r_104_118_65,r_104_118_65,1.0,4,69,65,32
6,r_79_107_58,r_68_14_107,seq60,r_79_107_58,1.0,2,60,58,32
89,seq102,seq106,r_8_97_47,r_8_97_47,1.0,1,48,47,32
85,seq92,r_35_149_179,r_87_133_146,r_35_149_179,0.58,-32,147,179,32
42,r_42_52_32,seq114,r_147_88_8,r_42_52_32,1.0,0,32,32,32
36,r_125_74_173,r_41_48_6,r_77_57_178,r_77_57_178,0.61,1,179,178,32
27,r_64_3_104,seq25,seq9,r_64_3_104,0.86,2,106,104,32
47,r_67_21_167,seq26,r_117_85_93,r_117_85_93,0.97,74,167,93,32
18,r_51_134_138,r_131_1_132,r_15_45_9,r_51_134_138,0.8,0,138,138,32
24,r_68_14_107,seq34,seq39,r_68_14_107,1.0,0,107,107,32
5,r_35_149_179,r_87_133_146,seq46,r_35_149_179,0.97,0,179,179,32
25,r_53_56_144,seq61,seq19,r_53_56_144,0.53,2,146,144,32
64,seq34,r_68_14_107,r_121_16_15,r_68_14_107,0.55,-45,62,107,32
68,seq49,r_53_56_144,r_139_32_91,r_139_32_91,1.0,39,130,91,32
38,r_20_13_118,r_80_89_195,r_6_81_119,r_20_13_118,1.0,0,118,118,32
67,seq46,r_29_140_56,r_35_149_179,r_35_149_179,0.83,0,179,179,32
46,r_86_0_54,seq93,seq17,r_86_0_54,0.99,1,55,54,32
43,r_126_130_171,seq114,r_40_27_30,r_126_130_171,0.98,0,171,171,32
96,seq116,seq46,r_29_140_56,r_29_140_56,1.0,8,64,56,32
22,r_117_85_93,r_119_66_177,seq50,r_117_85_93,1.0,1,94,93,32
28,r_148_47_90,seq122,seq72,r_148_47_90,0.98,0,90,90,32
44,r_100_58_78,r_136_90_160,seq49,r_100_58_78,1.0,0,78,78,32
20,r_98_95_51,r_119_66_177,seq9,r_98_95_51,1.0,0,51,51,32
23,r_37_83_77,r_105_73_158,seq109,r_37_83_77,1.0,0,77,77,32
7,r_129_75_35,r_38_144_110,r_147_88_8,r_129_75_35,1.0,-3,32,35,32
16,r_127_4_52,r_148_47_90,r_12_23_60,r_12_23_60,0.86,-8,52,60,32
51,seq1,seq63,r_66_91_67,r_66_91_67,1.0,6,73,67,33
33,r_16_97_51,r_143_122_124,seq76,r_16_97_51,1.0,0,51,51,33
6,r_143_122_124,r_16_97_51,seq4,r_16_97_51,1.0,1,52,51,33
14,r_124_20_68,r_61_120_102,seq145,r_124_20_68,0.89,37,105,68,33
29,r_110_15_46,r_52_24_122,seq142,r_110_15_46,1.0,0,46,46,33
8,r_125_115_161,r_67_83_192,seq22,r_125_115_161,0.85,0,161,161,33
53,seq4,r_143_122_124,seq55,r_143_122_124,1.0,0,124,124,33
43,r_60_21_120,r_86_140_118,seq145,r_86_140_118,0.86,1,119,118,33
30,r_95_94_55,seq141,seq87,r_95_94_55,1.0,1,56,55,33
37,r_30_28_158,r_11_102_162,r_128_71_101,r_30_28_158,0.97,0,158,158,33
59,seq142,r_127_80_149,r_110_15_46,r_110_15_46,0.82,18,64,46,33
26,r_118_8_40,seq18,r_39_36_98,r_118_8_40,0.99,0,40,40,33
19,r_61_120_102,r_11_102_162,seq18,r_11_102_162,1.0,1,163,162,33
16,r_100_121_159,seq22,r_64_137_50,r_100_121_159,0.81,1,160,159,33
82,seq76,r_59_54_160,r_16_97_51,r_16_97_51,1.0,2,53,51,33
39,r_82_113_78,seq43,seq12,r_82_113_78,1.0,0,78,78,33
1,r_133_112_17,r_86_140_118,seq41,r_86_140_118,0.98,1,119,118,33
46,r_29_72_125,seq106,r_64_137_50,r_29_72_125,0.98,0,125,125,33
42,r_75_147_59,seq23,r_127_80_149,r_75_147_59,0.88,2,61,59,33
86,seq87,seq96,r_95_94_55,r_95_94_55,1.0,3,58,55,33
27,r_134_32_24,r_135_14_193,seq49,r_134_32_24,0.92,1,25,24,33
19,r_61_120_102,r_124_20_68,r_11_102_162,r_124_20_68,0.87,30,98,68,33
1,r_133_112_17,seq76,r_86_140_118,r_133_112_17,0.95,2,19,17,33
95,seq108,r_62_129_94,r_27_58_9,r_62_129_94,1.0,0,94,94,33
31,r_11_102_162,r_30_28_158,r_135_14_193,r_30_28_158,0.54,4,162,158,33
3,r_130_50_65,r_59_54_160,seq142,r_130_50_65,1.0,0,65,65,33
72,seq44,seq49,r_48_99_104,r_48_99_104,1.0,6,110,104,33
12,r_104_51_11,r_138_5_129,r_59_54_160,r_104_51_11,1.0,0,11,11,33
4,r_67_83_192,r_125_115_161,seq55,r_125_115_161,0.97,0,161,161,33
47,r_69_146_137,r_124_20_68,r_89_40_174,r_69_146_137,0.75,1,138,137,33
0,r_127_80_149,seq84,r_75_147_59,r_75_147_59,0.99,3,62,59,33
11,r_138_5_129,r_86_140_118,seq90,r_86_140_118,0.94,1,119,118,33
20,r_39_36_98,seq19,r_64_137_50,r_39_36_98,0.93,1,99,98,33
13,r_117_6_95,seq141,seq9,r_117_6_95,0.99,0,95,95,33
48,r_42_139_143,seq17,seq105,r_42_139_143,0.83,0,143,143,33
62,seq19,r_39_36_98,seq105,r_39_36_98,1.0,2,100,98,33
85,seq84,r_127_80_149,r_130_50_65,r_130_50_65,0.71,39,104,65,33
0,r_127_80_149,r_75_147_59,r_104_51_11,r_127_80_149,1.0,1,150,149,33
47,r_69_146_137,seq38,r_124_20_68,r_124_20_68,0.85,30,98,68,33
40,r_3_34_150,r_135_14_193,seq141,r_3_34_150,0.9,0,150,150,33
74,seq46,r_7_35_140,seq13,r_7_35_140,0.97,0,140,140,33
18,r_128_71_101,r_59_54_160,seq17,r_128_71_101,1.0,0,101,101,33
45,r_64_137_50,r_30_28_158,r_39_36_98,r_64_137_50,0.59,49,99,50,33
24,r_7_35_140,seq46,seq38,r_7_35_140,0.96,0,140,140,33
36,r_33_57_54,r_127_80_149,seq1,r_33_57_54,0.96,3,57,54,33
25,r_86_140_118,r_138_5_129,r_74_131_107,r_86_140_118,0.75,1,119,118,33
6,r_143_122_124,seq4,r_135_14_193,r_143_122_124,1.0,0,124,124,33
65,seq25,r_60_21_120,seq41,r_60_21_120,0.41,-10,110,120,33
42,r_75_147_59,r_127_80_149,r_130_50_65,r_127_80_149,1.0,0,149,149,33
38,r_48_99_104,seq12,seq44,r_48_99_104,0.99,0,104,104,33
77,seq55,r_101_88_178,seq4,r_101_88_178,0.84,0,178,178,33
34,r_62_129_94,seq108,seq123,r_62_129_94,1.0,0,94,94,33
45,r_64_137_50,seq9,r_30_28_158,r_64_137_50,0.54,2,52,50,33
26,r_118_8_40,r_39_36_98,r_81_93_76,r_118_8_40,0.71,55,95,40,33
81,seq73,seq107,r_128_71_101,r_128_71_101,1.0,44,145,101,33
84,seq141,r_133_112_17,r_3_34_150,r_3_34_150,1.0,0,150,150,33
17,r_119_109_163,seq126,seq87,r_119_109_163,0.86,0,163,163,33
22,r_114_149_112,r_79_144_172,r_82_113_78,r_114_149_112,1.0,0,112,112,33
28,r_66_91_67,seq126,seq1,r_66_91_67,1.0,0,67,67,33
49,r_81_93_76,r_47_77_186,r_118_8_40,r_81_93_76,1.0,0,76,76,33
7,r_52_24_122,r_3_34_150,r_118_8_40,r_52_24_122,0.74,0,122,122,33
35,r_89_40_174,r_69_146_137,r_52_24_122,r_89_40_174,0.96,1,175,174,33
23,r_101_88_178,seq55,seq26,r_101_88_178,0.67,0,178,178,33
47,r_69_146_137,r_89_40_174,r_27_58_9,r_89_40_174,1.0,1,175,174,33
35,r_89_40_174,r_7_35_140,r_69_146_137,r_89_40_174,0.88,-38,136,174,33
44,r_32_6_175,r_69_141_33,seq14,r_32_6_175,0.96,0,175,175,34
51,seq131,r_108_94_137,seq139,r_108_94_137,0.93,8,145,137,34
32,r_44_121_14,r_73_147_157,seq124,r_44_121_14,0.98,0,14,14,34
16,r_88_76_152,seq41,r_119_29_107,r_119_29_107,0.6,46,153,107,34
21,r_101_4_180,seq43,r_50_65_155,r_101_4_180,0.5,0,180,180,34
1,r_82_26_29,r_24_48_163,seq127,r_24_48_163,0.41,1,164,163,34
5,r_119_29_107,seq62,r_0_23_5,r_119_29_107,1.0,0,107,107,34
46,r_108_94_137,seq131,r_115_18_91,r_115_18_91,0.62,64,155,91,34
42,r_87_46_195,r_33_20_176,r_8_60_183,r_33_20_176,0.98,0,176,176,34
64,seq27,r_75_116_49,r_3_85_46,r_3_85_46,0.86,3,49,46,34
14,r_3_85_46,seq58,seq27,r_3_85_46,1.0,0,46,46,34
45,r_86_134_132,seq124,r_8_60_183,r_86_134_132,0.92,0,132,132,34
31,r_56_17_184,seq145,r_132_53_153,r_56_17_184,0.46,0,184,184,34
41,r_146_68_81,r_92_136_125,r_115_18_91,r_146_68_81,1.0,10,91,81,34
15,r_66_25_141,r_82_26_29,seq143,r_66_25_141,0.83,-3,138,141,34
71,seq40,r_132_53_153,r_93_72_27,r_93_72_27,1.0,1,28,27,34
3,r_96_95_165,r_32_6_175,r_21_142_53,r_32_6_175,0.62,-9,166,175,34
26,r_98_35_100,seq143,r_89_91_6,r_98_35_100,0.88,1,101,100,34
72,seq41,r_88_76_152,seq139,r_88_76_152,0.89,1,153,152,34
0,r_73_147_157,seq135,r_132_53_153,r_73_147_157,0.67,0,157,157,34
11,r_1_70_146,r_84_118_196,r_132_53_153,r_1_70_146,0.7,0,146,146,34
2,r_132_53_153,r_128_148_43,r_93_72_27,r_132_53_153,0.84,-110,43,153,34
20,r_74_144_67,r_126_110_193,seq16,r_74_144_67,0.86,4,71,67,34
98,seq125,r_80_129_122,r_51_105_71,r_51_105_71,1.0,54,125,71,34
15,r_66_25_141,r_92_136_125,r_82_26_29,r_82_26_29,0.6,96,125,29,34
13,r_69_141_33,r_32_6_175,r_128_148_43,r_32_6_175,0.89,-8,167,175,34
6,r_24_48_163,r_38_22_75,r_82_26_29,r_24_48_163,0.92,-88,75,163,34
2,r_132_53_153,r_93_72_27,r_1_70_146,r_132_53_153,0.71,1,154,153,34
13,r_69_141_33,r_88_76_152,r_32_6_175,r_69_141_33,0.99,0,33,33,34
10,r_21_142_53,seq117,r_96_95_165,r_96_95_165,0.77,21,186,165,34
27,r_83_120_121,seq59,r_0_23_5,r_83_120_121,0.99,0,121,121,34
25,r_140_138_38,r_84_118_196,seq5,r_140_138_38,1.0,0,38,38,34
47,r_33_20_176,r_87_46_195,r_111_15_147,r_87_46_195,0.61,-19,176,195,34
40,r_112_39_106,seq109,r_90_123_96,r_112_39_106,1.0,0,106,106,34
18,r_90_123_96,r_56_17_184,r_3_85_46,r_3_85_46,0.84,50,96,46,34
88,seq139,r_21_142_53,r_98_35_100,r_21_142_53,0.71,1,54,53,34
7,r_7_10_20,r_93_72_27,seq135,r_7_10_20,1.0,0,20,20,34
33,r_115_18_91,seq14,r_146_68_81,r_115_18_91,1.0,0,91,91,34
6,r_24_48_163,r_82_26_29,r_132_53_153,r_132_53_153,0.7,10,163,153,34
1,r_82_26_29,r_73_147_157,r_24_48_163,r_82_26_29,1.0,0,29,29,34
61,seq145,r_56_17_184,r_113_79_3,r_56_17_184,0.62,-4,180,184,34
34,r_92_136_125,r_66_25_141,seq2,r_92_136_125,0.96,0,125,125,34
60,seq16,seq64,r_74_144_67,r_74_144_67,0.54,11,78,67,34
17,r_57_61_73,seq5,seq139,r_57_61_73,0.97,0,73,73,34
9,r_102_133_130,seq109,seq58,r_102_133_130,0.8,0,130,130,34
28,r_75_116_49,r_73_147_157,r_113_79_3,r_75_116_49,0.59,0,49,49,34
22,r_104_122_128,seq43,seq64,r_104_122_128,1.0,1,129,128,34
96,seq117,r_73_147_157,r_21_142_53,r_73_147_157,0.64,-102,55,157,34
36,r_128_148_43,r_132_53_153,r_69_141_33,r_128_148_43,1.0,0,43,43,34
49,r_51_105_71,seq106,seq125,r_51_105_71,1.0,0,71,71,34
44,r_32_6_175,seq64,r_69_141_33,r_69_141_33,0.99,33,66,33,34
23,r_50_65_155,seq19,r_140_138_38,r_140_138_38,0.56,117,155,38,34
29,r_93_72_27,r_132_53_153,seq40,r_132_53_153,0.98,1,154,153,34
79,seq59,r_83_120_121,seq19,r_83_120_121,1.0,0,121,121,34
35,r_38_22_75,seq127,seq31,r_38_22_75,1.0,0,75,75,34
30,r_147_130_143,seq146,r_83_41_104,r_147_130_143,0.84,0,143,143,35
92,seq111,r_66_131_133,r_44_145_66,r_44_145_66,1.0,16,82,66,35
14,r_44_145_66,seq1,seq111,r_44_145_66,1.0,1,67,66,35
8,r_3_106_135,r_87_127_183,r_83_41_104,r_83_41_104,0.59,31,135,104,35
43,r_18_31_119,seq123,seq138,r_18_31_119,1.0,0,119,119,35
83,seq84,r_112_120_138,r_114_26_51,r_112_120_138,0.7,-3,135,138,35
36,r_61_135_18,r_66_131_133,seq43,r_61_135_18,0.97,0,18,18,35
37,r_134_11_71,seq23,seq58,r_134_11_71,1.0,3,74,71,35
10,r_16_12_10,r_60_105_85,seq69,r_16_12_10,1.0,0,10,10,35
86,seq94,seq146,r_100_108_116,r_100_108_116,1.0,0,116,116,35
26,r_47_136_181,r_114_26_51,r_14_30_16,r_114_26_51,0.85,1,52,51,35
16,r_48_36_144,r_90_125_156,r_66_131_133,r_48_36_144,0.86,0,144,144,35
21,r_39_68_99,seq97,r_134_11_71,r_134_11_71,1.0,31,102,71,35
1,r_85_27_95,seq35,seq73,r_85_27_95,1.0,1,96,95,35
46,r_116_113_70,seq15,seq104,r_116_113_70,0.65,18,88,70,35
8,r_3_106_135,r_83_41_104,r_90_125_156,r_90_125_156,0.84,2,158,156,35
45,r_2_33_189,seq115,r_16_12_10,r_16_12_10,0.71,180,190,10,35
70,seq58,r_134_11_71,r_54_86_167,r_54_86_167,0.52,-39,128,167,35
87,seq97,r_54_86_167,r_77_56_125,r_77_56_125,0.86,12,137,125,35
24,r_71_91_168,seq78,r_109_119_27,r_71_91_168,0.57,1,169,168,35
19,r_38_62_113,seq40,seq23,r_38_62_113,0.99,0,113,113,35
75,seq69,r_3_106_135,r_16_12_10,r_16_12_10,0.99,0,10,10,35
66,seq40,r_38_62_113,seq53,r_38_62_113,1.0,0,113,113,35
76,seq72,r_70_75_65,r_55_126_96,r_70_75_65,1.0,2,67,65,35
31,r_96_140_102,seq28,r_117_132_62,r_96_140_102,0.86,0,102,102,35
41,r_70_75_65,seq72,seq123,r_70_75_65,1.0,0,65,65,35
24,r_71_91_168,r_98_42_117,seq78,r_71_91_168,0.59,-125,43,168,35
3,r_64_17_141,r_83_41_104,seq1,r_64_17_141,0.87,1,142,141,35
72,seq138,r_83_41_104,r_18_31_119,r_18_31_119,0.98,3,122,119,35
72,seq138,r_34_57_83,r_83_41_104,r_34_57_83,0.77,-8,75,83,35
4,r_90_125_156,seq78,r_3_106_135,r_90_125_156,0.61,1,157,156,35
0,r_98_42_117,seq43,seq53,r_98_42_117,0.96,0,117,117,35
11,r_34_57_83,seq138,r_117_132_62,r_34_57_83,0.99,0,83,83,35
28,r_81_139_21,r_45_8_54,seq21,r_81_139_21,0.8,4,25,21,35
20,r_60_105_85,seq73,seq133,r_60_105_85,0.95,0,85,85,35
13,r_65_51_158,seq79,r_29_22_94,r_65_51_158,0.69,1,159,158,35
48,r_87_127_183,seq69,r_38_62_113,r_87_127_183,0.54,0,183,183,35
34,r_45_8_54,r_18_31_119,seq4,r_45_8_54,0.89,1,55,54,35
6,r_100_108_116,r_83_41_104,seq94,r_100_108_116,0.9,0,116,116,35
39,r_50_20_38,r_45_8_54,r_101_74_7,r_50_20_38,1.0,0,38,38,35
87,seq97,r_39_68_99,r_54_86_167,r_39_68_99,0.93,7,106,99,35
37,r_134_11_71,seq58,r_39_68_99,r_134_11_71,0.56,57,128,71,35
47,r_142_128_34,r_114_26_51,seq4,r_142_128_34,1.0,1,35,34,35
78,seq76,r_54_86_167,r_109_119_27,r_109_119_27,1.0,24,51,27,35
18,r_77_56_125,seq146,r_16_12_10,r_77_56_125,0.99,0,125,125,35
29,r_7_37_126,r_87_127_183,seq133,r_7_37_126,0.87,1,127,126,35
22,r_101_74_7,r_98_42_117,r_50_20_38,r_101_74_7,0.68,33,40,7,35
25,r_19_0_63,r_117_132_62,seq102,r_19_0_63,0.58,-1,62,63,35
61,seq21,r_54_86_167,r_81_139_21,r_81_139_21,0.46,1,22,21,35
70,seq58,r_7_37_126,r_134_11_71,r_134_11_71,1.0,7,78,71,35
38,r_92_95_107,seq6,r_55_126_96,r_92_95_107,0.74,2,109,107,35
2,r_114_26_51,r_47_136_181,seq124,r_114_26_51,0.94,1,52,51,35
17,r_29_22_94,r_2_33_189,seq93,r_29_22_94,0.92,2,96,94,35
9,r_55_126_96,r_47_136_181,r_92_95_107,r_92_95_107,1.0,3,110,107,35
91,seq110,r_49_143_171,seq115,r_49_143_171,0.7,0,171,171,35
49,r_49_143_171,seq110,r_16_12_10,r_49_143_171,0.59,0,171,171,35
7,r_83_41_104,r_64_17_141,r_147_130_143,r_83_41_104,0.84,46,150,104,35
12,r_99_107_49,r_116_113_70,seq146,r_116_113_70,0.92,-18,52,70,35
40,r_109_119_27,r_2_33_189,seq76,r_109_119_27,1.0,0,27,27,35
79,seq78,r_90_125_156,seq102,r_90_125_156,0.98,1,157,156,35
35,r_112_120_138,seq124,r_70_75_65,r_70_75_65,0.71,73,138,65,35
44,r_17_23_42,r_115_9_130,r_123_145_119,r_17_23_42,1.0,81,123,42,36
36,r_108_90_169,r_4_131_177,seq12,r_108_90_169,0.72,1,170,169,36
8,r_2_50_125,seq3,r_138_28_41,r_138_28_41,0.81,84,125,41,36
54,seq136,r_81_86_103,r_134_130_97,r_81_86_103,0.66,1,104,103,36
37,r_48_77_123,seq91,r_32_70_19,r_48_77_123,0.98,0,123,123,36
16,r_79_45_93,seq85,r_53_106_140,r_79_45_93,1.0,1,94,93,36
21,r_115_9_130,r_17_23_42,seq76,r_115_9_130,0.5,2,132,130,36
29,r_56_147_32,r_81_86_103,seq44,r_56_147_32,0.92,0,32,32,36
42,r_122_26_68,seq92,r_10_30_199,r_122_26_68,0.83,4,72,68,36
13,r_133_110_91,r_95_113_34,r_35_58_16,r_133_110_91,0.52,-50,41,91,36
45,r_32_70_19,r_15_124_132,seq146,r_32_70_19,0.68,3,22,19,36
15,r_7_24_190,r_49_105_121,r_11_80_146,r_7_24_190,0.7,0,190,190,36
1,r_41_5_25,r_137_64_117,seq109,r_41_5_25,1.0,0,25,25,36
27,r_19_96_8,r_99_73_96,r_8_112_59,r_19_96_8,1.0,88,96,8,36
24,r_38_40_94,r_79_45_93,r_138_28_41,r_38_40_94,0.79,-52,42,94,36
39,r_138_28_41,r_38_40_94,r_2_50_125,r_2_50_125,0.94,0,125,125,36
31,r_137_64_117,seq0,r_128_117_46,r_128_117_46,0.52,73,119,46,36
41,r_148_103_179,r_49_105_121,r_81_86_103,r_148_103_179,0.86,-74,105,179,36
93,seq109,r_78_33_158,r_41_5_25,r_41_5_25,1.0,10,35,25,36
3,r_10_30_199,seq118,r_122_26_68,r_10_30_199,0.55,-127,72,199,36
47,r_95_113_34,r_133_110_91,r_10_30_199,r_95_113_34,0.73,13,47,34,36
38,r_8_112_59,r_4_131_177,r_19_96_8,r_8_112_59,1.0,0,59,59,36
5,r_69_140_33,seq118,seq57,r_69_140_33,1.0,0,33,33,36
4,r_49_105_121,seq72,seq141,r_49_105_121,0.95,1,122,121,36
0,r_121_18_107,r_49_105_121,seq109,r_121_18_107,1.0,-1,106,107,36
11,r_128_117_46,seq21,r_137_64_117,r_137_64_117,0.9,5,122,117,36
20,r_139_20_101,seq129,r_143_142_192,r_139_20_101,0.88,0,101,101,36
44,r_17_23_42,r_81_86_103,r_115_9_130,r_81_86_103,1.0,-45,58,103,36
15,r_7_24_190,seq141,r_49_105_121,r_49_105_121,1.0,43,164,121,36
48,r_47_84_151,r_53_106_140,seq75,r_47_84_151,0.86,1,152,151,36
12,r_81_86_103,r_148_103_179,r_69_140_33,r_148_103_179,0.95,0,179,179,36
6,r_89_27_104,seq109,seq72,r_89_27_104,1.0,0,104,104,36
85,seq91,r_48_77_123,seq120,r_48_77_123,1.0,0,123,123,36
2,r_99_73_96,r_19_96_8,seq71,r_99_73_96,0.92,0,96,96,36
87,seq94,seq60,r_148_103_179,r_148_103_179,0.67,4,183,179,36
39,r_138_28_41,r_15_124_132,r_38_40_94,r_138_28_41,1.0,0,41,41,36
34,r_11_80_146,seq60,r_7_24_190,r_11_80_146,0.9,43,189,146,36
49,r_46_107_53,r_121_18_107,seq1,r_46_107_53,1.0,1,54,53,36
41,r_148_103_179,r_81_86_103,seq94,r_148_103_179,0.98,0,179,179,36
18,r_68_93_134,seq57,r_133_110_91,r_68_93_134,0.91,1,135,134,36
25,r_65_61_129,seq52,r_55_37_108,r_55_37_108,0.96,23,131,108,36
33,r_6_101_183,seq146,seq74,r_6_101_183,0.26,2,185,183,36
23,r_63_13_11,r_78_33_158,seq118,r_63_13_11,0.66,3,14,11,36
58,seq146,r_6_101_183,r_32_70_19,r_32_70_19,0.45,132,151,19,36
65,seq135,r_143_142_192,r_139_20_101,r_139_20_101,0.74,56,157,101,36
32,r_55_37_108,seq29,r_4_131_177,r_55_37_108,0.93,0,108,108,36
96,seq118,r_69_140_33,r_63_13_11,r_69_140_33,0.97,0,33,33,36
46,r_100_111_54,r_79_45_93,seq3,r_79_45_93,0.59,-38,55,93,36
17,r_67_14_106,r_48_77_123,seq16,r_48_77_123,0.91,-18,105,123,36
28,r_15_124_132,seq74,seq120,r_15_124_132,0.95,0,132,132,36
35,r_134_130_97,seq75,seq136,r_134_130_97,0.79,1,98,97,36
12,r_81_86_103,seq136,r_148_103_179,r_81_86_103,0.99,1,104,103,36
30,r_108_69_97,r_105_38_100,r_53_82_105,r_108_69_97,1.0,8,105,97,37
48,r_8_7_60,r_133_117_114,seq44,r_133_117_114,1.0,0,114,114,37
92,seq114,r_27_65_182,r_137_22_41,r_137_22_41,0.79,142,183,41,37
8,r_121_141_117,r_5_55_174,r_106_25_56,r_5_55_174,0.99,-57,117,174,37
17,r_51_29_51,r_41_49_95,seq47,r_51_29_51,0.92,-1,50,51,37
42,r_52_60_26,r_109_11_22,seq45,r_52_60_26,0.72,0,26,26,37
44,r_123_90_175,r_106_25_56,seq10,r_123_90_175,0.95,0,175,175,37
24,r_87_83_49,r_138_19_153,seq127,r_87_83_49,1.0,0,49,49,37
40,r_84_104_135,r_14_70_31,r_73_71_98,r_84_104_135,0.84,2,137,135,37
71,seq44,r_4_131_109,r_108_69_97,r_4_131_109,0.79,-13,96,109,37
16,r_5_55_174,r_121_141_117,r_6_113_66,r_6_113_66,0.57,0,66,66,37
21,r_97_76_147,seq85,r_106_25_56,r_97_76_147,0.95,2,149,147,37
1,r_81_17_148,r_34_12_162,r_111_96_43,r_111_96_43,0.93,132,175,43,37
97,seq122,r_33_110_156,seq115,r_33_110_156,0.98,1,157,156,37
5,r_105_38_100,r_108_69_97,r_97_76_147,r_105_38_100,1.0,1,101,100,37
46,r_28_43_183,seq85,r_133_117_114,r_28_43_183,0.33,0,183,183,37
7,r_6_113_66,r_5_55_174,r_37_32_152,r_6_113_66,0.75,108,174,66,37
13,r_106_25_56,r_4_131_109,seq9,r_106_25_56,1.0,0,56,56,37
41,r_23_91_110,seq93,r_14_70_31,r_14_70_31,0.73,79,110,31,37
67,seq31,r_68_58_196,r_42_57_123,r_42_57_123,1.0,4,127,123,37
3,r_133_117_114,seq44,r_8_7_60,r_8_7_60,1.0,33,93,60,37
10,r_53_82_105,seq13,r_108_69_97,r_53_82_105,1.0,0,105,105,37
90,seq103,r_66_145_165,r_1_95_45,r_1_95_45,0.84,121,166,45,37
5,r_105_38_100,r_97_76_147,r_52_60_26,r_97_76_147,0.96,2,149,147,37
26,r_124_59_177,seq94,seq40,r_124_59_177,0.55,0,177,177,37
16,r_5_55_174,r_6_113_66,seq86,r_5_55_174,0.79,0,174,174,37
4,r_67_88_103,r_33_110_156,r_52_60_26,r_52_60_26,0.51,52,78,26,37
0,r_138_19_153,r_123_90_175,seq26,r_138_19_153,0.97,0,153,153,37
11,r_37_32_152,seq64,r_6_113_66,r_6_113_66,1.0,92,158,66,37
3,r_133_117_114,r_8_7_60,r_41_49_95,r_133_117_114,1.0,0,114,114,37
15,r_134_89_55,r_149_100_13,seq13,r_134_89_55,0.97,0,55,55,37
48,r_8_7_60,seq45,r_133_117_114,r_8_7_60,1.0,0,60,60,37
6,r_4_131_109,seq18,seq85,r_4_131_109,1.0,1,110,109,37
62,seq18,r_4_131_109,seq72,r_4_131_109,1.0,1,110,109,37
27,r_42_57_123,r_66_145_165,seq31,r_42_57_123,0.99,0,123,123,37
49,r_147_116_139,r_24_98_23,r_73_71_98,r_147_116_139,1.0,0,139,139,37
47,r_128_79_179,r_27_65_182,r_123_90_175,r_128_79_179,0.6,0,179,179,37
36,r_1_95_45,seq135,seq103,r_1_95_45,1.0,1,46,45,37
38,r_111_96_43,r_125_50_143,seq74,r_111_96_43,1.0,0,43,43,37
40,r_84_104_135,seq47,r_14_70_31,r_14_70_31,1.0,66,97,31,37
18,r_34_12_162,seq119,r_53_82_105,r_34_12_162,0.74,4,166,162,37
29,r_16_107_181,seq115,r_37_32_152,r_37_32_152,0.52,30,182,152,37
19,r_137_22_41,seq0,seq114,r_137_22_41,0.94,0,41,41,37
33,r_73_71_98,seq92,seq75,r_73_71_98,0.44,37,135,98,37
53,seq135,r_24_98_23,r_129_56_10,r_129_56_10,0.96,0,10,10,37
65,seq26,r_8_7_60,r_138_19_153,r_138_19_153,0.91,0,153,153,37
31,r_112_118_34,r_51_29_51,r_46_54_129,r_112_118_34,0.95,12,46,34,37
65,seq26,seq120,r_8_7_60,r_8_7_60,1.0,0,60,60,37
2,r_109_11_22,r_52_60_26,seq40,r_52_60_26,0.53,-4,22,26,37
25,r_130_39_12,r_84_104_135,r_129_56_10,r_84_104_135,0.7,-124,11,135,37
22,r_48_140_17,r_27_65_182,seq63,r_48_140_17,0.97,1,18,17,37
25,r_130_39_12,r_129_56_10,r_46_54_129,r_46_54_129,1.0,10,139,129,37
9,r_129_56_10,r_138_19_153,seq135,r_129_56_10,0.99,0,10,10,37
31,r_112_118_34,r_46_54_129,r_52_60_26,r_46_54_129,0.7,-18,111,129,37
32,r_24_98_23,seq135,seq127,r_24_98_23,0.67,7,30,23,37
4,r_67_88_103,r_52_60_26,r_149_100_13,r_67_88_103,0.98,1,104,103,37
20,r_14_70_31,seq74,seq21,r_14_70_31,1.0,0,31,31,37
49,r_147_116_139,r_41_49_95,r_24_98_23,r_41_49_95,1.0,0,95,95,37
7,r_6_113_66,r_53_82_105,r_5_55_174,r_5_55_174,0.98,-108,66,174,37
44,r_123_90_175,r_138_19_153,r_106_25_56,r_106_25_56,1.0,97,153,56,37
23,r_46_54_129,r_28_43_183,r_130_39_12,r_46_54_129,0.98,0,129,129,37
74,seq63,seq31,r_48_140_17,r_48_140_17,0.96,8,25,17,37
35,r_33_110_156,seq122,seq35,r_33_110_156,0.81,1,157,156,37
30,r_77_33_183,seq39,r_99_126_115,r_99_126_115,1.0,1,116,115,38
92,seq106,r_94_24_64,r_131_144_15,r_94_24_64,0.85,0,64,64,38
8,r_13_117_92,seq111,seq69,r_13_117_92,1.0,1,93,92,38
16,r_17_127_107,seq102,r_9_132_188,r_17_127_107,0.61,0,107,107,38
27,r_26_82_23,seq100,r_138_53_82,r_26_82_23,0.94,0,23,23,38
80,seq74,r_47_73_69,r_113_98_41,r_113_98_41,1.0,35,76,41,38
7,r_143_16_9,r_130_86_95,seq46,r_130_86_95,1.0,3,98,95,38
45,r_80_95_123,r_134_112_152,r_41_60_16,r_80_95_123,1.0,-1,122,123,38
39,r_140_92_32,r_80_95_123,seq124,r_140_92_32,0.99,0,32,32,38
33,r_138_53_82,r_26_82_23,r_7_23_30,r_138_53_82,1.0,1,83,82,38
27,r_26_82_23,r_138_53_82,seq21,r_138_53_82,1.0,1,83,82,38
66,seq39,r_77_33_183,r_4_54_36,r_4_54_36,1.0,36,72,36,38
76,seq69,r_104_78_11,r_13_117_92,r_13_117_92,1.0,6,98,92,38
0,r_42_35_34,r_49_90_121,seq85,r_42_35_34,1.0,1,35,34,38
31,r_59_25_146,r_79_136_141,r_12_87_61,r_79_136_141,0.95,5,146,141,38
41,r_45_84_114,seq28,seq20,r_45_84_114,0.94,0,114,114,38
3,r_96_65_105,r_40_83_196,r_7_23_30,r_96_65_105,0.83,0,105,105,38
10,r_99_126_115,seq81,r_77_33_183,r_99_126_115,0.99,0,115,115,38
90,seq102,r_17_127_107,r_129_48_58,r_129_48_58,0.66,6,64,58,38
16,r_17_127_107,r_9_132_188,r_122_66_184,r_122_66_184,0.37,0,184,184,38
14,r_130_86_95,r_143_16_9,r_44_18_60,r_130_86_95,1.0,0,95,95,38
2,r_41_60_16,seq8,seq141,r_41_60_16,0.99,0,16,16,38
21,r_129_48_58,r_34_1_124,seq102,r_129_48_58,1.0,0,58,58,38
98,seq124,r_9_132_188,r_49_90_121,r_49_90_121,0.96,5,126,121,38
48,r_68_101_94,seq31,r_19_30_18,r_68_101_94,0.99,0,94,94,38
27,r_26_82_23,seq21,r_79_136_141,r_26_82_23,0.36,167,190,23,38
25,r_108_128_56,seq43,r_104_78_11,r_108_128_56,1.0,0,56,56,38
9,r_44_18_60,r_134_112_152,r_130_86_95,r_44_18_60,0.7,47,107,60,38
6,r_51_56_75,r_55_52_98,seq137,r_51_56_75,0.94,0,75,75,38
49,r_146_38_46,r_149_15_126,r_19_30_18,r_19_30_18,0.66,14,32,18,38
5,r_49_90_121,seq21,seq124,r_49_90_121,0.95,0,121,121,38
47,r_67_6_89,r_47_73_69,seq63,r_67_6_89,1.0,0,89,89,38
14,r_130_86_95,seq46,r_143_16_9,r_143_16_9,0.84,18,27,9,38
6,r_51_56_75,seq137,r_55_52_98,r_55_52_98,1.0,22,120,98,38
40,r_115_14_111,seq22,seq76,r_115_14_111,0.98,1,112,111,38
18,r_149_15_126,r_59_25_146,seq102,r_59_25_146,1.0,-18,128,146,38
1,r_118_139_63,seq148,r_104_78_11,r_118_139_63,0.9,-5,58,63,38
29,r_94_24_64,seq106,seq43,r_94_24_64,1.0,0,64,64,38
38,r_7_23_30,r_49_90_121,seq114,r_7_23_30,1.0,0,30,30,38
24,r_2_93_150,seq103,r_105_135_24,r_2_93_150,0.65,7,157,150,38
35,r_19_30_18,r_146_38_46,r_68_101_94,r_68_101_94,1.0,49,143,94,38
68,seq46,r_130_86_95,r_143_16_9,r_130_86_95,0.96,-21,74,95,38
32,r_12_87_61,r_13_117_92,seq89,r_12_87_61,1.0,0,61,61,38
26,r_10_11_12,r_77_33_183,r_47_73_69,r_10_11_12,0.9,0,12,12,38
34,r_147_120_194,r_59_25_146,seq27,r_59_25_146,0.99,-38,108,146,38
20,r_104_78_11,seq69,r_108_128_56,r_108_128_56,1.0,11,67,56,38
33,r_138_53_82,r_42_35_34,r_26_82_23,r_26_82_23,0.54,1,24,23,38
4,r_4_54_36,seq57,seq39,r_4_54_36,1.0,2,38,36,38
42,r_131_144_15,r_13_117_92,seq106,r_131_144_15,0.5,0,15,15,38
9,r_44_18_60,seq31,r_134_112_152,r_44_18_60,0.99,0,60,60,38
11,r_105_135_24,seq69,r_131_144_15,r_131_144_15,0.76,9,24,15,38
22,r_122_66_184,seq62,r_17_127_107,r_17_127_107,0.91,77,184,107,38
28,r_134_112_152,seq106,r_51_56_75,r_51_56_75,0.91,80,155,75,38
91,seq103,r_2_93_150,seq64,r_2_93_150,0.7,8,158,150,38
36,r_113_98_41,seq124,seq74,r_113_98_41,1.0,0,41,41,38
44,r_34_1_124,seq20,r_41_60_16,r_34_1_124,0.93,1,125,124,38
20,r_104_78_11,r_26_82_23,seq69,r_104_78_11,0.89,-1,10,11,38
35,r_19_30_18,seq46,r_146_38_46,r_19_30_18,0.99,3,21,18,38
88,seq148,r_118_139_63,seq103,r_118_139_63,0.87,-5,58,63,38
93,seq111,r_54_42_70,r_10_101_149,r_54_42_70,1.0,0,70,70,39
36,r_30_68_176,r_134_112_179,r_56_100_116,r_56_100_116,0.8,60,176,116,39
92,seq110,r_76_84_94,seq3,r_76_84_94,1.0,0,94,94,39
14,r_21_85_105,seq23,seq124,r_21_85_105,0.82,3,108,105,39
8,r_103_90_169,seq23,r_69_38_110,r_69_38_110,0.72,62,172,110,39
37,r_73_80_85,r_147_107_146,seq3,r_73_80_85,1.0,0,85,85,39
16,r_142_41_107,r_57_126_132,r_40_28_9,r_142_41_107,0.92,1,108,107,39
21,r_17_39_117,seq9,r_60_45_10,r_17_39_117,0.51,0,117,117,39
39,r_96_53_167,r_102_14_30,seq3,r_96_53_167,0.48,0,167,167,39
1,r_127_20_25,seq13,r_130_94_73,r_130_94_73,1.0,12,85,73,39
27,r_60_45_10,seq48,seq146,r_60_45_10,0.96,0,10,10,39
46,r_57_126_132,seq149,seq128,r_57_126_132,0.28,2,134,132,39
42,r_76_84_94,seq110,seq92,r_76_84_94,1.0,1,95,94,39
45,r_37_32_3,r_27_59_171,r_83_74_82,r_83_74_82,0.96,89,171,82,39
4,r_50_113_46,seq99,seq36,r_50_113_46,1.0,0,46,46,39
95,seq116,r_62_71_166,r_69_38_110,r_69_38_110,1.0,56,166,110,39
31,r_123_95_173,seq70,r_82_129_26,r_123_95_173,0.42,0,173,173,39
41,r_69_38_110,seq98,seq116,r_69_38_110,1.0,0,110,110,39
44,r_145_139_54,r_69_38_110,seq133,r_69_38_110,0.98,-56,54,110,39
3,r_12_11_93,r_135_114_181,r_102_14_30,r_12_11_93,0.98,0,93,93,39
10,r_63_7_127,seq44,seq87,r_63_7_127,0.95,-1,126,127,39
0,r_72_108_88,seq13,seq48,r_72_108_88,0.96,0,88,88,39
98,seq124,r_147_107_146,r_21_85_105,r_21_85_105,0.66,43,148,105,39
15,r_83_74_82,seq48,r_37_32_3,r_83_74_82,1.0,1,83,82,39
49,r_118_46_133,r_26_77_21,seq119,r_118_46_133,1.0,1,134,133,39
57,seq138,seq99,r_56_100_116,r_56_100_116,0.99,8,124,116,39
13,r_40_28_9,seq125,r_142_41_107,r_142_41_107,1.0,3,110,107,39
49,r_118_46_133,seq81,r_26_77_21,r_26_77_21,0.96,30,51,21,39
85,seq92,seq144,r_120_55_98,r_120_55_98,1.0,1,99,98,39
62,seq18,seq140,r_12_11_93,r_12_11_93,0.59,40,133,93,39
99,seq125,seq64,r_34_58_139,r_34_58_139,0.77,28,167,139,39
48,r_26_77_21,seq16,r_118_46_133,r_26_77_21,0.98,1,22,21,39
2,r_56_100_116,seq87,seq138,r_56_100_116,0.78,0,116,116,39
47,r_135_114_181,seq22,r_12_11_93,r_12_11_93,1.0,88,181,93,39
93,seq111,r_10_101_149,r_47_79_153,r_10_101_149,0.97,8,157,149,39
74,seq48,r_83_74_82,r_54_42_70,r_83_74_82,0.93,1,83,82,39
18,r_130_94_73,r_134_112_179,r_127_20_25,r_130_94_73,1.0,1,74,73,39
33,r_134_112_179,r_30_68_176,r_31_1_7,r_134_112_179,0.59,-2,177,179,39
48,r_26_77_21,r_118_46_133,r_82_129_26,r_118_46_133,1.0,1,134,133,39
6,r_137_61_39,r_47_79_153,seq3,r_137_61_39,1.0,0,39,39,39
32,r_102_14_30,r_96_53_167,r_12_11_93,r_12_11_93,1.0,74,167,93,39
38,r_34_58_139,r_96_53_167,seq125,r_34_58_139,0.86,9,148,139,39
34,r_29_25_140,r_47_79_153,seq16,r_29_25_140,0.48,1,141,140,39
81,seq81,r_82_129_26,r_26_77_21,r_26_77_21,0.86,94,115,21,39
17,r_47_79_153,seq148,seq111,r_47_79_153,0.45,5,158,153,39
9,r_19_5_182,r_78_105_165,r_17_39_117,r_17_39_117,1.0,65,182,117,39
96,seq119,r_8_143_168,r_86_2_48,r_8_143_168,0.62,-40,128,168,39
22,r_10_101_149,seq23,r_40_28_9,r_10_101_149,0.48,0,149,149,39
28,r_120_55_98,seq64,seq92,r_120_55_98,1.0,0,98,98,39
7,r_147_107_146,seq124,r_127_20_25,r_147_107_146,0.6,3,149,146,39
23,r_27_59_171,r_37_32_3,r_78_105_165,r_27_59_171,0.56,0,171,171,39
35,r_54_42_70,seq111,seq48,r_54_42_70,0.58,2,72,70,39
12,r_82_129_26,seq81,r_26_77_21,r_26_77_21,0.85,70,91,21,39
19,r_117_24_57,r_21_85_105,seq64,r_117_24_57,0.64,0,57,57,39
41,r_62_88_53,r_76_50_164,r_6_36_174,r_62_88_53,0.57,122,175,53,40
30,r_98_72_113,seq16,r_142_29_66,r_142_29_66,0.92,50,116,66,40
36,r_38_95_127,r_54_117_158,seq11,r_38_95_127,0.75,0,127,127,40
40,r_141_147_21,r_142_29_66,r_127_74_38,r_142_29_66,0.96,-1,65,66,40
8,r_63_78_31,r_44_32_192,r_85_126_27,r_44_32_192,0.78,-161,31,192,40
7,r_9_65_15,r_21_60_2,seq22,r_9_65_15,1.0,0,15,15,40
83,seq93,r_94_104_140,seq64,r_94_104_140,1.0,1,141,140,40
31,r_42_39_84,seq110,r_90_24_124,r_90_24_124,0.95,-2,122,124,40
86,seq101,r_40_23_183,r_8_61_153,r_8_61_153,0.76,2,155,153,40
21,r_83_114_147,seq131,r_75_46_36,r_75_46_36,0.98,120,156,36,40
39,r_58_30_86,r_94_104_140,seq17,r_58_30_86,0.86,0,86,86,40
1,r_99_148_155,seq146,r_67_10_69,r_67_10_69,1.0,90,159,69,40
5,r_34_2_106,r_48_134_146,r_62_88_53,r_48_134_146,0.81,-4,142,146,40
42,r_144_66_154,seq47,seq5,r_144_66_154,0.43,0,154,154,40
45,r_135_129_133,seq3,r_57_125_93,r_135_129_133,0.55,1,134,133,40
19,r_57_125_93,r_26_136_115,r_141_147_21,r_141_147_21,0.59,73,94,21,40
76,seq139,r_26_136_115,r_9_65_15,r_9_65_15,0.94,110,125,15,40
31,r_42_39_84,seq55,seq110,r_42_39_84,0.79,1,85,84,40
3,r_21_60_2,r_48_134_146,seq70,r_48_134_146,0.83,-37,109,146,40
10,r_106_35_121,seq110,seq70,r_106_35_121,0.95,0,121,121,40
26,r_7_143_100,seq15,r_9_65_15,r_9_65_15,0.97,86,101,15,40
4,r_40_23_183,seq101,r_92_0_165,r_40_23_183,0.47,1,184,183,40
78,seq80,r_76_50_164,r_63_78_31,r_63_78_31,0.94,136,167,31,40
0,r_25_4_64,r_57_125_93,seq100,r_57_125_93,0.6,-18,75,93,40
73,seq56,r_73_119_172,seq64,r_73_119_172,0.55,0,172,172,40
11,r_6_36_174,seq47,r_34_2_106,r_6_36_174,0.6,-1,173,174,40
20,r_76_50_164,seq80,r_106_35_121,r_106_35_121,0.73,46,167,121,40
15,r_90_24_124,seq91,r_42_39_84,r_90_24_124,0.99,0,124,124,40
48,r_48_134_146,r_34_2_106,r_92_0_165,r_34_2_106,0.95,4,110,106,40
25,r_142_29_66,r_92_0_165,r_98_72_113,r_142_29_66,0.7,95,161,66,40
32,r_92_0_165,r_142_29_66,seq110,r_92_0_165,0.97,2,167,165,40
41,r_62_88_53,r_48_134_146,r_76_50_164,r_48_134_146,0.81,-4,142,146,40
47,r_67_10_69,r_84_19_59,r_144_66_154,r_144_66_154,0.9,-78,76,154,40
14,r_85_126_27,seq115,seq16,r_85_126_27,1.0,0,27,27,40
43,r_52_82_10,r_76_50_164,seq138,r_52_82_10,0.97,5,15,10,40
18,r_13_51_184,seq41,r_84_19_59,r_84_19_59,1.0,14,73,59,40
29,r_71_128_176,r_54_117_158,seq138,r_54_117_158,0.63,-11,147,158,40
24,r_109_149_136,seq137,seq115,r_109_149_136,0.38,2,138,136,40
92,seq110,r_58_30_86,r_92_0_165,r_92_0_165,0.95,7,172,165,40
47,r_67_10_69,r_144_66_154,r_99_148_155,r_144_66_154,0.96,0,154,154,40
50,seq1,r_54_117_158,seq138,r_54_117_158,0.86,-3,155,158,40
44,r_75_46_36,r_76_50_164,seq3,r_75_46_36,1.0,0,36,36,40
6,r_45_111_7,r_40_23_183,r_8_61_153,r_8_61_153,0.67,31,184,153,40
68,seq41,r_13_51_184,r_84_19_59,r_84_19_59,1.0,18,77,59,40
32,r_92_0_165,r_68_112_111,r_142_29_66,r_92_0_165,0.58,-54,111,165,40
38,r_54_117_158,seq1,r_84_19_59,r_84_19_59,0.99,96,155,59,40
25,r_142_29_66,r_141_147_21,r_92_0_165,r_142_29_66,1.0,0,66,66,40
25,r_142_29_66,r_6_36_174,r_141_147_21,r_141_147_21,1.0,0,21,21,40
29,r_71_128_176,seq138,seq17,r_71_128_176,0.5,0,176,176,40
98,seq123,r_21_60_2,r_27_20_94,r_27_20_94,0.68,4,98,94,40
17,r_68_112_111,r_92_0_165,seq15,r_68_112_111,0.99,0,111,111,40
9,r_79_118_186,seq93,r_106_35_121,r_106_35_121,0.98,66,187,121,40
13,r_140_37_104,r_31_77_49,seq41,r_31_77_49,0.99,0,49,49,40
22,r_87_145_83,r_90_24_124,seq16,r_90_24_124,0.9,-15,109,124,40
28,r_8_61_153,seq120,r_45_111_7,r_8_61_153,0.77,3,156,153,40
91,seq146,r_99_148_155,r_48_134_146,r_48_134_146,1.0,13,159,146,40
49,r_27_20_94,seq70,seq123,r_27_20_94,0.76,3,97,94,40
33,r_31_77_49,r_140_37_104,seq18,r_31_77_49,0.93,0,49,49,40
18,r_13_51_184,r_84_19_59,r_6_36_174,r_84_19_59,0.45,125,184,59,40
40,r_141_147_21,r_62_88_53,r_142_29_66,r_141_147_21,0.99,1,22,21,40
35,r_26_136_115,seq139,seq146,r_26_136_115,0.5,10,125,115,40
5,r_34_2_106,r_62_88_53,r_6_36_174,r_6_36_174,0.9,-3,171,174,40
12,r_127_74_38,r_68_112_111,r_141_147_21,r_127_74_38,0.99,0,38,38,40
48,r_48_134_146,r_92_0_165,seq146,r_48_134_146,0.82,0,146,146,40
30,r_130_9_99,r_88_138_190,seq108,r_130_9_99,1.0,0,99,99,41
92,seq113,r_50_121_185,r_56_47_130,r_56_47_130,0.99,55,185,130,41
8,r_56_47_130,r_13_139_125,seq69,r_56_47_130,0.89,0,130,130,41
43,r_87_104_104,seq127,r_24_149_41,r_87_104_104,1.0,1,105,104,41
16,r_134_0_137,seq62,r_7_83_4,r_134_0_137,0.96,1,138,137,41
21,r_95_133_64,r_146_25_151,seq69,r_95_133_64,0.91,2,66,64,41
1,r_140_136_118,r_46_73_167,r_33_48_109,r_140_136_118,1.0,2,120,118,41
15,r_131_135_162,r_16_90_38,seq142,r_16_90_38,0.68,-21,17,38,41
5,r_50_121_185,seq113,seq42,r_50_121_185,0.48,0,185,185,41
69,seq42,r_105_141_115,seq30,r_105_141_115,1.0,-6,109,115,41
15,r_131_135_162,seq142,seq34,r_131_135_162,0.74,-1,161,162,41
10,r_35_26_144,r_120_52_90,r_76_143_71,r_76_143_71,0.76,19,90,71,41
36,r_67_144_28,r_46_73_167,r_119_54_7,r_67_144_28,1.0,1,29,28,41
11,r_97_79_8,r_81_99_66,r_80_51_19,r_81_99_66,0.94,1,67,66,41
34,r_13_139_125,r_119_54_7,r_35_26_144,r_35_26_144,0.62,2,146,144,41
26,r_76_143_71,seq63,r_80_51_19,r_76_143_71,0.93,0,71,71,41
37,r_80_51_19,r_82_23_69,r_35_26_144,r_80_51_19,1.0,0,19,19,41
4,r_86_19_134,r_129_15_197,r_76_143_71,r_76_143_71,0.63,63,134,71,41
73,seq58,r_46_73_167,seq11,r_46_73_167,0.83,0,167,167,41
13,r_126_112_181,seq108,r_86_19_134,r_126_112_181,0.43,1,182,181,41
98,seq125,r_74_101_177,r_107_6_107,r_107_6_107,1.0,70,177,107,41
97,seq124,r_1_45_50,r_100_111_20,r_1_45_50,0.91,0,50,50,41
6,r_129_15_197,r_86_19_134,r_13_139_125,r_86_19_134,0.62,0,134,134,41
0,r_59_94_34,r_53_40_174,seq77,r_59_94_34,1.0,0,34,34,41
42,r_60_115_35,r_74_101_177,seq69,r_60_115_35,1.0,1,36,35,41
31,r_117_84_11,r_50_121_185,seq124,r_117_84_11,1.0,-1,10,11,41
69,seq42,seq30,r_50_121_185,r_50_121_185,0.91,0,185,185,41
2,r_66_39_176,seq17,r_119_54_7,r_66_39_176,0.77,0,176,176,41
40,r_96_36_169,r_66_39_176,r_65_102_33,r_96_36_169,0.83,0,169,169,41
74,seq62,r_134_0_137,seq11,r_134_0_137,1.0,-15,122,137,41
18,r_120_52_90,r_35_26_144,r_117_84_11,r_117_84_11,0.56,79,90,11,41
20,r_29_8_57,r_93_147_155,seq85,r_29_8_57,1.0,0,57,57,41
9,r_24_149_41,r_140_136_118,seq68,r_24_149_41,1.0,0,41,41,41
33,r_107_6_107,r_105_141_115,seq125,r_107_6_107,0.98,1,108,107,41
50,seq2,r_129_15_197,r_100_111_20,r_100_111_20,0.55,57,77,20,41
29,r_4_57_54,seq109,r_117_84_11,r_4_57_54,0.62,2,56,54,41
32,r_75_44_135,seq127,r_16_90_38,r_16_90_38,0.85,97,135,38,41
34,r_13_139_125,r_56_47_130,r_119_54_7,r_13_139_125,0.58,-5,120,125,41
48,r_1_45_50,seq124,seq63,r_1_45_50,1.0,0,50,50,41
35,r_33_48_109,seq22,r_140_136_118,r_140_136_118,0.65,9,127,118,41
10,r_35_26_144,r_76_143_71,r_13_139_125,r_35_26_144,1.0,2,146,144,41
81,seq77,r_88_138_190,r_59_94_34,r_59_94_34,1.0,156,190,34,41
24,r_65_102_33,r_126_112_181,seq142,r_65_102_33,1.0,0,33,33,41
17,r_89_27_156,seq38,r_35_26_144,r_89_27_156,0.53,0,156,156,41
37,r_80_51_19,r_35_26_144,r_76_143_71,r_76_143_71,0.7,75,146,71,41
22,r_132_148_184,seq20,r_46_73_167,r_132_148_184,0.47,0,184,184,41
28,r_70_37_94,r_35_26_144,seq32,r_70_37_94,1.0,0,94,94,41
49,r_146_25_151,seq114,seq38,r_146_25_151,0.82,2,153,151,41
7,r_46_73_167,seq58,seq110,r_46_73_167,0.75,0,167,167,41
23,r_82_23_69,seq69,seq43,r_82_23_69,1.0,1,70,69,41
14,r_16_90_38,r_131_135_162,r_80_51_19,r_16_90_38,1.0,0,38,38,41
12,r_93_147_155,seq14,r_59_94_34,r_59_94_34,1.0,139,173,34,41
30,r_130_71_150,seq85,r_8_18_153,r_130_71_150,0.79,2,152,150,42
92,seq102,seq100,r_147_68_29,r_147_68_29,1.0,94,123,29,42
82,seq83,r_147_68_29,r_106_86_142,r_147_68_29,0.43,94,123,29,42
14,r_8_18_153,seq89,seq26,r_8_18_153,0.35,22,175,153,42
8,r_96_87_62,r_116_131_118,seq41,r_96_87_62,0.45,8,70,62,42
16,r_118_74_10,seq83,seq109,r_118_74_10,0.96,0,10,10,42
43,r_146_84_158,seq15,seq80,r_146_84_158,0.47,1,159,158,42
18,r_147_68_29,seq92,seq102,r_147_68_29,0.97,3,32,29,42
37,r_116_131_118,seq80,seq15,r_116_131_118,0.88,1,119,118,42
24,r_69_143_75,r_132_90_131,r_67_58_47,r_67_58_47,0.93,2,49,47,42
1,r_95_78_109,seq70,r_77_122_21,r_95_78_109,1.0,2,111,109,42
46,r_103_22_110,r_38_7_174,r_17_44_7,r_103_22_110,0.81,16,126,110,42
42,r_91_139_14,seq92,seq72,r_91_139_14,0.39,71,85,14,42
80,seq141,r_104_19_192,r_66_14_100,r_66_14_100,0.85,58,158,100,42
69,seq41,seq16,r_96_87_62,r_96_87_62,0.78,1,63,62,42
45,r_31_65_161,seq63,seq51,r_31_65_161,0.7,1,162,161,42
19,r_149_29_116,seq43,r_24_57_45,r_149_29_116,0.88,2,118,116,42
44,r_32_79_48,seq27,seq92,r_32_79_48,0.98,0,48,48,42
76,seq63,r_31_65_161,r_95_78_109,r_95_78_109,0.93,53,162,109,42
31,r_40_117_105,seq0,r_48_129_50,r_40_117_105,0.73,0,105,105,42
41,r_56_127_185,seq114,r_118_74_10,r_118_74_10,0.73,175,185,10,42
20,r_67_58_47,r_116_131_118,r_69_143_75,r_67_58_47,0.84,2,49,47,42
4,r_50_105_87,seq148,seq10,r_50_105_87,1.0,0,87,87,42
84,seq88,r_40_117_105,r_21_1_9,r_21_1_9,0.42,112,121,9,42
13,r_115_3_60,seq137,seq16,r_115_3_60,1.0,0,60,60,42
48,r_132_90_131,seq123,r_2_61_28,r_132_90_131,0.58,5,136,131,42
6,r_101_53_165,seq134,r_28_144_1,r_101_53_165,0.74,0,165,165,42
62,seq148,r_50_105_87,r_119_113_3,r_50_105_87,1.0,0,87,87,42
23,r_108_107_17,r_96_87_62,seq4,r_108_107_17,0.72,-1,16,17,42
3,r_138_12_11,seq97,seq121,r_138_12_11,0.86,1,12,11,42
74,seq59,r_21_1_9,r_45_20_101,r_45_20_101,0.75,18,119,101,42
27,r_38_7_174,seq39,r_34_6_76,r_38_7_174,0.7,1,175,174,42
82,seq83,r_106_86_142,r_91_139_14,r_106_86_142,0.55,5,147,142,42
2,r_106_86_142,r_116_131_118,r_21_1_9,r_116_131_118,0.49,-14,104,118,42
47,r_48_129_50,r_124_99_135,r_40_117_105,r_48_129_50,0.45,87,137,50,42
38,r_77_122_21,r_67_58_47,seq63,r_77_122_21,0.98,1,22,21,42
40,r_66_14_100,seq121,seq141,r_66_14_100,0.81,0,100,100,42
24,r_69_143_75,r_67_58_47,seq114,r_69_143_75,0.74,11,86,75,42
74,seq59,seq88,r_21_1_9,r_21_1_9,0.49,65,74,9,42
29,r_45_20_101,seq63,seq59,r_45_20_101,0.92,2,103,101,42
33,r_124_99_135,r_48_129_50,r_34_6_76,r_124_99_135,0.39,2,137,135,42
82,seq83,seq33,r_147_68_29,r_147_68_29,0.59,72,101,29,42
50,seq0,r_34_6_76,seq123,r_34_6_76,0.72,0,76,76,42
32,r_54_82_180,r_48_129_50,r_21_1_9,r_54_82_180,0.22,0,180,180,42
77,seq70,r_95_78_109,seq134,r_95_78_109,1.0,2,111,109,42
34,r_23_35_151,seq89,r_147_68_29,r_23_35_151,0.71,1,152,151,42
10,r_49_125_37,r_96_87_62,seq85,r_49_125_37,0.78,1,38,37,42
75,seq60,seq134,r_36_62_143,r_36_62_143,0.99,-2,141,143,42
2,r_106_86_142,r_21_1_9,seq94,r_106_86_142,0.98,0,142,142,42
81,seq80,seq30,r_146_84_158,r_146_84_158,0.79,-3,155,158,42
17,r_142_42_96,seq63,r_34_6_76,r_142_42_96,0.97,1,97,96,42
9,r_36_62_143,seq10,seq60,r_36_62_143,0.9,0,143,143,42
96,seq114,r_81_55_114,r_69_143_75,r_69_143_75,0.78,44,119,75,42
49,r_37_47_81,seq110,seq137,r_37_47_81,1.0,0,81,81,42
7,r_2_61_28,seq4,r_132_90_131,r_132_90_131,0.91,8,139,131,42
39,r_64_76_22,seq72,seq123,r_64_76_22,0.63,0,22,22,42
20,r_67_58_47,r_69_143_75,r_64_76_22,r_69_143_75,0.76,7,82,75,42
84,seq88,seq59,r_40_117_105,r_40_117_105,0.83,-31,74,105,42
30,r_93_0_93,seq59,seq57,r_93_0_93,0.97,-2,91,93,43
51,seq131,seq87,r_122_141_107,r_122_141_107,1.0,0,107,107,43
36,r_28_129_70,seq27,r_109_133_9,r_28_129_70,1.0,0,70,70,43
92,seq111,r_29_74_185,r_64_107_29,r_64_107_29,0.96,156,185,29,43
14,r_115_71_54,seq68,r_51_101_15,r_51_101_15,0.91,48,63,15,43
8,r_100_108_104,seq18,seq106,r_100_108_104,0.96,0,104,104,43
43,r_77_138_167,seq139,r_54_31_144,r_77_138_167,0.61,0,167,167,43
76,seq59,r_148_75_39,r_85_22_98,r_85_22_98,0.94,4,102,98,43
37,r_132_5_150,r_109_133_9,r_120_20_36,r_109_133_9,0.62,141,150,9,43
10,r_64_107_29,r_126_52_94,r_109_133_9,r_64_107_29,0.98,2,31,29,43
55,seq139,r_77_138_167,r_144_79_182,r_144_79_182,0.8,0,182,182,43
16,r_43_2_190,seq104,r_115_71_54,r_115_71_54,0.57,136,190,54,43
21,r_29_74_185,seq111,r_35_140_145,r_29_74_185,0.52,0,185,185,43
39,r_110_84_66,seq38,r_115_71_54,r_110_84_66,1.0,0,66,66,43
1,r_54_31_144,seq14,r_93_0_93,r_54_31_144,0.58,1,145,144,43
97,seq119,r_117_105_101,r_145_4_153,r_117_105_101,0.93,1,102,101,43
46,r_85_22_98,r_144_79_182,seq59,r_85_22_98,0.98,0,98,98,43
42,r_63_78_62,seq102,r_15_39_41,r_63_78_62,1.0,0,62,62,43
48,r_15_39_41,seq98,seq131,r_15_39_41,1.0,0,41,41,43
45,r_36_114_137,r_35_140_145,r_97_88_132,r_35_140_145,0.96,-8,137,145,43
38,r_30_48_12,r_93_0_93,r_72_130_152,r_30_48_12,0.96,0,12,12,43
12,r_91_125_30,r_120_20_36,seq46,r_91_125_30,0.88,1,31,30,43
76,seq59,r_93_0_93,r_148_75_39,r_148_75_39,0.76,47,86,39,43
38,r_30_48_12,r_72_130_152,r_109_133_9,r_72_130_152,0.96,0,152,152,43
41,r_123_112_155,seq34,r_120_20_36,r_120_20_36,0.97,132,168,36,43
67,seq38,r_144_79_182,r_122_141_107,r_122_141_107,1.0,75,182,107,43
47,r_11_135_23,r_41_8_192,seq19,r_11_135_23,0.83,0,23,23,43
90,seq106,r_82_25_196,r_100_108_104,r_100_108_104,1.0,67,171,104,43
15,r_51_101_15,seq24,r_115_71_54,r_51_101_15,0.93,0,15,15,43
40,r_72_130_152,r_30_48_12,seq13,r_72_130_152,0.82,0,152,152,43
0,r_126_52_94,r_60_12_180,seq49,r_60_12_180,0.83,-79,101,180,43
63,seq27,r_28_129_70,seq24,r_28_129_70,0.96,0,70,70,43
13,r_90_89_127,r_41_8_192,seq50,r_90_89_127,0.95,1,128,127,43
3,r_148_75_39,r_53_45_43,seq1,r_148_75_39,1.0,0,39,39,43
27,r_122_141_107,r_123_112_155,seq131,r_122_141_107,1.0,0,107,107,43
9,r_65_142_20,r_103_69_92,seq50,r_65_142_20,0.96,0,20,20,43
87,seq99,r_3_137_119,seq121,r_3_137_119,0.95,-15,104,119,43
40,r_72_130_152,r_40_76_120,r_30_48_12,r_30_48_12,0.4,109,121,12,43
18,r_17_96_88,r_122_141_107,r_86_81_58,r_17_96_88,0.99,0,88,88,43
25,r_70_32_148,r_86_81_58,seq13,r_86_81_58,0.57,90,148,58,43
33,r_3_137_119,seq99,seq9,r_3_137_119,0.75,-2,117,119,43
70,seq46,r_126_52_94,r_91_125_30,r_91_125_30,0.99,71,101,30,43
65,seq34,r_123_112_155,r_100_108_104,r_100_108_104,1.0,56,160,104,43
32,r_41_8_192,r_90_89_127,seq27,r_90_89_127,0.97,1,128,127,43
49,r_26_66_27,r_43_2_190,r_145_4_153,r_26_66_27,0.9,-3,24,27,43
34,r_40_76_120,r_72_130_152,seq121,r_40_76_120,0.91,1,121,120,43
35,r_53_45_43,seq18,seq38,r_53_45_43,1.0,1,44,43,43
6,r_7_134_40,seq136,seq102,r_7_134_40,1.0,0,40,40,43
17,r_21_83_89,r_122_141_107,r_120_20_36,r_21_83_89,0.94,10,99,89,43
85,seq94,r_100_108_104,r_124_95_34,r_124_95_34,0.92,19,53,34,43
63,seq27,seq24,r_41_8_192,r_41_8_192,0.44,-43,149,192,43
31,r_124_95_34,seq9,seq94,r_124_95_34,0.66,130,164,34,43
28,r_60_12_180,r_91_125_30,r_100_108_104,r_60_12_180,0.76,0,180,180,43
28,r_60_12_180,r_126_52_94,r_91_125_30,r_91_125_30,0.92,71,101,30,43
91,seq146,seq67,r_93_0_93,r_93_0_93,1.0,23,116,93,43
7,r_128_23_87,seq104,seq6,r_128_23_87,1.0,0,87,87,43
44,r_35_140_145,r_36_114_137,seq59,r_36_114_137,0.9,1,138,137,43
23,r_117_105_101,seq119,r_11_135_23,r_11_135_23,0.78,79,102,23,43
31,r_124_95_34,seq68,seq9,r_124_95_34,0.99,2,36,34,43
2,r_120_20_36,r_91_125_30,seq37,r_120_20_36,0.98,0,36,36,43
61,seq19,r_43_2_190,r_11_135_23,r_11_135_23,0.99,7,30,23,43
30,r_3_56_83,r_73_44_198,seq108,r_3_56_83,1.0,3,86,83,44
36,r_125_9_81,seq87,seq86,r_125_9_81,1.0,1,82,81,44
14,r_141_144_86,r_34_129_134,seq86,r_141_144_86,0.56,1,87,86,44
8,r_16_147_60,r_57_140_125,r_113_50_4,r_16_147_60,1.0,0,60,60,44
43,r_64_66_101,r_113_50_4,seq93,r_64_66_101,1.0,0,101,101,44
39,r_36_142_98,r_1_27_186,r_146_8_151,r_146_8_151,0.54,-56,95,151,44
16,r_17_135_130,seq97,seq22,r_17_135_130,1.0,0,130,130,44
21,r_6_114_84,seq124,seq123,r_6_114_84,0.95,2,86,84,44
1,r_43_74_61,seq139,seq95,r_43_74_61,0.92,1,62,61,44
5,r_116_47_143,r_26_20_91,r_16_147_60,r_116_47_143,0.98,0,143,143,44
42,r_131_65_72,r_63_69_80,r_103_4_92,r_131_65_72,1.0,0,72,72,44
22,r_146_8_151,r_36_142_98,seq33,r_146_8_151,1.0,0,151,151,44
45,r_137_31_163,r_51_110_174,r_34_129_134,r_34_129_134,0.96,29,163,134,44
39,r_36_142_98,r_146_8_151,r_1_27_186,r_1_27_186,0.51,-143,43,186,44
19,r_148_18_2,r_81_72_142,r_40_127_116,r_40_127_116,0.54,-1,115,116,44
95,seq118,r_51_110_174,r_12_14_71,r_12_14_71,1.0,92,163,71,44
15,r_63_69_80,r_81_72_142,r_40_127_116,r_63_69_80,0.84,63,143,80,44
31,r_19_53_136,r_73_44_198,r_62_132_121,r_19_53_136,0.98,0,136,136,44
41,r_12_14_71,seq23,seq118,r_12_14_71,0.91,2,73,71,44
3,r_107_35_162,seq84,seq42,r_107_35_162,0.65,0,162,162,44
26,r_62_132_121,seq119,r_64_66_101,r_64_66_101,0.6,22,123,101,44
0,r_48_0_141,seq42,r_43_74_61,r_48_0_141,0.77,0,141,141,44
20,r_80_126_21,r_51_110_174,r_102_94_161,r_102_94_161,0.83,2,163,161,44
13,r_57_140_125,seq98,seq130,r_57_140_125,0.95,0,125,125,44
15,r_63_69_80,seq121,r_81_72_142,r_63_69_80,1.0,4,84,80,44
48,r_83_5_99,r_51_110_174,r_60_38_51,r_51_110_174,0.87,-74,100,174,44
6,r_76_78_178,r_79_90_150,r_24_115_75,r_76_78_178,0.84,-27,151,178,44
2,r_34_129_134,seq93,seq59,r_34_129_134,1.0,0,134,134,44
27,r_24_115_75,seq130,seq86,r_24_115_75,0.71,0,75,75,44
87,seq95,seq10,r_43_74_61,r_43_74_61,0.93,4,65,61,44
2,r_34_129_134,r_141_144_86,seq93,r_141_144_86,1.0,1,87,86,44
47,r_75_111_112,r_30_96_197,seq2,r_75_111_112,0.99,0,112,112,44
18,r_79_90_150,r_76_78_178,seq58,r_79_90_150,0.84,1,151,150,44
24,r_45_54_73,r_117_149_89,r_43_74_61,r_117_149_89,0.81,-9,80,89,44
35,r_1_27_186,r_36_142_98,r_116_47_143,r_1_27_186,0.58,0,186,186,44
25,r_122_89_167,r_73_44_198,seq25,r_122_89_167,0.39,-41,126,167,44
33,r_32_134_108,seq29,r_6_114_84,r_32_134_108,0.98,0,108,108,44
39,r_36_142_98,r_146_8_151,r_80_126_21,r_146_8_151,1.0,0,151,151,44
32,r_26_20_91,r_116_47_143,r_60_38_51,r_60_38_51,0.55,59,110,51,44
38,r_102_94_161,seq22,r_80_126_21,r_102_94_161,0.71,3,164,161,44
52,seq130,r_24_115_75,seq85,r_24_115_75,0.68,12,87,75,44
29,r_133_46_12,r_43_74_61,seq143,r_133_46_12,0.98,0,12,12,44
76,seq143,seq106,r_133_46_12,r_133_46_12,1.0,7,19,12,44
17,r_103_4_92,r_136_105_132,r_131_65_72,r_103_4_92,1.0,5,97,92,44
52,seq130,seq85,r_57_140_125,r_57_140_125,0.98,-2,123,125,44
22,r_146_8_151,r_51_110_174,r_36_142_98,r_36_142_98,0.96,12,110,98,44
28,r_109_99_131,seq61,r_24_115_75,r_109_99_131,0.98,1,132,131,44
49,r_60_38_51,seq98,r_26_20_91,r_60_38_51,1.0,1,52,51,44
7,r_37_120_66,r_103_4_92,seq139,r_37_120_66,0.9,0,66,66,44
44,r_113_50_4,r_64_66_101,r_16_147_60,r_113_50_4,1.0,97,101,4,44
11,r_128_71_32,r_6_114_84,seq49,r_128_71_32,1.0,0,32,32,44
23,r_40_127_116,seq97,r_63_69_80,r_63_69_80,0.97,38,118,80,44
6,r_76_78_178,r_24_115_75,r_12_14_71,r_76_78_178,0.84,0,178,178,44
79,seq84,r_107_35_162,r_7_100_107,r_7_100_107,0.74,18,125,107,44
35,r_1_27_186,r_148_18_2,r_36_142_98,r_36_142_98,0.8,14,112,98,44
12,r_145_11_111,r_57_140_125,r_117_149_89,r_117_149_89,0.97,24,113,89,44
12,r_145_11_111,r_117_149_89,r_57_140_125,r_117_149_89,1.0,0,89,89,44
30,r_135_92_171,seq103,r_81_10_103,r_81_10_103,0.95,73,176,103,45
16,r_116_89_160,r_81_10_103,seq28,r_116_89_160,0.94,5,165,160,45
9,r_133_119_16,r_111_74_47,r_38_93_68,r_111_74_47,0.59,-35,12,47,45
14,r_81_10_103,seq32,r_129_29_36,r_81_10_103,0.75,0,103,103,45
8,r_3_34_61,seq88,seq70,r_3_34_61,1.0,0,61,61,45
43,r_140_45_109,seq65,r_84_76_88,r_140_45_109,0.53,0,109,109,45
83,seq88,r_3_34_61,r_25_144_29,r_3_34_61,0.63,0,61,61,45
37,r_57_96_195,r_4_33_136,r_75_90_87,r_75_90_87,0.71,7,94,87,45
3,r_87_64_22,r_142_51_45,seq60,r_87_64_22,0.66,0,22,22,45
16,r_116_89_160,seq12,r_81_10_103,r_81_10_103,0.95,7,110,103,45
21,r_37_123_154,seq149,seq35,r_37_123_154,0.93,0,154,154,45
39,r_61_52_72,seq35,seq71,r_61_52_72,1.0,0,72,72,45
80,seq70,r_1_73_105,r_3_34_61,r_3_34_61,1.0,31,92,61,45
9,r_133_119_16,r_38_93_68,r_142_51_45,r_38_93_68,0.7,-5,63,68,45
27,r_77_19_13,r_20_126_97,r_31_130_55,r_20_126_97,0.73,1,98,97,45
95,seq120,seq13,r_9_97_69,r_9_97_69,1.0,39,108,69,45
66,seq32,r_81_10_103,seq54,r_81_10_103,0.95,4,107,103,45
1,r_25_144_29,r_20_126_97,seq88,r_25_144_29,1.0,1,30,29,45
31,r_9_97_69,r_44_107_1,seq120,r_9_97_69,1.0,0,69,69,45
10,r_4_33_136,r_57_96_195,seq114,r_4_33_136,0.96,1,137,136,45
26,r_1_73_105,seq70,r_5_53_82,r_5_53_82,0.65,27,109,82,45
4,r_84_76_88,seq115,r_44_107_1,r_84_76_88,1.0,0,88,88,45
44,r_31_130_55,r_38_93_68,r_77_19_13,r_38_93_68,0.65,-12,56,68,45
87,seq103,r_63_68_51,r_135_92_171,r_63_68_51,0.94,-7,44,51,45
20,r_137_27_144,r_112_79_165,r_75_90_87,r_75_90_87,1.0,59,146,87,45
13,r_100_94_123,seq70,r_3_34_61,r_3_34_61,1.0,9,70,61,45
15,r_129_29_36,r_83_72_98,seq12,r_129_29_36,0.79,1,37,36,45
17,r_63_68_51,seq103,r_42_80_53,r_63_68_51,0.98,0,51,51,45
23,r_20_126_97,r_25_144_29,r_77_19_13,r_20_126_97,0.77,-81,16,97,45
27,r_77_19_13,r_1_73_105,r_20_126_97,r_77_19_13,0.85,0,13,13,45
87,seq103,r_135_92_171,r_5_53_82,r_5_53_82,0.97,24,106,82,45
36,r_11_55_184,r_141_15_5,r_81_10_103,r_11_55_184,0.69,0,184,184,45
41,r_147_0_38,seq24,r_4_33_136,r_147_0_38,0.83,0,38,38,45
2,r_136_82_169,r_98_104_187,r_111_74_47,r_111_74_47,0.94,122,169,47,45
7,r_142_51_45,r_140_45_109,r_133_119_16,r_142_51_45,0.69,2,47,45,45
18,r_38_93_68,r_139_36_152,seq60,r_38_93_68,1.0,0,68,68,45
29,r_5_53_82,seq143,seq103,r_5_53_82,0.93,6,88,82,45
35,r_141_15_5,r_11_55_184,seq131,r_11_55_184,0.83,0,184,184,45
25,r_101_40_10,r_5_53_82,r_16_48_77,r_101_40_10,0.85,78,88,10,45
33,r_75_90_87,r_11_55_184,r_147_0_38,r_75_90_87,1.0,0,87,87,45
61,seq21,r_112_79_165,seq46,r_112_79_165,0.92,0,165,165,45
32,r_83_72_98,seq62,seq71,r_83_72_98,0.71,7,105,98,45
77,seq66,seq14,r_4_33_136,r_4_33_136,0.81,17,153,136,45
13,r_100_94_123,r_3_34_61,seq110,r_100_94_123,0.92,2,125,123,45
0,r_111_74_47,seq35,seq86,r_111_74_47,0.99,0,47,47,45
45,r_42_80_53,r_37_123_154,r_63_68_51,r_42_80_53,1.0,0,53,53,45
22,r_16_48_77,r_4_33_136,r_101_40_10,r_16_48_77,0.61,1,78,77,45
28,r_112_79_165,seq21,r_81_10_103,r_81_10_103,0.57,62,165,103,45
49,r_23_109_60,r_4_33_136,seq143,r_23_109_60,0.91,1,61,60,45
12,r_2_125_58,r_140_45_109,r_85_148_9,r_85_148_9,0.59,49,58,9,45
41,r_147_0_38,r_4_33_136,r_75_90_87,r_147_0_38,0.74,54,92,38,45
19,r_50_47_31,r_9_97_69,r_25_144_29,r_50_47_31,0.7,16,47,31,45
40,r_145_8_26,r_142_51_45,seq138,r_145_8_26,0.74,1,27,26,45
23,r_20_126_97,r_77_19_13,seq106,r_20_126_97,0.98,1,98,97,45
30,r_11_41_24,r_54_58_82,seq126,r_11_41_24,0.66,0,24,24,46
36,r_6_112_99,seq32,seq74,r_6_112_99,1.0,8,107,99,46
14,r_142_31_14,r_13_16_160,r_141_103_132,r_142_31_14,0.36,146,160,14,46
8,r_64_25_114,seq106,seq28,r_64_25_114,0.9,2,116,114,46
16,r_149_44_151,r_147_118_193,seq96,r_147_118_193,0.62,-39,154,193,46
39,r_140_81_96,r_113_90_177,r_62_139_61,r_140_81_96,0.63,6,102,96,46
1,r_110_39_112,r_128_23_126,r_46_9_8,r_110_39_112,0.97,0,112,112,46
46,r_62_139_61,r_6_112_99,seq105,r_62_139_61,0.94,2,63,61,46
42,r_95_45_83,seq124,seq21,r_95_45_83,1.0,0,83,83,46
80,seq91,seq106,r_110_39_112,r_110_39_112,1.0,44,156,112,46
7,r_33_98_139,r_83_88_23,seq135,r_33_98_139,1.0,0,139,139,46
19,r_87_77_125,seq101,r_110_39_112,r_110_39_112,0.88,26,138,112,46
95,seq119,r_12_69_10,r_97_3_123,r_97_3_123,1.0,19,142,123,46
43,r_53_102_34,r_57_144_169,seq17,r_53_102_34,0.85,4,38,34,46
31,r_123_143_159,seq40,r_64_25_114,r_123_143_159,0.68,1,160,159,46
3,r_57_144_169,seq28,r_73_78_53,r_57_144_169,0.49,1,170,169,46
10,r_73_78_53,seq85,r_122_42_30,r_73_78_53,0.58,12,65,53,46
4,r_66_15_181,r_142_31_14,seq0,r_142_31_14,0.46,167,181,14,46
32,r_92_79_41,seq20,seq35,r_92_79_41,0.62,0,41,41,46
15,r_7_121_104,r_70_148_134,r_1_111_28,r_70_148_134,0.93,-27,107,134,46
0,r_89_22_50,r_87_77_125,r_76_130_38,r_76_130_38,0.82,28,66,38,46
20,r_133_132_64,r_89_22_50,seq74,r_133_132_64,0.83,11,75,64,46
13,r_65_75_68,r_127_37_92,seq135,r_65_75_68,1.0,0,68,68,46
53,seq134,r_108_72_26,r_76_130_38,r_76_130_38,1.0,7,45,38,46
6,r_29_14_129,r_87_77_125,r_76_130_38,r_76_130_38,0.92,92,130,38,46
17,r_1_111_28,seq4,seq61,r_1_111_28,0.99,3,31,28,46
35,r_122_42_30,r_89_22_50,r_73_78_53,r_73_78_53,0.73,-29,24,53,46
2,r_54_58_82,r_33_98_139,r_48_50_57,r_54_58_82,0.5,1,83,82,46
40,r_48_50_57,seq17,seq117,r_48_50_57,0.61,6,63,57,46
18,r_47_30_90,seq55,r_131_137_70,r_47_30_90,0.9,0,90,90,46
24,r_127_37_92,r_123_143_159,r_83_88_23,r_127_37_92,0.82,0,92,92,46
34,r_83_88_23,r_33_98_139,r_127_37_92,r_83_88_23,1.0,116,139,23,46
37,r_76_130_38,r_6_112_99,seq134,r_76_130_38,0.81,1,39,38,46
25,r_131_137_70,r_54_58_82,r_128_23_126,r_131_137_70,1.0,0,70,70,46
64,seq28,r_57_144_169,r_127_37_92,r_127_37_92,0.96,78,170,92,46
88,seq106,r_64_25_114,seq35,r_64_25_114,1.0,2,116,114,46
15,r_7_121_104,r_12_69_10,r_70_148_134,r_7_121_104,0.54,-47,57,104,46
38,r_99_136_76,r_33_98_139,r_46_9_8,r_99_136_76,0.73,15,91,76,46
75,seq74,seq134,r_133_132_64,r_133_132_64,0.65,11,75,64,46
45,r_129_2_33,seq20,r_71_24_131,r_71_24_131,0.68,0,131,131,46
9,r_141_103_132,seq114,r_142_31_14,r_142_31_14,0.51,127,141,14,46
22,r_68_109_137,r_51_56_143,seq126,r_51_56_143,0.49,-8,135,143,46
28,r_13_16_160,r_142_31_14,seq85,r_142_31_14,0.52,146,160,14,46
49,r_36_34_81,r_70_148_134,r_108_72_26,r_70_148_134,0.66,-42,92,134,46
34,r_83_88_23,r_149_44_151,r_33_98_139,r_83_88_23,0.88,0,23,23,46
45,r_129_2_33,r_89_22_50,seq20,r_129_2_33,0.75,26,59,33,46
7,r_33_98_139,r_99_136_76,r_83_88_23,r_33_98_139,0.67,-57,82,139,46
23,r_97_3_123,seq0,seq119,r_97_3_123,0.92,0,123,123,46
12,r_71_24_131,r_57_144_169,r_129_2_33,r_57_144_169,0.61,-38,131,169,46
84,seq101,r_87_77_125,seq10,r_87_77_125,1.0,13,138,125,46
30,r_100_83_150,seq45,seq85,r_100_83_150,0.86,1,151,150,47
14,r_49_107_58,r_137_108_87,r_86_147_67,r_137_108_87,0.98,-25,62,87,47
1,r_62_6_41,seq59,seq142,r_62_6_41,0.62,9,50,41,47
43,r_99_24_187,seq68,r_62_6_41,r_62_6_41,0.63,147,188,41,47
37,r_118_41_63,r_53_17_182,seq2,r_118_41_63,1.0,0,63,63,47
3,r_21_16_7,r_8_47_97,r_137_108_87,r_21_16_7,1.0,82,89,7,47
16,r_4_101_64,r_40_78_154,seq33,r_4_101_64,0.96,6,70,64,47
21,r_3_133_132,seq66,r_5_18_56,r_5_18_56,0.63,76,132,56,47
39,r_10_20_164,seq142,r_56_132_116,r_10_20_164,0.72,2,166,164,47
5,r_94_115_108,r_88_48_107,r_111_37_35,r_111_37_35,0.76,82,117,35,47
81,seq74,r_139_82_140,r_73_114_38,r_73_114_38,0.5,4,42,38,47
69,seq42,r_0_116_173,seq27,r_0_116_173,0.81,0,173,173,47
19,r_103_120_72,seq19,seq45,r_103_120_72,0.64,0,72,72,47
31,r_9_76_174,r_124_117_193,r_123_84_110,r_123_84_110,0.93,65,175,110,47
10,r_123_84_110,seq91,seq130,r_123_84_110,0.98,1,111,110,47
4,r_53_17_182,r_118_41_63,r_31_110_51,r_53_17_182,1.0,-119,63,182,47
0,r_139_82_140,r_124_117_193,seq64,r_139_82_140,0.74,1,141,140,47
11,r_79_60_172,r_128_81_155,seq142,r_128_81_155,0.46,0,155,155,47
44,r_5_18_56,seq30,r_124_117_193,r_5_18_56,1.0,0,56,56,47
20,r_67_135_165,seq85,r_52_43_127,r_67_135_165,0.71,0,165,165,47
4,r_53_17_182,r_31_110_51,r_73_114_38,r_73_114_38,0.79,145,183,38,47
57,seq146,r_32_11_185,seq119,r_32_11_185,0.55,-43,142,185,47
6,r_54_138_81,seq121,r_5_18_56,r_54_138_81,0.99,2,83,81,47
34,r_56_132_116,r_21_16_7,r_12_25_91,r_56_132_116,0.99,0,116,116,47
45,r_136_93_48,seq72,seq64,r_136_93_48,1.0,0,48,48,47
27,r_137_108_87,seq98,r_21_16_7,r_137_108_87,0.99,1,88,87,47
22,r_7_57_40,r_128_81_155,r_4_101_64,r_128_81_155,0.89,-37,118,155,47
48,r_111_37_35,seq55,seq121,r_111_37_35,1.0,0,35,35,47
2,r_124_117_193,r_139_82_140,r_5_18_56,r_5_18_56,1.0,80,136,56,47
41,r_8_47_97,r_21_16_7,seq38,r_8_47_97,1.0,0,97,97,47
40,r_148_126_123,seq19,r_70_131_177,r_148_126_123,0.43,9,132,123,47
18,r_128_81_155,r_79_60_172,r_54_138_81,r_79_60_172,0.61,-17,155,172,47
29,r_28_104_78,seq140,seq68,r_28_104_78,1.0,0,78,78,47
34,r_56_132_116,r_8_47_97,r_21_16_7,r_21_16_7,0.51,51,58,7,47
22,r_7_57_40,seq34,r_128_81_155,r_7_57_40,0.94,5,45,40,47
25,r_14_129_129,seq125,r_127_105_2,r_14_129_129,0.93,3,132,129,47
42,r_31_110_51,r_53_17_182,r_94_115_108,r_94_115_108,1.0,75,183,108,47
32,r_12_25_91,seq97,seq122,r_12_25_91,0.99,0,91,91,47
38,r_50_77_124,seq122,r_4_101_64,r_50_77_124,1.0,0,124,124,47
77,seq68,r_99_24_187,r_28_104_78,r_28_104_78,1.0,110,188,78,47
75,seq64,seq19,r_139_82_140,r_139_82_140,0.9,1,141,140,47
17,r_32_11_185,seq45,r_62_6_41,r_32_11_185,0.37,1,186,185,47
94,seq98,r_137_108_87,seq64,r_137_108_87,1.0,1,88,87,47
9,r_52_43_127,r_86_147_67,r_109_113_71,r_86_147_67,0.69,64,131,67,47
28,r_0_116_173,seq42,r_123_84_110,r_123_84_110,0.64,63,173,110,47
91,seq95,r_40_78_154,r_127_105_2,r_40_78_154,0.59,-5,149,154,47
7,r_39_35_115,seq130,seq66,r_39_35_115,0.98,0,115,115,47
13,r_73_114_38,r_52_43_127,seq74,r_73_114_38,1.0,0,38,38,47
23,r_109_113_71,r_32_11_185,seq55,r_109_113_71,0.94,1,72,71,47
82,seq75,r_65_46_180,r_62_6_41,r_62_6_41,0.89,139,180,41,47
12,r_149_102_147,r_0_116_173,r_54_138_81,r_0_116_173,0.62,-25,148,173,47
42,r_31_110_51,r_28_104_78,r_53_17_182,r_31_110_51,1.0,0,51,51,47
30,r_123_139_149,r_1_129_62,r_15_58_9,r_1_129_62,0.98,0,62,62,48
36,r_75_52_103,r_38_98_86,r_66_62_38,r_75_52_103,0.86,-14,89,103,48
47,r_147_73_17,r_45_94_136,seq43,r_147_73_17,1.0,0,17,17,48
14,r_4_19_101,seq138,r_44_87_3,r_4_19_101,1.0,0,101,101,48
8,r_132_79_128,r_142_24_44,r_4_19_101,r_132_79_128,0.91,1,129,128,48
53,seq5,r_82_121_155,seq140,r_82_121_155,0.98,0,155,155,48
37,r_107_95_73,seq149,seq23,r_107_95_73,0.97,2,75,73,48
59,seq17,seq118,r_76_16_108,r_76_16_108,0.83,9,117,108,48
55,seq135,r_136_146_85,seq3,r_136_146_85,0.6,0,85,85,48
21,r_136_146_85,seq135,r_103_120_14,r_136_146_85,0.7,0,85,85,48
46,r_27_80_105,r_45_94_136,r_68_84_2,r_27_80_105,1.0,0,105,105,48
42,r_110_148_69,seq53,r_63_36_183,r_110_148_69,1.0,2,71,69,48
9,r_113_6_29,seq112,seq149,r_113_6_29,0.99,2,31,29,48
80,seq78,r_12_39_99,r_15_58_9,r_12_39_99,0.93,0,99,99,48
16,r_103_120_14,r_91_100_53,r_109_40_189,r_109_40_189,0.69,-176,13,189,48
23,r_69_99_172,r_113_6_29,seq89,r_69_99_172,0.96,0,172,172,48
77,seq59,seq43,r_143_10_36,r_143_10_36,1.0,13,49,36,48
19,r_38_98_86,r_75_52_103,seq54,r_38_98_86,0.93,1,87,86,48
39,r_29_116_179,r_66_62_38,seq114,r_66_62_38,0.55,141,179,38,48
31,r_67_122_72,seq56,seq119,r_67_122_72,1.0,1,73,72,48
41,r_44_87_3,seq42,r_4_19_101,r_4_19_101,1.0,9,110,101,48
3,r_63_36_183,r_60_8_153,r_45_94_136,r_63_36_183,0.91,-30,153,183,48
10,r_45_94_136,seq140,r_63_36_183,r_45_94_136,0.99,0,136,136,48
13,r_65_7_97,r_70_115_27,r_103_120_14,r_65_7_97,0.96,0,97,97,48
4,r_51_55_146,seq34,r_15_58_9,r_51_55_146,0.97,0,146,146,48
93,seq114,seq126,r_29_116_179,r_29_116_179,0.98,0,179,179,48
0,r_60_8_153,r_63_36_183,seq140,r_60_8_153,0.87,0,153,153,48
11,r_35_14_118,seq137,seq34,r_35_14_118,0.95,1,119,118,48
20,r_32_77_113,r_69_99_172,seq131,r_32_77_113,0.92,2,115,113,48
13,r_65_7_97,seq90,r_70_115_27,r_70_115_27,0.9,40,67,27,48
48,r_133_13_94,seq88,r_142_24_44,r_133_13_94,1.0,0,94,94,48
49,r_66_62_38,r_29_116_179,r_75_52_103,r_66_62_38,0.9,141,179,38,48
85,seq90,r_65_7_97,seq134,r_65_7_97,1.0,-30,67,97,48
49,r_66_62_38,r_51_55_146,r_29_116_179,r_66_62_38,0.97,-23,15,38,48
29,r_144_46_190,seq128,seq31,r_144_46_190,0.98,0,190,190,48
99,seq126,r_20_49_142,seq125,r_20_49_142,0.64,0,142,142,48
27,r_82_121_155,seq5,seq128,r_82_121_155,0.9,0,155,155,48
30,r_123_139_149,r_15_58_9,r_47_25_23,r_123_139_149,1.0,2,151,149,48
39,r_29_116_179,r_33_83_151,r_66_62_38,r_66_62_38,1.0,3,41,38,48
2,r_76_16_108,seq125,seq17,r_76_16_108,0.81,4,112,108,48
74,seq137,r_35_14_118,r_106_97_19,r_35_14_118,0.81,1,119,118,48
18,r_12_39_99,seq78,seq9,r_12_39_99,1.0,0,99,99,48
29,r_144_46_190,r_33_83_151,seq128,r_33_83_151,1.0,0,151,151,48
93,seq114,r_143_10_36,r_127_41_196,r_143_10_36,0.93,1,37,36,48
45,r_142_24_44,r_60_8_153,r_132_79_128,r_142_24_44,0.89,2,46,44,48
7,r_47_25_23,r_18_64_32,seq112,r_47_25_23,1.0,0,23,23,48
50,seq128,r_144_46_190,r_82_121_155,r_82_121_155,0.89,21,176,155,48
1,r_143_10_36,seq114,seq59,r_143_10_36,1.0,1,37,36,48
6,r_70_115_27,r_65_7_97,r_71_108_59,r_70_115_27,0.71,70,97,27,48
32,r_28_74_75,seq119,r_103_120_14,r_28_74_75,0.87,0,75,75,48
5,r_109_40_189,r_32_77_113,r_103_120_14,r_103_120_14,0.96,-1,13,14,48
34,r_71_108_59,seq140,r_70_115_27,r_71_108_59,1.0,1,60,59,48
43,r_37_102_54,seq118,r_66_62_38,r_37_102_54,1.0,0,54,54,48
26,r_106_97_19,r_20_49_142,seq2,r_106_97_19,0.73,3,22,19,48
12,r_91_100_53,seq85,seq23,r_91_100_53,1.0,0,53,53,48
45,r_142_24_44,r_132_79_128,r_133_13_94,r_142_24_44,1.0,84,128,44,48
17,r_33_83_151,r_144_46_190,r_51_55_146,r_33_83_151,0.83,0,151,151,48
33,r_11_130_24,r_20_49_142,seq48,r_11_130_24,0.99,-1,23,24,48
6,r_70_115_27,r_60_8_153,r_65_7_97,r_70_115_27,1.0,0,27,27,48
22,r_104_0_115,seq57,seq3,r_104_0_115,0.95,0,115,115,48
28,r_101_141_106,seq135,seq88,r_101_141_106,1.0,0,106,106,48
56,seq9,seq89,r_12_39_99,r_12_39_99,1.0,48,147,99,48
44,r_1_129_62,r_123_139_149,seq56,r_1_129_62,1.0,0,62,62,48
23,r_69_99_172,r_32_77_113,r_113_6_29,r_69_99_172,0.93,-59,113,172,48
30,r_93_127_150,seq45,seq33,r_93_127_150,0.83,-4,146,150,49
14,r_111_16_106,r_15_54_128,r_36_3_53,r_111_16_106,0.73,0,106,106,49
8,r_104_90_171,seq117,r_15_54_128,r_15_54_128,0.72,45,173,128,49
36,r_106_96_23,r_88_144_85,seq118,r_106_96_23,0.99,1,24,23,49
37,r_62_41_170,seq87,r_105_6_137,r_62_41_170,0.57,0,170,170,49
86,seq86,seq107,r_31_77_90,r_31_77_90,1.0,7,97,90,49
21,r_105_6_137,seq83,seq86,r_105_6_137,0.46,5,142,137,49
39,r_13_116_145,r_131_121_46,r_62_41_170,r_13_116_145,0.45,-73,72,145,49
1,r_20_126_164,r_119_10_149,r_82_134_84,r_119_10_149,0.82,15,164,149,49
38,r_124_47_48,r_145_58_124,seq69,r_124_47_48,1.0,0,48,48,49
5,r_101_89_72,r_43_22_52,r_60_26_60,r_43_22_52,1.0,20,72,52,49
45,r_40_67_111,r_131_121_46,seq57,r_40_67_111,0.9,1,112,111,49
27,r_35_52_30,r_93_127_150,r_88_144_85,r_88_144_85,0.85,14,99,85,49
19,r_43_22_52,seq64,seq132,r_43_22_52,0.97,0,52,52,49
41,r_112_38_73,r_31_77_90,seq18,r_112_38_73,1.0,0,73,73,49
43,r_66_141_17,r_15_54_128,seq33,r_66_141_17,1.0,-1,16,17,49
3,r_11_115_105,seq85,r_14_139_99,r_11_115_105,1.0,2,107,105,49
10,r_84_97_78,seq107,r_66_141_17,r_84_97_78,0.99,0,78,78,49
29,r_82_134_84,r_98_0_80,r_20_126_164,r_20_126_164,0.8,-5,159,164,49
26,r_100_19_132,seq85,seq8,r_100_19_132,0.92,0,132,132,49
72,seq57,r_14_139_99,r_40_67_111,r_40_67_111,0.94,19,130,111,49
4,r_39_129_126,r_76_25_178,r_29_108_91,r_76_25_178,0.99,-52,126,178,49
31,r_36_3_53,seq95,r_34_110_134,r_36_3_53,0.99,0,53,53,49
31,r_36_3_53,r_34_110_134,r_111_16_106,r_36_3_53,0.84,53,106,53,49
20,r_17_4_82,seq65,seq64,r_17_4_82,0.5,5,87,82,49
48,r_145_58_124,r_34_110_134,seq120,r_145_58_124,0.91,0,124,124,49
27,r_35_52_30,r_30_75_104,r_93_127_150,r_35_52_30,0.48,3,33,30,49
34,r_131_121_46,r_13_116_145,r_62_41_170,r_13_116_145,0.48,-95,50,145,49
47,r_148_7_71,r_39_129_126,seq114,r_39_129_126,0.74,-53,73,126,49
40,r_88_144_85,seq12,r_35_52_30,r_88_144_85,1.0,1,86,85,49
28,r_149_59_41,r_11_115_105,seq109,r_149_59_41,0.99,0,41,41,49
74,seq61,r_34_110_134,r_36_3_53,r_36_3_53,0.79,81,134,53,49
18,r_98_0_80,r_119_10_149,r_131_121_46,r_98_0_80,0.97,6,86,80,49
29,r_82_134_84,r_113_123_89,r_13_116_145,r_82_134_84,0.78,2,86,84,49
24,r_76_25_178,r_39_129_126,r_30_75_104,r_39_129_126,0.73,0,126,126,49
25,r_128_138_157,r_23_27_193,r_48_91_194,r_128_138_157,0.78,0,157,157,49
39,r_13_116_145,r_82_134_84,r_135_71_36,r_13_116_145,1.0,2,147,145,49
33,r_60_26_60,r_23_27_193,seq107,r_60_26_60,1.0,0,60,60,49
42,r_135_71_36,seq140,r_13_116_145,r_13_116_145,0.98,0,145,145,49
32,r_30_75_104,seq28,r_76_25_178,r_30_75_104,0.9,8,112,104,49
52,seq132,r_29_108_91,r_43_22_52,r_29_108_91,0.88,-18,73,91,49
39,r_13_116_145,r_62_41_170,r_82_134_84,r_13_116_145,0.58,-56,89,145,49
60,seq28,r_30_75_104,seq18,r_30_75_104,0.99,8,112,104,49
2,r_9_103_50,r_29_108_91,seq136,r_9_103_50,0.95,3,53,50,49
17,r_34_110_134,seq61,r_14_139_99,r_34_110_134,0.81,0,134,134,49
29,r_82_134_84,r_13_116_145,r_98_0_80,r_13_116_145,0.87,4,149,145,49
22,r_72_78_101,r_11_115_105,seq107,r_72_78_101,1.0,0,101,101,49
34,r_131_121_46,r_62_41_170,r_113_123_89,r_113_123_89,0.55,0,89,89,49
49,r_53_42_87,seq99,r_24_130_4,r_53_42_87,0.98,0,87,87,49
7,r_29_108_91,seq132,seq83,r_29_108_91,0.97,0,91,91,49
44,r_31_77_90,seq118,seq86,r_31_77_90,1.0,1,91,90,49
35,r_113_123_89,seq33,r_131_121_46,r_113_123_89,1.0,1,90,89,49
12,r_143_147_114,seq69,seq51,r_143_147_114,0.83,4,118,114,49
42,r_135_71_36,seq86,seq140,r_135_71_36,1.0,1,37,36,49
93,seq146,seq92,r_29_74_11,r_29_74_11,0.93,79,90,11,50
30,r_72_103_111,seq66,r_14_64_38,r_72_103_111,1.0,0,111,111,50
44,r_32_42_42,r_144_136_179,r_20_31_180,r_20_31_180,0.61,2,182,180,50
36,r_124_21_149,seq82,seq45,r_124_21_149,0.96,0,149,149,50
22,r_58_39_26,r_111_12_47,r_132_60_104,r_132_60_104,0.98,-78,26,104,50
37,r_20_31_180,seq67,r_32_42_42,r_20_31_180,0.33,2,182,180,50
16,r_5_30_137,r_124_21_149,r_111_12_47,r_111_12_47,0.57,94,141,47,50
13,r_78_118_13,r_111_12_47,r_29_74_11,r_78_118_13,0.97,2,15,13,50
5,r_127_86_72,seq89,seq45,r_127_86_72,1.0,0,72,72,50
46,r_84_91_67,r_148_100_110,r_29_74_11,r_84_91_67,1.0,0,67,67,50
27,r_8_87_23,r_37_114_99,seq120,r_8_87_23,0.99,0,23,23,50
24,r_14_64_38,r_26_2_96,seq44,r_14_64_38,0.99,3,41,38,50
12,r_0_141_33,r_137_79_167,seq94,r_0_141_33,1.0,1,34,33,50
9,r_111_12_47,seq6,r_54_99_41,r_111_12_47,1.0,1,48,47,50
45,r_53_83_21,seq133,seq89,r_53_83_21,1.0,2,23,21,50
8,r_144_136_179,r_24_57_43,r_32_42_42,r_144_136_179,0.68,-136,43,179,50
20,r_24_57_43,r_144_136_179,seq17,r_24_57_43,1.0,0,43,43,50
41,r_71_62_119,seq52,r_117_19_197,r_71_62_119,1.0,0,119,119,50
3,r_148_100_110,r_84_91_67,seq120,r_84_91_67,1.0,0,67,67,50
10,r_96_102_106,r_70_126_195,seq125,r_96_102_106,0.99,0,106,106,50
44,r_32_42_42,seq4,r_144_136_179,r_32_42_42,0.66,1,43,42,50
26,r_75_28_69,seq69,r_111_12_47,r_75_28_69,0.9,3,72,69,50
8,r_144_136_179,r_32_42_42,r_78_118_13,r_78_118_13,0.75,168,181,13,50
48,r_132_60_104,r_75_28_69,r_58_39_26,r_58_39_26,0.99,2,28,26,50
78,seq67,r_20_31_180,r_144_136_179,r_144_136_179,0.99,3,182,179,50
63,seq22,seq113,r_111_12_47,r_111_12_47,1.0,14,61,47,50
11,r_50_135_65,seq145,seq6,r_50_135_65,1.0,0,65,65,50
2,r_25_81_51,seq140,seq45,r_25_81_51,0.93,5,56,51,50
85,seq94,seq133,r_0_141_33,r_0_141_33,1.0,11,44,33,50
18,r_77_131_86,r_96_102_106,r_76_38_94,r_96_102_106,0.98,-6,100,106,50
15,r_10_3_175,seq55,seq17,r_10_3_175,0.45,0,175,175,50
54,seq6,r_111_12_47,r_149_112_3,r_111_12_47,0.94,1,48,47,50
22,r_58_39_26,r_132_60_104,r_129_43_61,r_58_39_26,0.98,52,78,26,50
13,r_78_118_13,r_29_74_11,r_14_64_38,r_14_64_38,0.77,94,132,38,50
6,r_115_85_164,r_41_35_160,r_148_100_110,r_41_35_160,0.81,1,161,160,50
64,seq23,seq128,r_139_49_22,r_139_49_22,0.97,24,46,22,50
21,r_13_56_17,seq138,seq145,r_13_56_17,0.99,1,18,17,50
40,r_65_110_92,r_72_103_111,r_26_2_96,r_26_2_96,0.94,-4,92,96,50
74,seq55,r_68_47_194,seq27,r_68_47_194,0.7,-45,149,194,50
18,r_77_131_86,r_72_103_111,r_96_102_106,r_77_131_86,0.73,0,86,86,50
48,r_132_60_104,r_58_39_26,r_117_19_197,r_132_60_104,0.98,1,105,104,50
43,r_116_147_36,r_115_85_164,seq82,r_116_147_36,1.0,1,37,36,50
54,seq6,r_149_112_3,r_50_135_65,r_50_135_65,0.98,3,68,65,50
88,seq145,r_50_135_65,r_13_56_17,r_50_135_65,0.99,0,65,65,50
42,r_139_49_22,r_96_102_106,seq23,r_139_49_22,0.83,0,22,22,50
32,r_117_19_197,seq16,r_71_62_119,r_71_62_119,1.0,9,128,119,50
38,r_143_63_114,seq44,seq55,r_143_63_114,1.0,0,114,114,50
77,seq66,r_72_103_111,seq89,r_72_103_111,1.0,0,111,111,50
34,r_122_11_178,seq101,seq138,r_122_11_178,0.42,0,178,178,50
25,r_73_109_20,r_98_34_80,seq101,r_98_34_80,0.51,-58,22,80,50
17,r_98_34_80,r_143_63_114,r_13_56_17,r_98_34_80,1.0,0,80,80,50
23,r_129_43_61,r_148_100_110,r_58_39_26,r_129_43_61,0.97,-2,59,61,50
96,seq120,r_142_36_83,r_8_87_23,r_142_36_83,0.57,-7,76,83,50
49,r_41_35_160,r_115_85_164,seq33,r_41_35_160,0.66,0,160,160,50
39,r_54_99_41,r_132_60_104,seq22,r_132_60_104,0.67,-60,44,104,50
7,r_142_36_83,seq120,seq140,r_142_36_83,1.0,0,83,83,50
35,r_76_38_94,r_115_85_164,r_77_131_86,r_76_38_94,1.0,2,96,94,50
30,r_99_111_83,r_32_15_158,r_11_28_181,r_99_111_83,0.9,3,86,83,51
51,seq2,seq30,r_59_42_67,r_59_42_67,1.0,-1,66,67,51
36,r_85_67_97,r_86_118_185,r_9_76_188,r_85_67_97,1.0,1,98,97,51
6,r_105_104_52,seq17,seq38,r_105_104_52,1.0,0,52,52,51
92,seq145,r_97_119_131,r_89_80_79,r_89_80_79,0.62,0,79,79,51
14,r_16_78_140,r_114_62_176,r_60_68_108,r_16_78_140,0.87,3,143,140,51
8,r_72_91_85,r_61_49_78,r_26_22_59,r_72_91_85,0.99,0,85,85,51
53,seq4,seq140,r_12_81_69,r_12_81_69,1.0,1,70,69,51
43,r_20_122_75,seq31,seq109,r_20_122_75,1.0,-2,73,75,51
83,seq77,seq66,r_75_23_72,r_75_23_72,1.0,0,72,72,51
26,r_0_117_47,seq66,seq39,r_0_117_47,1.0,0,47,47,51
71,seq45,r_86_118_185,r_60_68_108,r_60_68_108,1.0,31,139,108,51
16,r_63_96_148,seq133,seq125,r_63_96_148,0.89,0,148,148,51
21,r_43_54_184,seq125,seq18,r_43_54_184,0.42,0,184,184,51
39,r_148_13_76,seq74,seq109,r_148_13_76,1.0,0,76,76,51
1,r_8_64_64,seq140,r_132_35_61,r_8_64_64,0.82,4,68,64,51
5,r_55_21_156,seq116,r_10_128_30,r_10_128_30,0.78,129,159,30,51
42,r_47_100_136,seq39,seq123,r_47_100_136,0.97,2,138,136,51
45,r_75_23_72,seq98,seq77,r_75_23_72,1.0,1,73,72,51
70,seq44,seq46,r_95_131_22,r_95_131_22,0.97,24,46,22,51
19,r_143_139_132,seq125,r_75_23_72,r_143_139_132,0.95,0,132,132,51
37,r_112_137_32,r_75_23_72,seq4,r_112_137_32,1.0,-3,29,32,51
98,seq125,seq71,r_63_96_148,r_63_96_148,0.68,12,160,148,51
10,r_59_42_67,seq39,seq30,r_59_42_67,1.0,0,67,67,51
4,r_24_79_74,r_90_108_57,seq133,r_24_79_74,1.0,1,75,74,51
0,r_86_118_185,seq45,r_34_141_27,r_86_118_185,0.53,2,187,185,51
11,r_12_81_69,seq88,seq4,r_12_81_69,1.0,0,69,69,51
20,r_9_76_188,seq51,r_8_64_64,r_8_64_64,0.87,124,188,64,51
98,seq125,r_143_139_132,seq71,r_143_139_132,0.91,-3,129,132,51
48,r_114_62_176,r_16_78_140,r_59_42_67,r_59_42_67,0.93,69,136,67,51
12,r_11_28_181,r_99_111_83,r_134_33_70,r_99_111_83,0.59,98,181,83,51
70,seq44,r_110_40_102,seq39,r_110_40_102,0.39,70,172,102,51
33,r_14_146_17,seq116,seq38,r_14_146_17,0.97,0,17,17,51
30,r_99_111_83,r_11_28_181,seq136,r_11_28_181,0.48,0,181,181,51
47,r_129_93_133,seq145,r_127_27_125,r_127_27_125,0.72,23,148,125,51
38,r_95_131_22,r_32_15_158,seq36,r_95_131_22,0.99,0,22,22,51
40,r_69_107_68,r_24_79_74,seq77,r_24_79_74,0.98,-9,65,74,51
18,r_25_106_88,r_86_118_185,r_24_79_74,r_24_79_74,1.0,37,111,74,51
29,r_57_73_93,seq123,seq17,r_57_73_93,1.0,-2,91,93,51
24,r_60_68_108,seq71,seq45,r_60_68_108,1.0,0,108,108,51
48,r_114_62_176,r_59_42_67,r_69_107_68,r_114_62_176,0.98,1,177,176,51
25,r_134_33_70,seq36,seq145,r_134_33_70,1.0,0,70,70,51
3,r_34_141_27,r_102_5_144,r_6_121_8,r_34_141_27,0.96,2,29,27,51
64,seq30,seq2,r_59_42_67,r_59_42_67,1.0,0,67,67,51
46,r_132_35_61,seq109,r_8_64_64,r_8_64_64,1.0,-7,57,64,51
50,seq1,r_56_41_190,seq74,r_56_41_190,0.45,-18,172,190,51
9,r_102_5_144,r_61_49_78,r_89_80_79,r_102_5_144,0.99,-8,136,144,51
32,r_50_29_119,r_61_49_78,seq30,r_50_29_119,0.91,1,120,119,51
34,r_61_49_78,seq38,r_97_119_131,r_97_119_131,1.0,3,134,131,51
60,seq17,seq37,r_57_73_93,r_57_73_93,1.0,2,95,93,51
81,seq71,r_60_68_108,seq58,r_60_68_108,1.0,0,108,108,51
94,seq113,r_63_96_148,seq36,r_63_96_148,0.69,-66,82,148,51
9,r_102_5_144,r_89_80_79,r_61_49_78,r_89_80_79,1.0,1,80,79,51
22,r_110_40_102,r_86_118_185,seq1,r_110_40_102,0.62,-7,95,102,51
28,r_147_87_160,r_142_120_163,seq123,r_147_87_160,0.42,0,160,160,51
41,r_10_128_30,r_12_81_69,seq138,r_10_128_30,0.92,-1,29,30,51
56,seq136,r_11_28_181,r_99_111_83,r_99_111_83,0.97,28,111,83,51
7,r_26_22_59,r_132_35_61,seq140,r_26_22_59,0.83,9,68,59,51
23,r_103_7_179,seq88,r_127_27_125,r_127_27_125,0.53,54,179,125,51
17,r_6_121_8,r_8_64_64,r_26_22_59,r_6_121_8,0.99,65,73,8,51
79,seq66,seq77,r_69_107_68,r_69_107_68,0.85,3,71,68,51
35,r_97_119_131,seq145,r_61_49_78,r_97_119_131,0.96,0,131,131,51
12,r_11_28_181,seq136,r_99_111_83,r_99_111_83,0.98,3,86,83,51
30,r_74_41_127,seq81,seq44,r_74_41_127,0.57,2,129,127,52
36,r_96_128_59,r_122_60_183,seq83,r_96_128_59,1.0,1,60,59,52
14,r_100_52_74,seq22,seq148,r_100_52_74,1.0,0,74,74,52
8,r_19_106_155,seq49,r_97_6_125,r_19_106_155,0.71,0,155,155,52
43,r_5_66_104,seq149,r_12_130_15,r_5_66_104,0.79,0,104,104,52
45,r_12_130_15,seq33,seq123,r_12_130_15,0.98,-1,14,15,52
37,r_55_133_119,r_116_99_182,seq107,r_55_133_119,0.97,0,119,119,52
59,seq148,r_135_77_159,r_100_52_74,r_100_52_74,1.0,4,78,74,52
71,seq47,r_102_105_170,r_137_117_135,r_137_117_135,0.8,37,172,135,52
39,r_34_138_110,seq43,seq47,r_34_138_110,1.0,0,110,110,52
1,r_69_75_109,r_135_77_159,r_104_108_73,r_69_75_109,0.91,1,110,109,52
46,r_24_91_133,seq111,seq118,r_24_91_133,0.98,0,133,133,52
24,r_129_48_18,r_29_121_191,seq1,r_129_48_18,0.82,0,18,18,52
23,r_126_53_45,r_23_28_57,seq111,r_23_28_57,0.78,-13,44,57,52
19,r_39_98_52,r_71_21_196,r_12_130_15,r_39_98_52,0.93,0,52,52,52
67,seq40,r_59_26_122,r_119_58_71,r_119_58_71,1.0,64,135,71,52
10,r_31_3_140,seq83,r_120_16_100,r_31_3_140,0.93,0,140,140,52
90,seq88,r_56_70_124,r_120_16_100,r_56_70_124,0.92,0,124,124,52
26,r_90_139_161,seq33,r_19_106_155,r_19_106_155,0.99,4,159,155,52
41,r_18_50_56,r_20_86_190,r_97_6_125,r_18_50_56,1.0,0,56,56,52
78,seq65,r_10_13_158,r_119_58_71,r_119_58_71,0.99,87,158,71,52
63,seq30,seq123,r_104_108_73,r_104_108_73,0.57,16,89,73,52
11,r_114_147_189,r_85_45_63,r_20_86_190,r_114_147_189,0.52,1,190,189,52
20,r_137_117_135,seq65,r_34_138_110,r_34_138_110,0.59,29,139,110,52
48,r_46_9_61,r_32_4_172,r_85_45_63,r_46_9_61,0.98,-1,60,61,52
25,r_97_6_125,seq1,r_18_50_56,r_18_50_56,1.0,0,56,56,52
34,r_103_14_134,r_0_115_55,seq64,r_0_115_55,1.0,0,55,55,52
27,r_104_108_73,r_116_99_182,seq30,r_104_108_73,0.89,-5,68,73,52
87,seq83,r_31_3_140,seq43,r_31_3_140,1.0,-63,77,140,52
41,r_18_50_56,r_97_6_125,r_56_70_124,r_56_70_124,0.52,5,129,124,52
38,r_89_93_22,r_56_70_124,seq131,r_89_93_22,0.97,0,22,22,52
40,r_0_115_55,r_103_14_134,r_110_94_58,r_0_115_55,1.0,0,55,55,52
47,r_20_86_190,r_18_50_56,r_23_28_57,r_20_86_190,1.0,-134,56,190,52
18,r_15_17_152,r_132_80_192,r_31_3_140,r_15_17_152,0.81,2,154,152,52
34,r_103_14_134,seq64,r_34_138_110,r_34_138_110,0.98,22,132,110,52
47,r_20_86_190,r_23_28_57,r_114_147_189,r_23_28_57,0.29,133,190,57,52
6,r_23_28_57,r_20_86_190,r_127_25_166,r_127_25_166,0.97,24,190,166,52
32,r_135_77_159,seq72,seq84,r_135_77_159,0.53,2,161,159,52
31,r_92_36_47,seq42,seq145,r_92_36_47,1.0,0,47,47,52
60,seq149,r_5_66_104,seq37,r_5_66_104,1.0,-11,93,104,52
17,r_56_70_124,seq88,r_129_48_18,r_56_70_124,0.5,0,124,124,52
25,r_97_6_125,r_18_50_56,seq27,r_97_6_125,0.69,4,129,125,52
50,seq1,seq2,r_129_48_18,r_129_48_18,1.0,0,18,18,52
28,r_122_60_183,seq144,r_126_53_45,r_126_53_45,0.78,141,186,45,52
3,r_110_94_58,seq107,r_0_115_55,r_0_115_55,0.89,1,56,55,52
44,r_120_16_100,r_59_26_122,seq88,r_120_16_100,0.69,1,101,100,52
27,r_104_108_73,seq30,r_69_75_109,r_69_75_109,0.86,11,120,109,52
6,r_23_28_57,r_112_142_199,r_20_86_190,r_23_28_57,1.0,0,57,57,52
35,r_85_45_63,r_114_147_189,r_137_117_135,r_85_45_63,0.44,126,189,63,52
57,seq145,seq148,r_92_36_47,r_92_36_47,1.0,7,54,47,52
30,r_30_43_142,seq42,seq118,r_30_43_142,0.67,1,143,142,53
44,r_44_85_158,r_137_7_197,r_68_125_4,r_44_85_158,0.93,0,158,158,53
36,r_86_132_88,seq28,seq26,r_86_132_88,1.0,0,88,88,53
92,seq114,r_72_75_144,r_93_64_16,r_72_75_144,0.71,0,144,144,53
14,r_94_70_181,seq87,r_100_73_34,r_94_70_181,0.39,0,181,181,53
8,r_97_140_73,r_44_85_158,seq104,r_97_140_73,0.92,0,73,73,53
5,r_61_88_13,r_20_92_118,seq32,r_61_88_13,0.99,-1,12,13,53
22,r_55_36_51,seq138,seq56,r_55_36_51,1.0,1,52,51,53
72,seq38,seq47,r_133_143_25,r_133_143_25,1.0,9,34,25,53
86,seq96,r_129_69_129,r_29_141_199,r_129_69_129,0.85,21,150,129,53
16,r_20_92_118,r_6_122_160,seq120,r_20_92_118,0.72,0,118,118,53
46,r_59_82_77,r_50_19_192,r_93_64_16,r_59_82_77,1.0,0,77,77,53
24,r_110_130_27,r_55_36_51,seq16,r_110_130_27,0.49,0,27,27,53
12,r_100_73_34,r_46_79_47,r_149_8_196,r_149_8_196,1.0,-162,34,196,53
69,seq31,r_51_10_87,seq135,r_51_10_87,0.73,8,95,87,53
45,r_139_49_136,r_136_84_187,r_103_66_98,r_139_49_136,0.44,0,136,136,53
19,r_144_67_83,r_63_113_130,r_81_57_62,r_144_67_83,0.98,1,84,83,53
48,r_149_8_196,seq52,r_100_73_34,r_100_73_34,1.0,5,39,34,53
31,r_76_45_131,seq26,r_46_79_47,r_76_45_131,0.99,1,132,131,53
80,seq54,r_25_71_32,r_14_115_17,r_25_71_32,0.48,1,33,32,53
45,r_139_49_136,r_103_66_98,r_6_122_160,r_139_49_136,0.65,29,165,136,53
43,r_93_64_16,seq9,seq114,r_93_64_16,0.81,0,16,16,53
1,r_25_71_32,r_94_70_181,seq16,r_25_71_32,1.0,1,33,32,53
90,seq107,seq77,r_102_128_53,r_102_128_53,1.0,50,103,53,53
95,seq119,seq124,r_137_7_197,r_137_7_197,0.31,-143,54,197,53
28,r_46_79_47,seq2,seq13,r_46_79_47,1.0,0,47,47,53
4,r_91_109_71,seq90,seq56,r_91_109_71,1.0,2,73,71,53
41,r_102_128_53,r_91_109_71,seq107,r_102_128_53,0.75,6,59,53,53
10,r_105_98_33,r_86_132_88,r_50_19_192,r_105_98_33,1.0,0,33,33,53
69,seq31,seq135,r_24_83_143,r_24_83_143,0.98,-4,139,143,53
22,r_55_36_51,seq56,r_72_75_144,r_72_75_144,0.99,30,174,144,53
2,r_145_15_150,seq41,r_105_98_33,r_145_15_150,0.84,-1,149,150,53
47,r_111_18_96,seq107,r_51_10_87,r_111_18_96,0.7,16,112,96,53
40,r_6_122_160,r_20_92_118,r_111_18_96,r_20_92_118,0.52,0,118,118,53
43,r_93_64_16,seq114,r_59_82_77,r_59_82_77,1.0,5,82,77,53
32,r_62_106_114,r_68_125_4,seq11,r_62_106_114,0.99,0,114,114,53
38,r_103_66_98,r_44_85_158,seq77,r_103_66_98,0.94,0,98,98,53
40,r_6_122_160,r_111_18_96,r_139_49_136,r_6_122_160,0.94,0,160,160,53
57,seq9,r_133_143_25,seq104,r_133_143_25,0.96,-3,22,25,53
9,r_24_83_143,seq131,seq31,r_24_83_143,0.75,0,143,143,53
0,r_133_143_25,seq9,seq38,r_133_143_25,0.99,0,25,25,53
17,r_14_115_17,seq16,seq54,r_14_115_17,0.99,-1,16,17,53
20,r_35_74_23,r_81_57_62,seq17,r_35_74_23,0.89,0,23,23,53
7,r_72_75_144,seq114,r_55_36_51,r_72_75_144,0.84,0,144,144,53
44,r_44_85_158,r_103_66_98,r_137_7_197,r_103_66_98,1.0,0,98,98,53
23,r_95_80_76,seq114,seq138,r_95_80_76,1.0,0,76,76,53
82,seq77,seq107,r_103_66_98,r_103_66_98,1.0,5,103,98,53
25,r_112_3_12,r_72_75_144,seq28,r_112_3_12,0.88,0,12,12,53
40,r_125_104_176,r_128_1_9,r_30_129_183,r_125_104_176,0.59,0,176,176,54
30,r_115_102_174,seq147,seq15,r_115_102_174,0.48,0,174,174,54
49,r_18_40_96,seq131,r_19_33_14,r_19_33_14,0.98,4,18,14,54
14,r_64_145_91,seq5,r_81_82_26,r_64_145_91,0.92,0,91,91,54
38,r_30_129_183,seq96,r_125_104_176,r_30_129_183,0.95,0,183,183,54
37,r_116_62_132,seq28,r_48_36_23,r_116_62_132,0.68,3,135,132,54
17,r_48_36_23,r_0_9_63,seq119,r_48_36_23,0.58,0,23,23,54
86,seq96,r_143_111_154,r_117_132_45,r_117_132_45,0.93,62,107,45,54
21,r_112_72_142,r_30_129_183,r_71_8_104,r_30_129_183,0.98,-41,142,183,54
1,r_65_90_82,seq66,r_142_35_18,r_65_90_82,1.0,0,82,82,54
46,r_75_123_100,seq91,r_18_40_96,r_75_123_100,1.0,3,103,100,54
56,seq146,r_3_63_178,r_86_69_54,r_86_69_54,0.89,0,54,54,54
32,r_23_79_24,seq126,r_143_111_154,r_143_111_154,0.67,0,154,154,54
19,r_55_10_87,seq126,seq66,r_55_10_87,0.89,-5,82,87,54
33,r_128_1_9,r_125_104_176,r_78_120_116,r_78_120_116,0.99,57,173,116,54
31,r_71_8_104,seq15,seq131,r_71_8_104,0.81,1,105,104,54
41,r_140_2_101,seq50,seq119,r_140_2_101,1.0,2,103,101,54
67,seq43,r_78_120_116,seq12,r_78_120_116,1.0,1,117,116,54
39,r_19_33_14,r_64_145_91,seq131,r_19_33_14,0.97,3,17,14,54
3,r_78_120_116,seq43,r_128_1_9,r_78_120_116,0.99,0,116,116,54
28,r_41_16_39,seq25,r_87_6_19,r_41_16_39,0.59,3,42,39,54
13,r_134_137_25,r_11_136_99,r_29_37_21,r_134_137_25,0.99,0,25,25,54
0,r_0_9_63,r_24_105_161,r_87_6_19,r_0_9_63,0.73,0,63,63,54
20,r_100_27_152,r_115_102_174,seq38,r_100_27_152,0.76,0,152,152,54
98,seq126,r_55_10_87,r_23_79_24,r_23_79_24,0.89,-1,23,24,54
49,r_18_40_96,r_19_33_14,r_75_123_100,r_18_40_96,1.0,4,100,96,54
57,seq147,r_115_102_174,r_65_90_82,r_65_90_82,1.0,92,174,82,54
12,r_11_136_99,r_24_105_161,r_88_32_130,r_11_136_99,0.97,73,172,99,54
36,r_86_69_54,r_59_17_196,seq146,r_86_69_54,1.0,0,54,54,54
6,r_138_113_157,r_115_102_174,r_134_137_25,r_134_137_25,0.56,132,157,25,54
11,r_7_54_48,r_77_4_90,seq28,r_7_54_48,0.84,1,49,48,54
45,r_117_132_45,r_138_113_157,r_143_111_154,r_117_132_45,1.0,0,45,45,54
27,r_70_109_140,r_115_102_174,r_18_40_96,r_70_109_140,0.96,0,140,140,54
7,r_24_105_161,r_42_95_168,r_11_136_99,r_24_105_161,0.85,-61,100,161,54
9,r_87_6_19,r_83_13_155,seq147,r_87_6_19,1.0,0,19,19,54
2,r_143_111_154,r_30_129_183,r_23_79_24,r_30_129_183,0.86,-27,156,183,54
74,seq58,r_23_79_24,r_112_72_142,r_23_79_24,0.61,53,77,24,54
18,r_77_4_90,seq119,seq118,r_77_4_90,1.0,1,91,90,54
29,r_88_32_130,seq106,seq133,r_88_32_130,0.88,0,130,130,54
24,r_76_21_80,seq148,seq66,r_76_21_80,1.0,0,80,80,54
5,r_81_82_26,seq130,seq38,r_81_82_26,1.0,2,28,26,54
7,r_24_105_161,r_11_136_99,seq119,r_24_105_161,1.0,-1,160,161,54
38,r_30_129_183,r_143_111_154,seq96,r_143_111_154,0.73,2,156,154,54
23,r_144_51_43,r_125_104_176,seq103,r_144_51_43,0.62,0,43,43,54
34,r_47_26_11,r_140_2_101,seq131,r_47_26_11,0.65,0,11,11,54
90,seq103,seq146,r_144_51_43,r_144_51_43,1.0,0,43,43,54
45,r_117_132_45,r_143_111_154,seq96,r_143_111_154,0.6,-2,152,154,54
48,r_59_17_196,r_86_69_54,r_42_95_168,r_86_69_54,0.87,0,54,54,54
96,seq122,r_3_63_178,r_144_51_43,r_144_51_43,1.0,133,176,43,54
22,r_73_107_5,r_78_120_116,r_110_61_113,r_78_120_116,1.0,-25,91,116,54
42,r_29_37_21,seq85,seq38,r_29_37_21,1.0,0,21,21,54
7,r_24_105_161,r_0_9_63,r_42_95_168,r_0_9_63,0.86,0,63,63,54
44,r_93_14_94,r_70_109_140,r_59_17_196,r_93_14_94,0.81,0,94,94,54
32,r_23_79_24,r_44_149_138,seq126,r_23_79_24,0.94,-1,23,24,54
48,r_59_17_196,r_42_95_168,r_93_14_94,r_93_14_94,0.53,0,94,94,54
35,r_110_61_113,seq12,r_73_107_5,r_73_107_5,0.69,132,137,5,54
12,r_11_136_99,r_70_109_140,r_24_105_161,r_70_109_140,0.67,-41,99,140,54
30,r_99_111_64,r_124_1_132,seq128,r_99_111_64,0.74,8,72,64,55
36,r_14_141_43,r_143_23_182,seq107,r_14_141_43,0.3,139,182,43,55
38,r_70_131_37,r_35_90_95,seq28,r_70_131_37,1.0,1,38,37,55
54,seq136,r_44_58_77,seq40,r_44_58_77,1.0,3,80,77,55
21,r_35_90_95,seq80,r_82_97_44,r_35_90_95,0.98,0,95,95,55
1,r_47_117_126,r_133_55_148,r_70_131_37,r_47_117_126,0.97,0,126,126,55
5,r_124_1_132,r_68_138_190,r_44_58_77,r_44_58_77,0.69,58,135,77,55
65,seq25,r_75_66_196,r_82_97_44,r_82_97_44,1.0,7,51,44,55
16,r_56_51_38,r_39_29_124,seq25,r_56_51_38,0.64,0,38,38,55
38,r_70_131_37,seq28,r_47_117_126,r_47_117_126,1.0,28,154,126,55
31,r_140_112_79,r_72_110_75,seq37,r_140_112_79,1.0,-4,75,79,55
10,r_87_85_149,r_69_8_176,r_98_125_186,r_98_125_186,0.53,-25,161,186,55
42,r_7_115_56,r_142_0_168,r_60_17_117,r_7_115_56,1.0,0,56,56,55
26,r_67_88_142,seq62,r_63_132_81,r_67_88_142,0.7,0,142,142,55
47,r_60_17_117,r_7_115_56,r_44_58_77,r_60_17_117,1.0,0,117,117,55
14,r_108_79_23,r_24_137_83,seq42,r_24_137_83,1.0,1,84,83,55
4,r_24_137_83,seq57,seq144,r_24_137_83,0.99,-2,81,83,55
0,r_49_71_163,seq119,r_54_3_87,r_54_3_87,0.95,81,168,87,55
11,r_101_33_96,r_142_0_168,seq41,r_101_33_96,1.0,0,96,96,55
68,seq28,seq15,r_70_131_37,r_70_131_37,1.0,10,47,37,55
13,r_76_10_154,r_75_66_196,r_35_90_95,r_35_90_95,0.92,12,107,95,55
98,seq121,r_50_38_166,r_87_85_149,r_87_85_149,0.77,18,167,149,55
44,r_48_102_24,r_143_23_182,r_44_58_77,r_143_23_182,0.54,-124,58,182,55
49,r_63_132_81,r_143_23_182,r_67_88_142,r_67_88_142,0.88,11,153,142,55
15,r_72_110_75,r_140_112_79,seq62,r_72_110_75,1.0,0,75,75,55
66,seq26,seq145,r_77_122_40,r_77_122_40,1.0,10,50,40,55
48,r_68_138_190,r_124_1_132,r_24_137_83,r_24_137_83,0.95,52,135,83,55
6,r_149_92_123,r_69_8_176,r_99_111_64,r_149_92_123,0.71,0,123,123,55
13,r_76_10_154,r_35_90_95,seq28,r_76_10_154,1.0,0,154,154,55
29,r_104_45_82,r_65_127_27,r_54_3_87,r_65_127_27,0.94,-8,19,27,55
2,r_44_58_77,seq136,seq9,r_44_58_77,1.0,3,80,77,55
47,r_60_17_117,seq41,r_7_115_56,r_7_115_56,1.0,4,60,56,55
74,seq46,r_142_0_168,r_149_92_123,r_149_92_123,0.61,52,175,123,55
25,r_34_16_12,r_140_112_79,r_21_94_194,r_34_16_12,0.56,64,76,12,55
34,r_61_134_14,seq129,seq144,r_61_134_14,1.0,0,14,14,55
45,r_20_2_15,r_47_117_126,seq62,r_20_2_15,0.98,0,15,15,55
14,r_108_79_23,seq146,r_24_137_83,r_108_79_23,0.97,0,23,23,55
42,r_7_115_56,r_60_17_117,r_101_33_96,r_7_115_56,0.76,61,117,56,55
52,seq6,r_69_8_176,r_44_58_77,r_44_58_77,1.0,99,176,77,55
68,seq28,r_70_131_37,r_76_10_154,r_76_10_154,1.0,0,154,154,55
22,r_13_32_18,r_108_79_23,seq129,r_13_32_18,1.0,0,18,18,55
25,r_34_16_12,r_21_94_194,seq107,r_21_94_194,0.61,-45,149,194,55
9,r_143_23_182,r_14_141_43,r_44_58_77,r_44_58_77,0.99,105,182,77,55
96,seq119,r_49_71_163,r_142_0_168,r_142_0_168,0.6,0,168,168,55
18,r_59_86_10,seq41,seq105,r_59_86_10,0.98,0,10,10,55
29,r_104_45_82,r_54_3_87,r_99_111_64,r_104_45_82,0.53,1,83,82,55
28,r_39_29_124,seq62,r_35_90_95,r_39_29_124,0.92,5,129,124,55
8,r_82_97_44,r_101_33_96,seq25,r_101_33_96,0.76,-50,46,96,55
19,r_77_122_40,r_75_66_196,seq26,r_77_122_40,0.99,0,40,40,55
7,r_11_130_46,r_143_23_182,seq41,r_11_130_46,1.0,0,46,46,55
30,r_59_133_131,r_15_48_173,seq125,r_59_133_131,0.99,0,131,131,56
36,r_126_76_77,r_114_148_73,r_6_87_29,r_6_87_29,1.0,61,90,29,56
92,seq112,seq80,r_95_92_90,r_95_92_90,1.0,17,107,90,56
83,seq91,r_83_109_110,seq119,r_83_109_110,1.0,0,110,110,56
37,r_88_135_62,seq110,seq116,r_88_135_62,1.0,1,63,62,56
3,r_108_37_187,r_1_97_184,r_139_62_14,r_139_62_14,0.43,173,187,14,56
16,r_5_18_68,seq60,r_30_79_8,r_5_18_68,1.0,0,68,68,56
5,r_72_141_194,r_127_69_170,r_114_148_73,r_114_148_73,1.0,80,153,73,56
46,r_25_65_70,seq57,seq125,r_25_65_70,1.0,0,70,70,56
42,r_123_104_75,seq90,seq42,r_123_104_75,1.0,2,77,75,56
69,seq49,r_77_81_189,r_75_12_115,r_75_12_115,1.0,61,176,115,56
38,r_68_55_17,seq134,r_27_3_120,r_68_55_17,0.95,0,17,17,56
43,r_140_74_61,r_64_117_24,r_63_131_84,r_140_74_61,0.99,0,61,61,56
38,r_68_55_17,r_27_3_120,r_66_0_78,r_27_3_120,0.97,-37,83,120,56
31,r_95_92_90,r_149_53_175,seq105,r_95_92_90,1.0,0,90,90,56
24,r_86_31_82,r_24_28_43,r_130_45_38,r_86_31_82,0.98,-39,43,82,56
17,r_143_54_46,r_140_74_61,seq16,r_143_54_46,1.0,0,46,46,56
3,r_108_37_187,r_126_76_77,r_1_97_184,r_126_76_77,1.0,-12,65,77,56
10,r_36_43_72,r_83_109_110,r_6_87_29,r_36_43_72,1.0,0,72,72,56
40,r_8_84_44,seq57,seq60,r_8_84_44,1.0,1,45,44,56
43,r_140_74_61,r_63_131_84,seq61,r_63_131_84,0.93,0,84,84,56
26,r_127_69_170,r_72_141_194,seq70,r_127_69_170,0.8,0,170,170,56
4,r_139_62_14,seq146,r_15_48_173,r_139_62_14,1.0,0,14,14,56
0,r_63_131_84,r_126_76_77,r_140_74_61,r_140_74_61,0.91,2,63,61,56
1,r_56_23_30,r_64_117_24,seq57,r_64_117_24,0.89,-8,16,24,56
20,r_75_12_115,r_149_53_175,seq125,r_75_12_115,1.0,1,116,115,56
13,r_99_111_138,r_4_33_190,seq110,r_99_111_138,0.41,10,148,138,56
39,r_6_87_29,r_13_58_93,r_36_43_72,r_6_87_29,1.0,48,77,29,56
0,r_63_131_84,r_140_74_61,seq128,r_63_131_84,0.99,0,84,84,56
15,r_15_48_173,r_59_133_131,seq16,r_59_133_131,0.75,0,131,131,56
4,r_139_62_14,r_15_48_173,seq16,r_139_62_14,0.56,119,133,14,56
6,r_122_120_179,seq60,r_139_62_14,r_139_62_14,0.91,164,178,14,56
64,seq40,r_75_12_115,r_30_79_8,r_75_12_115,0.81,-82,33,115,56
41,r_130_45_38,r_129_102_192,r_86_31_82,r_130_45_38,0.99,0,38,38,56
87,seq103,r_149_53_175,r_5_18_68,r_5_18_68,1.0,108,176,68,56
2,r_11_137_3,r_140_74_61,r_64_117_24,r_140_74_61,1.0,0,61,61,56
47,r_118_52_67,seq80,seq29,r_118_52_67,1.0,0,67,67,56
45,r_27_3_120,r_85_39_112,r_68_55_17,r_68_55_17,1.0,0,17,17,56
18,r_136_138_71,r_1_97_184,seq82,r_136_138_71,1.0,0,71,71,56
29,r_67_100_165,seq46,r_83_109_110,r_83_109_110,0.78,55,165,110,56
8,r_35_38_10,r_147_132_140,seq90,r_35_38_10,0.96,0,10,10,56
25,r_66_0_78,r_85_39_112,r_68_55_17,r_66_0_78,0.51,5,83,78,56
33,r_83_109_110,seq91,seq47,r_83_109_110,0.6,0,110,110,56
72,seq57,r_8_84_44,r_56_23_30,r_8_84_44,1.0,1,45,44,56
34,r_19_10_128,seq16,seq105,r_19_10_128,0.99,1,129,128,56
23,r_24_28_43,r_86_31_82,seq80,r_24_28_43,0.96,0,43,43,56
75,seq70,r_1_97_184,r_127_69_170,r_127_69_170,0.99,3,173,170,56
45,r_27_3_120,r_68_55_17,r_25_65_70,r_27_3_120,0.99,0,120,120,56
96,seq119,r_17_101_183,r_44_2_121,r_44_2_121,1.0,16,137,121,56
22,r_1_97_184,seq145,seq61,r_1_97_184,0.23,2,186,184,56
28,r_147_132_140,seq61,r_59_133_131,r_147_132_140,0.66,1,141,140,56
43,r_140_74_61,r_143_54_46,r_64_117_24,r_143_54_46,0.61,0,46,46,56
49,r_44_2_121,seq60,seq119,r_44_2_121,0.95,0,121,121,56
7,r_13_58_93,r_6_87_29,seq14,r_13_58_93,1.0,1,94,93,56
44,r_114_148_73,r_126_76_77,r_72_141_194,r_72_141_194,1.0,-121,73,194,56
41,r_130_45_38,seq142,r_15_48_173,r_15_48_173,0.62,0,173,173,56
79,seq82,seq60,r_136_138_71,r_136_138_71,1.0,2,73,71,56
24,r_86_31_82,r_130_45_38,seq116,r_86_31_82,0.91,0,82,82,56
35,r_149_53_175,seq103,r_66_0_78,r_149_53_175,0.47,1,176,175,56
12,r_17_101_183,seq119,r_5_18_68,r_17_101_183,0.53,0,183,183,56
39,r_6_87_29,r_15_48_173,r_13_58_93,r_15_48_173,0.51,-131,42,173,56
19,r_64_117_24,r_56_23_30,r_11_137_3,r_64_117_24,1.0,-3,21,24,56
15,r_15_48_173,seq16,r_130_45_38,r_15_48_173,1.0,0,173,173,56
41,r_130_45_38,r_86_31_82,seq142,r_86_31_82,1.0,2,84,82,56
30,r_108_137_136,r_85_143_170,r_147_39_32,r_108_137_136,0.66,0,136,136,57
31,r_131_13_39,seq70,seq94,r_131_13_39,1.0,0,39,39,57
36,r_133_69_127,seq91,seq62,r_133_69_127,0.93,0,127,127,57
9,r_99_106_18,r_28_41_151,r_133_69_127,r_99_106_18,0.88,134,152,18,57
14,r_105_107_97,seq141,seq55,r_105_107_97,0.99,0,97,97,57
8,r_77_98_77,r_36_140_123,r_64_145_4,r_77_98_77,0.94,0,77,77,57
19,r_28_41_151,r_58_125_128,r_99_106_18,r_99_106_18,1.0,-2,16,18,57
3,r_26_144_52,r_130_30_188,r_57_142_140,r_57_142_140,0.91,6,146,140,57
19,r_28_41_151,r_99_106_18,seq2,r_99_106_18,0.65,134,152,18,57
5,r_130_30_188,r_67_123_132,r_26_144_52,r_130_30_188,0.92,-110,78,188,57
46,r_64_145_4,r_11_45_135,r_36_140_123,r_64_145_4,0.52,122,126,4,57
18,r_72_129_31,seq24,seq49,r_72_129_31,0.55,-2,29,31,57
21,r_147_39_32,r_54_139_149,seq78,r_147_39_32,0.64,-1,31,32,57
1,r_29_60_55,r_26_144_52,seq21,r_26_144_52,0.49,-13,39,52,57
45,r_11_45_135,r_64_145_4,r_40_148_19,r_11_45_135,0.86,0,135,135,57
95,seq118,r_36_140_123,seq136,r_36_140_123,0.55,2,125,123,57
39,r_135_25_10,r_93_50_179,r_110_100_138,r_110_100_138,0.43,39,177,138,57
41,r_19_103_112,seq52,r_61_31_66,r_61_31_66,0.99,49,115,66,57
44,r_61_31_66,r_64_145_4,seq49,r_61_31_66,0.98,0,66,66,57
10,r_110_100_138,r_130_30_188,r_73_134_78,r_130_30_188,0.59,-46,142,188,57
9,r_99_106_18,r_133_69_127,r_28_41_151,r_99_106_18,0.63,-2,16,18,57
39,r_135_25_10,r_29_60_55,r_93_50_179,r_135_25_10,0.97,0,10,10,57
8,r_77_98_77,r_64_145_4,seq120,r_64_145_4,0.48,133,137,4,57
34,r_47_146_5,seq17,r_27_126_134,r_27_126_134,1.0,37,171,134,57
4,r_53_12_104,seq56,seq18,r_53_12_104,0.99,0,104,104,57
44,r_61_31_66,seq49,r_19_103_112,r_19_103_112,0.55,-4,108,112,57
73,seq55,seq23,r_105_107_97,r_105_107_97,0.98,4,101,97,57
11,r_58_125_128,r_28_41_151,seq49,r_58_125_128,0.64,2,130,128,57
98,seq122,r_112_37_98,seq118,r_112_37_98,1.0,-15,83,98,57
15,r_71_63_65,r_128_68_194,r_131_13_39,r_71_63_65,1.0,0,65,65,57
49,r_73_134_78,r_93_50_179,r_110_100_138,r_110_100_138,0.9,18,156,138,57
85,seq91,r_133_69_127,r_29_60_55,r_133_69_127,0.63,0,127,127,57
34,r_47_146_5,r_75_115_57,seq17,r_75_115_57,1.0,2,59,57,57
99,seq149,r_130_30_188,r_85_143_170,r_130_30_188,0.45,-15,173,188,57
5,r_130_30_188,r_26_144_52,r_32_0_53,r_130_30_188,0.55,1,189,188,57
43,r_32_0_53,seq118,r_44_8_196,r_32_0_53,1.0,0,53,53,57
2,r_36_140_123,seq118,seq70,r_36_140_123,0.77,2,125,123,57
3,r_26_144_52,r_108_137_136,r_130_30_188,r_26_144_52,1.0,0,52,52,57
40,r_67_123_132,seq1,seq94,r_67_123_132,0.83,0,132,132,57
29,r_48_84_171,r_82_132_195,r_121_51_23,r_48_84_171,0.57,1,172,171,57
24,r_93_50_179,r_135_25_10,r_85_143_170,r_135_25_10,0.61,169,179,10,57
33,r_33_59_75,seq119,seq18,r_33_59_75,0.98,0,75,75,57
44,r_61_31_66,seq14,r_64_145_4,r_64_145_4,0.54,23,27,4,57
61,seq18,seq149,r_53_12_104,r_53_12_104,0.98,-4,100,104,57
32,r_112_37_98,seq122,r_83_88_58,r_112_37_98,1.0,0,98,98,57
38,r_81_127_99,seq6,r_105_107_97,r_81_127_99,0.63,0,99,99,57
47,r_96_10_33,r_85_143_170,r_121_51_23,r_96_10_33,0.71,0,33,33,57
17,r_5_124_152,seq94,seq49,r_5_124_152,0.56,2,154,152,57
27,r_75_115_57,seq14,seq66,r_75_115_57,1.0,0,57,57,57
49,r_73_134_78,seq56,r_93_50_179,r_73_134_78,1.0,-3,75,78,57
0,r_138_109_59,r_112_37_98,seq66,r_138_109_59,0.85,0,59,59,57
23,r_22_86_148,r_5_124_152,seq118,r_22_86_148,0.92,1,149,148,57
35,r_27_126_134,r_85_143_170,seq14,r_27_126_134,0.67,8,142,134,57
93,seq105,r_131_121_75,r_143_102_11,r_143_102_11,0.91,52,63,11,58
41,r_110_61_47,r_120_106_154,seq133,r_110_61_47,0.87,-2,45,47,58
36,r_100_42_112,r_120_106_154,r_70_31_61,r_100_42_112,0.75,2,114,112,58
92,seq99,r_109_21_7,r_34_14_52,r_34_14_52,1.0,61,113,52,58
14,r_55_82_101,seq11,r_32_69_107,r_55_82_101,1.0,0,101,101,58
8,r_16_127_158,seq132,seq123,r_16_127_158,0.77,4,162,158,58
43,r_73_28_194,seq56,r_24_104_96,r_24_104_96,1.0,4,100,96,58
17,r_118_107_106,seq56,r_111_17_146,r_111_17_146,1.0,4,150,146,58
3,r_142_136_22,r_45_44_177,r_71_95_184,r_71_95_184,0.6,1,185,184,58
5,r_70_31_61,seq123,seq114,r_70_31_61,0.79,-2,59,61,58
21,r_15_74_120,seq47,seq0,r_15_74_120,0.99,0,120,120,58
1,r_20_77_73,r_46_59_186,seq13,r_20_77_73,1.0,0,73,73,58
46,r_130_58_105,seq97,r_112_57_86,r_130_58_105,0.99,0,105,105,58
75,seq56,r_91_135_42,r_73_28_194,r_91_135_42,1.0,-3,39,42,58
42,r_76_6_127,seq47,r_81_60_93,r_81_60_93,1.0,28,121,93,58
45,r_140_75_189,seq43,seq30,r_140_75_189,0.35,0,189,189,58
19,r_25_18_133,seq27,r_29_10_26,r_25_18_133,0.95,0,133,133,58
39,r_88_94_20,r_16_127_158,seq84,r_88_94_20,0.97,-1,19,20,58
22,r_147_66_15,r_131_121_75,seq114,r_147_66_15,0.99,0,15,15,58
66,seq37,r_4_9_181,seq2,r_4_9_181,1.0,0,181,181,58
7,r_34_14_52,r_20_77_73,seq99,r_34_14_52,1.0,-1,51,52,58
76,seq62,r_90_103_162,r_34_14_52,r_34_14_52,1.0,111,163,52,58
31,r_29_10_26,r_55_82_101,r_120_106_154,r_29_10_26,1.0,0,26,26,58
10,r_119_12_13,r_4_9_181,seq72,r_119_12_13,1.0,0,13,13,58
32,r_79_146_60,r_143_102_11,r_81_60_93,r_81_60_93,0.98,6,99,93,58
26,r_129_101_74,r_4_9_181,seq93,r_4_9_181,0.77,-114,67,181,58
95,seq114,r_45_44_177,r_70_31_61,r_70_31_61,0.56,-2,59,61,58
0,r_111_17_146,seq39,r_118_107_106,r_111_17_146,0.91,0,146,146,58
20,r_117_148_149,seq33,seq132,r_117_148_149,0.84,0,149,149,58
13,r_24_104_96,seq67,r_73_28_194,r_24_104_96,0.99,2,98,96,58
6,r_85_113_24,r_90_103_162,seq43,r_85_113_24,1.0,0,24,24,58
15,r_32_69_107,seq84,r_55_82_101,r_32_69_107,1.0,2,109,107,58
11,r_116_40_21,seq26,seq124,r_116_40_21,0.91,0,21,21,58
27,r_1_115_55,seq13,r_147_66_15,r_1_115_55,0.97,1,56,55,58
85,seq84,r_32_69_107,seq89,r_32_69_107,0.99,3,110,107,58
40,r_134_137_168,r_4_9_181,seq39,r_134_137_168,0.57,1,169,168,58
74,seq54,r_48_52_126,seq123,r_48_52_126,1.0,1,127,126,58
29,r_112_57_86,r_117_148_149,seq67,r_112_57_86,0.99,0,86,86,58
24,r_145_23_70,r_76_6_127,seq89,r_145_23_70,0.99,1,71,70,58
38,r_143_102_11,r_142_136_22,seq105,r_143_102_11,0.98,0,11,11,58
25,r_87_22_145,seq133,seq99,r_87_22_145,0.67,0,145,145,58
98,seq124,seq30,r_116_40_21,r_116_40_21,1.0,6,27,21,58
58,seq144,r_76_6_127,r_131_121_75,r_76_6_127,0.65,21,148,127,58
35,r_120_106_154,r_110_61_47,r_29_10_26,r_29_10_26,1.0,3,29,26,58
32,r_79_146_60,r_87_22_145,r_143_102_11,r_79_146_60,1.0,1,61,60,58
34,r_81_60_93,seq26,r_79_146_60,r_81_60_93,1.0,2,95,93,58
3,r_142_136_22,r_55_82_101,r_45_44_177,r_142_136_22,0.85,-1,21,22,58
69,seq43,r_140_75_189,r_85_113_24,r_85_113_24,1.0,5,29,24,58
17,r_118_107_106,r_46_59_186,seq56,r_118_107_106,0.94,0,106,106,58
48,r_38_138_68,r_45_44_177,r_109_21_7,r_38_138_68,0.89,-25,43,68,58
31,r_29_10_26,r_120_106_154,r_25_18_133,r_25_18_133,0.89,24,157,133,58
28,r_48_52_126,seq54,seq144,r_48_52_126,0.97,0,126,126,58
18,r_91_135_42,seq56,seq86,r_91_135_42,1.0,0,42,42,58
49,r_128_68_140,seq133,seq149,r_128_68_140,0.95,3,143,140,58
23,r_90_103_162,seq62,r_109_21_7,r_109_21_7,0.37,156,163,7,58
16,r_19_5_30,r_32_69_107,seq133,r_19_5_30,1.0,1,31,30,58
12,r_71_95_184,seq65,r_142_136_22,r_142_136_22,0.69,163,185,22,58
6,r_79_89_21,r_55_142_168,seq102,r_79_89_21,1.0,1,22,21,59
44,r_118_140_6,r_51_70_75,r_91_36_162,r_118_140_6,0.69,165,171,6,59
8,r_146_93_146,r_121_99_149,r_45_44_145,r_121_99_149,0.99,-2,147,149,59
53,seq8,seq56,r_87_135_114,r_87_135_114,0.99,22,136,114,59
43,r_2_84_94,r_113_48_61,r_10_133_121,r_113_48_61,0.85,0,61,61,59
83,seq73,r_110_81_115,r_112_1_22,r_110_81_115,0.72,0,115,115,59
37,r_132_52_142,r_121_99_149,r_131_39_137,r_132_52_142,0.99,0,142,142,59
71,seq37,seq75,r_100_12_41,r_100_12_41,1.0,32,73,41,59
16,r_121_99_149,r_38_137_141,r_100_12_41,r_100_12_41,0.72,108,149,41,59
1,r_129_50_169,seq74,seq16,r_129_50_169,0.78,1,170,169,59
24,r_40_148_26,r_122_108_81,seq34,r_40_148_26,0.67,2,28,26,59
5,r_120_31_163,seq22,r_32_144_135,r_120_31_163,0.71,0,163,163,59
46,r_32_144_135,seq90,seq28,r_32_144_135,0.97,0,135,135,59
80,seq68,r_3_138_179,r_115_27_43,r_115_27_43,0.82,143,186,43,59
69,seq33,r_5_17_182,r_42_83_123,r_42_83_123,1.0,59,182,123,59
30,r_125_85_27,r_101_124_158,seq25,r_125_85_27,0.95,0,27,27,59
29,r_72_11_35,r_127_103_128,r_19_126_7,r_72_11_35,0.92,3,38,35,59
39,r_101_124_158,r_35_61_5,seq56,r_35_61_5,0.64,153,158,5,59
31,r_46_136_62,seq37,r_40_148_26,r_40_148_26,0.88,37,63,26,59
41,r_92_57_103,seq80,seq22,r_92_57_103,1.0,0,103,103,59
67,seq29,r_3_138_179,r_76_107_91,r_76_107_91,1.0,4,95,91,59
49,r_112_1_22,r_128_82_72,seq73,r_112_1_22,0.97,0,22,22,59
3,r_76_107_91,r_119_13_180,seq29,r_76_107_91,1.0,0,91,91,59
40,r_86_62_44,r_101_124_158,seq49,r_86_62_44,0.56,1,45,44,59
4,r_106_15_17,r_100_12_41,seq68,r_106_15_17,0.57,-3,14,17,59
0,r_141_43_124,r_121_99_149,r_110_81_115,r_141_43_124,0.55,0,124,124,59
19,r_115_27_43,seq56,seq68,r_115_27_43,0.6,2,45,43,59
11,r_110_81_115,seq73,seq16,r_110_81_115,1.0,0,115,115,59
20,r_38_137_141,r_121_99_149,r_40_148_26,r_40_148_26,0.98,123,149,26,59
15,r_113_48_61,r_2_84_94,seq71,r_2_84_94,0.98,-33,61,94,59
63,seq24,r_3_138_179,r_114_47_37,r_114_47_37,1.0,2,39,37,59
48,r_42_83_123,r_127_103_128,seq59,r_42_83_123,0.99,0,123,123,59
13,r_114_47_37,r_76_107_91,seq24,r_114_47_37,0.8,0,37,37,59
43,r_2_84_94,r_10_133_121,seq28,r_2_84_94,1.0,0,94,94,59
99,seq117,r_19_126_7,r_10_133_121,r_10_133_121,1.0,2,123,121,59
73,seq56,r_115_27_43,seq8,r_115_27_43,0.5,2,45,43,59
93,seq102,seq33,r_79_89_21,r_79_89_21,1.0,7,28,21,59
47,r_87_135_114,seq16,seq8,r_87_135_114,0.89,0,114,114,59
74,seq59,seq33,r_42_83_123,r_42_83_123,1.0,11,134,123,59
18,r_5_17_182,seq33,r_112_1_22,r_112_1_22,0.67,160,182,22,59
33,r_147_54_90,seq105,seq66,r_147_54_90,0.99,0,90,90,59
66,seq28,r_2_84_94,r_32_144_135,r_32_144_135,0.67,12,147,135,59
61,seq22,r_120_31_163,r_92_57_103,r_92_57_103,0.82,60,163,103,59
38,r_51_70_75,r_127_103_128,r_118_140_6,r_51_70_75,0.99,0,75,75,59
25,r_100_12_41,seq116,seq37,r_100_12_41,0.67,1,42,41,59
77,seq65,r_119_13_180,r_113_48_61,r_113_48_61,1.0,120,181,61,59
10,r_139_0_38,r_51_70_75,seq116,r_139_0_38,0.99,0,38,38,59
14,r_19_126_7,seq130,r_72_11_35,r_72_11_35,0.82,16,51,35,59
45,r_35_61_5,r_101_124_158,r_114_47_37,r_114_47_37,1.0,121,158,37,59
17,r_119_13_180,seq65,r_146_93_146,r_146_93_146,0.99,35,181,146,59
9,r_128_82_72,seq9,seq102,r_128_82_72,1.0,0,72,72,59
96,seq109,r_55_142_168,r_92_57_103,r_92_57_103,1.0,68,171,103,59
22,r_96_4_100,seq14,seq149,r_96_4_100,0.99,1,101,100,59
73,seq56,seq8,r_101_124_158,r_101_124_158,0.57,-15,143,158,59
7,r_127_103_128,r_41_21_195,r_122_108_81,r_122_108_81,1.0,48,129,81,59
44,r_118_140_6,r_63_94_134,r_51_70_75,r_51_70_75,0.8,62,137,75,59
23,r_134_123_76,seq37,r_79_89_21,r_134_123_76,0.96,0,76,76,59
35,r_45_44_145,r_101_124_158,r_146_93_146,r_101_124_158,0.99,-11,147,158,59
12,r_10_133_121,seq149,seq117,r_10_133_121,0.97,0,121,121,59
22,r_89_123_44,seq19,seq126,r_89_123_44,0.89,0,44,44,60
30,r_120_51_85,seq7,seq81,r_120_51_85,0.97,1,86,85,60
0,r_88_98_28,seq96,seq16,r_88_98_28,1.0,0,28,28,60
36,r_149_2_112,seq13,r_28_15_23,r_149_2_112,0.92,-10,102,112,60
48,r_80_131_31,r_105_78_186,seq49,r_80_131_31,1.0,0,31,31,60
18,r_23_66_15,r_124_87_145,r_40_21_89,r_23_66_15,0.56,29,44,15,60
8,r_143_65_131,r_146_69_170,seq13,r_143_65_131,0.91,0,131,131,60
41,r_25_103_49,r_4_122_188,r_6_110_14,r_25_103_49,0.99,0,49,49,60
43,r_57_50_139,seq35,r_89_123_44,r_57_50_139,0.9,2,141,139,60
37,r_94_109_142,seq67,seq35,r_94_109_142,0.87,1,143,142,60
19,r_28_15_23,r_4_122_188,r_149_2_112,r_149_2_112,0.8,-11,101,112,60
55,seq7,r_120_51_85,seq93,r_120_51_85,1.0,1,86,85,60
16,r_79_11_187,seq107,r_105_78_186,r_105_78_186,0.68,1,187,186,60
85,seq96,r_88_98_28,r_6_110_14,r_88_98_28,0.79,0,28,28,60
46,r_97_118_77,seq145,r_63_33_113,r_63_33_113,1.0,7,120,113,60
21,r_105_78_186,r_80_131_31,r_20_31_5,r_80_131_31,1.0,0,31,31,60
35,r_121_68_27,seq104,seq5,r_121_68_27,1.0,0,27,27,60
26,r_34_30_47,seq119,seq101,r_34_30_47,1.0,1,48,47,60
76,seq67,r_94_109_142,r_90_70_175,r_94_109_142,1.0,1,143,142,60
31,r_44_85_71,seq16,seq125,r_44_85_71,0.99,0,71,71,60
27,r_1_38_35,seq56,seq125,r_1_38_35,1.0,0,35,35,60
10,r_9_52_165,r_43_53_88,seq107,r_43_53_88,0.64,4,92,88,60
19,r_28_15_23,seq125,r_4_122_188,r_28_15_23,0.9,1,24,23,60
11,r_124_87_145,r_111_10_6,seq81,r_124_87_145,0.7,0,145,145,60
20,r_92_71_81,r_97_118_77,seq5,r_97_118_77,0.6,9,86,77,60
5,r_135_130_11,r_22_18_196,seq125,r_135_130_11,0.92,3,14,11,60
13,r_115_139_87,seq128,seq35,r_115_139_87,1.0,0,87,87,60
42,r_83_113_80,r_1_38_35,r_115_139_87,r_83_113_80,0.39,34,114,80,60
15,r_117_61_96,r_54_140_135,r_34_30_47,r_34_30_47,1.0,49,96,47,60
57,seq138,r_59_37_151,seq86,r_59_37_151,1.0,1,152,151,60
21,r_105_78_186,r_20_31_5,seq133,r_20_31_5,0.33,182,187,5,60
99,seq126,seq128,r_89_123_44,r_89_123_44,0.76,34,78,44,60
5,r_135_130_11,seq125,seq35,r_135_130_11,0.46,104,115,11,60
39,r_64_108_56,seq16,seq42,r_64_108_56,1.0,0,56,56,60
2,r_82_0_78,r_112_36_155,seq91,r_82_0_78,0.79,0,78,78,60
40,r_8_24_98,r_20_31_5,seq136,r_8_24_98,0.91,-1,97,98,60
29,r_43_53_88,r_9_52_165,seq26,r_43_53_88,0.69,4,92,88,60
24,r_27_100_91,seq5,seq104,r_27_100_91,0.99,1,92,91,60
25,r_40_21_89,seq72,r_47_73_79,r_40_21_89,0.8,18,107,89,60
33,r_137_95_190,seq41,r_117_61_96,r_117_61_96,0.43,93,189,96,60
98,seq125,seq104,r_1_38_35,r_1_38_35,1.0,13,48,35,60
68,seq41,r_112_36_155,r_76_55_149,r_76_55_149,0.87,8,157,149,60
32,r_47_73_79,r_32_58_92,seq42,r_47_73_79,0.65,0,79,79,60
38,r_59_37_151,seq138,seq129,r_59_37_151,0.84,1,152,151,60
34,r_112_36_155,seq41,r_20_31_5,r_20_31_5,0.78,152,157,5,60
4,r_29_14_38,r_76_55_149,r_9_52_165,r_29_14_38,0.99,0,38,38,60
17,r_20_31_5,r_105_78_186,r_112_36_155,r_112_36_155,0.85,-2,153,155,60
9,r_76_55_149,seq81,seq41,r_76_55_149,0.9,0,149,149,60
26,r_34_30_47,seq101,r_117_61_96,r_34_30_47,0.51,110,157,47,60
49,r_63_33_113,seq12,r_97_118_77,r_63_33_113,1.0,0,113,113,60
56,seq136,r_146_69_170,r_8_24_98,r_8_24_98,1.0,50,148,98,60
7,r_111_10_6,r_124_87_145,r_9_52_165,r_124_87_145,0.76,-3,142,145,60
18,r_23_66_15,r_40_21_89,r_32_58_92,r_23_66_15,0.32,106,121,15,60
23,r_32_58_92,seq62,r_6_110_14,r_6_110_14,0.68,81,95,14,60
93,seq102,r_26_65_51,r_8_89_103,r_8_89_103,1.0,14,117,103,61
30,r_76_33_54,seq19,seq27,r_76_33_54,0.8,8,62,54,61
51,seq1,r_114_139_128,r_143_75_74,r_143_75_74,0.93,3,77,74,61
36,r_7_25_88,r_104_91_100,seq133,r_7_25_88,0.98,1,89,88,61
29,r_47_101_50,seq27,seq35,r_47_101_50,0.99,-5,45,50,61
8,r_125_63_104,r_56_115_168,seq149,r_125_63_104,1.0,0,104,104,61
37,r_72_0_139,seq12,seq23,r_72_0_139,0.94,0,139,139,61
3,r_138_147_176,r_37_16_25,r_3_52_107,r_138_147_176,0.77,0,176,176,61
16,r_118_103_183,seq105,r_80_67_175,r_80_67_175,0.91,8,183,175,61
21,r_95_124_166,r_56_115_168,r_3_52_107,r_95_124_166,0.55,0,166,166,61
1,r_111_135_28,r_131_83_187,r_11_107_110,r_11_107_110,0.99,1,111,110,61
97,seq117,seq92,r_78_84_111,r_78_84_111,0.96,3,114,111,61
46,r_79_24_162,seq98,r_39_30_21,r_79_24_162,0.63,0,162,162,61
42,r_80_67_175,seq2,r_118_103_183,r_118_103_183,0.69,3,186,183,61
43,r_131_83_187,r_3_52_107,r_111_135_28,r_111_135_28,1.0,4,32,28,61
24,r_122_119_135,r_111_135_28,seq20,r_122_119_135,0.99,0,135,135,61
73,seq41,r_116_106_17,r_126_5_199,r_116_106_17,0.56,0,17,17,61
69,seq31,seq97,r_10_62_113,r_10_62_113,0.99,1,114,113,61
45,r_114_139_128,seq55,r_78_84_111,r_114_139_128,0.81,1,129,128,61
19,r_42_112_181,seq51,r_78_84_111,r_78_84_111,1.0,72,183,111,61
95,seq108,r_88_68_71,seq55,r_88_68_71,1.0,0,71,71,61
76,seq51,r_42_112_181,r_37_16_25,r_37_16_25,0.95,157,182,25,61
31,r_58_50_92,seq17,seq6,r_58_50_92,0.99,1,93,92,61
3,r_138_147_176,r_42_112_181,r_37_16_25,r_37_16_25,1.0,72,97,25,61
10,r_11_107_110,r_29_73_122,r_111_135_28,r_111_135_28,0.63,82,110,28,61
87,seq90,r_54_127_167,r_132_57_53,r_132_57_53,1.0,0,53,53,61
4,r_121_13_197,seq28,r_61_60_81,r_61_60_81,1.0,5,86,81,61
78,seq55,r_114_139_128,seq108,r_114_139_128,0.95,-10,118,128,61
26,r_15_142_34,seq123,seq28,r_15_142_34,1.0,1,35,34,61
63,seq20,r_138_147_176,r_122_119_135,r_122_119_135,0.72,1,136,135,61
11,r_104_91_100,seq148,seq53,r_104_91_100,0.36,11,111,100,61
22,r_132_57_53,r_36_66_6,seq90,r_132_57_53,1.0,0,53,53,61
13,r_45_146_120,r_26_65_51,r_3_52_107,r_45_146_120,0.97,0,120,120,61
98,seq148,r_43_145_98,r_88_68_71,r_88_68_71,1.0,13,84,71,61
15,r_134_74_105,r_116_106_17,seq140,r_134_74_105,0.99,0,105,105,61
48,r_8_89_103,r_118_103_183,seq102,r_8_89_103,0.99,1,104,103,61
57,seq12,r_72_0_139,seq98,r_72_0_139,1.0,0,139,139,61
67,seq27,r_47_101_50,r_76_33_54,r_47_101_50,0.92,-3,47,50,61
0,r_78_84_111,seq117,r_114_139_128,r_114_139_128,1.0,5,133,128,61
2,r_3_52_107,r_122_119_135,r_45_146_120,r_3_52_107,0.97,21,128,107,61
47,r_10_62_113,r_126_5_199,seq31,r_10_62_113,0.88,0,113,113,61
38,r_21_87_41,seq31,r_26_65_51,r_21_87_41,1.0,2,43,41,61
24,r_122_119_135,r_3_52_107,r_111_135_28,r_111_135_28,1.0,71,99,28,61
25,r_85_9_66,seq32,seq109,r_85_9_66,1.0,1,67,66,61
43,r_131_83_187,r_111_135_28,r_37_16_25,r_37_16_25,0.5,163,188,25,61
33,r_61_60_81,r_42_112_181,r_121_13_197,r_61_60_81,1.0,2,83,81,61
14,r_37_16_25,r_93_136_173,seq90,r_37_16_25,0.99,0,25,25,61
34,r_88_68_71,seq108,seq148,r_88_68_71,1.0,0,71,71,61
5,r_39_30_21,r_143_75_74,r_36_66_6,r_39_30_21,0.92,0,21,21,61
1,r_111_135_28,seq23,r_131_83_187,r_111_135_28,0.99,0,28,28,61
17,r_129_44_79,r_134_74_105,r_15_142_34,r_129_44_79,1.0,0,79,79,61
94,seq105,r_118_103_183,r_37_16_25,r_37_16_25,1.0,158,183,25,61
9,r_143_75_74,r_29_73_122,seq1,r_143_75_74,0.98,0,74,74,61
96,seq109,seq97,r_85_9_66,r_85_9_66,1.0,21,87,66,61
6,r_36_66_6,seq4,r_39_30_21,r_39_30_21,0.73,6,27,21,61
28,r_116_106_17,r_134_74_105,seq23,r_134_74_105,0.91,0,105,105,61
73,seq41,r_126_5_199,r_129_44_79,r_129_44_79,0.42,16,95,79,61
49,r_26_65_51,seq148,r_21_87_41,r_21_87_41,0.99,20,61,41,61
7,r_29_73_122,seq82,r_111_135_28,r_29_73_122,1.0,6,128,122,61
56,seq137,r_104_91_100,r_59_38_68,r_59_38_68,1.0,34,102,68,61
7,r_29_73_122,r_143_75_74,seq82,r_143_75_74,0.99,0,74,74,61
44,r_120_18_127,seq133,r_116_106_17,r_120_18_127,0.99,1,128,127,61
23,r_93_136_173,seq128,r_104_91_100,r_93_136_173,0.36,2,175,173,61
82,seq140,r_54_127_167,r_37_16_25,r_37_16_25,0.96,145,170,25,61
79,seq69,r_80_67_175,r_54_127_167,r_54_127_167,0.96,6,173,167,61
35,r_126_5_199,r_10_62_113,seq6,r_10_62_113,1.0,0,113,113,61
12,r_59_38_68,seq149,seq137,r_59_38_68,1.0,0,68,68,61
41,r_101_21_45,r_42_130_175,r_13_3_152,r_101_21_45,0.72,0,45,45,62
33,r_42_130_175,r_101_21_45,r_74_139_38,r_42_130_175,0.61,-130,45,175,62
30,r_50_92_180,r_60_8_196,r_75_79_48,r_75_79_48,1.0,133,181,48,62
19,r_16_104_42,seq56,seq31,r_16_104_42,1.0,1,43,42,62
36,r_135_136_168,seq129,r_109_32_88,r_109_32_88,0.98,80,168,88,62
14,r_78_147_178,r_34_149_142,r_74_139_38,r_78_147_178,0.96,-34,144,178,62
8,r_15_23_112,r_19_70_145,r_94_38_79,r_19_70_145,1.0,-33,112,145,62
43,r_144_46_148,r_112_24_190,r_145_90_166,r_144_46_148,0.42,2,150,148,62
13,r_74_139_38,r_65_146_197,r_42_130_175,r_74_139_38,1.0,5,43,38,62
37,r_13_3_152,r_112_24_190,r_63_44_133,r_63_44_133,1.0,27,160,133,62
4,r_75_79_48,seq2,seq30,r_75_79_48,1.0,0,48,48,62
5,r_11_29_161,seq76,r_109_32_88,r_109_32_88,0.72,73,161,88,62
46,r_14_115_80,seq138,r_109_32_88,r_14_115_80,1.0,4,84,80,62
42,r_19_70_145,r_15_23_112,r_102_0_31,r_19_70_145,0.87,-33,112,145,62
80,seq81,seq9,r_61_58_108,r_61_58_108,1.0,5,113,108,62
45,r_34_149_142,r_78_147_178,r_119_43_117,r_34_149_142,0.55,0,142,142,62
33,r_42_130_175,r_74_139_38,r_22_120_5,r_74_139_38,0.8,137,175,38,62
31,r_48_64_76,r_148_116_124,r_66_91_25,r_48_64_76,1.0,0,76,76,62
3,r_84_97_144,seq126,r_52_7_18,r_84_97_144,0.77,0,144,144,62
90,seq99,seq122,r_142_73_23,r_142_73_23,1.0,79,102,23,62
1,r_123_71_150,r_4_69_96,r_94_38_79,r_94_38_79,0.67,0,79,79,62
0,r_119_43_117,seq98,seq27,r_119_43_117,0.99,0,117,117,62
63,seq27,seq132,r_119_43_117,r_119_43_117,1.0,8,125,117,62
14,r_78_147_178,r_74_139_38,r_13_3_152,r_78_147_178,0.66,0,178,178,62
11,r_53_59_14,r_11_29_161,seq6,r_53_59_14,1.0,0,14,14,62
20,r_94_38_79,r_68_86_82,r_123_71_150,r_94_38_79,0.99,0,79,79,62
48,r_96_45_69,seq56,seq95,r_96_45_69,1.0,0,69,69,62
35,r_110_33_36,r_14_115_80,seq76,r_110_33_36,0.98,1,37,36,62
1,r_123_71_150,r_94_38_79,seq67,r_123_71_150,0.93,0,150,150,62
13,r_74_139_38,r_42_130_175,r_75_79_48,r_42_130_175,0.58,0,175,175,62
6,r_4_69_96,r_148_116_124,seq98,r_4_69_96,0.95,0,96,96,62
27,r_10_141_83,r_47_54_84,seq12,r_10_141_83,1.0,0,83,83,62
49,r_63_44_133,r_11_29_161,r_101_21_45,r_63_44_133,0.98,0,133,133,62
40,r_111_118_185,seq137,r_103_134_67,r_111_118_185,0.3,1,186,185,62
18,r_103_134_67,seq132,seq85,r_103_134_67,1.0,0,67,67,62
29,r_68_86_82,seq76,seq56,r_68_86_82,1.0,0,82,82,62
24,r_109_32_88,r_19_70_145,r_14_115_80,r_109_32_88,0.99,0,88,88,62
25,r_47_54_84,r_10_141_83,r_66_91_25,r_47_54_84,0.56,-1,83,84,62
44,r_5_39_29,seq56,seq41,r_5_39_29,1.0,1,30,29,62
47,r_142_73_23,r_123_71_150,seq99,r_142_73_23,1.0,1,24,23,62
20,r_94_38_79,r_123_71_150,r_15_23_112,r_94_38_79,0.94,52,131,79,62
38,r_61_58_108,seq122,seq81,r_61_58_108,1.0,0,108,108,62
4,r_75_79_48,seq30,r_74_139_38,r_75_79_48,0.48,43,91,48,62
34,r_102_0_31,r_119_43_117,r_22_120_5,r_102_0_31,0.76,0,31,31,62
1,r_123_71_150,r_142_73_23,r_4_69_96,r_123_71_150,0.65,-129,21,150,62
9,r_124_62_103,seq76,r_5_39_29,r_124_62_103,1.0,0,103,103,62
26,r_52_7_18,r_135_136_168,r_84_97_144,r_84_97_144,0.59,-3,141,144,62
50,seq128,seq49,r_107_133_158,r_107_133_158,1.0,4,162,158,62
26,r_52_7_18,r_4_69_96,r_135_136_168,r_52_7_18,0.71,0,18,18,62
12,r_18_17_24,r_42_130_175,seq28,r_18_17_24,1.0,1,25,24,62
4,r_75_79_48,r_74_139_38,r_50_92_180,r_50_92_180,0.87,1,181,180,62
28,r_112_24_190,r_13_3_152,r_15_23_112,r_15_23_112,0.74,78,190,112,62
43,r_144_46_148,r_145_90_166,r_51_37_165,r_144_46_148,0.99,20,168,148,62
49,r_63_44_133,r_108_35_100,r_11_29_161,r_108_35_100,1.0,-11,89,100,62
39,r_66_91_25,r_110_33_36,seq126,r_66_91_25,0.97,1,26,25,62
7,r_148_116_124,r_144_46_148,r_74_139_38,r_148_116_124,0.98,3,127,124,62
42,r_19_70_145,r_102_0_31,seq20,r_19_70_145,0.99,0,145,145,62
93,seq146,r_140_92_199,r_119_24_98,r_119_24_98,1.0,-6,92,98,63
36,r_31_60_81,r_76_13_162,seq51,r_31_60_81,1.0,0,81,81,63
9,r_87_27_65,r_116_25_153,seq57,r_116_25_153,0.86,9,162,153,63
8,r_50_135_93,seq78,r_59_67_60,r_50_135_93,0.97,0,93,93,63
83,seq89,r_126_98_89,r_65_129_87,r_65_129_87,1.0,6,93,87,63
28,r_23_16_64,r_76_13_162,r_8_136_35,r_23_16_64,0.43,51,115,64,63
86,seq97,r_100_2_123,seq74,r_100_2_123,0.98,1,124,123,63
21,r_17_148_177,r_122_86_1,r_131_61_128,r_131_61_128,0.69,49,177,128,63
1,r_141_14_187,seq137,r_132_90_132,r_132_90_132,0.74,55,187,132,63
14,r_8_136_35,r_76_13_162,seq56,r_8_136_35,0.5,8,43,35,63
5,r_115_6_72,r_132_90_132,seq56,r_115_6_72,0.99,0,72,72,63
46,r_11_105_176,seq37,r_72_66_58,r_72_66_58,0.59,118,176,58,63
45,r_116_25_153,r_47_113_193,seq88,r_47_113_193,0.52,-12,181,193,63
24,r_62_4_78,seq101,r_58_93_140,r_62_4_78,0.54,69,147,78,63
43,r_72_66_58,r_50_135_93,r_139_106_163,r_50_135_93,0.94,-35,58,93,63
40,r_85_42_28,r_9_43_125,seq97,r_85_42_28,0.92,10,38,28,63
27,r_82_22_50,r_9_43_125,r_26_1_107,r_9_43_125,1.0,2,127,125,63
76,seq74,r_63_28_157,seq34,r_63_28_157,0.97,2,159,157,63
31,r_7_46_92,seq38,r_122_86_1,r_7_46_92,0.97,0,92,92,63
41,r_63_28_157,seq74,seq134,r_63_28_157,0.83,2,159,157,63
10,r_109_33_180,seq118,r_26_1_107,r_109_33_180,0.48,0,180,180,63
27,r_82_22_50,r_17_148_177,r_9_43_125,r_82_22_50,1.0,2,52,50,63
4,r_139_106_163,seq107,r_131_61_128,r_139_106_163,0.58,0,163,163,63
0,r_131_61_128,r_125_84_192,r_133_29_116,r_131_61_128,0.91,0,128,128,63
15,r_112_0_88,seq38,seq107,r_112_0_88,1.0,0,88,88,63
48,r_65_129_87,r_9_43_125,seq89,r_65_129_87,1.0,0,87,87,63
16,r_99_121_32,r_21_35_44,r_143_5_119,r_99_121_32,1.0,0,32,32,63
6,r_77_149_71,r_62_4_78,r_122_86_1,r_77_149_71,1.0,0,71,71,63
55,seq18,r_140_92_199,r_21_35_44,r_21_35_44,0.82,6,50,44,63
23,r_145_12_27,r_133_29_116,r_122_86_1,r_133_29_116,0.94,-70,46,116,63
29,r_100_2_123,seq97,r_76_13_162,r_100_2_123,0.94,1,124,123,63
24,r_62_4_78,r_120_83_165,seq101,r_62_4_78,0.9,0,78,78,63
43,r_72_66_58,r_139_106_163,r_11_105_176,r_72_66_58,0.79,104,162,58,63
50,seq130,r_87_27_65,r_8_136_35,r_87_27_65,1.0,0,65,65,63
32,r_9_43_125,r_65_129_87,r_82_22_50,r_9_43_125,0.97,-52,73,125,63
32,r_9_43_125,r_82_22_50,seq38,r_9_43_125,0.84,2,127,125,63
34,r_132_90_132,r_10_71_175,r_31_60_81,r_132_90_132,0.9,0,132,132,63
3,r_15_117_31,r_87_27_65,seq79,r_15_117_31,0.7,0,31,31,63
60,seq37,r_11_105_176,r_115_6_72,r_115_6_72,1.0,104,176,72,63
17,r_119_24_98,seq48,seq146,r_119_24_98,0.98,8,106,98,63
9,r_87_27_65,seq130,r_116_25_153,r_87_27_65,1.0,0,65,65,63
22,r_59_67_60,seq20,r_50_135_93,r_50_135_93,0.96,0,93,93,63
28,r_23_16_64,r_109_33_180,r_76_13_162,r_23_16_64,1.0,0,64,64,63
91,seq107,r_139_106_163,r_112_0_88,r_112_0_88,0.99,75,163,88,63
49,r_58_93_140,r_10_71_175,r_62_4_78,r_62_4_78,0.83,7,85,78,63
47,r_21_35_44,seq134,seq48,r_21_35_44,1.0,0,44,44,63
56,seq20,r_59_67_60,seq101,r_59_67_60,0.93,18,78,60,63
7,r_126_98_89,seq89,seq37,r_126_98_89,0.74,4,93,89,63
44,r_133_29_116,seq56,seq3,r_133_29_116,0.97,1,117,116,63
42,r_91_95_48,r_131_61_128,seq79,r_91_95_48,0.87,2,50,48,63
35,r_10_71_175,r_26_1_107,seq97,r_26_1_107,0.35,68,175,107,63
12,r_125_84_192,r_131_61_128,r_116_25_153,r_131_61_128,0.9,0,128,128,63
27,r_67_30_137,r_52_117_185,r_45_90_78,r_52_117_185,0.97,1,186,185,64
8,r_121_92_124,r_67_30_137,r_87_63_35,r_87_63_35,1.0,89,124,35,64
43,r_98_102_61,seq53,seq72,r_98_102_61,1.0,1,62,61,64
83,seq69,r_13_68_184,r_15_7_37,r_15_7_37,1.0,70,107,37,64
37,r_52_117_185,r_45_90_78,r_67_30_137,r_67_30_137,0.97,0,137,137,64
64,seq145,r_87_63_35,seq138,r_87_63_35,1.0,0,35,35,64
16,r_51_142_86,r_124_130_173,seq29,r_51_142_86,0.97,2,88,86,64
21,r_94_135_110,seq129,r_76_41_109,r_94_135_110,0.99,0,110,110,64
39,r_93_39_120,seq125,r_88_37_133,r_93_39_120,1.0,0,120,120,64
1,r_2_1_123,r_33_100_161,r_58_97_2,r_2_1_123,0.94,1,124,123,64
97,seq118,seq50,r_54_36_41,r_54_36_41,1.0,90,131,41,64
14,r_82_25_40,seq79,r_38_60_18,r_82_25_40,0.93,3,43,40,64
5,r_33_100_161,r_96_27_114,seq80,r_33_100_161,0.66,0,161,161,64
46,r_106_23_119,seq0,seq66,r_106_23_119,1.0,1,120,119,64
42,r_71_91_101,seq19,seq73,r_71_91_101,0.6,6,107,101,64
7,r_113_114_64,r_38_60_18,r_61_110_131,r_61_110_131,0.74,0,131,131,64
69,seq28,r_61_110_131,seq133,r_61_110_131,1.0,0,131,131,64
45,r_62_32_164,seq26,r_45_90_78,r_62_32_164,0.74,1,165,164,64
9,r_86_134_11,r_113_114_64,seq123,r_86_134_11,1.0,0,11,11,64
19,r_64_112_130,r_45_90_78,seq55,r_64_112_130,0.92,0,130,130,64
31,r_116_103_104,r_45_90_78,seq14,r_116_103_104,0.99,1,105,104,64
41,r_10_115_158,seq29,seq14,r_10_115_158,0.72,1,159,158,64
10,r_126_105_80,seq44,seq125,r_126_105_80,1.0,1,81,80,64
40,r_83_127_181,r_87_63_35,r_107_42_138,r_83_127_181,0.98,0,181,181,64
26,r_74_119_92,r_144_70_93,r_58_97_2,r_58_97_2,0.81,90,92,2,64
4,r_144_70_93,r_46_65_178,seq43,r_144_70_93,1.0,0,93,93,64
32,r_54_36_41,r_34_85_172,seq118,r_54_36_41,1.0,0,41,41,64
20,r_120_149_82,seq133,seq29,r_120_149_82,1.0,0,82,82,64
13,r_76_41_109,seq50,r_94_135_110,r_94_135_110,0.98,1,111,110,64
98,seq123,seq8,r_86_134_11,r_86_134_11,0.96,82,93,11,64
15,r_34_85_172,seq140,seq145,r_34_85_172,0.64,0,172,172,64
6,r_136_95_141,r_9_12_7,seq129,r_136_95_141,0.66,0,141,141,64
36,r_87_63_35,r_83_127_181,r_121_92_124,r_121_92_124,1.0,57,181,124,64
0,r_38_60_18,r_22_3_100,seq53,r_38_60_18,1.0,0,18,18,64
27,r_67_30_137,seq49,r_52_117_185,r_67_30_137,0.85,1,138,137,64
37,r_52_117_185,r_67_30_137,r_107_42_138,r_52_117_185,0.84,0,185,185,64
2,r_107_42_138,r_46_65_178,r_126_105_80,r_46_65_178,1.0,-40,138,178,64
47,r_6_11_136,r_48_31_147,seq72,r_6_11_136,0.74,1,137,136,64
33,r_21_24_28,r_10_115_158,seq129,r_21_24_28,1.0,2,30,28,64
40,r_83_127_181,r_122_131_128,r_87_63_35,r_83_127_181,0.96,-53,128,181,64
25,r_81_40_12,seq69,seq89,r_81_40_12,0.91,1,13,12,64
18,r_48_31_147,r_6_11_136,seq140,r_48_31_147,0.71,-10,137,147,64
29,r_111_18_165,seq29,r_9_12_7,r_111_18_165,0.64,0,165,165,64
50,seq0,r_106_23_119,r_109_17_8,r_106_23_119,1.0,1,120,119,64
70,seq29,r_10_115_158,r_51_142_86,r_51_142_86,0.98,38,124,86,64
38,r_46_65_178,seq75,r_21_24_28,r_21_24_28,1.0,151,179,28,64
34,r_122_131_128,r_83_127_181,r_126_105_80,r_83_127_181,0.82,-53,128,181,64
64,seq145,seq138,r_34_85_172,r_34_85_172,0.45,0,172,172,64
24,r_15_7_37,seq72,seq69,r_15_7_37,1.0,0,37,37,64
75,seq49,r_67_30_137,seq146,r_67_30_137,0.85,1,138,137,64
81,seq59,seq72,r_76_41_109,r_76_41_109,0.74,17,126,109,64
0,r_38_60_18,seq53,r_82_25_40,r_82_25_40,0.51,25,65,40,64
22,r_45_90_78,r_116_103_104,r_81_40_12,r_116_103_104,1.0,1,105,104,64
28,r_9_12_7,r_136_95_141,seq8,r_136_95_141,1.0,0,141,141,64
49,r_88_37_133,r_46_65_178,r_120_149_82,r_88_37_133,0.88,0,133,133,64
44,r_99_47_77,seq73,seq80,r_99_47_77,0.85,2,79,77,64
36,r_87_63_35,seq145,r_83_127_181,r_87_63_35,0.99,0,35,35,64
82,seq66,r_124_130_173,seq137,r_124_130_173,0.52,6,179,173,64
35,r_148_4_105,seq16,r_109_17_8,r_148_4_105,1.0,0,105,105,64
12,r_22_3_100,seq133,r_96_27_114,r_22_3_100,1.0,1,101,100,64
84,seq72,seq59,r_6_11_136,r_6_11_136,1.0,6,142,136,64
30,r_2_1_129,r_108_127_187,r_126_26_42,r_108_127_187,0.67,-57,130,187,65
36,r_142_8_139,r_98_31_111,r_77_51_89,r_142_8_139,0.85,-28,111,139,65
22,r_126_26_42,r_59_90_148,seq85,r_126_26_42,1.0,0,42,42,65
46,r_39_105_109,seq110,r_113_56_44,r_39_105_109,0.92,-3,106,109,65
14,r_98_31_111,r_142_8_139,r_70_80_83,r_142_8_139,0.82,-28,111,139,65
8,r_84_24_87,r_23_83_114,seq30,r_84_24_87,0.95,-1,86,87,65
60,seq143,r_73_50_68,seq110,r_73_50_68,1.0,-22,46,68,65
43,r_101_36_112,r_135_141_100,seq28,r_101_36_112,0.88,0,112,112,65
83,seq82,r_144_149_147,r_136_42_146,r_136_42_146,0.75,1,147,146,65
37,r_70_80_83,seq22,seq132,r_70_80_83,0.99,3,86,83,65
24,r_109_52_16,seq41,r_62_14_143,r_109_52_16,0.9,0,16,16,65
21,r_77_51_89,seq104,r_142_8_139,r_77_51_89,0.94,0,89,89,65
39,r_9_55_104,seq117,seq27,r_9_55_104,0.92,0,104,104,65
5,r_119_38_175,seq104,r_69_100_73,r_69_100_73,0.9,102,175,73,65
29,r_33_37_33,r_136_42_146,seq34,r_33_37_33,0.89,-1,32,33,65
46,r_39_105_109,r_45_75_61,seq110,r_45_75_61,0.96,-1,60,61,65
42,r_29_131_84,seq132,seq139,r_29_131_84,1.0,0,84,84,65
69,seq40,seq3,r_78_95_130,r_78_95_130,1.0,1,131,130,65
45,r_16_46_108,seq7,seq40,r_16_46_108,1.0,0,108,108,65
24,r_109_52_16,r_62_14_143,r_49_103_199,r_62_14_143,0.84,3,146,143,65
25,r_61_120_36,r_146_4_156,r_130_87_37,r_61_120_36,0.99,0,36,36,65
49,r_133_102_53,seq64,seq41,r_133_102_53,1.0,0,53,53,65
66,seq30,r_61_120_36,r_84_24_87,r_84_24_87,0.93,0,87,87,65
31,r_19_97_88,seq3,seq57,r_19_97_88,0.99,0,88,88,65
41,r_23_83_114,seq20,r_33_37_33,r_23_83_114,0.77,2,116,114,65
3,r_60_96_194,r_145_86_140,r_48_91_96,r_48_91_96,0.94,65,161,96,65
10,r_144_149_147,seq82,r_9_55_104,r_9_55_104,0.76,43,147,104,65
16,r_130_87_37,r_69_100_73,r_61_120_36,r_130_87_37,0.76,-1,36,37,65
28,r_18_140_57,r_45_75_61,seq117,r_18_140_57,0.96,-5,52,57,65
26,r_108_127_187,r_2_1_129,r_33_37_33,r_2_1_129,0.9,1,130,129,65
2,r_59_90_148,r_126_26_42,r_113_56_44,r_126_26_42,0.93,0,42,42,65
15,r_78_95_130,seq34,seq40,r_78_95_130,0.99,0,130,130,65
6,r_146_4_156,seq53,seq99,r_146_4_156,0.86,0,156,156,65
2,r_59_90_148,r_113_56_44,seq57,r_59_90_148,0.68,2,150,148,65
0,r_62_14_143,r_109_52_16,seq10,r_62_14_143,0.9,0,143,143,65
27,r_148_21_107,seq44,seq7,r_148_21_107,0.77,2,109,107,65
47,r_94_121_59,seq88,seq22,r_94_121_59,1.0,1,60,59,65
40,r_48_91_96,r_16_46_108,seq17,r_48_91_96,0.58,0,96,96,65
18,r_45_75_61,r_39_105_109,seq63,r_45_75_61,0.99,1,62,61,65
64,seq27,seq132,r_9_55_104,r_9_55_104,0.96,-7,97,104,65
24,r_109_52_16,r_49_103_199,r_119_38_175,r_109_52_16,0.83,169,185,16,65
61,seq17,r_60_96_194,r_48_91_96,r_48_91_96,0.94,3,99,96,65
32,r_113_56_44,r_59_90_148,r_15_147_171,r_113_56_44,0.29,128,172,44,65
38,r_65_47_126,seq92,r_33_37_33,r_65_47_126,0.42,5,131,126,65
9,r_69_100_73,r_101_36_112,seq3,r_69_100_73,0.99,1,74,73,65
21,r_77_51_89,r_142_8_139,r_138_72_182,r_142_8_139,0.88,-4,135,139,65
36,r_142_8_139,r_77_51_89,r_133_102_53,r_142_8_139,0.82,0,139,139,65
11,r_106_35_56,r_98_31_111,r_66_118_49,r_98_31_111,0.54,-55,56,111,65
91,seq104,r_77_51_89,seq93,r_77_51_89,1.0,-3,86,89,65
23,r_66_118_49,seq92,r_106_35_56,r_66_118_49,0.58,7,56,49,65
21,r_77_51_89,r_138_72_182,r_111_115_157,r_77_51_89,0.52,72,161,89,65
44,r_134_25_137,seq53,seq20,r_134_25_137,0.56,4,141,137,65
85,seq85,seq41,r_126_26_42,r_126_26_42,1.0,0,42,42,65
0,r_62_14_143,r_19_97_88,r_109_52_16,r_109_52_16,0.74,0,16,16,65
35,r_145_86_140,r_60_96_194,seq107,r_60_96_194,0.52,-38,156,194,65
12,r_73_50_68,seq143,seq82,r_73_50_68,1.0,0,68,68,65
84,seq139,r_15_147_171,r_29_131_84,r_29_131_84,1.0,88,172,84,65
30,r_44_147_131,r_94_128_153,seq6,r_44_147_131,0.79,0,131,131,66
36,r_31_127_76,seq72,seq99,r_31_127_76,1.0,2,78,76,66
66,seq35,seq135,r_48_89_104,r_48_89_104,1.0,23,127,104,66
44,r_55_76_57,r_71_90_167,seq47,r_55_76_57,0.99,2,59,57,66
8,r_26_37_93,seq25,r_38_120_47,r_38_120_47,1.0,47,94,47,66
54,seq7,r_36_131_155,r_24_117_63,r_24_117_63,0.95,93,156,63,66
37,r_104_105_159,r_36_131_155,r_22_81_181,r_104_105_159,0.69,0,159,159,66
16,r_94_128_153,r_44_147_131,r_22_81_181,r_22_81_181,0.46,-50,131,181,66
21,r_12_39_144,seq13,r_133_3_110,r_133_3_110,0.76,36,146,110,66
1,r_56_88_133,seq108,seq106,r_56_88_133,0.97,0,133,133,66
5,r_62_100_173,seq27,r_56_88_133,r_56_88_133,0.99,43,176,133,66
46,r_4_30_72,r_31_127_76,seq47,r_4_30_72,0.99,0,72,72,66
45,r_15_57_171,r_133_3_110,r_52_129_33,r_15_57_171,0.8,5,176,171,66
18,r_9_77_29,r_10_45_81,seq25,r_9_77_29,1.0,0,29,29,66
45,r_15_57_171,r_62_100_173,r_133_3_110,r_133_3_110,1.0,17,127,110,66
3,r_5_96_91,r_74_69_198,seq27,r_5_96_91,1.0,0,91,91,66
42,r_103_14_77,r_38_120_47,seq141,r_103_14_77,0.99,1,78,77,66
35,r_136_50_42,r_22_81_181,r_74_69_198,r_136_50_42,0.99,0,42,42,66
43,r_68_18_36,r_94_128_153,seq59,r_68_18_36,1.0,0,36,36,66
4,r_71_90_167,seq91,seq83,r_71_90_167,0.77,1,168,167,66
63,seq25,r_26_37_93,r_9_77_29,r_9_77_29,0.87,49,78,29,66
11,r_137_78_100,r_65_116_162,seq138,r_65_116_162,0.58,-49,113,162,66
20,r_23_16_90,r_58_149_197,r_9_77_29,r_23_16_90,0.94,0,90,90,66
13,r_33_79_172,r_62_100_173,seq82,r_33_79_172,0.7,-1,171,172,66
48,r_64_86_74,r_58_149_197,seq123,r_64_86_74,0.99,1,75,74,66
0,r_34_146_26,r_94_128_153,seq132,r_34_146_26,1.0,0,26,26,66
2,r_133_3_110,r_15_57_171,r_12_39_144,r_15_57_171,0.84,4,175,171,66
15,r_52_129_33,r_63_125_69,seq84,r_52_129_33,0.73,10,43,33,66
27,r_10_45_81,r_113_110_79,seq112,r_10_45_81,1.0,0,81,81,66
19,r_22_81_181,r_136_50_42,seq46,r_136_50_42,1.0,0,42,42,66
41,r_38_120_47,r_85_126_34,r_103_14_77,r_38_120_47,0.91,0,47,47,66
2,r_133_3_110,r_71_90_167,r_15_57_171,r_133_3_110,1.0,1,111,110,66
47,r_28_122_185,seq54,r_102_93_85,r_102_93_85,0.5,100,185,85,66
40,r_21_148_150,seq99,r_64_86_74,r_21_148_150,0.63,0,150,150,66
24,r_70_19_126,seq115,seq108,r_70_19_126,0.79,1,127,126,66
35,r_136_50_42,r_74_69_198,r_36_131_155,r_36_131_155,0.99,5,160,155,66
25,r_66_124_135,r_65_116_162,r_97_143_154,r_66_124_135,0.48,-74,61,135,66
33,r_24_117_63,seq132,seq7,r_24_117_63,1.0,2,65,63,66
48,r_64_86_74,seq123,r_21_148_150,r_21_148_150,0.98,2,152,150,66
42,r_103_14_77,r_26_37_93,r_38_120_47,r_38_120_47,0.97,0,47,47,66
38,r_113_110_79,seq144,seq115,r_113_110_79,0.9,-6,73,79,66
34,r_60_114_129,seq144,r_85_126_34,r_60_114_129,0.49,3,132,129,66
17,r_32_119_55,seq84,seq53,r_32_119_55,0.66,3,58,55,66
81,seq135,seq35,r_48_89_104,r_48_89_104,1.0,43,147,104,66
25,r_66_124_135,r_97_143_154,r_26_37_93,r_66_124_135,0.95,-1,134,135,66
9,r_80_95_190,r_48_89_104,r_28_122_185,r_48_89_104,0.83,0,104,104,66
22,r_102_93_85,r_70_19_126,r_74_69_198,r_102_93_85,0.99,0,85,85,66
41,r_38_120_47,r_103_14_77,r_26_37_93,r_38_120_47,0.55,31,78,47,66
49,r_36_131_155,r_104_105_159,r_136_50_42,r_36_131_155,0.67,1,156,155,66
7,r_48_89_104,r_80_95_190,seq35,r_48_89_104,1.0,1,105,104,66
23,r_97_143_154,seq29,r_85_126_34,r_97_143_154,0.87,0,154,154,66
82,seq141,r_36_131_155,r_103_14_77,r_103_14_77,0.99,11,88,77,66
16,r_94_128_153,r_22_81_181,seq140,r_94_128_153,0.81,0,153,153,66
36,r_20_3_126,seq144,r_114_130_6,r_20_3_126,0.88,0,126,126,67
92,seq93,r_97_71_182,r_40_1_150,r_40_1_150,0.84,3,153,150,67
37,r_2_95_80,seq24,r_114_130_6,r_2_95_80,0.87,-20,60,80,67
55,seq135,r_28_103_98,r_67_136_37,r_67_136_37,0.93,6,43,37,67
19,r_116_50_48,r_91_47_105,r_9_63_41,r_91_47_105,1.0,5,110,105,67
16,r_0_117_70,r_65_82_195,seq127,r_65_82_195,0.55,-130,65,195,67
21,r_61_57_106,r_76_33_199,r_29_69_87,r_61_57_106,0.59,36,142,106,67
39,r_40_1_150,r_75_41_17,seq93,r_40_1_150,0.79,0,150,150,67
5,r_37_35_160,seq142,r_83_104_63,r_83_104_63,0.91,19,82,63,67
42,r_11_26_188,r_18_77_138,r_23_131_54,r_23_131_54,1.0,84,138,54,67
1,r_9_63_41,r_0_117_70,seq6,r_9_63_41,0.96,-2,39,41,67
45,r_97_71_182,seq93,r_18_77_138,r_18_77_138,0.73,44,182,138,67
11,r_143_94_12,r_73_66_102,r_109_125_71,r_143_94_12,1.0,66,78,12,67
31,r_90_112_88,r_73_66_102,seq56,r_90_112_88,0.99,1,89,88,67
41,r_76_33_199,r_61_57_106,r_78_126_19,r_76_33_199,0.64,-71,128,199,67
94,seq101,seq128,r_8_123_35,r_8_123_35,1.0,0,35,35,67
20,r_141_107_26,r_18_77_138,seq86,r_141_107_26,0.99,2,28,26,67
10,r_59_51_121,seq4,r_67_136_37,r_59_51_121,0.94,3,124,121,67
26,r_7_105_94,seq74,seq92,r_7_105_94,0.92,-2,92,94,67
8,r_68_146_181,r_138_72_55,r_83_104_63,r_68_146_181,0.33,0,181,181,67
4,r_17_12_165,seq74,r_141_107_26,r_17_12_165,0.57,0,165,165,67
0,r_83_104_63,r_91_47_105,seq32,r_83_104_63,0.98,-1,62,63,67
19,r_116_50_48,r_88_139_129,r_91_47_105,r_116_50_48,0.46,-3,45,48,67
13,r_85_96_97,r_27_140_189,r_23_131_54,r_23_131_54,0.8,44,98,54,67
48,r_109_125_71,seq54,r_143_94_12,r_109_125_71,0.99,-1,70,71,67
15,r_120_106_38,r_116_50_48,seq148,r_120_106_38,0.7,-1,37,38,67
49,r_88_139_129,r_9_63_41,seq144,r_88_139_129,0.9,5,134,129,67
57,seq10,r_46_132_151,r_23_131_54,r_23_131_54,1.0,70,124,54,67
6,r_23_131_54,r_18_77_138,r_85_96_97,r_23_131_54,0.63,84,138,54,67
5,r_37_35_160,r_83_104_63,r_9_63_41,r_37_35_160,0.91,0,160,160,67
27,r_89_118_100,seq74,seq54,r_89_118_100,0.96,0,100,100,67
9,r_78_126_19,seq13,seq44,r_78_126_19,0.83,1,20,19,67
42,r_11_26_188,r_23_131_54,r_7_105_94,r_11_26_188,0.65,0,188,188,67
49,r_88_139_129,r_116_50_48,r_9_63_41,r_9_63_41,0.7,-2,39,41,67
47,r_114_130_6,r_73_66_102,r_2_95_80,r_114_130_6,0.73,96,102,6,67
18,r_29_69_87,seq80,seq70,r_29_69_87,0.77,3,90,87,67
12,r_48_99_57,r_17_12_165,seq148,r_48_99_57,0.99,-2,55,57,67
24,r_122_129_107,r_17_12_165,seq134,r_122_129_107,0.96,1,108,107,67
25,r_73_66_102,r_75_41_17,r_9_63_41,r_73_66_102,0.99,0,102,102,67
68,seq30,seq74,r_5_98_90,r_5_98_90,0.86,8,98,90,67
2,r_15_31_22,r_18_77_138,r_102_16_15,r_15_31_22,0.94,0,22,22,67
23,r_62_60_53,r_27_140_189,r_8_123_35,r_62_60_53,0.7,0,53,53,67
44,r_67_136_37,r_90_112_88,seq135,r_67_136_37,0.76,0,37,37,67
34,r_5_98_90,r_111_121_153,seq30,r_5_98_90,0.84,4,94,90,67
43,r_91_47_105,r_83_104_63,r_122_129_107,r_91_47_105,0.93,-51,54,105,67
41,r_76_33_199,r_78_126_19,seq80,r_76_33_199,0.54,-46,153,199,67
53,seq133,r_138_72_55,r_143_94_12,r_138_72_55,0.95,0,55,55,67
35,r_8_123_35,seq43,seq101,r_8_123_35,1.0,0,35,35,67
11,r_143_94_12,seq93,r_73_66_102,r_143_94_12,0.87,0,12,12,67
22,r_138_72_55,seq133,r_68_146_181,r_138_72_55,1.0,0,55,55,67
28,r_46_132_151,seq10,r_48_99_57,r_46_132_151,0.55,0,151,151,67
91,seq92,r_113_58_110,r_7_105_94,r_7_105_94,0.72,8,102,94,67
8,r_68_146_181,seq142,r_138_72_55,r_138_72_55,1.0,1,56,55,67
7,r_18_77_138,r_11_26_188,r_2_95_80,r_18_77_138,0.73,1,139,138,67
30,r_91_53_152,seq20,r_96_21_26,r_91_53_152,0.76,0,152,152,68
36,r_133_108_91,r_5_141_111,seq81,r_133_108_91,1.0,2,93,91,68
5,r_16_146_50,seq13,seq14,r_16_146_50,0.99,6,56,50,68
14,r_70_79_143,r_144_89_165,r_142_102_117,r_142_102_117,0.6,8,125,117,68
8,r_29_42_107,r_69_60_197,r_17_56_161,r_29_42_107,0.84,3,110,107,68
37,r_32_31_131,seq100,r_34_45_125,r_32_31_131,0.69,1,132,131,68
24,r_24_111_16,r_27_105_93,seq65,r_24_111_16,0.83,0,16,16,68
16,r_34_45_125,r_87_104_163,r_32_31_131,r_34_45_125,0.98,1,126,125,68
1,r_27_105_93,r_90_52_172,r_16_146_50,r_90_52_172,0.98,-79,93,172,68
97,seq123,r_30_78_164,seq82,r_30_78_164,0.77,4,168,164,68
46,r_25_64_129,r_66_128_174,seq51,r_25_64_129,1.0,0,129,129,68
42,r_1_149_158,r_57_97_146,r_27_105_93,r_27_105_93,1.0,53,146,93,68
45,r_98_54_61,r_69_60_197,r_95_10_31,r_98_54_61,0.98,1,62,61,68
19,r_110_3_66,r_5_141_111,seq124,r_5_141_111,0.52,-44,67,111,68
33,r_96_21_26,r_12_132_166,r_91_53_152,r_96_21_26,0.91,141,167,26,68
95,seq148,seq136,r_131_46_71,r_131_46_71,1.0,-6,65,71,68
31,r_113_147_145,seq26,seq55,r_113_147_145,0.76,-1,144,145,68
67,seq38,r_48_11_98,r_47_36_72,r_47_36_72,0.92,28,100,72,68
89,seq107,r_125_117_140,r_137_50_115,r_137_50_115,0.99,26,141,115,68
3,r_47_36_72,r_27_105_93,seq38,r_47_36_72,1.0,1,73,72,68
10,r_30_78_164,seq123,r_22_71_49,r_30_78_164,0.42,3,167,164,68
0,r_40_77_139,seq49,r_96_21_26,r_40_77_139,0.9,2,141,139,68
26,r_22_71_49,r_110_3_66,seq55,r_22_71_49,0.9,2,51,49,68
20,r_131_46_71,r_72_73_170,seq134,r_131_46_71,0.93,1,72,71,68
13,r_137_50_115,seq51,seq107,r_137_50_115,1.0,0,115,115,68
98,seq124,r_101_115_196,r_110_3_66,r_110_3_66,0.93,0,66,66,68
15,r_140_59_156,seq83,r_47_36_72,r_140_59_156,0.98,0,156,156,68
48,r_142_102_117,r_30_78_164,r_92_43_189,r_142_102_117,0.58,1,118,117,68
6,r_144_89_165,seq145,r_92_43_189,r_144_89_165,0.36,-78,87,165,68
8,r_29_42_107,r_17_56_161,r_1_149_158,r_29_42_107,0.84,53,160,107,68
23,r_12_132_166,seq84,r_96_21_26,r_96_21_26,1.0,1,27,26,68
58,seq14,r_57_97_146,r_16_146_50,r_16_146_50,0.81,9,59,50,68
29,r_88_2_9,r_113_147_145,r_12_132_166,r_88_2_9,0.99,1,10,9,68
27,r_18_118_78,seq61,seq127,r_18_118_78,1.0,0,78,78,68
75,seq65,seq26,r_24_111_16,r_24_111_16,0.94,33,49,16,68
2,r_17_56_161,r_12_132_166,r_29_42_107,r_29_42_107,0.99,5,112,107,68
47,r_57_97_146,r_1_149_158,r_130_103_199,r_57_97_146,0.76,0,146,146,68
40,r_87_104_163,seq119,r_6_62_137,r_87_104_163,0.9,0,163,163,68
25,r_5_141_111,seq49,seq51,r_5_141_111,1.0,0,111,111,68
39,r_109_114_51,r_69_60_197,seq145,r_109_114_51,0.78,8,59,51,68
50,seq129,seq81,r_121_138_113,r_121_138_113,1.0,3,116,113,68
6,r_144_89_165,r_92_43_189,r_70_79_143,r_92_43_189,0.99,-23,166,189,68
14,r_70_79_143,r_142_102_117,seq23,r_70_79_143,0.76,0,143,143,68
38,r_48_11_98,seq38,seq8,r_48_11_98,0.89,2,100,98,68
52,seq134,seq26,r_131_46_71,r_131_46_71,1.0,-6,65,71,68
34,r_125_117_140,seq107,seq26,r_125_117_140,0.79,1,141,140,68
2,r_17_56_161,r_29_42_107,r_48_11_98,r_17_56_161,0.98,0,161,161,68
17,r_121_138_113,r_1_149_158,seq129,r_121_138_113,1.0,0,113,113,68
9,r_80_0_157,seq41,seq35,r_80_0_157,0.58,1,158,157,68
42,r_1_149_158,r_27_105_93,seq84,r_1_149_158,0.89,0,158,158,68
29,r_88_2_9,r_12_132_166,r_96_21_26,r_88_2_9,0.91,67,76,9,68
22,r_19_76_69,r_125_117_140,seq94,r_19_76_69,0.97,4,73,69,68
49,r_67_44_92,r_5_141_111,r_16_146_50,r_67_44_92,0.98,0,92,92,68
56,seq139,r_6_62_137,r_47_36_72,r_47_36_72,0.66,66,138,72,68
7,r_63_33_167,seq35,r_5_141_111,r_5_141_111,0.75,56,167,111,68
44,r_6_62_137,seq139,r_27_105_93,r_6_62_137,0.84,1,138,137,68
33,r_96_21_26,r_140_59_156,r_12_132_166,r_96_21_26,1.0,0,26,26,68
79,seq81,seq129,r_133_108_91,r_133_108_91,1.0,21,112,91,68
35,r_95_10_31,r_140_59_156,seq41,r_95_10_31,1.0,0,31,31,68
12,r_90_52_172,seq99,r_15_126_70,r_15_126_70,0.83,102,172,70,68
23,r_12_132_166,r_96_21_26,r_131_46_71,r_12_132_166,0.58,1,167,166,68
36,r_16_12_71,r_33_8_1,r_91_70_24,r_16_12_71,1.0,0,71,71,69
14,r_97_27_163,r_100_68_130,r_93_34_104,r_97_27_163,0.8,-33,130,163,69
43,r_92_122_131,seq79,r_100_68_130,r_92_122_131,0.66,0,131,131,69
37,r_55_121_185,seq108,r_88_26_92,r_88_26_92,0.98,93,185,92,69
19,r_91_70_24,r_57_112_109,r_39_74_68,r_91_70_24,1.0,86,110,24,69
16,r_129_15_181,seq43,r_91_70_24,r_91_70_24,0.99,158,182,24,69
21,r_39_74_68,r_140_42_121,r_91_70_24,r_39_74_68,0.98,0,68,68,69
1,r_104_119_164,seq87,r_3_5_94,r_3_5_94,0.71,70,164,94,69
77,seq53,r_117_134_76,r_92_122_131,r_92_122_131,0.54,1,132,131,69
5,r_131_78_103,r_142_139_195,seq99,r_131_78_103,0.9,0,103,103,69
42,r_118_130_156,seq29,seq38,r_118_130_156,0.81,0,156,156,69
44,r_56_46_28,r_92_122_131,seq65,r_56_46_28,0.98,-5,23,28,69
80,seq58,r_32_143_138,r_136_23_34,r_136_23_34,0.98,146,180,34,69
45,r_123_101_179,seq77,r_136_23_34,r_136_23_34,0.99,146,180,34,69
33,r_136_23_34,r_28_37_49,seq58,r_28_37_49,0.65,-15,34,49,69
31,r_100_68_130,r_97_27_163,r_92_122_131,r_100_68_130,0.75,2,132,130,69
41,r_140_42_121,seq99,seq38,r_140_42_121,0.9,-1,120,121,69
47,r_57_112_109,r_92_122_131,r_91_70_24,r_91_70_24,0.97,-1,23,24,69
10,r_107_105_124,r_7_19_64,r_30_109_13,r_30_109_13,0.79,64,77,13,69
19,r_91_70_24,r_75_102_108,r_57_112_109,r_91_70_24,0.98,0,24,24,69
14,r_97_27_163,r_93_34_104,seq147,r_97_27_163,0.97,0,163,163,69
26,r_144_110_86,r_32_143_138,r_113_20_113,r_144_110_86,0.55,51,137,86,69
54,seq6,r_86_45_170,r_66_14_55,r_66_14_55,1.0,1,56,55,69
26,r_144_110_86,r_107_105_124,r_32_143_138,r_107_105_124,0.84,-36,88,124,69
63,seq148,r_106_124_97,r_7_19_64,r_106_124_97,0.74,-35,62,97,69
2,r_113_20_113,seq108,r_89_132_155,r_113_20_113,0.58,59,172,113,69
73,seq43,r_129_15_181,r_95_71_56,r_95_71_56,1.0,103,159,56,69
11,r_88_26_92,r_90_17_153,seq22,r_88_26_92,1.0,-1,91,92,69
13,r_93_34_104,r_104_119_164,seq11,r_93_34_104,0.94,2,106,104,69
48,r_138_146_171,r_84_125_168,r_30_109_13,r_138_146_171,0.46,-1,170,171,69
34,r_95_71_56,r_106_124_97,seq43,r_95_71_56,1.0,0,56,56,69
6,r_76_133_102,seq24,r_117_134_76,r_76_133_102,0.82,-9,93,102,69
20,r_28_37_49,r_64_145_44,seq69,r_28_37_49,1.0,-1,48,49,69
12,r_63_72_17,r_66_14_55,seq77,r_63_72_17,0.8,1,18,17,69
27,r_48_98_85,r_131_78_103,seq22,r_48_98_85,1.0,1,86,85,69
2,r_113_20_113,seq62,seq108,r_113_20_113,0.61,13,126,113,69
40,r_66_14_55,seq2,seq6,r_66_14_55,1.0,0,55,55,69
25,r_90_17_153,r_55_121_185,r_100_68_130,r_100_68_130,0.54,-4,126,130,69
29,r_106_124_97,seq148,seq52,r_106_124_97,0.96,-2,95,97,69
24,r_84_125_168,r_138_146_171,r_93_34_104,r_84_125_168,0.51,2,170,168,69
25,r_90_17_153,r_88_26_92,r_55_121_185,r_88_26_92,0.82,-1,91,92,69
47,r_57_112_109,r_91_70_24,r_30_109_13,r_57_112_109,0.99,1,110,109,69
50,seq0,r_3_5_94,r_55_121_185,r_3_5_94,0.99,3,97,94,69
25,r_90_17_153,r_100_68_130,seq1,r_90_17_153,0.56,0,153,153,69
84,seq65,seq52,r_56_46_28,r_56_46_28,0.83,6,34,28,69
38,r_96_60_116,seq94,seq147,r_96_60_116,0.79,0,116,116,69
9,r_32_143_138,seq58,seq77,r_32_143_138,0.53,6,144,138,69
22,r_31_116_72,r_104_119_164,seq141,r_31_116_72,1.0,0,72,72,69
28,r_73_47_189,seq13,r_104_119_164,r_104_119_164,0.62,25,189,164,69
49,r_3_5_94,seq0,seq44,r_3_5_94,0.99,3,97,94,69
7,r_128_81_120,r_118_130_156,r_93_34_104,r_118_130_156,1.0,-34,122,156,69
23,r_75_102_108,seq148,seq147,r_75_102_108,0.99,0,108,108,69
93,seq119,r_115_68_107,seq101,r_115_68_107,1.0,-4,103,107,70
25,r_64_131_16,seq32,seq103,r_64_131_16,0.87,2,18,16,70
14,r_31_146_134,r_98_97_37,r_106_1_1,r_98_97_37,0.81,97,134,37,70
8,r_65_12_175,r_137_102_30,seq105,r_65_12_175,0.51,3,178,175,70
16,r_20_143_9,r_67_79_11,seq107,r_20_143_9,0.92,1,10,9,70
21,r_48_22_116,seq105,r_52_111_35,r_48_22_116,0.94,2,118,116,70
39,r_8_46_73,r_115_68_107,seq30,r_8_46_73,0.48,5,78,73,70
28,r_21_26_54,r_58_96_69,r_75_28_137,r_58_96_69,0.75,-18,51,69,70
46,r_82_104_159,seq53,seq103,r_82_104_159,0.79,1,160,159,70
62,seq27,r_54_138_105,r_94_113_163,r_54_138_105,0.65,-63,42,105,70
19,r_135_2_82,r_87_71_168,r_127_34_59,r_87_71_168,1.0,-86,82,168,70
43,r_141_148_49,r_49_91_109,seq60,r_141_148_49,0.59,0,49,49,70
29,r_10_38_38,seq78,seq57,r_10_38_38,1.0,0,38,38,70
65,seq32,seq93,r_67_79_11,r_67_79_11,1.0,3,14,11,70
4,r_67_79_11,r_108_149_157,seq32,r_67_79_11,0.96,1,12,11,70
67,seq36,r_56_74_190,r_124_51_42,r_124_51_42,1.0,9,51,42,70
90,seq107,seq142,r_20_143_9,r_20_143_9,0.66,1,10,9,70
3,r_140_39_83,r_65_12_175,seq107,r_140_39_83,0.91,0,83,83,70
10,r_70_13_132,seq35,seq59,r_70_13_132,0.96,0,132,132,70
26,r_29_18_120,r_145_90_70,r_75_28_137,r_29_18_120,0.58,-49,71,120,70
0,r_118_47_115,r_37_117_133,r_48_22_116,r_118_47_115,0.97,0,115,115,70
63,seq30,seq121,r_8_46_73,r_8_46_73,0.99,0,73,73,70
73,seq60,r_69_89_71,seq142,r_69_89_71,1.0,0,71,71,70
20,r_94_113_163,seq126,r_31_146_134,r_94_113_163,0.49,0,163,163,70
15,r_24_129_106,r_118_47_115,r_29_18_120,r_24_129_106,0.96,0,106,106,70
48,r_58_96_69,r_21_26_54,r_33_61_36,r_58_96_69,0.94,-1,68,69,70
6,r_110_147_179,seq66,seq126,r_110_147_179,0.5,0,179,179,70
24,r_52_111_35,r_19_45_77,seq133,r_19_45_77,0.65,-42,35,77,70
37,r_33_61_36,seq122,seq121,r_33_61_36,0.89,4,40,36,70
26,r_29_18_120,r_75_28_137,r_24_129_106,r_24_129_106,0.52,2,108,106,70
27,r_19_45_77,seq132,seq134,r_19_45_77,0.86,0,77,77,70
71,seq57,r_56_74_190,r_10_38_38,r_10_38_38,1.0,-1,37,38,70
2,r_136_40_81,r_58_96_69,seq142,r_136_40_81,0.95,-3,78,81,70
40,r_109_139_184,seq114,seq101,r_109_139_184,0.4,1,185,184,70
18,r_6_50_123,r_37_117_133,r_135_2_82,r_6_50_123,0.77,1,124,123,70
43,r_141_148_49,seq60,r_98_97_37,r_98_97_37,0.43,124,161,37,70
49,r_130_3_10,seq30,seq78,r_130_3_10,0.92,0,10,10,70
33,r_0_72_177,seq107,r_136_40_81,r_136_40_81,1.0,87,168,81,70
30,r_77_43_48,r_118_47_115,r_75_28_137,r_77_43_48,1.0,1,49,48,70
70,seq53,r_82_104_159,seq16,r_82_104_159,1.0,1,160,159,70
32,r_88_55_146,seq76,seq17,r_88_55_146,0.89,0,146,146,70
38,r_11_41_96,seq128,seq95,r_11_41_96,0.97,0,96,96,70
34,r_87_71_168,seq119,r_70_13_132,r_87_71_168,0.67,0,168,168,70
47,r_99_81_25,seq142,seq128,r_99_81_25,0.97,0,25,25,70
17,r_137_102_30,r_65_12_175,r_118_47_115,r_118_47_115,0.66,63,178,115,70
9,r_75_28_137,seq4,r_77_43_48,r_77_43_48,1.0,28,76,48,70
22,r_54_138_105,seq17,r_130_3_10,r_54_138_105,0.94,0,105,105,70
62,seq27,r_94_113_163,r_82_104_159,r_94_113_163,0.35,-29,134,163,70
91,seq114,r_109_139_184,r_69_89_71,r_69_89_71,1.0,114,185,71,70
56,seq14,r_25_80_162,r_75_28_137,r_25_80_162,0.82,1,163,162,70
44,r_145_90_70,r_29_18_120,r_75_28_137,r_145_90_70,0.7,-1,69,70,70
23,r_108_149_157,seq30,r_58_96_69,r_58_96_69,0.63,-2,67,69,70
11,r_124_51_42,r_135_2_82,seq36,r_124_51_42,0.9,0,42,42,70
12,r_49_91_109,seq133,seq103,r_49_91_109,0.96,6,115,109,70
23,r_108_149_157,r_58_96_69,r_75_28_137,r_58_96_69,0.8,96,165,69,70
51,seq131,r_30_104_151,r_10_141_15,r_10_141_15,0.91,82,97,15,71
36,r_119_97_127,r_13_51_172,seq53,r_119_97_127,0.86,8,135,127,71
17,r_48_35_53,seq6,seq79,r_48_35_53,0.85,3,56,53,71
86,seq89,seq135,r_70_57_11,r_70_57_11,0.48,83,94,11,71
16,r_16_107_146,seq137,seq6,r_16_107_146,0.54,3,149,146,71
21,r_125_41_168,seq143,seq134,r_125_41_168,0.8,0,168,168,71
1,r_42_76_79,seq5,seq39,r_42_76_79,0.99,2,81,79,71
28,r_60_26_29,seq131,r_17_75_48,r_60_26_29,0.93,7,36,29,71
5,r_31_124_119,r_13_51_172,seq6,r_31_124_119,1.0,0,119,119,71
46,r_149_100_82,seq89,r_13_51_172,r_149_100_82,0.87,8,90,82,71
42,r_77_139_94,r_145_118_167,r_48_35_53,r_77_139_94,0.73,26,120,94,71
3,r_33_44_31,r_63_136_37,seq101,r_33_44_31,0.99,3,34,31,71
45,r_81_84_73,r_145_118_167,seq34,r_81_84_73,1.0,1,74,73,71
37,r_58_61_20,r_114_120_57,seq9,r_58_61_20,1.0,1,21,20,71
66,seq28,r_66_129_142,r_96_144_112,r_66_129_142,0.54,-20,122,142,71
41,r_63_136_37,r_33_44_31,r_10_141_15,r_63_136_37,0.8,-3,34,37,71
31,r_21_148_92,seq131,r_83_103_178,r_21_148_92,0.72,23,115,92,71
30,r_11_116_30,r_66_129_142,r_88_102_25,r_11_116_30,0.97,0,30,30,71
10,r_145_118_167,r_128_47_10,seq135,r_145_118_167,0.76,0,167,167,71
54,seq6,r_88_102_25,r_31_124_119,r_31_124_119,1.0,5,124,119,71
26,r_40_147_106,seq126,seq39,r_40_147_106,0.96,0,106,106,71
4,r_66_129_142,r_121_92_155,seq27,r_66_129_142,0.88,0,142,142,71
0,r_87_43_147,r_66_129_142,r_128_47_10,r_66_129_142,0.99,-20,122,142,71
63,seq137,r_16_107_146,r_73_24_22,r_73_24_22,0.85,127,149,22,71
13,r_49_94_103,seq39,seq65,r_49_94_103,1.0,1,104,103,71
46,r_149_100_82,r_13_51_172,r_15_105_117,r_15_105_117,0.76,38,155,117,71
15,r_13_51_172,seq91,seq5,r_13_51_172,0.55,2,174,172,71
47,r_17_75_48,r_123_82_179,seq126,r_17_75_48,1.0,2,50,48,71
29,r_73_24_22,r_31_124_119,seq137,r_73_24_22,0.93,0,22,22,71
87,seq91,r_13_51_172,r_15_105_117,r_15_105_117,0.53,72,189,117,71
39,r_38_72_55,r_13_51_172,seq18,r_38_72_55,1.0,1,56,55,71
76,seq134,seq6,r_88_102_25,r_88_102_25,0.91,25,50,25,71
40,r_30_104_151,seq131,seq106,r_30_104_151,0.64,-3,148,151,71
25,r_83_103_178,seq131,r_21_148_92,r_21_148_92,0.78,23,115,92,71
14,r_0_12_17,r_42_76_79,seq106,r_0_12_17,1.0,0,17,17,71
33,r_133_90_188,seq32,r_125_41_168,r_125_41_168,0.76,21,189,168,71
64,seq25,r_123_82_179,r_42_76_79,r_42_76_79,0.93,100,179,79,71
24,r_88_102_25,r_1_146_126,r_11_116_30,r_88_102_25,0.98,1,26,25,71
22,r_10_141_15,r_49_94_103,seq131,r_10_141_15,1.0,1,16,15,71
90,seq101,seq14,r_33_44_31,r_33_44_31,1.0,2,33,31,71
76,seq134,r_88_102_25,r_125_41_168,r_125_41_168,0.79,0,168,168,71
34,r_93_8_96,seq113,seq68,r_93_8_96,1.0,0,96,96,71
25,r_83_103_178,r_21_148_92,r_42_76_79,r_83_103_178,0.99,0,178,178,71
43,r_71_112_56,r_40_147_106,seq101,r_71_112_56,1.0,0,56,56,71
31,r_21_148_92,r_83_103_178,r_10_141_15,r_83_103_178,1.0,0,178,178,71
28,r_60_26_29,r_17_75_48,r_33_44_31,r_17_75_48,0.85,86,134,48,71
91,seq106,r_121_92_155,r_87_43_147,r_87_43_147,0.63,19,166,147,71
28,r_60_26_29,r_33_44_31,r_95_85_109,r_60_26_29,0.39,136,165,29,71
49,r_45_69_107,r_16_107_146,seq126,r_45_69_107,0.94,0,107,107,71
7,r_19_54_176,seq115,r_88_102_25,r_88_102_25,1.0,154,179,25,71
23,r_1_146_126,seq113,seq4,r_1_146_126,0.97,1,127,126,71
20,r_70_57_11,r_48_35_53,seq89,r_70_57_11,1.0,-1,10,11,71
35,r_123_82_179,seq25,r_45_69_107,r_45_69_107,0.98,72,179,107,71
93,seq101,seq102,r_47_149_109,r_47_149_109,1.0,13,122,109,72
30,r_131_129_152,r_135_122_192,seq30,r_131_129_152,0.52,6,158,152,72
44,r_61_76_167,r_22_144_46,seq102,r_61_76_167,0.87,1,168,167,72
36,r_47_149_109,seq45,seq101,r_47_149_109,0.92,2,111,109,72
6,r_22_144_46,r_59_139_68,r_61_76_167,r_22_144_46,1.0,0,46,46,72
92,seq100,r_105_33_106,seq103,r_105_33_106,1.0,5,111,106,72
14,r_133_134_138,seq78,seq13,r_133_134_138,1.0,0,138,138,72
53,seq4,seq118,r_23_50_75,r_23_50_75,1.0,73,148,75,72
18,r_35_31_30,seq96,r_24_18_34,r_35_31_30,0.84,4,34,30,72
54,seq5,seq51,r_19_40_77,r_19_40_77,1.0,3,80,77,72
37,r_65_108_120,seq55,seq11,r_65_108_120,0.95,0,120,120,72
15,r_9_106_140,r_24_18_34,seq98,r_24_18_34,1.0,0,34,34,72
3,r_148_37_12,r_60_104_136,seq36,r_148_37_12,0.85,-1,11,12,72
10,r_79_68_128,r_57_82_145,r_7_123_107,r_57_82_145,1.0,-15,130,145,72
55,seq6,r_105_33_106,seq103,r_105_33_106,0.99,-37,69,106,72
71,seq46,r_57_82_145,r_25_130_119,r_57_82_145,0.48,0,145,145,72
39,r_112_62_182,seq8,r_119_127_3,r_119_127_3,0.82,182,185,3,72
1,r_135_122_192,r_131_129_152,r_35_31_30,r_35_31_30,1.0,128,158,30,72
5,r_114_12_102,r_25_130_119,seq102,r_114_12_102,0.98,0,102,102,72
42,r_124_32_170,r_112_62_182,r_47_149_109,r_47_149_109,0.67,62,171,109,72
45,r_77_107_65,seq5,seq54,r_77_107_65,1.0,0,65,65,72
15,r_9_106_140,r_114_12_102,r_126_84_150,r_126_84_150,0.51,9,159,150,72
19,r_7_123_107,r_57_82_145,r_105_33_106,r_7_123_107,0.98,4,111,107,72
15,r_9_106_140,seq98,r_114_12_102,r_114_12_102,0.98,38,140,102,72
95,seq103,r_105_33_106,seq6,r_105_33_106,1.0,-1,105,106,72
31,r_109_132_126,seq49,r_117_90_101,r_109_132_126,0.84,0,126,126,72
41,r_57_82_145,seq46,seq36,r_57_82_145,0.96,0,145,145,72
67,seq38,r_27_110_161,seq71,r_27_110_161,1.0,2,163,161,72
10,r_79_68_128,r_58_147_72,r_57_82_145,r_58_147_72,1.0,1,73,72,72
26,r_58_147_72,r_79_68_128,seq88,r_58_147_72,1.0,1,73,72,72
72,seq49,r_109_132_126,seq55,r_109_132_126,0.99,0,126,126,72
4,r_59_139_68,seq36,seq66,r_59_139_68,1.0,0,68,68,72
0,r_60_104_136,seq102,r_10_92_26,r_60_104_136,0.72,1,137,136,72
11,r_25_130_119,seq120,seq46,r_25_130_119,0.65,3,122,119,72
2,r_74_99_56,seq1,seq120,r_74_99_56,1.0,0,56,56,72
20,r_121_21_86,seq141,seq41,r_121_21_86,1.0,0,86,86,72
50,seq1,r_74_99_56,seq75,r_74_99_56,0.98,1,57,56,72
23,r_10_92_26,seq120,seq72,r_10_92_26,1.0,1,27,26,72
99,seq120,r_25_130_119,r_74_99_56,r_74_99_56,1.0,26,82,56,72
35,r_24_18_34,r_9_106_140,r_35_31_30,r_24_18_34,0.94,0,34,34,72
87,seq88,seq102,r_117_90_101,r_117_90_101,0.99,21,122,101,72
21,r_20_97_59,r_23_50_75,seq1,r_20_97_59,1.0,0,59,59,72
40,r_117_90_101,seq36,seq88,r_117_90_101,0.98,1,102,101,72
47,r_23_50_75,r_22_144_46,seq4,r_23_50_75,0.95,0,75,75,72
25,r_53_128_79,r_44_89_198,seq78,r_53_128_79,1.0,0,79,79,72
33,r_126_84_150,r_44_89_198,r_9_106_140,r_44_89_198,0.66,-45,153,198,72
6,r_22_144_46,r_61_76_167,seq6,r_22_144_46,0.45,122,168,46,72
38,r_27_110_161,seq38,r_77_107_65,r_77_107_65,1.0,98,163,65,72
75,seq55,r_65_108_120,r_77_107_65,r_77_107_65,0.68,55,120,65,72
47,r_23_50_75,r_20_97_59,r_22_144_46,r_23_50_75,0.94,-16,59,75,72
17,r_15_111_104,seq72,r_121_21_86,r_15_111_104,0.93,0,104,104,72
9,r_105_33_106,seq100,r_7_123_107,r_105_33_106,0.97,5,111,106,72
22,r_56_17_70,seq138,seq80,r_56_17_70,0.63,12,82,70,72
28,r_125_87_55,r_59_139_68,seq98,r_125_87_55,0.78,0,55,55,72
44,r_61_76_167,r_23_50_75,r_22_144_46,r_61_76_167,1.0,-92,75,167,72
12,r_86_42_98,r_112_62_182,r_74_99_56,r_86_42_98,0.98,0,98,98,72
7,r_140_143_40,r_9_106_140,seq2,r_140_143_40,1.0,0,40,40,72
15,r_61_34_48,r_49_72_69,seq66,r_61_34_48,0.97,1,49,48,73
44,r_18_47_65,r_10_91_162,r_141_48_143,r_10_91_162,0.95,1,163,162,73
36,r_141_48_143,seq74,r_18_47_65,r_18_47_65,1.0,81,146,65,73
8,r_10_91_162,r_104_78_138,r_122_80_169,r_104_78_138,0.81,-18,120,138,73
10,r_121_118_40,r_122_80_169,seq1,r_121_118_40,1.0,0,40,40,73
83,seq81,r_31_67_186,r_120_137_182,r_120_137_182,0.57,4,186,182,73
37,r_127_76_2,r_49_72_69,r_120_137_182,r_49_72_69,0.97,0,69,69,73
3,r_9_148_171,r_70_33_60,r_135_16_111,r_70_33_60,0.54,114,174,60,73
19,r_115_149_178,r_49_72_69,r_127_76_2,r_115_149_178,0.32,2,180,178,73
16,r_70_33_60,seq1,r_9_148_171,r_70_33_60,0.93,1,61,60,73
1,r_49_72_69,r_127_76_2,r_115_149_178,r_49_72_69,0.97,0,69,69,73
42,r_120_137_182,r_127_76_2,seq81,r_120_137_182,0.53,0,182,182,73
41,r_71_50_14,r_92_119_152,r_134_7_42,r_71_50_14,0.67,0,14,14,73
69,seq40,r_23_42_82,r_75_140_4,r_23_42_82,1.0,-2,80,82,73
45,r_23_42_82,seq40,seq85,r_23_42_82,0.99,0,82,82,73
41,r_71_50_14,r_134_7_42,r_43_2_147,r_134_7_42,0.78,0,42,42,73
19,r_115_149_178,seq24,r_49_72_69,r_49_72_69,0.79,7,76,69,73
33,r_88_57_121,seq66,seq64,r_88_57_121,0.82,9,130,121,73
31,r_8_144_140,r_28_123_101,seq97,r_28_123_101,0.68,34,135,101,73
26,r_28_123_101,r_8_144_140,seq30,r_28_123_101,0.74,0,101,101,73
16,r_70_33_60,r_9_148_171,r_51_99_116,r_70_33_60,0.73,84,144,60,73
6,r_51_99_116,seq132,r_39_36_107,r_51_99_116,0.62,0,116,116,73
3,r_9_148_171,seq24,r_70_33_60,r_9_148_171,0.57,-121,50,171,73
27,r_79_133_170,seq55,r_83_53_29,r_79_133_170,0.62,0,170,170,73
87,seq90,r_120_137_182,r_88_57_121,r_88_57_121,0.73,-39,82,121,73
2,r_122_80_169,seq52,r_101_95_5,r_122_80_169,0.75,1,170,169,73
47,r_135_16_111,r_127_76_2,seq125,r_135_16_111,0.9,2,113,111,73
33,r_88_57_121,r_83_53_29,seq66,r_83_53_29,1.0,1,30,29,73
40,r_130_87_87,seq64,r_127_76_2,r_130_87_87,0.8,14,101,87,73
29,r_100_56_112,r_3_109_198,r_71_50_14,r_100_56_112,0.75,0,112,112,73
46,r_113_110_19,seq85,seq117,r_113_110_19,0.61,0,19,19,73
37,r_127_76_2,r_120_137_182,r_130_87_87,r_120_137_182,0.55,-55,127,182,73
9,r_6_147_41,seq97,seq52,r_6_147_41,1.0,0,41,41,73
11,r_134_7_42,r_43_2_147,r_71_50_14,r_134_7_42,0.73,-26,16,42,73
70,seq46,r_105_27_166,r_111_41_124,r_111_41_124,0.5,43,167,124,73
0,r_94_45_23,r_103_62_177,seq1,r_94_45_23,0.69,6,29,23,73
61,seq17,r_127_76_2,r_145_14_189,r_127_76_2,0.38,70,72,2,73
32,r_84_44_63,seq129,seq63,r_84_44_63,0.98,0,63,63,73
38,r_58_19_125,seq108,seq112,r_58_19_125,0.41,0,125,125,73
34,r_105_27_166,seq46,seq138,r_105_27_166,0.88,1,167,166,73
97,seq117,r_51_99_116,r_113_110_19,r_113_110_19,0.71,3,22,19,73
81,seq74,r_141_48_143,r_104_78_138,r_141_48_143,0.7,3,146,143,73
17,r_136_13_97,r_70_33_60,seq66,r_136_13_97,0.74,9,106,97,73
11,r_134_7_42,r_71_50_14,seq108,r_134_7_42,0.97,3,45,42,73
28,r_111_41_124,seq131,seq132,r_111_41_124,1.0,0,124,124,73
84,seq85,seq54,r_23_42_82,r_23_42_82,1.0,42,124,82,73
84,seq85,r_113_110_19,seq54,r_113_110_19,0.96,0,19,19,73
56,seq129,r_84_44_63,seq108,r_84_44_63,0.84,-8,55,63,73
44,r_18_47_65,seq22,r_10_91_162,r_18_47_65,1.0,0,65,65,73
20,r_83_53_29,r_88_57_121,seq131,r_83_53_29,1.0,0,29,29,73
8,r_10_91_162,r_122_80_169,seq89,r_10_91_162,0.99,1,163,162,73
23,r_20_38_86,r_31_67_186,seq132,r_20_38_86,1.0,0,86,86,73
41,r_71_50_14,r_43_2_147,r_100_56_112,r_71_50_14,0.96,98,112,14,73
79,seq68,r_43_2_147,r_101_95_5,r_43_2_147,1.0,0,147,147,73
35,r_103_62_177,seq124,r_69_128_58,r_103_62_177,0.69,0,177,177,73
13,r_69_128_58,r_10_91_162,seq15,r_69_128_58,1.0,1,59,58,73
36,r_132_71_190,seq77,r_48_19_79,r_48_19_79,0.53,111,190,79,74
26,r_5_145_142,r_137_26_174,r_3_54_94,r_5_145_142,0.64,32,174,142,74
14,r_29_98_100,seq105,r_53_119_198,r_29_98_100,0.99,1,101,100,74
8,r_44_87_61,r_91_136_129,seq40,r_44_87_61,0.73,1,62,61,74
43,r_112_131_175,seq32,r_50_62_74,r_50_62_74,0.91,101,175,74,74
16,r_49_4_146,seq11,r_69_81_38,r_49_4_146,0.52,0,146,146,74
39,r_21_88_148,seq42,r_30_7_136,r_21_88_148,0.98,0,148,148,74
1,r_48_19_79,r_74_57_183,seq80,r_48_19_79,0.64,0,79,79,74
5,r_50_62_74,r_48_19_79,seq40,r_50_62_74,1.0,0,74,74,74
24,r_148_125_40,seq6,seq39,r_148_125_40,1.0,1,41,40,74
32,r_30_7_136,r_41_139_31,r_12_110_89,r_12_110_89,1.0,48,137,89,74
15,r_115_140_50,r_96_118_157,r_138_55_48,r_115_140_50,1.0,0,50,50,74
31,r_113_56_69,r_67_2_104,r_90_133_105,r_67_2_104,0.89,-75,29,104,74
32,r_30_7_136,seq73,r_41_139_31,r_41_139_31,0.62,3,34,31,74
41,r_67_2_104,seq97,seq0,r_67_2_104,1.0,0,104,104,74
2,r_116_141_29,r_38_99_46,r_122_93_8,r_38_99_46,0.86,-17,29,46,74
47,r_8_35_133,r_72_14_117,r_69_81_38,r_69_81_38,0.6,2,40,38,74
48,r_68_37_17,r_75_31_88,seq0,r_68_37_17,0.98,0,17,17,74
7,r_137_26_174,r_70_101_150,r_5_145_142,r_70_101_150,0.71,-2,148,150,74
31,r_113_56_69,r_90_133_105,r_103_20_167,r_113_56_69,1.0,0,69,69,74
13,r_75_31_88,seq121,r_138_55_48,r_75_31_88,0.97,0,88,88,74
32,r_30_7_136,r_12_110_89,r_21_88_148,r_21_88_148,0.52,7,155,148,74
51,seq1,r_138_55_48,r_53_119_198,r_138_55_48,0.98,0,48,48,74
19,r_38_99_46,r_85_109_56,seq60,r_38_99_46,1.0,0,46,46,74
6,r_24_10_12,r_108_111_23,seq59,r_24_10_12,0.97,1,13,12,74
10,r_108_111_23,seq120,r_41_139_31,r_41_139_31,0.77,-2,29,31,74
40,r_70_101_150,seq43,seq97,r_70_101_150,0.98,0,150,150,74
27,r_69_81_38,r_38_99_46,r_8_35_133,r_8_35_133,1.0,-95,38,133,74
29,r_34_142_98,seq17,r_138_55_48,r_34_142_98,0.98,1,99,98,74
5,r_50_62_74,seq40,r_128_28_124,r_128_28_124,0.97,0,124,124,74
25,r_51_47_101,r_137_26_174,seq18,r_51_47_101,1.0,0,101,101,74
33,r_3_54_94,r_53_119_198,seq45,r_3_54_94,0.99,3,97,94,74
82,seq79,r_41_139_31,r_114_100_187,r_114_100_187,0.86,0,187,187,74
42,r_9_76_16,r_67_2_104,seq11,r_9_76_16,0.97,0,16,16,74
31,r_113_56_69,r_103_20_167,r_72_14_117,r_72_14_117,0.7,-1,116,117,74
34,r_41_139_31,r_8_35_133,r_108_111_23,r_41_139_31,0.99,0,31,31,74
9,r_74_57_183,seq39,r_67_2_104,r_67_2_104,1.0,86,190,104,74
7,r_137_26_174,r_5_145_142,seq16,r_5_145_142,0.55,32,174,142,74
88,seq97,r_38_99_46,r_70_101_150,r_70_101_150,0.89,5,155,150,74
22,r_103_20_167,seq104,r_94_89_81,r_103_20_167,0.77,0,167,167,74
28,r_53_119_198,r_3_54_94,r_29_98_100,r_53_119_198,1.0,-97,101,198,74
0,r_138_55_48,seq1,seq65,r_138_55_48,0.99,-2,46,48,74
49,r_94_89_81,seq18,seq144,r_94_89_81,1.0,2,83,81,74
4,r_122_93_8,seq92,r_116_141_29,r_116_141_29,0.98,4,33,29,74
56,seq13,r_5_145_142,r_113_56_69,r_113_56_69,1.0,73,142,69,74
7,r_137_26_174,r_51_47_101,r_70_101_150,r_51_47_101,0.96,0,101,101,74
35,r_12_110_89,r_103_20_167,r_9_76_16,r_12_110_89,0.99,0,89,89,74
12,r_23_149_140,r_96_118_157,r_50_62_74,r_50_62_74,0.95,67,141,74,74
20,r_58_15_53,r_103_20_167,seq121,r_58_15_53,1.0,1,54,53,74
30,r_50_34_146,r_4_40_175,r_97_12_135,r_97_12_135,0.92,41,176,135,75
14,r_82_137_58,seq69,seq11,r_82_137_58,0.9,2,60,58,75
43,r_101_56_96,seq29,seq11,r_101_56_96,0.99,0,96,96,75
23,r_135_133_23,seq96,seq10,r_135_133_23,1.0,0,23,23,75
54,seq10,seq141,r_123_70_79,r_123_70_79,1.0,5,84,79,75
26,r_74_119_94,r_114_142_41,r_108_100_197,r_114_142_41,0.69,6,47,41,75
39,r_75_120_95,seq64,seq0,r_75_120_95,0.99,0,95,95,75
5,r_140_36_83,seq136,seq29,r_140_36_83,1.0,2,85,83,75
46,r_27_28_177,seq118,r_105_124_91,r_105_124_91,0.92,86,177,91,75
48,r_134_149_36,r_7_59_89,r_35_129_102,r_134_149_36,1.0,2,38,36,75
45,r_104_57_60,seq39,seq43,r_104_57_60,1.0,0,60,60,75
19,r_35_129_102,seq16,r_135_133_23,r_35_129_102,0.58,3,105,102,75
10,r_30_103_33,r_78_138_65,r_63_13_54,r_78_138_65,0.61,0,65,65,75
66,seq43,r_131_24_145,r_104_57_60,r_104_57_60,0.99,4,64,60,75
38,r_111_15_62,r_83_45_191,r_23_61_57,r_83_45_191,0.59,-30,161,191,75
26,r_74_119_94,r_108_100_197,seq107,r_74_119_94,1.0,0,94,94,75
3,r_46_25_85,seq98,seq67,r_46_25_85,0.99,1,86,85,75
86,seq95,r_104_57_60,seq51,r_104_57_60,1.0,-8,52,60,75
72,seq62,seq69,r_2_132_76,r_2_132_76,1.0,47,123,76,75
4,r_139_31_120,seq107,r_148_18_77,r_139_31_120,0.92,0,120,120,75
0,r_83_45_191,r_54_73_72,r_111_15_62,r_111_15_62,1.0,12,74,62,75
20,r_54_73_72,r_83_45_191,r_108_100_197,r_54_73_72,0.76,2,74,72,75
13,r_97_12_135,seq39,r_50_34_146,r_97_12_135,0.94,0,135,135,75
15,r_88_87_113,seq80,seq98,r_88_87_113,0.63,8,121,113,75
57,seq143,r_14_55_178,r_5_81_156,r_14_55_178,0.77,2,180,178,75
10,r_30_103_33,r_50_34_146,r_78_138_65,r_30_103_33,1.0,1,34,33,75
47,r_68_106_93,seq65,r_52_42_49,r_68_106_93,0.42,47,140,93,75
6,r_7_59_89,seq143,r_111_15_62,r_7_59_89,1.0,0,89,89,75
27,r_148_18_77,seq39,r_134_149_36,r_148_18_77,1.0,2,79,77,75
1,r_52_42_49,seq26,seq109,r_52_42_49,1.0,0,49,49,75
2,r_92_146_101,seq0,r_135_133_23,r_92_146_101,0.95,4,105,101,75
24,r_72_41_80,r_7_59_89,seq19,r_72_41_80,1.0,0,80,80,75
33,r_66_110_147,r_50_34_146,r_112_22_20,r_66_110_147,0.57,1,148,147,75
48,r_134_149_36,r_35_129_102,r_148_18_77,r_134_149_36,0.93,69,105,36,75
29,r_126_58_35,r_82_137_58,seq26,r_126_58_35,1.0,0,35,35,75
37,r_63_13_54,seq84,r_30_103_33,r_63_13_54,0.61,0,54,54,75
79,seq80,seq96,r_21_113_163,r_21_113_163,0.64,17,180,163,75
38,r_111_15_62,seq10,r_83_45_191,r_111_15_62,1.0,1,63,62,75
21,r_23_61_57,seq43,seq38,r_23_61_57,1.0,0,57,57,75
34,r_105_124_91,seq109,seq67,r_105_124_91,1.0,0,91,91,75
80,seq84,r_63_13_54,r_112_22_20,r_63_13_54,0.97,4,58,54,75
60,seq19,seq136,r_72_41_80,r_72_41_80,1.0,25,105,80,75
17,r_5_81_156,r_14_55_178,r_71_47_6,r_14_55_178,0.57,-22,156,178,75
28,r_14_55_178,seq143,r_72_41_80,r_72_41_80,1.0,100,180,80,75
36,r_114_142_41,r_74_119_94,seq121,r_114_142_41,0.98,0,41,41,75
49,r_20_1_51,seq10,r_71_47_6,r_20_1_51,1.0,1,52,51,75
7,r_78_138_65,r_76_89_195,seq79,r_78_138_65,1.0,0,65,65,75
44,r_4_40_175,r_50_34_146,seq127,r_50_34_146,0.38,31,177,146,75
79,seq80,r_88_87_113,seq96,r_88_87_113,0.94,8,121,113,75
22,r_112_22_20,r_52_42_49,seq8,r_112_22_20,0.69,0,20,20,75
12,r_128_60_174,seq147,r_104_57_60,r_104_57_60,0.95,114,174,60,75
52,seq8,r_68_106_93,r_112_22_20,r_112_22_20,0.84,1,21,20,75
23,r_135_133_23,seq10,r_92_146_101,r_92_146_101,1.0,42,143,101,75
91,seq94,seq76,r_116_58_46,r_116_58_46,1.0,4,50,46,76
38,r_1_104_53,seq14,r_91_8_129,r_1_104_53,1.0,0,53,53,76
8,r_92_148_76,seq82,seq14,r_92_148_76,0.99,3,79,76,76
43,r_93_65_135,seq132,seq50,r_93_65_135,0.82,0,135,135,76
54,seq9,r_135_137_148,r_49_48_90,r_49_48_90,1.0,67,157,90,76
37,r_54_38_190,seq50,r_4_17_79,r_4_17_79,1.0,5,84,79,76
39,r_26_46_81,seq82,seq22,r_26_46_81,0.97,0,81,81,76
1,r_25_11_67,r_133_47_116,seq42,r_25_11_67,1.0,0,67,67,76
97,seq120,r_135_137_148,r_49_48_90,r_49_48_90,0.99,44,134,90,76
5,r_4_17_79,r_135_137_148,r_54_38_190,r_4_17_79,1.0,0,79,79,76
80,seq64,seq60,r_26_46_81,r_26_46_81,1.0,-1,80,81,76
69,seq42,seq145,r_25_11_67,r_25_11_67,1.0,1,68,67,76
0,r_116_58_46,seq107,seq94,r_116_58_46,1.0,3,49,46,76
12,r_95_68_17,r_54_38_190,seq55,r_95_68_17,1.0,0,17,17,76
66,seq36,r_127_12_133,seq27,r_127_12_133,1.0,0,133,133,76
38,r_1_104_53,r_91_8_129,r_34_0_60,r_91_8_129,1.0,0,129,129,76
31,r_51_113_163,seq84,r_25_11_67,r_51_113_163,0.75,0,163,163,76
41,r_141_124_178,seq82,seq40,r_141_124_178,0.36,0,178,178,76
11,r_81_131_33,r_61_111_48,seq138,r_61_111_48,0.91,-25,23,48,76
89,seq84,r_51_113_163,r_149_41_115,r_51_113_163,0.74,0,163,163,76
26,r_34_0_60,r_44_130_122,r_32_89_18,r_34_0_60,1.0,0,60,60,76
4,r_135_137_148,seq9,r_79_90_42,r_79_90_42,1.0,109,151,42,76
20,r_35_114_119,seq132,r_133_47_116,r_35_114_119,0.81,4,123,119,76
13,r_16_142_114,seq60,seq82,r_16_142_114,0.86,1,115,114,76
48,r_49_48_90,r_133_47_116,seq120,r_49_48_90,0.97,1,91,90,76
6,r_129_108_71,seq106,r_32_89_18,r_129_108_71,0.89,2,73,71,76
99,seq125,r_96_29_107,seq40,r_96_29_107,1.0,0,107,107,76
5,r_4_17_79,r_54_38_190,r_93_65_135,r_93_65_135,1.0,55,190,135,76
46,r_87_19_37,seq37,r_99_126_105,r_87_19_37,0.88,2,39,37,76
27,r_21_75_72,r_129_108_71,r_86_3_9,r_21_75_72,0.95,0,72,72,76
47,r_98_103_73,r_91_8_129,seq50,r_98_103_73,0.55,0,73,73,76
40,r_109_70_103,r_101_115_112,r_79_90_42,r_79_90_42,0.97,61,103,42,76
18,r_96_29_107,seq125,r_133_47_116,r_96_29_107,0.75,0,107,107,76
29,r_10_119_180,seq128,r_135_137_148,r_135_137_148,0.74,32,180,148,76
32,r_28_66_22,r_73_39_195,r_44_130_122,r_28_66_22,0.34,38,60,22,76
24,r_136_72_153,seq27,seq128,r_136_72_153,0.63,1,154,153,76
25,r_44_130_122,seq125,r_28_66_22,r_44_130_122,1.0,1,123,122,76
2,r_140_97_30,r_16_142_114,seq15,r_140_97_30,1.0,0,30,30,76
33,r_45_123_121,r_135_137_148,r_25_11_67,r_45_123_121,0.82,0,121,121,76
50,seq128,r_10_119_180,r_136_72_153,r_136_72_153,1.0,27,180,153,76
32,r_28_66_22,r_5_83_56,r_73_39_195,r_28_66_22,0.78,10,32,22,76
14,r_102_139_23,r_122_88_185,seq50,r_102_139_23,1.0,0,23,23,76
65,seq27,r_136_72_153,r_81_131_33,r_136_72_153,0.97,1,154,153,76
52,seq6,r_122_88_185,r_85_30_32,r_85_30_32,0.97,154,186,32,76
71,seq50,r_102_139_23,r_93_65_135,r_93_65_135,1.0,10,145,135,76
34,r_134_110_170,seq18,r_16_142_114,r_134_110_170,0.91,0,170,170,76
3,r_85_30_32,r_135_137_148,seq107,r_85_30_32,0.96,1,33,32,76
37,r_54_38_190,r_4_17_79,r_25_11_67,r_25_11_67,0.63,123,190,67,76
57,seq14,r_1_104_53,seq42,r_1_104_53,1.0,0,53,53,76
22,r_99_126_105,seq121,r_34_0_60,r_34_0_60,1.0,7,67,60,76
28,r_101_115_112,seq84,r_34_0_60,r_101_115_112,1.0,0,112,112,76
49,r_91_8_129,r_98_103_73,r_1_104_53,r_91_8_129,1.0,-56,73,129,76
44,r_71_117_87,seq76,r_129_108_71,r_71_117_87,0.93,0,87,87,76
21,r_79_90_42,seq50,seq132,r_79_90_42,0.97,0,42,42,76
9,r_32_89_18,r_116_58_46,r_133_47_116,r_32_89_18,0.84,0,18,18,76
49,r_91_8_129,r_1_104_53,r_4_17_79,r_91_8_129,1.0,0,129,129,76
30,r_48_88_101,r_5_121_108,r_96_146_15,r_48_88_101,0.97,0,101,101,77
43,r_72_31_84,r_63_62_185,r_84_117_171,r_72_31_84,0.9,2,86,84,77
24,r_33_12_104,r_135_109_161,r_133_54_130,r_135_109_161,0.99,0,161,161,77
48,r_45_98_14,r_111_91_175,seq47,r_45_98_14,0.86,-2,12,14,77
37,r_75_24_99,seq11,seq85,r_75_24_99,0.67,13,112,99,77
21,r_115_16_67,seq70,r_84_117_171,r_115_16_67,0.91,4,71,67,77
5,r_111_91_175,seq52,r_89_55_188,r_89_55_188,0.81,-13,175,188,77
46,r_143_92_122,r_79_132_64,seq47,r_143_92_122,0.99,2,124,122,77
42,r_110_36_80,r_63_62_185,r_46_74_195,r_110_36_80,0.96,-1,79,80,77
32,r_41_23_25,r_63_62_185,r_133_54_130,r_133_54_130,0.99,16,146,130,77
19,r_63_62_185,r_69_38_194,r_34_15_85,r_34_15_85,0.91,101,186,85,77
18,r_135_109_161,r_33_12_104,r_49_123_107,r_135_109_161,0.8,0,161,161,77
38,r_60_120_95,seq61,r_111_91_175,r_111_91_175,0.63,8,183,175,77
18,r_135_109_161,r_69_38_194,r_33_12_104,r_33_12_104,0.89,14,118,104,77
31,r_49_123_107,r_75_24_99,seq76,r_49_123_107,1.0,0,107,107,77
41,r_118_37_173,seq53,r_148_86_157,r_148_86_157,0.99,19,176,157,77
89,seq90,seq76,r_112_2_47,r_112_2_47,0.99,78,125,47,77
17,r_95_30_40,seq101,seq122,r_95_30_40,1.0,0,40,40,77
10,r_46_74_195,seq3,r_139_17_96,r_139_17_96,1.0,3,99,96,77
5,r_111_91_175,r_89_55_188,r_140_94_186,r_111_91_175,0.73,13,188,175,77
26,r_134_104_166,seq39,seq137,r_134_104_166,0.65,0,166,166,77
0,r_14_56_75,seq53,seq127,r_14_56_75,1.0,0,75,75,77
73,seq53,r_118_37_173,r_97_43_48,r_97_43_48,1.0,128,176,48,77
11,r_69_38_194,r_124_130_162,r_41_23_25,r_69_38_194,0.9,-94,100,194,77
39,r_100_13_30,seq78,seq107,r_100_13_30,1.0,1,31,30,77
13,r_119_51_128,r_29_40_72,seq58,r_29_40_72,1.0,0,72,72,77
44,r_112_2_47,r_69_38_194,r_103_6_131,r_112_2_47,0.98,4,51,47,77
15,r_103_6_131,seq70,r_112_2_47,r_112_2_47,0.99,87,134,47,77
14,r_97_43_48,r_144_44_164,seq11,r_97_43_48,1.0,0,48,48,77
6,r_79_132_64,r_143_92_122,seq142,r_143_92_122,0.86,-56,66,122,77
99,seq127,r_96_146_15,r_14_56_75,r_14_56_75,1.0,33,108,75,77
27,r_108_136_198,r_148_86_157,seq26,r_148_86_157,0.91,2,159,157,77
20,r_96_146_15,r_10_87_60,seq127,r_96_146_15,1.0,0,15,15,77
2,r_139_17_96,r_135_109_161,r_46_74_195,r_139_17_96,0.91,0,96,96,77
47,r_125_18_89,seq85,seq129,r_125_18_89,1.0,0,89,89,77
40,r_105_4_93,seq76,r_29_40_72,r_29_40_72,0.48,26,98,72,77
74,seq137,r_10_87_60,seq27,r_10_87_60,1.0,3,63,60,77
18,r_135_109_161,r_139_17_96,r_69_38_194,r_139_17_96,0.91,0,96,96,77
29,r_144_44_164,seq76,seq20,r_144_44_164,0.74,1,165,164,77
24,r_33_12_104,seq122,r_135_109_161,r_33_12_104,0.96,2,106,104,77
33,r_29_40_72,r_119_51_128,seq114,r_29_40_72,0.58,0,72,72,77
58,seq142,r_116_57_105,r_79_132_64,r_79_132_64,0.43,9,73,64,77
3,r_149_102_54,seq138,seq68,r_149_102_54,1.0,0,54,54,77
20,r_96_146_15,seq127,r_48_88_101,r_48_88_101,1.0,7,108,101,77
42,r_110_36_80,r_46_74_195,seq21,r_110_36_80,0.53,67,147,80,77
38,r_60_120_95,r_135_109_161,seq61,r_60_120_95,1.0,2,97,95,77
8,r_89_55_188,seq61,r_111_91_175,r_89_55_188,0.47,-13,175,188,77
8,r_89_55_188,r_111_91_175,seq26,r_89_55_188,0.91,0,188,188,77
34,r_81_0_142,seq52,r_149_102_54,r_149_102_54,0.83,91,145,54,77
13,r_119_51_128,seq58,r_75_24_99,r_119_51_128,0.99,0,128,128,77
9,r_34_15_85,r_66_99_124,r_29_40_72,r_34_15_85,1.0,1,86,85,77
22,r_124_130_162,r_69_38_194,r_125_18_89,r_125_18_89,0.9,74,163,89,77
28,r_133_54_130,seq59,r_41_23_25,r_133_54_130,0.67,1,131,130,77
49,r_28_77_152,seq35,r_84_117_171,r_28_77_152,0.49,11,163,152,77
32,r_41_23_25,seq90,r_63_62_185,r_41_23_25,0.98,-2,23,25,77
23,r_10_87_60,seq137,seq52,r_10_87_60,1.0,3,63,60,77
35,r_25_83_169,seq1,seq145,r_25_83_169,0.48,11,180,169,77
12,r_148_86_157,r_108_136_198,seq42,r_148_86_157,0.77,2,159,157,77
8,r_89_55_188,r_79_132_64,seq138,r_89_55_188,0.71,-146,42,188,77
30,r_48_148_160,seq19,r_71_146_26,r_48_148_160,0.67,0,160,160,78
51,seq1,r_17_32_118,r_34_67_78,r_34_67_78,0.55,0,78,78,78
36,r_75_139_121,r_41_121_185,seq51,r_75_139_121,0.98,0,121,121,78
14,r_83_54_170,r_38_2_197,seq20,r_83_54_170,0.83,0,170,170,78
8,r_134_45_69,seq55,seq0,r_134_45_69,1.0,0,69,69,78
4,r_71_146_26,seq93,seq1,r_71_146_26,0.9,0,26,26,78
43,r_106_73_107,r_72_88_162,seq132,r_106_73_107,0.75,0,107,107,78
16,r_82_103_43,seq20,r_86_137_39,r_82_103_43,1.0,0,43,43,78
49,r_61_8_54,seq16,r_138_39_126,r_138_39_126,0.97,15,141,126,78
21,r_29_77_5,r_126_113_103,seq26,r_126_113_103,0.94,0,103,103,78
39,r_107_80_163,seq42,r_117_104_20,r_107_80_163,0.79,0,163,163,78
5,r_4_130_109,r_61_8_54,r_81_64_108,r_4_130_109,1.0,0,109,109,78
5,r_4_130_109,r_27_116_58,r_61_8_54,r_61_8_54,0.86,9,63,54,78
46,r_98_99_177,seq42,r_66_111_110,r_66_111_110,0.61,67,177,110,78
42,r_81_64_108,r_44_135_148,r_4_130_109,r_81_64_108,0.99,1,109,108,78
45,r_138_39_126,r_46_124_83,seq16,r_138_39_126,0.98,0,126,126,78
25,r_35_69_41,seq22,seq28,r_35_69_41,1.0,0,41,41,78
31,r_131_65_132,seq97,r_3_140_123,r_131_65_132,0.94,1,133,132,78
10,r_96_119_13,r_41_121_185,seq10,r_96_119_13,0.96,0,13,13,78
37,r_149_58_15,r_72_88_162,seq101,r_149_58_15,0.99,0,15,15,78
3,r_72_88_162,seq1,seq21,r_72_88_162,0.62,0,162,162,78
26,r_144_43_119,seq51,seq123,r_144_43_119,0.38,-3,116,119,78
72,seq51,seq118,r_75_139_121,r_75_139_121,1.0,22,143,121,78
32,r_46_124_83,r_138_39_126,r_49_57_23,r_49_57_23,0.73,1,24,23,78
49,r_61_8_54,r_4_130_109,seq16,r_4_130_109,1.0,0,109,109,78
11,r_66_111_110,r_83_54_170,seq7,r_66_111_110,0.63,0,110,110,78
20,r_105_60_73,r_47_102_76,r_95_5_2,r_105_60_73,1.0,0,73,73,78
47,r_117_104_20,seq87,seq93,r_117_104_20,0.96,0,20,20,78
15,r_3_140_123,r_34_67_78,r_47_102_76,r_3_140_123,1.0,-43,80,123,78
48,r_47_102_76,seq1,seq26,r_47_102_76,1.0,0,76,76,78
6,r_17_32_118,seq1,seq114,r_17_32_118,1.0,2,120,118,78
85,seq89,r_3_140_123,r_128_12_93,r_128_12_93,1.0,85,178,93,78
2,r_41_121_185,r_4_130_109,r_53_127_164,r_41_121_185,1.0,0,185,185,78
49,r_61_8_54,r_24_108_194,r_4_130_109,r_61_8_54,1.0,0,54,54,78
2,r_41_121_185,r_75_139_121,r_4_130_109,r_41_121_185,1.0,-64,121,185,78
18,r_126_113_103,r_29_77_5,r_149_58_15,r_126_113_103,1.0,0,103,103,78
29,r_145_30_174,r_94_90_165,r_131_65_132,r_131_65_132,0.91,42,174,132,78
33,r_34_67_78,r_3_140_123,seq1,r_34_67_78,1.0,0,78,78,78
68,seq37,seq123,r_94_90_165,r_94_90_165,0.62,-27,138,165,78
38,r_44_135_148,r_95_5_2,r_36_63_70,r_95_5_2,0.64,146,148,2,78
34,r_36_63_70,r_125_142_128,seq109,r_36_63_70,0.81,0,70,70,78
40,r_49_57_23,seq132,r_46_124_83,r_49_57_23,1.0,0,23,23,78
75,seq68,seq37,r_53_127_164,r_53_127_164,0.45,-62,102,164,78
96,seq118,seq20,r_52_59_32,r_52_59_32,1.0,1,33,32,78
60,seq19,r_48_148_160,r_125_142_128,r_48_148_160,0.74,0,160,160,78
17,r_94_90_165,r_145_30_174,seq37,r_145_30_174,0.71,-6,168,174,78
13,r_52_59_32,seq132,seq118,r_52_59_32,0.94,0,32,32,78
9,r_95_5_2,r_44_135_148,r_105_60_73,r_105_60_73,1.0,75,148,73,78
62,seq21,seq132,r_86_137_39,r_86_137_39,0.9,9,48,39,78
37,r_149_58_15,seq101,r_126_113_103,r_126_113_103,1.0,10,113,103,78
28,r_27_116_58,r_4_130_109,seq10,r_4_130_109,0.61,-46,63,109,78
81,seq141,seq132,r_86_137_39,r_86_137_39,0.99,4,43,39,78
23,r_136_15_48,r_66_111_110,r_75_139_121,r_136_15_48,0.97,0,48,48,78
7,r_53_127_164,r_44_135_148,r_105_60_73,r_105_60_73,1.0,5,78,73,78
44,r_128_12_93,r_147_133_193,seq89,r_128_12_93,1.0,0,93,93,78
19,r_86_137_39,r_41_121_185,seq141,r_86_137_39,0.98,1,40,39,78
35,r_79_9_150,r_72_88_162,seq87,r_79_9_150,0.94,1,151,150,78
23,r_136_15_48,r_75_139_121,r_4_130_109,r_136_15_48,1.0,73,121,48,78
22,r_68_98_64,r_39_116_37,seq81,r_68_98_64,0.72,-22,42,64,79
43,r_59_103_121,r_18_73_139,seq135,r_59_103_121,0.56,0,121,121,79
16,r_143_60_128,r_39_116_37,r_91_20_25,r_143_60_128,0.81,2,130,128,79
21,r_88_89_105,seq40,seq48,r_88_89_105,1.0,0,105,105,79
1,r_119_85_142,r_2_49_115,seq53,r_2_49_115,0.94,0,115,115,79
5,r_39_116_37,r_143_60_128,r_139_79_113,r_39_116_37,0.89,95,132,37,79
46,r_18_73_139,r_59_103_121,r_12_4_120,r_18_73_139,0.75,-18,121,139,79
42,r_145_56_122,seq112,seq101,r_145_56_122,0.79,1,123,122,79
46,r_18_73_139,r_12_4_120,r_6_47_138,r_18_73_139,0.93,0,139,139,79
19,r_21_58_132,r_113_128_5,seq81,r_113_128_5,0.56,127,132,5,79
76,seq70,r_133_25_130,seq83,r_133_25_130,1.0,-1,129,130,79
31,r_126_77_124,r_69_105_135,r_113_128_5,r_69_105_135,0.97,-12,123,135,79
3,r_31_30_83,r_86_136_104,r_17_45_14,r_31_30_83,0.81,0,83,83,79
10,r_82_57_178,seq101,r_113_128_5,r_113_128_5,0.85,173,178,5,79
36,r_46_132_158,r_126_77_124,seq15,r_126_77_124,0.64,-75,49,124,79
14,r_91_20_25,r_38_29_119,r_143_60_128,r_91_20_25,0.87,94,119,25,79
4,r_17_45_14,seq134,seq112,r_17_45_14,1.0,0,14,14,79
11,r_14_115_176,r_32_130_168,r_133_25_130,r_32_130_168,0.49,8,176,168,79
2,r_124_26_58,r_2_49_115,seq108,r_124_26_58,0.54,-2,56,58,79
20,r_69_105_135,r_72_100_145,seq140,r_69_105_135,0.55,0,135,135,79
13,r_95_148_106,r_139_79_113,seq22,r_139_79_113,0.9,-6,107,113,79
98,seq121,r_50_111_173,r_102_51_117,r_102_51_117,0.91,43,160,117,79
29,r_38_29_119,r_133_25_130,r_91_20_25,r_91_20_25,1.0,1,26,25,79
48,r_110_147_127,r_50_111_173,r_88_89_105,r_88_89_105,0.94,24,129,105,79
96,seq112,r_145_56_122,r_17_45_14,r_17_45_14,0.89,14,28,14,79
34,r_92_63_73,r_42_54_30,seq13,r_92_63_73,0.87,0,73,73,79
36,r_46_132_158,seq15,seq131,r_46_132_158,1.0,1,159,158,79
27,r_6_47_138,r_43_106_156,r_18_73_139,r_6_47_138,1.0,1,139,138,79
87,seq90,seq27,r_2_49_115,r_2_49_115,1.0,1,116,115,79
30,r_107_34_60,r_110_147_127,seq48,r_107_34_60,0.95,-2,58,60,79
40,r_86_136_104,r_62_55_179,seq108,r_86_136_104,0.78,1,105,104,79
24,r_139_79_113,r_95_148_106,r_39_116_37,r_139_79_113,0.87,3,116,113,79
44,r_42_54_30,r_92_63_73,r_113_128_5,r_92_63_73,0.98,5,78,73,79
33,r_62_55_179,seq81,r_102_51_117,r_102_51_117,0.99,63,180,117,79
14,r_91_20_25,seq122,r_38_29_119,r_91_20_25,0.98,0,25,25,79
39,r_36_127_59,r_76_144_90,r_142_23_19,r_36_127_59,0.48,0,59,59,79
44,r_42_54_30,r_126_77_124,r_92_63_73,r_42_54_30,0.85,0,30,30,79
32,r_2_49_115,r_119_85_142,seq90,r_2_49_115,1.0,0,115,115,79
38,r_12_4_120,r_72_100_145,seq0,r_12_4_120,1.0,0,120,120,79
3,r_31_30_83,r_17_45_14,r_133_25_130,r_133_25_130,0.88,0,130,130,79
45,r_72_100_145,r_118_97_85,seq7,r_118_97_85,0.98,-33,52,85,79
45,r_72_100_145,seq7,r_59_103_121,r_59_103_121,0.8,29,150,121,79
17,r_11_35_137,seq101,r_68_98_64,r_11_35_137,0.99,1,138,137,79
9,r_84_146_76,seq112,r_126_77_124,r_84_146_76,1.0,0,76,76,79
29,r_38_29_119,r_91_20_25,seq94,r_38_29_119,0.96,0,119,119,79
34,r_92_63_73,seq138,r_42_54_30,r_42_54_30,0.53,7,37,30,79
28,r_113_128_5,r_21_58_132,r_126_77_124,r_21_58_132,0.88,0,132,132,79
49,r_32_130_168,r_14_115_176,r_21_58_132,r_14_115_176,0.7,-7,169,176,79
56,seq8,r_126_77_124,r_84_146_76,r_84_146_76,1.0,49,125,76,79
7,r_118_97_85,r_72_100_145,seq135,r_72_100_145,0.5,-57,88,145,79
23,r_102_51_117,seq0,seq13,r_102_51_117,0.98,0,117,117,79
9,r_84_146_76,r_126_77_124,seq8,r_126_77_124,0.74,1,125,124,79
35,r_44_117_148,seq0,r_21_58_132,r_44_117_148,0.89,1,149,148,79
93,seq103,r_97_47_69,r_30_7_141,r_97_47_69,0.94,-1,68,69,80
51,seq3,r_99_110_195,r_104_64_113,r_104_64_113,0.94,4,117,113,80
26,r_96_75_46,seq34,r_113_83_25,r_96_75_46,0.96,0,46,46,80
36,r_33_126_152,r_99_110_195,r_93_122_62,r_33_126_152,0.7,-62,90,152,80
92,seq98,r_43_32_118,r_85_52_99,r_85_52_99,0.74,0,99,99,80
14,r_17_38_108,r_114_145_159,seq103,r_17_38_108,0.82,1,109,108,80
8,r_118_35_144,r_129_131_193,r_127_107_22,r_118_35_144,0.84,0,144,144,80
72,seq46,seq29,r_23_115_34,r_23_115_34,1.0,1,35,34,80
21,r_119_102_197,r_104_64_113,r_43_32_118,r_119_102_197,0.44,-95,102,197,80
39,r_62_130_187,seq138,r_104_64_113,r_104_64_113,0.97,53,166,113,80
1,r_90_68_87,r_0_55_137,r_37_100_83,r_90_68_87,0.98,3,90,87,80
5,r_106_149_164,seq94,r_12_76_42,r_106_149_164,0.89,0,164,164,80
42,r_53_116_149,seq146,seq147,r_53_116_149,0.48,1,150,149,80
80,seq65,r_14_74_110,r_56_42_186,r_14_74_110,1.0,0,110,110,80
16,r_125_123_94,r_105_2_161,r_59_41_17,r_125_123_94,0.85,-81,13,94,80
32,r_23_115_34,r_96_75_46,seq46,r_23_115_34,1.0,0,34,34,80
19,r_20_19_111,r_106_149_164,r_23_115_34,r_20_19_111,0.97,0,111,111,80
85,seq72,seq46,r_78_135_11,r_78_135_11,0.99,9,20,11,80
95,seq146,r_86_1_114,r_90_68_87,r_90_68_87,1.0,28,115,87,80
31,r_13_140_96,seq132,seq137,r_13_140_96,0.73,-2,94,96,80
41,r_0_55_137,r_101_10_181,r_13_140_96,r_0_55_137,0.96,0,137,137,80
89,seq92,r_16_121_163,r_12_76_42,r_16_121_163,0.72,0,163,163,80
10,r_93_122_62,r_62_130_187,r_33_126_152,r_93_122_62,0.85,0,62,62,80
0,r_77_91_167,seq44,seq73,r_77_91_167,0.65,1,168,167,80
11,r_24_50_160,r_27_84_178,seq112,r_24_50_160,0.64,0,160,160,80
20,r_16_121_163,seq92,seq69,r_16_121_163,0.76,0,163,163,80
15,r_14_74_110,seq65,r_89_111_20,r_14_74_110,1.0,0,110,110,80
48,r_56_42_186,seq65,r_88_87_124,r_56_42_186,0.46,2,188,186,80
23,r_127_107_22,seq39,seq9,r_127_107_22,0.99,2,24,22,80
27,r_114_145_159,r_45_139_199,seq98,r_114_145_159,0.86,0,159,159,80
6,r_101_10_181,r_26_81_191,r_85_52_99,r_85_52_99,0.8,84,183,99,80
21,r_119_102_197,r_43_32_118,r_11_6_128,r_11_6_128,0.93,1,129,128,80
3,r_78_135_11,r_96_75_46,seq72,r_78_135_11,0.91,-1,10,11,80
36,r_33_126_152,r_93_122_62,r_0_55_137,r_33_126_152,0.58,0,152,152,80
10,r_93_122_62,r_33_126_152,r_104_64_113,r_93_122_62,0.99,84,146,62,80
27,r_114_145_159,r_17_38_108,r_45_139_199,r_17_38_108,0.99,1,109,108,80
2,r_43_32_118,r_36_63_89,r_56_42_186,r_36_63_89,0.33,0,89,89,80
47,r_21_109_77,r_25_143_1,r_5_79_9,r_21_109_77,0.68,0,77,77,80
93,seq103,r_30_7_141,r_17_38_108,r_17_38_108,1.0,7,115,108,80
40,r_36_63_89,r_43_32_118,seq147,r_36_63_89,0.75,0,89,89,80
18,r_88_87_124,r_24_50_160,r_54_28_66,r_88_87_124,0.77,2,126,124,80
29,r_11_6_128,seq142,r_119_102_197,r_11_6_128,0.8,0,128,128,80
34,r_113_83_25,seq138,r_96_75_46,r_96_75_46,0.98,12,58,46,80
33,r_105_2_161,seq4,seq61,r_105_2_161,0.86,1,162,161,80
39,r_62_130_187,r_104_64_113,r_127_107_22,r_62_130_187,0.72,1,188,187,80
50,seq128,r_125_123_94,r_14_74_110,r_14_74_110,1.0,24,134,110,80
38,r_133_49_171,seq95,r_33_126_152,r_133_49_171,0.73,0,171,171,80
52,seq4,r_105_2_161,seq51,r_105_2_161,0.99,1,162,161,80
45,r_70_136_38,r_36_63_89,r_129_131_193,r_70_136_38,1.0,0,38,38,80
43,r_59_41_17,seq29,r_125_123_94,r_59_41_17,0.82,-4,13,17,80
4,r_129_131_193,r_118_35_144,r_70_136_38,r_70_136_38,0.85,0,38,38,80
81,seq66,r_54_28_66,seq51,r_54_28_66,0.61,71,137,66,80
17,r_85_52_99,r_11_6_128,seq98,r_85_52_99,0.84,0,99,99,80
25,r_5_79_9,r_85_52_99,r_21_109_77,r_85_52_99,0.97,-18,81,99,80
9,r_86_1_114,seq146,seq67,r_86_1_114,0.72,1,115,114,80
22,r_54_28_66,seq66,seq58,r_54_28_66,0.76,-4,62,66,80
28,r_97_47_69,seq103,seq134,r_97_47_69,0.96,2,71,69,80
91,seq95,r_133_49_171,seq31,r_133_49_171,0.93,0,171,171,80
49,r_37_100_83,r_104_64_113,r_90_68_87,r_37_100_83,0.99,1,84,83,80
7,r_104_64_113,r_119_102_197,seq3,r_104_64_113,0.95,0,113,113,80
44,r_27_84_178,seq137,r_78_135_11,r_78_135_11,0.64,170,181,11,80
2,r_43_32_118,r_56_42_186,r_119_102_197,r_43_32_118,0.7,-18,100,118,80
35,r_99_110_195,r_33_126_152,seq40,r_33_126_152,1.0,-62,90,152,80
12,r_25_143_1,r_21_109_77,seq144,r_21_109_77,0.44,4,81,77,80
37,r_89_111_20,r_12_76_42,r_59_41_17,r_89_111_20,0.75,-2,18,20,80
30,r_102_17_97,r_23_53_193,seq109,r_102_17_97,0.99,0,97,97,81
36,r_49_46_119,r_69_68_162,seq146,r_49_46_119,0.94,1,120,119,81
14,r_12_14_88,r_63_116_112,r_13_7_54,r_12_14_88,1.0,0,88,88,81
43,r_22_33_199,r_78_89_100,r_57_82_57,r_57_82_57,0.85,12,69,57,81
20,r_48_32_137,r_83_143_163,r_27_113_39,r_27_113_39,0.95,0,39,39,81
31,r_124_54_18,r_18_47_58,seq141,r_124_54_18,1.0,0,18,18,81
37,r_20_98_102,seq108,r_18_47_58,r_20_98_102,0.96,1,103,102,81
81,seq73,r_133_137_181,r_37_21_29,r_37_21_29,0.99,5,34,29,81
1,r_5_99_167,seq25,r_34_117_150,r_5_99_167,0.93,0,167,167,81
1,r_5_99_167,r_51_71_86,seq25,r_51_71_86,1.0,0,86,86,81
97,seq119,r_133_137_181,r_28_103_87,r_28_103_87,0.97,94,181,87,81
5,r_136_1_177,seq2,r_5_99_167,r_136_1_177,0.57,0,177,177,81
46,r_50_45_106,seq41,seq38,r_50_45_106,0.62,0,106,106,81
70,seq35,r_27_113_39,r_107_52_194,r_27_113_39,0.54,3,42,39,81
39,r_13_7_54,seq108,seq39,r_13_7_54,1.0,0,54,54,81
19,r_28_103_87,seq139,r_37_21_29,r_28_103_87,1.0,0,87,87,81
41,r_51_71_86,r_5_99_167,seq24,r_51_71_86,0.87,0,86,86,81
3,r_30_19_128,seq114,r_129_70_90,r_30_19_128,0.76,0,128,128,81
10,r_118_101_85,r_69_68_162,r_57_82_57,r_69_68_162,1.0,-77,85,162,81
26,r_34_117_150,seq140,r_36_66_75,r_34_117_150,0.8,0,150,150,81
13,r_63_116_112,seq81,seq25,r_63_116_112,1.0,1,113,112,81
4,r_76_62_120,seq104,r_27_113_39,r_27_113_39,0.69,81,120,39,81
0,r_115_59_118,seq42,seq135,r_115_59_118,0.99,0,118,118,81
16,r_57_82_57,r_30_19_128,r_107_52_194,r_57_82_57,1.0,0,57,57,81
11,r_129_70_90,seq108,seq148,r_129_70_90,0.85,-2,88,90,81
13,r_63_116_112,r_12_14_88,seq81,r_12_14_88,1.0,-5,83,88,81
11,r_129_70_90,seq148,r_30_19_128,r_30_19_128,1.0,0,128,128,81
15,r_121_88_76,r_5_99_167,seq147,r_121_88_76,1.0,0,76,76,81
48,r_64_3_81,r_83_143_163,r_69_68_162,r_64_3_81,1.0,1,82,81,81
6,r_110_112_67,r_136_1_177,r_100_85_139,r_136_1_177,0.7,-84,93,177,81
85,seq139,r_28_103_87,seq43,r_28_103_87,1.0,0,87,87,81
70,seq35,r_102_17_97,r_107_52_194,r_102_17_97,0.54,24,121,97,81
16,r_57_82_57,r_107_52_194,r_118_101_85,r_118_101_85,1.0,5,90,85,81
27,r_125_75_151,r_55_31_159,r_30_19_128,r_55_31_159,1.0,-8,151,159,81
6,r_110_112_67,r_100_85_139,r_83_143_163,r_100_85_139,1.0,-1,138,139,81
33,r_18_47_58,seq109,seq93,r_18_47_58,1.0,0,58,58,81
45,r_58_122_17,r_30_19_128,r_48_32_137,r_58_122_17,1.0,0,17,17,81
18,r_8_144_154,r_136_1_177,r_124_54_18,r_8_144_154,0.73,0,154,154,81
29,r_107_52_194,r_78_89_100,seq15,r_78_89_100,1.0,0,100,100,81
25,r_55_31_159,seq25,r_100_85_139,r_100_85_139,0.98,24,163,139,81
70,seq35,r_107_52_194,r_102_17_97,r_107_52_194,0.87,-18,176,194,81
64,seq147,r_131_92_103,r_121_88_76,r_121_88_76,0.79,9,85,76,81
7,r_27_113_39,seq35,r_58_122_17,r_27_113_39,0.86,-16,23,39,81
58,seq140,r_34_117_150,r_83_143_163,r_34_117_150,0.81,2,152,150,81
20,r_48_32_137,r_27_113_39,r_44_84_91,r_27_113_39,0.98,98,137,39,81
68,seq25,r_55_31_159,r_63_116_112,r_63_116_112,0.99,51,163,112,81
32,r_74_96_180,seq93,r_78_89_100,r_74_96_180,0.65,0,180,180,81
38,r_26_56_138,seq43,r_63_116_112,r_26_56_138,0.98,0,138,138,81
34,r_44_84_91,r_50_45_106,r_97_4_8,r_44_84_91,1.0,0,91,91,81
40,r_123_145_24,seq6,seq67,r_123_145_24,0.88,-1,23,24,81
45,r_58_122_17,r_48_32_137,r_27_113_39,r_48_32_137,0.86,-58,79,137,81
94,seq109,seq148,r_102_17_97,r_102_17_97,1.0,15,112,97,81
9,r_78_89_100,r_22_33_199,seq105,r_78_89_100,1.0,0,100,100,81
49,r_37_21_29,r_136_1_177,seq73,r_37_21_29,0.87,0,29,29,81
22,r_131_92_103,seq130,r_28_103_87,r_131_92_103,1.0,0,103,103,81
91,seq104,r_76_62_120,r_0_80_110,r_0_80_110,0.86,23,133,110,81
44,r_0_80_110,seq81,seq41,r_0_80_110,0.99,1,111,110,81
79,seq67,seq134,r_123_145_24,r_123_145_24,0.88,48,72,24,81
12,r_100_85_139,seq135,seq94,r_100_85_139,0.76,0,139,139,81
36,r_0_138_157,seq53,r_98_68_6,r_0_138_157,0.86,3,160,157,82
14,r_65_82_122,seq102,r_97_86_23,r_65_82_122,0.98,0,122,122,82
43,r_41_134_104,seq50,r_52_137_105,r_41_134_104,1.0,2,106,104,82
83,seq87,r_128_99_64,r_106_20_11,r_128_99_64,1.0,0,64,64,82
37,r_113_61_156,seq118,r_147_71_78,r_147_71_78,0.84,79,157,78,82
42,r_97_86_23,r_56_136_168,seq103,r_97_86_23,0.55,7,30,23,82
39,r_130_126_150,r_89_9_179,seq29,r_130_126_150,0.55,8,158,150,82
1,r_81_96_127,seq66,seq85,r_81_96_127,1.0,0,127,127,82
46,r_32_59_63,r_147_71_78,r_24_114_169,r_32_59_63,0.96,1,64,63,82
80,seq80,r_75_88_149,seq129,r_75_88_149,0.96,7,156,149,82
45,r_52_137_105,r_90_36_69,seq43,r_90_36_69,1.0,1,70,69,82
30,r_92_70_16,r_44_18_112,seq119,r_92_70_16,0.95,0,16,16,82
66,seq42,r_149_74_133,r_95_104_33,r_95_104_33,0.76,93,126,33,82
31,r_115_15_81,seq11,r_37_139_1,r_115_15_81,0.98,0,81,81,82
41,r_90_36_69,r_52_137_105,seq50,r_90_36_69,1.0,1,70,69,82
67,seq43,r_140_145_164,r_12_131_109,r_12_131_109,1.0,3,112,109,82
44,r_57_69_57,r_1_31_152,seq124,r_57_69_57,1.0,0,57,57,82
3,r_17_40_172,seq119,seq102,r_17_40_172,0.49,1,173,172,82
89,seq103,seq91,r_97_86_23,r_97_86_23,0.94,9,32,23,82
26,r_78_49_60,r_1_31_152,r_133_14_36,r_78_49_60,0.98,0,60,60,82
0,r_140_145_164,seq43,r_32_59_63,r_32_59_63,1.0,108,171,63,82
11,r_4_107_140,r_1_31_152,r_149_74_133,r_149_74_133,0.77,7,140,133,82
20,r_146_21_154,seq122,r_95_104_33,r_95_104_33,0.85,31,64,33,82
15,r_110_45_142,r_24_114_169,r_144_27_71,r_110_45_142,0.96,1,143,142,82
48,r_147_71_78,seq85,seq119,r_147_71_78,1.0,0,78,78,82
6,r_94_125_124,r_28_121_180,r_10_63_98,r_94_125_124,0.97,0,124,124,82
27,r_28_121_180,r_94_125_124,r_128_99_64,r_128_99_64,0.61,60,124,64,82
22,r_128_99_64,r_28_121_180,seq67,r_28_121_180,0.94,1,181,180,82
2,r_37_139_1,seq50,r_115_15_81,r_115_15_81,0.99,4,85,81,82
99,seq124,r_79_23_174,r_57_69_57,r_57_69_57,1.0,1,58,57,82
25,r_12_131_109,seq11,seq43,r_12_131_109,0.97,1,110,109,82
28,r_142_64_48,r_79_23_174,seq85,r_142_64_48,1.0,0,48,48,82
33,r_22_7_130,seq102,seq30,r_22_7_130,0.69,0,130,130,82
88,seq102,r_65_82_122,seq8,r_65_82_122,1.0,0,122,122,82
18,r_133_14_36,r_10_63_98,r_77_132_3,r_133_14_36,1.0,1,37,36,82
58,seq148,r_56_136_168,seq3,r_56_136_168,0.85,0,168,168,82
32,r_149_74_133,seq42,r_90_36_69,r_90_36_69,0.96,64,133,69,82
38,r_143_127_116,seq119,r_32_59_63,r_32_59_63,0.85,53,116,63,82
34,r_16_46_161,r_56_136_168,r_65_82_122,r_65_82_122,0.97,36,158,122,82
60,seq29,r_106_20_11,r_130_126_150,r_130_126_150,0.55,0,150,150,82
27,r_28_121_180,r_128_99_64,seq8,r_28_121_180,1.0,0,180,180,82
17,r_24_114_169,seq111,r_52_137_105,r_52_137_105,0.93,21,126,105,82
10,r_2_116_50,r_110_45_142,seq117,r_2_116_50,1.0,0,50,50,82
49,r_19_60_30,r_58_120_38,seq33,r_58_120_38,1.0,-8,30,38,82
22,r_128_99_64,seq87,r_28_121_180,r_128_99_64,1.0,0,64,64,82
4,r_95_104_33,r_81_96_127,seq42,r_95_104_33,1.0,0,33,33,82
7,r_144_27_71,r_0_138_157,seq11,r_0_138_157,0.87,-83,74,157,82
12,r_58_120_38,seq38,seq102,r_58_120_38,1.0,0,38,38,82
30,r_21_73_133,r_146_9_73,r_68_7_63,r_146_9_73,0.9,0,73,73,83
14,r_129_100_83,seq5,seq124,r_129_100_83,1.0,0,83,83,83
53,seq4,r_76_101_177,r_102_109_54,r_102_109_54,1.0,124,178,54,83
54,seq5,r_129_100_83,seq22,r_129_100_83,1.0,0,83,83,83
37,r_42_27_171,seq111,r_23_17_155,r_23_17_155,0.96,21,176,155,83
86,seq90,r_11_79_158,r_74_14_65,r_74_14_65,0.56,-3,62,65,83
16,r_77_37_75,seq8,seq72,r_77_37_75,1.0,0,75,75,83
39,r_143_92_99,r_98_28_198,seq124,r_143_92_99,1.0,1,100,99,83
1,r_146_9_73,r_21_73_133,seq41,r_146_9_73,1.0,0,73,73,83
46,r_75_67_161,r_23_17_155,r_120_110_118,r_75_67_161,0.48,-45,116,161,83
46,r_75_67_161,r_120_110_118,seq108,r_75_67_161,1.0,0,161,161,83
45,r_0_65_117,seq128,r_129_100_83,r_0_65_117,0.98,0,117,117,83
31,r_135_62_74,r_15_104_52,seq130,r_135_62_74,0.63,-22,52,74,83
2,r_119_114_49,r_83_81_55,r_47_24_23,r_119_114_49,1.0,1,50,49,83
11,r_53_38_36,seq41,seq124,r_53_38_36,1.0,-1,35,36,83
98,seq124,r_89_137_160,r_53_38_36,r_53_38_36,1.0,5,41,36,83
47,r_15_104_52,r_135_62_74,r_46_132_21,r_15_104_52,0.94,0,52,52,83
58,seq12,r_146_9_73,r_68_7_63,r_146_9_73,0.91,-19,54,73,83
41,r_120_110_118,r_76_101_177,r_75_67_161,r_120_110_118,0.7,2,120,118,83
11,r_53_38_36,seq59,r_76_101_177,r_76_101_177,0.63,4,181,177,83
3,r_11_79_158,seq41,seq133,r_11_79_158,0.84,1,159,158,83
10,r_51_103_166,r_76_101_177,r_31_63_150,r_76_101_177,0.44,-6,171,177,83
90,seq108,seq18,r_75_67_161,r_75_67_161,0.91,0,161,161,83
81,seq140,r_26_52_185,r_88_117_39,r_88_117_39,0.95,13,52,39,83
26,r_68_7_63,seq136,r_46_132_21,r_68_7_63,0.88,8,71,63,83
41,r_120_110_118,r_75_67_161,r_39_149_194,r_75_67_161,0.99,0,161,161,83
92,seq112,seq41,r_93_121_48,r_93_121_48,1.0,6,54,48,83
0,r_76_101_177,seq4,r_53_38_36,r_53_38_36,0.53,142,178,36,83
42,r_88_117_39,r_120_110_118,seq140,r_88_117_39,0.8,7,46,39,83
20,r_107_1_90,seq49,seq134,r_107_1_90,1.0,0,90,90,83
15,r_2_95_179,r_57_45_15,r_127_54_14,r_2_95_179,0.6,1,180,179,83
48,r_102_109_54,r_113_25_199,seq4,r_102_109_54,0.58,19,73,54,83
71,seq55,r_34_131_66,seq141,r_34_131_66,1.0,-15,51,66,83
30,r_21_73_133,r_68_7_63,r_107_1_90,r_21_73_133,0.75,0,133,133,83
4,r_47_24_23,r_26_52_185,seq147,r_47_24_23,0.82,0,23,23,83
40,r_31_63_150,seq142,seq145,r_31_63_150,0.58,3,153,150,83
25,r_122_139_145,seq49,seq140,r_122_139_145,0.97,1,146,145,83
33,r_16_61_77,r_107_1_90,seq116,r_16_61_77,1.0,0,77,77,83
13,r_43_36_16,r_53_38_36,seq6,r_53_38_36,0.95,-17,19,36,83
32,r_23_17_155,seq134,r_143_92_99,r_23_17_155,0.65,0,155,155,83
38,r_58_105_151,seq145,r_46_132_21,r_58_105_151,0.47,4,155,151,83
34,r_33_126_121,seq64,seq87,r_33_126_121,1.0,2,123,121,83
43,r_46_132_21,r_85_29_93,r_15_104_52,r_46_132_21,0.81,0,21,21,83
9,r_74_14_65,r_2_95_179,seq90,r_74_14_65,1.0,1,66,65,83
27,r_83_81_55,r_148_96_184,seq125,r_83_81_55,0.98,2,57,55,83
98,seq124,r_53_38_36,r_143_92_99,r_143_92_99,1.0,0,99,99,83
22,r_50_60_159,seq141,r_102_109_54,r_50_60_159,0.54,0,159,159,83
49,r_32_78_85,r_57_45_15,seq13,r_32_78_85,1.0,0,85,85,83
7,r_85_29_93,seq130,r_129_100_83,r_85_29_93,1.0,2,95,93,83
23,r_94_144_129,seq18,r_146_9_73,r_146_9_73,1.0,63,136,73,83
82,seq141,r_50_60_159,seq64,r_50_60_159,1.0,0,159,159,83
35,r_34_131_66,seq55,seq134,r_34_131_66,1.0,1,67,66,83
28,r_127_54_14,r_122_139_145,seq8,r_127_54_14,1.0,0,14,14,83
30,r_106_61_167,r_88_91_80,r_8_15_196,r_106_61_167,0.69,0,167,167,84
45,r_120_4_158,r_68_53_43,seq107,r_68_53_43,0.74,0,43,43,84
14,r_88_91_80,r_106_61_167,r_27_86_46,r_27_86_46,0.96,66,112,46,84
26,r_68_53_43,r_120_4_158,seq75,r_68_53_43,0.98,0,43,43,84
83,seq84,r_41_28_156,seq16,r_41_28_156,0.75,-27,129,156,84
37,r_23_83_83,r_136_17_88,seq62,r_23_83_83,1.0,0,83,83,84
55,seq141,r_103_97_179,r_10_44_145,r_10_44_145,0.83,28,173,145,84
21,r_131_112_60,r_43_30_62,r_88_91_80,r_88_91_80,0.96,-20,60,80,84
5,r_65_20_93,r_0_125_98,r_132_77_77,r_132_77_77,1.0,16,93,77,84
46,r_149_19_65,r_80_73_188,seq79,r_149_19_65,1.0,0,65,65,84
31,r_92_5_56,seq93,seq50,r_92_5_56,1.0,0,56,56,84
19,r_143_56_103,seq79,r_80_73_188,r_143_56_103,1.0,0,103,103,84
41,r_41_28_156,seq84,r_148_110_82,r_148_110_82,0.91,79,161,82,84
3,r_12_121_72,seq14,seq129,r_12_121_72,1.0,1,73,72,84
28,r_63_37_39,r_55_95_161,seq7,r_63_37_39,1.0,0,39,39,84
4,r_136_17_88,r_89_21_45,seq14,r_136_17_88,1.0,0,88,88,84
11,r_104_101_137,r_10_44_145,r_0_125_98,r_104_101_137,0.98,1,138,137,84
13,r_55_95_161,r_80_73_188,r_68_53_43,r_80_73_188,0.68,-27,161,188,84
15,r_109_31_109,seq64,r_39_127_69,r_109_31_109,0.99,0,109,109,84
48,r_6_32_79,r_133_134_176,r_131_112_60,r_6_32_79,1.0,1,80,79,84
0,r_38_3_29,r_34_35_149,r_8_15_196,r_38_3_29,0.67,11,40,29,84
20,r_108_82_18,r_78_115_94,seq72,r_108_82_18,0.99,0,18,18,84
0,r_38_3_29,r_8_15_196,r_12_121_72,r_12_121_72,1.0,84,156,72,84
27,r_102_45_173,seq90,r_104_101_137,r_104_101_137,0.79,35,172,137,84
24,r_27_86_46,r_109_31_109,r_88_91_80,r_27_86_46,1.0,0,46,46,84
47,r_133_134_176,r_6_32_79,r_132_77_77,r_6_32_79,0.88,1,80,79,84
18,r_78_115_94,r_142_111_197,r_132_77_77,r_78_115_94,1.0,0,94,94,84
29,r_34_35_149,seq129,r_74_124_51,r_34_35_149,0.87,1,150,149,84
32,r_132_77_77,r_133_134_176,r_0_125_98,r_0_125_98,0.79,13,111,98,84
38,r_36_146_11,r_126_40_150,seq140,r_36_146_11,1.0,0,11,11,84
35,r_138_117_35,r_103_97_179,r_43_30_62,r_43_30_62,0.96,116,178,62,84
25,r_54_66_87,seq14,seq26,r_54_66_87,0.92,0,87,87,84
43,r_148_110_82,r_24_18_9,seq135,r_148_110_82,1.0,0,82,82,84
64,seq135,seq79,r_148_110_82,r_148_110_82,1.0,43,125,82,84
47,r_133_134_176,r_132_77_77,r_12_121_72,r_133_134_176,0.34,0,176,176,84
32,r_132_77_77,r_126_40_150,r_133_134_176,r_132_77_77,0.76,2,79,77,84
34,r_70_13_143,seq79,seq116,r_70_13_143,0.56,0,143,143,84
45,r_120_4_158,seq107,seq26,r_120_4_158,0.97,0,158,158,84
40,r_74_124_51,r_27_86_46,seq123,r_27_86_46,1.0,0,46,46,84
35,r_138_117_35,seq69,r_103_97_179,r_138_117_35,1.0,0,35,35,84
23,r_8_15_196,r_11_29_53,r_38_3_29,r_8_15_196,0.63,-140,56,196,84
8,r_103_97_179,seq49,r_138_117_35,r_138_117_35,1.0,21,56,35,84
49,r_130_1_115,r_89_21_45,r_80_73_188,r_130_1_115,0.99,0,115,115,84
44,r_47_128_135,r_10_44_145,r_92_5_56,r_10_44_145,0.79,-10,135,145,84
16,r_11_29_53,r_8_15_196,seq48,r_11_29_53,0.87,3,56,53,84
17,r_24_18_9,r_148_110_82,seq69,r_148_110_82,1.0,2,84,82,84
12,r_43_30_62,seq98,r_138_117_35,r_43_30_62,0.85,0,62,62,84
23,r_8_15_196,r_38_3_29,r_106_61_167,r_106_61_167,0.86,0,167,167,84
40,r_111_117_161,r_137_118_58,seq70,r_111_117_161,0.88,2,163,161,85
30,r_96_8_159,seq60,r_27_65_38,r_96_8_159,0.89,0,159,159,85
44,r_76_115_151,r_46_94_33,r_27_65_38,r_27_65_38,0.75,113,151,38,85
0,r_135_98_54,r_2_77_110,seq149,r_135_98_54,1.0,1,55,54,85
8,r_142_48_156,r_132_114_98,r_133_125_17,r_142_48_156,0.96,-48,108,156,85
9,r_2_77_110,r_144_99_75,seq3,r_2_77_110,0.97,0,110,110,85
71,seq49,r_62_146_67,seq41,r_62_146_67,1.0,0,67,67,85
16,r_133_125_17,r_0_138_79,r_140_59_19,r_140_59_19,0.93,0,19,19,85
39,r_132_114_98,r_142_48_156,seq124,r_132_114_98,0.74,10,108,98,85
1,r_47_36_61,r_144_99_75,r_61_103_94,r_47_36_61,0.88,2,63,61,85
46,r_40_20_106,seq3,r_140_59_19,r_40_20_106,1.0,0,106,106,85
11,r_144_99_75,seq23,r_2_77_110,r_144_99_75,1.0,0,75,75,85
69,seq44,r_64_90_154,seq70,r_64_90_154,1.0,1,155,154,85
45,r_66_147_1,seq124,r_132_114_98,r_132_114_98,0.98,0,98,98,85
6,r_46_94_33,r_47_36_61,r_76_115_151,r_46_94_33,1.0,1,34,33,85
3,r_62_146_67,seq49,seq15,r_62_146_67,1.0,0,67,67,85
10,r_16_127_101,r_39_56_195,r_30_5_194,r_16_127_101,0.55,0,101,101,85
73,seq53,r_0_138_79,r_100_72_21,r_0_138_79,0.67,-26,53,79,85
26,r_7_42_118,r_17_19_150,seq11,r_7_42_118,1.0,0,118,118,85
35,r_140_59_19,r_30_5_194,r_133_125_17,r_140_59_19,1.0,0,19,19,85
14,r_137_118_58,r_111_117_161,r_116_120_147,r_116_120_147,0.89,16,163,147,85
5,r_27_65_38,r_17_19_150,seq149,r_27_65_38,0.96,2,40,38,85
98,seq124,r_66_147_1,r_132_114_98,r_132_114_98,0.96,3,101,98,85
8,r_142_48_156,r_133_125_17,r_37_107_51,r_142_48_156,1.0,0,156,156,85
15,r_105_68_107,seq25,seq22,r_105_68_107,0.97,1,108,107,85
33,r_30_5_194,r_27_65_38,r_16_127_101,r_16_127_101,0.79,13,114,101,85
85,seq89,r_111_117_161,r_137_118_58,r_137_118_58,1.0,25,83,58,85
9,r_2_77_110,r_66_147_1,r_144_99_75,r_144_99_75,0.9,0,75,75,85
99,seq126,r_116_120_147,r_34_141_4,r_116_120_147,0.72,-51,96,147,85
17,r_88_31_42,r_111_117_161,seq49,r_88_31_42,0.9,2,44,42,85
27,r_109_130_83,r_142_48_156,seq101,r_109_130_83,0.57,4,87,83,85
47,r_0_138_79,r_96_8_159,seq45,r_0_138_79,1.0,0,79,79,85
40,r_111_117_161,seq89,r_137_118_58,r_137_118_58,1.0,8,66,58,85
36,r_108_131_10,r_116_120_147,r_0_138_79,r_108_131_10,0.97,0,10,10,85
18,r_136_43_144,seq143,r_88_31_42,r_136_43_144,0.96,0,144,144,85
29,r_95_4_69,seq6,seq149,r_95_4_69,1.0,0,69,69,85
24,r_61_103_94,r_30_5_194,r_47_36_61,r_47_36_61,0.99,0,61,61,85
33,r_30_5_194,r_61_103_94,r_27_65_38,r_27_65_38,0.48,28,66,38,85
9,r_2_77_110,r_135_98_54,r_66_147_1,r_135_98_54,0.78,3,57,54,85
6,r_46_94_33,r_76_115_151,seq104,r_76_115_151,0.69,-27,124,151,85
36,r_108_131_10,r_0_138_79,r_69_50_48,r_108_131_10,1.0,49,59,10,85
44,r_76_115_151,r_111_117_161,r_46_94_33,r_46_94_33,0.93,9,42,33,85
34,r_116_120_147,seq126,r_137_118_58,r_116_120_147,0.9,0,147,147,85
2,r_37_107_51,seq145,seq26,r_37_107_51,0.99,1,52,51,85
75,seq60,r_96_8_159,r_2_77_110,r_2_77_110,0.81,49,159,110,85
43,r_100_72_21,r_47_36_61,seq53,r_100_72_21,1.0,0,21,21,85
32,r_69_50_48,seq11,r_108_131_10,r_69_50_48,1.0,0,48,48,85
31,r_57_79_115,r_137_118_58,r_38_80_190,r_137_118_58,1.0,0,58,58,85
31,r_57_79_115,r_38_80_190,seq13,r_57_79_115,0.97,-1,114,115,85
14,r_137_118_58,r_57_79_115,r_111_117_161,r_137_118_58,0.85,0,58,58,85
22,r_35_73_84,seq102,r_47_36_61,r_35_73_84,1.0,0,84,84,85
11,r_144_99_75,r_47_36_61,seq23,r_47_36_61,0.9,-5,56,61,85
28,r_81_87_124,seq32,r_148_134_192,r_81_87_124,0.84,0,124,124,85
49,r_83_9_88,seq84,seq78,r_83_9_88,1.0,0,88,88,85
24,r_61_103_94,r_47_36_61,seq84,r_61_103_94,0.97,0,94,94,85
23,r_129_58_45,seq25,seq52,r_129_58_45,0.95,3,48,45,85
56,seq15,seq97,r_62_146_67,r_62_146_67,1.0,1,68,67,85
7,r_54_1_65,seq33,seq15,r_54_1_65,0.8,0,65,65,85
1,r_47_36_61,r_61_103_94,r_35_73_84,r_47_36_61,0.98,33,94,61,85
11,r_144_99_75,r_2_77_110,r_66_147_1,r_2_77_110,0.98,-3,107,110,85
19,r_29_110_57,r_136_43_144,seq32,r_29_110_57,0.95,0,57,57,85
8,r_72_107_59,r_9_16_199,r_87_124_186,r_72_107_59,0.61,10,69,59,86
43,r_105_116_141,seq11,r_50_65_88,r_105_116_141,0.84,0,141,141,86
32,r_22_61_31,r_142_49_145,seq63,r_22_61_31,1.0,0,31,31,86
91,seq109,r_6_43_43,seq3,r_6_43_43,0.98,0,43,43,86
71,seq51,r_29_21_129,seq36,r_29_21_129,1.0,1,130,129,86
86,seq91,r_7_85_94,seq104,r_7_85_94,1.0,0,94,94,86
16,r_112_92_164,seq140,r_146_0_124,r_112_92_164,0.98,0,164,164,86
1,r_118_80_103,r_105_116_141,r_53_25_27,r_118_80_103,0.95,0,103,103,86
80,seq74,r_53_25_27,r_142_49_145,r_142_49_145,1.0,5,150,145,86
5,r_60_103_144,seq86,seq78,r_60_103_144,0.71,1,145,144,86
46,r_144_45_82,r_40_120_63,r_38_126_81,r_38_126_81,0.99,21,102,81,86
69,seq140,r_112_92_164,r_101_133_16,r_112_92_164,0.95,0,164,164,86
19,r_129_68_142,seq4,seq36,r_129_68_142,0.95,0,142,142,86
39,r_62_147_137,r_102_47_5,seq14,r_62_147_137,1.0,0,137,137,86
31,r_146_0_124,r_39_69_155,seq20,r_146_0_124,0.58,1,125,124,86
41,r_29_21_129,seq51,seq148,r_29_21_129,0.95,1,130,129,86
67,seq36,r_146_0_124,seq51,r_146_0_124,0.99,0,124,124,86
14,r_143_44_22,r_112_92_164,seq15,r_143_44_22,1.0,0,22,22,86
42,r_79_95_54,seq125,r_87_124_186,r_79_95_54,1.0,0,54,54,86
10,r_84_134_60,seq64,seq3,r_84_134_60,0.99,0,60,60,86
4,r_55_128_148,seq137,r_99_141_15,r_99_141_15,0.9,136,151,15,86
78,seq67,seq12,r_7_85_94,r_7_85_94,1.0,5,99,94,86
0,r_89_27_179,seq149,r_143_44_22,r_143_44_22,0.62,157,179,22,86
11,r_121_13_69,seq19,seq104,r_121_13_69,1.0,0,69,69,86
26,r_117_17_50,r_121_13_69,r_139_93_154,r_121_13_69,0.81,-18,51,69,86
20,r_33_5_65,seq135,r_130_145_168,r_33_5_65,0.83,1,66,65,86
13,r_98_34_150,seq136,seq75,r_98_34_150,0.86,0,150,150,86
15,r_35_119_149,seq4,seq94,r_35_119_149,0.96,0,149,149,86
48,r_48_108_97,seq123,r_52_82_170,r_48_108_97,0.96,-1,96,97,86
57,seq11,r_105_116_141,seq94,r_105_116_141,1.0,0,141,141,86
62,seq20,r_76_46_192,r_146_0_124,r_146_0_124,1.0,6,130,124,86
85,seq86,r_60_103_144,seq42,r_60_103_144,0.99,1,145,144,86
2,r_130_145_168,seq75,seq36,r_130_145_168,0.86,0,168,168,86
8,r_72_107_59,r_87_124_186,r_143_44_22,r_72_107_59,0.42,50,109,59,86
21,r_53_25_27,r_89_27_179,seq125,r_53_25_27,1.0,1,28,27,86
27,r_39_69_155,seq36,r_60_103_144,r_39_69_155,0.94,0,155,155,86
29,r_71_58_23,r_60_103_144,seq111,r_71_58_23,0.77,0,23,23,86
39,r_62_147_137,r_89_27_179,r_102_47_5,r_102_47_5,0.97,11,16,5,86
2,r_130_145_168,r_142_49_145,seq75,r_142_49_145,0.87,-70,75,145,86
47,r_77_8_174,seq96,r_129_68_142,r_129_68_142,0.97,32,174,142,86
38,r_6_43_43,seq109,seq19,r_6_43_43,0.99,0,43,43,86
25,r_142_49_145,seq15,seq74,r_142_49_145,0.8,0,145,145,86
33,r_10_57_180,seq19,r_89_27_179,r_89_27_179,0.96,2,181,179,86
88,seq96,r_77_8_174,r_101_133_16,r_77_8_174,0.96,0,174,174,86
20,r_33_5_65,r_130_145_168,r_143_44_22,r_143_44_22,0.65,129,151,22,86
61,seq19,r_31_132_175,r_38_126_81,r_38_126_81,1.0,94,175,81,86
28,r_9_16_199,r_72_107_59,r_117_17_50,r_72_107_59,0.98,0,59,59,86
34,r_106_88_153,seq114,r_143_44_22,r_106_88_153,0.92,0,153,153,86
81,seq75,r_142_49_145,r_130_145_168,r_142_49_145,0.77,-70,75,145,86
35,r_97_110_189,r_55_128_148,seq73,r_97_110_189,0.94,0,189,189,86
17,r_50_65_88,seq3,seq137,r_50_65_88,1.0,0,88,88,86
9,r_139_93_154,r_9_16_199,r_84_134_60,r_84_134_60,0.83,94,154,60,86
26,r_117_17_50,r_139_93_154,r_9_16_199,r_139_93_154,1.0,0,154,154,86
37,r_102_47_5,r_62_147_137,r_29_21_129,r_102_47_5,1.0,132,137,5,86
22,r_24_122_162,r_97_110_189,r_60_103_144,r_24_122_162,0.59,1,163,162,86
7,r_38_126_81,r_90_1_171,r_144_45_82,r_38_126_81,1.0,1,82,81,86
23,r_7_85_94,seq91,seq67,r_7_85_94,1.0,0,94,94,86
35,r_97_110_189,r_24_122_162,r_55_128_148,r_97_110_189,0.79,-26,163,189,86
12,r_87_124_186,seq135,r_79_95_54,r_79_95_54,1.0,24,78,54,86
30,r_43_33_188,r_39_114_84,r_133_56_158,r_43_33_188,0.7,-102,86,188,87
32,r_115_12_145,r_79_41_195,r_113_29_46,r_113_29_46,1.0,0,46,46,87
8,r_84_76_90,seq93,r_122_27_68,r_122_27_68,0.89,20,88,68,87
2,r_39_114_84,r_43_33_188,r_133_56_158,r_133_56_158,0.72,-125,33,158,87
71,seq49,seq30,r_100_26_17,r_100_26_17,0.94,64,81,17,87
1,r_133_56_158,r_142_15_162,seq3,r_133_56_158,0.85,0,158,158,87
5,r_69_35_135,seq8,r_16_120_104,r_69_35_135,0.54,1,136,135,87
42,r_142_15_162,seq14,seq30,r_142_15_162,0.89,0,162,162,87
6,r_10_86_56,seq3,r_94_9_35,r_10_86_56,1.0,0,56,56,87
12,r_48_140_136,r_146_126_38,r_148_23_25,r_48_140_136,1.0,-102,34,136,87
32,r_115_12_145,r_113_29_46,seq71,r_115_12_145,0.99,3,148,145,87
45,r_22_68_157,seq75,seq40,r_22_68_157,0.82,1,158,157,87
48,r_148_23_25,r_32_119_51,seq50,r_148_23_25,1.0,-1,24,25,87
13,r_32_119_51,r_79_41_195,seq8,r_32_119_51,1.0,0,51,51,87
19,r_6_67_60,r_53_149_175,r_64_106_52,r_6_67_60,0.51,95,155,60,87
46,r_85_0_14,r_133_56_158,seq18,r_85_0_14,0.99,0,14,14,87
15,r_95_66_74,seq57,seq103,r_95_66_74,1.0,0,74,74,87
95,seq111,r_137_110_160,seq92,r_137_110_160,1.0,0,160,160,87
31,r_79_41_195,r_115_12_145,r_64_106_52,r_79_41_195,0.9,-132,63,195,87
10,r_16_120_104,seq80,r_10_86_56,r_10_86_56,1.0,49,105,56,87
90,seq103,r_7_52_172,r_95_66_74,r_95_66_74,1.0,98,172,74,87
30,r_43_33_188,r_133_56_158,r_32_119_51,r_133_56_158,0.92,-41,117,158,87
16,r_112_145_98,r_4_91_5,seq1,r_112_145_98,1.0,0,98,98,87
4,r_44_90_119,seq45,r_74_147_39,r_44_90_119,1.0,1,120,119,87
0,r_54_5_125,r_48_140_136,seq47,r_54_5_125,0.91,0,125,125,87
11,r_97_118_133,seq24,r_4_91_5,r_97_118_133,1.0,2,135,133,87
14,r_100_26_17,seq42,seq46,r_100_26_17,1.0,1,18,17,87
49,r_130_89_40,r_58_117_138,seq93,r_58_117_138,1.0,0,138,138,87
57,seq17,seq78,r_133_56_158,r_133_56_158,1.0,2,160,158,87
36,r_113_29_46,r_115_12_145,r_64_106_52,r_115_12_145,0.84,-16,129,145,87
28,r_146_126_38,r_48_140_136,seq14,r_146_126_38,1.0,0,38,38,87
51,seq3,r_10_86_56,r_4_91_5,r_10_86_56,0.79,-26,30,56,87
16,r_112_145_98,r_74_147_39,r_4_91_5,r_4_91_5,0.88,23,28,5,87
67,seq42,r_100_26_17,r_99_98_6,r_100_26_17,0.59,1,18,17,87
25,r_125_141_34,r_88_131_194,seq104,r_125_141_34,1.0,0,34,34,87
64,seq36,seq46,r_59_60_11,r_59_60_11,0.94,-1,10,11,87
24,r_64_106_52,seq57,r_79_41_195,r_64_106_52,1.0,0,52,52,87
47,r_128_20_97,r_133_56_158,r_74_147_39,r_128_20_97,0.86,-1,96,97,87
36,r_113_29_46,r_77_96_191,r_115_12_145,r_113_29_46,1.0,0,46,46,87
29,r_122_27_68,seq75,seq62,r_122_27_68,1.0,0,68,68,87
26,r_25_129_27,r_69_35_135,seq93,r_25_129_27,0.96,1,28,27,87
35,r_58_117_138,r_130_89_40,r_64_106_52,r_58_117_138,0.95,0,138,138,87
33,r_127_21_140,seq107,r_125_141_34,r_125_141_34,1.0,106,140,34,87
50,seq1,seq116,r_112_145_98,r_112_145_98,1.0,17,115,98,87
58,seq18,r_34_102_109,r_85_0_14,r_34_102_109,0.68,0,109,109,87
37,r_105_139_54,seq78,seq103,r_105_139_54,1.0,0,54,54,87
41,r_61_2_196,seq57,seq38,r_61_2_196,0.67,-181,15,196,87
49,r_130_89_40,seq30,r_58_117_138,r_130_89_40,0.99,0,40,40,87
17,r_34_102_109,seq18,r_74_147_39,r_34_102_109,1.0,0,109,109,87
2,r_39_114_84,r_133_56_158,r_59_60_11,r_39_114_84,1.0,0,84,84,87
18,r_59_60_11,r_10_86_56,seq36,r_59_60_11,0.92,-1,10,11,87
35,r_58_117_138,r_84_76_90,r_130_89_40,r_130_89_40,1.0,0,40,40,87
7,r_53_149_175,seq81,r_146_126_38,r_53_149_175,0.62,0,175,175,87
44,r_37_65_142,r_133_56_158,seq47,r_37_65_142,0.87,0,142,142,87
23,r_7_52_172,seq103,r_39_114_84,r_39_114_84,0.48,88,172,84,87
82,seq80,r_16_120_104,seq31,r_16_120_104,0.54,24,128,104,87
30,r_69_45_76,r_20_43_107,seq139,r_69_45_76,1.0,2,78,76,88
6,r_36_106_20,seq109,seq123,r_36_106_20,0.99,0,20,20,88
14,r_47_86_108,r_80_73_85,r_6_21_180,r_80_73_85,1.0,0,85,85,88
8,r_97_55_69,seq18,r_24_41_182,r_97_55_69,0.92,3,72,69,88
43,r_24_41_182,r_25_84_142,r_97_55_69,r_24_41_182,0.92,-40,142,182,88
37,r_48_82_163,seq34,r_56_135_114,r_48_82_163,0.65,0,163,163,88
39,r_35_38_70,r_76_75_124,seq51,r_35_38_70,0.8,1,71,70,88
1,r_29_115_164,r_129_112_53,seq37,r_29_115_164,1.0,0,164,164,88
1,r_29_115_164,r_116_59_121,r_129_112_53,r_29_115_164,0.66,-66,98,164,88
5,r_89_7_82,r_90_12_195,seq54,r_89_7_82,1.0,0,82,82,88
42,r_31_93_159,seq103,r_47_86_108,r_47_86_108,0.92,53,161,108,88
45,r_3_132_104,seq62,r_2_141_62,r_3_132_104,0.61,8,112,104,88
19,r_6_21_180,r_99_134_56,r_1_42_90,r_6_21_180,0.7,1,181,180,88
31,r_23_40_63,r_99_134_56,seq130,r_23_40_63,0.96,0,63,63,88
41,r_20_43_107,seq54,seq126,r_20_43_107,0.78,1,108,107,88
46,r_83_52_26,seq130,seq101,r_83_52_26,0.94,8,34,26,88
26,r_17_118_93,seq149,seq34,r_17_118_93,1.0,0,93,93,88
16,r_74_78_6,r_97_55_69,seq46,r_74_78_6,0.37,88,94,6,88
0,r_56_135_114,seq46,seq14,r_56_135_114,0.61,1,115,114,88
63,seq149,seq123,r_25_84_142,r_25_84_142,0.97,15,157,142,88
20,r_25_84_142,r_24_41_182,r_20_43_107,r_24_41_182,0.55,-40,142,182,88
13,r_137_108_84,seq100,seq146,r_137_108_84,1.0,0,84,84,88
85,seq81,seq88,r_111_95_47,r_111_95_47,1.0,0,47,47,88
87,seq91,r_131_148_181,r_56_135_114,r_56_135_114,1.0,44,158,114,88
4,r_60_16_36,r_25_84_142,seq145,r_60_16_36,0.54,3,39,36,88
9,r_129_112_53,r_76_75_124,seq8,r_129_112_53,1.0,0,53,53,88
93,seq109,r_60_16_36,r_99_134_56,r_99_134_56,0.67,110,166,56,88
16,r_74_78_6,seq46,r_23_40_63,r_74_78_6,0.69,107,113,6,88
47,r_116_59_121,r_29_115_164,seq103,r_116_59_121,0.77,0,121,121,88
40,r_76_75_124,seq145,r_39_64_110,r_39_64_110,0.98,25,135,110,88
33,r_2_141_62,seq34,seq144,r_2_141_62,0.65,19,81,62,88
64,seq34,r_2_141_62,r_30_140_38,r_30_140_38,1.0,43,81,38,88
21,r_30_140_38,seq51,seq34,r_30_140_38,1.0,1,39,38,88
38,r_39_64_110,seq34,seq136,r_39_64_110,0.98,0,110,110,88
52,seq130,seq88,r_23_40_63,r_23_40_63,1.0,18,81,63,88
34,r_15_26_99,seq72,r_97_55_69,r_15_26_99,1.0,0,99,99,88
14,r_47_86_108,r_6_21_180,r_65_125_198,r_47_86_108,0.79,1,109,108,88
64,seq34,r_30_140_38,r_17_118_93,r_30_140_38,0.62,86,124,38,88
81,seq71,r_147_85_171,seq72,r_147_85_171,0.68,-53,118,171,88
25,r_105_94_46,r_89_7_82,r_36_106_20,r_105_94_46,0.66,0,46,46,88
10,r_111_95_47,r_47_86_108,seq81,r_111_95_47,0.79,0,47,47,88
96,seq136,r_113_58_133,r_39_64_110,r_39_64_110,0.83,6,116,110,88
22,r_122_114_89,r_113_58_133,r_89_7_82,r_89_7_82,1.0,8,90,82,88
28,r_147_85_171,r_2_141_62,r_33_22_106,r_147_85_171,0.37,-53,118,171,88
91,seq103,r_31_93_159,seq77,r_31_93_159,0.97,2,161,159,88
2,r_33_22_106,r_147_85_171,seq72,r_147_85_171,0.99,-28,143,171,88
23,r_28_63_111,seq34,r_102_19_78,r_28_63_111,0.96,1,112,111,88
28,r_147_85_171,r_33_22_106,seq18,r_147_85_171,1.0,0,171,171,88
48,r_127_143_50,seq0,seq136,r_127_143_50,1.0,1,51,50,88
12,r_36_5_58,r_21_50_94,r_128_113_35,r_36_5_58,1.0,-1,57,58,89
37,r_42_119_90,seq104,r_25_38_86,r_42_119_90,1.0,0,90,90,89
55,seq139,r_19_140_97,seq136,r_19_140_97,1.0,-19,78,97,89
46,r_17_123_62,seq111,seq32,r_17_123_62,1.0,0,62,62,89
42,r_39_95_67,r_61_96_2,seq112,r_39_95_67,1.0,0,67,67,89
80,seq75,r_69_44_123,r_71_41_103,r_71_41_103,1.0,20,123,103,89
38,r_98_148_39,r_19_140_97,r_28_132_3,r_98_148_39,0.99,0,39,39,89
45,r_26_9_139,r_77_115_168,seq76,r_26_9_139,0.97,0,139,139,89
92,seq104,r_42_119_90,r_92_11_54,r_42_119_90,1.0,-43,47,90,89
47,r_110_70_34,r_122_27_27,seq107,r_110_70_34,1.0,0,34,34,89
43,r_99_118_143,r_34_0_57,r_83_35_96,r_99_118_143,0.64,-85,58,143,89
11,r_128_113_35,seq129,seq124,r_128_113_35,1.0,0,35,35,89
95,seq111,seq62,r_81_93_107,r_81_93_107,1.0,1,108,107,89
66,seq31,seq85,r_71_41_103,r_71_41_103,0.98,21,124,103,89
32,r_83_35_96,r_99_118_143,r_60_127_113,r_60_127_113,0.74,2,115,113,89
31,r_66_49_85,r_90_79_181,seq43,r_66_49_85,1.0,0,85,85,89
41,r_48_16_124,seq52,seq23,r_48_16_124,0.98,1,125,124,89
19,r_47_57_24,r_131_53_56,r_37_102_17,r_47_57_24,1.0,0,24,24,89
26,r_81_93_107,r_48_16_124,seq111,r_81_93_107,1.0,0,107,107,89
72,seq52,r_48_16_124,seq141,r_48_16_124,0.98,1,125,124,89
16,r_84_67_11,r_46_120_104,r_92_11_54,r_46_120_104,1.0,0,104,104,89
1,r_4_8_23,seq31,r_89_116_4,r_89_116_4,0.89,23,27,4,89
4,r_21_50_94,seq85,seq7,r_21_50_94,0.73,-12,82,94,89
0,r_101_143_63,r_77_115_168,r_61_96_2,r_101_143_63,1.0,0,63,63,89
20,r_108_94_120,r_77_115_168,r_37_102_17,r_77_115_168,0.68,-48,120,168,89
30,r_134_74_26,seq107,r_4_8_23,r_134_74_26,1.0,0,26,26,89
13,r_138_64_128,r_15_130_195,r_56_105_64,r_138_64_128,1.0,0,128,128,89
44,r_34_0_57,r_99_118_143,r_122_27_27,r_34_0_57,1.0,1,58,57,89
15,r_54_3_133,seq145,r_25_38_86,r_54_3_133,0.87,0,133,133,89
48,r_19_140_97,seq139,seq137,r_19_140_97,1.0,0,97,97,89
6,r_77_115_168,seq112,seq85,r_77_115_168,0.18,7,175,168,89
27,r_25_38_86,r_138_64_128,seq45,r_25_38_86,1.0,0,86,86,89
3,r_37_102_17,r_54_3_133,r_47_57_24,r_37_102_17,0.8,-1,16,17,89
62,seq147,r_46_120_104,r_92_11_54,r_46_120_104,0.98,-77,27,104,89
40,r_90_79_181,seq144,r_21_50_94,r_90_79_181,0.53,0,181,181,89
18,r_149_142_160,seq23,r_4_8_23,r_149_142_160,0.7,0,160,160,89
29,r_71_41_103,seq45,seq75,r_71_41_103,1.0,0,103,103,89
43,r_99_118_143,r_83_35_96,r_33_100_22,r_33_100_22,0.87,122,144,22,89
33,r_72_20_116,seq7,r_4_8_23,r_4_8_23,0.52,99,122,23,89
32,r_83_35_96,r_54_3_133,r_99_118_143,r_83_35_96,0.71,1,97,96,89
34,r_6_103_146,seq78,seq136,r_6_103_146,0.98,0,146,146,89
17,r_106_109_134,seq12,r_84_67_11,r_106_109_134,0.82,0,134,134,89
5,r_131_53_56,seq107,seq32,r_131_53_56,1.0,1,57,56,89
9,r_46_120_104,r_55_24_99,r_122_27_27,r_46_120_104,1.0,0,104,104,89
58,seq14,seq18,r_40_30_41,r_40_30_41,0.96,-6,35,41,89
16,r_84_67_11,r_149_142_160,r_46_120_104,r_84_67_11,0.98,0,11,11,89
22,r_87_133_101,seq63,seq78,r_87_133_101,0.99,0,101,101,89
28,r_55_24_99,r_46_120_104,seq136,r_55_24_99,1.0,0,99,99,89
7,r_60_127_113,seq136,r_83_35_96,r_60_127_113,1.0,0,113,113,89
23,r_61_96_2,r_39_95_67,r_101_143_63,r_61_96_2,1.0,65,67,2,89
10,r_122_27_27,r_106_109_134,seq63,r_122_27_27,0.77,0,27,27,89
35,r_56_105_64,r_21_50_94,seq112,r_56_105_64,0.6,-1,63,64,89
30,r_129_112_138,seq20,r_26_29_105,r_26_29_105,0.95,3,108,105,90
36,r_123_35_86,r_148_118_159,r_60_122_26,r_123_35_86,1.0,0,86,86,90
14,r_96_59_164,r_0_58_171,r_67_144_34,r_96_59_164,0.69,0,164,164,90
53,seq7,r_116_108_170,r_0_58_171,r_116_108_170,0.72,1,171,170,90
43,r_30_25_121,seq82,r_11_111_117,r_30_25_121,0.97,0,121,121,90
22,r_26_29_105,r_129_112_138,r_140_117_37,r_129_112_138,1.0,1,139,138,90
37,r_79_93_85,seq12,seq45,r_79_93_85,1.0,0,85,85,90
40,r_57_113_111,r_38_17_63,seq55,r_57_113_111,0.71,0,111,111,90
55,seq137,r_138_52_52,r_124_15_93,r_124_15_93,1.0,24,117,93,90
71,seq45,seq119,r_79_93_85,r_79_93_85,1.0,0,85,85,90
16,r_62_4_146,seq12,r_134_136_128,r_62_4_146,0.7,0,146,146,90
21,r_74_147_87,r_124_15_93,seq104,r_74_147_87,1.0,0,87,87,90
39,r_149_18_95,seq53,seq55,r_149_18_95,0.81,1,96,95,90
1,r_130_110_96,seq82,seq7,r_130_110_96,0.84,3,99,96,90
32,r_95_114_16,r_75_99_102,seq100,r_95_114_16,1.0,0,16,16,90
5,r_134_136_128,seq44,r_109_19_35,r_134_136_128,1.0,0,128,128,90
27,r_97_41_156,r_102_145_49,seq40,r_97_41_156,0.98,0,156,156,90
31,r_115_37_139,seq133,seq51,r_115_37_139,0.99,0,139,139,90
41,r_14_121_6,r_77_71_152,r_140_117_37,r_140_117_37,0.89,116,153,37,90
3,r_80_1_169,seq40,r_11_111_117,r_11_111_117,0.87,54,171,117,90
10,r_101_31_181,r_92_139_189,r_60_122_26,r_60_122_26,0.74,155,181,26,90
4,r_131_83_123,r_96_59_164,r_124_15_93,r_96_59_164,1.0,-41,123,164,90
78,seq55,r_38_17_63,r_131_83_123,r_38_17_63,1.0,0,63,63,90
11,r_38_17_63,seq55,r_57_113_111,r_38_17_63,0.99,0,63,63,90
13,r_148_118_159,seq70,seq78,r_148_118_159,0.4,13,172,159,90
42,r_102_145_49,r_135_66_73,r_97_41_156,r_102_145_49,1.0,0,49,49,90
15,r_84_24_134,r_138_52_52,seq2,r_84_24_134,0.69,0,134,134,90
46,r_103_128_36,r_75_99_102,seq141,r_103_128_36,0.99,0,36,36,90
57,seq13,r_97_41_156,r_76_89_107,r_76_89_107,0.62,0,107,107,90
0,r_64_10_10,r_134_136_128,seq51,r_64_10_10,0.91,3,13,10,90
9,r_140_117_37,seq6,seq12,r_140_117_37,1.0,0,37,37,90
19,r_48_143_29,seq105,seq51,r_48_143_29,1.0,0,29,29,90
30,r_129_112_138,r_26_29_105,r_102_145_49,r_129_112_138,1.0,0,138,138,90
8,r_109_19_35,r_74_147_87,seq61,r_109_19_35,1.0,0,35,35,90
27,r_97_41_156,seq22,r_102_145_49,r_102_145_49,1.0,33,82,49,90
25,r_60_122_26,r_79_93_85,seq119,r_60_122_26,0.93,1,27,26,90
2,r_75_99_102,r_76_89_107,seq51,r_75_99_102,1.0,0,102,102,90
40,r_57_113_111,r_30_25_121,r_38_17_63,r_38_17_63,1.0,8,71,63,90
18,r_0_58_171,r_96_59_164,seq7,r_0_58_171,0.5,0,171,171,90
29,r_76_89_107,seq61,seq13,r_76_89_107,0.94,0,107,107,90
88,seq82,r_30_25_121,r_148_118_159,r_30_25_121,1.0,0,121,121,90
61,seq22,r_97_41_156,seq13,r_97_41_156,1.0,-100,56,156,90
42,r_102_145_49,r_97_41_156,r_129_112_138,r_102_145_49,0.97,102,151,49,90
87,seq81,r_28_23_112,r_68_27_9,r_68_27_9,0.57,1,10,9,90
34,r_11_111_117,seq44,r_30_25_121,r_11_111_117,0.98,4,121,117,90
49,r_63_146_50,r_97_41_156,seq107,r_63_146_50,1.0,0,50,50,90
24,r_126_98_13,r_97_41_156,r_138_52_52,r_126_98_13,0.99,0,13,13,90
17,r_77_71_152,r_14_121_6,r_68_27_9,r_77_71_152,0.58,1,153,152,90
22,r_26_29_105,seq142,r_129_112_138,r_26_29_105,0.91,2,107,105,90
28,r_135_66_73,seq20,seq7,r_135_66_73,1.0,0,73,73,90
25,r_60_122_26,seq119,r_46_3_40,r_46_3_40,0.72,23,63,40,90
7,r_106_91_148,seq54,seq53,r_106_91_148,0.55,0,148,148,90
38,r_46_3_40,r_38_17_63,r_60_122_26,r_46_3_40,1.0,1,41,40,90
11,r_38_17_63,r_57_113_111,r_109_19_35,r_57_113_111,1.0,0,111,111,90
12,r_28_23_112,seq81,r_140_117_37,r_28_23_112,0.7,0,112,112,90
30,r_129_105_149,r_50_68_180,seq131,r_129_105_149,0.91,1,150,149,91
66,seq30,r_84_149_162,r_74_47_70,r_74_47_70,0.74,48,118,70,91
14,r_29_108_175,seq81,r_129_105_149,r_29_108_175,0.56,0,175,175,91
23,r_89_13_23,r_19_91_179,r_49_113_165,r_89_13_23,1.0,0,23,23,91
54,seq9,r_122_134_141,seq96,r_122_134_141,1.0,-14,127,141,91
39,r_38_111_76,seq139,r_109_2_168,r_38_111_76,1.0,4,80,76,91
1,r_79_127_91,r_44_65_103,r_70_42_33,r_79_127_91,0.95,0,91,91,91
5,r_72_12_163,seq102,r_6_144_81,r_72_12_163,0.61,0,163,163,91
46,r_128_11_157,seq86,r_61_78_79,r_128_11_157,0.55,0,157,157,91
42,r_109_2_168,r_21_117_83,r_38_111_76,r_38_111_76,0.54,1,77,76,91
45,r_61_78_79,r_84_149_162,seq141,r_61_78_79,1.0,0,79,79,91
40,r_77_125_24,seq4,r_82_147_176,r_77_125_24,0.96,0,24,24,91
43,r_97_76_41,r_50_68_180,seq16,r_97_76_41,0.99,0,41,41,91
38,r_132_48_22,seq34,r_40_3_67,r_40_3_67,0.62,24,91,67,91
39,r_38_111_76,r_109_2_168,seq126,r_109_2_168,0.84,1,169,168,91
41,r_6_144_81,seq43,r_98_58_8,r_6_144_81,0.89,36,117,81,91
3,r_122_134_141,seq9,seq30,r_122_134_141,0.88,1,142,141,91
10,r_84_149_162,seq131,r_133_63_142,r_84_149_162,0.53,0,162,162,91
90,seq102,r_72_12_163,seq67,r_72_12_163,0.63,0,163,163,91
26,r_73_69_74,r_72_12_163,seq148,r_73_69_74,1.0,0,74,74,91
17,r_82_147_176,r_41_75_195,r_77_125_24,r_77_125_24,1.0,0,24,24,91
78,seq66,r_24_0_158,r_56_115_5,r_24_0_158,0.55,-20,138,158,91
0,r_44_65_103,seq141,seq26,r_44_65_103,0.9,0,103,103,91
34,r_52_32_30,r_44_65_103,r_95_142_6,r_52_32_30,0.94,0,30,30,91
11,r_21_117_83,r_109_2_168,seq146,r_109_2_168,0.45,-84,84,168,91
40,r_77_125_24,r_82_147_176,r_80_28_56,r_80_28_56,0.79,19,75,56,91
20,r_1_94_64,r_122_134_141,seq46,r_1_94_64,1.0,2,66,64,91
13,r_31_124_71,seq143,seq102,r_31_124_71,0.87,1,72,71,91
98,seq148,r_19_91_179,r_73_69_74,r_73_69_74,1.0,105,179,74,91
15,r_64_123_69,r_84_149_162,seq53,r_64_123_69,1.0,0,69,69,91
12,r_95_142_6,r_103_17_161,r_52_32_30,r_95_142_6,0.97,62,68,6,91
65,seq27,r_93_130_173,r_45_5_15,r_45_5_15,0.99,-5,10,15,91
8,r_36_120_17,r_72_12_163,r_41_75_195,r_36_120_17,1.0,0,17,17,91
6,r_93_130_173,seq27,r_21_117_83,r_93_130_173,0.32,-2,171,173,91
36,r_49_113_165,r_89_13_23,r_74_47_70,r_74_47_70,0.98,96,166,70,91
27,r_74_47_70,seq138,seq143,r_74_47_70,1.0,0,70,70,91
35,r_45_5_15,r_10_137_12,seq27,r_45_5_15,0.98,-3,12,15,91
37,r_107_106_49,seq26,r_89_13_23,r_107_106_49,0.98,0,49,49,91
38,r_132_48_22,r_80_28_56,seq34,r_132_48_22,0.99,0,22,22,91
18,r_15_83_140,r_18_7_177,r_61_78_79,r_18_7_177,0.71,-37,140,177,91
29,r_50_68_180,r_129_105_149,r_40_3_67,r_50_68_180,0.69,-13,167,180,91
24,r_136_25_90,seq126,seq26,r_136_25_90,0.98,2,92,90,91
25,r_24_0_158,seq66,r_61_78_79,r_24_0_158,0.84,0,158,158,91
33,r_103_17_161,r_72_12_163,r_44_65_103,r_103_17_161,0.56,0,161,161,91
42,r_109_2_168,r_38_111_76,r_133_63_142,r_133_63_142,0.54,26,168,142,91
47,r_70_42_33,seq4,seq62,r_70_42_33,0.77,-1,32,33,91
36,r_49_113_165,seq57,r_89_13_23,r_89_13_23,1.0,7,30,23,91
22,r_40_3_67,seq119,seq53,r_40_3_67,0.55,3,70,67,91
28,r_92_59_164,seq87,r_73_69_74,r_73_69_74,0.95,91,165,74,91
49,r_145_54_137,r_133_63_142,r_98_58_8,r_145_54_137,0.95,0,137,137,91
44,r_33_14_88,r_103_17_161,r_80_28_56,r_103_17_161,1.0,-73,88,161,91
17,r_82_147_176,r_77_125_24,r_74_47_70,r_74_47_70,0.79,106,176,70,91
23,r_89_13_23,r_49_113_165,r_107_106_49,r_107_106_49,1.0,117,166,49,91
41,r_6_144_81,r_98_58_8,r_72_12_163,r_6_144_81,0.98,82,163,81,91
37,r_58_33_46,seq127,seq27,r_58_33_46,0.55,1,47,46,92
30,r_25_50_106,seq40,seq120,r_25_50_106,0.95,0,106,106,92
36,r_48_63_156,r_142_103_152,seq55,r_48_63_156,0.9,0,156,156,92
92,seq113,r_15_102_133,r_71_123_48,r_71_123_48,1.0,30,78,48,92
14,r_53_5_139,r_1_112_136,seq72,r_53_5_139,0.87,0,139,139,92
46,r_122_2_22,r_104_129_125,seq29,r_122_2_22,1.0,0,22,22,92
8,r_131_73_168,r_90_32_3,r_105_6_118,r_105_6_118,0.91,50,168,118,92
43,r_95_8_71,r_79_139_142,seq77,r_79_139_142,0.96,-64,78,142,92
54,seq140,seq55,r_0_10_87,r_0_10_87,1.0,39,126,87,92
55,seq144,r_7_108_185,r_121_13_123,r_121_13_123,0.81,57,180,123,92
86,seq97,r_121_13_123,r_90_32_3,r_121_13_123,0.54,3,126,123,92
16,r_145_46_138,seq57,r_79_139_142,r_145_46_138,0.59,5,143,138,92
39,r_92_65_180,r_89_12_24,r_52_24_179,r_92_65_180,0.56,0,180,180,92
1,r_142_103_152,seq56,seq81,r_142_103_152,0.25,0,152,152,92
42,r_83_49_55,r_91_68_171,r_31_138_164,r_83_49_55,1.0,0,55,55,92
45,r_45_149_59,seq70,seq98,r_45_149_59,1.0,3,62,59,92
19,r_9_96_128,seq118,r_89_12_24,r_9_96_128,0.93,0,128,128,92
0,r_14_135_49,r_53_5_139,seq56,r_14_135_49,0.99,1,50,49,92
95,seq118,r_9_96_128,seq66,r_9_96_128,1.0,-28,100,128,92
7,r_71_123_48,r_31_138_164,seq113,r_71_123_48,1.0,3,51,48,92
35,r_61_64_57,seq43,seq40,r_61_64_57,0.98,1,58,57,92
31,r_54_37_97,r_91_68_171,seq29,r_54_37_97,1.0,0,97,97,92
20,r_93_130_27,seq4,seq114,r_93_130_27,0.88,6,33,27,92
41,r_79_139_142,r_92_65_180,r_145_46_138,r_79_139_142,0.89,0,142,142,92
44,r_69_136_134,seq114,seq127,r_69_136_134,0.56,-80,54,134,92
10,r_143_17_90,r_52_24_179,seq23,r_143_17_90,1.0,0,90,90,92
26,r_28_74_102,r_89_12_24,seq144,r_28_74_102,1.0,0,102,102,92
73,seq56,r_142_103_152,seq148,r_142_103_152,0.48,7,159,152,92
11,r_104_129_125,seq116,r_84_128_108,r_104_129_125,0.98,0,125,125,92
9,r_22_36_31,seq60,r_86_3_72,r_22_36_31,0.78,1,32,31,92
99,seq127,seq99,r_69_136_134,r_69_136_134,0.57,-1,133,134,92
13,r_91_68_171,r_54_37_97,seq120,r_54_37_97,1.0,0,97,97,92
15,r_52_24_179,seq127,r_75_78_121,r_75_78_121,1.0,15,136,121,92
4,r_31_138_164,r_83_49_55,r_124_42_119,r_31_138_164,0.92,0,164,164,92
9,r_22_36_31,r_86_3_72,r_61_64_57,r_86_3_72,0.51,2,74,72,92
13,r_91_68_171,seq120,r_71_123_48,r_91_68_171,0.68,1,172,171,92
6,r_35_18_116,r_121_13_123,r_85_62_73,r_35_18_116,1.0,0,116,116,92
3,r_11_115_12,r_142_103_152,r_89_12_24,r_11_115_12,1.0,0,12,12,92
4,r_31_138_164,r_71_123_48,r_83_49_55,r_31_138_164,1.0,-109,55,164,92
99,seq127,r_58_33_46,seq99,r_58_33_46,0.54,10,56,46,92
27,r_67_47_85,r_59_126_151,seq77,r_67_47_85,1.0,-1,84,85,92
70,seq43,r_61_64_57,seq77,r_61_64_57,1.0,1,58,57,92
87,seq98,seq114,r_45_149_59,r_45_149_59,1.0,8,67,59,92
2,r_59_126_151,seq27,seq19,r_59_126_151,0.59,0,151,151,92
47,r_85_62_73,r_79_139_142,seq81,r_85_62_73,1.0,0,73,73,92
40,r_147_51_188,seq19,r_142_103_152,r_142_103_152,0.72,36,188,152,92
74,seq57,r_145_46_138,seq134,r_145_46_138,0.73,5,143,138,92
18,r_105_6_118,r_92_65_180,seq27,r_105_6_118,0.99,0,118,118,92
29,r_75_78_121,seq30,r_52_24_179,r_75_78_121,1.0,0,121,121,92
24,r_86_3_72,r_25_50_106,r_83_49_55,r_86_3_72,0.7,0,72,72,92
25,r_121_13_123,r_35_18_116,seq116,r_35_18_116,0.75,0,116,116,92
33,r_89_12_24,r_92_65_180,r_9_96_128,r_9_96_128,1.0,2,130,128,92
42,r_83_49_55,r_31_138_164,r_86_3_72,r_83_49_55,0.95,109,164,55,92
61,seq26,r_31_138_164,r_86_3_72,r_86_3_72,0.98,15,87,72,92
38,r_0_10_87,r_92_65_180,seq140,r_0_10_87,1.0,0,87,87,92
21,r_16_119_51,seq140,seq87,r_16_119_51,1.0,0,51,51,92
34,r_84_128_108,seq23,seq81,r_84_128_108,1.0,1,109,108,92
81,seq80,r_15_102_133,r_91_68_171,r_91_68_171,0.49,-36,135,171,92
17,r_7_108_185,seq144,r_93_130_27,r_7_108_185,0.18,1,186,185,92
63,seq29,r_122_2_22,r_54_37_97,r_54_37_97,1.0,27,124,97,92
96,seq120,r_91_68_171,r_25_50_106,r_25_50_106,0.97,56,162,106,92
22,r_106_94_78,r_15_102_133,r_11_115_12,r_106_94_78,1.0,0,78,78,92
28,r_1_112_136,r_53_5_139,r_0_10_87,r_1_112_136,0.95,3,139,136,92
63,seq29,r_9_96_128,r_122_2_22,r_122_2_22,0.44,7,29,22,92
49,r_15_102_133,seq113,r_69_136_134,r_15_102_133,0.6,2,135,133,92
23,r_124_42_119,seq44,seq88,r_124_42_119,0.56,0,119,119,92
12,r_107_21_81,r_147_51_188,seq99,r_107_21_81,0.99,4,85,81,92
41,r_93_144_45,r_49_43_168,seq115,r_93_144_45,1.0,0,45,45,93
25,r_61_33_35,r_39_130_198,r_126_78_146,r_61_33_35,0.88,8,43,35,93
5,r_128_127_199,r_131_19_56,seq23,r_131_19_56,1.0,0,56,56,93
53,seq6,r_69_81_139,r_31_60_16,r_69_81_139,0.75,2,141,139,93
43,r_9_62_12,r_129_17_111,r_28_80_90,r_9_62_12,1.0,100,112,12,93
99,seq123,r_27_100_41,r_113_145_93,r_113_145_93,1.0,3,96,93,93
54,seq135,r_95_90_132,r_96_54_184,r_95_90_132,0.65,0,132,132,93
15,r_106_83_39,r_59_79_131,seq42,r_106_83_39,1.0,5,44,39,93
31,r_139_122_14,r_49_43_168,seq50,r_139_122_14,0.88,1,15,14,93
38,r_31_60_16,r_28_80_90,r_69_81_139,r_31_60_16,0.82,0,16,16,93
21,r_107_70_63,r_65_73_166,seq105,r_107_70_63,1.0,0,63,63,93
39,r_39_130_198,r_61_33_35,r_125_68_169,r_125_68_169,0.44,2,171,169,93
1,r_116_132_19,r_49_43_168,r_113_145_93,r_113_145_93,1.0,75,168,93,93
97,seq120,r_2_7_114,seq16,r_2_7_114,1.0,-11,103,114,93
7,r_69_81_139,r_31_60_16,r_134_4_34,r_69_81_139,0.98,0,139,139,93
24,r_126_78_146,r_61_33_35,r_29_46_20,r_126_78_146,0.73,7,153,146,93
19,r_113_145_93,seq38,seq123,r_113_145_93,0.99,0,93,93,93
11,r_134_4_34,seq51,r_69_81_139,r_134_4_34,0.77,105,139,34,93
36,r_67_22_53,r_113_145_93,r_28_80_90,r_67_22_53,0.89,40,93,53,93
1,r_116_132_19,seq16,r_49_43_168,r_116_132_19,1.0,0,19,19,93
38,r_31_60_16,r_69_81_139,seq6,r_69_81_139,1.0,2,141,139,93
3,r_129_17_111,r_9_62_12,seq52,r_129_17_111,0.92,1,112,111,93
11,r_134_4_34,r_77_45_106,r_58_34_66,r_134_4_34,1.0,0,34,34,93
26,r_12_18_159,seq89,r_59_79_131,r_12_18_159,0.89,0,159,159,93
8,r_59_79_131,r_69_81_139,seq16,r_69_81_139,0.92,-25,114,139,93
18,r_37_124_49,seq11,r_96_54_184,r_37_124_49,1.0,0,49,49,93
4,r_102_0_176,r_96_54_184,r_101_57_85,r_101_57_85,1.0,93,178,85,93
0,r_77_45_106,r_65_73_166,seq140,r_77_45_106,1.0,0,106,106,93
99,seq123,r_49_43_168,r_27_100_41,r_27_100_41,1.0,9,50,41,93
20,r_2_7_114,seq120,seq89,r_2_7_114,0.98,-1,113,114,93
13,r_125_68_169,seq50,r_39_130_198,r_39_130_198,0.68,-31,167,198,93
7,r_69_81_139,seq6,r_31_60_16,r_31_60_16,0.93,10,26,16,93
48,r_41_97_128,seq15,r_101_57_85,r_101_57_85,1.0,54,139,85,93
6,r_58_34_66,r_134_4_34,seq8,r_58_34_66,1.0,0,66,66,93
2,r_49_43_168,r_116_132_19,r_2_7_114,r_2_7_114,1.0,54,168,114,93
94,seq115,r_126_78_146,r_93_144_45,r_93_144_45,1.0,0,45,45,93
6,r_58_34_66,seq10,r_134_4_34,r_134_4_34,0.85,-4,30,34,93
8,r_59_79_131,r_106_83_39,r_69_81_139,r_106_83_39,1.0,2,41,39,93
9,r_27_100_41,r_109_44_162,seq123,r_27_100_41,1.0,1,42,41,93
87,seq89,r_12_18_159,r_2_7_114,r_2_7_114,0.57,45,159,114,93
47,r_95_90_132,seq135,seq52,r_95_90_132,0.56,0,132,132,93
40,r_32_110_91,r_28_80_90,seq6,r_32_110_91,1.0,1,92,91,93
45,r_14_76_38,r_65_73_166,seq13,r_14_76_38,1.0,1,39,38,93
33,r_28_80_90,r_32_110_91,r_67_22_53,r_28_80_90,1.0,0,90,90,93
88,seq91,seq74,r_101_57_85,r_101_57_85,1.0,3,88,85,93
32,r_63_99_167,seq66,r_113_145_93,r_113_145_93,0.98,74,167,93,93
34,r_141_84_92,seq112,seq50,r_141_84_92,1.0,1,93,92,93
49,r_29_46_20,r_65_73_166,seq112,r_29_46_20,0.99,1,21,20,93
36,r_67_22_53,r_58_34_66,r_113_145_93,r_113_145_93,0.73,-40,53,93,93
17,r_104_86_123,r_41_97_128,r_28_80_90,r_104_86_123,0.94,2,125,123,93
25,r_61_33_35,r_126_78_146,r_146_72_1,r_126_78_146,0.96,0,146,146,93
22,r_101_57_85,r_102_0_176,seq91,r_101_57_85,1.0,0,85,85,93
28,r_75_26_174,seq92,r_59_79_131,r_75_26_174,0.51,0,174,174,93
91,seq105,r_111_5_181,r_107_70_63,r_107_70_63,1.0,22,85,63,93
37,r_85_25_31,seq23,seq66,r_85_25_31,1.0,0,31,31,93
44,r_136_98_73,seq120,seq48,r_136_98_73,1.0,2,75,73,93
11,r_134_4_34,r_58_34_66,r_126_78_146,r_134_4_34,0.51,45,79,34,93
23,r_30_121_65,r_69_81_139,seq56,r_30_121_65,1.0,0,65,65,93
82,seq66,r_65_73_166,r_85_25_31,r_85_25_31,1.0,94,125,31,93
46,r_131_19_56,r_128_127_199,r_85_25_31,r_131_19_56,0.96,0,56,56,93
35,r_119_47_155,r_65_73_166,r_109_44_162,r_119_47_155,0.38,0,155,155,93
12,r_21_87_161,seq149,seq10,r_21_87_161,0.82,0,161,161,93
24,r_126_78_146,seq138,r_61_33_35,r_126_78_146,0.72,-101,45,146,93
2,r_49_43_168,r_93_144_45,r_116_132_19,r_49_43_168,0.59,-123,45,168,93
33,r_92_68_48,r_108_25_163,r_148_113_126,r_92_68_48,0.88,3,51,48,94
36,r_45_19_159,r_74_125_184,r_30_101_125,r_74_125_184,0.99,-25,159,184,94
9,r_22_91_123,r_21_55_17,r_46_47_45,r_22_91_123,0.87,0,123,123,94
5,r_46_47_45,seq6,r_4_17_21,r_46_47_45,1.0,0,45,45,94
14,r_89_12_137,seq122,r_14_137_10,r_89_12_137,0.97,0,137,137,94
8,r_117_96_179,seq44,r_126_71_171,r_117_96_179,0.4,1,180,179,94
16,r_132_54_103,r_30_101_125,r_28_124_79,r_30_101_125,1.0,-22,103,125,94
21,r_84_39_92,r_117_96_179,seq51,r_84_39_92,1.0,0,92,92,94
39,r_14_137_10,r_108_25_163,r_89_12_137,r_14_137_10,0.41,153,163,10,94
1,r_29_129_172,r_119_11_182,seq81,r_119_11_182,0.34,2,184,182,94
46,r_30_101_125,seq2,seq31,r_30_101_125,0.73,5,130,125,94
42,r_74_125_184,seq72,r_138_85_88,r_138_85_88,0.99,96,184,88,94
45,r_139_142_93,seq58,r_21_55_17,r_139_142_93,1.0,0,93,93,94
9,r_22_91_123,r_140_87_52,r_21_55_17,r_22_91_123,0.47,-71,52,123,94
24,r_148_113_126,r_92_68_48,r_67_41_76,r_148_113_126,0.91,0,126,126,94
19,r_138_85_88,r_89_12_137,r_92_68_48,r_138_85_88,0.95,1,89,88,94
43,r_70_63_41,seq135,r_7_9_40,r_7_9_40,1.0,1,41,40,94
33,r_92_68_48,r_148_113_126,r_138_85_88,r_92_68_48,0.76,78,126,48,94
2,r_4_17_21,r_88_116_35,seq136,r_4_17_21,1.0,0,21,21,94
41,r_10_103_152,r_74_125_184,seq64,r_10_103_152,0.9,1,153,152,94
10,r_126_71_171,seq73,r_117_96_179,r_126_71_171,0.69,1,172,171,94
4,r_7_9_40,r_132_54_103,r_70_63_41,r_7_9_40,1.0,1,41,40,94
0,r_119_11_182,r_29_129_172,seq2,r_29_129_172,0.39,12,184,172,94
63,seq31,seq43,r_30_101_125,r_30_101_125,0.86,5,130,125,94
73,seq57,seq24,r_0_18_59,r_0_18_59,1.0,15,74,59,94
11,r_42_62_138,r_45_19_159,seq149,r_42_62_138,0.87,0,138,138,94
20,r_100_143_117,seq121,r_67_41_76,r_100_143_117,0.99,0,117,117,94
13,r_90_5_100,seq121,seq72,r_90_5_100,0.99,0,100,100,94
25,r_88_116_35,r_45_19_159,r_60_82_57,r_60_82_57,0.99,2,59,57,94
53,seq6,r_46_47_45,seq115,r_46_47_45,1.0,0,45,45,94
15,r_23_111_151,seq112,seq36,r_23_111_151,0.76,2,153,151,94
48,r_99_34_90,seq130,r_109_83_9,r_99_34_90,0.99,0,90,90,94
6,r_107_123_136,seq127,seq8,r_107_123_136,0.66,4,140,136,94
2,r_4_17_21,seq136,seq77,r_4_17_21,0.38,136,157,21,94
99,seq127,r_107_123_136,r_7_9_40,r_7_9_40,1.0,100,140,40,94
5,r_46_47_45,r_4_17_21,r_22_91_123,r_22_91_123,0.8,1,124,123,94
3,r_60_82_57,r_90_5_100,r_88_116_35,r_88_116_35,0.55,22,57,35,94
35,r_147_50_34,r_89_12_137,seq72,r_147_50_34,1.0,0,34,34,94
18,r_21_55_17,r_26_78_42,r_22_91_123,r_22_91_123,0.91,-106,17,123,94
40,r_28_124_79,r_32_128_156,seq51,r_28_124_79,0.99,0,79,79,94
29,r_94_102_197,r_67_41_76,seq81,r_67_41_76,1.0,1,77,76,94
37,r_53_3_37,seq120,r_92_68_48,r_53_3_37,1.0,1,38,37,94
32,r_27_114_143,seq35,r_138_85_88,r_27_114_143,0.9,0,143,143,94
38,r_48_106_77,seq77,seq127,r_48_106_77,0.99,2,79,77,94
44,r_140_87_52,r_22_91_123,seq120,r_140_87_52,0.84,0,52,52,94
24,r_148_113_126,r_119_11_182,r_92_68_48,r_92_68_48,0.97,-14,34,48,94
94,seq112,r_23_111_151,r_109_83_9,r_23_111_151,0.73,2,153,151,94
31,r_0_18_59,r_94_102_197,seq57,r_0_18_59,0.89,0,59,59,94
30,r_37_13_24,seq58,seq72,r_37_13_24,0.71,1,25,24,94
17,r_109_83_9,r_117_96_179,seq73,r_109_83_9,0.73,4,13,9,94
37,r_53_3_37,r_92_68_48,seq115,r_53_3_37,0.21,88,125,37,94
28,r_118_95_121,seq149,seq93,r_118_95_121,0.99,1,122,121,94
49,r_67_41_76,r_94_102_197,r_42_62_138,r_67_41_76,0.67,1,77,76,94
27,r_26_78_42,seq31,r_21_55_17,r_26_78_42,0.96,0,42,42,94
7,r_61_79_86,seq64,seq58,r_61_79_86,1.0,0,86,86,94
18,r_21_55_17,r_22_91_123,r_139_142_93,r_139_142_93,0.97,30,123,93,94
74,seq58,r_37_13_24,r_139_142_93,r_37_13_24,0.86,1,25,24,94
12,r_108_25_163,seq1,seq77,r_108_25_163,0.68,0,163,163,94
49,r_67_41_76,r_42_62_138,r_148_113_126,r_42_62_138,1.0,-11,127,138,94
18,r_134_144_20,r_77_119_134,seq65,r_134_144_20,0.58,0,20,20,95
36,r_48_126_146,r_141_86_170,r_23_112_31,r_141_86_170,0.71,-12,158,170,95
14,r_76_90_65,seq85,r_94_40_75,r_94_40_75,0.96,5,80,75,95
14,r_76_90_65,r_62_54_101,seq85,r_76_90_65,0.74,0,65,65,95
8,r_43_91_125,r_44_55_191,r_36_16_10,r_43_91_125,0.99,2,127,125,95
71,seq50,r_87_80_163,r_76_90_65,r_76_90_65,0.98,99,164,65,95
16,r_35_104_69,seq39,seq9,r_35_104_69,1.0,0,69,69,95
21,r_113_8_137,seq49,seq51,r_113_8_137,0.82,0,137,137,95
5,r_131_82_153,r_60_11_102,r_45_26_74,r_131_82_153,0.76,1,154,153,95
46,r_5_143_127,seq106,r_110_135_124,r_5_143_127,0.93,0,127,127,95
42,r_56_41_3,r_27_3_168,r_77_119_134,r_77_119_134,0.99,35,169,134,95
45,r_69_129_161,seq59,seq2,r_69_129_161,0.51,0,161,161,95
19,r_133_149_67,r_7_102_78,seq25,r_133_149_67,0.49,10,77,67,95
63,seq30,r_88_53_44,seq108,r_88_53_44,0.97,2,46,44,95
31,r_62_54_101,r_76_90_65,r_140_22_39,r_62_54_101,0.98,-36,65,101,95
6,r_23_112_31,r_96_15_148,r_60_11_102,r_23_112_31,0.83,0,31,31,95
81,seq78,r_134_144_20,r_88_53_44,r_88_53_44,1.0,5,49,44,95
26,r_0_101_108,seq111,seq28,r_0_101_108,0.92,2,110,108,95
72,seq51,r_47_1_116,seq109,r_47_1_116,0.71,4,120,116,95
35,r_63_118_16,seq146,seq108,r_63_118_16,0.87,1,17,16,95
88,seq106,r_88_53_44,r_87_80_163,r_87_80_163,0.98,2,165,163,95
4,r_71_74_80,seq2,r_132_99_2,r_71_74_80,0.99,6,86,80,95
0,r_132_99_2,r_62_54_101,r_71_74_80,r_132_99_2,0.59,77,79,2,95
72,seq51,seq109,r_113_8_137,r_113_8_137,0.57,-1,136,137,95
13,r_110_135_124,seq31,r_7_102_78,r_110_135_124,0.7,1,125,124,95
29,r_97_145_26,r_76_90_65,seq108,r_97_145_26,0.99,0,26,26,95
32,r_98_70_15,seq109,seq148,r_98_70_15,1.0,3,18,15,95
15,r_67_73_132,seq124,r_93_136_52,r_93_136_52,0.51,90,142,52,95
48,r_141_86_170,seq105,r_130_46_38,r_141_86_170,0.62,1,171,170,95
27,r_68_115_50,seq18,seq14,r_68_115_50,0.53,6,56,50,95
9,r_52_116_59,seq148,seq9,r_52_116_59,1.0,0,59,59,95
3,r_128_29_13,r_110_135_124,r_100_66_6,r_128_29_13,0.66,3,16,13,95
38,r_61_34_43,r_0_101_108,seq105,r_61_34_43,0.99,1,44,43,95
87,seq105,r_141_86_170,r_61_34_43,r_61_34_43,0.58,128,171,43,95
2,r_77_119_134,seq38,r_56_41_3,r_77_119_134,0.85,0,134,134,95
47,r_96_15_148,seq137,r_98_70_15,r_96_15_148,0.58,1,149,148,95
40,r_12_114_182,seq72,r_87_80_163,r_87_80_163,0.72,19,182,163,95
24,r_44_55_191,r_43_91_125,r_97_145_26,r_44_55_191,0.92,-64,127,191,95
25,r_45_26_74,r_130_46_38,seq124,r_45_26_74,0.97,0,74,74,95
43,r_88_53_44,seq30,seq78,r_88_53_44,1.0,0,44,44,95
31,r_62_54_101,r_140_22_39,r_100_66_6,r_62_54_101,0.93,3,104,101,95
70,seq49,r_113_8_137,r_130_46_38,r_113_8_137,0.98,0,137,137,95
52,seq9,r_103_138_171,r_52_116_59,r_52_116_59,1.0,17,76,59,95
34,r_87_80_163,seq50,seq106,r_87_80_163,0.86,1,164,163,95
17,r_21_57_114,seq79,r_88_53_44,r_88_53_44,1.0,71,115,44,95
56,seq14,seq59,r_68_115_50,r_68_115_50,0.65,-2,48,50,95
28,r_7_102_78,r_96_15_148,r_110_135_124,r_7_102_78,0.94,59,137,78,95
28,r_7_102_78,r_133_149_67,r_96_15_148,r_7_102_78,0.88,-5,73,78,95
91,seq109,seq51,r_113_8_137,r_113_8_137,0.97,1,138,137,95
49,r_32_127_68,r_103_138_171,r_98_70_15,r_32_127_68,1.0,1,69,68,95
41,r_4_117_28,r_27_3_168,r_130_46_38,r_4_117_28,1.0,1,29,28,95
7,r_93_136_52,seq14,r_67_73_132,r_93_136_52,1.0,32,84,52,95
44,r_47_1_116,seq51,r_52_116_59,r_47_1_116,1.0,1,117,116,95
82,seq79,r_21_57_114,r_36_16_10,r_21_57_114,0.5,-26,88,114,95
12,r_92_17_120,seq65,r_130_46_38,r_92_17_120,1.0,1,121,120,95
23,r_140_22_39,r_21_57_114,r_62_54_101,r_140_22_39,1.0,0,39,39,95
23,r_140_22_39,r_62_54_101,r_132_99_2,r_62_54_101,1.0,3,104,101,95
20,r_10_144_41,r_48_83_37,seq100,r_10_144_41,0.95,0,41,41,96
14,r_47_114_64,seq80,seq143,r_47_114_64,1.0,0,64,64,96
8,r_107_109_136,seq54,r_46_13_97,r_107_109_136,0.98,1,137,136,96
43,r_123_31_161,r_50_102_171,r_5_52_127,r_5_52_127,1.0,34,161,127,96
38,r_66_6_25,r_71_53_99,seq135,r_66_6_25,0.99,0,25,25,96
71,seq59,r_94_30_119,r_96_65_137,r_94_30_119,0.99,0,119,119,96
21,r_46_13_97,seq42,r_127_138_55,r_46_13_97,0.85,2,99,97,96
42,r_40_39_179,seq95,r_94_30_119,r_94_30_119,0.88,61,180,119,96
45,r_96_65_137,seq92,seq59,r_96_65_137,0.39,1,138,137,96
19,r_133_88_108,r_20_3_74,r_111_136_92,r_133_88_108,0.56,-35,73,108,96
30,r_71_53_99,r_66_6_25,r_4_56_13,r_71_53_99,0.95,-72,27,99,96
27,r_146_120_12,r_137_1_85,seq37,r_137_1_85,1.0,0,85,85,96
38,r_66_6_25,seq135,r_98_131_98,r_98_131_98,1.0,19,117,98,96
46,r_137_1_85,r_148_11_20,r_146_120_12,r_137_1_85,0.94,-65,20,85,96
69,seq57,r_90_25_177,r_41_93_34,r_41_93_34,1.0,13,47,34,96
31,r_126_2_167,seq80,r_111_136_92,r_126_2_167,0.53,0,167,167,96
29,r_81_132_6,seq34,r_127_138_55,r_127_138_55,1.0,1,56,55,96
41,r_0_85_181,seq92,seq73,r_0_85_181,0.34,0,181,181,96
19,r_133_88_108,r_111_136_92,seq43,r_133_88_108,0.88,0,108,108,96
28,r_41_93_34,r_116_15_18,seq57,r_41_93_34,1.0,0,34,34,96
44,r_147_27_56,r_18_68_160,seq42,r_147_27_56,0.63,1,57,56,96
10,r_103_134_69,seq139,r_16_86_50,r_103_134_69,0.99,0,69,69,96
90,seq105,seq110,r_18_68_160,r_18_68_160,0.95,16,176,160,96
28,r_41_93_34,r_71_53_99,r_116_15_18,r_116_15_18,0.54,2,20,18,96
26,r_32_125_164,seq117,seq54,r_32_125_164,0.57,2,166,164,96
3,r_48_83_37,r_103_134_69,r_133_88_108,r_133_88_108,0.47,-3,105,108,96
4,r_121_76_65,seq21,r_47_114_64,r_121_76_65,1.0,0,65,65,96
63,seq38,r_18_68_160,r_101_145_197,r_18_68_160,0.99,0,160,160,96
21,r_46_13_97,r_127_138_55,r_107_109_136,r_107_109_136,0.82,3,139,136,96
13,r_87_72_141,seq97,seq69,r_87_72_141,0.6,7,148,141,96
46,r_137_1_85,r_146_120_12,r_148_11_20,r_137_1_85,1.0,0,85,85,96
48,r_104_9_117,seq55,r_128_62_1,r_104_9_117,0.98,1,118,117,96
47,r_16_86_50,seq78,seq70,r_16_86_50,0.49,0,50,50,96
62,seq37,r_17_113_66,r_146_120_12,r_17_113_66,0.82,3,69,66,96
27,r_146_120_12,seq82,r_137_1_85,r_146_120_12,0.98,1,13,12,96
85,seq92,r_96_65_137,r_23_91_82,r_23_91_82,1.0,56,138,82,96
15,r_4_56_13,seq118,seq95,r_4_56_13,1.0,0,13,13,96
5,r_148_11_20,r_87_72_141,r_137_1_85,r_137_1_85,0.99,19,104,85,96
0,r_116_15_18,r_44_12_123,r_4_56_13,r_116_15_18,1.0,0,18,18,96
30,r_71_53_99,r_4_56_13,seq110,r_71_53_99,1.0,-2,97,99,96
2,r_98_131_98,seq36,r_66_6_25,r_98_131_98,0.99,-2,96,98,96
3,r_48_83_37,r_106_24_172,r_103_134_69,r_48_83_37,0.55,38,75,37,96
18,r_5_52_127,seq42,seq75,r_5_52_127,1.0,0,127,127,96
24,r_51_8_101,seq28,r_17_113_66,r_17_113_66,1.0,41,107,66,96
25,r_90_25_177,seq69,r_94_30_119,r_94_30_119,0.84,58,177,119,96
33,r_20_3_74,r_133_88_108,seq80,r_20_3_74,1.0,0,74,74,96
64,seq42,r_46_13_97,r_147_27_56,r_46_13_97,0.94,0,97,97,96
32,r_35_129_146,r_126_2_167,r_5_52_127,r_126_2_167,0.98,-21,146,167,96
52,seq139,r_103_134_69,seq28,r_103_134_69,1.0,5,74,69,96
34,r_106_24_172,r_96_65_137,r_44_12_123,r_44_12_123,0.95,8,131,123,96
34,r_106_24_172,r_44_12_123,r_5_52_127,r_106_24_172,0.53,-13,159,172,96
75,seq70,r_0_85_181,r_103_134_69,r_103_134_69,0.62,1,70,69,96
17,r_64_130_158,r_128_62_1,seq34,r_64_130_158,0.81,0,158,158,96
9,r_94_30_119,seq59,r_147_27_56,r_94_30_119,0.98,0,119,119,96
47,r_16_86_50,seq70,r_61_84_77,r_61_84_77,1.0,1,78,77,96
22,r_79_19_107,seq42,seq7,r_79_19_107,1.0,0,107,107,96
36,r_141_33_43,seq77,seq69,r_141_33_43,1.0,0,43,43,96
49,r_61_84_77,seq142,r_16_86_50,r_61_84_77,0.89,1,78,77,96
72,seq63,r_23_91_82,seq42,r_23_91_82,1.0,-33,49,82,96
56,seq21,r_121_76_65,seq78,r_121_76_65,1.0,2,67,65,96
7,r_111_136_92,r_87_72_141,r_126_2_167,r_111_136_92,0.54,78,170,92,96
16,r_127_138_55,r_0_85_181,r_81_132_6,r_127_138_55,1.0,1,56,55,96
23,r_23_91_82,seq63,seq92,r_23_91_82,1.0,0,82,82,96
3,r_48_83_37,r_10_144_41,r_106_24_172,r_48_83_37,0.92,0,37,37,96
5,r_148_11_20,r_137_1_85,r_87_72_141,r_148_11_20,0.6,4,24,20,96
35,r_44_12_123,r_128_62_1,r_106_24_172,r_44_12_123,0.98,0,123,123,96
12,r_18_68_160,seq38,seq105,r_18_68_160,0.59,2,162,160,96
93,seq103,r_117_105_117,r_127_134_75,r_127_134_75,1.0,2,77,75,97
14,r_80_44_91,seq22,seq33,r_80_44_91,1.0,1,92,91,97
8,r_90_112_129,seq144,r_21_93_48,r_90_112_129,0.82,0,129,129,97
53,seq5,seq129,r_31_113_85,r_31_113_85,1.0,44,129,85,97
43,r_76_131_3,seq109,seq6,r_76_131_3,0.46,113,116,3,97
71,seq43,r_54_41_73,r_14_133_25,r_54_41_73,0.71,-5,68,73,97
1,r_30_137_135,seq56,r_35_46_55,r_30_137_135,0.85,0,135,135,97
46,r_110_57_106,r_89_10_165,r_69_108_26,r_110_57_106,0.61,2,108,106,97
42,r_89_10_165,seq100,seq12,r_89_10_165,0.76,0,165,165,97
45,r_61_140_119,r_74_18_138,seq100,r_61_140_119,0.66,5,124,119,97
31,r_101_67_124,seq59,r_110_57_106,r_101_67_124,0.97,7,131,124,97
41,r_47_48_152,seq102,r_66_40_146,r_47_48_152,0.65,2,154,152,97
3,r_37_51_180,seq71,r_53_119_18,r_37_51_180,0.72,0,180,180,97
10,r_117_105_117,seq103,seq102,r_117_105_117,0.84,0,117,117,97
17,r_23_132_114,r_89_10_165,seq71,r_23_132_114,1.0,0,114,114,97
26,r_85_95_88,r_23_132_114,r_127_134_75,r_85_95_88,1.0,0,88,88,97
23,r_72_94_34,r_146_20_143,seq83,r_72_94_34,0.99,0,34,34,97
78,seq64,r_147_88_70,r_69_108_26,r_69_108_26,0.74,39,65,26,97
85,seq83,r_11_75_123,r_72_94_34,r_72_94_34,1.0,15,49,34,97
0,r_147_88_70,seq64,seq84,r_147_88_70,0.71,-5,65,70,97
73,seq56,r_30_137_135,r_116_50_90,r_116_50_90,0.53,19,109,90,97
48,r_69_108_26,r_130_1_155,seq64,r_69_108_26,0.92,0,26,26,97
13,r_146_20_143,r_27_15_69,seq78,r_146_20_143,0.93,0,143,143,97
15,r_31_113_85,r_73_65_197,seq5,r_31_113_85,1.0,0,85,85,97
6,r_145_25_166,seq24,r_27_15_69,r_145_25_166,0.74,0,166,166,97
27,r_116_50_90,seq92,seq56,r_116_50_90,1.0,0,90,90,97
2,r_115_70_95,seq3,seq122,r_115_70_95,0.96,0,95,95,97
81,seq78,seq139,r_146_20_143,r_146_20_143,0.79,19,162,143,97
47,r_35_46_55,r_45_121_145,r_7_58_196,r_35_46_55,0.87,-2,53,55,97
74,seq59,r_101_67_124,r_53_119_18,r_101_67_124,0.69,-2,122,124,97
29,r_66_40_146,seq144,seq139,r_66_40_146,0.86,0,146,146,97
24,r_130_1_155,seq139,r_54_41_73,r_130_1_155,0.71,1,156,155,97
19,r_96_26_10,seq129,seq22,r_96_26_10,1.0,0,10,10,97
20,r_2_91_37,r_73_65_197,seq109,r_2_91_37,0.98,1,38,37,97
32,r_141_104_148,seq77,seq83,r_141_104_148,0.68,1,149,148,97
38,r_86_13_107,r_53_119_18,seq83,r_86_13_107,0.88,0,107,107,97
34,r_128_55_65,r_101_67_124,seq129,r_128_55_65,1.0,0,65,65,97
33,r_111_52_22,r_61_140_119,r_96_26_10,r_96_26_10,0.91,14,24,10,97
5,r_53_119_18,r_11_75_123,seq92,r_53_119_18,1.0,0,18,18,97
28,r_68_28_50,r_47_48_152,r_27_15_69,r_68_28_50,1.0,0,50,50,97
81,seq78,r_23_132_114,seq139,r_23_132_114,0.83,0,114,114,97
30,r_21_93_48,seq78,seq77,r_21_93_48,1.0,0,48,48,97
17,r_23_132_114,r_85_95_88,r_89_10_165,r_85_95_88,0.57,-17,71,88,97
11,r_14_133_25,seq148,r_73_65_197,r_14_133_25,0.9,-1,24,25,97
22,r_54_41_73,seq43,seq77,r_54_41_73,0.96,-1,72,73,97
49,r_74_18_138,r_61_140_119,r_54_41_73,r_74_18_138,0.86,-3,135,138,97
44,r_39_16_92,seq122,seq149,r_39_16_92,0.98,0,92,92,97
40,r_73_65_197,r_54_41_73,r_14_133_25,r_73_65_197,0.9,-170,27,197,97
79,seq71,r_45_121_145,r_23_132_114,r_23_132_114,1.0,21,135,114,97
30,r_54_138_66,r_111_38_177,r_125_96_35,r_54_138_66,0.97,2,68,66,98
23,r_88_112_121,r_70_45_54,r_100_118_89,r_88_112_121,0.95,0,121,121,98
23,r_88_112_121,r_105_86_20,seq30,r_88_112_121,0.77,-93,28,121,98
8,r_83_139_148,r_90_78_192,r_134_143_55,r_83_139_148,0.79,0,148,148,98
43,r_111_38_177,r_54_138_66,r_97_115_46,r_111_38_177,0.99,-110,67,177,98
37,r_77_130_99,seq4,r_90_78_192,r_77_130_99,0.89,-2,97,99,98
72,seq135,r_125_96_35,r_36_89_6,r_125_96_35,0.59,0,35,35,98
16,r_120_141_72,seq80,seq135,r_120_141_72,0.99,0,72,72,98
1,r_97_115_46,r_111_38_177,r_107_62_132,r_107_62_132,1.0,48,180,132,98
53,seq6,r_8_27_80,r_56_25_136,r_8_27_80,0.72,-61,19,80,98
46,r_12_0_169,r_8_27_80,r_54_138_66,r_12_0_169,0.99,-100,69,169,98
42,r_16_2_135,seq136,r_107_62_132,r_107_62_132,0.65,3,135,132,98
49,r_134_143_55,seq14,r_129_33_76,r_134_143_55,0.93,1,56,55,98
45,r_92_29_51,r_51_21_157,seq4,r_92_29_51,0.99,0,51,51,98
24,r_70_45_54,r_88_112_121,r_129_33_76,r_70_45_54,0.94,67,121,54,98
19,r_9_5_103,seq30,seq60,r_9_5_103,0.56,6,109,103,98
31,r_67_116_175,r_100_118_89,r_8_27_80,r_8_27_80,0.63,3,83,80,98
41,r_39_43_71,seq59,r_134_143_55,r_39_43_71,1.0,0,71,71,98
3,r_95_35_58,seq133,r_15_119_24,r_15_119_24,0.9,71,95,24,98
10,r_20_19_183,seq142,r_67_116_175,r_67_116_175,0.56,8,183,175,98
26,r_129_33_76,r_8_27_80,r_70_45_54,r_70_45_54,0.65,21,75,54,98
0,r_106_85_137,seq46,r_77_130_99,r_106_85_137,0.67,1,138,137,98
14,r_125_96_35,r_8_27_80,r_54_138_66,r_125_96_35,0.96,34,69,35,98
11,r_108_3_179,r_111_38_177,r_132_63_142,r_132_63_142,1.0,38,180,142,98
13,r_90_78_192,r_83_139_148,r_77_130_99,r_90_78_192,0.57,-73,119,192,98
46,r_12_0_169,r_54_138_66,seq147,r_12_0_169,0.55,4,173,169,98
15,r_107_62_132,seq124,seq41,r_107_62_132,1.0,1,133,132,98
36,r_82_140_53,r_95_35_58,seq135,r_82_140_53,1.0,1,54,53,98
2,r_8_27_80,r_67_116_175,r_105_86_20,r_67_116_175,0.86,5,180,175,98
53,seq6,r_56_25_136,r_50_66_112,r_50_66_112,0.74,1,113,112,98
87,seq142,r_20_19_183,r_110_24_32,r_110_24_32,0.58,151,183,32,98
35,r_123_94_69,r_97_115_46,seq76,r_123_94_69,0.52,42,111,69,98
1,r_97_115_46,r_61_40_77,r_111_38_177,r_111_38_177,0.51,-128,49,177,98
2,r_8_27_80,r_50_66_112,r_67_116_175,r_8_27_80,1.0,0,80,80,98
47,r_73_52_129,seq136,r_70_45_54,r_73_52_129,0.83,1,130,129,98
40,r_37_18_73,seq124,r_92_29_51,r_37_18_73,1.0,1,74,73,98
74,seq46,r_106_85_137,seq81,r_106_85_137,0.87,1,138,137,98
18,r_93_68_160,r_20_19_183,r_134_143_55,r_134_143_55,0.66,105,160,55,98
29,r_113_91_127,seq13,r_70_45_54,r_70_45_54,1.0,86,140,54,98
43,r_111_38_177,r_97_115_46,seq1,r_111_38_177,0.39,3,180,177,98
33,r_145_131_62,seq137,seq53,r_145_131_62,1.0,3,65,62,98
50,seq1,r_101_75_159,seq31,r_101_75_159,0.93,6,165,159,98
49,r_134_143_55,r_129_33_76,r_39_43_71,r_134_143_55,0.92,23,78,55,98
32,r_61_40_77,seq26,seq133,r_61_40_77,1.0,1,78,77,98
38,r_32_57_110,seq81,r_77_130_99,r_32_57_110,0.96,0,110,110,98
52,seq133,r_95_35_58,r_61_40_77,r_61_40_77,1.0,18,95,77,98
77,seq53,r_51_21_157,r_145_131_62,r_145_131_62,1.0,38,100,62,98
17,r_110_24_32,r_145_131_62,seq49,r_110_24_32,1.0,2,34,32,98
20,r_105_86_20,r_88_112_121,seq117,r_105_86_20,0.8,7,27,20,98
4,r_148_71_38,r_101_75_159,seq137,r_148_71_38,0.98,0,38,38,98
60,seq14,seq109,r_84_114_75,r_84_114_75,1.0,14,89,75,98
91,seq102,r_70_45_54,r_36_89_6,r_70_45_54,0.99,-26,28,54,98
9,r_132_63_142,seq124,r_8_27_80,r_132_63_142,0.79,0,142,142,98
24,r_70_45_54,r_39_43_71,r_88_112_121,r_70_45_54,0.98,0,54,54,98
31,r_67_116_175,r_8_27_80,r_106_85_137,r_8_27_80,0.47,97,177,80,98
9,r_132_63_142,r_8_27_80,r_108_3_179,r_132_63_142,0.74,34,176,142,98
22,r_100_118_89,r_23_64_49,r_88_112_121,r_100_118_89,0.54,18,107,89,98
23,r_88_112_121,seq30,r_70_45_54,r_88_112_121,0.67,-62,59,121,98
14,r_125_96_35,seq135,r_8_27_80,r_125_96_35,0.95,0,35,35,98
56,seq137,seq121,r_56_25_136,r_56_25_136,0.76,2,138,136,98
44,r_34_128_165,r_50_66_112,r_148_71_38,r_148_71_38,0.95,103,141,38,98
35,r_123_94_69,r_67_116_175,r_97_115_46,r_97_115_46,0.99,32,78,46,98
12,r_84_114_75,seq44,seq14,r_84_114_75,0.98,1,76,75,98
48,r_55_72_48,r_95_35_58,seq22,r_55_72_48,0.99,3,51,48,98
16,r_105_49_27,seq3,seq20,r_105_49_27,1.0,0,27,27,99
17,r_1_41_147,r_36_118_39,seq100,r_36_118_39,1.0,-10,29,39,99
14,r_51_5_74,seq102,seq7,r_51_5_74,0.82,-1,73,74,99
8,r_56_48_198,r_50_135_160,r_82_17_70,r_82_17_70,0.93,91,161,70,99
53,seq133,r_37_22_86,seq43,r_37_22_86,1.0,0,86,86,99
43,r_72_149_79,seq67,r_139_109_31,r_72_149_79,0.96,3,82,79,99
5,r_16_94_45,r_122_9_53,r_31_146_11,r_31_146_11,0.91,5,16,11,99
13,r_31_146_11,r_82_17_70,r_16_94_45,r_31_146_11,0.96,1,12,11,99
21,r_141_13_138,seq44,r_51_5_74,r_141_13_138,0.78,1,139,138,99
1,r_45_21_85,r_141_13_138,seq10,r_45_21_85,0.99,0,85,85,99
46,r_42_11_117,seq7,r_139_109_31,r_139_109_31,0.42,86,117,31,99
61,seq20,seq24,r_105_49_27,r_105_49_27,1.0,0,27,27,99
41,r_129_0_14,r_82_17_70,seq33,r_129_0_14,0.42,0,14,14,99
7,r_103_40_151,seq130,r_58_61_195,r_103_40_151,0.86,1,152,151,99
31,r_66_78_120,r_88_92_158,r_85_121_25,r_85_121_25,1.0,4,29,25,99
19,r_28_76_89,seq39,seq43,r_28_76_89,0.99,0,89,89,99
13,r_31_146_11,r_16_94_45,seq130,r_16_94_45,0.97,0,45,45,99
11,r_127_80_26,seq29,seq67,r_127_80_26,0.56,1,27,26,99
3,r_50_135_160,r_56_48_198,r_79_107_96,r_56_48_198,0.77,-37,161,198,99
10,r_73_116_155,seq143,r_16_94_45,r_16_94_45,0.6,110,155,45,99
4,r_82_17_70,r_148_125_7,seq84,r_82_17_70,0.96,3,73,70,99
0,r_62_57_152,r_129_0_14,r_66_78_120,r_62_57_152,0.45,0,152,152,99
15,r_79_107_96,seq84,seq111,r_79_107_96,0.91,1,97,96,99
48,r_88_92_158,r_66_78_120,r_71_30_84,r_88_92_158,0.68,0,158,158,99
6,r_114_99_113,r_68_77_170,r_105_49_27,r_114_99_113,0.66,0,113,113,99
24,r_34_128_35,r_28_76_89,seq75,r_34_128_35,0.8,0,35,35,99
99,seq147,seq67,r_86_59_133,r_86_59_133,0.76,1,134,133,99
27,r_68_77_170,r_114_99_113,r_71_30_84,r_68_77_170,0.76,-56,114,170,99
58,seq130,r_122_9_53,r_31_146_11,r_122_9_53,0.64,0,53,53,99
13,r_31_146_11,seq130,r_55_4_145,r_55_4_145,1.0,0,145,145,99
2,r_86_59_133,r_55_4_145,seq147,r_86_59_133,0.84,3,136,133,99
22,r_108_97_59,r_145_140_40,seq70,r_145_140_40,0.92,1,41,40,99
29,r_144_124_17,r_139_109_31,seq67,r_144_124_17,0.56,0,17,17,99
25,r_54_115_127,r_86_59_133,r_18_119_43,r_54_115_127,0.86,0,127,127,99
68,seq32,r_142_19_136,r_122_9_53,r_122_9_53,1.0,87,140,53,99
32,r_126_120_165,seq102,seq138,r_126_120_165,0.52,5,170,165,99
77,seq67,seq25,r_37_22_86,r_37_22_86,1.0,10,96,86,99
34,r_71_30_84,seq26,r_129_0_14,r_71_30_84,0.93,2,86,84,99
12,r_122_9_53,seq130,seq104,r_122_9_53,1.0,0,53,53,99
27,r_68_77_170,r_71_30_84,r_82_17_70,r_68_77_170,0.54,0,170,170,99
81,seq81,r_12_87_185,r_16_94_45,r_16_94_45,1.0,61,106,45,99
47,r_85_121_25,r_137_117_182,r_66_78_120,r_85_121_25,1.0,0,25,25,99
9,r_37_22_86,seq133,seq67,r_37_22_86,1.0,0,86,86,99
42,r_36_118_39,r_1_41_147,seq81,r_36_118_39,1.0,0,39,39,99
37,r_139_109_31,seq133,seq26,r_139_109_31,1.0,0,31,31,99
49,r_142_19_136,seq32,r_89_63_3,r_142_19_136,0.74,4,140,136,99
7,r_103_40_151,r_15_46_83,seq130,r_15_46_83,0.98,0,83,83,99
44,r_15_46_83,r_103_40_151,r_16_94_45,r_15_46_83,0.96,0,83,83,99
23,r_55_4_145,seq75,r_31_146_11,r_55_4_145,0.5,0,145,145,99
17,r_1_41_147,seq100,seq39,r_1_41_147,0.74,0,147,147,99
38,r_145_140_40,r_108_97_59,r_8_64_16,r_145_140_40,0.99,1,41,40,99
5,r_16_94_45,r_31_146_11,seq81,r_16_94_45,1.0,0,45,45,99
