30,r_79_131_114,seq142,seq62,r_79_131_114,0.84,0,114,114,0
51,seq1,seq15,r_132_68_111,r_132_68_111,1.0,15,126,111,0
36,r_8_47_141,seq71,r_83_109_106,r_8_47_141,0.78,1,142,141,0
77,seq60,seq1,r_37_136_23,r_37_136_23,0.78,-5,18,23,0
14,r_89_93_103,r_59_66_152,r_19_145_31,r_89_93_103,0.99,1,104,103,0
8,r_147_110_93,seq49,seq52,r_147_110_93,0.99,0,93,93,0
43,r_65_76_97,seq118,seq142,r_65_76_97,1.0,0,97,97,0
31,r_37_136_23,seq44,r_108_33_65,r_108_33_65,0.6,-47,18,65,0
54,seq12,r_127_53_163,seq17,r_127_53_163,1.0,1,164,163,0
86,seq95,r_59_66_152,r_129_7_18,r_129_7_18,0.89,137,155,18,0
16,r_67_41_86,r_127_53_163,seq22,r_67_41_86,0.96,0,86,86,0
21,r_34_21_61,r_147_110_93,r_75_43_41,r_34_21_61,1.0,0,61,61,0
1,r_85_111_99,r_140_88_119,r_54_146_24,r_54_146_24,1.0,77,101,24,0
46,r_84_69_64,seq16,r_25_134_27,r_84_69_64,0.47,17,81,64,0
45,r_138_106_72,seq23,seq49,r_138_106_72,1.0,-1,71,72,0
12,r_137_107_35,seq124,seq16,r_137_107_35,1.0,0,35,35,0
48,r_86_64_174,r_58_11_98,r_19_145_31,r_86_64_174,1.0,-135,39,174,0
41,r_2_72_75,r_65_76_97,seq71,r_2_72_75,0.86,0,75,75,0
67,seq35,r_9_10_87,seq23,r_9_10_87,1.0,0,87,87,0
10,r_108_33_65,seq40,r_37_136_23,r_108_33_65,0.69,2,67,65,0
47,r_129_7_18,r_127_53_163,seq95,r_129_7_18,1.0,0,18,18,0
26,r_9_10_87,seq35,r_133_46_57,r_9_10_87,1.0,0,87,87,0
18,r_54_146_24,r_67_41_86,seq49,r_54_146_24,1.0,0,24,24,0
4,r_77_117_116,r_144_81_192,seq24,r_77_117_116,1.0,3,119,116,0
0,r_99_90_11,r_9_10_87,seq115,r_99_90_11,0.88,1,12,11,0
20,r_113_87_139,seq120,r_132_68_111,r_113_87_139,0.91,1,140,139,0
15,r_140_88_119,seq115,r_83_109_106,r_83_109_106,1.0,15,121,106,0
40,r_38_128_36,seq135,r_148_30_63,r_148_30_63,1.0,3,66,63,0
40,r_38_128_36,seq45,seq135,r_38_128_36,0.97,0,36,36,0
34,r_133_46_57,r_122_125_195,r_9_10_87,r_9_10_87,1.0,-2,85,87,0
57,seq15,r_42_29_153,r_85_111_99,r_42_29_153,0.8,0,153,153,0
6,r_127_53_163,seq12,r_34_21_61,r_127_53_163,0.84,1,164,163,0
62,seq149,r_148_30_63,seq97,r_148_30_63,1.0,0,63,63,0
99,seq126,seq135,r_38_128_36,r_38_128_36,1.0,30,66,36,0
5,r_19_145_31,r_86_64_174,r_89_93_103,r_89_93_103,1.0,73,176,103,0
34,r_133_46_57,seq135,r_122_125_195,r_133_46_57,0.91,-7,50,57,0
2,r_80_28_127,seq56,r_99_90_11,r_80_28_127,0.74,0,127,127,0
74,seq51,seq149,r_132_68_111,r_132_68_111,0.99,28,139,111,0
33,r_132_68_111,seq56,seq1,r_132_68_111,1.0,0,111,111,0
48,r_86_64_174,r_19_145_31,seq0,r_86_64_174,0.84,1,175,174,0
64,seq23,r_138_106_72,seq35,r_138_106_72,1.0,-1,71,72,0
11,r_103_114_16,r_74_143_189,seq71,r_103_114_16,0.99,0,16,16,0
58,seq16,r_84_69_64,r_137_107_35,r_137_107_35,1.0,41,76,35,0
61,seq20,r_127_53_163,seq104,r_127_53_163,1.0,-46,117,163,0
60,seq18,r_58_11_98,r_79_131_114,r_58_11_98,1.0,2,100,98,0
94,seq115,r_65_76_97,r_99_90_11,r_65_76_97,0.97,0,97,97,0
22,r_119_141_28,r_127_53_163,seq120,r_119_141_28,1.0,0,28,28,0
9,r_83_109_106,seq52,r_116_57_53,r_83_109_106,1.0,0,106,106,0
29,r_130_14_39,r_148_30_63,seq142,r_130_14_39,1.0,0,39,39,0
62,seq149,seq97,r_132_68_111,r_132_68_111,0.99,36,147,111,0
28,r_42_29_153,seq15,seq35,r_42_29_153,0.64,0,153,153,0
49,r_59_66_152,seq95,r_99_90_11,r_99_90_11,0.96,147,158,11,0
56,seq142,r_79_131_114,r_65_76_97,r_65_76_97,1.0,17,114,97,0
7,r_58_11_98,seq18,r_99_90_11,r_58_11_98,0.99,1,99,98,0
18,r_54_146_24,seq49,r_85_111_99,r_85_111_99,0.62,21,120,99,0
44,r_148_30_63,seq149,r_38_128_36,r_148_30_63,1.0,0,63,63,0
5,r_19_145_31,seq135,r_86_64_174,r_19_145_31,1.0,0,31,31,0
23,r_100_36_172,r_139_92_196,r_3_39_2,r_100_36_172,0.83,0,172,172,0
27,r_75_43_41,r_85_111_99,seq27,r_75_43_41,1.0,0,41,41,0
13,r_26_55_58,r_132_68_111,r_103_114_16,r_26_55_58,1.0,1,59,58,0
93,seq111,seq14,r_140_147_124,r_140_147_124,1.0,5,129,124,1
30,r_37_79_176,seq132,r_118_98_22,r_37_79_176,0.5,0,176,176,1
36,r_99_68_149,seq138,seq58,r_99_68_149,0.88,0,149,149,1
43,r_124_48_97,seq5,seq122,r_124_48_97,1.0,0,97,97,1
81,seq73,seq66,r_19_1_103,r_19_1_103,1.0,45,148,103,1
37,r_24_100_108,seq104,seq23,r_24_100_108,0.57,3,111,108,1
42,r_109_101_29,seq111,r_11_57_158,r_109_101_29,1.0,1,30,29,1
21,r_74_130_159,seq133,r_40_72_127,r_74_130_159,0.8,0,159,159,1
39,r_120_46_189,seq66,r_9_71_148,r_9_71_148,1.0,0,148,148,1
1,r_11_57_158,r_109_101_29,r_13_55_10,r_11_57_158,0.71,0,158,158,1
97,seq121,r_140_147_124,r_117_0_107,r_117_0_107,0.56,17,124,107,1
46,r_36_148_119,seq23,r_123_127_2,r_36_148_119,1.0,0,119,119,1
1,r_11_57_158,seq17,r_109_101_29,r_109_101_29,1.0,10,39,29,1
45,r_107_59_114,seq66,r_67_15_44,r_107_59_114,0.54,34,148,114,1
8,r_108_29_58,r_124_48_97,seq84,r_124_48_97,0.57,-38,59,97,1
66,seq38,r_22_16_109,seq113,r_22_16_109,1.0,-18,91,109,1
31,r_96_3_94,seq88,seq34,r_96_3_94,0.98,0,94,94,1
58,seq20,r_134_102_8,r_65_128_188,r_134_102_8,0.8,16,24,8,1
14,r_86_56_55,seq34,seq84,r_86_56_55,0.97,1,56,55,1
15,r_49_129_51,r_125_27_146,r_144_4_7,r_49_129_51,1.0,0,51,51,1
3,r_125_27_146,r_99_68_149,seq34,r_125_27_146,0.95,0,146,146,1
10,r_6_97_180,seq94,seq35,r_6_97_180,0.51,0,180,180,1
40,r_137_106_17,r_125_27_146,seq94,r_137_106_17,0.98,0,17,17,1
4,r_117_0_107,seq81,seq121,r_117_0_107,0.99,0,107,107,1
0,r_12_8_68,r_139_10_143,seq66,r_139_10_143,0.99,-70,73,143,1
63,seq133,r_74_130_159,r_123_127_2,r_74_130_159,0.65,0,159,159,1
20,r_62_41_76,seq23,r_144_4_7,r_62_41_76,1.0,7,83,76,1
27,r_9_71_148,seq54,r_120_46_189,r_9_71_148,0.91,0,148,148,1
87,seq87,r_95_26_101,seq115,r_95_26_101,0.79,17,118,101,1
2,r_19_1_103,r_6_97_180,seq132,r_19_1_103,0.94,0,103,103,1
24,r_110_77_134,r_65_128_188,seq64,r_110_77_134,0.89,0,134,134,1
25,r_40_72_127,r_107_59_114,seq115,r_40_72_127,0.9,0,127,127,1
19,r_126_105_49,r_145_7_194,seq14,r_126_105_49,0.81,7,56,49,1
34,r_65_128_188,seq20,r_45_92_42,r_65_128_188,0.63,-17,171,188,1
42,r_109_101_29,r_11_57_158,seq64,r_11_57_158,0.78,0,158,158,1
38,r_51_119_85,seq69,seq47,r_51_119_85,1.0,0,85,85,1
34,r_65_128_188,r_110_77_134,seq20,r_110_77_134,0.99,0,134,134,1
60,seq23,r_62_41_76,r_24_100_108,r_62_41_76,0.98,11,87,76,1
17,r_18_141_84,r_112_93_12,r_53_103_39,r_18_141_84,0.99,2,86,84,1
94,seq113,r_6_97_180,r_137_106_17,r_137_106_17,0.67,147,164,17,1
9,r_83_114_153,r_145_7_194,r_123_127_2,r_83_114_153,0.87,0,153,153,1
16,r_13_55_10,seq44,seq146,r_13_55_10,0.98,1,11,10,1
22,r_112_93_12,r_18_141_84,seq63,r_18_141_84,1.0,0,84,84,1
28,r_143_52_174,seq111,r_108_29_58,r_108_29_58,0.59,126,184,58,1
91,seq94,r_6_97_180,r_137_106_17,r_137_106_17,0.7,163,180,17,1
49,r_95_26_101,seq87,r_45_92_42,r_95_26_101,0.49,2,103,101,1
7,r_140_147_124,seq121,seq111,r_140_147_124,0.99,0,124,124,1
23,r_91_78_183,seq82,r_110_77_134,r_110_77_134,0.83,52,186,134,1
41,r_135_75_40,seq122,seq115,r_135_75_40,1.0,0,40,40,1
35,r_139_10_143,seq146,r_45_92_42,r_139_10_143,0.95,0,143,143,1
12,r_22_16_109,seq38,seq115,r_22_16_109,0.95,0,109,109,1
33,r_118_98_22,r_65_128_188,seq138,r_118_98_22,1.0,0,22,22,1
5,r_53_103_39,r_74_130_159,seq138,r_53_103_39,1.0,0,39,39,1
30,r_93_120_74,r_136_31_150,r_35_4_75,r_136_31_150,1.0,-75,75,150,2
36,r_33_50_138,r_36_6_2,seq134,r_33_50_138,0.96,0,138,138,2
37,r_0_42_114,seq9,r_130_105_28,r_0_42_114,0.99,0,114,114,2
71,seq135,r_110_61_121,r_130_105_28,r_110_61_121,0.82,-11,110,121,2
26,r_37_107_21,r_79_24_58,seq3,r_79_24_58,0.92,-42,16,58,2
21,r_142_98_19,r_136_31_150,r_131_129_149,r_142_98_19,0.95,131,150,19,2
97,seq121,r_62_29_130,r_68_26_93,r_68_26_93,1.0,66,159,93,2
5,r_69_51_157,seq77,r_100_148_37,r_100_148_37,1.0,125,162,37,2
42,r_95_88_131,r_1_11_120,r_138_85_98,r_95_88_131,1.0,0,131,131,2
45,r_114_59_177,r_124_53_154,seq144,r_124_53_154,0.65,1,155,154,2
39,r_67_22_54,seq132,r_146_28_10,r_67_22_54,1.0,0,54,54,2
41,r_81_117_182,seq83,r_34_106_125,r_34_106_125,0.62,57,182,125,2
3,r_1_11_120,r_95_88_131,r_41_5_115,r_95_88_131,1.0,0,131,131,2
10,r_47_71_31,r_111_23_174,r_110_61_121,r_110_61_121,0.99,53,174,121,2
72,seq46,seq30,r_79_24_58,r_79_24_58,1.0,6,64,58,2
0,r_110_61_121,seq135,seq102,r_110_61_121,0.98,0,121,121,2
73,seq48,r_122_96_142,r_73_49_46,r_73_49_46,0.73,97,143,46,2
11,r_118_113_68,r_68_26_93,r_73_49_46,r_118_113_68,1.0,2,70,68,2
20,r_138_85_98,seq3,r_147_13_13,r_138_85_98,0.93,7,105,98,2
13,r_70_78_103,r_109_125_51,r_41_5_115,r_109_125_51,0.85,25,76,51,2
8,r_12_97_52,r_1_11_120,seq83,r_12_97_52,1.0,0,52,52,2
15,r_40_15_136,r_124_53_154,r_109_125_51,r_40_15_136,0.94,2,138,136,2
48,r_58_89_141,seq140,seq90,r_58_89_141,0.93,0,141,141,2
35,r_39_25_16,r_142_98_19,seq63,r_39_25_16,1.0,0,16,16,2
6,r_130_105_28,r_56_44_198,seq2,r_130_105_28,0.97,0,28,28,2
45,r_114_59_177,seq144,seq121,r_114_59_177,0.94,1,178,177,2
47,r_17_94_147,r_142_98_19,r_122_96_142,r_17_94_147,0.85,0,147,147,2
40,r_109_125_51,r_70_78_103,seq74,r_70_78_103,1.0,-32,71,103,2
29,r_124_53_154,r_114_59_177,seq143,r_124_53_154,0.56,1,155,154,2
24,r_68_26_93,seq102,r_62_29_130,r_68_26_93,1.0,1,94,93,2
34,r_79_24_58,seq145,seq46,r_79_24_58,1.0,0,58,58,2
44,r_43_54_42,r_52_86_128,seq74,r_43_54_42,1.0,-1,41,42,2
25,r_122_96_142,seq48,r_17_94_147,r_122_96_142,0.93,6,148,142,2
68,seq30,seq21,r_12_97_52,r_12_97_52,1.0,58,110,52,2
32,r_80_128_178,r_52_86_128,seq99,r_52_86_128,1.0,0,128,128,2
38,r_131_129_149,seq101,seq19,r_131_129_149,0.95,0,149,149,2
63,seq145,r_37_107_21,r_146_28_10,r_146_28_10,0.74,2,12,10,2
22,r_62_29_130,seq121,r_123_141_189,r_62_29_130,0.25,-2,128,130,2
28,r_35_4_75,r_81_117_182,r_93_120_74,r_81_117_182,0.99,-107,75,182,2
91,seq102,r_68_26_93,seq87,r_68_26_93,0.98,1,94,93,2
49,r_36_6_2,r_33_50_138,seq116,r_33_50_138,1.0,-1,137,138,2
33,r_146_28_10,r_136_31_150,seq145,r_146_28_10,0.97,0,10,10,2
7,r_52_86_128,r_80_128_178,r_47_71_31,r_52_86_128,0.99,0,128,128,2
13,r_70_78_103,r_41_5_115,r_146_28_10,r_70_78_103,1.0,1,104,103,2
23,r_136_31_150,r_142_98_19,r_130_105_28,r_136_31_150,0.92,0,150,150,2
32,r_80_128_178,seq99,r_122_96_142,r_80_128_178,0.98,1,179,178,2
12,r_149_16_79,seq65,seq21,r_149_16_79,1.0,0,79,79,2
46,r_73_49_46,r_149_16_79,seq48,r_73_49_46,1.0,0,46,46,2
84,seq83,r_81_117_182,r_12_97_52,r_12_97_52,1.0,130,182,52,2
40,r_18_146_60,r_59_103_120,seq17,r_18_146_60,0.9,-2,58,60,3
93,seq109,seq44,r_65_144_46,r_65_144_46,1.0,10,56,46,3
36,r_98_122_143,seq93,seq35,r_98_122_143,0.96,1,144,143,3
14,r_21_114_135,r_54_141_189,r_107_73_38,r_21_114_135,0.71,0,135,135,3
83,seq82,r_55_5_152,r_75_4_100,r_75_4_100,0.96,54,154,100,3
37,r_136_12_199,r_80_20_142,r_64_130_160,r_80_20_142,0.5,1,143,142,3
1,r_7_118_64,r_22_90_136,r_53_147_61,r_7_118_64,0.99,0,64,64,3
39,r_148_32_16,r_105_1_18,seq116,r_105_1_18,0.73,0,18,18,3
46,r_52_23_126,seq47,r_31_79_74,r_52_23_126,0.72,6,132,126,3
42,r_48_145_178,r_33_0_102,seq81,r_33_0_102,0.72,0,102,102,3
45,r_9_97_115,seq134,seq66,r_9_97_115,0.91,0,115,115,3
76,seq62,r_53_147_61,seq112,r_53_147_61,0.99,0,61,61,3
31,r_53_147_61,seq17,r_7_118_64,r_7_118_64,0.76,-1,63,64,3
41,r_70_120_71,seq104,seq35,r_70_120_71,1.0,1,72,71,3
85,seq87,seq47,r_92_2_42,r_92_2_42,1.0,4,46,42,3
3,r_14_25_59,r_58_138_146,seq116,r_14_25_59,0.99,1,60,59,3
10,r_15_83_147,seq134,seq66,r_15_83_147,0.65,0,147,147,3
20,r_61_27_40,r_68_110_110,seq89,r_68_110_110,0.78,-63,47,110,3
26,r_33_0_102,r_48_145_178,r_65_144_46,r_33_0_102,0.99,0,102,102,3
4,r_68_110_110,seq63,seq49,r_68_110_110,1.0,0,110,110,3
0,r_129_91_73,r_68_110_110,seq112,r_68_110_110,0.78,-28,82,110,3
11,r_56_46_99,r_75_4_100,r_76_57_76,r_75_4_100,1.0,1,101,100,3
13,r_26_19_80,seq30,seq111,r_26_19_80,0.95,-7,73,80,3
15,r_101_28_185,r_22_90_136,seq143,r_22_90_136,0.89,1,137,136,3
48,r_31_79_74,seq104,r_52_23_126,r_52_23_126,0.87,3,129,126,3
16,r_65_144_46,r_125_84_62,seq109,r_65_144_46,1.0,1,47,46,3
6,r_80_20_142,r_136_12_199,r_131_127_92,r_80_20_142,0.59,1,143,142,3
97,seq116,r_148_32_16,r_14_25_59,r_14_25_59,1.0,1,60,59,3
99,seq121,seq81,r_107_73_38,r_107_73_38,0.79,89,127,38,3
27,r_125_84_62,r_37_126_127,seq137,r_125_84_62,1.0,5,67,62,3
87,seq93,r_98_122_143,r_76_57_76,r_76_57_76,0.58,68,144,76,3
97,seq116,r_18_146_60,r_148_32_16,r_148_32_16,0.64,0,16,16,3
2,r_75_4_100,r_56_46_99,seq42,r_75_4_100,0.87,1,101,100,3
47,r_37_126_127,seq35,r_106_139_183,r_37_126_127,0.97,0,127,127,3
39,r_148_32_16,seq116,r_88_72_75,r_88_72_75,1.0,-2,73,75,3
18,r_113_100_95,r_131_127_92,r_67_3_84,r_113_100_95,0.99,0,95,95,3
29,r_69_10_138,r_106_139_183,seq86,r_69_10_138,0.68,2,140,138,3
24,r_123_6_98,seq62,r_106_139_183,r_123_6_98,0.77,3,101,98,3
25,r_54_141_189,r_21_114_135,seq115,r_21_114_135,0.8,0,135,135,3
33,r_76_57_76,r_75_4_100,seq93,r_76_57_76,0.96,0,76,76,3
17,r_105_1_18,r_54_141_189,r_31_79_74,r_105_1_18,0.83,0,18,18,3
82,seq81,r_136_12_199,r_58_138_146,r_136_12_199,0.49,-53,146,199,3
44,r_142_85_25,r_33_0_102,seq133,r_142_85_25,0.99,1,26,25,3
42,r_48_145_178,seq81,seq29,r_48_145_178,0.56,1,179,178,3
61,seq29,seq40,r_48_145_178,r_48_145_178,0.83,0,178,178,3
32,r_67_3_84,seq96,r_105_1_18,r_67_3_84,1.0,3,87,84,3
52,seq134,r_15_83_147,seq140,r_15_83_147,0.65,0,147,147,3
34,r_59_103_120,seq35,r_53_147_61,r_59_103_120,0.89,1,121,120,3
94,seq111,r_106_139_183,r_26_19_80,r_26_19_80,0.95,14,94,80,3
21,r_92_2_42,r_101_28_185,seq87,r_92_2_42,1.0,4,46,42,3
9,r_131_127_92,r_113_100_95,seq143,r_131_127_92,1.0,0,92,92,3
82,seq81,r_33_0_102,r_136_12_199,r_33_0_102,0.66,-63,39,102,3
96,seq115,r_75_4_100,r_51_11_33,r_75_4_100,0.79,-27,73,100,3
22,r_88_72_75,seq42,r_148_32_16,r_88_72_75,0.98,0,75,75,3
28,r_64_130_160,seq96,r_136_12_199,r_136_12_199,0.64,-39,160,199,3
49,r_55_5_152,seq82,seq134,r_55_5_152,0.59,2,154,152,3
8,r_107_73_38,seq40,seq96,r_107_73_38,1.0,0,38,38,3
43,r_51_11_33,r_107_73_38,seq115,r_51_11_33,0.55,0,33,33,3
7,r_16_124_145,seq49,seq134,r_16_124_145,0.96,0,145,145,3
23,r_58_138_146,seq89,seq81,r_58_138_146,0.73,1,147,146,3
38,r_119_132_41,seq143,r_107_73_38,r_119_132_41,0.79,0,41,41,3
35,r_22_90_136,r_101_28_185,seq89,r_22_90_136,0.93,1,137,136,3
12,r_94_95_130,seq140,seq40,r_94_95_130,0.99,1,131,130,3
36,r_137_110_124,r_133_30_193,seq19,r_137_110_124,0.93,0,124,124,4
9,r_1_94_30,seq26,r_14_98_110,r_14_98_110,1.0,23,133,110,4
92,seq114,seq78,r_117_106_132,r_117_106_132,0.72,9,141,132,4
8,r_23_142_107,seq68,seq25,r_23_142_107,1.0,1,108,107,4
51,seq2,r_89_29_58,seq47,r_89_29_58,1.0,0,58,58,4
37,r_80_132_90,seq102,r_121_55_92,r_80_132_90,0.99,0,90,90,4
59,seq146,seq141,r_21_38_50,r_21_38_50,1.0,18,68,50,4
21,r_62_100_157,r_77_35_130,r_128_138_147,r_77_35_130,1.0,0,130,130,4
39,r_121_55_92,seq68,r_80_132_90,r_80_132_90,1.0,33,123,90,4
1,r_75_11_35,r_61_50_97,r_99_46_40,r_61_50_97,0.9,0,97,97,4
42,r_69_72_143,seq51,seq129,r_69_72_143,0.68,0,143,143,4
80,seq73,r_22_57_179,r_42_40_142,r_42_40_142,0.99,37,179,142,4
1,r_75_11_35,seq7,r_61_50_97,r_75_11_35,1.0,1,36,35,4
32,r_61_50_97,r_75_11_35,seq8,r_61_50_97,0.58,14,111,97,4
31,r_148_86_29,r_62_100_157,seq33,r_148_86_29,0.94,0,29,29,4
45,r_112_139_103,r_127_28_189,seq26,r_112_139_103,1.0,1,104,103,4
19,r_92_18_182,seq116,r_89_29_58,r_89_29_58,1.0,13,71,58,4
15,r_82_136_41,r_14_98_110,r_10_36_6,r_82_136_41,0.88,0,41,41,4
32,r_61_50_97,seq122,r_75_11_35,r_75_11_35,1.0,0,35,35,4
76,seq64,r_118_76_67,r_49_91_44,r_118_76_67,1.0,0,67,67,4
97,seq124,seq8,r_118_76_67,r_118_76_67,0.57,80,147,67,4
25,r_84_67_18,r_149_37_14,seq102,r_84_67_18,0.74,-4,14,18,4
27,r_144_97_17,seq141,seq39,r_144_97_17,0.92,0,17,17,4
10,r_52_103_11,r_144_97_17,r_117_106_132,r_52_103_11,0.75,2,13,11,4
3,r_71_0_120,seq68,r_144_97_17,r_71_0_120,1.0,0,120,120,4
97,seq124,r_118_76_67,r_31_24_89,r_31_24_89,0.55,87,176,89,4
72,seq51,r_69_72_143,r_144_97_17,r_69_72_143,0.85,3,146,143,4
14,r_34_83_4,r_44_96_149,r_27_58_19,r_34_83_4,0.8,72,76,4,4
78,seq66,r_117_106_132,r_112_139_103,r_112_139_103,0.86,32,135,103,4
63,seq26,r_117_106_132,r_112_139_103,r_112_139_103,0.79,15,118,103,4
11,r_44_96_149,seq143,r_48_131_133,r_44_96_149,0.72,1,150,149,4
6,r_149_37_14,r_84_67_18,r_120_13_10,r_149_37_14,0.62,0,14,14,4
0,r_120_13_10,r_121_55_92,seq59,r_120_13_10,0.98,0,10,10,4
18,r_89_29_58,seq2,r_92_18_182,r_89_29_58,1.0,0,58,58,4
9,r_1_94_30,seq122,seq26,r_1_94_30,0.89,5,35,30,4
17,r_27_58_19,seq43,r_34_83_4,r_27_58_19,1.0,0,19,19,4
47,r_85_87_118,r_134_119_190,seq81,r_85_87_118,0.97,0,118,118,4
40,r_77_35_130,seq147,r_3_5_43,r_77_35_130,0.76,0,130,130,4
29,r_113_15_155,seq8,r_61_50_97,r_61_50_97,0.85,-11,86,97,4
24,r_49_91_44,r_92_18_182,seq116,r_49_91_44,0.61,67,111,44,4
44,r_99_46_40,r_92_18_182,r_75_11_35,r_99_46_40,1.0,0,40,40,4
20,r_21_38_50,seq20,seq146,r_21_38_50,1.0,0,50,50,4
33,r_128_138_147,r_101_104_197,r_71_0_120,r_128_138_147,0.65,0,147,147,4
88,seq105,r_14_98_110,seq116,r_14_98_110,1.0,0,110,110,4
38,r_31_24_89,seq16,seq122,r_31_24_89,0.88,5,94,89,4
34,r_127_28_189,r_112_139_103,r_80_132_90,r_127_28_189,0.93,-85,104,189,4
43,r_145_53_59,r_14_98_110,r_3_5_43,r_14_98_110,0.69,-51,59,110,4
26,r_56_95_34,r_44_96_149,r_10_36_6,r_56_95_34,1.0,0,34,34,4
97,seq124,r_89_29_58,seq8,r_89_29_58,1.0,-2,56,58,4
48,r_9_88_48,r_1_94_30,seq20,r_9_88_48,0.99,-2,46,48,4
16,r_48_131_133,r_62_100_157,r_44_96_149,r_48_131_133,0.6,24,157,133,4
41,r_3_5_43,r_92_18_182,seq16,r_3_5_43,1.0,0,43,43,4
29,r_113_15_155,r_61_50_97,r_1_94_30,r_113_15_155,0.97,0,155,155,4
22,r_42_40_142,r_90_4_150,seq73,r_42_40_142,0.65,0,142,142,4
28,r_22_57_179,seq73,r_101_104_197,r_22_57_179,0.51,0,179,179,4
49,r_118_76_67,seq64,r_84_67_18,r_118_76_67,0.98,0,67,67,4
7,r_14_98_110,seq105,r_1_94_30,r_14_98_110,1.0,0,110,110,4
18,r_89_29_58,r_92_18_182,seq116,r_89_29_58,0.32,125,183,58,4
10,r_52_103_11,r_117_106_132,seq26,r_117_106_132,0.47,-73,59,132,4
23,r_101_104_197,r_128_138_147,r_149_37_14,r_101_104_197,0.79,-110,87,197,4
84,seq147,r_77_35_130,r_48_131_133,r_77_35_130,0.53,2,132,130,4
30,r_69_48_73,seq110,seq84,r_69_48_73,1.0,0,73,73,5
8,r_40_88_169,r_18_100_127,r_25_45_35,r_40_88_169,0.45,-122,47,169,5
36,r_4_99_70,seq139,seq85,r_4_99_70,1.0,0,70,70,5
14,r_68_52_164,r_92_95_188,r_143_80_29,r_143_80_29,0.7,135,164,29,5
81,seq74,r_56_123_102,r_143_80_29,r_56_123_102,1.0,-47,55,102,5
83,seq83,seq149,r_5_3_54,r_5_3_54,1.0,27,81,54,5
37,r_14_38_158,seq9,seq58,r_14_38_158,0.72,0,158,158,5
1,r_2_76_109,seq142,seq104,r_2_76_109,0.87,0,109,109,5
64,seq27,seq37,r_14_38_158,r_14_38_158,0.96,-56,102,158,5
32,r_106_125_7,r_68_52_164,r_8_28_134,r_8_28_134,0.87,11,145,134,5
7,r_8_28_134,seq83,r_106_125_7,r_8_28_134,1.0,0,134,134,5
56,seq140,seq57,r_144_21_30,r_144_21_30,1.0,22,52,30,5
19,r_12_13_113,r_71_72_182,r_2_76_109,r_12_13_113,0.96,0,113,113,5
11,r_143_80_29,seq57,seq74,r_143_80_29,0.64,6,35,29,5
39,r_145_11_25,r_69_48_73,seq0,r_145_11_25,1.0,0,25,25,5
31,r_24_131_89,seq0,r_121_141_108,r_121_141_108,1.0,1,109,108,5
42,r_98_130_64,r_14_38_158,r_30_65_1,r_98_130_64,0.4,-8,56,64,5
8,r_40_88_169,r_25_45_35,seq22,r_25_45_35,0.66,134,169,35,5
72,seq51,r_71_72_182,r_82_39_3,r_71_72_182,0.68,0,182,182,5
38,r_109_44_14,r_67_107_139,seq37,r_109_44_14,1.0,0,14,14,5
34,r_144_21_30,r_64_36_193,seq140,r_144_21_30,1.0,0,30,30,5
99,seq127,r_43_132_195,r_122_20_170,r_122_20_170,0.87,3,173,170,5
20,r_71_72_182,seq51,r_2_76_109,r_71_72_182,0.63,0,182,182,5
48,r_59_87_153,seq74,seq16,r_59_87_153,0.89,0,153,153,5
17,r_49_35_33,r_56_123_102,seq124,r_49_35_33,0.87,0,33,33,5
57,seq142,r_2_76_109,r_55_81_74,r_55_81_74,1.0,35,109,74,5
5,r_50_89_19,r_98_130_64,r_60_129_62,r_60_129_62,0.93,3,65,62,5
62,seq149,r_8_28_134,seq83,r_8_28_134,1.0,-66,68,134,5
10,r_6_103_32,seq63,seq1,r_6_103_32,1.0,1,33,32,5
99,seq127,r_78_86_81,r_43_132_195,r_78_86_81,1.0,2,83,81,5
46,r_47_120_39,r_114_61_93,seq135,r_47_120_39,1.0,0,39,39,5
33,r_101_133_18,seq53,seq37,r_101_133_18,0.97,-1,17,18,5
27,r_121_141_108,r_67_107_139,r_24_131_89,r_121_141_108,0.99,0,108,108,5
2,r_92_95_188,r_68_52_164,r_8_28_134,r_8_28_134,0.9,30,164,134,5
41,r_25_45_35,r_40_88_169,r_55_81_74,r_25_45_35,0.93,99,134,35,5
47,r_67_107_139,seq126,r_2_76_109,r_2_76_109,0.78,17,126,109,5
40,r_122_20_170,r_71_72_182,seq127,r_122_20_170,0.36,1,171,170,5
29,r_93_137_106,r_24_131_89,r_2_76_109,r_93_137_106,1.0,0,106,106,5
24,r_60_129_62,r_146_26_126,r_50_89_19,r_60_129_62,0.99,0,62,62,5
6,r_112_32_41,r_55_81_74,seq90,r_112_32_41,1.0,0,41,41,5
25,r_41_23_131,seq90,seq74,r_41_23_131,0.99,0,131,131,5
43,r_146_26_126,r_143_80_29,r_112_32_41,r_146_26_126,0.99,2,128,126,5
70,seq135,seq46,r_47_120_39,r_47_120_39,1.0,25,64,39,5
68,seq37,seq58,r_109_44_14,r_109_44_14,0.92,86,100,14,5
28,r_5_3_54,r_4_99_70,seq83,r_5_3_54,1.0,0,54,54,5
2,r_92_95_188,r_8_28_134,seq53,r_92_95_188,0.7,0,188,188,5
41,r_25_45_35,r_6_103_32,r_40_88_169,r_6_103_32,0.92,1,33,32,5
3,r_94_113_31,seq42,seq90,r_94_113_31,0.99,0,31,31,5
5,r_50_89_19,seq46,r_98_130_64,r_50_89_19,0.97,-1,18,19,5
75,seq58,seq97,r_14_38_158,r_14_38_158,0.79,1,159,158,5
45,r_114_61_93,r_106_125_7,r_24_131_89,r_114_61_93,1.0,0,93,93,5
22,r_55_81_74,seq27,r_25_45_35,r_55_81_74,1.0,0,74,74,5
51,seq1,r_136_15_178,r_6_103_32,r_6_103_32,1.0,12,44,32,5
49,r_134_54_117,seq57,r_69_48_73,r_69_48_73,0.95,47,120,73,5
24,r_60_129_62,r_50_89_19,r_56_123_102,r_56_123_102,1.0,1,103,102,5
7,r_8_28_134,seq149,seq83,r_8_28_134,0.39,-64,70,134,5
23,r_66_77_61,r_12_13_113,seq58,r_66_77_61,1.0,2,63,61,5
43,r_146_26_126,r_79_91_53,r_143_80_29,r_79_91_53,1.0,-2,51,53,5
35,r_30_65_1,seq9,r_98_130_64,r_98_130_64,1.0,16,80,64,5
14,r_146_21_108,seq45,r_39_16_59,r_39_16_59,1.0,58,117,59,6
8,r_141_75_136,r_43_101_196,r_8_144_11,r_8_144_11,0.99,0,11,11,6
43,r_3_61_44,r_35_126_193,r_130_56_43,r_35_126_193,0.49,-127,66,193,6
37,r_40_134_57,seq113,seq94,r_40_134_57,0.95,5,62,57,6
42,r_82_60_30,r_43_101_196,r_79_112_19,r_82_60_30,0.84,0,30,30,6
21,r_11_26_127,seq99,r_32_109_89,r_11_26_127,0.93,0,127,127,6
39,r_128_115_68,r_142_80_162,r_145_135_29,r_128_115_68,0.63,1,69,68,6
1,r_131_129_166,r_18_71_178,seq0,r_131_129_166,0.47,0,166,166,6
5,r_30_123_79,seq25,seq77,r_30_123_79,1.0,4,83,79,6
9,r_32_109_89,r_63_48_21,r_11_26_127,r_11_26_127,1.0,0,127,127,6
19,r_74_85_62,seq57,seq55,r_74_85_62,1.0,0,62,62,6
34,r_120_62_54,seq133,r_148_102_38,r_120_62_54,1.0,0,54,54,6
49,r_121_114_123,r_39_16_59,r_145_135_29,r_121_114_123,0.91,0,123,123,6
8,r_141_75_136,r_8_144_11,r_97_110_26,r_97_110_26,0.96,130,156,26,6
0,r_6_118_142,seq55,r_66_17_97,r_66_17_97,0.93,-18,79,97,6
11,r_142_80_162,seq137,r_143_54_96,r_143_54_96,0.99,66,162,96,6
20,r_46_111_83,r_141_75_136,r_97_110_26,r_97_110_26,0.97,65,91,26,6
13,r_72_100_3,r_18_71_178,seq122,r_18_71_178,0.71,0,178,178,6
17,r_148_102_38,r_130_56_43,r_120_62_54,r_120_62_54,1.0,18,72,54,6
6,r_143_54_96,r_31_107_138,r_13_124_40,r_13_124_40,0.61,57,97,40,6
16,r_145_135_29,seq77,seq14,r_145_135_29,0.91,5,34,29,6
27,r_97_110_26,seq22,r_39_16_59,r_39_16_59,1.0,7,66,59,6
87,seq94,r_7_42_192,r_40_134_57,r_40_134_57,1.0,9,66,57,6
2,r_53_27_99,r_35_126_193,seq133,r_53_27_99,1.0,0,99,99,6
18,r_66_17_97,seq25,r_6_118_142,r_66_17_97,0.78,7,104,97,6
29,r_31_107_138,seq149,r_63_48_21,r_31_107_138,0.83,1,139,138,6
10,r_33_78_49,seq1,seq57,r_33_78_49,1.0,0,49,49,6
25,r_28_34_164,r_36_24_156,r_93_105_13,r_36_24_156,0.77,5,161,156,6
33,r_36_24_156,r_28_34_164,r_63_48_21,r_36_24_156,0.72,1,157,156,6
17,r_148_102_38,seq122,r_130_56_43,r_148_102_38,0.56,0,38,38,6
3,r_39_16_59,r_11_26_127,r_97_110_26,r_39_16_59,0.99,0,59,59,6
50,seq0,r_119_70_124,r_131_129_166,r_119_70_124,0.67,1,125,124,6
58,seq140,seq22,r_98_96_64,r_98_96_64,1.0,5,69,64,6
68,seq45,r_146_21_108,r_10_138_55,r_10_138_55,1.0,5,60,55,6
48,r_79_112_19,r_39_16_59,r_90_29_158,r_79_112_19,0.96,0,19,19,6
38,r_50_38_180,seq116,r_143_54_96,r_143_54_96,1.0,91,187,96,6
9,r_32_109_89,seq25,r_63_48_21,r_63_48_21,0.58,77,98,21,6
22,r_91_19_172,seq77,r_53_27_99,r_53_27_99,0.97,73,172,99,6
49,r_121_114_123,r_35_126_193,r_39_16_59,r_39_16_59,1.0,32,91,59,6
24,r_130_56_43,r_146_21_108,r_148_102_38,r_130_56_43,0.73,15,58,43,6
7,r_18_71_178,r_131_129_166,r_143_54_96,r_143_54_96,0.63,80,176,96,6
44,r_41_69_151,seq14,seq99,r_41_69_151,0.96,0,151,151,6
41,r_13_124_40,r_41_69_151,seq51,r_13_124_40,0.98,0,40,40,6
48,r_79_112_19,r_90_29_158,r_82_60_30,r_79_112_19,0.81,22,41,19,6
35,r_35_126_193,r_53_27_99,r_146_21_108,r_53_27_99,1.0,0,99,99,6
12,r_58_12_106,seq1,r_8_144_11,r_58_12_106,0.98,1,107,106,6
23,r_8_144_11,r_15_64_88,r_141_75_136,r_8_144_11,0.83,0,11,11,6
23,r_8_144_11,r_141_75_136,r_58_12_106,r_58_12_106,1.0,50,156,106,6
40,r_90_48_190,r_101_41_77,r_38_148_81,r_90_48_190,0.37,0,190,190,7
36,r_56_24_127,seq22,seq13,r_56_24_127,1.0,0,127,127,7
14,r_86_110_75,r_91_121_179,seq95,r_86_110_75,1.0,0,75,75,7
43,r_0_103_90,r_85_93_98,seq136,r_0_103_90,0.96,0,90,90,7
54,seq8,r_101_41_77,seq46,r_101_41_77,1.0,0,77,77,7
3,r_55_75_19,r_73_94_155,r_26_105_172,r_73_94_155,0.46,-58,97,155,7
3,r_55_75_19,r_26_105_172,r_76_124_150,r_26_105_172,0.77,0,172,172,7
5,r_3_45_16,seq16,seq87,r_3_45_16,0.98,0,16,16,7
16,r_102_49_105,seq80,r_21_36_41,r_102_49_105,0.38,53,158,105,7
21,r_58_127_125,seq67,seq133,r_58_127_125,1.0,0,125,125,7
42,r_26_105_172,seq40,seq111,r_26_105_172,0.73,0,172,172,7
15,r_139_65_9,r_141_126_104,r_107_54_22,r_141_126_104,0.86,1,105,104,7
95,seq116,r_99_20_165,seq74,r_99_20_165,0.61,0,165,165,7
31,r_76_124_150,r_92_9_194,seq13,r_76_124_150,0.56,3,153,150,7
41,r_101_41_77,seq8,r_90_48_190,r_101_41_77,1.0,0,77,77,7
23,r_12_27_40,r_58_127_125,seq16,r_58_127_125,0.96,-85,40,125,7
8,r_29_115_185,r_146_53_193,seq13,r_146_53_193,0.61,-85,108,193,7
4,r_23_81_128,seq80,r_85_93_98,r_23_81_128,1.0,0,128,128,7
20,r_32_142_93,seq28,seq61,r_32_142_93,1.0,2,95,93,7
48,r_149_17_147,r_113_6_117,seq8,r_149_17_147,0.96,0,147,147,7
6,r_73_94_155,seq13,r_84_51_119,r_73_94_155,0.77,0,155,155,7
10,r_85_93_98,r_91_121_179,r_23_81_128,r_85_93_98,0.5,44,142,98,7
62,seq18,r_84_51_119,r_101_41_77,r_101_41_77,1.0,43,120,77,7
11,r_21_36_41,seq37,seq80,r_21_36_41,0.55,-20,21,41,7
85,seq80,r_23_81_128,r_21_36_41,r_23_81_128,0.99,-1,127,128,7
19,r_34_47_49,seq1,r_3_45_16,r_34_47_49,0.85,0,49,49,7
8,r_29_115_185,seq52,r_146_53_193,r_29_115_185,0.6,-144,41,185,7
27,r_79_35_152,r_2_145_133,r_84_51_119,r_79_35_152,0.95,-26,126,152,7
87,seq87,seq15,r_3_45_16,r_3_45_16,0.98,82,98,16,7
37,r_112_70_44,r_31_129_196,seq147,r_112_70_44,0.9,0,44,44,7
2,r_134_77_134,seq80,seq46,r_134_77_134,0.76,0,134,134,7
41,r_101_41_77,r_90_48_190,r_5_144_135,r_90_48_190,0.49,0,190,190,7
47,r_146_53_193,r_29_115_185,r_141_126_104,r_141_126_104,1.0,5,109,104,7
40,r_90_48_190,r_84_51_119,r_101_41_77,r_101_41_77,1.0,7,84,77,7
18,r_120_44_66,seq95,seq78,r_120_44_66,1.0,1,67,66,7
24,r_2_145_133,r_79_35_152,r_30_63_17,r_2_145_133,0.95,1,134,133,7
34,r_141_126_104,r_139_65_9,r_119_69_92,r_141_126_104,1.0,1,105,104,7
25,r_84_51_119,seq18,r_79_35_152,r_84_51_119,0.91,0,119,119,7
33,r_7_128_80,r_38_148_81,seq135,r_7_128_80,1.0,0,80,80,7
39,r_117_62_59,seq114,seq60,r_117_62_59,1.0,0,59,59,7
65,seq28,r_130_25_149,seq33,r_130_25_149,0.96,0,149,149,7
61,seq16,r_66_131_124,r_12_27_40,r_66_131_124,0.97,-28,96,124,7
32,r_106_143_74,r_23_81_128,seq89,r_23_81_128,1.0,-48,80,128,7
77,seq60,r_91_121_179,r_99_20_165,r_99_20_165,0.68,14,179,165,7
3,r_55_75_19,r_23_81_128,r_73_94_155,r_55_75_19,0.6,2,21,19,7
26,r_107_54_22,r_120_44_66,r_139_65_9,r_107_54_22,0.88,0,22,22,7
17,r_99_20_165,seq116,r_117_62_59,r_117_62_59,0.52,106,165,59,7
78,seq61,r_84_51_119,r_32_142_93,r_32_142_93,1.0,0,93,93,7
9,r_119_69_92,r_5_144_135,r_146_53_193,r_119_69_92,0.84,0,92,92,7
28,r_43_104_129,seq40,r_84_51_119,r_43_104_129,0.97,0,129,129,7
13,r_30_63_17,r_101_41_77,seq118,r_30_63_17,1.0,0,17,17,7
72,seq136,seq95,r_0_103_90,r_0_103_90,1.0,1,91,90,7
7,r_66_131_124,seq16,seq22,r_66_131_124,0.97,0,124,124,7
9,r_119_69_92,r_146_53_193,r_141_126_104,r_141_126_104,0.86,4,108,104,7
29,r_11_109_36,r_76_124_150,seq60,r_11_109_36,1.0,1,37,36,7
79,seq64,r_83_59_169,seq57,r_83_59_169,0.94,0,169,169,7
35,r_98_4_88,seq39,seq46,r_98_4_88,1.0,0,88,88,7
12,r_130_25_149,seq28,seq125,r_130_25_149,0.99,0,149,149,7
84,seq78,seq40,r_120_44_66,r_120_44_66,1.0,6,72,66,7
30,r_54_47_116,r_141_108_122,r_99_2_175,r_54_47_116,0.61,0,116,116,8
20,r_146_132_32,seq128,r_16_60_35,r_16_60_35,1.0,2,37,35,8
36,r_93_24_92,seq18,r_99_2_175,r_93_24_92,0.81,0,92,92,8
8,r_98_139_162,r_54_47_116,r_6_138_100,r_98_139_162,0.84,-46,116,162,8
43,r_50_5_183,seq144,r_115_77_37,r_50_5_183,0.58,0,183,183,8
74,seq56,r_96_137_152,r_119_12_13,r_119_12_13,1.0,0,13,13,8
37,r_6_138_100,r_96_137_152,r_98_139_162,r_6_138_100,0.74,0,100,100,8
71,seq44,r_102_91_173,r_53_32_98,r_53_32_98,0.72,1,99,98,8
21,r_142_39_171,r_75_95_199,seq107,r_142_39_171,0.54,0,171,171,8
5,r_26_41_69,r_54_47_116,r_75_95_199,r_26_41_69,0.68,5,74,69,8
46,r_14_127_188,seq13,r_119_12_13,r_119_12_13,1.0,175,188,13,8
42,r_100_94_123,seq72,seq38,r_100_94_123,0.9,0,123,123,8
0,r_66_42_169,seq123,r_8_143_108,r_8_143_108,0.99,-10,98,108,8
41,r_7_103_104,seq18,seq34,r_7_103_104,0.5,42,146,104,8
18,r_16_60_35,seq15,r_146_132_32,r_16_60_35,1.0,0,35,35,8
45,r_17_59_146,r_88_149_62,r_98_139_162,r_88_149_62,1.0,0,62,62,8
19,r_134_40_150,r_96_137_152,seq25,r_134_40_150,0.88,0,150,150,8
0,r_66_42_169,r_122_28_47,seq123,r_122_28_47,0.64,3,50,47,8
72,seq46,r_9_51_52,r_80_69_164,r_9_51_52,1.0,-1,51,52,8
31,r_86_81_75,r_7_103_104,r_145_89_51,r_86_81_75,1.0,0,75,75,8
41,r_7_103_104,r_86_81_75,seq15,r_86_81_75,0.96,0,75,75,8
41,r_7_103_104,seq15,seq18,r_7_103_104,0.86,-5,99,104,8
16,r_49_45_28,seq87,r_26_41_69,r_26_41_69,0.84,47,116,69,8
4,r_53_32_98,seq106,seq44,r_53_32_98,1.0,0,98,98,8
11,r_75_95_199,r_142_39_171,r_26_41_69,r_26_41_69,0.92,102,171,69,8
15,r_105_109_147,seq58,seq74,r_105_109_147,0.56,1,148,147,8
57,seq140,seq65,r_141_108_122,r_141_108_122,1.0,-1,121,122,8
6,r_80_69_164,r_62_79_143,r_88_149_62,r_80_69_164,0.56,-21,143,164,8
48,r_9_51_52,seq87,seq131,r_9_51_52,0.99,1,53,52,8
2,r_99_2_175,r_54_47_116,r_116_30_168,r_99_2_175,0.97,1,176,175,8
64,seq23,r_88_149_62,r_98_139_162,r_88_149_62,0.52,-4,58,62,8
49,r_19_11_14,r_14_127_188,seq72,r_19_11_14,1.0,0,14,14,8
27,r_145_89_51,r_102_91_173,seq29,r_145_89_51,0.55,16,67,51,8
30,r_54_47_116,r_99_2_175,seq15,r_99_2_175,0.91,1,176,175,8
36,r_93_24_92,r_99_2_175,seq15,r_99_2_175,0.31,-38,137,175,8
39,r_78_111_55,r_20_148_148,r_119_12_13,r_78_111_55,0.99,1,56,55,8
2,r_99_2_175,r_7_103_104,r_54_47_116,r_99_2_175,0.64,-61,114,175,8
47,r_57_31_137,seq46,seq72,r_57_31_137,0.98,0,137,137,8
0,r_66_42_169,r_8_143_108,r_113_55_166,r_66_42_169,0.49,-7,162,169,8
10,r_35_83_41,seq64,seq106,r_35_83_41,1.0,0,41,41,8
40,r_36_136_117,r_52_43_121,r_98_139_162,r_98_139_162,0.51,-44,118,162,8
14,r_122_28_47,r_66_42_169,seq92,r_122_28_47,0.99,0,47,47,8
29,r_129_4_135,seq0,seq18,r_129_4_135,0.89,1,136,135,8
6,r_80_69_164,r_88_149_62,r_146_132_32,r_80_69_164,0.91,0,164,164,8
48,r_9_51_52,seq131,r_104_71_81,r_104_71_81,1.0,13,94,81,8
25,r_62_79_143,r_80_69_164,r_115_77_37,r_115_77_37,0.87,106,143,37,8
33,r_52_43_121,seq90,seq38,r_52_43_121,1.0,0,121,121,8
88,seq90,r_52_43_121,seq34,r_52_43_121,1.0,0,121,121,8
58,seq13,r_14_127_188,r_68_110_126,r_68_110_126,1.0,62,188,126,8
61,seq18,r_93_24_92,seq90,r_93_24_92,0.85,0,92,92,8
32,r_102_91_173,r_115_77_37,r_113_55_166,r_115_77_37,0.63,136,173,37,8
38,r_104_71_81,r_93_24_92,r_9_51_52,r_104_71_81,1.0,0,81,81,8
80,seq72,r_100_94_123,r_19_11_14,r_19_11_14,0.86,0,14,14,8
34,r_20_148_148,seq92,r_68_110_126,r_20_148_148,0.81,4,152,148,8
64,seq23,r_98_139_162,r_141_108_122,r_141_108_122,0.69,55,177,122,8
75,seq58,r_105_109_147,seq73,r_105_109_147,1.0,1,148,147,8
60,seq144,r_50_5_183,r_99_2_175,r_50_5_183,0.59,0,183,183,8
45,r_17_59_146,r_98_139_162,r_100_94_123,r_100_94_123,0.72,23,146,123,8
24,r_119_12_13,r_121_67_43,seq56,r_119_12_13,1.0,0,13,13,8
17,r_88_149_62,r_17_59_146,r_80_69_164,r_88_149_62,0.98,0,62,62,8
9,r_8_143_108,r_62_79_143,seq123,r_8_143_108,0.9,16,124,108,8
3,r_121_67_43,seq123,seq125,r_121_67_43,0.81,3,46,43,8
59,seq15,r_16_60_35,r_7_103_104,r_16_60_35,1.0,0,35,35,8
16,r_49_45_28,r_121_67_43,seq87,r_49_45_28,0.91,7,35,28,8
22,r_141_108_122,r_54_47_116,seq140,r_141_108_122,0.77,1,123,122,8
28,r_96_137_152,seq37,r_36_136_117,r_96_137_152,0.98,0,152,152,8
61,seq18,seq90,r_129_4_135,r_129_4_135,0.79,15,150,135,8
72,seq46,r_80_69_164,r_26_41_69,r_80_69_164,0.84,0,164,164,8
44,r_116_30_168,seq44,r_26_41_69,r_26_41_69,0.9,99,168,69,8
17,r_88_149_62,r_80_69_164,r_26_41_69,r_80_69_164,1.0,0,164,164,8
82,seq74,r_114_22_170,r_105_109_147,r_105_109_147,1.0,23,170,147,8
35,r_113_55_166,seq87,r_100_94_123,r_100_94_123,0.69,45,168,123,8
12,r_115_77_37,r_102_91_173,r_62_79_143,r_115_77_37,0.51,136,173,37,8
36,r_93_24_92,seq15,r_54_47_116,r_93_24_92,0.36,63,155,92,8
93,seq108,r_133_76_180,r_114_85_84,r_114_85_84,1.0,72,156,84,9
30,r_11_53_152,seq35,r_57_52_124,r_11_53_152,0.96,0,152,152,9
36,r_92_144_95,seq77,r_93_33_20,r_92_144_95,1.0,0,95,95,9
70,seq44,r_146_138_51,r_96_46_97,r_146_138_51,0.76,0,51,51,9
13,r_78_25_25,r_55_95_118,seq101,r_78_25_25,0.89,-1,24,25,9
14,r_100_59_101,r_67_124_175,r_62_39_33,r_100_59_101,0.91,1,102,101,9
8,r_132_128_148,r_47_148_192,seq81,r_132_128_148,0.93,0,148,148,9
53,seq9,seq110,r_65_134_139,r_65_134_139,0.95,1,140,139,9
43,r_48_106_81,seq54,seq72,r_48_106_81,1.0,0,81,81,9
37,r_23_122_17,r_62_39_33,seq116,r_23_122_17,1.0,0,17,17,9
28,r_66_27_104,r_113_14_93,r_98_2_135,r_98_2_135,1.0,1,136,135,9
5,r_41_107_59,seq18,seq88,r_41_107_59,1.0,0,59,59,9
16,r_51_1_88,r_67_124_175,r_123_149_120,r_51_1_88,0.81,4,92,88,9
1,r_113_14_93,seq139,seq54,r_113_14_93,1.0,0,93,93,9
48,r_97_49_132,r_3_119_72,r_147_29_86,r_97_49_132,0.69,-98,34,132,9
45,r_65_134_139,seq135,seq9,r_65_134_139,0.78,1,140,139,9
10,r_93_33_20,seq20,r_98_2_135,r_93_33_20,1.0,0,20,20,9
70,seq44,r_117_64_35,r_69_8_46,r_69_8_46,0.4,116,162,46,9
19,r_30_89_75,r_68_70_23,seq22,r_30_89_75,1.0,0,75,75,9
33,r_115_129_40,r_15_87_187,r_142_0_126,r_142_0_126,0.54,61,187,126,9
40,r_91_37_50,r_68_70_23,r_97_49_132,r_91_37_50,1.0,0,50,50,9
31,r_147_29_86,seq36,seq140,r_147_29_86,0.93,0,86,86,9
3,r_56_83_100,seq86,seq139,r_56_83_100,0.89,0,100,100,9
0,r_142_0_126,seq104,r_147_29_86,r_147_29_86,1.0,41,127,86,9
46,r_62_39_33,r_50_32_112,r_100_59_101,r_62_39_33,0.94,79,112,33,9
15,r_69_8_46,seq73,seq43,r_69_8_46,0.57,16,62,46,9
21,r_98_2_135,r_93_33_20,r_66_27_104,r_98_2_135,1.0,0,135,135,9
85,seq88,r_67_124_175,r_41_107_59,r_41_107_59,1.0,116,175,59,9
10,r_93_33_20,r_98_2_135,r_92_144_95,r_93_33_20,0.98,78,98,20,9
33,r_115_129_40,seq90,r_15_87_187,r_115_129_40,1.0,0,40,40,9
49,r_24_61_85,r_118_126_1,r_31_7_34,r_24_61_85,0.59,-48,37,85,9
49,r_24_61_85,r_31_7_34,seq72,r_24_61_85,0.97,1,86,85,9
2,r_21_94_63,r_74_121_159,r_19_136_6,r_21_94_63,0.91,-1,62,63,9
47,r_141_4_96,seq130,seq10,r_141_4_96,0.91,0,96,96,9
18,r_28_145_80,r_133_76_180,seq88,r_28_145_80,1.0,0,80,80,9
46,r_62_39_33,r_96_46_97,r_50_32_112,r_62_39_33,1.0,0,33,33,9
25,r_74_121_159,seq140,seq82,r_74_121_159,0.64,3,162,159,9
48,r_97_49_132,r_91_37_50,seq139,r_97_49_132,0.62,3,135,132,9
70,seq44,r_96_46_97,r_117_64_35,r_96_46_97,0.48,-25,72,97,9
32,r_3_119_72,seq42,seq45,r_3_119_72,0.86,8,80,72,9
38,r_55_95_118,seq40,r_28_145_80,r_55_95_118,0.99,0,118,118,9
52,seq135,r_65_134_139,r_118_126_1,r_65_134_139,0.86,1,140,139,9
6,r_146_138_51,seq44,seq54,r_146_138_51,1.0,0,51,51,9
16,r_51_1_88,r_123_149_120,seq104,r_51_1_88,0.46,27,115,88,9
17,r_123_149_120,r_15_87_187,r_96_46_97,r_123_149_120,0.83,3,123,120,9
26,r_50_32_112,r_98_2_135,r_62_39_33,r_62_39_33,0.86,0,33,33,9
9,r_57_52_124,seq12,r_100_59_101,r_57_52_124,0.92,0,124,124,9
21,r_98_2_135,r_114_85_84,r_93_33_20,r_93_33_20,0.83,1,21,20,9
48,r_97_49_132,r_147_29_86,r_91_37_50,r_91_37_50,0.65,2,52,50,9
26,r_50_32_112,r_62_39_33,r_69_8_46,r_50_32_112,1.0,-1,111,112,9
7,r_31_7_34,r_55_95_118,seq17,r_31_7_34,0.98,1,35,34,9
22,r_114_85_84,seq72,seq108,r_114_85_84,1.0,0,84,84,9
91,seq104,r_142_0_126,r_51_1_88,r_51_1_88,1.0,39,127,88,9
42,r_117_64_35,seq82,seq135,r_117_64_35,0.99,0,35,35,9
41,r_63_13_52,seq101,r_146_138_51,r_63_13_52,0.9,1,53,52,9
23,r_15_87_187,r_123_149_120,r_115_129_40,r_115_129_40,0.69,83,123,40,9
82,seq82,seq86,r_74_121_159,r_74_121_159,0.79,4,163,159,9
12,r_67_124_175,seq88,r_113_14_93,r_67_124_175,0.58,0,175,175,9
23,r_15_87_187,r_115_129_40,r_56_83_100,r_15_87_187,0.75,0,187,187,9
20,r_143_125_54,r_74_121_159,seq72,r_143_125_54,1.0,0,54,54,9
51,seq131,r_66_69_175,r_68_147_89,r_68_147_89,0.98,86,175,89,10
8,r_110_12_127,r_47_113_165,r_27_97_168,r_110_12_127,0.83,1,128,127,10
43,r_141_105_77,r_27_97_168,r_48_11_37,r_141_105_77,1.0,0,77,77,10
5,r_27_97_168,r_59_42_74,r_110_12_127,r_110_12_127,0.54,-3,124,127,10
37,r_25_139_131,seq63,seq51,r_25_139_131,0.8,0,131,131,10
21,r_89_133_153,r_137_2_183,r_68_147_89,r_137_2_183,0.6,-30,153,183,10
1,r_68_147_89,seq144,seq67,r_68_147_89,1.0,2,91,89,10
5,r_27_97_168,r_141_105_77,r_59_42_74,r_27_97_168,0.58,-84,84,168,10
42,r_79_26_164,seq78,r_68_147_89,r_68_147_89,0.67,75,164,89,10
45,r_106_50_116,r_66_69_175,r_117_85_66,r_106_50_116,0.99,0,116,116,10
19,r_87_58_108,r_33_123_123,r_59_42_74,r_87_58_108,0.52,8,116,108,10
27,r_66_69_175,seq131,r_27_97_168,r_66_69_175,1.0,0,175,175,10
14,r_48_11_37,r_59_42_74,r_76_3_20,r_48_11_37,0.98,0,37,37,10
38,r_101_82_26,r_72_140_135,r_59_42_74,r_72_140_135,0.99,0,135,135,10
39,r_32_7_121,r_19_21_45,seq111,r_32_7_121,1.0,1,122,121,10
31,r_146_112_152,r_47_113_165,r_87_58_108,r_146_112_152,0.23,1,153,152,10
41,r_36_109_145,seq74,seq125,r_36_109_145,0.96,0,145,145,10
38,r_101_82_26,r_86_90_81,r_72_140_135,r_101_82_26,1.0,0,26,26,10
30,r_76_3_20,r_25_139_131,r_88_9_51,r_76_3_20,1.0,0,20,20,10
3,r_75_95_28,seq5,r_91_71_82,r_91_71_82,0.99,-1,81,82,10
10,r_121_34_150,seq39,seq63,r_121_34_150,0.67,0,150,150,10
44,r_119_44_21,seq22,seq74,r_119_44_21,0.99,1,22,21,10
4,r_86_90_81,seq49,seq30,r_86_90_81,0.99,0,81,81,10
0,r_100_56_91,seq30,r_19_21_45,r_100_56_91,0.98,0,91,91,10
11,r_70_107_136,seq49,r_59_42_74,r_70_107_136,1.0,0,136,136,10
50,seq1,r_88_9_51,r_76_3_20,r_88_9_51,0.9,1,52,51,10
20,r_61_24_158,seq83,r_32_7_121,r_32_7_121,1.0,37,158,121,10
30,r_76_3_20,r_88_9_51,r_48_11_37,r_76_3_20,0.78,32,52,20,10
47,r_35_130_29,r_46_102_36,r_47_113_165,r_46_102_36,0.9,-7,29,36,10
6,r_41_77_122,seq78,seq1,r_41_77_122,1.0,0,122,122,10
27,r_66_69_175,r_106_50_116,seq131,r_106_50_116,0.98,0,116,116,10
9,r_88_9_51,seq1,r_76_3_20,r_76_3_20,1.0,0,20,20,10
39,r_32_7_121,seq94,r_19_21_45,r_19_21_45,1.0,11,56,45,10
2,r_129_122_72,seq52,r_10_23_57,r_129_122_72,0.98,2,74,72,10
40,r_33_123_123,seq40,r_43_108_19,r_33_123_123,0.68,0,123,123,10
18,r_124_149_63,seq28,r_70_107_136,r_124_149_63,0.98,1,64,63,10
29,r_127_57_101,seq52,seq145,r_127_57_101,1.0,1,102,101,10
16,r_46_102_36,r_137_2_183,seq136,r_46_102_36,1.0,1,37,36,10
34,r_72_140_135,r_101_82_26,r_15_128_31,r_72_140_135,0.97,0,135,135,10
36,r_10_23_57,r_121_34_150,seq104,r_10_23_57,1.0,0,57,57,10
35,r_117_85_66,r_79_26_164,r_106_50_116,r_117_85_66,0.94,99,165,66,10
25,r_137_2_183,r_142_135_128,seq111,r_142_135_128,1.0,1,129,128,10
64,seq39,r_121_34_150,seq83,r_121_34_150,0.7,5,155,150,10
47,r_35_130_29,r_47_113_165,r_88_9_51,r_35_130_29,0.67,141,170,29,10
65,seq40,r_33_123_123,seq22,r_33_123_123,0.99,3,126,123,10
13,r_43_108_19,r_68_147_89,seq53,r_43_108_19,0.66,1,20,19,10
32,r_59_42_74,r_91_71_82,r_101_82_26,r_59_42_74,0.99,3,77,74,10
25,r_137_2_183,seq111,r_41_77_122,r_137_2_183,0.8,0,183,183,10
18,r_124_149_63,r_70_107_136,r_118_45_93,r_124_149_63,0.77,50,113,63,10
17,r_91_71_82,seq138,r_75_95_28,r_91_71_82,0.63,9,91,82,10
34,r_72_140_135,r_116_114_179,r_101_82_26,r_101_82_26,1.0,5,31,26,10
50,seq1,r_76_3_20,r_41_77_122,r_41_77_122,1.0,-1,121,122,10
24,r_19_21_45,r_46_102_36,r_100_56_91,r_100_56_91,1.0,7,98,91,10
33,r_132_134_25,seq54,seq65,r_132_134_25,0.96,3,28,25,10
46,r_14_29_58,r_68_147_89,r_19_21_45,r_68_147_89,0.89,-30,59,89,10
22,r_47_113_165,r_146_112_152,seq120,r_47_113_165,0.19,-9,156,165,10
28,r_15_128_31,r_46_102_36,seq52,r_15_128_31,1.0,0,31,31,10
49,r_142_135_128,r_137_2_183,seq136,r_142_135_128,0.99,1,129,128,10
23,r_118_45_93,seq138,r_124_149_63,r_118_45_93,0.99,0,93,93,10
9,r_88_9_51,r_76_3_20,seq144,r_88_9_51,1.0,1,52,51,10
35,r_117_85_66,seq1,r_79_26_164,r_117_85_66,0.53,0,66,66,10
12,r_116_114_179,seq62,r_100_56_91,r_116_114_179,0.5,1,180,179,10
24,r_19_21_45,r_110_12_127,r_46_102_36,r_19_21_45,0.77,0,45,45,10
84,seq83,r_61_24_158,seq39,r_61_24_158,0.7,0,158,158,10
30,r_0_6_167,seq48,r_65_53_140,r_65_53_140,0.65,44,184,140,11
36,r_31_64_56,seq111,seq81,r_31_64_56,0.63,12,68,56,11
14,r_117_19_118,r_135_84_156,seq92,r_117_19_118,0.63,0,118,118,11
8,r_98_75_131,r_0_6_167,r_110_43_126,r_98_75_131,0.44,1,132,131,11
56,seq141,r_127_12_46,r_57_35_13,r_127_12_46,0.86,-23,23,46,11
21,r_56_95_2,r_97_54_141,r_72_104_109,r_56_95_2,0.93,139,141,2,11
1,r_16_96_170,r_63_83_33,seq136,r_16_96_170,0.91,1,171,170,11
1,r_16_96_170,seq144,r_63_83_33,r_63_83_33,0.96,51,84,33,11
46,r_67_121_111,seq103,seq122,r_67_121_111,0.58,-11,100,111,11
42,r_139_118_86,seq122,r_138_26_188,r_139_118_86,0.97,0,86,86,11
45,r_33_88_93,r_98_75_131,r_116_108_38,r_33_88_93,0.89,0,93,93,11
24,r_61_93_124,r_138_26_188,r_66_24_169,r_138_26_188,0.53,0,188,188,11
19,r_18_90_193,r_52_130_81,seq136,r_52_130_81,1.0,0,81,81,11
95,seq122,r_139_118_86,r_67_121_111,r_139_118_86,1.0,0,86,86,11
76,seq60,r_98_75_131,r_94_20_78,r_94_20_78,1.0,4,82,78,11
39,r_127_12_46,seq122,r_135_84_156,r_127_12_46,0.38,110,156,46,11
41,r_72_104_109,seq81,r_56_95_2,r_72_104_109,0.94,2,111,109,11
10,r_59_10_5,r_110_43_126,r_143_2_96,r_59_10_5,0.62,123,128,5,11
26,r_73_36_73,r_125_146_91,r_134_68_58,r_134_68_58,0.68,15,73,58,11
72,seq48,r_0_6_167,r_78_109_114,r_78_109_114,1.0,70,184,114,11
17,r_89_113_24,r_102_34_146,seq50,r_89_113_24,0.96,0,24,24,11
11,r_142_27_130,r_138_26_188,r_116_108_38,r_138_26_188,0.97,-57,131,188,11
20,r_94_20_78,r_142_27_130,seq60,r_94_20_78,0.99,0,78,78,11
13,r_143_2_96,r_1_99_180,r_59_10_5,r_143_2_96,0.85,0,96,96,11
25,r_63_83_33,r_102_34_146,r_16_96_170,r_63_83_33,0.91,0,33,33,11
48,r_52_130_81,r_18_90_193,r_102_34_146,r_52_130_81,0.84,0,81,81,11
6,r_29_40_154,r_16_96_170,r_87_70_74,r_16_96_170,0.95,-16,154,170,11
2,r_11_114_107,seq140,r_52_130_81,r_11_114_107,0.99,1,108,107,11
47,r_41_9_162,r_145_132_108,r_143_2_96,r_41_9_162,0.56,-63,99,162,11
40,r_135_84_156,r_117_19_118,r_143_2_96,r_135_84_156,0.73,-38,118,156,11
18,r_145_132_108,r_61_93_124,r_134_68_58,r_145_132_108,0.55,-2,106,108,11
24,r_61_93_124,r_110_43_126,r_138_26_188,r_61_93_124,0.8,1,125,124,11
33,r_125_146_91,r_110_43_126,seq122,r_125_146_91,0.98,1,92,91,11
47,r_41_9_162,r_143_2_96,seq136,r_41_9_162,1.0,-1,161,162,11
88,seq103,r_67_121_111,r_145_132_108,r_145_132_108,0.97,9,117,108,11
44,r_116_108_38,r_142_27_130,seq45,r_116_108_38,0.82,7,45,38,11
91,seq111,r_67_121_111,r_71_25_31,r_71_25_31,0.92,18,49,31,11
42,r_139_118_86,r_138_26_188,r_102_34_146,r_139_118_86,0.57,77,163,86,11
32,r_115_137_106,r_97_54_141,seq111,r_115_137_106,0.99,0,106,106,11
38,r_97_54_141,r_56_95_2,r_65_53_140,r_56_95_2,1.0,139,141,2,11
3,r_91_14_29,r_30_13_89,seq8,r_91_14_29,0.59,2,31,29,11
65,seq37,seq111,r_134_68_58,r_134_68_58,0.85,0,58,58,11
25,r_63_83_33,r_16_96_170,seq144,r_16_96_170,1.0,1,171,170,11
61,seq22,r_71_25_31,r_142_27_130,r_71_25_31,0.99,0,31,31,11
35,r_138_26_188,r_61_93_124,r_98_75_131,r_138_26_188,0.82,0,188,188,11
96,seq123,r_30_13_89,seq124,r_30_13_89,1.0,-11,78,89,11
40,r_135_84_156,r_143_2_96,r_127_12_46,r_135_84_156,0.64,0,156,156,11
22,r_5_7_120,seq131,seq81,r_5_7_120,0.94,0,120,120,11
28,r_30_13_89,seq123,seq144,r_30_13_89,0.69,1,90,89,11
49,r_110_43_126,r_59_10_5,r_98_75_131,r_110_43_126,0.6,4,130,126,11
12,r_134_68_58,seq46,seq37,r_134_68_58,0.75,0,58,58,11
7,r_87_70_74,r_145_132_108,seq86,r_87_70_74,0.74,2,76,74,11
5,r_71_25_31,seq22,seq111,r_71_25_31,0.97,0,31,31,11
23,r_102_34_146,seq74,r_139_118_86,r_139_118_86,0.98,61,147,86,11
39,r_127_12_46,seq44,seq122,r_127_12_46,0.93,0,46,46,11
35,r_138_26_188,r_142_27_130,r_61_93_124,r_138_26_188,0.75,-57,131,188,11
48,r_52_130_81,r_102_34_146,r_11_114_107,r_11_114_107,0.96,10,117,107,11
84,seq86,seq79,r_87_70_74,r_87_70_74,1.0,6,80,74,11
36,r_55_45_74,r_89_136_185,seq85,r_55_45_74,0.83,0,74,74,12
43,r_86_47_121,r_73_128_181,r_101_14_16,r_86_47_121,0.68,0,121,121,12
1,r_39_133_122,r_67_46_152,r_143_110_49,r_39_133_122,0.96,0,122,122,12
32,r_101_14_16,r_127_32_87,seq10,r_101_14_16,0.98,0,16,16,12
5,r_54_107_66,seq29,r_66_126_133,r_54_107_66,1.0,0,66,66,12
42,r_59_140_60,seq36,seq94,r_59_140_60,0.79,13,73,60,12
45,r_81_148_2,r_4_108_143,seq98,r_4_108_143,0.95,-1,142,143,12
19,r_21_77_90,seq118,seq41,r_21_77_90,1.0,1,91,90,12
38,r_83_60_173,seq98,r_37_115_19,r_37_115_19,0.3,154,173,19,12
31,r_31_147_110,seq96,seq5,r_31_147_110,0.99,0,110,110,12
41,r_51_0_68,seq68,seq43,r_51_0_68,1.0,1,69,68,12
86,seq91,r_42_11_22,r_34_82_42,r_34_82_42,1.0,2,44,42,12
3,r_9_106_83,r_7_138_182,seq53,r_9_106_83,0.92,6,89,83,12
20,r_25_120_26,r_13_114_101,r_101_14_16,r_25_120_26,1.0,2,28,26,12
10,r_4_108_143,r_81_148_2,r_13_114_101,r_4_108_143,0.71,1,144,143,12
14,r_37_115_19,r_89_136_185,r_83_60_173,r_37_115_19,0.72,166,185,19,12
4,r_66_126_133,r_83_60_173,r_112_2_88,r_66_126_133,0.66,0,133,133,12
63,seq29,r_6_111_85,seq19,r_6_111_85,1.0,0,85,85,12
13,r_20_28_80,seq10,seq43,r_20_28_80,1.0,0,80,80,12
98,seq124,seq132,r_44_48_98,r_44_48_98,1.0,0,98,98,12
15,r_127_32_87,seq43,seq96,r_127_32_87,0.98,0,87,87,12
32,r_101_14_16,seq10,r_25_120_26,r_25_120_26,0.99,43,69,26,12
57,seq142,r_42_11_22,r_34_82_42,r_34_82_42,1.0,32,74,42,12
21,r_143_110_49,r_83_60_173,seq68,r_143_110_49,1.0,1,50,49,12
14,r_37_115_19,r_9_106_83,r_89_136_185,r_37_115_19,1.0,0,19,19,12
5,r_54_107_66,r_66_126_133,seq98,r_66_126_133,1.0,0,133,133,12
87,seq92,r_65_24_78,r_112_2_88,r_65_24_78,0.99,9,87,78,12
47,r_105_56_167,r_78_137_125,r_67_46_152,r_105_56_167,0.4,-24,143,167,12
38,r_83_60_173,r_143_110_49,seq98,r_143_110_49,1.0,1,50,49,12
37,r_95_1_62,r_51_0_68,r_88_135_44,r_51_0_68,1.0,-15,53,68,12
40,r_104_116_105,seq134,seq64,r_104_116_105,0.89,1,106,105,12
29,r_6_111_85,seq29,seq132,r_6_111_85,1.0,0,85,85,12
24,r_65_24_78,seq92,seq72,r_65_24_78,0.89,3,81,78,12
52,seq5,r_73_128_181,r_141_121_71,r_141_121_71,1.0,110,181,71,12
34,r_44_48_98,seq10,seq124,r_44_48_98,0.99,1,99,98,12
17,r_141_121_71,seq96,seq113,r_141_121_71,1.0,1,72,71,12
18,r_89_136_185,r_55_45_74,r_37_115_19,r_37_115_19,0.81,2,21,19,12
9,r_22_16_96,r_95_1_62,r_23_122_24,r_22_16_96,0.52,-14,82,96,12
22,r_26_30_106,r_69_63_190,seq85,r_26_30_106,0.97,0,106,106,12
28,r_61_99_107,seq19,seq139,r_61_99_107,0.86,0,107,107,12
91,seq98,r_83_60_173,r_81_148_2,r_83_60_173,0.4,-12,161,173,12
11,r_38_52_31,seq132,r_35_131_25,r_38_52_31,0.97,5,36,31,12
18,r_89_136_185,r_37_115_19,r_88_135_44,r_37_115_19,0.66,166,185,19,12
23,r_102_146_151,r_89_136_185,r_38_52_31,r_89_136_185,0.81,-34,151,185,12
35,r_100_58_148,seq53,r_141_121_71,r_141_121_71,1.0,86,157,71,12
47,r_105_56_167,r_67_46_152,seq36,r_105_56_167,0.83,0,167,167,12
12,r_78_137_125,r_105_56_167,seq17,r_105_56_167,0.62,-41,126,167,12
93,seq99,r_5_126_76,r_70_49_62,r_70_49_62,0.93,7,69,62,13
44,r_24_25_74,r_21_82_170,r_133_122_166,r_21_82_170,0.52,2,172,170,13
51,seq129,r_109_148_133,seq30,r_109_148_133,0.69,0,133,133,13
36,r_94_135_72,r_36_62_130,seq58,r_94_135_72,1.0,0,72,72,13
29,r_146_72_27,r_27_96_98,r_40_128_198,r_146_72_27,0.97,0,27,27,13
8,r_41_105_111,seq20,r_147_121_2,r_41_105_111,1.0,1,112,111,13
43,r_67_137_127,r_12_17_167,seq19,r_67_137_127,0.67,6,133,127,13
37,r_68_57_101,r_147_121_2,r_112_114_3,r_68_57_101,0.99,0,101,101,13
3,r_59_79_60,r_15_43_129,r_23_103_77,r_15_43_129,0.94,2,131,129,13
55,seq134,r_74_138_110,seq47,r_74_138_110,1.0,2,112,110,13
21,r_117_44_147,seq75,r_40_128_198,r_117_44_147,0.97,1,148,147,13
5,r_12_17_167,r_60_119_171,seq50,r_12_17_167,0.8,5,172,167,13
46,r_70_49_62,r_36_62_130,seq99,r_70_49_62,1.0,1,63,62,13
42,r_21_82_170,seq0,r_24_25_74,r_24_25_74,0.61,5,79,74,13
80,seq65,r_36_62_130,seq123,r_36_62_130,1.0,0,130,130,13
45,r_63_13_131,r_102_71_189,r_147_121_2,r_63_13_131,0.63,21,152,131,13
7,r_147_121_2,r_142_139_63,r_41_105_111,r_41_105_111,1.0,10,121,111,13
95,seq113,r_143_54_24,r_1_90_33,r_1_90_33,1.0,138,171,33,13
27,r_101_87_41,r_41_105_111,seq37,r_101_87_41,0.59,4,45,41,13
41,r_5_126_76,seq78,r_10_2_1,r_5_126_76,0.95,1,77,76,13
30,r_1_90_33,r_9_141_73,seq19,r_1_90_33,0.49,0,33,33,13
3,r_59_79_60,seq29,r_15_43_129,r_59_79_60,0.96,0,60,60,13
10,r_9_141_73,seq8,r_146_72_27,r_146_72_27,0.97,125,152,27,13
20,r_106_149_58,r_45_116_157,r_101_87_41,r_106_149_58,1.0,1,59,58,13
4,r_18_84_148,seq19,seq51,r_18_84_148,0.55,2,150,148,13
63,seq26,r_15_43_129,r_59_79_60,r_59_79_60,0.86,71,131,60,13
11,r_60_119_171,r_12_17_167,r_94_135_72,r_12_17_167,0.7,5,172,167,13
15,r_11_93_165,r_15_43_129,r_124_104_85,r_124_104_85,0.92,46,131,85,13
9,r_31_76_55,r_59_79_60,r_53_89_136,r_31_76_55,0.73,0,55,55,13
12,r_53_89_136,r_31_76_55,seq3,r_53_89_136,0.97,1,137,136,13
6,r_23_103_77,seq0,r_59_79_60,r_23_103_77,0.94,0,77,77,13
87,seq81,r_102_71_189,r_142_139_63,r_142_139_63,1.0,126,189,63,13
1,r_127_107_9,r_53_89_136,seq56,r_127_107_9,0.63,3,12,9,13
2,r_33_108_65,r_35_88_173,seq97,r_33_108_65,0.93,1,66,65,13
47,r_15_43_129,seq26,r_127_107_9,r_15_43_129,0.94,-4,125,129,13
40,r_45_116_157,seq66,r_10_2_1,r_45_116_157,0.81,1,158,157,13
18,r_36_62_130,seq65,r_31_76_55,r_36_62_130,0.92,0,130,130,13
24,r_6_140_92,seq56,r_83_16_30,r_6_140_92,1.0,0,92,92,13
35,r_124_104_85,r_133_122_166,r_59_79_60,r_133_122_166,1.0,3,169,166,13
25,r_102_71_189,r_63_13_131,r_112_114_3,r_102_71_189,0.16,0,189,189,13
65,seq30,r_35_88_173,seq129,r_35_88_173,0.5,4,177,173,13
39,r_83_16_30,r_147_121_2,r_112_114_3,r_83_16_30,1.0,0,30,30,13
42,r_21_82_170,r_24_25_74,r_32_48_11,r_21_82_170,0.91,2,172,170,13
32,r_142_139_63,r_124_104_85,r_147_121_2,r_147_121_2,1.0,61,63,2,13
9,r_31_76_55,r_53_89_136,r_74_138_110,r_31_76_55,0.6,54,109,55,13
34,r_27_96_98,seq145,seq113,r_27_96_98,0.99,0,98,98,13
14,r_136_85_12,r_40_128_198,seq37,r_136_85_12,1.0,0,12,12,13
81,seq66,r_45_116_157,seq145,r_45_116_157,1.0,1,158,157,13
17,r_144_28_19,r_36_62_130,seq86,r_144_28_19,0.73,-6,13,19,13
28,r_133_122_166,r_124_104_85,r_24_25_74,r_124_104_85,0.41,83,168,85,13
22,r_110_7_125,seq0,seq65,r_110_7_125,0.78,0,125,125,13
31,r_32_48_11,r_147_121_2,seq145,r_32_48_11,0.99,0,11,11,13
28,r_133_122_166,r_15_43_129,r_124_104_85,r_124_104_85,0.98,5,90,85,13
49,r_115_77_168,r_35_88_173,seq66,r_115_77_168,0.76,0,168,168,13
56,seq8,r_9_141_73,seq125,r_9_141_73,0.72,0,73,73,13
7,r_147_121_2,r_102_71_189,r_142_139_63,r_142_139_63,1.0,1,64,63,13
44,r_24_25_74,r_36_62_130,r_21_82_170,r_24_25_74,0.99,1,75,74,13
79,seq61,seq22,r_31_76_55,r_31_76_55,0.84,11,66,55,13
35,r_124_104_85,seq58,r_133_122_166,r_124_104_85,1.0,0,85,85,13
12,r_53_89_136,seq61,r_31_76_55,r_31_76_55,0.99,9,64,55,13
84,seq75,r_117_44_147,seq130,r_117_44_147,1.0,1,148,147,13
93,seq103,r_38_130_154,r_133_13_7,r_38_130_154,0.7,0,154,154,14
92,seq102,seq54,r_45_55_142,r_45_55_142,0.99,0,142,142,14
8,r_32_7_156,r_111_31_119,seq39,r_111_31_119,1.0,0,119,119,14
43,r_3_119_6,seq74,r_89_66_70,r_89_66_70,0.98,4,74,70,14
37,r_45_55_142,r_56_63_148,r_96_48_84,r_96_48_84,0.99,0,84,84,14
16,r_0_1_83,seq39,seq145,r_0_1_83,1.0,0,83,83,14
21,r_16_59_194,seq86,r_139_143_81,r_139_143_81,1.0,22,103,81,14
39,r_52_85_77,seq54,seq18,r_52_85_77,1.0,0,77,77,14
1,r_115_137_28,r_8_23_193,r_27_69_36,r_8_23_193,0.51,-43,150,193,14
97,seq112,r_75_125_60,r_110_51_144,r_75_125_60,0.95,2,62,60,14
46,r_36_35_61,seq12,seq81,r_36_35_61,0.8,0,61,61,14
42,r_84_146_155,r_109_24_180,r_116_40_14,r_84_146_155,0.78,0,155,155,14
8,r_32_7_156,seq39,r_27_69_36,r_32_7_156,0.95,0,156,156,14
69,seq41,r_46_70_131,r_80_98_118,r_46_70_131,0.85,0,131,131,14
45,r_80_98_118,seq103,seq41,r_80_98_118,0.69,2,120,118,14
44,r_10_118_57,seq11,r_116_40_14,r_116_40_14,0.98,1,15,14,14
19,r_46_70_131,seq41,r_148_26_67,r_46_70_131,0.96,0,131,131,14
15,r_96_48_84,r_45_55_142,r_126_2_17,r_45_55_142,1.0,2,144,142,14
38,r_56_63_148,r_126_2_17,seq112,r_56_63_148,0.57,3,151,148,14
41,r_65_67_186,seq18,r_110_51_144,r_65_67_186,0.23,0,186,186,14
31,r_68_42_20,r_38_130_154,seq77,r_68_42_20,0.88,1,21,20,14
10,r_47_79_188,r_123_138_157,r_110_51_144,r_123_138_157,0.82,-7,150,157,14
90,seq97,seq60,r_96_48_84,r_96_48_84,1.0,85,169,84,14
26,r_71_14_64,r_96_48_84,seq5,r_71_14_64,1.0,0,64,64,14
4,r_139_143_81,r_46_70_131,r_16_59_194,r_139_143_81,1.0,0,81,81,14
11,r_89_66_70,r_47_79_188,r_3_119_6,r_89_66_70,0.99,7,77,70,14
2,r_114_17_43,seq74,seq141,r_114_17_43,1.0,0,43,43,14
28,r_34_33_25,r_10_118_57,seq105,r_34_33_25,0.62,0,25,25,14
13,r_148_26_67,r_43_120_100,seq149,r_148_26_67,0.99,0,67,67,14
15,r_96_48_84,seq149,r_45_55_142,r_96_48_84,0.88,0,84,84,14
6,r_129_61_139,seq4,r_80_98_118,r_129_61_139,0.95,0,139,139,14
80,seq81,r_75_125_60,r_36_35_61,r_36_35_61,0.75,3,64,61,14
44,r_10_118_57,r_116_40_14,seq145,r_10_118_57,0.99,0,57,57,14
38,r_56_63_148,r_45_55_142,r_126_2_17,r_126_2_17,0.79,-4,13,17,14
87,seq91,r_109_24_180,r_19_132_93,r_19_132_93,1.0,87,180,93,14
27,r_101_99_30,seq81,r_116_40_14,r_101_99_30,1.0,0,30,30,14
40,r_38_130_154,seq103,r_71_14_64,r_38_130_154,0.54,0,154,154,14
5,r_27_69_36,r_47_79_188,r_3_119_6,r_27_69_36,0.98,0,36,36,14
0,r_116_40_14,r_10_118_57,r_101_99_30,r_10_118_57,0.67,0,57,57,14
18,r_94_107_96,r_64_30_102,seq141,r_94_107_96,0.99,0,96,96,14
29,r_37_76_108,seq117,r_27_69_36,r_37_76_108,0.83,-2,106,108,14
37,r_45_55_142,r_96_48_84,seq102,r_45_55_142,1.0,0,142,142,14
48,r_106_93_47,seq39,seq41,r_106_93_47,1.0,0,47,47,14
33,r_64_30_102,r_94_107_96,r_68_42_20,r_94_107_96,0.84,0,96,96,14
47,r_126_2_17,r_56_63_148,r_96_48_84,r_96_48_84,0.99,67,151,84,14
32,r_75_125_60,seq112,seq74,r_75_125_60,0.94,2,62,60,14
47,r_126_2_17,r_68_42_20,r_56_63_148,r_126_2_17,0.92,-4,13,17,14
34,r_124_25_162,seq73,seq128,r_124_25_162,0.71,0,162,162,14
1,r_115_137_28,r_43_120_100,r_8_23_193,r_115_137_28,0.94,0,28,28,14
0,r_116_40_14,seq97,r_10_118_57,r_116_40_14,0.97,0,14,14,14
17,r_113_131_164,seq136,seq108,r_113_131_164,0.92,1,165,164,14
9,r_43_120_100,seq86,r_0_1_83,r_43_120_100,0.91,0,100,100,14
49,r_123_138_157,r_47_79_188,r_52_85_77,r_123_138_157,0.85,0,157,157,14
35,r_111_31_119,r_32_7_156,r_133_13_7,r_111_31_119,0.65,0,119,119,14
80,seq81,r_101_99_30,r_75_125_60,r_101_99_30,0.98,0,30,30,14
12,r_19_132_93,r_8_23_193,seq18,r_19_132_93,1.0,0,93,93,14
30,r_115_122_181,seq37,seq48,r_115_122_181,0.62,0,181,181,15
36,r_111_75_187,seq92,r_62_66_91,r_62_66_91,1.0,14,105,91,15
14,r_119_86_118,r_84_6_133,seq8,r_84_6_133,1.0,-21,112,133,15
8,r_68_126_109,r_109_67_3,r_114_10_10,r_68_126_109,0.96,0,109,109,15
53,seq8,r_76_55_128,r_119_86_118,r_76_55_128,0.56,15,143,128,15
43,r_62_66_91,r_70_123_184,r_111_75_187,r_62_66_91,1.0,0,91,91,15
54,seq9,r_108_146_199,r_101_147_151,r_101_147_151,0.88,6,157,151,15
54,seq9,r_36_78_125,r_108_146_199,r_36_78_125,0.92,1,126,125,15
83,seq82,r_105_30_150,seq47,r_105_30_150,0.99,2,152,150,15
37,r_94_2_86,r_129_56_111,seq51,r_94_2_86,0.99,1,87,86,15
3,r_97_90_82,seq113,r_143_18_138,r_143_18_138,1.0,8,146,138,15
13,r_99_77_45,seq73,seq116,r_99_77_45,1.0,0,45,45,15
19,r_91_63_190,r_14_131_105,r_23_128_141,r_23_128_141,0.95,2,143,141,15
26,r_129_56_111,r_1_40_75,seq124,r_129_56_111,0.79,1,112,111,15
16,r_112_140_185,seq34,r_101_147_151,r_101_147_151,0.69,36,187,151,15
39,r_17_118_167,seq83,r_12_98_93,r_12_98_93,0.74,74,167,93,15
1,r_59_31_169,r_108_146_199,r_52_72_74,r_52_72_74,0.38,96,170,74,15
5,r_133_15_182,seq54,seq138,r_133_15_182,0.48,0,182,182,15
46,r_52_72_74,seq22,seq19,r_52_72_74,0.96,0,74,74,15
45,r_107_11_168,seq48,r_74_44_43,r_74_44_43,0.99,126,169,43,15
19,r_91_63_190,r_79_85_166,r_14_131_105,r_14_131_105,0.74,-32,73,105,15
95,seq117,seq93,r_120_96_73,r_120_96_73,0.64,-1,72,73,15
97,seq124,r_21_64_1,r_129_56_111,r_129_56_111,1.0,7,118,111,15
31,r_58_7_103,seq13,r_114_10_10,r_114_10_10,0.7,98,108,10,15
41,r_29_144_108,seq60,seq89,r_29_144_108,0.96,0,108,108,15
32,r_25_5_162,seq142,r_120_96_73,r_25_5_162,0.99,-2,160,162,15
3,r_97_90_82,r_129_56_111,seq113,r_97_90_82,0.99,0,82,82,15
26,r_129_56_111,r_94_2_86,r_1_40_75,r_129_56_111,0.88,-24,87,111,15
72,seq48,r_107_11_168,seq54,r_107_11_168,0.78,1,169,168,15
4,r_80_103_78,r_81_38_121,seq106,r_80_103_78,0.96,0,78,78,15
78,seq61,seq73,r_12_98_93,r_12_98_93,1.0,21,114,93,15
73,seq51,r_41_136_39,r_94_2_86,r_94_2_86,1.0,18,104,86,15
11,r_101_147_151,r_129_56_111,r_1_40_75,r_101_147_151,0.75,-39,112,151,15
20,r_81_38_121,r_25_5_162,seq124,r_81_38_121,0.97,1,122,121,15
11,r_101_147_151,r_1_40_75,seq9,r_101_147_151,1.0,1,152,151,15
0,r_114_10_10,r_20_33_171,seq88,r_114_10_10,0.86,0,10,10,15
15,r_104_0_129,seq116,seq92,r_104_0_129,0.89,1,130,129,15
48,r_42_102_71,seq148,seq137,r_42_102_71,1.0,0,71,71,15
35,r_71_39_25,seq135,seq65,r_71_39_25,1.0,0,25,25,15
2,r_1_40_75,r_101_147_151,r_105_30_150,r_1_40_75,0.9,74,149,75,15
6,r_105_30_150,seq82,r_1_40_75,r_105_30_150,0.89,2,152,150,15
36,r_111_75_187,r_62_66_91,r_71_39_25,r_111_75_187,0.5,0,187,187,15
2,r_1_40_75,r_105_30_150,r_79_85_166,r_79_85_166,0.96,1,167,166,15
2,r_1_40_75,seq65,r_129_56_111,r_129_56_111,0.6,-37,74,111,15
47,r_76_55_128,r_23_128_141,r_52_72_74,r_76_55_128,0.94,14,142,128,15
40,r_84_6_133,r_119_86_118,r_97_90_82,r_84_6_133,0.98,0,133,133,15
18,r_14_131_105,r_79_85_166,r_49_4_112,r_49_4_112,0.96,54,166,112,15
25,r_23_128_141,r_76_55_128,r_91_63_190,r_23_128_141,0.83,1,142,141,15
43,r_62_66_91,r_111_75_187,r_104_0_129,r_104_0_129,0.54,58,187,129,15
33,r_12_98_93,seq137,seq61,r_12_98_93,0.88,-1,92,93,15
79,seq65,r_1_40_75,r_71_39_25,r_71_39_25,0.91,6,31,25,15
28,r_50_145_42,seq13,seq127,r_50_145_42,1.0,4,46,42,15
32,r_25_5_162,r_81_38_121,seq142,r_81_38_121,0.9,1,122,121,15
25,r_23_128_141,r_91_63_190,seq121,r_91_63_190,0.93,0,190,190,15
21,r_100_139_56,seq124,seq26,r_100_139_56,1.0,0,56,56,15
12,r_74_44_43,r_104_0_129,seq142,r_74_44_43,0.99,1,44,43,15
34,r_120_96_73,r_112_140_185,seq117,r_120_96_73,0.6,0,73,73,15
75,seq54,r_133_15_182,r_115_122_181,r_115_122_181,0.6,1,182,181,15
99,seq127,r_133_15_182,r_50_145_42,r_50_145_42,0.99,4,46,42,15
97,seq124,r_100_139_56,r_21_64_1,r_100_139_56,1.0,0,56,56,15
2,r_1_40_75,r_129_56_111,r_101_147_151,r_129_56_111,1.0,1,112,111,15
60,seq148,r_42_102_71,seq117,r_42_102_71,1.0,0,71,71,15
17,r_20_33_171,seq46,seq141,r_20_33_171,0.31,1,172,171,15
19,r_91_63_190,r_23_128_141,seq83,r_91_63_190,0.9,0,190,190,15
9,r_143_18_138,r_133_15_182,r_97_90_82,r_143_18_138,0.55,0,138,138,15
22,r_79_85_166,r_14_131_105,r_1_40_75,r_1_40_75,0.88,91,166,75,15
56,seq13,r_58_7_103,r_52_72_74,r_52_72_74,0.96,34,108,74,15
7,r_36_78_125,seq9,r_120_96_73,r_36_78_125,0.96,1,126,125,15
44,r_49_4_112,seq19,r_14_131_105,r_49_4_112,0.98,1,113,112,15
84,seq83,r_17_118_167,r_50_145_42,r_50_145_42,0.97,128,170,42,15
93,seq102,seq147,r_107_19_82,r_107_19_82,0.99,0,82,82,16
44,r_37_36_199,r_116_12_173,r_7_18_170,r_7_18_170,0.91,4,174,170,16
25,r_70_111_18,r_76_81_147,seq93,r_70_111_18,0.94,0,18,18,16
92,seq99,r_136_114_169,r_66_45_57,r_66_45_57,0.94,114,171,57,16
8,r_108_100_158,seq93,seq62,r_108_100_158,0.51,1,159,158,16
94,seq103,seq67,r_92_31_27,r_92_31_27,0.9,-2,25,27,16
36,r_91_28_39,r_98_17_172,seq139,r_91_28_39,1.0,0,39,39,16
37,r_97_2_126,r_51_126_198,seq6,r_97_2_126,0.99,0,126,126,16
64,seq22,seq96,r_84_124_38,r_84_124_38,1.0,-3,35,38,16
21,r_130_90_105,r_35_27_187,r_60_63_46,r_130_90_105,0.93,3,108,105,16
1,r_64_56_114,seq29,seq26,r_64_56_114,0.77,1,115,114,16
5,r_82_146_62,r_130_90_105,seq89,r_82_146_62,0.97,-1,61,62,16
46,r_137_43_165,r_116_12_173,r_37_36_199,r_137_43_165,0.63,10,175,165,16
9,r_110_47_30,seq22,seq117,r_110_47_30,0.98,1,31,30,16
80,seq73,r_35_27_187,r_104_109_97,r_104_109_97,1.0,8,105,97,16
45,r_107_19_82,seq55,seq102,r_107_19_82,1.0,0,82,82,16
30,r_60_63_46,r_135_138_107,r_91_28_39,r_60_63_46,0.79,-1,45,46,16
38,r_92_31_27,seq103,r_135_138_107,r_135_138_107,1.0,15,122,107,16
31,r_87_121_112,r_51_126_198,seq119,r_87_121_112,0.98,0,112,112,16
3,r_66_45_57,seq15,r_144_34_42,r_66_45_57,1.0,-2,55,57,16
43,r_44_69_16,r_120_101_193,seq50,r_44_69_16,0.77,0,16,16,16
27,r_144_34_42,r_105_129_56,seq46,r_105_129_56,0.98,-13,43,56,16
90,seq94,r_98_17_172,seq39,r_98_17_172,0.97,-68,104,172,16
26,r_120_101_193,r_135_138_107,r_64_56_114,r_135_138_107,0.84,1,108,107,16
4,r_132_72_154,seq68,r_97_2_126,r_132_72_154,0.96,0,154,154,16
19,r_149_134_45,r_5_127_119,seq141,r_149_134_45,1.0,0,45,45,16
11,r_116_12_173,r_137_43_165,r_145_77_6,r_116_12_173,0.74,1,174,173,16
20,r_122_148_156,r_131_83_191,r_24_33_1,r_122_148_156,0.79,1,157,156,16
13,r_98_17_172,r_7_18_170,r_82_146_62,r_98_17_172,0.64,2,174,172,16
15,r_35_27_187,seq46,r_87_121_112,r_87_121_112,0.95,75,187,112,16
10,r_105_129_56,seq78,seq94,r_105_129_56,1.0,0,56,56,16
33,r_57_10_31,r_37_36_199,seq29,r_57_10_31,0.97,0,31,31,16
44,r_37_36_199,r_57_10_31,r_116_12_173,r_57_10_31,0.81,1,32,31,16
87,seq89,seq1,r_82_146_62,r_82_146_62,1.0,-1,61,62,16
47,r_76_81_147,seq139,r_66_45_57,r_76_81_147,0.84,0,147,147,16
40,r_140_23_104,seq13,r_110_47_30,r_140_23_104,1.0,0,104,104,16
18,r_136_114_169,seq99,seq53,r_136_114_169,0.47,2,171,169,16
24,r_135_138_107,seq117,r_92_31_27,r_135_138_107,0.99,1,108,107,16
32,r_71_52_188,seq50,r_108_100_158,r_71_52_188,0.22,2,190,188,16
34,r_25_65_94,r_120_101_193,r_37_36_199,r_25_65_94,0.98,4,98,94,16
16,r_79_42_58,seq9,seq38,r_79_42_58,1.0,1,59,58,16
17,r_32_4_72,r_71_52_188,seq58,r_32_4_72,1.0,1,73,72,16
22,r_104_109_97,r_123_86_75,seq73,r_104_109_97,0.98,0,97,97,16
28,r_54_133_120,seq11,seq26,r_54_133_120,0.93,1,121,120,16
7,r_49_95_89,seq40,seq67,r_49_95_89,0.84,3,92,89,16
23,r_48_115_137,r_116_12_173,r_112_30_9,r_112_30_9,0.73,133,142,9,16
29,r_84_124_38,seq78,seq22,r_84_124_38,0.97,-1,37,38,16
35,r_7_18_170,r_98_17_172,r_37_36_199,r_37_36_199,0.61,-29,170,199,16
38,r_92_31_27,r_76_81_147,seq103,r_92_31_27,0.94,0,27,27,16
26,r_36_134_27,r_138_88_47,seq17,r_36_134_27,0.67,0,27,27,17
40,r_120_48_171,r_32_129_77,r_46_22_156,r_120_48_171,0.39,0,171,171,17
30,r_64_10_145,seq20,r_87_91_74,r_87_91_74,1.0,71,145,74,17
14,r_6_61_141,r_64_10_145,r_136_63_5,r_6_61_141,0.42,4,145,141,17
8,r_54_145_89,r_11_28_162,seq18,r_54_145_89,0.75,1,90,89,17
37,r_46_22_156,r_106_107_117,r_6_61_141,r_106_107_117,0.68,3,120,117,17
19,r_59_26_116,seq117,r_98_15_97,r_59_26_116,1.0,0,116,116,17
16,r_4_16_102,r_78_68_91,r_75_79_13,r_4_16_102,0.93,5,107,102,17
21,r_106_107_117,r_46_22_156,seq2,r_106_107_117,0.92,3,120,117,17
39,r_123_66_128,seq81,r_32_129_77,r_123_66_128,0.7,0,128,128,17
1,r_87_91_74,r_41_44_199,seq100,r_87_91_74,1.0,0,74,74,17
33,r_40_90_20,r_126_89_87,seq47,r_40_90_20,0.99,0,20,20,17
28,r_119_104_51,r_41_44_199,seq82,r_119_104_51,1.0,0,51,51,17
5,r_58_76_79,seq47,r_36_134_27,r_58_76_79,0.95,0,79,79,17
45,r_32_129_77,seq130,r_120_48_171,r_32_129_77,0.82,0,77,77,17
22,r_29_139_56,r_59_26_116,seq142,r_29_139_56,0.58,0,56,56,17
70,seq42,seq131,r_119_104_51,r_119_104_51,0.99,2,53,51,17
41,r_60_121_88,r_57_80_185,seq14,r_60_121_88,1.0,0,88,88,17
67,seq35,seq103,r_122_8_133,r_122_8_133,0.42,-28,105,133,17
89,seq103,r_70_43_137,r_112_0_67,r_112_0_67,1.0,29,96,67,17
10,r_146_96_100,seq17,r_74_110_21,r_146_96_100,1.0,0,100,100,17
0,r_78_68_91,seq108,seq20,r_78_68_91,0.73,19,110,91,17
11,r_98_15_97,seq102,r_87_91_74,r_87_91_74,0.97,28,102,74,17
20,r_122_8_133,r_143_141_64,seq35,r_143_141_64,1.0,1,65,64,17
13,r_75_79_13,r_98_15_97,r_4_16_102,r_75_79_13,0.81,89,102,13,17
15,r_112_0_67,r_11_28_162,seq103,r_112_0_67,1.0,3,70,67,17
48,r_70_43_137,seq95,seq55,r_70_43_137,0.42,4,141,137,17
6,r_126_89_87,r_146_96_100,r_128_115_69,r_146_96_100,1.0,-12,88,100,17
70,seq42,r_136_63_5,seq82,r_136_63_5,0.54,140,145,5,17
87,seq100,seq81,r_87_91_74,r_87_91_74,1.0,2,76,74,17
47,r_34_5_127,r_132_39_112,r_40_90_20,r_34_5_127,0.9,0,127,127,17
9,r_138_88_47,r_57_80_185,seq130,r_138_88_47,1.0,0,47,47,17
40,r_120_48_171,seq82,r_32_129_77,r_32_129_77,0.93,3,80,77,17
35,r_137_83_52,r_75_79_13,seq37,r_137_83_52,0.67,111,163,52,17
25,r_94_135_92,r_132_39_112,seq130,r_94_135_92,0.87,0,92,92,17
43,r_136_63_5,r_106_107_117,r_119_104_51,r_119_104_51,0.99,58,109,51,17
19,r_59_26_116,r_29_139_56,seq117,r_29_139_56,0.91,0,56,56,17
32,r_128_115_69,r_146_96_100,seq56,r_128_115_69,0.68,0,69,69,17
38,r_125_101_167,seq18,r_12_7_53,r_12_7_53,1.0,114,167,53,17
34,r_113_99_152,seq14,r_122_8_133,r_113_99_152,0.97,0,152,152,17
81,seq82,r_120_48_171,r_119_104_51,r_119_104_51,1.0,2,53,51,17
45,r_32_129_77,r_120_48_171,r_123_66_128,r_123_66_128,0.95,43,171,128,17
49,r_85_109_187,r_4_16_102,r_128_115_69,r_4_16_102,0.9,87,189,102,17
17,r_19_73_68,r_49_92_124,seq130,r_19_73_68,0.94,2,70,68,17
83,seq142,seq23,r_29_139_56,r_29_139_56,0.98,-6,50,56,17
18,r_74_110_21,r_137_83_52,seq111,r_74_110_21,0.97,0,21,21,17
26,r_36_134_27,seq17,r_58_76_79,r_58_76_79,1.0,43,122,79,17
91,seq108,r_78_68_91,seq149,r_78_68_91,0.82,19,110,91,17
46,r_12_7_53,seq130,seq14,r_12_7_53,1.0,1,54,53,17
49,r_85_109_187,seq102,r_4_16_102,r_4_16_102,0.89,53,155,102,17
56,seq144,r_77_140_188,r_125_101_167,r_77_140_188,0.11,0,188,188,17
7,r_143_141_64,r_122_8_133,seq67,r_143_141_64,1.0,0,64,64,17
44,r_77_140_188,seq144,r_119_104_51,r_119_104_51,0.95,137,188,51,17
43,r_136_63_5,r_119_104_51,r_6_61_141,r_136_63_5,0.73,134,139,5,17
23,r_11_28_162,seq84,seq25,r_11_28_162,0.77,0,162,162,17
82,seq84,r_11_28_162,seq2,r_11_28_162,1.0,0,162,162,17
30,r_113_74_181,seq69,r_77_65_46,r_77_65_46,1.0,137,183,46,18
36,r_114_121_86,seq61,r_39_107_91,r_114_121_86,0.85,3,89,86,18
28,r_108_53_16,r_9_64_119,seq61,r_108_53_16,1.0,0,16,16,18
23,r_77_65_46,seq67,r_113_74_181,r_113_74_181,0.99,1,182,181,18
14,r_106_135_103,r_2_78_133,seq8,r_106_135_103,1.0,0,103,103,18
43,r_79_122_174,seq18,r_32_137_149,r_79_122_174,0.33,8,182,174,18
37,r_57_144_20,r_2_78_133,seq25,r_2_78_133,0.54,2,135,133,18
40,r_149_30_39,r_81_26_183,seq89,r_149_30_39,1.0,0,39,39,18
86,seq94,seq93,r_147_35_124,r_147_35_124,1.0,17,141,124,18
16,r_139_50_109,seq67,r_108_53_16,r_139_50_109,0.84,0,109,109,18
21,r_81_26_183,seq102,r_29_88_105,r_29_88_105,0.99,79,184,105,18
39,r_47_96_143,r_63_105_77,seq123,r_63_105_77,1.0,0,77,77,18
1,r_130_76_72,r_28_51_81,r_95_38_177,r_95_38_177,0.95,-104,73,177,18
5,r_128_70_151,seq31,r_39_107_91,r_128_70_151,0.56,1,152,151,18
46,r_32_137_149,r_95_38_177,seq80,r_95_38_177,0.61,-28,149,177,18
42,r_103_117_171,seq25,r_56_84_57,r_103_117_171,0.77,0,171,171,18
7,r_54_46_159,seq89,r_45_24_4,r_45_24_4,0.76,155,159,4,18
37,r_57_144_20,r_75_42_85,seq25,r_57_144_20,0.99,1,21,20,18
66,seq31,r_128_70_151,seq110,r_128_70_151,0.91,1,152,151,18
10,r_9_64_119,r_29_88_105,r_55_10_189,r_9_64_119,0.48,37,156,119,18
3,r_2_78_133,r_57_144_20,r_75_42_85,r_2_78_133,0.72,1,134,133,18
39,r_47_96_143,seq123,r_106_135_103,r_47_96_143,0.99,0,143,143,18
41,r_63_105_77,r_47_96_143,r_111_23_59,r_47_96_143,1.0,-66,77,143,18
89,seq104,r_95_38_177,r_49_72_160,r_49_72_160,1.0,16,176,160,18
20,r_75_42_85,r_57_144_20,r_54_46_159,r_57_144_20,0.88,-4,16,20,18
3,r_2_78_133,r_106_135_103,r_57_144_20,r_2_78_133,0.74,-29,104,133,18
10,r_9_64_119,r_113_74_181,r_29_88_105,r_113_74_181,0.92,-61,120,181,18
26,r_16_36_98,r_95_38_177,r_149_30_39,r_16_36_98,0.59,0,98,98,18
0,r_49_72_160,seq136,seq104,r_49_72_160,0.89,1,161,160,18
18,r_86_73_176,r_128_70_151,seq142,r_86_73_176,0.98,0,176,176,18
11,r_29_88_105,seq15,seq44,r_29_88_105,0.97,0,105,105,18
27,r_90_59_136,r_77_65_46,r_82_145_89,r_90_59_136,1.0,0,136,136,18
15,r_147_35_124,r_129_71_138,seq94,r_147_35_124,0.99,0,124,124,18
13,r_7_126_14,r_103_117_171,seq99,r_7_126_14,1.0,0,14,14,18
85,seq93,seq94,r_130_76_72,r_130_76_72,1.0,69,141,72,18
27,r_90_59_136,seq0,r_77_65_46,r_77_65_46,1.0,37,83,46,18
23,r_77_65_46,r_43_146_126,r_90_59_136,r_77_65_46,1.0,0,46,46,18
79,seq80,seq142,r_32_137_149,r_32_137_149,0.8,9,158,149,18
22,r_95_38_177,r_28_51_81,r_129_71_138,r_95_38_177,0.93,1,178,177,18
12,r_56_84_57,r_47_96_143,seq120,r_56_84_57,0.68,-1,56,57,18
34,r_112_133_53,r_28_51_81,seq21,r_112_133_53,0.72,0,53,53,18
18,r_86_73_176,r_129_71_138,r_128_70_151,r_129_71_138,0.97,-2,136,138,18
29,r_58_13_150,seq142,r_111_23_59,r_111_23_59,1.0,95,154,59,18
87,seq99,r_82_145_89,r_34_97_17,r_34_97_17,1.0,0,17,17,18
25,r_125_48_115,seq66,r_43_146_126,r_43_146_126,1.0,1,127,126,18
33,r_143_62_75,seq80,seq60,r_143_62_75,1.0,2,77,75,18
88,seq102,r_81_26_183,r_54_46_159,r_54_46_159,0.99,25,184,159,18
65,seq25,r_103_117_171,r_129_71_138,r_129_71_138,0.6,35,173,138,18
20,r_75_42_85,r_54_46_159,r_45_24_4,r_75_42_85,0.98,1,86,85,18
32,r_129_71_138,r_86_73_176,seq41,r_129_71_138,0.96,0,138,138,18
38,r_131_17_162,r_81_26_183,r_77_65_46,r_77_65_46,1.0,99,145,46,18
20,r_75_42_85,r_45_24_4,r_2_78_133,r_2_78_133,0.78,16,149,133,18
19,r_34_97_17,r_9_64_119,seq99,r_34_97_17,0.95,0,17,17,18
81,seq87,r_52_27_97,seq134,r_52_27_97,1.0,0,97,97,18
17,r_28_51_81,seq120,r_32_137_149,r_28_51_81,1.0,0,81,81,18
31,r_111_23_59,r_114_121_86,r_112_133_53,r_114_121_86,0.7,-27,59,86,18
9,r_82_145_89,seq138,r_7_126_14,r_7_126_14,0.91,118,132,14,18
82,seq89,r_54_46_159,r_149_30_39,r_149_30_39,1.0,0,39,39,18
96,seq120,r_28_51_81,r_56_84_57,r_28_51_81,0.72,0,81,81,18
49,r_1_141_43,r_106_135_103,seq119,r_1_141_43,1.0,0,43,43,18
28,r_108_53_16,seq61,r_139_50_109,r_139_50_109,1.0,9,118,109,18
22,r_95_38_177,r_16_36_98,r_28_51_81,r_95_38_177,1.0,-79,98,177,18
44,r_43_146_126,seq99,r_125_48_115,r_43_146_126,0.94,1,127,126,18
17,r_28_51_81,r_32_137_149,r_130_76_72,r_32_137_149,1.0,0,149,149,18
1,r_130_76_72,r_95_38_177,r_52_27_97,r_52_27_97,0.78,7,104,97,18
7,r_54_46_159,r_75_42_85,seq89,r_75_42_85,0.92,-53,32,85,18
47,r_98_19_26,seq123,seq136,r_98_19_26,0.98,0,26,26,18
79,seq80,r_143_62_75,seq142,r_143_62_75,1.0,2,77,75,18
38,r_131_17_162,r_77_65_46,seq89,r_77_65_46,0.74,116,162,46,18
23,r_77_65_46,r_90_59_136,seq67,r_90_59_136,1.0,0,136,136,18
36,r_2_121_101,seq78,r_73_106_94,r_2_121_101,1.0,7,108,101,19
61,seq25,r_142_112_55,r_39_13_196,r_142_112_55,1.0,-4,51,55,19
25,r_125_97_48,seq145,r_60_20_137,r_125_97_48,1.0,0,48,48,19
14,r_110_67_61,r_93_96_50,seq44,r_110_67_61,1.0,0,61,61,19
8,r_34_24_159,seq104,r_38_61_194,r_34_24_159,0.49,1,160,159,19
43,r_6_41_177,r_126_0_109,seq10,r_126_0_109,1.0,0,109,109,19
75,seq56,r_45_50_156,r_70_139_10,r_70_139_10,0.9,1,11,10,19
18,r_94_95_34,r_126_0_109,r_137_140_183,r_94_95_34,1.0,0,34,34,19
35,r_70_139_10,r_1_83_187,seq56,r_70_139_10,0.95,0,10,10,19
16,r_46_109_65,r_126_0_109,seq145,r_46_109_65,0.98,0,65,65,19
21,r_60_20_137,seq71,r_125_97_48,r_125_97_48,1.0,17,65,48,19
39,r_22_82_121,seq14,r_62_101_79,r_62_101_79,0.98,4,83,79,19
1,r_1_83_187,r_16_148_125,seq30,r_16_148_125,0.56,6,131,125,19
5,r_45_50_156,r_137_140_183,seq123,r_45_50_156,0.73,0,156,156,19
46,r_33_135_86,seq86,r_75_141_89,r_33_135_86,1.0,2,88,86,19
42,r_75_141_89,r_74_149_169,r_33_135_86,r_75_141_89,0.99,0,89,89,19
45,r_136_59_22,r_1_83_187,seq49,r_136_59_22,0.98,0,22,22,19
69,seq44,seq51,r_144_124_87,r_144_124_87,0.85,2,89,87,19
65,seq30,r_73_106_94,r_66_19_2,r_73_106_94,0.97,-47,47,94,19
19,r_16_148_125,r_1_83_187,r_55_7_97,r_55_7_97,0.79,34,131,97,19
95,seq111,r_55_7_97,seq27,r_55_7_97,0.87,3,100,97,19
66,seq35,seq104,r_113_65_107,r_113_65_107,1.0,2,109,107,19
67,seq40,r_39_13_196,r_118_132_54,r_118_132_54,1.0,17,71,54,19
3,r_144_124_87,seq68,r_110_67_61,r_144_124_87,0.85,0,87,87,19
10,r_126_0_109,r_6_41_177,seq17,r_126_0_109,0.99,0,109,109,19
24,r_142_112_55,seq25,seq127,r_142_112_55,1.0,-2,53,55,19
1,r_1_83_187,seq30,seq57,r_1_83_187,0.68,0,187,187,19
4,r_99_12_164,r_66_19_2,r_118_132_54,r_66_19_2,0.53,164,166,2,19
0,r_133_134_186,r_42_21_131,r_55_7_97,r_133_134_186,0.92,-55,131,186,19
11,r_88_116_110,r_115_130_36,r_92_120_4,r_88_116_110,0.99,0,110,110,19
20,r_11_114_185,seq108,seq78,r_11_114_185,0.51,0,185,185,19
13,r_76_107_140,seq119,seq10,r_76_107_140,0.88,2,142,140,19
15,r_55_7_97,seq111,r_125_97_48,r_55_7_97,0.9,3,100,97,19
48,r_73_106_94,seq30,seq48,r_73_106_94,0.98,-1,93,94,19
28,r_62_101_79,seq47,r_5_54_153,r_5_54_153,0.71,5,158,153,19
28,r_62_101_79,r_22_82_121,seq47,r_22_82_121,0.98,0,121,121,19
37,r_31_143_7,r_16_148_125,seq26,r_31_143_7,0.56,112,119,7,19
57,seq17,seq68,r_126_0_109,r_126_0_109,1.0,9,118,109,19
6,r_102_32_60,seq78,seq85,r_102_32_60,1.0,1,61,60,19
62,seq26,r_147_128_62,r_18_53_52,r_18_53_52,0.71,12,64,52,19
27,r_147_128_62,seq68,seq51,r_147_128_62,0.83,-7,55,62,19
21,r_60_20_137,r_125_97_48,r_126_0_109,r_126_0_109,1.0,34,143,109,19
90,seq89,r_81_63_70,seq80,r_81_63_70,1.0,-11,59,70,19
17,r_118_132_54,seq146,seq40,r_118_132_54,1.0,-1,53,54,19
87,seq85,seq43,r_102_32_60,r_102_32_60,1.0,25,85,60,19
39,r_22_82_121,r_62_101_79,r_144_124_87,r_22_82_121,1.0,0,121,121,19
41,r_74_149_169,r_137_140_183,r_76_107_140,r_74_149_169,0.56,0,169,169,19
47,r_42_21_131,r_133_134_186,r_118_132_54,r_42_21_131,0.88,0,131,131,19
0,r_133_134_186,r_55_7_97,r_11_114_185,r_55_7_97,0.95,89,186,97,19
40,r_77_98_88,seq129,seq78,r_77_98_88,1.0,2,90,88,19
8,r_34_24_159,r_38_61_194,r_137_140_183,r_34_24_159,0.86,25,184,159,19
43,r_6_41_177,seq10,r_70_139_10,r_6_41_177,0.72,0,177,177,19
33,r_105_122_95,seq85,seq51,r_105_122_95,0.63,2,97,95,19
88,seq86,r_33_135_86,seq10,r_33_135_86,1.0,1,87,86,19
37,r_31_143_7,r_147_128_62,r_16_148_125,r_147_128_62,0.95,4,66,62,19
32,r_66_19_2,r_99_12_164,r_81_63_70,r_81_63_70,0.96,96,166,70,19
38,r_81_63_70,seq89,seq68,r_81_63_70,1.0,-1,69,70,19
52,seq145,r_115_130_36,r_46_109_65,r_46_109_65,1.0,-1,64,65,19
34,r_4_64_141,r_99_12_164,seq111,r_4_64_141,0.77,0,141,141,19
2,r_18_53_52,seq35,seq26,r_18_53_52,0.98,0,52,52,19
81,seq71,r_133_134_186,r_125_97_48,r_125_97_48,0.99,31,79,48,19
25,r_125_97_48,r_60_20_137,r_55_7_97,r_55_7_97,0.87,46,143,97,19
94,seq108,r_11_114_185,r_147_128_62,r_11_114_185,0.67,0,185,185,19
9,r_90_37_75,r_93_96_50,seq23,r_90_37_75,0.96,-1,74,75,19
31,r_93_96_50,r_110_67_61,seq52,r_110_67_61,0.92,-10,51,61,19
28,r_62_101_79,r_126_0_109,r_22_82_121,r_62_101_79,0.95,0,79,79,19
49,r_100_36_83,seq79,seq51,r_100_36_83,1.0,2,85,83,19
7,r_8_29_154,seq28,r_144_124_87,r_8_29_154,0.63,1,155,154,19
18,r_94_95_34,r_137_140_183,r_73_106_94,r_73_106_94,1.0,10,104,94,19
99,seq127,seq85,r_142_112_55,r_142_112_55,0.84,-2,53,55,19
44,r_113_65_107,seq3,seq35,r_113_65_107,1.0,0,107,107,19
41,r_74_149_169,r_75_141_89,r_137_140_183,r_75_141_89,0.98,-34,55,89,19
12,r_38_61_194,seq15,r_34_24_159,r_34_24_159,0.87,1,160,159,19
30,r_110_88_65,r_120_86_178,seq76,r_110_88_65,0.88,11,76,65,20
44,r_16_113_140,r_52_11_37,seq14,r_16_113_140,0.96,0,140,140,20
4,r_85_84_27,r_147_38_40,seq102,r_85_84_27,0.82,2,29,27,20
27,r_129_119_104,seq15,seq7,r_129_119_104,0.99,0,104,104,20
53,seq6,r_1_101_129,seq14,r_1_101_129,1.0,-17,112,129,20
43,r_72_94_74,r_87_80_108,r_93_56_64,r_72_94_74,1.0,0,74,74,20
54,seq7,r_87_80_108,r_129_119_104,r_129_119_104,1.0,14,118,104,20
37,r_92_60_89,r_39_111_124,r_35_22_199,r_92_60_89,0.99,1,90,89,20
21,r_87_80_108,seq7,seq33,r_87_80_108,0.53,10,118,108,20
1,r_34_41_97,r_55_74_174,seq134,r_34_41_97,0.93,2,99,97,20
97,seq136,seq6,r_85_84_27,r_85_84_27,0.66,79,106,27,20
22,r_107_36_35,r_115_20_157,seq144,r_107_36_35,0.98,0,35,35,20
5,r_96_3_182,seq7,seq132,r_96_3_182,0.27,2,184,182,20
46,r_58_122_168,seq73,r_16_113_140,r_58_122_168,0.23,15,183,168,20
42,r_35_22_199,r_34_41_97,r_92_60_89,r_92_60_89,0.82,10,99,89,20
80,seq73,r_58_122_168,r_142_19_81,r_142_19_81,0.99,20,101,81,20
19,r_97_126_61,r_39_111_124,seq123,r_39_111_124,0.79,-57,67,124,20
11,r_52_11_37,r_29_13_38,seq90,r_52_11_37,0.98,0,37,37,20
18,r_147_38_40,r_28_95_3,seq75,r_147_38_40,0.99,3,43,40,20
25,r_27_42_14,r_99_40_167,seq106,r_27_42_14,0.92,0,14,14,20
31,r_39_111_124,r_97_126_61,seq146,r_39_111_124,0.56,4,128,124,20
24,r_65_9_55,seq50,r_85_84_27,r_65_9_55,0.99,0,55,55,20
10,r_5_62_78,r_129_119_104,r_24_2_198,r_5_62_78,0.97,-3,75,78,20
16,r_115_20_157,r_16_113_140,r_32_131_123,r_115_20_157,0.65,-34,123,157,20
7,r_47_128_44,seq76,seq114,r_47_128_44,0.87,13,57,44,20
0,r_99_40_167,r_53_66_59,r_147_38_40,r_99_40_167,0.69,0,167,167,20
26,r_103_125_52,r_43_61_144,r_29_13_38,r_103_125_52,1.0,-1,51,52,20
15,r_117_140_72,r_16_113_140,seq148,r_117_140_72,0.98,0,72,72,20
48,r_68_45_82,seq12,seq106,r_68_45_82,0.99,1,83,82,20
6,r_43_61_144,seq146,seq102,r_43_61_144,0.53,5,149,144,20
62,seq17,r_87_80_108,r_141_59_43,r_141_59_43,0.98,23,66,43,20
70,seq134,r_24_2_198,r_34_41_97,r_34_41_97,0.56,2,99,97,20
85,seq82,r_32_131_123,seq30,r_32_131_123,0.89,0,123,123,20
9,r_44_100_114,seq15,r_115_20_157,r_115_20_157,1.0,0,157,157,20
8,r_69_127_45,r_93_56_64,seq133,r_69_127_45,1.0,0,45,45,20
27,r_129_119_104,r_5_62_78,seq15,r_5_62_78,0.99,-2,76,78,20
3,r_32_131_123,r_115_20_157,r_93_56_64,r_115_20_157,0.89,1,158,157,20
40,r_139_79_160,r_28_95_3,r_47_128_44,r_28_95_3,0.49,157,160,3,20
16,r_115_20_157,r_32_131_123,r_44_100_114,r_115_20_157,0.99,1,158,157,20
33,r_93_56_64,seq134,r_72_94_74,r_93_56_64,0.97,4,68,64,20
64,seq148,seq25,r_117_140_72,r_117_140_72,1.0,19,91,72,20
47,r_31_67_32,r_112_71_116,r_77_18_99,r_31_67_32,1.0,84,116,32,20
29,r_112_71_116,r_130_135_46,r_31_67_32,r_112_71_116,0.95,-81,35,116,20
70,seq134,r_93_56_64,r_24_2_198,r_93_56_64,0.89,4,68,64,20
65,seq21,r_120_86_178,r_92_60_89,r_92_60_89,0.92,93,182,89,20
2,r_23_124_23,r_43_61_144,seq7,r_23_124_23,0.92,-1,22,23,20
32,r_116_145_145,seq26,seq64,r_116_145_145,0.75,-3,142,145,20
41,r_63_91_34,r_52_11_37,seq143,r_63_91_34,0.96,1,35,34,20
47,r_31_67_32,r_77_18_99,r_112_71_116,r_31_67_32,0.92,1,33,32,20
36,r_29_13_38,r_52_11_37,seq123,r_29_13_38,1.0,-1,37,38,20
81,seq75,seq70,r_147_38_40,r_147_38_40,1.0,82,122,40,20
17,r_1_101_129,seq6,seq12,r_1_101_129,0.62,0,129,129,20
9,r_44_100_114,seq64,seq15,r_44_100_114,0.94,3,117,114,20
16,r_115_20_157,r_107_36_35,r_16_113_140,r_107_36_35,0.87,0,35,35,20
29,r_112_71_116,r_31_67_32,r_129_119_104,r_112_71_116,0.99,0,116,116,20
28,r_120_86_178,seq21,seq82,r_120_86_178,0.35,4,182,178,20
44,r_16_113_140,r_117_140_72,r_52_11_37,r_117_140_72,0.75,0,72,72,20
23,r_142_19_81,r_44_100_114,seq73,r_142_19_81,0.65,0,81,81,20
14,r_130_135_46,seq108,r_47_128_44,r_130_135_46,0.93,8,54,46,20
12,r_98_48_86,seq102,seq30,r_98_48_86,0.89,33,119,86,20
45,r_141_59_43,r_44_100_114,seq17,r_141_59_43,1.0,1,44,43,20
93,seq111,r_137_81_173,r_120_41_88,r_120_41_88,1.0,19,107,88,21
14,r_95_97_126,seq8,seq1,r_95_97_126,0.91,0,126,126,21
9,r_147_87_29,r_32_24_38,r_91_37_128,r_91_37_128,1.0,0,128,128,21
43,r_109_144_151,r_36_90_181,seq30,r_109_144_151,0.96,0,151,151,21
37,r_106_18_156,seq14,r_32_24_38,r_32_24_38,0.47,118,156,38,21
55,seq10,r_110_73_90,r_100_48_154,r_110_73_90,0.96,1,91,90,21
46,r_138_47_115,seq68,seq131,r_138_47_115,0.95,0,115,115,21
42,r_110_73_90,seq10,seq125,r_110_73_90,0.99,0,90,90,21
69,seq30,r_65_51_105,r_75_43_172,r_65_51_105,1.0,0,105,105,21
2,r_83_129_10,r_71_22_48,r_58_3_192,r_58_3_192,0.89,-182,10,192,21
45,r_114_149_133,r_44_104_168,r_20_12_125,r_114_149_133,0.99,0,133,133,21
16,r_118_45_23,r_20_12_125,seq42,r_118_45_23,0.69,1,24,23,21
36,r_32_24_38,r_106_18_156,r_147_87_29,r_32_24_38,0.84,0,38,38,21
87,seq78,r_20_12_125,r_34_108_56,r_34_108_56,0.99,0,56,56,21
19,r_11_98_145,seq27,seq16,r_11_98_145,0.98,1,146,145,21
33,r_133_116_49,seq145,seq68,r_133_116_49,0.61,70,119,49,21
31,r_107_146_153,seq1,seq68,r_107_146_153,0.56,2,155,153,21
41,r_79_69_142,seq26,r_110_73_90,r_79_69_142,0.93,5,147,142,21
3,r_137_81_173,seq111,r_9_6_43,r_9_6_43,1.0,119,162,43,21
10,r_120_41_88,r_28_60_116,seq111,r_120_41_88,1.0,0,88,88,21
26,r_102_33_106,r_72_124_166,r_65_51_105,r_102_33_106,1.0,2,108,106,21
4,r_139_59_148,r_36_90_181,seq136,r_139_59_148,0.97,0,148,148,21
0,r_91_37_128,seq30,r_147_87_29,r_91_37_128,0.71,0,128,128,21
11,r_115_123_103,seq50,r_56_15_104,r_115_123_103,1.0,1,104,103,21
13,r_36_90_181,seq42,r_142_128_87,r_142_128_87,1.0,94,181,87,21
15,r_142_128_87,r_58_3_192,seq21,r_142_128_87,1.0,1,88,87,21
48,r_105_92_109,seq17,r_32_24_38,r_105_92_109,0.99,0,109,109,21
30,r_63_134_17,r_72_124_166,seq4,r_63_134_17,1.0,0,17,17,21
33,r_133_116_49,r_139_59_148,seq145,r_133_116_49,1.0,1,50,49,21
36,r_32_24_38,r_147_87_29,r_105_92_109,r_105_92_109,1.0,16,125,109,21
69,seq30,r_75_43_172,r_109_144_151,r_109_144_151,0.92,18,169,151,21
47,r_44_104_168,seq4,r_142_128_87,r_44_104_168,0.5,0,168,168,21
20,r_119_80_46,r_34_108_56,r_83_129_10,r_83_129_10,0.98,36,46,10,21
9,r_147_87_29,r_138_47_115,r_32_24_38,r_147_87_29,0.57,38,67,29,21
40,r_53_101_155,r_54_74_189,seq23,r_53_101_155,0.76,1,156,155,21
18,r_64_96_160,seq27,seq148,r_64_96_160,0.88,1,161,160,21
29,r_28_60_116,seq125,seq10,r_28_60_116,0.99,0,116,116,21
24,r_89_93_131,r_79_69_142,seq4,r_89_93_131,1.0,0,131,131,21
21,r_58_3_192,r_139_59_148,r_83_129_10,r_58_3_192,0.86,-182,10,192,21
25,r_67_127_158,seq27,r_0_112_3,r_0_112_3,0.84,155,158,3,21
39,r_62_7_33,r_9_6_43,seq29,r_62_7_33,0.99,-3,30,33,21
1,r_34_108_56,r_115_123_103,seq78,r_34_108_56,1.0,0,56,56,21
38,r_85_130_137,seq25,r_95_97_126,r_85_130_137,0.81,0,137,137,21
6,r_141_88_40,r_89_93_131,seq27,r_141_88_40,1.0,0,40,40,21
17,r_65_51_105,seq30,r_71_22_48,r_65_51_105,1.0,0,105,105,21
94,seq136,seq143,r_139_59_148,r_139_59_148,1.0,4,152,148,21
9,r_147_87_29,seq46,r_138_47_115,r_147_87_29,1.0,0,29,29,21
28,r_2_135_97,r_115_123_103,r_120_41_88,r_115_123_103,1.0,-6,97,103,21
67,seq27,r_64_96_160,r_141_88_40,r_141_88_40,1.0,0,40,40,21
7,r_56_15_104,seq17,seq143,r_56_15_104,0.96,1,105,104,21
44,r_20_12_125,seq78,r_114_149_133,r_20_12_125,0.59,9,134,125,21
23,r_54_74_189,seq99,r_120_41_88,r_120_41_88,0.96,101,189,88,21
35,r_5_57_150,seq25,seq14,r_5_57_150,0.83,0,150,150,21
12,r_100_48_154,seq42,r_83_129_10,r_100_48_154,0.57,3,157,154,21
36,r_27_96_179,seq74,r_89_61_30,r_89_61_30,1.0,38,68,30,22
9,r_114_23_51,r_12_28_143,r_10_118_99,r_114_23_51,0.63,95,146,51,22
2,r_26_103_27,seq11,seq30,r_26_103_27,1.0,0,27,27,22
8,r_35_120_130,r_141_133_142,r_134_115_104,r_35_120_130,1.0,2,132,130,22
18,r_17_119_180,r_67_29_34,r_53_31_26,r_17_119_180,0.86,-146,34,180,22
54,seq135,seq111,r_113_51_102,r_113_51_102,1.0,30,132,102,22
83,seq90,r_106_108_150,r_81_1_59,r_81_1_59,0.99,94,153,59,22
37,r_10_118_99,seq140,r_68_72_195,r_10_118_99,0.8,0,99,99,22
86,seq95,r_0_54_184,r_35_120_130,r_35_120_130,0.92,54,184,130,22
16,r_68_72_195,r_21_76_91,r_10_118_99,r_68_72_195,0.54,-102,93,195,22
39,r_97_34_185,seq16,r_22_39_156,r_22_39_156,0.78,29,185,156,22
1,r_71_49_137,seq92,r_148_43_17,r_71_49_137,0.63,0,137,137,22
97,seq121,r_48_73_158,r_35_120_130,r_48_73_158,0.54,1,159,158,22
46,r_99_123_97,seq135,seq16,r_99_123_97,1.0,0,97,97,22
42,r_4_79_168,seq84,seq88,r_4_79_168,0.71,0,168,168,22
7,r_25_47_174,r_134_115_104,r_22_39_156,r_134_115_104,1.0,-49,55,104,22
7,r_25_47_174,r_22_39_156,r_71_49_137,r_25_47_174,0.81,-18,156,174,22
15,r_89_61_30,r_27_96_179,seq149,r_27_96_179,0.99,0,179,179,22
30,r_81_1_59,seq20,r_77_59_4,r_81_1_59,1.0,0,59,59,22
27,r_136_138_19,r_38_145_87,seq137,r_136_138_19,0.9,0,19,19,22
15,r_89_61_30,r_99_123_97,r_27_96_179,r_89_61_30,1.0,0,30,30,22
41,r_134_115_104,r_25_47_174,seq52,r_134_115_104,0.99,5,109,104,22
14,r_53_31_26,r_142_24_68,r_17_119_180,r_53_31_26,1.0,0,26,26,22
3,r_18_8_120,r_127_44_167,r_21_76_91,r_18_8_120,0.65,0,120,120,22
10,r_38_145_87,seq149,r_40_57_42,r_40_57_42,1.0,47,89,42,22
44,r_42_15_22,r_94_36_134,seq30,r_42_15_22,0.92,0,22,22,22
26,r_56_116_183,seq110,r_65_70_136,r_65_70_136,1.0,19,155,136,22
47,r_55_9_15,r_106_108_150,seq63,r_55_9_15,1.0,0,15,15,22
14,r_53_31_26,r_17_119_180,seq85,r_17_119_180,0.77,0,180,180,22
4,r_141_133_142,r_80_5_141,seq137,r_141_133_142,0.81,0,142,142,22
11,r_127_44_167,seq147,r_21_76_91,r_127_44_167,0.71,0,167,167,22
20,r_94_36_134,seq87,r_113_51_102,r_113_51_102,0.97,32,134,102,22
48,r_58_19_145,r_27_96_179,seq45,r_58_19_145,0.44,0,145,145,22
13,r_78_122_32,seq33,r_17_119_180,r_17_119_180,0.79,5,185,180,22
6,r_22_39_156,r_25_47_174,seq112,r_22_39_156,0.84,0,156,156,22
85,seq93,r_113_51_102,seq11,r_113_51_102,0.99,-28,74,102,22
43,r_12_28_143,r_114_23_51,r_32_3_36,r_12_28_143,0.99,0,143,143,22
5,r_21_76_91,r_12_28_143,r_142_24_68,r_21_76_91,0.98,2,93,91,22
0,r_77_59_4,seq37,r_81_1_59,r_81_1_59,1.0,8,67,59,22
36,r_27_96_179,r_89_61_30,seq11,r_89_61_30,0.54,149,179,30,22
34,r_75_98_45,r_99_123_97,r_26_103_27,r_75_98_45,0.99,2,47,45,22
19,r_32_3_36,seq52,r_125_64_189,r_32_3_36,0.62,6,42,36,22
22,r_65_70_136,r_56_116_183,r_25_47_174,r_65_70_136,0.87,47,183,136,22
35,r_67_29_34,r_17_119_180,seq37,r_67_29_34,1.0,0,34,34,22
96,seq112,r_40_57_42,r_71_49_137,r_40_57_42,1.0,3,45,42,22
40,r_125_64_189,seq139,r_32_3_36,r_32_3_36,0.54,53,89,36,22
29,r_46_107_107,seq37,r_117_128_86,r_117_128_86,0.67,-19,67,86,22
17,r_148_43_17,seq30,seq104,r_148_43_17,0.99,0,17,17,22
26,r_56_116_183,r_65_70_136,r_78_122_32,r_56_116_183,0.84,0,183,183,22
43,r_12_28_143,r_71_49_137,r_21_76_91,r_21_76_91,0.61,-60,31,91,22
5,r_21_76_91,r_78_122_32,r_12_28_143,r_21_76_91,0.62,-63,28,91,22
25,r_113_51_102,seq93,seq135,r_113_51_102,1.0,0,102,102,22
33,r_117_128_86,r_141_133_142,r_82_91_126,r_117_128_86,0.55,50,136,86,22
32,r_0_54_184,seq95,r_77_59_4,r_0_54_184,0.24,0,184,184,22
38,r_50_69_94,seq16,seq130,r_50_69_94,1.0,0,94,94,22
9,r_114_23_51,r_82_91_126,r_12_28_143,r_114_23_51,0.98,0,51,51,22
7,r_25_47_174,r_71_49_137,r_65_70_136,r_25_47_174,0.87,0,174,174,22
60,seq16,r_97_34_185,r_99_123_97,r_99_123_97,1.0,57,154,97,22
81,seq87,r_94_36_134,seq60,r_94_36_134,0.8,8,142,134,22
45,r_40_57_42,seq112,r_38_145_87,r_40_57_42,1.0,0,42,42,22
22,r_65_70_136,seq104,r_56_116_183,r_65_70_136,0.96,1,137,136,22
28,r_80_5_141,r_141_133_142,seq140,r_80_5_141,0.56,0,141,141,22
49,r_82_91_126,seq84,r_117_128_86,r_82_91_126,0.73,0,126,126,22
73,seq63,r_38_145_87,r_55_9_15,r_55_9_15,1.0,0,15,15,22
56,seq11,r_25_47_174,r_27_96_179,r_27_96_179,0.64,0,179,179,22
18,r_17_119_180,r_53_31_26,r_78_122_32,r_17_119_180,0.85,0,180,180,22
23,r_14_6_74,r_27_96_179,r_32_3_36,r_14_6_74,1.0,0,74,74,22
29,r_46_107_107,r_117_128_86,r_26_103_27,r_46_107_107,1.0,0,107,107,22
79,seq85,r_17_119_180,r_53_31_26,r_53_31_26,0.73,124,150,26,22
12,r_48_73_158,seq121,r_77_59_4,r_48_73_158,0.65,1,159,158,22
43,r_12_28_143,r_21_76_91,r_114_23_51,r_12_28_143,0.71,-67,76,143,22
84,seq92,r_71_49_137,seq112,r_71_49_137,0.95,0,137,137,22
4,r_58_22_22,r_34_121_155,seq78,r_58_22_22,0.98,0,22,22,23
30,r_148_119_89,seq124,seq135,r_148_119_89,0.9,0,89,89,23
36,r_48_6_65,seq135,r_92_38_44,r_48_6_65,1.0,0,65,65,23
43,r_55_15_95,seq115,seq127,r_55_15_95,1.0,0,95,95,23
37,r_59_84_128,r_97_19_131,seq17,r_97_19_131,0.83,-3,128,131,23
59,seq143,r_146_53_125,r_149_25_86,r_149_25_86,1.0,7,93,86,23
71,seq42,r_65_125_88,seq28,r_65_125_88,1.0,2,90,88,23
16,r_131_35_68,seq24,seq23,r_131_35_68,0.9,4,72,68,23
21,r_111_109_72,r_146_53_125,r_49_108_67,r_111_109_72,0.53,0,72,72,23
39,r_138_74_129,r_147_81_135,r_131_35_68,r_138_74_129,0.81,8,137,129,23
1,r_65_125_88,seq42,seq141,r_65_125_88,0.98,0,88,88,23
87,seq93,r_5_118_163,seq44,r_5_118_163,0.8,-46,117,163,23
46,r_2_57_109,seq115,r_65_125_88,r_2_57_109,0.58,2,111,109,23
42,r_77_51_63,seq13,seq10,r_77_51_63,0.99,0,63,63,23
80,seq78,r_69_11_142,r_58_22_22,r_58_22_22,0.99,125,147,22,23
45,r_97_19_131,r_59_84_128,seq116,r_97_19_131,0.98,0,131,131,23
54,seq10,r_117_50_39,r_111_109_72,r_117_50_39,0.93,0,39,39,23
24,r_117_50_39,seq124,r_111_109_72,r_111_109_72,1.0,29,101,72,23
19,r_7_41_102,seq115,r_131_35_68,r_7_41_102,1.0,-1,101,102,23
38,r_27_75_162,r_29_130_46,r_5_118_163,r_27_75_162,0.51,1,163,162,23
31,r_144_129_47,r_52_21_115,seq32,r_144_129_47,0.74,16,63,47,23
41,r_87_145_94,seq93,seq56,r_87_145_94,1.0,1,95,94,23
67,seq31,r_34_121_155,seq28,r_34_121_155,0.99,0,155,155,23
12,r_66_85_27,r_34_121_155,r_147_81_135,r_66_85_27,1.0,0,27,27,23
89,seq100,r_97_19_131,r_106_73_99,r_97_19_131,0.69,0,131,131,23
3,r_5_118_163,seq113,r_27_75_162,r_27_75_162,0.68,1,163,162,23
26,r_16_98_188,seq132,r_12_4_132,r_12_4_132,0.83,57,189,132,23
0,r_12_4_132,seq70,r_8_0_130,r_8_0_130,0.62,2,132,130,23
11,r_110_67_110,r_147_81_135,seq132,r_110_67_110,0.97,1,111,110,23
20,r_147_81_135,r_138_74_129,r_2_57_109,r_147_81_135,0.53,2,137,135,23
5,r_90_107_34,seq71,seq100,r_90_107_34,0.81,13,47,34,23
13,r_133_1_141,seq37,r_106_73_99,r_133_1_141,0.54,0,141,141,23
15,r_3_40_160,seq142,r_123_94_36,r_3_40_160,0.74,0,160,160,23
48,r_54_122_80,seq114,seq32,r_54_122_80,0.9,8,88,80,23
40,r_92_38_44,r_34_121_155,seq71,r_92_38_44,0.75,0,44,44,23
12,r_66_85_27,r_147_81_135,r_36_14_139,r_66_85_27,0.72,112,139,27,23
36,r_48_6_65,r_92_38_44,r_52_21_115,r_52_21_115,1.0,41,156,115,23
27,r_8_0_130,seq128,r_12_4_132,r_8_0_130,0.96,0,130,130,23
29,r_36_14_139,seq137,r_66_85_27,r_36_14_139,0.81,0,139,139,23
25,r_18_68_62,seq104,seq137,r_18_68_62,0.66,25,87,62,23
6,r_61_45_23,seq31,seq112,r_61_45_23,0.92,2,25,23,23
32,r_49_108_67,seq140,r_117_50_39,r_49_108_67,0.93,0,67,67,23
38,r_27_75_162,r_76_120_69,r_29_130_46,r_27_75_162,0.65,-90,72,162,23
18,r_29_130_46,seq72,seq140,r_29_130_46,0.99,0,46,46,23
60,seq17,r_79_105_184,r_59_84_128,r_59_84_128,0.78,28,156,128,23
81,seq141,r_134_47_87,r_65_125_88,r_65_125_88,1.0,3,91,88,23
94,seq114,r_54_122_80,seq143,r_54_122_80,1.0,0,80,80,23
79,seq72,r_29_130_46,seq28,r_29_130_46,0.79,1,47,46,23
28,r_136_99_84,r_134_47_87,seq44,r_136_99_84,1.0,1,85,84,23
49,r_52_21_115,r_69_11_142,r_48_6_65,r_69_11_142,0.85,-27,115,142,23
8,r_123_94_36,r_146_53_125,seq112,r_123_94_36,0.9,2,38,36,23
44,r_149_25_86,r_110_67_110,seq143,r_149_25_86,0.93,0,86,86,23
23,r_46_43_111,seq70,r_117_50_39,r_46_43_111,0.84,0,111,111,23
35,r_76_120_69,r_52_21_115,seq89,r_76_120_69,0.97,0,69,69,23
24,r_117_50_39,seq10,seq124,r_117_50_39,0.99,0,39,39,23
30,r_49_142_84,seq89,seq116,r_49_142_84,1.0,0,84,84,24
36,r_58_11_140,r_140_85_125,r_93_134_34,r_93_134_34,0.78,53,87,34,24
53,seq132,seq47,r_19_23_100,r_19_23_100,1.0,27,127,100,24
43,r_57_137_123,seq123,seq106,r_57_137_123,0.97,0,123,123,24
37,r_54_127_107,seq131,seq2,r_54_127_107,1.0,0,107,107,24
55,seq135,seq147,r_148_3_79,r_148_3_79,1.0,0,79,79,24
86,seq95,r_37_141_115,seq15,r_37_141_115,1.0,-15,100,115,24
21,r_16_139_106,seq106,r_60_20_23,r_16_139_106,0.67,13,119,106,24
39,r_117_4_96,seq106,r_49_142_84,r_117_4_96,0.97,0,96,96,24
1,r_28_130_90,r_55_65_153,seq25,r_28_130_90,0.99,1,91,90,24
5,r_66_31_179,seq135,r_57_137_123,r_66_31_179,0.38,0,179,179,24
42,r_41_108_180,seq35,r_58_11_140,r_58_11_140,0.86,42,182,140,24
16,r_99_67_13,r_46_77_141,seq123,r_99_67_13,0.94,0,13,13,24
32,r_37_141_115,seq15,seq6,r_37_141_115,0.98,0,115,115,24
19,r_51_64_158,seq120,seq114,r_51_64_158,0.89,1,159,158,24
52,seq131,r_54_127_107,seq47,r_54_127_107,0.95,-64,43,107,24
11,r_88_104_30,seq74,seq147,r_88_104_30,0.69,-8,22,30,24
32,r_37_141_115,r_61_0_54,seq15,r_61_0_54,1.0,0,54,54,24
41,r_109_18_187,seq135,r_93_134_34,r_93_134_34,0.65,153,187,34,24
3,r_148_3_79,seq89,seq135,r_148_3_79,0.98,1,80,79,24
26,r_79_90_124,seq146,seq147,r_79_90_124,0.86,1,125,124,24
72,seq44,r_92_86_157,seq32,r_92_86_157,1.0,0,157,157,24
4,r_133_125_176,r_41_108_180,r_99_67_13,r_99_67_13,0.93,163,176,13,24
25,r_61_0_54,r_37_141_115,r_1_33_49,r_61_0_54,0.99,0,54,54,24
0,r_126_98_128,seq114,seq32,r_126_98_128,0.97,0,128,128,24
45,r_149_105_167,r_93_134_34,seq89,r_93_134_34,1.0,1,35,34,24
63,seq146,r_79_90_124,seq145,r_79_90_124,0.99,-35,89,124,24
73,seq47,seq132,r_138_118_118,r_138_118_118,1.0,9,127,118,24
13,r_7_59_33,r_113_53_194,r_37_141_115,r_37_141_115,0.99,26,141,115,24
15,r_78_87_117,seq21,seq72,r_78_87_117,0.99,0,117,117,24
40,r_55_65_153,seq95,r_82_29_75,r_55_65_153,0.59,-32,121,153,24
48,r_19_23_100,seq106,seq132,r_19_23_100,1.0,0,100,100,24
10,r_93_134_34,r_58_11_140,r_78_87_117,r_78_87_117,0.51,24,141,117,24
27,r_84_34_163,r_121_71_31,seq102,r_121_71_31,0.29,134,165,31,24
36,r_58_11_140,r_93_134_34,seq147,r_58_11_140,0.99,0,140,140,24
29,r_1_33_49,seq136,seq72,r_1_33_49,1.0,0,49,49,24
22,r_82_29_75,r_55_65_153,r_62_69_134,r_62_69_134,0.99,38,172,134,24
2,r_111_122_147,r_92_86_157,seq145,r_111_122_147,0.83,0,147,147,24
47,r_92_86_157,seq44,seq120,r_92_86_157,0.78,0,157,157,24
24,r_83_24_17,r_16_139_106,seq145,r_83_24_17,0.95,0,17,17,24
40,r_55_65_153,r_28_130_90,seq95,r_28_130_90,0.88,1,91,90,24
33,r_100_42_88,seq101,seq119,r_100_42_88,1.0,0,88,88,24
39,r_117_4_96,r_49_142_84,r_140_85_125,r_140_85_125,0.76,15,140,125,24
58,seq10,r_133_125_176,r_80_13_3,r_133_125_176,0.98,-29,147,176,24
38,r_40_75_104,r_58_11_140,seq74,r_40_75_104,0.82,0,104,104,24
40,r_55_65_153,r_82_29_75,r_99_67_13,r_82_29_75,0.5,85,160,75,24
34,r_46_77_141,r_41_108_180,seq12,r_41_108_180,0.66,-35,145,180,24
60,seq15,r_37_141_115,seq95,r_37_141_115,1.0,-15,100,115,24
45,r_149_105_167,seq89,r_84_34_163,r_84_34_163,0.45,4,167,163,24
10,r_93_134_34,r_149_105_167,r_58_11_140,r_93_134_34,1.0,1,35,34,24
22,r_82_29_75,r_26_17_184,r_55_65_153,r_82_29_75,1.0,0,75,75,24
28,r_62_69_134,seq119,r_82_29_75,r_62_69_134,0.97,1,135,134,24
49,r_56_129_62,r_66_31_179,r_99_67_13,r_56_129_62,1.0,0,62,62,24
7,r_14_8_177,seq47,r_93_134_34,r_93_134_34,0.62,143,177,34,24
44,r_143_43_68,r_126_98_128,seq74,r_143_43_68,1.0,0,68,68,24
23,r_26_17_184,r_82_29_75,seq128,r_82_29_75,1.0,-2,73,75,24
35,r_39_27_91,seq106,r_107_45_2,r_39_27_91,0.98,1,92,91,24
12,r_138_118_118,r_7_59_33,seq47,r_138_118_118,0.99,0,118,118,24
30,r_59_127_87,seq135,seq102,r_59_127_87,0.99,0,87,87,25
44,r_106_37_24,r_28_55_170,r_69_108_46,r_69_108_46,0.85,127,173,46,25
51,seq135,r_59_127_87,r_118_80_9,r_59_127_87,1.0,-9,78,87,25
14,r_0_35_188,seq101,r_26_18_18,r_26_18_18,0.86,171,189,18,25
8,r_24_125_179,seq22,r_88_128_5,r_24_125_179,0.36,1,180,179,25
88,seq96,r_28_55_170,r_139_133_19,r_139_133_19,0.99,-3,16,19,25
37,r_112_110_58,r_47_39_93,seq42,r_47_39_93,0.9,-32,61,93,25
1,r_69_108_46,seq12,r_139_133_19,r_69_108_46,1.0,0,46,46,25
23,r_111_141_33,seq91,seq70,r_111_141_33,1.0,-1,32,33,25
21,r_14_23_161,seq34,r_89_33_32,r_14_23_161,0.59,-1,160,161,25
32,r_68_119_193,r_28_55_170,r_139_133_19,r_68_119_193,0.84,-143,50,193,25
46,r_118_80_9,seq10,r_73_15_108,r_73_15_108,1.0,15,123,108,25
10,r_26_18_18,r_114_8_83,seq122,r_26_18_18,1.0,0,18,18,25
39,r_89_33_32,r_47_39_93,seq43,r_89_33_32,0.92,0,32,32,25
19,r_48_105_189,seq10,r_129_76_127,r_129_76_127,0.9,62,189,127,25
76,seq140,r_103_54_155,r_114_8_83,r_114_8_83,0.56,17,100,83,25
31,r_99_58_135,r_47_39_93,r_44_85_51,r_99_58_135,0.97,-71,64,135,25
44,r_106_37_24,r_97_84_173,r_28_55_170,r_106_37_24,0.95,0,24,24,25
90,seq101,r_2_32_178,r_27_6_81,r_27_6_81,1.0,97,178,81,25
17,r_138_52_12,r_24_125_179,seq34,r_138_52_12,0.98,0,12,12,25
12,r_44_85_51,seq116,r_99_58_135,r_44_85_51,1.0,0,51,51,25
4,r_16_100_132,seq102,seq149,r_16_100_132,0.64,0,132,132,25
0,r_142_36_75,r_31_67_154,seq29,r_142_36_75,1.0,1,76,75,25
73,seq64,r_71_72_97,r_93_51_41,r_93_51_41,0.76,23,64,41,25
20,r_73_15_108,seq146,r_118_80_9,r_73_15_108,0.99,0,108,108,25
5,r_4_25_42,r_27_6_81,seq34,r_4_25_42,0.93,5,47,42,25
15,r_129_76_127,seq30,seq137,r_129_76_127,1.0,0,127,127,25
48,r_20_82_79,seq65,seq145,r_20_82_79,1.0,0,79,79,25
26,r_61_57_31,r_142_36_75,seq50,r_61_57_31,0.71,0,31,31,25
12,r_44_85_51,r_99_58_135,seq122,r_99_58_135,1.0,0,135,135,25
62,seq29,seq143,r_142_36_75,r_142_36_75,1.0,25,100,75,25
99,seq123,seq94,r_130_13_50,r_130_13_50,0.93,7,57,50,25
27,r_71_72_97,seq64,seq49,r_71_72_97,0.57,0,97,97,25
9,r_139_133_19,seq45,seq96,r_139_133_19,0.92,1,20,19,25
34,r_27_6_81,r_4_25_42,seq104,r_27_6_81,0.72,-31,50,81,25
87,seq95,r_87_21_191,r_19_147_131,r_19_147_131,0.47,3,134,131,25
6,r_130_13_50,r_87_21_191,seq123,r_130_13_50,1.0,0,50,50,25
2,r_3_5_101,seq50,seq74,r_3_5_101,0.91,-1,100,101,25
47,r_97_84_173,seq70,r_47_39_93,r_47_39_93,0.98,85,178,93,25
67,seq43,seq145,r_89_33_32,r_89_33_32,1.0,14,46,32,25
40,r_38_134_163,r_131_40_184,r_99_58_135,r_38_134_163,0.7,0,163,163,25
18,r_31_67_154,seq74,seq42,r_31_67_154,0.86,0,154,154,25
29,r_126_11_145,seq122,seq10,r_126_11_145,0.59,2,147,145,25
25,r_2_32_178,seq101,r_26_18_18,r_26_18_18,0.62,160,178,18,25
42,r_28_55_170,r_106_37_24,seq146,r_106_37_24,0.56,149,173,24,25
61,seq22,r_24_125_179,seq65,r_24_125_179,0.71,1,180,179,25
98,seq122,r_126_11_145,r_26_18_18,r_26_18_18,0.89,15,33,18,25
75,seq70,r_97_84_173,r_111_141_33,r_111_141_33,1.0,145,178,33,25
13,r_83_124_136,seq137,r_130_13_50,r_83_124_136,0.75,0,136,136,25
11,r_46_9_15,r_142_36_75,seq94,r_46_9_15,0.66,5,20,15,25
31,r_99_58_135,r_44_85_51,r_38_134_163,r_99_58_135,0.98,19,154,135,25
22,r_107_63_134,r_14_23_161,seq60,r_107_63_134,0.98,0,134,134,25
28,r_47_39_93,r_99_58_135,seq53,r_47_39_93,1.0,0,93,93,25
49,r_114_8_83,seq132,seq140,r_114_8_83,1.0,0,83,83,25
41,r_144_7_29,r_24_125_179,seq95,r_144_7_29,1.0,0,29,29,25
86,seq94,seq123,r_46_9_15,r_46_9_15,0.95,1,16,15,25
7,r_19_147_131,r_131_40_184,seq95,r_19_147_131,0.75,3,134,131,25
42,r_28_55_170,r_68_119_193,r_106_37_24,r_106_37_24,0.78,26,50,24,25
34,r_27_6_81,seq104,seq101,r_27_6_81,0.97,0,81,81,25
40,r_25_110_169,r_135_108_42,r_11_12_189,r_25_110_169,0.79,0,169,169,26
36,r_33_126_179,r_78_112_139,r_11_12_189,r_11_12_189,0.66,-49,140,189,26
14,r_81_28_129,r_88_80_82,r_13_69_180,r_88_80_82,1.0,0,82,82,26
53,seq132,r_10_23_154,r_89_7_157,r_10_23_154,1.0,-6,148,154,26
37,r_64_51_196,r_25_110_169,r_75_115_98,r_75_115_98,0.86,71,169,98,26
16,r_131_111_67,seq114,seq17,r_131_111_67,1.0,0,67,67,26
21,r_145_4_69,r_52_40_173,r_100_8_25,r_145_4_69,0.71,0,69,69,26
1,r_83_1_9,r_43_134_88,seq53,r_43_134_88,0.96,3,91,88,26
46,r_70_54_93,seq29,r_131_111_67,r_131_111_67,1.0,28,95,67,26
42,r_87_147_171,seq86,r_143_102_70,r_143_102_70,0.98,101,171,70,26
3,r_75_115_98,r_27_96_193,r_60_37_87,r_75_115_98,1.0,-1,97,98,26
10,r_45_109_74,seq3,seq50,r_45_109_74,1.0,0,74,74,26
26,r_13_69_180,r_81_28_129,seq94,r_81_28_129,0.99,1,130,129,26
41,r_2_122_55,seq97,seq94,r_2_122_55,1.0,1,56,55,26
13,r_100_8_25,r_91_61_145,seq19,r_100_8_25,1.0,0,25,25,26
11,r_6_149_152,seq68,r_78_112_139,r_6_149_152,0.78,0,152,152,26
99,seq125,r_36_47_194,r_38_73_15,r_38_73_15,0.45,143,158,15,26
1,r_83_1_9,seq53,r_99_120_161,r_99_120_161,0.99,7,168,161,26
57,seq139,r_60_37_87,r_107_21_56,r_60_37_87,1.0,0,87,87,26
45,r_135_108_42,seq34,r_25_110_169,r_135_108_42,0.99,-2,40,42,26
87,seq90,seq19,r_43_134_88,r_43_134_88,1.0,7,95,88,26
30,r_107_21_56,r_87_147_171,seq129,r_107_21_56,0.57,1,57,56,26
2,r_143_102_70,seq71,r_58_20_11,r_143_102_70,1.0,1,71,70,26
47,r_10_23_154,seq132,seq117,r_10_23_154,0.76,0,154,154,26
14,r_81_28_129,r_13_69_180,r_88_80_82,r_81_28_129,1.0,2,131,129,26
24,r_148_77_89,r_25_110_169,seq71,r_148_77_89,0.91,0,89,89,26
29,r_142_79_17,seq105,r_11_12_189,r_142_79_17,0.96,0,17,17,26
25,r_27_96_193,r_75_115_98,r_143_102_70,r_27_96_193,1.0,-94,99,193,26
33,r_140_26_112,seq117,r_138_144_7,r_140_26_112,1.0,0,112,112,26
58,seq141,seq35,r_88_80_82,r_88_80_82,1.0,17,99,82,26
20,r_43_134_88,r_83_1_9,seq90,r_43_134_88,1.0,0,88,88,26
32,r_0_57_162,seq72,r_43_134_88,r_0_57_162,0.86,0,162,162,26
40,r_25_110_169,r_148_77_89,r_135_108_42,r_25_110_169,0.99,-128,41,169,26
38,r_146_123_99,seq129,r_138_144_7,r_146_123_99,0.99,0,99,99,26
34,r_58_20_11,r_43_134_88,seq34,r_58_20_11,0.66,0,11,11,26
60,seq17,r_91_61_145,r_131_111_67,r_131_111_67,1.0,9,76,67,26
45,r_135_108_42,r_25_110_169,r_75_115_98,r_75_115_98,0.89,71,169,98,26
17,r_44_22_109,r_89_7_157,r_98_121_83,r_89_7_157,0.99,-44,113,157,26
18,r_82_32_53,seq19,r_135_108_42,r_82_32_53,0.56,0,53,53,26
22,r_116_24_159,seq90,r_131_111_67,r_116_24_159,0.6,0,159,159,26
49,r_78_112_139,r_33_126_179,seq71,r_78_112_139,0.42,1,140,139,26
7,r_101_66_164,seq132,seq62,r_101_66_164,0.62,6,170,164,26
44,r_130_127_130,seq17,r_42_39_30,r_130_127_130,0.5,18,148,130,26
35,r_60_37_87,seq139,r_135_108_42,r_60_37_87,1.0,0,87,87,26
30,r_125_26_63,seq107,seq116,r_125_26_63,1.0,0,63,63,27
36,r_33_21_112,seq71,seq137,r_33_21_112,0.93,0,112,112,27
14,r_115_17_49,r_68_4_120,r_7_36_172,r_68_4_120,0.92,-35,85,120,27
8,r_8_5_147,seq23,seq92,r_8_5_147,0.93,0,147,147,27
54,seq6,r_117_69_74,r_49_59_150,r_49_59_150,0.88,8,158,150,27
89,seq92,r_115_17_49,r_8_5_147,r_8_5_147,1.0,3,150,147,27
16,r_63_35_163,r_149_138_179,seq18,r_63_35_163,0.58,1,164,163,27
21,r_61_78_173,r_14_38_116,r_122_97_89,r_61_78_173,0.96,-80,93,173,27
39,r_143_95_91,seq147,seq51,r_143_95_91,1.0,0,91,91,27
24,r_43_145_30,r_8_5_147,seq71,r_8_5_147,0.61,-117,30,147,27
1,r_68_4_120,seq18,seq65,r_68_4_120,1.0,0,120,120,27
5,r_28_24_164,r_118_25_198,seq113,r_28_24_164,0.76,0,164,164,27
45,r_15_31_123,r_124_46_178,r_33_21_112,r_33_21_112,0.63,16,128,112,27
41,r_52_106_26,r_66_30_146,seq107,r_52_106_26,1.0,1,27,26,27
38,r_81_2_161,seq137,seq55,r_81_2_161,0.99,0,161,161,27
31,r_122_97_89,seq51,r_61_78_173,r_122_97_89,0.98,0,89,89,27
17,r_149_138_179,r_28_24_164,seq92,r_149_138_179,1.0,0,179,179,27
89,seq92,r_0_73_124,r_115_17_49,r_0_73_124,0.8,1,125,124,27
3,r_128_102_65,r_117_69_74,r_48_99_10,r_128_102_65,0.53,2,67,65,27
10,r_124_46_178,r_49_59_150,r_79_83_54,r_79_83_54,1.0,96,150,54,27
90,seq96,r_7_36_172,r_12_70_99,r_12_70_99,0.61,73,172,99,27
14,r_115_17_49,r_7_36_172,r_12_70_99,r_7_36_172,0.83,0,172,172,27
78,seq64,r_0_73_124,seq147,r_0_73_124,0.65,-4,120,124,27
0,r_88_10_141,r_63_35_163,seq47,r_88_10_141,0.99,1,142,141,27
20,r_49_59_150,r_124_46_178,seq6,r_49_59_150,0.71,0,150,150,27
13,r_14_38_116,r_61_78_173,r_79_83_54,r_14_38_116,0.74,0,116,116,27
15,r_67_85_105,r_8_5_147,seq9,r_67_85_105,1.0,0,105,105,27
48,r_76_103_95,seq148,seq82,r_76_103_95,1.0,0,95,95,27
57,seq9,seq42,r_67_85_105,r_67_85_105,1.0,45,150,105,27
21,r_61_78_173,r_122_97_89,r_128_102_65,r_61_78_173,0.94,1,174,173,27
2,r_66_30_146,seq137,seq54,r_66_30_146,1.0,1,147,146,27
19,r_27_87_20,r_0_73_124,seq51,r_27_87_20,0.93,0,20,20,27
27,r_146_109_72,r_63_35_163,seq129,r_146_109_72,0.91,0,72,72,27
2,r_66_30_146,r_111_11_86,seq137,r_111_11_86,1.0,-8,78,86,27
47,r_123_84_69,seq135,seq130,r_123_84_69,1.0,0,69,69,27
37,r_48_99_10,r_0_73_124,seq56,r_48_99_10,0.98,0,10,10,27
40,r_111_11_86,r_66_30_146,r_48_99_10,r_111_11_86,0.9,0,86,86,27
18,r_79_83_54,seq58,seq80,r_79_83_54,1.0,0,54,54,27
10,r_124_46_178,r_79_83_54,r_7_36_172,r_124_46_178,0.96,0,178,178,27
25,r_44_112_59,seq113,seq53,r_44_112_59,0.98,1,60,59,27
33,r_114_105_153,seq107,r_45_62_9,r_114_105_153,0.94,1,154,153,27
64,seq23,r_8_5_147,seq58,r_8_5_147,1.0,0,147,147,27
42,r_142_60_15,r_66_30_146,r_33_21_112,r_142_60_15,0.89,117,132,15,27
32,r_20_141_133,r_45_62_9,seq131,r_20_141_133,0.99,0,133,133,27
38,r_81_2_161,r_12_70_99,seq137,r_12_70_99,0.99,0,99,99,27
29,r_50_1_52,r_124_46_178,r_43_145_30,r_50_1_52,1.0,0,52,52,27
34,r_13_98_70,seq71,seq51,r_13_98_70,1.0,0,70,70,27
42,r_142_60_15,r_76_103_95,r_66_30_146,r_142_60_15,0.96,0,15,15,27
17,r_149_138_179,r_63_35_163,r_28_24_164,r_149_138_179,0.45,-15,164,179,27
9,r_74_121_100,r_117_69_74,r_101_37_29,r_74_121_100,1.0,0,100,100,27
96,seq116,r_45_62_9,r_125_26_63,r_125_26_63,1.0,5,68,63,27
31,r_122_97_89,r_61_78_173,r_12_70_99,r_61_78_173,0.59,1,174,173,27
28,r_77_19_181,seq127,r_128_102_65,r_77_19_181,0.6,0,181,181,27
49,r_12_70_99,r_81_2_161,r_122_97_89,r_12_70_99,0.96,0,99,99,27
7,r_45_62_9,r_117_69_74,r_114_105_153,r_114_105_153,1.0,6,159,153,27
23,r_7_36_172,seq96,r_33_21_112,r_7_36_172,0.71,0,172,172,27
22,r_101_37_29,seq41,r_43_145_30,r_101_37_29,0.82,0,29,29,27
12,r_0_73_124,seq92,seq58,r_0_73_124,0.95,1,125,124,27
84,seq82,r_117_69_74,r_76_103_95,r_76_103_95,1.0,64,159,95,27
30,r_136_66_143,r_69_126_183,seq51,r_69_126_183,0.72,-40,143,183,28
36,r_21_81_110,r_32_61_153,seq51,r_21_81_110,0.98,1,111,110,28
9,r_55_10_170,seq137,r_21_81_110,r_55_10_170,0.96,0,170,170,28
5,r_98_74_45,seq85,seq144,r_98_74_45,1.0,0,45,45,28
49,r_131_0_44,seq144,r_37_148_81,r_131_0_44,1.0,0,44,44,28
35,r_34_56_111,r_98_74_45,r_108_43_98,r_34_56_111,0.66,0,111,111,28
16,r_25_110_63,r_69_126_183,seq64,r_25_110_63,1.0,0,63,63,28
21,r_19_52_120,r_146_138_92,r_57_128_179,r_146_138_92,0.97,1,93,92,28
1,r_106_23_101,r_44_4_128,seq85,r_106_23_101,0.99,1,102,101,28
46,r_44_4_128,seq73,r_78_105_106,r_44_4_128,0.97,0,128,128,28
69,seq50,r_69_126_183,seq2,r_69_126_183,0.99,-41,142,183,28
22,r_108_43_98,r_55_10_170,r_34_56_111,r_108_43_98,0.78,25,123,98,28
45,r_140_1_102,r_55_10_170,r_135_75_130,r_140_1_102,1.0,0,102,102,28
43,r_35_88_38,r_111_103_26,seq73,r_35_88_38,0.99,0,38,38,28
11,r_67_113_21,r_80_5_193,seq68,r_67_113_21,0.94,6,27,21,28
3,r_60_117_75,seq92,r_142_24_39,r_60_117_75,1.0,0,75,75,28
44,r_139_47_19,seq9,r_37_148_81,r_139_47_19,1.0,0,19,19,28
0,r_69_126_183,seq50,seq39,r_69_126_183,0.46,0,183,183,28
23,r_37_148_81,r_65_107_198,r_139_47_19,r_139_47_19,1.0,22,41,19,28
13,r_36_70_112,seq94,r_115_40_6,r_36_70_112,0.8,1,113,112,28
15,r_149_46_97,seq94,seq68,r_149_46_97,0.98,0,97,97,28
48,r_132_38_69,seq28,r_112_49_16,r_132_38_69,1.0,0,69,69,28
14,r_82_29_46,seq7,seq85,r_82_29_46,1.0,2,48,46,28
21,r_19_52_120,r_57_128_179,r_25_110_63,r_19_52_120,1.0,0,120,120,28
20,r_84_104_48,seq12,seq91,r_84_104_48,0.99,0,48,48,28
2,r_123_99_10,r_57_128_179,r_93_20_178,r_57_128_179,0.57,-41,138,179,28
29,r_111_103_26,r_35_88_38,r_60_117_75,r_35_88_38,0.9,1,39,38,28
8,r_112_49_16,r_131_0_44,r_109_45_74,r_112_49_16,1.0,0,16,16,28
29,r_111_103_26,r_130_13_50,r_35_88_38,r_111_103_26,0.9,-4,22,26,28
27,r_119_89_29,seq121,seq27,r_119_89_29,0.77,0,29,29,28
18,r_32_61_153,seq134,r_37_148_81,r_37_148_81,0.8,72,153,81,28
25,r_30_17_119,r_77_6_33,r_115_40_6,r_30_17_119,0.92,0,119,119,28
34,r_78_105_106,r_112_49_16,seq31,r_78_105_106,1.0,2,108,106,28
82,seq79,r_26_124_59,r_106_23_101,r_26_124_59,1.0,0,59,59,28
8,r_112_49_16,r_109_45_74,r_132_38_69,r_132_38_69,0.89,6,75,69,28
38,r_109_45_74,r_78_105_106,seq14,r_109_45_74,0.98,1,75,74,28
77,seq68,r_147_63_156,r_149_46_97,r_149_46_97,0.94,17,114,97,28
34,r_78_105_106,r_109_45_74,r_112_49_16,r_78_105_106,0.51,-31,75,106,28
27,r_119_89_29,seq27,r_142_24_39,r_142_24_39,1.0,2,41,39,28
17,r_22_145_91,seq94,seq31,r_22_145_91,1.0,0,91,91,28
25,r_30_17_119,r_115_40_6,seq54,r_30_17_119,0.49,69,188,119,28
9,r_55_10_170,r_140_1_102,seq137,r_140_1_102,0.99,0,102,102,28
19,r_142_24_39,r_65_107_198,r_119_89_29,r_142_24_39,0.78,0,39,39,28
29,r_111_103_26,r_60_117_75,seq76,r_60_117_75,0.67,-3,72,75,28
22,r_108_43_98,seq94,r_55_10_170,r_108_43_98,0.88,0,98,98,28
28,r_16_41_66,r_34_56_111,seq86,r_34_56_111,0.7,-44,67,111,28
32,r_130_13_50,seq96,seq129,r_130_13_50,0.56,6,56,50,28
42,r_26_124_59,seq79,seq76,r_26_124_59,1.0,0,59,59,28
79,seq72,seq76,r_83_102_37,r_83_102_37,1.0,58,95,37,28
55,seq7,r_82_29_46,seq39,r_82_29_46,1.0,3,49,46,28
35,r_34_56_111,r_16_41_66,r_98_74_45,r_98_74_45,0.61,22,67,45,28
12,r_146_138_92,r_19_52_120,seq79,r_146_138_92,1.0,1,93,92,28
24,r_83_102_37,r_60_117_75,seq72,r_83_102_37,0.73,2,39,37,28
55,seq7,seq39,r_37_148_81,r_37_148_81,0.41,98,179,81,28
30,r_129_94_115,r_52_68_164,seq45,r_129_94_115,1.0,1,116,115,29
16,r_50_35_15,r_85_22_78,seq57,r_50_35_15,0.98,0,15,15,29
36,r_69_44_130,seq78,seq92,r_69_44_130,1.0,0,130,130,29
14,r_52_68_164,r_129_94_115,seq37,r_129_94_115,1.0,-17,98,115,29
8,r_85_22_78,seq45,r_93_75_33,r_85_22_78,1.0,0,78,78,29
43,r_55_19_80,seq6,seq71,r_55_19_80,1.0,1,81,80,29
37,r_29_58_114,r_24_4_175,seq105,r_29_58_114,0.79,3,117,114,29
1,r_121_46_158,seq117,seq96,r_121_46_158,0.41,1,159,158,29
5,r_62_28_92,seq139,r_97_95_186,r_62_28_92,0.94,4,96,92,29
46,r_3_23_79,seq137,r_33_12_180,r_3_23_79,0.98,0,79,79,29
42,r_97_95_186,seq105,r_62_28_92,r_62_28_92,0.99,4,96,92,29
45,r_14_31_131,seq128,seq37,r_14_31_131,0.9,0,131,131,29
41,r_61_59_27,r_108_87_146,r_82_135_1,r_61_59_27,1.0,0,27,27,29
89,seq110,seq45,r_99_8_149,r_99_8_149,0.96,10,159,149,29
87,seq105,r_65_26_58,r_32_51_185,r_65_26_58,1.0,1,59,58,29
13,r_106_79_32,r_122_39_44,r_86_133_104,r_122_39_44,0.52,0,44,44,29
3,r_30_42_138,r_73_43_196,r_131_21_45,r_30_42_138,0.89,0,138,138,29
4,r_65_26_58,seq105,seq64,r_65_26_58,1.0,0,58,58,29
10,r_86_133_104,r_48_134_65,r_106_79_32,r_86_133_104,0.89,-38,66,104,29
87,seq105,r_32_51_185,r_29_58_114,r_29_58_114,0.94,3,117,114,29
10,r_86_133_104,r_106_79_32,seq105,r_86_133_104,1.0,0,104,104,29
28,r_93_75_33,seq114,seq6,r_93_75_33,1.0,0,33,33,29
34,r_144_72_54,seq53,seq132,r_144_72_54,0.95,-6,48,54,29
26,r_25_145_172,seq6,r_30_42_138,r_25_145_172,0.72,1,173,172,29
72,seq60,r_149_100_100,seq9,r_149_100_100,1.0,-16,84,100,29
14,r_52_68_164,seq37,seq128,r_52_68_164,0.98,2,166,164,29
89,seq110,r_131_21_45,seq45,r_131_21_45,1.0,0,45,45,29
78,seq76,r_33_12_180,r_69_44_130,r_69_44_130,0.98,21,151,130,29
0,r_48_134_65,r_86_133_104,seq80,r_48_134_65,1.0,1,66,65,29
73,seq138,r_33_12_180,r_136_83_31,r_136_83_31,0.65,150,181,31,29
20,r_99_8_149,seq92,seq110,r_99_8_149,0.85,0,149,149,29
46,r_3_23_79,r_33_12_180,seq41,r_33_12_180,0.76,-10,170,180,29
4,r_65_26_58,seq64,r_147_103_90,r_147_103_90,0.99,36,126,90,29
62,seq37,r_52_68_164,r_14_31_131,r_14_31_131,0.51,35,166,131,29
41,r_61_59_27,r_82_135_1,r_131_21_45,r_131_21_45,1.0,25,70,45,29
5,r_62_28_92,r_97_95_186,r_86_133_104,r_97_95_186,0.61,1,187,186,29
27,r_32_51_185,r_97_95_186,r_149_100_100,r_149_100_100,1.0,-4,96,100,29
2,r_88_111_110,r_136_83_31,r_2_63_156,r_2_63_156,0.94,-7,149,156,29
2,r_88_111_110,r_112_84_148,r_136_83_31,r_136_83_31,0.82,85,116,31,29
40,r_27_67_118,seq70,r_86_133_104,r_27_67_118,0.94,0,118,118,29
29,r_13_89_95,r_20_104_165,r_5_143_147,r_20_104_165,0.88,-14,151,165,29
74,seq64,r_54_113_151,seq132,r_54_113_151,0.96,-17,134,151,29
29,r_13_89_95,r_14_31_131,r_20_104_165,r_13_89_95,0.85,0,95,95,29
24,r_149_100_100,seq60,r_32_51_185,r_149_100_100,1.0,-4,96,100,29
25,r_24_4_175,seq116,seq142,r_24_4_175,0.67,0,175,175,29
33,r_112_84_148,seq0,r_85_22_78,r_112_84_148,0.94,1,149,148,29
42,r_97_95_186,r_62_28_92,r_65_26_58,r_97_95_186,0.65,0,186,186,29
13,r_106_79_32,r_86_133_104,r_146_127_94,r_106_79_32,0.98,62,94,32,29
32,r_20_104_165,seq96,r_65_26_58,r_20_104_165,0.48,2,167,165,29
38,r_56_148_199,r_15_36_170,r_136_83_31,r_56_148_199,0.85,-27,172,199,29
75,seq139,seq41,r_1_18_64,r_1_18_64,1.0,0,64,64,29
31,r_131_21_45,seq110,r_61_59_27,r_131_21_45,0.77,0,45,45,29
9,r_136_83_31,r_30_42_138,seq92,r_136_83_31,0.78,-1,30,31,29
81,seq80,r_66_98_150,r_48_134_65,r_48_134_65,1.0,91,156,65,29
17,r_147_103_90,r_15_36_170,r_65_26_58,r_15_36_170,0.51,-79,91,170,29
13,r_106_79_32,r_54_113_151,r_122_39_44,r_106_79_32,0.57,0,32,32,29
48,r_141_81_17,r_122_39_44,seq6,r_141_81_17,0.99,-1,16,17,29
22,r_1_18_64,seq101,seq139,r_1_18_64,1.0,0,64,64,29
49,r_5_143_147,seq142,r_13_89_95,r_13_89_95,1.0,56,151,95,29
11,r_122_39_44,r_106_79_32,seq132,r_122_39_44,0.9,0,44,44,29
7,r_74_7_128,seq71,r_50_35_15,r_74_7_128,1.0,0,128,128,29
23,r_91_107_154,seq123,seq78,r_91_107_154,0.73,0,154,154,29
35,r_146_127_94,seq116,r_106_79_32,r_146_127_94,1.0,0,94,94,29
12,r_15_36_170,r_56_148_199,r_121_46_158,r_15_36_170,0.57,2,172,170,29
30,r_40_42_67,seq62,seq64,r_40_42_67,0.89,1,68,67,30
36,r_96_35_184,seq146,r_30_90_99,r_30_90_99,0.97,15,114,99,30
14,r_63_120_106,seq11,r_130_87_100,r_63_120_106,0.99,0,106,106,30
60,seq12,r_9_18_55,r_55_71_1,r_9_18_55,1.0,0,55,55,30
59,seq11,r_68_75_82,seq38,r_68_75_82,1.0,0,82,82,30
21,r_50_127_90,r_8_103_121,r_70_46_77,r_50_127_90,1.0,0,90,90,30
39,r_48_36_147,seq10,r_93_59_110,r_48_36_147,0.53,1,148,147,30
1,r_30_90_99,r_8_103_121,r_31_116_45,r_30_90_99,0.6,0,99,99,30
46,r_22_82_85,seq73,seq21,r_22_82_85,1.0,0,85,85,30
42,r_1_112_123,seq104,r_17_78_8,r_1_112_123,0.85,1,124,123,30
45,r_51_26_172,r_52_61_70,r_115_83_56,r_51_26_172,1.0,-107,65,172,30
76,seq57,r_142_141_64,r_19_76_15,r_19_76_15,0.48,42,57,15,30
41,r_43_100_34,r_1_112_123,seq11,r_43_100_34,0.79,0,34,34,30
31,r_28_138_76,r_70_46_77,r_115_83_56,r_28_138_76,1.0,0,76,76,30
89,seq104,r_1_112_123,seq10,r_1_112_123,1.0,1,124,123,30
3,r_70_46_77,r_44_148_175,seq33,r_70_46_77,1.0,0,77,77,30
26,r_143_3_149,seq137,seq145,r_143_3_149,0.65,0,149,149,30
7,r_115_83_56,seq131,seq128,r_115_83_56,1.0,1,57,56,30
11,r_123_86_143,seq146,r_84_99_91,r_123_86_143,0.59,2,145,143,30
62,seq145,r_142_141_64,r_143_3_149,r_143_3_149,0.78,-4,145,149,30
20,r_44_148_175,seq23,r_32_16_73,r_32_16_73,0.81,99,172,73,30
13,r_37_47_161,r_32_16_73,seq137,r_32_16_73,1.0,1,74,73,30
15,r_72_5_160,seq94,seq57,r_72_5_160,0.93,0,160,160,30
0,r_31_116_45,seq107,r_37_47_161,r_31_116_45,0.99,0,45,45,30
13,r_37_47_161,seq137,r_7_110_30,r_37_47_161,0.87,2,163,161,30
6,r_92_101_132,seq20,seq54,r_92_101_132,0.99,0,132,132,30
62,seq145,r_8_103_121,r_142_141_64,r_8_103_121,0.54,1,122,121,30
36,r_96_35_184,r_30_90_99,r_129_102_198,r_96_35_184,0.86,-7,177,184,30
25,r_52_61_70,r_129_102_198,r_8_103_121,r_8_103_121,1.0,0,121,121,30
27,r_119_56_124,r_48_36_147,seq137,r_48_36_147,0.46,-18,129,147,30
2,r_77_108_158,seq81,seq10,r_77_108_158,0.85,1,159,158,30
47,r_93_59_110,r_51_26_172,r_133_111_163,r_93_59_110,0.91,0,110,110,30
43,r_19_76_15,r_43_100_34,seq57,r_19_76_15,0.93,0,15,15,30
0,r_31_116_45,r_37_47_161,r_30_90_99,r_30_90_99,0.99,1,100,99,30
18,r_147_109_154,r_55_71_1,seq126,r_55_71_1,0.77,154,155,1,30
29,r_134_132_170,seq89,r_17_78_8,r_134_132_170,0.81,0,170,170,30
23,r_13_91_74,r_28_138_76,r_65_66_81,r_13_91_74,0.38,60,134,74,30
24,r_84_99_91,r_48_36_147,r_123_86_143,r_48_36_147,0.71,-4,143,147,30
25,r_52_61_70,r_93_59_110,r_129_102_198,r_52_61_70,0.92,0,70,70,30
33,r_130_87_100,r_142_141_64,seq144,r_130_87_100,0.99,0,100,100,30
64,seq20,r_92_101_132,seq73,r_92_101_132,1.0,0,132,132,30
88,seq97,r_44_148_175,r_9_18_55,r_9_18_55,1.0,120,175,55,30
47,r_93_59_110,r_133_111_163,r_48_36_147,r_48_36_147,0.93,16,163,147,30
34,r_149_14_176,seq126,seq41,r_149_14_176,0.43,0,176,176,30
50,seq0,r_129_102_198,r_7_110_30,r_7_110_30,1.0,1,31,30,30
45,r_51_26_172,r_115_83_56,r_63_120_106,r_51_26_172,0.93,1,173,172,30
9,r_133_111_163,seq135,r_93_59_110,r_93_59_110,0.97,4,114,110,30
22,r_98_95_140,seq137,r_129_102_198,r_98_95_140,0.82,1,141,140,30
28,r_32_16_73,r_37_47_161,seq124,r_32_16_73,0.96,1,74,73,30
49,r_68_75_82,seq11,seq124,r_68_75_82,1.0,0,82,82,30
19,r_7_110_30,r_55_71_1,seq0,r_7_110_30,1.0,0,30,30,30
44,r_65_66_81,seq38,r_13_91_74,r_65_66_81,0.99,0,81,81,30
23,r_13_91_74,r_30_90_99,r_28_138_76,r_13_91_74,1.0,2,76,74,30
9,r_133_111_163,r_93_59_110,seq34,r_93_59_110,0.55,53,163,110,30
5,r_9_18_55,seq12,seq97,r_9_18_55,1.0,0,55,55,30
36,r_109_129_85,seq61,seq73,r_109_129_85,1.0,3,88,85,31
14,r_128_80_101,seq139,r_118_132_7,r_128_80_101,0.51,0,101,101,31
8,r_72_86_156,r_111_68_191,r_2_20_34,r_2_20_34,0.7,122,156,34,31
55,seq135,r_18_99_130,r_41_27_1,r_18_99_130,1.0,-9,121,130,31
71,seq44,r_35_31_100,r_22_112_118,r_35_31_100,0.69,1,101,100,31
16,r_85_103_111,r_111_68_191,seq3,r_85_103_111,0.91,1,112,111,31
21,r_110_114_141,r_14_60_159,r_22_112_118,r_14_60_159,0.99,-4,155,159,31
5,r_5_145_174,seq16,r_75_107_79,r_75_107_79,0.98,98,177,79,31
46,r_71_97_125,seq102,r_36_134_120,r_71_97_125,0.96,0,125,125,31
45,r_18_99_130,seq135,r_36_134_120,r_18_99_130,0.62,1,131,130,31
2,r_51_149_45,r_22_112_118,seq45,r_22_112_118,0.56,-68,50,118,31
31,r_46_136_109,seq108,seq40,r_46_136_109,1.0,0,109,109,31
3,r_56_33_38,seq44,seq102,r_56_33_38,1.0,2,40,38,31
26,r_15_12_135,seq138,seq40,r_15_12_135,0.55,12,147,135,31
11,r_75_107_79,seq16,seq10,r_75_107_79,0.76,1,80,79,31
48,r_48_66_47,r_106_125_63,seq121,r_106_125_63,1.0,0,63,63,31
57,seq9,seq53,r_101_147_28,r_101_147_28,1.0,62,90,28,31
0,r_23_148_40,seq3,seq122,r_23_148_40,1.0,0,40,40,31
34,r_65_32_17,r_35_31_100,seq49,r_65_32_17,0.98,-1,16,17,31
36,r_109_129_85,seq73,r_14_60_159,r_14_60_159,1.0,0,159,159,31
39,r_146_104_41,r_75_107_79,seq140,r_146_104_41,1.0,0,41,41,31
47,r_100_117_119,r_14_60_159,seq78,r_100_117_119,1.0,0,119,119,31
18,r_141_124_162,seq73,r_2_20_34,r_141_124_162,0.58,0,162,162,31
24,r_50_57_146,seq122,r_72_86_156,r_72_86_156,0.86,22,178,156,31
58,seq10,r_13_105_178,r_5_145_174,r_13_105_178,0.49,1,179,178,31
44,r_34_113_16,r_15_12_135,seq16,r_34_113_16,1.0,0,16,16,31
32,r_38_96_144,seq102,seq69,r_38_96_144,0.94,0,144,144,31
38,r_131_7_61,r_92_4_72,r_56_33_38,r_131_7_61,0.88,0,61,61,31
15,r_101_147_28,r_14_60_159,seq9,r_101_147_28,1.0,0,28,28,31
17,r_29_88_9,r_89_81_76,r_126_74_196,r_89_81_76,0.64,4,80,76,31
9,r_98_42_185,seq43,r_130_119_168,r_130_119_168,0.69,17,185,168,31
22,r_92_4_72,r_131_7_61,seq91,r_131_7_61,0.99,0,61,61,31
28,r_133_19_147,r_111_68_191,r_2_20_34,r_133_19_147,0.88,0,147,147,31
7,r_14_60_159,seq45,r_109_129_85,r_109_129_85,1.0,74,159,85,31
17,r_29_88_9,r_126_74_196,r_130_119_168,r_130_119_168,0.6,0,168,168,31
82,seq69,r_115_77_106,r_38_96_144,r_38_96_144,0.98,4,148,144,31
35,r_36_134_120,seq3,r_71_97_125,r_71_97_125,0.52,7,132,125,31
60,seq140,seq78,r_146_104_41,r_146_104_41,1.0,11,52,41,31
12,r_106_125_63,r_48_66_47,seq0,r_106_125_63,1.0,0,63,63,31
84,seq73,r_141_124_162,r_106_125_63,r_106_125_63,1.0,94,157,63,31
93,seq102,r_126_119_100,r_145_24_179,r_126_119_100,0.96,-1,99,100,32
30,r_81_107_128,seq35,seq78,r_81_107_128,0.92,0,128,128,32
36,r_96_63_38,r_74_76_12,seq46,r_96_63_38,0.67,46,84,38,32
98,seq112,seq68,r_101_149_18,r_101_149_18,0.52,27,45,18,32
8,r_18_90_72,r_124_6_122,seq72,r_18_90_72,0.62,47,119,72,32
7,r_8_114_30,seq27,seq148,r_8_114_30,1.0,1,31,30,32
37,r_141_127_105,r_110_13_66,r_100_10_19,r_141_127_105,0.91,-39,66,105,32
20,r_138_54_24,r_117_14_71,seq53,r_138_54_24,0.6,2,26,24,32
55,seq139,seq75,r_97_1_43,r_97_1_43,0.44,27,70,43,32
39,r_84_67_113,seq108,seq105,r_84_67_113,0.45,26,139,113,32
1,r_110_13_66,r_141_127_105,seq59,r_110_13_66,0.99,0,66,66,32
46,r_130_0_56,seq26,r_145_24_179,r_130_0_56,0.99,8,64,56,32
42,r_60_57_123,r_34_109_167,seq70,r_60_57_123,1.0,1,124,123,32
4,r_3_134_59,r_47_146_172,seq62,r_3_134_59,1.0,0,59,59,32
15,r_5_71_57,seq92,r_101_149_18,r_101_149_18,0.61,40,58,18,32
36,r_96_63_38,r_34_109_167,r_74_76_12,r_96_63_38,0.94,0,38,38,32
19,r_77_30_189,r_36_11_196,r_88_82_191,r_88_82_191,0.87,-1,190,191,32
76,seq59,seq86,r_110_13_66,r_110_13_66,1.0,5,71,66,32
3,r_97_1_43,seq56,seq104,r_97_1_43,0.96,0,43,43,32
31,r_133_51_87,seq75,seq129,r_133_51_87,0.89,0,87,87,32
41,r_47_146_172,seq2,r_61_116_67,r_61_116_67,0.93,110,177,67,32
10,r_125_93_85,seq128,r_38_122_135,r_125_93_85,0.64,0,85,85,32
44,r_100_10_19,r_121_7_147,seq65,r_100_10_19,1.0,0,19,19,32
26,r_20_15_139,seq148,r_38_122_135,r_20_15_139,0.82,0,139,139,32
0,r_44_120_63,seq50,r_48_99_180,r_44_120_63,0.91,2,65,63,32
11,r_34_109_167,r_60_57_123,seq142,r_60_57_123,0.98,1,124,123,32
65,seq32,seq92,r_22_25_112,r_22_25_112,1.0,2,114,112,32
48,r_121_7_147,seq62,r_96_63_38,r_121_7_147,0.96,0,147,147,32
54,seq9,r_38_122_135,r_73_118_28,r_73_118_28,0.86,0,28,28,32
35,r_95_140_16,r_115_43_181,r_73_118_28,r_95_140_16,0.62,0,16,16,32
57,seq142,r_34_109_167,r_145_24_179,r_34_109_167,0.64,-87,80,167,32
6,r_117_14_71,r_125_93_85,r_95_140_16,r_117_14_71,0.98,6,77,71,32
5,r_101_149_18,r_143_49_151,r_5_71_57,r_101_149_18,0.5,133,151,18,32
0,r_44_120_63,r_48_99_180,r_22_25_112,r_44_120_63,0.38,117,180,63,32
27,r_61_116_67,r_126_119_100,seq26,r_61_116_67,1.0,2,69,67,32
29,r_143_49_151,r_38_122_135,r_101_149_18,r_101_149_18,1.0,0,18,18,32
2,r_48_99_180,r_44_120_63,r_23_123_114,r_44_120_63,0.53,117,180,63,32
47,r_124_6_122,r_18_90_72,seq39,r_18_90_72,0.64,4,76,72,32
24,r_115_43_181,seq105,r_16_80_62,r_115_43_181,0.48,3,184,181,32
25,r_22_25_112,seq70,seq32,r_22_25_112,1.0,0,112,112,32
21,r_73_118_28,seq94,r_95_140_16,r_73_118_28,0.62,-12,16,28,32
47,r_124_6_122,seq39,r_111_42_10,r_124_6_122,1.0,0,122,122,32
10,r_125_93_85,r_38_122_135,r_133_51_87,r_38_122_135,1.0,0,135,135,32
38,r_85_58_54,r_135_106_7,seq50,r_85_58_54,0.95,8,62,54,32
18,r_74_76_12,r_36_11_196,r_96_63_38,r_96_63_38,0.6,0,38,38,32
5,r_101_149_18,r_100_10_19,r_143_49_151,r_101_149_18,0.56,0,18,18,32
75,seq56,seq9,r_125_93_85,r_125_93_85,1.0,53,138,85,32
17,r_126_119_100,r_135_106_7,r_111_42_10,r_135_106_7,0.67,94,101,7,32
9,r_38_122_135,r_125_93_85,r_141_127_105,r_125_93_85,0.66,50,135,85,32
9,r_38_122_135,r_126_119_100,r_125_93_85,r_125_93_85,0.99,4,89,85,32
33,r_131_31_51,seq112,r_73_118_28,r_73_118_28,0.77,24,52,28,32
29,r_143_49_151,r_101_149_18,r_61_116_67,r_101_149_18,0.87,133,151,18,32
28,r_87_69_90,seq32,r_73_118_28,r_87_69_90,0.55,7,97,90,32
49,r_23_123_114,r_20_15_139,r_117_14_71,r_23_123_114,0.94,9,123,114,32
11,r_34_109_167,seq142,r_8_114_30,r_34_109_167,0.97,2,169,167,32
23,r_91_19_79,seq112,seq21,r_91_19_79,0.44,9,88,79,32
55,seq139,r_97_1_43,seq27,r_97_1_43,0.76,44,87,43,32
12,r_135_106_7,r_85_58_54,r_144_41_34,r_85_58_54,0.79,8,62,54,32
36,r_96_63_38,seq46,r_121_7_147,r_121_7_147,0.78,5,152,147,32
35,r_95_140_16,r_73_118_28,r_117_14_71,r_95_140_16,0.75,12,28,16,32
21,r_73_118_28,r_95_140_16,seq9,r_73_118_28,0.83,0,28,28,32
36,r_93_97_74,seq38,seq15,r_93_97_74,1.0,0,74,74,33
14,r_12_79_94,seq38,seq122,r_12_79_94,1.0,0,94,94,33
18,r_21_149_105,r_68_96_44,r_75_66_138,r_68_96_44,0.87,0,44,44,33
27,r_80_108_13,r_63_1_166,r_13_26_190,r_80_108_13,0.99,-1,12,13,33
54,seq135,seq56,r_68_96_44,r_68_96_44,0.89,-4,40,44,33
55,seq8,r_63_1_166,r_116_35_81,r_116_35_81,0.93,30,111,81,33
21,r_60_76_66,r_107_140_62,seq111,r_60_76_66,0.83,1,67,66,33
1,r_23_48_64,r_10_104_163,seq120,r_23_48_64,0.94,0,64,64,33
97,seq122,seq144,r_12_79_94,r_12_79_94,1.0,2,96,94,33
5,r_62_134_97,seq87,seq114,r_62_134_97,1.0,0,97,97,33
46,r_47_58_185,seq125,r_40_112_92,r_47_58_185,0.46,1,186,185,33
45,r_49_128_88,seq88,seq0,r_49_128_88,1.0,1,89,88,33
19,r_40_112_92,seq28,seq144,r_40_112_92,1.0,0,92,92,33
11,r_16_54_171,seq122,seq146,r_16_54_171,0.74,1,172,171,33
37,r_137_33_28,seq114,r_145_18_16,r_137_33_28,1.0,1,29,28,33
31,r_22_127_181,seq34,r_23_48_64,r_23_48_64,0.42,117,181,64,33
10,r_116_35_81,seq45,seq8,r_116_35_81,1.0,0,81,81,33
26,r_78_2_7,r_59_20_169,r_103_99_131,r_78_2_7,0.62,164,171,7,33
4,r_3_126_177,seq87,r_43_44_2,r_3_126_177,0.67,0,177,177,33
99,seq125,r_47_58_185,r_36_123_11,r_36_123_11,1.0,3,14,11,33
0,r_46_7_75,r_67_110_140,seq146,r_46_7_75,0.98,1,76,75,33
11,r_16_54_171,r_25_83_72,seq122,r_25_83_72,1.0,0,72,72,33
33,r_141_42_24,r_23_48_64,seq92,r_141_42_24,1.0,1,25,24,33
20,r_138_117_154,seq82,r_62_134_97,r_138_117_154,0.86,1,155,154,33
13,r_132_71_159,seq118,seq31,r_132_71_159,0.95,1,160,159,33
15,r_17_14_76,r_21_149_105,r_102_130_77,r_17_14_76,1.0,-1,75,76,33
48,r_37_147_84,seq41,seq87,r_37_147_84,1.0,1,85,84,33
49,r_5_89_41,r_21_149_105,seq114,r_21_149_105,1.0,0,105,105,33
12,r_103_99_131,r_5_89_41,r_78_2_7,r_5_89_41,0.69,7,48,41,33
2,r_102_130_77,r_62_134_97,r_17_14_76,r_102_130_77,1.0,0,77,77,33
44,r_57_133_40,r_63_1_166,seq38,r_57_133_40,1.0,1,41,40,33
50,seq0,seq6,r_49_128_88,r_49_128_88,1.0,1,89,88,33
58,seq142,r_27_24_183,r_72_101_170,r_27_24_183,0.83,-13,170,183,33
42,r_36_123_11,r_46_7_75,seq125,r_36_123_11,0.85,0,11,11,33
52,seq131,r_74_113_194,seq85,r_74_113_194,0.75,-13,181,194,33
34,r_75_66_138,seq114,r_43_44_2,r_43_44_2,0.89,139,141,2,33
8,r_52_32_21,r_138_117_154,seq56,r_52_32_21,0.66,5,26,21,33
86,seq92,r_3_126_177,r_141_42_24,r_141_42_24,0.97,22,46,24,33
81,seq85,r_73_29_193,seq131,r_73_29_193,0.76,-17,176,193,33
17,r_106_11_63,seq144,seq64,r_106_11_63,1.0,0,63,63,33
9,r_59_20_169,r_78_2_7,r_25_83_72,r_25_83_72,1.0,99,171,72,33
49,r_5_89_41,r_103_99_131,r_21_149_105,r_5_89_41,0.9,0,41,41,33
22,r_27_24_183,seq142,seq118,r_27_24_183,0.58,0,183,183,33
28,r_25_83_72,r_16_54_171,r_4_69_22,r_25_83_72,1.0,0,72,72,33
91,seq114,r_75_66_138,r_62_134_97,r_62_134_97,1.0,44,141,97,33
72,seq51,seq61,r_102_130_77,r_102_130_77,0.92,82,159,77,33
39,r_68_96_44,r_21_149_105,seq135,r_21_149_105,0.58,-61,44,105,33
7,r_67_110_140,r_86_19_114,r_23_48_64,r_67_110_140,0.99,0,140,140,33
18,r_21_149_105,r_75_66_138,r_116_35_81,r_21_149_105,1.0,0,105,105,33
43,r_4_69_22,r_75_66_138,seq30,r_4_69_22,0.97,0,22,22,33
23,r_63_1_166,seq139,r_57_133_40,r_57_133_40,0.95,127,167,40,33
82,seq87,r_3_126_177,r_132_71_159,r_132_71_159,0.73,18,177,159,33
35,r_107_140_62,r_60_76_66,r_102_130_77,r_102_130_77,0.53,0,77,77,33
30,r_50_52_99,seq78,r_15_8_40,r_50_52_99,0.74,0,99,99,34
87,seq100,r_113_106_33,r_68_60_14,r_113_106_33,0.98,4,37,33,34
14,r_66_125_93,r_51_41_173,r_38_110_16,r_66_125_93,0.95,1,94,93,34
1,r_82_30_32,seq23,r_138_32_165,r_82_30_32,1.0,0,32,32,34
35,r_84_40_129,r_108_59_34,r_47_107_51,r_84_40_129,1.0,0,129,129,34
37,r_27_62_107,seq131,seq88,r_27_62_107,0.98,1,108,107,34
16,r_93_12_125,r_142_136_17,seq94,r_93_12_125,0.65,1,126,125,34
1,r_82_30_32,r_138_32_165,r_6_10_22,r_6_10_22,0.6,156,178,22,34
19,r_121_53_149,seq101,seq123,r_121_53_149,0.78,0,149,149,34
10,r_114_71_44,r_133_97_117,seq56,r_114_71_44,0.87,2,46,44,34
24,r_15_8_40,seq94,r_142_136_17,r_15_8_40,0.9,2,42,40,34
31,r_58_33_80,r_133_97_117,seq5,r_58_33_80,1.0,1,81,80,34
41,r_75_149_122,r_133_97_117,r_119_132_2,r_75_149_122,0.8,0,122,122,34
45,r_96_9_26,seq37,seq79,r_96_9_26,0.46,0,26,26,34
20,r_38_110_16,r_15_8_40,r_133_97_117,r_133_97_117,0.7,-101,16,117,34
72,seq56,r_126_18_198,r_114_71_44,r_114_71_44,0.89,27,71,44,34
78,seq78,r_50_52_99,r_70_73_6,r_50_52_99,0.9,0,99,99,34
11,r_129_137_59,r_142_136_17,r_90_85_41,r_142_136_17,0.72,47,64,17,34
98,seq123,seq19,r_121_53_149,r_121_53_149,0.9,6,155,149,34
15,r_119_132_2,seq25,r_14_145_142,r_14_145_142,0.84,42,184,142,34
6,r_98_146_115,r_64_55_182,r_58_33_80,r_64_55_182,0.93,-66,116,182,34
68,seq44,r_140_4_150,r_77_143_12,r_77_143_12,1.0,1,13,12,34
46,r_77_143_12,seq78,seq44,r_77_143_12,1.0,0,12,12,34
4,r_6_10_22,r_114_71_44,seq19,r_6_10_22,0.99,-3,19,22,34
2,r_90_85_41,r_93_12_125,seq20,r_93_12_125,0.56,-81,44,125,34
21,r_39_144_58,r_148_35_193,r_31_81_19,r_39_144_58,0.99,1,59,58,34
43,r_31_81_19,r_142_136_17,seq102,r_31_81_19,0.98,0,19,19,34
40,r_16_21_166,seq100,r_31_81_19,r_16_21_166,0.41,-2,164,166,34
47,r_105_83_56,r_111_29_186,seq131,r_105_83_56,0.98,0,56,56,34
29,r_14_145_142,r_45_91_194,r_119_132_2,r_14_145_142,0.66,0,142,142,34
34,r_87_112_9,seq19,r_26_74_49,r_26_74_49,0.95,106,155,49,34
25,r_140_4_150,seq63,seq117,r_140_4_150,0.72,0,150,150,34
33,r_24_134_75,r_45_91_194,seq72,r_24_134_75,0.89,1,76,75,34
13,r_26_74_49,seq80,r_87_112_9,r_26_74_49,0.96,1,50,49,34
88,seq101,r_121_53_149,r_68_60_14,r_121_53_149,0.95,0,149,149,34
50,seq1,r_111_29_186,r_133_97_117,r_111_29_186,0.3,1,187,186,34
58,seq17,r_133_97_117,r_3_89_139,r_133_97_117,0.46,-7,110,117,34
20,r_38_110_16,r_133_97_117,r_66_125_93,r_66_125_93,0.99,17,110,93,34
32,r_47_107_51,r_126_18_198,r_68_60_14,r_47_107_51,0.88,9,60,51,34
38,r_138_32_165,r_82_30_32,r_6_10_22,r_6_10_22,0.69,143,165,22,34
44,r_113_106_33,seq100,seq127,r_113_106_33,0.94,4,37,33,34
75,seq67,r_111_29_186,r_103_0_55,r_103_0_55,1.0,41,96,55,34
39,r_103_0_55,seq120,seq67,r_103_0_55,1.0,0,55,55,34
60,seq20,r_64_55_182,r_90_85_41,r_90_85_41,0.59,141,182,41,34
17,r_3_89_139,r_111_29_186,seq17,r_111_29_186,0.55,-46,140,186,34
28,r_51_41_173,r_65_130_82,seq63,r_51_41_173,0.75,0,173,173,34
22,r_45_91_194,r_14_145_142,r_115_22_116,r_14_145_142,0.88,0,142,142,34
28,r_51_41_173,r_66_125_93,r_65_130_82,r_51_41_173,0.8,-77,96,173,34
91,seq109,r_133_97_117,seq17,r_133_97_117,0.62,-5,112,117,34
18,r_108_59_34,seq123,seq76,r_108_59_34,0.85,8,42,34,34
49,r_115_22_116,r_142_136_17,seq11,r_115_22_116,0.75,0,116,116,34
7,r_65_130_82,r_84_40_129,seq2,r_65_130_82,0.64,3,85,82,34
23,r_49_69_104,r_126_18_198,r_113_106_33,r_49_69_104,0.7,0,104,104,34
35,r_84_40_129,r_65_130_82,r_108_59_34,r_84_40_129,0.77,-44,85,129,34
36,r_61_7_11,r_50_52_99,seq43,r_61_7_11,0.98,2,13,11,34
93,seq101,r_12_44_124,r_124_71_115,r_12_44_124,0.86,1,125,124,35
51,seq129,r_35_9_148,r_60_55_89,r_60_55_89,0.95,59,148,89,35
36,r_142_102_186,seq91,r_123_69_30,r_142_102_186,0.49,0,186,186,35
14,r_132_145_91,seq58,r_140_45_195,r_132_145_91,0.92,0,91,91,35
37,r_60_55_89,r_23_82_126,seq129,r_60_55_89,0.98,0,89,89,35
54,seq133,seq98,r_110_49_39,r_110_49_39,0.75,1,40,39,35
40,r_5_86_35,seq89,seq3,r_5_86_35,1.0,0,35,35,35
16,r_15_8_86,r_141_62_73,seq6,r_15_8_86,1.0,-1,85,86,35
21,r_40_39_90,r_36_29_151,r_134_147_38,r_40_39_90,0.6,1,91,90,35
39,r_66_63_119,seq117,r_64_27_99,r_66_63_119,0.88,0,119,119,35
97,seq118,seq76,r_52_26_49,r_52_26_49,1.0,50,99,49,35
21,r_40_39_90,r_134_147_38,r_11_1_128,r_11_1_128,0.95,0,128,128,35
46,r_53_37_74,seq14,seq57,r_53_37_74,1.0,0,74,74,35
42,r_19_18_130,seq126,r_67_116_12,r_19_18_130,0.99,0,130,130,35
6,r_78_20_44,r_33_138_178,r_30_135_127,r_78_20_44,1.0,0,44,44,35
7,r_104_34_7,r_48_122_80,r_125_107_43,r_104_34_7,0.4,119,126,7,35
1,r_110_49_39,seq17,seq133,r_110_49_39,0.96,0,39,39,35
45,r_74_59_110,seq103,r_78_20_44,r_78_20_44,0.52,66,110,44,35
19,r_115_21_84,seq61,seq51,r_115_21_84,1.0,0,84,84,35
29,r_125_107_43,r_64_27_99,seq58,r_64_27_99,1.0,-45,54,99,35
31,r_54_31_136,r_33_138_178,seq22,r_33_138_178,0.57,-19,159,178,35
47,r_50_137_94,seq101,r_105_100_117,r_50_137_94,0.5,55,149,94,35
41,r_127_65_160,r_125_107_43,seq148,r_127_65_160,0.51,0,160,160,35
3,r_36_29_151,seq70,r_113_25_75,r_36_29_151,0.97,1,152,151,35
10,r_80_120_157,r_112_106_187,r_109_77_24,r_112_106_187,0.53,-28,159,187,35
90,seq97,r_50_137_94,r_42_4_25,r_50_137_94,0.52,-28,66,94,35
72,seq51,r_33_138_178,r_64_27_99,r_64_27_99,1.0,81,180,99,35
18,r_52_26_49,r_93_7_111,seq118,r_52_26_49,0.65,0,49,49,35
7,r_104_34_7,r_33_138_178,r_48_122_80,r_104_34_7,0.63,69,76,7,35
4,r_35_9_148,seq129,seq130,r_35_9_148,0.96,0,148,148,35
25,r_56_72_48,r_52_26_49,r_42_4_25,r_42_4_25,1.0,29,54,25,35
0,r_12_44_124,seq101,seq95,r_12_44_124,0.99,1,125,124,35
63,seq131,r_50_137_94,r_42_4_25,r_50_137_94,0.5,0,94,94,35
73,seq57,r_113_25_75,r_53_37_74,r_53_37_74,0.61,-5,69,74,35
11,r_112_106_187,r_80_120_157,seq143,r_80_120_157,0.83,-20,137,157,35
13,r_136_128_154,seq121,seq47,r_136_128_154,0.59,0,154,154,35
15,r_113_25_75,r_15_8_86,r_48_122_80,r_113_25_75,0.65,3,78,75,35
20,r_123_69_30,seq61,r_87_46_129,r_123_69_30,1.0,0,30,30,35
2,r_23_82_126,r_119_85_58,seq143,r_23_82_126,1.0,0,126,126,35
7,r_104_34_7,seq57,r_33_138_178,r_104_34_7,0.57,34,41,7,35
27,r_141_62_73,r_15_8_86,r_52_26_49,r_141_62_73,1.0,1,74,73,35
48,r_119_85_58,seq14,r_67_116_12,r_119_85_58,1.0,0,58,58,35
83,seq84,seq0,r_109_77_24,r_109_77_24,1.0,8,32,24,35
2,r_23_82_126,r_60_55_89,r_119_85_58,r_23_82_126,0.67,-63,63,126,35
47,r_50_137_94,seq131,seq101,r_50_137_94,0.84,0,94,94,35
74,seq58,r_114_83_64,seq92,r_114_83_64,1.0,0,64,64,35
33,r_144_88_52,r_64_27_99,seq94,r_64_27_99,1.0,-27,72,99,35
6,r_78_20_44,r_30_135_127,r_74_59_110,r_78_20_44,0.98,84,128,44,35
65,seq22,r_105_100_117,r_54_31_136,r_105_100_117,0.84,1,118,117,35
20,r_123_69_30,r_87_46_129,seq89,r_87_46_129,0.99,6,135,129,35
68,seq38,seq111,r_60_55_89,r_60_55_89,1.0,54,143,89,35
32,r_140_45_195,seq111,r_132_145_91,r_132_145_91,1.0,2,93,91,35
38,r_108_96_87,seq91,seq14,r_108_96_87,1.0,0,87,87,35
34,r_105_100_117,seq22,r_50_137_94,r_50_137_94,0.89,23,117,94,35
30,r_149_2_15,r_110_49_39,seq90,r_149_2_15,1.0,0,15,15,35
85,seq90,r_33_138_178,r_149_2_15,r_149_2_15,0.98,16,31,15,35
26,r_87_46_129,seq130,r_123_69_30,r_123_69_30,1.0,3,33,30,35
9,r_33_138_178,seq51,r_124_71_115,r_124_71_115,0.64,65,180,115,35
26,r_87_46_129,r_123_69_30,seq95,r_87_46_129,0.7,6,135,129,35
22,r_114_83_64,seq58,seq14,r_114_83_64,1.0,0,64,64,35
28,r_67_116_12,r_60_55_89,r_119_85_58,r_67_116_12,1.0,53,65,12,35
44,r_11_1_128,seq3,r_40_39_90,r_11_1_128,1.0,0,128,128,35
41,r_127_65_160,seq98,r_125_107_43,r_125_107_43,0.72,61,104,43,35
23,r_48_122_80,r_11_1_128,r_113_25_75,r_48_122_80,0.92,0,80,80,35
17,r_42_4_25,seq97,r_56_72_48,r_56_72_48,1.0,51,99,48,35
17,r_42_4_25,r_53_37_74,seq97,r_42_4_25,0.98,0,25,25,35
5,r_109_77_24,seq13,seq84,r_109_77_24,0.98,0,24,24,35
35,r_93_7_111,seq32,seq103,r_93_7_111,0.99,0,111,111,35
12,r_64_27_99,r_144_88_52,r_149_2_15,r_64_27_99,1.0,0,99,99,35
8,r_134_147_38,r_48_122_80,seq14,r_134_147_38,1.0,4,42,38,35
93,seq101,seq35,r_46_47_112,r_46_47_112,1.0,1,113,112,36
30,r_24_77_124,seq28,seq43,r_24_77_124,0.96,1,125,124,36
12,r_64_105_57,seq18,r_32_121_105,r_64_105_57,0.92,0,57,57,36
36,r_116_129_153,seq5,r_21_65_22,r_21_65_22,0.55,131,153,22,36
8,r_133_128_189,seq96,r_46_47_112,r_46_47_112,0.97,77,189,112,36
4,r_62_104_26,seq122,seq18,r_62_104_26,1.0,0,26,26,36
43,r_54_92_160,seq29,seq85,r_54_92_160,0.8,0,160,160,36
86,seq85,seq38,r_54_92_160,r_54_92_160,0.85,3,163,160,36
54,seq11,seq126,r_136_91_72,r_136_91_72,1.0,17,89,72,36
21,r_8_113_35,seq38,r_131_147_82,r_8_113_35,0.69,56,91,35,36
71,seq43,r_57_127_140,r_24_77_124,r_24_77_124,1.0,18,142,124,36
14,r_58_117_43,seq85,r_10_138_98,r_58_117_43,1.0,1,44,43,36
1,r_66_145_101,seq33,r_136_91_72,r_66_145_101,1.0,0,101,101,36
5,r_53_124_149,seq18,seq83,r_53_124_149,0.83,1,150,149,36
46,r_46_47_112,seq126,seq101,r_46_47_112,1.0,0,112,112,36
42,r_131_147_82,r_120_36_142,r_8_113_35,r_8_113_35,0.51,49,84,35,36
29,r_2_110_33,seq75,seq137,r_2_110_33,1.0,0,33,33,36
45,r_79_144_20,seq17,r_21_65_22,r_79_144_20,1.0,2,22,20,36
80,seq75,r_10_138_98,r_57_127_140,r_10_138_98,1.0,-18,80,98,36
32,r_115_134_139,r_140_74_67,r_88_102_81,r_115_134_139,1.0,0,139,139,36
21,r_8_113_35,r_136_91_72,seq38,r_8_113_35,1.0,1,36,35,36
53,seq137,r_54_92_160,r_2_110_33,r_2_110_33,0.99,7,40,33,36
27,r_10_138_98,seq75,r_58_117_43,r_58_117_43,1.0,11,54,43,36
19,r_93_16_157,seq39,r_120_36_142,r_120_36_142,0.59,17,159,142,36
33,r_118_73_54,seq95,seq33,r_118_73_54,1.0,1,55,54,36
0,r_21_65_22,r_50_7_53,r_79_144_20,r_21_65_22,1.0,2,24,22,36
39,r_88_102_81,r_23_86_65,r_115_134_139,r_115_134_139,1.0,7,146,139,36
31,r_100_45_145,seq89,r_8_113_35,r_8_113_35,0.99,110,145,35,36
41,r_120_36_142,seq83,seq95,r_120_36_142,0.67,0,142,142,36
86,seq85,r_58_117_43,seq38,r_58_117_43,1.0,1,44,43,36
3,r_108_132_92,seq33,r_62_104_26,r_108_132_92,1.0,0,92,92,36
10,r_44_22_197,r_1_34_110,r_24_77_124,r_44_22_197,0.81,-71,126,197,36
90,seq95,r_118_73_54,r_135_60_156,r_118_73_54,1.0,0,54,54,36
26,r_31_13_100,seq98,seq80,r_31_13_100,1.0,2,102,100,36
84,seq83,r_42_112_163,r_53_124_149,r_42_112_163,0.8,-8,155,163,36
63,seq29,r_54_92_160,r_119_114_137,r_119_114_137,0.48,23,160,137,36
20,r_135_60_156,r_49_142_135,seq95,r_49_142_135,0.93,0,135,135,36
13,r_97_111_89,r_108_132_92,r_23_86_65,r_97_111_89,1.0,3,92,89,36
98,seq122,r_140_74_67,r_116_129_153,r_140_74_67,0.91,0,67,67,36
48,r_42_112_163,seq19,r_97_111_89,r_97_111_89,0.97,74,163,89,36
6,r_140_74_67,seq122,r_115_134_139,r_140_74_67,1.0,0,67,67,36
85,seq139,r_136_91_72,r_21_65_22,r_136_91_72,0.79,0,72,72,36
87,seq87,r_88_102_81,seq39,r_88_102_81,1.0,0,81,81,36
40,r_99_27_127,seq126,seq80,r_99_27_127,0.98,0,127,127,36
47,r_32_121_105,r_48_9_117,r_64_105_57,r_64_105_57,1.0,-1,56,57,36
18,r_40_25_111,seq15,seq70,r_40_25_111,0.96,0,111,111,36
25,r_48_9_117,seq81,r_21_65_22,r_48_9_117,0.96,0,117,117,36
6,r_140_74_67,r_115_134_139,r_136_91_72,r_115_134_139,1.0,0,139,139,36
65,seq33,r_108_132_92,seq103,r_108_132_92,1.0,0,92,92,36
68,seq38,seq19,r_125_3_83,r_125_3_83,1.0,41,124,83,36
32,r_115_134_139,r_46_47_112,r_140_74_67,r_140_74_67,0.94,4,71,67,36
52,seq5,r_116_129_153,r_146_82_73,r_146_82_73,0.99,80,153,73,36
20,r_135_60_156,seq95,r_40_25_111,r_135_60_156,1.0,0,156,156,36
17,r_119_114_137,seq33,seq29,r_119_114_137,0.88,0,137,137,36
94,seq103,r_97_111_89,r_50_7_53,r_50_7_53,0.62,1,54,53,36
9,r_136_91_72,seq139,seq11,r_136_91_72,1.0,0,72,72,36
96,seq107,seq38,r_143_149_174,r_143_149_174,0.61,-11,163,174,36
16,r_50_7_53,r_93_16_157,seq103,r_50_7_53,1.0,0,53,53,36
22,r_6_90_118,seq70,seq15,r_6_90_118,0.8,1,119,118,36
28,r_125_3_83,r_93_16_157,seq28,r_125_3_83,1.0,0,83,83,36
47,r_32_121_105,r_64_105_57,seq33,r_32_121_105,1.0,0,105,105,36
49,r_23_86_65,r_10_138_98,seq81,r_23_86_65,0.97,0,65,65,36
44,r_1_34_110,r_44_22_197,seq39,r_1_34_110,0.87,3,113,110,36
23,r_146_82_73,seq80,seq122,r_146_82_73,0.98,0,73,73,36
82,seq80,r_146_82_73,r_48_9_117,r_146_82_73,0.58,0,73,73,36
79,seq71,r_143_149_174,r_53_124_149,r_53_124_149,0.85,25,174,149,36
27,r_10_138_98,r_58_117_43,seq94,r_10_138_98,1.0,0,98,98,36
14,r_58_117_43,r_10_138_98,seq75,r_10_138_98,1.0,0,98,98,36
84,seq83,r_120_36_142,r_42_112_163,r_42_112_163,0.33,-20,143,163,36
12,r_64_105_57,r_32_121_105,r_23_86_65,r_64_105_57,0.56,48,105,57,36
30,r_148_131_106,r_33_113_104,seq123,r_148_131_106,1.0,0,106,106,37
44,r_115_11_182,r_84_128_116,r_9_109_10,r_115_11_182,0.95,0,182,182,37
51,seq4,seq69,r_97_125_146,r_97_125_146,0.98,7,153,146,37
36,r_25_103_124,r_38_41_172,seq133,r_25_103_124,0.86,0,124,124,37
14,r_31_136_117,seq130,seq79,r_31_136_117,1.0,0,117,117,37
43,r_106_105_160,seq10,r_110_65_23,r_110_65_23,0.75,139,162,23,37
17,r_135_59_88,seq42,r_31_136_117,r_31_136_117,0.86,16,133,117,37
4,r_9_109_10,r_76_8_171,seq130,r_9_109_10,0.91,0,10,10,37
59,seq147,r_44_146_149,r_27_60_60,r_27_60_60,1.0,16,76,60,37
71,seq51,r_92_127_179,r_108_122_190,r_92_127_179,0.94,1,180,179,37
16,r_84_128_116,seq13,r_115_11_182,r_84_128_116,0.81,0,116,116,37
21,r_43_94_186,r_37_100_147,seq2,r_37_100_147,1.0,-50,97,147,37
39,r_66_134_83,r_25_103_124,r_44_146_149,r_66_134_83,1.0,0,83,83,37
31,r_67_88_185,r_43_94_186,r_33_113_104,r_43_94_186,0.65,-1,185,186,37
42,r_114_50_135,seq81,seq86,r_114_50_135,0.97,0,135,135,37
12,r_93_95_30,r_76_8_171,r_33_113_104,r_93_95_30,1.0,0,30,30,37
7,r_44_146_149,r_66_134_83,r_19_14_133,r_66_134_83,0.95,68,151,83,37
45,r_36_87_168,seq62,r_37_100_147,r_36_87_168,0.32,9,177,168,37
46,r_129_47_14,r_1_72_126,r_0_140_154,r_129_47_14,0.9,0,14,14,37
39,r_66_134_83,r_44_146_149,r_27_60_60,r_44_146_149,0.98,2,151,149,37
31,r_67_88_185,r_96_111_119,r_43_94_186,r_67_88_185,0.52,-57,128,185,37
41,r_48_12_132,seq15,r_110_65_23,r_110_65_23,0.85,109,132,23,37
3,r_38_41_172,r_25_103_124,r_96_111_119,r_38_41_172,0.79,-48,124,172,37
10,r_137_32_63,r_38_41_172,seq58,r_137_32_63,1.0,0,63,63,37
26,r_99_85_91,r_101_28_4,seq34,r_99_85_91,0.96,3,94,91,37
16,r_84_128_116,r_115_11_182,r_55_6_164,r_84_128_116,0.97,66,182,116,37
0,r_1_72_126,r_67_88_185,r_108_122_190,r_1_72_126,0.99,0,126,126,37
13,r_142_49_65,r_31_136_117,r_108_122_190,r_142_49_65,0.94,0,65,65,37
15,r_33_113_104,r_25_103_124,r_96_111_119,r_33_113_104,0.85,20,124,104,37
66,seq39,r_56_24_134,r_96_111_119,r_96_111_119,0.99,-69,50,119,37
21,r_43_94_186,seq2,r_9_109_10,r_43_94_186,0.6,0,186,186,37
5,r_98_16_50,r_137_32_63,r_0_140_154,r_98_16_50,0.98,0,50,50,37
5,r_98_16_50,r_0_140_154,seq34,r_0_140_154,0.88,8,162,154,37
8,r_17_52_32,seq145,r_21_75_11,r_17_52_32,1.0,0,32,32,37
27,r_118_144_105,r_37_100_147,seq121,r_118_144_105,0.97,0,105,105,37
2,r_97_125_146,seq107,seq4,r_97_125_146,0.93,0,146,146,37
47,r_77_64_175,r_108_122_190,seq2,r_108_122_190,0.36,-15,175,190,37
46,r_129_47_14,r_0_140_154,r_82_30_27,r_129_47_14,0.73,22,36,14,37
74,seq58,r_76_8_171,r_137_32_63,r_137_32_63,1.0,37,100,63,37
18,r_29_117_85,r_76_8_171,seq130,r_29_117_85,0.93,0,85,85,37
29,r_96_111_119,r_67_88_185,r_33_113_104,r_33_113_104,0.89,15,119,104,37
25,r_19_14_133,seq18,r_53_104_26,r_19_14_133,0.56,1,134,133,37
32,r_3_102_57,r_37_100_147,seq5,r_3_102_57,0.87,0,57,57,37
50,seq2,r_120_139_158,r_43_94_186,r_120_139_158,0.59,1,159,158,37
58,seq18,r_19_14_133,r_27_60_60,r_27_60_60,0.94,74,134,60,37
38,r_27_60_60,r_25_103_124,seq90,r_27_60_60,1.0,0,60,60,37
48,r_82_30_27,seq133,r_129_47_14,r_82_30_27,0.78,0,27,27,37
34,r_120_139_158,seq2,seq91,r_120_139_158,0.68,1,159,158,37
3,r_38_41_172,r_96_111_119,seq34,r_38_41_172,1.0,0,172,172,37
17,r_135_59_88,seq147,seq42,r_135_59_88,1.0,1,89,88,37
94,seq107,r_56_24_134,seq79,r_56_24_134,0.89,0,134,134,37
9,r_0_140_154,seq143,seq133,r_0_140_154,0.5,-4,150,154,37
96,seq121,seq130,r_118_144_105,r_118_144_105,1.0,4,109,105,37
66,seq39,r_96_111_119,seq79,r_96_111_119,1.0,-37,82,119,37
33,r_110_65_23,seq13,r_21_75_11,r_110_65_23,0.99,0,23,23,37
22,r_37_100_147,r_43_94_186,r_25_103_124,r_43_94_186,0.78,-39,147,186,37
91,seq90,seq147,r_27_60_60,r_27_60_60,1.0,33,93,60,37
49,r_101_28_4,r_99_85_91,seq54,r_99_85_91,0.93,-4,87,91,37
7,r_44_146_149,seq147,r_66_134_83,r_66_134_83,1.0,2,85,83,37
44,r_115_11_182,r_76_8_171,r_84_128_116,r_84_128_116,0.67,0,116,116,37
23,r_56_24_134,seq107,seq130,r_56_24_134,0.89,0,134,134,37
40,r_53_104_26,r_37_100_147,seq13,r_53_104_26,0.99,1,27,26,37
37,r_136_124_187,r_116_94_65,r_88_113_13,r_116_94_65,0.69,-18,47,65,38
40,r_149_51_43,r_132_42_176,r_98_17_104,r_98_17_104,0.87,61,165,104,38
40,r_149_51_43,seq6,r_132_42_176,r_149_51_43,0.81,0,43,43,38
36,r_115_137_38,seq79,r_56_135_69,r_56_135_69,1.0,0,69,69,38
14,r_56_135_69,seq70,r_115_137_38,r_56_135_69,1.0,0,69,69,38
43,r_122_111_85,seq20,r_88_113_13,r_122_111_85,0.81,0,85,85,38
81,seq75,r_91_69_181,r_104_73_180,r_104_73_180,0.47,0,180,180,38
16,r_85_12_54,seq58,seq117,r_85_12_54,0.98,4,58,54,38
21,r_44_84_111,seq130,r_110_29_23,r_44_84_111,0.45,0,111,111,38
30,r_110_29_23,seq9,seq107,r_110_29_23,1.0,0,23,23,38
1,r_14_7_97,r_54_18_141,seq66,r_14_7_97,1.0,1,98,97,38
46,r_128_139_123,r_140_48_186,seq109,r_128_139_123,0.99,0,123,123,38
9,r_112_26_17,seq146,r_41_105_94,r_112_26_17,0.95,0,17,17,38
9,r_112_26_17,r_41_105_94,seq125,r_41_105_94,1.0,-26,68,94,38
35,r_64_11_58,seq63,r_46_37_145,r_64_11_58,1.0,0,58,58,38
51,seq130,r_8_16_194,r_33_123_14,r_33_123_14,1.0,31,45,14,38
11,r_98_17_104,seq95,seq119,r_98_17_104,0.7,0,104,104,38
10,r_88_113_13,r_52_38_113,r_136_124_187,r_88_113_13,0.99,0,13,13,38
3,r_148_67_173,r_0_141_169,r_52_38_113,r_52_38_113,0.97,65,178,113,38
47,r_132_42_176,seq119,r_149_51_43,r_149_51_43,1.0,4,47,43,38
26,r_24_15_74,r_14_7_97,r_39_103_35,r_24_15_74,1.0,1,75,74,38
11,r_98_17_104,r_106_1_60,seq95,r_106_1_60,1.0,-5,55,60,38
4,r_21_49_80,r_108_82_86,r_116_94_65,r_21_49_80,0.8,0,80,80,38
0,r_30_59_63,seq13,seq66,r_30_59_63,1.0,0,63,63,38
20,r_106_1_60,r_98_17_104,seq80,r_106_1_60,1.0,0,60,60,38
13,r_32_90_107,seq144,seq6,r_32_90_107,0.72,0,107,107,38
15,r_39_103_35,r_140_48_186,seq50,r_39_103_35,0.97,2,37,35,38
44,r_19_27_163,r_60_131_26,r_40_35_174,r_19_27_163,0.65,19,182,163,38
6,r_89_10_98,seq75,seq109,r_89_10_98,0.99,0,98,98,38
85,seq79,r_40_35_174,r_116_94_65,r_116_94_65,1.0,109,174,65,38
10,r_88_113_13,r_136_124_187,r_122_111_85,r_122_111_85,1.0,64,149,85,38
2,r_54_18_141,seq71,r_23_45_171,r_54_18_141,0.7,1,142,141,38
29,r_140_48_186,seq81,r_36_93_168,r_36_93_168,0.68,19,187,168,38
35,r_64_11_58,r_46_37_145,r_110_29_23,r_46_37_145,1.0,2,147,145,38
25,r_99_47_184,r_115_137_38,r_56_135_69,r_56_135_69,1.0,73,142,69,38
33,r_121_101_152,seq133,seq146,r_121_101_152,0.77,0,152,152,38
34,r_33_123_14,seq75,seq130,r_33_123_14,0.78,0,14,14,38
47,r_132_42_176,r_149_51_43,r_85_12_54,r_85_12_54,0.57,129,183,54,38
70,seq57,r_40_35_174,r_116_94_65,r_116_94_65,1.0,29,94,65,38
32,r_0_141_169,seq78,r_98_17_104,r_98_17_104,0.83,67,171,104,38
38,r_102_31_3,r_19_27_163,seq95,r_102_31_3,0.73,161,164,3,38
52,seq133,r_121_101_152,r_41_105_94,r_41_105_94,0.9,58,152,94,38
75,seq66,r_145_100_196,r_30_59_63,r_30_59_63,1.0,114,177,63,38
19,r_60_131_26,r_14_7_97,seq55,r_60_131_26,0.69,0,26,26,38
60,seq146,seq114,r_121_101_152,r_121_101_152,0.59,-1,151,152,38
81,seq75,r_89_10_98,r_91_69_181,r_89_10_98,0.77,2,100,98,38
17,r_46_37_145,seq83,seq144,r_46_37_145,0.58,2,147,145,38
41,r_5_92_19,r_140_48_186,seq20,r_5_92_19,1.0,0,19,19,38
37,r_136_124_187,r_88_113_13,r_5_92_19,r_88_113_13,0.48,174,187,13,38
22,r_108_82_86,seq117,r_122_111_85,r_108_82_86,0.61,-1,85,86,38
28,r_116_94_65,r_136_124_187,seq57,r_116_94_65,1.0,0,65,65,38
49,r_62_147_197,seq107,r_52_38_113,r_52_38_113,1.0,41,154,113,38
31,r_2_3_31,r_14_7_97,seq53,r_2_3_31,0.96,0,31,31,38
7,r_41_105_94,seq34,seq78,r_41_105_94,1.0,0,94,94,38
44,r_19_27_163,r_102_31_3,r_60_131_26,r_60_131_26,0.97,138,164,26,38
71,seq58,r_85_12_54,seq71,r_85_12_54,1.0,4,58,54,38
23,r_40_35_174,seq79,r_19_27_163,r_40_35_174,0.76,0,174,174,38
84,seq78,r_0_141_169,r_41_105_94,r_41_105_94,1.0,84,178,94,38
36,r_50_128_183,seq83,r_87_98_64,r_87_98_64,1.0,-1,63,64,39
14,r_22_54_142,r_79_139_34,seq60,r_22_54_142,0.83,0,142,142,39
83,seq78,r_25_67_175,r_88_115_65,r_88_115_65,1.0,110,175,65,39
37,r_52_141_144,r_55_42_121,r_47_143_68,r_47_143_68,0.99,56,124,68,39
86,seq82,seq60,r_126_6_83,r_126_6_83,1.0,2,85,83,39
16,r_55_42_121,r_52_141_144,r_147_97_72,r_55_42_121,0.97,3,124,121,39
21,r_126_6_83,seq83,seq82,r_126_6_83,0.97,0,83,83,39
39,r_61_64_79,seq5,seq29,r_61_64_79,0.72,2,81,79,39
42,r_106_39_99,r_55_42_121,seq80,r_106_39_99,0.9,0,99,99,39
45,r_103_136_71,r_95_111_146,seq73,r_95_111_146,0.49,-75,71,146,39
19,r_59_116_153,r_52_141_144,seq134,r_59_116_153,0.78,0,153,153,39
27,r_87_98_64,r_50_128_183,seq145,r_50_128_183,0.3,6,189,183,39
85,seq81,r_15_23_15,r_107_94_110,r_107_94_110,0.92,1,111,110,39
11,r_15_23_15,r_147_97_72,r_32_148_168,r_15_23_15,0.93,0,15,15,39
31,r_68_9_136,seq108,seq27,r_68_9_136,0.91,0,136,136,39
41,r_47_143_68,r_120_123_78,r_91_92_180,r_47_143_68,0.95,0,68,68,39
3,r_32_148_168,seq51,r_55_42_121,r_32_148_168,0.47,3,171,168,39
10,r_4_124_155,seq12,r_47_143_68,r_47_143_68,0.99,40,108,68,39
87,seq83,r_69_13_47,seq145,r_69_13_47,1.0,2,49,47,39
72,seq43,r_147_97_72,r_16_1_12,r_147_97_72,0.99,0,72,72,39
43,r_75_74_32,r_32_148_168,seq29,r_75_74_32,0.86,4,36,32,39
73,seq44,seq118,r_17_72_58,r_17_72_58,1.0,20,78,58,39
20,r_46_11_139,seq144,r_47_143_68,r_46_11_139,0.99,0,139,139,39
13,r_77_41_91,r_0_146_114,seq127,r_77_41_91,0.91,0,91,91,39
37,r_52_141_144,r_47_143_68,r_93_76_4,r_93_76_4,0.65,152,156,4,39
15,r_28_142_105,r_46_11_139,seq29,r_28_142_105,0.92,0,105,105,39
6,r_58_26_135,r_137_66_157,r_47_143_68,r_58_26_135,0.66,0,135,135,39
99,seq127,r_129_33_185,r_77_41_91,r_77_41_91,0.98,94,185,91,39
36,r_50_128_183,r_87_98_64,r_106_39_99,r_106_39_99,0.63,90,189,99,39
27,r_87_98_64,r_61_64_79,r_50_128_183,r_87_98_64,1.0,1,65,64,39
8,r_69_13_47,seq83,seq27,r_69_13_47,1.0,2,49,47,39
2,r_113_57_127,r_95_111_146,r_69_13_47,r_113_57_127,0.86,2,129,127,39
47,r_130_8_159,r_79_139_34,seq144,r_130_8_159,0.76,0,159,159,39
18,r_2_45_123,r_58_26_135,seq70,r_2_45_123,0.83,0,123,123,39
29,r_21_31_87,seq20,seq108,r_21_31_87,1.0,2,89,87,39
33,r_17_72_58,r_46_11_139,seq44,r_17_72_58,1.0,2,60,58,39
1,r_89_30_28,r_3_138_101,seq27,r_89_30_28,0.97,1,29,28,39
38,r_0_146_114,r_102_36_3,seq65,r_102_36_3,0.8,113,116,3,39
34,r_137_66_157,seq101,r_88_115_65,r_137_66_157,0.84,0,157,157,39
17,r_129_33_185,seq127,r_102_36_3,r_102_36_3,0.57,182,185,3,39
9,r_140_86_59,r_106_39_99,seq20,r_140_86_59,0.75,5,64,59,39
22,r_119_105_124,r_58_26_135,seq81,r_119_105_124,0.82,0,124,124,39
7,r_88_115_65,seq62,seq144,r_88_115_65,0.96,2,67,65,39
44,r_56_99_118,r_50_128_183,r_3_138_101,r_3_138_101,0.94,26,127,101,39
23,r_147_97_72,seq43,seq90,r_147_97_72,1.0,0,72,72,39
82,seq73,r_102_36_3,r_103_136_71,r_103_136_71,0.88,7,78,71,39
25,r_16_1_12,seq53,seq43,r_16_1_12,0.99,0,12,12,39
35,r_135_63_143,seq149,seq132,r_135_63_143,0.9,1,144,143,39
23,r_147_97_72,seq90,r_55_42_121,r_55_42_121,0.99,31,152,121,39
93,seq108,r_36_116_187,r_9_100_140,r_9_100_140,0.88,49,189,140,40
30,r_64_20_161,r_109_22_195,r_6_80_103,r_64_20_161,0.62,0,161,161,40
38,r_78_43_118,r_51_46_80,r_146_114_17,r_78_43_118,0.78,-72,46,118,40
36,r_36_116_187,seq108,r_104_28_141,r_104_28_141,1.0,48,189,141,40
77,seq77,r_6_80_103,r_32_130_13,r_32_130_13,0.89,15,28,13,40
49,r_44_17_45,r_9_100_140,r_31_94_31,r_44_17_45,1.0,-1,44,45,40
37,r_129_0_21,r_79_110_28,seq107,r_129_0_21,0.62,-5,16,21,40
14,r_76_82_92,seq122,r_70_34_88,r_76_82_92,1.0,1,93,92,40
10,r_112_135_41,r_18_48_130,seq5,r_112_135_41,1.0,-1,40,41,40
43,r_85_52_90,r_18_48_130,r_31_94_31,r_85_52_90,0.92,0,90,90,40
1,r_120_45_29,r_134_117_38,r_21_138_32,r_21_138_32,0.77,0,32,32,40
23,r_142_144_55,r_31_94_31,seq89,r_142_144_55,1.0,0,55,55,40
31,r_91_139_19,r_40_81_135,r_131_68_1,r_131_68_1,0.78,17,18,1,40
16,r_118_59_136,seq5,r_126_62_199,r_118_59_136,0.82,0,136,136,40
21,r_149_128_183,seq107,r_95_53_150,r_95_53_150,0.54,33,183,150,40
39,r_10_99_174,seq132,r_70_34_88,r_10_99_174,0.43,-72,102,174,40
97,seq122,r_76_82_92,seq98,r_76_82_92,1.0,-16,76,92,40
5,r_95_53_150,seq74,r_142_144_55,r_142_144_55,0.99,97,152,55,40
42,r_70_34_88,r_35_143_153,r_76_82_92,r_76_82_92,0.8,10,102,92,40
45,r_126_62_199,r_40_81_135,seq147,r_40_81_135,0.92,-75,60,135,40
90,seq105,r_111_42_43,r_87_86_75,r_87_86_75,1.0,1,76,75,40
19,r_58_137_124,seq26,seq15,r_58_137_124,0.99,0,124,124,40
13,r_31_94_31,r_142_144_55,r_44_17_45,r_142_144_55,0.67,0,55,55,40
8,r_146_114_17,seq2,r_78_43_118,r_146_114_17,0.93,1,18,17,40
34,r_16_113_26,seq47,seq106,r_16_113_26,1.0,0,26,26,40
90,seq105,seq65,r_111_42_43,r_111_42_43,0.97,1,44,43,40
38,r_78_43_118,r_146_114_17,seq136,r_78_43_118,0.51,0,118,118,40
39,r_10_99_174,r_70_34_88,seq26,r_10_99_174,0.97,1,175,174,40
41,r_29_24_159,seq93,r_9_100_140,r_29_24_159,0.93,0,159,159,40
24,r_111_42_43,r_148_127_40,seq105,r_111_42_43,1.0,0,43,43,40
17,r_21_138_32,r_109_22_195,seq33,r_21_138_32,1.0,0,32,32,40
8,r_146_114_17,r_78_43_118,seq19,r_78_43_118,1.0,-9,109,118,40
2,r_32_130_13,r_131_68_1,seq77,r_32_130_13,0.94,0,13,13,40
35,r_87_86_75,r_120_45_29,seq105,r_87_86_75,1.0,1,76,75,40
0,r_51_46_80,r_78_43_118,r_131_68_1,r_51_46_80,0.97,9,89,80,40
43,r_85_52_90,r_31_94_31,r_18_48_130,r_18_48_130,1.0,0,130,130,40
11,r_61_55_94,r_149_128_183,r_21_138_32,r_61_55_94,0.93,0,94,94,40
20,r_38_27_84,seq15,seq98,r_38_27_84,1.0,0,84,84,40
98,seq123,r_109_22_195,r_54_23_95,r_54_23_95,1.0,8,103,95,40
15,r_104_28_141,r_67_13_170,seq90,r_104_28_141,0.94,0,141,141,40
48,r_35_143_153,r_70_34_88,seq4,r_35_143_153,0.45,-61,92,153,40
79,seq89,r_9_100_140,r_142_144_55,r_142_144_55,1.0,1,56,55,40
46,r_88_3_51,seq89,seq97,r_88_3_51,0.98,0,51,51,40
4,r_131_68_1,seq124,r_140_12_15,r_140_12_15,1.0,13,28,15,40
23,r_142_144_55,r_29_24_159,r_31_94_31,r_31_94_31,0.94,4,35,31,40
32,r_140_12_15,r_148_127_40,r_131_68_1,r_140_12_15,0.59,0,15,15,40
27,r_141_11_172,seq90,r_76_82_92,r_76_82_92,0.97,80,172,92,40
47,r_69_7_110,seq49,r_131_68_1,r_69_7_110,1.0,0,110,110,40
40,r_54_23_95,seq15,seq123,r_54_23_95,1.0,0,95,95,40
18,r_9_100_140,seq89,seq19,r_9_100_140,0.73,0,140,140,40
29,r_60_57_166,r_126_62_199,r_67_13_170,r_126_62_199,0.52,-30,169,199,40
13,r_31_94_31,r_118_59_136,r_142_144_55,r_31_94_31,0.71,0,31,31,40
25,r_125_83_66,r_51_46_80,seq98,r_125_83_66,1.0,0,66,66,40
33,r_56_14_157,seq119,r_9_100_140,r_56_14_157,0.94,0,157,157,40
48,r_35_143_153,seq4,seq2,r_35_143_153,0.99,1,154,153,40
70,seq66,r_67_13_170,r_126_62_199,r_126_62_199,0.68,-28,171,199,40
35,r_87_86_75,seq33,r_120_45_29,r_120_45_29,0.97,-3,26,29,40
60,seq26,r_58_137_124,r_32_130_13,r_58_137_124,0.6,0,124,124,40
9,r_40_81_135,r_126_62_199,r_131_68_1,r_40_81_135,0.93,0,135,135,40
56,seq15,r_38_27_84,seq1,r_38_27_84,1.0,-16,68,84,40
44,r_41_30_176,seq97,seq119,r_41_30_176,0.5,0,176,176,40
12,r_6_80_103,seq77,seq37,r_6_80_103,0.65,11,114,103,40
84,seq97,r_41_30_176,r_88_3_51,r_88_3_51,0.92,125,176,51,40
41,r_5_131_43,seq30,seq82,r_5_131_43,0.99,2,45,43,41
30,r_40_27_66,seq54,seq20,r_40_27_66,1.0,0,66,66,41
36,r_97_33_161,r_139_136_197,r_90_0_90,r_97_33_161,0.96,0,161,161,41
8,r_23_43_190,seq1,r_138_119_116,r_138_119_116,0.67,74,190,116,41
37,r_38_86_60,r_145_94_121,seq22,r_38_86_60,1.0,0,60,60,41
86,seq78,r_144_111_136,r_95_24_76,r_95_24_76,0.99,60,136,76,41
21,r_144_111_136,seq78,r_139_136_197,r_144_111_136,0.37,0,136,136,41
39,r_125_7_56,r_139_136_197,seq66,r_125_7_56,1.0,4,60,56,41
1,r_120_45_185,seq30,r_107_74_129,r_107_74_129,1.0,57,186,129,41
20,r_122_71_135,r_3_129_94,seq108,r_122_71_135,0.9,1,136,135,41
46,r_85_81_72,seq53,r_25_10_52,r_85_81_72,0.97,1,73,72,41
42,r_39_147_14,seq21,r_69_70_148,r_69_70_148,0.71,6,154,148,41
15,r_9_6_51,seq50,r_112_31_37,r_9_6_51,0.98,0,51,51,41
3,r_46_48_68,r_123_115_99,r_51_101_75,r_123_115_99,0.9,-27,72,99,41
10,r_117_59_65,seq141,seq50,r_117_59_65,0.89,8,73,65,41
72,seq53,r_39_147_14,r_107_74_129,r_107_74_129,1.0,13,142,129,41
4,r_104_13_139,seq78,r_41_80_159,r_104_13_139,0.99,0,139,139,41
0,r_12_64_74,seq47,seq16,r_12_64_74,0.99,0,74,74,41
73,seq54,r_40_27_66,seq79,r_40_27_66,1.0,0,66,66,41
11,r_107_74_129,seq87,seq53,r_107_74_129,0.95,0,129,129,41
31,r_75_29_27,seq68,seq79,r_75_29_27,1.0,0,27,27,41
20,r_122_71_135,r_113_77_92,r_3_129_94,r_113_77_92,0.54,2,94,92,41
48,r_121_14_59,seq20,r_34_89_5,r_121_14_59,0.99,1,60,59,41
6,r_41_80_159,r_52_84_192,r_4_149_42,r_4_149_42,1.0,125,167,42,41
35,r_134_116_54,r_122_71_135,seq62,r_134_116_54,1.0,0,54,54,41
14,r_4_149_42,seq62,seq76,r_4_149_42,1.0,0,42,42,41
2,r_106_2_112,seq79,r_121_14_59,r_106_2_112,1.0,0,112,112,41
47,r_127_11_102,seq20,seq141,r_127_11_102,0.93,5,107,102,41
40,r_3_129_94,seq65,r_122_71_135,r_3_129_94,0.76,1,95,94,41
24,r_145_94_121,seq130,r_106_2_112,r_106_2_112,1.0,16,128,112,41
25,r_118_58_137,r_138_119_116,r_4_149_42,r_4_149_42,1.0,75,117,42,41
28,r_32_137_47,r_51_101_75,seq57,r_32_137_47,1.0,1,48,47,41
33,r_113_77_92,r_122_71_135,r_9_6_51,r_113_77_92,0.77,0,92,92,41
85,seq76,r_138_119_116,r_4_149_42,r_4_149_42,0.97,9,51,42,41
18,r_112_31_37,r_85_81_72,seq146,r_112_31_37,1.0,0,37,37,41
58,seq18,r_35_19_170,r_106_2_112,r_106_2_112,1.0,60,172,112,41
70,seq49,seq62,r_32_137_47,r_32_137_47,0.98,22,69,47,41
34,r_140_100_28,r_40_27_66,seq67,r_140_100_28,1.0,0,28,28,41
68,seq42,r_51_101_75,r_103_61_18,r_103_61_18,0.98,66,84,18,41
32,r_17_105_63,seq36,seq91,r_17_105_63,0.99,0,63,63,41
38,r_35_19_170,seq18,r_38_86_60,r_38_86_60,0.98,112,172,60,41
22,r_103_61_18,r_104_13_139,seq42,r_103_61_18,1.0,0,18,18,41
17,r_25_10_52,seq91,r_85_81_72,r_85_81_72,1.0,11,83,72,41
77,seq62,r_126_98_33,r_134_116_54,r_134_116_54,0.97,7,61,54,41
9,r_123_115_99,seq28,r_103_61_18,r_103_61_18,0.98,89,107,18,41
96,seq108,seq36,r_122_71_135,r_122_71_135,0.57,4,139,135,41
91,seq91,r_25_10_52,r_17_105_63,r_17_105_63,1.0,20,83,63,41
49,r_135_148_184,seq87,r_5_131_43,r_5_131_43,0.71,143,186,43,41
71,seq50,r_126_98_33,r_117_59_65,r_126_98_33,1.0,-4,29,33,41
25,r_118_58_137,r_4_149_42,r_12_64_74,r_118_58_137,0.92,0,137,137,41
56,seq143,seq66,r_25_10_52,r_25_10_52,0.87,12,64,52,41
7,r_138_119_116,r_118_58_137,r_9_6_51,r_138_119_116,1.0,1,117,116,41
44,r_95_24_76,r_51_101_75,r_8_83_44,r_95_24_76,0.55,0,76,76,41
12,r_15_55_82,seq128,seq87,r_15_55_82,1.0,0,82,82,41
40,r_3_129_94,r_122_71_135,seq30,r_122_71_135,0.94,1,136,135,41
45,r_8_83_44,r_138_119_116,seq130,r_8_83_44,1.0,0,44,44,41
40,r_12_11_176,r_128_139_7,r_132_70_114,r_12_11_176,0.83,0,176,176,42
92,seq111,r_126_94_155,r_138_122_86,r_138_122_86,0.83,70,156,86,42
14,r_48_78_167,seq108,r_75_100_93,r_48_78_167,0.69,0,167,167,42
8,r_82_0_119,seq142,seq147,r_82_0_119,1.0,0,119,119,42
83,seq76,r_19_83_173,r_103_101_39,r_103_101_39,0.96,60,99,39,42
37,r_63_85_92,r_30_32_159,r_57_56_43,r_63_85_92,1.0,1,93,92,42
71,seq39,r_35_131_177,seq5,r_35_131_177,0.85,0,177,177,42
21,r_104_88_99,r_49_91_96,r_75_100_93,r_49_91_96,0.9,0,96,96,42
39,r_7_149_134,seq127,r_134_62_11,r_7_149_134,0.56,2,136,134,42
97,seq118,r_49_91_96,seq26,r_49_91_96,1.0,0,96,96,42
5,r_61_33_149,seq92,r_135_114_70,r_135_114_70,0.73,79,149,70,42
29,r_79_28_32,seq15,r_21_42_31,r_79_28_32,1.0,0,32,32,42
42,r_126_94_155,seq111,seq118,r_126_94_155,0.97,0,155,155,42
19,r_102_72_148,r_19_83_173,r_128_139_7,r_19_83_173,0.78,-21,152,173,42
23,r_90_31_29,r_75_100_93,seq27,r_90_31_29,1.0,0,29,29,42
45,r_89_2_55,r_82_0_119,r_86_96_191,r_89_2_55,1.0,0,55,55,42
41,r_19_83_173,seq76,r_67_77_162,r_19_83_173,0.62,0,173,173,42
20,r_68_1_17,r_30_32_159,r_138_122_86,r_68_1_17,1.0,0,17,17,42
3,r_67_77_162,r_110_119_198,seq108,r_110_119_198,0.39,-36,162,198,42
10,r_86_96_191,r_30_32_159,r_138_122_86,r_138_122_86,1.0,73,159,86,42
4,r_30_32_159,r_86_96_191,r_126_94_155,r_86_96_191,1.0,-32,159,191,42
11,r_20_125_112,r_12_11_176,r_134_62_11,r_20_125_112,0.9,0,112,112,42
13,r_132_70_114,seq112,r_103_101_39,r_103_101_39,1.0,79,118,39,42
15,r_54_74_104,seq47,seq51,r_54_74_104,0.85,1,105,104,42
48,r_35_131_177,seq39,r_134_62_11,r_35_131_177,0.62,0,177,177,42
6,r_75_100_93,r_132_70_114,seq144,r_75_100_93,0.93,0,93,93,42
27,r_57_56_43,seq92,r_103_101_39,r_57_56_43,0.63,3,46,43,42
7,r_21_42_31,r_102_72_148,r_79_28_32,r_79_28_32,0.94,9,41,32,42
87,seq142,r_82_0_119,seq24,r_82_0_119,1.0,0,119,119,42
2,r_146_99_116,r_132_70_114,r_55_25_8,r_55_25_8,0.87,117,125,8,42
40,r_12_11_176,r_20_125_112,r_128_139_7,r_20_125_112,0.71,4,116,112,42
18,r_46_69_172,seq37,seq5,r_46_69_172,0.81,0,172,172,42
24,r_40_87_80,r_75_100_93,seq51,r_40_87_80,0.97,1,81,80,42
43,r_95_141_94,seq136,r_90_31_29,r_95_141_94,0.36,88,182,94,42
33,r_45_8_24,seq15,r_90_31_29,r_90_31_29,1.0,78,107,29,42
20,r_68_1_17,r_138_122_86,r_57_56_43,r_138_122_86,0.98,0,86,86,42
32,r_49_91_96,r_104_88_99,seq116,r_49_91_96,1.0,0,96,96,42
77,seq53,r_93_98_121,r_75_100_93,r_93_98_121,0.87,0,121,121,42
45,r_89_2_55,r_86_96_191,r_138_122_86,r_138_122_86,0.97,53,139,86,42
9,r_93_98_121,seq53,seq113,r_93_98_121,1.0,0,121,121,42
26,r_138_122_86,r_68_1_17,r_89_2_55,r_138_122_86,0.83,0,86,86,42
26,r_138_122_86,r_21_42_31,r_68_1_17,r_68_1_17,1.0,1,18,17,42
34,r_103_101_39,r_59_107_135,seq76,r_103_101_39,1.0,-2,37,39,42
28,r_66_23_136,seq124,r_45_8_24,r_66_23_136,0.99,0,136,136,42
30,r_149_79_184,r_94_58_178,r_137_138_90,r_137_138_90,0.9,88,178,90,43
44,r_52_127_115,r_62_128_25,r_1_47_112,r_52_127_115,0.99,0,115,115,43
36,r_137_138_90,r_1_47_112,seq111,r_137_138_90,0.87,0,90,90,43
25,r_135_54_50,r_43_108_197,seq48,r_135_54_50,1.0,-2,48,50,43
43,r_61_104_119,seq37,r_62_128_25,r_61_104_119,0.84,3,122,119,43
37,r_83_77_198,r_4_51_171,r_30_95_105,r_83_77_198,0.62,-26,172,198,43
10,r_62_128_25,r_32_87_62,r_52_127_115,r_62_128_25,0.85,1,26,25,43
21,r_32_87_62,r_134_18_30,r_146_124_40,r_134_18_30,0.98,32,62,30,43
77,seq73,r_67_143_146,r_72_19_45,r_72_19_45,0.59,-1,44,45,43
1,r_129_33_135,seq35,seq69,r_129_33_135,0.73,0,135,135,43
5,r_116_15_67,seq117,seq35,r_116_15_67,1.0,1,68,67,43
18,r_9_93_26,r_7_57_96,r_81_118_11,r_9_93_26,0.86,0,26,26,43
85,seq99,r_129_33_135,r_70_22_13,r_70_22_13,0.92,-2,11,13,43
23,r_81_118_11,seq141,r_9_93_26,r_81_118_11,0.51,39,50,11,43
31,r_94_58_178,r_149_79_184,r_92_31_169,r_94_58_178,0.5,0,178,178,43
3,r_67_143_146,seq73,seq48,r_67_143_146,0.64,3,149,146,43
44,r_52_127_115,seq69,r_62_128_25,r_52_127_115,0.77,-94,21,115,43
14,r_146_124_40,r_76_53_106,seq5,r_146_124_40,0.98,0,40,40,43
26,r_26_10_155,r_30_95_105,r_116_15_67,r_26_10_155,0.93,-50,105,155,43
15,r_70_22_13,seq148,seq99,r_70_22_13,0.98,-2,11,13,43
4,r_76_53_106,r_132_12_1,r_56_97_88,r_56_97_88,1.0,40,128,88,43
46,r_110_140_24,r_129_33_135,seq148,r_110_140_24,0.77,2,26,24,43
0,r_85_36_98,r_43_108_197,r_106_130_63,r_85_36_98,0.98,1,99,98,43
17,r_21_45_48,r_106_130_63,r_96_0_80,r_21_45_48,0.9,0,48,48,43
20,r_56_97_88,r_59_133_5,seq42,r_56_97_88,0.85,0,88,88,43
13,r_1_47_112,seq39,r_52_127_115,r_52_127_115,0.57,7,122,115,43
48,r_64_6_126,seq25,r_61_104_119,r_64_6_126,0.59,1,127,126,43
6,r_92_31_169,seq60,r_80_40_54,r_80_40_54,0.96,24,78,54,43
10,r_62_128_25,r_52_127_115,r_61_104_119,r_62_128_25,0.98,95,120,25,43
27,r_20_144_117,seq42,r_110_140_24,r_20_144_117,0.77,1,118,117,43
12,r_75_65_56,r_30_95_105,seq27,r_75_65_56,0.79,0,56,56,43
2,r_30_95_105,r_26_10_155,seq39,r_30_95_105,0.94,0,105,105,43
40,r_126_120_86,seq90,seq84,r_126_120_86,0.81,1,87,86,43
29,r_132_12_1,r_76_53_106,r_1_47_112,r_1_47_112,0.51,41,153,112,43
6,r_92_31_169,r_80_40_54,r_146_124_40,r_92_31_169,0.92,1,170,169,43
46,r_110_140_24,r_64_6_126,r_3_13_102,r_3_13_102,0.79,0,102,102,43
46,r_110_140_24,seq148,r_64_6_126,r_64_6_126,0.48,-56,70,126,43
32,r_82_109_64,r_20_144_117,seq35,r_82_109_64,0.97,0,64,64,43
16,r_80_40_54,seq34,seq35,r_80_40_54,0.99,0,54,54,43
33,r_72_19_45,seq8,seq73,r_72_19_45,0.98,-1,44,45,43
24,r_96_0_80,r_21_45_48,r_82_109_64,r_96_0_80,0.99,1,81,80,43
60,seq29,r_149_79_184,r_1_47_112,r_149_79_184,0.42,1,185,184,43
17,r_21_45_48,r_96_0_80,seq111,r_96_0_80,1.0,1,81,80,43
11,r_139_142_10,seq63,seq48,r_139_142_10,1.0,2,12,10,43
22,r_71_23_74,r_76_53_106,seq37,r_71_23_74,0.98,-2,72,74,43
28,r_7_57_96,seq48,r_62_128_25,r_7_57_96,0.85,1,97,96,43
49,r_4_51_171,r_83_77_198,seq141,r_83_77_198,0.66,-26,172,198,43
7,r_88_101_120,r_76_53_106,r_146_124_40,r_76_53_106,0.99,14,120,106,43
19,r_38_147_32,seq63,seq35,r_38_147_32,1.0,-2,30,32,43
42,r_2_112_29,r_75_65_56,seq117,r_2_112_29,0.99,0,29,29,43
26,r_26_10_155,r_116_15_67,r_30_95_105,r_26_10_155,1.0,1,156,155,43
82,seq90,r_126_120_86,seq39,r_126_120_86,1.0,-20,66,86,43
24,r_96_0_80,seq11,r_21_45_48,r_21_45_48,0.94,-1,47,48,43
35,r_3_13_102,seq24,r_110_140_24,r_3_13_102,0.97,0,102,102,43
8,r_115_28_49,r_49_131_194,seq39,r_115_28_49,0.99,-7,42,49,43
23,r_81_118_11,r_62_128_25,seq141,r_81_118_11,0.84,0,11,11,43
30,r_69_113_107,r_120_41_178,r_33_18_25,r_69_113_107,0.99,0,107,107,44
85,seq79,r_93_94_141,r_130_72_124,r_130_72_124,0.92,11,135,124,44
36,r_34_32_123,r_2_56_155,r_42_115_38,r_42_115_38,0.56,85,123,38,44
0,r_142_139_5,r_100_20_83,r_120_41_178,r_120_41_178,0.48,-123,55,178,44
14,r_117_57_136,r_120_41_178,r_10_140_65,r_10_140_65,1.0,6,71,65,44
8,r_30_49_104,seq79,seq70,r_30_49_104,0.96,0,104,104,44
0,r_142_139_5,r_120_41_178,seq132,r_142_139_5,0.37,107,112,5,44
43,r_67_134_165,r_1_118_185,r_14_125_79,r_14_125_79,1.0,2,81,79,44
83,seq74,r_43_25_133,seq137,r_43_25_133,1.0,0,133,133,44
16,r_86_11_75,r_38_45_85,seq26,r_38_45_85,0.64,-7,78,85,44
21,r_43_25_133,seq74,seq4,r_43_25_133,0.76,0,133,133,44
5,r_51_66_187,r_100_20_83,r_84_105_153,r_100_20_83,0.94,3,86,83,44
46,r_124_76_99,r_2_56_155,seq121,r_124_76_99,0.99,1,100,99,44
42,r_93_94_141,r_86_11_75,r_61_90_89,r_61_90_89,0.78,50,139,89,44
45,r_96_0_126,seq9,seq59,r_96_0_126,0.39,31,157,126,44
19,r_5_129_150,r_80_148_101,r_42_115_38,r_80_148_101,0.83,1,102,101,44
9,r_8_53_95,r_51_66_187,r_86_11_75,r_8_53_95,1.0,0,95,95,44
19,r_5_129_150,r_42_115_38,r_10_140_65,r_5_129_150,1.0,1,151,150,44
31,r_141_48_70,seq137,r_93_94_141,r_141_48_70,0.53,0,70,70,44
41,r_91_114_68,seq78,seq99,r_91_114_68,0.97,-1,67,68,44
3,r_112_97_58,seq132,r_3_135_14,r_112_97_58,1.0,0,58,58,44
10,r_84_105_153,seq78,r_142_139_5,r_84_105_153,0.68,0,153,153,44
90,seq99,r_104_85_131,r_35_15_2,r_104_85_131,0.98,0,131,131,44
1,r_33_18_25,seq98,seq31,r_33_18_25,0.66,2,27,25,44
12,r_29_64_130,seq108,r_1_118_185,r_1_118_185,0.5,-134,51,185,44
4,r_75_27_144,seq55,r_60_44_23,r_75_27_144,0.92,0,144,144,44
11,r_10_140_65,seq131,r_117_57_136,r_10_140_65,1.0,3,68,65,44
20,r_143_47_122,r_52_144_41,r_8_53_95,r_8_53_95,0.85,27,122,95,44
98,seq121,r_82_81_147,r_124_76_99,r_124_76_99,0.94,48,147,99,44
15,r_82_81_147,seq55,r_30_49_104,r_30_49_104,0.85,43,147,104,44
13,r_24_107_52,r_1_118_185,seq102,r_24_107_52,0.83,1,53,52,44
12,r_29_64_130,r_1_118_185,r_61_90_89,r_29_64_130,0.96,0,130,130,44
85,seq79,r_30_49_104,r_93_94_141,r_30_49_104,1.0,0,104,104,44
23,r_61_90_89,seq19,r_3_135_14,r_3_135_14,0.9,13,27,14,44
5,r_51_66_187,r_84_105_153,r_75_27_144,r_75_27_144,0.51,44,188,144,44
27,r_80_148_101,r_5_129_150,seq136,r_80_148_101,0.92,1,102,101,44
2,r_100_20_83,r_51_66_187,seq13,r_100_20_83,0.97,1,84,83,44
47,r_14_125_79,seq58,r_67_134_165,r_14_125_79,0.82,1,80,79,44
34,r_120_41_178,seq50,seq132,r_120_41_178,0.57,2,180,178,44
26,r_60_44_23,r_2_56_155,seq36,r_60_44_23,0.98,5,28,23,44
43,r_67_134_165,r_14_125_79,seq137,r_67_134_165,0.9,3,168,165,44
33,r_104_85_131,seq99,r_24_107_52,r_104_85_131,0.71,0,131,131,44
64,seq22,r_120_41_178,r_95_71_93,r_120_41_178,0.68,-79,99,178,44
47,r_14_125_79,r_67_134_165,seq108,r_67_134_165,1.0,3,168,165,44
9,r_8_53_95,r_68_83_44,r_51_66_187,r_68_83_44,1.0,0,44,44,44
65,seq137,r_141_48_70,seq74,r_141_48_70,1.0,0,70,70,44
38,r_130_72_124,r_2_56_155,seq79,r_130_72_124,0.87,0,124,124,44
34,r_120_41_178,r_69_113_107,seq50,r_69_113_107,1.0,0,107,107,44
24,r_68_83_44,r_8_53_95,r_77_128_50,r_68_83_44,1.0,0,44,44,44
32,r_77_128_50,seq116,r_68_83_44,r_68_83_44,1.0,4,48,44,44
17,r_3_135_14,seq110,seq98,r_3_135_14,0.62,-1,13,14,44
0,r_142_139_5,seq132,r_84_105_153,r_142_139_5,0.49,153,158,5,44
22,r_37_23_103,seq26,seq12,r_37_23_103,0.59,0,103,103,44
28,r_122_40_100,r_143_47_122,r_8_53_95,r_8_53_95,1.0,6,101,95,44
49,r_147_63_109,r_82_81_147,r_33_18_25,r_147_63_109,0.96,0,109,109,44
44,r_38_45_85,r_93_94_141,r_42_115_38,r_38_45_85,0.93,1,86,85,44
35,r_2_56_155,seq12,r_42_115_38,r_2_56_155,0.46,0,155,155,44
23,r_61_90_89,r_3_135_14,seq131,r_61_90_89,0.98,7,96,89,44
36,r_94_93_178,r_140_48_68,r_108_41_115,r_108_41_115,0.96,64,179,115,45
8,r_78_134_148,r_75_135_85,r_6_120_56,r_78_134_148,0.99,-84,64,148,45
43,r_59_79_133,seq129,r_131_95_31,r_59_79_133,0.71,0,133,133,45
26,r_128_42_35,seq96,seq49,r_128_42_35,1.0,2,37,35,45
54,seq7,seq65,r_9_91_128,r_9_91_128,1.0,2,130,128,45
83,seq68,seq28,r_103_52_84,r_103_52_84,1.0,11,95,84,45
81,seq65,seq7,r_122_60_121,r_122_60_121,0.98,1,122,121,45
40,r_139_72_15,r_70_31_129,seq24,r_139_72_15,0.82,0,15,15,45
16,r_75_135_85,seq38,r_64_46_28,r_75_135_85,1.0,0,85,85,45
21,r_27_51_136,seq19,r_131_95_31,r_27_51_136,0.98,0,136,136,45
39,r_44_57_77,seq33,seq54,r_44_57_77,1.0,0,77,77,45
46,r_100_148_9,r_71_149_154,r_110_102_63,r_110_102_63,0.99,90,153,63,45
31,r_6_120_56,r_84_89_99,r_78_134_148,r_6_120_56,1.0,0,56,56,45
14,r_25_12_40,r_73_8_162,seq96,r_25_12_40,1.0,1,41,40,45
45,r_103_52_84,r_140_48_68,seq68,r_103_52_84,1.0,1,85,84,45
76,seq54,r_15_1_66,r_39_97_123,r_15_1_66,0.95,1,67,66,45
35,r_16_92_44,seq65,seq50,r_16_92_44,1.0,2,46,44,45
41,r_73_8_162,seq55,r_123_2_8,r_73_8_162,0.76,0,162,162,45
3,r_86_45_141,r_18_99_4,seq11,r_86_45_141,0.97,1,142,141,45
10,r_110_102_63,r_83_47_34,r_100_148_9,r_110_102_63,1.0,1,64,63,45
8,r_78_134_148,r_6_120_56,r_138_145_7,r_78_134_148,0.99,0,148,148,45
20,r_83_47_34,r_110_102_63,seq38,r_110_102_63,0.85,-14,49,63,45
4,r_70_31_129,seq63,seq38,r_70_31_129,1.0,0,129,129,45
11,r_130_56_168,seq32,r_124_5_23,r_130_56_168,0.68,1,169,168,45
15,r_82_10_152,seq36,r_76_77_49,r_82_10_152,0.87,0,152,152,45
48,r_90_4_89,r_122_60_121,seq32,r_90_4_89,0.85,0,89,89,45
12,r_43_14_176,r_123_2_8,r_64_46_28,r_43_14_176,0.53,0,176,176,45
6,r_15_1_66,seq54,seq111,r_15_1_66,0.97,1,67,66,45
65,seq24,seq66,r_139_72_15,r_139_72_15,1.0,8,23,15,45
81,seq65,r_16_92_44,seq7,r_16_92_44,1.0,3,47,44,45
27,r_81_13_125,seq105,r_131_95_31,r_81_13_125,0.9,0,125,125,45
2,r_88_125_120,seq49,seq19,r_88_125_120,0.97,-1,119,120,45
24,r_104_26_179,seq121,r_138_145_7,r_138_145_7,0.53,174,181,7,45
19,r_76_77_49,seq142,seq35,r_76_77_49,1.0,2,51,49,45
13,r_131_95_31,r_15_1_66,seq132,r_131_95_31,1.0,0,31,31,45
25,r_144_17_145,seq24,r_131_95_31,r_131_95_31,0.92,115,146,31,45
33,r_18_99_4,r_86_45_141,r_131_95_31,r_18_99_4,0.7,138,142,4,45
47,r_123_2_8,r_43_14_176,seq143,r_123_2_8,0.74,168,176,8,45
70,seq35,seq23,r_76_77_49,r_76_77_49,1.0,48,97,49,45
42,r_116_119_10,r_133_98_16,seq87,r_116_119_10,0.85,0,10,10,45
32,r_39_97_123,r_124_5_23,seq54,r_124_5_23,0.53,113,136,23,45
38,r_71_149_154,r_100_148_9,r_131_95_31,r_71_149_154,0.6,0,154,154,45
77,seq55,r_73_8_162,r_141_117_57,r_141_117_57,1.0,105,162,57,45
1,r_64_46_28,r_124_5_23,seq68,r_64_46_28,1.0,0,28,28,45
34,r_141_117_57,r_130_56_168,seq55,r_141_117_57,1.0,0,57,57,45
17,r_124_5_23,r_39_97_123,r_40_112_105,r_40_112_105,1.0,31,136,105,45
9,r_108_41_115,r_130_56_168,r_139_72_15,r_108_41_115,0.98,2,117,115,45
31,r_6_120_56,r_78_134_148,r_70_31_129,r_6_120_56,1.0,92,148,56,45
98,seq126,r_25_12_40,r_84_89_99,r_84_89_99,0.74,32,131,99,45
22,r_106_67_158,seq49,r_39_97_123,r_106_67_158,0.53,3,161,158,45
28,r_9_91_128,seq114,seq19,r_9_91_128,0.96,0,128,128,45
49,r_37_101_69,seq29,seq50,r_37_101_69,1.0,0,69,69,45
56,seq11,seq3,r_86_45_141,r_86_45_141,1.0,4,145,141,45
7,r_84_89_99,seq49,seq74,r_84_89_99,0.91,0,99,99,45
44,r_69_30_87,r_40_112_105,r_116_119_10,r_116_119_10,1.0,78,88,10,45
23,r_122_60_121,seq74,seq65,r_122_60_121,0.98,0,121,121,45
79,seq62,r_70_31_129,r_133_98_16,r_70_31_129,0.99,-58,71,129,45
5,r_133_98_16,seq107,seq62,r_133_98_16,0.78,-1,15,16,45
40,r_99_139_18,r_132_130_187,r_35_105_138,r_35_105_138,0.99,49,187,138,46
30,r_96_33_195,r_80_124_168,r_93_51_88,r_93_51_88,0.62,80,168,88,46
36,r_14_135_134,r_129_84_92,seq29,r_129_84_92,0.99,0,92,92,46
9,r_47_73_147,r_91_20_39,r_78_88_196,r_47_73_147,0.79,0,147,147,46
14,r_61_39_135,seq57,seq29,r_61_39_135,0.92,0,135,135,46
18,r_148_34_32,seq149,r_111_143_27,r_148_34_32,0.97,2,34,32,46
37,r_122_114_64,r_6_27_169,seq12,r_122_114_64,1.0,0,64,64,46
71,seq36,seq31,r_148_34_32,r_148_34_32,1.0,99,131,32,46
16,r_145_140_84,r_83_24_78,seq100,r_145_140_84,1.0,0,84,84,46
21,r_80_124_168,r_96_33_195,r_97_121_5,r_80_124_168,0.55,0,168,168,46
39,r_92_18_87,r_45_40_175,r_23_68_36,r_92_18_87,1.0,0,87,87,46
1,r_129_84_92,seq67,r_6_27_169,r_129_84_92,0.5,81,173,92,46
1,r_129_84_92,r_14_135_134,seq67,r_129_84_92,0.93,0,92,92,46
5,r_6_27_169,seq86,r_129_84_92,r_129_84_92,0.87,77,169,92,46
46,r_120_72_181,seq131,r_83_24_78,r_83_24_78,0.54,103,181,78,46
35,r_21_38_51,seq82,r_49_144_15,r_21_38_51,0.96,0,51,51,46
19,r_95_42_127,r_94_1_126,seq115,r_95_42_127,0.97,0,127,127,46
9,r_47_73_147,seq50,r_91_20_39,r_47_73_147,0.91,-107,40,147,46
41,r_108_56_131,r_23_68_36,r_136_9_29,r_108_56_131,0.79,-94,37,131,46
36,r_14_135_134,seq29,r_23_68_36,r_14_135_134,0.77,0,134,134,46
95,seq115,seq30,r_95_42_127,r_95_42_127,1.0,14,141,127,46
76,seq57,r_61_39_135,r_45_40_175,r_61_39_135,0.91,0,135,135,46
38,r_132_130_187,r_99_139_18,r_28_41_14,r_132_130_187,0.44,0,187,187,46
31,r_89_127_80,r_71_44_166,seq8,r_71_44_166,0.76,-54,112,166,46
44,r_119_101_24,seq17,seq85,r_119_101_24,1.0,0,24,24,46
3,r_98_147_137,seq100,r_89_127_80,r_98_147_137,0.8,0,137,137,46
48,r_49_144_15,r_146_54_141,r_141_5_143,r_49_144_15,0.75,0,15,15,46
23,r_45_40_175,seq43,r_74_102_83,r_45_40_175,0.8,1,176,175,46
22,r_141_5_143,r_78_88_196,r_49_144_15,r_49_144_15,0.65,19,34,15,46
26,r_126_59_21,r_70_110_105,r_113_81_99,r_126_59_21,0.98,84,105,21,46
72,seq37,r_146_54_141,r_16_7_40,r_16_7_40,0.83,37,77,40,46
4,r_146_54_141,seq37,seq87,r_146_54_141,0.85,0,141,141,46
0,r_35_105_138,seq117,r_136_9_29,r_35_105_138,0.65,1,139,138,46
73,seq43,r_93_51_88,seq82,r_93_51_88,1.0,2,90,88,46
20,r_83_24_78,r_145_140_84,r_45_40_175,r_145_140_84,1.0,-6,78,84,46
13,r_48_46_114,r_35_105_138,seq29,r_48_46_114,0.81,1,115,114,46
98,seq123,seq15,r_0_142_81,r_0_142_81,1.0,37,118,81,46
15,r_0_142_81,r_80_124_168,seq123,r_0_142_81,1.0,0,81,81,46
49,r_136_9_29,r_108_56_131,r_119_101_24,r_108_56_131,1.0,0,131,131,46
43,r_28_41_14,r_61_39_135,r_71_44_166,r_28_41_14,0.48,3,17,14,46
99,seq125,r_128_138_184,r_108_56_131,r_108_56_131,1.0,53,184,131,46
22,r_141_5_143,r_49_144_15,seq26,r_141_5_143,0.93,0,143,143,46
2,r_71_44_166,r_89_127_80,r_95_42_127,r_89_127_80,0.7,86,166,80,46
41,r_108_56_131,r_136_9_29,seq2,r_108_56_131,0.94,0,131,131,46
47,r_58_63_103,r_70_110_105,seq116,r_70_110_105,0.97,-3,102,105,46
17,r_111_143_27,r_35_105_138,seq36,r_111_143_27,0.81,0,27,27,46
38,r_132_130_187,r_23_68_36,r_99_139_18,r_99_139_18,0.69,4,22,18,46
24,r_93_51_88,seq43,r_122_114_64,r_93_51_88,0.99,0,88,88,46
25,r_70_110_105,r_58_63_103,seq3,r_70_110_105,0.99,0,105,105,46
43,r_28_41_14,r_71_44_166,seq8,r_71_44_166,0.97,-55,111,166,46
48,r_49_144_15,r_141_5_143,r_78_88_196,r_141_5_143,1.0,0,143,143,46
40,r_99_139_18,r_95_42_127,r_132_130_187,r_99_139_18,1.0,0,18,18,46
6,r_91_20_39,r_47_73_147,r_108_56_131,r_91_20_39,0.96,108,147,39,46
20,r_83_24_78,r_45_40_175,seq82,r_45_40_175,1.0,1,176,175,46
32,r_113_81_99,seq30,r_126_59_21,r_113_81_99,0.99,0,99,99,46
6,r_91_20_39,r_70_110_105,r_47_73_147,r_70_110_105,0.59,-65,40,105,46
8,r_16_7_40,seq67,seq37,r_16_7_40,0.96,0,40,40,46
81,seq131,r_120_72_181,r_35_105_138,r_35_105_138,0.98,43,181,138,46
49,r_136_9_29,seq123,r_108_56_131,r_136_9_29,0.99,0,29,29,46
10,r_78_88_196,r_141_5_143,r_106_103_37,r_141_5_143,0.65,-93,50,143,46
34,r_106_103_37,seq133,r_78_88_196,r_106_103_37,0.72,0,37,37,46
7,r_74_102_83,r_128_138_184,seq67,r_74_102_83,0.98,0,83,83,46
27,r_23_68_36,r_108_56_131,r_78_88_196,r_23_68_36,0.62,1,37,36,46
12,r_64_134_86,seq107,r_78_88_196,r_64_134_86,0.96,-3,83,86,46
92,seq146,r_23_126_151,seq20,r_23_126_151,0.99,2,153,151,47
8,r_52_8_102,r_148_32_194,seq133,r_52_8_102,0.97,0,102,102,47
23,r_94_17_27,r_66_119_154,r_48_84_14,r_48_84_14,0.57,9,23,14,47
83,seq79,r_112_34_97,seq40,r_112_34_97,1.0,2,99,97,47
13,r_44_65_47,seq139,seq20,r_44_65_47,0.46,81,128,47,47
9,r_48_84_14,r_149_76_183,r_94_17_27,r_48_84_14,0.94,0,14,14,47
16,r_141_55_164,seq27,seq115,r_141_55_164,0.32,0,164,164,47
21,r_112_34_97,seq79,r_143_135_75,r_112_34_97,0.99,2,99,97,47
97,seq118,r_88_10_184,r_4_91_104,r_4_91_104,1.0,79,183,104,47
46,r_122_35_96,r_109_50_188,seq46,r_122_35_96,0.85,0,96,96,47
90,seq102,r_147_111_92,r_105_107_24,r_105_107_24,0.95,-1,23,24,47
32,r_73_19_33,r_147_111_92,seq145,r_73_19_33,0.94,0,33,33,47
45,r_105_107_24,r_66_119_154,seq102,r_105_107_24,0.63,-1,23,24,47
95,seq115,seq20,r_141_55_164,r_141_55_164,0.59,1,165,164,47
76,seq54,r_109_50_188,seq72,r_109_50_188,0.81,0,188,188,47
31,r_78_37_88,r_52_8_102,seq116,r_78_37_88,0.97,0,88,88,47
10,r_33_90_123,seq136,seq20,r_33_90_123,0.61,1,124,123,47
26,r_63_123_149,r_62_117_37,seq142,r_63_123_149,0.54,4,153,149,47
72,seq42,r_41_92_186,r_109_50_188,r_41_92_186,0.34,4,190,186,47
4,r_4_91_104,r_94_17_27,seq118,r_4_91_104,1.0,0,104,104,47
0,r_147_111_92,seq144,seq97,r_147_111_92,0.8,4,96,92,47
11,r_47_45_91,seq46,seq30,r_47_45_91,1.0,0,91,91,47
20,r_66_119_154,seq9,seq51,r_66_119_154,0.94,0,154,154,47
13,r_44_65_47,r_147_111_92,seq139,r_44_65_47,0.69,29,76,47,47
48,r_110_67_65,r_130_22_54,seq12,r_110_67_65,0.87,5,70,65,47
6,r_23_126_151,seq146,r_47_45_91,r_23_126_151,0.52,2,153,151,47
27,r_149_76_183,seq51,seq31,r_149_76_183,0.42,0,183,183,47
29,r_88_10_184,r_13_25_34,seq118,r_13_25_34,0.73,-15,19,34,47
35,r_13_25_34,r_88_10_184,seq9,r_13_25_34,0.92,0,34,34,47
87,seq97,seq12,r_147_111_92,r_147_111_92,0.68,0,92,92,47
1,r_2_83_10,seq30,seq18,r_2_83_10,1.0,0,10,10,47
2,r_29_26_121,r_68_108_63,seq125,r_29_26_121,0.5,22,143,121,47
40,r_101_11_156,r_95_120_166,r_2_83_10,r_101_11_156,0.74,4,160,156,47
74,seq51,r_149_76_183,r_66_119_154,r_66_119_154,0.58,29,183,154,47
18,r_71_64_71,seq137,seq12,r_71_64_71,0.99,0,71,71,47
33,r_77_98_131,seq102,r_4_91_104,r_4_91_104,0.96,71,175,104,47
61,seq145,seq9,r_87_0_106,r_87_0_106,0.43,55,161,106,47
38,r_95_120_166,seq142,seq138,r_95_120_166,0.54,1,167,166,47
77,seq137,r_129_36_110,seq114,r_129_36_110,0.85,0,110,110,47
34,r_41_92_186,seq42,r_56_89_176,r_56_89_176,0.91,10,186,176,47
14,r_81_58_51,r_129_36_110,r_148_32_194,r_81_58_51,0.64,0,51,51,47
17,r_127_1_187,seq51,r_29_26_121,r_127_1_187,0.45,0,187,187,47
29,r_88_10_184,seq118,r_147_111_92,r_147_111_92,0.72,92,184,92,47
28,r_143_135_75,seq114,r_86_82_6,r_143_135_75,1.0,2,77,75,47
44,r_134_106_43,r_23_126_151,seq100,r_134_106_43,1.0,1,44,43,47
36,r_93_7_38,seq31,seq142,r_93_7_38,0.95,5,43,38,47
49,r_104_132_105,r_109_50_188,r_148_32_194,r_104_132_105,0.79,0,105,105,47
10,r_33_90_123,seq20,r_141_55_164,r_33_90_123,0.54,53,176,123,47
43,r_140_43_45,r_52_8_102,seq102,r_140_43_45,1.0,0,45,45,47
30,r_107_74_165,seq35,seq85,r_107_74_165,0.75,0,165,165,48
9,r_120_71_76,seq15,r_110_45_150,r_110_45_150,1.0,15,165,150,48
18,r_59_52_173,seq58,seq2,r_59_52_173,0.89,0,173,173,48
14,r_16_125_89,seq44,seq55,r_16_125_89,0.99,0,89,89,48
37,r_91_23_140,seq111,seq131,r_91_23_140,0.88,0,140,140,48
3,r_42_3_16,seq88,r_57_17_87,r_57_17_87,1.0,1,88,87,48
86,seq94,r_60_121_152,r_138_117_130,r_138_117_130,0.98,23,153,130,48
16,r_7_22_137,seq49,seq11,r_7_22_137,0.85,-1,136,137,48
21,r_137_62_91,seq30,seq127,r_137_62_91,0.98,0,91,91,48
1,r_80_29_61,seq88,seq13,r_80_29_61,1.0,0,61,61,48
42,r_135_21_145,r_59_52_173,seq36,r_135_21_145,0.65,0,145,145,48
11,r_105_48_170,r_129_68_143,r_63_5_9,r_63_5_9,0.84,2,11,9,48
19,r_81_102_108,r_86_4_149,seq70,r_81_102_108,0.6,0,108,108,48
44,r_139_148_46,seq40,seq79,r_139_148_46,1.0,0,46,46,48
31,r_33_132_97,r_31_95_169,seq15,r_33_132_97,1.0,0,97,97,48
41,r_116_99_6,r_140_39_190,r_137_62_91,r_137_62_91,1.0,13,104,91,48
10,r_146_25_70,seq34,r_141_66_138,r_146_25_70,1.0,0,70,70,48
74,seq58,r_1_147_180,r_93_47_112,r_1_147_180,0.98,0,180,180,48
26,r_140_39_190,seq94,r_134_78_13,r_140_39_190,0.42,0,190,190,48
4,r_73_12_107,seq111,seq108,r_73_12_107,0.96,3,110,107,48
78,seq77,r_120_71_76,r_134_78_13,r_120_71_76,0.69,-14,62,76,48
73,seq55,seq13,r_16_125_89,r_16_125_89,1.0,14,103,89,48
20,r_83_92_105,r_130_113_22,r_61_64_182,r_83_92_105,0.95,0,105,105,48
13,r_72_10_74,r_31_95_169,seq109,r_72_10_74,1.0,1,75,74,48
6,r_82_142_34,r_86_4_149,r_93_47_112,r_82_142_34,0.97,104,138,34,48
10,r_146_25_70,r_141_66_138,seq30,r_141_66_138,1.0,1,139,138,48
3,r_42_3_16,r_57_17_87,seq88,r_42_3_16,0.98,0,16,16,48
2,r_129_68_143,r_54_89_154,r_31_95_169,r_129_68_143,0.93,0,143,143,48
47,r_93_47_112,seq79,r_82_142_34,r_93_47_112,0.92,2,114,112,48
40,r_28_122_174,seq19,r_1_147_180,r_1_147_180,0.96,2,182,180,48
5,r_128_76_36,seq67,r_61_64_182,r_128_76_36,0.99,0,36,36,48
74,seq58,r_82_142_34,r_1_147_180,r_1_147_180,0.76,-54,126,180,48
18,r_59_52_173,r_135_21_145,seq58,r_135_21_145,0.81,2,147,145,48
29,r_60_121_152,r_27_118_178,r_51_6_123,r_51_6_123,0.97,30,153,123,48
24,r_110_45_150,seq30,r_120_71_76,r_110_45_150,0.81,0,150,150,48
34,r_141_66_138,r_146_25_70,r_51_6_123,r_141_66_138,1.0,1,139,138,48
25,r_8_145_79,seq77,r_72_10_74,r_72_10_74,0.5,8,82,74,48
65,seq35,r_107_74_165,seq143,r_107_74_165,0.64,0,165,165,48
32,r_57_17_87,seq53,r_42_3_16,r_57_17_87,0.96,2,89,87,48
52,seq131,seq114,r_91_23_140,r_91_23_140,1.0,16,156,140,48
77,seq70,seq15,r_81_102_108,r_81_102_108,0.99,34,142,108,48
33,r_61_64_182,r_72_10_74,r_128_76_36,r_61_64_182,0.96,-138,44,182,48
34,r_141_66_138,seq30,r_146_25_70,r_146_25_70,1.0,7,77,70,48
0,r_134_78_13,r_33_132_97,seq77,r_134_78_13,0.97,1,14,13,48
68,seq40,r_139_148_46,r_24_100_84,r_139_148_46,0.95,0,46,46,48
17,r_1_147_180,seq109,r_138_117_130,r_138_117_130,0.57,49,179,130,48
94,seq109,r_1_147_180,r_72_10_74,r_72_10_74,1.0,30,104,74,48
22,r_51_6_123,seq84,seq133,r_51_6_123,0.97,0,123,123,48
28,r_75_37_116,seq127,r_81_102_108,r_75_37_116,0.93,1,117,116,48
49,r_97_124_144,r_54_89_154,seq38,r_54_89_154,0.98,-5,149,154,48
56,seq13,seq119,r_80_29_61,r_80_29_61,1.0,3,64,61,48
23,r_27_118_178,r_18_144_188,r_7_22_137,r_18_144_188,0.65,-9,179,188,48
79,seq79,seq84,r_56_115_155,r_56_115_155,1.0,12,167,155,48
35,r_86_4_149,r_82_142_34,r_97_124_144,r_86_4_149,0.71,1,150,149,48
12,r_56_115_155,seq96,seq79,r_56_115_155,0.62,3,158,155,48
30,r_112_100_106,r_135_69_153,seq3,r_135_69_153,0.77,-38,115,153,49
26,r_102_17_120,r_18_127_46,r_86_55_12,r_102_17_120,0.83,-74,46,120,49
9,r_135_69_153,r_0_12_14,seq8,r_135_69_153,0.66,0,153,153,49
17,r_32_34_47,seq16,r_64_87_148,r_32_34_47,1.0,0,47,47,49
14,r_56_13_59,r_30_99_95,seq125,r_56_13_59,1.0,1,60,59,49
43,r_68_119_154,seq134,seq93,r_68_119_154,0.8,2,156,154,49
83,seq80,seq142,r_143_51_82,r_143_51_82,0.79,0,82,82,49
10,r_33_66_31,r_94_81_100,seq113,r_33_66_31,1.0,0,31,31,49
86,seq93,seq19,r_68_119_154,r_68_119_154,1.0,7,161,154,49
16,r_23_106_197,r_26_79_187,r_15_20_61,r_15_20_61,1.0,34,95,61,49
39,r_63_76_149,seq3,seq7,r_63_76_149,0.58,4,153,149,49
1,r_140_107_118,r_28_21_99,r_32_34_47,r_32_34_47,1.0,53,100,47,49
46,r_88_104_60,r_62_115_144,seq130,r_88_104_60,1.0,0,60,60,49
42,r_143_51_82,r_2_67_142,seq80,r_143_51_82,0.78,0,82,82,49
45,r_90_126_102,r_137_91_189,r_85_149_97,r_90_126_102,0.53,0,102,102,49
19,r_42_141_90,seq120,seq37,r_42_141_90,0.8,0,90,90,49
17,r_32_34_47,r_64_87_148,r_140_107_118,r_64_87_148,0.61,-44,104,148,49
27,r_0_12_14,r_135_69_153,seq1,r_135_69_153,0.98,0,153,153,49
61,seq16,r_32_34_47,r_86_55_12,r_32_34_47,0.74,0,47,47,49
31,r_45_73_132,seq84,r_42_141_90,r_45_73_132,0.82,-1,131,132,49
41,r_50_118_158,seq3,r_2_67_142,r_50_118_158,0.51,1,159,158,49
18,r_94_81_100,seq84,seq97,r_94_81_100,0.97,3,103,100,49
90,seq105,r_137_91_189,r_135_69_153,r_135_69_153,0.74,37,190,153,49
37,r_14_95_25,seq108,r_109_75_179,r_14_95_25,1.0,-6,19,25,49
27,r_0_12_14,r_56_13_59,r_135_69_153,r_0_12_14,0.47,1,15,14,49
98,seq123,seq19,r_47_136_40,r_47_136_40,1.0,11,51,40,49
0,r_64_87_148,seq7,r_94_81_100,r_64_87_148,0.71,2,150,148,49
15,r_47_136_40,r_112_100_106,seq123,r_47_136_40,0.97,0,40,40,49
20,r_38_103_72,r_94_81_100,seq40,r_38_103_72,1.0,1,73,72,49
13,r_29_129_76,seq114,r_78_82_71,r_29_129_76,0.7,0,76,76,49
44,r_121_31_57,r_78_82_71,seq114,r_121_31_57,0.88,1,58,57,49
6,r_137_91_189,seq105,r_98_96_141,r_98_96_141,0.86,49,190,141,49
21,r_86_55_12,r_62_115_144,seq145,r_86_55_12,0.99,0,12,12,49
99,seq125,r_117_6_162,r_56_13_59,r_56_13_59,0.99,90,149,59,49
34,r_138_147_49,r_112_100_106,r_23_106_197,r_138_147_49,1.0,1,50,49,49
87,seq97,seq43,r_94_81_100,r_94_81_100,0.95,19,119,100,49
2,r_148_9_44,r_117_6_162,seq114,r_148_9_44,1.0,0,44,44,49
47,r_11_133_93,seq130,r_26_79_187,r_11_133_93,1.0,0,93,93,49
40,r_98_96_141,r_109_75_179,seq19,r_98_96_141,0.67,0,141,141,49
18,r_94_81_100,r_38_103_72,seq84,r_38_103_72,0.96,1,73,72,49
29,r_15_20_61,r_30_99_95,r_138_147_49,r_15_20_61,0.8,1,62,61,49
61,seq16,r_86_55_12,r_146_92_51,r_86_55_12,0.71,105,117,12,49
24,r_26_79_187,r_23_106_197,seq123,r_23_106_197,0.31,-10,187,197,49
25,r_124_39_185,seq37,r_38_103_72,r_38_103_72,0.87,114,186,72,49
33,r_128_83_1,r_2_67_142,r_62_115_144,r_128_83_1,0.69,141,142,1,49
47,r_11_133_93,r_26_79_187,r_50_118_158,r_50_118_158,0.92,0,158,158,49
38,r_117_6_162,seq113,seq8,r_117_6_162,0.88,0,162,162,49
9,r_135_69_153,r_47_136_40,r_0_12_14,r_135_69_153,0.59,-138,15,153,49
26,r_102_17_120,r_86_55_12,seq123,r_102_17_120,1.0,0,120,120,49
22,r_46_111_110,r_112_100_106,r_94_81_100,r_46_111_110,0.81,1,111,110,49
28,r_2_67_142,r_128_83_1,r_90_126_102,r_128_83_1,0.9,141,142,1,49
49,r_60_74_86,seq19,seq134,r_60_74_86,1.0,0,86,86,49
7,r_78_82_71,seq71,seq53,r_78_82_71,1.0,0,71,71,49
8,r_18_127_46,r_102_17_120,seq125,r_102_17_120,0.63,-74,46,120,49
11,r_146_92_51,seq97,seq16,r_146_92_51,1.0,1,52,51,49
62,seq145,seq16,r_86_55_12,r_86_55_12,1.0,3,15,12,49
79,seq70,r_117_6_162,seq72,r_117_6_162,0.88,-95,67,162,49
35,r_28_21_99,r_140_107_118,seq37,r_28_21_99,0.81,1,100,99,49
12,r_62_115_144,r_63_76_149,r_60_74_86,r_60_74_86,0.99,59,145,86,49
30,r_102_17_96,seq123,r_93_20_77,r_102_17_96,1.0,1,97,96,50
8,r_94_95_73,seq124,r_6_136_144,r_6_136_144,0.66,-73,71,144,50
43,r_130_66_13,r_114_7_83,r_80_147_84,r_130_66_13,1.0,72,85,13,50
54,seq133,r_80_147_84,r_47_75_11,r_80_147_84,0.96,-11,73,84,50
83,seq100,seq108,r_74_146_80,r_74_146_80,1.0,3,83,80,50
37,r_140_46_119,r_76_89_114,seq29,r_140_46_119,1.0,5,124,119,50
16,r_149_5_129,seq73,r_98_82_118,r_149_5_129,1.0,1,130,129,50
21,r_117_44_159,seq143,seq2,r_117_44_159,0.69,0,159,159,50
39,r_41_13_151,seq1,r_76_89_114,r_41_13_151,0.91,1,152,151,50
1,r_31_97_93,r_39_40_134,seq123,r_31_97_93,1.0,0,93,93,50
46,r_98_82_118,r_140_46_119,seq8,r_98_82_118,0.84,1,119,118,50
48,r_59_64_35,seq100,seq19,r_59_64_35,1.0,1,36,35,50
80,seq91,seq26,r_114_7_83,r_114_7_83,1.0,3,86,83,50
69,seq51,r_43_67_183,r_30_134_14,r_30_134_14,0.9,169,183,14,50
45,r_93_20_77,seq104,seq83,r_93_20_77,1.0,2,79,77,50
19,r_139_48_79,r_4_86_111,seq96,r_4_86_111,0.79,-21,90,111,50
35,r_24_53_44,seq14,r_61_16_181,r_24_53_44,0.99,3,47,44,50
65,seq26,r_43_67_183,r_30_134_14,r_30_134_14,1.0,0,14,14,50
41,r_68_15_67,r_4_86_111,r_59_64_35,r_68_15_67,0.83,2,69,67,50
3,r_141_112_169,r_61_16_181,r_94_95_73,r_141_112_169,0.83,0,169,169,50
10,r_76_89_114,r_140_46_119,seq55,r_76_89_114,0.96,3,117,114,50
14,r_113_28_16,r_45_145_23,seq85,r_113_28_16,0.99,0,16,16,50
26,r_148_58_156,r_50_49_167,seq29,r_50_49_167,0.95,-10,157,167,50
8,r_94_95_73,r_6_136_144,seq8,r_6_136_144,1.0,-6,138,144,50
46,r_98_82_118,seq8,r_149_5_129,r_98_82_118,0.52,38,156,118,50
0,r_74_146_80,r_60_10_120,seq100,r_74_146_80,1.0,0,80,80,50
22,r_61_16_181,r_141_112_169,r_24_53_44,r_24_53_44,0.79,7,51,44,50
20,r_138_33_137,r_137_132_103,r_47_75_11,r_138_33_137,0.81,-36,101,137,50
13,r_137_132_103,r_138_33_137,seq88,r_137_132_103,0.81,0,103,103,50
15,r_34_62_97,r_137_132_103,r_87_12_32,r_87_12_32,0.63,65,97,32,50
6,r_6_136_144,r_27_63_132,r_94_95_73,r_94_95_73,0.89,5,78,73,50
49,r_47_75_11,seq96,seq133,r_47_75_11,1.0,1,12,11,50
27,r_50_49_167,r_148_58_156,r_32_77_101,r_148_58_156,0.79,8,164,156,50
22,r_61_16_181,r_24_53_44,r_80_147_84,r_24_53_44,0.69,137,181,44,50
98,seq126,r_59_64_35,seq8,r_59_64_35,0.75,0,35,35,50
40,r_60_10_120,seq81,seq144,r_60_10_120,0.77,1,121,120,50
18,r_80_147_84,seq133,seq42,r_80_147_84,1.0,-1,83,84,50
29,r_135_142_190,seq108,r_27_63_132,r_135_142_190,0.4,-68,122,190,50
24,r_39_40_134,seq131,seq81,r_39_40_134,0.9,1,135,134,50
35,r_24_53_44,r_61_16_181,r_6_136_144,r_24_53_44,0.58,137,181,44,50
2,r_45_145_23,r_6_136_144,seq124,r_6_136_144,0.5,-120,24,144,50
33,r_54_71_178,seq79,r_93_20_77,r_93_20_77,0.92,101,178,77,50
50,seq0,r_4_86_111,r_35_25_20,r_4_86_111,0.52,1,112,111,50
42,r_35_25_20,seq22,r_21_110_40,r_35_25_20,0.9,-4,16,20,50
6,r_6_136_144,r_94_95_73,r_139_48_79,r_6_136_144,0.96,0,144,144,50
17,r_38_99_27,r_137_132_103,seq22,r_38_99_27,1.0,3,30,27,50
32,r_69_11_91,r_137_132_103,seq116,r_69_11_91,1.0,1,92,91,50
38,r_103_107_107,r_36_3_177,seq133,r_103_107_107,1.0,1,108,107,50
76,seq81,r_59_64_35,r_39_40_134,r_39_40_134,0.98,21,155,134,50
34,r_115_119_146,r_106_52_194,seq126,r_115_119_146,0.95,3,149,146,50
56,seq8,r_27_63_132,r_149_5_129,r_149_5_129,1.0,4,133,129,50
7,r_32_77_101,r_36_3_177,seq111,r_32_77_101,1.0,1,102,101,50
44,r_114_7_83,r_130_66_13,seq91,r_114_7_83,0.94,1,84,83,50
11,r_87_12_32,r_149_5_129,seq109,r_87_12_32,1.0,0,32,32,50
23,r_21_110_40,r_115_119_146,seq73,r_115_119_146,0.88,3,149,146,50
82,seq96,r_148_58_156,r_139_48_79,r_148_58_156,0.53,-49,107,156,50
12,r_4_86_111,seq0,seq37,r_4_86_111,0.91,0,111,111,50
30,r_96_85_165,seq125,seq31,r_96_85_165,0.49,0,165,165,51
9,r_47_109_12,r_60_100_15,seq134,r_47_109_12,1.0,0,12,12,51
14,r_26_94_104,seq138,r_3_54_137,r_26_94_104,0.74,0,104,104,51
8,r_10_104_99,r_37_106_186,r_88_5_28,r_10_104_99,1.0,0,99,99,51
43,r_146_92_66,r_143_16_158,r_88_5_28,r_146_92_66,1.0,0,66,66,51
83,seq77,r_73_23_182,r_98_78_119,r_98_78_119,0.83,65,184,119,51
3,r_75_86_34,r_38_61_175,r_6_148_144,r_75_86_34,1.0,1,35,34,51
59,seq149,r_37_106_186,r_84_83_145,r_84_83_145,0.43,41,186,145,51
16,r_18_126_199,r_32_74_96,r_114_110_79,r_32_74_96,0.93,0,96,96,51
21,r_93_147_153,seq20,r_105_140_126,r_93_147_153,0.83,0,153,153,51
39,r_81_2_91,r_130_13_121,r_139_14_7,r_81_2_91,1.0,0,91,91,51
1,r_84_83_145,r_52_12_55,r_122_131_44,r_84_83_145,0.98,4,149,145,51
1,r_84_83_145,r_42_135_81,r_52_12_55,r_52_12_55,0.92,26,81,55,51
5,r_39_119_181,seq50,r_52_12_55,r_39_119_181,0.54,0,181,181,51
42,r_98_78_119,seq56,seq77,r_98_78_119,0.91,0,119,119,51
70,seq51,r_102_79_148,seq99,r_102_79_148,0.68,-119,29,148,51
69,seq50,r_39_119_181,r_27_72_120,r_27_72_120,0.86,44,164,120,51
45,r_27_72_120,seq31,seq50,r_27_72_120,0.97,1,121,120,51
19,r_102_79_148,seq1,r_26_94_104,r_102_79_148,0.83,0,148,148,51
15,r_6_148_144,r_75_86_34,r_114_110_79,r_6_148_144,1.0,0,144,144,51
32,r_82_71_35,seq8,seq99,r_82_71_35,0.87,0,35,35,51
4,r_111_21_83,seq70,r_15_17_40,r_15_17_40,1.0,6,46,40,51
31,r_65_107_130,seq90,r_26_94_104,r_65_107_130,0.95,1,131,130,51
41,r_115_28_140,seq69,r_3_54_137,r_115_28_140,0.96,0,140,140,51
34,r_105_140_126,r_52_12_55,r_93_147_153,r_93_147_153,0.88,0,153,153,51
26,r_42_135_81,r_84_83_145,r_122_131_44,r_42_135_81,0.86,-1,80,81,51
15,r_6_148_144,seq68,r_75_86_34,r_75_86_34,1.0,2,36,34,51
73,seq57,r_11_132_188,r_39_119_181,r_11_132_188,0.42,2,190,188,51
38,r_3_54_137,r_26_94_104,r_115_28_140,r_3_54_137,0.96,3,140,137,51
98,seq125,r_96_85_165,seq117,r_96_85_165,0.85,0,165,165,51
48,r_130_13_121,r_81_2_91,r_87_46_75,r_130_13_121,1.0,0,121,121,51
12,r_129_133_19,r_120_40_101,seq116,r_120_40_101,0.9,-18,83,101,51
13,r_38_61_175,r_88_5_28,r_96_85_165,r_96_85_165,1.0,10,175,165,51
6,r_80_0_114,seq141,seq68,r_80_0_114,0.91,3,117,114,51
46,r_91_89_39,r_142_59_78,r_143_16_158,r_91_89_39,1.0,1,40,39,51
12,r_129_133_19,seq62,r_120_40_101,r_129_133_19,0.88,-1,18,19,51
2,r_43_36_163,seq44,r_26_94_104,r_43_36_163,0.64,0,163,163,51
47,r_142_59_78,r_42_135_81,r_143_16_158,r_142_59_78,0.66,1,79,78,51
10,r_15_17_40,r_39_119_181,r_75_86_34,r_15_17_40,1.0,1,41,40,51
40,r_32_74_96,seq69,seq101,r_32_74_96,1.0,0,96,96,51
18,r_114_110_79,r_29_53_118,r_18_126_199,r_29_53_118,0.81,-37,81,118,51
29,r_87_46_75,r_143_16_158,seq57,r_87_46_75,1.0,1,76,75,51
25,r_37_106_186,seq149,r_80_0_114,r_37_106_186,0.44,0,186,186,51
33,r_120_40_101,seq138,r_11_132_188,r_11_132_188,0.29,-121,67,188,51
13,r_38_61_175,r_75_86_34,r_88_5_28,r_75_86_34,1.0,1,35,34,51
33,r_120_40_101,r_11_132_188,seq117,r_120_40_101,0.98,0,101,101,51
38,r_3_54_137,seq62,r_26_94_104,r_26_94_104,0.87,7,111,104,51
34,r_105_140_126,seq31,r_52_12_55,r_52_12_55,1.0,72,127,55,51
3,r_75_86_34,r_6_148_144,r_111_21_83,r_75_86_34,0.96,49,83,34,51
0,r_60_100_15,r_114_110_79,seq34,r_60_100_15,0.96,-1,14,15,51
22,r_52_12_55,r_81_2_91,seq57,r_52_12_55,1.0,0,55,55,51
28,r_29_53_118,r_96_85_165,seq33,r_29_53_118,1.0,0,118,118,51
99,seq127,seq20,r_139_14_7,r_139_14_7,1.0,19,26,7,51
49,r_30_67_61,seq63,r_15_17_40,r_30_67_61,1.0,0,61,61,51
14,r_26_94_104,r_3_54_137,r_65_107_130,r_26_94_104,0.77,35,139,104,51
24,r_41_136_46,r_87_46_75,seq97,r_41_136_46,1.0,1,47,46,51
35,r_11_132_188,seq57,r_139_14_7,r_139_14_7,0.56,183,190,7,51
7,r_122_131_44,seq138,seq149,r_122_131_44,1.0,2,46,44,51
30,r_55_62_189,seq23,r_79_83_163,r_79_83_163,0.72,26,189,163,52
51,seq1,r_116_60_164,seq13,r_116_60_164,1.0,0,164,164,52
9,r_45_78_98,r_10_125_173,seq99,r_10_125_173,0.99,0,173,173,52
14,r_10_125_173,seq99,r_45_78_98,r_45_78_98,1.0,4,102,98,52
8,r_18_142_150,r_79_83_163,seq26,r_18_142_150,0.96,0,150,150,52
54,seq7,r_40_22_171,r_149_68_73,r_149_68_73,0.92,-2,71,73,52
46,r_98_113_25,r_59_129_123,seq69,r_98_113_25,1.0,0,25,25,52
16,r_8_130_165,r_138_140_196,seq67,r_8_130_165,0.94,0,165,165,52
21,r_81_114_154,r_61_92_158,r_18_142_150,r_61_92_158,1.0,-2,156,158,52
39,r_82_17_161,r_138_140_196,seq24,r_82_17_161,0.89,0,161,161,52
31,r_9_91_181,r_144_66_24,r_115_37_77,r_9_91_181,0.99,0,181,181,52
5,r_54_100_116,seq14,seq89,r_54_100_116,0.89,9,125,116,52
42,r_61_92_158,r_81_114_154,r_19_84_131,r_81_114_154,0.68,0,154,154,52
43,r_32_85_32,r_34_63_186,r_59_129_123,r_32_85_32,1.0,0,32,32,52
18,r_127_145_35,seq6,seq97,r_127_145_35,0.83,0,35,35,52
33,r_31_109_59,seq120,r_61_92_158,r_31_109_59,1.0,0,59,59,52
69,seq39,r_40_22_171,r_148_42_75,r_148_42_75,1.0,6,81,75,52
20,r_2_101_22,r_19_84_131,seq108,r_2_101_22,1.0,-2,20,22,52
27,r_59_129_123,r_98_113_25,r_32_85_32,r_59_129_123,1.0,-98,25,123,52
28,r_52_58_58,r_54_100_116,seq95,r_52_58_58,1.0,0,58,58,52
45,r_34_63_186,r_32_85_32,seq26,r_32_85_32,0.98,0,32,32,52
12,r_133_47_43,r_43_124_16,r_70_121_61,r_43_124_16,1.0,1,17,16,52
27,r_59_129_123,r_32_85_32,seq6,r_59_129_123,0.81,1,124,123,52
60,seq146,r_76_3_37,seq95,r_76_3_37,0.99,-6,31,37,52
31,r_9_91_181,r_19_84_131,r_144_66_24,r_144_66_24,0.95,100,124,24,52
41,r_134_106_130,seq108,seq136,r_134_106_130,0.64,0,130,130,52
89,seq99,r_10_125_173,r_45_78_98,r_45_78_98,0.9,29,127,98,52
38,r_70_121_61,seq69,seq11,r_70_121_61,1.0,-2,59,61,52
26,r_137_53_71,r_87_141_193,seq117,r_137_53_71,1.0,0,71,71,52
15,r_38_132_11,r_59_129_123,seq50,r_38_132_11,0.69,0,11,11,52
47,r_43_124_16,r_133_47_43,seq67,r_43_124_16,0.74,-1,15,16,52
14,r_10_125_173,r_45_78_98,seq15,r_10_125_173,0.99,0,173,173,52
4,r_19_84_131,r_9_91_181,r_61_92_158,r_19_84_131,0.47,2,133,131,52
0,r_73_49_167,r_61_92_158,r_118_27_53,r_73_49_167,0.79,0,167,167,52
63,seq23,r_55_62_189,r_43_124_16,r_43_124_16,0.97,173,189,16,52
11,r_72_105_160,r_33_51_169,r_31_109_59,r_31_109_59,0.53,110,169,59,52
98,seq122,r_87_141_193,r_54_100_116,r_54_100_116,0.76,60,176,116,52
76,seq67,r_19_84_131,r_43_124_16,r_43_124_16,1.0,-1,15,16,52
37,r_76_3_37,seq146,seq4,r_76_3_37,0.98,0,37,37,52
6,r_116_60_164,seq1,r_90_128_67,r_116_60_164,0.86,0,164,164,52
85,seq143,seq36,r_90_128_67,r_90_128_67,1.0,47,114,67,52
10,r_80_48_170,seq26,r_134_106_130,r_80_48_170,0.64,0,170,170,52
52,seq4,seq39,r_76_3_37,r_76_3_37,0.97,1,38,37,52
25,r_118_27_53,r_80_48_170,r_98_113_25,r_118_27_53,0.99,-2,51,53,52
74,seq56,r_5_20_188,r_40_22_171,r_40_22_171,0.75,18,189,171,52
12,r_133_47_43,r_70_121_61,seq21,r_133_47_43,0.96,1,44,43,52
24,r_40_22_171,seq39,seq24,r_40_22_171,0.77,0,171,171,52
10,r_80_48_170,r_118_27_53,seq26,r_118_27_53,0.98,-4,49,53,52
34,r_25_64_52,r_19_84_131,seq143,r_25_64_52,0.99,-1,51,52,52
43,r_32_85_32,r_59_129_123,seq36,r_59_129_123,0.71,7,130,123,52
36,r_126_28_23,seq74,r_144_66_24,r_126_28_23,1.0,-1,22,23,52
65,seq26,r_34_63_186,r_18_142_150,r_18_142_150,0.92,32,182,150,52
1,r_144_66_24,seq4,r_126_28_23,r_144_66_24,1.0,0,24,24,52
32,r_5_20_188,seq56,seq143,r_5_20_188,0.35,1,189,188,52
17,r_119_131_137,r_73_49_167,seq117,r_119_131_137,1.0,0,137,137,52
9,r_45_78_98,r_55_62_189,r_10_125_173,r_45_78_98,0.99,-5,93,98,52
29,r_149_68_73,r_38_132_11,seq7,r_149_68_73,1.0,0,73,73,52
22,r_33_51_169,r_72_105_160,r_138_140_196,r_33_51_169,0.9,0,169,169,52
7,r_148_42_75,r_19_84_131,seq39,r_148_42_75,1.0,0,75,75,52
44,r_90_128_67,r_73_49_167,r_2_101_22,r_90_128_67,0.65,-2,65,67,52
23,r_110_16_168,r_55_62_189,r_144_66_24,r_144_66_24,0.95,146,170,24,52
35,r_94_93_106,r_87_141_193,r_25_64_52,r_87_141_193,1.0,-87,106,193,52
29,r_149_68_73,seq147,r_38_132_11,r_38_132_11,0.72,0,11,11,52
93,seq106,seq108,r_57_53_53,r_57_53_53,0.86,8,61,53,53
8,r_135_51_192,r_149_130_46,seq24,r_149_130_46,0.96,2,48,46,53
36,r_78_35_190,seq128,r_1_3_128,r_1_3_128,0.53,61,189,128,53
62,seq17,r_91_50_38,seq68,r_91_50_38,1.0,-10,28,38,53
48,r_69_70_48,r_19_82_114,seq20,r_69_70_48,1.0,0,48,48,53
14,r_1_3_128,r_19_82_114,r_71_33_104,r_1_3_128,0.77,-17,111,128,53
43,r_101_116_186,r_25_54_176,r_15_111_183,r_25_54_176,0.87,0,176,176,53
3,r_39_21_23,r_114_67_120,r_27_120_76,r_27_120_76,0.76,47,123,76,53
19,r_58_30_177,seq142,r_28_56_131,r_58_30_177,0.49,1,178,177,53
16,r_55_93_81,seq20,seq14,r_55_93_81,1.0,0,81,81,53
21,r_89_16_171,seq122,r_12_100_88,r_89_16_171,0.83,0,171,171,53
1,r_88_141_137,seq131,r_42_125_30,r_88_141_137,0.99,0,137,137,53
37,r_114_67_120,r_78_35_190,r_39_21_23,r_39_21_23,0.99,0,23,23,53
38,r_149_130_46,r_135_51_192,seq52,r_149_130_46,0.93,2,48,46,53
42,r_79_115_139,seq52,r_2_104_11,r_79_115_139,0.54,7,146,139,53
69,seq32,seq139,r_45_86_93,r_45_86_93,1.0,50,143,93,53
31,r_109_49_42,seq6,seq119,r_109_49_42,0.84,0,42,42,53
9,r_2_104_11,r_31_87_49,seq22,r_2_104_11,0.99,0,11,11,53
19,r_58_30_177,r_59_136_169,seq142,r_59_136_169,0.81,-101,68,169,53
95,seq112,r_11_36_143,r_91_50_38,r_91_50_38,0.98,0,38,38,53
2,r_31_87_49,seq142,seq80,r_31_87_49,1.0,0,49,49,53
4,r_113_118_39,r_40_43_178,r_44_85_196,r_113_118_39,0.7,-9,30,39,53
3,r_39_21_23,seq22,r_114_67_120,r_39_21_23,0.99,0,23,23,53
44,r_140_64_22,r_78_35_190,seq127,r_140_64_22,0.99,-1,21,22,53
26,r_27_120_76,r_44_85_196,seq23,r_27_120_76,1.0,-1,75,76,53
78,seq68,r_147_74_159,r_7_18_115,r_7_18_115,0.54,34,149,115,53
0,r_60_107_74,r_98_110_127,seq84,r_60_107_74,0.89,1,75,74,53
63,seq146,r_71_33_104,r_109_49_42,r_71_33_104,0.85,0,104,104,53
25,r_44_85_196,r_11_36_143,r_113_118_39,r_44_85_196,0.75,-166,30,196,53
11,r_41_124_90,r_63_133_130,seq52,r_41_124_90,0.77,0,90,90,53
13,r_19_82_114,r_1_3_128,r_55_93_81,r_19_82_114,0.62,0,114,114,53
98,seq122,r_98_110_127,seq66,r_98_110_127,0.99,0,127,127,53
10,r_57_53_53,seq46,seq106,r_57_53_53,0.74,1,54,53,53
27,r_117_123_29,r_63_133_130,seq37,r_117_123_29,1.0,0,29,29,53
14,r_1_3_128,r_71_33_104,seq6,r_1_3_128,0.83,0,128,128,53
40,r_63_133_130,seq73,r_12_100_88,r_63_133_130,0.86,1,131,130,53
29,r_28_56_131,seq20,r_149_130_46,r_28_56_131,0.91,1,132,131,53
33,r_147_74_159,seq68,r_45_86_93,r_147_74_159,0.57,1,160,159,53
17,r_42_125_30,seq52,r_40_43_178,r_42_125_30,1.0,0,30,30,53
32,r_105_83_82,seq52,r_55_93_81,r_105_83_82,0.48,0,82,82,53
45,r_91_50_38,seq17,seq112,r_91_50_38,1.0,0,38,38,53
34,r_143_134_181,seq37,seq38,r_143_134_181,0.54,0,181,181,53
75,seq52,r_79_115_139,r_41_124_90,r_41_124_90,1.0,56,146,90,53
99,seq127,seq52,r_140_64_22,r_140_64_22,1.0,0,22,22,53
18,r_40_43_178,r_113_118_39,r_42_125_30,r_42_125_30,0.97,0,30,30,53
96,seq119,seq146,r_109_49_42,r_109_49_42,0.96,1,43,42,53
82,seq80,seq131,r_31_87_49,r_31_87_49,1.0,0,49,49,53
37,r_114_67_120,r_39_21_23,r_2_104_11,r_114_67_120,0.98,3,123,120,53
22,r_45_86_93,r_4_61_75,seq131,r_45_86_93,1.0,0,93,93,53
28,r_76_62_129,r_12_100_88,r_60_107_74,r_60_107_74,0.94,58,132,74,53
49,r_5_34_97,seq20,r_4_61_75,r_5_34_97,0.99,0,97,97,53
7,r_71_33_104,seq146,seq9,r_71_33_104,0.99,0,104,104,53
18,r_40_43_178,r_42_125_30,r_91_50_38,r_91_50_38,0.57,140,178,38,53
23,r_137_90_118,seq95,r_105_83_82,r_137_90_118,1.0,0,118,118,53
17,r_42_125_30,r_40_43_178,r_88_141_137,r_88_141_137,1.0,41,178,137,53
35,r_7_18_115,r_76_62_129,seq17,r_7_18_115,0.7,0,115,115,53
12,r_11_36_143,seq145,r_109_49_42,r_11_36_143,0.96,0,143,143,53
36,r_51_19_63,seq108,seq30,r_51_19_63,1.0,0,63,63,54
46,r_32_3_148,r_13_84_36,r_136_105_72,r_136_105_72,0.68,0,72,72,54
43,r_28_26_161,seq1,r_125_109_67,r_28_26_161,0.82,0,161,161,54
37,r_102_70_88,r_56_88_129,r_134_27_35,r_134_27_35,0.99,58,93,35,54
83,seq85,r_31_12_172,r_145_126_11,r_145_126_11,1.0,0,11,11,54
48,r_145_126_11,r_80_37_147,seq85,r_145_126_11,1.0,0,11,11,54
16,r_23_115_169,seq110,r_13_84_36,r_23_115_169,0.91,0,169,169,54
21,r_93_133_108,seq97,seq58,r_93_133_108,0.71,4,112,108,54
1,r_136_105_72,r_32_3_148,r_44_36_83,r_32_3_148,1.0,0,148,148,54
1,r_136_105_72,seq95,r_32_3_148,r_136_105_72,1.0,0,72,72,54
38,r_7_21_48,r_143_128_197,seq116,r_7_21_48,0.41,0,48,48,54
22,r_44_36_83,r_134_27_35,r_140_54_9,r_44_36_83,0.69,-48,35,83,54
42,r_16_76_84,seq72,seq95,r_16_76_84,0.62,-8,76,84,54
19,r_31_12_172,seq85,r_16_76_84,r_16_76_84,0.55,88,172,84,54
80,seq72,r_141_120_151,r_134_27_35,r_134_27_35,0.96,0,35,35,54
41,r_0_114_45,r_4_139_77,seq39,r_4_139_77,0.89,0,77,77,54
20,r_142_8_25,r_4_139_77,seq132,r_142_8_25,0.96,-3,22,25,54
5,r_24_112_55,r_44_36_83,r_52_47_106,r_52_47_106,0.95,0,106,106,54
22,r_44_36_83,r_24_112_55,r_136_105_72,r_136_105_72,0.88,11,83,72,54
26,r_4_139_77,r_0_114_45,seq29,r_4_139_77,0.99,0,77,77,54
4,r_87_40_181,seq71,seq74,r_87_40_181,0.66,0,181,181,54
46,r_32_3_148,seq85,r_13_84_36,r_13_84_36,0.66,-10,26,36,54
8,r_13_84_36,r_143_128_197,r_98_34_30,r_98_34_30,1.0,0,30,30,54
0,r_59_79_100,seq72,seq97,r_59_79_100,0.64,-1,99,100,54
63,seq29,r_94_99_138,r_4_139_77,r_4_139_77,1.0,61,138,77,54
25,r_98_34_30,seq22,r_13_84_36,r_98_34_30,1.0,0,30,30,54
73,seq58,seq127,r_93_133_108,r_93_133_108,0.81,30,138,108,54
11,r_73_147_156,r_18_90_177,seq11,r_73_147_156,0.92,1,157,156,54
5,r_24_112_55,r_68_49_159,r_44_36_83,r_24_112_55,0.94,-1,54,55,54
46,r_32_3_148,r_136_105_72,r_0_114_45,r_32_3_148,0.93,2,150,148,54
57,seq14,seq146,r_113_77_89,r_113_77_89,0.96,27,116,89,54
96,seq119,r_142_8_25,r_113_77_89,r_142_8_25,0.9,3,28,25,54
85,seq95,r_136_105_72,r_16_76_84,r_136_105_72,1.0,-3,69,72,54
22,r_44_36_83,r_140_54_9,r_24_112_55,r_24_112_55,0.76,1,56,55,54
27,r_94_99_138,seq29,r_59_79_100,r_59_79_100,0.59,38,138,100,54
35,r_62_35_62,r_141_120_151,seq129,r_141_120_151,0.78,-102,49,151,54
2,r_80_37_147,seq95,seq74,r_80_37_147,0.6,1,148,147,54
41,r_0_114_45,seq39,r_32_3_148,r_32_3_148,1.0,9,157,148,54
33,r_50_17_102,seq146,r_142_8_25,r_142_8_25,0.98,44,69,25,54
58,seq146,r_50_17_102,r_125_109_67,r_125_109_67,1.0,-2,65,67,54
24,r_45_67_19,r_87_40_181,seq138,r_45_67_19,1.0,0,19,19,54
32,r_86_65_95,r_18_90_177,seq110,r_86_65_95,0.96,5,100,95,54
40,r_148_123_41,r_56_88_129,seq61,r_148_123_41,0.97,0,41,41,54
34,r_83_104_185,seq30,r_15_135_158,r_83_104_185,0.51,0,185,185,54
75,seq61,r_15_135_158,r_148_123_41,r_148_123_41,0.98,72,113,41,54
53,seq129,r_24_112_55,r_62_35_62,r_24_112_55,1.0,-5,50,55,54
9,r_15_135_158,seq61,r_68_49_159,r_15_135_158,0.61,0,158,158,54
28,r_131_78_82,seq138,seq46,r_131_78_82,1.0,0,82,82,54
49,r_134_27_35,r_44_36_83,seq72,r_134_27_35,1.0,0,35,35,54
7,r_106_92_150,seq29,r_91_25_26,r_106_92_150,0.2,1,151,150,54
44,r_141_120_151,seq72,r_18_90_177,r_141_120_151,0.69,2,153,151,54
23,r_125_109_67,seq72,seq146,r_125_109_67,0.88,0,67,67,54
17,r_140_54_9,seq85,r_24_112_55,r_24_112_55,1.0,79,134,55,54
79,seq71,r_87_40_181,seq55,r_87_40_181,0.59,1,182,181,54
36,r_118_122_139,r_62_38_78,r_28_125_52,r_62_38_78,0.62,-4,74,78,55
14,r_19_51_145,r_54_101_90,r_37_112_7,r_54_101_90,0.98,15,105,90,55
14,r_19_51_145,r_37_112_7,seq136,r_19_51_145,1.0,0,145,145,55
83,seq81,r_40_46_76,r_76_106_82,r_40_46_76,0.73,0,76,76,55
21,r_70_53_175,r_119_105_187,r_48_44_157,r_70_53_175,0.8,2,177,175,55
16,r_64_59_124,seq15,r_37_112_7,r_37_112_7,0.54,119,126,7,55
21,r_70_53_175,r_48_44_157,r_119_105_187,r_48_44_157,0.78,1,158,157,55
1,r_48_44_157,r_70_53_175,r_18_90_47,r_18_90_47,0.9,111,158,47,55
5,r_4_13_97,r_120_129_154,seq135,r_4_13_97,0.99,1,98,97,55
46,r_8_26_165,seq123,r_64_59_124,r_8_26_165,0.76,0,165,165,55
42,r_99_143_117,seq56,seq73,r_99_143_117,0.99,0,117,117,55
51,seq2,r_88_98_29,r_30_25_9,r_88_98_29,0.57,-7,22,29,55
67,seq134,r_18_90_47,r_124_85_120,r_124_85_120,1.0,0,120,120,55
31,r_83_147_162,seq89,r_148_140_27,r_148_140_27,1.0,2,29,27,55
69,seq45,seq3,r_142_131_69,r_142_131_69,0.94,8,77,69,55
2,r_95_84_50,seq49,seq97,r_95_84_50,1.0,0,50,50,55
41,r_149_74_22,seq100,seq47,r_149_74_22,0.92,0,22,22,55
15,r_29_86_147,r_37_112_7,r_88_98_29,r_29_86_147,0.8,1,148,147,55
76,seq63,r_21_66_83,seq50,r_21_66_83,0.94,7,90,83,55
67,seq134,seq89,r_18_90_47,r_18_90_47,1.0,22,69,47,55
89,seq97,r_23_24_190,r_95_84_50,r_95_84_50,1.0,140,190,50,55
3,r_9_126_177,seq56,r_4_13_97,r_9_126_177,0.62,0,177,177,55
26,r_54_101_90,r_19_51_145,r_142_131_69,r_54_101_90,0.71,15,105,90,55
8,r_148_140_27,r_83_147_162,r_48_44_157,r_148_140_27,0.79,135,162,27,55
48,r_141_128_36,r_28_125_52,r_138_33_15,r_141_128_36,0.57,16,52,36,55
38,r_139_17_12,seq22,seq71,r_139_17_12,0.95,2,14,12,55
4,r_119_105_187,seq117,seq56,r_119_105_187,0.47,0,187,187,55
11,r_27_145_95,r_39_82_129,r_104_77_164,r_27_145_95,0.92,0,95,95,55
6,r_111_113_63,seq68,seq116,r_111_113_63,1.0,5,68,63,55
74,seq56,r_9_126_177,r_120_129_154,r_9_126_177,0.54,0,177,177,55
99,seq127,r_41_115_174,r_65_78_65,r_65_78_65,1.0,110,175,65,55
20,r_138_33_15,r_69_35_155,seq11,r_138_33_15,0.57,-1,14,15,55
36,r_118_122_139,r_28_125_52,r_104_77_164,r_118_122_139,0.96,3,142,139,55
45,r_18_90_47,seq63,seq89,r_18_90_47,1.0,1,48,47,55
27,r_40_46_76,r_39_82_129,seq10,r_40_46_76,0.97,0,76,76,55
8,r_148_140_27,seq61,r_83_147_162,r_148_140_27,1.0,1,28,27,55
51,seq2,r_30_25_9,r_39_82_129,r_39_82_129,0.85,15,144,129,55
40,r_67_52_161,r_1_110_176,r_4_13_97,r_4_13_97,0.75,68,165,97,55
74,seq56,r_99_143_117,r_9_126_177,r_99_143_117,1.0,0,117,117,55
18,r_142_131_69,r_21_66_83,seq45,r_142_131_69,0.65,0,69,69,55
29,r_21_66_83,seq63,seq68,r_21_66_83,0.98,3,86,83,55
24,r_41_115_174,seq127,r_107_57_26,r_107_57_26,0.59,149,175,26,55
25,r_62_38_78,r_118_122_139,seq144,r_62_38_78,1.0,1,79,78,55
23,r_43_146_14,r_18_90_47,r_32_31_1,r_18_90_47,0.84,-33,14,47,55
15,r_29_86_147,seq45,r_37_112_7,r_29_86_147,0.46,-90,57,147,55
32,r_87_7_173,r_48_44_157,r_1_110_176,r_87_7_173,0.45,-17,156,173,55
17,r_58_16_183,r_118_122_139,r_28_125_52,r_58_16_183,0.57,-87,96,183,55
9,r_88_98_29,seq5,seq15,r_88_98_29,1.0,0,29,29,55
33,r_28_125_52,r_141_128_36,r_58_16_183,r_28_125_52,0.95,0,52,52,55
31,r_83_147_162,r_148_140_27,r_138_33_15,r_83_147_162,0.85,0,162,162,55
22,r_65_78_65,seq144,seq127,r_65_78_65,1.0,0,65,65,55
28,r_133_72_167,seq123,seq55,r_133_72_167,0.61,1,168,167,55
49,r_120_129_154,seq11,seq56,r_120_129_154,0.89,-2,152,154,55
7,r_39_82_129,seq121,seq2,r_39_82_129,0.61,0,129,129,55
17,r_58_16_183,r_28_125_52,r_65_78_65,r_28_125_52,0.52,133,185,52,55
71,seq49,r_95_84_50,r_37_112_7,r_95_84_50,1.0,0,50,50,55
10,r_107_57_26,seq79,seq14,r_107_57_26,0.94,1,27,26,55
35,r_124_85_120,seq14,seq134,r_124_85_120,1.0,0,120,120,55
58,seq10,seq63,r_40_46_76,r_40_46_76,0.75,50,126,76,55
36,r_129_88_79,seq117,seq52,r_129_88_79,1.0,0,79,79,56
9,r_0_49_17,r_119_48_135,r_50_128_37,r_50_128_37,1.0,96,133,37,56
14,r_65_83_183,seq33,r_23_6_116,r_23_6_116,1.0,12,128,116,56
8,r_132_10_156,seq100,r_2_71_150,r_132_10_156,0.67,0,156,156,56
53,seq9,r_37_149_143,r_62_97_87,r_62_97_87,0.95,8,95,87,56
43,r_74_86_90,seq104,seq7,r_74_86_90,0.99,0,90,90,56
37,r_130_141_72,r_37_149_143,r_60_92_8,r_130_141_72,1.0,0,72,72,56
42,r_59_27_52,seq91,seq42,r_59_27_52,1.0,0,52,52,56
59,seq146,r_143_24_88,seq126,r_143_24_88,1.0,-7,81,88,56
14,r_65_83_183,r_23_6_116,r_41_36_102,r_65_83_183,0.98,0,183,183,56
13,r_115_45_12,r_3_124_153,seq33,r_115_45_12,0.92,0,12,12,56
55,seq12,r_95_61_181,r_41_36_102,r_41_36_102,0.96,3,105,102,56
16,r_51_120_144,seq131,r_50_128_37,r_50_128_37,0.73,108,145,37,56
39,r_95_61_181,seq16,r_15_85_101,r_15_85_101,0.65,82,183,101,56
1,r_127_136_95,seq14,r_101_18_4,r_127_136_95,1.0,0,95,95,56
5,r_82_44_126,r_8_17_136,r_62_97_87,r_82_44_126,0.83,-29,97,126,56
46,r_133_68_130,r_119_48_135,seq144,r_133_68_130,0.8,0,130,130,56
93,seq113,r_116_63_105,r_34_102_15,r_34_102_15,0.51,0,15,15,56
45,r_32_39_115,r_119_48_135,r_116_63_105,r_116_63_105,0.95,21,126,105,56
30,r_19_57_168,r_137_54_59,r_101_18_4,r_137_54_59,1.0,-15,44,59,56
9,r_0_49_17,r_5_76_139,r_119_48_135,r_0_49_17,1.0,0,17,17,56
31,r_22_139_171,seq52,r_96_1_162,r_96_1_162,0.98,11,173,162,56
67,seq40,r_107_105_187,r_15_85_101,r_15_85_101,0.74,86,187,101,56
3,r_8_17_136,seq77,seq21,r_8_17_136,0.86,0,136,136,56
72,seq58,r_56_84_137,seq40,r_56_84_137,0.99,0,137,137,56
4,r_41_36_102,seq33,seq12,r_41_36_102,1.0,0,102,102,56
0,r_23_6_116,seq31,r_11_53_56,r_23_6_116,0.99,0,116,116,56
63,seq29,r_75_80_182,r_74_86_90,r_74_86_90,1.0,93,183,90,56
11,r_2_71_150,r_96_1_162,r_8_17_136,r_96_1_162,0.96,-12,150,162,56
20,r_62_97_87,r_106_122_132,seq90,r_62_97_87,1.0,0,87,87,56
98,seq125,r_47_70_174,seq134,r_47_70_174,0.43,0,174,174,56
15,r_116_63_105,seq147,r_28_64_35,r_116_63_105,0.98,4,109,105,56
6,r_3_124_153,seq125,r_66_99_58,r_3_124_153,0.7,0,153,153,56
26,r_137_54_59,r_19_57_168,seq87,r_137_54_59,1.0,0,59,59,56
10,r_66_99_58,r_23_6_116,r_11_53_56,r_66_99_58,0.79,0,58,58,56
27,r_75_80_182,seq29,seq58,r_75_80_182,0.58,1,183,182,56
30,r_19_57_168,r_101_18_4,r_41_36_102,r_19_57_168,0.92,0,168,168,56
47,r_5_76_139,r_75_80_182,r_133_68_130,r_5_76_139,0.88,0,139,139,56
40,r_37_149_143,seq9,r_127_136_95,r_127_136_95,0.89,48,143,95,56
29,r_101_18_4,r_19_57_168,r_127_136_95,r_127_136_95,0.99,73,168,95,56
25,r_15_85_101,r_32_39_115,seq104,r_15_85_101,0.93,0,101,101,56
19,r_11_53_56,r_75_80_182,r_66_99_58,r_11_53_56,0.87,0,56,56,56
50,seq131,r_51_120_144,r_116_63_105,r_116_63_105,0.49,38,143,105,56
33,r_34_102_15,r_50_128_37,seq113,r_34_102_15,1.0,0,15,15,56
32,r_106_122_132,seq145,r_41_36_102,r_106_122_132,0.95,0,132,132,56
38,r_56_84_137,seq58,seq16,r_56_84_137,0.94,0,137,137,56
24,r_50_128_37,seq29,r_0_49_17,r_50_128_37,0.76,0,37,37,56
60,seq147,r_116_63_105,seq117,r_116_63_105,1.0,-1,104,105,56
17,r_96_1_162,seq144,r_13_72_121,r_96_1_162,0.97,0,162,162,56
28,r_78_140_63,seq142,r_59_27_52,r_78_140_63,0.93,0,63,63,56
66,seq35,r_143_24_88,r_60_92_8,r_143_24_88,0.98,-60,28,88,56
49,r_28_64_35,r_62_97_87,seq148,r_62_97_87,0.61,-51,36,87,56
56,seq14,r_127_136_95,seq58,r_127_136_95,0.85,-10,85,95,56
7,r_143_24_88,seq146,r_34_102_15,r_143_24_88,0.99,0,88,88,56
44,r_55_67_155,r_89_98_180,r_116_63_105,r_116_63_105,0.46,52,157,105,56
23,r_119_48_135,r_133_68_130,r_60_92_8,r_133_68_130,0.77,0,130,130,56
35,r_89_98_180,seq69,seq12,r_89_98_180,0.52,0,180,180,56
12,r_38_109_69,r_143_24_88,r_137_54_59,r_38_109_69,1.0,0,69,69,56
36,r_116_120_163,r_93_118_122,r_125_123_74,r_116_120_163,0.69,-91,72,163,57
8,r_52_53_165,r_18_43_170,r_80_115_17,r_80_115_17,0.61,149,166,17,57
43,r_21_83_83,seq91,seq20,r_21_83_83,1.0,0,83,83,57
37,r_37_98_114,seq3,seq62,r_37_98_114,0.76,1,115,114,57
3,r_80_115_17,r_5_27_135,r_133_107_41,r_80_115_17,0.66,103,120,17,57
59,seq144,r_95_131_18,r_40_32_133,r_40_32_133,0.49,-20,113,133,57
16,r_119_82_95,r_36_45_65,r_70_111_36,r_119_82_95,0.97,-31,64,95,57
39,r_9_54_127,seq57,seq106,r_9_54_127,0.97,0,127,127,57
5,r_17_75_66,r_96_104_174,seq79,r_17_75_66,1.0,0,66,66,57
24,r_133_107_41,r_17_75_66,r_80_115_17,r_133_107_41,0.99,0,41,41,57
1,r_41_65_39,seq62,r_33_126_27,r_33_126_27,0.67,9,36,27,57
45,r_0_72_81,seq62,seq12,r_0_72_81,1.0,1,82,81,57
26,r_81_94_47,seq86,seq92,r_81_94_47,1.0,1,48,47,57
38,r_102_59_159,seq148,r_21_83_83,r_21_83_83,1.0,41,124,83,57
41,r_36_45_65,r_119_82_95,seq25,r_36_45_65,1.0,0,65,65,57
89,seq92,seq71,r_81_94_47,r_81_94_47,1.0,25,72,47,57
10,r_129_48_117,r_93_118_122,seq31,r_129_48_117,1.0,0,117,117,57
20,r_74_145_49,seq100,seq86,r_74_145_49,1.0,0,49,49,57
4,r_93_118_122,r_116_120_163,seq1,r_93_118_122,0.98,0,122,122,57
0,r_39_147_105,r_52_53_165,r_16_8_8,r_39_147_105,0.99,1,106,105,57
13,r_125_123_74,seq91,r_116_120_163,r_125_123_74,1.0,0,74,74,57
46,r_70_111_36,r_67_112_115,r_90_66_97,r_70_111_36,1.0,61,97,36,57
15,r_40_32_133,seq135,seq47,r_40_32_133,0.54,5,138,133,57
48,r_4_127_64,seq10,seq106,r_4_127_64,1.0,1,65,64,57
46,r_70_111_36,r_146_78_88,r_67_112_115,r_70_111_36,0.98,0,36,36,57
13,r_125_123_74,r_116_120_163,r_109_141_82,r_116_120_163,0.92,-1,162,163,57
36,r_116_120_163,r_125_123_74,seq97,r_125_123_74,0.55,89,163,74,57
42,r_5_27_135,r_105_136_84,r_80_115_17,r_5_27_135,0.81,-118,17,135,57
27,r_2_134_72,r_67_112_115,r_41_65_39,r_41_65_39,0.48,33,72,39,57
2,r_67_112_115,seq15,r_81_94_47,r_67_112_115,1.0,0,115,115,57
47,r_109_141_82,r_0_72_81,r_125_123_74,r_109_141_82,1.0,0,82,82,57
38,r_102_59_159,seq92,seq148,r_102_59_159,0.44,-109,50,159,57
74,seq140,seq91,r_119_82_95,r_119_82_95,1.0,5,100,95,57
18,r_90_66_97,seq20,seq89,r_90_66_97,0.99,0,97,97,57
16,r_119_82_95,r_70_111_36,seq140,r_119_82_95,0.99,1,96,95,57
33,r_28_63_118,seq79,seq10,r_28_63_118,0.76,0,118,118,57
64,seq25,r_52_53_165,r_36_45_65,r_36_45_65,1.0,100,165,65,57
58,seq15,r_67_112_115,seq42,r_67_112_115,1.0,-5,110,115,57
6,r_16_8_8,seq92,r_39_147_105,r_39_147_105,1.0,18,123,105,57
42,r_5_27_135,r_80_115_17,r_19_44_52,r_5_27_135,1.0,0,135,135,57
32,r_68_7_79,r_105_136_84,seq58,r_105_136_84,0.84,0,84,84,57
34,r_105_136_84,seq3,seq57,r_105_136_84,1.0,0,84,84,57
17,r_11_34_172,seq77,r_146_78_88,r_11_34_172,0.67,0,172,172,57
30,r_76_49_1,seq148,r_33_126_27,r_33_126_27,1.0,-2,25,27,57
3,r_80_115_17,seq92,r_5_27_135,r_80_115_17,0.96,0,17,17,57
31,r_113_60_11,r_41_65_39,seq30,r_113_60_11,0.95,0,11,11,57
28,r_99_139_92,seq23,r_55_128_90,r_99_139_92,0.99,0,92,92,57
49,r_95_131_18,r_40_32_133,seq79,r_95_131_18,0.77,1,19,18,57
44,r_38_117_158,seq31,seq3,r_38_117_158,0.47,20,178,158,57
7,r_33_126_27,seq84,r_76_49_1,r_33_126_27,0.98,0,27,27,57
23,r_18_43_170,r_52_53_165,seq31,r_18_43_170,0.62,0,170,170,57
79,seq71,seq92,r_39_147_105,r_39_147_105,1.0,26,131,105,57
47,r_82_83_17,r_42_120_122,seq37,r_82_83_17,0.94,0,17,17,58
46,r_144_8_12,r_3_125_78,seq146,r_144_8_12,0.98,-1,11,12,58
37,r_48_104_94,r_100_18_100,r_5_147_59,r_48_104_94,0.96,0,94,94,58
16,r_94_92_149,r_38_115_139,r_56_86_76,r_56_86_76,0.5,74,150,76,58
39,r_70_149_179,seq43,r_109_111_82,r_109_111_82,0.72,97,179,82,58
42,r_134_124_105,seq61,seq13,r_134_124_105,0.76,1,106,105,58
7,r_121_140_155,r_49_67_16,r_98_131_141,r_49_67_16,0.97,139,155,16,58
74,seq61,r_38_115_139,r_72_22_120,r_72_22_120,0.67,11,131,120,58
19,r_34_36_102,seq97,seq78,r_34_36_102,0.93,0,102,102,58
4,r_136_15_74,seq141,r_135_89_13,r_136_15_74,0.49,86,160,74,58
38,r_128_145_87,r_10_148_152,r_88_4_157,r_128_145_87,0.62,73,160,87,58
35,r_25_103_44,r_133_139_99,seq77,r_133_139_99,0.72,-53,46,99,58
43,r_17_21_38,seq71,seq74,r_17_21_38,0.84,0,38,38,58
3,r_72_22_120,seq129,seq61,r_72_22_120,0.97,0,120,120,58
14,r_49_67_16,r_106_117_175,r_121_140_155,r_49_67_16,0.98,0,16,16,58
26,r_133_139_99,seq97,seq28,r_133_139_99,0.87,0,99,99,58
14,r_49_67_16,r_121_140_155,r_138_60_92,r_49_67_16,0.92,139,155,16,58
11,r_19_68_55,seq81,r_26_119_198,r_19_68_55,0.98,0,55,55,58
4,r_136_15_74,seq78,r_98_131_141,r_136_15_74,1.0,0,74,74,58
0,r_138_60_92,seq84,r_49_67_16,r_138_60_92,0.71,0,92,92,58
29,r_5_147_59,r_127_132_170,seq20,r_5_147_59,0.92,0,59,59,58
20,r_14_126_67,seq59,r_24_75_57,r_14_126_67,0.98,0,67,67,58
13,r_127_132_170,seq77,r_133_139_99,r_133_139_99,0.76,77,176,99,58
44,r_24_75_57,r_48_104_94,r_27_6_83,r_27_6_83,0.63,-25,58,83,58
15,r_38_115_139,r_94_92_149,r_1_9_46,r_1_9_46,0.6,93,139,46,58
48,r_57_40_137,seq16,seq141,r_57_40_137,0.66,0,137,137,58
4,r_136_15_74,r_98_131_141,seq141,r_98_131_141,0.69,0,141,141,58
6,r_52_79_72,r_42_120_122,r_46_0_31,r_42_120_122,0.72,-50,72,122,58
21,r_10_148_152,r_128_145_87,r_134_124_105,r_10_148_152,0.54,8,160,152,58
99,seq123,r_27_6_83,r_56_86_76,r_56_86_76,1.0,19,95,76,58
27,r_47_122_4,r_127_132_170,r_45_7_37,r_45_7_37,0.52,10,47,37,58
63,seq37,r_80_85_193,r_82_83_17,r_82_83_17,1.0,2,19,17,58
12,r_45_7_37,r_88_4_157,r_47_122_4,r_45_7_37,0.74,4,41,37,58
2,r_27_6_83,seq123,r_24_75_57,r_24_75_57,1.0,26,83,57,58
10,r_96_76_29,r_10_148_152,seq108,r_96_76_29,0.96,0,29,29,58
25,r_135_89_13,r_96_76_29,seq90,r_135_89_13,1.0,0,13,13,58
74,seq61,r_134_124_105,r_38_115_139,r_134_124_105,0.94,1,106,105,58
24,r_31_73_181,seq28,r_137_142_64,r_137_142_64,0.94,117,181,64,58
34,r_26_119_198,r_45_7_37,r_19_68_55,r_26_119_198,0.65,-80,118,198,58
7,r_121_140_155,r_42_120_122,r_49_67_16,r_49_67_16,0.94,4,20,16,58
33,r_137_142_64,seq101,seq2,r_137_142_64,0.98,1,65,64,58
50,seq129,r_72_22_120,r_109_111_82,r_109_111_82,0.7,18,100,82,58
58,seq28,r_31_73_181,r_133_139_99,r_133_139_99,0.8,10,109,99,58
65,seq41,r_88_4_157,r_100_18_100,r_100_18_100,0.36,14,114,100,58
21,r_10_148_152,r_96_76_29,r_128_145_87,r_96_76_29,0.58,4,33,29,58
61,seq32,r_100_18_100,seq81,r_100_18_100,0.99,0,100,100,58
38,r_128_145_87,r_88_4_157,r_10_148_152,r_128_145_87,0.63,4,91,87,58
52,seq12,r_143_64_191,r_88_4_157,r_88_4_157,0.57,18,175,157,58
77,seq66,r_98_131_141,r_136_15_74,r_136_15_74,0.78,25,99,74,58
34,r_26_119_198,seq118,r_45_7_37,r_45_7_37,0.58,4,41,37,58
83,seq78,r_1_9_46,r_34_36_102,r_34_36_102,1.0,4,106,102,58
30,r_1_9_46,r_106_117_175,seq78,r_1_9_46,1.0,2,48,46,58
17,r_3_125_78,r_109_111_82,seq108,r_109_111_82,1.0,-28,54,82,58
9,r_98_131_141,seq90,r_136_15_74,r_136_15_74,1.0,34,108,74,58
22,r_113_114_160,seq77,seq54,r_113_114_160,0.73,1,161,160,58
9,r_98_131_141,r_136_15_74,r_38_115_139,r_98_131_141,0.99,0,141,141,58
28,r_109_111_82,seq116,seq129,r_109_111_82,0.98,0,82,82,58
23,r_56_86_76,seq50,seq77,r_56_86_76,1.0,0,76,76,58
82,seq77,r_113_114_160,r_56_86_76,r_56_86_76,0.76,71,147,76,58
79,seq130,r_19_68_55,r_17_21_38,r_19_68_55,0.64,5,60,55,58
30,r_23_123_158,r_35_29_179,seq22,r_23_123_158,0.54,1,159,158,59
97,seq121,r_31_77_43,seq26,r_31_77_43,0.88,-1,42,43,59
36,r_125_141_95,r_59_11_173,r_66_76_69,r_125_141_95,0.93,1,96,95,59
92,seq111,r_7_86_107,seq113,r_7_86_107,0.54,-3,104,107,59
8,r_83_27_6,r_108_16_115,r_2_95_76,r_83_27_6,0.88,89,95,6,59
96,seq120,r_61_128_59,seq32,r_61_128_59,0.91,-17,42,59,59
7,r_131_79_101,seq34,r_31_77_43,r_31_77_43,1.0,-1,42,43,59
26,r_10_1_11,r_62_67_30,r_24_45_151,r_10_1_11,0.64,2,13,11,59
16,r_65_82_119,seq137,seq143,r_65_82_119,0.66,2,121,119,59
39,r_148_57_184,r_88_48_75,seq143,r_88_48_75,1.0,-3,72,75,59
1,r_36_102_136,seq116,seq63,r_36_102_136,0.9,3,139,136,59
46,r_19_106_62,r_17_130_141,seq72,r_19_106_62,0.98,2,64,62,59
42,r_8_5_176,seq33,r_20_3_88,r_20_3_88,0.6,88,176,88,59
69,seq51,r_110_147_42,seq89,r_110_147_42,1.0,-2,40,42,59
22,r_17_130_141,r_19_106_62,r_149_92_41,r_17_130_141,0.75,-105,36,141,59
33,r_101_100_87,r_35_29_179,r_75_12_96,r_101_100_87,0.49,92,179,87,59
73,seq71,r_2_95_76,seq133,r_2_95_76,0.9,-20,56,76,59
45,r_42_40_28,r_93_135_197,seq107,r_42_40_28,1.0,0,28,28,59
41,r_129_64_148,seq124,seq143,r_129_64_148,0.63,0,148,148,59
3,r_7_86_107,r_122_118_89,seq14,r_7_86_107,0.67,-23,84,107,59
10,r_2_95_76,seq71,r_83_27_6,r_2_95_76,1.0,0,76,76,59
5,r_62_67_30,r_110_147_42,seq137,r_62_67_30,0.94,0,30,30,59
72,seq63,seq39,r_36_102_136,r_36_102_136,0.91,3,139,136,59
98,seq124,r_28_70_137,r_52_4_37,r_52_4_37,0.77,1,38,37,59
4,r_117_105_94,seq124,seq104,r_117_105_94,0.94,2,96,94,59
0,r_59_11_173,seq142,r_47_138_24,r_59_11_173,0.36,2,175,173,59
63,seq34,r_103_112_183,r_31_77_43,r_31_77_43,1.0,140,183,43,59
12,r_37_145_50,r_36_102_136,seq21,r_37_145_50,1.0,0,50,50,59
15,r_6_90_74,r_88_48_75,r_66_76_69,r_6_90_74,0.92,1,75,74,59
48,r_28_70_137,r_146_69_164,seq119,r_28_70_137,0.82,2,139,137,59
7,r_131_79_101,r_31_77_43,seq142,r_131_79_101,1.0,0,101,101,59
6,r_84_54_116,seq96,r_75_12_96,r_84_54_116,0.99,0,116,116,59
40,r_58_115_32,r_8_5_176,seq49,r_58_115_32,1.0,1,33,32,59
37,r_110_147_42,seq51,seq91,r_110_147_42,0.97,-2,40,42,59
95,seq119,seq96,r_9_60_57,r_9_60_57,1.0,-1,56,57,59
27,r_108_16_115,seq33,seq133,r_108_16_115,0.98,2,117,115,59
14,r_31_77_43,seq121,r_131_79_101,r_31_77_43,1.0,-1,42,43,59
87,seq99,r_18_132_124,seq91,r_18_132_124,0.87,1,125,124,59
22,r_17_130_141,r_149_92_41,seq140,r_17_130_141,0.66,6,147,141,59
2,r_114_73_70,seq26,seq33,r_114_73_70,1.0,-4,66,70,59
47,r_146_69_164,seq139,r_127_38_153,r_146_69_164,0.67,0,164,164,59
25,r_30_144_26,r_9_60_57,seq107,r_30_144_26,0.97,-1,25,26,59
29,r_50_0_83,r_7_86_107,seq126,r_50_0_83,1.0,0,83,83,59
33,r_101_100_87,seq80,r_35_29_179,r_101_100_87,0.98,-1,86,87,59
87,seq99,seq91,r_24_45_151,r_24_45_151,0.94,0,151,151,59
88,seq142,r_59_11_173,r_131_79_101,r_131_79_101,0.99,66,167,101,59
14,r_31_77_43,r_131_79_101,seq34,r_131_79_101,1.0,0,101,101,59
49,r_75_12_96,r_62_67_30,r_84_54_116,r_84_54_116,0.97,-1,115,116,59
32,r_103_112_183,seq34,r_114_73_70,r_114_73_70,0.65,113,183,70,59
34,r_122_118_89,r_7_86_107,seq81,r_122_118_89,0.77,5,94,89,59
60,seq26,r_114_73_70,seq121,r_114_73_70,0.5,0,70,70,59
68,seq49,seq15,r_58_115_32,r_58_115_32,1.0,0,32,32,59
18,r_24_45_151,r_2_95_76,r_10_1_11,r_24_45_151,0.65,-140,11,151,59
94,seq116,r_36_102_136,seq113,r_36_102_136,0.74,5,141,136,59
31,r_61_128_59,seq120,r_58_115_32,r_61_128_59,0.88,0,59,59,59
21,r_47_138_24,r_58_115_32,r_66_76_69,r_47_138_24,0.98,-3,21,24,59
26,r_10_1_11,r_24_45_151,r_18_132_124,r_10_1_11,0.82,141,152,11,59
28,r_35_29_179,r_101_100_87,r_17_130_141,r_101_100_87,0.59,92,179,87,59
28,r_35_29_179,r_23_123_158,r_101_100_87,r_101_100_87,0.87,-1,86,87,59
22,r_17_130_141,seq140,r_35_29_179,r_35_29_179,0.83,-4,175,179,59
18,r_24_45_151,r_10_1_11,seq99,r_24_45_151,0.86,1,152,151,59
44,r_18_132_124,seq99,r_10_1_11,r_18_132_124,0.99,1,125,124,59
23,r_20_3_88,r_65_82_119,r_122_118_89,r_20_3_88,0.98,1,89,88,59
82,seq89,seq51,r_19_106_62,r_19_106_62,0.52,0,62,62,59
11,r_53_98_46,r_101_100_87,seq142,r_53_98_46,1.0,0,46,46,59
19,r_52_4_37,seq21,seq124,r_52_4_37,1.0,0,37,37,59
35,r_88_48_75,r_148_57_184,seq139,r_88_48_75,1.0,-3,72,75,59
38,r_9_60_57,seq124,seq119,r_9_60_57,0.96,1,58,57,59
17,r_149_92_41,r_88_48_75,r_17_130_141,r_149_92_41,0.46,-5,36,41,59
30,r_94_131_172,seq4,r_84_69_57,r_94_131_172,0.81,0,172,172,60
36,r_130_102_112,seq23,r_117_82_13,r_130_102_112,0.86,0,112,112,60
8,r_105_50_60,r_87_97_159,r_80_54_63,r_80_54_63,0.94,5,68,63,60
58,seq143,seq86,r_99_62_40,r_99_62_40,1.0,16,56,40,60
54,seq5,r_41_58_67,r_38_142_148,r_38_142_148,1.0,3,151,148,60
83,seq76,seq29,r_71_121_132,r_71_121_132,1.0,0,132,132,60
37,r_140_49_140,r_43_53_164,r_90_114_32,r_140_49_140,0.67,0,140,140,60
15,r_124_2_34,r_134_85_127,seq110,r_124_2_34,1.0,0,34,34,60
16,r_15_40_155,seq128,r_7_107_107,r_15_40_155,0.78,0,155,155,60
39,r_36_98_97,r_9_120_156,seq141,r_36_98_97,0.99,0,97,97,60
1,r_80_54_63,seq118,r_105_50_60,r_80_54_63,1.0,0,63,63,60
42,r_46_145_76,seq75,r_9_120_156,r_46_145_76,0.89,2,78,76,60
66,seq29,r_116_61_152,r_100_27_49,r_100_27_49,0.98,0,49,49,60
93,seq110,r_116_61_152,r_124_2_34,r_124_2_34,0.86,2,36,34,60
32,r_9_120_156,r_46_145_76,r_21_135_145,r_9_120_156,1.0,-1,155,156,60
27,r_117_82_13,seq129,r_130_102_112,r_130_102_112,1.0,7,119,112,60
28,r_17_104_171,r_39_16_39,r_45_25_51,r_39_16_39,0.91,5,44,39,60
31,r_126_33_50,r_84_69_57,seq118,r_126_33_50,1.0,0,50,50,60
41,r_6_95_69,r_89_24_85,seq129,r_6_95_69,1.0,0,69,69,60
3,r_43_53_164,r_140_49_140,r_134_85_127,r_43_53_164,0.61,-24,140,164,60
10,r_101_88_104,seq35,r_74_144_8,r_101_88_104,0.99,0,104,104,60
14,r_99_62_40,seq13,seq143,r_99_62_40,0.56,0,40,40,60
26,r_136_111_105,r_127_119_185,seq23,r_136_111_105,0.98,0,105,105,60
78,seq66,r_22_77_173,seq3,r_22_77_173,1.0,0,173,173,60
0,r_127_119_185,r_136_111_105,seq79,r_136_111_105,1.0,-5,100,105,60
63,seq149,r_116_61_152,r_89_24_85,r_89_24_85,0.93,67,152,85,60
11,r_138_8_144,seq109,r_89_24_85,r_89_24_85,1.0,64,149,85,60
20,r_134_85_127,seq141,r_43_53_164,r_134_85_127,0.83,0,127,127,60
13,r_7_107_107,seq129,seq20,r_7_107_107,0.97,0,107,107,60
48,r_68_106_71,r_43_53_164,seq128,r_68_106_71,1.0,1,72,71,60
12,r_38_142_148,seq4,seq5,r_38_142_148,1.0,0,148,148,60
27,r_117_82_13,r_127_119_185,seq129,r_117_82_13,1.0,0,13,13,60
0,r_127_119_185,seq79,seq51,r_127_119_185,0.69,0,185,185,60
20,r_134_85_127,r_43_53_164,r_99_62_40,r_43_53_164,0.98,1,165,164,60
29,r_64_32_12,r_115_31_184,r_39_16_39,r_39_16_39,1.0,145,184,39,60
50,seq128,r_15_40_155,r_68_106_71,r_68_106_71,1.0,6,77,71,60
42,r_46_145_76,r_9_120_156,r_140_49_140,r_140_49_140,0.67,16,156,140,60
32,r_9_120_156,r_36_98_97,r_46_145_76,r_9_120_156,0.98,-58,98,156,60
38,r_116_61_152,seq149,r_105_50_60,r_116_61_152,0.86,0,152,152,60
25,r_100_27_49,seq86,seq29,r_100_27_49,1.0,1,50,49,60
44,r_89_24_85,r_80_54_63,seq149,r_89_24_85,0.95,0,85,85,60
3,r_43_53_164,r_134_85_127,r_7_107_107,r_43_53_164,1.0,1,165,164,60
2,r_39_16_39,r_17_104_171,r_64_32_12,r_39_16_39,0.98,0,39,39,60
17,r_26_63_163,seq128,r_39_16_39,r_26_63_163,0.76,-1,162,163,60
65,seq28,seq128,r_18_123_46,r_18_123_46,1.0,4,50,46,60
6,r_11_139_25,r_105_50_60,r_45_25_51,r_11_139_25,0.86,2,27,25,60
28,r_17_104_171,r_45_25_51,seq13,r_17_104_171,0.92,0,171,171,60
22,r_48_137_116,seq30,seq141,r_48_137_116,0.99,0,116,116,60
56,seq13,seq70,r_17_104_171,r_17_104_171,0.93,0,171,171,60
7,r_22_77_173,seq66,r_9_120_156,r_22_77_173,0.78,0,173,173,60
44,r_89_24_85,r_6_95_69,r_80_54_63,r_89_24_85,0.76,-16,69,85,60
23,r_132_10_78,seq78,seq110,r_132_10_78,0.73,12,90,78,60
49,r_18_123_46,r_6_95_69,seq28,r_18_123_46,1.0,0,46,46,60
19,r_90_114_32,r_127_119_185,seq128,r_90_114_32,0.99,0,32,32,60
35,r_91_57_59,seq20,seq70,r_91_57_59,1.0,2,61,59,60
12,r_38_142_148,r_116_61_152,seq4,r_38_142_148,0.57,-72,76,148,60
84,seq78,r_132_10_78,seq147,r_132_10_78,1.0,14,92,78,60
92,seq109,r_54_45_190,r_69_39_25,r_69_39_25,1.0,165,190,25,61
8,r_145_27_101,r_34_125_171,r_78_59_87,r_145_27_101,0.98,1,102,101,61
12,r_36_136_53,seq62,seq5,r_36_136_53,0.51,-4,49,53,61
5,r_148_89_61,r_145_27_101,r_97_70_3,r_97_70_3,0.6,58,61,3,61
42,r_95_17_133,seq67,seq128,r_95_17_133,0.89,0,133,133,61
32,r_81_143_60,r_53_55_166,r_75_32_167,r_81_143_60,0.43,99,159,60,61
47,r_3_126_34,r_131_137_110,r_29_16_186,r_3_126_34,0.75,0,34,34,61
19,r_38_60_139,seq102,r_78_59_87,r_38_60_139,0.86,0,139,139,61
33,r_87_110_36,r_75_32_167,seq134,r_87_110_36,1.0,0,36,36,61
77,seq72,r_115_41_54,r_26_66_15,r_115_41_54,0.78,-40,14,54,61
18,r_46_51_90,seq62,r_91_61_111,r_91_61_111,0.96,1,112,111,61
31,r_53_55_166,r_36_136_53,r_81_143_60,r_81_143_60,1.0,20,80,60,61
14,r_69_39_25,r_46_51_90,seq109,r_69_39_25,1.0,1,26,25,61
3,r_54_45_190,seq109,r_141_119_98,r_54_45_190,0.26,0,190,190,61
10,r_78_59_87,seq101,r_97_70_3,r_78_59_87,0.96,0,87,87,61
26,r_97_70_3,r_91_61_111,r_148_89_61,r_148_89_61,0.56,0,61,61,61
23,r_114_144_32,r_115_41_54,r_131_137_110,r_114_144_32,1.0,2,34,32,61
4,r_33_99_114,seq128,seq67,r_33_99_114,0.94,0,114,114,61
20,r_28_80_157,seq50,r_91_61_111,r_91_61_111,0.93,46,157,111,61
15,r_131_137_110,r_91_61_111,r_29_16_186,r_29_16_186,0.51,-76,110,186,61
41,r_103_13_20,r_4_73_113,seq11,r_103_13_20,0.79,0,20,20,61
29,r_26_66_15,r_75_32_167,seq72,r_26_66_15,0.61,-1,14,15,61
73,seq62,r_53_55_166,r_46_51_90,r_46_51_90,1.0,7,97,90,61
43,r_9_14_42,seq71,seq90,r_9_14_42,1.0,0,42,42,61
10,r_78_59_87,r_97_70_3,r_145_27_101,r_78_59_87,0.59,82,169,87,61
27,r_34_125_171,r_113_12_188,seq47,r_34_125_171,0.54,1,172,171,61
38,r_149_42_41,r_91_61_111,seq71,r_149_42_41,1.0,1,42,41,61
87,seq101,r_78_59_87,seq83,r_78_59_87,1.0,0,87,87,61
2,r_91_61_111,seq123,r_46_51_90,r_91_61_111,1.0,1,112,111,61
40,r_15_86_135,r_20_68_179,seq123,r_15_86_135,0.91,0,135,135,61
18,r_46_51_90,seq71,seq62,r_46_51_90,0.91,0,90,90,61
24,r_142_1_134,seq84,seq85,r_142_1_134,0.75,0,134,134,61
36,r_77_94_31,r_78_59_87,seq76,r_77_94_31,1.0,0,31,31,61
34,r_146_22_14,r_75_32_167,seq128,r_146_22_14,0.99,0,14,14,61
85,seq93,r_148_89_61,r_139_64_16,r_148_89_61,0.84,-10,51,61,61
11,r_139_64_16,r_91_61_111,seq93,r_139_64_16,1.0,0,16,16,61
70,seq50,r_28_80_157,r_127_56_137,r_127_56_137,0.85,25,162,137,61
32,r_81_143_60,seq147,r_53_55_166,r_81_143_60,1.0,0,60,60,61
16,r_115_41_54,seq129,seq71,r_115_41_54,1.0,0,54,54,61
21,r_132_57_50,r_15_86_135,r_26_66_15,r_132_57_50,0.72,1,51,50,61
44,r_113_12_188,r_139_64_16,r_131_137_110,r_113_12_188,0.62,0,188,188,61
6,r_40_98_39,seq47,r_92_21_33,r_40_98_39,0.92,1,40,39,61
0,r_92_21_33,seq104,r_40_98_39,r_92_21_33,0.97,5,38,33,61
22,r_127_56_137,seq123,r_9_14_42,r_127_56_137,0.73,0,137,137,61
84,seq90,r_28_80_157,r_9_14_42,r_9_14_42,0.99,-1,41,42,61
59,seq147,r_49_52_145,r_105_130_5,r_49_52_145,0.57,-91,54,145,61
49,r_116_96_99,r_28_80_157,r_114_144_32,r_28_80_157,0.72,-58,99,157,61
44,r_113_12_188,r_34_125_171,r_139_64_16,r_139_64_16,0.57,156,172,16,61
35,r_106_6_131,seq104,seq85,r_106_6_131,0.95,0,131,131,61
23,r_114_144_32,r_131_137_110,r_116_96_99,r_114_144_32,1.0,67,99,32,61
50,seq0,seq54,r_55_39_19,r_55_39_19,0.99,32,51,19,62
40,r_65_113_4,r_59_61_193,r_24_106_10,r_24_106_10,0.67,179,189,10,62
12,r_32_91_14,r_98_96_53,r_112_81_95,r_32_91_14,0.99,0,14,14,62
6,r_142_93_15,r_130_71_124,seq132,r_142_93_15,0.93,3,18,15,62
37,r_130_71_124,seq10,seq38,r_130_71_124,0.99,0,124,124,62
86,seq79,r_13_94_172,seq114,r_13_94_172,0.51,-19,153,172,62
16,r_133_75_86,seq103,seq40,r_133_75_86,1.0,0,86,86,62
21,r_90_129_160,r_16_15_168,r_5_33_156,r_5_33_156,0.82,-2,154,156,62
5,r_31_21_80,seq18,r_55_39_19,r_31_21_80,1.0,-13,67,80,62
46,r_13_94_172,seq79,r_56_84_37,r_56_84_37,0.65,139,176,37,62
42,r_25_144_17,r_31_21_80,r_24_106_10,r_25_144_17,1.0,2,19,17,62
23,r_35_41_51,seq114,seq50,r_35_41_51,0.99,0,51,51,62
66,seq37,seq80,r_26_136_75,r_26_136_75,1.0,9,84,75,62
31,r_1_149_163,seq47,r_44_70_44,r_44_70_44,1.0,6,50,44,62
3,r_19_126_47,r_27_46_102,r_128_117_6,r_19_126_47,0.96,13,60,47,62
10,r_62_83_126,r_5_33_156,r_25_144_17,r_62_83_126,0.91,0,126,126,62
73,seq50,seq0,r_35_41_51,r_35_41_51,1.0,2,53,51,62
26,r_82_147_111,seq38,r_56_84_37,r_82_147_111,0.97,1,112,111,62
33,r_5_33_156,r_4_49_136,r_90_129_160,r_5_33_156,0.69,0,156,156,62
0,r_85_107_105,r_14_116_183,r_44_70_44,r_85_107_105,0.94,1,106,105,62
19,r_135_23_45,r_125_66_180,r_128_117_6,r_135_23_45,1.0,0,45,45,62
11,r_30_148_165,seq9,r_112_81_95,r_30_148_165,0.57,5,170,165,62
15,r_3_64_84,r_115_7_185,r_135_23_45,r_3_64_84,0.99,0,84,84,62
13,r_56_84_37,seq28,seq9,r_56_84_37,0.72,0,37,37,62
12,r_32_91_14,r_112_81_95,r_65_113_4,r_112_81_95,0.67,6,101,95,62
14,r_55_39_19,r_112_81_95,seq0,r_55_39_19,0.95,0,19,19,62
27,r_128_117_6,r_31_21_80,r_19_126_47,r_128_117_6,1.0,74,80,6,62
1,r_98_96_53,seq38,seq80,r_98_96_53,1.0,0,53,53,62
41,r_112_81_95,r_3_64_84,r_32_91_14,r_32_91_14,0.89,9,23,14,62
41,r_112_81_95,r_32_91_14,r_27_46_102,r_27_46_102,1.0,0,102,102,62
47,r_125_66_180,seq72,r_65_113_4,r_65_113_4,0.53,178,182,4,62
34,r_24_106_10,r_65_113_4,r_25_144_17,r_25_144_17,1.0,2,19,17,62
18,r_115_7_185,r_59_61_193,r_130_71_124,r_130_71_124,0.98,62,186,124,62
29,r_16_15_168,seq43,r_130_71_124,r_16_15_168,0.6,0,168,168,62
24,r_100_58_149,seq95,seq43,r_100_58_149,0.92,0,149,149,62
25,r_2_118_162,seq34,r_29_120_38,r_2_118_162,0.85,0,162,162,62
43,r_44_70_44,r_1_149_163,seq52,r_1_149_163,0.97,-1,162,163,62
33,r_5_33_156,r_62_83_126,r_4_49_136,r_5_33_156,0.55,-30,126,156,62
43,r_44_70_44,r_31_21_80,r_1_149_163,r_44_70_44,1.0,0,44,44,62
68,seq40,seq110,r_133_75_86,r_133_75_86,1.0,15,101,86,62
61,seq20,r_90_129_160,r_6_63_99,r_6_63_99,0.95,1,100,99,62
32,r_6_63_99,seq17,seq20,r_6_63_99,0.98,0,99,99,62
52,seq134,r_26_136_75,seq47,r_26_136_75,1.0,3,78,75,62
36,r_119_109_42,seq74,r_73_127_41,r_119_109_42,1.0,0,42,42,62
2,r_53_137_12,r_3_64_84,seq74,r_53_137_12,0.99,0,12,12,62
45,r_73_127_41,r_31_21_80,seq132,r_73_127_41,0.93,0,41,41,62
75,seq52,seq47,r_44_70_44,r_44_70_44,1.0,43,87,44,62
39,r_77_101_33,seq11,seq68,r_77_101_33,0.92,1,34,33,62
4,r_29_120_38,r_89_111_179,seq67,r_29_120_38,0.99,0,38,38,62
9,r_27_46_102,seq80,r_112_81_95,r_27_46_102,1.0,0,102,102,62
51,seq132,r_56_84_37,r_142_93_15,r_142_93_15,0.58,3,18,15,62
31,r_1_149_163,r_44_70_44,r_133_75_86,r_1_149_163,0.89,0,163,163,62
22,r_121_122_121,seq141,seq38,r_121_122_121,1.0,0,121,121,62
49,r_139_99_108,r_125_66_180,r_57_45_174,r_139_99_108,1.0,0,108,108,62
7,r_26_136_75,seq134,seq37,r_26_136_75,1.0,0,75,75,62
38,r_131_87_32,r_85_107_105,r_128_117_6,r_131_87_32,0.82,1,33,32,62
48,r_140_143_50,r_125_66_180,r_135_23_45,r_125_66_180,1.0,-129,51,180,62
30,r_65_97_171,seq77,r_118_108_95,r_118_108_95,1.0,76,171,95,63
36,r_54_5_147,r_24_92_82,r_99_122_71,r_54_5_147,1.0,-75,72,147,63
9,r_2_130_32,r_140_143_163,r_81_7_69,r_81_7_69,0.92,94,163,69,63
14,r_56_71_184,r_121_31_170,r_99_122_71,r_99_122_71,1.0,99,170,71,63
37,r_121_31_170,r_56_71_184,r_42_116_49,r_121_31_170,0.62,0,170,170,63
26,r_141_149_52,r_36_29_104,seq55,r_141_149_52,1.0,0,52,52,63
16,r_23_28_169,seq1,r_87_44_27,r_23_28_169,0.61,0,169,169,63
39,r_81_7_69,seq94,r_2_130_32,r_81_7_69,1.0,0,69,69,63
1,r_118_108_95,seq70,r_6_114_14,r_118_108_95,1.0,0,95,95,63
42,r_69_53_73,r_140_143_163,seq147,r_69_53_73,0.86,1,74,73,63
9,r_2_130_32,seq58,r_140_143_163,r_2_130_32,0.83,-1,31,32,63
80,seq73,r_18_66_132,r_54_5_147,r_18_66_132,0.56,0,132,132,63
45,r_148_131_180,seq96,seq27,r_148_131_180,0.47,1,181,180,63
19,r_144_88_179,r_132_109_109,r_2_130_32,r_144_88_179,0.37,2,181,179,63
78,seq68,seq145,r_78_38_18,r_78_38_18,1.0,-1,17,18,63
31,r_15_91_91,r_65_97_171,seq147,r_15_91_91,1.0,0,91,91,63
41,r_100_45_166,seq22,seq40,r_100_45_166,0.68,1,167,166,63
28,r_111_61_29,r_17_0_23,seq51,r_111_61_29,0.94,0,29,29,63
6,r_140_143_163,r_69_53_73,r_2_130_32,r_140_143_163,0.92,-132,31,163,63
10,r_10_126_93,seq94,seq52,r_10_126_93,1.0,0,93,93,63
8,r_115_80_177,r_87_44_27,r_140_143_163,r_87_44_27,0.53,150,177,27,63
80,seq73,r_54_5_147,r_74_67_139,r_54_5_147,0.51,6,153,147,63
32,r_37_41_24,r_139_46_167,seq57,r_37_41_24,0.81,0,24,24,63
0,r_12_98_75,seq13,seq129,r_12_98_75,1.0,1,76,75,63
11,r_6_114_14,r_12_98_75,seq63,r_6_114_14,0.72,0,14,14,63
13,r_20_134_178,seq51,r_4_30_105,r_4_30_105,1.0,76,181,105,63
48,r_107_136_133,seq40,r_99_122_71,r_107_136_133,0.99,0,133,133,63
57,seq19,seq68,r_112_105_79,r_112_105_79,1.0,24,103,79,63
43,r_78_38_18,seq59,seq68,r_78_38_18,0.78,-1,17,18,63
2,r_99_122_71,r_54_5_147,r_107_136_133,r_107_136_133,1.0,20,153,133,63
36,r_54_5_147,r_99_122_71,r_141_149_52,r_54_5_147,0.65,6,153,147,63
27,r_123_86_72,r_148_131_180,seq58,r_123_86_72,0.83,1,73,72,63
14,r_56_71_184,r_99_122_71,r_144_88_179,r_56_71_184,0.85,0,184,184,63
38,r_17_0_23,r_111_61_29,seq1,r_111_61_29,0.57,-9,20,29,63
29,r_74_67_139,r_87_44_27,r_121_31_170,r_87_44_27,0.94,-4,23,27,63
2,r_99_122_71,r_112_105_79,r_54_5_147,r_99_122_71,1.0,0,71,71,63
47,r_36_29_104,seq27,r_78_38_18,r_36_29_104,0.73,0,104,104,63
18,r_137_95_119,seq57,seq129,r_137_95_119,1.0,0,119,119,63
25,r_146_82_122,seq129,r_24_92_82,r_146_82_122,1.0,1,123,122,63
33,r_127_21_99,seq63,r_133_62_90,r_127_21_99,1.0,1,100,99,63
20,r_64_102_19,r_107_136_133,r_112_105_79,r_64_102_19,1.0,0,19,19,63
50,seq1,r_23_28_169,r_17_0_23,r_23_28_169,0.84,0,169,169,63
70,seq51,r_20_134_178,r_111_61_29,r_111_61_29,0.9,152,181,29,63
6,r_140_143_163,r_2_130_32,r_10_126_93,r_10_126_93,0.99,70,163,93,63
20,r_64_102_19,r_112_105_79,r_87_44_27,r_112_105_79,1.0,0,79,79,63
61,seq27,r_36_29_104,seq135,r_36_29_104,1.0,0,104,104,63
52,seq129,r_146_82_122,seq93,r_146_82_122,1.0,-46,76,122,63
34,r_133_62_90,r_139_46_167,r_127_21_99,r_127_21_99,1.0,1,100,99,63
8,r_115_80_177,r_4_30_105,r_87_44_27,r_115_80_177,0.94,-140,37,177,63
21,r_16_8_42,seq11,seq47,r_16_8_42,1.0,-1,41,42,63
17,r_89_50_70,seq52,seq142,r_89_50_70,1.0,0,70,70,63
96,seq147,r_36_29_104,r_15_91_91,r_15_91_91,0.97,3,94,91,63
29,r_74_67_139,r_121_31_170,seq73,r_121_31_170,0.54,-20,150,170,63
22,r_18_66_132,seq73,r_72_43_4,r_18_66_132,1.0,0,132,132,63
91,seq96,r_148_131_180,r_24_92_82,r_24_92_82,1.0,0,82,82,63
5,r_87_44_27,r_74_67_139,r_64_102_19,r_87_44_27,1.0,0,27,27,63
49,r_24_92_82,r_54_5_147,seq96,r_24_92_82,1.0,0,82,82,63
4,r_85_48_44,r_42_116_49,r_6_114_14,r_85_48_44,0.99,1,45,44,63
7,r_4_30_105,r_115_80_177,seq14,r_4_30_105,0.92,0,105,105,63
44,r_117_128_113,r_49_138_199,r_72_43_4,r_72_43_4,0.77,119,123,4,63
23,r_112_105_79,r_99_122_71,seq19,r_112_105_79,1.0,-8,71,79,63
30,r_137_23_82,seq13,seq63,r_137_23_82,0.98,0,82,82,64
21,r_99_6_119,seq1,r_15_80_49,r_15_80_49,1.0,5,54,49,64
36,r_68_93_65,seq104,seq19,r_68_93_65,1.0,1,66,65,64
14,r_109_78_142,seq132,r_59_83_101,r_109_78_142,0.67,0,142,142,64
54,seq8,r_129_138_57,seq46,r_129_138_57,1.0,0,57,57,64
41,r_15_80_49,r_111_40_163,r_99_6_119,r_15_80_49,0.98,0,49,49,64
54,seq8,seq46,r_79_81_112,r_79_81_112,1.0,10,122,112,64
59,seq18,r_34_2_165,r_148_22_81,r_148_22_81,1.0,17,98,81,64
86,seq101,r_111_40_163,seq50,r_111_40_163,0.79,2,165,163,64
16,r_14_100_122,seq146,seq46,r_14_100_122,0.92,0,122,122,64
1,r_111_40_163,seq101,seq21,r_111_40_163,0.39,2,165,163,64
46,r_20_70_180,r_10_39_75,r_47_32_36,r_20_70_180,0.64,-105,75,180,64
69,seq46,seq8,r_14_100_122,r_14_100_122,1.0,0,122,122,64
45,r_105_77_161,seq62,seq30,r_105_77_161,0.95,0,161,161,64
27,r_107_94_186,r_17_52_74,r_53_45_87,r_107_94_186,0.54,0,186,186,64
78,seq64,r_127_131_20,r_75_76_69,r_75_76_69,1.0,65,134,69,64
76,seq62,r_105_77_161,r_58_133_70,r_105_77_161,0.92,0,161,161,64
31,r_127_131_20,seq31,r_107_94_186,r_127_131_20,1.0,1,21,20,64
5,r_143_86_33,r_58_133_70,r_142_134_27,r_143_86_33,1.0,0,33,33,64
10,r_58_133_70,r_25_82_184,r_67_102_55,r_58_133_70,0.7,1,71,70,64
26,r_17_52_74,r_142_134_27,r_107_94_186,r_17_52_74,1.0,1,75,74,64
72,seq55,r_51_147_144,seq50,r_51_147_144,1.0,-29,115,144,64
40,r_89_84_30,seq28,seq31,r_89_84_30,0.54,7,37,30,64
0,r_79_81_112,r_26_44_169,seq8,r_79_81_112,0.98,0,112,112,64
73,seq56,seq124,r_135_96_118,r_135_96_118,0.95,9,127,118,64
20,r_75_76_69,r_149_72_6,r_0_54_121,r_75_76_69,1.0,1,70,69,64
15,r_67_102_55,r_128_71_120,seq62,r_67_102_55,1.0,0,55,55,64
46,r_20_70_180,r_47_32_36,r_34_2_165,r_20_70_180,0.29,3,183,180,64
23,r_140_97_14,r_47_32_36,seq1,r_140_97_14,0.94,1,15,14,64
21,r_99_6_119,r_15_80_49,seq104,r_99_6_119,1.0,0,119,119,64
10,r_58_133_70,r_143_86_33,r_25_82_184,r_143_86_33,1.0,0,33,33,64
6,r_41_87_28,r_34_2_165,seq38,r_41_87_28,1.0,0,28,28,64
87,seq104,r_116_35_83,r_99_6_119,r_99_6_119,1.0,19,138,119,64
27,r_107_94_186,seq64,r_17_52_74,r_17_52_74,1.0,7,81,74,64
87,seq104,r_68_93_65,r_116_35_83,r_68_93_65,0.99,1,66,65,64
42,r_95_48_45,seq60,seq69,r_95_48_45,1.0,0,45,45,64
9,r_26_44_169,r_73_36_23,r_95_48_45,r_26_44_169,0.97,0,169,169,64
41,r_15_80_49,r_99_6_119,r_53_45_87,r_15_80_49,0.89,70,119,49,64
18,r_92_108_198,r_20_70_180,r_47_32_36,r_47_32_36,1.0,147,183,36,64
29,r_112_115_141,seq5,r_41_87_28,r_41_87_28,0.98,117,145,28,64
24,r_59_83_101,r_135_96_118,seq12,r_59_83_101,0.47,0,101,101,64
78,seq64,r_73_36_23,r_127_131_20,r_127_131_20,0.92,5,25,20,64
25,r_24_103_2,seq74,r_58_133_70,r_24_103_2,0.68,169,171,2,64
32,r_148_22_81,seq13,seq18,r_148_22_81,1.0,0,81,81,64
34,r_116_35_83,r_42_3_197,seq104,r_116_35_83,0.64,1,84,83,64
4,r_73_36_23,seq64,seq130,r_73_36_23,0.88,-2,21,23,64
17,r_66_16_73,seq29,r_89_84_30,r_66_16_73,1.0,0,73,73,64
9,r_26_44_169,r_79_81_112,r_73_36_23,r_79_81_112,0.61,0,112,112,64
26,r_17_52_74,r_107_94_186,r_75_76_69,r_107_94_186,0.9,0,186,186,64
96,seq122,seq1,r_129_138_57,r_129_138_57,1.0,4,61,57,64
31,r_127_131_20,r_107_94_186,r_51_147_144,r_51_147_144,0.97,4,148,144,64
22,r_0_54_121,r_42_3_197,r_75_76_69,r_75_76_69,1.0,73,142,69,64
28,r_135_96_118,seq126,seq56,r_135_96_118,0.96,0,118,118,64
11,r_47_32_36,seq19,r_20_70_180,r_47_32_36,1.0,0,36,36,64
75,seq60,r_95_48_45,seq63,r_95_48_45,1.0,0,45,45,64
49,r_145_91_80,r_109_78_142,seq85,r_145_91_80,1.0,0,80,80,64
7,r_128_71_120,seq126,seq69,r_128_71_120,0.83,0,120,120,64
33,r_110_7_26,seq64,seq118,r_110_7_26,0.91,3,29,26,64
35,r_10_39_75,r_20_70_180,r_140_97_14,r_10_39_75,1.0,0,75,75,64
19,r_129_138_57,seq8,seq122,r_129_138_57,1.0,0,57,57,64
23,r_140_97_14,seq1,r_10_39_75,r_10_39_75,1.0,2,77,75,64
84,seq85,r_112_115_141,r_145_91_80,r_145_91_80,1.0,5,85,80,64
36,r_9_131_64,seq49,seq17,r_9_131_64,1.0,0,64,64,65
13,r_30_10_96,r_5_1_4,r_79_103_58,r_30_10_96,1.0,0,96,96,65
92,seq105,r_76_75_120,seq142,r_76_75_120,1.0,0,120,120,65
14,r_34_38_131,seq88,seq0,r_34_38_131,0.59,2,133,131,65
8,r_90_59_188,seq81,r_124_94_40,r_90_59_188,0.35,1,189,188,65
26,r_20_31_43,r_62_102_66,seq113,r_20_31_43,0.55,0,43,43,65
37,r_62_102_66,seq122,seq88,r_62_102_66,1.0,0,66,66,65
13,r_30_10_96,r_87_11_175,r_5_1_4,r_30_10_96,0.47,-51,45,96,65
39,r_120_18_115,r_24_13_165,seq93,r_120_18_115,0.74,1,116,115,65
5,r_55_61_147,seq109,r_54_115_95,r_55_61_147,0.86,0,147,147,65
42,r_26_37_77,r_108_111_174,seq27,r_26_37_77,1.0,0,77,77,65
24,r_104_57_109,seq39,r_56_95_13,r_56_95_13,0.95,-2,11,13,65
45,r_74_107_178,seq35,seq149,r_74_107_178,0.51,2,180,178,65
24,r_104_57_109,r_56_95_13,seq35,r_104_57_109,0.94,-2,107,109,65
19,r_4_137_186,r_89_139_3,r_24_13_165,r_89_139_3,0.36,183,186,3,65
30,r_84_23_26,r_80_48_160,r_89_139_3,r_84_23_26,1.0,1,27,26,65
10,r_80_48_160,seq41,seq58,r_80_48_160,0.73,0,160,160,65
16,r_5_1_4,r_54_115_95,seq35,r_54_115_95,0.92,0,95,95,65
4,r_146_44_173,seq125,r_21_70_65,r_146_44_173,0.68,0,173,173,65
0,r_6_112_185,seq133,r_60_42_47,r_60_42_47,0.55,138,185,47,65
11,r_28_43_103,r_79_103_58,r_22_69_27,r_28_43_103,1.0,0,103,103,65
15,r_32_96_110,r_4_137_186,seq0,r_32_96_110,0.98,0,110,110,65
48,r_130_63_161,r_45_65_116,r_20_31_43,r_130_63_161,0.88,-45,116,161,65
7,r_87_11_175,r_104_57_109,r_89_139_3,r_87_11_175,0.76,2,177,175,65
57,seq16,r_108_111_174,r_54_115_95,r_54_115_95,0.76,0,95,95,65
3,r_147_140_39,seq113,seq133,r_147_140_39,1.0,0,39,39,65
6,r_79_103_58,r_24_13_165,r_30_10_96,r_30_10_96,1.0,75,171,96,65
62,seq27,seq113,r_26_37_77,r_26_37_77,1.0,4,81,77,65
51,seq128,r_67_141_52,r_15_47_8,r_67_141_52,0.84,-29,23,52,65
2,r_54_115_95,r_5_1_4,seq16,r_54_115_95,0.91,0,95,95,65
9,r_52_119_106,r_20_31_43,r_76_75_120,r_76_75_120,0.59,26,146,120,65
28,r_56_95_13,r_126_148_118,r_104_57_109,r_56_95_13,0.98,0,13,13,65
33,r_124_94_40,seq25,seq36,r_124_94_40,1.0,0,40,40,65
1,r_67_141_52,seq128,seq39,r_67_141_52,1.0,-1,51,52,65
41,r_118_121_32,r_56_95_13,r_24_13_165,r_118_121_32,0.4,117,149,32,65
47,r_51_144_60,seq19,r_20_31_43,r_51_144_60,0.77,5,65,60,65
64,seq35,r_74_107_178,r_76_75_120,r_76_75_120,1.0,60,180,120,65
58,seq17,r_40_29_154,seq58,r_40_29_154,0.97,0,154,154,65
70,seq49,r_9_131_64,r_56_95_13,r_9_131_64,1.0,0,64,64,65
38,r_101_73_71,seq136,r_106_99_29,r_101_73_71,0.74,0,71,71,65
34,r_40_29_154,seq17,seq66,r_40_29_154,0.69,0,154,154,65
17,r_76_75_120,seq105,r_104_57_109,r_76_75_120,0.98,0,120,120,65
48,r_130_63_161,r_20_31_43,seq33,r_130_63_161,0.98,0,161,161,65
9,r_52_119_106,r_90_59_188,r_20_31_43,r_52_119_106,0.93,0,106,106,65
96,seq117,seq134,r_106_99_29,r_106_99_29,0.83,104,133,29,65
28,r_56_95_13,r_104_57_109,seq93,r_104_57_109,1.0,-8,101,109,65
22,r_126_148_118,r_74_107_178,seq142,r_126_148_118,0.99,1,119,118,65
49,r_143_2_138,seq125,seq41,r_143_2_138,0.73,0,138,138,65
7,r_87_11_175,r_126_148_118,r_104_57_109,r_87_11_175,0.77,-57,118,175,65
44,r_8_114_79,seq7,seq72,r_8_114_79,1.0,1,80,79,65
23,r_60_42_47,r_101_73_71,seq145,r_60_42_47,1.0,0,47,47,65
41,r_118_121_32,r_74_107_178,r_56_95_13,r_118_121_32,0.96,0,32,32,65
40,r_22_69_27,r_32_96_110,seq122,r_22_69_27,0.88,0,27,27,65
79,seq81,r_90_59_188,r_32_96_110,r_32_96_110,1.0,62,172,110,65
12,r_21_70_65,seq58,r_89_139_3,r_21_70_65,0.9,0,65,65,65
30,r_51_143_83,r_38_36_13,r_34_21_38,r_51_143_83,0.51,1,84,83,66
11,r_61_129_44,r_149_101_172,r_69_89_159,r_61_129_44,0.81,3,47,44,66
14,r_31_42_141,seq105,r_93_35_117,r_31_42_141,0.61,0,141,141,66
43,r_46_75_2,r_132_39_94,r_30_147_63,r_30_147_63,1.0,55,118,63,66
17,r_76_124_56,r_148_144_114,seq49,r_76_124_56,1.0,0,56,56,66
59,seq16,r_13_82_129,seq110,r_13_82_129,0.84,0,129,129,66
16,r_12_29_84,r_72_90_22,seq145,r_12_29_84,0.99,1,85,84,66
21,r_13_82_129,seq16,seq47,r_13_82_129,0.93,0,129,129,66
7,r_69_89_159,r_61_129_44,r_30_147_63,r_69_89_159,0.57,2,161,159,66
36,r_77_41_28,r_104_74_135,r_70_126_166,r_77_41_28,1.0,0,28,28,66
7,r_69_89_159,r_38_36_13,r_61_129_44,r_61_129_44,0.74,5,49,44,66
45,r_11_111_51,r_12_29_84,r_24_121_3,r_11_111_51,0.98,0,51,51,66
2,r_70_126_166,r_23_102_57,r_77_41_28,r_70_126_166,0.97,-109,57,166,66
31,r_131_98_156,seq115,r_45_53_73,r_131_98_156,0.77,0,156,156,66
10,r_52_97_74,seq2,seq86,r_52_97_74,0.99,4,78,74,66
25,r_34_21_38,seq84,seq114,r_34_21_38,0.98,1,39,38,66
26,r_87_91_162,r_4_43_180,seq25,r_87_91_162,0.55,0,162,162,66
5,r_32_127_15,r_136_78_27,r_119_80_89,r_32_127_15,0.89,2,17,15,66
1,r_136_78_27,r_108_15_152,seq141,r_136_78_27,0.95,0,27,27,66
0,r_45_53_73,seq2,seq68,r_45_53_73,1.0,0,73,73,66
39,r_63_137_14,r_70_126_166,seq14,r_63_137_14,1.0,0,14,14,66
13,r_30_147_63,r_119_80_89,r_72_90_22,r_30_147_63,1.0,0,63,63,66
6,r_81_85_25,r_96_112_184,seq122,r_81_85_25,0.96,1,26,25,66
48,r_106_40_80,r_96_112_184,r_32_127_15,r_106_40_80,0.76,1,81,80,66
85,seq86,r_55_130_127,r_52_97_74,r_52_97_74,0.63,9,83,74,66
2,r_70_126_166,r_77_41_28,r_55_130_127,r_70_126_166,0.66,1,167,166,66
5,r_32_127_15,r_119_80_89,r_106_40_80,r_32_127_15,1.0,73,88,15,66
36,r_77_41_28,r_70_126_166,r_104_74_135,r_104_74_135,0.85,31,166,135,66
27,r_55_130_127,seq95,seq6,r_55_130_127,0.99,0,127,127,66
11,r_61_129_44,r_69_89_159,r_10_120_79,r_10_120_79,0.83,-1,78,79,66
3,r_128_107_52,seq138,seq9,r_128_107_52,1.0,0,52,52,66
40,r_148_144_114,seq95,seq139,r_148_144_114,1.0,0,114,114,66
18,r_48_5_107,r_93_35_117,seq138,r_48_5_107,0.92,2,109,107,66
29,r_104_74_135,r_100_0_139,r_24_121_3,r_24_121_3,0.68,135,138,3,66
24,r_119_80_89,seq49,seq14,r_119_80_89,1.0,0,89,89,66
33,r_10_120_79,r_119_80_89,r_61_129_44,r_10_120_79,0.94,0,79,79,66
46,r_23_102_57,r_70_126_166,seq95,r_23_102_57,0.99,0,57,57,66
50,seq2,r_45_53_73,seq6,r_45_53_73,1.0,0,73,73,66
32,r_20_83_112,r_132_39_94,seq22,r_20_83_112,0.79,2,114,112,66
38,r_146_26_182,seq65,r_37_28_146,r_37_28_146,0.58,35,181,146,66
19,r_93_35_117,seq9,r_31_42_141,r_31_42_141,1.0,17,158,141,66
9,r_79_27_77,seq99,seq134,r_79_27_77,0.98,6,83,77,66
22,r_108_15_152,seq109,r_88_58_134,r_88_58_134,0.76,18,152,134,66
28,r_116_71_173,seq19,r_88_58_134,r_116_71_173,0.66,0,173,173,66
49,r_1_3_157,seq19,r_45_53_73,r_1_3_157,0.76,0,157,157,66
44,r_100_0_139,r_104_74_135,r_32_127_15,r_32_127_15,0.93,124,139,15,66
12,r_38_36_13,r_55_130_127,r_52_97_74,r_38_36_13,0.72,71,84,13,66
40,r_58_68_30,r_95_52_180,r_77_137_77,r_58_68_30,0.66,71,101,30,67
30,r_33_22_91,r_108_97_193,r_114_28_1,r_33_22_91,1.0,0,91,91,67
42,r_15_67_34,seq1,seq59,r_15_67_34,0.89,0,34,34,67
36,r_17_123_79,seq1,seq71,r_17_123_79,0.94,0,79,79,67
11,r_92_4_43,seq96,seq14,r_92_4_43,0.94,4,47,43,67
95,seq120,r_48_76_7,r_129_98_65,r_129_98_65,0.78,-24,41,65,67
16,r_46_70_51,seq2,r_58_68_30,r_46_70_51,0.92,4,55,51,67
43,r_128_73_130,seq94,seq117,r_128_73_130,0.72,0,130,130,67
39,r_108_97_193,r_33_22_91,r_65_41_40,r_108_97_193,0.64,-102,91,193,67
1,r_20_10_149,seq143,seq2,r_20_10_149,0.74,0,149,149,67
46,r_138_26_127,seq16,r_47_39_29,r_138_26_127,0.71,6,133,127,67
69,seq55,r_130_11_61,seq117,r_130_11_61,1.0,0,61,61,67
45,r_130_11_61,seq55,r_44_51_117,r_130_11_61,1.0,0,61,61,67
45,r_130_11_61,r_44_51_117,seq16,r_44_51_117,0.94,3,120,117,67
22,r_47_39_29,r_64_100_78,seq27,r_47_39_29,0.73,2,31,29,67
31,r_129_98_65,seq117,seq120,r_129_98_65,0.7,2,67,65,67
41,r_136_30_39,seq5,r_8_132_118,r_136_30_39,0.51,107,146,39,67
12,r_44_51_117,r_113_140_188,r_92_4_43,r_113_140_188,0.69,1,189,188,67
3,r_102_119_196,r_108_97_193,r_125_50_26,r_108_97_193,0.25,-4,189,193,67
10,r_38_84_170,seq142,seq35,r_38_84_170,0.55,0,170,170,67
26,r_89_147_54,r_20_10_149,r_101_74_37,r_89_147_54,0.82,8,62,54,67
0,r_81_107_157,seq13,seq57,r_81_107_157,0.6,6,163,157,67
55,seq13,r_81_107_157,r_109_118_18,r_109_118_18,0.94,1,19,18,67
20,r_8_132_118,r_108_97_193,r_61_115_108,r_108_97_193,0.55,-75,118,193,67
7,r_125_50_26,r_64_100_78,seq143,r_125_50_26,0.93,0,26,26,67
48,r_37_88_93,seq12,seq55,r_37_88_93,0.96,0,93,93,67
6,r_45_29_99,r_6_34_162,r_93_144_70,r_6_34_162,0.65,-4,158,162,67
6,r_45_29_99,seq117,r_6_34_162,r_45_29_99,0.98,0,99,99,67
27,r_6_34_162,r_113_140_188,r_78_25_109,r_113_140_188,0.97,-25,163,188,67
38,r_109_118_18,r_38_84_170,seq13,r_109_118_18,0.93,1,19,18,67
69,seq55,seq117,r_37_88_93,r_37_88_93,0.99,20,113,93,67
2,r_78_25_109,seq14,seq12,r_78_25_109,0.73,2,111,109,67
12,r_44_51_117,r_130_11_61,r_113_140_188,r_44_51_117,0.8,1,118,117,67
29,r_61_115_108,r_23_139_166,seq117,r_61_115_108,1.0,0,108,108,67
6,r_45_29_99,r_93_144_70,r_44_51_117,r_45_29_99,0.62,82,181,99,67
24,r_64_100_78,r_61_115_108,seq72,r_61_115_108,0.65,-28,80,108,67
18,r_24_87_20,r_37_88_93,seq62,r_37_88_93,0.58,-74,19,93,67
13,r_65_41_40,r_38_84_170,r_108_97_193,r_65_41_40,0.98,0,40,40,67
58,seq16,r_138_26_127,seq127,r_138_26_127,0.98,6,133,127,67
21,r_101_74_37,seq19,r_89_147_54,r_101_74_37,0.75,0,37,37,67
28,r_113_140_188,r_44_51_117,seq90,r_113_140_188,0.83,0,188,188,67
34,r_23_139_166,seq127,r_109_118_18,r_109_118_18,0.67,149,167,18,67
17,r_145_111_112,seq106,seq5,r_145_111_112,0.98,0,112,112,67
94,seq117,r_129_98_65,r_61_115_108,r_61_115_108,0.98,2,110,108,67
40,r_58_68_30,r_78_25_109,r_95_52_180,r_58_68_30,0.85,0,30,30,67
9,r_149_54_146,seq127,seq75,r_149_54_146,0.98,0,146,146,67
28,r_113_140_188,r_6_34_162,r_44_51_117,r_113_140_188,0.7,-25,163,188,67
49,r_77_137_77,r_21_9_167,r_58_68_30,r_21_9_167,0.97,-88,79,167,67
23,r_93_144_70,seq82,seq110,r_93_144_70,1.0,0,70,70,67
12,r_44_51_117,seq27,r_130_11_61,r_130_11_61,1.0,6,67,61,67
93,seq103,r_128_124_80,seq81,r_128_124_80,0.61,11,91,80,68
36,r_98_18_75,seq145,seq39,r_98_18_75,0.53,10,85,75,68
14,r_120_131_109,seq29,seq86,r_120_131_109,0.92,0,109,109,68
8,r_1_122_84,r_110_25_191,r_50_108_131,r_1_122_84,0.86,0,84,84,68
53,seq8,r_70_74_160,seq20,r_70_74_160,0.91,0,160,160,68
43,r_115_32_64,seq6,seq91,r_115_32_64,1.0,0,64,64,68
54,seq10,r_132_96_74,seq6,r_132_96_74,1.0,0,74,74,68
37,r_109_133_67,seq146,seq140,r_109_133_67,0.77,26,93,67,68
86,seq87,r_4_56_124,r_51_41_59,r_51_41_59,1.0,66,125,59,68
16,r_11_21_110,seq77,r_0_47_178,r_11_21_110,0.88,0,110,110,68
21,r_58_38_146,seq20,r_137_22_108,r_58_38_146,0.94,0,146,146,68
1,r_76_100_73,r_70_74_160,seq24,r_76_100_73,1.0,1,74,73,68
46,r_36_111_85,seq142,seq86,r_36_111_85,0.98,0,85,85,68
4,r_136_52_57,seq53,r_0_47_178,r_136_52_57,0.97,2,59,57,68
80,seq81,seq104,r_114_148_42,r_114_148_42,0.57,79,121,42,68
30,r_143_101_119,r_57_23_50,r_26_45_33,r_143_101_119,1.0,-69,50,119,68
66,seq39,r_9_15_22,r_98_18_75,r_98_18_75,0.78,10,85,75,68
31,r_125_5_177,seq43,seq20,r_125_5_177,0.5,-1,176,177,68
3,r_69_97_51,r_0_47_178,seq145,r_69_97_51,1.0,4,55,51,68
67,seq145,r_98_18_75,r_69_97_51,r_69_97_51,0.92,34,85,51,68
89,seq91,r_3_134_79,r_115_32_64,r_115_32_64,0.99,6,70,64,68
47,r_141_130_15,r_50_108_131,r_73_19_156,r_141_130_15,0.96,3,18,15,68
26,r_137_22_108,r_60_71_117,r_3_134_79,r_137_22_108,0.83,8,116,108,68
16,r_11_21_110,r_0_47_178,r_136_52_57,r_0_47_178,1.0,0,178,178,68
34,r_0_47_178,r_11_21_110,r_114_148_42,r_0_47_178,0.98,0,178,178,68
5,r_50_108_131,r_1_122_84,seq142,r_50_108_131,1.0,1,132,131,68
78,seq75,r_63_49_136,seq140,r_63_49_136,1.0,0,136,136,68
11,r_95_13_171,seq68,r_58_38_146,r_58_38_146,0.55,25,171,146,68
20,r_31_42_170,seq83,r_128_124_80,r_31_42_170,0.86,1,171,170,68
98,seq117,seq104,r_128_124_80,r_128_124_80,1.0,9,89,80,68
15,r_65_59_139,r_125_5_177,seq72,r_65_59_139,0.75,5,144,139,68
4,r_136_52_57,r_0_47_178,r_11_21_110,r_11_21_110,1.0,68,178,110,68
48,r_105_54_190,seq77,r_141_130_15,r_141_130_15,1.0,38,53,15,68
34,r_0_47_178,r_136_52_57,r_11_21_110,r_11_21_110,1.0,3,113,110,68
5,r_50_108_131,seq89,r_1_122_84,r_1_122_84,1.0,0,84,84,68
34,r_0_47_178,r_69_97_51,r_136_52_57,r_69_97_51,0.58,8,59,51,68
17,r_51_41_59,r_109_133_67,r_80_85_31,r_109_133_67,0.67,-8,59,67,68
27,r_60_71_117,r_125_5_177,seq146,r_60_71_117,0.62,3,120,117,68
30,r_143_101_119,r_26_45_33,r_118_7_16,r_143_101_119,1.0,2,121,119,68
19,r_128_124_80,r_26_45_33,seq103,r_26_45_33,1.0,1,34,33,68
70,seq53,r_136_52_57,r_57_23_50,r_57_23_50,0.77,4,54,50,68
93,seq103,seq81,r_63_49_136,r_63_49_136,0.95,32,168,136,68
18,r_33_113_62,seq35,seq43,r_33_113_62,1.0,1,63,62,68
13,r_80_85_31,seq39,seq27,r_80_85_31,0.97,0,31,31,68
25,r_99_79_155,seq107,seq140,r_99_79_155,0.79,0,155,155,68
33,r_63_49_136,seq75,seq68,r_63_49_136,0.77,0,136,136,68
48,r_105_54_190,r_141_130_15,seq75,r_105_54_190,0.29,-48,142,190,68
19,r_128_124_80,seq103,seq117,r_128_124_80,0.77,0,80,80,68
68,seq43,r_125_5_177,r_144_126_83,r_144_126_83,0.99,93,176,83,68
42,r_28_92_26,r_137_22_108,seq61,r_28_92_26,1.0,1,27,26,68
24,r_26_45_33,r_128_124_80,r_34_40_10,r_26_45_33,1.0,1,34,33,68
29,r_114_148_42,r_63_49_136,seq6,r_114_148_42,1.0,0,42,42,68
6,r_118_7_16,r_11_21_110,seq35,r_118_7_16,0.99,0,16,16,68
8,r_1_122_84,r_50_108_131,seq89,r_50_108_131,1.0,-12,119,131,68
22,r_55_138_186,seq27,r_33_113_62,r_33_113_62,1.0,124,186,62,68
49,r_70_74_160,seq8,r_128_124_80,r_70_74_160,0.76,0,160,160,68
12,r_34_40_10,r_118_7_16,seq2,r_34_40_10,0.89,2,12,10,68
10,r_16_135_37,seq91,seq53,r_16_135_37,1.0,0,37,37,68
7,r_123_30_81,seq2,seq94,r_123_30_81,1.0,0,81,81,68
23,r_144_126_83,r_110_25_191,seq43,r_144_126_83,0.98,0,83,83,68
39,r_57_23_50,r_143_101_119,seq53,r_57_23_50,1.0,0,50,50,68
5,r_50_108_131,r_141_130_15,seq89,r_141_130_15,0.66,0,15,15,68
36,r_43_30_113,seq107,r_134_7_175,r_43_30_113,0.74,1,114,113,69
43,r_80_23_133,seq24,r_111_149_19,r_80_23_133,0.93,1,134,133,69
25,r_11_65_57,seq128,seq40,r_11_65_57,1.0,0,57,57,69
37,r_25_34_108,seq66,seq128,r_25_34_108,0.76,0,108,108,69
3,r_78_118_16,seq40,r_17_3_91,r_17_3_91,0.98,2,93,91,69
26,r_46_138_40,r_131_105_100,seq64,r_46_138_40,1.0,0,40,40,69
20,r_142_133_36,seq14,seq128,r_142_133_36,1.0,0,36,36,69
13,r_63_148_159,r_143_96_96,r_121_116_156,r_63_148_159,0.98,0,159,159,69
55,seq9,r_121_116_156,seq86,r_121_116_156,0.85,0,156,156,69
21,r_126_44_126,seq107,seq88,r_126_44_126,0.97,0,126,126,69
39,r_47_10_83,seq20,seq139,r_47_10_83,1.0,0,83,83,69
1,r_53_62_85,r_143_96_96,seq107,r_53_62_85,1.0,0,85,85,69
5,r_26_129_137,r_83_74_191,seq71,r_26_129_137,0.97,0,137,137,69
46,r_0_104_88,r_143_96_96,r_109_84_51,r_0_104_88,1.0,0,88,88,69
42,r_17_3_91,seq125,r_78_118_16,r_17_3_91,0.85,2,93,91,69
69,seq40,r_22_52_123,r_146_60_106,r_146_60_106,1.0,6,112,106,69
45,r_83_74_191,r_26_129_137,seq59,r_26_129_137,1.0,0,137,137,69
0,r_109_84_51,seq95,r_5_69_41,r_109_84_51,0.99,-2,49,51,69
19,r_27_42_73,r_63_148_159,seq71,r_27_42_73,1.0,0,73,73,69
99,seq127,seq123,r_79_141_142,r_79_141_142,0.87,32,174,142,69
13,r_63_148_159,seq16,r_143_96_96,r_143_96_96,0.87,7,103,96,69
31,r_70_119_153,seq125,r_21_39_31,r_21_39_31,0.6,133,164,31,69
41,r_57_122_146,seq18,seq66,r_57_122_146,0.86,0,146,146,69
30,r_111_149_19,r_70_119_153,seq15,r_111_149_19,0.98,0,19,19,69
4,r_131_105_100,r_99_110_120,r_109_84_51,r_131_105_100,0.97,-3,97,100,69
11,r_35_117_111,seq128,seq24,r_35_117_111,0.67,7,118,111,69
13,r_63_148_159,r_27_42_73,seq16,r_27_42_73,0.66,6,79,73,69
98,seq125,r_70_119_153,r_45_113_86,r_45_113_86,0.9,78,164,86,69
15,r_121_116_156,seq9,r_72_130_52,r_121_116_156,0.78,0,156,156,69
28,r_5_69_41,r_56_77_147,r_109_84_51,r_5_69_41,0.53,42,83,41,69
80,seq73,r_53_62_85,seq31,r_53_62_85,1.0,-32,53,85,69
6,r_103_93_131,seq94,seq67,r_103_93_131,0.64,0,131,131,69
74,seq61,r_145_33_155,seq73,r_145_33_155,1.0,-13,142,155,69
99,seq127,r_99_110_120,seq123,r_99_110_120,0.79,0,120,120,69
2,r_48_58_151,seq1,seq127,r_48_58_151,0.84,2,153,151,69
47,r_92_112_68,seq15,r_6_38_3,r_92_112_68,1.0,2,70,68,69
28,r_5_69_41,r_27_42_73,r_56_77_147,r_5_69_41,0.97,0,41,41,69
18,r_79_141_142,r_121_116_156,seq59,r_79_141_142,0.98,0,142,142,69
24,r_82_28_61,seq88,seq114,r_82_28_61,1.0,0,61,61,69
34,r_143_96_96,r_63_148_159,seq67,r_63_148_159,1.0,1,160,159,69
3,r_78_118_16,r_147_36_160,seq40,r_78_118_16,0.93,-1,15,16,69
32,r_41_106_188,seq67,r_79_141_142,r_41_106_188,0.29,0,188,188,69
38,r_134_7_175,seq37,seq1,r_134_7_175,0.67,0,175,175,69
77,seq67,r_41_106_188,r_103_93_131,r_103_93_131,0.84,57,188,131,69
34,r_143_96_96,seq73,r_63_148_159,r_143_96_96,0.86,0,96,96,69
29,r_56_77_147,r_80_23_133,r_5_69_41,r_5_69_41,1.0,7,48,41,69
17,r_6_38_3,r_25_34_108,r_92_112_68,r_92_112_68,0.95,26,94,68,69
25,r_11_65_57,seq40,r_100_136_127,r_100_136_127,0.95,-3,124,127,69
29,r_56_77_147,r_5_69_41,r_146_60_106,r_5_69_41,0.98,106,147,41,69
36,r_43_30_113,r_134_7_175,r_29_120_141,r_43_30_113,0.98,29,142,113,69
22,r_115_81_135,seq64,seq51,r_115_81_135,0.82,0,135,135,69
12,r_91_75_15,seq2,seq88,r_91_75_15,0.83,0,15,15,69
40,r_72_130_52,r_11_65_57,seq18,r_72_130_52,1.0,0,52,52,69
49,r_89_137_110,r_134_7_175,seq87,r_89_137_110,1.0,1,111,110,69
7,r_145_33_155,seq1,seq87,r_145_33_155,0.88,0,155,155,69
44,r_146_60_106,seq66,seq40,r_146_60_106,1.0,0,106,106,69
23,r_99_110_120,seq127,seq102,r_99_110_120,0.87,1,121,120,69
79,seq71,r_132_85_69,r_27_42_73,r_27_42_73,1.0,17,90,73,69
35,r_100_136_127,seq67,r_11_65_57,r_11_65_57,1.0,70,127,57,69
30,r_89_79_90,r_108_49_146,seq137,r_89_79_90,0.95,0,90,90,70
36,r_85_120_180,seq19,r_4_128_172,r_4_128_172,0.98,13,185,172,70
14,r_71_63_104,seq87,seq104,r_71_63_104,0.9,1,105,104,70
8,r_109_17_98,seq144,r_99_96_24,r_109_17_98,1.0,1,99,98,70
46,r_142_6_42,r_38_1_141,seq34,r_142_6_42,0.99,0,42,42,70
43,r_81_148_106,seq33,seq80,r_81_148_106,1.0,0,106,106,70
34,r_99_96_24,r_72_115_41,seq102,r_99_96_24,0.74,0,24,24,70
71,seq47,seq22,r_57_126_107,r_57_126_107,1.0,6,113,107,70
16,r_39_93_135,r_69_131_137,r_72_115_41,r_39_93_135,0.98,0,135,135,70
39,r_45_8_126,seq53,r_81_148_106,r_45_8_126,0.64,0,126,126,70
97,seq122,r_12_86_185,r_98_74_177,r_98_74_177,0.64,10,187,177,70
37,r_117_24_23,r_98_74_177,seq62,r_117_24_23,0.89,0,23,23,70
48,r_116_67_34,r_52_68_40,seq46,r_116_67_34,1.0,0,34,34,70
41,r_29_113_25,r_109_17_98,seq141,r_29_113_25,1.0,0,25,25,70
19,r_106_14_120,seq62,seq111,r_106_14_120,0.77,6,126,120,70
15,r_108_49_146,r_37_27_150,r_72_115_41,r_108_49_146,1.0,0,146,146,70
9,r_30_35_21,r_69_131_137,seq75,r_30_35_21,0.95,2,23,21,70
28,r_139_56_51,r_36_138_179,seq137,r_139_56_51,1.0,1,52,51,70
4,r_28_140_122,r_9_40_134,r_99_96_24,r_28_140_122,1.0,0,122,122,70
0,r_32_42_174,seq104,r_29_113_25,r_32_42_174,0.59,0,174,174,70
21,r_110_2_58,seq53,r_119_94_197,r_110_2_58,1.0,0,58,58,70
73,seq50,seq137,r_88_78_110,r_88_78_110,1.0,31,141,110,70
32,r_70_0_30,r_28_140_122,seq51,r_28_140_122,0.96,-90,32,122,70
20,r_57_126_107,seq141,seq47,r_57_126_107,0.99,0,107,107,70
23,r_25_127_53,r_12_86_185,r_88_78_110,r_25_127_53,0.89,4,57,53,70
13,r_119_94_197,r_28_140_122,r_110_2_58,r_119_94_197,0.95,-91,106,197,70
46,r_142_6_42,seq34,r_66_92_80,r_66_92_80,0.98,51,131,80,70
15,r_108_49_146,r_66_92_80,r_37_27_150,r_66_92_80,1.0,0,80,80,70
2,r_52_68_40,seq75,seq54,r_52_68_40,0.96,0,40,40,70
70,seq46,r_16_73_191,r_116_67_34,r_116_67_34,0.96,21,55,34,70
23,r_25_127_53,r_88_78_110,seq102,r_25_127_53,0.55,23,76,53,70
27,r_84_7_47,seq91,seq77,r_84_7_47,1.0,0,47,47,70
6,r_4_128_172,r_28_140_122,r_29_113_25,r_4_128_172,0.75,-134,38,172,70
17,r_61_147_55,seq102,seq53,r_61_147_55,1.0,0,55,55,70
29,r_149_129_49,r_108_49_146,seq118,r_108_49_146,0.52,-85,61,146,70
24,r_66_92_80,r_108_49_146,seq134,r_66_92_80,1.0,0,80,80,70
33,r_82_10_62,r_32_42_174,r_121_145_44,r_82_10_62,0.93,1,63,62,70
88,seq101,r_37_27_150,seq3,r_37_27_150,0.92,0,150,150,70
6,r_4_128_172,r_29_113_25,r_71_63_104,r_29_113_25,0.57,147,172,25,70
38,r_64_97_158,seq58,r_139_56_51,r_64_97_158,0.85,0,158,158,70
3,r_72_115_41,seq54,seq144,r_72_115_41,1.0,0,41,41,70
94,seq111,r_121_145_44,r_106_14_120,r_106_14_120,0.85,0,120,120,70
22,r_125_90_92,seq51,seq33,r_125_90_92,1.0,0,92,92,70
49,r_133_143_171,seq3,r_4_128_172,r_133_143_171,0.42,4,175,171,70
56,seq137,seq50,r_139_56_51,r_139_56_51,1.0,27,78,51,70
44,r_12_86_185,seq122,r_139_56_51,r_12_86_185,0.43,2,187,185,70
82,seq77,r_23_130_189,r_38_1_141,r_38_1_141,0.51,-2,139,141,70
35,r_38_1_141,seq114,seq77,r_38_1_141,0.81,1,142,141,70
30,r_72_35_102,r_43_87_199,r_76_64_41,r_72_35_102,1.0,0,102,102,71
14,r_82_126_85,seq118,seq61,r_82_126_85,1.0,0,85,85,71
20,r_149_129_39,r_5_28_181,seq113,r_149_129_39,1.0,0,39,39,71
12,r_66_46_54,r_6_18_93,seq116,r_66_46_54,0.9,0,54,54,71
37,r_115_51_114,seq36,r_69_101_92,r_115_51_114,1.0,0,114,114,71
39,r_148_25_151,seq121,r_40_58_105,r_40_58_105,1.0,5,110,105,71
97,seq116,r_124_127_191,r_66_46_54,r_66_46_54,0.66,6,60,54,71
74,seq57,r_137_52_64,r_38_75_49,r_137_52_64,0.9,-9,55,64,71
42,r_69_101_92,r_109_74_110,seq44,r_69_101_92,0.97,0,92,92,71
6,r_38_75_49,seq142,seq57,r_38_75_49,0.89,0,49,49,71
31,r_65_114_42,r_148_25_151,r_20_77_142,r_65_114_42,0.68,-4,38,42,71
44,r_9_103_34,seq57,seq108,r_9_103_34,1.0,0,34,34,71
76,seq71,r_12_122_156,r_137_52_64,r_137_52_64,0.99,0,64,64,71
41,r_20_77_142,r_65_114_42,seq86,r_20_77_142,0.67,2,144,142,71
38,r_132_92_26,seq97,r_56_26_171,r_132_92_26,1.0,0,26,26,71
3,r_110_48_73,seq121,seq79,r_110_48_73,1.0,0,73,73,71
43,r_93_62_20,r_134_59_18,seq142,r_93_62_20,0.81,4,24,20,71
26,r_119_133_86,seq36,r_110_48_73,r_119_133_86,0.9,0,86,86,71
0,r_7_4_62,seq61,seq57,r_7_4_62,1.0,2,64,62,71
13,r_40_58_105,seq17,r_148_25_151,r_40_58_105,0.9,0,105,105,71
15,r_125_84_79,seq105,seq53,r_125_84_79,1.0,0,79,79,71
48,r_91_128_100,seq107,r_109_74_110,r_91_128_100,0.97,0,100,100,71
13,r_40_58_105,r_148_25_151,seq121,r_148_25_151,1.0,3,154,151,71
99,seq121,r_110_48_73,r_148_25_151,r_110_48_73,1.0,0,73,73,71
10,r_1_0_140,r_106_104_166,r_60_144_123,r_1_0_140,0.88,0,140,140,71
27,r_12_122_156,r_43_87_199,r_82_126_85,r_12_122_156,0.63,0,156,156,71
19,r_63_70_194,r_139_32_70,r_68_23_37,r_139_32_70,0.9,-36,34,70,71
2,r_106_104_166,seq140,r_72_35_102,r_106_104_166,0.68,0,166,166,71
47,r_68_23_37,r_115_51_114,r_63_70_194,r_68_23_37,0.53,-2,35,37,71
40,r_67_117_162,r_124_127_191,seq33,r_124_127_191,0.52,-29,162,191,71
18,r_85_96_152,seq86,r_5_28_181,r_85_96_152,0.62,0,152,152,71
29,r_60_144_123,r_43_87_199,seq99,r_60_144_123,0.89,0,123,123,71
25,r_112_88_175,seq27,seq116,r_112_88_175,0.45,-1,174,175,71
33,r_137_52_64,seq57,seq71,r_137_52_64,1.0,1,65,64,71
39,r_148_25_151,r_40_58_105,seq36,r_148_25_151,0.74,3,154,151,71
58,seq19,r_131_11_131,seq86,r_131_11_131,0.66,3,134,131,71
75,seq61,r_7_4_62,r_67_117_162,r_7_4_62,0.94,-21,41,62,71
68,seq42,r_22_41_141,r_125_84_79,r_125_84_79,0.83,12,91,79,71
1,r_134_59_18,r_93_62_20,seq140,r_93_62_20,0.72,4,24,20,71
34,r_90_146_82,r_6_18_93,seq36,r_90_146_82,1.0,0,82,82,71
35,r_76_64_41,r_124_127_191,seq14,r_76_64_41,1.0,0,41,41,71
17,r_22_41_141,seq73,seq121,r_22_41_141,0.88,0,141,141,71
94,seq111,seq30,r_85_96_152,r_85_96_152,0.95,17,169,152,71
9,r_6_18_93,seq27,r_80_141_11,r_6_18_93,0.98,-3,90,93,71
31,r_65_114_42,r_20_77_142,seq47,r_20_77_142,0.96,0,142,142,71
10,r_1_0_140,seq78,r_106_104_166,r_1_0_140,0.69,-89,51,140,71
28,r_139_32_70,seq147,r_56_26_171,r_139_32_70,1.0,0,70,70,71
24,r_8_138_32,r_81_54_147,seq105,r_8_138_32,1.0,0,32,32,71
49,r_2_120_103,seq16,seq36,r_2_120_103,1.0,0,103,103,71
56,seq16,r_2_120_103,r_5_28_181,r_2_120_103,1.0,-6,97,103,71
23,r_131_11_131,seq19,r_8_138_32,r_8_138_32,1.0,102,134,32,71
30,r_104_139_112,seq109,r_21_135_45,r_104_139_112,0.99,0,112,112,72
0,r_68_57_27,r_88_40_148,r_130_23_36,r_68_57_27,1.0,1,28,27,72
8,r_29_138_31,r_118_72_54,seq143,r_29_138_31,1.0,0,31,31,72
37,r_106_42_161,r_15_26_103,r_32_45_3,r_15_26_103,1.0,0,103,103,72
16,r_36_64_168,seq117,r_65_105_132,r_36_64_168,0.79,0,168,168,72
39,r_82_11_118,r_142_149_193,r_60_35_35,r_142_149_193,0.94,-75,118,193,72
5,r_65_105_132,seq41,r_60_35_35,r_60_35_35,0.62,100,135,35,72
77,seq58,r_107_115_113,seq48,r_107_115_113,0.52,-53,60,113,72
45,r_120_44_144,r_142_149_193,r_131_90_140,r_120_44_144,0.63,0,144,144,72
31,r_130_23_36,r_13_46_69,r_68_57_27,r_68_57_27,0.74,11,38,27,72
26,r_21_135_45,r_8_80_104,seq114,r_21_135_45,0.99,3,48,45,72
41,r_76_116_59,r_101_2_58,r_66_100_37,r_76_116_59,0.74,2,61,59,72
3,r_146_145_106,r_124_9_141,r_96_111_44,r_146_145_106,0.85,2,108,106,72
42,r_118_72_54,seq51,seq56,r_118_72_54,0.97,0,54,54,72
34,r_66_100_37,seq4,seq37,r_66_100_37,1.0,1,38,37,72
20,r_69_24_167,seq28,r_108_77_93,r_108_77_93,0.77,74,167,93,72
13,r_119_61_51,r_88_40_148,r_101_2_58,r_101_2_58,0.86,24,82,58,72
15,r_86_147_23,seq143,seq50,r_86_147_23,0.94,1,24,23,72
14,r_96_111_44,seq53,seq148,r_96_111_44,0.99,4,48,44,72
21,r_88_40_148,r_39_0_5,r_107_115_113,r_88_40_148,0.9,0,148,148,72
10,r_39_0_5,r_88_40_148,r_101_2_58,r_101_2_58,0.52,42,100,58,72
33,r_128_52_30,r_119_61_51,seq28,r_128_52_30,1.0,1,31,30,72
25,r_60_35_35,r_144_20_198,seq51,r_60_35_35,0.96,3,38,35,72
43,r_17_83_53,seq18,r_96_111_44,r_17_83_53,1.0,0,53,53,72
2,r_131_90_140,seq48,r_54_129_191,r_131_90_140,0.43,-27,113,140,72
47,r_103_31_62,seq25,r_92_70_63,r_92_70_63,0.7,-1,62,63,72
40,r_3_6_117,seq102,r_144_20_198,r_3_6_117,0.87,0,117,117,72
18,r_93_112_64,r_142_149_193,r_13_46_69,r_93_112_64,0.98,0,64,64,72
29,r_78_125_123,seq134,seq51,r_78_125_123,0.84,0,123,123,72
24,r_92_70_63,seq55,r_103_31_62,r_92_70_63,1.0,2,65,63,72
73,seq51,r_118_72_54,r_60_35_35,r_60_35_35,0.59,19,54,35,72
9,r_34_110_38,seq12,seq99,r_34_110_38,0.79,3,41,38,72
94,seq114,seq53,r_21_135_45,r_21_135_45,0.97,11,56,45,72
37,r_106_42_161,r_32_45_3,seq109,r_106_42_161,1.0,1,162,161,72
58,seq143,r_30_140_178,r_29_138_31,r_29_138_31,0.61,147,178,31,72
32,r_89_98_124,r_88_40_148,r_21_135_45,r_89_98_124,0.6,-32,92,124,72
77,seq58,r_54_129_191,r_107_115_113,r_107_115_113,0.93,-87,26,113,72
52,seq134,r_78_125_123,r_13_46_69,r_78_125_123,1.0,0,123,123,72
11,r_132_38_19,r_34_110_38,seq1,r_132_38_19,1.0,1,20,19,72
28,r_15_26_103,r_106_42_161,r_96_111_44,r_15_26_103,0.96,0,103,103,72
91,seq102,r_3_6_117,seq4,r_3_6_117,1.0,0,117,117,72
49,r_108_77_93,r_8_80_104,r_47_75_1,r_108_77_93,1.0,2,95,93,72
2,r_131_90_140,r_54_129_191,r_21_135_45,r_131_90_140,0.93,0,140,140,72
7,r_43_79_154,seq28,r_8_80_104,r_43_79_154,0.72,1,155,154,72
44,r_101_2_58,seq136,r_39_0_5,r_101_2_58,0.98,2,60,58,72
35,r_141_14_146,seq1,r_131_90_140,r_141_14_146,0.76,0,146,146,72
72,seq50,r_65_105_132,r_86_147_23,r_86_147_23,0.94,1,24,23,72
93,seq109,seq138,r_113_31_54,r_113_31_54,1.0,36,90,54,73
30,r_62_34_142,seq93,seq5,r_62_34_142,0.92,0,142,142,73
51,seq131,r_44_145_65,seq92,r_44_145_65,1.0,2,67,65,73
8,r_30_17_139,seq27,r_33_121_134,r_30_17_139,0.54,3,142,139,73
48,r_94_9_30,seq38,seq5,r_94_9_30,1.0,0,30,30,73
43,r_1_123_177,seq24,r_95_148_132,r_95_148_132,0.53,45,177,132,73
37,r_55_46_98,seq56,seq89,r_55_46_98,1.0,0,98,98,73
16,r_33_121_134,seq84,r_63_104_2,r_63_104_2,0.45,133,135,2,73
5,r_37_79_119,r_1_123_177,seq74,r_37_79_119,0.94,0,119,119,73
46,r_36_49_109,seq43,seq84,r_36_49_109,0.99,0,109,109,73
80,seq74,r_112_132_9,r_37_79_119,r_37_79_119,0.99,17,136,119,73
45,r_44_145_65,seq131,seq22,r_44_145_65,1.0,0,65,65,73
11,r_66_10_186,r_35_29_73,r_95_148_132,r_95_148_132,0.92,55,187,132,73
19,r_86_14_31,r_30_17_139,seq22,r_86_14_31,0.96,0,31,31,73
77,seq139,r_72_87_56,r_129_78_129,r_129_78_129,0.83,23,152,129,73
31,r_102_107_58,r_77_2_97,r_15_81_20,r_77_2_97,1.0,-36,61,97,73
41,r_18_142_173,seq93,r_94_9_30,r_18_142_173,0.65,0,173,173,73
49,r_98_96_33,r_80_147_87,r_106_110_123,r_98_96_33,0.98,0,33,33,73
10,r_76_108_17,r_80_147_87,seq11,r_76_108_17,1.0,0,17,17,73
26,r_35_29_73,r_77_2_97,r_66_10_186,r_35_29_73,1.0,0,73,73,73
14,r_101_57_10,seq45,r_12_140_48,r_12_140_48,1.0,30,78,48,73
11,r_66_10_186,r_113_31_54,r_62_34_142,r_113_31_54,0.99,1,55,54,73
0,r_75_83_105,seq64,r_80_147_87,r_75_83_105,0.57,0,105,105,73
73,seq56,r_55_46_98,seq88,r_55_46_98,0.96,0,98,98,73
20,r_128_119_13,r_76_108_17,r_39_32_41,r_39_32_41,1.0,23,64,41,73
49,r_98_96_33,r_106_110_123,seq88,r_106_110_123,1.0,0,123,123,73
62,seq24,r_1_123_177,r_118_53_167,r_1_123_177,0.48,-10,167,177,73
73,seq56,seq88,r_95_148_132,r_95_148_132,1.0,7,139,132,73
25,r_19_20_8,seq137,r_72_87_56,r_72_87_56,1.0,4,60,56,73
27,r_95_148_132,r_71_60_198,seq56,r_95_148_132,0.95,3,135,132,73
12,r_72_87_56,seq13,seq43,r_72_87_56,0.97,0,56,56,73
36,r_40_61_39,r_12_140_48,seq88,r_12_140_48,1.0,-3,45,48,73
7,r_50_25_38,seq146,seq27,r_50_25_38,0.79,9,47,38,73
11,r_66_10_186,r_62_34_142,r_35_29_73,r_35_29_73,0.5,0,73,73,73
34,r_103_23_51,r_6_149_196,seq144,r_103_23_51,0.99,0,51,51,73
33,r_90_3_102,seq144,seq92,r_90_3_102,0.99,0,102,102,73
9,r_113_31_54,r_66_10_186,seq109,r_113_31_54,1.0,3,57,54,73
39,r_51_58_96,seq146,r_12_140_48,r_12_140_48,1.0,11,59,48,73
67,seq38,seq135,r_54_67_37,r_54_67_37,1.0,1,38,37,73
32,r_114_85_108,seq27,seq144,r_114_85_108,1.0,0,108,108,73
6,r_124_141_35,r_122_47_197,seq48,r_124_141_35,1.0,1,36,35,73
22,r_12_140_48,seq56,r_51_58_96,r_12_140_48,1.0,0,48,48,73
14,r_101_57_10,r_118_53_167,seq45,r_101_57_10,1.0,2,12,10,73
13,r_80_147_87,seq139,seq93,r_80_147_87,0.99,-1,86,87,73
17,r_15_81_20,r_136_115_168,r_102_107_58,r_102_107_58,0.71,40,98,58,73
2,r_54_67_37,seq109,seq38,r_54_67_37,1.0,0,37,37,73
71,seq48,r_112_132_9,r_124_141_35,r_124_141_35,1.0,1,36,35,73
26,r_35_29_73,r_66_10_186,r_80_147_87,r_35_29_73,0.55,114,187,73,73
0,r_75_83_105,r_80_147_87,r_106_110_123,r_106_110_123,0.99,-1,122,123,73
28,r_77_2_97,r_102_107_58,seq22,r_77_2_97,1.0,0,97,97,73
18,r_106_110_123,r_98_96_33,r_75_83_105,r_106_110_123,1.0,0,123,123,73
44,r_134_0_75,seq22,r_15_81_20,r_134_0_75,1.0,1,76,75,73
18,r_106_110_123,seq88,r_98_96_33,r_98_96_33,0.97,7,40,33,73
38,r_39_32_41,r_113_31_54,r_128_119_13,r_39_32_41,1.0,0,41,41,73
35,r_129_78_129,r_122_47_197,seq139,r_129_78_129,1.0,4,133,129,73
30,r_145_28_150,r_66_60_182,r_17_120_140,r_145_28_150,0.88,0,150,150,74
14,r_82_78_178,seq119,r_10_72_177,r_82_78_178,0.52,0,178,178,74
83,seq86,r_75_13_94,seq35,r_75_13_94,1.0,2,96,94,74
37,r_132_140_183,r_94_70_188,r_50_39_37,r_50_39_37,1.0,147,184,37,74
26,r_121_128_47,seq47,seq33,r_121_128_47,1.0,0,47,47,74
71,seq54,r_59_130_189,r_104_53_88,r_104_53_88,1.0,101,189,88,74
86,seq92,r_67_138_99,r_97_0_55,r_67_138_99,1.0,-14,85,99,74
16,r_103_20_89,seq131,r_15_115_56,r_15_115_56,0.74,35,91,56,74
21,r_51_25_77,seq57,seq126,r_51_25_77,1.0,0,77,77,74
1,r_6_21_155,r_30_56_115,seq62,r_30_56_115,1.0,1,116,115,74
42,r_111_148_74,r_94_70_188,seq1,r_111_148_74,1.0,1,75,74,74
44,r_106_27_17,r_117_40_29,seq76,r_106_27_17,1.0,0,17,17,74
48,r_41_110_24,seq1,r_16_14_8,r_41_110_24,1.0,0,24,24,74
19,r_55_37_68,r_109_74_195,r_3_68_25,r_55_37_68,1.0,1,69,68,74
41,r_38_31_11,r_117_40_29,seq36,r_38_31_11,0.93,0,11,11,74
27,r_16_14_8,r_104_53_88,r_41_110_24,r_104_53_88,0.84,0,88,88,74
17,r_49_69_20,seq64,r_66_60_182,r_49_69_20,1.0,0,20,20,74
3,r_67_138_99,seq92,seq47,r_67_138_99,1.0,0,99,99,74
10,r_144_18_120,seq125,r_129_34_60,r_144_18_120,0.83,6,126,120,74
79,seq76,seq133,r_106_27_17,r_106_27_17,1.0,3,20,17,74
4,r_127_4_102,r_87_23_164,r_67_138_99,r_127_4_102,0.99,0,102,102,74
0,r_94_70_188,r_132_140_183,r_87_23_164,r_94_70_188,0.43,1,189,188,74
11,r_87_23_164,seq147,r_17_120_140,r_87_23_164,0.6,0,164,164,74
20,r_135_12_73,seq57,r_121_128_47,r_121_128_47,0.97,34,81,47,74
13,r_44_81_135,seq8,r_109_74_195,r_44_81_135,0.99,1,136,135,74
15,r_19_85_143,seq147,r_100_88_96,r_19_85_143,0.83,0,143,143,74
45,r_15_115_56,r_17_120_140,r_6_21_155,r_15_115_56,0.97,0,56,56,74
12,r_109_74_195,seq36,r_44_81_135,r_44_81_135,1.0,1,136,135,74
6,r_89_116_133,seq32,seq96,r_89_116_133,0.99,0,133,133,74
99,seq126,r_71_52_193,r_51_25_77,r_51_25_77,1.0,1,78,77,74
52,seq131,seq8,r_144_18_120,r_144_18_120,0.52,35,155,120,74
1,r_6_21_155,seq62,r_89_116_133,r_6_21_155,0.75,2,157,155,74
40,r_59_130_189,seq54,r_11_101_5,r_11_101_5,0.6,184,189,5,74
18,r_129_34_60,r_105_84_162,r_10_72_177,r_129_34_60,1.0,0,60,60,74
29,r_30_56_115,r_6_21_155,seq86,r_6_21_155,0.62,-39,116,155,74
8,r_117_40_29,seq61,seq90,r_117_40_29,1.0,0,29,29,74
34,r_105_84_162,seq57,seq2,r_105_84_162,0.89,0,162,162,74
33,r_17_120_140,seq80,seq62,r_17_120_140,0.99,-1,139,140,74
47,r_104_53_88,r_16_14_8,seq147,r_104_53_88,1.0,0,88,88,74
32,r_75_13_94,seq86,seq125,r_75_13_94,0.93,0,94,94,74
38,r_97_0_55,r_144_18_120,seq92,r_144_18_120,0.92,-48,72,120,74
52,seq131,r_103_20_89,seq8,r_103_20_89,0.84,-1,88,89,74
34,r_105_84_162,r_129_34_60,seq57,r_129_34_60,1.0,0,60,60,74
35,r_3_68_25,r_10_72_177,seq134,r_3_68_25,0.99,1,26,25,74
36,r_50_39_37,seq99,seq8,r_50_39_37,1.0,0,37,37,74
24,r_24_124_54,r_82_78_178,seq99,r_24_124_54,1.0,0,54,54,74
22,r_22_77_161,seq146,r_55_37_68,r_55_37_68,0.99,93,161,68,74
45,r_15_115_56,r_6_21_155,r_103_20_89,r_103_20_89,0.56,3,92,89,74
56,seq8,r_10_72_177,r_50_39_37,r_50_39_37,0.97,84,121,37,74
7,r_10_72_177,seq8,r_82_78_178,r_10_72_177,0.57,-1,176,177,74
18,r_129_34_60,r_10_72_177,r_144_18_120,r_129_34_60,0.9,61,121,60,74
31,r_102_136_12,r_100_88_96,seq42,r_102_136_12,0.84,0,12,12,74
12,r_109_74_195,r_55_37_68,seq36,r_55_37_68,1.0,1,69,68,74
36,r_17_83_111,r_41_93_26,seq30,r_17_83_111,1.0,0,111,111,75
23,r_128_92_82,r_62_108_118,r_43_67_87,r_62_108_118,0.98,0,118,118,75
14,r_89_141_137,seq21,r_75_15_144,r_75_15_144,0.55,7,151,144,75
43,r_86_96_113,r_46_52_103,r_17_83_111,r_46_52_103,1.0,1,104,103,75
43,r_86_96_113,r_17_83_111,r_136_54_141,r_136_54_141,0.97,2,143,141,75
16,r_133_88_64,seq70,r_99_37_39,r_133_88_64,1.0,1,65,64,75
1,r_48_102_79,seq44,seq3,r_48_102_79,0.98,0,79,79,75
5,r_61_123_146,r_129_49_172,seq87,r_61_123_146,0.41,-49,97,146,75
46,r_129_49_172,r_82_114_167,r_118_130_136,r_82_114_167,0.9,-86,81,167,75
28,r_62_108_118,seq78,r_128_92_82,r_128_92_82,0.99,0,82,82,75
19,r_75_15_144,seq45,r_39_104_58,r_75_15_144,0.86,0,144,144,75
48,r_99_37_39,seq78,seq2,r_99_37_39,1.0,0,39,39,75
20,r_38_103_22,r_132_122_149,r_41_93_26,r_38_103_22,0.97,-1,21,22,75
67,seq35,r_140_63_188,r_53_68_129,r_140_63_188,0.27,0,188,188,75
96,seq117,r_43_67_87,r_55_24_171,r_55_24_171,0.91,2,173,171,75
3,r_43_67_87,r_39_104_58,seq79,r_43_67_87,1.0,0,87,87,75
26,r_85_84_61,r_75_15_144,seq76,r_85_84_61,0.74,0,61,61,75
72,seq59,r_26_139_175,r_146_135_152,r_146_135_152,0.86,23,175,152,75
4,r_26_139_175,seq59,r_38_103_22,r_38_103_22,0.95,153,175,22,75
0,r_55_24_171,r_137_36_72,seq35,r_137_36_72,0.98,3,75,72,75
73,seq60,r_132_122_149,r_125_116_95,r_125_116_95,0.98,55,150,95,75
13,r_91_22_108,seq16,r_38_103_22,r_91_22_108,0.59,3,111,108,75
15,r_82_114_167,r_129_49_172,r_53_68_129,r_82_114_167,0.51,-56,111,167,75
28,r_62_108_118,r_128_92_82,r_10_143_36,r_62_108_118,0.99,0,118,118,75
34,r_131_101_56,r_55_24_171,seq78,r_131_101_56,1.0,0,56,56,75
7,r_29_27_44,seq47,seq64,r_29_27_44,1.0,0,44,44,75
12,r_9_74_18,seq149,seq70,r_9_74_18,1.0,0,18,18,75
0,r_55_24_171,seq35,seq117,r_55_24_171,0.72,0,171,171,75
45,r_12_90_50,r_41_93_26,seq20,r_12_90_50,1.0,0,50,50,75
39,r_23_66_53,seq5,seq33,r_23_66_53,1.0,0,53,53,75
42,r_10_143_36,r_29_27_44,seq44,r_29_27_44,0.63,-8,36,44,75
30,r_13_50_51,r_40_28_93,r_86_96_113,r_40_28_93,0.98,-36,57,93,75
2,r_53_68_129,seq109,r_82_114_167,r_82_114_167,0.52,-29,138,167,75
47,r_105_106_123,r_39_104_58,r_125_116_95,r_39_104_58,1.0,65,123,58,75
18,r_113_25_125,seq35,r_85_84_61,r_85_84_61,0.56,66,127,61,75
29,r_147_120_132,seq79,seq69,r_147_120_132,0.97,0,132,132,75
24,r_40_28_93,seq3,seq47,r_40_28_93,1.0,0,93,93,75
2,r_53_68_129,r_82_114_167,r_61_123_146,r_82_114_167,1.0,5,172,167,75
25,r_42_8_180,seq110,r_125_116_95,r_125_116_95,1.0,86,181,95,75
33,r_140_63_188,seq35,r_43_67_87,r_43_67_87,0.72,101,188,87,75
70,seq47,seq2,r_40_28_93,r_40_28_93,1.0,10,103,93,75
6,r_80_7_10,r_144_126_195,r_11_58_104,r_11_58_104,1.0,5,109,104,75
61,seq21,r_89_141_137,r_118_130_136,r_89_141_137,0.73,10,147,137,75
32,r_137_36_72,r_55_24_171,seq109,r_137_36_72,0.95,3,75,72,75
38,r_11_58_104,r_46_52_103,r_80_7_10,r_11_58_104,0.97,0,104,104,75
15,r_82_114_167,r_53_68_129,seq60,r_82_114_167,0.99,0,167,167,75
30,r_13_50_51,r_86_96_113,r_91_22_108,r_86_96_113,0.99,0,113,113,75
17,r_14_121_182,seq97,r_43_67_87,r_43_67_87,0.99,95,182,87,75
82,seq78,r_99_37_39,r_132_122_149,r_99_37_39,0.99,0,39,39,75
96,seq117,r_62_108_118,r_43_67_87,r_43_67_87,0.66,25,112,87,75
91,seq109,r_53_68_129,r_137_36_72,r_137_36_72,1.0,66,138,72,75
23,r_128_92_82,r_105_106_123,r_62_108_118,r_128_92_82,0.81,1,83,82,75
35,r_46_52_103,r_86_96_113,r_125_116_95,r_46_52_103,1.0,1,104,103,75
93,seq110,seq22,r_5_129_69,r_5_129_69,1.0,4,73,69,76
44,r_147_96_121,r_122_51_37,r_78_28_73,r_147_96_121,0.99,-2,119,121,76
16,r_53_127_110,r_44_82_104,r_42_126_148,r_42_126_148,1.0,17,165,148,76
36,r_52_148_123,seq62,r_108_10_12,r_52_148_123,0.64,2,125,123,76
29,r_94_79_27,r_52_148_123,r_84_36_177,r_94_79_27,1.0,0,27,27,76
14,r_41_31_187,seq63,seq90,r_41_31_187,0.31,2,189,187,76
8,r_130_4_117,seq145,seq48,r_130_4_117,0.94,1,118,117,76
6,r_112_14_16,r_137_6_122,r_53_127_110,r_112_14_16,0.94,2,18,16,76
30,r_99_13_38,seq43,seq111,r_99_13_38,0.85,0,38,38,76
28,r_44_82_104,r_132_37_23,seq2,r_44_82_104,1.0,0,104,104,76
71,seq48,r_71_19_189,r_132_37_23,r_132_37_23,1.0,166,189,23,76
16,r_53_127_110,r_77_88_115,r_44_82_104,r_53_127_110,0.56,0,110,110,76
39,r_83_87_94,seq47,seq15,r_83_87_94,0.95,4,98,94,76
1,r_78_28_73,r_52_148_123,seq111,r_78_28_73,1.0,0,73,73,76
46,r_40_12_149,seq47,seq92,r_40_12_149,0.8,0,149,149,76
42,r_49_50_76,r_52_148_123,seq128,r_49_50_76,1.0,0,76,76,76
45,r_33_35_133,r_142_86_151,seq2,r_33_35_133,0.9,2,135,133,76
35,r_25_119_14,r_118_20_68,r_95_125_53,r_95_125_53,1.0,3,56,53,76
19,r_89_146_75,seq107,seq62,r_89_146_75,1.0,0,75,75,76
28,r_44_82_104,r_71_19_189,r_132_37_23,r_132_37_23,0.84,35,58,23,76
41,r_80_139_59,r_5_129_69,r_77_88_115,r_5_129_69,0.98,-8,61,69,76
89,seq104,r_81_91_140,seq103,r_81_91_140,0.83,-28,112,140,76
3,r_67_143_105,seq16,seq145,r_67_143_105,0.87,0,105,105,76
90,seq105,r_39_38_116,seq1,r_39_38_116,1.0,0,116,116,76
35,r_25_119_14,r_42_126_148,r_118_20_68,r_25_119_14,0.81,0,14,14,76
26,r_77_88_115,r_53_127_110,r_80_139_59,r_77_88_115,0.51,-54,61,115,76
13,r_142_86_151,seq109,r_78_28_73,r_78_28_73,0.8,79,152,73,76
26,r_77_88_115,r_80_139_59,seq70,r_77_88_115,1.0,0,115,115,76
15,r_5_129_69,r_81_91_140,seq110,r_5_129_69,0.97,0,69,69,76
48,r_71_19_189,seq48,r_39_38_116,r_39_38_116,0.93,73,189,116,76
4,r_122_51_37,r_42_126_148,r_123_101_128,r_122_51_37,0.95,96,133,37,76
9,r_95_125_53,r_81_91_140,r_25_119_14,r_95_125_53,0.96,2,55,53,76
57,seq128,r_142_86_151,r_49_50_76,r_49_50_76,0.99,71,147,76,76
85,seq92,seq145,r_40_12_149,r_40_12_149,0.5,13,162,149,76
2,r_132_37_23,r_44_82_104,seq48,r_44_82_104,1.0,0,104,104,76
2,r_132_37_23,r_78_28_73,r_44_82_104,r_132_37_23,0.97,0,23,23,76
27,r_39_38_116,seq105,seq65,r_39_38_116,0.93,2,118,116,76
41,r_80_139_59,r_77_88_115,r_137_6_122,r_80_139_59,0.99,63,122,59,76
47,r_30_24_102,r_52_148_123,seq21,r_30_24_102,1.0,0,102,102,76
40,r_114_17_103,seq2,r_108_10_12,r_114_17_103,0.96,1,104,103,76
18,r_9_136_109,r_144_56_150,r_30_24_102,r_9_136_109,0.97,0,109,109,76
17,r_84_36_177,r_32_149_132,r_94_79_27,r_94_79_27,0.58,16,43,27,76
20,r_60_69_49,seq58,seq62,r_60_69_49,0.69,6,55,49,76
33,r_138_29_131,seq103,seq121,r_138_29_131,0.67,0,131,131,76
44,r_147_96_121,r_76_57_47,r_122_51_37,r_147_96_121,0.75,-76,45,121,76
70,seq47,r_83_87_94,r_7_27_5,r_83_87_94,1.0,4,98,94,76
6,r_112_14_16,r_53_127_110,r_80_139_59,r_53_127_110,0.95,0,110,110,76
65,seq22,seq34,r_118_20_68,r_118_20_68,0.72,15,83,68,76
32,r_117_64_169,r_108_10_12,r_81_91_140,r_117_64_169,0.75,2,171,169,76
32,r_117_64_169,r_144_56_150,r_108_10_12,r_117_64_169,0.65,-17,152,169,76
38,r_23_140_71,seq15,r_78_28_73,r_78_28_73,0.72,4,77,73,76
34,r_137_6_122,r_40_12_149,r_80_139_59,r_137_6_122,0.68,0,122,122,76
75,seq63,r_41_31_187,r_132_37_23,r_132_37_23,0.84,138,161,23,76
21,r_26_66_46,r_142_86_151,seq111,r_26_66_46,0.99,0,46,46,76
31,r_108_10_12,r_117_64_169,r_114_17_103,r_114_17_103,0.81,68,171,103,76
29,r_94_79_27,r_84_36_177,r_106_134_92,r_106_134_92,1.0,20,112,92,76
91,seq107,r_89_146_75,seq16,r_89_146_75,1.0,0,75,75,76
49,r_106_134_92,seq3,r_94_79_27,r_106_134_92,0.93,0,92,92,76
0,r_76_57_47,seq72,seq62,r_76_57_47,0.78,1,48,47,76
7,r_32_149_132,seq141,seq58,r_32_149_132,0.91,0,132,132,76
31,r_108_10_12,r_112_14_16,r_117_64_169,r_108_10_12,0.81,0,12,12,76
12,r_144_56_150,r_117_64_169,r_42_126_148,r_117_64_169,0.66,-13,156,169,76
37,r_61_102_18,r_95_125_53,seq45,r_61_102_18,0.68,0,18,18,76
4,r_122_51_37,r_67_143_105,r_42_126_148,r_122_51_37,1.0,0,37,37,76
30,r_27_96_10,seq42,r_101_0_142,r_101_0_142,1.0,1,143,142,77
36,r_125_75_194,r_143_82_149,r_119_1_95,r_119_1_95,0.98,54,149,95,77
53,seq7,r_131_104_170,r_71_85_139,r_71_85_139,1.0,31,170,139,77
43,r_20_147_90,seq53,r_19_49_49,r_20_147_90,0.78,1,91,90,77
25,r_116_99_18,r_130_79_144,seq69,r_116_99_18,0.8,6,24,18,77
16,r_55_122_198,r_101_0_142,r_39_97_30,r_55_122_198,0.92,-59,139,198,77
21,r_123_34_60,r_20_147_90,r_111_108_47,r_123_34_60,0.99,0,60,60,77
1,r_145_43_73,r_130_79_144,r_93_68_193,r_145_43_73,1.0,1,74,73,77
5,r_17_137_76,seq62,seq144,r_17_137_76,1.0,1,77,76,77
46,r_90_95_189,seq77,r_46_91_78,r_46_91_78,1.0,111,189,78,77
39,r_134_33_43,r_71_85_139,seq84,r_134_33_43,1.0,0,43,43,77
11,r_89_31_190,r_19_49_49,r_142_26_64,r_89_31_190,0.47,0,190,190,77
76,seq53,r_20_147_90,r_55_122_198,r_20_147_90,1.0,1,91,90,77
31,r_103_24_187,seq18,r_20_147_90,r_103_24_187,0.35,0,187,187,77
41,r_119_1_95,r_46_91_78,r_92_61_24,r_46_91_78,0.79,0,78,78,77
15,r_50_118_20,seq124,seq112,r_50_118_20,1.0,0,20,20,77
3,r_46_91_78,r_119_1_95,r_127_6_9,r_46_91_78,1.0,0,78,78,77
10,r_86_64_163,seq69,seq42,r_86_64_163,0.71,0,163,163,77
26,r_130_79_144,seq133,r_57_113_172,r_130_79_144,0.53,0,144,144,77
17,r_92_61_24,seq78,seq94,r_92_61_24,0.87,0,24,24,77
0,r_41_129_113,seq135,seq29,r_41_129_113,1.0,0,113,113,77
13,r_87_102_182,r_55_122_198,r_73_40_146,r_87_102_182,0.85,0,182,182,77
48,r_131_104_170,r_76_48_168,seq15,r_131_104_170,0.72,0,170,170,77
6,r_142_26_64,r_17_137_76,seq38,r_142_26_64,0.91,4,68,64,77
11,r_89_31_190,r_111_108_47,r_19_49_49,r_89_31_190,1.0,-141,49,190,77
41,r_119_1_95,r_92_61_24,r_125_75_194,r_119_1_95,0.69,1,96,95,77
8,r_19_49_49,r_89_31_190,r_20_147_90,r_20_147_90,0.99,1,91,90,77
27,r_93_68_193,r_148_106_155,r_145_43_73,r_145_43_73,0.57,37,110,73,77
34,r_111_108_47,r_89_31_190,seq54,r_111_108_47,1.0,0,47,47,77
8,r_19_49_49,seq60,r_89_31_190,r_19_49_49,0.97,0,49,49,77
37,r_4_32_46,seq69,seq80,r_4_32_46,0.91,3,49,46,77
2,r_101_0_142,r_87_102_182,r_27_96_10,r_101_0_142,0.96,0,142,142,77
40,r_88_23_93,r_86_64_163,seq133,r_88_23_93,0.95,0,93,93,77
18,r_5_21_104,r_66_128_132,seq44,r_66_128_132,0.68,-25,107,132,77
29,r_146_35_131,r_109_120_171,seq7,r_146_35_131,0.62,0,131,131,77
26,r_130_79_144,r_57_113_172,r_76_48_168,r_130_79_144,0.71,28,172,144,77
24,r_71_85_139,seq74,seq44,r_71_85_139,0.51,0,139,139,77
33,r_107_100_98,r_66_128_132,seq94,r_107_100_98,0.66,7,105,98,77
61,seq18,r_103_24_187,seq56,r_103_24_187,0.96,-31,156,187,77
38,r_72_138_66,r_66_128_132,r_123_34_60,r_72_138_66,0.72,1,67,66,77
77,seq54,r_16_14_160,r_123_34_60,r_123_34_60,1.0,99,159,60,77
20,r_36_110_26,r_86_64_163,seq44,r_36_110_26,0.87,1,27,26,77
90,seq80,seq52,r_4_32_46,r_4_32_46,0.9,3,49,46,77
9,r_76_48_168,r_131_104_170,r_130_79_144,r_131_104_170,0.97,-1,169,170,77
28,r_11_81_23,seq135,seq62,r_11_81_23,0.94,0,23,23,77
23,r_39_97_30,seq52,r_55_122_198,r_39_97_30,0.97,0,30,30,77
4,r_57_113_172,r_130_79_144,r_92_61_24,r_57_113_172,0.98,0,172,172,77
22,r_2_67_110,seq3,seq77,r_2_67_110,0.95,0,110,110,77
49,r_114_149_129,seq84,seq25,r_114_149_129,1.0,0,129,129,77
4,r_57_113_172,r_87_102_182,r_130_79_144,r_57_113_172,0.83,-28,144,172,77
44,r_148_106_155,seq132,r_123_34_60,r_123_34_60,1.0,95,155,60,77
35,r_58_65_177,seq47,r_117_139_55,r_58_65_177,0.66,0,177,177,77
93,seq101,r_124_55_103,r_19_61_51,r_124_55_103,0.69,-25,78,103,78
27,r_120_145_20,seq72,seq15,r_120_145_20,1.0,0,20,20,78
19,r_119_131_15,r_80_74_36,seq137,r_119_131_15,0.9,0,15,15,78
14,r_124_55_103,r_110_142_125,seq6,r_124_55_103,1.0,0,103,103,78
8,r_16_146_137,seq85,seq21,r_16_146_137,0.75,0,137,137,78
53,seq133,r_111_20_122,r_43_7_1,r_111_20_122,1.0,-44,78,122,78
43,r_77_29_119,seq40,r_8_54_41,r_77_29_119,0.95,0,119,119,78
20,r_52_23_39,seq112,seq86,r_52_23_39,1.0,0,39,39,78
23,r_68_107_31,seq34,r_135_114_22,r_68_107_31,1.0,0,31,31,78
37,r_132_125_67,seq103,seq25,r_132_125_67,1.0,3,70,67,78
16,r_57_98_160,seq148,r_123_64_58,r_123_64_58,1.0,104,162,58,78
39,r_116_147_183,r_75_49_70,r_8_54_41,r_116_147_183,0.99,-113,70,183,78
1,r_45_59_69,r_110_142_125,seq138,r_45_59_69,1.0,1,70,69,78
5,r_4_104_143,seq103,seq148,r_4_104_143,0.7,1,144,143,78
42,r_18_113_97,seq130,seq89,r_18_113_97,1.0,1,98,97,78
45,r_117_78_96,r_4_104_143,seq133,r_117_78_96,0.93,1,97,96,78
66,seq25,r_43_7_1,r_132_125_67,r_132_125_67,1.0,12,79,67,78
39,r_116_147_183,r_8_54_41,seq109,r_116_147_183,0.75,0,183,183,78
31,r_110_142_125,r_45_59_69,seq121,r_45_59_69,1.0,1,70,69,78
21,r_95_84_19,seq89,seq133,r_95_84_19,0.65,1,20,19,78
89,seq94,seq34,r_99_30_60,r_99_30_60,1.0,3,63,60,78
3,r_122_88_80,seq21,r_76_128_46,r_76_128_46,1.0,37,83,46,78
10,r_73_69_102,r_11_81_161,seq129,r_73_69_102,1.0,0,102,102,78
30,r_48_38_18,r_135_114_22,r_127_105_53,r_48_38_18,1.0,1,19,18,78
26,r_32_22_174,seq137,r_57_98_160,r_32_22_174,0.51,4,178,174,78
72,seq40,r_77_29_119,r_123_64_58,r_123_64_58,0.69,20,78,58,78
7,r_19_61_51,seq9,seq101,r_19_61_51,0.93,6,57,51,78
4,r_36_56_194,r_63_28_173,r_68_107_31,r_68_107_31,0.78,143,174,31,78
0,r_87_134_86,r_5_93_138,seq12,r_87_134_86,0.93,0,86,86,78
63,seq148,r_57_98_160,r_4_104_143,r_4_104_143,0.85,17,160,143,78
13,r_17_50_77,seq6,r_115_27_66,r_17_50_77,0.99,1,78,77,78
15,r_75_49_70,r_116_147_183,seq83,r_75_49_70,1.0,0,70,70,78
48,r_115_27_66,seq41,seq130,r_115_27_66,1.0,2,68,66,78
49,r_8_54_41,r_116_147_183,r_77_29_119,r_77_29_119,1.0,14,133,119,78
57,seq139,r_5_93_138,seq102,r_5_93_138,1.0,1,139,138,78
6,r_63_28_173,r_36_56_194,r_122_88_80,r_63_28_173,0.65,1,174,173,78
31,r_110_142_125,seq121,r_80_74_36,r_110_142_125,0.99,0,125,125,78
2,r_136_126_107,r_2_58_181,r_87_134_86,r_136_126_107,0.96,-7,100,107,78
40,r_99_30_60,seq90,seq94,r_99_30_60,0.99,0,60,60,78
29,r_149_71_110,r_2_58_181,r_132_125_67,r_149_71_110,1.0,0,110,110,78
18,r_127_105_53,seq83,r_48_38_18,r_48_38_18,0.7,36,54,18,78
44,r_91_26_188,r_136_126_107,r_95_84_19,r_91_26_188,0.97,0,188,188,78
25,r_11_81_161,r_73_69_102,r_43_7_1,r_73_69_102,1.0,0,102,102,78
33,r_82_66_91,seq65,seq21,r_82_66_91,0.91,1,92,91,78
9,r_80_74_36,r_75_49_70,seq9,r_75_49_70,0.92,-26,44,70,78
38,r_111_20_122,seq133,r_122_88_80,r_111_20_122,1.0,1,123,122,78
75,seq137,r_32_22_174,r_124_55_103,r_124_55_103,1.0,75,178,103,78
17,r_5_93_138,seq139,r_124_55_103,r_5_93_138,0.64,1,139,138,78
25,r_11_81_161,r_43_7_1,r_0_42_7,r_11_81_161,0.99,1,162,161,78
96,seq109,r_79_106_133,seq46,r_79_106_133,1.0,-15,118,133,78
49,r_8_54_41,seq118,r_116_147_183,r_8_54_41,1.0,0,41,41,78
22,r_92_39_87,seq24,seq102,r_92_39_87,0.92,0,87,87,78
12,r_123_64_58,seq72,seq40,r_123_64_58,1.0,0,58,58,78
34,r_135_114_22,r_77_29_119,r_1_108_8,r_135_114_22,0.75,1,23,22,78
44,r_91_26_188,seq12,r_136_126_107,r_136_126_107,0.94,35,142,107,78
85,seq86,r_136_126_107,r_52_23_39,r_52_23_39,1.0,3,42,39,78
82,seq140,r_47_51_163,seq60,r_47_51_163,0.64,3,166,163,78
11,r_76_128_46,r_53_141_47,seq14,r_76_128_46,0.52,0,46,46,78
79,seq65,r_82_66_91,seq12,r_82_66_91,0.78,6,97,91,78
84,seq85,r_16_146_137,r_0_42_7,r_16_146_137,0.59,0,137,137,78
12,r_93_143_57,seq57,seq134,r_93_143_57,0.86,0,57,57,79
36,r_42_47_64,r_86_8_130,seq119,r_42_47_64,0.9,0,64,64,79
14,r_130_38_98,seq67,seq60,r_130_38_98,1.0,1,99,98,79
8,r_54_22_125,seq24,r_68_17_11,r_54_22_125,0.91,0,125,125,79
43,r_111_109_77,seq21,seq105,r_111_109_77,1.0,0,77,77,79
37,r_55_50_141,r_15_75_3,seq61,r_55_50_141,1.0,0,141,141,79
59,seq19,seq60,r_91_136_103,r_91_136_103,0.91,-4,99,103,79
97,seq119,r_149_26_184,r_42_47_64,r_42_47_64,0.93,120,184,64,79
5,r_77_104_83,r_7_40_192,r_43_62_74,r_77_104_83,1.0,0,83,83,79
69,seq51,r_86_8_130,r_14_128_132,r_86_8_130,0.98,0,130,130,79
45,r_20_10_146,seq48,r_35_59_33,r_35_59_33,0.99,33,66,33,79
24,r_131_32_25,r_115_78_127,r_45_120_120,r_131_32_25,0.7,76,101,25,79
19,r_110_89_111,r_117_106_119,seq113,r_110_89_111,0.6,0,111,111,79
29,r_43_62_74,r_125_96_148,r_77_104_83,r_43_62_74,0.89,15,89,74,79
41,r_146_18_138,seq100,r_95_132_42,r_146_18_138,1.0,0,138,138,79
21,r_53_23_19,seq70,seq81,r_53_23_19,1.0,1,20,19,79
10,r_118_6_94,seq90,seq36,r_118_6_94,0.55,7,101,94,79
34,r_80_107_48,r_16_138_145,seq11,r_80_107_48,0.65,0,48,48,79
26,r_84_27_147,seq87,r_115_78_127,r_84_27_147,0.75,1,148,147,79
46,r_69_44_26,r_95_132_42,seq36,r_69_44_26,0.63,0,26,26,79
0,r_108_31_88,r_73_148_168,seq76,r_108_31_88,1.0,0,88,88,79
11,r_139_83_85,seq56,r_95_132_42,r_139_83_85,0.99,5,90,85,79
20,r_73_148_168,seq61,r_66_129_159,r_73_148_168,0.51,0,168,168,79
13,r_140_33_70,r_130_38_98,r_20_10_146,r_140_33_70,0.65,17,87,70,79
98,seq121,seq36,r_28_127_69,r_28_127_69,0.8,2,71,69,79
46,r_69_44_26,seq36,r_49_71_91,r_49_71_91,0.7,2,93,91,79
48,r_86_8_130,seq51,seq121,r_86_8_130,0.81,2,132,130,79
6,r_133_88_65,seq61,seq51,r_133_88_65,1.0,1,66,65,79
2,r_125_96_148,r_43_62_74,seq24,r_125_96_148,0.93,0,148,148,79
30,r_72_30_40,r_54_22_125,seq100,r_72_30_40,0.99,0,40,40,79
27,r_91_136_103,seq41,seq19,r_91_136_103,0.83,1,104,103,79
42,r_95_132_42,r_69_44_26,r_117_106_119,r_95_132_42,1.0,0,42,42,79
2,r_125_96_148,r_37_64_79,r_43_62_74,r_125_96_148,1.0,-69,79,148,79
40,r_149_26_184,seq119,r_108_31_88,r_108_31_88,0.56,96,184,88,79
74,seq60,seq19,r_130_38_98,r_130_38_98,1.0,1,99,98,79
18,r_37_64_79,r_125_96_148,seq135,r_37_64_79,1.0,0,79,79,79
29,r_43_62_74,seq19,r_125_96_148,r_43_62_74,0.55,0,74,74,79
25,r_115_78_127,seq90,r_49_71_91,r_49_71_91,0.63,44,135,91,79
33,r_2_145_134,r_73_148_168,seq79,r_2_145_134,0.96,0,134,134,79
58,seq144,r_16_138_145,r_3_102_75,r_3_102_75,1.0,71,146,75,79
31,r_35_59_33,r_115_78_127,r_20_10_146,r_35_59_33,1.0,1,34,33,79
68,seq48,r_124_12_182,r_35_59_33,r_35_59_33,0.99,147,180,33,79
42,r_95_132_42,r_117_106_119,r_139_83_85,r_117_106_119,0.93,1,120,119,79
38,r_124_12_182,seq48,r_77_104_83,r_77_104_83,1.0,100,183,83,79
24,r_131_32_25,r_110_89_111,r_115_78_127,r_131_32_25,1.0,0,25,25,79
60,seq21,r_111_109_77,seq81,r_111_109_77,1.0,-15,62,77,79
45,r_20_10_146,r_35_59_33,seq61,r_20_10_146,0.96,0,146,146,79
81,seq76,r_45_120_120,r_108_31_88,r_108_31_88,1.0,47,135,88,79
17,r_15_75_3,r_55_50_141,r_147_0_35,r_15_75_3,0.86,138,141,3,79
94,seq113,r_3_102_75,r_124_12_182,r_3_102_75,0.62,0,75,75,79
9,r_45_120_120,seq76,r_131_32_25,r_131_32_25,1.0,110,135,25,79
47,r_92_97_21,r_125_96_148,seq74,r_92_97_21,0.67,0,21,21,79
94,seq113,r_124_12_182,r_110_89_111,r_124_12_182,0.4,-59,123,182,79
31,r_35_59_33,r_20_10_146,seq48,r_20_10_146,1.0,0,146,146,79
7,r_147_0_35,seq4,seq56,r_147_0_35,1.0,0,35,35,79
22,r_25_123_84,seq39,seq100,r_25_123_84,0.98,0,84,84,79
44,r_49_71_91,seq121,r_69_44_26,r_69_44_26,0.54,63,89,26,79
23,r_3_102_75,seq113,seq41,r_3_102_75,1.0,0,75,75,79
35,r_28_127_69,seq79,seq121,r_28_127_69,0.8,2,71,69,79
40,r_113_115_42,r_138_87_162,r_103_4_78,r_103_4_78,0.58,84,162,78,80
8,r_78_123_129,r_80_84_81,r_134_117_30,r_78_123_129,1.0,-47,82,129,80
32,r_149_20_15,r_31_125_128,seq61,r_149_20_15,0.79,-1,14,15,80
43,r_92_65_126,seq45,r_141_100_77,r_92_65_126,0.99,0,126,126,80
33,r_23_47_31,r_77_85_88,r_121_36_49,r_77_85_88,1.0,0,88,88,80
37,r_95_51_177,r_8_24_92,r_129_124_60,r_129_124_60,1.0,4,64,60,80
3,r_19_57_174,r_63_79_45,r_39_118_121,r_19_57_174,0.76,0,174,174,80
16,r_39_118_121,seq143,r_106_97_51,r_106_97_51,0.87,76,127,51,80
26,r_29_0_16,r_1_26_64,seq70,r_29_0_16,1.0,0,16,16,80
21,r_49_12_82,r_7_93_164,r_147_6_79,r_49_12_82,1.0,0,82,82,80
46,r_1_26_64,r_13_101_114,seq69,r_1_26_64,1.0,0,64,64,80
42,r_129_124_60,r_146_75_185,seq110,r_129_124_60,1.0,0,60,60,80
41,r_63_79_45,r_103_4_78,seq112,r_63_79_45,0.83,-1,44,45,80
39,r_77_85_88,r_23_47_31,r_146_75_185,r_77_85_88,1.0,0,88,88,80
48,r_59_126_23,r_140_73_194,seq105,r_59_126_23,1.0,1,24,23,80
19,r_31_125_128,seq133,r_121_36_49,r_31_125_128,1.0,0,128,128,80
1,r_42_130_34,seq54,seq133,r_42_130_34,1.0,0,34,34,80
8,r_78_123_129,r_134_117_30,r_52_74_75,r_78_123_129,0.97,2,131,129,80
76,seq61,seq54,r_35_40_67,r_35_40_67,1.0,4,71,67,80
31,r_80_84_81,r_78_123_129,r_42_130_34,r_80_84_81,1.0,1,82,81,80
3,r_19_57_174,r_55_11_108,r_63_79_45,r_19_57_174,0.9,-82,92,174,80
10,r_146_75_185,r_129_124_60,r_77_85_88,r_146_75_185,1.0,-125,60,185,80
90,seq104,r_53_108_87,r_59_126_23,r_53_108_87,0.92,-9,78,87,80
49,r_138_87_162,r_147_6_79,r_113_115_42,r_113_115_42,1.0,7,49,42,80
0,r_134_117_30,r_42_130_34,r_78_123_129,r_134_117_30,1.0,0,30,30,80
73,seq54,seq61,r_103_4_78,r_103_4_78,1.0,2,80,78,80
11,r_55_11_108,r_19_57_174,r_59_126_23,r_55_11_108,0.71,0,108,108,80
20,r_67_71_65,seq89,r_29_0_16,r_67_71_65,1.0,0,65,65,80
13,r_22_5_116,seq142,seq48,r_22_5_116,1.0,0,116,116,80
15,r_141_100_77,seq137,seq135,r_141_100_77,1.0,0,77,77,80
49,r_138_87_162,r_113_115_42,r_22_5_116,r_138_87_162,0.94,0,162,162,80
85,seq144,seq21,r_27_58_56,r_27_58_56,0.79,14,70,56,80
0,r_134_117_30,r_78_123_129,r_63_79_45,r_78_123_129,0.53,5,134,129,80
10,r_146_75_185,r_77_85_88,r_53_108_87,r_53_108_87,0.8,98,185,87,80
27,r_32_114_120,seq111,r_60_88_110,r_32_114_120,0.94,1,121,120,80
36,r_33_72_13,seq48,r_82_86_52,r_82_86_52,1.0,7,59,52,80
24,r_82_86_52,r_140_73_194,r_33_72_13,r_82_86_52,1.0,0,52,52,80
2,r_147_6_79,r_53_108_87,r_49_12_82,r_147_6_79,1.0,6,85,79,80
47,r_96_116_199,r_141_100_77,r_82_86_52,r_96_116_199,1.0,-135,64,199,80
39,r_77_85_88,r_146_75_185,r_140_73_194,r_77_85_88,0.67,97,185,88,80
4,r_62_10_25,r_39_118_121,seq133,r_62_10_25,1.0,-1,24,25,80
18,r_53_108_87,seq104,seq89,r_53_108_87,1.0,0,87,87,80
9,r_68_91_57,seq90,seq98,r_68_91_57,0.99,0,57,57,80
16,r_39_118_121,r_106_97_51,r_19_57_174,r_19_57_174,0.82,-7,167,174,80
70,seq44,r_60_88_110,r_8_24_92,r_60_88_110,0.95,2,112,110,80
39,r_77_85_88,r_27_58_56,r_23_47_31,r_77_85_88,0.72,-58,30,88,80
22,r_41_81_38,seq136,seq142,r_41_81_38,1.0,0,38,38,80
38,r_8_24_92,seq99,seq44,r_8_24_92,0.81,-6,86,92,80
95,seq112,seq30,r_63_79_45,r_63_79_45,1.0,5,50,45,80
29,r_106_97_51,seq109,seq9,r_106_97_51,0.98,1,52,51,80
34,r_60_88_110,seq44,r_53_108_87,r_60_88_110,0.98,2,112,110,80
92,seq109,r_106_97_51,seq37,r_106_97_51,0.99,-7,44,51,80
40,r_113_115_42,r_39_118_121,r_138_87_162,r_113_115_42,0.97,0,42,42,80
37,r_95_51_177,r_129_124_60,r_32_114_120,r_95_51_177,0.58,0,177,177,80
28,r_35_40_67,r_13_101_114,seq61,r_35_40_67,1.0,0,67,67,80
56,seq136,r_34_28_187,r_146_75_185,r_146_75_185,0.55,2,187,185,80
7,r_52_74_75,seq54,seq109,r_52_74_75,1.0,0,75,75,80
44,r_50_46_160,seq43,seq98,r_50_46_160,0.57,0,160,160,80
23,r_34_28_187,seq136,r_42_130_34,r_42_130_34,0.74,153,187,34,80
82,seq89,seq102,r_53_108_87,r_53_108_87,1.0,32,119,87,80
35,r_148_76_118,seq69,seq64,r_148_76_118,0.87,0,118,118,80
12,r_103_4_78,seq64,seq54,r_103_4_78,1.0,0,78,78,80
14,r_13_101_114,r_49_12_82,seq25,r_49_12_82,1.0,-30,52,82,80
6,r_27_58_56,r_68_91_57,seq144,r_27_58_56,0.75,-8,48,56,80
30,r_103_52_114,seq72,r_49_90_69,r_103_52_114,1.0,0,114,114,81
36,r_42_118_184,seq128,r_147_24_10,r_147_24_10,0.48,175,185,10,81
4,r_148_108_186,r_44_97_158,seq55,r_44_97_158,0.68,29,187,158,81
92,seq106,r_69_7_178,r_100_74_153,r_100_74_153,0.98,26,179,153,81
14,r_142_64_150,r_101_19_162,r_91_63_38,r_142_64_150,0.54,0,150,150,81
8,r_82_88_163,seq92,r_12_137_75,r_82_88_163,0.59,0,163,163,81
0,r_117_41_145,r_36_123_173,r_125_9_170,r_36_123_173,0.82,0,173,173,81
53,seq3,seq84,r_4_39_59,r_4_39_59,0.83,12,71,59,81
43,r_114_45_74,r_85_57_87,seq71,r_114_45_74,0.86,2,76,74,81
83,seq79,seq144,r_147_24_10,r_147_24_10,0.59,115,125,10,81
37,r_22_124_109,seq60,seq116,r_22_124_109,0.99,0,109,109,81
56,seq6,seq116,r_23_35_39,r_23_35_39,1.0,19,58,39,81
98,seq122,seq116,r_147_24_10,r_147_24_10,0.8,10,20,10,81
16,r_146_70_168,seq116,seq141,r_146_70_168,0.44,1,169,168,81
21,r_149_17_180,seq96,r_133_21_19,r_149_17_180,0.55,0,180,180,81
39,r_69_7_178,seq106,r_111_53_66,r_111_53_66,0.94,113,179,66,81
1,r_4_39_59,seq71,seq3,r_4_39_59,0.87,1,60,59,81
5,r_68_102_127,seq71,r_126_131_27,r_68_102_127,0.95,3,130,127,81
46,r_36_123_173,r_89_139_58,r_117_41_145,r_89_139_58,0.5,96,154,58,81
42,r_125_9_170,r_44_97_158,r_134_54_137,r_134_54_137,0.92,10,147,137,81
45,r_50_95_103,seq16,seq116,r_50_95_103,0.66,0,103,103,81
19,r_12_137_75,r_50_95_103,seq47,r_12_137_75,1.0,0,75,75,81
31,r_8_34_193,seq43,r_46_13_152,r_46_13_152,0.69,5,157,152,81
89,seq96,r_149_17_180,r_129_30_132,r_129_30_132,1.0,23,155,132,81
3,r_130_109_61,r_100_74_153,seq72,r_130_109_61,1.0,1,62,61,81
10,r_87_10_198,r_78_14_60,r_126_131_27,r_87_10_198,0.88,-138,60,198,81
26,r_120_40_179,seq55,r_111_53_66,r_111_53_66,0.99,121,187,66,81
72,seq55,r_120_40_179,r_148_108_186,r_148_108_186,0.52,1,187,186,81
4,r_148_108_186,r_37_98_174,r_44_97_158,r_44_97_158,0.94,16,174,158,81
0,r_117_41_145,r_100_74_153,r_36_123_173,r_100_74_153,0.76,-7,146,153,81
11,r_49_90_69,seq84,seq59,r_49_90_69,0.96,2,71,69,81
48,r_46_13_152,seq18,r_8_34_193,r_46_13_152,0.91,0,152,152,81
46,r_36_123_173,r_117_41_145,r_4_39_59,r_36_123_173,0.93,0,173,173,81
51,seq1,seq32,r_136_20_23,r_136_20_23,0.91,0,23,23,81
27,r_99_66_122,r_27_48_117,seq77,r_99_66_122,0.97,0,122,122,81
55,seq5,r_69_7_178,r_147_24_10,r_147_24_10,0.92,3,13,10,81
47,r_65_143_176,seq47,r_114_45_74,r_65_143_176,0.6,0,176,176,81
15,r_91_63_38,r_44_97_158,seq144,r_91_63_38,0.95,1,39,38,81
29,r_129_30_132,seq18,seq96,r_129_30_132,0.77,0,132,132,81
24,r_134_54_137,seq58,seq128,r_134_54_137,0.88,0,137,137,81
33,r_37_98_174,r_148_108_186,r_112_15_160,r_148_108_186,0.57,-12,174,186,81
6,r_23_35_39,seq83,seq107,r_23_35_39,0.99,0,39,39,81
28,r_147_24_10,r_80_28_199,seq5,r_147_24_10,0.77,0,10,10,81
34,r_101_19_162,r_142_64_150,seq83,r_101_19_162,0.9,0,162,162,81
40,r_136_20_23,r_134_54_137,seq1,r_134_54_137,0.76,-114,23,137,81
32,r_133_21_19,seq0,seq60,r_133_21_19,1.0,0,19,19,81
17,r_85_57_87,seq107,seq141,r_85_57_87,1.0,0,87,87,81
2,r_119_61_37,r_140_62_133,seq73,r_119_61_37,0.71,0,37,37,81
9,r_111_53_66,r_104_11_22,seq58,r_111_53_66,1.0,0,66,66,81
96,seq116,r_146_70_168,r_22_124_109,r_22_124_109,0.98,40,149,109,81
42,r_125_9_170,r_134_54_137,r_117_41_145,r_125_9_170,0.46,1,171,170,81
22,r_78_14_60,r_69_7_178,seq0,r_78_14_60,1.0,2,62,60,81
49,r_93_81_105,r_51_138_192,seq83,r_51_138_192,0.87,-80,112,192,81
41,r_89_139_58,r_36_123_173,seq135,r_89_139_58,0.91,0,58,58,81
7,r_44_97_158,r_125_9_170,r_136_20_23,r_136_20_23,0.53,135,158,23,81
44,r_140_62_133,r_142_64_150,seq128,r_140_62_133,0.9,0,133,133,81
35,r_100_74_153,seq128,r_49_90_69,r_49_90_69,0.79,84,153,69,81
38,r_126_131_27,r_103_52_114,r_87_10_198,r_126_131_27,0.65,0,27,27,81
36,r_25_87_117,seq3,r_9_114_164,r_25_87_117,0.9,0,117,117,82
9,r_9_114_164,r_25_87_117,r_74_21_155,r_9_114_164,0.61,13,177,164,82
13,r_66_45_98,r_102_46_23,r_50_52_148,r_102_46_23,0.56,1,24,23,82
92,seq109,r_93_1_167,r_89_14_74,r_89_14_74,1.0,7,81,74,82
14,r_76_54_92,seq126,seq78,r_76_54_92,1.0,0,92,92,82
8,r_92_15_132,r_118_77_175,r_89_14_74,r_92_15_132,0.92,0,132,132,82
29,r_7_138_49,r_66_45_98,seq130,r_66_45_98,0.59,1,99,98,82
13,r_66_45_98,r_7_138_49,r_11_24_36,r_66_45_98,0.97,1,99,98,82
1,r_41_147_62,r_74_21_155,seq133,r_41_147_62,0.77,-20,42,62,82
29,r_7_138_49,seq130,r_19_73_127,r_19_73_127,0.98,3,130,127,82
55,seq8,r_27_2_69,r_122_58_31,r_27_2_69,0.62,1,70,69,82
21,r_149_91_90,r_119_13_68,r_85_28_6,r_149_91_90,0.75,-7,83,90,82
39,r_27_2_69,seq8,seq80,r_27_2_69,1.0,1,70,69,82
16,r_11_24_36,seq130,seq126,r_11_24_36,1.0,8,44,36,82
5,r_119_13_68,r_149_91_90,r_115_83_15,r_115_83_15,0.47,59,74,15,82
46,r_146_63_67,r_47_35_133,seq130,r_146_63_67,1.0,0,67,67,82
45,r_144_148_151,r_44_121_198,r_26_71_47,r_144_148_151,0.77,0,151,151,82
24,r_47_35_133,seq81,r_44_121_198,r_47_35_133,0.71,2,135,133,82
19,r_113_59_130,seq36,r_89_14_74,r_113_59_130,0.91,0,130,130,82
33,r_26_71_47,seq109,r_144_148_151,r_144_148_151,0.98,1,152,151,82
41,r_95_30_88,seq61,seq84,r_95_30_88,1.0,0,88,88,82
40,r_122_58_31,r_76_54_92,seq8,r_122_58_31,0.99,1,32,31,82
3,r_93_1_167,seq109,seq32,r_93_1_167,0.69,0,167,167,82
0,r_88_43_27,seq130,seq127,r_88_43_27,1.0,3,30,27,82
26,r_134_17_65,r_76_54_92,seq112,r_134_17_65,1.0,2,67,65,82
2,r_33_98_14,r_95_30_88,seq128,r_33_98_14,0.99,-1,13,14,82
49,r_135_136_26,r_93_1_167,r_89_14_74,r_89_14_74,1.0,7,81,74,82
31,r_39_49_28,r_92_15_132,r_94_145_124,r_39_49_28,1.0,0,28,28,82
98,seq126,r_76_54_92,r_11_24_36,r_76_54_92,0.77,0,92,92,82
15,r_62_16_60,seq32,r_68_107_56,r_62_16_60,1.0,3,63,60,82
48,r_19_73_127,seq90,r_7_138_49,r_19_73_127,1.0,0,127,127,82
6,r_74_21_155,seq81,r_9_114_164,r_9_114_164,0.52,-3,161,164,82
18,r_102_46_23,r_66_45_98,seq60,r_102_46_23,1.0,0,23,23,82
29,r_7_138_49,r_47_35_133,r_66_45_98,r_7_138_49,1.0,1,50,49,82
10,r_68_107_56,r_119_13_68,seq34,r_68_107_56,1.0,2,58,56,82
35,r_94_145_124,r_99_142_10,r_39_49_28,r_39_49_28,1.0,6,34,28,82
74,seq64,r_42_37_55,r_85_28_6,r_42_37_55,0.56,-32,23,55,82
30,r_42_37_55,seq64,seq81,r_42_37_55,1.0,2,57,55,82
72,seq60,r_51_129_178,r_102_46_23,r_102_46_23,1.0,2,25,23,82
47,r_44_121_198,r_144_148_151,r_47_35_133,r_144_148_151,0.98,0,151,151,82
4,r_0_10_18,r_69_38_19,seq79,r_0_10_18,0.98,0,18,18,82
49,r_135_136_26,r_99_142_10,r_93_1_167,r_135_136_26,0.99,0,26,26,82
24,r_47_35_133,r_146_63_67,seq81,r_146_63_67,1.0,0,67,67,82
43,r_115_83_15,seq116,seq143,r_115_83_15,1.0,3,18,15,82
35,r_94_145_124,r_39_49_28,seq32,r_94_145_124,1.0,2,126,124,82
68,seq36,r_113_59_130,seq75,r_113_59_130,0.98,-20,110,130,82
42,r_141_5_163,r_69_38_19,r_68_107_56,r_141_5_163,0.77,4,167,163,82
32,r_118_77_175,seq139,r_40_6_85,r_40_6_85,0.85,99,184,85,82
34,r_72_18_86,seq127,r_146_63_67,r_72_18_86,0.98,0,86,86,82
81,seq81,r_74_21_155,r_42_37_55,r_42_37_55,1.0,106,161,55,82
58,seq143,seq78,r_115_83_15,r_115_83_15,1.0,10,25,15,82
17,r_40_6_85,seq79,r_69_38_19,r_40_6_85,0.99,2,87,85,82
25,r_69_38_19,r_141_5_163,r_40_6_85,r_40_6_85,1.0,82,167,85,82
42,r_141_5_163,seq111,r_69_38_19,r_69_38_19,0.87,14,33,19,82
9,r_9_114_164,r_125_48_196,r_25_87_117,r_25_87_117,0.7,0,117,117,82
31,r_39_49_28,r_94_145_124,r_33_98_14,r_94_145_124,1.0,2,126,124,82
33,r_26_71_47,seq100,seq109,r_26_71_47,1.0,0,47,47,82
56,seq139,r_118_77_175,seq131,r_118_77_175,0.74,-38,137,175,82
44,r_67_120_179,r_44_121_198,r_42_37_55,r_42_37_55,1.0,128,183,55,82
13,r_66_45_98,r_50_52_148,r_7_138_49,r_7_138_49,0.96,3,52,49,82
25,r_69_38_19,seq80,r_141_5_163,r_69_38_19,1.0,0,19,19,82
95,seq116,r_41_147_62,seq81,r_41_147_62,0.97,-4,58,62,82
12,r_89_14_74,r_99_142_10,r_135_136_26,r_89_14_74,0.9,1,75,74,82
14,r_87_78_155,seq29,r_62_94_89,r_87_78_155,0.88,0,155,155,83
8,r_93_81_165,seq55,r_71_74_80,r_71_74_80,0.82,85,165,80,83
43,r_18_135_68,r_49_142_196,seq31,r_18_135_68,1.0,2,70,68,83
83,seq85,r_108_118_125,r_47_60_47,r_47_60_47,0.66,78,125,47,83
55,seq9,r_104_57_74,r_19_144_77,r_19_144_77,0.98,49,126,77,83
16,r_88_121_114,seq34,seq125,r_88_121_114,0.53,0,114,114,83
1,r_61_25_108,seq4,r_63_107_51,r_61_25_108,1.0,1,109,108,83
5,r_147_27_136,seq72,seq46,r_147_27_136,1.0,0,136,136,83
42,r_62_94_89,seq1,seq31,r_62_94_89,0.72,1,90,89,83
45,r_19_144_77,r_100_123_145,seq84,r_19_144_77,0.78,0,77,77,83
19,r_108_118_125,seq85,r_89_36_8,r_108_118_125,0.94,0,125,125,83
29,r_26_127_38,r_90_59_103,r_16_40_24,r_26_127_38,1.0,0,38,38,83
66,seq34,r_33_0_193,r_79_110_120,r_79_110_120,0.94,57,177,120,83
31,r_124_80_46,seq3,seq120,r_124_80_46,0.99,4,50,46,83
67,seq42,seq31,r_140_21_133,r_140_21_133,1.0,6,139,133,83
10,r_90_59_103,r_63_107_51,r_22_39_91,r_22_39_91,1.0,12,103,91,83
26,r_139_64_150,seq114,seq23,r_139_64_150,0.71,2,152,150,83
72,seq55,r_93_81_165,r_89_36_8,r_93_81_165,0.82,0,165,165,83
78,seq72,r_11_53_187,r_56_6_31,r_56_6_31,0.99,156,187,31,83
0,r_22_39_91,seq122,r_90_59_103,r_22_39_91,1.0,0,91,91,83
11,r_20_96_116,r_93_81_165,seq2,r_20_96_116,1.0,0,116,116,83
20,r_11_53_187,seq72,r_5_7_64,r_11_53_187,0.38,0,187,187,83
13,r_138_128_130,r_5_7_64,seq31,r_138_128_130,0.99,0,130,130,83
18,r_65_13_22,r_134_91_124,r_10_70_35,r_10_70_35,0.58,1,36,35,83
15,r_103_30_106,seq130,seq23,r_103_30_106,0.99,1,107,106,83
57,seq130,r_103_30_106,r_104_57_74,r_103_30_106,0.51,1,107,106,83
6,r_77_101_37,seq120,seq28,r_77_101_37,1.0,0,37,37,83
24,r_10_70_35,seq50,r_65_13_22,r_10_70_35,1.0,0,35,35,83
99,seq126,r_149_148_167,r_49_142_196,r_49_142_196,0.79,-17,179,196,83
12,r_75_38_17,r_147_27_136,seq133,r_75_38_17,1.0,1,18,17,83
46,r_132_48_39,r_147_27_136,seq114,r_132_48_39,1.0,0,39,39,83
52,seq3,r_124_80_46,r_92_45_48,r_92_45_48,0.99,2,50,48,83
41,r_16_40_24,r_47_60_47,r_26_127_38,r_16_40_24,1.0,23,47,24,83
2,r_8_43_181,seq141,r_65_13_22,r_65_13_22,0.75,159,181,22,83
47,r_104_57_74,seq31,seq130,r_104_57_74,0.96,4,78,74,83
40,r_149_148_167,seq126,r_103_30_106,r_103_30_106,1.0,62,168,106,83
21,r_14_35_10,seq2,seq44,r_14_35_10,0.99,0,10,10,83
48,r_47_60_47,r_16_40_24,seq85,r_47_60_47,1.0,0,47,47,83
25,r_63_107_51,r_90_59_103,seq137,r_90_59_103,0.99,-3,100,103,83
64,seq31,seq42,r_62_94_89,r_62_94_89,1.0,35,124,89,83
50,seq1,r_62_94_89,seq15,r_62_94_89,0.8,1,90,89,83
61,seq24,r_140_21_133,r_63_107_51,r_140_21_133,0.97,-10,123,133,83
38,r_71_74_80,r_100_123_145,seq114,r_71_74_80,1.0,0,80,80,83
37,r_95_111_57,seq46,seq44,r_95_111_57,1.0,1,58,57,83
34,r_134_91_124,seq23,seq85,r_134_91_124,1.0,5,129,124,83
97,seq122,r_22_39_91,seq28,r_22_39_91,1.0,-44,47,91,83
17,r_49_142_196,r_18_135_68,seq46,r_18_135_68,1.0,2,70,68,83
9,r_140_21_133,seq24,seq42,r_140_21_133,0.99,0,133,133,83
22,r_86_115_70,r_147_27_136,seq120,r_86_115_70,0.58,0,70,70,83
4,r_56_6_31,r_90_59_103,seq72,r_56_6_31,1.0,2,33,31,83
56,seq12,r_131_37_98,r_22_39_91,r_22_39_91,1.0,0,91,91,83
7,r_100_123_145,r_5_7_64,r_14_35_10,r_100_123_145,0.96,1,146,145,83
44,r_136_54_138,seq114,r_89_36_8,r_136_54_138,0.77,1,139,138,83
23,r_79_110_120,r_51_73_55,seq34,r_51_73_55,0.46,65,120,55,83
35,r_145_76_94,r_33_0_193,seq15,r_145_76_94,0.99,0,94,94,83
39,r_92_45_48,r_147_27_136,seq3,r_92_45_48,1.0,2,50,48,83
93,seq112,r_74_10_62,seq107,r_74_10_62,0.66,20,82,62,84
99,seq127,r_118_57_182,r_54_32_29,r_54_32_29,0.61,22,51,29,84
40,r_47_101_56,r_17_52_181,seq137,r_47_101_56,0.86,2,58,56,84
36,r_141_144_124,seq38,seq75,r_141_144_124,1.0,0,124,124,84
5,r_111_3_193,r_92_23_78,r_96_13_28,r_111_3_193,0.58,-142,51,193,84
14,r_133_123_80,seq16,r_71_95_139,r_133_123_80,1.0,0,80,80,84
8,r_106_21_164,seq66,r_14_99_72,r_14_99_72,0.94,93,165,72,84
27,r_71_95_139,r_133_123_80,r_81_126_189,r_71_95_139,0.95,0,139,139,84
23,r_25_1_31,r_118_57_182,seq89,r_25_1_31,1.0,0,31,31,84
44,r_44_15_46,r_48_34_156,seq19,r_44_15_46,0.97,1,47,46,84
39,r_135_77_142,seq12,r_61_18_44,r_135_77_142,0.82,0,142,142,84
1,r_114_30_103,seq56,seq64,r_114_30_103,1.0,0,103,103,84
35,r_27_93_41,r_106_21_164,r_53_55_4,r_27_93_41,0.94,4,45,41,84
37,r_24_29_30,seq134,seq69,r_24_29_30,1.0,0,30,30,84
7,r_9_88_172,r_90_68_95,r_136_2_53,r_9_88_172,0.8,-1,171,172,84
15,r_74_10_62,r_63_73_81,seq19,r_74_10_62,0.95,-4,58,62,84
20,r_136_2_53,r_97_142_198,seq56,r_136_2_53,1.0,0,53,53,84
33,r_130_124_114,r_135_77_142,seq58,r_130_124_114,1.0,0,114,114,84
41,r_59_140_69,r_90_68_95,seq26,r_90_68_95,0.97,-26,69,95,84
89,seq100,r_17_52_181,r_42_139_93,r_42_139_93,0.98,0,93,93,84
47,r_96_13_28,r_136_2_53,r_111_3_193,r_96_13_28,0.86,0,28,28,84
3,r_92_23_78,r_111_3_193,seq121,r_92_23_78,1.0,0,78,78,84
26,r_81_126_189,r_17_52_181,r_71_95_139,r_81_126_189,0.55,-7,182,189,84
18,r_102_6_26,seq16,seq40,r_102_6_26,0.88,-2,24,26,84
16,r_43_49_50,r_118_57_182,r_90_68_95,r_90_68_95,0.82,87,182,95,84
14,r_133_123_80,r_71_95_139,seq137,r_71_95_139,0.98,2,141,139,84
4,r_14_99_72,r_130_124_114,seq75,r_14_99_72,1.0,1,73,72,84
78,seq66,r_106_21_164,seq146,r_106_21_164,0.99,1,165,164,84
11,r_82_143_57,r_114_30_103,seq138,r_114_30_103,1.0,-39,64,103,84
13,r_94_147_163,seq22,seq36,r_94_147_163,0.52,3,166,163,84
98,seq121,seq134,r_92_23_78,r_92_23_78,1.0,11,89,78,84
38,r_97_142_198,r_136_2_53,r_46_84_34,r_136_2_53,0.99,-2,51,53,84
6,r_17_52_181,r_81_126_189,r_27_93_41,r_17_52_181,0.68,0,181,181,84
49,r_98_67_32,r_61_18_44,seq79,r_98_67_32,0.89,0,32,32,84
2,r_90_68_95,r_9_88_172,r_43_49_50,r_9_88_172,0.94,0,172,172,84
48,r_110_76_59,r_8_108_118,seq58,r_110_76_59,0.9,0,59,59,84
27,r_71_95_139,seq138,r_133_123_80,r_133_123_80,0.96,2,82,80,84
16,r_43_49_50,r_141_144_124,r_118_57_182,r_43_49_50,0.98,0,50,50,84
29,r_46_84_34,r_74_10_62,r_97_142_198,r_46_84_34,0.9,15,49,34,84
79,seq69,seq33,r_24_29_30,r_24_29_30,1.0,11,41,30,84
2,r_90_68_95,seq19,r_9_88_172,r_90_68_95,0.8,0,95,95,84
92,seq109,r_61_18_44,r_115_50_119,r_61_18_44,1.0,-1,43,44,84
24,r_149_80_169,seq131,r_94_147_163,r_149_80_169,0.51,3,172,169,84
33,r_130_124_114,r_14_99_72,r_135_77_142,r_14_99_72,0.98,1,73,72,84
31,r_61_18_44,seq109,seq120,r_61_18_44,0.96,2,46,44,84
0,r_54_32_29,r_133_123_80,seq127,r_54_32_29,1.0,0,29,29,84
32,r_63_73_81,r_74_10_62,seq70,r_63_73_81,0.91,1,82,81,84
52,seq131,r_149_80_169,r_102_6_26,r_149_80_169,0.83,3,172,169,84
17,r_148_31_188,r_97_142_198,r_81_126_189,r_81_126_189,0.58,-1,188,189,84
94,seq113,r_74_10_62,seq107,r_74_10_62,0.79,20,82,62,84
9,r_51_0_135,r_105_20_37,seq65,r_51_0_135,0.93,0,135,135,84
19,r_122_78_33,seq65,r_125_11_187,r_122_78_33,0.99,0,33,33,84
28,r_42_139_93,seq89,seq100,r_42_139_93,0.97,0,93,93,84
91,seq107,r_63_73_81,seq112,r_63_73_81,0.9,-19,62,81,84
7,r_9_88_172,r_118_57_182,r_90_68_95,r_90_68_95,1.0,3,98,95,84
10,r_119_35_11,r_74_10_62,seq16,r_119_35_11,0.59,5,16,11,84
12,r_103_37_170,seq36,seq5,r_103_37_170,0.53,0,170,170,84
45,r_125_11_187,seq109,r_122_78_33,r_122_78_33,1.0,11,44,33,84
30,r_105_110_104,seq130,seq95,r_105_110_104,0.98,0,104,104,85
36,r_90_52_80,seq1,r_102_37_138,r_90_52_80,0.38,-15,65,80,85
30,r_105_110_104,seq95,r_102_37_138,r_102_37_138,1.0,13,151,138,85
19,r_66_100_44,r_117_21_110,seq88,r_66_100_44,1.0,0,44,44,85
88,seq95,r_118_93_36,seq10,r_118_93_36,1.0,1,37,36,85
43,r_27_36_154,seq104,r_90_52_80,r_27_36_154,0.83,0,154,154,85
54,seq7,r_76_67_160,r_90_52_80,r_90_52_80,0.89,81,161,80,85
37,r_63_18_77,r_119_136_3,seq108,r_63_18_77,1.0,0,77,77,85
26,r_113_123_12,r_91_82_192,seq42,r_113_123_12,0.96,1,13,12,85
16,r_135_57_65,r_117_21_110,r_96_39_11,r_135_57_65,1.0,0,65,65,85
21,r_30_16_173,seq145,r_22_85_115,r_22_85_115,0.76,58,173,115,85
5,r_8_125_167,seq25,seq68,r_8_125_167,0.5,0,167,167,85
42,r_89_58_102,r_81_60_41,seq68,r_89_58_102,0.98,1,103,102,85
32,r_6_15_90,seq40,seq124,r_6_15_90,1.0,0,90,90,85
69,seq40,seq74,r_12_29_39,r_12_29_39,1.0,25,64,39,85
34,r_92_147_10,r_22_85_115,r_131_120_199,r_92_147_10,0.99,0,10,10,85
11,r_103_137_35,seq49,seq53,r_103_137_35,1.0,0,35,35,85
48,r_12_29_39,r_91_82_192,seq40,r_12_29_39,1.0,0,39,39,85
66,seq32,seq13,r_22_85_115,r_22_85_115,1.0,38,153,115,85
14,r_140_64_26,r_6_15_90,r_92_147_10,r_92_147_10,0.67,16,26,10,85
3,r_141_78_98,seq11,seq109,r_141_78_98,0.77,2,100,98,85
40,r_94_98_17,seq88,seq145,r_94_98_17,0.99,0,17,17,85
4,r_22_85_115,r_134_107_16,seq32,r_22_85_115,0.92,0,115,115,85
0,r_146_26_142,seq2,r_122_56_37,r_146_26_142,0.49,0,142,142,85
13,r_117_21_110,seq106,r_119_136_3,r_117_21_110,1.0,0,110,110,85
15,r_65_143_106,seq99,seq88,r_65_143_106,0.97,5,111,106,85
17,r_122_56_37,r_102_37_138,seq32,r_122_56_37,0.93,0,37,37,85
12,r_76_67_160,r_51_4_72,seq77,r_76_67_160,0.99,1,161,160,85
18,r_28_128_31,r_76_67_160,seq24,r_28_128_31,1.0,0,31,31,85
2,r_50_9_186,r_96_39_11,r_146_26_142,r_50_9_186,0.38,0,186,186,85
10,r_96_39_11,r_50_9_186,r_135_57_65,r_135_57_65,1.0,120,185,65,85
0,r_146_26_142,r_122_56_37,r_62_75_155,r_62_75_155,0.77,6,161,155,85
39,r_80_144_48,seq95,r_142_111_83,r_142_111_83,0.99,3,86,83,85
47,r_62_75_155,r_131_120_199,r_146_26_142,r_146_26_142,0.76,13,155,142,85
29,r_127_61_179,r_119_136_3,r_118_93_36,r_118_93_36,0.86,143,179,36,85
24,r_48_17_147,seq84,seq88,r_48_17_147,0.79,0,147,147,85
25,r_112_33_100,r_8_125_167,seq10,r_112_33_100,0.79,0,100,100,85
25,r_112_33_100,seq10,r_102_37_138,r_102_37_138,1.0,-1,137,138,85
38,r_5_45_184,seq77,r_141_78_98,r_5_45_184,0.34,0,184,184,85
44,r_118_93_36,seq95,seq49,r_118_93_36,1.0,1,37,36,85
2,r_50_9_186,r_5_45_184,r_96_39_11,r_96_39_11,0.64,3,14,11,85
45,r_139_79_18,r_8_125_167,r_116_72_92,r_116_72_92,0.45,51,143,92,85
32,r_6_15_90,r_140_64_26,seq40,r_140_64_26,0.99,4,30,26,85
49,r_73_44_30,r_5_45_184,seq49,r_73_44_30,0.99,0,30,30,85
22,r_102_37_138,seq42,r_112_33_100,r_102_37_138,0.97,0,138,138,85
28,r_133_46_107,seq11,r_113_123_12,r_133_46_107,1.0,0,107,107,85
7,r_116_72_92,r_141_78_98,r_139_79_18,r_116_72_92,0.84,1,93,92,85
39,r_80_144_48,seq1,seq95,r_80_144_48,0.99,0,48,48,85
45,r_139_79_18,r_103_137_35,r_8_125_167,r_103_137_35,0.59,-15,20,35,85
41,r_126_149_55,r_91_82_192,r_119_136_3,r_126_149_55,1.0,0,55,55,85
10,r_96_39_11,r_141_78_98,r_50_9_186,r_96_39_11,1.0,0,11,11,85
35,r_115_55_183,seq38,r_90_52_80,r_90_52_80,0.75,103,183,80,85
30,r_35_140_163,seq86,r_48_90_158,r_48_90_158,0.97,14,172,158,86
36,r_50_124_58,seq27,seq109,r_50_124_58,0.99,2,60,58,86
14,r_40_39_190,r_32_114_75,r_82_87_63,r_40_39_190,0.94,-115,75,190,86
8,r_48_90_158,seq6,r_35_140_163,r_48_90_158,0.72,3,161,158,86
37,r_92_137_57,r_125_95_156,r_21_58_39,r_92_137_57,1.0,0,57,57,86
44,r_139_143_88,r_72_69_54,r_128_112_107,r_128_112_107,0.99,3,110,107,86
31,r_141_93_40,r_135_17_34,seq18,r_141_93_40,0.99,0,40,40,86
56,seq7,r_63_134_161,r_85_3_16,r_85_3_16,0.75,7,23,16,86
16,r_82_87_63,r_129_79_178,r_40_39_190,r_82_87_63,0.99,0,63,63,86
21,r_129_79_178,seq71,r_75_33_41,r_75_33_41,0.55,137,178,41,86
39,r_46_88_97,seq37,r_85_3_16,r_85_3_16,0.93,85,101,16,86
5,r_61_59_90,seq132,seq89,r_61_59_90,0.97,0,90,90,86
46,r_127_8_144,r_29_130_183,r_50_124_58,r_127_8_144,0.61,2,146,144,86
42,r_13_146_182,r_51_25_140,r_75_33_41,r_75_33_41,0.97,100,141,41,86
13,r_75_33_41,r_149_66_175,r_57_115_12,r_75_33_41,1.0,0,41,41,86
70,seq34,r_149_66_175,r_116_14_29,r_116_14_29,0.86,0,29,29,86
38,r_54_133_162,r_92_137_57,seq147,r_54_133_162,0.98,1,163,162,86
41,r_52_28_167,seq147,r_2_68_76,r_52_28_167,0.64,0,167,167,86
67,seq27,r_50_124_58,r_142_53_172,r_50_124_58,0.8,2,60,58,86
22,r_142_53_172,r_32_114_75,r_26_19_9,r_142_53_172,0.88,2,174,172,86
3,r_43_73_196,r_94_106_176,r_61_59_90,r_94_106_176,0.51,1,177,176,86
10,r_103_98_105,seq136,r_141_93_40,r_103_98_105,1.0,0,105,105,86
33,r_57_115_12,seq22,r_75_33_41,r_75_33_41,1.0,14,55,41,86
16,r_82_87_63,r_40_39_190,r_70_62_129,r_70_62_129,1.0,61,190,129,86
4,r_63_134_161,seq7,seq42,r_63_134_161,0.76,2,163,161,86
0,r_70_62_129,seq102,seq118,r_70_62_129,0.85,0,129,129,86
63,seq147,r_149_66_175,r_54_133_162,r_54_133_162,0.6,14,176,162,86
11,r_29_130_183,seq9,seq111,r_29_130_183,0.46,0,183,183,86
20,r_149_66_175,seq147,r_75_33_41,r_75_33_41,1.0,135,176,41,86
98,seq120,r_43_73_196,r_99_123_138,r_99_123_138,1.0,11,149,138,86
48,r_10_80_94,r_43_73_196,seq147,r_10_80_94,1.0,0,94,94,86
6,r_94_106_176,r_43_73_196,r_85_3_16,r_43_73_196,0.59,-20,176,196,86
62,seq18,r_83_4_152,r_103_98_105,r_103_98_105,0.53,47,152,105,86
99,seq126,r_49_121_137,seq144,r_49_121_137,0.78,3,140,137,86
27,r_49_121_137,seq126,r_85_3_16,r_49_121_137,0.94,0,137,137,86
24,r_135_17_34,seq105,r_78_122_14,r_78_122_14,0.93,32,46,14,86
2,r_64_74_154,seq89,seq97,r_64_74_154,0.49,8,162,154,86
47,r_128_112_107,seq144,r_139_143_88,r_128_112_107,1.0,1,108,107,86
43,r_78_122_14,r_13_146_182,r_135_17_34,r_78_122_14,1.0,1,15,14,86
18,r_2_68_76,seq145,seq16,r_2_68_76,0.82,1,77,76,86
42,r_13_146_182,r_75_33_41,seq145,r_13_146_182,0.76,0,182,182,86
25,r_77_67_121,seq11,r_103_98_105,r_77_67_121,0.97,3,124,121,86
58,seq9,r_29_130_183,r_55_104_26,r_55_104_26,0.8,157,183,26,86
38,r_54_133_162,seq0,r_92_137_57,r_92_137_57,1.0,17,74,57,86
45,r_72_69_54,r_135_17_34,r_139_143_88,r_139_143_88,0.98,14,102,88,86
34,r_84_119_108,seq105,r_116_14_29,r_84_119_108,0.99,0,108,108,86
19,r_55_104_26,seq47,seq131,r_55_104_26,1.0,0,26,26,86
33,r_57_115_12,r_92_137_57,seq22,r_57_115_12,0.64,0,12,12,86
17,r_99_123_138,r_142_53_172,seq120,r_99_123_138,1.0,0,138,138,86
32,r_116_14_29,r_61_59_90,seq34,r_116_14_29,1.0,0,29,29,86
9,r_85_3_16,r_54_133_162,seq7,r_85_3_16,0.99,-1,15,16,86
22,r_142_53_172,r_99_123_138,r_32_114_75,r_142_53_172,0.58,-34,138,172,86
28,r_21_58_39,seq148,r_92_137_57,r_92_137_57,1.0,14,71,57,86
49,r_51_25_140,r_13_146_182,seq136,r_51_25_140,0.96,1,141,140,86
44,r_139_143_88,r_43_73_196,r_72_69_54,r_139_143_88,0.9,0,88,88,86
23,r_113_12_82,r_139_143_88,seq36,r_139_143_88,0.9,-6,82,88,86
79,seq71,r_129_79_178,seq6,r_129_79_178,0.61,4,182,178,86
35,r_83_4_152,seq18,seq144,r_83_4_152,0.72,0,152,152,86
12,r_32_114_75,r_40_39_190,seq27,r_32_114_75,1.0,0,75,75,86
45,r_72_69_54,seq118,r_135_17_34,r_72_69_54,1.0,0,54,54,86
90,seq144,r_55_104_26,r_96_60_153,r_96_60_153,0.87,5,158,153,86
30,r_140_5_54,seq33,r_57_110_65,r_57_110_65,1.0,7,72,65,87
51,seq1,r_48_62_169,r_89_67_64,r_89_67_64,1.0,90,154,64,87
40,r_130_61_20,r_101_28_132,seq123,r_130_61_20,0.99,0,20,20,87
36,r_19_94_134,seq65,r_74_142_62,r_74_142_62,0.71,72,134,62,87
14,r_41_99_147,seq145,seq65,r_41_99_147,0.95,0,147,147,87
8,r_56_10_140,seq23,seq11,r_56_10_140,0.92,0,140,140,87
43,r_137_126_106,r_101_28_132,seq36,r_137_126_106,0.99,0,106,106,87
16,r_141_77_172,r_80_95_52,r_90_133_39,r_141_77_172,0.88,-129,43,172,87
18,r_54_8_34,seq45,seq20,r_54_8_34,1.0,0,34,34,87
37,r_101_28_132,seq66,r_9_82_8,r_101_28_132,0.87,0,132,132,87
55,seq11,seq145,r_56_10_140,r_56_10_140,1.0,4,144,140,87
21,r_58_37_110,seq78,r_130_61_20,r_58_37_110,0.93,0,110,110,87
1,r_43_97_60,r_122_146_165,r_109_55_118,r_109_55_118,0.97,47,165,118,87
1,r_43_97_60,seq45,r_122_146_165,r_43_97_60,1.0,0,60,60,87
5,r_31_47_192,r_4_114_174,r_148_64_76,r_148_64_76,0.83,98,174,76,87
46,r_6_39_167,seq36,r_90_133_39,r_6_39_167,0.74,0,167,167,87
42,r_109_55_118,seq112,seq71,r_109_55_118,0.87,0,118,118,87
19,r_29_32_139,r_93_129_176,r_131_87_24,r_29_32_139,0.73,0,139,139,87
31,r_122_146_165,r_70_17_18,r_90_133_39,r_90_133_39,0.53,126,165,39,87
41,r_52_143_81,seq21,r_148_64_76,r_52_143_81,0.99,1,82,81,87
89,seq107,r_48_62_169,r_89_67_64,r_89_67_64,1.0,92,156,64,87
49,r_57_110_65,seq42,seq35,r_57_110_65,0.99,0,65,65,87
26,r_89_67_64,seq123,seq1,r_89_67_64,1.0,1,65,64,87
0,r_93_129_176,seq18,r_98_118_149,r_93_129_176,0.56,2,178,176,87
11,r_26_72_135,seq69,seq108,r_26_72_135,0.98,1,136,135,87
17,r_136_113_47,r_103_60_188,seq78,r_136_113_47,1.0,1,48,47,87
20,r_4_114_174,r_31_47_192,r_56_10_140,r_31_47_192,0.78,-18,174,192,87
15,r_103_60_188,seq79,r_9_82_8,r_9_82_8,0.88,181,189,8,87
6,r_98_118_149,seq105,r_51_147_170,r_98_118_149,0.7,1,150,149,87
27,r_70_17_18,r_122_146_165,r_74_142_62,r_74_142_62,1.0,33,95,62,87
13,r_102_44_55,r_89_67_64,r_31_47_192,r_31_47_192,0.47,-137,55,192,87
7,r_90_133_39,r_88_134_113,seq69,r_90_133_39,0.99,2,41,39,87
49,r_57_110_65,r_128_111_108,seq42,r_57_110_65,0.59,-26,39,65,87
3,r_27_106_15,seq108,r_80_95_52,r_80_95_52,1.0,1,53,52,87
74,seq65,r_148_64_76,r_19_94_134,r_148_64_76,0.95,0,76,76,87
25,r_15_50_70,seq25,seq36,r_15_50_70,1.0,0,70,70,87
33,r_81_12_100,seq71,seq112,r_81_12_100,1.0,1,101,100,87
68,seq42,r_19_94_134,seq65,r_19_94_134,0.77,0,134,134,87
3,r_27_106_15,r_31_47_192,seq108,r_27_106_15,0.98,0,15,15,87
61,seq23,r_56_10_140,r_31_47_192,r_56_10_140,0.99,0,140,140,87
32,r_48_62_169,seq1,r_85_38_66,r_48_62_169,0.6,0,169,169,87
39,r_80_95_52,r_141_77_172,r_131_87_24,r_80_95_52,1.0,0,52,52,87
38,r_30_40_89,r_88_134_113,r_141_77_172,r_141_77_172,0.62,-83,89,172,87
29,r_131_87_24,seq108,r_80_95_52,r_80_95_52,1.0,0,52,52,87
34,r_148_64_76,seq65,r_91_46_1,r_148_64_76,1.0,0,76,76,87
16,r_141_77_172,r_90_133_39,r_30_40_89,r_30_40_89,0.84,2,91,89,87
81,seq78,r_58_37_110,r_9_82_8,r_58_37_110,0.74,0,110,110,87
9,r_124_3_98,r_83_16_5,seq21,r_124_3_98,1.0,3,101,98,87
22,r_14_132_124,seq45,seq65,r_14_132_124,0.94,0,124,124,87
28,r_128_111_108,r_48_62_169,seq123,r_128_111_108,1.0,0,108,108,87
29,r_131_87_24,r_58_37_110,seq108,r_131_87_24,0.97,0,24,24,87
56,seq145,r_41_99_147,seq127,r_41_99_147,1.0,0,147,147,87
44,r_119_76_96,seq20,seq68,r_119_76_96,1.0,0,96,96,87
23,r_85_38_66,seq112,seq115,r_85_38_66,1.0,0,66,66,87
82,seq79,r_103_60_188,r_93_129_176,r_93_129_176,0.52,13,189,176,87
35,r_74_142_62,seq135,r_70_17_18,r_74_142_62,1.0,0,62,62,87
12,r_88_134_113,seq20,r_7_149_4,r_88_134_113,0.97,0,113,113,87
74,seq65,r_19_94_134,r_14_132_124,r_14_132_124,0.88,10,134,124,87
92,seq106,r_52_104_91,seq21,r_52_104_91,0.95,4,95,91,88
8,r_70_135_98,seq72,seq44,r_70_135_98,1.0,1,99,98,88
53,seq7,r_53_40_118,seq145,r_53_40_118,1.0,-18,100,118,88
43,r_81_45_117,r_4_148_172,r_49_50_11,r_81_45_117,1.0,0,117,117,88
71,seq58,seq139,r_13_140_69,r_13_140_69,0.52,-2,67,69,88
86,seq97,r_43_137_170,r_82_130_67,r_82_130_67,0.92,103,170,67,88
16,r_17_74_142,seq69,seq71,r_17_74_142,0.55,2,144,142,88
39,r_85_136_119,seq120,r_82_130_67,r_85_136_119,1.0,1,120,119,88
97,seq120,r_85_136_119,seq9,r_85_136_119,1.0,-46,73,119,88
42,r_27_126_135,seq99,seq147,r_27_126_135,0.98,0,135,135,88
80,seq87,r_52_104_91,seq21,r_52_104_91,0.92,0,91,91,88
15,r_59_149_40,seq87,seq56,r_59_149_40,1.0,1,41,40,88
35,r_73_55_48,seq21,seq47,r_73_55_48,0.76,-1,47,48,88
61,seq21,r_73_55_48,seq87,r_73_55_48,1.0,-1,47,48,88
31,r_125_26_143,r_29_30_164,r_133_132_124,r_29_30_164,0.57,-21,143,164,88
41,r_37_63_106,seq77,seq7,r_37_63_106,0.92,2,108,106,88
10,r_6_32_130,seq44,seq139,r_6_32_130,0.9,0,130,130,88
26,r_143_34_148,seq60,r_78_89_4,r_143_34_148,0.56,0,148,148,88
48,r_142_10_52,r_129_31_2,seq145,r_142_10_52,0.98,0,52,52,88
14,r_110_68_181,r_142_10_52,r_79_61_56,r_142_10_52,0.29,129,181,52,88
32,r_33_146_23,r_129_31_2,seq71,r_33_146_23,0.71,1,24,23,88
4,r_52_104_91,seq87,seq12,r_52_104_91,0.98,0,91,91,88
0,r_20_75_113,r_98_19_190,seq139,r_20_75_113,0.97,-5,108,113,88
11,r_112_95_79,r_78_89_4,seq77,r_112_95_79,0.99,1,80,79,88
2,r_79_61_56,r_125_26_143,r_37_63_106,r_79_61_56,0.99,0,56,56,88
59,seq145,seq7,r_142_10_52,r_142_10_52,1.0,0,52,52,88
20,r_113_28_101,r_82_130_67,r_129_31_2,r_129_31_2,0.8,100,102,2,88
13,r_22_134_168,seq56,r_86_39_187,r_22_134_168,0.38,-22,146,168,88
70,seq57,r_29_30_164,r_49_50_11,r_49_50_11,0.97,0,11,11,88
6,r_64_5_134,seq69,seq41,r_64_5_134,0.98,0,134,134,88
44,r_83_24_32,seq1,r_98_19_190,r_83_24_32,0.97,-1,31,32,88
2,r_79_61_56,r_37_63_106,r_112_95_79,r_79_61_56,0.65,52,108,56,88
29,r_129_31_2,r_0_2_49,r_51_65_1,r_0_2_49,1.0,0,49,49,88
76,seq72,seq14,r_0_2_49,r_0_2_49,1.0,2,51,49,88
37,r_0_2_49,r_129_31_2,seq72,r_0_2_49,1.0,0,49,49,88
28,r_49_50_11,r_116_46_199,seq57,r_49_50_11,0.85,0,11,11,88
40,r_13_140_69,seq139,seq58,r_13_140_69,0.43,0,69,69,88
18,r_122_108_111,seq56,seq69,r_122_108_111,0.8,0,111,111,88
33,r_119_138_93,r_27_126_135,seq111,r_119_138_93,0.64,0,93,93,88
92,seq106,seq21,r_29_30_164,r_29_30_164,1.0,6,170,164,88
38,r_53_40_118,seq7,seq93,r_53_40_118,1.0,-2,116,118,88
47,r_90_84_46,seq139,seq56,r_90_84_46,0.84,-4,42,46,88
13,r_22_134_168,r_86_39_187,r_17_74_142,r_86_39_187,0.55,-18,169,187,88
18,r_122_108_111,seq69,r_62_114_145,r_62_114_145,0.97,9,154,145,88
36,r_121_38_37,r_6_32_130,seq60,r_6_32_130,0.65,-93,37,130,88
45,r_86_39_187,r_90_84_46,r_49_50_11,r_86_39_187,0.58,0,187,187,88
17,r_3_16_149,seq139,seq105,r_3_16_149,0.92,1,150,149,88
9,r_82_130_67,r_23_117_76,seq97,r_23_117_76,0.92,-9,67,76,88
29,r_129_31_2,r_51_65_1,r_113_28_101,r_113_28_101,1.0,15,116,101,88
91,seq105,seq60,r_3_16_149,r_3_16_149,0.83,5,154,149,88
49,r_67_42_97,r_27_126_135,r_15_66_39,r_67_42_97,0.98,0,97,97,88
7,r_8_92_107,seq48,r_70_135_98,r_8_92_107,0.76,1,108,107,88
23,r_133_132_124,seq77,seq128,r_133_132_124,0.98,0,124,124,88
12,r_23_117_76,r_51_65_1,r_0_2_49,r_51_65_1,1.0,75,76,1,88
14,r_110_68_181,seq7,r_142_10_52,r_142_10_52,1.0,0,52,52,88
1,r_15_66_39,r_79_61_56,seq139,r_15_66_39,0.86,1,40,39,88
30,r_26_35_109,seq43,r_122_124_66,r_122_124_66,0.78,0,66,66,89
51,seq2,r_4_51_190,seq66,r_4_51_190,0.41,0,190,190,89
14,r_103_135_76,seq85,seq18,r_103_135_76,0.98,1,77,76,89
43,r_94_9_3,r_56_31_154,r_45_48_153,r_56_31_154,0.98,1,155,154,89
3,r_84_34_11,seq131,seq17,r_84_34_11,1.0,0,11,11,89
55,seq138,r_129_29_163,r_142_46_177,r_142_46_177,0.54,2,179,177,89
71,seq58,r_116_140_79,r_86_115_160,r_116_140_79,1.0,0,79,79,89
16,r_13_104_116,r_40_134_64,seq92,r_40_134_64,0.99,0,64,64,89
21,r_80_114_31,r_14_73_133,r_128_33_8,r_14_73_133,0.61,1,134,133,89
39,r_57_148_162,seq111,r_129_29_163,r_57_148_162,0.5,2,164,162,89
46,r_15_137_24,r_79_144_159,r_32_113_7,r_79_144_159,0.6,0,159,159,89
42,r_23_8_97,seq71,r_62_39_75,r_23_8_97,0.75,5,102,97,89
12,r_10_38_34,r_93_120_84,seq75,r_10_38_34,0.99,0,34,34,89
45,r_40_134_64,r_13_104_116,seq85,r_40_134_64,1.0,0,64,64,89
19,r_122_124_66,r_146_27_74,r_26_35_109,r_122_124_66,1.0,0,66,66,89
37,r_101_21_25,r_80_114_31,seq81,r_101_21_25,0.98,0,25,25,89
31,r_14_73_133,r_80_114_31,seq75,r_14_73_133,0.92,1,134,133,89
41,r_86_115_160,seq107,seq36,r_86_115_160,0.49,3,163,160,89
89,seq105,seq123,r_136_117_28,r_136_117_28,0.99,60,88,28,89
10,r_62_39_75,seq69,r_45_48_153,r_62_39_75,0.97,0,75,75,89
90,seq107,r_86_115_160,r_28_110_125,r_28_110_125,0.95,47,172,125,89
28,r_72_147_47,r_89_133_67,seq85,r_72_147_47,0.97,0,47,47,89
4,r_129_29_163,seq138,r_40_134_64,r_40_134_64,1.0,106,170,64,89
0,r_142_46_177,r_16_74_96,seq97,r_16_74_96,0.98,2,98,96,89
69,seq54,seq105,r_136_117_28,r_136_117_28,0.97,13,41,28,89
20,r_79_144_159,r_15_137_24,r_80_114_31,r_79_144_159,0.68,0,159,159,89
10,r_62_39_75,r_45_48_153,r_23_8_97,r_62_39_75,0.54,35,110,75,89
48,r_3_50_111,r_28_110_125,r_62_39_75,r_3_50_111,0.82,1,112,111,89
16,r_13_104_116,seq92,r_136_117_28,r_13_104_116,1.0,1,117,116,89
21,r_80_114_31,r_128_33_8,r_79_144_159,r_79_144_159,0.64,0,159,159,89
0,r_142_46_177,seq97,seq138,r_142_46_177,0.35,2,179,177,89
27,r_99_5_70,seq36,seq131,r_99_5_70,0.87,4,74,70,89
2,r_52_49_176,seq69,r_129_29_163,r_52_49_176,0.57,0,176,176,89
71,seq58,r_86_115_160,r_28_110_125,r_28_110_125,1.0,5,130,125,89
29,r_68_108_185,seq60,r_146_27_74,r_68_108_185,0.31,0,185,185,89
26,r_136_117_28,r_141_121_199,seq54,r_136_117_28,0.92,0,28,28,89
33,r_28_110_125,seq85,seq58,r_28_110_125,0.64,0,125,125,89
19,r_122_124_66,r_26_35_109,seq109,r_122_124_66,0.78,50,116,66,89
38,r_67_61_100,r_65_12_9,seq85,r_67_61_100,1.0,0,100,100,89
52,seq131,r_146_27_74,r_99_5_70,r_146_27_74,0.78,-5,69,74,89
77,seq71,r_23_8_97,seq36,r_23_8_97,0.97,5,102,97,89
34,r_16_74_96,r_142_46_177,seq17,r_16_74_96,0.97,2,98,96,89
27,r_99_5_70,seq131,r_26_35_109,r_26_35_109,0.68,7,116,109,89
8,r_139_1_44,r_106_11_115,seq7,r_139_1_44,0.72,14,58,44,89
17,r_93_120_84,seq64,seq87,r_93_120_84,0.97,0,84,84,89
13,r_95_70_46,r_57_148_162,seq132,r_95_70_46,0.98,0,46,46,89
9,r_76_90_150,seq145,seq69,r_76_90_150,0.85,0,150,150,89
22,r_32_113_7,r_79_144_159,r_89_133_67,r_32_113_7,0.74,152,159,7,89
49,r_146_27_74,seq0,seq97,r_146_27_74,1.0,0,74,74,89
7,r_56_31_154,r_94_9_3,r_101_21_25,r_56_31_154,0.8,1,155,154,89
44,r_77_30_42,r_146_27_74,r_22_59_4,r_146_27_74,1.0,-9,65,74,89
23,r_89_133_67,seq55,seq92,r_89_133_67,0.79,1,68,67,89
30,r_26_35_109,r_122_124_66,r_99_5_70,r_26_35_109,0.84,1,110,109,89
1,r_102_96_19,r_13_104_116,seq69,r_102_96_19,0.99,1,20,19,89
79,seq78,seq44,r_89_133_67,r_89_133_67,0.89,74,141,67,89
35,r_65_12_9,r_67_61_100,seq100,r_67_61_100,0.98,0,100,100,89
84,seq87,seq36,r_93_120_84,r_93_120_84,0.98,9,93,84,89
45,r_70_3_43,seq37,r_135_20_150,r_70_3_43,1.0,0,43,43,90
12,r_41_78_54,r_30_51_189,seq45,r_41_78_54,1.0,0,54,54,90
37,r_55_112_80,r_8_103_145,seq57,r_55_112_80,0.89,3,83,80,90
30,r_24_40_53,seq15,r_90_104_178,r_24_40_53,0.99,0,53,53,90
21,r_58_67_125,r_30_51_189,seq108,r_58_67_125,0.88,0,125,125,90
39,r_136_0_170,seq91,r_82_26_154,r_136_0_170,0.6,0,170,170,90
1,r_53_66_119,r_80_28_149,seq11,r_80_28_149,1.0,-16,133,149,90
5,r_80_28_149,r_9_21_176,seq91,r_80_28_149,0.98,0,149,149,90
46,r_50_61_169,r_90_104_178,seq91,r_50_61_169,0.85,0,169,169,90
42,r_114_141_114,seq12,r_90_104_178,r_114_141_114,0.99,0,114,114,90
80,seq72,r_9_21_176,seq64,r_9_21_176,0.76,-18,158,176,90
10,r_135_20_150,seq113,r_70_3_43,r_70_3_43,1.0,0,43,43,90
31,r_106_132_38,r_143_44_116,seq37,r_106_132_38,1.0,0,38,38,90
76,seq63,seq7,r_90_104_178,r_90_104_178,0.99,11,189,178,90
2,r_83_35_152,r_76_42_104,seq13,r_83_35_152,0.74,-120,32,152,90
8,r_134_94_50,seq148,r_138_142_20,r_134_94_50,1.0,0,50,50,90
58,seq15,r_99_85_111,r_38_84_6,r_38_84_6,0.61,28,34,6,90
14,r_75_124_16,r_4_52_30,seq108,r_75_124_16,0.69,0,16,16,90
61,seq148,r_134_94_50,seq116,r_134_94_50,1.0,0,50,50,90
48,r_76_42_104,r_99_85_111,seq148,r_76_42_104,0.95,1,105,104,90
26,r_144_6_146,seq91,seq11,r_144_6_146,0.96,0,146,146,90
20,r_16_73_132,r_101_39_45,r_100_69_64,r_16_73_132,0.94,0,132,132,90
48,r_76_42_104,r_131_145_163,r_99_85_111,r_99_85_111,0.61,-20,91,111,90
13,r_22_128_37,r_99_85_111,seq25,r_22_128_37,0.97,0,37,37,90
6,r_82_26_154,seq64,r_136_0_170,r_136_0_170,0.68,0,170,170,90
2,r_83_35_152,seq13,r_10_89_151,r_83_35_152,0.89,0,152,152,90
99,seq126,r_109_36_61,r_125_147_180,r_109_36_61,0.36,15,76,61,90
49,r_5_32_195,seq113,r_70_3_43,r_70_3_43,1.0,14,57,43,90
10,r_135_20_150,r_70_3_43,r_123_139_7,r_135_20_150,0.8,0,150,150,90
27,r_10_89_151,r_101_39_45,seq45,r_10_89_151,0.82,0,151,151,90
87,seq91,r_136_0_170,r_50_61_169,r_50_61_169,0.46,1,170,169,90
40,r_8_103_145,seq87,seq115,r_8_103_145,0.92,0,145,145,90
18,r_9_21_176,seq72,r_136_0_170,r_136_0_170,0.9,7,177,170,90
61,seq148,seq116,r_76_42_104,r_76_42_104,1.0,6,110,104,90
71,seq47,r_101_39_45,r_110_95_28,r_110_95_28,0.96,24,52,28,90
29,r_138_142_20,seq108,r_134_94_50,r_134_94_50,1.0,5,55,50,90
19,r_65_105_25,seq137,seq57,r_65_105_25,1.0,0,25,25,90
77,seq64,r_82_26_154,seq72,r_82_26_154,0.89,14,168,154,90
34,r_149_122_120,r_125_147_180,r_48_140_60,r_48_140_60,0.74,58,118,60,90
36,r_101_39_45,r_16_73_132,seq60,r_16_73_132,0.97,-85,47,132,90
45,r_70_3_43,r_135_20_150,r_80_28_149,r_70_3_43,0.94,107,150,43,90
17,r_127_120_135,seq108,r_100_69_64,r_127_120_135,1.0,0,135,135,90
94,seq108,r_127_120_135,r_75_124_16,r_127_120_135,0.68,0,135,135,90
23,r_4_52_30,seq116,seq88,r_4_52_30,1.0,0,30,30,90
33,r_110_95_28,seq108,seq47,r_110_95_28,0.99,0,28,28,90
22,r_48_140_60,seq56,seq13,r_48_140_60,1.0,0,60,60,90
56,seq13,r_83_35_152,r_48_140_60,r_48_140_60,1.0,1,61,60,90
7,r_109_36_61,seq126,r_134_94_50,r_134_94_50,1.0,34,84,50,90
44,r_117_86_177,r_90_104_178,seq137,r_117_86_177,0.35,0,177,177,90
35,r_43_102_102,seq25,seq31,r_43_102_102,0.99,0,102,102,90
30,r_13_118_81,seq110,seq85,r_13_118_81,1.0,0,81,81,91
31,r_69_91_116,r_131_65_163,seq33,r_131_65_163,1.0,0,163,163,91
68,seq40,seq4,r_89_5_27,r_89_5_27,1.0,22,49,27,91
43,r_56_21_87,r_7_86_148,seq71,r_56_21_87,0.63,3,90,87,91
38,r_82_41_25,r_107_17_97,r_108_2_137,r_82_41_25,0.94,0,25,25,91
37,r_78_80_93,r_145_81_184,seq144,r_78_80_93,0.97,1,94,93,91
3,r_58_128_141,r_114_45_26,r_47_8_147,r_58_128_141,0.97,0,141,141,91
49,r_61_102_37,seq90,r_100_28_9,r_61_102_37,1.0,1,38,37,91
16,r_108_2_137,r_0_52_69,r_82_41_25,r_82_41_25,0.6,1,26,25,91
1,r_0_52_69,seq26,seq97,r_0_52_69,0.78,0,69,69,91
29,r_75_98_135,r_139_23_96,seq72,r_75_98_135,0.66,2,137,135,91
57,seq144,r_114_45_26,seq33,r_114_45_26,0.81,-11,15,26,91
45,r_107_17_97,seq126,seq64,r_107_17_97,0.99,0,97,97,91
19,r_131_65_163,r_35_140_124,r_69_91_116,r_35_140_124,0.59,0,124,124,91
15,r_19_149_171,seq59,r_100_28_9,r_19_149_171,0.97,0,171,171,91
38,r_82_41_25,r_108_2_137,r_117_10_78,r_117_10_78,0.97,76,154,78,91
39,r_89_5_27,r_117_10_78,seq40,r_89_5_27,1.0,2,29,27,91
10,r_35_140_124,r_131_65_163,seq126,r_35_140_124,1.0,0,124,124,91
36,r_114_45_26,seq144,seq40,r_114_45_26,0.92,0,26,26,91
47,r_54_73_18,seq18,seq112,r_54_73_18,1.0,0,18,18,91
26,r_138_88_164,seq36,r_66_37_28,r_66_37_28,1.0,139,167,28,91
16,r_108_2_137,r_82_41_25,r_96_130_14,r_108_2_137,0.61,14,151,137,91
27,r_96_130_14,seq104,seq26,r_96_130_14,0.95,1,15,14,91
11,r_133_16_151,seq110,seq148,r_133_16_151,0.76,0,151,151,91
20,r_7_86_148,seq64,seq144,r_7_86_148,0.67,0,148,148,91
13,r_145_81_184,seq85,seq4,r_145_81_184,0.66,-2,182,184,91
15,r_19_149_171,r_43_113_83,seq59,r_19_149_171,0.58,-71,100,171,91
48,r_3_30_142,seq126,r_147_20_63,r_3_30_142,0.99,1,143,142,91
6,r_147_20_63,r_117_10_78,seq143,r_147_20_63,1.0,0,63,63,91
2,r_117_10_78,r_108_2_137,r_22_55_126,r_22_55_126,0.64,28,154,126,91
55,seq141,r_22_55_126,seq67,r_22_55_126,0.97,-74,52,126,91
0,r_53_93_34,seq122,seq32,r_53_93_34,1.0,0,34,34,91
3,r_58_128_141,r_63_38_99,r_114_45_26,r_58_128_141,0.82,-91,50,141,91
87,seq97,r_135_132_188,r_0_52_69,r_0_52_69,1.0,120,189,69,91
29,r_75_98_135,r_61_102_37,r_22_55_126,r_61_102_37,0.87,-14,23,37,91
2,r_117_10_78,r_7_86_148,r_108_2_137,r_7_86_148,0.48,-70,78,148,91
18,r_63_38_99,r_3_30_142,r_56_21_87,r_63_38_99,1.0,2,101,99,91
24,r_43_113_83,r_19_149_171,seq72,r_19_149_171,0.89,-16,155,171,91
8,r_66_37_28,seq32,r_138_88_164,r_66_37_28,1.0,1,29,28,91
33,r_14_99_146,r_145_81_184,r_63_38_99,r_14_99_146,0.65,7,153,146,91
19,r_131_65_163,r_69_91_116,seq72,r_131_65_163,1.0,0,163,163,91
65,seq33,r_35_140_124,r_69_91_116,r_35_140_124,0.53,-7,117,124,91
57,seq144,seq33,r_78_80_93,r_78_80_93,1.0,12,105,93,91
34,r_77_11_169,r_135_132_188,seq74,r_77_11_169,0.76,0,169,169,91
41,r_121_87_15,r_66_37_28,seq4,r_121_87_15,0.91,0,15,15,91
17,r_125_137_140,seq57,seq104,r_125_137_140,0.51,0,140,140,91
29,r_75_98_135,r_22_55_126,r_139_23_96,r_22_55_126,0.52,-29,97,126,91
22,r_44_119_102,seq42,seq136,r_44_119_102,0.99,0,102,102,91
28,r_139_23_96,r_7_86_148,seq97,r_7_86_148,0.81,-52,96,148,91
14,r_6_46_13,r_66_37_28,seq110,r_6_46_13,1.0,0,13,13,91
23,r_142_9_47,r_35_140_124,seq123,r_142_9_47,0.78,1,48,47,91
44,r_60_109_110,seq146,r_147_20_63,r_60_109_110,0.99,1,111,110,91
82,seq85,r_145_81_184,r_13_118_81,r_13_118_81,1.0,101,182,81,91
79,seq74,seq83,r_77_11_169,r_77_11_169,0.75,1,170,169,91
35,r_103_120_60,r_3_30_142,seq85,r_103_120_60,1.0,0,60,60,91
84,seq143,seq74,r_147_20_63,r_147_20_63,1.0,9,72,63,91
51,seq131,seq6,r_40_120_40,r_40_120_40,0.99,87,127,40,92
70,seq41,r_145_76_191,r_1_3_52,r_1_3_52,1.0,-1,51,52,92
92,seq110,r_22_74_175,r_27_23_123,r_27_23_123,0.81,52,175,123,92
43,r_140_141_67,r_62_126_72,seq30,r_140_141_67,1.0,2,69,67,92
12,r_90_16_54,r_86_55_146,seq12,r_90_16_54,1.0,0,54,54,92
37,r_103_84_94,seq7,r_109_33_18,r_103_84_94,0.95,2,96,94,92
59,seq17,r_68_99_174,r_11_2_104,r_11_2_104,0.82,-1,103,104,92
19,r_22_74_175,r_102_136_75,r_117_45_95,r_22_74_175,0.72,0,175,175,92
16,r_102_136_75,r_20_114_120,r_22_74_175,r_102_136_75,0.83,0,75,75,92
21,r_56_148_144,seq100,seq113,r_56_148_144,0.81,3,147,144,92
1,r_70_101_110,r_144_135_118,r_88_115_21,r_70_101_110,0.99,8,118,110,92
5,r_62_126_72,seq82,r_137_77_181,r_62_126_72,0.98,2,74,72,92
46,r_68_99_174,seq65,r_62_126_72,r_68_99_174,0.27,-3,171,174,92
45,r_18_59_100,r_86_55_146,r_102_136_75,r_18_59_100,0.95,0,100,100,92
24,r_44_61_33,r_149_37_5,r_80_108_64,r_80_108_64,1.0,41,105,64,92
19,r_22_74_175,seq110,r_102_136_75,r_102_136_75,1.0,23,98,75,92
10,r_98_72_46,r_93_53_131,seq73,r_98_72_46,1.0,0,46,46,92
15,r_147_123_42,r_107_95_180,r_62_126_72,r_62_126_72,0.66,101,173,72,92
33,r_42_138_74,r_107_95_180,r_26_121_134,r_26_121_134,1.0,46,180,134,92
13,r_88_115_21,seq35,r_117_45_95,r_88_115_21,0.99,0,21,21,92
76,seq51,r_93_53_131,r_40_120_40,r_40_120_40,0.42,91,131,40,92
6,r_93_53_131,r_98_72_46,r_130_66_20,r_98_72_46,1.0,-12,34,46,92
8,r_133_105_49,r_69_10_80,seq113,r_69_10_80,0.51,-30,50,80,92
47,r_146_0_27,seq110,seq125,r_146_0_27,0.76,-4,23,27,92
16,r_102_136_75,r_22_74_175,r_18_59_100,r_102_136_75,0.81,100,175,75,92
7,r_24_8_189,r_9_36_196,r_38_52_162,r_24_8_189,0.47,-11,178,189,92
78,seq60,r_145_76_191,r_69_10_80,r_69_10_80,1.0,82,162,80,92
0,r_38_52_162,seq132,seq82,r_38_52_162,0.67,0,162,162,92
63,seq30,seq32,r_140_141_67,r_140_141_67,1.0,4,71,67,92
20,r_20_114_120,r_13_143_153,r_1_3_52,r_13_143_153,0.72,-32,121,153,92
49,r_130_66_20,r_93_53_131,r_40_120_40,r_130_66_20,0.55,118,138,20,92
13,r_88_115_21,r_117_45_95,r_70_101_110,r_117_45_95,1.0,0,95,95,92
85,seq82,r_62_126_72,seq58,r_62_126_72,0.95,2,74,72,92
15,r_147_123_42,r_78_21_159,r_107_95_180,r_147_123_42,0.99,1,43,42,92
5,r_62_126_72,r_137_77_181,r_102_136_75,r_62_126_72,0.52,109,181,72,92
27,r_80_108_64,seq73,r_44_61_33,r_80_108_64,1.0,0,64,64,92
41,r_117_45_95,seq139,r_88_115_21,r_88_115_21,1.0,2,23,21,92
2,r_144_135_118,r_92_57_93,r_103_84_94,r_144_135_118,0.58,-24,94,118,92
41,r_117_45_95,r_88_115_21,seq47,r_117_45_95,1.0,0,95,95,92
40,r_78_21_159,seq106,r_109_33_18,r_78_21_159,0.93,0,159,159,92
18,r_86_55_146,r_107_95_180,r_146_0_27,r_86_55_146,0.64,0,146,146,92
29,r_137_77_181,seq113,r_62_126_72,r_62_126_72,1.0,8,80,72,92
22,r_107_95_180,r_42_138_74,r_142_94_30,r_107_95_180,0.95,0,180,180,92
33,r_42_138_74,seq106,r_107_95_180,r_42_138_74,1.0,0,74,74,92
30,r_40_120_40,r_54_83_44,seq131,r_40_120_40,0.61,2,42,40,92
7,r_24_8_189,r_49_112_192,r_9_36_196,r_24_8_189,0.49,-47,142,189,92
6,r_93_53_131,r_130_66_20,seq91,r_93_53_131,0.91,0,131,131,92
42,r_5_79_7,r_1_3_52,r_22_74_175,r_1_3_52,1.0,0,52,52,92
42,r_5_79_7,r_22_74_175,r_27_23_123,r_27_23_123,0.71,3,126,123,92
2,r_144_135_118,r_103_84_94,r_98_72_46,r_144_135_118,0.99,0,118,118,92
4,r_54_83_44,r_86_55_146,seq35,r_54_83_44,0.99,0,44,44,92
49,r_130_66_20,r_117_45_95,r_93_53_131,r_130_66_20,0.49,1,21,20,92
23,r_87_104_43,r_62_126_72,r_85_67_24,r_87_104_43,1.0,0,43,43,92
24,r_44_61_33,r_147_123_42,r_149_37_5,r_149_37_5,0.97,29,34,5,92
9,r_142_94_30,seq14,r_149_37_5,r_142_94_30,1.0,0,30,30,92
81,seq71,r_49_112_192,r_92_57_93,r_92_57_93,1.0,76,169,93,92
17,r_4_128_132,seq118,seq19,r_4_128_132,0.81,3,135,132,92
29,r_137_77_181,r_62_126_72,r_13_143_153,r_13_143_153,0.51,28,181,153,92
22,r_107_95_180,r_86_55_146,r_42_138_74,r_42_138_74,1.0,72,146,74,92
28,r_111_63_187,seq60,seq15,r_111_63_187,0.57,0,187,187,92
7,r_24_8_189,seq14,r_49_112_192,r_49_112_192,0.38,-100,92,192,92
44,r_69_10_80,seq6,seq119,r_69_10_80,1.0,0,80,80,92
11,r_1_3_52,r_5_79_7,seq41,r_1_3_52,1.0,0,52,52,92
35,r_11_2_104,seq139,seq17,r_11_2_104,0.89,1,105,104,92
30,r_22_93_151,seq0,seq40,r_22_93_151,0.96,0,151,151,93
8,r_48_36_92,r_126_127_153,r_88_81_41,r_48_36_92,0.75,1,93,92,93
43,r_122_141_72,r_107_74_130,seq7,r_122_141_72,1.0,0,72,72,93
37,r_31_125_144,seq62,r_80_109_127,r_31_125_144,0.53,2,146,144,93
21,r_75_63_142,r_51_57_4,seq114,r_75_63_142,0.97,0,142,142,93
1,r_49_28_180,r_47_3_183,r_87_27_93,r_87_27_93,0.59,87,180,93,93
97,seq118,seq69,r_21_98_31,r_21_98_31,0.72,67,98,31,93
46,r_130_77_156,seq70,r_122_141_72,r_122_141_72,1.0,86,158,72,93
42,r_45_23_78,seq7,seq68,r_45_23_78,0.96,-11,67,78,93
32,r_41_101_116,r_73_26_33,r_129_15_39,r_41_101_116,1.0,0,116,116,93
99,seq120,r_41_101_116,r_87_27_93,r_87_27_93,0.5,-46,47,93,93
14,r_88_81_41,r_66_50_167,r_58_148_17,r_88_81_41,0.99,0,41,41,93
32,r_41_101_116,seq120,r_73_26_33,r_73_26_33,1.0,0,33,33,93
10,r_52_133_40,r_143_78_154,r_51_57_4,r_52_133_40,0.96,3,43,40,93
24,r_126_127_153,seq62,r_138_39_3,r_126_127_153,0.92,6,159,153,93
95,seq116,seq85,r_96_124_111,r_96_124_111,1.0,15,126,111,93
41,r_103_113_117,seq104,r_13_1_20,r_103_113_117,0.53,0,117,117,93
11,r_24_142_23,seq135,seq33,r_24_142_23,1.0,0,23,23,93
3,r_96_124_111,r_143_78_154,seq116,r_96_124_111,0.63,0,111,111,93
26,r_139_136_184,seq94,r_45_23_78,r_45_23_78,0.67,106,184,78,93
78,seq70,r_130_77_156,r_107_74_130,r_107_74_130,1.0,13,143,130,93
0,r_47_3_183,seq2,r_102_86_75,r_102_86_75,0.69,109,184,75,93
14,r_88_81_41,r_58_148_17,r_48_36_92,r_48_36_92,0.96,6,98,92,93
13,r_80_109_127,r_130_77_156,seq16,r_80_109_127,0.69,2,129,127,93
15,r_129_15_39,seq135,r_41_101_116,r_41_101_116,1.0,9,125,116,93
48,r_89_8_119,r_143_78_154,seq2,r_89_8_119,1.0,0,119,119,93
4,r_73_26_33,r_41_101_116,seq120,r_41_101_116,0.92,0,116,116,93
6,r_145_59_128,r_47_3_183,r_24_142_23,r_145_59_128,0.69,0,128,128,93
85,seq94,r_139_136_184,r_140_5_169,r_140_5_169,0.7,15,184,169,93
7,r_32_105_44,r_61_12_145,seq2,r_32_105_44,1.0,0,44,44,93
27,r_66_50_167,seq79,r_51_57_4,r_66_50_167,0.72,0,167,167,93
49,r_147_108_13,seq118,seq9,r_147_108_13,1.0,0,13,13,93
2,r_84_19_138,r_71_144_2,r_51_57_4,r_84_19_138,0.96,0,138,138,93
47,r_149_60_131,seq68,r_129_15_39,r_149_60_131,0.97,0,131,131,93
74,seq62,r_31_125_144,r_73_26_33,r_73_26_33,0.57,113,146,33,93
24,r_126_127_153,r_48_36_92,seq62,r_48_36_92,1.0,3,95,92,93
33,r_102_86_75,r_42_43_170,seq4,r_102_86_75,1.0,0,75,75,93
19,r_44_91_56,seq40,seq79,r_44_91_56,1.0,0,56,56,93
88,seq104,r_103_113_117,seq40,r_103_113_117,1.0,0,117,117,93
50,seq0,r_22_93_151,seq54,r_22_93_151,0.99,0,151,151,93
38,r_107_74_130,seq90,seq70,r_107_74_130,0.97,0,130,130,93
52,seq2,r_47_3_183,r_61_12_145,r_61_12_145,0.95,39,184,145,93
34,r_55_17_77,seq33,r_44_91_56,r_44_91_56,0.96,22,78,56,93
25,r_29_121_21,seq65,seq82,r_29_121_21,1.0,0,21,21,93
99,seq120,r_87_27_93,r_73_26_33,r_87_27_93,0.94,-10,83,93,93
45,r_51_57_4,r_75_63_142,r_84_19_138,r_51_57_4,0.8,138,142,4,93
31,r_100_14_54,seq40,seq70,r_100_14_54,0.83,4,58,54,93
16,r_21_98_31,seq128,seq7,r_21_98_31,0.85,2,33,31,93
22,r_87_27_93,r_130_77_156,r_147_108_13,r_87_27_93,0.98,0,93,93,93
28,r_123_53_84,seq6,seq16,r_123_53_84,0.97,0,84,84,93
9,r_58_148_17,seq68,seq128,r_58_148_17,0.76,9,26,17,93
4,r_73_26_33,r_49_28_180,r_41_101_116,r_73_26_33,1.0,0,33,33,93
56,seq9,r_61_12_145,r_147_108_13,r_61_12_145,0.56,-58,87,145,93
44,r_132_67_76,r_96_124_111,seq9,r_132_67_76,0.83,0,76,76,93
35,r_46_64_120,seq72,r_129_15_39,r_46_64_120,0.86,0,120,120,93
22,r_2_50_44,seq115,seq118,r_2_50_44,1.0,0,44,44,94
30,r_7_97_65,r_75_127_94,r_106_30_16,r_7_97_65,1.0,0,65,65,94
44,r_4_48_21,r_119_148_114,r_39_47_85,r_4_48_21,0.66,65,86,21,94
36,r_98_40_183,r_87_90_100,r_79_70_86,r_98_40_183,0.96,-95,88,183,94
92,seq100,r_120_149_145,r_119_148_114,r_119_148_114,1.0,39,153,114,94
14,r_75_127_94,r_7_97_65,seq57,r_7_97_65,0.93,0,65,65,94
8,r_73_144_173,r_91_94_99,r_123_101_8,r_73_144_173,0.5,-74,99,173,94
54,seq6,seq11,r_91_94_99,r_91_94_99,0.91,1,100,99,94
37,r_95_68_92,r_143_69_135,seq131,r_95_68_92,1.0,0,92,92,94
5,r_106_30_16,r_66_36_29,seq93,r_106_30_16,0.98,0,16,16,94
19,r_79_70_86,r_98_40_183,seq110,r_98_40_183,0.93,0,183,183,94
86,seq82,r_122_46_150,r_80_52_50,r_80_52_50,1.0,102,152,50,94
16,r_1_8_121,seq65,r_114_81_117,r_1_8_121,0.49,20,141,121,94
21,r_87_90_100,seq110,seq130,r_87_90_100,1.0,1,101,100,94
39,r_112_96_185,seq138,r_39_47_85,r_39_47_85,0.69,102,187,85,94
34,r_109_103_42,seq5,seq115,r_109_103_42,1.0,0,42,42,94
1,r_59_137_115,seq88,seq93,r_59_137_115,0.99,0,115,115,94
46,r_120_149_145,seq100,r_26_86_134,r_26_86_134,0.95,19,153,134,94
42,r_104_146_74,r_122_46_150,seq136,r_104_146_74,1.0,0,74,74,94
9,r_66_36_29,r_119_148_114,seq140,r_66_36_29,1.0,2,31,29,94
45,r_124_38_177,r_55_74_2,r_67_63_141,r_124_38_177,0.38,2,179,177,94
19,r_79_70_86,seq44,r_98_40_183,r_79_70_86,0.91,3,89,86,94
15,r_27_72_31,r_1_8_121,r_58_14_129,r_27_72_31,0.87,90,121,31,94
66,seq20,r_78_62_176,r_75_127_94,r_75_127_94,1.0,62,156,94,94
89,seq88,r_37_32_97,r_123_101_8,r_37_32_97,0.9,0,97,97,94
3,r_39_47_85,r_3_42_80,seq57,r_39_47_85,0.6,-24,61,85,94
5,r_106_30_16,seq93,r_7_97_65,r_7_97_65,1.0,3,68,65,94
10,r_28_25_108,seq115,seq129,r_28_25_108,0.94,0,108,108,94
90,seq93,seq136,r_59_137_115,r_59_137_115,1.0,0,115,115,94
44,r_4_48_21,seq24,r_119_148_114,r_4_48_21,0.99,1,22,21,94
26,r_18_107_73,r_43_135_68,r_66_36_29,r_18_107_73,0.97,0,73,73,94
8,r_73_144_173,r_123_101_8,r_39_47_85,r_123_101_8,0.55,168,176,8,94
13,r_117_56_131,seq11,seq82,r_117_56_131,0.59,0,131,131,94
4,r_67_63_141,r_123_101_8,r_109_103_42,r_67_63_141,0.83,0,141,141,94
18,r_119_148_114,r_66_36_29,r_4_48_21,r_119_148_114,0.86,-83,31,114,94
6,r_3_42_80,r_39_47_85,seq24,r_3_42_80,1.0,0,80,80,94
62,seq15,r_43_135_68,r_114_81_117,r_43_135_68,0.79,5,73,68,94
81,seq61,r_91_94_99,r_123_101_8,r_123_101_8,0.49,20,28,8,94
4,r_67_63_141,r_91_94_99,r_123_101_8,r_123_101_8,0.37,20,28,8,94
28,r_23_89_13,seq34,seq21,r_23_89_13,0.86,0,13,13,94
36,r_98_40_183,r_79_70_86,r_2_50_44,r_79_70_86,0.45,97,183,86,94
27,r_105_35_140,seq12,r_119_148_114,r_105_35_140,0.9,1,141,140,94
3,r_39_47_85,seq57,r_4_48_21,r_39_47_85,0.95,0,85,85,94
2,r_143_69_135,r_95_68_92,seq141,r_95_68_92,1.0,0,92,92,94
47,r_43_135_68,seq15,r_119_148_114,r_43_135_68,0.82,5,73,68,94
40,r_78_62_176,seq20,r_39_47_85,r_78_62_176,0.34,0,176,176,94
74,seq44,r_79_70_86,seq85,r_79_70_86,1.0,3,89,86,94
29,r_13_60_78,seq33,r_104_146_74,r_13_60_78,0.73,1,79,78,94
25,r_26_86_134,seq22,r_95_68_92,r_26_86_134,0.69,0,134,134,94
33,r_132_29_138,seq111,seq61,r_132_29_138,0.79,1,139,138,94
58,seq11,r_117_56_131,r_102_10_64,r_102_10_64,0.76,3,67,64,94
47,r_43_135_68,r_119_148_114,r_39_47_85,r_119_148_114,0.85,0,114,114,94
20,r_123_101_8,r_67_63_141,r_132_29_138,r_123_101_8,0.96,133,141,8,94
32,r_37_32_97,r_59_137_115,r_71_0_4,r_37_32_97,0.93,0,97,97,94
38,r_102_10_64,r_79_70_86,seq11,r_102_10_64,1.0,1,65,64,94
41,r_80_52_50,seq136,seq82,r_80_52_50,1.0,0,50,50,94
14,r_75_127_94,seq57,seq99,r_75_127_94,0.93,-5,89,94,94
15,r_27_72_31,r_120_149_145,r_1_8_121,r_27_72_31,1.0,0,31,31,94
31,r_92_134_43,r_104_146_74,seq41,r_104_146_74,0.97,-29,45,74,94
17,r_71_0_4,r_1_8_121,r_37_32_97,r_71_0_4,0.78,117,121,4,94
49,r_139_17_104,r_55_74_2,seq12,r_139_17_104,0.89,0,104,104,94
18,r_119_148_114,r_4_48_21,seq100,r_119_148_114,0.9,0,114,114,94
12,r_84_77_199,seq93,r_87_90_100,r_87_90_100,1.0,27,127,100,94
30,r_77_25_73,r_132_70_152,seq41,r_77_25_73,0.77,0,73,73,95
51,seq1,r_108_104_184,r_113_80_187,r_108_104_184,0.71,0,184,184,95
36,r_45_28_80,r_131_62_75,r_33_122_171,r_45_28_80,1.0,0,80,80,95
9,r_3_54_8,r_85_55_76,r_149_2_25,r_85_55_76,0.79,1,77,76,95
8,r_40_97_81,r_124_50_115,r_49_48_181,r_40_97_81,0.96,1,82,81,95
46,r_92_114_43,r_8_42_92,seq102,r_92_114_43,1.0,-1,42,43,95
49,r_58_135_59,r_72_38_198,r_10_75_102,r_10_75_102,1.0,0,102,102,95
35,r_85_55_76,r_137_100_27,r_3_54_8,r_85_55_76,0.85,-66,10,76,95
37,r_98_127_110,seq147,r_64_57_24,r_98_127_110,1.0,0,110,110,95
28,r_149_2_25,seq63,seq12,r_149_2_25,1.0,-1,24,25,95
16,r_72_38_198,r_113_80_187,r_58_135_59,r_58_135_59,1.0,20,79,59,95
21,r_11_111_108,r_78_88_133,r_45_28_80,r_11_111_108,0.93,0,108,108,95
1,r_113_80_187,seq52,r_33_122_171,r_33_122_171,0.78,18,189,171,95
45,r_139_74_125,seq6,r_93_107_5,r_139_74_125,0.86,0,125,125,95
66,seq20,r_27_26_90,seq1,r_27_26_90,0.98,2,92,90,95
76,seq52,r_113_80_187,r_10_75_102,r_10_75_102,1.0,48,150,102,95
31,r_108_104_184,seq1,seq145,r_108_104_184,0.57,0,184,184,95
41,r_30_37_109,seq91,seq52,r_30_37_109,1.0,0,109,109,95
3,r_34_90_135,seq53,r_99_65_199,r_34_90_135,0.94,0,135,135,95
10,r_78_88_133,seq103,r_27_26_90,r_78_88_133,0.72,0,133,133,95
39,r_66_14_10,r_40_97_81,r_89_105_136,r_66_14_10,0.87,0,10,10,95
26,r_99_65_199,r_84_117_65,r_108_104_184,r_99_65_199,0.53,-135,64,199,95
8,r_40_97_81,r_49_48_181,r_47_4_146,r_47_4_146,0.81,0,146,146,95
0,r_140_5_103,seq145,r_66_14_10,r_140_5_103,0.99,0,103,103,95
29,r_60_83_34,r_98_127_110,r_64_57_24,r_64_57_24,0.5,10,34,24,95
11,r_32_29_106,r_124_50_115,r_77_25_73,r_32_29_106,0.5,3,109,106,95
13,r_22_101_97,r_98_127_110,r_60_83_34,r_60_83_34,0.82,66,100,34,95
15,r_33_122_171,seq142,seq1,r_33_122_171,0.39,0,171,171,95
48,r_43_9_91,seq21,seq147,r_43_9_91,0.95,0,91,91,95
6,r_143_95_173,seq87,r_40_97_81,r_143_95_173,0.5,0,173,173,95
14,r_61_125_11,r_140_5_103,seq15,r_61_125_11,0.74,0,11,11,95
74,seq44,r_27_26_90,r_18_126_167,r_18_126_167,1.0,3,170,167,95
36,r_45_28_80,r_33_122_171,r_11_111_108,r_11_111_108,0.82,63,171,108,95
27,r_8_42_92,seq44,seq21,r_8_42_92,1.0,1,93,92,95
7,r_120_17_41,seq41,seq67,r_120_17_41,0.99,0,41,41,95
2,r_10_75_102,seq36,r_58_135_59,r_10_75_102,1.0,0,102,102,95
40,r_18_126_167,seq31,seq44,r_18_126_167,0.79,0,167,167,95
92,seq102,r_119_112_122,r_92_114_43,r_92_114_43,0.65,0,43,43,95
24,r_96_129_78,r_47_4_146,r_89_105_136,r_96_129_78,1.0,1,79,78,95
18,r_116_148_19,r_140_5_103,seq31,r_116_148_19,1.0,0,19,19,95
35,r_85_55_76,r_3_54_8,seq31,r_85_55_76,1.0,1,77,76,95
25,r_27_26_90,seq20,r_149_2_25,r_27_26_90,1.0,2,92,90,95
43,r_13_35_128,r_3_54_8,seq1,r_13_35_128,0.98,-1,127,128,95
33,r_132_70_152,r_108_104_184,seq142,r_132_70_152,0.5,1,153,152,95
88,seq87,r_143_95_173,seq94,r_143_95_173,0.97,-78,95,173,95
38,r_51_79_130,r_47_4_146,seq102,r_51_79_130,0.86,2,132,130,95
52,seq130,seq81,r_131_62_75,r_131_62_75,1.0,32,107,75,95
77,seq53,r_34_90_135,seq133,r_34_90_135,1.0,0,135,135,95
47,r_137_100_27,r_85_55_76,r_123_39_23,r_137_100_27,1.0,0,27,27,95
34,r_119_112_122,seq102,r_123_39_23,r_119_112_122,0.99,0,122,122,95
17,r_131_62_75,r_45_28_80,seq130,r_131_62_75,1.0,0,75,75,95
26,r_99_65_199,r_108_104_184,r_34_90_135,r_34_90_135,0.74,10,145,135,95
19,r_124_50_115,r_40_97_81,r_60_83_34,r_124_50_115,1.0,-82,33,115,95
28,r_149_2_25,seq12,r_27_26_90,r_27_26_90,1.0,8,98,90,95
22,r_49_48_181,r_89_105_136,r_131_62_75,r_131_62_75,0.81,107,182,75,95
4,r_64_57_24,r_113_80_187,r_60_83_34,r_60_83_34,0.99,-1,33,34,95
49,r_58_135_59,r_96_129_78,r_72_38_198,r_58_135_59,1.0,0,59,59,95
12,r_84_117_65,r_99_65_199,r_60_83_34,r_60_83_34,0.93,28,62,34,95
30,r_88_129_170,r_114_118_136,r_32_94_63,r_88_129_170,0.51,-34,136,170,96
30,r_88_129_170,r_32_94_63,r_50_7_68,r_88_129_170,0.85,0,170,170,96
14,r_59_107_89,seq52,seq112,r_59_107_89,1.0,0,89,89,96
8,r_24_42_118,r_82_144_169,r_128_39_8,r_24_42_118,0.66,1,119,118,96
43,r_75_125_120,r_105_15_7,r_134_11_88,r_105_15_7,1.0,113,120,7,96
36,r_137_89_18,r_109_64_197,seq9,r_137_89_18,0.6,0,18,18,96
25,r_14_69_55,seq119,seq138,r_14_69_55,0.97,0,55,55,96
86,seq92,r_82_144_169,r_0_54_76,r_0_54_76,0.73,93,169,76,96
16,r_80_123_198,r_16_140_91,r_62_122_92,r_80_123_198,0.66,-106,92,198,96
21,r_98_58_2,r_40_115_113,r_146_86_105,r_98_58_2,0.95,111,113,2,96
39,r_3_104_125,r_106_35_132,seq119,r_3_104_125,0.6,0,125,125,96
22,r_31_139_34,r_40_115_113,seq124,r_31_139_34,1.0,1,35,34,96
42,r_13_27_99,r_84_96_151,r_66_131_60,r_13_27_99,1.0,0,99,99,96
33,r_55_149_38,r_16_140_91,seq48,r_55_149_38,1.0,0,38,38,96
69,seq46,r_73_44_164,r_0_54_76,r_0_54_76,0.92,74,150,76,96
31,r_84_96_151,seq48,r_117_17_128,r_84_96_151,0.55,1,152,151,96
41,r_142_18_138,seq48,r_10_85_75,r_142_18_138,0.87,1,139,138,96
46,r_74_45_21,r_31_139_34,seq8,r_74_45_21,1.0,0,21,21,96
10,r_5_49_135,seq38,seq36,r_5_49_135,0.75,0,135,135,96
26,r_2_143_79,seq9,seq61,r_2_143_79,1.0,0,79,79,96
4,r_114_118_136,r_88_129_170,r_31_139_34,r_31_139_34,0.76,102,136,34,96
0,r_16_140_91,r_146_86_105,r_105_15_7,r_146_86_105,0.94,-13,92,105,96
63,seq30,seq101,r_0_54_76,r_0_54_76,1.0,9,85,76,96
11,r_56_12_158,seq124,r_43_132_36,r_43_132_36,0.99,124,160,36,96
20,r_62_122_92,seq138,r_80_123_198,r_62_122_92,0.79,2,94,92,96
13,r_146_86_105,r_80_123_198,r_98_58_2,r_146_86_105,1.0,0,105,105,96
15,r_50_7_68,seq70,r_109_64_197,r_50_7_68,1.0,0,68,68,96
48,r_102_83_175,seq67,r_0_54_76,r_0_54_76,0.64,100,176,76,96
49,r_10_85_75,r_113_25_131,r_142_18_138,r_142_18_138,0.59,0,138,138,96
12,r_32_94_63,r_88_129_170,r_113_25_131,r_113_25_131,1.0,39,170,131,96
6,r_0_54_76,r_114_118_136,seq30,r_0_54_76,0.96,1,77,76,96
27,r_81_72_53,r_47_91_186,r_0_54_76,r_0_54_76,0.96,105,181,76,96
2,r_47_91_186,r_81_72_53,r_50_7_68,r_50_7_68,1.0,118,186,68,96
47,r_40_115_113,r_98_58_2,r_128_39_8,r_40_115_113,0.97,0,113,113,96
29,r_99_93_124,seq70,r_0_54_76,r_0_54_76,0.99,54,130,76,96
24,r_105_15_7,r_75_125_120,r_16_140_91,r_75_125_120,0.8,0,120,120,96
58,seq21,r_113_25_131,r_10_85_75,r_10_85_75,0.78,-2,73,75,96
65,seq36,seq29,r_5_49_135,r_5_49_135,1.0,3,138,135,96
32,r_120_6_70,r_146_86_105,r_14_69_55,r_146_86_105,0.82,-34,71,105,96
17,r_66_131_60,seq70,seq77,r_66_131_60,1.0,0,60,60,96
9,r_113_25_131,seq21,r_32_94_63,r_113_25_131,0.54,5,136,131,96
96,seq119,r_90_33_146,r_3_104_125,r_90_33_146,0.66,0,146,146,96
28,r_109_64_197,r_148_23_144,r_50_7_68,r_109_64_197,0.69,-124,73,197,96
49,r_10_85_75,r_75_125_120,r_113_25_131,r_10_85_75,0.76,1,76,75,96
44,r_106_35_132,r_3_104_125,r_43_132_36,r_43_132_36,0.99,102,138,36,96
23,r_73_44_164,seq46,r_114_118_136,r_114_118_136,0.56,30,166,136,96
34,r_43_132_36,r_5_49_135,seq79,r_43_132_36,1.0,0,36,36,96
35,r_148_23_144,r_109_64_197,r_5_49_135,r_5_49_135,0.87,12,147,135,96
12,r_32_94_63,seq119,r_88_129_170,r_32_94_63,0.76,0,63,63,96
30,r_120_12_48,r_100_45_113,r_85_41_41,r_120_12_48,0.98,65,113,48,97
8,r_97_64_70,r_61_91_177,r_149_124_189,r_97_64_70,0.96,1,71,70,97
43,r_79_126_89,seq15,seq130,r_79_126_89,0.86,3,92,89,97
66,seq40,seq137,r_103_56_31,r_103_56_31,1.0,10,41,31,97
16,r_138_141_69,r_58_28_106,r_61_91_177,r_138_141_69,0.53,2,71,69,97
21,r_5_145_198,r_72_121_110,r_0_31_159,r_72_121_110,1.0,0,110,110,97
39,r_72_121_110,r_5_145_198,seq76,r_72_121_110,1.0,0,110,110,97
1,r_58_28_106,r_0_31_159,seq26,r_58_28_106,1.0,1,107,106,97
46,r_2_81_90,r_86_142_153,r_120_12_48,r_2_81_90,0.97,0,90,90,97
69,seq46,r_57_129_117,r_37_95_39,r_37_95_39,0.94,61,100,39,97
19,r_86_142_153,seq74,r_5_145_198,r_86_142_153,0.7,1,154,153,97
75,seq66,r_86_142_153,r_73_108_13,r_73_108_13,0.57,0,13,13,97
95,seq114,r_0_31_159,r_39_54_128,r_39_54_128,1.0,41,169,128,97
76,seq74,r_86_142_153,r_134_52_115,r_134_52_115,0.92,40,155,115,97
2,r_103_56_31,r_5_145_198,seq40,r_103_56_31,1.0,1,32,31,97
41,r_33_110_124,seq21,r_73_108_13,r_33_110_124,1.0,1,125,124,97
18,r_116_65_172,r_38_133_118,seq32,r_116_65_172,0.75,0,172,172,97
45,r_94_59_21,seq137,seq44,r_94_59_21,0.99,0,21,21,97
46,r_2_81_90,r_120_12_48,r_30_148_142,r_30_148_142,0.99,0,142,142,97
8,r_97_64_70,r_149_124_189,r_83_135_85,r_97_64_70,0.88,70,140,70,97
16,r_138_141_69,r_61_91_177,seq76,r_138_141_69,0.62,108,177,69,97
4,r_83_135_85,r_100_45_113,r_97_64_70,r_83_135_85,1.0,0,85,85,97
11,r_53_117_82,r_38_133_118,seq44,r_38_133_118,0.9,-32,86,118,97
3,r_73_108_13,r_30_148_142,seq66,r_73_108_13,0.93,0,13,13,97
37,r_47_4_44,r_2_81_90,r_43_18_19,r_47_4_44,0.99,2,46,44,97
20,r_7_68_187,seq74,seq44,r_7_68_187,0.48,0,187,187,97
13,r_87_93_114,seq132,r_57_129_117,r_87_93_114,1.0,0,114,114,97
33,r_85_41_41,seq62,r_43_18_19,r_85_41_41,1.0,0,41,41,97
15,r_100_45_113,r_120_12_48,r_22_55_28,r_100_45_113,0.99,0,113,113,97
48,r_61_91_177,r_97_64_70,r_138_141_69,r_61_91_177,1.0,-106,71,177,97
26,r_122_67_26,r_58_28_106,seq23,r_122_67_26,0.93,-6,20,26,97
27,r_131_36_112,seq44,r_79_126_89,r_131_36_112,1.0,0,112,112,97
7,r_38_133_118,r_120_12_48,seq111,r_38_133_118,0.95,0,118,118,97
28,r_37_95_39,r_116_65_172,seq46,r_37_95_39,1.0,1,40,39,97
40,r_134_52_115,r_120_12_48,r_128_105_3,r_134_52_115,0.98,0,115,115,97
18,r_116_65_172,r_149_124_189,r_38_133_118,r_38_133_118,1.0,35,153,118,97
24,r_136_82_137,r_8_27_143,seq132,r_136_82_137,0.66,6,143,137,97
48,r_61_91_177,r_138_141_69,r_39_54_128,r_39_54_128,0.93,49,177,128,97
68,seq44,r_131_36_112,r_53_117_82,r_131_36_112,0.55,0,112,112,97
42,r_22_55_28,seq3,r_100_45_113,r_100_45_113,1.0,1,114,113,97
0,r_115_6_37,seq99,seq127,r_115_6_37,0.95,1,38,37,97
60,seq21,r_33_110_124,r_0_31_159,r_33_110_124,1.0,1,125,124,97
17,r_39_54_128,seq66,seq114,r_39_54_128,0.87,0,128,128,97
61,seq23,r_8_27_143,r_122_67_26,r_122_67_26,0.96,-6,20,26,97
25,r_119_29_35,r_58_28_106,seq99,r_119_29_35,0.56,0,35,35,97
22,r_57_129_117,seq46,r_87_93_114,r_87_93_114,0.99,5,119,114,97
7,r_38_133_118,r_53_117_82,r_120_12_48,r_38_133_118,0.72,-32,86,118,97
44,r_128_105_3,r_86_142_153,r_134_52_115,r_134_52_115,0.89,-1,114,115,97
23,r_140_106_133,seq113,r_43_18_19,r_140_106_133,0.94,2,135,133,97
42,r_22_55_28,seq17,seq3,r_22_55_28,0.83,1,29,28,97
88,seq99,r_115_6_37,r_119_29_35,r_119_29_35,0.82,3,38,35,97
35,r_0_31_159,r_58_28_106,r_120_12_48,r_58_28_106,1.0,-6,100,106,97
31,r_43_18_19,r_86_142_153,r_120_12_48,r_43_18_19,1.0,0,19,19,97
38,r_143_51_56,r_5_145_198,seq60,r_143_51_56,0.97,1,57,56,97
15,r_3_98_155,r_37_39_102,seq59,r_3_98_155,0.64,8,163,155,98
33,r_62_15_44,seq111,seq56,r_62_15_44,0.97,1,45,44,98
30,r_106_63_82,r_110_55_179,seq79,r_106_63_82,0.98,1,83,82,98
51,seq131,r_20_76_175,r_128_29_98,r_128_29_98,1.0,20,118,98,98
36,r_92_108_121,r_12_126_197,r_142_80_110,r_92_108_121,0.93,0,121,121,98
14,r_93_28_147,r_147_90_109,r_129_11_103,r_93_28_147,0.58,-49,98,147,98
8,r_64_144_164,seq81,r_78_22_81,r_64_144_164,0.55,2,166,164,98
46,r_110_55_179,r_57_96_39,r_91_43_14,r_110_55_179,0.89,-164,15,179,98
16,r_136_38_10,r_50_67_137,seq56,r_136_38_10,0.61,0,10,10,98
83,seq85,r_140_33_173,seq141,r_140_33_173,0.76,3,176,173,98
37,r_128_29_98,seq120,seq131,r_128_29_98,1.0,2,100,98,98
59,seq145,r_5_31_158,r_30_71_64,r_30_71_64,0.66,-3,61,64,98
31,r_25_42_21,r_48_119_115,seq81,r_25_42_21,0.93,-6,15,21,98
80,seq79,seq56,r_106_63_82,r_106_63_82,1.0,5,87,82,98
45,r_74_86_108,seq49,r_18_69_105,r_74_86_108,0.93,2,110,108,98
72,seq53,r_36_24_45,seq138,r_36_24_45,0.91,2,47,45,98
11,r_91_43_14,r_110_55_179,r_84_137_76,r_84_137_76,1.0,104,180,76,98
11,r_91_43_14,r_3_98_155,r_110_55_179,r_91_43_14,0.94,1,15,14,98
76,seq65,r_61_14_150,r_57_96_39,r_57_96_39,0.66,115,154,39,98
89,seq104,r_0_13_59,seq59,r_0_13_59,1.0,1,60,59,98
52,seq4,seq101,r_17_45_8,r_17_45_8,1.0,3,11,8,98
3,r_37_39_102,r_116_149_176,r_2_82_58,r_116_149_176,0.86,-74,102,176,98
10,r_84_137_76,r_116_149_176,r_1_9_35,r_116_149_176,0.65,-99,77,176,98
90,seq111,seq123,r_2_82_58,r_2_82_58,0.93,7,65,58,98
20,r_95_16_50,seq145,r_139_10_89,r_139_10_89,0.54,6,95,89,98
26,r_30_71_64,seq143,seq145,r_30_71_64,0.98,4,68,64,98
0,r_48_119_115,seq148,r_27_75_17,r_48_119_115,0.99,0,115,115,98
29,r_2_82_58,r_50_67_137,seq111,r_2_82_58,1.0,1,59,58,98
73,seq56,r_136_38_10,r_41_47_97,r_41_47_97,1.0,3,100,97,98
46,r_110_55_179,r_91_43_14,r_64_144_164,r_110_55_179,0.45,1,180,179,98
15,r_3_98_155,r_127_89_138,r_37_39_102,r_3_98_155,0.52,-17,138,155,98
13,r_1_9_35,r_41_47_97,r_70_7_119,r_1_9_35,1.0,2,37,35,98
57,seq141,seq112,r_147_90_109,r_147_90_109,1.0,-4,105,109,98
13,r_1_9_35,r_70_7_119,r_84_137_76,r_1_9_35,0.97,87,122,35,98
6,r_70_7_119,seq72,r_136_38_10,r_70_7_119,0.78,3,122,119,98
62,seq148,r_48_119_115,seq77,r_48_119_115,1.0,2,117,115,98
1,r_129_11_103,r_93_28_147,seq134,r_93_28_147,0.97,-9,138,147,98
27,r_139_10_89,seq51,r_95_16_50,r_139_10_89,0.99,6,95,89,98
34,r_36_24_45,seq53,r_25_42_21,r_36_24_45,0.96,2,47,45,98
14,r_93_28_147,r_129_11_103,r_92_108_121,r_93_28_147,1.0,3,150,147,98
2,r_41_47_97,r_107_100_142,seq56,r_41_47_97,0.99,0,97,97,98
43,r_27_75_17,seq56,seq97,r_27_75_17,0.98,2,19,17,98
40,r_140_33_173,seq85,r_68_58_62,r_68_58_62,0.75,124,186,62,98
18,r_44_26_104,seq46,seq112,r_44_26_104,1.0,0,104,104,98
24,r_127_89_138,r_3_98_155,seq148,r_127_89_138,0.89,0,138,138,98
25,r_61_14_150,seq65,r_127_89_138,r_61_14_150,0.69,4,154,150,98
20,r_95_16_50,r_70_7_119,seq145,r_95_16_50,0.75,0,50,50,98
47,r_5_31_158,r_95_16_50,r_129_11_103,r_5_31_158,0.84,1,159,158,98
38,r_20_76_175,seq131,r_18_69_105,r_18_69_105,0.79,70,175,105,98
17,r_147_90_109,r_93_28_147,seq141,r_147_90_109,1.0,0,109,109,98
5,r_57_96_39,r_44_26_104,seq65,r_57_96_39,0.96,2,41,39,98
9,r_107_100_142,seq21,seq135,r_107_100_142,0.75,0,142,142,98
47,r_5_31_158,seq145,r_95_16_50,r_95_16_50,0.97,-1,49,50,98
12,r_0_13_59,seq104,seq143,r_0_13_59,1.0,0,59,59,98
23,r_94_87_30,r_92_108_121,seq143,r_94_87_30,0.96,0,30,30,98
28,r_132_23_162,seq131,seq59,r_132_23_162,0.67,-1,161,162,98
91,seq112,seq141,r_44_26_104,r_44_26_104,1.0,1,105,104,98
7,r_68_58_62,r_93_28_147,seq120,r_68_58_62,1.0,2,64,62,98
44,r_142_80_110,seq131,r_66_54_16,r_142_80_110,0.62,0,110,110,98
22,r_8_102_29,r_147_90_109,seq101,r_8_102_29,0.98,0,29,29,98
35,r_18_69_105,r_110_55_179,r_12_126_197,r_18_69_105,0.98,6,111,105,98
93,seq114,r_38_79_85,seq111,r_38_79_85,1.0,1,86,85,99
30,r_56_11_184,r_12_34_103,r_13_149_13,r_12_34_103,0.53,-9,94,103,99
4,r_92_47_29,r_136_6_128,seq42,r_92_47_29,1.0,0,29,29,99
36,r_131_31_61,r_59_95_70,r_109_62_38,r_131_31_61,1.0,0,61,61,99
8,r_124_105_102,r_21_76_115,r_135_4_7,r_21_76_115,0.78,-8,107,115,99
43,r_3_20_96,r_121_97_181,seq27,r_3_20_96,0.94,0,96,96,99
37,r_23_127_75,seq74,r_140_133_64,r_23_127_75,0.84,0,75,75,99
16,r_0_148_95,r_112_54_175,r_53_75_23,r_0_148_95,0.96,6,101,95,99
21,r_17_108_147,seq27,r_80_33_190,r_17_108_147,0.75,1,148,147,99
5,r_142_35_65,seq126,seq10,r_142_35_65,1.0,0,65,65,99
45,r_139_107_94,seq1,seq45,r_139_107_94,0.99,1,95,94,99
19,r_36_68_156,r_125_143_5,r_21_76_115,r_125_143_5,0.9,151,156,5,99
29,r_109_62_38,r_121_97_181,seq5,r_109_62_38,0.99,0,38,38,99
76,seq67,r_24_137_81,r_87_115_51,r_24_137_81,0.88,0,81,81,99
41,r_38_79_85,seq114,seq101,r_38_79_85,1.0,0,85,85,99
42,r_29_50_52,r_59_95_70,seq44,r_29_50_52,0.98,2,54,52,99
24,r_86_145_21,r_89_110_192,seq123,r_86_145_21,0.98,0,21,21,99
26,r_119_48_4,r_96_70_154,r_90_116_110,r_90_116_110,0.99,44,154,110,99
78,seq73,r_12_34_103,r_146_30_76,r_12_34_103,0.59,0,103,103,99
11,r_37_81_145,r_91_8_127,seq41,r_37_81_145,0.62,-5,140,145,99
46,r_87_115_51,r_49_32_170,r_122_52_19,r_87_115_51,0.97,1,52,51,99
20,r_49_32_170,seq18,r_60_99_123,r_49_32_170,0.78,0,170,170,99
13,r_24_137_81,seq67,seq94,r_24_137_81,1.0,0,81,81,99
48,r_128_98_69,r_59_95_70,r_139_107_94,r_59_95_70,0.85,25,95,70,99
4,r_92_47_29,seq42,r_66_25_131,r_66_25_131,1.0,14,145,131,99
12,r_90_116_110,seq41,r_109_62_38,r_90_116_110,1.0,0,110,110,99
31,r_13_149_13,r_140_133_64,seq73,r_13_149_13,0.96,0,13,13,99
0,r_122_52_19,r_3_20_96,r_87_115_51,r_3_20_96,1.0,0,96,96,99
30,r_56_11_184,r_13_149_13,r_84_65_67,r_56_11_184,0.62,2,186,184,99
2,r_59_95_70,r_131_31_61,seq130,r_59_95_70,1.0,0,70,70,99
41,r_38_79_85,seq101,r_22_14_118,r_22_14_118,0.73,56,174,118,99
47,r_129_26_62,seq40,r_80_33_190,r_129_26_62,1.0,0,62,62,99
40,r_91_8_127,r_37_81_145,r_102_71_117,r_102_71_117,1.0,11,128,117,99
18,r_21_76_115,r_124_105_102,r_140_133_64,r_124_105_102,1.0,13,115,102,99
10,r_53_75_23,r_90_116_110,seq73,r_53_75_23,0.99,-1,22,23,99
33,r_140_133_64,r_124_105_102,r_29_50_52,r_140_133_64,1.0,0,64,64,99
12,r_90_116_110,r_141_28_31,seq41,r_141_28_31,0.91,1,32,31,99
88,seq101,r_64_16_164,seq55,r_64_16_164,1.0,4,168,164,99
58,seq144,r_2_78_182,r_60_99_123,r_60_99_123,0.72,-13,110,123,99
0,r_122_52_19,seq19,r_3_20_96,r_122_52_19,1.0,0,19,19,99
68,seq45,r_121_97_181,r_128_98_69,r_128_98_69,0.47,0,69,69,99
61,seq27,r_60_99_123,r_3_20_96,r_3_20_96,1.0,45,141,96,99
10,r_53_75_23,seq73,r_0_148_95,r_53_75_23,0.59,53,76,23,99
34,r_96_70_154,r_112_54_175,seq130,r_96_70_154,0.72,0,154,154,99
68,seq45,r_128_98_69,r_139_107_94,r_139_107_94,1.0,0,94,94,99
9,r_12_34_103,r_56_11_184,r_87_115_51,r_12_34_103,1.0,0,103,103,99
14,r_141_28_31,r_90_116_110,r_122_52_19,r_90_116_110,0.85,-79,31,110,99
31,r_13_149_13,seq73,r_69_104_121,r_69_104_121,1.0,34,155,121,99
22,r_22_14_118,seq134,r_141_28_31,r_22_14_118,1.0,0,118,118,99
28,r_84_65_67,r_38_79_85,seq134,r_84_65_67,0.96,3,70,67,99
91,seq111,r_146_30_76,r_60_99_123,r_60_99_123,0.66,-47,76,123,99
74,seq61,r_124_105_102,r_135_4_7,r_135_4_7,0.99,11,18,7,99
49,r_102_71_117,seq94,r_91_8_127,r_102_71_117,1.0,0,117,117,99
7,r_66_25_131,seq61,r_92_47_29,r_66_25_131,0.94,3,134,131,99
44,r_69_104_121,r_121_97_181,r_13_149_13,r_69_104_121,0.6,0,121,121,99
79,seq74,r_23_127_75,seq41,r_23_127_75,1.0,1,76,75,99
35,r_136_6_128,seq77,seq85,r_136_6_128,1.0,1,129,128,99
42,r_29_50_52,seq44,r_140_133_64,r_140_133_64,1.0,8,72,64,99
