36,r_122_143_124,r_81_8_183,seq135,r_122_143_124,0.61,0,124,124,0
14,r_63_77_189,seq132,r_141_140_197,r_141_140_197,0.58,-8,189,197,0
43,r_146_35_162,r_63_77_189,seq28,r_146_35_162,0.73,4,166,162,0
86,seq96,r_81_8_183,r_75_83_135,r_75_83_135,1.0,18,153,135,0
16,r_69_111_157,seq138,seq92,r_69_111_157,0.95,0,157,157,0
21,r_37_112_81,seq102,r_133_97_105,r_37_112_81,1.0,1,82,81,0
39,r_115_148_75,r_37_112_81,seq54,r_115_148_75,1.0,2,77,75,0
1,r_41_44_54,seq95,r_126_39_133,r_126_39_133,0.79,5,138,133,0
1,r_41_44_54,seq66,seq95,r_41_44_54,0.42,9,63,54,0
5,r_27_130_119,seq92,seq110,r_27_130_119,1.0,0,119,119,0
46,r_94_20_122,seq128,seq84,r_94_20_122,1.0,0,122,122,0
42,r_120_88_55,seq96,r_126_39_133,r_120_88_55,0.98,0,55,55,0
0,r_86_0_38,r_108_51_117,r_121_21_84,r_86_0_38,0.81,11,49,38,0
19,r_49_136_114,seq73,r_108_51_117,r_49_136_114,1.0,0,114,114,0
40,r_129_60_28,seq128,r_117_85_30,r_117_85_30,0.99,-1,29,30,0
37,r_76_36_33,r_82_100_57,seq103,r_76_36_33,1.0,0,33,33,0
41,r_93_67_100,seq66,seq102,r_93_67_100,0.95,1,101,100,0
44,r_12_55_136,r_52_22_120,r_16_114_175,r_16_114_175,0.99,0,175,175,0
3,r_4_137_152,seq103,r_33_13_92,r_4_137_152,0.97,0,152,152,0
10,r_109_11_91,seq70,seq110,r_109_11_91,0.96,0,91,91,0
90,seq102,r_37_112_81,r_139_42_45,r_139_42_45,0.92,33,78,45,0
72,seq59,seq28,r_31_48_170,r_31_48_170,0.63,8,178,170,0
86,seq96,r_120_88_55,r_81_8_183,r_120_88_55,1.0,-12,43,55,0
29,r_81_8_183,r_75_83_135,r_89_5_163,r_81_8_183,0.47,1,184,183,0
20,r_75_83_135,r_121_21_84,seq96,r_75_83_135,0.99,0,135,135,0
13,r_82_100_57,r_89_5_163,r_1_99_60,r_1_99_60,0.75,0,60,60,0
15,r_52_22_120,seq10,seq90,r_52_22_120,0.79,0,120,120,0
6,r_25_40_180,seq145,r_4_137_152,r_25_40_180,0.58,0,180,180,0
8,r_58_91_31,r_4_137_152,seq90,r_58_91_31,0.91,1,32,31,0
27,r_89_5_163,seq6,seq17,r_89_5_163,0.81,0,163,163,0
7,r_147_50_40,seq80,seq138,r_147_50_40,1.0,1,41,40,0
47,r_142_29_132,r_81_8_183,r_7_61_199,r_142_29_132,0.91,1,133,132,0
36,r_122_143_124,seq135,seq43,r_122_143_124,0.51,38,162,124,0
74,seq62,r_27_130_119,seq17,r_27_130_119,1.0,-12,107,119,0
18,r_113_149_83,r_31_48_170,seq128,r_113_149_83,1.0,0,83,83,0
29,r_81_8_183,r_12_55_136,r_75_83_135,r_81_8_183,0.57,-47,136,183,0
90,seq102,r_139_42_45,r_93_67_100,r_93_67_100,1.0,1,101,100,0
25,r_31_48_170,seq17,seq59,r_31_48_170,0.84,0,170,170,0
33,r_104_2_159,seq10,r_94_20_122,r_104_2_159,0.56,0,159,159,0
2,r_71_78_20,r_41_44_54,seq72,r_71_78_20,0.99,0,20,20,0
31,r_117_85_30,seq62,r_129_60_28,r_117_85_30,1.0,0,30,30,0
42,r_120_88_55,r_126_39_133,r_49_136_114,r_49_136_114,0.69,17,131,114,0
32,r_106_125_68,seq134,seq66,r_106_125_68,0.6,1,69,68,0
38,r_121_21_84,r_75_83_135,r_86_0_38,r_75_83_135,0.93,-31,104,135,0
52,seq132,r_63_77_189,r_69_111_157,r_69_111_157,0.97,32,189,157,0
28,r_65_74_44,r_31_48_170,seq103,r_65_74_44,1.0,1,45,44,0
34,r_32_38_26,seq73,r_26_87_76,r_26_87_76,1.0,0,76,76,0
81,seq80,r_133_97_105,r_9_124_103,r_9_124_103,1.0,1,104,103,0
17,r_26_87_76,seq134,r_32_38_26,r_26_87_76,0.98,0,76,76,0
94,seq110,seq102,r_109_11_91,r_109_11_91,0.99,2,93,91,0
11,r_139_42_45,r_24_79_139,seq102,r_139_42_45,1.0,0,45,45,0
49,r_9_124_103,seq138,seq80,r_9_124_103,1.0,0,103,103,0
56,seq10,r_104_2_159,r_141_140_197,r_104_2_159,0.93,0,159,159,0
44,r_12_55_136,r_81_8_183,r_52_22_120,r_12_55_136,0.85,0,136,136,0
23,r_108_51_117,seq90,r_49_136_114,r_49_136_114,1.0,11,125,114,0
12,r_33_13_92,seq107,seq134,r_33_13_92,0.43,1,93,92,0
84,seq92,r_27_130_119,seq54,r_27_130_119,1.0,0,119,119,0
36,r_73_58_154,seq20,r_123_126_32,r_73_58_154,0.59,0,154,154,1
0,r_119_130_55,r_6_28_100,seq132,r_119_130_55,1.0,0,55,55,1
22,r_39_38_39,seq51,seq132,r_39_38_39,1.0,0,39,39,1
14,r_127_99_121,r_133_43_3,seq76,r_127_99_121,0.98,0,121,121,1
30,r_44_81_150,r_127_99_121,r_125_9_166,r_125_9_166,0.98,4,170,166,1
43,r_16_41_193,r_5_77_159,r_14_121_189,r_5_77_159,1.0,0,159,159,1
83,seq80,seq47,r_128_75_94,r_128_75_94,0.82,6,100,94,1
37,r_133_43_3,r_127_99_121,r_33_117_84,r_133_43_3,0.8,118,121,3,1
59,seq21,r_129_97_80,seq49,r_129_97_80,1.0,0,80,80,1
48,r_147_90_11,r_17_78_148,seq131,r_147_90_11,0.97,0,11,11,1
21,r_29_15_170,r_7_18_197,r_133_43_3,r_7_18_197,0.56,-26,171,197,1
1,r_6_28_100,seq59,r_137_146_69,r_137_146_69,0.95,36,105,69,1
5,r_70_116_183,seq19,r_119_130_55,r_70_116_183,0.28,1,184,183,1
37,r_133_43_3,r_87_83_139,r_29_15_170,r_133_43_3,0.66,169,172,3,1
69,seq49,r_17_78_148,seq21,r_17_78_148,0.99,1,149,148,1
45,r_123_126_32,r_53_120_196,seq50,r_53_120_196,0.7,-134,62,196,1
23,r_92_32_49,r_96_31_187,r_106_46_6,r_92_32_49,1.0,0,49,49,1
11,r_138_40_35,r_17_78_148,seq24,r_138_40_35,1.0,0,35,35,1
31,r_33_117_84,seq98,seq54,r_33_117_84,1.0,0,84,84,1
37,r_133_43_3,r_33_117_84,r_87_83_139,r_133_43_3,0.72,147,150,3,1
67,seq42,seq79,r_36_141_9,r_36_141_9,0.96,68,77,9,1
10,r_87_83_139,r_144_140_57,r_10_104_26,r_87_83_139,0.98,-78,61,139,1
26,r_45_124_115,seq95,seq62,r_45_124_115,0.87,0,115,115,1
73,seq55,r_115_113_124,seq20,r_115_113_124,0.98,-9,115,124,1
20,r_22_2_146,seq98,r_128_75_94,r_22_2_146,0.98,0,146,146,1
13,r_72_48_140,r_7_18_197,r_33_117_84,r_7_18_197,0.96,-57,140,197,1
15,r_128_75_94,seq131,seq80,r_128_75_94,0.96,0,94,94,1
2,r_10_104_26,r_14_121_189,r_148_23_162,r_10_104_26,0.72,0,26,26,1
46,r_135_136_45,r_92_32_49,r_106_46_6,r_106_46_6,1.0,39,45,6,1
6,r_115_113_124,seq55,r_138_40_35,r_115_113_124,0.91,0,124,124,1
41,r_148_23_162,r_119_130_55,r_10_104_26,r_148_23_162,1.0,-136,26,162,1
10,r_87_83_139,r_10_104_26,r_133_43_3,r_87_83_139,0.99,0,139,139,1
55,seq142,r_112_52_19,r_111_71_142,r_112_52_19,0.63,-4,15,19,1
47,r_69_110_82,r_125_9_166,seq34,r_69_110_82,1.0,0,82,82,1
29,r_96_31_187,seq91,seq94,r_96_31_187,0.3,0,187,187,1
24,r_129_97_80,seq21,seq91,r_129_97_80,1.0,0,80,80,1
18,r_112_52_19,seq142,seq94,r_112_52_19,1.0,0,19,19,1
25,r_0_26_153,seq59,seq47,r_0_26_153,0.67,3,156,153,1
33,r_144_140_57,r_87_83_139,seq11,r_144_140_57,0.73,4,61,57,1
64,seq34,seq64,r_69_110_82,r_69_110_82,1.0,20,102,82,1
58,seq20,r_73_58_154,seq55,r_73_58_154,0.48,0,154,154,1
65,seq35,r_111_71_142,seq56,r_111_71_142,0.97,1,143,142,1
55,seq142,r_111_71_142,r_60_66_60,r_60_66_60,0.99,0,60,60,1
17,r_111_71_142,seq35,r_119_130_55,r_111_71_142,0.88,1,143,142,1
28,r_101_82_65,r_128_75_94,seq3,r_101_82_65,1.0,0,65,65,1
49,r_68_102_90,r_7_18_197,r_10_104_26,r_68_102_90,0.99,0,90,90,1
7,r_17_78_148,seq49,r_60_66_60,r_17_78_148,0.76,1,149,148,1
44,r_145_12_112,r_125_9_166,seq91,r_145_12_112,0.56,4,116,112,1
19,r_67_114_47,r_87_83_139,seq61,r_67_114_47,0.98,0,47,47,1
35,r_5_77_159,r_16_41_193,r_119_130_55,r_16_41_193,0.97,-34,159,193,1
12,r_60_66_60,seq51,seq142,r_60_66_60,1.0,0,60,60,1
51,seq129,r_117_33_157,r_78_30_124,r_78_30_124,1.0,33,157,124,2
45,r_84_83_42,r_125_77_20,r_19_102_6,r_84_83_42,1.0,1,43,42,2
36,r_38_40_74,r_121_81_177,r_96_143_48,r_38_40_74,1.0,0,74,74,2
14,r_75_128_92,seq136,r_119_62_19,r_75_128_92,0.75,2,94,92,2
8,r_47_123_138,seq16,seq133,r_47_123_138,0.94,1,139,138,2
32,r_59_99_45,seq35,r_25_118_39,r_59_99_45,1.0,0,45,45,2
16,r_101_15_127,r_106_146_174,seq34,r_101_15_127,0.96,1,128,127,2
21,r_142_4_114,seq138,seq12,r_142_4_114,0.96,1,115,114,2
39,r_110_103_65,r_68_49_111,r_60_97_99,r_110_103_65,0.94,48,113,65,2
1,r_86_37_112,seq67,seq87,r_86_37_112,0.99,1,113,112,2
97,seq109,r_1_39_194,r_135_65_175,r_1_39_194,0.53,-25,169,194,2
5,r_52_100_87,r_57_122_117,seq148,r_52_100_87,0.75,1,88,87,2
42,r_127_140_165,r_131_73_191,seq12,r_127_140_165,0.55,0,165,165,2
29,r_28_54_35,r_26_92_132,seq66,r_28_54_35,0.59,-2,33,35,2
32,r_59_99_45,r_25_118_39,r_7_6_160,r_7_6_160,0.97,15,175,160,2
19,r_68_49_111,r_110_103_65,r_117_33_157,r_117_33_157,0.54,-44,113,157,2
66,seq148,seq136,r_104_79_89,r_104_79_89,1.0,7,96,89,2
76,seq35,r_134_147_134,seq29,r_134_147_134,1.0,-1,133,134,2
41,r_108_17_83,seq132,seq14,r_108_17_83,0.47,1,84,83,2
3,r_104_79_89,seq18,seq148,r_104_79_89,0.99,0,89,89,2
26,r_113_20_76,r_7_6_160,r_120_42_72,r_113_20_76,0.9,0,76,76,2
73,seq32,r_106_146_174,r_38_40_74,r_38_40_74,1.0,6,80,74,2
11,r_78_30_124,seq13,r_68_49_111,r_78_30_124,0.95,0,124,124,2
20,r_134_147_134,seq35,r_135_65_175,r_134_147_134,0.98,0,134,134,2
13,r_120_42_72,seq53,r_113_20_76,r_120_42_72,0.86,1,73,72,2
15,r_43_48_146,seq107,r_78_30_124,r_43_48_146,0.77,1,147,146,2
48,r_80_95_73,r_125_77_20,seq136,r_80_95_73,1.0,0,73,73,2
49,r_111_71_183,r_60_97_99,r_55_10_25,r_111_71_183,0.45,-1,182,183,2
6,r_45_89_67,r_38_40_74,seq148,r_38_40_74,1.0,0,74,74,2
43,r_119_62_19,seq66,seq61,r_119_62_19,1.0,0,19,19,2
40,r_115_93_107,r_131_73_191,seq5,r_115_93_107,1.0,0,107,107,2
74,seq133,r_91_2_180,r_117_33_157,r_117_33_157,1.0,25,182,157,2
4,r_74_114_43,r_36_144_100,seq66,r_74_114_43,1.0,0,43,43,2
24,r_96_143_48,seq130,seq32,r_96_143_48,0.99,2,50,48,2
25,r_105_149_173,seq11,r_80_95_73,r_80_95_73,1.0,100,173,73,2
19,r_68_49_111,r_117_33_157,r_78_30_124,r_68_49_111,0.7,13,124,111,2
61,seq13,r_78_30_124,seq133,r_78_30_124,1.0,1,125,124,2
83,seq61,r_1_39_194,r_119_62_19,r_119_62_19,1.0,1,20,19,2
31,r_25_118_39,r_106_146_174,r_59_99_45,r_59_99_45,1.0,2,47,45,2
17,r_60_97_99,seq53,r_111_71_183,r_60_97_99,0.91,1,100,99,2
22,r_91_2_180,seq133,r_84_83_42,r_84_83_42,1.0,140,182,42,2
28,r_131_73_191,r_127_140_165,seq0,r_127_140_165,0.59,0,165,165,2
49,r_111_71_183,r_7_6_160,r_60_97_99,r_60_97_99,0.95,-3,96,99,2
56,seq136,r_131_73_191,seq0,r_131_73_191,0.74,-33,158,191,2
7,r_117_33_157,seq129,r_47_123_138,r_117_33_157,0.81,0,157,157,2
44,r_7_6_160,seq63,r_59_99_45,r_59_99_45,0.99,115,160,45,2
23,r_26_92_132,seq34,r_126_41_3,r_26_92_132,0.93,0,132,132,2
17,r_60_97_99,r_111_71_183,seq9,r_111_71_183,0.73,0,183,183,2
75,seq34,r_76_8_4,r_101_15_127,r_101_15_127,1.0,15,142,127,2
79,seq53,r_60_97_99,seq5,r_60_97_99,0.89,1,100,99,2
35,r_70_64_97,r_134_147_134,r_126_41_3,r_70_64_97,1.0,0,97,97,2
27,r_22_112_10,r_47_123_138,seq31,r_22_112_10,0.97,1,11,10,2
30,r_37_14_140,r_65_127_177,seq1,r_37_14_140,0.87,1,141,140,3
8,r_97_146_99,r_106_73_41,seq19,r_97_146_99,1.0,0,99,99,3
21,r_149_92_15,r_87_100_78,seq53,r_149_92_15,1.0,0,15,15,3
83,seq80,r_57_141_134,r_103_31_60,r_103_31_60,0.44,74,134,60,3
37,r_90_61_97,r_86_136_23,r_130_143_6,r_90_61_97,0.94,0,97,97,3
43,r_111_112_48,r_42_33_190,r_93_129_19,r_111_112_48,0.77,-34,14,48,3
59,seq18,r_57_141_134,r_103_31_60,r_103_31_60,0.56,49,109,60,3
16,r_95_104_182,r_115_64_105,r_42_33_190,r_115_64_105,0.95,0,105,105,3
39,r_118_48_81,r_43_72_173,seq147,r_118_48_81,0.87,1,82,81,3
5,r_52_17_92,seq117,r_130_143_6,r_52_17_92,0.74,0,92,92,3
46,r_113_119_103,seq71,seq34,r_113_119_103,0.8,1,104,103,3
42,r_87_100_78,r_20_32_129,seq19,r_20_32_129,0.64,-50,79,129,3
45,r_86_136_23,r_90_61_97,r_94_35_174,r_86_136_23,0.69,74,97,23,3
22,r_93_129_19,r_82_24_165,r_111_112_48,r_93_129_19,0.9,0,19,19,3
95,seq147,seq2,r_118_48_81,r_118_48_81,0.98,70,151,81,3
41,r_109_16_163,seq107,r_123_110_160,r_109_16_163,0.68,0,163,163,3
3,r_116_102_106,seq83,seq55,r_116_102_106,0.94,0,106,106,3
1,r_142_47_30,seq85,r_122_135_8,r_142_47_30,0.94,3,33,30,3
10,r_51_8_137,r_122_135_8,r_106_73_41,r_51_8_137,0.97,0,137,137,3
19,r_60_120_22,r_95_104_182,r_57_141_134,r_60_120_22,0.96,1,23,22,3
26,r_57_141_134,seq80,r_115_64_105,r_57_141_134,0.91,0,134,134,3
4,r_123_110_160,r_52_17_92,r_94_35_174,r_123_110_160,0.65,0,160,160,3
22,r_93_129_19,r_111_112_48,r_140_27_61,r_93_129_19,0.9,40,59,19,3
4,r_123_110_160,r_13_0_123,r_52_17_92,r_13_0_123,0.89,2,125,123,3
78,seq71,r_113_119_103,seq55,r_113_119_103,0.88,1,104,103,3
32,r_94_35_174,r_86_136_23,r_123_110_160,r_123_110_160,1.0,0,160,160,3
20,r_145_36_139,r_42_33_190,r_57_141_134,r_145_36_139,0.88,1,140,139,3
15,r_103_31_60,seq53,r_60_120_22,r_103_31_60,1.0,0,60,60,3
48,r_58_88_76,r_45_76_69,seq79,r_58_88_76,0.95,-2,74,76,3
12,r_130_143_6,r_43_72_173,r_52_17_92,r_130_143_6,0.7,168,174,6,3
6,r_77_128_101,r_94_35_174,seq10,r_77_128_101,0.98,1,102,101,3
43,r_111_112_48,r_11_105_111,r_149_92_15,r_149_92_15,0.52,117,132,15,3
25,r_54_59_34,r_123_110_160,seq39,r_54_59_34,1.0,0,34,34,3
2,r_82_24_165,seq63,r_145_36_139,r_145_36_139,0.67,29,168,139,3
40,r_122_135_8,r_51_8_137,r_142_47_30,r_122_135_8,0.96,129,137,8,3
45,r_86_136_23,r_94_35_174,r_103_31_60,r_86_136_23,0.81,96,119,23,3
33,r_115_64_105,r_95_104_182,seq83,r_115_64_105,0.99,0,105,105,3
32,r_94_35_174,r_77_128_101,r_86_136_23,r_77_128_101,0.44,1,102,101,3
36,r_6_40_42,seq30,seq148,r_6_40_42,1.0,0,42,42,3
19,r_60_120_22,r_57_141_134,r_103_31_60,r_60_120_22,0.87,57,79,22,3
34,r_140_27_61,r_116_102_106,r_93_129_19,r_140_27_61,0.96,3,64,61,3
43,r_111_112_48,r_93_129_19,r_11_105_111,r_111_112_48,0.96,1,49,48,3
28,r_20_32_129,r_87_100_78,r_103_31_60,r_20_32_129,0.82,0,129,129,3
49,r_45_76_69,r_58_88_76,seq131,r_45_76_69,1.0,0,69,69,3
44,r_13_0_123,r_123_110_160,r_6_40_42,r_123_110_160,0.88,-35,125,160,3
63,seq22,r_82_24_165,r_67_126_25,r_67_126_25,0.68,26,51,25,3
35,r_29_96_152,r_132_38_175,seq69,r_132_38_175,0.73,-16,159,175,3
29,r_67_126_25,r_51_8_137,seq83,r_67_126_25,0.99,0,25,25,3
23,r_43_72_173,r_130_143_6,r_144_9_159,r_130_143_6,0.74,168,174,6,3
93,seq112,r_147_106_141,r_68_16_61,r_68_16_61,1.0,39,100,61,4
30,r_75_6_1,r_11_39_117,r_72_101_27,r_11_39_117,1.0,0,117,117,4
44,r_21_44_29,r_53_34_169,seq134,r_53_34_169,0.59,-11,158,169,4
36,r_140_40_67,seq50,seq28,r_140_40_67,1.0,0,67,67,4
14,r_17_49_63,seq145,seq20,r_17_49_63,1.0,1,64,63,4
29,r_32_88_45,r_140_40_67,r_8_66_24,r_32_88_45,0.87,0,45,45,4
8,r_90_59_90,r_12_76_180,r_5_95_18,r_90_59_90,1.0,0,90,90,4
43,r_48_65_59,r_118_109_120,seq57,r_48_65_59,0.97,1,60,59,4
83,seq83,r_126_78_116,r_127_13_92,r_126_78_116,0.96,-16,100,116,4
37,r_11_39_117,r_75_6_1,r_9_132_12,r_11_39_117,1.0,0,117,117,4
13,r_1_2_130,seq128,r_8_66_24,r_1_2_130,0.79,-118,12,130,4
16,r_8_66_24,r_126_78_116,r_1_2_130,r_8_66_24,0.98,1,25,24,4
5,r_27_35_162,seq84,seq134,r_27_35_162,0.84,0,162,162,4
46,r_64_124_149,seq123,r_9_132_12,r_64_124_149,0.56,0,149,149,4
42,r_47_146_179,r_104_55_54,r_17_49_63,r_17_49_63,0.91,116,179,63,4
32,r_149_130_78,r_136_89_164,r_9_132_12,r_136_89_164,1.0,-6,158,164,4
10,r_5_95_18,r_47_146_179,seq10,r_5_95_18,0.95,2,20,18,4
24,r_116_121_13,seq145,r_131_81_122,r_131_81_122,1.0,26,148,122,4
19,r_7_71_68,seq143,seq50,r_7_71_68,0.96,1,69,68,4
58,seq10,seq57,r_91_31_42,r_91_31_42,1.0,12,54,42,4
41,r_125_122_99,seq112,seq70,r_125_122_99,0.71,13,112,99,4
6,r_136_89_164,r_149_130_78,r_144_87_143,r_136_89_164,0.95,0,164,164,4
3,r_120_54_137,seq96,seq148,r_120_54_137,0.49,1,138,137,4
28,r_104_55_54,r_42_107_165,r_47_146_179,r_42_107_165,0.55,-113,52,165,4
16,r_8_66_24,r_1_2_130,r_32_88_45,r_8_66_24,0.87,110,134,24,4
4,r_77_51_138,r_136_89_164,r_100_26_146,r_77_51_138,0.89,0,138,138,4
26,r_92_18_11,r_91_31_42,r_75_6_1,r_91_31_42,0.98,-7,35,42,4
11,r_126_78_116,seq83,seq28,r_126_78_116,1.0,0,116,116,4
20,r_42_107_165,seq141,seq134,r_42_107_165,0.51,0,165,165,4
98,seq148,r_14_93_188,r_120_54_137,r_120_54_137,0.87,2,139,137,4
15,r_12_76_180,seq0,seq50,r_12_76_180,0.36,0,180,180,4
48,r_111_63_62,seq62,r_32_88_45,r_111_63_62,1.0,0,62,62,4
49,r_53_34_169,r_21_44_29,seq105,r_53_34_169,0.51,1,170,169,4
57,seq137,r_25_52_118,seq129,r_25_52_118,0.59,23,141,118,4
13,r_1_2_130,r_8_66_24,seq141,r_1_2_130,0.97,4,134,130,4
6,r_136_89_164,r_77_51_138,r_149_130_78,r_136_89_164,0.71,-26,138,164,4
1,r_91_31_42,seq38,r_5_95_18,r_91_31_42,0.97,3,45,42,4
23,r_69_86_46,r_17_49_63,seq83,r_69_86_46,0.99,0,46,46,4
22,r_9_132_12,r_12_76_180,r_94_29_140,r_9_132_12,0.95,0,12,12,4
2,r_82_110_104,seq134,seq24,r_82_110_104,0.92,3,107,104,4
40,r_147_106_141,seq112,r_45_61_95,r_45_61_95,0.99,48,143,95,4
25,r_73_103_157,seq133,seq143,r_73_103_157,0.77,0,157,157,4
64,seq20,seq3,r_17_49_63,r_17_49_63,1.0,12,75,63,4
21,r_37_138_39,r_149_130_78,seq0,r_37_138_39,1.0,0,39,39,4
50,seq0,r_12_76_180,r_37_138_39,r_37_138_39,1.0,66,105,39,4
44,r_21_44_29,r_149_130_78,r_53_34_169,r_21_44_29,1.0,1,30,29,4
32,r_149_130_78,seq30,r_136_89_164,r_149_130_78,0.68,1,79,78,4
38,r_67_19_91,r_25_52_118,seq10,r_67_19_91,0.97,0,91,91,4
77,seq57,seq10,r_48_65_59,r_48_65_59,1.0,8,67,59,4
34,r_131_81_122,seq56,r_116_121_13,r_131_81_122,0.98,0,122,122,4
24,r_116_121_13,seq10,seq145,r_116_121_13,0.9,0,13,13,4
81,seq79,seq10,r_58_108_102,r_58_108_102,1.0,0,102,102,4
17,r_58_108_102,seq84,seq79,r_58_108_102,1.0,0,102,102,4
9,r_118_109_120,seq80,r_14_93_188,r_118_109_120,0.85,0,120,120,4
28,r_104_55_54,r_47_146_179,r_100_26_146,r_100_26_146,0.98,-3,143,146,4
49,r_53_34_169,seq134,r_21_44_29,r_21_44_29,1.0,1,30,29,4
31,r_113_99_31,r_91_31_42,seq60,r_113_99_31,1.0,0,31,31,4
35,r_127_13_92,seq143,r_69_86_46,r_127_13_92,0.45,3,95,92,4
12,r_100_26_146,seq97,r_104_55_54,r_100_26_146,0.91,0,146,146,4
53,seq6,r_103_96_159,r_46_54_32,r_46_54_32,1.0,7,39,32,5
44,r_89_87_53,r_106_4_175,r_66_16_195,r_89_87_53,0.59,122,175,53,5
51,seq3,r_55_114_119,r_138_105_37,r_138_105_37,0.95,82,119,37,5
36,r_94_119_113,seq26,seq147,r_94_119_113,0.95,0,113,113,5
3,r_110_57_144,r_131_83_117,seq144,r_110_57_144,0.96,0,144,144,5
14,r_33_30_118,r_112_62_163,r_95_108_160,r_33_30_118,0.93,0,118,118,5
8,r_141_145_183,seq140,r_80_5_162,r_80_5_162,1.0,24,186,162,5
30,r_79_20_129,r_143_68_70,r_65_84_44,r_79_20_129,0.97,-82,47,129,5
43,r_116_135_101,seq26,seq140,r_116_135_101,0.85,1,102,101,5
59,seq14,r_131_83_117,seq8,r_131_83_117,0.97,0,117,117,5
21,r_136_126_188,seq14,r_134_32_76,r_136_126_188,0.25,0,188,188,5
39,r_35_49_139,seq37,r_134_32_76,r_134_32_76,0.97,63,139,76,5
25,r_112_62_163,seq39,r_31_101_105,r_112_62_163,0.97,1,164,163,5
4,r_72_148_91,seq28,r_58_9_43,r_58_9_43,1.0,5,48,43,5
5,r_121_50_149,seq13,r_66_16_195,r_121_50_149,0.9,1,150,149,5
46,r_41_0_90,seq109,seq149,r_41_0_90,1.0,0,90,90,5
42,r_15_7_176,r_78_74_168,seq144,r_78_74_168,0.71,0,168,168,5
10,r_65_84_44,r_131_83_117,r_79_20_129,r_65_84_44,0.68,1,45,44,5
45,r_47_129_99,r_2_76_197,seq124,r_47_129_99,1.0,0,99,99,5
19,r_75_118_51,r_127_122_167,r_46_54_32,r_75_118_51,0.83,1,52,51,5
38,r_85_88_136,r_143_68_70,seq11,r_85_88_136,1.0,0,136,136,5
31,r_127_122_167,seq40,r_85_88_136,r_85_88_136,0.98,31,167,136,5
67,seq26,r_116_135_101,seq11,r_116_135_101,0.99,1,102,101,5
3,r_110_57_144,r_79_20_129,r_131_83_117,r_131_83_117,0.54,-6,111,117,5
28,r_132_125_38,seq48,seq109,r_132_125_38,1.0,1,39,38,5
72,seq146,r_78_74_168,r_138_105_37,r_138_105_37,0.99,131,168,37,5
63,seq21,seq102,r_45_113_33,r_45_113_33,0.91,58,91,33,5
73,seq39,r_112_62_163,r_35_49_139,r_35_49_139,0.5,25,164,139,5
44,r_89_87_53,seq133,r_106_4_175,r_89_87_53,0.79,3,56,53,5
20,r_143_68_70,r_79_20_129,r_85_88_136,r_143_68_70,0.99,0,70,70,5
33,r_106_4_175,r_89_87_53,r_72_148_91,r_89_87_53,0.74,122,175,53,5
98,seq124,seq86,r_47_129_99,r_47_129_99,0.99,2,101,99,5
48,r_117_82_75,r_141_145_183,r_10_70_156,r_117_82_75,1.0,0,75,75,5
10,r_65_84_44,r_79_20_129,r_72_148_91,r_65_84_44,0.99,52,96,44,5
30,r_79_20_129,r_65_84_44,r_55_114_119,r_79_20_129,1.0,0,129,129,5
47,r_78_74_168,r_15_7_176,seq26,r_15_7_176,0.73,-8,168,176,5
12,r_12_51_40,r_81_56_133,seq91,r_12_51_40,1.0,0,40,40,5
40,r_103_96_159,seq6,r_138_105_37,r_138_105_37,1.0,124,161,37,5
74,seq40,r_127_122_167,r_61_90_180,r_127_122_167,0.45,0,167,167,5
18,r_99_120_94,seq98,seq22,r_99_120_94,1.0,0,94,94,5
24,r_131_83_117,seq14,seq44,r_131_83_117,1.0,0,117,117,5
25,r_112_62_163,r_33_30_118,seq39,r_33_30_118,1.0,0,118,118,5
33,r_106_4_175,r_100_52_161,r_89_87_53,r_89_87_53,0.78,108,161,53,5
58,seq13,r_121_50_149,seq28,r_121_50_149,0.99,1,150,149,5
20,r_143_68_70,r_85_88_136,seq14,r_85_88_136,1.0,1,137,136,5
32,r_43_93_179,r_106_4_175,seq104,r_106_4_175,0.83,1,176,175,5
38,r_85_88_136,r_41_0_90,r_143_68_70,r_85_88_136,0.96,-66,70,136,5
52,seq133,r_66_16_195,r_55_114_119,r_55_114_119,0.84,22,141,119,5
4,r_72_148_91,r_58_9_43,r_65_84_44,r_72_148_91,1.0,0,91,91,5
26,r_45_113_33,r_103_96_159,seq21,r_45_113_33,0.91,5,38,33,5
0,r_64_34_50,seq123,seq22,r_64_34_50,1.0,2,52,50,5
35,r_58_9_43,r_95_108_160,r_72_148_91,r_58_9_43,1.0,1,44,43,5
35,r_58_9_43,r_72_148_91,seq28,r_72_148_91,1.0,0,91,91,5
2,r_138_105_37,seq111,seq22,r_138_105_37,1.0,0,37,37,5
9,r_31_101_105,r_35_49_139,r_17_130_69,r_35_49_139,1.0,-34,105,139,5
96,seq147,seq8,r_94_119_113,r_94_119_113,1.0,17,130,113,5
22,r_17_130_69,r_141_145_183,seq109,r_17_130_69,1.0,0,69,69,5
49,r_100_52_161,r_106_4_175,r_138_105_37,r_100_52_161,0.6,0,161,161,5
23,r_134_32_76,r_31_101_105,seq60,r_134_32_76,1.0,0,76,76,5
27,r_25_38_41,r_31_101_105,r_1_92_30,r_25_38_41,0.8,0,41,41,5
79,seq60,r_2_76_197,r_134_32_76,r_134_32_76,1.0,65,141,76,5
88,seq91,r_106_4_175,r_1_92_30,r_1_92_30,0.59,1,31,30,5
6,r_36_115_18,seq147,r_10_70_156,r_36_115_18,0.73,1,19,18,5
40,r_101_2_130,r_94_116_21,r_89_24_12,r_101_2_130,1.0,1,131,130,6
40,r_101_2_130,r_97_62_31,r_94_116_21,r_97_62_31,0.99,0,31,31,6
51,seq128,seq131,r_38_104_162,r_38_104_162,0.98,21,183,162,6
14,r_8_136_69,r_40_119_191,seq47,r_8_136_69,1.0,0,69,69,6
8,r_134_63_93,r_100_123_65,r_20_23_73,r_134_63_93,1.0,0,93,93,6
43,r_81_70_70,seq87,r_29_115_42,r_81_70_70,1.0,0,70,70,6
5,r_89_24_12,r_20_23_73,seq0,r_89_24_12,1.0,0,12,12,6
54,seq133,seq37,r_71_57_136,r_71_57_136,1.0,12,148,136,6
33,r_42_126_56,r_5_44_55,r_34_17_150,r_42_126_56,1.0,0,56,56,6
45,r_90_69_19,r_83_86_121,r_71_57_136,r_90_69_19,0.82,0,19,19,6
19,r_98_105_172,seq145,r_114_78_174,r_98_105_172,0.59,3,175,172,6
30,r_112_3_13,r_73_84_85,r_79_148_8,r_112_3_13,0.97,0,13,13,6
33,r_42_126_56,r_138_106_49,seq11,r_42_126_56,0.59,123,179,56,6
4,r_55_56_51,r_114_78_174,seq48,r_55_56_51,1.0,0,51,51,6
27,r_71_57_136,r_38_104_162,r_90_69_19,r_90_69_19,0.93,0,19,19,6
27,r_71_57_136,r_90_69_19,seq133,r_71_57_136,0.96,0,136,136,6
95,seq120,r_18_130_148,r_53_27_86,r_53_27_86,0.98,7,93,86,6
38,r_29_115_42,seq25,r_81_70_70,r_81_70_70,0.98,65,135,70,6
41,r_36_35_119,seq37,r_88_66_74,r_36_35_119,1.0,0,119,119,6
45,r_90_69_19,r_38_104_162,r_18_130_148,r_38_104_162,0.77,-13,149,162,6
10,r_38_104_162,r_88_66_74,r_90_69_19,r_88_66_74,1.0,0,74,74,6
20,r_88_66_74,r_71_57_136,seq131,r_88_66_74,1.0,0,74,74,6
48,r_53_27_86,seq128,seq120,r_53_27_86,1.0,0,86,86,6
18,r_15_139_22,r_21_39_183,seq131,r_15_139_22,1.0,0,22,22,6
85,seq76,r_20_23_73,seq145,r_20_23_73,1.0,0,73,73,6
5,r_89_24_12,seq0,r_101_2_130,r_101_2_130,1.0,33,163,130,6
33,r_42_126_56,r_34_17_150,r_85_4_16,r_34_17_150,0.6,-45,105,150,6
10,r_38_104_162,r_90_69_19,r_36_35_119,r_38_104_162,1.0,0,162,162,6
24,r_5_44_55,r_42_126_56,r_94_116_21,r_42_126_56,1.0,0,56,56,6
39,r_113_142_38,r_73_84_85,seq117,r_113_142_38,0.99,0,38,38,6
38,r_29_115_42,seq54,seq25,r_29_115_42,1.0,0,42,42,6
2,r_20_23_73,seq76,r_5_44_55,r_20_23_73,1.0,0,73,73,6
41,r_36_35_119,r_88_66_74,r_38_104_162,r_38_104_162,0.79,21,183,162,6
47,r_26_19_80,seq54,seq37,r_26_19_80,1.0,0,80,80,6
25,r_30_107_175,seq143,seq25,r_30_107_175,0.38,0,175,175,6
88,seq91,r_141_102_127,seq80,r_141_102_127,0.64,-27,100,127,6
68,seq33,r_21_39_183,r_85_4_16,r_21_39_183,0.72,-109,74,183,6
61,seq145,r_98_105_172,seq76,r_98_105_172,0.85,3,175,172,6
52,seq131,seq128,r_88_66_74,r_88_66_74,1.0,9,83,74,6
34,r_16_111_152,seq132,r_149_14_168,r_16_111_152,0.71,1,153,152,6
3,r_109_103_32,seq32,seq54,r_109_103_32,0.97,0,32,32,6
46,r_138_106_49,r_8_136_69,seq68,r_138_106_49,1.0,0,49,49,6
0,r_7_74_14,r_121_96_53,r_112_3_13,r_121_96_53,0.8,-39,14,53,6
45,r_90_69_19,r_71_57_136,r_38_104_162,r_90_69_19,0.67,117,136,19,6
9,r_72_147_82,seq128,r_6_129_173,r_72_147_82,1.0,0,82,82,6
32,r_61_60_30,r_36_35_119,seq0,r_61_60_30,0.93,0,30,30,6
22,r_12_65_142,seq46,r_141_102_127,r_12_65_142,0.97,0,142,142,6
49,r_40_119_191,r_8_136_69,seq110,r_8_136_69,1.0,0,69,69,6
44,r_108_82_140,seq118,r_20_23_73,r_108_82_140,0.95,0,140,140,6
1,r_85_4_16,seq110,seq49,r_85_4_16,0.97,1,17,16,6
23,r_34_17_150,seq41,seq146,r_34_17_150,0.88,0,150,150,6
33,r_42_126_56,r_85_4_16,r_138_106_49,r_42_126_56,0.62,76,132,56,6
16,r_97_62_31,r_101_2_130,seq58,r_97_62_31,0.97,0,31,31,6
35,r_141_102_127,seq91,seq144,r_141_102_127,0.57,0,127,127,6
8,r_110_19_36,seq118,seq94,r_110_19_36,0.69,11,47,36,7
9,r_111_125_40,seq41,r_126_51_131,r_126_51_131,1.0,12,143,131,7
14,r_138_45_155,r_103_36_174,r_71_128_29,r_103_36_174,0.55,-19,155,174,7
43,r_105_93_85,r_18_60_196,r_68_37_39,r_68_37_39,0.96,46,85,39,7
18,r_56_59_33,r_29_90_84,r_104_1_89,r_56_59_33,1.0,1,34,33,7
37,r_31_127_190,r_101_10_74,r_56_59_33,r_101_10_74,0.89,0,74,74,7
86,seq86,r_34_78_151,r_133_50_92,r_133_50_92,0.55,4,96,92,7
16,r_132_72_102,seq107,r_130_9_62,r_130_9_62,1.0,44,106,62,7
21,r_65_49_9,r_96_91_107,r_110_19_36,r_96_91_107,1.0,0,107,107,7
39,r_108_121_171,seq76,r_33_40_60,r_33_40_60,1.0,111,171,60,7
1,r_88_39_72,r_103_36_174,seq17,r_88_39_72,0.93,2,74,72,7
46,r_122_131_167,seq140,seq118,r_122_131_167,0.8,1,168,167,7
42,r_126_51_131,seq25,r_111_125_40,r_126_51_131,0.91,1,132,131,7
7,r_22_27_55,r_126_51_131,seq144,r_22_27_55,1.0,0,55,55,7
69,seq41,r_133_50_92,r_111_125_40,r_133_50_92,0.65,0,92,92,7
60,seq144,seq4,r_22_27_55,r_22_27_55,1.0,2,57,55,7
19,r_34_78_151,seq8,seq20,r_34_78_151,0.97,0,151,151,7
9,r_111_125_40,r_2_11_101,seq41,r_111_125_40,1.0,0,40,40,7
22,r_81_84_44,r_116_6_162,seq98,r_81_84_44,0.91,2,46,44,7
31,r_62_142_126,seq119,r_110_19_36,r_62_142_126,1.0,0,126,126,7
41,r_33_40_60,r_65_49_9,seq95,r_33_40_60,1.0,0,60,60,7
89,seq95,r_13_146_139,r_33_40_60,r_33_40_60,1.0,0,60,60,7
3,r_29_90_84,seq98,seq148,r_29_90_84,0.95,1,85,84,7
10,r_58_117_80,r_31_127_190,r_33_40_60,r_33_40_60,0.97,21,81,60,7
45,r_100_89_15,r_99_21_47,seq66,r_100_89_15,0.98,1,16,15,7
25,r_68_37_39,seq64,seq73,r_68_37_39,0.97,0,39,39,7
26,r_92_63_182,r_18_60_196,r_115_120_31,r_115_120_31,0.68,151,182,31,7
48,r_83_75_16,seq94,seq145,r_83_75_16,1.0,1,17,16,7
0,r_13_146_139,seq66,r_149_139_27,r_149_139_27,0.71,112,139,27,7
11,r_101_10_74,r_31_127_190,r_143_74_22,r_101_10_74,1.0,0,74,74,7
20,r_147_124_163,seq35,r_12_16_12,r_12_16_12,0.75,151,163,12,7
13,r_106_15_118,r_18_60_196,seq4,r_106_15_118,0.98,0,118,118,7
98,seq119,r_62_142_126,seq38,r_62_142_126,1.0,0,126,126,7
0,r_13_146_139,r_149_139_27,r_101_10_74,r_13_146_139,0.44,21,160,139,7
15,r_46_23_64,seq44,r_79_113_8,r_46_23_64,1.0,0,64,64,7
25,r_68_37_39,seq73,r_105_93_85,r_105_93_85,1.0,-2,83,85,7
47,r_96_91_107,r_65_49_9,r_56_59_33,r_96_91_107,1.0,0,107,107,7
40,r_28_54_133,seq70,r_132_72_102,r_28_54_133,0.67,0,133,133,7
29,r_53_61_170,seq95,r_147_124_163,r_53_61_170,0.73,0,170,170,7
5,r_149_139_27,r_111_125_40,seq82,r_149_139_27,1.0,1,28,27,7
33,r_2_11_101,r_18_60_196,seq57,r_2_11_101,0.99,3,104,101,7
61,seq17,r_18_60_196,r_88_39_72,r_88_39_72,1.0,85,157,72,7
32,r_143_74_22,seq94,r_101_10_74,r_101_10_74,1.0,1,75,74,7
38,r_133_50_92,seq41,seq86,r_133_50_92,1.0,2,94,92,7
34,r_141_87_127,seq73,r_34_78_151,r_141_87_127,0.46,35,162,127,7
85,seq82,r_143_74_22,r_149_139_27,r_149_139_27,0.87,3,30,27,7
36,r_99_21_47,r_133_50_92,r_115_120_31,r_115_120_31,0.77,16,47,31,7
24,r_12_16_12,r_58_117_80,seq44,r_12_16_12,1.0,1,13,12,7
2,r_115_120_31,r_62_142_126,r_12_16_12,r_115_120_31,1.0,0,31,31,7
93,seq145,r_22_27_55,r_83_75_16,r_22_27_55,1.0,-3,52,55,7
49,r_103_36_174,seq135,seq76,r_103_36_174,0.72,1,175,174,7
23,r_123_24_181,seq97,seq35,r_123_24_181,0.64,0,181,181,7
27,r_114_129_37,seq0,seq3,r_114_129_37,1.0,0,37,37,7
35,r_85_136_144,seq26,seq17,r_85_136_144,0.82,0,144,144,7
12,r_130_9_62,seq64,seq17,r_130_9_62,1.0,0,62,62,7
40,r_120_6_17,r_115_127_172,seq45,r_115_127_172,0.51,2,174,172,8
30,r_11_83_179,seq37,r_145_19_176,r_145_19_176,0.87,8,184,176,8
92,seq110,r_3_78_121,r_116_36_8,r_3_78_121,0.81,0,121,121,8
41,r_115_127_172,r_131_149_19,r_120_6_17,r_115_127_172,0.99,-155,17,172,8
14,r_86_94_99,seq25,seq98,r_86_94_99,0.96,1,100,99,8
8,r_31_12_68,r_119_49_199,seq51,r_31_12_68,1.0,2,70,68,8
43,r_112_103_106,seq97,seq25,r_112_103_106,0.97,0,106,106,8
37,r_119_49_199,seq133,r_140_102_128,r_140_102_128,1.0,32,160,128,8
3,r_65_47_136,r_135_113_80,r_106_33_69,r_65_47_136,0.86,12,148,136,8
20,r_55_14_192,r_30_9_64,r_34_15_23,r_34_15_23,0.91,3,26,23,8
16,r_106_33_69,r_112_103_106,seq24,r_106_33_69,1.0,2,71,69,8
39,r_129_74_92,r_30_9_64,r_91_75_12,r_129_74_92,0.99,1,93,92,8
42,r_7_142_113,seq10,seq122,r_7_142_113,0.85,8,121,113,8
7,r_85_50_36,r_119_49_199,r_137_62_146,r_137_62_146,1.0,2,148,146,8
69,seq39,seq77,r_134_76_41,r_134_76_41,1.0,49,90,41,8
25,r_13_109_46,seq44,seq37,r_13_109_46,0.87,1,47,46,8
6,r_34_15_23,seq133,r_55_14_192,r_34_15_23,0.87,-2,21,23,8
31,r_135_113_80,seq37,r_81_136_21,r_135_113_80,0.96,0,80,80,8
67,seq133,r_119_49_199,r_20_92_116,r_20_92_116,1.0,44,160,116,8
3,r_65_47_136,r_95_32_83,r_135_113_80,r_135_113_80,1.0,1,81,80,8
26,r_82_35_129,seq43,r_106_33_69,r_106_33_69,1.0,63,132,69,8
40,r_120_6_17,r_137_62_146,r_115_127_172,r_120_6_17,0.98,0,17,17,8
15,r_95_32_83,r_65_47_136,r_81_136_21,r_81_136_21,0.98,61,82,21,8
48,r_101_125_88,r_137_62_146,r_130_21_22,r_101_125_88,0.95,0,88,88,8
17,r_147_73_160,r_30_9_64,r_34_15_23,r_34_15_23,0.55,28,51,23,8
34,r_88_126_34,seq87,seq143,r_88_126_34,0.98,0,34,34,8
27,r_69_70_72,seq1,seq59,r_69_70_72,0.86,6,78,72,8
38,r_131_149_19,r_115_127_172,seq16,r_131_149_19,0.98,0,19,19,8
4,r_130_21_22,r_65_47_136,seq64,r_130_21_22,0.89,1,23,22,8
41,r_115_127_172,r_120_6_17,r_2_46_1,r_115_127_172,0.46,2,174,172,8
47,r_56_40_123,seq22,seq67,r_56_40_123,0.7,-1,122,123,8
88,seq97,r_112_103_106,r_116_36_8,r_112_103_106,0.99,0,106,106,8
45,r_28_48_16,r_34_15_23,seq0,r_28_48_16,0.82,-1,15,16,8
32,r_71_72_112,seq121,r_135_113_80,r_135_113_80,1.0,42,122,80,8
36,r_134_76_41,r_30_9_64,seq87,r_134_76_41,0.98,1,42,41,8
2,r_57_144_51,seq39,seq121,r_57_144_51,1.0,1,52,51,8
9,r_145_19_176,r_115_127_172,r_134_76_41,r_115_127_172,0.6,3,175,172,8
21,r_81_136_21,r_57_144_51,r_95_32_83,r_95_32_83,1.0,-62,21,83,8
22,r_4_8_96,seq80,r_69_70_72,r_4_8_96,1.0,1,97,96,8
28,r_79_108_81,r_145_19_176,r_130_21_22,r_79_108_81,1.0,0,81,81,8
7,r_85_50_36,seq67,r_119_49_199,r_85_50_36,0.99,0,36,36,8
11,r_60_63_45,seq27,seq87,r_60_63_45,1.0,0,45,45,8
24,r_99_23_31,seq77,seq27,r_99_23_31,1.0,1,32,31,8
44,r_140_102_128,seq97,r_119_49_199,r_140_102_128,1.0,0,128,128,8
23,r_20_92_116,seq87,seq133,r_20_92_116,0.98,0,116,116,8
17,r_147_73_160,r_34_15_23,seq117,r_147_73_160,0.95,0,160,160,8
49,r_139_84_20,r_52_68_59,seq37,r_139_84_20,0.87,0,20,20,8
84,seq80,r_4_8_96,r_34_15_23,r_4_8_96,0.95,-5,91,96,8
42,r_114_122_31,r_13_23_42,r_48_44_29,r_114_122_31,1.0,0,31,31,9
36,r_97_52_127,r_81_42_163,seq30,r_97_52_127,0.93,7,134,127,9
12,r_56_112_45,r_13_23_42,seq103,r_56_112_45,0.65,1,46,45,9
14,r_126_72_122,r_81_42_163,seq19,r_126_72_122,1.0,0,122,122,9
43,r_110_125_106,seq21,r_92_108_18,r_110_125_106,1.0,1,107,106,9
54,seq134,r_67_132_177,r_64_78_60,r_64_78_60,0.73,95,155,60,9
37,r_61_18_144,seq25,r_64_78_60,r_61_18_144,0.99,0,144,144,9
59,seq15,r_113_121_124,seq51,r_113_121_124,1.0,0,124,124,9
86,seq80,r_6_50_188,r_33_88_141,r_33_88_141,0.99,47,188,141,9
16,r_69_120_15,seq9,r_2_86_58,r_2_86_58,1.0,31,89,58,9
21,r_113_121_124,seq15,r_56_112_45,r_113_121_124,1.0,0,124,124,9
39,r_45_60_99,r_126_72_122,r_64_78_60,r_45_60_99,0.79,1,100,99,9
1,r_35_109_155,seq79,seq37,r_35_109_155,0.9,1,156,155,9
97,seq115,r_38_17_164,r_99_148_113,r_99_148_113,1.0,21,134,113,9
19,r_20_27_121,seq65,seq40,r_20_27_121,0.89,1,122,121,9
5,r_48_44_29,r_10_95_57,seq75,r_48_44_29,1.0,0,29,29,9
41,r_6_50_188,seq80,r_2_86_58,r_6_50_188,0.48,0,188,188,9
67,seq34,r_28_41_149,r_130_62_97,r_130_62_97,1.0,54,151,97,9
30,r_140_36_30,r_58_49_152,r_92_108_18,r_140_36_30,1.0,0,30,30,9
3,r_99_148_113,seq63,seq115,r_99_148_113,0.99,0,113,113,9
8,r_67_132_177,r_45_60_99,r_48_44_29,r_67_132_177,0.72,2,179,177,9
28,r_118_123_46,seq94,seq68,r_118_123_46,1.0,1,47,46,9
83,seq75,seq16,r_48_44_29,r_48_44_29,1.0,26,55,29,9
4,r_12_143_172,seq68,r_102_87_112,r_102_87_112,1.0,58,170,112,9
78,seq63,r_71_1_140,seq3,r_71_1_140,0.97,-12,128,140,9
63,seq25,r_117_32_84,seq19,r_117_32_84,1.0,0,84,84,9
13,r_104_22_130,seq76,seq105,r_104_22_130,1.0,0,130,130,9
98,seq131,seq53,r_10_95_57,r_10_95_57,0.97,28,85,57,9
15,r_102_87_112,r_6_50_188,r_118_123_46,r_102_87_112,1.0,0,112,112,9
48,r_71_1_140,seq63,r_64_78_60,r_71_1_140,0.86,1,141,140,9
49,r_13_23_42,r_144_145_156,r_124_39_67,r_124_39_67,0.66,89,156,67,9
35,r_74_84_39,seq135,seq85,r_74_84_39,1.0,0,39,39,9
6,r_130_62_97,r_12_143_172,seq106,r_130_62_97,1.0,0,97,97,9
27,r_64_78_60,r_35_109_155,r_45_60_99,r_64_78_60,0.93,8,68,60,9
2,r_117_32_84,seq25,r_10_95_57,r_117_32_84,1.0,0,84,84,9
20,r_144_145_156,r_2_86_58,r_13_23_42,r_144_145_156,0.69,-110,46,156,9
40,r_28_41_149,seq34,seq25,r_28_41_149,0.27,15,164,149,9
29,r_55_128_80,seq68,seq40,r_55_128_80,0.98,1,81,80,9
24,r_33_88_141,seq14,seq80,r_33_88_141,1.0,1,142,141,9
46,r_146_91_13,r_35_109_155,seq149,r_146_91_13,0.98,0,13,13,9
25,r_59_136_169,seq127,r_71_1_140,r_59_136_169,0.62,-2,167,169,9
33,r_38_17_164,seq115,seq85,r_38_17_164,0.58,2,166,164,9
20,r_144_145_156,r_13_23_42,r_102_87_112,r_102_87_112,1.0,44,156,112,9
38,r_139_138_102,seq105,seq149,r_139_138_102,1.0,0,102,102,9
52,seq142,r_141_82_119,r_101_129_128,r_141_82_119,1.0,3,122,119,9
34,r_116_5_165,seq135,r_124_39_67,r_116_5_165,0.45,0,165,165,9
17,r_89_4_189,seq30,r_130_62_97,r_130_62_97,1.0,92,189,97,9
9,r_141_82_119,seq142,seq15,r_141_82_119,0.99,3,122,119,9
31,r_93_11_129,seq15,seq25,r_93_11_129,0.98,1,130,129,9
31,r_93_11_129,seq51,seq15,r_93_11_129,0.69,-78,51,129,9
28,r_118_123_46,seq68,r_102_87_112,r_102_87_112,1.0,27,139,112,9
7,r_124_39_67,r_141_82_119,r_13_23_42,r_124_39_67,1.0,0,67,67,9
8,r_67_132_177,r_13_23_42,r_45_60_99,r_13_23_42,0.82,4,46,42,9
44,r_73_0_190,seq83,r_12_143_172,r_12_143_172,0.56,18,190,172,9
23,r_7_77_137,seq65,r_81_42_163,r_7_77_137,0.86,0,137,137,9
93,seq103,seq9,r_56_112_45,r_56_112_45,0.95,-5,40,45,9
0,r_2_86_58,r_144_145_156,r_69_120_15,r_2_86_58,1.0,-1,57,58,9
49,r_13_23_42,r_67_132_177,r_144_145_156,r_13_23_42,0.62,4,46,42,9
11,r_10_95_57,r_33_88_141,seq131,r_33_88_141,0.52,-83,58,141,9
68,seq34,r_148_128_151,r_132_127_18,r_132_127_18,1.0,0,18,18,10
8,r_62_139_131,seq88,seq145,r_62_139_131,0.77,1,132,131,10
43,r_59_51_145,seq42,seq68,r_59_51_145,0.62,1,146,145,10
37,r_140_17_92,seq68,seq92,r_140_17_92,0.99,1,93,92,10
10,r_120_54_26,r_135_29_158,seq86,r_120_54_26,1.0,0,26,26,10
55,seq129,r_76_50_133,r_136_48_36,r_136_48_36,0.66,97,133,36,10
16,r_90_117_135,seq11,r_100_143_81,r_90_117_135,0.74,0,135,135,10
42,r_8_67_140,r_20_52_90,r_100_143_81,r_8_67_140,0.86,-50,90,140,10
80,seq75,seq78,r_98_43_91,r_98_43_91,1.0,19,110,91,10
45,r_70_7_132,r_97_85_78,seq24,r_97_85_78,1.0,1,79,78,10
19,r_121_96_72,seq14,seq1,r_121_96_72,0.57,5,77,72,10
30,r_79_18_13,seq144,r_98_43_91,r_79_18_13,0.99,0,13,13,10
15,r_100_143_81,r_8_67_140,r_90_117_135,r_100_143_81,1.0,60,141,81,10
40,r_108_60_50,r_22_149_149,r_120_54_26,r_108_60_50,0.99,0,50,50,10
4,r_57_103_14,r_62_139_131,seq11,r_57_103_14,0.58,1,15,14,10
95,seq109,r_105_40_182,seq137,r_105_40_182,0.56,-35,147,182,10
28,r_132_127_18,r_35_94_198,seq34,r_132_127_18,1.0,0,18,18,10
76,seq66,r_36_93_167,seq3,r_36_93_167,0.57,3,170,167,10
36,r_114_9_55,r_22_149_149,r_71_82_19,r_114_9_55,0.59,0,55,55,10
31,r_36_93_167,seq66,r_140_17_92,r_36_93_167,0.49,1,168,167,10
41,r_97_85_78,r_70_7_132,r_79_18_13,r_97_85_78,1.0,1,79,78,10
3,r_148_128_151,r_69_81_181,seq134,r_148_128_151,0.8,0,151,151,10
14,r_136_48_36,r_70_7_132,seq24,r_70_7_132,0.97,0,132,132,10
0,r_105_40_182,seq109,r_20_52_90,r_20_52_90,1.0,92,182,90,10
11,r_135_29_158,seq147,seq26,r_135_29_158,0.69,0,158,158,10
39,r_13_63_30,r_113_37_69,r_44_23_17,r_13_63_30,0.97,1,31,30,10
13,r_101_83_177,seq65,r_133_126_189,r_101_83_177,0.58,0,177,177,10
15,r_100_143_81,r_98_43_91,r_8_67_140,r_100_143_81,1.0,0,81,81,10
57,seq138,r_32_111_174,r_39_112_53,r_39_112_53,1.0,121,174,53,10
27,r_47_73_3,r_102_115_138,seq61,r_47_73_3,0.64,138,141,3,10
30,r_79_18_13,r_98_43_91,r_97_85_78,r_79_18_13,1.0,78,91,13,10
1,r_141_122_10,r_105_40_182,seq66,r_141_122_10,0.98,0,10,10,10
2,r_20_52_90,seq38,r_113_37_69,r_20_52_90,1.0,0,90,90,10
18,r_56_46_98,r_98_43_91,r_140_17_92,r_140_17_92,0.8,1,93,92,10
24,r_5_146_115,r_62_139_131,r_108_60_50,r_62_139_131,0.72,-13,118,131,10
25,r_130_104_164,seq11,r_71_82_19,r_130_104_164,0.53,2,166,164,10
33,r_27_107_129,seq84,seq80,r_27_107_129,0.97,0,129,129,10
64,seq26,seq65,r_45_10_110,r_45_10_110,1.0,1,111,110,10
7,r_71_82_19,seq19,r_62_139_131,r_71_82_19,0.68,4,23,19,10
58,seq11,r_130_104_164,r_57_103_14,r_57_103_14,0.64,152,166,14,10
45,r_70_7_132,seq24,r_20_52_90,r_70_7_132,0.85,0,132,132,10
7,r_71_82_19,r_62_139_131,r_114_9_55,r_114_9_55,0.66,16,71,55,10
32,r_98_43_91,r_56_46_98,seq75,r_98_43_91,0.9,0,91,91,10
23,r_39_112_53,r_102_115_138,seq0,r_39_112_53,1.0,0,53,53,10
52,seq3,r_25_118_139,seq66,r_25_118_139,0.85,0,139,139,10
75,seq65,r_101_83_177,r_45_10_110,r_45_10_110,0.86,69,179,110,10
17,r_102_115_138,r_47_73_3,seq147,r_102_115_138,0.65,3,141,138,10
9,r_22_149_149,seq92,r_71_82_19,r_22_149_149,0.68,2,151,149,10
29,r_45_10_110,r_36_93_167,r_32_111_174,r_45_10_110,0.4,-71,39,110,10
29,r_45_10_110,r_32_111_174,seq26,r_45_10_110,0.89,0,110,110,10
22,r_113_37_69,seq1,seq31,r_113_37_69,0.51,8,77,69,10
49,r_32_111_174,seq138,r_123_125_112,r_32_111_174,0.69,0,174,174,10
99,seq124,r_76_50_133,r_100_143_81,r_76_50_133,0.61,-1,132,133,10
44,r_76_50_133,seq129,r_35_94_198,r_76_50_133,0.91,0,133,133,10
35,r_25_118_139,seq3,seq42,r_25_118_139,0.96,0,139,139,10
55,seq129,r_136_48_36,r_15_28_147,r_15_28_147,0.68,2,149,147,10
34,r_44_23_17,r_21_142_191,seq11,r_44_23_17,1.0,1,18,17,10
42,r_8_67_140,r_100_143_81,r_25_118_139,r_8_67_140,1.0,1,141,140,10
14,r_136_48_36,r_98_43_91,r_70_7_132,r_136_48_36,0.99,3,39,36,10
84,seq84,r_27_107_129,seq138,r_27_107_129,0.94,0,129,129,10
14,r_9_140_137,seq40,r_103_96_20,r_103_96_20,0.78,117,137,20,11
49,r_68_124_57,seq45,r_7_62_11,r_68_124_57,1.0,1,58,57,11
43,r_133_38_118,seq83,r_44_146_2,r_133_38_118,0.99,0,118,118,11
37,r_113_94_71,seq74,r_87_73_4,r_113_94_71,1.0,0,71,71,11
36,r_7_62_11,r_18_92_158,seq134,r_18_92_158,0.96,-147,11,158,11
59,seq19,r_84_20_155,r_132_144_90,r_132_144_90,0.55,65,155,90,11
21,r_36_105_69,r_89_102_123,seq127,r_36_105_69,1.0,0,69,69,11
39,r_84_20_155,seq19,r_98_69_44,r_84_20_155,0.86,0,155,155,11
1,r_82_126_175,r_121_120_183,seq111,r_82_126_175,0.65,0,175,175,11
97,seq119,seq31,r_35_12_131,r_35_12_131,1.0,-1,130,131,11
33,r_15_123_17,r_118_81_49,seq91,r_15_123_17,0.94,3,20,17,11
5,r_130_14_132,r_44_146_2,r_30_110_18,r_130_14_132,0.96,0,132,132,11
42,r_108_46_186,seq6,r_130_14_132,r_130_14_132,0.84,56,188,132,11
45,r_132_144_90,r_9_140_137,seq19,r_132_144_90,0.99,0,90,90,11
16,r_136_42_22,r_88_41_198,seq33,r_88_41_198,0.61,-174,24,198,11
30,r_58_53_39,r_108_46_186,seq91,r_108_46_186,0.64,-142,44,186,11
0,r_118_81_49,seq114,seq10,r_118_81_49,1.0,0,49,49,11
87,seq78,r_75_51_101,r_79_1_41,r_75_51_101,0.57,-42,59,101,11
27,r_30_110_18,seq65,r_130_14_132,r_130_14_132,1.0,6,138,132,11
31,r_13_54_92,seq29,r_24_85_40,r_13_54_92,0.94,2,94,92,11
41,r_0_139_109,r_23_28_161,seq141,r_0_139_109,1.0,1,110,109,11
3,r_57_37_112,seq64,r_109_101_47,r_109_101_47,1.0,65,112,47,11
16,r_136_42_22,seq33,r_72_2_103,r_72_2_103,1.0,6,109,103,11
2,r_18_92_158,r_98_69_44,r_103_96_20,r_18_92_158,0.83,-120,38,158,11
73,seq50,r_90_43_191,r_18_92_158,r_90_43_191,0.83,-10,181,191,11
11,r_75_51_101,seq78,r_80_104_51,r_75_51_101,0.84,2,103,101,11
96,seq114,r_118_81_49,r_143_115_7,r_118_81_49,0.99,-5,44,49,11
20,r_77_25_177,seq64,seq3,r_77_25_177,0.61,0,177,177,11
46,r_109_101_47,seq55,seq61,r_109_101_47,1.0,0,47,47,11
48,r_5_86_180,r_90_43_191,r_77_25_177,r_5_86_180,0.65,1,181,180,11
26,r_103_96_20,r_23_28_161,r_18_92_158,r_103_96_20,1.0,0,20,20,11
85,seq74,r_113_94_71,r_16_71_59,r_113_94_71,1.0,0,71,71,11
2,r_18_92_158,r_103_96_20,seq40,r_18_92_158,0.43,1,159,158,11
8,r_98_69_44,r_5_86_180,seq31,r_98_69_44,1.0,0,44,44,11
68,seq134,r_88_41_198,r_7_62_11,r_7_62_11,1.0,11,22,11,11
47,r_80_104_51,seq45,seq66,r_80_104_51,1.0,2,53,51,11
18,r_16_71_59,r_133_38_118,seq74,r_133_38_118,1.0,-55,63,118,11
29,r_11_39_147,r_5_86_180,r_132_144_90,r_5_86_180,0.68,-32,148,180,11
24,r_106_59_60,seq6,seq149,r_106_59_60,0.8,3,63,60,11
25,r_128_99_84,r_9_140_137,r_88_41_198,r_128_99_84,1.0,0,84,84,11
64,seq31,seq119,r_98_69_44,r_98_69_44,1.0,43,87,44,11
27,r_30_110_18,r_147_129_30,seq65,r_30_110_18,0.95,0,18,18,11
58,seq17,seq149,r_147_129_30,r_147_129_30,0.89,67,97,30,11
60,seq148,r_79_1_41,r_132_144_90,r_132_144_90,0.95,3,93,90,11
38,r_35_12_131,r_107_26_67,r_132_144_90,r_35_12_131,0.55,-43,88,131,11
60,seq148,r_117_8_188,r_79_1_41,r_79_1_41,0.52,26,67,41,11
13,r_79_1_41,seq91,seq78,r_79_1_41,0.95,3,44,41,11
17,r_89_102_123,r_60_49_119,seq138,r_89_102_123,0.91,0,123,123,11
94,seq111,r_95_116_122,seq145,r_95_116_122,1.0,0,122,122,11
9,r_72_2_103,r_9_140_137,r_136_42_22,r_72_2_103,1.0,0,103,103,11
26,r_103_96_20,r_18_92_158,r_9_140_137,r_103_96_20,0.36,139,159,20,11
56,seq141,r_87_73_4,r_0_139_109,r_0_139_109,1.0,5,114,109,11
22,r_23_28_161,seq97,seq64,r_23_28_161,0.67,0,161,161,11
28,r_121_120_183,seq138,r_122_137_134,r_121_120_183,0.37,1,184,183,11
44,r_95_116_122,seq111,r_136_42_22,r_95_116_122,0.8,0,122,122,11
38,r_35_12_131,r_132_144_90,seq119,r_35_12_131,0.98,1,132,131,11
23,r_107_26_67,r_35_12_131,r_147_129_30,r_107_26_67,0.98,0,67,67,11
19,r_147_129_30,seq78,seq17,r_147_129_30,0.98,2,32,30,11
35,r_60_49_119,r_89_102_123,r_143_115_7,r_60_49_119,0.61,4,123,119,11
12,r_122_137_134,seq64,seq97,r_122_137_134,0.8,0,134,134,11
28,r_116_68_43,seq59,seq32,r_116_68_43,1.0,0,43,43,12
30,r_93_61_151,seq140,seq29,r_93_61_151,0.4,0,151,151,12
20,r_31_12_90,r_87_33_104,r_54_119_7,r_54_119_7,0.97,5,12,7,12
36,r_76_11_75,r_103_137_137,seq82,r_76_11_75,0.96,0,75,75,12
50,seq129,seq78,r_142_9_29,r_142_9_29,1.0,20,49,29,12
43,r_18_102_134,r_57_1_194,r_133_6_26,r_133_6_26,1.0,113,139,26,12
37,r_70_48_51,r_81_111_84,seq109,r_70_48_51,1.0,0,51,51,12
16,r_130_66_71,r_27_17_162,seq114,r_130_66_71,0.68,4,75,71,12
39,r_87_33_104,seq8,r_146_30_46,r_87_33_104,0.99,0,104,104,12
1,r_132_124_111,r_148_108_158,seq8,r_148_108_158,0.68,-47,111,158,12
5,r_103_137_137,r_76_11_75,r_142_9_29,r_103_137_137,0.95,-62,75,137,12
46,r_5_60_156,seq123,seq139,r_5_60_156,0.35,0,156,156,12
80,seq78,seq129,r_70_48_51,r_70_48_51,1.0,45,96,51,12
45,r_15_143_95,r_91_118_147,seq2,r_15_143_95,0.99,0,95,95,12
33,r_23_55_12,r_13_85_124,seq94,r_13_85_124,1.0,0,124,124,12
31,r_136_64_120,seq114,seq84,r_136_64_120,0.95,0,120,120,12
89,seq94,r_100_47_143,r_131_10_116,r_131_10_116,0.81,23,139,116,12
26,r_44_88_180,seq40,r_132_124_111,r_132_124_111,1.0,72,183,111,12
4,r_141_112_96,seq84,seq104,r_141_112_96,0.98,0,96,96,12
78,seq75,r_43_125_157,r_148_108_158,r_43_125_157,0.61,5,162,157,12
0,r_81_111_84,seq92,seq40,r_81_111_84,1.0,0,84,84,12
63,seq32,r_146_30_46,r_116_68_43,r_116_68_43,0.99,28,71,43,12
11,r_38_22_175,seq50,r_70_48_51,r_70_48_51,1.0,124,175,51,12
13,r_148_108_158,r_132_124_111,r_34_16_185,r_132_124_111,1.0,0,111,111,12
8,r_24_0_52,r_93_61_151,seq86,r_24_0_52,1.0,0,52,52,12
49,r_147_138_97,r_5_60_156,r_24_0_52,r_24_0_52,0.33,135,187,52,12
6,r_115_128_142,r_37_56_133,r_100_47_143,r_37_56_133,0.84,8,141,133,12
17,r_121_36_149,r_31_12_90,seq89,r_121_36_149,1.0,0,149,149,12
5,r_103_137_137,r_142_9_29,seq73,r_103_137_137,1.0,0,137,137,12
13,r_148_108_158,r_34_16_185,r_105_26_19,r_148_108_158,0.91,0,158,158,12
22,r_54_119_7,r_31_12_90,r_99_110_92,r_54_119_7,0.99,86,93,7,12
40,r_46_145_176,seq95,r_141_112_96,r_141_112_96,1.0,80,176,96,12
42,r_122_83_40,r_87_33_104,seq120,r_87_33_104,0.45,-64,40,104,12
18,r_42_127_49,r_81_111_84,seq89,r_81_111_84,1.0,-20,64,84,12
29,r_131_10_116,seq32,seq94,r_131_10_116,1.0,0,116,116,12
24,r_13_85_124,seq94,r_122_83_40,r_13_85_124,0.83,0,124,124,12
72,seq59,r_116_68_43,r_20_19_14,r_116_68_43,0.98,0,43,43,12
58,seq144,r_91_118_147,seq14,r_91_118_147,1.0,-23,124,147,12
20,r_31_12_90,r_54_119_7,seq67,r_31_12_90,1.0,3,93,90,12
32,r_45_117_76,r_44_88_180,seq73,r_45_117_76,1.0,0,76,76,12
10,r_20_19_14,r_103_137_137,seq59,r_20_19_14,0.98,0,14,14,12
38,r_69_71_100,r_44_88_180,seq50,r_69_71_100,0.99,0,100,100,12
75,seq72,seq114,r_146_30_46,r_146_30_46,0.36,105,151,46,12
19,r_133_6_26,r_100_47_143,seq114,r_133_6_26,1.0,0,26,26,12
33,r_23_55_12,r_132_124_111,r_13_85_124,r_23_55_12,0.98,0,12,12,12
17,r_121_36_149,seq67,r_31_12_90,r_31_12_90,0.99,5,95,90,12
9,r_142_9_29,r_98_63_181,seq96,r_142_9_29,1.0,0,29,29,12
14,r_98_63_181,r_42_127_49,r_142_9_29,r_98_63_181,0.86,-10,171,181,12
49,r_147_138_97,seq114,r_5_60_156,r_147_138_97,1.0,0,97,97,12
56,seq140,r_93_61_151,seq32,r_93_61_151,0.47,31,182,151,12
44,r_37_56_133,r_115_128_142,r_131_10_116,r_131_10_116,0.49,26,142,116,12
69,seq52,r_4_41_9,seq28,r_4_41_9,0.63,14,23,9,12
96,seq109,seq78,r_70_48_51,r_70_48_51,1.0,1,52,51,12
35,r_99_110_92,r_97_126_1,r_54_119_7,r_99_110_92,1.0,0,92,92,12
12,r_27_17_162,seq104,r_81_111_84,r_81_111_84,0.65,78,162,84,12
84,seq84,r_141_112_96,r_46_145_176,r_141_112_96,0.84,0,96,96,12
30,r_102_130_70,seq118,r_68_43_198,r_102_130_70,0.95,2,72,70,13
36,r_68_43_198,r_39_47_83,r_102_130_70,r_68_43_198,0.79,-124,74,198,13
8,r_18_76_188,seq32,r_94_10_133,r_18_76_188,0.3,0,188,188,13
43,r_6_17_117,seq23,seq30,r_6_17_117,0.66,-2,115,117,13
35,r_126_74_125,r_21_3_119,r_8_100_21,r_8_100_21,0.99,-1,20,21,13
59,seq23,r_6_17_117,seq83,r_6_17_117,0.79,0,117,117,13
16,r_92_82_196,seq59,r_31_64_40,r_31_64_40,0.98,22,62,40,13
21,r_104_101_84,seq59,seq4,r_104_101_84,0.63,3,87,84,13
1,r_109_113_185,seq66,r_104_101_84,r_104_101_84,1.0,102,186,84,13
5,r_137_78_61,seq148,r_129_138_13,r_137_78_61,0.98,0,61,61,13
14,r_110_144_18,r_73_22_118,seq143,r_110_144_18,0.79,-3,15,18,13
45,r_79_124_169,r_13_28_195,r_126_74_125,r_79_124_169,0.51,2,171,169,13
11,r_98_141_184,r_67_51_58,r_44_26_3,r_67_51_58,0.41,128,186,58,13
52,seq7,r_75_131_101,r_67_51_58,r_67_51_58,0.63,-1,57,58,13
38,r_8_100_21,r_126_74_125,r_110_144_18,r_126_74_125,0.71,0,125,125,13
31,r_21_3_119,r_126_74_125,r_107_1_56,r_107_1_56,0.84,63,119,56,13
3,r_39_47_83,r_36_65_87,seq48,r_39_47_83,0.7,4,87,83,13
10,r_73_22_118,r_98_141_184,seq105,r_73_22_118,0.96,0,118,118,13
26,r_52_146_131,seq19,seq83,r_52_146_131,0.68,0,131,131,13
19,r_85_140_45,seq4,r_84_145_17,r_85_140_45,0.98,0,45,45,13
42,r_31_64_40,r_110_144_18,r_92_82_196,r_31_64_40,0.67,0,40,40,13
48,r_53_0_139,r_106_142_137,r_73_22_118,r_106_142_137,0.99,1,138,137,13
6,r_24_86_78,r_13_28_195,seq117,r_24_86_78,1.0,-1,77,78,13
21,r_104_101_84,seq4,r_85_140_45,r_104_101_84,0.35,64,148,84,13
2,r_107_1_56,seq69,r_21_3_119,r_21_3_119,1.0,-1,118,119,13
27,r_70_123_94,seq48,r_16_95_19,r_70_123_94,0.81,6,100,94,13
38,r_8_100_21,r_57_133_24,r_126_74_125,r_8_100_21,0.99,-1,20,21,13
73,seq58,r_94_10_133,r_136_147_103,r_94_10_133,0.78,-100,33,133,13
47,r_5_11_74,r_35_90_89,seq105,r_5_11_74,0.99,0,74,74,13
4,r_84_145_17,r_14_149_168,r_62_25_164,r_84_145_17,0.94,1,18,17,13
74,seq59,r_104_101_84,r_31_64_40,r_104_101_84,0.46,0,84,84,13
18,r_128_40_93,seq23,r_53_0_139,r_128_40_93,0.59,0,93,93,13
29,r_63_37_92,r_109_113_185,seq143,r_63_37_92,0.9,4,96,92,13
24,r_106_142_137,r_53_0_139,r_35_90_89,r_53_0_139,0.51,-1,138,139,13
35,r_126_74_125,r_8_100_21,seq32,r_126_74_125,0.73,0,125,125,13
4,r_84_145_17,r_62_25_164,r_85_140_45,r_85_140_45,0.81,11,56,45,13
11,r_98_141_184,r_73_22_118,r_67_51_58,r_98_141_184,0.75,-125,59,184,13
25,r_67_51_58,r_107_1_56,r_98_141_184,r_67_51_58,0.53,0,58,58,13
76,seq66,r_109_113_185,r_16_95_19,r_16_95_19,1.0,0,19,19,13
75,seq60,r_14_149_168,seq115,r_14_149_168,0.49,-39,129,168,13
41,r_54_96_73,seq55,r_35_90_89,r_35_90_89,0.77,9,98,89,13
17,r_49_116_62,r_137_78_61,seq9,r_137_78_61,0.99,0,61,61,13
25,r_67_51_58,r_98_141_184,r_39_47_83,r_67_51_58,0.66,126,184,58,13
9,r_94_10_133,seq58,seq125,r_94_10_133,0.97,1,134,133,13
22,r_108_111_181,seq29,r_73_22_118,r_73_22_118,0.9,64,182,118,13
28,r_62_25_164,seq20,r_136_147_103,r_62_25_164,0.56,0,164,164,13
21,r_104_101_84,r_85_140_45,r_109_113_185,r_104_101_84,0.66,101,185,84,13
7,r_34_93_193,r_14_149_168,seq115,r_14_149_168,0.38,-39,129,168,13
37,r_129_138_13,seq139,seq20,r_129_138_13,1.0,0,13,13,13
58,seq20,r_62_25_164,r_129_138_13,r_129_138_13,1.0,2,15,13,13
12,r_14_149_168,seq60,r_75_131_101,r_14_149_168,0.28,1,169,168,13
18,r_128_40_93,r_53_0_139,r_91_87_192,r_53_0_139,1.0,5,144,139,13
51,seq130,r_53_21_190,r_83_149_155,r_83_149_155,0.85,35,190,155,14
8,r_64_7_61,r_127_43_188,seq133,r_64_7_61,1.0,0,61,61,14
43,r_45_3_105,r_17_70_111,r_113_54_73,r_17_70_111,1.0,-6,105,111,14
83,seq89,seq48,r_2_4_85,r_2_4_85,1.0,38,123,85,14
40,r_146_92_39,r_88_49_94,seq31,r_146_92_39,1.0,0,39,39,14
71,seq46,r_114_137_90,seq20,r_114_137_90,0.95,0,90,90,14
16,r_33_10_70,r_56_40_124,seq106,r_33_10_70,1.0,1,71,70,14
21,r_102_93_158,seq37,r_96_141_53,r_102_93_158,0.85,0,158,158,14
39,r_76_138_62,r_36_72_176,r_123_86_161,r_76_138_62,1.0,0,62,62,14
42,r_82_103_184,r_8_139_189,r_41_26_116,r_41_26_116,0.63,68,184,116,14
73,seq51,seq135,r_126_136_12,r_126_136_12,0.77,1,13,12,14
19,r_17_70_111,r_34_85_132,seq48,r_17_70_111,0.91,1,112,111,14
30,r_55_11_44,r_18_14_131,r_39_58_48,r_55_11_44,1.0,2,46,44,14
27,r_24_84_72,r_75_12_163,r_64_7_61,r_75_12_163,0.72,9,172,163,14
66,seq29,r_131_9_171,seq87,r_131_9_171,0.87,-92,79,171,14
41,r_114_137_90,seq46,r_47_77_25,r_47_77_25,0.66,65,90,25,14
3,r_111_132_117,seq133,seq44,r_111_132_117,0.76,0,117,117,14
90,seq100,r_34_85_132,seq28,r_34_85_132,0.86,1,133,132,14
9,r_39_58_48,seq135,r_55_11_44,r_39_58_48,1.0,1,49,48,14
4,r_73_50_154,seq121,r_140_118_100,r_140_118_100,0.83,54,154,100,14
0,r_41_26_116,seq121,seq27,r_41_26_116,1.0,0,116,116,14
11,r_2_4_85,seq106,seq89,r_2_4_85,1.0,0,85,85,14
20,r_59_74_86,seq87,seq37,r_59_74_86,0.92,1,87,86,14
98,seq121,r_41_26_116,seq20,r_41_26_116,1.0,1,117,116,14
48,r_75_12_163,seq133,r_24_84_72,r_24_84_72,1.0,7,79,72,14
49,r_101_95_134,r_78_116_13,r_126_136_12,r_101_95_134,0.86,2,136,134,14
57,seq145,r_134_16_177,r_38_65_41,r_38_65_41,0.83,126,167,41,14
12,r_78_116_13,r_101_95_134,r_34_85_132,r_34_85_132,0.76,4,136,132,14
6,r_56_40_124,seq94,seq107,r_56_40_124,0.99,0,124,124,14
15,r_38_65_41,seq29,seq145,r_38_65_41,0.99,2,43,41,14
99,seq122,seq13,r_18_14_131,r_18_14_131,1.0,5,136,131,14
35,r_96_141_53,r_64_7_61,seq63,r_96_141_53,0.83,1,54,53,14
10,r_110_61_6,seq133,r_140_118_100,r_140_118_100,1.0,44,144,100,14
27,r_24_84_72,seq15,r_75_12_163,r_24_84_72,0.97,2,74,72,14
49,r_101_95_134,r_144_35_59,r_78_116_13,r_101_95_134,0.72,-121,13,134,14
1,r_126_136_12,r_88_49_94,seq51,r_126_136_12,0.89,0,12,12,14
47,r_131_9_171,seq19,r_108_62_168,r_131_9_171,0.63,0,171,171,14
12,r_78_116_13,r_39_58_48,r_101_95_134,r_39_58_48,0.74,-35,13,48,14
18,r_134_16_177,seq145,seq121,r_134_16_177,0.59,0,177,177,14
29,r_108_62_168,seq98,r_76_138_62,r_76_138_62,1.0,107,169,62,14
24,r_140_118_100,seq119,seq142,r_140_118_100,0.96,0,100,100,14
25,r_34_85_132,seq100,r_57_109_10,r_34_85_132,0.99,0,132,132,14
48,r_75_12_163,r_24_84_72,r_41_26_116,r_41_26_116,0.97,51,167,116,14
14,r_47_77_25,r_36_72_176,seq129,r_47_77_25,0.89,0,25,25,14
32,r_83_149_155,seq46,seq130,r_83_149_155,0.64,1,156,155,14
38,r_113_54_73,r_17_70_111,seq37,r_113_54_73,1.0,4,77,73,14
52,seq133,r_75_12_163,r_64_7_61,r_64_7_61,1.0,0,61,61,14
34,r_128_104_170,seq130,r_111_132_117,r_128_104_170,0.54,0,170,170,14
75,seq63,seq48,r_96_141_53,r_96_141_53,1.0,40,93,53,14
17,r_88_49_94,r_83_149_155,seq13,r_88_49_94,0.93,9,103,94,14
98,seq121,seq20,r_134_16_177,r_134_16_177,0.76,7,184,177,14
46,r_144_35_59,r_101_95_134,seq46,r_144_35_59,0.99,0,59,59,14
7,r_53_21_190,seq130,r_110_61_6,r_110_61_6,0.52,184,190,6,14
44,r_18_14_131,seq1,seq122,r_18_14_131,0.93,0,131,131,14
23,r_5_32_151,seq67,seq28,r_5_32_151,0.52,0,151,151,14
22,r_117_124_23,r_53_21_190,seq106,r_117_124_23,0.99,0,23,23,14
93,seq115,seq6,r_100_148_53,r_100_148_53,1.0,48,101,53,15
36,r_146_140_58,r_32_63_61,r_75_67_133,r_146_140_58,1.0,0,58,58,15
43,r_75_67_133,r_143_97_6,r_106_88_147,r_106_88_147,0.6,5,152,147,15
37,r_18_86_35,r_106_88_147,seq43,r_18_86_35,1.0,0,35,35,15
16,r_36_126_109,seq60,r_40_81_12,r_36_126_109,0.95,0,109,109,15
21,r_48_113_57,r_129_136_107,seq60,r_48_113_57,1.0,7,64,57,15
14,r_138_77_41,r_1_10_72,seq96,r_1_10_72,0.57,-28,44,72,15
1,r_0_53_129,seq105,seq24,r_0_53_129,0.89,1,130,129,15
42,r_19_27_146,seq82,r_69_87_73,r_19_27_146,0.92,0,146,146,15
80,seq80,r_143_97_6,r_74_65_155,r_74_65_155,0.84,20,175,155,15
19,r_59_107_103,seq30,seq105,r_59_107_103,0.93,1,104,103,15
30,r_127_128_13,seq4,seq64,r_127_128_13,1.0,0,13,13,15
9,r_71_119_44,r_1_10_72,seq6,r_1_10_72,0.99,1,73,72,15
76,seq60,r_36_126_109,r_48_113_57,r_48_113_57,0.98,66,123,57,15
38,r_26_49_188,r_55_95_14,r_15_120_112,r_15_120_112,1.0,77,189,112,15
39,r_46_38_23,seq24,r_112_47_128,r_112_47_128,0.99,3,131,128,15
31,r_92_78_161,seq132,r_129_136_107,r_129_136_107,0.63,58,165,107,15
41,r_145_37_182,seq33,r_74_65_155,r_74_65_155,0.54,27,182,155,15
3,r_32_63_61,r_1_10_72,seq14,r_32_63_61,0.99,2,63,61,15
47,r_102_70_127,seq135,r_76_16_21,r_76_16_21,0.78,-3,18,21,15
72,seq52,seq45,r_48_113_57,r_48_113_57,0.94,16,73,57,15
6,r_79_98_124,r_76_16_21,seq137,r_79_98_124,0.54,53,177,124,15
40,r_5_122_18,r_79_98_124,seq132,r_5_122_18,0.53,-1,17,18,15
5,r_76_16_21,r_94_91_139,r_102_70_127,r_76_16_21,0.96,-4,17,21,15
4,r_72_13_173,seq123,r_127_128_13,r_127_128_13,0.59,161,174,13,15
33,r_125_25_46,seq135,seq14,r_125_25_46,0.98,2,48,46,15
78,seq64,r_15_120_112,r_127_128_13,r_15_120_112,0.73,0,112,112,15
11,r_112_47_128,seq12,r_46_38_23,r_112_47_128,0.75,1,129,128,15
20,r_74_65_155,r_79_98_124,r_41_142_125,r_41_142_125,0.69,0,125,125,15
98,seq123,r_72_13_173,r_11_21_22,r_11_21_22,0.89,104,126,22,15
15,r_31_58_167,r_143_97_6,seq118,r_31_58_167,0.58,0,167,167,15
48,r_2_130_121,seq14,r_50_144_9,r_2_130_121,0.99,0,121,121,15
20,r_74_65_155,r_41_142_125,seq80,r_74_65_155,0.97,0,155,155,15
18,r_129_136_107,r_48_113_57,r_35_66_47,r_129_136_107,0.98,-49,58,107,15
6,r_79_98_124,r_74_65_155,r_76_16_21,r_79_98_124,0.77,0,124,124,15
5,r_76_16_21,r_102_70_127,r_93_51_96,r_76_16_21,0.95,107,128,21,15
9,r_71_119_44,seq118,r_1_10_72,r_71_119_44,0.95,1,45,44,15
70,seq43,seq85,r_18_86_35,r_18_86_35,1.0,23,58,35,15
39,r_46_38_23,r_18_86_35,seq24,r_46_38_23,0.63,0,23,23,15
12,r_11_21_22,seq45,seq123,r_11_21_22,0.98,0,22,22,15
45,r_55_95_14,r_129_136_107,r_26_49_188,r_55_95_14,0.89,3,17,14,15
38,r_26_49_188,r_50_144_9,r_55_95_14,r_26_49_188,0.46,-178,10,188,15
24,r_1_10_72,r_138_77_41,r_11_21_22,r_1_10_72,1.0,1,73,72,15
25,r_41_142_125,seq131,r_129_136_107,r_41_142_125,0.74,0,125,125,15
47,r_102_70_127,r_76_16_21,seq80,r_102_70_127,0.97,2,129,127,15
32,r_133_99_71,seq149,seq82,r_133_99_71,1.0,0,71,71,15
29,r_40_81_12,r_54_68_170,seq42,r_40_81_12,0.87,0,12,12,15
22,r_7_44_48,r_134_61_95,seq121,r_7_44_48,1.0,0,48,48,15
34,r_90_89_4,r_54_68_170,r_8_139_136,r_8_139_136,0.79,34,170,136,15
45,r_55_95_14,r_26_49_188,r_28_22_191,r_28_22_191,0.93,-2,189,191,15
81,seq82,r_19_27_146,r_133_99_71,r_133_99_71,0.66,75,146,71,15
17,r_54_68_170,r_90_89_4,r_35_66_47,r_35_66_47,0.99,123,170,47,15
26,r_50_144_9,r_90_89_4,r_2_130_121,r_2_130_121,0.74,-1,120,121,15
28,r_134_61_95,r_75_67_133,r_35_66_47,r_75_67_133,1.0,-38,95,133,15
84,seq96,r_3_104_199,r_138_77_41,r_138_77_41,0.87,5,46,41,15
7,r_15_120_112,seq64,r_90_89_4,r_15_120_112,0.97,0,112,112,15
23,r_35_66_47,r_134_61_95,r_129_136_107,r_35_66_47,0.97,0,47,47,15
10,r_100_148_53,seq33,seq115,r_100_148_53,0.97,0,53,53,15
35,r_69_87_73,seq30,seq9,r_69_87_73,1.0,0,73,73,15
18,r_129_136_107,r_35_66_47,seq108,r_129_136_107,0.94,2,109,107,15
23,r_35_66_47,r_129_136_107,r_134_61_95,r_35_66_47,0.79,62,109,47,15
65,seq30,r_69_87_73,seq114,r_69_87_73,1.0,-18,55,73,15
30,r_138_122_61,r_140_115_178,seq9,r_138_122_61,1.0,0,61,61,16
51,seq6,r_116_95_130,r_3_17_30,r_3_17_30,1.0,103,133,30,16
6,r_15_117_22,seq50,seq144,r_15_117_22,0.99,0,22,22,16
36,r_47_120_94,seq32,seq105,r_47_120_94,1.0,4,98,94,16
19,r_36_130_44,r_116_95_130,seq136,r_36_130_44,0.92,0,44,44,16
8,r_108_55_93,seq136,seq109,r_108_55_93,0.98,0,93,93,16
69,seq146,seq33,r_37_27_15,r_37_27_15,0.65,18,33,15,16
1,r_0_41_157,seq4,seq44,r_0_41_157,0.75,0,157,157,16
24,r_28_94_27,seq39,seq144,r_28_94_27,0.98,1,28,27,16
5,r_102_31_82,seq114,r_24_125_62,r_102_31_82,0.72,7,89,82,16
45,r_58_49_132,r_132_90_198,r_97_104_142,r_58_49_132,0.65,0,132,132,16
62,seq29,r_3_17_30,seq44,r_3_17_30,1.0,0,30,30,16
33,r_118_52_113,r_107_85_17,seq48,r_118_52_113,0.99,0,113,113,16
95,seq109,seq39,r_108_55_93,r_108_55_93,1.0,0,93,93,16
66,seq34,r_93_7_66,seq96,r_93_7_66,1.0,0,66,66,16
12,r_42_73_170,r_148_83_126,seq143,r_42_73_170,0.96,2,172,170,16
26,r_148_83_126,r_42_73_170,r_126_12_10,r_42_73_170,1.0,3,173,170,16
41,r_22_13_111,seq105,r_28_94_27,r_22_13_111,0.92,0,111,111,16
89,seq96,r_67_111_81,seq34,r_67_111_81,1.0,-6,75,81,16
3,r_67_111_81,seq96,r_8_5_29,r_67_111_81,0.97,1,82,81,16
26,r_148_83_126,seq48,r_42_73_170,r_148_83_126,0.72,0,126,126,16
72,seq46,r_59_62_124,r_135_61_58,r_59_62_124,1.0,0,124,124,16
78,seq56,r_97_104_142,seq143,r_97_104_142,0.66,2,144,142,16
0,r_121_74_136,seq114,seq103,r_121_74_136,0.49,0,136,136,16
11,r_97_104_142,seq56,r_58_49_132,r_58_49_132,0.58,12,144,132,16
20,r_93_7_66,seq34,seq25,r_93_7_66,1.0,0,66,66,16
13,r_139_86_187,seq99,r_43_147_51,r_43_147_51,1.0,44,95,51,16
15,r_80_82_59,seq44,seq98,r_80_82_59,1.0,1,60,59,16
48,r_24_125_62,r_140_115_178,seq145,r_24_125_62,0.96,12,74,62,16
49,r_107_85_17,r_118_52_113,seq35,r_118_52_113,0.93,0,113,113,16
12,r_42_73_170,r_126_12_10,r_148_83_126,r_148_83_126,0.85,0,126,126,16
13,r_139_86_187,r_43_147_51,r_121_74_136,r_139_86_187,0.61,1,188,187,16
21,r_126_12_10,r_42_73_170,r_40_51_72,r_40_51_72,0.97,4,76,72,16
21,r_126_12_10,r_67_111_81,r_42_73_170,r_126_12_10,0.77,2,12,10,16
17,r_8_5_29,r_80_82_59,r_148_83_126,r_8_5_29,0.48,2,31,29,16
27,r_16_141_161,seq18,r_138_122_61,r_138_122_61,0.91,100,161,61,16
84,seq78,seq112,r_28_94_27,r_28_94_27,1.0,23,50,27,16
2,r_75_71_175,seq50,r_15_117_22,r_15_117_22,0.82,153,175,22,16
47,r_140_115_178,r_24_125_62,seq143,r_24_125_62,0.64,13,75,62,16
40,r_14_100_16,r_67_111_81,seq25,r_14_100_16,0.79,0,16,16,16
74,seq50,r_75_71_175,seq123,r_75_71_175,0.71,0,175,175,16
29,r_68_128_99,seq70,r_1_113_174,r_68_128_99,0.99,0,99,99,16
96,seq112,seq145,r_149_72_47,r_149_72_47,0.98,4,51,47,16
33,r_118_52_113,seq48,r_59_62_124,r_118_52_113,0.73,38,151,113,16
25,r_23_10_143,r_57_106_163,seq35,r_23_10_143,0.69,0,143,143,16
28,r_3_17_30,seq29,seq6,r_3_17_30,0.97,0,30,30,16
50,seq4,r_0_41_157,r_142_66_55,r_142_66_55,0.98,102,157,55,16
58,seq18,r_16_141_161,r_102_31_82,r_16_141_161,0.8,0,161,161,16
70,seq39,r_135_61_58,r_116_95_130,r_116_95_130,0.5,-10,120,130,16
18,r_142_66_55,seq144,seq4,r_142_66_55,1.0,0,55,55,16
49,r_107_85_17,r_89_110_31,r_118_52_113,r_107_85_17,0.97,0,17,17,16
38,r_45_63_117,r_116_95_130,r_28_94_27,r_116_95_130,0.98,-13,117,130,16
34,r_1_113_174,seq144,r_68_128_99,r_68_128_99,1.0,75,174,99,16
75,seq53,r_40_51_72,seq9,r_40_51_72,1.0,1,73,72,16
33,r_118_52_113,r_119_2_188,r_107_85_17,r_107_85_17,0.92,1,18,17,16
39,r_37_27_15,r_42_73_170,seq146,r_37_27_15,0.86,0,15,15,16
9,r_40_51_72,seq53,r_126_12_10,r_40_51_72,1.0,1,73,72,16
37,r_89_110_31,seq54,seq60,r_89_110_31,1.0,0,31,31,16
23,r_149_72_47,seq60,seq112,r_149_72_47,0.99,1,48,47,16
7,r_64_91_86,seq9,seq134,r_64_91_86,0.97,0,86,86,16
44,r_59_62_124,seq46,r_118_52_113,r_59_62_124,0.97,0,124,124,16
17,r_8_5_29,r_148_83_126,r_67_111_81,r_8_5_29,0.89,66,95,29,16
43,r_43_147_51,seq98,seq25,r_43_147_51,1.0,0,51,51,16
31,r_77_131_56,r_108_55_93,r_89_110_31,r_77_131_56,0.95,1,57,56,16
35,r_88_124_139,seq46,r_77_131_56,r_88_124_139,0.63,0,139,139,16
30,r_113_80_110,seq6,r_19_5_53,r_113_80_110,0.99,0,110,110,17
36,r_77_9_129,seq95,seq40,r_77_9_129,0.97,1,130,129,17
26,r_129_39_45,seq91,seq88,r_129_39_45,1.0,-1,44,45,17
14,r_86_82_189,seq10,r_122_74_13,r_86_82_189,0.45,0,189,189,17
69,seq51,seq27,r_31_29_34,r_31_29_34,1.0,2,36,34,17
8,r_138_119_163,seq96,seq90,r_138_119_163,0.66,0,163,163,17
83,seq88,r_120_21_3,r_129_39_45,r_129_39_45,1.0,42,87,45,17
37,r_28_58_177,seq7,r_12_64_150,r_12_64_150,0.55,28,178,150,17
71,seq57,r_133_147_169,seq36,r_133_147_169,1.0,-48,121,169,17
15,r_146_84_23,r_25_62_78,seq111,r_146_84_23,0.97,-1,22,23,17
2,r_19_5_53,r_34_100_5,r_113_80_110,r_113_80_110,1.0,1,111,110,17
21,r_76_149_67,seq40,seq101,r_76_149_67,1.0,0,67,67,17
46,r_133_147_169,seq57,seq88,r_133_147_169,0.54,0,169,169,17
80,seq83,r_110_143_162,seq17,r_110_143_162,0.82,4,166,162,17
45,r_8_44_95,r_55_38_196,r_122_74_13,r_8_44_95,0.99,0,95,95,17
76,seq71,r_99_130_68,r_23_72_33,r_23_72_33,0.96,0,33,33,17
19,r_49_67_131,seq94,seq51,r_49_67_131,0.49,3,134,131,17
23,r_108_37_31,r_23_72_33,r_43_56_19,r_108_37_31,0.91,-2,29,31,17
31,r_45_16_125,r_28_58_177,r_73_4_91,r_45_16_125,0.67,0,125,125,17
41,r_55_38_196,r_8_44_95,r_23_72_33,r_55_38_196,0.99,-108,88,196,17
89,seq95,r_77_9_129,seq47,r_77_9_129,0.93,0,129,129,17
24,r_60_112_49,r_46_109_143,r_132_24_86,r_60_112_49,1.0,-1,48,49,17
10,r_15_66_90,seq97,seq65,r_15_66_90,0.32,-18,72,90,17
1,r_122_74_13,r_92_118_62,r_106_116_9,r_122_74_13,0.46,0,13,13,17
4,r_25_62_78,r_48_139_104,seq90,r_25_62_78,1.0,0,78,78,17
63,seq27,seq51,r_54_105_199,r_54_105_199,0.59,-15,184,199,17
11,r_41_26_109,seq89,r_120_21_3,r_41_26_109,0.98,0,109,109,17
20,r_46_109_143,seq2,seq47,r_46_109_143,0.64,0,143,143,17
13,r_132_24_86,r_133_147_169,r_23_72_33,r_132_24_86,0.68,0,86,86,17
25,r_23_72_33,seq91,seq71,r_23_72_33,1.0,0,33,33,17
48,r_81_20_76,seq79,seq115,r_81_20_76,1.0,0,76,76,17
3,r_31_29_34,seq111,seq51,r_31_29_34,1.0,0,34,34,17
38,r_42_33_28,r_136_144_197,seq10,r_42_33_28,0.94,0,28,28,17
27,r_73_4_91,seq1,r_68_3_75,r_73_4_91,1.0,0,91,91,17
40,r_120_21_3,seq1,r_41_26_109,r_41_26_109,1.0,2,111,109,17
34,r_114_121_51,seq141,r_52_32_11,r_114_121_51,1.0,0,51,51,17
58,seq11,r_117_126_174,r_134_0_138,r_134_0_138,0.85,37,175,138,17
0,r_43_56_19,r_136_144_197,seq89,r_43_56_19,1.0,0,19,19,17
68,seq47,r_134_0_138,seq95,r_134_0_138,0.98,0,138,138,17
32,r_142_18_114,seq22,seq140,r_142_18_114,1.0,0,114,114,17
52,seq2,r_46_109_143,r_122_74_13,r_46_109_143,0.73,0,143,143,17
24,r_60_112_49,r_132_24_86,r_14_107_85,r_60_112_49,0.8,37,86,49,17
2,r_19_5_53,seq131,r_34_100_5,r_19_5_53,1.0,0,53,53,17
17,r_134_0_138,seq47,r_142_18_114,r_134_0_138,0.94,0,138,138,17
10,r_15_66_90,seq65,r_148_98_188,r_15_66_90,0.96,0,90,90,17
28,r_68_3_75,seq95,seq96,r_68_3_75,1.0,0,75,75,17
49,r_14_107_85,r_12_64_150,r_60_112_49,r_14_107_85,0.78,-2,83,85,17
56,seq137,seq91,r_92_118_62,r_92_118_62,1.0,11,73,62,17
7,r_13_145_152,seq124,r_54_105_199,r_13_145_152,0.82,2,154,152,17
44,r_117_126_174,seq11,r_42_33_28,r_42_33_28,0.84,147,175,28,17
35,r_30_61_64,r_55_38_196,seq94,r_30_61_64,0.97,1,65,64,17
12,r_99_130_68,seq71,r_30_61_64,r_99_130_68,0.68,-6,62,68,17
93,seq106,seq74,r_0_48_108,r_0_48_108,1.0,15,123,108,18
30,r_21_121_23,r_9_71_76,r_14_20_193,r_14_20_193,0.86,-169,24,193,18
91,seq104,r_47_7_142,r_15_16_52,r_15_16_52,1.0,1,53,52,18
14,r_55_39_160,seq65,r_123_54_70,r_55_39_160,0.92,0,160,160,18
8,r_38_10_144,seq74,r_49_3_49,r_49_3_49,0.74,97,146,49,18
62,seq148,r_93_98_148,r_37_91_60,r_37_91_60,0.72,-2,58,60,18
37,r_37_91_60,r_130_114_89,r_139_142_140,r_37_91_60,1.0,2,62,60,18
16,r_126_46_85,r_31_97_110,r_93_98_148,r_126_46_85,0.74,0,85,85,18
39,r_102_53_114,r_140_24_137,r_4_138_111,r_102_53_114,0.74,0,114,114,18
1,r_6_101_96,r_34_51_103,r_140_24_137,r_34_51_103,0.48,-19,84,103,18
5,r_34_51_103,seq129,r_126_46_85,r_126_46_85,0.88,21,106,85,18
45,r_110_26_66,seq23,r_111_128_167,r_110_26_66,1.0,1,67,66,18
20,r_31_97_110,r_55_39_160,seq129,r_31_97_110,0.93,-1,109,110,18
36,r_41_92_38,seq137,seq144,r_41_92_38,0.99,0,38,38,18
24,r_111_128_167,r_110_26_66,r_55_39_160,r_111_128_167,0.89,0,167,167,18
15,r_124_119_63,seq65,r_11_136_139,r_11_136_139,0.77,31,170,139,18
19,r_33_108_92,r_40_25_187,r_103_5_168,r_33_108_92,0.72,83,175,92,18
49,r_15_16_52,r_33_108_92,seq104,r_15_16_52,0.97,1,53,52,18
63,seq149,seq1,r_8_43_50,r_8_43_50,0.97,-4,46,50,18
31,r_125_64_179,seq134,r_55_39_160,r_125_64_179,0.64,2,181,179,18
41,r_72_52_135,seq22,r_102_53_114,r_72_52_135,0.99,2,137,135,18
46,r_45_67_22,seq36,seq132,r_45_67_22,0.99,-1,21,22,18
3,r_4_138_111,seq132,seq129,r_4_138_111,0.86,1,112,111,18
10,r_49_3_49,r_4_138_111,r_130_114_89,r_49_3_49,0.85,21,70,49,18
0,r_130_114_89,r_31_97_110,r_49_3_49,r_130_114_89,0.86,1,90,89,18
11,r_30_133_73,r_55_39_160,r_115_44_3,r_30_133_73,1.0,0,73,73,18
20,r_31_97_110,r_130_114_89,r_55_39_160,r_31_97_110,0.51,-16,94,110,18
46,r_45_67_22,seq132,r_90_76_170,r_90_76_170,0.91,8,178,170,18
15,r_124_119_63,seq77,seq65,r_124_119_63,0.99,2,65,63,18
12,r_103_5_168,r_29_81_15,r_33_108_92,r_33_108_92,1.0,77,169,92,18
21,r_8_43_50,r_94_57_145,seq149,r_8_43_50,0.77,0,50,50,18
19,r_33_108_92,r_15_16_52,seq35,r_15_16_52,0.99,1,53,52,18
22,r_139_142_140,r_37_91_60,seq83,r_139_142_140,0.93,-1,139,140,18
17,r_93_98_148,r_34_51_103,seq35,r_93_98_148,0.99,0,148,148,18
12,r_103_5_168,r_124_119_63,r_29_81_15,r_124_119_63,0.99,-22,41,63,18
2,r_89_88_78,seq105,seq74,r_89_88_78,0.56,6,84,78,18
47,r_123_54_70,seq50,seq2,r_123_54_70,0.71,10,80,70,18
24,r_111_128_167,seq78,r_110_26_66,r_110_26_66,1.0,1,67,66,18
18,r_107_27_19,r_113_135_162,seq80,r_107_27_19,1.0,0,19,19,18
25,r_60_56_143,seq74,seq137,r_60_56_143,0.99,0,143,143,18
16,r_126_46_85,r_93_98_148,r_34_51_103,r_126_46_85,0.41,21,106,85,18
23,r_140_24_137,r_6_101_96,r_34_51_103,r_140_24_137,0.73,0,137,137,18
1,r_6_101_96,r_140_24_137,r_8_43_50,r_140_24_137,0.87,0,137,137,18
65,seq23,r_40_25_187,r_32_62_113,r_32_62_113,0.99,-10,103,113,18
32,r_145_18_6,r_0_48_108,r_31_97_110,r_145_18_6,0.85,102,108,6,18
38,r_69_131_67,r_4_138_111,seq137,r_69_131_67,1.0,3,70,67,18
19,r_33_108_92,seq35,r_40_25_187,r_33_108_92,1.0,-1,91,92,18
34,r_90_76_170,seq137,r_45_67_22,r_90_76_170,0.83,2,172,170,18
45,r_110_26_66,r_111_128_167,r_12_86_101,r_110_26_66,0.96,101,167,66,18
17,r_93_98_148,r_139_142_140,r_34_51_103,r_139_142_140,0.49,-30,110,140,18
9,r_0_48_108,r_6_101_96,seq106,r_0_48_108,0.87,0,108,108,18
37,r_37_91_60,r_139_142_140,r_34_51_103,r_139_142_140,0.86,-13,127,140,18
22,r_139_142_140,r_93_98_148,r_37_91_60,r_37_91_60,1.0,8,68,60,18
26,r_14_20_193,r_111_128_167,r_21_121_23,r_21_121_23,0.8,6,29,23,18
7,r_9_71_76,seq116,r_21_121_23,r_9_71_76,0.94,0,76,76,18
44,r_40_25_187,seq17,r_90_76_170,r_40_25_187,0.26,0,187,187,18
23,r_140_24_137,r_102_53_114,r_6_101_96,r_102_53_114,0.61,0,114,114,18
79,seq78,r_14_20_193,r_9_71_76,r_9_71_76,1.0,12,88,76,18
35,r_42_122_106,r_102_53_114,seq63,r_42_122_106,0.99,1,107,106,18
93,seq110,r_136_6_169,r_7_82_81,r_7_82_81,1.0,27,108,81,19
30,r_17_111_114,seq35,r_11_31_12,r_17_111_114,0.99,0,114,114,19
47,r_14_62_120,r_133_22_35,r_11_31_12,r_11_31_12,0.51,5,17,12,19
14,r_48_126_110,seq96,seq35,r_48_126_110,1.0,0,110,110,19
43,r_23_55_63,r_86_125_176,r_71_45_8,r_23_55_63,1.0,0,63,63,19
15,r_88_124_33,r_76_83_93,seq26,r_88_124_33,1.0,1,34,33,19
86,seq91,r_127_128_178,r_86_125_176,r_86_125_176,0.73,2,178,176,19
16,r_7_82_81,seq87,seq89,r_7_82_81,0.8,1,82,81,19
29,r_11_31_12,r_86_125_176,r_14_62_120,r_11_31_12,1.0,1,13,12,19
91,seq101,seq64,r_54_49_39,r_54_49_39,1.0,13,52,39,19
97,seq119,r_24_42_50,seq15,r_24_42_50,0.55,28,78,50,19
32,r_86_125_176,seq53,r_38_33_13,r_38_33_13,1.0,3,16,13,19
5,r_19_134_152,r_127_128_178,r_23_55_63,r_23_55_63,0.8,90,153,63,19
42,r_112_10_180,seq141,r_90_85_79,r_90_85_79,0.99,101,180,79,19
27,r_5_12_20,r_48_126_110,r_71_45_8,r_5_12_20,0.98,4,24,20,19
38,r_54_49_39,seq4,seq101,r_54_49_39,1.0,0,39,39,19
45,r_68_74_142,seq144,seq41,r_68_74_142,0.96,0,142,142,19
31,r_72_103_41,r_121_122_149,r_147_94_196,r_72_103_41,0.68,1,42,41,19
23,r_147_94_196,r_20_129_177,r_72_103_41,r_72_103_41,0.93,8,49,41,19
19,r_121_122_149,r_104_63_158,seq65,r_121_122_149,0.88,0,149,149,19
7,r_58_135_46,seq41,seq26,r_58_135_46,0.87,5,51,46,19
37,r_133_22_35,r_14_62_120,r_105_27_11,r_133_22_35,0.87,1,36,35,19
41,r_20_129_177,r_147_94_196,r_71_45_8,r_71_45_8,0.82,172,180,8,19
3,r_139_95_167,seq60,r_66_106_49,r_66_106_49,0.53,103,152,49,19
10,r_73_146_107,seq137,r_113_28_98,r_113_28_98,0.57,10,108,98,19
26,r_21_61_121,r_20_129_177,r_113_28_98,r_21_61_121,0.59,9,130,121,19
4,r_113_28_98,seq4,seq93,r_113_28_98,0.98,3,101,98,19
11,r_76_83_93,seq140,r_56_44_112,r_76_83_93,0.66,7,100,93,19
0,r_25_1_179,r_7_82_81,r_8_79_10,r_8_79_10,0.7,2,12,10,19
20,r_118_67_145,seq43,seq4,r_118_67_145,0.82,0,145,145,19
13,r_37_145_90,seq32,r_136_6_169,r_37_145_90,1.0,0,90,90,19
46,r_8_79_10,r_25_1_179,r_102_107_59,r_102_107_59,1.0,120,179,59,19
6,r_90_85_79,r_73_146_107,r_29_51_76,r_73_146_107,1.0,-28,79,107,19
0,r_25_1_179,r_8_79_10,r_9_78_44,r_25_1_179,0.47,0,179,179,19
8,r_40_142_48,r_2_116_117,seq137,r_40_142_48,1.0,1,49,48,19
2,r_56_44_112,seq53,r_76_83_93,r_76_83_93,0.95,14,107,93,19
12,r_38_33_13,r_102_107_59,r_86_125_176,r_38_33_13,0.99,0,13,13,19
74,seq64,seq101,r_90_85_79,r_90_85_79,1.0,48,127,79,19
47,r_14_62_120,r_11_31_12,r_71_45_8,r_14_62_120,0.9,3,123,120,19
88,seq93,r_104_63_158,r_113_28_98,r_113_28_98,0.95,6,104,98,19
50,seq130,r_104_63_158,r_73_146_107,r_73_146_107,0.73,53,160,107,19
58,seq144,r_68_74_142,seq13,r_68_74_142,1.0,-17,125,142,19
68,seq46,seq101,r_9_78_44,r_9_78_44,1.0,28,72,44,19
34,r_97_98_70,seq132,r_147_94_196,r_97_98_70,0.8,-5,65,70,19
46,r_8_79_10,r_19_134_152,r_25_1_179,r_8_79_10,0.99,0,10,10,19
75,seq65,r_17_111_114,seq115,r_17_111_114,1.0,-19,95,114,19
17,r_102_107_59,seq108,r_8_79_10,r_102_107_59,1.0,1,60,59,19
25,r_57_109_19,r_113_28_98,r_11_31_12,r_113_28_98,0.9,-9,89,98,19
29,r_11_31_12,r_14_62_120,r_17_111_114,r_11_31_12,0.55,111,123,12,19
28,r_131_39_92,r_19_134_152,seq43,r_131_39_92,0.99,0,92,92,19
49,r_36_30_125,seq81,seq70,r_36_30_125,0.61,8,133,125,19
39,r_9_78_44,r_113_28_98,seq46,r_9_78_44,1.0,0,44,44,19
25,r_57_109_19,r_37_145_90,r_113_28_98,r_57_109_19,0.98,0,19,19,19
48,r_24_42_50,seq119,seq138,r_24_42_50,0.9,1,51,50,19
97,seq123,r_56_64_95,r_148_13_47,r_148_13_47,0.6,5,52,47,20
30,r_20_78_116,seq44,seq111,r_20_78_116,0.96,1,117,116,20
35,r_1_15_24,r_75_81_71,r_131_122_159,r_131_122_159,0.85,0,159,159,20
8,r_88_94_106,r_107_36_151,seq47,r_88_94_106,0.57,0,106,106,20
20,r_77_0_34,r_73_104_58,r_4_108_190,r_77_0_34,0.6,25,59,34,20
18,r_42_3_51,r_11_21_152,seq69,r_42_3_51,0.97,0,51,51,20
40,r_30_39_77,r_11_21_152,r_148_13_47,r_148_13_47,0.96,0,47,47,20
21,r_2_28_113,seq109,seq137,r_2_28_113,0.98,1,114,113,20
39,r_41_34_120,r_4_108_190,seq22,r_41_34_120,0.77,0,120,120,20
23,r_102_37_21,r_65_129_174,seq26,r_102_37_21,0.62,-2,19,21,20
42,r_130_40_72,r_58_25_137,r_119_24_13,r_130_40_72,0.92,0,72,72,20
45,r_56_64_95,seq123,r_93_71_87,r_56_64_95,0.98,1,96,95,20
95,seq116,r_11_21_152,r_80_45_12,r_11_21_152,0.74,-19,133,152,20
66,seq47,r_100_38_91,seq29,r_100_38_91,1.0,-8,83,91,20
76,seq83,r_131_122_159,seq44,r_131_122_159,0.77,1,160,159,20
31,r_55_31_84,seq51,r_27_121_15,r_55_31_84,0.57,2,86,84,20
41,r_87_66_98,seq26,r_70_140_191,r_87_66_98,0.97,0,98,98,20
3,r_75_81_71,r_107_36_151,seq5,r_75_81_71,0.95,0,71,71,20
90,seq109,r_2_28_113,r_119_24_13,r_2_28_113,0.53,1,114,113,20
20,r_77_0_34,r_4_108_190,r_100_38_91,r_100_38_91,0.6,0,91,91,20
36,r_80_45_12,r_114_126_148,r_10_33_4,r_80_45_12,0.74,0,12,12,20
63,seq135,r_48_19_176,r_27_121_15,r_27_121_15,0.68,162,177,15,20
11,r_62_128_88,r_132_14_130,seq82,r_62_128_88,0.6,2,90,88,20
43,r_49_79_23,r_88_94_106,r_9_8_172,r_9_8_172,0.96,0,172,172,20
15,r_68_139_82,seq86,r_12_63_37,r_68_139_82,0.98,1,83,82,20
40,r_30_39_77,r_148_13_47,seq51,r_30_39_77,0.99,0,77,77,20
48,r_72_149_74,r_62_128_88,seq133,r_72_149_74,1.0,1,75,74,20
12,r_27_121_15,r_48_19_176,r_55_31_84,r_55_31_84,0.94,0,84,84,20
6,r_107_36_151,r_9_8_172,r_54_138_133,r_9_8_172,0.99,-21,151,172,20
1,r_12_63_37,r_119_24_13,r_68_139_82,r_68_139_82,0.98,9,91,82,20
19,r_148_13_47,r_70_140_191,seq123,r_148_13_47,1.0,7,54,47,20
74,seq76,r_114_126_148,seq16,r_114_126_148,0.96,-25,123,148,20
24,r_65_129_174,seq137,r_30_39_77,r_65_129_174,0.55,1,175,174,20
35,r_1_15_24,seq123,r_75_81_71,r_75_81_71,0.95,40,111,71,20
25,r_100_38_91,seq47,r_77_0_34,r_100_38_91,0.94,0,91,91,20
43,r_49_79_23,seq47,r_88_94_106,r_88_94_106,0.96,10,116,106,20
33,r_90_136_68,r_2_28_113,r_148_13_47,r_90_136_68,0.91,1,69,68,20
1,r_12_63_37,r_11_21_152,r_119_24_13,r_12_63_37,1.0,0,37,37,20
68,seq51,r_55_31_84,r_30_39_77,r_30_39_77,0.76,9,86,77,20
61,seq29,r_132_14_130,seq47,r_132_14_130,1.0,0,130,130,20
32,r_93_71_87,r_88_94_106,r_56_64_95,r_93_71_87,0.93,5,92,87,20
38,r_32_143_97,r_114_126_148,seq113,r_32_143_97,0.97,2,99,97,20
26,r_119_24_13,r_102_37_21,seq109,r_119_24_13,0.99,-1,12,13,20
34,r_58_25_137,seq111,r_147_57_100,r_58_25_137,0.63,0,137,137,20
60,seq26,r_87_66_98,r_102_37_21,r_87_66_98,0.97,0,98,98,20
47,r_73_104_58,r_77_0_34,seq26,r_73_104_58,0.98,1,59,58,20
43,r_49_79_23,r_55_31_84,seq47,r_55_31_84,0.93,-61,23,84,20
20,r_77_0_34,r_41_34_120,r_73_104_58,r_77_0_34,0.75,0,34,34,20
22,r_70_140_191,r_58_25_137,r_54_138_133,r_70_140_191,0.77,-54,137,191,20
12,r_27_121_15,seq133,r_48_19_176,r_27_121_15,0.97,0,15,15,20
49,r_6_43_153,r_107_36_151,r_117_60_19,r_107_36_151,0.97,0,151,151,20
28,r_10_33_4,r_11_21_152,r_80_45_12,r_11_21_152,0.92,-97,55,152,20
44,r_48_19_176,seq135,r_54_138_133,r_54_138_133,0.8,44,177,133,20
79,seq86,r_68_139_82,seq112,r_68_139_82,1.0,1,83,82,20
30,r_109_90_110,r_24_107_177,r_40_92_6,r_109_90_110,0.93,2,112,110,21
44,r_137_142_29,r_53_64_184,r_50_76_153,r_53_64_184,0.47,0,184,184,21
36,r_12_66_85,seq2,seq48,r_12_66_85,1.0,0,85,85,21
92,seq108,seq62,r_13_97_112,r_13_97_112,0.98,1,113,112,21
14,r_57_25_137,seq78,r_149_61_19,r_57_25_137,0.96,1,138,137,21
8,r_133_10_132,r_13_97_112,r_144_85_73,r_144_85_73,0.87,27,100,73,21
53,seq131,r_74_132_122,r_39_122_194,r_74_132_122,1.0,0,122,122,21
43,r_56_71_154,r_24_107_177,seq135,r_56_71_154,0.58,2,156,154,21
37,r_126_82_94,seq77,seq84,r_126_82_94,0.99,5,99,94,21
80,seq62,r_96_87_11,seq21,r_96_87_11,0.75,2,13,11,21
21,r_45_101_163,seq124,r_93_125_61,r_93_125_61,0.52,102,163,61,21
39,r_68_129_141,seq48,seq111,r_68_129_141,0.8,0,141,141,21
1,r_43_145_84,seq70,r_99_103_41,r_99_103_41,0.88,43,84,41,21
80,seq62,seq21,r_13_97_112,r_13_97_112,1.0,8,120,112,21
5,r_42_105_142,seq138,seq141,r_42_105_142,0.79,0,142,142,21
46,r_53_64_184,r_95_146_62,r_137_142_29,r_53_64_184,0.77,-122,62,184,21
42,r_20_4_76,r_139_1_101,seq124,r_20_4_76,1.0,0,76,76,21
18,r_52_130_28,seq28,seq26,r_52_130_28,0.88,1,29,28,21
45,r_93_125_61,r_18_100_98,seq59,r_93_125_61,0.83,2,63,61,21
19,r_46_9_66,r_75_51_161,seq2,r_46_9_66,0.98,-1,65,66,21
95,seq114,r_46_9_66,r_123_134_145,r_46_9_66,0.88,19,85,66,21
89,seq84,seq140,r_126_82_94,r_126_82_94,0.95,4,98,94,21
4,r_116_5_196,r_99_103_41,seq59,r_99_103_41,1.0,0,41,41,21
72,seq47,r_11_118_185,r_102_7_173,r_11_118_185,0.37,0,185,185,21
78,seq59,seq143,r_93_125_61,r_93_125_61,1.0,0,61,61,21
0,r_6_73_133,seq140,seq94,r_6_73_133,0.99,0,133,133,21
11,r_139_1_101,seq135,r_88_91_20,r_88_91_20,0.99,80,100,20,21
20,r_106_16_118,r_6_73_133,seq77,r_106_16_118,0.89,0,118,118,21
13,r_24_107_177,r_39_122_194,r_83_113_111,r_83_113_111,0.83,68,179,111,21
46,r_53_64_184,r_137_142_29,r_95_146_62,r_137_142_29,0.7,155,184,29,21
48,r_144_85_73,seq147,r_133_10_132,r_144_85_73,0.72,2,75,73,21
49,r_75_51_161,r_24_107_177,r_46_9_66,r_46_9_66,0.5,95,161,66,21
33,r_8_98_146,seq147,r_20_4_76,r_8_98_146,1.0,0,146,146,21
6,r_123_134_145,r_127_89_90,r_53_64_184,r_127_89_90,0.88,0,90,90,21
99,seq124,r_45_101_163,r_20_4_76,r_20_4_76,1.0,24,100,76,21
31,r_88_91_20,seq141,seq77,r_88_91_20,1.0,0,20,20,21
2,r_14_37_139,seq2,r_69_27_26,r_14_37_139,0.88,2,141,139,21
47,r_11_118_185,seq47,r_95_146_62,r_95_146_62,0.97,123,185,62,21
57,seq141,r_88_91_20,seq94,r_88_91_20,0.77,0,20,20,21
29,r_121_15_115,r_57_25_137,r_13_97_112,r_121_15_115,0.98,3,118,115,21
62,seq21,seq62,r_99_103_41,r_99_103_41,1.0,5,46,41,21
8,r_133_10_132,r_144_85_73,r_127_89_90,r_133_10_132,1.0,0,132,132,21
24,r_29_33_165,seq128,seq147,r_29_33_165,0.63,0,165,165,21
15,r_136_120_53,seq35,r_52_130_28,r_136_120_53,0.99,0,53,53,21
25,r_74_132_122,seq131,seq84,r_74_132_122,0.94,0,122,122,21
33,r_8_98_146,r_18_100_98,seq147,r_18_100_98,0.98,0,98,98,21
32,r_18_100_98,r_8_98_146,r_149_61_19,r_18_100_98,0.84,0,98,98,21
52,seq2,r_14_37_139,r_46_9_66,r_46_9_66,0.99,75,141,66,21
6,r_123_134_145,r_53_64_184,r_96_87_11,r_123_134_145,1.0,1,146,145,21
57,seq141,seq94,r_42_105_142,r_42_105_142,0.81,0,142,142,21
10,r_149_61_19,r_24_107_177,seq23,r_149_61_19,0.64,4,23,19,21
3,r_22_104_30,seq30,seq147,r_22_104_30,1.0,1,31,30,21
44,r_137_142_29,seq32,r_53_64_184,r_137_142_29,1.0,0,29,29,21
60,seq147,r_144_85_73,seq35,r_144_85_73,1.0,2,75,73,21
17,r_96_87_11,seq81,r_123_134_145,r_123_134_145,0.84,3,148,145,21
22,r_13_97_112,r_133_10_132,r_121_15_115,r_121_15_115,0.96,-2,113,115,21
28,r_80_19_179,seq119,seq140,r_80_19_179,0.43,2,181,179,21
41,r_110_44_46,r_29_33_165,seq30,r_110_44_46,1.0,2,48,46,21
49,r_75_51_161,r_46_9_66,r_24_107_177,r_46_9_66,0.99,3,69,66,21
68,seq32,r_137_142_29,r_69_27_26,r_137_142_29,0.97,0,29,29,21
56,seq140,r_6_73_133,seq79,r_6_73_133,1.0,0,133,133,21
7,r_95_146_62,r_53_64_184,seq111,r_95_146_62,1.0,0,62,62,21
23,r_127_89_90,r_123_134_145,seq70,r_127_89_90,0.96,0,90,90,21
27,r_99_103_41,r_116_5_196,seq21,r_99_103_41,1.0,0,41,41,21
12,r_83_113_111,seq23,seq48,r_83_113_111,0.93,1,112,111,21
38,r_69_27_26,r_11_118_185,seq32,r_69_27_26,0.62,1,27,26,21
7,r_70_2_19,r_97_20_27,seq83,r_70_2_19,0.98,-1,18,19,22
40,r_89_113_32,r_73_96_187,r_26_82_154,r_26_82_154,0.63,4,158,154,22
30,r_58_101_134,seq91,r_28_87_130,r_58_101_134,0.93,3,137,134,22
38,r_120_106_46,seq145,seq124,r_120_106_46,1.0,0,46,46,22
51,seq7,r_137_127_171,r_78_35_149,r_78_35_149,0.79,22,171,149,22
36,r_39_44_68,seq1,seq74,r_39_44_68,1.0,0,68,68,22
69,seq42,seq56,r_65_22_50,r_65_22_50,1.0,1,51,50,22
14,r_73_96_187,seq14,r_11_21_22,r_11_21_22,0.98,78,100,22,22
43,r_137_127_171,seq7,r_54_104_186,r_137_127_171,0.59,0,171,171,22
16,r_55_118_61,r_133_79_184,seq43,r_55_118_61,1.0,0,61,61,22
21,r_114_17_95,r_107_94_173,r_130_112_82,r_107_94_173,1.0,-78,95,173,22
39,r_13_67_168,seq86,r_148_142_178,r_13_67_168,0.79,2,170,168,22
1,r_117_80_158,r_78_35_149,r_29_63_132,r_117_80_158,0.75,-17,141,158,22
1,r_117_80_158,r_89_113_32,r_78_35_149,r_117_80_158,0.66,-81,77,158,22
5,r_99_4_140,seq124,r_147_144_127,r_99_4_140,0.85,-1,139,140,22
46,r_148_142_178,r_105_46_119,r_13_67_168,r_13_67_168,0.73,12,180,168,22
41,r_97_20_27,r_105_46_119,seq102,r_97_20_27,0.95,0,27,27,22
2,r_65_22_50,seq31,seq42,r_65_22_50,1.0,0,50,50,22
40,r_89_113_32,r_117_80_158,r_73_96_187,r_89_113_32,0.73,-3,29,32,22
31,r_85_6_145,seq100,seq75,r_85_6_145,1.0,1,146,145,22
10,r_78_35_149,seq18,seq7,r_78_35_149,0.76,0,149,149,22
26,r_139_116_60,seq124,seq1,r_139_116_60,1.0,0,60,60,22
0,r_16_146_41,seq48,seq43,r_16_146_41,1.0,0,41,41,22
14,r_73_96_187,r_11_21_22,seq145,r_11_21_22,0.7,165,187,22,22
4,r_123_45_85,seq74,r_16_146_41,r_123_45_85,1.0,0,85,85,22
11,r_130_112_82,seq42,r_60_3_34,r_60_3_34,0.76,49,83,34,22
20,r_107_94_173,r_114_17_95,seq15,r_114_17_95,1.0,-6,89,95,22
13,r_29_63_132,r_26_82_154,r_117_80_158,r_29_63_132,0.81,0,132,132,22
15,r_61_12_123,r_26_82_154,r_60_3_34,r_60_3_34,0.66,90,124,34,22
48,r_88_37_91,r_13_67_168,seq91,r_88_37_91,1.0,0,91,91,22
12,r_11_21_22,r_73_96_187,r_33_103_43,r_33_103_43,0.9,144,187,43,22
1,r_117_80_158,r_29_63_132,seq24,r_117_80_158,0.92,0,158,158,22
13,r_29_63_132,r_117_80_158,r_54_104_186,r_117_80_158,0.95,0,158,158,22
6,r_147_144_127,r_133_79_184,seq98,r_147_144_127,0.9,0,127,127,22
0,r_16_146_41,seq43,r_123_45_85,r_123_45_85,1.0,23,108,85,22
27,r_77_136_78,r_5_57_121,seq49,r_77_136_78,0.98,-3,75,78,22
12,r_11_21_22,r_139_116_60,r_73_96_187,r_73_96_187,0.78,-167,20,187,22
47,r_133_79_184,r_147_144_127,seq18,r_147_144_127,0.67,0,127,127,22
18,r_62_115_129,seq100,seq102,r_62_115_129,0.97,0,129,129,22
29,r_26_82_154,r_29_63_132,r_0_143_100,r_0_143_100,0.63,32,132,100,22
19,r_125_108_52,r_69_36_141,r_54_104_186,r_125_108_52,0.89,-1,51,52,22
11,r_130_112_82,r_60_3_34,r_114_17_95,r_130_112_82,0.61,45,127,82,22
25,r_131_81_133,seq51,r_62_115_129,r_131_81_133,0.98,0,133,133,22
33,r_5_57_121,r_28_87_130,r_88_37_91,r_28_87_130,1.0,-9,121,130,22
64,seq27,r_64_132_190,r_128_92_159,r_128_92_159,0.98,2,161,159,22
47,r_133_79_184,seq18,r_78_35_149,r_133_79_184,0.81,3,187,184,22
58,seq15,r_107_94_173,r_65_22_50,r_65_22_50,0.99,123,173,50,22
20,r_107_94_173,seq15,r_78_35_149,r_107_94_173,0.56,0,173,173,22
32,r_0_143_100,r_62_115_129,seq19,r_0_143_100,1.0,-1,99,100,22
17,r_60_3_34,r_13_67_168,r_105_46_119,r_60_3_34,1.0,0,34,34,22
59,seq145,r_120_106_46,seq122,r_120_106_46,1.0,-3,43,46,22
94,seq100,r_85_6_145,r_69_36_141,r_85_6_145,1.0,1,146,145,22
9,r_128_92_159,seq24,seq27,r_128_92_159,0.92,0,159,159,22
28,r_84_126_98,r_148_142_178,r_55_118_61,r_55_118_61,1.0,23,84,61,22
3,r_54_104_186,r_121_41_185,r_125_108_52,r_125_108_52,0.95,4,56,52,22
87,seq83,r_99_4_140,r_70_2_19,r_70_2_19,1.0,1,20,19,22
23,r_66_38_83,r_123_45_85,r_125_108_52,r_66_38_83,1.0,0,83,83,22
29,r_26_82_154,r_0_143_100,r_89_113_32,r_26_82_154,0.77,0,154,154,22
93,seq144,r_136_73_186,r_138_96_157,r_138_96_157,0.85,29,186,157,23
36,r_77_103_130,r_138_96_157,seq70,r_77_103_130,0.97,0,130,130,23
14,r_115_20_131,seq27,seq58,r_115_20_131,1.0,0,131,131,23
43,r_137_43_183,r_52_114_164,r_102_18_165,r_137_43_183,0.45,-17,166,183,23
30,r_72_98_18,seq29,seq65,r_72_98_18,0.99,0,18,18,23
37,r_138_96_157,seq95,seq144,r_138_96_157,0.82,0,157,157,23
59,seq146,r_36_2_146,seq71,r_36_2_146,0.79,0,146,146,23
16,r_105_75_87,seq34,seq92,r_105_75_87,1.0,2,89,87,23
21,r_52_114_164,r_137_43_183,r_36_2_146,r_137_43_183,0.68,-17,166,183,23
1,r_99_147_129,seq91,r_109_135_95,r_99_147_129,0.97,-2,127,129,23
42,r_113_128_110,r_77_103_130,r_33_63_92,r_77_103_130,1.0,-20,110,130,23
80,seq70,r_121_129_173,r_78_94_57,r_78_94_57,1.0,69,126,57,23
45,r_119_86_126,seq74,r_67_130_64,r_67_130_64,1.0,63,127,64,23
19,r_25_100_142,r_50_49_158,r_125_142_72,r_50_49_158,0.57,-15,143,158,23
89,seq92,seq40,r_132_42_31,r_132_42_31,1.0,-2,29,31,23
95,seq110,r_13_76_184,r_125_142_72,r_125_142_72,1.0,112,184,72,23
41,r_116_4_134,r_138_96_157,seq91,r_116_4_134,0.56,0,134,134,23
3,r_111_143_85,r_77_103_130,seq15,r_111_143_85,1.0,-1,84,85,23
90,seq95,r_138_96_157,r_125_142_72,r_125_142_72,0.97,85,157,72,23
4,r_57_22_73,r_99_147_129,r_87_26_88,r_57_22_73,0.98,-5,68,73,23
0,r_125_142_72,r_82_24_199,seq104,r_125_142_72,1.0,2,74,72,23
63,seq34,r_105_75_87,seq27,r_105_75_87,1.0,5,92,87,23
98,seq123,r_62_127_151,r_21_134_75,r_62_127_151,0.41,5,156,151,23
15,r_84_44_128,seq15,seq16,r_84_44_128,0.79,0,128,128,23
48,r_136_73_186,seq144,r_125_142_72,r_125_142_72,0.99,112,184,72,23
13,r_132_42_31,seq16,seq92,r_132_42_31,1.0,-2,29,31,23
8,r_36_2_146,r_136_73_186,r_52_114_164,r_36_2_146,0.55,40,186,146,23
6,r_19_83_48,seq70,seq65,r_19_83_48,0.99,-3,45,48,23
27,r_33_63_92,r_21_134_75,seq91,r_33_63_92,1.0,0,92,92,23
5,r_101_23_32,seq34,seq47,r_101_23_32,1.0,0,32,32,23
2,r_82_24_199,r_112_117_180,r_148_39_117,r_148_39_117,0.85,54,171,117,23
47,r_67_130_64,r_52_114_164,seq104,r_67_130_64,1.0,0,64,64,23
40,r_21_134_75,r_51_131_84,seq40,r_51_131_84,1.0,-16,68,84,23
74,seq58,r_121_129_173,r_115_20_131,r_115_20_131,0.79,42,173,131,23
18,r_50_49_158,seq29,r_33_63_92,r_33_63_92,0.97,66,158,92,23
29,r_0_133_171,seq71,r_87_26_88,r_87_26_88,0.59,85,173,88,23
25,r_112_117_180,seq91,seq81,r_112_117_180,0.48,0,180,180,23
33,r_48_12_169,r_52_114_164,r_87_26_88,r_52_114_164,0.76,2,166,164,23
34,r_62_127_151,seq123,r_66_61_67,r_62_127_151,0.44,5,156,151,23
10,r_102_18_165,r_137_43_183,seq71,r_137_43_183,0.76,0,183,183,23
17,r_120_31_155,seq60,r_148_39_117,r_148_39_117,0.91,38,155,117,23
9,r_148_39_117,seq1,seq27,r_148_39_117,0.94,0,117,117,23
22,r_68_108_152,seq145,r_125_142_72,r_68_108_152,0.66,0,152,152,23
28,r_38_106_177,seq29,r_124_8_33,r_124_8_33,0.71,144,177,33,23
49,r_17_93_60,r_10_59_194,seq1,r_17_93_60,1.0,0,60,60,23
43,r_137_43_183,r_102_18_165,r_17_93_60,r_137_43_183,0.88,0,183,183,23
10,r_102_18_165,seq146,r_137_43_183,r_102_18_165,0.94,1,166,165,23
23,r_87_26_88,r_10_59_194,seq29,r_10_59_194,0.6,-119,75,194,23
82,seq74,r_119_86_126,seq56,r_119_86_126,0.72,1,127,126,23
31,r_78_94_57,r_84_44_128,seq70,r_78_94_57,1.0,0,57,57,23
12,r_121_129_173,seq58,r_105_75_87,r_121_129_173,0.73,0,173,173,23
28,r_90_25_16,r_131_99_174,r_45_16_10,r_90_25_16,0.96,0,16,16,24
14,r_124_140_117,seq110,r_3_89_43,r_3_89_43,1.0,78,121,43,24
8,r_103_37_105,seq34,seq18,r_103_37_105,0.66,4,109,105,24
43,r_115_76_147,seq27,seq105,r_115_76_147,0.96,0,147,147,24
83,seq78,r_13_11_111,seq148,r_13_11_111,0.81,0,111,111,24
37,r_91_104_165,r_134_15_169,r_106_107_80,r_91_104_165,0.59,1,166,165,24
16,r_134_15_169,r_91_104_165,seq80,r_91_104_165,0.62,1,166,165,24
39,r_75_9_162,seq110,seq41,r_75_9_162,0.62,2,164,162,24
23,r_72_116_19,seq20,seq66,r_72_116_19,1.0,0,19,19,24
5,r_19_112_102,seq123,seq22,r_19_112_102,0.79,0,102,102,24
46,r_7_77_112,seq80,seq83,r_7_77_112,0.96,0,112,112,24
45,r_21_120_22,r_106_107_80,seq34,r_21_120_22,1.0,0,22,22,24
87,seq83,r_4_29_3,r_126_127_13,r_126_127_13,1.0,2,15,13,24
7,r_126_127_13,seq83,r_58_133_91,r_58_133_91,1.0,1,92,91,24
3,r_2_121_14,seq59,seq44,r_2_121_14,0.99,0,14,14,24
15,r_70_51_176,r_3_89_43,r_43_38_89,r_70_51_176,0.63,4,180,176,24
72,seq49,seq50,r_95_57_40,r_95_57_40,0.89,11,51,40,24
35,r_128_135_180,r_95_57_40,r_45_16_10,r_95_57_40,1.0,7,47,40,24
95,seq105,seq113,r_115_76_147,r_115_76_147,0.99,3,150,147,24
66,seq33,r_70_51_176,r_3_89_43,r_3_89_43,1.0,93,136,43,24
71,seq44,r_60_48_181,r_2_121_14,r_2_121_14,0.97,1,15,14,24
31,r_84_129_160,seq42,seq82,r_84_129_160,0.87,-2,158,160,24
67,seq34,r_103_37_105,r_21_120_22,r_21_120_22,0.78,87,109,22,24
89,seq87,r_60_48_181,r_81_96_49,r_81_96_49,0.94,132,181,49,24
11,r_28_137_31,r_106_107_80,seq22,r_28_137_31,0.96,3,34,31,24
0,r_106_107_80,r_101_53_4,seq50,r_101_53_4,0.91,77,81,4,24
38,r_63_30_52,seq148,r_45_16_10,r_63_30_52,1.0,3,55,52,24
63,seq22,r_26_71_126,r_64_8_118,r_64_8_118,0.59,-4,114,118,24
13,r_4_29_3,r_101_53_4,r_93_31_152,r_4_29_3,0.38,148,151,3,24
15,r_70_51_176,seq33,r_3_89_43,r_3_89_43,1.0,55,98,43,24
48,r_114_32_124,r_101_53_4,r_109_47_29,r_101_53_4,0.69,120,124,4,24
17,r_117_130_15,r_134_15_169,seq98,r_117_130_15,0.57,59,74,15,24
21,r_144_119_50,r_60_48_181,seq110,r_144_119_50,1.0,0,50,50,24
85,seq80,r_7_77_112,seq59,r_7_77_112,0.87,0,112,112,24
4,r_125_111_47,r_134_15_169,r_101_53_4,r_125_111_47,0.98,5,52,47,24
99,seq123,r_19_112_102,seq79,r_19_112_102,1.0,0,102,102,24
1,r_131_99_174,r_91_104_165,seq98,r_131_99_174,0.46,-100,74,174,24
10,r_3_89_43,r_70_51_176,r_124_140_117,r_3_89_43,0.72,137,180,43,24
22,r_43_38_89,r_28_137_31,seq148,r_28_137_31,0.52,96,127,31,24
29,r_14_102_20,seq55,seq142,r_14_102_20,0.77,-1,19,20,24
22,r_43_38_89,seq148,r_70_51_176,r_43_38_89,0.51,91,180,89,24
19,r_85_61_36,r_106_107_80,seq27,r_85_61_36,0.93,2,38,36,24
2,r_46_108_90,r_115_76_147,seq49,r_46_108_90,0.94,1,91,90,24
47,r_26_71_126,seq22,r_45_16_10,r_45_16_10,0.79,118,128,10,24
18,r_60_48_181,seq87,r_3_89_43,r_3_89_43,0.68,140,183,43,24
35,r_128_135_180,r_45_16_10,seq55,r_128_135_180,0.52,0,180,180,24
25,r_58_133_91,seq80,r_126_127_13,r_58_133_91,1.0,0,91,91,24
20,r_81_96_49,r_19_112_102,seq27,r_81_96_49,0.98,1,50,49,24
10,r_3_89_43,seq18,r_70_51_176,r_3_89_43,1.0,1,44,43,24
68,seq39,r_138_10_158,r_3_89_43,r_3_89_43,0.86,118,161,43,24
42,r_109_47_29,r_91_104_165,r_114_32_124,r_114_32_124,0.92,42,166,124,24
32,r_122_118_168,r_60_48_181,r_103_37_105,r_122_118_168,0.55,0,168,168,24
34,r_1_146_68,seq98,seq49,r_1_146_68,1.0,0,68,68,24
7,r_126_127_13,r_103_37_105,seq83,r_126_127_13,1.0,0,13,13,24
30,r_95_57_40,r_128_135_180,seq49,r_95_57_40,1.0,8,48,40,24
98,seq148,r_63_30_52,seq78,r_63_30_52,1.0,3,55,52,24
9,r_64_8_118,seq33,r_19_112_102,r_64_8_118,0.7,-4,114,118,24
1,r_131_99_174,r_90_25_16,r_91_104_165,r_131_99_174,0.76,-159,15,174,24
26,r_45_16_10,r_128_135_180,r_90_25_16,r_45_16_10,0.45,90,100,10,24
17,r_117_130_15,seq18,r_134_15_169,r_117_130_15,1.0,0,15,15,24
22,r_43_38_89,seq142,r_28_137_31,r_43_38_89,0.48,7,96,89,24
91,seq94,seq33,r_3_89_43,r_3_89_43,1.0,89,132,43,24
56,seq142,r_43_38_89,seq5,r_43_38_89,1.0,6,95,89,24
44,r_141_74_60,seq44,r_126_127_13,r_141_74_60,1.0,0,60,60,24
42,r_109_47_29,r_56_92_65,r_91_104_165,r_109_47_29,0.98,0,29,29,24
12,r_100_132_114,r_114_32_124,r_103_37_105,r_100_132_114,0.99,0,114,114,24
23,r_72_116_19,seq66,r_138_10_158,r_138_10_158,0.89,-1,157,158,24
23,r_29_32_52,r_36_5_165,seq47,r_29_32_52,1.0,0,52,52,25
38,r_22_60_53,r_86_40_154,r_21_148_51,r_22_60_53,1.0,0,53,53,25
8,r_86_40_154,seq1,r_43_124_100,r_43_124_100,0.53,54,154,100,25
43,r_96_63_189,r_34_73_132,r_136_81_177,r_34_73_132,1.0,2,134,132,25
37,r_117_20_117,seq133,r_98_11_32,r_117_20_117,1.0,0,117,117,25
2,r_98_11_32,r_110_58_68,seq103,r_98_11_32,0.98,1,33,32,25
43,r_96_63_189,r_136_81_177,r_57_122_181,r_136_81_177,0.98,13,190,177,25
1,r_7_100_98,seq26,seq108,r_7_100_98,0.91,0,98,98,25
5,r_43_124_100,seq27,seq108,r_43_124_100,1.0,0,100,100,25
46,r_87_31_118,seq138,r_21_148_51,r_87_31_118,0.99,0,118,118,25
69,seq38,r_8_66_106,r_72_140_167,r_8_66_106,1.0,1,107,106,25
45,r_149_107_83,r_91_109_170,seq59,r_149_107_83,0.98,2,85,83,25
10,r_21_148_51,r_118_142_92,r_22_60_53,r_22_60_53,1.0,4,57,53,25
19,r_8_66_106,seq38,seq51,r_8_66_106,1.0,2,108,106,25
40,r_49_74_33,seq131,seq128,r_49_74_33,1.0,1,34,33,25
31,r_90_125_4,r_91_109_170,r_102_69_87,r_102_69_87,1.0,74,161,87,25
89,seq85,r_91_109_170,r_102_69_87,r_102_69_87,1.0,64,151,87,25
26,r_136_81_177,r_65_24_73,r_37_64_163,r_65_24_73,0.46,48,121,73,25
0,r_82_33_159,seq144,r_29_32_52,r_29_32_52,1.0,108,160,52,25
29,r_112_146_59,r_116_54_131,r_111_88_1,r_112_146_59,1.0,0,59,59,25
73,seq47,seq75,r_93_101_62,r_93_101_62,1.0,10,72,62,25
11,r_25_9_124,seq1,seq134,r_25_9_124,0.98,1,125,124,25
13,r_91_109_170,seq85,r_82_33_159,r_91_109_170,0.64,0,170,170,25
15,r_116_54_131,seq108,seq6,r_116_54_131,1.0,0,131,131,25
48,r_13_30_116,seq47,r_78_79_70,r_13_30_116,0.68,0,116,116,25
6,r_129_0_138,r_132_94_80,r_110_58_68,r_110_58_68,0.99,13,81,68,25
62,seq17,r_110_58_68,r_118_142_92,r_110_58_68,1.0,-1,67,68,25
81,seq67,r_82_33_159,r_39_62_50,r_39_62_50,1.0,1,51,50,25
9,r_97_114_46,r_36_5_165,seq141,r_97_114_46,1.0,0,46,46,25
27,r_78_79_70,r_147_84_15,seq23,r_78_79_70,1.0,0,70,70,25
39,r_115_35_16,r_65_24_73,r_129_0_138,r_115_35_16,1.0,0,16,16,25
47,r_110_58_68,r_28_104_122,r_129_0_138,r_110_58_68,0.9,0,68,68,25
14,r_113_15_25,r_78_79_70,r_90_125_4,r_113_15_25,1.0,2,27,25,25
3,r_77_42_48,seq10,r_21_148_51,r_77_42_48,0.71,4,52,48,25
18,r_57_122_181,seq128,r_4_16_35,r_4_16_35,0.63,146,181,35,25
24,r_34_73_132,r_96_63_189,seq134,r_34_73_132,0.97,2,134,132,25
33,r_53_105_188,seq23,r_149_107_83,r_149_107_83,0.76,106,189,83,25
47,r_110_58_68,r_129_0_138,r_29_32_52,r_129_0_138,1.0,0,138,138,25
65,seq23,r_53_105_188,r_78_79_70,r_78_79_70,1.0,83,153,70,25
61,seq144,r_82_33_159,r_149_107_83,r_149_107_83,1.0,42,125,83,25
32,r_72_140_167,seq76,seq46,r_72_140_167,0.68,2,169,167,25
34,r_111_88_1,r_7_100_98,r_112_146_59,r_112_146_59,0.88,3,62,59,25
39,r_115_35_16,r_129_0_138,r_29_32_52,r_115_35_16,0.96,59,75,16,25
16,r_102_69_87,r_72_140_167,seq85,r_102_69_87,0.64,0,87,87,25
6,r_129_0_138,r_110_58_68,r_97_114_46,r_129_0_138,1.0,0,138,138,25
96,seq108,r_116_54_131,r_43_124_100,r_43_124_100,0.6,31,131,100,25
16,r_102_69_87,r_4_16_35,r_72_140_167,r_4_16_35,0.6,0,35,35,25
22,r_93_101_62,seq128,seq47,r_93_101_62,1.0,0,62,62,25
28,r_118_142_92,r_21_148_51,seq17,r_21_148_51,0.69,38,89,51,25
93,seq131,r_49_74_33,seq133,r_49_74_33,0.96,1,34,33,25
49,r_4_16_35,r_102_69_87,seq45,r_4_16_35,1.0,1,36,35,25
7,r_132_94_80,r_129_0_138,seq134,r_129_0_138,0.91,-57,81,138,25
44,r_120_99_110,seq6,r_147_84_15,r_120_99_110,1.0,1,111,110,25
42,r_39_62_50,r_43_124_100,seq67,r_39_62_50,0.94,0,50,50,25
35,r_28_104_122,r_110_58_68,r_91_109_170,r_110_58_68,1.0,0,68,68,25
35,r_28_104_122,r_91_109_170,seq38,r_28_104_122,1.0,0,122,122,25
12,r_36_5_165,seq46,r_116_54_131,r_116_54_131,1.0,34,165,131,25
84,seq77,r_123_101_133,r_95_45_38,r_95_45_38,1.0,1,39,38,26
14,r_34_13_68,seq49,seq91,r_34_13_68,1.0,0,68,68,26
30,r_47_78_35,r_69_147_170,r_64_134_21,r_47_78_35,0.93,0,35,35,26
43,r_123_101_133,r_17_22_22,r_42_54_116,r_42_54_116,0.86,18,134,116,26
61,seq21,r_1_108_166,r_106_29_93,r_1_108_166,0.72,-40,126,166,26
74,seq57,seq18,r_100_103_27,r_100_103_27,1.0,5,32,27,26
86,seq81,seq115,r_112_62_60,r_112_62_60,1.0,10,70,60,26
21,r_65_8_112,r_80_31_90,r_23_20_84,r_65_8_112,0.56,-22,90,112,26
1,r_51_93_99,seq94,r_44_19_12,r_51_93_99,0.83,0,99,99,26
5,r_33_67_157,seq50,r_23_20_84,r_33_67_157,0.71,3,160,157,26
42,r_97_111_123,r_123_101_133,r_7_74_62,r_7_74_62,1.0,8,70,62,26
45,r_112_62_60,r_23_20_84,seq81,r_112_62_60,1.0,1,61,60,26
19,r_63_89_63,r_88_0_83,seq149,r_63_89_63,1.0,1,64,63,26
16,r_95_45_38,r_88_0_83,seq77,r_95_45_38,1.0,0,38,38,26
8,r_64_134_21,r_23_20_84,r_34_13_68,r_64_134_21,1.0,0,21,21,26
3,r_38_36_43,seq79,seq148,r_38_36_43,1.0,0,43,43,26
31,r_113_14_165,seq83,r_102_104_155,r_113_14_165,0.5,1,166,165,26
41,r_17_22_22,r_123_101_133,r_142_5_128,r_123_101_133,0.88,1,134,133,26
10,r_88_0_83,seq49,seq81,r_88_0_83,1.0,0,83,83,26
26,r_109_35_136,seq61,seq48,r_109_35_136,0.92,0,136,136,26
4,r_6_70_105,r_56_140_178,r_64_134_21,r_64_134_21,0.84,85,106,21,26
11,r_23_20_84,seq21,r_65_8_112,r_23_20_84,1.0,0,84,84,26
20,r_59_138_89,r_33_67_157,seq27,r_59_138_89,1.0,0,89,89,26
37,r_25_37_20,seq41,seq11,r_25_37_20,1.0,2,22,20,26
47,r_107_66_29,r_85_90_146,r_53_130_131,r_107_66_29,0.96,0,29,29,26
48,r_128_82_111,r_4_141_117,seq79,r_128_82_111,1.0,0,111,111,26
57,seq15,r_123_101_133,r_142_5_128,r_123_101_133,0.71,-25,108,133,26
22,r_56_140_178,r_116_99_66,r_10_117_119,r_10_117_119,0.8,39,158,119,26
6,r_116_99_66,seq72,r_106_29_93,r_116_99_66,0.62,0,66,66,26
11,r_23_20_84,r_65_8_112,r_145_32_190,r_65_8_112,1.0,2,114,112,26
0,r_53_130_131,r_107_66_29,r_96_43_14,r_53_130_131,0.88,0,131,131,26
49,r_96_43_14,r_46_9_173,seq94,r_96_43_14,0.9,0,14,14,26
44,r_7_74_62,r_97_111_123,r_142_5_128,r_97_111_123,1.0,1,124,123,26
11,r_23_20_84,r_145_32_190,r_33_67_157,r_33_67_157,0.98,8,165,157,26
42,r_97_111_123,r_7_74_62,seq50,r_97_111_123,1.0,1,124,123,26
21,r_65_8_112,r_23_20_84,r_142_5_128,r_65_8_112,0.94,2,114,112,26
2,r_80_31_90,r_65_8_112,r_38_36_43,r_80_31_90,1.0,0,90,90,26
29,r_142_5_128,seq125,r_7_74_62,r_7_74_62,1.0,68,130,62,26
33,r_84_16_87,r_113_14_165,seq75,r_84_16_87,1.0,-1,86,87,26
47,r_107_66_29,r_53_130_131,r_4_141_117,r_4_141_117,0.97,14,131,117,26
50,seq149,seq52,r_63_89_63,r_63_89_63,1.0,104,167,63,26
8,r_64_134_21,r_34_13_68,r_47_78_35,r_34_13_68,1.0,0,68,68,26
61,seq21,r_23_20_84,r_1_108_166,r_23_20_84,1.0,0,84,84,26
32,r_3_121_171,seq11,seq135,r_3_121_171,0.54,0,171,171,26
38,r_85_90_146,seq12,r_80_31_90,r_85_90_146,0.95,1,147,146,26
52,seq131,r_42_54_116,r_137_92_18,r_42_54_116,0.88,3,119,116,26
13,r_100_103_27,r_123_101_133,seq57,r_100_103_27,1.0,0,27,27,26
24,r_44_19_12,r_10_117_119,seq139,r_44_19_12,0.84,0,12,12,26
17,r_42_54_116,seq131,r_118_136_101,r_42_54_116,0.97,3,119,116,26
6,r_116_99_66,r_106_29_93,seq60,r_106_29_93,1.0,1,94,93,26
94,seq114,r_123_101_133,r_142_5_128,r_123_101_133,0.84,-25,108,133,26
9,r_69_147_170,seq76,r_65_8_112,r_69_147_170,0.7,0,170,170,26
96,seq119,r_53_130_131,r_107_66_29,r_107_66_29,0.67,69,98,29,26
22,r_56_140_178,r_6_70_105,r_116_99_66,r_116_99_66,1.0,40,106,66,26
35,r_137_92_18,r_105_124_109,seq131,r_137_92_18,0.93,-3,15,18,26
28,r_1_108_166,seq21,r_88_0_83,r_88_0_83,0.82,83,166,83,26
91,seq94,r_126_28_107,r_96_43_14,r_126_28_107,0.97,-20,87,107,26
7,r_106_29_93,seq40,seq21,r_106_29_93,1.0,1,94,93,26
0,r_53_130_131,seq119,r_107_66_29,r_107_66_29,0.96,22,51,29,26
44,r_7_74_62,seq30,r_97_111_123,r_7_74_62,1.0,3,65,62,26
23,r_126_28_107,seq94,r_106_29_93,r_126_28_107,1.0,0,107,107,26
82,seq75,seq18,r_84_16_87,r_84_16_87,1.0,8,95,87,26
12,r_102_104_155,r_3_121_171,r_109_35_136,r_3_121_171,0.95,-16,155,171,26
30,r_149_5_158,seq107,r_99_86_112,r_99_86_112,0.47,46,158,112,27
36,r_92_40_82,r_81_44_184,r_98_130_26,r_92_40_82,0.99,0,82,82,27
53,seq136,r_55_146_124,seq46,r_55_146_124,0.52,-4,120,124,27
43,r_87_97_188,seq32,r_2_132_91,r_87_97_188,0.6,0,188,188,27
18,r_19_67_34,seq129,seq29,r_19_67_34,0.99,0,34,34,27
31,r_23_54_103,r_106_89_129,seq109,r_23_54_103,1.0,0,103,103,27
37,r_72_8_166,r_18_91_163,r_80_116_171,r_80_116_171,0.35,-75,96,171,27
71,seq46,r_111_4_88,seq17,r_111_4_88,0.55,23,111,88,27
21,r_76_75_134,r_30_148_192,seq33,r_76_75_134,0.94,0,134,134,27
39,r_28_21_131,seq33,seq52,r_28_21_131,0.99,0,131,131,27
1,r_144_142_155,r_127_138_170,seq6,r_144_142_155,0.72,0,155,155,27
1,r_144_142_155,r_147_27_61,r_127_138_170,r_147_27_61,1.0,-1,60,61,27
28,r_82_93_36,seq6,seq38,r_82_93_36,1.0,0,36,36,27
5,r_143_57_105,seq71,seq113,r_143_57_105,0.99,1,106,105,27
46,r_39_145_76,r_23_54_103,r_102_105_17,r_23_54_103,0.55,-2,101,103,27
42,r_0_61_24,r_15_78_177,seq115,r_0_61_24,0.62,-5,19,24,27
57,seq13,r_28_21_131,r_140_117_12,r_140_117_12,1.0,1,13,12,27
45,r_111_4_88,r_55_146_124,seq38,r_111_4_88,0.81,16,104,88,27
15,r_3_25_49,r_55_146_124,r_149_5_158,r_55_146_124,0.49,-66,58,124,27
95,seq119,r_96_94_194,r_41_84_75,r_41_84_75,1.0,1,76,75,27
76,seq52,r_2_132_91,r_80_116_171,r_2_132_91,1.0,3,94,91,27
31,r_23_54_103,r_39_145_76,r_106_89_129,r_39_145_76,0.86,-8,68,76,27
67,seq37,r_64_1_191,r_19_67_34,r_19_67_34,1.0,148,182,34,27
24,r_112_120_22,seq32,seq109,r_112_120_22,0.97,-1,21,22,27
26,r_41_84_75,r_65_62_79,seq119,r_41_84_75,1.0,0,75,75,27
4,r_101_59_94,seq29,r_2_132_91,r_101_59_94,0.98,1,95,94,27
0,r_147_27_61,r_144_142_155,r_126_43_46,r_144_142_155,0.93,-95,60,155,27
63,seq32,r_87_97_188,r_19_67_34,r_19_67_34,1.0,147,181,34,27
13,r_55_146_124,seq90,r_34_110_35,r_34_110_35,0.99,93,128,35,27
56,seq12,r_16_95_178,seq77,r_16_95_178,0.9,-57,121,178,27
48,r_106_89_129,seq113,seq26,r_106_89_129,0.92,1,130,129,27
15,r_3_25_49,r_0_61_24,r_18_91_163,r_3_25_49,0.62,129,178,49,27
49,r_18_91_163,seq52,seq123,r_18_91_163,0.76,0,163,163,27
19,r_125_83_196,r_22_53_69,r_102_105_17,r_125_83_196,0.8,-178,18,196,27
8,r_102_105_17,seq74,r_125_83_196,r_102_105_17,0.9,0,17,17,27
6,r_56_20_68,seq45,seq79,r_56_20_68,0.99,0,68,68,27
85,seq79,seq74,r_56_20_68,r_56_20_68,1.0,22,90,68,27
96,seq121,r_128_133_70,r_68_100_38,r_68_100_38,1.0,0,38,38,27
2,r_2_132_91,seq52,r_98_130_26,r_2_132_91,1.0,0,91,91,27
40,r_16_95_178,seq45,seq58,r_16_95_178,0.69,0,178,178,27
29,r_88_73_128,seq121,seq13,r_88_73_128,1.0,1,129,128,27
25,r_81_44_184,seq115,r_87_97_188,r_87_97_188,0.51,-2,186,188,27
33,r_30_148_192,r_76_75_134,seq63,r_76_75_134,1.0,1,135,134,27
17,r_68_100_38,seq113,seq121,r_68_100_38,1.0,0,38,38,27
64,seq33,r_28_21_131,r_140_117_12,r_28_21_131,0.8,0,131,131,27
70,seq45,r_16_95_178,seq77,r_16_95_178,0.51,0,178,178,27
32,r_65_62_79,seq123,seq122,r_65_62_79,0.98,-1,78,79,27
52,seq7,seq85,r_22_53_69,r_22_53_69,1.0,1,70,69,27
41,r_34_110_35,seq109,seq17,r_34_110_35,0.98,0,35,35,27
57,seq13,r_140_117_12,r_88_73_128,r_88_73_128,0.99,-1,127,128,27
34,r_51_103_108,r_15_78_177,r_22_53_69,r_51_103_108,0.99,0,108,108,27
14,r_140_117_12,r_96_94_194,seq13,r_140_117_12,0.99,0,12,12,27
75,seq50,seq13,r_131_134_119,r_131_134_119,0.95,-2,117,119,27
9,r_127_138_170,r_144_142_155,r_0_61_24,r_127_138_170,0.67,-33,137,170,27
59,seq17,r_15_78_177,r_34_110_35,r_34_110_35,0.61,0,35,35,27
15,r_3_25_49,r_149_5_158,r_15_78_177,r_149_5_158,0.43,-76,82,158,27
9,r_127_138_170,r_0_61_24,r_126_43_46,r_127_138_170,0.8,1,171,170,27
37,r_72_8_166,r_80_116_171,r_126_43_46,r_72_8_166,0.97,0,166,166,27
15,r_3_25_49,r_15_78_177,r_0_61_24,r_0_61_24,0.67,57,81,24,27
49,r_18_91_163,r_76_75_134,seq52,r_76_75_134,0.86,-71,63,134,27
44,r_99_86_112,seq47,seq10,r_99_86_112,0.89,3,115,112,27
23,r_131_134_119,seq124,seq50,r_131_134_119,0.96,0,119,119,27
82,seq71,r_143_57_105,seq29,r_143_57_105,0.99,1,106,105,27
76,seq52,r_80_116_171,r_28_21_131,r_28_21_131,1.0,8,139,131,27
12,r_22_53_69,seq36,seq7,r_22_53_69,1.0,0,69,69,27
7,r_126_43_46,seq13,seq36,r_126_43_46,1.0,0,46,46,27
36,r_115_30_144,seq10,r_4_50_63,r_4_50_63,0.96,81,144,63,28
8,r_144_100_98,seq51,r_31_59_90,r_144_100_98,0.7,0,98,98,28
43,r_139_52_53,r_42_61_49,r_6_90_73,r_139_52_53,0.38,16,69,53,28
35,r_7_15_21,r_140_89_179,seq43,r_7_15_21,0.99,-1,20,21,28
59,seq17,r_56_128_186,r_144_100_98,r_144_100_98,1.0,88,186,98,28
43,r_139_52_53,r_6_90_73,r_9_138_105,r_9_138_105,0.97,3,108,105,28
16,r_62_13_100,r_143_123_111,r_6_90_73,r_62_13_100,1.0,0,100,100,28
39,r_5_25_86,r_72_93_112,seq70,r_5_25_86,0.94,0,86,86,28
46,r_99_14_70,seq98,seq28,r_99_14_70,1.0,0,70,70,28
42,r_18_65_128,seq28,seq38,r_18_65_128,1.0,0,128,128,28
14,r_33_71_46,r_35_58_134,r_9_138_105,r_33_71_46,1.0,0,46,46,28
45,r_88_29_197,r_6_90_73,r_4_50_63,r_4_50_63,1.0,22,85,63,28
19,r_23_112_68,seq51,r_20_11_79,r_23_112_68,1.0,1,69,68,28
33,r_106_34_113,r_129_137_45,r_7_15_21,r_106_34_113,0.61,-16,97,113,28
38,r_146_32_54,seq102,seq135,r_146_32_54,0.98,0,54,54,28
66,seq38,seq107,r_149_85_95,r_149_85_95,1.0,0,95,95,28
27,r_42_61_49,r_139_52_53,r_6_90_73,r_42_61_49,0.53,2,51,49,28
41,r_72_93_112,seq3,r_7_15_21,r_72_93_112,1.0,0,112,112,28
67,seq40,seq121,r_144_100_98,r_144_100_98,1.0,12,110,98,28
10,r_131_27_171,r_124_126_198,r_33_71_46,r_33_71_46,1.0,126,172,46,28
26,r_134_97_129,seq135,seq54,r_134_97_129,1.0,0,129,129,28
4,r_149_85_95,r_9_138_105,seq38,r_149_85_95,0.98,0,95,95,28
0,r_111_84_87,r_131_27_171,seq86,r_111_84_87,1.0,1,88,87,28
11,r_20_11_79,r_5_25_86,r_23_112_68,r_20_11_79,0.99,-3,76,79,28
14,r_33_71_46,r_124_126_198,r_37_114_116,r_37_114_116,0.99,2,118,116,28
20,r_140_89_179,seq53,r_45_83_143,r_140_89_179,0.61,1,180,179,28
2,r_12_49_38,seq148,r_88_29_197,r_12_49_38,1.0,3,41,38,28
6,r_66_122_125,r_131_27_171,seq2,r_66_122_125,0.83,0,125,125,28
15,r_118_8_44,r_18_65_128,seq51,r_118_8_44,0.99,1,45,44,28
68,seq43,seq47,r_7_15_21,r_7_15_21,0.99,15,36,21,28
21,r_116_133_28,r_140_89_179,r_87_41_182,r_116_133_28,1.0,1,29,28,28
3,r_129_137_45,seq109,r_106_34_113,r_129_137_45,1.0,0,45,45,28
47,r_9_138_105,r_149_85_95,r_33_71_46,r_33_71_46,1.0,49,95,46,28
18,r_87_41_182,r_116_133_28,r_42_61_49,r_42_61_49,0.61,133,182,49,28
24,r_31_59_90,r_72_93_112,seq40,r_31_59_90,1.0,0,90,90,28
25,r_6_90_73,r_88_29_197,seq78,r_6_90_73,0.78,12,85,73,28
64,seq28,r_18_65_128,r_99_14_70,r_99_14_70,0.63,58,128,70,28
88,seq98,r_37_114_116,seq80,r_37_114_116,1.0,0,116,116,28
14,r_33_71_46,r_9_138_105,r_124_126_198,r_9_138_105,1.0,0,105,105,28
17,r_108_63_170,r_35_58_134,seq53,r_108_63_170,0.97,0,170,170,28
32,r_101_39_163,seq91,r_106_34_113,r_101_39_163,0.87,1,164,163,28
34,r_68_16_160,seq2,r_4_50_63,r_68_16_160,0.81,0,160,160,28
7,r_35_58_134,r_108_63_170,r_104_75_145,r_104_75_145,0.78,1,146,145,28
17,r_108_63_170,r_94_1_6,r_35_58_134,r_35_58_134,0.86,0,134,134,28
9,r_64_69_139,r_104_75_145,r_139_52_53,r_64_69_139,0.92,1,140,139,28
33,r_106_34_113,seq43,r_129_137_45,r_129_137_45,1.0,7,52,45,28
28,r_4_50_63,r_115_30_144,r_88_29_197,r_4_50_63,0.64,1,64,63,28
93,seq109,r_129_137_45,seq130,r_129_137_45,1.0,0,45,45,28
12,r_22_44_58,seq40,seq46,r_22_44_58,1.0,0,58,58,28
56,seq130,seq109,r_45_83_143,r_45_83_143,0.93,17,160,143,28
44,r_82_147_67,r_0_95_185,seq70,r_82_147_67,0.98,0,67,67,28
47,r_9_138_105,r_33_71_46,r_139_52_53,r_9_138_105,0.91,0,105,105,28
29,r_73_125_11,r_104_75_145,seq78,r_73_125_11,0.92,0,11,11,28
7,r_35_58_134,r_33_71_46,seq40,r_33_71_46,1.0,0,46,46,28
30,r_43_143_107,seq130,seq19,r_43_143_107,0.74,9,116,107,29
20,r_138_119_54,r_118_128_185,seq53,r_138_119_54,0.76,-17,37,54,29
8,r_93_34_80,seq38,r_39_54_198,r_93_34_80,1.0,0,80,80,29
43,r_37_111_77,r_144_17_197,seq130,r_37_111_77,1.0,0,77,77,29
37,r_145_106_140,r_126_134_137,r_112_101_134,r_112_101_134,0.97,7,141,134,29
19,r_81_75_183,seq117,r_126_134_137,r_81_75_183,0.97,0,183,183,29
21,r_39_54_198,seq80,r_93_34_80,r_93_34_80,1.0,0,80,80,29
5,r_144_17_197,r_37_111_77,seq74,r_37_111_77,1.0,0,77,77,29
46,r_127_48_159,seq107,r_132_133_112,r_127_48_159,0.84,1,160,159,29
42,r_116_42_1,r_65_4_147,r_61_64_26,r_116_42_1,0.94,146,147,1,29
32,r_124_90_14,r_12_114_122,r_105_115_113,r_124_90_14,0.98,108,122,14,29
41,r_21_69_44,r_73_45_45,seq32,r_21_69_44,1.0,0,44,44,29
69,seq46,r_25_40_130,r_21_69_44,r_21_69_44,1.0,92,136,44,29
45,r_118_128_185,seq49,r_126_134_137,r_126_134_137,1.0,49,186,137,29
19,r_81_75_183,r_149_88_111,seq117,r_149_88_111,1.0,1,112,111,29
1,r_89_76_36,r_136_55_110,r_140_121_64,r_89_76_36,1.0,-6,30,36,29
39,r_122_98_109,r_8_44_8,r_103_129_15,r_122_98_109,0.6,-21,88,109,29
31,r_22_29_164,seq27,r_93_34_80,r_93_34_80,0.67,84,164,80,29
3,r_105_115_113,seq125,r_124_90_14,r_105_115_113,1.0,0,113,113,29
10,r_30_70_62,r_132_133_112,seq92,r_30_70_62,0.87,0,62,62,29
26,r_141_26_126,r_71_59_144,seq130,r_71_59_144,0.91,-16,128,144,29
16,r_8_44_8,r_122_98_109,r_16_2_119,r_16_2_119,1.0,-1,118,119,29
4,r_140_121_64,r_141_26_126,r_89_76_36,r_89_76_36,0.62,27,63,36,29
0,r_57_51_116,seq38,seq82,r_57_51_116,1.0,0,116,116,29
11,r_148_67_82,seq32,seq7,r_148_67_82,1.0,0,82,82,29
28,r_61_64_26,r_132_133_112,seq107,r_61_64_26,1.0,-1,25,26,29
44,r_103_129_15,r_140_121_64,r_84_5_10,r_84_5_10,0.87,2,12,10,29
15,r_52_13_158,seq50,r_149_88_111,r_52_13_158,0.93,0,158,158,29
57,seq11,r_120_96_90,r_144_17_197,r_120_96_90,0.6,75,165,90,29
6,r_110_24_121,r_127_48_159,r_122_98_109,r_110_24_121,1.0,0,121,121,29
99,seq125,r_105_115_113,r_144_17_197,r_105_115_113,1.0,0,113,113,29
27,r_120_96_90,seq11,seq10,r_120_96_90,0.97,0,90,90,29
87,seq91,r_145_106_140,r_144_17_197,r_145_106_140,0.99,0,140,140,29
32,r_124_90_14,seq91,r_12_114_122,r_124_90_14,1.0,-2,12,14,29
12,r_84_5_10,r_89_76_36,r_103_129_15,r_103_129_15,0.75,-5,10,15,29
47,r_136_55_110,seq72,r_30_70_62,r_30_70_62,0.85,49,111,62,29
93,seq107,r_83_36_179,r_61_64_26,r_61_64_26,1.0,3,29,26,29
18,r_112_101_134,r_71_59_144,seq27,r_112_101_134,0.7,0,134,134,29
24,r_71_59_144,r_141_26_126,r_120_96_90,r_71_59_144,1.0,1,145,144,29
25,r_58_135_148,seq49,r_149_88_111,r_149_88_111,0.96,43,154,111,29
33,r_47_56_189,seq80,r_83_36_179,r_47_56_189,0.23,1,190,189,29
88,seq92,seq91,r_30_70_62,r_30_70_62,0.76,72,134,62,29
10,r_30_70_62,seq92,r_136_55_110,r_30_70_62,0.69,41,103,62,29
38,r_16_2_119,seq68,r_8_44_8,r_16_2_119,1.0,0,119,119,29
48,r_73_45_45,r_21_69_44,seq68,r_73_45_45,1.0,-1,44,45,29
34,r_132_133_112,seq68,r_99_137_42,r_132_133_112,0.81,4,116,112,29
60,seq19,r_12_114_122,r_43_143_107,r_12_114_122,0.99,0,122,122,29
97,seq117,r_81_75_183,seq123,r_81_75_183,0.73,-152,31,183,29
17,r_25_40_130,seq46,seq60,r_25_40_130,0.71,6,136,130,29
9,r_0_139_142,r_127_48_159,r_8_44_8,r_0_139_142,0.95,0,142,142,29
67,seq38,r_93_34_80,r_95_147_7,r_93_34_80,1.0,-23,57,80,29
49,r_33_146_30,r_81_75_183,seq10,r_33_146_30,1.0,0,30,30,29
22,r_65_4_147,r_116_42_1,r_71_59_144,r_71_59_144,0.73,3,147,144,29
36,r_99_137_42,r_37_111_77,seq131,r_37_111_77,0.93,-34,43,77,29
7,r_149_88_111,r_81_75_183,r_95_147_7,r_149_88_111,1.0,1,112,111,29
35,r_12_114_122,seq19,seq77,r_12_114_122,1.0,0,122,122,29
84,seq82,r_52_13_158,r_57_51_116,r_57_51_116,0.93,22,138,116,29
30,r_52_111_170,seq116,seq53,r_52_111_170,0.64,0,170,170,30
26,r_30_8_44,r_57_127_106,seq70,r_30_8_44,0.81,0,44,44,30
26,r_30_8_44,seq70,r_126_55_78,r_126_55_78,0.92,4,82,78,30
14,r_148_137_63,r_126_55_78,r_54_78_46,r_148_137_63,1.0,0,63,63,30
8,r_57_127_106,seq3,seq51,r_57_127_106,0.94,1,107,106,30
43,r_119_114_156,seq61,seq147,r_119_114_156,0.83,0,156,156,30
37,r_101_21_87,seq80,r_72_84_26,r_101_21_87,0.78,6,93,87,30
21,r_144_91_60,r_148_137_63,seq131,r_144_91_60,1.0,2,62,60,30
39,r_89_77_116,seq2,r_72_84_26,r_89_77_116,0.94,0,116,116,30
1,r_104_44_71,r_97_63_172,seq17,r_104_44_71,1.0,0,71,71,30
5,r_16_28_162,r_52_111_170,r_9_125_66,r_9_125_66,1.0,97,163,66,30
44,r_103_66_76,seq34,r_38_59_21,r_38_59_21,1.0,2,23,21,30
42,r_13_112_55,r_148_137_63,seq2,r_13_112_55,1.0,0,55,55,30
45,r_149_5_114,r_83_115_164,r_82_123_103,r_149_5_114,0.99,1,115,114,30
27,r_72_84_26,r_7_124_160,r_101_21_87,r_72_84_26,0.96,63,89,26,30
16,r_38_59_21,seq45,r_103_66_76,r_38_59_21,0.85,-1,20,21,30
20,r_62_76_33,r_41_18_77,seq51,r_62_76_33,0.88,0,33,33,30
3,r_109_14_138,seq75,seq56,r_109_14_138,0.81,0,138,138,30
16,r_38_59_21,r_103_66_76,seq116,r_103_66_76,1.0,4,80,76,30
34,r_108_134_31,r_109_14_138,r_60_27_126,r_108_134_31,0.99,107,138,31,30
0,r_33_6_99,seq49,r_9_125_66,r_9_125_66,1.0,22,88,66,30
13,r_7_124_160,r_126_55_78,r_72_84_26,r_126_55_78,0.98,2,80,78,30
15,r_60_27_126,r_119_114_156,r_108_134_31,r_60_27_126,0.55,0,126,126,30
48,r_9_125_66,seq2,seq64,r_9_125_66,1.0,1,67,66,30
27,r_72_84_26,seq51,r_7_124_160,r_72_84_26,0.65,0,26,26,30
13,r_7_124_160,r_72_84_26,r_38_59_21,r_7_124_160,1.0,0,160,160,30
44,r_103_66_76,r_38_59_21,seq36,r_103_66_76,1.0,4,80,76,30
11,r_122_40_18,r_71_15_91,seq92,r_122_40_18,1.0,0,18,18,30
47,r_26_65_75,seq75,r_67_133_8,r_67_133_8,0.88,67,75,8,30
40,r_82_123_103,r_110_139_194,seq116,r_82_123_103,1.0,0,103,103,30
10,r_54_78_46,seq45,seq75,r_54_78_46,1.0,3,49,46,30
25,r_141_32_81,seq12,r_62_76_33,r_141_32_81,1.0,1,82,81,30
64,seq36,seq107,r_103_66_76,r_103_66_76,1.0,6,82,76,30
70,seq49,r_33_6_99,seq42,r_33_6_99,0.57,15,114,99,30
32,r_11_29_107,seq48,r_104_44_71,r_11_29_107,0.89,0,107,107,30
38,r_74_25_72,seq131,seq2,r_74_25_72,1.0,1,73,72,30
24,r_90_19_43,seq69,seq10,r_90_19_43,1.0,1,44,43,30
17,r_81_98_176,seq102,r_128_100_90,r_128_100_90,1.0,91,181,90,30
34,r_108_134_31,r_57_127_106,r_67_133_8,r_108_134_31,1.0,0,31,31,30
9,r_126_55_78,r_7_124_160,r_30_8_44,r_126_55_78,0.83,4,82,78,30
22,r_41_18_77,seq58,seq68,r_41_18_77,1.0,3,80,77,30
34,r_108_134_31,r_67_133_8,r_109_14_138,r_108_134_31,0.6,38,69,31,30
2,r_143_4_54,seq64,seq45,r_143_4_54,1.0,1,55,54,30
7,r_128_100_90,r_89_77_116,r_9_125_66,r_89_77_116,0.97,-26,90,116,30
23,r_37_136_62,seq86,seq131,r_37_136_62,1.0,0,62,62,30
41,r_106_50_40,r_41_18_77,seq85,r_106_50_40,0.61,0,40,40,30
31,r_20_120_16,r_16_28_162,seq43,r_20_120_16,1.0,0,16,16,30
35,r_95_142_130,seq51,seq1,r_95_142_130,0.99,1,131,130,30
12,r_71_15_91,seq147,r_144_91_60,r_144_91_60,0.88,31,91,60,30
30,r_55_14_159,r_78_24_194,seq132,r_55_14_159,0.39,2,161,159,31
69,seq37,r_85_82_93,r_77_66_37,r_85_82_93,0.97,-42,51,93,31
14,r_67_45_167,seq65,r_93_2_36,r_93_2_36,1.0,139,175,36,31
8,r_46_149_68,seq134,r_88_64_59,r_46_149_68,1.0,0,68,68,31
60,seq142,r_13_129_140,r_33_38_11,r_33_38_11,0.95,-1,10,11,31
28,r_53_118_21,seq28,r_23_105_157,r_53_118_21,0.97,0,21,21,31
37,r_35_18_31,seq10,seq147,r_35_18_31,0.99,4,35,31,31
83,seq74,r_19_49_117,seq76,r_19_49_117,1.0,0,117,117,31
54,seq134,r_73_9_80,r_144_6_133,r_144_6_133,1.0,9,142,133,31
29,r_135_125_48,seq59,seq62,r_135_125_48,0.98,3,51,48,31
86,seq84,r_91_96_108,r_53_118_21,r_91_96_108,0.69,0,108,108,31
16,r_73_9_80,r_13_129_140,seq134,r_73_9_80,1.0,0,80,80,31
21,r_123_86_185,r_119_56_179,seq139,r_119_56_179,0.64,1,180,179,31
18,r_50_140_50,r_78_24_194,r_7_113_178,r_50_140_50,1.0,0,50,50,31
5,r_81_94_163,seq44,r_73_9_80,r_81_94_163,0.76,0,163,163,31
42,r_119_56_179,r_123_86_185,r_146_17_95,r_146_17_95,0.51,85,180,95,31
41,r_33_38_11,r_63_40_141,seq142,r_33_38_11,0.98,3,14,11,31
45,r_51_47_113,r_108_16_181,r_93_2_36,r_108_16_181,0.89,-68,113,181,31
25,r_93_2_36,r_85_82_93,r_119_56_179,r_93_2_36,1.0,0,36,36,31
48,r_127_71_39,r_116_106_72,seq27,r_116_106_72,1.0,1,73,72,31
48,r_127_71_39,r_81_94_163,r_116_106_72,r_127_71_39,1.0,0,39,39,31
76,seq60,r_21_128_166,seq1,r_21_128_166,1.0,0,166,166,31
31,r_78_24_194,r_50_140_50,seq65,r_50_140_50,1.0,0,50,50,31
26,r_19_49_117,seq74,r_127_71_39,r_19_49_117,0.95,0,117,117,31
4,r_13_129_140,seq62,seq102,r_13_129_140,0.99,1,141,140,31
78,seq65,r_67_45_167,r_43_36_94,r_43_36_94,1.0,81,175,94,31
0,r_146_17_95,seq10,r_77_66_37,r_146_17_95,0.42,11,106,95,31
73,seq44,r_43_36_94,r_53_118_21,r_43_36_94,0.79,-14,80,94,31
11,r_116_106_72,seq27,seq15,r_116_106_72,1.0,1,73,72,31
20,r_122_8_111,r_19_49_117,seq120,r_122_8_111,0.97,0,111,111,31
13,r_63_40_141,seq80,seq99,r_63_40_141,0.98,0,141,141,31
15,r_91_96_108,seq84,seq133,r_91_96_108,0.99,0,108,108,31
48,r_127_71_39,seq27,r_19_49_117,r_19_49_117,1.0,0,117,117,31
93,seq102,seq10,r_13_129_140,r_13_129_140,0.98,0,140,140,31
3,r_88_64_59,seq76,seq10,r_88_64_59,0.97,-2,57,59,31
27,r_144_6_133,seq41,seq134,r_144_6_133,0.81,0,133,133,31
36,r_54_112_51,seq27,seq132,r_54_112_51,0.84,0,51,51,31
2,r_22_58_78,seq132,seq52,r_22_58_78,0.78,2,80,78,31
40,r_111_0_110,seq137,r_110_90_20,r_111_0_110,0.98,0,110,110,31
74,seq52,r_61_75_76,r_22_58_78,r_22_58_78,0.52,2,80,78,31
24,r_7_113_178,r_85_82_93,r_50_140_50,r_7_113_178,1.0,-105,73,178,31
43,r_23_105_157,r_53_118_21,r_43_36_94,r_53_118_21,0.7,136,157,21,31
33,r_21_128_166,seq60,r_83_95_8,r_21_128_166,0.82,0,166,166,31
50,seq1,r_21_128_166,r_109_3_61,r_109_3_61,0.95,3,64,61,31
63,seq147,r_138_12_58,r_35_18_31,r_138_12_58,0.79,0,58,58,31
61,seq15,r_26_117_180,r_116_106_72,r_116_106_72,1.0,0,72,72,31
34,r_79_20_74,r_130_148_196,seq131,r_79_20_74,1.0,0,74,74,31
75,seq59,r_119_56_179,r_67_45_167,r_119_56_179,0.5,-4,175,179,31
17,r_98_11_107,r_7_113_178,r_83_95_8,r_98_11_107,1.0,0,107,107,31
25,r_93_2_36,r_119_56_179,r_51_47_113,r_51_47_113,0.98,62,175,113,31
9,r_85_82_93,r_7_113_178,seq141,r_85_82_93,1.0,0,93,93,31
28,r_53_118_21,r_23_105_157,r_89_5_188,r_23_105_157,0.88,0,157,157,31
22,r_126_104_81,r_43_36_94,seq28,r_126_104_81,0.99,2,83,81,31
49,r_109_3_61,r_91_96_108,seq1,r_109_3_61,0.8,1,62,61,31
43,r_23_105_157,r_43_36_94,r_53_118_21,r_23_105_157,0.96,-118,39,157,31
7,r_61_75_76,seq114,seq70,r_61_75_76,0.89,4,80,76,31
44,r_48_143_77,r_108_16_181,r_79_20_74,r_108_16_181,1.0,-103,78,181,31
1,r_110_90_20,seq102,seq100,r_110_90_20,0.98,0,20,20,31
39,r_77_66_37,seq10,seq37,r_77_66_37,0.78,9,46,37,31
35,r_26_117_180,seq99,r_89_5_188,r_26_117_180,0.54,0,180,180,31
38,r_138_12_58,seq147,seq31,r_138_12_58,1.0,0,58,58,31
12,r_43_36_94,seq141,seq65,r_43_36_94,1.0,0,94,94,31
43,r_33_83_91,seq92,seq138,r_33_83_91,0.77,0,91,91,32
3,r_118_67_172,seq25,seq128,r_118_67_172,0.99,0,172,172,32
55,seq138,seq45,r_33_83_91,r_33_83_91,0.8,6,97,91,32
86,seq98,r_123_73_143,r_46_39_80,r_46_39_80,0.74,8,88,80,32
16,r_74_147_134,r_13_34_133,seq142,r_74_147_134,0.69,2,136,134,32
21,r_29_111_174,seq1,seq81,r_29_111_174,0.75,0,174,174,32
39,r_72_32_167,seq57,r_77_58_119,r_72_32_167,0.81,0,167,167,32
1,r_123_73_143,seq100,seq75,r_123_73_143,0.87,0,143,143,32
97,seq119,r_133_26_171,r_5_36_56,r_5_36_56,0.96,5,61,56,32
46,r_42_86_181,seq69,seq57,r_42_86_181,0.27,6,187,181,32
9,r_5_36_56,r_22_114_194,seq119,r_5_36_56,1.0,0,56,56,32
7,r_63_139_34,r_56_88_55,r_13_34_133,r_13_34_133,1.0,16,149,133,32
45,r_70_141_83,r_47_30_196,seq129,r_70_141_83,1.0,0,83,83,32
4,r_77_58_119,r_136_2_87,r_72_32_167,r_72_32_167,0.9,3,170,167,32
24,r_9_144_23,r_120_55_173,r_90_59_106,r_120_55_173,0.62,-22,151,173,32
19,r_40_18_97,r_118_67_172,seq54,r_40_18_97,0.91,0,97,97,32
41,r_137_17_95,seq148,seq142,r_137_17_95,0.77,0,95,95,32
67,seq43,r_124_113_152,seq92,r_124_113_152,0.92,-9,143,152,32
3,r_118_67_172,r_40_18_97,seq25,r_40_18_97,0.95,1,98,97,32
10,r_146_85_63,r_63_139_34,seq143,r_146_85_63,0.97,0,63,63,32
27,r_66_134_170,seq75,r_90_59_106,r_66_134_170,0.8,0,170,170,32
26,r_71_10_160,r_90_59_106,r_125_117_30,r_125_117_30,0.5,130,160,30,32
8,r_61_28_153,seq145,r_110_104_13,r_61_28_153,0.98,0,153,153,32
7,r_63_139_34,r_22_114_194,r_56_88_55,r_56_88_55,0.6,2,57,55,32
4,r_77_58_119,r_13_34_133,r_136_2_87,r_77_58_119,0.8,0,119,119,32
63,seq23,seq149,r_44_96_57,r_44_96_57,1.0,7,64,57,32
73,seq57,r_72_32_167,seq12,r_72_32_167,0.97,-49,118,167,32
48,r_110_104_13,r_6_89_175,r_47_30_196,r_110_104_13,0.96,0,13,13,32
20,r_136_2_87,r_130_131_135,r_5_36_56,r_136_2_87,0.94,0,87,87,32
15,r_68_31_178,seq129,r_130_131_135,r_130_131_135,0.96,44,179,135,32
6,r_11_41_124,seq145,r_5_36_56,r_5_36_56,0.4,69,125,56,32
23,r_0_122_12,r_71_10_160,seq132,r_0_122_12,0.61,0,12,12,32
10,r_146_85_63,seq143,r_62_37_149,r_146_85_63,0.44,88,151,63,32
27,r_66_134_170,r_130_131_135,seq75,r_130_131_135,0.99,0,135,135,32
13,r_47_30_196,r_70_141_83,r_110_104_13,r_70_141_83,0.9,-28,55,83,32
31,r_120_55_173,r_68_31_178,r_9_144_23,r_9_144_23,1.0,1,24,23,32
40,r_46_39_80,seq128,seq98,r_46_39_80,0.93,-1,79,80,32
18,r_65_19_75,r_42_86_181,seq129,r_65_19_75,0.99,0,75,75,32
53,seq132,r_123_73_143,r_0_122_12,r_0_122_12,0.72,2,14,12,32
25,r_52_99_96,seq43,seq78,r_52_99_96,0.99,0,96,96,32
33,r_127_116_137,r_118_67_172,r_125_117_30,r_118_67_172,0.69,-33,139,172,32
58,seq143,seq43,r_8_91_122,r_8_91_122,1.0,18,140,122,32
61,seq148,r_137_17_95,seq25,r_137_17_95,1.0,3,98,95,32
32,r_13_34_133,r_74_147_134,r_63_139_34,r_63_139_34,0.46,99,133,34,32
38,r_6_89_175,seq25,r_70_141_83,r_70_141_83,0.94,93,176,83,32
34,r_62_37_149,seq115,r_146_85_63,r_146_85_63,1.0,18,81,63,32
24,r_9_144_23,r_46_39_80,r_120_55_173,r_9_144_23,0.82,0,23,23,32
47,r_56_88_55,seq128,r_63_139_34,r_56_88_55,0.94,2,57,55,32
81,seq87,r_63_139_34,r_64_84_193,r_64_84_193,0.88,-40,153,193,32
17,r_124_113_152,seq43,seq82,r_124_113_152,0.87,0,152,152,32
5,r_44_96_57,seq27,seq23,r_44_96_57,1.0,0,57,57,32
31,r_120_55_173,r_9_144_23,r_125_117_30,r_120_55_173,0.31,1,174,173,32
29,r_7_135_20,seq142,seq108,r_7_135_20,1.0,0,20,20,32
28,r_125_117_30,r_137_17_95,seq45,r_125_117_30,0.55,1,31,30,32
42,r_35_76_21,r_90_59_106,seq54,r_35_76_21,0.88,0,21,21,32
49,r_8_91_122,seq129,seq143,r_8_91_122,0.99,2,124,122,32
43,r_33_83_91,seq138,seq148,r_33_83_91,0.4,54,145,91,32
82,seq92,r_33_83_91,seq143,r_33_83_91,1.0,0,91,91,32
35,r_133_26_171,seq108,r_130_131_135,r_133_26_171,0.63,1,172,171,32
12,r_130_131_135,r_66_134_170,seq128,r_130_131_135,0.88,0,135,135,32
65,seq27,r_44_96_57,seq126,r_44_96_57,1.0,0,57,57,32
30,r_88_143_128,seq31,r_86_87_84,r_88_143_128,0.7,0,128,128,33
36,r_56_12_80,r_54_108_133,seq24,r_56_12_80,0.8,0,80,80,33
9,r_14_63_184,seq60,r_52_69_43,r_14_63_184,0.71,0,184,184,33
14,r_21_25_116,r_77_10_152,seq61,r_21_25_116,0.9,0,116,116,33
53,seq5,r_90_81_167,r_95_120_88,r_95_120_88,0.99,79,167,88,33
43,r_131_73_74,seq125,seq65,r_131_73_74,1.0,0,74,74,33
54,seq6,seq94,r_16_27_117,r_16_27_117,1.0,0,117,117,33
37,r_147_130_150,r_39_85_105,seq72,r_39_85_105,0.91,-4,101,105,33
16,r_82_138_162,r_44_62_164,seq101,r_82_138_162,0.81,0,162,162,33
21,r_16_27_117,seq24,seq6,r_16_27_117,1.0,0,117,117,33
1,r_104_64_114,r_21_25_116,r_140_13_77,r_104_64_114,1.0,0,114,114,33
5,r_132_149_96,r_79_7_127,r_129_109_159,r_132_149_96,0.99,0,96,96,33
32,r_99_34_20,seq98,r_86_87_84,r_86_87_84,1.0,8,92,84,33
15,r_0_40_91,r_107_113_195,r_26_136_161,r_26_136_161,0.94,16,177,161,33
31,r_44_62_164,seq93,r_78_124_132,r_44_62_164,0.45,3,167,164,33
41,r_23_38_199,r_1_116_131,seq15,r_1_116_131,1.0,-45,86,131,33
67,seq31,r_88_143_128,r_79_7_127,r_88_143_128,0.97,0,128,128,33
5,r_132_149_96,r_129_109_159,seq20,r_129_109_159,1.0,-11,148,159,33
10,r_110_100_148,seq74,r_8_127_72,r_110_100_148,0.77,0,148,148,33
40,r_54_108_133,r_140_13_77,seq111,r_54_108_133,0.95,0,133,133,33
26,r_95_120_88,r_71_112_83,r_83_67_68,r_95_120_88,0.99,0,88,88,33
72,seq48,r_148_141_183,seq20,r_148_141_183,0.9,0,183,183,33
37,r_147_130_150,seq72,r_36_17_70,r_147_130_150,0.79,0,150,150,33
0,r_129_109_159,seq20,r_132_149_96,r_132_149_96,1.0,8,104,96,33
23,r_68_103_40,seq139,seq111,r_68_103_40,1.0,1,41,40,33
20,r_26_136_161,seq24,r_0_40_91,r_26_136_161,0.96,0,161,161,33
13,r_86_87_84,r_104_64_114,r_99_34_20,r_86_87_84,0.94,0,84,84,33
15,r_0_40_91,seq102,r_107_113_195,r_0_40_91,0.94,0,91,91,33
48,r_122_59_106,r_14_63_184,r_39_85_105,r_122_59_106,0.95,1,107,106,33
6,r_148_141_183,seq48,r_86_87_84,r_86_87_84,0.94,99,183,84,33
27,r_8_127_72,r_148_141_183,r_80_106_3,r_8_127_72,1.0,0,72,72,33
2,r_78_124_132,seq18,seq37,r_78_124_132,1.0,0,132,132,33
47,r_1_116_131,r_23_38_199,seq134,r_1_116_131,0.97,0,131,131,33
34,r_140_13_77,r_54_108_133,r_104_64_114,r_140_13_77,0.94,53,130,77,33
0,r_129_109_159,r_132_149_96,r_110_100_148,r_129_109_159,1.0,0,159,159,33
40,r_54_108_133,r_56_12_80,r_140_13_77,r_140_13_77,0.65,8,85,77,33
24,r_97_57_87,seq135,r_49_96_122,r_97_57_87,0.95,2,89,87,33
25,r_71_112_83,seq102,seq28,r_71_112_83,0.97,1,84,83,33
88,seq93,r_44_62_164,r_147_130_150,r_147_130_150,0.52,17,167,150,33
58,seq142,seq134,r_42_89_62,r_42_89_62,1.0,0,62,62,33
33,r_133_91_15,r_82_138_162,r_144_30_95,r_133_91_15,0.94,0,15,15,33
61,seq18,r_78_124_132,seq145,r_78_124_132,0.99,0,132,132,33
38,r_77_10_152,seq137,seq15,r_77_10_152,0.93,0,152,152,33
34,r_140_13_77,r_23_38_199,r_54_108_133,r_140_13_77,1.0,0,77,77,33
9,r_14_63_184,r_122_59_106,seq60,r_122_59_106,0.99,-1,105,106,33
49,r_52_69_43,r_0_40_91,seq74,r_52_69_43,1.0,0,43,43,33
12,r_42_89_62,seq18,seq142,r_42_89_62,1.0,-3,59,62,33
32,r_99_34_20,r_0_40_91,seq98,r_99_34_20,1.0,0,20,20,33
22,r_49_96_122,r_129_109_159,r_97_57_87,r_97_57_87,0.87,2,89,87,33
28,r_90_81_167,seq5,r_58_35_6,r_90_81_167,0.85,0,167,167,33
24,r_97_57_87,r_49_96_122,seq48,r_49_96_122,1.0,0,122,122,33
7,r_117_47_179,seq92,seq50,r_117_47_179,0.45,1,180,179,33
44,r_83_67_68,seq37,seq29,r_83_67_68,1.0,0,68,68,33
35,r_119_118_82,r_22_2_142,r_9_32_22,r_119_118_82,1.0,0,82,82,33
22,r_49_96_122,r_97_57_87,r_58_35_6,r_49_96_122,1.0,0,122,122,33
4,r_144_30_95,seq114,r_133_91_15,r_133_91_15,1.0,22,37,15,33
93,seq109,r_81_55_185,seq16,r_81_55_185,0.71,-25,160,185,34
51,seq149,r_76_116_172,r_1_50_100,r_1_50_100,0.99,58,158,100,34
36,r_63_102_92,r_113_7_145,r_52_66_95,r_63_102_92,0.9,3,95,92,34
14,r_69_130_126,r_33_98_109,r_122_9_192,r_33_98_109,0.68,-8,101,109,34
8,r_95_26_121,r_133_124_151,r_72_34_94,r_95_26_121,0.64,-5,116,121,34
43,r_133_124_151,r_144_111_42,r_12_5_141,r_133_124_151,0.44,2,153,151,34
37,r_29_57_106,seq14,r_70_108_28,r_29_57_106,0.84,-5,101,106,34
30,r_137_42_53,seq8,seq91,r_137_42_53,1.0,0,53,53,34
16,r_103_138_55,r_82_48_76,seq112,r_103_138_55,0.93,3,58,55,34
39,r_144_111_42,r_133_124_151,r_46_6_165,r_133_124_151,0.86,6,157,151,34
24,r_84_143_195,r_70_108_28,r_104_0_178,r_70_108_28,0.55,2,30,28,34
28,r_115_35_36,r_81_55_185,r_93_32_169,r_115_35_36,1.0,0,36,36,34
5,r_30_56_175,seq17,seq10,r_30_56_175,0.76,0,175,175,34
46,r_59_41_73,seq112,r_70_108_28,r_59_41_73,0.97,1,74,73,34
42,r_19_136_158,r_104_0_178,r_68_129_7,r_104_0_178,0.6,-19,159,178,34
45,r_131_22_139,seq58,seq23,r_131_22_139,0.66,1,140,139,34
29,r_70_108_28,r_84_143_195,seq90,r_70_108_28,0.54,2,30,28,34
24,r_84_143_195,r_104_0_178,r_36_121_4,r_84_143_195,0.64,-120,75,195,34
69,seq38,r_45_20_85,r_80_18_27,r_80_18_27,0.92,20,47,27,34
1,r_92_147_20,r_80_18_27,seq134,r_80_18_27,0.85,3,30,27,34
41,r_82_48_76,r_144_111_42,seq149,r_82_48_76,0.7,1,77,76,34
89,seq96,seq8,r_141_99_57,r_141_99_57,1.0,80,137,57,34
3,r_2_110_98,seq112,r_45_20_85,r_2_110_98,0.32,1,99,98,34
26,r_60_31_75,seq90,r_146_120_62,r_60_31_75,0.92,0,75,75,34
78,seq65,r_1_50_100,seq23,r_1_50_100,1.0,1,101,100,34
20,r_146_120_62,r_81_55_185,r_60_31_75,r_60_31_75,0.99,110,185,75,34
13,r_3_85_132,seq65,r_103_138_55,r_3_85_132,0.93,0,132,132,34
15,r_72_34_94,r_43_83_122,r_11_79_3,r_72_34_94,0.85,2,96,94,34
6,r_51_62_1,r_145_140_117,r_88_37_9,r_145_140_117,0.96,2,119,117,34
21,r_93_32_169,r_115_35_36,seq128,r_93_32_169,0.87,1,170,169,34
2,r_123_87_25,r_81_55_185,seq16,r_81_55_185,0.69,-25,160,185,34
0,r_81_55_185,r_146_120_62,seq148,r_81_55_185,0.47,0,185,185,34
27,r_53_126_119,seq39,r_95_26_121,r_53_126_119,0.87,0,119,119,34
87,seq91,r_43_83_122,r_137_42_53,r_137_42_53,1.0,48,101,53,34
40,r_122_9_192,r_73_89_91,r_71_101_24,r_122_9_192,0.69,-95,97,192,34
25,r_33_98_109,r_69_130_126,seq77,r_33_98_109,0.81,3,112,109,34
33,r_1_50_100,seq65,seq149,r_1_50_100,0.81,1,101,100,34
47,r_71_101_24,r_137_42_53,r_122_9_192,r_122_9_192,0.94,-168,24,192,34
2,r_123_87_25,r_59_41_73,r_81_55_185,r_123_87_25,0.93,-5,20,25,34
32,r_40_106_115,seq54,r_1_50_100,r_1_50_100,0.56,22,122,100,34
38,r_73_89_91,r_122_9_192,r_137_42_53,r_137_42_53,0.95,44,97,53,34
34,r_145_140_117,r_51_62_1,r_100_118_103,r_145_140_117,0.64,2,119,117,34
11,r_80_18_27,r_113_7_145,seq38,r_80_18_27,0.87,3,30,27,34
75,seq58,r_131_22_139,seq86,r_131_22_139,1.0,1,140,139,34
21,r_93_32_169,r_137_42_53,r_115_35_36,r_93_32_169,0.97,-117,52,169,34
9,r_11_79_3,r_100_118_103,r_72_34_94,r_72_34_94,0.78,7,101,94,34
28,r_115_35_36,r_93_32_169,r_141_99_57,r_115_35_36,0.83,134,170,36,34
22,r_113_7_145,seq28,seq14,r_113_7_145,0.75,1,146,145,34
14,r_69_130_126,r_122_9_192,seq27,r_69_130_126,0.9,3,129,126,34
7,r_12_5_141,seq125,r_40_106_115,r_12_5_141,0.78,0,141,141,34
0,r_81_55_185,r_25_15_176,r_146_120_62,r_146_120_62,0.66,-11,51,62,34
23,r_25_15_176,r_81_55_185,r_2_110_98,r_25_15_176,0.53,2,178,176,34
35,r_52_66_95,r_53_126_119,r_63_102_92,r_63_102_92,0.8,4,96,92,34
12,r_100_118_103,r_11_79_3,seq148,r_100_118_103,0.69,0,103,103,34
19,r_141_99_57,r_45_20_85,seq96,r_141_99_57,1.0,0,57,57,34
30,r_101_84_63,seq0,seq144,r_101_84_63,1.0,0,63,63,35
36,r_149_102_77,seq83,seq97,r_149_102_77,1.0,0,77,77,35
12,r_142_70_46,seq13,seq75,r_142_70_46,1.0,0,46,46,35
20,r_82_86_102,seq63,seq20,r_82_86_102,0.98,1,103,102,35
14,r_71_19_75,seq128,seq112,r_71_19_75,0.75,4,79,75,35
8,r_46_81_155,r_98_73_141,r_47_65_164,r_46_81_155,0.37,-14,141,155,35
53,seq4,r_43_133_97,r_44_104_86,r_44_104_86,0.57,17,103,86,35
48,r_141_78_35,r_46_81_155,r_140_51_11,r_141_78_35,0.89,-5,30,35,35
43,r_91_8_170,r_106_2_180,r_25_143_48,r_25_143_48,0.73,122,170,48,35
37,r_103_132_177,seq112,r_5_145_109,r_5_145_109,0.56,70,179,109,35
23,r_54_61_59,r_14_41_112,seq148,r_14_41_112,1.0,0,112,112,35
86,seq92,seq32,r_47_65_164,r_47_65_164,0.99,-1,163,164,35
16,r_37_122_62,seq21,seq112,r_37_122_62,0.8,-2,60,62,35
21,r_14_41_112,seq88,r_120_125_36,r_14_41_112,1.0,0,112,112,35
5,r_47_65_164,r_141_78_35,seq92,r_47_65_164,0.56,0,164,164,35
42,r_38_66_61,r_46_81_155,r_120_125_36,r_38_66_61,1.0,0,61,61,35
24,r_6_59_21,seq88,r_49_24_148,r_49_24_148,0.94,12,160,148,35
19,r_121_114_121,seq136,seq57,r_121_114_121,1.0,0,121,121,35
4,r_95_58_55,r_3_55_78,seq57,r_95_58_55,0.74,-9,46,55,35
66,seq32,r_77_27_127,seq92,r_77_27_127,1.0,-23,104,127,35
41,r_62_116_42,seq130,r_120_125_36,r_62_116_42,1.0,0,42,42,35
3,r_87_53_69,seq117,seq136,r_87_53_69,1.0,0,69,69,35
78,seq68,seq108,r_67_100_105,r_67_100_105,0.9,1,106,105,35
0,r_44_104_86,seq75,seq4,r_44_104_86,0.82,8,94,86,35
63,seq23,r_34_107_72,seq20,r_34_107_72,1.0,-4,68,72,35
11,r_3_55_78,r_82_86_102,seq64,r_3_55_78,0.99,1,79,78,35
20,r_82_86_102,r_3_55_78,seq63,r_3_55_78,0.92,-6,72,78,35
13,r_77_27_127,seq32,r_71_19_75,r_77_27_127,1.0,1,128,127,35
65,seq30,r_135_89_84,r_74_48_6,r_135_89_84,0.82,-30,54,84,35
15,r_98_73_141,r_46_81_155,seq105,r_98_73_141,0.98,0,141,141,35
26,r_146_15_89,r_67_100_105,r_6_59_21,r_6_59_21,1.0,4,25,21,35
27,r_25_143_48,r_109_119_144,seq9,r_25_143_48,1.0,0,48,48,35
85,seq90,r_129_113_101,seq124,r_129_113_101,0.99,-31,70,101,35
31,r_52_1_4,seq123,r_7_126_90,r_52_1_4,0.78,6,10,4,35
38,r_12_85_45,r_34_107_72,r_52_1_4,r_12_85_45,0.68,-1,44,45,35
47,r_34_107_72,seq23,r_5_145_109,r_34_107_72,1.0,0,72,72,35
24,r_6_59_21,r_49_24_148,seq88,r_6_59_21,0.88,1,22,21,35
45,r_120_125_36,r_5_145_109,r_131_18_174,r_120_125_36,1.0,0,36,36,35
74,seq57,seq21,r_121_114_121,r_121_114_121,1.0,9,130,121,35
29,r_50_110_129,r_46_81_155,r_44_104_86,r_44_104_86,0.75,43,129,86,35
31,r_52_1_4,r_7_126_90,r_12_85_45,r_52_1_4,0.82,38,42,4,35
61,seq20,seq23,r_82_86_102,r_82_86_102,1.0,31,133,102,35
32,r_43_133_97,seq4,seq147,r_43_133_97,0.93,6,103,97,35
25,r_140_51_11,r_43_133_97,r_141_78_35,r_140_51_11,0.93,0,11,11,35
75,seq60,seq40,r_135_89_84,r_135_89_84,1.0,39,123,84,35
60,seq147,r_80_39_197,r_43_133_97,r_43_133_97,0.99,23,120,97,35
9,r_26_139_135,seq92,r_16_22_7,r_26_139_135,0.89,0,135,135,35
26,r_146_15_89,r_6_59_21,r_120_125_36,r_146_15_89,1.0,0,89,89,35
23,r_54_61_59,seq115,r_14_41_112,r_54_61_59,1.0,0,59,59,35
96,seq148,seq88,r_54_61_59,r_54_61_59,1.0,80,139,59,35
18,r_67_100_105,r_121_114_121,r_134_138_15,r_134_138_15,0.76,13,28,15,35
28,r_56_94_147,r_16_22_7,seq123,r_56_94_147,0.69,0,147,147,35
22,r_109_119_144,r_131_18_174,r_98_73_141,r_109_119_144,0.87,0,144,144,35
49,r_7_126_90,seq40,seq97,r_7_126_90,0.83,-1,89,90,35
7,r_135_89_84,seq30,seq60,r_135_89_84,0.96,2,86,84,35
18,r_67_100_105,r_134_138_15,seq68,r_67_100_105,0.88,5,110,105,35
8,r_46_81_155,r_47_65_164,r_96_29_67,r_47_65_164,0.63,-8,156,164,35
10,r_134_138_15,r_140_51_11,seq136,r_134_138_15,0.5,1,16,15,35
81,seq75,r_44_104_86,r_142_70_46,r_142_70_46,1.0,0,46,46,35
35,r_93_31_119,seq144,r_74_48_6,r_93_31_119,1.0,0,119,119,35
84,seq88,r_14_41_112,seq148,r_14_41_112,1.0,0,112,112,35
12,r_115_47_44,r_60_1_107,r_58_30_36,r_115_47_44,1.0,13,57,44,36
14,r_92_108_104,seq42,seq75,r_92_108_104,1.0,0,104,104,36
8,r_111_13_110,r_60_1_107,r_148_48_106,r_148_48_106,0.66,12,118,106,36
43,r_52_56_141,seq49,seq138,r_52_56_141,0.75,4,145,141,36
37,r_99_78_60,seq141,seq66,r_99_78_60,1.0,0,60,60,36
29,r_61_45_51,r_119_112_53,r_100_130_35,r_61_45_51,1.0,0,51,51,36
71,seq44,r_41_24_101,seq129,r_41_24_101,1.0,0,101,101,36
16,r_145_80_81,seq118,seq26,r_145_80_81,0.94,0,81,81,36
21,r_147_73_75,seq66,r_58_30_36,r_147_73_75,0.97,0,75,75,36
39,r_36_59_103,r_123_121_129,seq38,r_36_59_103,0.53,0,103,103,36
1,r_67_14_62,seq129,seq70,r_67_14_62,0.81,3,65,62,36
80,seq75,r_34_55_154,r_92_108_104,r_92_108_104,0.59,50,154,104,36
30,r_4_77_20,seq74,r_50_95_4,r_4_77_20,1.0,1,21,20,36
19,r_72_25_100,seq66,seq42,r_72_25_100,0.97,0,100,100,36
15,r_7_140_74,r_119_112_53,r_97_20_120,r_97_20_120,1.0,55,175,120,36
5,r_100_130_35,seq89,seq118,r_100_130_35,1.0,2,37,35,36
3,r_97_20_120,r_0_27_194,r_104_68_65,r_0_27_194,0.95,-74,120,194,36
48,r_93_2_199,r_136_53_34,r_119_112_53,r_119_112_53,0.64,2,55,53,36
4,r_6_8_102,r_124_37_136,seq16,r_6_8_102,0.98,1,103,102,36
44,r_3_9_50,seq66,r_40_35_10,r_3_9_50,0.95,6,56,50,36
13,r_128_91_72,r_0_27_194,r_82_11_24,r_128_91_72,1.0,0,72,72,36
15,r_7_140_74,seq120,r_119_112_53,r_7_140_74,0.58,0,74,74,36
46,r_58_30_36,seq117,seq10,r_58_30_36,1.0,0,36,36,36
6,r_109_64_79,seq42,r_34_55_154,r_109_64_79,1.0,0,79,79,36
40,r_119_112_53,seq10,seq39,r_119_112_53,1.0,0,53,53,36
36,r_88_15_137,r_144_90_17,r_72_25_100,r_144_90_17,1.0,121,138,17,36
27,r_148_48_106,seq10,seq66,r_148_48_106,1.0,1,107,106,36
36,r_88_15_137,r_3_9_50,r_144_90_17,r_88_15_137,0.86,-86,51,137,36
18,r_144_90_17,r_123_121_129,r_88_15_137,r_144_90_17,0.97,0,17,17,36
17,r_123_121_129,seq138,r_124_37_136,r_124_37_136,0.54,12,148,136,36
47,r_32_134_82,seq63,r_84_54_11,r_32_134_82,1.0,0,82,82,36
24,r_41_24_101,seq44,seq10,r_41_24_101,1.0,0,101,101,36
34,r_84_54_11,seq74,r_32_134_82,r_32_134_82,1.0,2,84,82,36
38,r_40_35_10,seq137,r_82_11_24,r_40_35_10,0.94,1,11,10,36
11,r_19_65_41,r_148_48_106,seq131,r_148_48_106,0.54,-63,43,106,36
48,r_93_2_199,r_119_112_53,seq120,r_93_2_199,0.51,-65,134,199,36
50,seq129,r_67_14_62,seq44,r_67_14_62,1.0,3,65,62,36
6,r_109_64_79,r_34_55_154,r_5_76_148,r_109_64_79,1.0,69,148,79,36
32,r_34_55_154,seq75,seq141,r_34_55_154,0.88,0,154,154,36
45,r_136_53_34,r_93_2_199,seq16,r_136_53_34,1.0,4,38,34,36
34,r_84_54_11,r_99_78_60,seq74,r_84_54_11,1.0,0,11,11,36
81,seq81,r_124_37_136,r_46_69_69,r_46_69_69,0.99,69,138,69,36
17,r_123_121_129,seq70,seq138,r_123_121_129,0.59,0,129,129,36
9,r_104_68_65,seq138,seq29,r_104_68_65,1.0,0,65,65,36
96,seq120,r_7_140_74,r_146_62_164,r_7_140_74,0.99,0,74,74,36
7,r_23_139_73,seq66,r_40_35_10,r_23_139_73,0.94,5,78,73,36
18,r_144_90_17,r_88_15_137,r_111_13_110,r_111_13_110,0.75,28,138,110,36
94,seq117,r_58_30_36,seq127,r_58_30_36,0.99,2,38,36,36
35,r_57_116_180,seq110,r_92_108_104,r_92_108_104,1.0,76,180,104,36
40,r_45_76_100,r_5_140_28,r_130_22_75,r_5_140_28,1.0,72,100,28,37
43,r_70_40_182,seq32,r_95_56_74,r_95_56_74,0.99,112,186,74,37
42,r_1_86_30,seq68,seq43,r_1_86_30,0.9,-4,26,30,37
37,r_35_129_172,seq37,r_138_14_35,r_35_129_172,0.55,0,172,172,37
59,seq26,r_38_94_177,r_105_124_23,r_105_124_23,0.99,156,179,23,37
16,r_136_20_158,seq101,r_5_140_28,r_136_20_158,0.87,0,158,158,37
21,r_52_18_103,r_55_78_191,seq125,r_52_18_103,1.0,0,103,103,37
1,r_142_115_101,r_149_60_102,seq117,r_142_115_101,0.53,2,103,101,37
5,r_38_94_177,seq26,r_42_106_65,r_42_106_65,0.61,114,179,65,37
46,r_7_148_147,seq43,seq101,r_7_148_147,0.9,0,147,147,37
33,r_99_141_37,r_52_18_103,r_42_106_65,r_99_141_37,0.99,1,38,37,37
49,r_57_113_56,r_34_108_197,seq49,r_57_113_56,1.0,0,56,56,37
19,r_128_48_116,r_110_123_159,r_5_140_28,r_128_48_116,0.86,2,118,116,37
33,r_99_141_37,r_42_106_65,r_83_10_87,r_83_10_87,0.33,40,127,87,37
88,seq103,r_139_44_57,r_142_115_101,r_139_44_57,0.87,0,57,57,37
95,seq119,r_83_10_87,r_95_56_74,r_95_56_74,1.0,17,91,74,37
66,seq37,r_35_129_172,seq118,r_35_129_172,0.87,-9,163,172,37
10,r_138_14_35,r_95_56_74,r_135_17_51,r_95_56_74,1.0,0,74,74,37
31,r_69_109_151,seq43,r_42_106_65,r_69_109_151,0.96,0,151,151,37
57,seq24,seq126,r_99_141_37,r_99_141_37,0.98,3,40,37,37
89,seq104,r_42_106_65,r_137_97_68,r_137_97_68,1.0,3,71,68,37
3,r_62_102_126,seq114,r_149_60_102,r_149_60_102,1.0,25,127,102,37
8,r_5_140_28,r_45_76_100,r_71_96_27,r_45_76_100,1.0,0,100,100,37
11,r_12_131_41,seq49,r_34_108_197,r_12_131_41,1.0,0,41,41,37
9,r_71_96_27,r_63_91_48,r_5_140_28,r_5_140_28,0.74,-1,27,28,37
14,r_77_36_160,r_71_96_27,r_99_141_37,r_77_36_160,0.89,0,160,160,37
0,r_120_41_70,r_82_112_199,r_53_4_155,r_120_41_70,1.0,0,70,70,37
13,r_42_106_65,seq119,seq19,r_42_106_65,0.95,-2,63,65,37
48,r_132_58_146,seq134,seq117,r_132_58_146,0.53,0,146,146,37
6,r_73_9_170,seq143,seq16,r_73_9_170,0.8,1,171,170,37
8,r_5_140_28,r_1_86_30,r_45_76_100,r_1_86_30,0.63,5,35,30,37
27,r_110_123_159,r_82_112_199,seq81,r_110_123_159,0.88,0,159,159,37
25,r_67_85_32,r_77_36_160,seq79,r_67_85_32,0.98,2,34,32,37
4,r_105_124_23,seq49,seq119,r_105_124_23,0.97,1,24,23,37
24,r_95_56_74,r_138_14_35,seq119,r_95_56_74,1.0,0,74,74,37
18,r_149_60_102,r_142_115_101,r_139_44_57,r_142_115_101,0.75,2,103,101,37
29,r_50_30_166,r_70_40_182,seq143,r_50_30_166,0.51,0,166,166,37
64,seq32,r_70_40_182,r_142_115_101,r_142_115_101,0.94,85,186,101,37
44,r_6_51_20,r_62_102_126,seq28,r_6_51_20,0.98,0,20,20,37
58,seq25,r_122_11_82,seq59,r_122_11_82,0.59,3,85,82,37
57,seq24,r_99_141_37,r_122_11_82,r_122_11_82,0.76,4,86,82,37
15,r_139_44_57,seq103,seq81,r_139_44_57,1.0,0,57,57,37
77,seq79,r_87_47_198,r_67_85_32,r_67_85_32,0.89,27,59,32,37
68,seq43,r_69_109_151,r_1_86_30,r_69_109_151,0.72,0,151,151,37
38,r_46_23_175,seq43,seq13,r_46_23_175,0.42,2,177,175,37
52,seq8,seq144,r_130_22_75,r_130_22_75,1.0,7,82,75,37
47,r_116_89_38,seq134,seq19,r_116_89_38,0.96,4,42,38,37
34,r_133_107_124,seq117,seq33,r_133_107_124,0.95,0,124,124,37
10,r_138_14_35,seq81,r_95_56_74,r_138_14_35,0.66,3,38,35,37
24,r_95_56_74,r_137_97_68,r_138_14_35,r_95_56_74,0.84,-37,37,74,37
28,r_122_11_82,seq25,seq24,r_122_11_82,0.93,1,83,82,37
91,seq114,r_62_102_126,r_92_15_122,r_92_15_122,0.97,10,132,122,37
14,r_77_36_160,r_67_85_32,r_71_96_27,r_71_96_27,0.68,8,35,27,37
7,r_92_15_122,r_73_9_170,seq68,r_92_15_122,0.84,0,122,122,37
39,r_63_91_48,seq144,r_53_4_155,r_63_91_48,1.0,0,48,48,37
23,r_2_146_135,r_53_4_155,r_52_18_103,r_53_4_155,0.98,-20,135,155,37
40,r_45_76_100,r_77_36_160,r_5_140_28,r_5_140_28,0.97,-1,27,28,37
35,r_53_4_155,r_2_146_135,r_63_91_48,r_53_4_155,0.91,-20,135,155,37
12,r_83_10_87,seq119,r_21_66_6,r_83_10_87,0.94,4,91,87,37
8,r_90_13_47,seq63,r_39_139_27,r_90_13_47,0.99,0,47,47,38
38,r_20_141_161,seq28,r_130_111_41,r_130_111_41,1.0,5,46,41,38
43,r_143_72_67,seq122,seq100,r_143_72_67,0.75,17,84,67,38
3,r_97_89_168,r_101_29_38,seq43,r_97_89_168,0.78,1,169,168,38
86,seq147,r_77_17_151,seq2,r_77_17_151,1.0,-4,147,151,38
16,r_116_47_134,seq147,r_126_138_121,r_126_138_121,0.94,13,134,121,38
21,r_41_10_87,seq64,r_24_60_46,r_41_10_87,0.46,0,87,87,38
39,r_66_30_158,r_51_15_137,r_7_70_172,r_51_15_137,0.91,0,137,137,38
1,r_88_105_139,seq81,r_76_142_52,r_88_105_139,1.0,1,140,139,38
45,r_25_22_141,r_6_94_91,seq2,r_6_94_91,0.98,0,91,91,38
19,r_79_18_97,r_25_22_141,r_76_142_52,r_79_18_97,0.97,1,98,97,38
98,seq122,seq49,r_126_138_121,r_126_138_121,0.95,1,122,121,38
45,r_25_22_141,seq2,seq140,r_25_22_141,0.91,0,141,141,38
38,r_20_141_161,r_130_111_41,seq21,r_20_141_161,0.74,0,161,161,38
41,r_16_125_188,seq23,r_6_94_91,r_16_125_188,0.26,0,188,188,38
89,seq99,r_108_135_185,r_67_110_30,r_67_110_30,0.8,104,134,30,38
3,r_97_89_168,r_146_4_71,r_101_29_38,r_101_29_38,0.94,33,71,38,38
10,r_6_94_91,r_25_22_141,r_58_92_173,r_6_94_91,0.91,0,91,91,38
90,seq100,r_136_86_150,r_143_72_67,r_143_72_67,0.56,80,147,67,38
26,r_33_128_135,seq54,r_24_60_46,r_33_128_135,0.83,0,135,135,38
0,r_108_135_185,seq99,r_35_91_1,r_108_135_185,0.31,2,187,185,38
31,r_67_110_30,r_123_50_12,seq99,r_67_110_30,0.9,2,32,30,38
29,r_57_103_40,r_41_10_87,seq63,r_57_103_40,0.99,1,41,40,38
5,r_124_85_54,r_123_50_12,seq23,r_124_85_54,1.0,0,54,54,38
15,r_136_86_150,seq100,r_6_94_91,r_6_94_91,0.54,68,159,91,38
48,r_93_1_94,seq117,seq140,r_93_1_94,0.97,0,94,94,38
49,r_78_131_28,r_126_138_121,r_39_139_27,r_126_138_121,1.0,1,122,121,38
35,r_101_29_38,seq28,r_97_89_168,r_101_29_38,1.0,1,39,38,38
6,r_58_92_173,seq64,r_6_94_91,r_6_94_91,0.5,7,98,91,38
62,seq23,r_16_125_188,r_124_85_54,r_124_85_54,1.0,134,188,54,38
9,r_24_60_46,r_136_86_150,seq117,r_24_60_46,0.97,0,46,46,38
36,r_126_138_121,r_78_131_28,seq122,r_126_138_121,1.0,1,122,121,38
10,r_6_94_91,r_58_92_173,r_136_86_150,r_6_94_91,0.78,61,152,91,38
37,r_71_37_120,r_76_142_52,seq61,r_76_142_52,0.99,0,52,52,38
49,r_78_131_28,r_41_10_87,r_126_138_121,r_78_131_28,1.0,0,28,28,38
30,r_130_111_41,r_20_141_161,seq102,r_20_141_161,0.96,-33,128,161,38
22,r_3_119_75,r_7_70_172,r_40_31_167,r_3_119_75,0.93,97,172,75,38
2,r_121_52_122,seq21,seq11,r_121_52_122,0.68,0,122,122,38
40,r_82_137_81,seq148,seq133,r_82_137_81,1.0,0,81,81,38
18,r_146_4_71,r_97_89_168,r_35_91_1,r_146_4_71,0.98,0,71,71,38
24,r_69_112_124,seq54,r_12_27_10,r_69_112_124,0.97,1,125,124,38
35,r_101_29_38,r_97_89_168,r_57_103_40,r_97_89_168,0.81,1,169,168,38
25,r_149_34_73,seq127,seq32,r_149_34_73,1.0,0,73,73,38
33,r_40_31_167,seq133,r_3_119_75,r_40_31_167,0.71,0,167,167,38
47,r_39_139_27,r_121_52_122,r_5_38_44,r_121_52_122,0.53,0,122,122,38
50,seq2,r_25_22_141,seq147,r_25_22_141,0.97,1,142,141,38
6,r_58_92_173,r_6_94_91,r_24_60_46,r_58_92_173,0.83,2,175,173,38
42,r_12_27_10,r_16_125_188,seq102,r_12_27_10,0.88,0,10,10,38
20,r_5_38_44,seq43,r_39_139_27,r_5_38_44,0.92,0,44,44,38
42,r_12_27_10,seq102,r_69_112_124,r_69_112_124,1.0,32,156,124,38
52,seq133,seq127,r_82_137_81,r_82_137_81,1.0,7,88,81,38
47,r_39_139_27,r_114_0_65,r_121_52_122,r_39_139_27,0.98,0,27,27,38
34,r_56_96_181,r_123_50_12,seq115,r_123_50_12,0.42,169,181,12,38
78,seq63,r_90_13_47,r_57_103_40,r_90_13_47,0.43,0,47,47,38
36,r_126_138_121,seq23,r_78_131_28,r_78_131_28,1.0,9,37,28,38
39,r_66_30_158,r_7_70_172,seq48,r_66_30_158,0.85,0,158,158,38
37,r_71_37_120,seq61,seq14,r_71_37_120,1.0,5,125,120,38
22,r_3_119_75,r_51_15_137,r_7_70_172,r_51_15_137,0.91,-54,83,137,38
28,r_118_42_176,r_123_50_12,seq147,r_118_42_176,0.53,0,176,176,38
91,seq102,r_20_141_161,r_130_111_41,r_130_111_41,1.0,87,128,41,38
7,r_109_107_100,seq21,r_12_27_10,r_109_107_100,0.54,2,102,100,38
23,r_51_15_137,r_66_30_158,seq132,r_51_15_137,0.56,0,137,137,38
30,r_130_111_41,r_41_10_87,r_20_141_161,r_130_111_41,0.75,0,41,41,38
95,seq115,r_20_141_161,r_12_27_10,r_12_27_10,0.51,41,51,10,38
14,r_76_142_52,r_71_37_120,r_123_50_12,r_76_142_52,0.78,0,52,52,38
30,r_108_68_87,r_25_75_128,r_0_5_49,r_108_68_87,1.0,0,87,87,39
26,r_84_131_148,r_15_124_189,seq48,r_15_124_189,0.99,1,190,189,39
8,r_111_93_173,seq81,r_4_82_150,r_111_93_173,0.75,1,174,173,39
37,r_114_135_156,seq100,r_70_14_26,r_114_135_156,0.85,0,156,156,39
59,seq148,seq125,r_80_41_117,r_80_41_117,0.94,8,125,117,39
16,r_80_41_117,seq48,seq148,r_80_41_117,0.94,2,119,117,39
21,r_13_94_80,r_80_41_117,seq79,r_13_94_80,1.0,0,80,80,39
1,r_90_127_65,seq138,seq81,r_90_127_65,1.0,0,65,65,39
5,r_140_76_166,r_71_88_4,seq42,r_140_76_166,0.62,0,166,166,39
46,r_33_27_76,seq21,seq42,r_33_27_76,1.0,0,76,76,39
42,r_112_59_187,seq109,r_32_110_146,r_32_110_146,0.82,41,187,146,39
33,r_136_69_41,seq100,r_54_44_89,r_54_44_89,0.96,46,135,89,39
32,r_58_56_35,r_115_17_193,r_132_139_20,r_58_56_35,1.0,0,35,35,39
31,r_98_77_53,r_106_89_61,r_71_88_4,r_98_77_53,1.0,1,54,53,39
29,r_106_89_61,r_98_77_53,seq100,r_98_77_53,1.0,1,54,53,39
41,r_57_39_143,r_118_19_15,r_45_128_69,r_45_128_69,0.52,74,143,69,39
23,r_70_14_26,seq99,seq16,r_70_14_26,1.0,0,26,26,39
3,r_8_104_121,seq97,seq66,r_8_104_121,0.82,0,121,121,39
10,r_25_75_128,r_18_95_131,seq97,r_25_75_128,0.91,0,128,128,39
26,r_84_131_148,seq26,r_15_124_189,r_84_131_148,0.85,0,148,148,39
0,r_24_23_140,seq67,r_18_95_131,r_24_23_140,0.99,0,140,140,39
11,r_18_95_131,seq7,r_141_2_25,r_18_95_131,0.97,0,131,131,39
20,r_123_29_64,seq130,seq100,r_123_29_64,1.0,1,65,64,39
98,seq126,r_24_23_140,r_45_128_69,r_45_128_69,0.66,12,81,69,39
15,r_96_147_125,seq79,seq103,r_96_147_125,0.56,1,126,125,39
48,r_10_146_123,seq40,seq99,r_10_146_123,1.0,2,125,123,39
85,seq97,r_8_104_121,r_49_107_165,r_8_104_121,1.0,0,121,121,39
36,r_78_117_57,r_111_93_173,seq63,r_78_117_57,0.7,45,102,57,39
87,seq100,r_114_135_156,r_123_29_64,r_123_29_64,0.99,41,105,64,39
2,r_71_88_4,r_20_144_178,r_32_110_146,r_71_88_4,0.5,175,179,4,39
81,seq79,r_96_147_125,r_9_143_8,r_9_143_8,0.71,5,13,8,39
85,seq97,r_49_107_165,r_25_75_128,r_49_107_165,1.0,1,166,165,39
40,r_4_82_150,r_71_88_4,seq92,r_4_82_150,0.93,0,150,150,39
24,r_61_122_62,seq53,seq40,r_61_122_62,0.82,8,70,62,39
36,r_78_117_57,seq148,r_111_93_173,r_78_117_57,1.0,0,57,57,39
25,r_32_110_146,seq30,r_58_56_35,r_32_110_146,0.59,0,146,146,39
33,r_136_69_41,r_15_124_189,seq100,r_136_69_41,0.79,20,61,41,39
70,seq48,r_80_41_117,seq92,r_80_41_117,0.97,2,119,117,39
43,r_15_124_189,r_136_69_41,seq92,r_136_69_41,0.69,16,57,41,39
39,r_72_12_9,r_0_5_49,r_141_2_25,r_141_2_25,0.55,32,57,25,39
61,seq26,r_84_131_148,seq138,r_84_131_148,1.0,0,148,148,39
22,r_37_36_30,seq125,seq65,r_37_36_30,1.0,0,30,30,39
38,r_54_44_89,seq42,r_136_69_41,r_54_44_89,0.98,0,89,89,39
36,r_78_117_57,seq63,r_90_127_65,r_78_117_57,0.56,68,125,57,39
60,seq21,r_71_88_4,r_32_110_146,r_32_110_146,0.97,29,175,146,39
47,r_141_2_25,r_106_89_61,seq42,r_141_2_25,0.95,0,25,25,39
17,r_20_144_178,r_71_88_4,r_136_69_41,r_20_144_178,0.71,1,179,178,39
9,r_11_85_60,seq35,seq113,r_11_85_60,1.0,0,60,60,39
52,seq133,r_111_93_173,r_78_117_57,r_111_93_173,0.88,-76,97,173,39
28,r_45_128_69,seq1,seq126,r_45_128_69,1.0,1,70,69,39
7,r_49_107_165,seq97,r_121_22_5,r_49_107_165,0.78,1,166,165,39
82,seq81,r_111_93_173,r_90_127_65,r_90_127_65,1.0,7,72,65,39
49,r_132_139_20,seq129,seq105,r_132_139_20,0.99,0,20,20,39
35,r_50_38_168,r_111_93_173,seq66,r_50_38_168,0.59,1,169,168,39
84,seq92,seq48,r_4_82_150,r_4_82_150,0.99,-1,149,150,39
30,r_17_127_181,seq146,r_111_2_103,r_111_2_103,0.92,81,184,103,40
42,r_137_63_34,r_29_142_196,seq18,r_137_63_34,0.99,0,34,34,40
36,r_106_20_197,r_68_148_143,r_69_73_127,r_106_20_197,0.96,-54,143,197,40
14,r_8_147_77,r_78_128_177,seq31,r_8_147_77,1.0,0,77,77,40
8,r_104_59_151,r_54_60_1,seq114,r_104_59_151,0.87,0,151,151,40
43,r_68_148_143,r_106_20_197,seq83,r_68_148_143,0.88,0,143,143,40
19,r_129_96_12,seq25,r_64_33_116,r_64_33_116,0.88,22,138,116,40
55,seq136,r_116_16_189,r_78_128_177,r_116_16_189,0.52,0,189,189,40
16,r_45_14_170,seq76,r_110_28_133,r_45_14_170,0.55,0,170,170,40
39,r_24_39_144,seq90,seq114,r_24_39_144,0.98,1,145,144,40
1,r_34_91_88,r_138_79_140,seq38,r_138_79_140,0.75,-45,95,140,40
5,r_75_77_79,seq114,r_30_95_50,r_75_77_79,1.0,0,79,79,40
19,r_129_96_12,r_30_95_50,seq25,r_129_96_12,0.99,0,12,12,40
69,seq48,r_132_97_146,seq135,r_132_97_146,1.0,0,146,146,40
11,r_30_95_50,seq18,seq87,r_30_95_50,1.0,0,50,50,40
40,r_132_97_146,r_131_133_149,r_85_0_96,r_131_133_149,0.46,-3,146,149,40
76,seq146,r_17_127_181,r_57_65_53,r_57_65_53,1.0,131,184,53,40
31,r_22_70_166,seq74,r_94_44_126,r_22_70_166,0.58,0,166,166,40
41,r_105_10_176,r_78_128_177,r_94_44_126,r_105_10_176,0.68,0,176,176,40
67,seq43,r_69_73_127,r_119_118_25,r_69_73_127,0.55,0,127,127,40
38,r_56_4_45,seq62,seq52,r_56_4_45,1.0,0,45,45,40
96,seq114,r_131_133_149,r_104_59_151,r_104_59_151,1.0,1,152,151,40
3,r_144_140_107,seq126,seq38,r_144_140_107,0.89,0,107,107,40
26,r_54_60_1,r_104_59_151,r_75_77_79,r_75_77_79,0.87,72,151,79,40
46,r_23_84_91,r_57_65_53,r_47_37_21,r_23_84_91,0.75,-65,26,91,40
46,r_23_84_91,r_47_37_21,r_75_77_79,r_47_37_21,0.86,71,92,21,40
10,r_19_145_28,seq130,seq83,r_19_145_28,1.0,0,28,28,40
15,r_13_88_43,seq87,r_12_143_17,r_12_143_17,0.97,114,131,17,40
12,r_21_122_178,r_106_20_197,seq46,r_21_122_178,0.86,0,178,178,40
6,r_64_33_116,seq38,r_129_96_12,r_129_96_12,0.83,113,125,12,40
21,r_47_37_21,r_23_84_91,r_123_149_38,r_23_84_91,0.98,1,92,91,40
27,r_85_0_96,seq135,seq36,r_85_0_96,1.0,0,96,96,40
24,r_123_149_38,seq107,r_47_37_21,r_123_149_38,0.94,0,38,38,40
40,r_132_97_146,r_94_44_126,r_131_133_149,r_94_44_126,0.41,1,127,126,40
74,seq58,r_120_112_182,seq134,r_120_112_182,0.91,-19,163,182,40
18,r_138_79_140,seq1,seq74,r_138_79_140,1.0,0,140,140,40
29,r_51_27_186,seq52,r_19_145_28,r_19_145_28,0.98,158,186,28,40
25,r_69_73_127,seq43,seq31,r_69_73_127,0.99,0,127,127,40
33,r_81_40_148,r_78_128_177,seq41,r_81_40_148,0.78,0,148,148,40
4,r_89_5_31,r_104_59_151,seq134,r_89_5_31,1.0,0,31,31,40
99,seq126,r_144_140_107,r_50_115_20,r_50_115_20,0.54,0,20,20,40
50,seq1,r_138_79_140,seq43,r_138_79_140,1.0,0,140,140,40
32,r_120_112_182,seq58,r_75_77_79,r_75_77_79,0.53,103,182,79,40
34,r_111_2_103,seq135,seq126,r_111_2_103,0.98,0,103,103,40
37,r_50_115_20,seq134,seq126,r_50_115_20,0.91,0,20,20,40
48,r_12_143_17,r_144_140_107,r_13_88_43,r_12_143_17,1.0,6,23,17,40
47,r_119_118_25,r_8_147_77,seq43,r_119_118_25,1.0,0,25,25,40
17,r_78_128_177,r_8_147_77,r_51_27_186,r_8_147_77,1.0,0,77,77,40
53,seq134,seq80,r_89_5_31,r_89_5_31,1.0,6,37,31,40
9,r_116_16_189,seq136,r_45_14_170,r_45_14_170,0.68,19,189,170,40
21,r_47_37_21,seq3,r_23_84_91,r_47_37_21,0.95,0,21,21,40
96,seq114,r_75_77_79,r_131_133_149,r_75_77_79,0.94,0,79,79,40
22,r_110_28_133,seq18,r_56_4_45,r_56_4_45,0.99,85,130,45,40
28,r_61_6_172,seq74,seq66,r_61_6_172,0.68,0,172,172,40
75,seq62,r_56_4_45,r_13_88_43,r_56_4_45,1.0,0,45,45,40
2,r_57_65_53,r_64_33_116,seq62,r_57_65_53,1.0,2,55,53,40
7,r_94_44_126,r_132_97_146,seq58,r_94_44_126,0.95,1,127,126,40
44,r_42_72_139,r_139_121_180,seq80,r_42_72_139,1.0,1,140,139,40
23,r_131_133_149,seq11,seq135,r_131_133_149,0.41,11,160,149,40
17,r_78_128_177,r_51_27_186,seq136,r_78_128_177,0.91,0,177,177,40
79,seq74,r_22_70_166,r_75_77_79,r_75_77_79,1.0,87,166,79,40
35,r_86_7_187,seq38,r_85_0_96,r_85_0_96,1.0,91,187,96,40
12,r_21_122_178,r_116_16_189,r_106_20_197,r_116_16_189,0.31,-93,96,189,40
84,seq87,r_13_88_43,r_75_77_79,r_75_77_79,1.0,3,82,79,40
30,r_17_63_115,seq143,r_93_77_30,r_93_77_30,0.58,30,60,30,41
9,r_98_45_58,r_62_136_139,r_89_137_96,r_98_45_58,0.99,81,139,58,41
3,r_23_105_48,seq142,r_107_4_21,r_23_105_48,1.0,0,48,48,41
13,r_60_141_42,seq33,r_59_2_32,r_60_141_42,1.0,1,43,42,41
16,r_15_68_118,seq86,r_118_116_119,r_15_68_118,1.0,1,119,118,41
39,r_48_80_94,seq6,seq121,r_48_80_94,0.53,9,103,94,41
1,r_149_1_112,seq43,r_30_76_53,r_30_76_53,0.99,9,62,53,41
42,r_132_11_137,r_50_31_191,seq110,r_132_11_137,0.91,0,137,137,41
69,seq39,r_65_46_192,r_129_51_7,r_129_51_7,0.89,145,152,7,41
45,r_19_0_100,seq130,seq139,r_19_0_100,1.0,0,100,100,41
21,r_119_113_28,seq139,r_129_51_7,r_129_51_7,0.73,25,32,7,41
19,r_117_70_168,seq54,seq86,r_117_70_168,0.88,0,168,168,41
33,r_53_20_190,r_19_0_100,r_81_66_14,r_19_0_100,0.54,90,190,100,41
22,r_146_12_46,r_74_5_89,r_138_57_124,r_146_12_46,1.0,0,46,46,41
4,r_100_58_45,seq144,r_59_2_32,r_100_58_45,1.0,1,46,45,41
41,r_101_145_37,r_59_2_32,seq6,r_101_145_37,1.0,0,37,37,41
34,r_35_108_54,r_22_85_104,seq115,r_35_108_54,1.0,0,54,54,41
76,seq56,r_132_11_137,r_23_105_48,r_23_105_48,0.89,89,137,48,41
10,r_55_25_130,seq140,seq88,r_55_25_130,0.94,0,130,130,41
11,r_74_5_89,r_62_136_139,r_23_105_48,r_74_5_89,0.95,0,89,89,41
20,r_138_57_124,seq123,seq27,r_138_57_124,1.0,0,124,124,41
48,r_126_78_162,r_124_42_182,r_138_57_124,r_138_57_124,1.0,59,183,124,41
57,seq142,r_72_71_140,seq52,r_72_71_140,0.77,0,140,140,41
6,r_32_94_169,seq16,r_129_51_7,r_32_94_169,0.66,1,170,169,41
1,r_149_1_112,r_30_76_53,r_19_0_100,r_149_1_112,0.93,0,112,112,41
9,r_98_45_58,seq29,r_62_136_139,r_98_45_58,1.0,1,59,58,41
46,r_50_31_191,seq56,r_107_4_21,r_107_4_21,1.0,19,40,21,41
52,seq7,r_126_78_162,r_81_66_14,r_81_66_14,0.99,4,18,14,41
70,seq40,r_59_2_32,r_87_67_23,r_87_67_23,0.5,18,41,23,41
27,r_22_85_104,seq130,seq82,r_22_85_104,1.0,1,105,104,41
22,r_146_12_46,r_138_57_124,seq69,r_138_57_124,1.0,0,124,124,41
2,r_93_77_30,r_133_102_74,r_17_63_115,r_133_102_74,0.97,-14,60,74,41
47,r_118_116_119,r_53_20_190,r_15_68_118,r_118_116_119,1.0,0,119,119,41
40,r_131_109_175,seq8,r_149_1_112,r_149_1_112,0.98,64,176,112,41
18,r_124_42_182,r_126_78_162,r_14_28_179,r_14_28_179,0.65,4,183,179,41
23,r_72_71_140,seq79,seq142,r_72_71_140,0.61,-85,55,140,41
24,r_18_61_150,r_112_34_151,seq8,r_18_61_150,0.92,0,150,150,41
32,r_81_66_14,r_74_5_89,seq7,r_81_66_14,0.92,-1,13,14,41
25,r_62_136_139,r_74_5_89,r_98_45_58,r_62_136_139,0.91,-50,89,139,41
33,r_53_20_190,r_118_116_119,r_19_0_100,r_53_20_190,1.0,-71,119,190,41
28,r_30_76_53,r_149_1_112,seq43,r_149_1_112,1.0,0,112,112,41
38,r_107_4_21,r_53_20_190,r_50_31_191,r_107_4_21,1.0,0,21,21,41
26,r_87_67_23,seq95,seq40,r_87_67_23,0.44,1,24,23,41
28,r_30_76_53,r_19_0_100,r_149_1_112,r_30_76_53,1.0,0,53,53,41
25,r_62_136_139,r_98_45_58,r_30_76_53,r_62_136_139,0.99,0,139,139,41
2,r_93_77_30,r_17_63_115,seq143,r_17_63_115,1.0,-4,111,115,41
91,seq104,r_126_78_162,r_133_102_74,r_133_102_74,1.0,0,74,74,41
55,seq139,seq69,r_19_0_100,r_19_0_100,1.0,3,103,100,41
35,r_84_3_79,r_118_116_119,r_101_145_37,r_84_3_79,0.99,0,79,79,41
30,r_17_63_115,r_93_77_30,seq29,r_17_63_115,0.95,0,115,115,41
12,r_133_102_74,seq49,seq104,r_133_102_74,1.0,0,74,74,41
23,r_72_71_140,seq142,r_148_75_38,r_72_71_140,0.99,0,140,140,41
30,r_74_89_123,seq112,r_146_71_106,r_74_89_123,0.84,0,123,123,42
36,r_129_118_73,seq1,r_54_50_49,r_129_118_73,1.0,0,73,73,42
8,r_131_114_195,seq144,r_128_91_33,r_128_91_33,1.0,41,74,33,42
37,r_78_134_154,r_146_71_106,r_148_64_177,r_146_71_106,0.78,1,107,106,42
59,seq138,seq1,r_139_21_28,r_139_21_28,1.0,46,74,28,42
16,r_70_22_141,seq124,seq17,r_70_22_141,0.8,3,144,141,42
21,r_33_35_142,seq4,r_105_56_129,r_33_35_142,0.66,4,146,142,42
1,r_111_62_71,seq97,r_13_40_75,r_111_62_71,1.0,2,73,71,42
46,r_146_71_106,r_78_134_154,r_16_121_117,r_146_71_106,0.6,1,107,106,42
42,r_68_145_63,seq9,seq149,r_68_145_63,1.0,0,63,63,42
45,r_61_66_109,r_140_96_118,r_129_118_73,r_61_66_109,0.97,1,110,109,42
41,r_139_21_28,r_59_65_38,seq138,r_139_21_28,1.0,-1,27,28,42
11,r_16_121_117,r_146_71_106,r_29_125_36,r_146_71_106,0.6,11,117,106,42
24,r_128_91_33,r_131_114_195,seq2,r_131_114_195,0.48,-9,186,195,42
44,r_95_107_45,r_122_63_194,r_11_83_143,r_95_107_45,1.0,1,46,45,42
26,r_132_82_130,r_78_134_154,r_53_127_13,r_132_82_130,0.52,40,170,130,42
31,r_140_96_118,r_61_66_109,seq88,r_140_96_118,1.0,0,118,118,42
3,r_105_56_129,seq43,r_146_71_106,r_105_56_129,0.82,0,129,129,42
10,r_11_83_143,r_49_25_149,r_16_121_117,r_11_83_143,0.75,0,143,143,42
26,r_132_82_130,seq14,r_78_134_154,r_132_82_130,0.94,0,130,130,42
4,r_100_8_199,r_120_0_104,r_75_108_78,r_100_8_199,1.0,-95,104,199,42
0,r_148_64_177,seq77,r_81_94_140,r_148_64_177,0.65,0,177,177,42
11,r_16_121_117,r_119_32_64,r_100_8_199,r_119_32_64,0.91,0,64,64,42
46,r_146_71_106,r_74_89_123,r_105_56_129,r_105_56_129,0.95,17,146,129,42
13,r_27_79_94,seq43,r_93_123_51,r_27_79_94,0.95,0,94,94,42
37,r_78_134_154,r_148_64_177,r_132_82_130,r_132_82_130,0.57,5,135,130,42
15,r_75_108_78,r_78_134_154,r_95_107_45,r_78_134_154,0.94,-76,78,154,42
6,r_13_40_75,seq9,r_111_62_71,r_13_40_75,1.0,1,76,75,42
40,r_54_50_49,r_93_123_51,seq149,r_54_50_49,1.0,0,49,49,42
44,r_95_107_45,r_11_83_143,r_75_108_78,r_95_107_45,0.89,38,83,45,42
12,r_59_65_38,r_139_21_28,seq5,r_139_21_28,0.65,0,28,28,42
46,r_146_71_106,r_16_121_117,r_74_89_123,r_146_71_106,0.63,11,117,106,42
2,r_7_117_184,seq141,r_128_91_33,r_7_117_184,0.59,0,184,184,42
47,r_119_32_64,r_16_121_117,seq3,r_119_32_64,1.0,0,64,64,42
18,r_28_57_111,r_33_35_142,seq138,r_28_57_111,1.0,0,111,111,42
29,r_86_72_122,r_47_87_193,r_92_52_197,r_86_72_122,0.97,0,122,122,42
25,r_92_52_197,r_105_56_129,r_86_72_122,r_86_72_122,0.37,0,122,122,42
33,r_49_25_149,seq34,seq136,r_49_25_149,0.91,0,149,149,42
19,r_53_127_13,seq144,seq116,r_53_127_13,1.0,0,13,13,42
61,seq14,r_132_82_130,seq106,r_132_82_130,0.85,0,130,130,42
32,r_39_84_84,seq26,seq137,r_39_84_84,1.0,0,84,84,42
97,seq116,seq17,r_53_127_13,r_53_127_13,0.97,34,47,13,42
24,r_128_91_33,seq136,r_131_114_195,r_128_91_33,1.0,0,33,33,42
17,r_51_45_103,r_33_35_142,seq1,r_51_45_103,1.0,1,104,103,42
9,r_120_0_104,r_100_8_199,seq76,r_120_0_104,1.0,0,104,104,42
37,r_78_134_154,r_132_82_130,r_99_30_85,r_78_134_154,0.93,0,154,154,42
22,r_69_110_133,r_11_83_143,r_51_45_103,r_11_83_143,1.0,-10,133,143,42
28,r_93_123_51,r_18_67_69,r_27_79_94,r_27_79_94,1.0,1,95,94,42
40,r_54_50_49,seq149,r_129_118_73,r_129_118_73,0.99,21,94,73,42
49,r_147_115_125,seq113,seq77,r_147_115_125,0.85,10,135,125,42
43,r_20_31_39,r_132_82_130,r_103_104_196,r_20_31_39,0.98,0,39,39,42
7,r_81_94_140,r_18_67_69,r_75_108_78,r_75_108_78,0.99,64,142,78,42
23,r_99_30_85,seq149,seq9,r_99_30_85,1.0,0,85,85,42
35,r_103_104_196,seq142,r_20_31_39,r_20_31_39,1.0,79,118,39,42
17,r_38_75_50,r_113_66_136,seq51,r_113_66_136,0.68,-86,50,136,43
46,r_16_5_30,r_90_133_19,seq145,r_16_5_30,0.96,-15,15,30,43
10,r_91_135_39,r_126_85_49,seq27,r_91_135_39,1.0,1,40,39,43
43,r_149_117_97,r_116_131_195,seq36,r_149_117_97,1.0,0,97,97,43
83,seq79,r_15_70_102,r_120_114_80,r_15_70_102,0.53,-19,83,102,43
37,r_69_0_158,seq34,seq119,r_69_0_158,0.83,0,158,158,43
45,r_90_133_19,r_16_5_30,seq80,r_90_133_19,1.0,0,19,19,43
39,r_143_28_109,seq27,r_139_65_58,r_143_28_109,1.0,-1,108,109,43
95,seq109,r_24_43_98,r_97_73_13,r_97_73_13,0.51,-1,12,13,43
1,r_137_47_3,r_107_81_162,r_46_59_38,r_107_81_162,0.57,0,162,162,43
5,r_11_35_164,seq145,r_110_49_56,r_110_49_56,1.0,111,167,56,43
84,seq80,r_93_144_175,r_22_128_52,r_22_128_52,0.79,0,52,52,43
12,r_42_32_35,r_11_35_164,r_54_2_138,r_42_32_35,1.0,0,35,35,43
41,r_113_66_136,seq95,r_97_73_13,r_113_66_136,1.0,0,136,136,43
47,r_97_73_13,seq129,seq109,r_97_73_13,0.92,-1,12,13,43
4,r_100_1_145,seq78,seq72,r_100_1_145,1.0,0,145,145,43
0,r_44_86_122,seq95,r_118_50_103,r_44_86_122,0.67,4,126,122,43
11,r_96_6_156,r_107_81_162,r_120_114_80,r_96_6_156,0.79,0,156,156,43
36,r_46_59_38,r_63_48_70,seq103,r_46_59_38,0.82,-2,36,38,43
13,r_12_121_152,seq84,seq124,r_12_121_152,0.57,0,152,152,43
15,r_55_88_110,r_125_17_186,seq89,r_55_88_110,0.94,1,111,110,43
48,r_118_50_103,r_122_146_150,r_42_32_35,r_118_50_103,0.95,5,108,103,43
30,r_22_128_52,r_116_131_195,seq80,r_22_128_52,0.95,0,52,52,43
14,r_126_85_49,seq124,seq136,r_126_85_49,1.0,-1,48,49,43
12,r_42_32_35,r_54_2_138,r_44_86_122,r_42_32_35,0.91,100,135,35,43
6,r_130_40_166,seq51,r_44_86_122,r_130_40_166,0.38,9,175,166,43
2,r_54_2_138,r_42_32_35,seq45,r_54_2_138,0.73,-4,134,138,43
10,r_91_135_39,seq27,r_24_43_98,r_24_43_98,1.0,7,105,98,43
85,seq83,r_110_49_56,r_63_48_70,r_110_49_56,0.99,0,56,56,43
87,seq89,seq142,r_55_88_110,r_55_88_110,0.73,-6,104,110,43
40,r_63_48_70,seq51,seq83,r_63_48_70,0.94,7,77,70,43
29,r_41_123_120,seq29,r_14_82_23,r_41_123_120,0.72,1,121,120,43
24,r_106_26_90,seq56,seq3,r_106_26_90,1.0,0,90,90,43
18,r_14_82_23,r_22_128_52,r_90_133_19,r_90_133_19,1.0,0,19,19,43
16,r_134_127_37,r_139_65_58,seq124,r_134_127_37,1.0,0,37,37,43
25,r_33_141_176,seq111,r_57_87_67,r_57_87_67,1.0,110,177,67,43
33,r_120_114_80,r_94_10_171,seq74,r_120_114_80,0.94,1,81,80,43
88,seq95,r_113_66_136,seq8,r_113_66_136,1.0,0,136,136,43
68,seq45,seq80,r_54_2_138,r_54_2_138,0.76,-2,136,138,43
32,r_24_43_98,seq109,r_91_135_39,r_24_43_98,1.0,0,98,98,43
34,r_115_102_68,seq34,seq51,r_115_102_68,1.0,0,68,68,43
75,seq64,seq136,r_15_70_102,r_15_70_102,0.95,13,115,102,43
8,r_139_65_58,seq36,seq39,r_139_65_58,1.0,0,58,58,43
2,r_54_2_138,r_122_146_150,r_42_32_35,r_42_32_35,1.0,4,39,35,43
9,r_132_140_113,seq119,r_137_47_3,r_132_140_113,1.0,0,113,113,43
96,seq111,r_33_141_176,seq8,r_33_141_176,0.93,-10,166,176,43
19,r_23_76_33,r_33_141_176,r_7_53_11,r_23_76_33,0.97,0,33,33,43
28,r_122_146_150,r_118_50_103,seq30,r_122_146_150,0.81,0,150,150,43
49,r_15_70_102,seq79,seq64,r_15_70_102,0.73,2,104,102,43
3,r_110_49_56,seq83,seq71,r_110_49_56,1.0,0,56,56,43
7,r_57_87_67,r_15_70_102,r_90_133_19,r_57_87_67,0.98,0,67,67,43
44,r_107_81_162,r_137_47_3,seq84,r_107_81_162,0.58,0,162,162,43
82,seq78,r_100_1_145,seq79,r_100_1_145,0.98,0,145,145,43
35,r_94_10_171,seq39,r_126_85_49,r_126_85_49,0.96,123,172,49,43
23,r_7_53_11,r_94_10_171,seq36,r_7_53_11,0.91,0,11,11,43
40,r_143_120_145,r_138_122_19,r_34_25_199,r_143_120_145,0.84,0,145,145,44
44,r_138_122_19,r_143_120_145,r_13_137_138,r_138_122_19,1.0,126,145,19,44
9,r_148_36_43,r_93_97_44,seq117,r_148_36_43,1.0,0,43,43,44
36,r_95_28_125,r_116_106_88,r_13_137_138,r_116_106_88,0.96,-12,76,88,44
9,r_148_36_43,seq117,r_17_129_173,r_17_129_173,0.46,-2,171,173,44
87,seq102,r_41_26_162,r_138_122_19,r_138_122_19,0.97,-3,16,19,44
14,r_73_32_150,r_147_24_147,r_49_135_63,r_147_24_147,0.99,-1,146,147,44
19,r_46_86_42,r_51_89_110,r_3_50_146,r_3_50_146,1.0,1,147,146,44
37,r_47_74_72,r_107_70_158,seq127,r_47_74_72,1.0,0,72,72,44
3,r_59_67_23,r_112_2_107,r_22_126_99,r_112_2_107,1.0,0,107,107,44
26,r_51_89_110,r_109_111_9,r_3_50_146,r_3_50_146,0.83,8,154,146,44
42,r_96_55_106,r_80_30_78,r_121_4_96,r_96_55_106,0.89,0,106,106,44
16,r_116_106_88,r_95_28_125,seq142,r_95_28_125,0.86,-37,88,125,44
39,r_17_129_173,r_16_76_136,seq7,r_16_76_136,0.68,0,136,136,44
42,r_96_55_106,r_15_27_20,r_49_135_63,r_96_55_106,0.45,-87,19,106,44
44,r_138_122_19,r_93_97_44,r_143_120_145,r_138_122_19,0.99,-2,17,19,44
45,r_40_119_114,r_140_85_105,r_34_25_199,r_40_119_114,0.99,1,115,114,44
28,r_49_135_63,seq132,seq39,r_49_135_63,0.97,-5,58,63,44
95,seq117,r_51_89_110,r_34_25_199,r_51_89_110,1.0,0,110,110,44
31,r_145_65_61,r_19_82_1,seq39,r_145_65_61,1.0,0,61,61,44
30,r_15_27_20,r_96_55_106,seq100,r_15_27_20,1.0,0,20,20,44
10,r_8_20_182,seq62,r_112_2_107,r_112_2_107,0.67,75,182,107,44
26,r_51_89_110,seq117,r_109_111_9,r_51_89_110,0.71,1,111,110,44
40,r_143_120_145,r_9_18_86,r_138_122_19,r_138_122_19,0.99,-2,17,19,44
78,seq79,r_147_24_147,r_75_66_187,r_147_24_147,1.0,0,147,147,44
0,r_41_26_162,r_37_31_192,r_3_50_146,r_41_26_162,0.74,2,164,162,44
63,seq21,r_124_60_181,r_95_28_125,r_95_28_125,1.0,56,181,125,44
73,seq139,r_124_60_181,seq78,r_124_60_181,0.82,-110,71,181,44
11,r_112_2_107,r_91_45_178,r_43_69_38,r_91_45_178,0.99,-71,107,178,44
20,r_9_18_86,r_143_120_145,seq146,r_143_120_145,0.77,-63,82,145,44
13,r_37_31_192,r_41_26_162,r_38_63_198,r_41_26_162,0.85,-5,157,162,44
39,r_17_129_173,seq7,r_148_36_43,r_17_129_173,0.7,-2,171,173,44
46,r_101_90_47,seq88,seq99,r_101_90_47,1.0,0,47,47,44
48,r_81_52_101,seq12,r_37_31_192,r_81_52_101,1.0,2,103,101,44
2,r_54_103_39,seq14,seq110,r_54_103_39,1.0,1,40,39,44
6,r_16_76_136,r_17_129_173,r_80_30_78,r_16_76_136,0.89,0,136,136,44
99,seq127,r_44_48_176,r_47_74_72,r_47_74_72,1.0,0,72,72,44
52,seq131,r_109_111_9,r_147_24_147,r_147_24_147,0.98,4,151,147,44
27,r_19_82_1,r_145_65_61,r_101_90_47,r_19_82_1,1.0,46,47,1,44
19,r_46_86_42,seq139,r_10_128_15,r_46_86_42,0.92,0,42,42,44
41,r_43_69_38,r_147_24_147,seq77,r_43_69_38,1.0,0,38,38,44
49,r_13_137_138,seq104,r_138_122_19,r_13_137_138,0.9,0,138,138,44
47,r_80_30_78,r_93_97_44,r_16_76_136,r_80_30_78,0.53,40,118,78,44
47,r_80_30_78,seq83,r_96_55_106,r_80_30_78,0.98,0,78,78,44
25,r_147_24_147,seq79,seq131,r_147_24_147,0.9,0,147,147,44
5,r_93_97_44,seq131,seq0,r_93_97_44,1.0,0,44,44,44
88,seq104,r_95_28_125,seq110,r_95_28_125,0.89,0,125,125,44
42,r_96_55_106,r_49_135_63,r_80_30_78,r_80_30_78,0.98,1,79,78,44
19,r_46_86_42,r_10_128_15,r_109_111_9,r_46_86_42,0.36,33,75,42,44
32,r_3_50_146,seq35,r_46_86_42,r_3_50_146,0.89,0,146,146,44
38,r_121_4_96,r_37_31_192,seq87,r_121_4_96,1.0,0,96,96,44
34,r_91_45_178,seq142,r_138_122_19,r_138_122_19,0.73,159,178,19,44
3,r_59_67_23,r_94_57_189,r_112_2_107,r_59_67_23,0.78,-2,21,23,44
81,seq142,r_91_45_178,r_59_67_23,r_91_45_178,0.57,-16,162,178,44
17,r_92_58_160,seq110,r_10_128_15,r_92_58_160,0.84,0,160,160,44
47,r_80_30_78,r_96_55_106,r_93_97_44,r_96_55_106,0.77,0,106,106,44
28,r_49_135_63,seq39,r_73_32_150,r_49_135_63,0.28,100,163,63,44
91,seq110,r_92_58_160,r_54_103_39,r_54_103_39,0.99,107,146,39,44
49,r_13_137_138,r_95_28_125,seq104,r_95_28_125,0.56,0,125,125,44
7,r_124_60_181,seq21,r_59_67_23,r_124_60_181,0.57,0,181,181,44
23,r_107_70_158,r_47_74_72,r_71_130_6,r_107_70_158,1.0,-86,72,158,44
19,r_46_86_42,r_109_111_9,r_51_89_110,r_51_89_110,0.95,0,110,110,44
35,r_23_141_163,seq83,r_107_70_158,r_23_141_163,0.89,0,163,163,44
12,r_22_126_99,r_94_57_189,r_59_67_23,r_94_57_189,0.83,-87,102,189,44
30,r_12_96_126,r_58_122_140,r_76_117_16,r_12_96_126,0.81,0,126,126,45
36,r_120_98_155,seq132,r_119_64_167,r_119_64_167,0.65,1,168,167,45
14,r_42_13_66,r_58_122_140,seq36,r_42_13_66,0.99,0,66,66,45
8,r_109_144_183,seq59,r_73_61_47,r_73_61_47,0.65,136,183,47,45
43,r_10_51_132,seq38,seq34,r_10_51_132,0.98,1,133,132,45
37,r_4_102_94,seq28,r_31_44_93,r_4_102_94,1.0,0,94,94,45
59,seq20,seq82,r_53_148_110,r_53_148_110,0.99,34,144,110,45
21,r_40_60_169,seq32,r_30_8_42,r_40_60_169,0.67,0,169,169,45
39,r_106_99_120,seq32,seq57,r_106_99_120,0.65,2,122,120,45
46,r_26_149_171,r_130_80_165,r_19_147_198,r_26_149_171,0.47,0,171,171,45
42,r_37_90_153,r_130_80_165,seq116,r_130_80_165,0.67,-10,155,165,45
45,r_134_47_87,seq116,seq132,r_134_47_87,1.0,0,87,87,45
97,seq116,r_89_115_10,r_37_90_153,r_37_90_153,0.89,0,153,153,45
41,r_11_43_185,seq32,r_30_8_42,r_30_8_42,0.71,143,185,42,45
20,r_111_118_119,r_89_115_10,r_30_8_42,r_111_118_119,0.99,1,120,119,45
33,r_79_93_46,seq87,r_41_74_69,r_41_74_69,0.99,7,76,69,45
0,r_9_124_130,r_88_113_81,r_5_83_19,r_88_113_81,0.57,50,131,81,45
63,seq28,r_4_102_94,r_54_145_9,r_4_102_94,0.93,0,94,94,45
73,seq55,seq68,r_5_83_19,r_5_83_19,0.98,62,81,19,45
20,r_111_118_119,r_19_147_198,r_89_115_10,r_89_115_10,0.68,67,77,10,45
13,r_53_148_110,seq81,seq20,r_53_148_110,0.98,3,113,110,45
26,r_35_105_30,r_25_141_18,seq125,r_35_105_30,1.0,0,30,30,45
7,r_27_2_117,r_101_62_64,seq59,r_27_2_117,1.0,1,118,117,45
79,seq68,r_53_148_110,r_6_72_50,r_53_148_110,0.94,-51,59,110,45
5,r_138_48_157,r_56_3_143,r_88_113_81,r_56_3_143,1.0,1,144,143,45
33,r_79_93_46,r_88_113_81,seq87,r_79_93_46,0.87,0,46,46,45
27,r_119_64_167,seq52,r_120_98_155,r_120_98_155,0.44,13,168,155,45
3,r_30_8_42,r_42_13_66,r_70_127_54,r_42_13_66,0.59,0,66,66,45
2,r_101_62_64,r_58_122_140,r_27_2_117,r_101_62_64,1.0,0,64,64,45
18,r_58_122_140,r_129_140_195,r_25_141_18,r_58_122_140,0.67,1,141,140,45
29,r_130_80_165,r_37_90_153,r_10_51_132,r_130_80_165,0.9,-10,155,165,45
24,r_56_3_143,r_138_48_157,seq67,r_56_3_143,0.92,1,144,143,45
25,r_39_17_162,seq33,r_130_80_165,r_39_17_162,0.72,1,163,162,45
48,r_5_83_19,seq68,seq55,r_5_83_19,0.39,62,81,19,45
40,r_76_117_16,r_88_113_81,r_0_94_6,r_88_113_81,0.61,-63,18,81,45
68,seq36,seq97,r_42_13_66,r_42_13_66,1.0,13,79,66,45
32,r_6_72_50,seq66,r_5_83_19,r_5_83_19,0.82,44,63,19,45
48,r_5_83_19,r_56_3_143,seq68,r_5_83_19,0.97,0,19,19,45
38,r_69_45_122,r_10_51_132,r_111_118_119,r_69_45_122,0.98,2,124,122,45
4,r_70_127_54,r_10_51_132,r_30_8_42,r_70_127_54,1.0,0,54,54,45
34,r_31_44_93,r_103_121_44,r_4_102_94,r_4_102_94,1.0,0,94,94,45
75,seq59,r_109_144_183,r_27_2_117,r_27_2_117,1.0,66,183,117,45
48,r_5_83_19,seq55,r_9_124_130,r_9_124_130,1.0,1,131,130,45
17,r_139_18_154,r_129_140_195,seq114,r_139_18_154,0.64,2,156,154,45
10,r_73_61_47,r_138_48_157,r_0_94_6,r_73_61_47,1.0,0,47,47,45
5,r_138_48_157,r_73_61_47,r_56_3_143,r_73_61_47,1.0,-5,42,47,45
22,r_129_140_195,r_58_122_140,r_30_8_42,r_129_140_195,0.68,-79,116,195,45
28,r_41_74_69,r_130_80_165,r_79_93_46,r_41_74_69,1.0,2,71,69,45
91,seq95,r_31_44_93,seq33,r_31_44_93,1.0,1,94,93,45
49,r_14_50_156,seq143,seq104,r_14_50_156,0.67,0,156,156,45
7,r_27_2_117,seq112,r_101_62_64,r_101_62_64,1.0,5,69,64,45
44,r_100_24_72,r_56_3_143,seq63,r_100_24_72,0.86,2,74,72,45
2,r_101_62_64,r_27_2_117,seq112,r_27_2_117,1.0,4,121,117,45
12,r_46_84_102,r_10_51_132,r_4_102_94,r_46_84_102,1.0,0,102,102,45
3,r_30_8_42,r_19_147_198,r_42_13_66,r_30_8_42,0.99,0,42,42,45
23,r_89_115_10,r_119_64_167,r_111_118_119,r_89_115_10,0.91,1,11,10,45
23,r_89_115_10,r_111_118_119,seq15,r_111_118_119,1.0,1,120,119,45
30,r_64_105_133,seq4,r_9_1_37,r_64_105_133,0.94,0,133,133,46
42,r_43_31_113,r_118_55_32,seq62,r_43_31_113,0.72,-79,34,113,46
36,r_125_79_130,seq85,seq63,r_125_79_130,0.84,2,132,130,46
14,r_134_76_183,seq74,r_101_93_108,r_101_93_108,0.99,75,183,108,46
8,r_8_44_134,r_17_70_85,r_130_94_186,r_8_44_134,0.76,-3,131,134,46
37,r_130_94_186,r_71_69_88,r_8_44_134,r_130_94_186,0.64,-49,137,186,46
38,r_124_107_17,r_48_114_123,seq74,r_124_107_17,0.65,-1,16,17,46
16,r_78_132_160,r_123_147_171,seq143,r_123_147_171,0.69,-4,167,171,46
21,r_111_50_61,seq85,r_133_66_24,r_111_50_61,1.0,-1,60,61,46
39,r_28_60_84,r_84_108_166,r_43_31_113,r_28_60_84,0.85,-2,82,84,46
1,r_13_65_162,r_123_147_171,r_82_145_115,r_82_145_115,0.57,56,171,115,46
5,r_82_145_115,seq46,r_58_131_111,r_82_145_115,0.98,0,115,115,46
46,r_3_137_163,r_140_59_187,r_7_56_104,r_3_137_163,0.61,2,165,163,46
7,r_48_114_123,r_71_69_88,seq99,r_48_114_123,1.0,0,123,123,46
45,r_54_39_59,seq21,seq148,r_54_39_59,1.0,1,60,59,46
41,r_118_55_32,r_43_31_113,seq146,r_118_55_32,0.84,-2,30,32,46
34,r_38_22_9,r_20_120_90,r_5_87_54,r_38_22_9,0.54,1,10,9,46
65,seq29,r_61_81_110,seq42,r_61_81_110,0.7,21,131,110,46
44,r_9_1_37,seq117,seq139,r_9_1_37,1.0,-3,34,37,46
76,seq63,r_113_18_165,r_125_79_130,r_125_79_130,0.79,35,165,130,46
31,r_17_70_85,r_123_147_171,r_138_149_159,r_123_147_171,1.0,0,171,171,46
3,r_140_59_187,seq136,r_5_87_54,r_140_59_187,0.44,0,187,187,46
60,seq146,r_78_132_160,r_118_55_32,r_118_55_32,0.53,-2,30,32,46
29,r_11_104_52,seq72,r_110_128_185,r_11_104_52,1.0,1,53,52,46
0,r_101_93_108,seq33,seq51,r_101_93_108,1.0,1,109,108,46
19,r_75_23_45,r_77_135_138,seq51,r_75_23_45,1.0,0,45,45,46
11,r_92_142_118,r_25_40_79,seq146,r_92_142_118,0.78,-50,68,118,46
20,r_103_57_71,seq14,seq115,r_103_57_71,0.8,-1,70,71,46
48,r_49_126_100,seq102,seq33,r_49_126_100,1.0,0,100,100,46
78,seq72,r_15_45_80,r_122_116_12,r_122_116_12,0.71,16,28,12,46
47,r_58_131_111,r_5_87_54,seq62,r_58_131_111,1.0,0,111,111,46
40,r_71_69_88,r_130_94_186,r_118_55_32,r_118_55_32,0.44,36,68,32,46
18,r_5_87_54,seq85,seq88,r_5_87_54,0.67,6,60,54,46
25,r_61_81_110,r_36_144_57,seq35,r_36_144_57,0.86,-13,44,57,46
33,r_20_120_90,seq117,seq89,r_20_120_90,0.98,1,91,90,46
42,r_43_31_113,seq62,seq74,r_43_31_113,0.9,1,114,113,46
26,r_122_116_12,seq119,seq72,r_122_116_12,0.99,0,12,12,46
23,r_91_68_60,r_113_18_165,seq4,r_91_68_60,0.99,-2,58,60,46
15,r_133_66_24,r_64_105_133,seq34,r_133_66_24,0.56,2,26,24,46
34,r_38_22_9,r_5_87_54,r_9_1_37,r_9_1_37,1.0,30,67,37,46
17,r_25_40_79,r_92_142_118,seq97,r_25_40_79,0.66,0,79,79,46
25,r_61_81_110,seq35,r_133_66_24,r_61_81_110,0.89,1,111,110,46
50,seq0,r_138_149_159,r_48_114_123,r_138_149_159,0.42,-141,18,159,46
94,seq112,seq97,r_7_56_104,r_7_56_104,0.98,13,117,104,46
9,r_52_98_181,r_110_128_185,r_77_135_138,r_52_98_181,0.54,0,181,181,46
43,r_36_144_57,r_61_81_110,r_138_149_159,r_36_144_57,0.96,-1,56,57,46
50,seq0,r_48_114_123,seq10,r_48_114_123,0.52,-2,121,123,46
11,r_92_142_118,seq146,r_5_87_54,r_92_142_118,1.0,3,121,118,46
29,r_11_104_52,r_110_128_185,r_84_108_166,r_11_104_52,0.81,130,182,52,46
28,r_123_147_171,r_78_132_160,r_64_105_133,r_64_105_133,0.53,38,171,133,46
49,r_113_18_165,seq63,seq21,r_113_18_165,0.61,0,165,165,46
56,seq12,r_123_147_171,r_138_149_159,r_123_147_171,0.97,0,171,171,46
55,seq139,seq80,r_9_1_37,r_9_1_37,1.0,-3,34,37,46
35,r_7_56_104,r_64_105_133,seq112,r_64_105_133,0.51,-27,106,133,46
12,r_110_128_185,r_52_98_181,r_7_56_104,r_110_128_185,0.5,-1,184,185,46
7,r_48_114_123,r_124_107_17,r_71_69_88,r_124_107_17,0.92,29,46,17,46
84,seq88,seq14,r_5_87_54,r_5_87_54,0.79,7,61,54,46
30,r_124_82_107,r_6_78_121,seq65,r_124_82_107,0.99,0,107,107,47
18,r_56_52_20,r_132_3_65,r_57_5_161,r_56_52_20,0.9,0,20,20,47
36,r_86_90_124,seq95,seq117,r_86_90_124,0.93,0,124,124,47
17,r_54_29_29,r_1_41_57,seq92,r_54_29_29,0.96,0,29,29,47
14,r_66_110_141,r_58_126_190,seq18,r_66_110_141,0.89,0,141,141,47
83,seq95,r_86_90_124,seq72,r_86_90_124,0.99,0,124,124,47
16,r_6_78_121,seq119,r_12_7_110,r_6_78_121,1.0,0,121,121,47
21,r_143_15_158,seq25,seq148,r_143_15_158,0.46,1,159,158,47
5,r_132_3_65,r_143_15_158,seq88,r_132_3_65,1.0,0,65,65,47
46,r_144_138_93,r_14_84_135,seq72,r_144_138_93,0.99,0,93,93,47
62,seq21,r_50_19_67,r_121_87_126,r_121_87_126,1.0,33,159,126,47
22,r_79_69_58,r_12_7_110,seq61,r_79_69_58,0.99,0,58,58,47
45,r_140_28_97,r_12_7_110,seq13,r_140_28_97,1.0,0,97,97,47
19,r_42_112_139,seq18,seq70,r_42_112_139,0.65,0,139,139,47
8,r_38_100_21,seq21,seq147,r_38_100_21,0.96,0,21,21,47
95,seq117,seq83,r_86_90_124,r_86_90_124,1.0,0,124,124,47
31,r_67_47_188,r_9_35_187,r_42_112_139,r_42_112_139,0.66,48,187,139,47
67,seq60,r_85_34_87,seq72,r_85_34_87,1.0,0,87,87,47
3,r_120_11_171,seq137,r_89_32_172,r_89_32_172,0.83,0,172,172,47
10,r_121_87_126,r_73_76_178,seq21,r_121_87_126,0.92,0,126,126,47
26,r_8_99_128,r_73_76_178,r_123_24_31,r_8_99_128,1.0,0,128,128,47
55,seq10,seq148,r_1_41_57,r_1_41_57,1.0,1,58,57,47
11,r_85_34_87,seq60,seq122,r_85_34_87,1.0,0,87,87,47
15,r_9_35_187,r_67_47_188,r_120_11_171,r_9_35_187,0.56,0,187,187,47
13,r_57_5_161,r_56_52_20,seq83,r_57_5_161,0.91,0,161,161,47
6,r_116_62_59,seq149,r_38_100_21,r_116_62_59,0.99,5,64,59,47
13,r_57_5_161,r_125_23_32,r_56_52_20,r_57_5_161,0.98,-132,29,161,47
39,r_36_53_43,r_85_34_87,seq71,r_36_53_43,0.96,-2,41,43,47
2,r_14_84_135,seq4,r_54_29_29,r_14_84_135,0.96,0,135,135,47
47,r_50_19_67,r_143_15_158,seq21,r_50_19_67,1.0,0,67,67,47
40,r_108_146_112,seq147,r_56_52_20,r_108_146_112,1.0,0,112,112,47
29,r_27_91_98,seq68,seq92,r_27_91_98,0.98,0,98,98,47
24,r_12_7_110,seq147,seq137,r_12_7_110,0.63,-2,108,110,47
25,r_89_32_172,r_57_5_161,r_124_82_107,r_124_82_107,1.0,2,109,107,47
32,r_22_113_44,seq139,seq65,r_22_113_44,1.0,-1,43,44,47
70,seq65,r_89_32_172,seq105,r_89_32_172,0.8,-9,163,172,47
62,seq21,r_26_59_33,r_50_19_67,r_50_19_67,1.0,0,67,67,47
44,r_58_126_190,r_133_40_39,r_66_110_141,r_58_126_190,0.94,0,190,190,47
68,seq61,r_6_78_121,r_79_69_58,r_79_69_58,0.98,31,89,58,47
61,seq148,r_58_126_190,r_143_15_158,r_143_15_158,0.67,3,161,158,47
0,r_133_40_39,r_121_87_126,seq148,r_133_40_39,1.0,0,39,39,47
38,r_20_102_80,r_142_44_148,seq137,r_20_102_80,0.91,-4,76,80,47
68,seq61,r_79_69_58,r_131_129_159,r_131_129_159,1.0,14,173,159,47
41,r_26_59_33,r_121_87_126,seq21,r_26_59_33,0.74,0,33,33,47
25,r_89_32_172,r_124_82_107,r_120_11_171,r_89_32_172,0.97,0,172,172,47
94,seq114,r_6_78_121,seq70,r_6_78_121,0.98,-24,97,121,47
9,r_30_43_28,r_121_87_126,seq147,r_30_43_28,1.0,1,29,28,47
1,r_1_41_57,seq70,seq10,r_1_41_57,1.0,0,57,57,47
49,r_73_76_178,seq92,r_121_87_126,r_121_87_126,0.98,52,178,126,47
4,r_80_2_16,r_12_7_110,seq68,r_80_2_16,0.98,0,16,16,47
18,r_56_52_20,r_57_5_161,r_108_146_112,r_108_146_112,0.97,49,161,112,47
44,r_58_126_190,r_66_110_141,r_133_40_39,r_58_126_190,0.91,-49,141,190,47
23,r_142_44_148,r_58_126_190,r_141_145_62,r_142_44_148,0.66,0,148,148,47
7,r_125_23_32,r_57_5_161,seq75,r_125_23_32,0.99,0,32,32,47
12,r_130_31_181,seq18,r_38_100_21,r_130_31_181,0.52,0,181,181,47
42,r_37_135_51,seq117,seq33,r_37_135_51,0.9,0,51,51,47
51,seq2,r_71_4_194,r_69_117_98,r_69_117_98,1.0,4,102,98,48
36,r_35_49_124,seq64,seq15,r_35_49_124,0.9,3,127,124,48
14,r_3_0_93,seq6,seq75,r_3_0_93,1.0,0,93,93,48
8,r_73_9_157,seq143,r_19_127_109,r_73_9_157,0.8,0,157,157,48
43,r_101_131_66,seq104,r_129_133_96,r_101_131_66,0.6,0,66,66,48
54,seq136,seq63,r_18_51_147,r_18_51_147,0.54,0,147,147,48
37,r_28_80_78,seq98,r_101_131_66,r_28_80_78,0.97,0,78,78,48
55,seq137,seq128,r_107_130_72,r_107_130_72,1.0,6,78,72,48
5,r_50_56_59,seq138,r_118_70_36,r_50_56_59,1.0,0,59,59,48
21,r_124_135_83,r_144_90_185,seq16,r_124_135_83,0.92,1,84,83,48
1,r_114_8_153,seq88,r_148_11_74,r_114_8_153,0.64,0,153,153,48
46,r_69_117_98,seq16,seq2,r_69_117_98,1.0,1,99,98,48
42,r_13_26_85,seq91,r_146_93_92,r_13_26_85,0.59,12,97,85,48
24,r_99_48_27,seq29,r_1_67_131,r_99_48_27,1.0,0,27,27,48
80,seq75,seq62,r_3_0_93,r_3_0_93,1.0,4,97,93,48
69,seq40,r_53_76_166,r_50_56_59,r_50_56_59,1.0,107,166,59,48
45,r_105_74_100,seq84,seq29,r_105_74_100,1.0,0,100,100,48
19,r_71_4_194,r_23_142_155,r_69_117_98,r_69_117_98,0.8,41,139,98,48
78,seq66,r_71_4_194,seq149,r_71_4_194,0.48,-82,112,194,48
76,seq64,r_35_49_124,seq14,r_35_49_124,1.0,3,127,124,48
24,r_99_48_27,r_1_67_131,r_27_7_71,r_99_48_27,1.0,45,72,27,48
35,r_85_72_121,r_45_60_1,r_25_113_42,r_25_113_42,1.0,16,58,42,48
67,seq32,r_22_125_176,r_148_11_74,r_148_11_74,1.0,43,117,74,48
89,seq97,r_134_111_177,seq65,r_134_111_177,0.27,2,179,177,48
3,r_129_133_96,seq12,r_78_20_58,r_129_133_96,0.96,1,97,96,48
26,r_108_123_183,seq65,r_50_56_59,r_50_56_59,0.88,124,183,59,48
4,r_38_100_163,seq15,r_129_133_96,r_38_100_163,0.61,1,164,163,48
0,r_134_111_177,seq97,r_55_92_77,r_134_111_177,0.53,1,178,177,48
73,seq59,r_106_96_179,r_69_117_98,r_69_117_98,1.0,81,179,98,48
29,r_95_120_55,r_148_11_74,r_122_115_40,r_95_120_55,0.77,2,57,55,48
20,r_23_142_155,r_27_7_71,r_71_4_194,r_27_7_71,1.0,0,71,71,48
56,seq138,r_144_90_185,r_34_39_139,r_144_90_185,0.76,-63,122,185,48
6,r_57_79_30,seq59,seq143,r_57_79_30,1.0,0,30,30,48
10,r_25_113_42,r_85_72_121,seq31,r_85_72_121,1.0,0,121,121,48
27,r_27_7_71,r_23_142_155,r_99_48_27,r_27_7_71,1.0,0,71,71,48
49,r_94_41_39,seq75,seq104,r_94_41_39,1.0,0,39,39,48
87,seq88,r_114_8_153,seq43,r_114_8_153,0.86,0,153,153,48
47,r_144_90_185,seq29,r_114_8_153,r_144_90_185,0.44,0,185,185,48
43,r_101_131_66,r_129_133_96,r_28_80_78,r_101_131_66,0.69,23,89,66,48
74,seq62,r_19_127_109,seq138,r_19_127_109,0.54,0,109,109,48
18,r_53_76_166,seq40,r_19_127_109,r_53_76_166,0.77,0,166,166,48
35,r_85_72_121,r_25_113_42,r_94_41_39,r_85_72_121,1.0,0,121,121,48
25,r_19_127_109,seq62,seq46,r_19_127_109,1.0,0,109,109,48
58,seq12,r_129_133_96,r_45_60_1,r_129_133_96,1.0,1,97,96,48
56,seq138,r_50_56_59,r_144_90_185,r_50_56_59,0.77,0,59,59,48
65,seq29,r_144_90_185,r_105_74_100,r_105_74_100,1.0,16,116,100,48
20,r_23_142_155,r_108_123_183,r_102_103_161,r_23_142_155,0.69,14,169,155,48
20,r_23_142_155,r_71_4_194,r_108_123_183,r_23_142_155,0.8,0,155,155,48
77,seq65,r_108_123_183,r_23_142_155,r_23_142_155,0.69,28,183,155,48
10,r_25_113_42,seq66,r_85_72_121,r_25_113_42,0.96,0,42,42,48
60,seq15,seq140,r_35_49_124,r_35_49_124,1.0,3,127,124,48
81,seq143,r_73_9_157,r_57_79_30,r_57_79_30,0.59,44,74,30,48
17,r_106_96_179,seq59,r_95_120_55,r_95_120_55,0.64,124,179,55,48
94,seq110,r_22_125_176,r_114_8_153,r_114_8_153,0.59,24,177,153,48
32,r_5_58_29,r_38_100_163,seq82,r_5_58_29,1.0,0,29,29,48
78,seq66,r_25_113_42,r_71_4_194,r_25_113_42,0.97,0,42,42,48
9,r_55_92_77,r_148_11_74,r_5_58_29,r_55_92_77,0.87,-3,74,77,48
22,r_1_67_131,seq104,r_146_93_92,r_1_67_131,0.95,0,131,131,48
41,r_78_20_58,r_27_7_71,r_42_36_17,r_78_20_58,1.0,0,58,58,48
7,r_87_89_86,r_102_103_161,seq15,r_87_89_86,1.0,2,88,86,48
44,r_107_130_72,r_61_119_191,seq137,r_107_130_72,1.0,0,72,72,48
23,r_148_11_74,r_55_92_77,seq32,r_148_11_74,1.0,0,74,74,48
30,r_122_115_40,seq75,seq128,r_122_115_40,1.0,1,41,40,48
51,seq129,r_28_29_155,r_35_26_39,r_35_26_39,0.62,61,100,39,49
36,r_99_74_175,seq19,r_30_127_131,r_30_127_131,1.0,44,175,131,49
9,r_22_57_120,r_4_110_31,r_142_143_2,r_22_57_120,1.0,1,121,120,49
19,r_4_110_31,r_22_57_120,r_146_80_69,r_4_110_31,0.98,90,121,31,49
16,r_113_100_146,seq0,r_146_80_69,r_146_80_69,0.54,77,146,69,49
5,r_46_63_132,seq32,seq124,r_46_63_132,0.98,0,132,132,49
46,r_78_97_85,seq73,r_146_80_69,r_78_97_85,1.0,0,85,85,49
42,r_39_59_123,seq117,r_102_7_8,r_39_59_123,0.79,0,123,123,49
45,r_132_70_90,r_91_15_143,seq41,r_132_70_90,0.99,0,90,90,49
95,seq119,r_107_118_172,r_131_136_94,r_131_136_94,1.0,78,172,94,49
31,r_149_6_76,seq126,seq62,r_149_6_76,1.0,0,76,76,49
11,r_25_109_32,seq44,r_133_17_137,r_25_109_32,0.61,2,34,32,49
10,r_5_145_184,seq19,r_95_69_154,r_5_145_184,0.49,0,184,184,49
4,r_77_37_157,seq41,r_65_43_111,r_77_37_157,0.66,0,157,157,49
0,r_23_123_129,seq81,seq0,r_23_123_129,0.99,0,129,129,49
20,r_91_15_143,r_3_54_173,r_61_106_74,r_91_15_143,0.81,0,143,143,49
15,r_95_69_154,seq14,seq41,r_95_69_154,0.62,0,154,154,49
6,r_1_79_162,seq122,r_35_26_39,r_35_26_39,0.61,123,162,39,49
13,r_35_26_39,seq13,seq129,r_35_26_39,1.0,0,39,39,49
99,seq126,r_149_6_76,seq134,r_149_6_76,1.0,1,77,76,49
27,r_42_101_102,r_1_79_162,r_130_115_19,r_42_101_102,1.0,0,102,102,49
47,r_8_47_109,r_99_74_175,r_42_101_102,r_42_101_102,1.0,8,110,102,49
18,r_9_85_134,seq49,r_133_17_137,r_9_85_134,0.99,0,134,134,49
24,r_131_136_94,seq13,seq119,r_131_136_94,1.0,1,95,94,49
25,r_33_138_135,seq41,r_65_43_111,r_33_138_135,0.89,0,135,135,49
33,r_2_108_116,r_137_76_179,r_65_43_111,r_2_108_116,1.0,0,116,116,49
64,seq40,r_128_67_170,r_61_106_74,r_128_67_170,0.73,-85,85,170,49
32,r_53_51_153,r_107_118_172,r_46_63_132,r_53_51_153,0.65,0,153,153,49
38,r_3_54_173,seq12,r_131_136_94,r_3_54_173,0.79,1,174,173,49
77,seq73,r_78_97_85,seq62,r_78_97_85,1.0,0,85,85,49
9,r_22_57_120,r_39_59_123,r_4_110_31,r_4_110_31,1.0,2,33,31,49
34,r_84_89_71,r_9_85_134,seq86,r_84_89_71,1.0,0,71,71,49
35,r_148_38_42,r_61_106_74,r_18_114_44,r_148_38_42,1.0,2,44,42,49
17,r_146_80_69,seq88,seq13,r_146_80_69,1.0,-1,68,69,49
96,seq122,r_1_79_162,r_72_94_63,r_72_94_63,1.0,99,162,63,49
22,r_65_43_111,r_142_143_2,seq62,r_65_43_111,0.98,1,112,111,49
28,r_28_29_155,seq129,seq44,r_28_29_155,0.95,1,156,155,49
8,r_130_115_19,r_71_11_167,seq49,r_130_115_19,1.0,1,20,19,49
49,r_147_68_148,seq13,seq88,r_147_68_148,0.85,1,149,148,49
56,seq14,r_95_69_154,r_84_89_71,r_84_89_71,0.79,83,154,71,49
7,r_107_118_172,seq119,seq50,r_107_118_172,0.69,0,172,172,49
19,r_4_110_31,r_71_11_167,r_22_57_120,r_4_110_31,0.96,-1,30,31,49
23,r_72_94_63,r_9_85_134,seq122,r_72_94_63,0.69,1,64,63,49
21,r_18_114_44,r_91_15_143,r_148_38_42,r_18_114_44,1.0,0,44,44,49
84,seq87,r_53_51_153,r_131_136_94,r_131_136_94,0.91,11,105,94,49
30,r_85_50_107,r_138_57_126,r_49_137_192,r_49_137_192,0.77,-85,107,192,50
51,seq131,r_107_145_166,r_9_65_7,r_107_145_166,0.48,0,166,166,50
2,r_30_136_158,seq112,r_68_117_123,r_30_136_158,0.99,0,158,158,50
36,r_129_121_138,seq0,r_115_109_27,r_129_121_138,0.73,3,141,138,50
14,r_120_3_155,seq69,seq141,r_120_3_155,0.87,0,155,155,50
37,r_105_24_140,seq112,seq45,r_105_24_140,0.76,0,140,140,50
71,seq51,r_92_134_122,r_110_18_175,r_92_134_122,0.96,0,122,122,50
21,r_2_48_116,seq45,r_133_147_26,r_2_48_116,0.82,0,116,116,50
39,r_102_42_74,seq7,seq81,r_102_42_74,0.93,0,74,74,50
1,r_138_57_126,seq67,r_102_42_74,r_138_57_126,0.98,0,126,126,50
5,r_70_79_106,r_129_121_138,r_99_71_1,r_70_79_106,0.61,3,109,106,50
42,r_29_124_75,seq64,r_120_3_155,r_29_124_75,1.0,0,75,75,50
19,r_14_41_181,seq98,r_92_134_122,r_14_41_181,0.48,0,181,181,50
27,r_100_4_48,r_66_35_170,r_84_128_149,r_100_4_48,0.59,122,170,48,50
99,seq127,r_89_148_38,r_115_109_27,r_89_148_38,1.0,0,38,38,50
16,r_115_109_27,r_92_134_122,seq127,r_92_134_122,0.69,-102,20,122,50
67,seq135,seq74,r_44_56_65,r_44_56_65,1.0,47,112,65,50
3,r_38_122_70,r_108_126_162,seq51,r_38_122_70,1.0,0,70,70,50
90,seq98,r_14_41_181,r_138_57_126,r_138_57_126,0.91,55,181,126,50
26,r_60_97_108,r_140_111_198,seq59,r_60_97_108,0.88,0,108,108,50
4,r_92_134_122,seq51,r_39_139_78,r_92_134_122,1.0,0,122,122,50
45,r_77_88_23,r_39_139_78,seq80,r_77_88_23,1.0,1,24,23,50
0,r_76_113_160,r_9_65_7,seq51,r_76_113_160,0.85,0,160,160,50
11,r_39_139_78,seq90,seq0,r_39_139_78,1.0,0,78,78,50
20,r_44_56_65,seq72,seq135,r_44_56_65,1.0,0,65,65,50
57,seq142,r_20_25_143,seq36,r_20_25_143,1.0,6,149,143,50
6,r_49_137_192,r_120_3_155,r_85_50_107,r_49_137_192,0.78,-85,107,192,50
24,r_125_11_35,seq59,seq54,r_125_11_35,0.78,0,35,35,50
85,seq81,r_78_62_76,r_102_42_74,r_102_42_74,1.0,0,74,74,50
46,r_43_114_12,seq135,r_89_148_38,r_89_148_38,1.0,10,48,38,50
25,r_89_148_38,seq127,r_43_114_12,r_89_148_38,1.0,0,38,38,50
87,seq90,r_39_139_78,r_68_117_123,r_39_139_78,1.0,-12,66,78,50
2,r_30_136_158,r_105_24_140,seq112,r_105_24_140,0.82,-23,117,140,50
47,r_110_18_175,seq52,r_101_63_128,r_101_63_128,0.9,47,175,128,50
40,r_101_63_128,seq12,r_91_10_121,r_101_63_128,0.97,1,129,128,50
18,r_68_117_123,seq23,seq90,r_68_117_123,0.68,1,124,123,50
29,r_20_25_143,seq142,r_138_57_126,r_20_25_143,0.99,0,143,143,50
34,r_66_35_170,r_100_4_48,seq37,r_100_4_48,0.49,122,170,48,50
34,r_66_35_170,r_120_3_155,r_100_4_48,r_66_35_170,0.63,-119,51,170,50
27,r_100_4_48,r_60_97_108,r_66_35_170,r_100_4_48,0.66,1,49,48,50
38,r_5_15_111,seq6,seq132,r_5_15_111,0.68,2,113,111,50
52,seq132,r_108_126_162,r_5_15_111,r_5_15_111,0.64,62,173,111,50
76,seq59,r_68_117_123,r_60_97_108,r_60_97_108,0.64,3,111,108,50
22,r_13_149_174,seq23,seq52,r_13_149_174,0.75,0,174,174,50
28,r_91_10_121,seq37,seq112,r_91_10_121,1.0,2,123,121,50
49,r_9_65_7,r_76_113_160,seq104,r_76_113_160,0.98,0,160,160,50
42,r_29_124_75,r_120_3_155,seq46,r_120_3_155,1.0,-38,117,155,50
76,seq59,r_125_11_35,r_68_117_123,r_125_11_35,0.93,0,35,35,50
35,r_8_28_172,r_95_82_176,seq33,r_8_28_172,0.52,0,172,172,50
12,r_84_128_149,seq118,seq69,r_84_128_149,0.74,2,151,149,50
93,seq115,r_26_87_194,r_108_135_80,r_108_135_80,1.0,1,81,80,51
14,r_72_117_176,r_80_121_177,r_108_135_80,r_72_117_176,0.51,3,179,176,51
8,r_17_131_84,seq24,seq86,r_17_131_84,1.0,0,84,84,51
53,seq7,r_55_74_182,r_23_75_102,r_23_75_102,0.97,80,182,102,51
43,r_133_69_93,seq128,seq12,r_133_69_93,0.52,-2,91,93,51
37,r_138_9_54,seq71,r_10_89_116,r_10_89_116,0.67,17,133,116,51
28,r_21_129_24,r_30_143_26,r_33_140_195,r_21_129_24,0.85,0,24,24,51
16,r_45_5_38,r_134_67_133,r_43_32_74,r_43_32_74,0.85,59,133,74,51
21,r_108_135_80,r_19_11_122,seq115,r_108_135_80,0.99,0,80,80,51
39,r_52_125_150,r_97_84_121,r_10_89_116,r_97_84_121,0.61,0,121,121,51
5,r_137_83_138,r_46_79_175,r_40_103_130,r_137_83_138,0.9,3,141,138,51
46,r_55_74_182,seq7,r_10_89_116,r_55_74_182,0.49,0,182,182,51
9,r_57_68_31,r_82_15_199,seq8,r_57_68_31,1.0,0,31,31,51
80,seq78,r_10_89_116,r_81_39_32,r_81_39_32,0.97,53,85,32,51
39,r_52_125_150,r_10_89_116,r_99_62_51,r_52_125_150,0.96,0,150,150,51
19,r_25_109_165,seq120,r_10_89_116,r_25_109_165,0.48,0,165,165,51
95,seq120,r_25_109_165,r_99_62_51,r_99_62_51,0.98,107,158,51,51
38,r_40_103_130,r_60_107_19,seq14,r_40_103_130,0.82,0,130,130,51
41,r_48_141_91,r_133_69_93,seq92,r_48_141_91,1.0,0,91,91,51
67,seq47,r_134_67_133,r_43_32_74,r_43_32_74,0.82,0,74,74,51
3,r_10_89_116,seq78,r_52_125_150,r_10_89_116,0.68,8,124,116,51
26,r_144_29_109,r_137_83_138,seq92,r_144_29_109,0.97,0,109,109,51
4,r_1_139_173,r_25_109_165,r_52_125_150,r_52_125_150,0.64,7,157,150,51
31,r_81_39_32,r_55_74_182,seq78,r_81_39_32,0.99,0,32,32,51
20,r_38_118_164,r_95_101_49,r_17_131_84,r_17_131_84,1.0,83,167,84,51
13,r_73_104_135,seq124,r_97_84_121,r_73_104_135,0.55,0,135,135,51
48,r_46_79_175,seq51,r_1_139_173,r_46_79_175,0.6,0,175,175,51
6,r_100_147_160,seq61,r_48_141_91,r_48_141_91,0.93,69,160,91,51
3,r_10_89_116,r_52_125_150,r_138_9_54,r_52_125_150,0.99,0,150,150,51
38,r_40_103_130,r_95_101_49,r_60_107_19,r_60_107_19,0.76,9,28,19,51
27,r_23_75_102,r_26_87_194,seq128,r_23_75_102,1.0,-1,101,102,51
18,r_59_53_104,seq88,r_30_143_26,r_59_53_104,1.0,0,104,104,51
34,r_30_143_26,seq63,r_59_53_104,r_59_53_104,1.0,2,106,104,51
33,r_36_35_103,r_137_83_138,seq88,r_36_35_103,0.99,0,103,103,51
34,r_30_143_26,seq149,seq63,r_30_143_26,0.98,2,28,26,51
68,seq49,r_91_148_118,seq93,r_91_148_118,0.99,0,118,118,51
1,r_33_140_195,r_82_15_199,r_21_129_24,r_21_129_24,1.0,0,24,24,51
32,r_97_84_121,r_52_125_150,seq123,r_97_84_121,0.7,0,121,121,51
79,seq77,seq63,r_76_85_157,r_76_85_157,0.57,8,165,157,51
4,r_1_139_173,r_52_125_150,r_91_148_118,r_1_139_173,0.83,0,173,173,51
47,r_96_13_21,seq63,seq31,r_96_13_21,1.0,0,21,21,51
22,r_80_121_177,r_72_117_176,r_95_101_49,r_72_117_176,0.52,3,179,176,51
10,r_99_62_51,r_50_136_70,seq120,r_50_136_70,0.53,-19,51,70,51
49,r_19_11_122,r_137_83_138,seq16,r_19_11_122,0.74,0,122,122,51
45,r_41_111_59,seq142,seq71,r_41_111_59,1.0,0,59,59,51
7,r_43_32_74,seq18,seq47,r_43_32_74,1.0,0,74,74,51
44,r_50_136_70,seq8,r_81_39_32,r_50_136_70,0.99,-1,69,70,51
23,r_98_22_126,seq14,r_81_39_32,r_98_22_126,0.64,0,126,126,51
64,seq31,r_6_119_197,r_96_13_21,r_96_13_21,1.0,1,22,21,51
12,r_134_67_133,r_45_5_38,seq71,r_134_67_133,0.76,0,133,133,51
35,r_60_107_19,seq86,seq66,r_60_107_19,0.82,2,21,19,51
36,r_88_132_95,r_146_27_130,seq55,r_88_132_95,0.86,0,95,95,52
14,r_1_39_109,r_110_43_110,r_84_98_99,r_1_39_109,1.0,0,109,109,52
8,r_104_117_161,r_109_36_103,r_42_59_88,r_104_117_161,0.88,0,161,161,52
66,seq33,seq134,r_67_141_189,r_67_141_189,0.7,0,189,189,52
13,r_50_127_43,r_67_141_189,r_99_107_4,r_50_127_43,1.0,0,43,43,52
37,r_30_47_124,r_84_98_99,r_8_53_56,r_30_47_124,0.94,0,124,124,52
45,r_40_6_25,r_7_78_116,r_8_53_56,r_40_6_25,0.96,33,58,25,52
19,r_105_57_35,seq32,r_109_36_103,r_109_36_103,0.43,76,179,103,52
71,seq58,seq90,r_51_89_129,r_51_89_129,0.99,10,139,129,52
39,r_130_119_112,r_84_98_99,r_19_126_41,r_130_119_112,1.0,0,112,112,52
1,r_140_95_10,seq76,r_48_129_84,r_48_129_84,1.0,3,87,84,52
97,seq116,seq10,r_146_27_130,r_146_27_130,0.87,26,156,130,52
46,r_20_17_91,seq10,seq60,r_20_17_91,0.84,0,91,91,52
42,r_122_82_182,r_99_107_4,r_80_139_141,r_99_107_4,0.28,178,182,4,52
95,seq114,r_25_75_113,r_136_5_5,r_25_75_113,0.62,0,113,113,52
30,r_145_13_33,r_44_11_179,r_69_28_55,r_44_11_179,0.88,-118,61,179,52
31,r_102_38_167,seq106,r_14_144_83,r_102_38_167,0.78,0,167,167,52
80,seq85,r_105_57_35,seq16,r_105_57_35,1.0,0,35,35,52
41,r_52_34_185,r_149_97_175,r_104_117_161,r_104_117_161,0.95,14,175,161,52
60,seq18,r_52_34_185,r_74_35_115,r_74_35_115,0.65,0,115,115,52
30,r_145_13_33,r_7_78_116,r_44_11_179,r_145_13_33,0.99,0,33,33,52
10,r_124_148_162,seq68,r_62_64_50,r_124_148_162,0.85,0,162,162,52
4,r_31_72_40,r_69_28_55,seq101,r_31_72_40,1.0,1,41,40,52
26,r_84_98_99,r_30_47_124,r_1_39_109,r_84_98_99,0.97,26,125,99,52
0,r_80_139_141,seq86,seq56,r_80_139_141,0.74,0,141,141,52
5,r_12_108_11,r_1_39_109,seq106,r_12_108_11,0.81,0,11,11,52
25,r_65_66_59,seq103,seq86,r_65_66_59,1.0,0,59,59,52
6,r_44_11_179,r_84_98_99,seq81,r_44_11_179,0.83,0,179,179,52
15,r_146_27_130,r_88_132_95,r_4_125_147,r_88_132_95,1.0,0,95,95,52
2,r_19_126_41,r_149_97_175,seq73,r_19_126_41,1.0,0,41,41,52
6,r_44_11_179,r_51_89_129,r_84_98_99,r_51_89_129,1.0,0,129,129,52
48,r_69_28_55,seq138,r_145_13_33,r_145_13_33,0.7,26,59,33,52
41,r_52_34_185,r_104_117_161,r_63_2_174,r_104_117_161,0.61,24,185,161,52
27,r_109_36_103,r_104_117_161,r_30_47_124,r_109_36_103,0.85,58,161,103,52
16,r_137_123_38,r_69_28_55,seq32,r_137_123_38,1.0,1,39,38,52
45,r_40_6_25,r_50_127_43,r_7_78_116,r_40_6_25,0.99,0,25,25,52
34,r_135_54_53,seq142,seq16,r_135_54_53,1.0,0,53,53,52
47,r_71_41_117,seq70,seq15,r_71_41_117,0.57,1,118,117,52
18,r_147_29_152,seq87,r_94_61_97,r_147_29_152,0.86,0,152,152,52
29,r_79_121_82,r_71_41_117,r_62_64_50,r_79_121_82,0.91,1,83,82,52
24,r_48_129_84,seq83,r_140_95_10,r_48_129_84,1.0,0,84,84,52
20,r_62_64_50,seq3,seq49,r_62_64_50,0.88,0,50,50,52
43,r_7_78_116,r_40_6_25,seq58,r_7_78_116,1.0,0,116,116,52
33,r_149_97_175,r_52_34_185,r_50_127_43,r_50_127_43,0.89,132,175,43,52
70,seq56,seq92,r_80_139_141,r_80_139_141,1.0,8,149,141,52
70,seq56,r_77_37_75,seq92,r_77_37_75,1.0,-11,64,75,52
15,r_146_27_130,r_4_125_147,seq116,r_146_27_130,1.0,0,130,130,52
38,r_4_125_147,r_146_27_130,r_20_17_91,r_4_125_147,0.77,-16,131,147,52
21,r_8_53_56,seq81,r_40_6_25,r_8_53_56,0.96,1,57,56,52
19,r_105_57_35,seq85,seq32,r_105_57_35,1.0,0,35,35,52
60,seq18,r_110_43_110,r_52_34_185,r_110_43_110,0.36,-10,100,110,52
17,r_63_2_174,seq16,r_8_53_56,r_63_2_174,0.51,1,175,174,52
9,r_94_61_97,seq9,seq70,r_94_61_97,1.0,0,97,97,52
22,r_77_37_75,r_42_59_88,seq26,r_77_37_75,1.0,0,75,75,52
28,r_51_89_129,r_44_11_179,seq58,r_51_89_129,0.78,0,129,129,52
49,r_110_43_110,seq18,seq10,r_110_43_110,1.0,0,110,110,52
43,r_7_78_116,r_145_13_33,r_40_6_25,r_7_78_116,0.86,-83,33,116,52
56,seq10,seq116,r_110_43_110,r_110_43_110,1.0,7,117,110,52
7,r_74_35_115,seq16,seq18,r_74_35_115,0.58,0,115,115,52
40,r_131_45_22,r_31_72_40,seq116,r_131_45_22,0.98,0,22,22,52
23,r_42_59_88,seq101,r_149_97_175,r_42_59_88,0.67,0,88,88,52
82,seq87,r_147_29_152,seq134,r_147_29_152,1.0,0,152,152,52
38,r_4_125_147,r_20_17_91,seq15,r_4_125_147,0.9,1,148,147,52
35,r_118_22_61,seq16,seq106,r_118_22_61,1.0,0,61,61,52
12,r_25_75_113,seq114,r_135_54_53,r_25_75_113,0.96,1,114,113,52
23,r_42_59_88,r_149_97_175,r_104_117_161,r_104_117_161,0.83,14,175,161,52
40,r_22_55_99,r_16_130_20,seq94,r_22_55_99,1.0,0,99,99,53
30,r_134_58_148,r_50_5_179,r_140_11_140,r_50_5_179,1.0,-31,148,179,53
14,r_47_126_114,r_40_118_117,r_117_114_182,r_117_114_182,1.0,-68,114,182,53
53,seq133,r_140_11_140,r_44_2_88,r_44_2_88,0.76,52,140,88,53
45,r_143_65_15,r_18_53_90,r_129_39_173,r_143_65_15,1.0,-1,14,15,53
7,r_84_71_157,r_40_118_117,r_89_66_116,r_84_71_157,1.0,0,157,157,53
37,r_13_124_158,seq145,r_52_28_74,r_52_28_74,0.82,84,158,74,53
55,seq7,r_75_115_150,r_146_125_121,r_146_125_121,1.0,5,126,121,53
21,r_50_5_179,r_134_58_148,r_47_126_114,r_47_126_114,0.76,34,148,114,53
1,r_108_36_177,r_4_127_130,seq19,r_4_127_130,1.0,0,130,130,53
21,r_50_5_179,r_47_126_114,r_102_29_168,r_50_5_179,0.99,0,179,179,53
5,r_149_106_76,r_129_39_173,seq67,r_149_106_76,1.0,0,76,76,53
38,r_46_15_39,r_93_41_64,r_76_43_68,r_46_15_39,1.0,0,39,39,53
32,r_16_130_20,r_22_55_99,r_42_104_103,r_16_130_20,1.0,79,99,20,53
80,seq78,r_45_30_7,seq119,r_45_30_7,0.64,131,138,7,53
11,r_52_28_74,r_105_137_171,r_149_106_76,r_105_137_171,0.8,0,171,171,53
31,r_146_125_121,seq120,seq7,r_146_125_121,0.92,0,121,121,53
41,r_139_38_161,seq99,r_144_25_75,r_144_25_75,0.76,86,161,75,53
89,seq99,r_139_38_161,seq87,r_139_38_161,0.79,-13,148,161,53
10,r_90_121_5,r_50_5_179,r_143_65_15,r_50_5_179,0.78,-71,108,179,53
4,r_105_137_171,seq67,r_52_28_74,r_52_28_74,1.0,3,77,74,53
11,r_52_28_74,r_63_95_187,r_105_137_171,r_52_28_74,1.0,0,74,74,53
20,r_102_29_168,seq34,r_135_64_14,r_135_64_14,0.56,158,172,14,53
13,r_98_21_72,r_144_25_75,r_143_65_15,r_98_21_72,1.0,0,72,72,53
80,seq78,seq132,r_45_30_7,r_45_30_7,0.74,77,84,7,53
15,r_4_127_130,r_108_36_177,seq116,r_4_127_130,0.98,0,130,130,53
4,r_105_137_171,r_52_28_74,r_80_82_149,r_105_137_171,0.57,0,171,171,53
6,r_89_66_116,seq0,r_79_57_24,r_89_66_116,0.83,0,116,116,53
18,r_40_118_117,r_45_30_7,r_84_71_157,r_40_118_117,1.0,0,117,117,53
8,r_83_8_35,seq119,seq54,r_83_8_35,0.99,1,36,35,53
0,r_45_30_7,r_40_118_117,r_135_64_14,r_40_118_117,1.0,0,117,117,53
17,r_56_3_53,r_63_95_187,seq0,r_56_3_53,1.0,0,53,53,53
42,r_35_48_199,r_50_5_179,r_143_65_15,r_143_65_15,0.92,5,20,15,53
22,r_129_39_173,r_143_65_15,r_140_11_140,r_140_11_140,0.99,33,173,140,53
18,r_40_118_117,r_84_71_157,r_98_21_72,r_84_71_157,1.0,0,157,157,53
39,r_74_123_56,r_50_5_179,seq120,r_74_123_56,1.0,0,56,56,53
2,r_33_122_131,seq69,seq0,r_33_122_131,1.0,0,131,131,53
18,r_40_118_117,r_47_126_114,r_45_30_7,r_45_30_7,0.44,74,81,7,53
29,r_10_20_102,r_103_27_17,seq77,r_10_20_102,0.88,3,105,102,53
25,r_76_43_68,r_98_21_72,r_46_15_39,r_76_43_68,1.0,-8,60,68,53
47,r_79_57_24,seq141,r_89_66_116,r_89_66_116,1.0,24,140,116,53
47,r_79_57_24,r_18_53_90,seq141,r_79_57_24,0.93,0,24,24,53
76,seq70,seq148,r_40_118_117,r_40_118_117,1.0,27,144,117,53
22,r_129_39_173,r_149_106_76,r_143_65_15,r_143_65_15,0.84,-1,14,15,53
34,r_44_2_88,seq19,seq133,r_44_2_88,1.0,0,88,88,53
36,r_135_64_14,r_33_122_131,seq132,r_135_64_14,0.99,0,14,14,53
45,r_143_65_15,r_129_39_173,r_98_21_72,r_98_21_72,1.0,54,126,72,53
9,r_140_11_140,seq133,r_83_8_35,r_140_11_140,0.97,0,140,140,53
1,r_108_36_177,seq19,r_18_53_90,r_108_36_177,0.46,0,177,177,53
32,r_16_130_20,r_18_53_90,r_22_55_99,r_16_130_20,0.99,0,20,20,53
49,r_144_25_75,r_138_92_191,seq69,r_144_25_75,0.98,0,75,75,53
43,r_93_41_64,r_46_15_39,seq94,r_93_41_64,1.0,-25,39,64,53
7,r_84_71_157,r_117_114_182,r_40_118_117,r_40_118_117,0.95,1,118,117,53
40,r_22_55_99,r_9_49_128,r_16_130_20,r_16_130_20,1.0,2,22,20,53
23,r_97_17_141,seq87,seq112,r_97_17_141,0.89,0,141,141,53
35,r_80_82_149,seq85,seq87,r_80_82_149,0.97,0,149,149,53
12,r_9_49_128,seq112,r_14_12_73,r_9_49_128,0.99,0,128,128,53
84,seq87,r_97_17_141,seq99,r_97_17_141,0.92,-1,140,141,53
36,r_55_96_93,seq44,r_112_23_18,r_55_96_93,0.81,1,94,93,54
14,r_63_40_138,seq120,r_2_29_106,r_63_40_138,0.91,1,139,138,54
43,r_122_54_89,r_17_132_173,seq74,r_122_54_89,0.99,1,90,89,54
37,r_91_59_127,seq82,r_73_85_23,r_91_59_127,1.0,1,128,127,54
3,r_149_72_152,r_108_26_7,r_79_58_63,r_108_26_7,0.76,147,154,7,54
61,seq25,r_63_40_138,r_130_1_34,r_130_1_34,0.58,2,36,34,54
55,seq11,r_78_60_125,r_6_88_151,r_6_88_151,0.51,2,153,151,54
16,r_71_14_145,r_30_101_141,seq134,r_71_14_145,0.51,-4,141,145,54
21,r_105_77_184,r_6_88_151,seq115,r_6_88_151,0.83,2,153,151,54
1,r_87_21_57,seq92,seq38,r_87_21_57,0.98,4,61,57,54
5,r_13_84_65,seq115,r_49_9_188,r_13_84_65,1.0,0,65,65,54
46,r_30_101_141,r_71_14_145,r_61_94_139,r_30_101_141,1.0,0,141,141,54
7,r_28_62_25,r_142_97_171,r_71_14_145,r_28_62_25,0.38,149,174,25,54
45,r_49_9_188,r_46_135_147,r_13_84_65,r_13_84_65,0.99,0,65,65,54
30,r_73_85_23,r_28_62_25,r_121_12_190,r_28_62_25,0.99,-4,21,25,54
39,r_141_39_20,r_13_84_65,seq25,r_141_39_20,0.96,-1,19,20,54
11,r_108_26_7,r_149_72_152,r_19_31_51,r_19_31_51,0.86,44,95,51,54
31,r_76_114_195,r_17_132_173,r_149_72_152,r_76_114_195,0.58,-22,173,195,54
41,r_6_88_151,r_105_77_184,seq11,r_6_88_151,0.61,0,151,151,54
8,r_144_69_115,seq148,r_83_3_49,r_83_3_49,0.97,1,50,49,54
35,r_118_138_52,r_78_60_125,seq126,r_118_138_52,1.0,0,52,52,54
28,r_106_66_126,seq115,r_68_86_153,r_68_86_153,1.0,9,162,153,54
26,r_100_42_121,seq81,seq74,r_100_42_121,1.0,0,121,121,54
8,r_144_69_115,r_83_3_49,r_6_88_151,r_144_69_115,1.0,0,115,115,54
0,r_2_29_106,seq134,seq131,r_2_29_106,1.0,1,107,106,54
3,r_149_72_152,r_71_14_145,r_108_26_7,r_108_26_7,0.92,6,13,7,54
98,seq125,seq38,r_103_20_61,r_103_20_61,1.0,10,71,61,54
15,r_17_132_173,r_76_114_195,seq111,r_17_132_173,0.86,0,173,173,54
48,r_103_20_61,r_78_60_125,seq125,r_103_20_61,1.0,1,62,61,54
47,r_83_3_49,r_149_72_152,r_144_69_115,r_83_3_49,0.57,1,50,49,54
70,seq47,seq4,r_140_8_46,r_140_8_46,0.98,6,52,46,54
6,r_68_86_153,seq148,r_106_66_126,r_68_86_153,0.64,0,153,153,54
2,r_142_97_171,r_28_62_25,r_16_70_82,r_16_70_82,1.0,92,174,82,54
20,r_112_23_18,r_13_84_65,seq75,r_13_84_65,0.82,-47,18,65,54
34,r_130_1_34,seq131,seq25,r_130_1_34,1.0,0,34,34,54
5,r_13_84_65,r_49_9_188,r_142_97_171,r_49_9_188,0.73,0,188,188,54
7,r_28_62_25,r_10_22_120,r_142_97_171,r_28_62_25,0.99,0,25,25,54
18,r_61_94_139,seq27,r_130_1_34,r_130_1_34,1.0,107,141,34,54
29,r_80_57_174,seq18,r_56_116_64,r_80_57_174,0.61,0,174,174,54
24,r_16_70_82,r_105_77_184,seq92,r_16_70_82,1.0,0,82,82,54
21,r_105_77_184,seq115,r_17_132_173,r_105_77_184,0.89,2,186,184,54
25,r_128_0_146,r_123_133_191,r_2_29_106,r_123_133_191,0.97,-45,146,191,54
42,r_34_109_47,r_142_97_171,seq102,r_34_109_47,1.0,0,47,47,54
47,r_83_3_49,r_144_69_115,seq99,r_144_69_115,1.0,0,115,115,54
58,seq18,r_80_57_174,r_28_62_25,r_28_62_25,0.47,149,174,25,54
32,r_10_22_120,r_73_85_23,seq52,r_73_85_23,0.81,43,66,23,54
38,r_46_135_147,seq126,seq147,r_46_135_147,0.88,0,147,147,54
32,r_10_22_120,seq52,r_118_138_52,r_10_22_120,1.0,0,120,120,54
9,r_19_31_51,seq44,r_108_26_7,r_19_31_51,1.0,0,51,51,54
2,r_142_97_171,r_2_29_106,r_28_62_25,r_142_97_171,0.48,-146,25,171,54
49,r_65_35_24,seq125,r_108_26_7,r_65_35_24,0.9,-3,21,24,54
40,r_140_8_46,seq145,seq47,r_140_8_46,0.94,2,48,46,54
45,r_49_9_188,r_13_84_65,r_149_72_152,r_149_72_152,0.99,36,188,152,54
17,r_67_129_83,seq75,seq44,r_67_129_83,0.98,2,85,83,54
22,r_56_116_64,seq44,r_78_60_125,r_56_116_64,0.99,4,68,64,54
28,r_106_66_126,seq74,seq115,r_106_66_126,0.93,0,126,126,54
78,seq75,r_121_12_190,r_112_23_18,r_112_23_18,0.98,1,19,18,54
44,r_33_90_154,seq53,r_6_88_151,r_6_88_151,0.68,8,159,151,54
23,r_78_60_125,seq11,r_56_116_64,r_56_116_64,0.97,78,142,64,54
82,seq92,r_49_9_188,r_16_70_82,r_16_70_82,1.0,2,84,82,54
12,r_79_58_63,seq45,seq81,r_79_58_63,1.0,0,63,63,54
30,r_134_27_99,r_6_126_147,seq35,r_134_27_99,0.8,0,99,99,55
92,seq117,r_136_88_174,r_78_113_79,r_78_113_79,0.98,0,79,79,55
48,r_32_95_137,r_13_15_176,r_114_54_151,r_114_54_151,0.67,1,152,151,55
8,r_106_23_78,seq87,r_84_123_34,r_106_23_78,1.0,0,78,78,55
18,r_84_123_34,seq4,r_48_44_199,r_84_123_34,1.0,0,34,34,55
83,seq93,r_38_70_169,r_58_42_45,r_58_42_45,0.98,124,169,45,55
37,r_13_15_176,r_109_82_88,seq110,r_109_82_88,1.0,4,92,88,55
16,r_39_140_138,r_48_44_199,r_26_96_49,r_39_140_138,0.97,0,138,138,55
39,r_114_54_151,seq124,r_32_95_137,r_114_54_151,0.87,0,151,151,55
1,r_46_130_185,r_112_20_150,r_61_91_110,r_61_91_110,0.59,41,151,110,55
42,r_132_66_70,seq24,seq45,r_132_66_70,1.0,0,70,70,55
45,r_10_77_158,seq24,r_132_66_70,r_132_66_70,1.0,88,158,70,55
19,r_99_100_65,seq104,seq110,r_99_100_65,1.0,0,65,65,55
4,r_141_90_194,r_49_98_197,r_83_147_51,r_83_147_51,1.0,0,51,51,55
22,r_31_41_19,r_146_37_43,seq107,r_31_41_19,0.87,0,19,19,55
66,seq50,r_92_29_94,seq121,r_92_29_94,1.0,-4,90,94,55
76,seq75,seq81,r_34_101_109,r_34_101_109,1.0,0,109,109,55
41,r_5_56_155,seq133,r_3_19_102,r_5_56_155,0.88,0,155,155,55
89,seq110,r_49_98_197,r_99_100_65,r_99_100_65,0.99,1,66,65,55
3,r_71_144_121,seq0,seq139,r_71_144_121,0.92,0,121,121,55
10,r_14_145_126,seq120,r_127_137_53,r_14_145_126,1.0,1,127,126,55
35,r_47_55_14,r_6_126_147,seq79,r_47_55_14,0.72,0,14,14,55
62,seq35,r_134_27_99,r_148_86_120,r_134_27_99,0.47,12,111,99,55
20,r_112_20_150,r_46_130_185,r_92_29_94,r_112_20_150,0.55,1,151,150,55
98,seq124,seq45,r_26_96_49,r_26_96_49,1.0,53,102,49,55
46,r_148_86_120,seq51,r_134_27_99,r_134_27_99,0.98,20,119,99,55
15,r_6_126_147,seq138,r_61_91_110,r_6_126_147,0.62,0,147,147,55
48,r_32_95_137,r_48_44_199,r_13_15_176,r_13_15_176,0.61,-37,139,176,55
17,r_83_147_51,r_148_86_120,r_141_90_194,r_83_147_51,1.0,0,51,51,55
6,r_3_19_102,seq111,r_5_56_155,r_5_56_155,0.82,6,161,155,55
6,r_3_19_102,seq105,seq111,r_3_19_102,0.98,0,102,102,55
62,seq35,r_148_86_120,r_134_27_99,r_134_27_99,0.67,0,99,99,55
26,r_1_68_29,r_57_36_161,r_129_149_28,r_1_68_29,0.85,1,30,29,55
1,r_46_130_185,r_61_91_110,r_76_28_52,r_46_130_185,1.0,1,186,185,55
46,r_148_86_120,r_83_147_51,seq51,r_83_147_51,1.0,0,51,51,55
33,r_116_2_46,r_5_56_155,seq118,r_116_2_46,1.0,0,46,46,55
27,r_136_88_174,seq117,r_134_27_99,r_136_88_174,0.77,0,174,174,55
40,r_48_44_199,r_32_95_137,r_106_23_78,r_48_44_199,0.7,-60,139,199,55
29,r_21_108_76,r_39_140_138,seq128,r_21_108_76,0.97,1,77,76,55
37,r_13_15_176,seq110,r_32_95_137,r_32_95_137,0.97,6,143,137,55
25,r_109_82_88,r_13_15_176,r_62_25_48,r_13_15_176,0.92,-84,92,176,55
31,r_78_113_79,r_1_68_29,seq117,r_78_113_79,1.0,0,79,79,55
44,r_58_42_45,r_57_36_161,seq93,r_58_42_45,1.0,0,45,45,55
36,r_62_25_48,r_49_98_197,r_8_94_24,r_62_25_48,1.0,2,50,48,55
32,r_135_12_73,r_49_98_197,seq117,r_135_12_73,0.84,5,78,73,55
38,r_34_101_109,seq120,seq75,r_34_101_109,1.0,0,109,109,55
49,r_8_94_24,r_64_16_168,seq133,r_8_94_24,1.0,0,24,24,55
7,r_146_37_43,r_92_29_94,r_47_55_14,r_146_37_43,0.99,0,43,43,55
2,r_76_28_52,r_78_113_79,r_8_94_24,r_76_28_52,1.0,0,52,52,55
31,r_78_113_79,r_76_28_52,r_1_68_29,r_78_113_79,1.0,-32,47,79,55
9,r_129_149_28,seq110,r_1_68_29,r_129_149_28,0.87,2,30,28,55
47,r_26_96_49,r_106_23_78,seq124,r_26_96_49,1.0,0,49,49,55
28,r_92_29_94,seq50,seq24,r_92_29_94,1.0,0,94,94,55
24,r_65_142_38,r_61_91_110,r_31_41_19,r_65_142_38,1.0,2,40,38,55
0,r_127_137_53,seq110,seq104,r_127_137_53,1.0,0,53,53,55
23,r_57_36_161,seq24,r_78_113_79,r_57_36_161,0.65,0,161,161,55
30,r_134_27_99,seq35,r_148_86_120,r_148_86_120,0.52,-4,116,120,55
37,r_13_15_176,r_32_95_137,seq67,r_13_15_176,0.92,0,176,176,55
30,r_35_46_85,r_84_132_183,r_139_109_74,r_35_46_85,0.66,1,86,85,56
51,seq3,r_27_122_3,r_10_97_42,r_10_97_42,1.0,23,65,42,56
36,r_22_14_105,r_84_132_183,seq104,r_22_14_105,0.93,0,105,105,56
8,r_67_93_171,r_147_107_184,r_103_55_27,r_103_55_27,0.64,144,171,27,56
53,seq5,r_94_121_147,seq100,r_94_121_147,0.82,-38,109,147,56
43,r_61_20_123,r_50_124_180,r_43_143_95,r_61_20_123,0.99,0,123,123,56
83,seq68,seq16,r_80_52_57,r_80_52_57,1.0,9,66,57,56
37,r_94_121_147,r_9_63_194,r_1_28_136,r_9_63_194,0.71,-47,147,194,56
71,seq41,r_67_93_171,r_35_46_85,r_35_46_85,0.71,54,139,85,56
86,seq78,r_105_40_138,seq44,r_105_40_138,1.0,1,139,138,56
16,r_106_131_164,seq111,seq57,r_106_131_164,0.55,5,169,164,56
21,r_24_48_179,seq78,r_91_72_173,r_24_48_179,0.34,0,179,179,56
39,r_84_132_183,seq92,seq133,r_84_132_183,0.44,-2,181,183,56
46,r_128_66_156,seq133,seq78,r_128_66_156,0.86,1,157,156,56
45,r_18_108_71,seq64,seq53,r_18_108_71,1.0,0,71,71,56
27,r_113_65_185,r_103_55_27,r_91_72_173,r_91_72_173,0.71,12,185,173,56
7,r_136_117_59,seq11,r_51_134_102,r_136_117_59,0.64,0,59,59,56
47,r_36_119_21,seq68,seq11,r_36_119_21,0.75,2,23,21,56
3,r_12_123_109,seq140,seq141,r_12_123_109,0.97,0,109,109,56
26,r_148_56_152,r_67_93_171,seq5,r_148_56_152,0.88,0,152,152,56
4,r_71_114_120,seq30,seq64,r_71_114_120,0.98,2,122,120,56
13,r_87_70_88,r_7_118_93,r_13_25_172,r_87_70_88,0.68,4,92,88,56
15,r_43_143_95,seq60,seq141,r_43_143_95,1.0,0,95,95,56
48,r_38_85_66,seq45,seq21,r_38_85_66,0.96,3,69,66,56
20,r_27_122_3,seq16,r_0_79_29,r_0_79_29,1.0,1,30,29,56
13,r_87_70_88,r_13_25_172,r_91_72_173,r_13_25_172,0.89,0,172,172,56
33,r_69_102_50,seq149,seq30,r_69_102_50,1.0,0,50,50,56
7,r_136_117_59,r_51_134_102,seq149,r_51_134_102,0.99,2,104,102,56
10,r_80_52_57,seq21,seq68,r_80_52_57,1.0,1,58,57,56
93,seq110,r_139_109_74,seq60,r_139_109_74,0.8,-36,38,74,56
28,r_37_90_17,r_139_109_74,seq53,r_139_109_74,0.58,-57,17,74,56
19,r_10_97_42,r_1_28_136,seq3,r_10_97_42,1.0,0,42,42,56
25,r_0_79_29,seq53,r_27_122_3,r_0_79_29,1.0,0,29,29,56
29,r_138_135_23,r_75_49_8,seq133,r_138_135_23,0.65,0,23,23,56
2,r_83_39_163,seq73,r_7_118_93,r_7_118_93,0.93,70,163,93,56
14,r_103_55_27,r_91_72_173,r_95_89_4,r_103_55_27,1.0,0,27,27,56
40,r_7_118_93,r_87_70_88,seq126,r_7_118_93,1.0,0,93,93,56
38,r_147_107_184,r_74_8_58,r_36_119_21,r_74_8_58,0.65,127,185,58,56
18,r_9_63_194,r_94_121_147,seq5,r_94_121_147,1.0,0,147,147,56
65,seq26,r_129_99_189,r_75_49_8,r_75_49_8,0.52,182,190,8,56
42,r_51_134_102,r_136_117_59,seq60,r_51_134_102,1.0,2,104,102,56
32,r_139_109_74,seq110,seq41,r_139_109_74,1.0,0,74,74,56
38,r_147_107_184,r_67_93_171,r_74_8_58,r_74_8_58,1.0,113,171,58,56
41,r_2_77_35,r_136_117_59,r_95_89_4,r_136_117_59,0.46,-24,35,59,56
34,r_88_96_130,seq47,r_43_143_95,r_88_96_130,0.99,1,131,130,56
67,seq30,r_91_72_173,r_69_102_50,r_69_102_50,1.0,0,50,50,56
27,r_113_65_185,r_95_89_4,r_103_55_27,r_103_55_27,1.0,1,28,27,56
22,r_130_34_62,r_144_116_187,r_2_77_35,r_144_116_187,0.57,-83,104,187,56
75,seq53,r_0_79_29,r_37_90_17,r_0_79_29,1.0,0,29,29,56
80,seq60,r_43_143_95,seq110,r_43_143_95,0.55,-57,38,95,56
23,r_13_25_172,r_87_70_88,r_67_93_171,r_87_70_88,0.49,84,172,88,56
42,r_51_134_102,seq125,r_136_117_59,r_51_134_102,0.87,-43,59,102,56
6,r_74_8_58,r_9_63_194,seq41,r_74_8_58,1.0,-1,57,58,56
35,r_105_40_138,seq78,r_22_14_105,r_105_40_138,0.98,0,138,138,56
12,r_32_115_157,seq4,r_27_122_3,r_32_115_157,0.49,0,157,157,56
36,r_4_55_189,seq79,r_114_49_96,r_114_49_96,1.0,94,190,96,57
8,r_131_143_73,r_39_28_190,seq103,r_131_143_73,1.0,0,73,73,57
43,r_8_82_127,seq87,r_15_27_83,r_15_27_83,0.73,47,130,83,57
70,seq43,r_8_82_127,r_4_55_189,r_4_55_189,0.53,-177,12,189,57
17,r_48_117_22,seq85,seq44,r_48_117_22,1.0,0,22,22,57
37,r_133_38_92,seq146,seq50,r_133_38_92,0.58,0,92,92,57
14,r_56_22_34,r_3_33_162,r_63_111_142,r_56_22_34,1.0,0,34,34,57
5,r_139_54_198,r_73_126_66,r_105_5_21,r_105_5_21,0.97,1,22,21,57
21,r_18_1_195,r_65_41_85,r_73_126_66,r_18_1_195,0.97,-111,84,195,57
1,r_42_74_116,r_81_35_40,r_9_71_76,r_81_35_40,1.0,76,116,40,57
46,r_61_84_181,r_90_40_19,r_48_117_22,r_61_84_181,0.5,3,184,181,57
42,r_73_126_66,r_139_54_198,r_18_1_195,r_73_126_66,0.97,0,66,66,57
31,r_140_83_29,seq128,r_134_129_137,r_140_83_29,0.89,0,29,29,57
2,r_136_59_16,seq128,seq25,r_136_59_16,0.72,2,18,16,57
24,r_134_129_137,r_140_83_29,r_37_135_64,r_134_129_137,0.99,0,137,137,57
30,r_36_94_80,r_144_86_50,r_16_12_82,r_144_86_50,0.99,0,50,50,57
0,r_141_100_43,seq97,r_90_40_19,r_141_100_43,1.0,0,43,43,57
39,r_3_33_162,r_39_28_190,r_134_129_137,r_39_28_190,0.66,-67,123,190,57
41,r_78_67_187,seq127,r_131_143_73,r_131_143_73,1.0,114,187,73,57
67,seq29,r_91_72_173,r_15_27_83,r_15_27_83,1.0,30,113,83,57
89,seq104,r_93_45_160,r_144_86_50,r_144_86_50,1.0,113,163,50,57
22,r_63_111_142,r_139_54_198,r_56_22_34,r_56_22_34,1.0,0,34,34,57
26,r_39_28_190,seq127,r_144_86_50,r_144_86_50,1.0,140,190,50,57
39,r_3_33_162,r_134_129_137,r_48_117_22,r_3_33_162,0.59,-22,140,162,57
55,seq145,seq17,r_101_64_49,r_101_64_49,1.0,9,58,49,57
14,r_56_22_34,r_63_111_142,r_75_124_102,r_75_124_102,0.53,32,134,102,57
4,r_65_41_85,r_18_1_195,r_105_5_21,r_65_41_85,0.84,0,85,85,57
39,r_3_33_162,r_56_22_34,r_39_28_190,r_3_33_162,0.5,-117,45,162,57
13,r_75_124_102,seq123,r_56_22_34,r_75_124_102,1.0,0,102,102,57
15,r_62_68_69,r_16_12_82,seq76,r_62_68_69,1.0,0,69,69,57
62,seq148,seq106,r_113_19_70,r_113_19_70,0.93,20,90,70,57
11,r_105_5_21,r_101_64_49,r_139_54_198,r_105_5_21,1.0,0,21,21,57
30,r_36_94_80,r_16_12_82,r_139_54_198,r_139_54_198,1.0,-118,80,198,57
99,seq127,r_78_67_187,r_114_49_96,r_114_49_96,1.0,55,151,96,57
3,r_144_86_50,r_36_94_80,seq104,r_144_86_50,0.92,0,50,50,57
27,r_15_27_83,seq52,seq29,r_15_27_83,1.0,0,83,83,57
35,r_101_64_49,r_121_112_117,seq145,r_101_64_49,1.0,0,49,49,57
22,r_63_111_142,r_56_22_34,seq32,r_63_111_142,1.0,0,142,142,57
47,r_77_70_166,r_114_49_96,seq97,r_114_49_96,1.0,0,96,96,57
18,r_93_45_160,seq104,r_15_27_83,r_15_27_83,1.0,80,163,83,57
29,r_114_49_96,r_77_70_166,r_81_35_40,r_114_49_96,0.94,0,96,96,57
25,r_2_6_144,r_26_107_164,r_48_117_22,r_48_117_22,0.51,122,144,22,57
33,r_7_60_184,r_11_47_53,seq103,r_7_60_184,0.7,-98,86,184,57
70,seq43,r_4_55_189,r_118_115_112,r_118_115_112,0.66,5,117,112,57
47,r_77_70_166,seq97,r_114_49_96,r_77_70_166,1.0,0,166,166,57
38,r_26_107_164,r_92_69_128,r_131_143_73,r_26_107_164,0.94,-64,100,164,57
77,seq76,seq85,r_62_68_69,r_62_68_69,1.0,11,80,69,57
34,r_11_47_53,r_7_60_184,seq24,r_7_60_184,0.98,-90,94,184,57
45,r_90_40_19,r_61_84_181,r_141_100_43,r_141_100_43,0.99,141,184,43,57
24,r_134_129_137,seq25,r_140_83_29,r_140_83_29,0.94,4,33,29,57
40,r_110_66_46,seq148,seq23,r_110_66_46,0.67,0,46,46,57
49,r_9_71_76,r_88_20_25,r_42_74_116,r_42_74_116,0.97,0,116,116,57
31,r_140_83_29,r_134_129_137,seq25,r_134_129_137,1.0,0,137,137,57
28,r_92_69_128,r_26_107_164,r_48_117_22,r_92_69_128,0.94,2,130,128,57
49,r_9_71_76,seq123,r_88_20_25,r_9_71_76,0.99,0,76,76,57
7,r_118_115_112,r_91_72_173,seq43,r_118_115_112,0.86,0,112,112,57
44,r_58_138_174,seq123,r_56_22_34,r_58_138_174,0.51,1,175,174,57
39,r_3_33_162,r_48_117_22,seq24,r_3_33_162,0.67,-12,150,162,57
12,r_34_14_68,seq44,seq106,r_34_14_68,1.0,0,68,68,57
45,r_90_40_19,r_75_124_102,r_61_84_181,r_75_124_102,0.52,-84,18,102,57
93,seq107,r_130_29_186,r_61_126_141,r_61_126_141,0.97,9,150,141,58
36,r_40_13_119,seq0,seq52,r_40_13_119,0.96,0,119,119,58
14,r_22_146_184,seq66,r_61_126_141,r_61_126_141,0.56,44,185,141,58
8,r_31_113_145,seq105,r_90_122_109,r_31_113_145,0.9,-2,143,145,58
54,seq145,r_61_126_141,seq114,r_61_126_141,1.0,2,143,141,58
37,r_67_95_194,r_8_101_158,r_149_60_82,r_149_60_82,1.0,76,158,82,58
19,r_84_120_26,seq86,r_144_69_49,r_144_69_49,0.77,119,168,49,58
79,seq77,r_40_13_119,r_89_58_168,r_89_58_168,0.82,9,177,168,58
1,r_10_64_190,r_62_3_117,r_148_133_146,r_62_3_117,0.96,0,117,117,58
5,r_147_14_84,seq100,seq129,r_147_14_84,0.99,0,84,84,58
42,r_36_51_169,seq103,r_57_49_3,r_36_51_169,0.42,0,169,169,58
45,r_99_18_100,r_40_13_119,r_147_14_84,r_99_18_100,0.99,0,100,100,58
89,seq100,r_143_93_182,r_2_38_95,r_2_38_95,0.98,86,181,95,58
30,r_102_28_18,seq80,seq76,r_102_28_18,0.97,1,19,18,58
90,seq103,r_36_51_169,r_48_72_73,r_36_51_169,0.93,1,170,169,58
26,r_90_122_109,r_89_58_168,seq117,r_89_58_168,1.0,-23,145,168,58
76,seq74,r_23_92_68,r_148_133_146,r_148_133_146,0.99,3,149,146,58
4,r_7_123_166,seq91,r_61_126_141,r_7_123_166,0.42,12,178,166,58
21,r_42_11_13,r_132_9_170,r_109_46_192,r_42_11_13,1.0,0,13,13,58
11,r_62_3_117,r_10_64_190,seq71,r_62_3_117,0.98,0,117,117,58
39,r_144_69_49,seq52,r_84_120_26,r_144_69_49,1.0,0,49,49,58
20,r_81_85_53,r_127_6_133,r_147_14_84,r_81_85_53,0.54,80,133,53,58
12,r_106_115_50,r_20_45_110,seq100,r_106_115_50,1.0,0,50,50,58
13,r_127_6_133,r_81_85_53,r_102_28_18,r_127_6_133,0.98,0,133,133,58
15,r_132_9_170,seq16,r_148_133_146,r_148_133_146,0.53,28,174,146,58
48,r_148_133_146,r_10_64_190,seq74,r_148_133_146,0.9,0,146,146,58
3,r_70_73_39,seq83,seq100,r_70_73_39,1.0,0,39,39,58
6,r_20_45_110,r_61_126_141,seq63,r_20_45_110,1.0,0,110,110,58
16,r_27_124_12,seq1,seq16,r_27_124_12,0.88,0,12,12,58
0,r_116_140_35,r_8_101_158,r_149_60_82,r_116_140_35,0.58,123,158,35,58
31,r_96_56_37,r_36_51_169,seq100,r_96_56_37,1.0,0,37,37,58
27,r_138_142_140,seq77,r_10_64_190,r_138_142_140,0.53,0,140,140,58
30,r_102_28_18,seq76,r_127_6_133,r_127_6_133,0.99,12,145,133,58
22,r_48_72_73,r_10_64_190,r_138_142_140,r_138_142_140,0.99,45,185,140,58
69,seq52,seq98,r_40_13_119,r_40_13_119,1.0,1,120,119,58
40,r_97_19_120,seq50,seq114,r_97_19_120,0.99,0,120,120,58
46,r_25_108_31,r_147_14_84,seq78,r_25_108_31,1.0,2,33,31,58
24,r_149_60_82,r_40_13_119,r_116_140_35,r_149_60_82,1.0,0,82,82,58
35,r_130_29_186,seq107,r_40_13_119,r_130_29_186,0.55,0,186,186,58
25,r_89_58_168,r_90_122_109,seq77,r_89_58_168,0.82,0,168,168,58
33,r_24_82_125,seq54,seq32,r_24_82_125,0.99,0,125,125,58
88,seq98,seq17,r_40_13_119,r_40_13_119,0.96,17,136,119,58
50,seq0,r_40_13_119,seq79,r_40_13_119,1.0,0,119,119,58
32,r_121_34_113,r_22_146_184,seq139,r_121_34_113,0.84,0,113,113,58
38,r_37_44_118,r_53_112_116,seq103,r_37_44_118,0.75,0,118,118,58
1,r_10_64_190,r_138_142_140,r_130_29_186,r_10_64_190,0.77,0,190,190,58
47,r_109_46_192,r_136_134_106,r_42_11_13,r_42_11_13,1.0,0,13,13,58
1,r_10_64_190,r_148_133_146,r_138_142_140,r_148_133_146,0.51,0,146,146,58
34,r_23_92_68,r_109_46_192,seq74,r_23_92_68,1.0,0,68,68,58
69,seq52,r_144_69_49,seq98,r_144_69_49,1.0,0,49,49,58
9,r_87_41_30,r_97_19_120,seq80,r_87_41_30,1.0,0,30,30,58
17,r_2_38_95,r_130_29_186,seq100,r_2_38_95,1.0,0,95,95,58
27,r_138_142_140,r_10_64_190,r_48_72_73,r_10_64_190,0.95,-5,185,190,58
82,seq80,r_89_58_168,r_87_41_30,r_87_41_30,0.82,9,39,30,58
28,r_137_65_174,r_89_58_168,r_20_45_110,r_20_45_110,0.97,11,121,110,58
49,r_15_43_98,seq118,seq71,r_15_43_98,0.95,1,99,98,58
7,r_143_93_182,seq100,r_137_65_174,r_137_65_174,0.78,8,182,174,58
19,r_84_120_26,r_89_58_168,seq86,r_84_120_26,1.0,4,30,26,58
0,r_116_140_35,r_138_142_140,r_8_101_158,r_116_140_35,1.0,1,36,35,58
23,r_68_30_81,seq35,r_149_60_82,r_68_30_81,1.0,0,81,81,58
35,r_130_29_186,r_2_38_95,seq107,r_2_38_95,1.0,0,95,95,58
28,r_137_65_174,r_20_45_110,seq145,r_137_65_174,0.98,0,174,174,58
3,r_122_131_167,r_110_27_48,r_49_12_148,r_122_131_167,0.81,-1,166,167,59
30,r_127_133_187,seq42,r_29_58_20,r_29_58_20,0.52,167,187,20,59
92,seq104,r_123_121_151,r_138_17_196,r_123_121_151,0.73,-39,112,151,59
43,r_2_15_107,r_137_102_180,r_81_80_185,r_2_15_107,0.96,2,109,107,59
45,r_124_111_14,r_71_106_44,r_96_23_161,r_124_111_14,0.72,0,14,14,59
18,r_64_5_191,seq28,r_68_41_18,r_68_41_18,0.84,16,34,18,59
15,r_71_106_44,r_81_80_185,r_68_41_18,r_71_106_44,1.0,0,44,44,59
40,r_56_30_47,seq10,r_110_27_48,r_56_30_47,0.95,0,47,47,59
55,seq129,r_137_102_180,r_36_119_23,r_36_119_23,0.84,157,180,23,59
86,seq95,r_13_38_181,r_40_140_99,r_40_140_99,1.0,82,181,99,59
16,r_57_67_132,seq144,seq92,r_57_67_132,0.99,1,133,132,59
1,r_7_75_120,r_35_120_117,seq61,r_7_75_120,0.58,-3,117,120,59
97,seq114,r_59_93_164,r_76_141_29,r_76_141_29,0.52,136,165,29,59
46,r_53_82_178,seq50,r_76_141_29,r_76_141_29,0.61,149,178,29,59
42,r_35_120_117,r_7_75_120,seq18,r_35_120_117,0.92,0,117,117,59
35,r_68_41_18,r_122_131_167,r_64_5_191,r_68_41_18,0.97,0,18,18,59
19,r_137_102_180,seq129,r_60_65_113,r_60_65_113,0.53,67,180,113,59
95,seq108,r_19_73_176,r_60_65_113,r_60_65_113,1.0,64,177,113,59
26,r_109_146_55,seq90,seq20,r_109_146_55,0.91,1,56,55,59
31,r_74_86_92,seq85,r_122_131_167,r_74_86_92,0.98,2,94,92,59
41,r_126_21_93,r_122_131_167,seq20,r_126_21_93,0.97,2,95,93,59
3,r_122_131_167,r_115_63_134,r_110_27_48,r_110_27_48,1.0,89,137,48,59
10,r_115_63_134,r_122_131_167,r_0_8_103,r_0_8_103,0.73,34,137,103,59
32,r_110_27_48,seq113,r_56_30_47,r_110_27_48,1.0,1,49,48,59
8,r_81_80_185,seq18,r_2_15_107,r_2_15_107,1.0,9,116,107,59
0,r_31_149_80,seq25,r_136_84_17,r_31_149_80,0.98,-1,79,80,59
20,r_123_121_151,r_138_17_196,r_40_140_99,r_40_140_99,0.69,52,151,99,59
13,r_19_73_176,seq108,r_35_120_117,r_19_73_176,0.26,4,180,176,59
48,r_77_91_170,seq16,r_76_141_29,r_77_91_170,0.68,1,171,170,59
8,r_81_80_185,r_71_106_44,seq18,r_71_106_44,1.0,1,45,44,59
5,r_96_23_161,r_124_111_14,r_0_8_103,r_96_23_161,0.63,0,161,161,59
27,r_112_89_174,seq105,r_110_27_48,r_110_27_48,0.98,127,175,48,59
47,r_40_140_99,r_122_131_167,r_116_54_68,r_122_131_167,0.8,-68,99,167,59
4,r_36_119_23,seq69,seq129,r_36_119_23,1.0,1,24,23,59
35,r_68_41_18,r_64_5_191,r_0_8_103,r_0_8_103,0.75,72,175,103,59
25,r_60_65_113,seq101,seq108,r_60_65_113,0.99,0,113,113,59
43,r_2_15_107,r_81_80_185,r_19_73_176,r_19_73_176,0.63,5,181,176,59
58,seq139,r_79_14_146,seq94,r_79_14_146,1.0,0,146,146,59
68,seq33,r_116_54_68,r_136_84_17,r_116_54_68,1.0,0,68,68,59
38,r_79_14_146,seq139,r_45_46_4,r_79_14_146,0.98,0,146,146,59
36,r_32_147_31,seq16,r_124_111_14,r_32_147_31,1.0,2,33,31,59
8,r_81_80_185,r_2_15_107,seq6,r_81_80_185,0.78,0,185,185,59
34,r_97_26_143,r_53_82_178,seq113,r_97_26_143,0.69,1,144,143,59
28,r_134_132_53,seq90,r_76_141_29,r_134_132_53,0.99,0,53,53,59
45,r_124_111_14,r_96_23_161,r_32_147_31,r_124_111_14,0.76,142,156,14,59
31,r_74_86_92,r_122_131_167,r_110_27_48,r_74_86_92,0.6,46,138,92,59
81,seq85,r_74_86_92,seq18,r_74_86_92,1.0,0,92,92,59
17,r_24_4_67,seq20,seq129,r_24_4_67,1.0,0,67,67,59
49,r_116_54_68,seq33,seq95,r_116_54_68,1.0,0,68,68,59
7,r_13_38_181,seq95,r_45_46_4,r_13_38_181,0.56,0,181,181,59
44,r_62_11_72,seq90,seq130,r_62_11_72,0.64,1,73,72,59
23,r_49_12_148,r_112_89_174,seq9,r_49_12_148,0.42,4,152,148,59
82,seq87,r_83_51_184,r_76_141_29,r_83_51_184,0.82,0,184,184,59
22,r_29_58_20,r_135_125_198,seq16,r_29_58_20,1.0,0,20,20,59
12,r_52_37_169,r_112_89_174,r_7_75_120,r_7_75_120,0.91,62,182,120,59
6,r_136_84_17,seq90,seq33,r_136_84_17,0.96,2,19,17,59
23,r_49_12_148,seq9,r_122_131_167,r_49_12_148,0.64,33,181,148,59
5,r_96_23_161,r_127_133_187,r_124_111_14,r_124_111_14,0.91,1,15,14,59
93,seq101,r_129_3_107,r_8_55_73,r_8_55_73,1.0,34,107,73,60
30,r_26_68_181,seq88,r_81_87_152,r_81_87_152,0.68,29,181,152,60
51,seq2,r_132_113_184,r_104_25_128,r_104_25_128,0.78,20,148,128,60
36,r_131_145_116,r_31_30_182,seq94,r_131_145_116,0.82,-3,113,116,60
8,r_108_7_77,r_129_3_107,seq148,r_108_7_77,0.97,0,77,77,60
54,seq9,r_81_87_152,r_19_49_21,r_19_49_21,0.66,132,153,21,60
37,r_29_123_119,seq88,seq101,r_29_123_119,0.96,0,119,119,60
59,seq144,seq84,r_115_12_76,r_115_12_76,1.0,3,79,76,60
86,seq142,seq77,r_20_98_121,r_20_98_121,0.56,-27,94,121,60
21,r_78_109_175,r_104_25_128,r_63_47_79,r_78_109_175,0.68,-48,127,175,60
39,r_135_6_109,seq71,seq23,r_135_6_109,1.0,0,109,109,60
97,seq117,r_137_111_180,r_69_83_113,r_69_83_113,1.0,36,149,113,60
14,r_141_147_41,r_60_120_34,seq71,r_141_147_41,0.99,2,43,41,60
5,r_54_128_138,seq4,seq148,r_54_128_138,0.93,0,138,138,60
46,r_115_12_76,r_95_99_104,seq144,r_115_12_76,1.0,0,76,76,60
21,r_78_109_175,r_63_47_79,r_35_149_7,r_78_109_175,0.99,0,175,175,60
19,r_69_83_113,r_34_89_160,seq37,r_69_83_113,1.0,0,113,113,60
20,r_106_16_43,seq84,seq90,r_106_16_43,1.0,0,43,43,60
95,seq110,r_86_44_110,r_72_121_46,r_72_121_46,1.0,18,64,46,60
41,r_8_55_73,r_95_99_104,seq101,r_8_55_73,1.0,0,73,73,60
9,r_60_120_34,r_61_53_129,seq13,r_61_53_129,0.43,-71,58,129,60
47,r_22_138_96,r_19_49_21,seq23,r_19_49_21,0.72,2,23,21,60
3,r_137_111_180,seq56,r_70_64_18,r_70_64_18,0.99,51,69,18,60
10,r_124_0_133,seq5,r_131_145_116,r_124_0_133,0.73,1,134,133,60
32,r_95_99_104,r_15_42_38,r_108_7_77,r_95_99_104,1.0,0,104,104,60
4,r_127_50_130,r_39_114_178,r_104_25_128,r_127_50_130,0.76,0,130,130,60
0,r_104_25_128,r_78_109_175,seq2,r_104_25_128,0.81,-1,127,128,60
13,r_134_24_132,r_81_87_152,r_74_103_102,r_81_87_152,1.0,-19,133,152,60
15,r_61_53_129,r_38_80_193,r_97_65_11,r_61_53_129,0.48,13,142,129,60
6,r_20_98_121,r_61_53_129,seq142,r_20_98_121,0.8,3,124,121,60
62,seq148,r_137_111_180,r_54_128_138,r_54_128_138,1.0,11,149,138,60
43,r_76_18_16,r_69_83_113,r_73_119_3,r_76_18_16,0.92,1,17,16,60
40,r_34_89_160,r_135_6_109,seq92,r_135_6_109,0.42,22,131,109,60
24,r_72_121_46,r_39_114_178,seq110,r_72_121_46,1.0,0,46,46,60
2,r_28_91_85,seq36,seq14,r_28_91_85,1.0,1,86,85,60
40,r_34_89_160,r_69_83_113,r_135_6_109,r_69_83_113,0.6,0,113,113,60
93,seq101,r_8_55_73,r_29_123_119,r_29_123_119,0.99,1,120,119,60
29,r_107_96_15,seq142,seq13,r_107_96_15,0.89,2,17,15,60
25,r_63_47_79,r_129_3_107,r_78_109_175,r_129_3_107,0.87,-24,83,107,60
64,seq27,seq139,r_124_0_133,r_124_0_133,0.88,13,146,133,60
47,r_22_138_96,seq23,r_112_41_5,r_22_138_96,1.0,0,96,96,60
23,r_105_67_10,r_31_30_182,seq146,r_105_67_10,1.0,0,10,10,60
50,seq1,r_10_85_89,seq32,r_10_85_89,1.0,0,89,89,60
40,r_34_89_160,seq92,r_31_30_182,r_34_89_160,0.97,24,184,160,60
68,seq37,r_137_111_180,r_69_83_113,r_69_83_113,1.0,36,149,113,60
32,r_95_99_104,r_8_55_73,r_15_42_38,r_95_99_104,0.84,-31,73,104,60
38,r_86_44_110,seq110,r_63_47_79,r_86_44_110,0.82,2,112,110,60
26,r_15_42_38,r_135_6_109,r_95_99_104,r_15_42_38,1.0,0,38,38,60
22,r_70_64_18,seq139,r_137_111_180,r_70_64_18,1.0,0,18,18,60
79,seq66,seq139,r_140_21_20,r_140_21_20,0.82,33,53,20,60
34,r_97_65_11,r_95_99_104,r_112_41_5,r_97_65_11,0.61,0,11,11,60
33,r_140_21_20,seq5,seq66,r_140_21_20,0.97,-2,18,20,60
17,r_122_62_134,r_31_30_182,seq88,r_122_62_134,0.98,0,134,134,60
25,r_63_47_79,r_78_109_175,r_86_44_110,r_78_109_175,0.71,0,175,175,60
26,r_15_42_38,r_95_99_104,r_129_3_107,r_15_42_38,0.96,66,104,38,60
49,r_10_85_89,seq1,seq14,r_10_85_89,1.0,0,89,89,60
7,r_81_87_152,seq9,r_106_16_43,r_106_16_43,1.0,110,153,43,60
44,r_74_103_102,r_132_113_184,seq88,r_74_103_102,1.0,0,102,102,60
26,r_15_42_38,r_129_3_107,r_125_40_165,r_125_40_165,1.0,2,167,165,60
12,r_31_30_182,seq59,r_34_89_160,r_31_30_182,0.61,1,183,182,60
36,r_101_43_95,r_67_5_130,r_115_15_160,r_101_43_95,1.0,0,95,95,61
6,r_138_90_131,r_23_124_119,r_18_57_55,r_18_57_55,0.94,-3,52,55,61
14,r_61_21_97,r_118_75_197,r_26_56_151,r_61_21_97,0.69,0,97,97,61
8,r_14_49_150,r_54_144_169,r_115_15_160,r_14_49_150,0.98,0,150,150,61
83,seq84,r_39_87_133,r_125_48_80,r_125_48_80,1.0,10,90,80,61
19,r_18_57_55,r_138_90_131,seq134,r_138_90_131,0.96,2,133,131,61
21,r_32_52_163,r_54_144_169,seq145,r_32_52_163,0.68,0,163,163,61
1,r_129_89_109,seq25,seq146,r_129_89_109,1.0,1,110,109,61
97,seq119,seq33,r_103_141_118,r_103_141_118,0.51,-7,111,118,61
46,r_23_124_119,seq134,r_125_48_80,r_125_48_80,1.0,39,119,80,61
35,r_7_104_50,r_34_121_140,seq139,r_7_104_50,1.0,0,50,50,61
45,r_34_121_140,seq36,seq25,r_34_121_140,0.84,1,141,140,61
41,r_122_27_143,seq112,r_111_130_53,r_122_27_143,1.0,0,143,143,61
10,r_103_141_118,r_79_50_124,seq119,r_79_50_124,0.66,-6,118,124,61
26,r_38_11_70,seq100,r_127_41_195,r_38_11_70,0.94,0,70,70,61
4,r_82_136_173,r_125_48_80,r_95_76_64,r_125_48_80,0.69,0,80,80,61
0,r_105_91_114,seq131,r_7_104_50,r_105_91_114,1.0,1,115,114,61
13,r_79_50_124,r_83_28_184,r_138_90_131,r_79_50_124,0.68,14,138,124,61
4,r_82_136_173,r_95_76_64,r_105_91_114,r_95_76_64,0.9,109,173,64,61
12,r_111_130_53,r_45_133_154,r_122_27_143,r_111_130_53,0.88,102,155,53,61
42,r_12_70_19,r_39_87_133,seq149,r_12_70_19,0.79,5,24,19,61
37,r_96_4_42,r_118_75_197,r_137_9_25,r_118_75_197,0.47,-148,49,197,61
2,r_95_76_64,seq30,r_37_99_3,r_95_76_64,0.99,0,64,64,61
40,r_73_97_75,r_61_21_97,seq88,r_61_21_97,1.0,-19,78,97,61
18,r_83_28_184,seq108,r_18_57_55,r_18_57_55,1.0,131,186,55,61
24,r_71_46_102,r_82_136_173,r_113_64_9,r_71_46_102,0.82,3,105,102,61
33,r_31_148_141,seq142,r_105_91_114,r_105_91_114,1.0,28,142,114,61
19,r_18_57_55,seq112,r_138_90_131,r_18_57_55,0.98,1,56,55,61
50,seq128,seq25,r_116_132_106,r_116_132_106,1.0,13,119,106,61
70,seq36,r_34_121_140,seq145,r_34_121_140,0.96,1,141,140,61
6,r_138_90_131,r_18_57_55,r_79_50_124,r_138_90_131,0.98,2,133,131,61
14,r_61_21_97,r_26_56_151,r_0_68_115,r_61_21_97,0.97,18,115,97,61
65,seq24,r_0_68_115,r_113_64_9,r_0_68_115,1.0,-24,91,115,61
32,r_51_59_146,seq146,r_37_99_3,r_51_59_146,0.84,-1,145,146,61
17,r_127_41_195,r_117_69_49,r_38_11_70,r_127_41_195,1.0,-125,70,195,61
43,r_117_69_49,r_127_41_195,seq19,r_117_69_49,1.0,1,50,49,61
9,r_107_2_185,seq149,r_115_15_160,r_115_15_160,0.61,25,185,160,61
96,seq131,r_105_91_114,seq120,r_105_91_114,1.0,1,115,114,61
38,r_81_135_15,r_95_76_64,seq22,r_81_135_15,0.82,0,15,15,61
28,r_53_93_142,r_47_10_191,seq1,r_53_93_142,0.54,0,142,142,61
49,r_26_56_151,seq44,seq112,r_26_56_151,0.98,0,151,151,61
7,r_125_48_80,r_82_136_173,seq84,r_125_48_80,1.0,0,80,80,61
20,r_35_106_51,r_67_5_130,seq80,r_35_106_51,0.97,0,51,51,61
23,r_116_132_106,r_54_144_169,seq128,r_116_132_106,0.99,1,107,106,61
12,r_111_130_53,seq8,r_45_133_154,r_111_130_53,0.72,8,61,53,61
4,r_50_118_22,r_22_115_147,seq138,r_22_115_147,0.73,-125,22,147,62
36,r_72_74_62,r_113_11_154,seq58,r_72_74_62,1.0,0,62,62,62
28,r_33_23_76,r_114_62_30,seq48,r_114_62_30,1.0,2,32,30,62
71,seq46,r_54_104_182,r_117_146_111,r_117_146_111,1.0,74,185,111,62
37,r_82_53_51,r_37_126_106,seq58,r_82_53_51,1.0,0,51,51,62
21,r_117_146_111,r_35_88_101,r_120_122_107,r_120_122_107,1.0,-3,104,107,62
39,r_54_104_182,seq46,r_148_38_65,r_148_38_65,0.83,120,185,65,62
1,r_124_86_97,r_117_146_111,r_9_57_50,r_9_57_50,0.98,13,63,50,62
6,r_84_56_1,r_119_47_167,r_59_16_20,r_84_56_1,0.91,48,49,1,62
33,r_43_93_59,seq132,seq134,r_43_93_59,1.0,0,59,59,62
32,r_30_136_177,seq125,r_28_87_124,r_28_87_124,0.77,0,124,124,62
7,r_4_101_23,r_116_44_196,r_145_68_55,r_145_68_55,1.0,48,103,55,62
45,r_107_61_171,seq10,r_117_146_111,r_117_146_111,1.0,61,172,111,62
14,r_145_68_55,seq141,r_4_101_23,r_145_68_55,1.0,1,56,55,62
47,r_116_44_196,r_13_94_73,r_137_92_31,r_116_44_196,0.9,-168,28,196,62
26,r_24_25_188,r_91_140_178,r_121_106_9,r_24_25_188,0.41,1,189,188,62
65,seq20,seq129,r_81_26_99,r_81_26_99,1.0,6,105,99,62
16,r_9_57_50,seq60,r_124_86_97,r_9_57_50,0.98,1,51,50,62
34,r_135_18_29,seq132,seq125,r_135_18_29,0.97,1,30,29,62
20,r_28_87_124,seq5,r_30_136_177,r_28_87_124,0.99,4,128,124,62
13,r_13_94_73,r_116_44_196,seq17,r_13_94_73,0.99,1,74,73,62
48,r_36_85_116,seq79,r_84_56_1,r_36_85_116,1.0,0,116,116,62
22,r_108_27_11,seq144,seq132,r_108_27_11,0.95,-1,10,11,62
57,seq10,r_107_61_171,r_78_100_169,r_107_61_171,0.97,1,172,171,62
41,r_59_16_20,r_24_25_188,r_84_56_1,r_59_16_20,0.97,0,20,20,62
27,r_105_142_45,r_89_69_187,seq58,r_105_142_45,1.0,1,46,45,62
87,seq79,r_36_85_116,seq7,r_36_85_116,0.99,0,116,116,62
1,r_124_86_97,r_9_57_50,seq70,r_124_86_97,1.0,2,99,97,62
2,r_112_128_185,seq111,r_28_87_124,r_28_87_124,0.94,61,185,124,62
32,r_30_136_177,r_28_87_124,r_21_52_152,r_30_136_177,0.98,0,177,177,62
18,r_113_11_154,seq63,seq125,r_113_11_154,0.66,0,154,154,62
29,r_120_122_107,seq60,r_117_146_111,r_117_146_111,1.0,12,123,111,62
24,r_21_52_152,seq17,seq96,r_21_52_152,0.56,0,152,152,62
25,r_81_26_99,seq134,seq20,r_81_26_99,1.0,0,99,99,62
43,r_137_92_31,r_117_146_111,r_116_44_196,r_137_92_31,0.98,3,34,31,62
61,seq15,seq1,r_114_62_30,r_114_62_30,1.0,26,56,30,62
77,seq138,r_37_126_106,r_50_118_22,r_37_126_106,0.99,-47,59,106,62
65,seq20,r_148_38_65,seq129,r_148_38_65,0.99,-1,64,65,62
16,r_9_57_50,r_124_86_97,r_127_6_193,r_124_86_97,0.99,3,100,97,62
20,r_28_87_124,r_30_136_177,r_45_31_172,r_28_87_124,0.99,53,177,124,62
7,r_4_101_23,r_117_146_111,r_116_44_196,r_4_101_23,0.93,-2,21,23,62
31,r_148_38_65,r_121_106_9,seq111,r_148_38_65,1.0,0,65,65,62
96,seq111,r_112_128_185,r_148_38_65,r_148_38_65,1.0,120,185,65,62
38,r_49_77_49,seq75,r_108_27_11,r_49_77_49,1.0,0,49,49,62
59,seq141,r_145_68_55,seq1,r_145_68_55,1.0,-1,54,55,62
49,r_78_100_169,r_117_146_111,seq10,r_117_146_111,1.0,-7,104,111,62
19,r_114_62_30,r_33_23_76,seq15,r_114_62_30,1.0,0,30,30,62
44,r_37_126_106,r_103_2_80,r_43_93_59,r_37_126_106,1.0,0,106,106,62
28,r_33_23_76,seq48,seq17,r_33_23_76,1.0,0,76,76,62
23,r_67_8_161,r_39_40_184,r_105_142_45,r_39_40_184,0.63,-23,161,184,62
8,r_121_106_9,r_148_38_65,seq20,r_148_38_65,1.0,0,65,65,62
30,r_70_126_153,seq105,r_8_19_140,r_70_126_153,0.79,0,153,153,63
36,r_6_148_65,r_89_130_178,seq81,r_6_148_65,1.0,1,66,65,63
92,seq104,seq47,r_106_109_73,r_106_109_73,1.0,4,77,73,63
43,r_107_52_142,r_39_96_138,seq46,r_39_96_138,0.42,2,140,138,63
37,r_106_109_73,r_63_94_122,seq104,r_106_109_73,1.0,0,73,73,63
53,seq136,r_120_141_37,r_147_68_30,r_120_141_37,0.99,-1,36,37,63
16,r_90_50_170,seq149,r_55_21_51,r_55_21_51,0.71,119,170,51,63
39,r_60_7_116,seq110,r_55_21_51,r_60_7_116,0.92,1,117,116,63
1,r_57_108_126,seq67,seq88,r_57_108_126,0.97,1,127,126,63
5,r_28_144_188,r_22_49_139,r_39_96_138,r_22_49_139,0.82,0,139,139,63
80,seq72,r_118_142_164,seq125,r_118_142_164,0.77,-6,158,164,63
19,r_39_96_138,r_107_52_142,r_132_111_114,r_39_96_138,0.72,0,138,138,63
8,r_100_143_59,r_89_130_178,seq116,r_100_143_59,1.0,0,59,59,63
77,seq64,r_24_113_199,r_77_95_135,r_77_95_135,0.96,35,170,135,63
38,r_115_112_34,r_75_103_197,r_147_68_30,r_115_112_34,1.0,1,35,34,63
11,r_37_93_12,r_118_142_164,seq73,r_37_93_12,0.98,1,13,12,63
31,r_4_146_69,seq138,r_147_68_30,r_4_146_69,0.71,1,70,69,63
41,r_22_49_139,r_28_144_188,r_3_66_28,r_22_49_139,0.76,0,139,139,63
81,seq73,r_36_145_72,r_37_93_12,r_37_93_12,0.59,0,12,12,63
89,seq98,r_91_41_109,r_37_93_12,r_91_41_109,0.65,0,109,109,63
3,r_89_130_178,r_92_74_5,r_118_142_164,r_89_130_178,0.28,2,180,178,63
10,r_133_32_161,r_48_61_184,r_137_5_132,r_133_32_161,0.59,1,162,161,63
23,r_91_41_109,r_107_52_142,r_17_29_143,r_107_52_142,0.46,1,143,142,63
48,r_120_141_37,r_77_95_135,r_0_14_50,r_0_14_50,0.52,1,51,50,63
15,r_27_80_17,r_8_19_140,seq23,r_27_80_17,0.82,2,19,17,63
12,r_55_21_51,seq123,seq138,r_55_21_51,0.93,0,51,51,63
4,r_79_127_95,r_132_111_114,seq12,r_79_127_95,0.93,0,95,95,63
73,seq56,r_24_113_199,r_139_44_61,r_139_44_61,1.0,40,101,61,63
7,r_132_111_114,r_28_144_188,r_39_96_138,r_28_144_188,0.58,-23,165,188,63
20,r_137_5_132,r_28_144_188,r_37_93_12,r_137_5_132,0.86,6,138,132,63
13,r_77_95_135,r_17_29_143,seq64,r_77_95_135,0.67,1,136,135,63
5,r_28_144_188,r_39_96_138,r_100_143_59,r_28_144_188,0.98,0,188,188,63
48,r_120_141_37,seq136,r_77_95_135,r_120_141_37,0.87,0,37,37,63
27,r_59_134_92,seq64,seq88,r_59_134_92,0.99,4,96,92,63
87,seq88,seq30,r_59_134_92,r_59_134_92,1.0,9,101,92,63
17,r_3_66_28,r_132_111_114,r_89_130_178,r_132_111_114,0.63,-86,28,114,63
23,r_91_41_109,r_17_29_143,r_132_111_114,r_132_111_114,0.56,68,182,114,63
2,r_8_19_140,r_38_82_193,r_119_124_85,r_38_82_193,0.88,-51,142,193,63
47,r_139_44_61,seq30,seq56,r_139_44_61,1.0,2,63,61,63
18,r_69_128_97,r_132_111_114,r_35_85_192,r_69_128_97,0.96,3,100,97,63
24,r_17_29_143,r_77_95_135,seq131,r_77_95_135,0.89,1,136,135,63
64,seq31,r_86_9_131,r_39_96_138,r_86_9_131,0.82,7,138,131,63
32,r_71_101_113,r_28_144_188,r_63_94_122,r_71_101_113,0.94,1,114,113,63
52,seq131,r_36_145_72,r_17_29_143,r_36_145_72,1.0,1,73,72,63
77,seq64,r_59_134_92,r_24_113_199,r_59_134_92,1.0,10,102,92,63
21,r_0_14_50,seq25,r_120_141_37,r_0_14_50,0.88,1,51,50,63
34,r_122_121_147,seq83,r_36_145_72,r_122_121_147,0.91,1,148,147,63
70,seq47,seq18,r_135_26_32,r_135_26_32,0.94,17,49,32,63
38,r_115_112_34,r_147_68_30,r_36_145_72,r_36_145_72,0.98,18,90,72,63
94,seq110,r_60_7_116,r_27_80_17,r_60_7_116,0.49,7,123,116,63
9,r_36_145_72,seq131,r_115_112_34,r_36_145_72,1.0,1,73,72,63
14,r_135_26_32,r_118_142_164,seq47,r_135_26_32,1.0,0,32,32,63
28,r_92_74_5,r_89_130_178,r_139_44_61,r_139_44_61,0.87,119,180,61,63
49,r_119_124_85,r_24_113_199,seq13,r_119_124_85,0.99,1,86,85,63
56,seq12,r_89_130_178,r_79_127_95,r_79_127_95,0.53,0,95,95,63
7,r_132_111_114,seq98,r_28_144_188,r_132_111_114,0.87,4,118,114,63
44,r_38_82_193,r_8_19_140,seq11,r_8_19_140,0.94,6,146,140,63
17,r_3_66_28,r_89_130_178,r_22_49_139,r_22_49_139,0.68,1,140,139,63
22,r_42_15_23,seq110,r_24_113_199,r_42_15_23,0.99,0,23,23,63
79,seq67,r_57_108_126,seq129,r_57_108_126,1.0,1,127,126,63
35,r_86_9_131,seq31,r_37_93_12,r_86_9_131,0.63,0,131,131,63
12,r_84_103_57,seq56,r_4_78_134,r_84_103_57,1.0,0,57,57,64
14,r_134_34_161,r_37_93_185,r_146_50_59,r_146_50_59,0.88,102,161,59,64
8,r_112_6_104,r_99_14_162,r_148_113_80,r_112_6_104,0.84,0,104,104,64
53,seq9,r_39_126_172,r_32_96_47,r_32_96_47,0.91,20,67,47,64
18,r_15_91_15,r_84_103_57,seq49,r_15_91_15,0.63,1,16,15,64
31,r_142_95_114,r_111_104_8,r_124_100_43,r_142_95_114,1.0,1,115,114,64
3,r_26_5_26,r_134_34_161,seq105,r_26_5_26,1.0,0,26,26,64
55,seq140,seq19,r_42_149_101,r_42_149_101,1.0,9,110,101,64
16,r_92_133_63,seq115,r_58_17_120,r_92_133_63,1.0,1,64,63,64
21,r_145_40_139,seq125,seq51,r_145_40_139,0.54,0,139,139,64
39,r_62_136_124,r_41_90_190,seq54,r_62_136_124,0.9,0,124,124,64
1,r_76_3_171,r_25_67_29,r_42_149_101,r_76_3_171,0.43,0,171,171,64
32,r_48_81_16,r_110_71_73,seq61,r_48_81_16,0.9,0,16,16,64
46,r_101_97_68,seq47,seq28,r_101_97_68,1.0,2,70,68,64
42,r_41_90_190,r_62_136_124,r_32_96_47,r_41_90_190,0.99,-66,124,190,64
45,r_29_63_97,r_86_132_135,r_84_103_57,r_29_63_97,1.0,0,97,97,64
19,r_148_113_80,r_142_95_114,seq45,r_148_113_80,0.98,0,80,80,64
66,seq46,r_37_93_185,r_42_149_101,r_42_149_101,1.0,86,187,101,64
31,r_142_95_114,r_148_113_80,r_111_104_8,r_148_113_80,0.7,0,80,80,64
10,r_143_116_92,r_29_63_97,seq106,r_29_63_97,1.0,-3,94,97,64
41,r_8_44_55,seq45,seq115,r_8_44_55,0.96,1,56,55,64
0,r_110_71_73,seq11,seq28,r_110_71_73,0.58,3,76,73,64
11,r_98_52_100,seq139,r_60_74_41,r_98_52_100,1.0,0,100,100,64
13,r_66_123_94,seq115,seq105,r_66_123_94,1.0,0,94,94,64
15,r_111_104_8,r_142_95_114,r_22_79_132,r_142_95_114,0.8,1,115,114,64
48,r_0_13_188,seq51,r_110_71_73,r_0_13_188,0.48,0,188,188,64
57,seq18,r_20_85_64,seq7,r_20_85_64,1.0,0,64,64,64
12,r_84_103_57,r_4_78_134,r_29_63_97,r_84_103_57,1.0,81,138,57,64
6,r_144_30_173,seq43,r_58_17_120,r_144_30_173,0.74,1,174,173,64
20,r_4_78_134,r_111_104_8,r_84_103_57,r_4_78_134,0.85,-76,58,134,64
33,r_58_17_120,r_92_133_63,r_23_128_67,r_58_17_120,1.0,3,123,120,64
27,r_99_14_162,seq70,r_110_71_73,r_99_14_162,0.68,0,162,162,64
2,r_88_120_126,r_76_3_171,r_124_100_43,r_76_3_171,1.0,-45,126,171,64
47,r_42_149_101,seq75,seq140,r_42_149_101,1.0,0,101,101,64
4,r_32_96_47,r_148_113_80,seq9,r_32_96_47,0.99,0,47,47,64
29,r_24_138_119,seq147,seq33,r_24_138_119,0.86,-1,118,119,64
24,r_86_132_135,seq137,r_8_44_55,r_86_132_135,1.0,0,135,135,64
43,r_36_129_32,r_4_78_134,seq56,r_36_129_32,1.0,2,34,32,64
33,r_58_17_120,r_42_149_101,r_92_133_63,r_92_133_63,1.0,3,66,63,64
38,r_117_31_181,r_0_13_188,r_76_3_171,r_0_13_188,0.29,-7,181,188,64
52,seq7,r_39_126_172,r_32_96_47,r_32_96_47,0.97,127,174,47,64
34,r_22_79_132,seq61,r_111_104_8,r_22_79_132,0.59,1,133,132,64
26,r_21_121_24,seq109,seq75,r_21_121_24,1.0,0,24,24,64
20,r_4_78_134,r_84_103_57,seq109,r_4_78_134,1.0,0,134,134,64
19,r_148_113_80,seq45,r_112_6_104,r_112_6_104,1.0,20,124,104,64
16,r_92_133_63,r_58_17_120,r_124_100_43,r_58_17_120,0.79,3,123,120,64
17,r_37_93_185,r_134_34_161,seq46,r_134_34_161,1.0,0,161,161,64
20,r_4_78_134,r_36_129_32,r_111_104_8,r_4_78_134,0.9,-100,34,134,64
94,seq109,r_76_3_171,r_4_78_134,r_4_78_134,0.73,2,136,134,64
9,r_10_94_93,r_29_63_97,r_110_71_73,r_10_94_93,1.0,0,93,93,64
23,r_146_50_59,r_10_94_93,r_21_121_24,r_146_50_59,0.95,0,59,59,64
22,r_107_87_99,seq147,r_146_50_59,r_107_87_99,1.0,0,99,99,64
28,r_20_85_64,seq18,seq64,r_20_85_64,1.0,0,64,64,64
7,r_80_119_143,seq49,r_10_94_93,r_80_119_143,0.75,0,143,143,64
35,r_60_74_41,r_99_14_162,r_98_52_100,r_98_52_100,0.9,37,137,100,64
13,r_130_59_24,r_44_127_142,seq41,r_130_59_24,1.0,0,24,24,65
14,r_125_22_177,seq105,r_53_138_72,r_125_22_177,0.71,0,177,177,65
22,r_48_97_127,r_47_117_18,r_23_104_194,r_48_97_127,1.0,0,127,127,65
59,seq14,seq129,r_148_146_82,r_148_146_82,0.59,7,89,82,65
1,r_44_127_142,seq129,r_107_149_73,r_107_149_73,1.0,71,144,73,65
97,seq115,seq145,r_94_75_81,r_94_75_81,1.0,8,89,81,65
42,r_70_58_95,r_48_97_127,seq9,r_70_58_95,1.0,0,95,95,65
27,r_49_82_22,r_103_106_107,r_26_62_10,r_49_82_22,1.0,1,23,22,65
19,r_65_109_74,seq14,r_103_106_107,r_65_109_74,0.57,51,125,74,65
7,r_67_32_130,r_111_30_39,r_53_138_72,r_67_32_130,1.0,0,130,130,65
37,r_25_43_41,r_42_133_43,r_39_87_17,r_42_133_43,0.96,-2,41,43,65
30,r_0_56_59,r_63_74_136,seq4,r_0_56_59,1.0,0,59,59,65
95,seq105,r_125_22_177,r_94_75_81,r_94_75_81,1.0,96,177,81,65
73,seq41,seq40,r_130_59_24,r_130_59_24,1.0,32,56,24,65
31,r_132_88_161,seq135,seq141,r_132_88_161,0.75,0,161,161,65
10,r_3_68_163,seq113,seq102,r_3_68_163,0.73,0,163,163,65
16,r_77_134_189,r_136_114_28,r_70_58_95,r_77_134_189,0.37,0,189,189,65
5,r_47_117_18,r_65_109_74,r_70_58_95,r_47_117_18,0.85,-1,17,18,65
41,r_121_73_102,seq15,r_100_118_47,r_100_118_47,1.0,9,56,47,65
4,r_53_138_72,r_140_137_152,r_25_43_41,r_53_138_72,1.0,0,72,72,65
11,r_94_75_81,seq139,seq115,r_94_75_81,1.0,0,81,81,65
15,r_100_118_47,r_121_73_102,seq15,r_121_73_102,1.0,0,102,102,65
44,r_21_34_56,seq1,seq124,r_21_34_56,1.0,0,56,56,65
56,seq139,r_25_43_41,r_50_112_118,r_50_112_118,1.0,10,128,118,65
46,r_140_137_152,r_98_19_8,seq13,r_140_137_152,0.82,-2,150,152,65
48,r_17_11_103,r_7_38_125,r_148_146_82,r_148_146_82,0.56,21,103,82,65
16,r_77_134_189,seq55,r_136_114_28,r_136_114_28,1.0,4,32,28,65
8,r_26_62_10,seq15,r_49_82_22,r_49_82_22,1.0,0,22,22,65
75,seq45,r_10_24_150,r_7_38_125,r_7_38_125,1.0,12,137,125,65
99,seq124,seq9,r_21_34_56,r_21_34_56,1.0,26,82,56,65
5,r_47_117_18,r_70_58_95,r_10_24_150,r_70_58_95,1.0,0,95,95,65
0,r_39_87_17,r_94_75_81,r_25_43_41,r_94_75_81,0.88,-21,60,81,65
6,r_116_95_27,r_44_127_142,r_26_62_10,r_116_95_27,1.0,1,28,27,65
36,r_23_104_194,r_18_144_34,r_48_97_127,r_48_97_127,0.93,0,127,127,65
3,r_111_30_39,r_21_34_56,seq86,r_21_34_56,0.98,-11,45,56,65
40,r_122_64_80,r_7_38_125,r_107_149_73,r_7_38_125,0.77,-44,81,125,65
18,r_46_108_78,r_132_88_161,r_26_62_10,r_46_108_78,1.0,0,78,78,65
29,r_90_8_98,seq147,r_94_75_81,r_94_75_81,1.0,19,100,81,65
36,r_23_104_194,r_25_43_41,r_18_144_34,r_23_104_194,0.87,-160,34,194,65
24,r_83_76_111,seq105,r_47_117_18,r_83_76_111,1.0,0,111,111,65
26,r_136_114_28,r_126_27_191,r_77_134_189,r_136_114_28,1.0,0,28,28,65
25,r_107_149_73,seq31,seq33,r_107_149_73,1.0,0,73,73,65
43,r_18_144_34,r_48_97_127,r_23_104_194,r_18_144_34,1.0,0,34,34,65
43,r_18_144_34,r_23_104_194,r_89_84_155,r_89_84_155,0.93,17,172,155,65
0,r_39_87_17,r_25_43_41,r_94_75_81,r_94_75_81,0.71,-62,19,81,65
20,r_98_19_8,r_140_137_152,r_7_38_125,r_7_38_125,0.88,26,151,125,65
32,r_89_84_155,r_91_131_157,r_48_97_127,r_48_97_127,0.94,28,155,127,65
77,seq55,r_77_134_189,r_136_114_28,r_136_114_28,1.0,43,71,28,65
34,r_148_146_82,seq45,seq128,r_148_146_82,0.53,1,83,82,65
49,r_16_60_21,r_142_110_37,seq29,r_16_60_21,1.0,0,21,21,65
51,seq1,r_21_34_56,r_26_62_10,r_21_34_56,1.0,0,56,56,65
15,r_100_118_47,r_25_43_41,r_121_73_102,r_100_118_47,0.97,0,47,47,65
45,r_63_74_136,seq129,r_39_87_17,r_63_74_136,1.0,1,137,136,65
9,r_103_106_107,seq29,r_65_109_74,r_103_106_107,0.94,2,109,107,65
26,r_136_114_28,r_77_134_189,seq55,r_136_114_28,0.42,161,189,28,65
96,seq113,r_3_68_163,r_142_110_37,r_3_68_163,0.98,-29,134,163,65
22,r_48_97_127,r_70_58_95,r_47_117_18,r_70_58_95,0.87,0,95,95,65
2,r_143_54_55,r_46_108_78,seq57,r_143_54_55,0.94,0,55,55,65
45,r_63_74_136,r_0_56_59,seq129,r_0_56_59,1.0,0,59,59,65
7,r_67_32_130,r_121_73_102,r_111_30_39,r_67_32_130,0.46,-61,69,130,65
23,r_50_112_118,seq128,seq139,r_50_112_118,1.0,0,118,118,65
47,r_42_133_43,r_25_43_41,seq79,r_42_133_43,1.0,0,43,43,65
35,r_7_38_125,r_26_62_10,seq45,r_7_38_125,1.0,0,125,125,65
12,r_51_119_112,seq13,r_142_110_37,r_51_119_112,1.0,0,112,112,65
41,r_121_73_102,r_100_118_47,seq115,r_121_73_102,1.0,0,102,102,65
9,r_45_52_59,r_55_67_156,seq130,r_55_67_156,1.0,0,156,156,66
14,r_0_120_82,r_136_117_41,r_90_77_63,r_0_120_82,0.51,-22,60,82,66
93,seq109,r_35_100_46,r_2_132_112,r_2_132_112,1.0,9,121,112,66
43,r_2_132_112,seq5,seq109,r_2_132_112,0.98,0,112,112,66
27,r_90_77_63,r_0_120_82,r_96_83_99,r_0_120_82,0.91,0,82,82,66
37,r_75_33_111,r_14_18_143,r_74_51_72,r_75_33_111,1.0,4,115,111,66
59,seq13,seq22,r_19_16_76,r_19_16_76,1.0,0,76,76,66
39,r_99_6_125,seq5,seq110,r_99_6_125,1.0,0,125,125,66
1,r_122_93_160,seq22,r_12_128_124,r_122_93_160,0.6,0,160,160,66
80,seq139,r_119_42_39,r_12_128_124,r_12_128_124,0.92,4,128,124,66
46,r_79_89_138,seq94,r_74_51_72,r_79_89_138,0.95,1,139,138,66
42,r_19_16_76,r_3_87_113,seq13,r_19_16_76,0.98,0,76,76,66
16,r_121_103_13,r_73_144_101,seq104,r_121_103_13,0.92,0,13,13,66
32,r_55_67_156,r_45_52_59,seq85,r_55_67_156,0.68,0,156,156,66
45,r_48_84_78,r_31_91_4,r_74_51_72,r_48_84_78,1.0,3,81,78,66
30,r_36_30_108,seq142,r_136_117_41,r_136_117_41,0.84,3,44,41,66
24,r_31_91_4,r_48_84_78,seq46,r_48_84_78,1.0,4,82,78,66
19,r_97_135_95,r_88_56_145,r_74_51_72,r_97_135_95,0.66,0,95,95,66
31,r_88_56_145,seq80,r_114_26_116,r_88_56_145,0.6,0,145,145,66
72,seq38,r_29_9_166,r_43_113_142,r_43_113_142,0.61,21,163,142,66
4,r_10_66_180,seq130,r_118_15_23,r_118_15_23,0.88,155,178,23,66
71,seq34,r_149_37_31,r_27_111_75,r_27_111_75,0.5,-15,60,75,66
15,r_116_112_132,seq1,seq80,r_116_112_132,0.89,0,132,132,66
6,r_76_108_90,r_39_49_119,r_136_117_41,r_39_49_119,0.94,-29,90,119,66
62,seq17,r_81_57_188,r_27_111_75,r_27_111_75,1.0,50,125,75,66
63,seq146,seq23,r_62_101_30,r_62_101_30,0.68,0,30,30,66
27,r_90_77_63,seq139,r_0_120_82,r_90_77_63,0.69,1,64,63,66
14,r_0_120_82,r_90_77_63,seq127,r_0_120_82,0.99,0,82,82,66
30,r_36_30_108,r_136_117_41,r_74_51_72,r_74_51_72,0.59,37,109,72,66
26,r_41_129_16,seq110,seq130,r_41_129_16,0.64,-1,15,16,66
2,r_14_18_143,r_75_33_111,r_2_132_112,r_14_18_143,0.94,-11,132,143,66
40,r_115_86_131,seq47,r_25_20_91,r_115_86_131,0.53,1,132,131,66
18,r_27_111_75,r_3_87_113,seq17,r_27_111_75,0.99,1,76,75,66
35,r_136_117_41,r_36_30_108,r_76_108_90,r_136_117_41,0.9,68,109,41,66
25,r_59_71_176,r_95_72_173,r_97_135_95,r_97_135_95,0.59,83,178,95,66
33,r_141_53_64,seq109,seq21,r_141_53_64,1.0,0,64,64,66
32,r_55_67_156,seq24,r_45_52_59,r_45_52_59,0.97,3,62,59,66
3,r_149_37_31,r_141_53_64,seq140,r_149_37_31,1.0,0,31,31,66
35,r_136_117_41,r_0_120_82,r_36_30_108,r_136_117_41,0.61,0,41,41,66
60,seq142,r_36_30_108,r_114_26_116,r_36_30_108,0.91,2,110,108,66
38,r_118_15_23,r_14_18_143,seq148,r_118_15_23,1.0,0,23,23,66
81,seq68,r_133_44_187,r_25_20_91,r_25_20_91,0.99,38,129,91,66
17,r_73_144_101,seq23,seq134,r_73_144_101,0.95,1,102,101,66
9,r_45_52_59,seq148,r_55_67_156,r_45_52_59,0.99,1,60,59,66
22,r_3_87_113,r_133_44_187,r_97_135_95,r_3_87_113,0.97,6,119,113,66
28,r_25_20_91,r_97_135_95,seq68,r_25_20_91,0.66,0,91,91,66
47,r_119_42_39,r_14_18_143,seq82,r_14_18_143,0.91,-99,44,143,66
44,r_54_102_118,r_122_93_160,r_74_51_72,r_122_93_160,0.8,-42,118,160,66
23,r_60_4_164,seq148,r_14_18_143,r_14_18_143,0.6,16,159,143,66
12,r_95_72_173,r_59_71_176,r_122_93_160,r_122_93_160,0.72,18,178,160,66
30,r_54_87_168,seq37,r_3_83_24,r_3_83_24,0.71,144,168,24,67
36,r_148_86_83,r_121_105_127,r_127_141_71,r_127_141_71,1.0,5,76,71,67
23,r_0_115_28,seq1,seq131,r_0_115_28,1.0,0,28,28,67
53,seq5,r_32_104_156,r_121_105_127,r_32_104_156,0.97,0,156,156,67
8,r_96_103_31,seq132,seq70,r_96_103_31,1.0,0,31,31,67
28,r_3_83_24,r_50_60_183,seq71,r_3_83_24,0.81,-3,21,24,67
37,r_75_57_159,r_62_123_188,r_122_136_11,r_75_57_159,0.92,0,159,159,67
59,seq12,r_17_31_138,r_93_40_57,r_93_40_57,0.79,85,142,57,67
71,seq42,r_68_19_79,seq76,r_68_19_79,0.96,0,79,79,67
16,r_108_28_63,seq97,seq18,r_108_28_63,0.91,0,63,63,67
21,r_50_60_183,seq44,r_111_15_25,r_111_15_25,0.74,158,183,25,67
39,r_9_26_35,seq78,r_20_72_69,r_20_72_69,1.0,16,85,69,67
5,r_106_35_119,seq132,r_79_47_88,r_106_35_119,0.97,0,119,119,67
46,r_127_141_71,r_69_27_111,r_148_86_83,r_148_86_83,1.0,-12,71,83,67
42,r_46_49_54,r_121_105_127,r_135_100_98,r_46_49_54,1.0,1,55,54,67
19,r_20_72_69,r_62_123_188,r_9_26_35,r_20_72_69,1.0,0,69,69,67
38,r_130_101_169,r_118_7_103,r_122_136_11,r_130_101_169,0.96,2,171,169,67
41,r_77_109_162,seq16,seq37,r_77_109_162,0.82,0,162,162,67
14,r_30_129_22,r_111_15_25,seq144,r_30_129_22,0.93,0,22,22,67
20,r_33_82_14,seq133,r_2_73_185,r_33_82_14,0.88,2,16,14,67
3,r_43_52_67,seq144,seq10,r_43_52_67,1.0,3,70,67,67
10,r_79_47_88,r_110_80_184,r_2_73_185,r_79_47_88,1.0,0,88,88,67
26,r_118_7_103,r_145_128_148,r_130_101_169,r_118_7_103,0.95,-1,102,103,67
72,seq44,r_50_60_183,r_110_80_184,r_110_80_184,0.84,1,185,184,67
16,r_108_28_63,seq18,r_88_4_137,r_88_4_137,1.0,5,142,137,67
12,r_122_136_11,r_89_147_110,seq25,r_122_136_11,1.0,0,11,11,67
78,seq59,r_92_21_131,r_14_112_80,r_14_112_80,1.0,52,132,80,67
11,r_88_4_137,seq16,r_108_28_63,r_88_4_137,0.83,0,137,137,67
13,r_92_21_131,seq59,r_20_72_69,r_20_72_69,0.69,63,132,69,67
48,r_135_100_98,r_145_128_148,r_46_49_54,r_46_49_54,1.0,44,98,54,67
6,r_94_13_135,seq1,r_34_114_122,r_94_13_135,0.98,0,135,135,67
62,seq16,r_77_109_162,seq53,r_77_109_162,1.0,0,162,162,67
15,r_66_64_45,r_46_49_54,r_107_91_6,r_66_64_45,1.0,0,45,45,67
0,r_48_99_30,r_43_52_67,seq1,r_43_52_67,0.96,-33,34,67,67
10,r_79_47_88,r_2_73_185,r_106_35_119,r_106_35_119,0.84,54,173,119,67
27,r_89_147_110,seq18,seq149,r_89_147_110,0.98,0,110,110,67
2,r_6_119_157,seq16,r_0_115_28,r_6_119_157,0.95,1,158,157,67
47,r_113_45_124,seq16,r_108_28_63,r_113_45_124,0.96,0,124,124,67
40,r_56_63_102,r_50_60_183,seq142,r_56_63_102,0.98,0,102,102,67
25,r_14_112_80,seq131,seq59,r_14_112_80,1.0,1,81,80,67
65,seq23,r_75_57_159,seq74,r_75_57_159,0.75,0,159,159,67
20,r_33_82_14,r_2_73_185,seq78,r_2_73_185,0.48,-43,142,185,67
61,seq143,r_17_31_138,r_93_40_57,r_93_40_57,0.66,5,62,57,67
32,r_62_123_188,seq23,r_6_119_157,r_6_119_157,0.91,31,188,157,67
38,r_130_101_169,seq98,r_118_7_103,r_118_7_103,1.0,5,108,103,67
34,r_2_73_185,seq25,r_14_112_80,r_14_112_80,0.99,106,186,80,67
84,seq74,r_75_57_159,r_111_15_25,r_111_15_25,0.92,11,36,25,67
17,r_84_39_92,seq18,r_30_129_22,r_30_129_22,0.98,76,98,22,67
26,r_118_7_103,r_130_101_169,seq98,r_130_101_169,0.99,2,171,169,67
22,r_41_67_154,seq37,seq12,r_41_67_154,0.95,0,154,154,67
1,r_93_40_57,r_2_73_185,seq143,r_93_40_57,1.0,0,57,57,67
18,r_111_15_25,r_14_112_80,seq74,r_111_15_25,0.99,0,25,25,67
49,r_117_22_181,seq76,seq137,r_117_22_181,0.52,0,181,181,67
56,seq137,seq144,r_117_22_181,r_117_22_181,0.93,3,184,181,67
7,r_32_104_156,seq5,r_94_13_135,r_32_104_156,0.92,0,156,156,67
44,r_17_31_138,r_107_91_6,seq59,r_17_31_138,0.95,4,142,138,67
35,r_68_19_79,seq42,seq37,r_68_19_79,1.0,0,79,79,67
30,r_71_87_154,r_23_125_195,seq4,r_23_125_195,0.6,-39,156,195,68
4,r_13_61_11,seq140,seq134,r_13_61_11,0.97,2,13,11,68
31,r_65_98_38,r_110_27_33,seq86,r_65_98_38,1.0,1,39,38,68
36,r_107_16_60,r_34_91_141,seq7,r_107_16_60,0.99,1,61,60,68
9,r_42_5_99,seq7,r_34_91_141,r_34_91_141,0.99,21,162,141,68
92,seq104,seq20,r_102_137_31,r_102_137_31,1.0,45,76,31,68
14,r_79_77_165,seq142,r_51_12_96,r_51_12_96,1.0,8,104,96,68
8,r_55_35_90,seq132,r_50_46_73,r_55_35_90,0.56,2,92,90,68
53,seq7,r_97_54_160,r_107_16_60,r_107_16_60,1.0,101,161,60,68
43,r_143_117_177,seq31,r_71_87_154,r_143_117_177,0.67,0,177,177,68
20,r_64_18_39,seq78,seq140,r_64_18_39,0.85,0,39,39,68
88,seq96,r_95_136_16,r_131_11_29,r_95_136_16,0.9,0,16,16,68
59,seq19,r_100_41_127,seq24,r_100_41_127,0.83,0,127,127,68
86,seq86,r_53_88_188,r_65_98_38,r_65_98_38,0.99,27,65,38,68
16,r_22_93_163,r_14_6_119,r_9_76_182,r_14_6_119,1.0,4,123,119,68
39,r_8_85_102,r_29_139_158,seq124,r_8_85_102,0.77,1,103,102,68
28,r_131_11_29,r_23_125_195,r_112_60_21,r_131_11_29,0.95,7,36,29,68
5,r_69_106_17,seq40,r_70_122_48,r_70_122_48,1.0,97,145,48,68
46,r_145_111_185,seq142,r_10_83_135,r_10_83_135,0.62,50,185,135,68
48,r_110_27_33,r_65_98_38,seq17,r_65_98_38,1.0,-2,36,38,68
21,r_102_137_31,r_55_35_90,seq104,r_102_137_31,1.0,0,31,31,68
47,r_97_54_160,r_64_18_39,r_79_77_165,r_97_54_160,0.66,21,181,160,68
67,seq33,r_21_90_162,r_89_114_138,r_89_114_138,1.0,26,164,138,68
34,r_2_66_35,r_51_12_96,seq78,r_51_12_96,0.99,-57,39,96,68
3,r_126_115_170,seq109,seq37,r_126_115_170,0.81,1,171,170,68
10,r_29_139_158,r_30_92_198,r_129_133_23,r_29_139_158,0.91,-81,77,158,68
14,r_79_77_165,r_51_12_96,r_97_54_160,r_51_12_96,0.73,70,166,96,68
0,r_51_12_96,seq103,r_79_77_165,r_51_12_96,1.0,1,97,96,68
13,r_36_141_130,r_45_0_184,r_102_137_31,r_45_0_184,0.84,-54,130,184,68
98,seq124,r_10_83_135,r_8_85_102,r_8_85_102,0.94,36,138,102,68
15,r_45_0_184,r_36_141_130,seq103,r_36_141_130,1.0,0,130,130,68
23,r_119_128_24,r_89_114_138,r_110_27_33,r_119_128_24,0.99,0,24,24,68
57,seq144,r_34_91_141,seq140,r_34_91_141,0.98,0,141,141,68
19,r_39_146_18,r_29_139_158,seq68,r_39_146_18,0.62,0,18,18,68
6,r_32_57_85,r_126_115_170,r_2_66_35,r_32_57_85,0.9,3,88,85,68
18,r_129_133_23,r_10_83_135,r_13_61_11,r_129_133_23,0.98,0,23,23,68
0,r_51_12_96,r_79_77_165,seq108,r_79_77_165,1.0,1,166,165,68
10,r_29_139_158,r_129_133_23,seq19,r_29_139_158,0.85,0,158,158,68
27,r_14_6_119,r_22_93_163,seq108,r_14_6_119,0.53,4,123,119,68
42,r_43_135_42,r_55_35_90,seq142,r_43_135_42,1.0,0,42,42,68
2,r_21_90_162,seq33,r_32_57_85,r_21_90_162,0.51,2,164,162,68
47,r_97_54_160,seq7,r_64_18_39,r_97_54_160,0.63,0,160,160,68
40,r_100_41_127,seq19,r_113_3_103,r_100_41_127,1.0,0,127,127,68
29,r_30_92_198,r_138_101_145,r_70_122_48,r_70_122_48,0.53,97,145,48,68
25,r_50_46_73,r_100_41_127,seq67,r_50_46_73,1.0,0,73,73,68
33,r_89_114_138,seq28,seq38,r_89_114_138,0.97,0,138,138,68
16,r_22_93_163,r_9_76_182,r_107_16_60,r_22_93_163,0.94,-1,162,163,68
38,r_81_44_75,r_71_87_154,r_95_136_16,r_81_44_75,0.99,0,75,75,68
94,seq109,r_126_115_170,r_71_87_154,r_126_115_170,0.76,1,171,170,68
32,r_112_60_21,r_126_115_170,r_131_11_29,r_112_60_21,0.57,5,26,21,68
9,r_42_5_99,r_113_3_103,seq7,r_42_5_99,1.0,0,99,99,68
12,r_105_120_30,seq47,seq132,r_105_120_30,0.84,-5,25,30,68
22,r_113_3_103,r_42_5_99,seq134,r_42_5_99,0.85,1,100,99,68
49,r_9_76_182,seq75,r_30_92_198,r_9_76_182,0.56,0,182,182,68
56,seq142,r_79_77_165,r_43_135_42,r_43_135_42,1.0,62,104,42,68
7,r_10_83_135,seq124,r_55_35_90,r_55_35_90,0.93,49,139,90,68
59,seq19,seq24,r_29_139_158,r_29_139_158,1.0,11,169,158,68
44,r_53_88_188,seq86,r_10_83_135,r_53_88_188,0.3,0,188,188,68
37,r_70_122_48,r_95_136_16,seq49,r_70_122_48,1.0,0,48,48,68
35,r_138_101_145,r_29_139_158,r_107_16_60,r_29_139_158,1.0,-13,145,158,68
1,r_95_136_16,r_70_122_48,r_81_44_75,r_95_136_16,1.0,32,48,16,68
23,r_119_128_24,r_110_27_33,seq109,r_119_128_24,0.6,99,123,24,68
90,seq103,seq98,r_109_50_40,r_109_50_40,1.0,1,41,40,69
14,r_134_55_82,seq76,r_32_108_54,r_134_55_82,1.0,1,83,82,69
8,r_85_145_159,seq51,seq27,r_85_145_159,0.91,1,160,159,69
43,r_42_64_104,r_54_128_140,r_14_136_97,r_42_64_104,0.92,0,104,104,69
37,r_47_126_163,seq62,r_130_87_118,r_47_126_163,0.82,0,163,163,69
71,seq51,r_116_44_167,r_4_82_111,r_4_82_111,0.93,-1,110,111,69
9,r_9_84_19,seq3,seq13,r_9_84_19,0.92,-5,14,19,69
16,r_140_36_155,r_122_19_135,r_95_28_90,r_95_28_90,0.98,45,135,90,69
39,r_22_97_149,r_34_63_148,r_121_48_127,r_22_97_149,0.93,0,149,149,69
2,r_93_0_76,r_122_19_135,r_102_26_112,r_93_0_76,0.97,39,115,76,69
46,r_72_131_85,seq62,seq146,r_72_131_85,1.0,0,85,85,69
69,seq41,r_123_8_30,r_91_124_67,r_91_124_67,1.0,2,69,67,69
19,r_4_82_111,seq65,seq51,r_4_82_111,1.0,0,111,111,69
33,r_90_46_48,r_106_2_171,seq111,r_90_46_48,0.9,7,55,48,69
35,r_33_113_11,seq98,seq111,r_33_113_11,0.85,0,11,11,69
4,r_79_24_12,r_140_36_155,r_67_132_10,r_79_24_12,0.91,0,12,12,69
31,r_16_143_109,seq20,seq11,r_16_143_109,1.0,0,109,109,69
0,r_92_83_44,r_91_124_67,seq27,r_91_124_67,0.55,2,69,67,69
96,seq119,r_106_2_171,seq99,r_106_2_171,0.45,-25,146,171,69
3,r_60_71_68,seq148,r_106_2_171,r_60_71_68,1.0,1,69,68,69
32,r_61_12_38,r_14_136_97,r_123_8_30,r_61_12_38,0.48,3,41,38,69
78,seq129,seq39,r_73_120_64,r_73_120_64,1.0,25,89,64,69
29,r_68_6_34,seq111,seq117,r_68_6_34,1.0,0,34,34,69
11,r_116_44_167,seq51,r_73_120_64,r_73_120_64,0.59,104,168,64,69
20,r_95_28_90,r_14_136_97,r_93_0_76,r_95_28_90,0.99,0,90,90,69
13,r_96_52_86,seq74,seq65,r_96_52_86,1.0,0,86,86,69
15,r_130_87_118,seq1,seq39,r_130_87_118,0.61,8,126,118,69
48,r_34_63_148,r_22_97_149,seq135,r_34_63_148,0.85,0,148,148,69
30,r_91_124_67,seq127,r_92_83_44,r_92_83_44,0.94,8,52,44,69
6,r_77_115_71,r_134_55_82,r_140_36_155,r_77_115_71,1.0,0,71,71,69
62,seq27,r_5_142_142,r_104_58_69,r_5_142_142,0.75,0,142,142,69
27,r_104_58_69,seq101,seq27,r_104_58_69,0.8,6,75,69,69
87,seq98,seq39,r_49_110_15,r_49_110_15,0.97,47,62,15,69
49,r_32_108_54,seq65,seq69,r_32_108_54,1.0,0,54,54,69
2,r_93_0_76,r_116_44_167,r_122_19_135,r_93_0_76,0.87,3,79,76,69
47,r_30_57_181,seq21,r_67_132_10,r_30_57_181,0.7,0,181,181,69
40,r_54_128_140,seq17,seq23,r_54_128_140,0.96,0,140,140,69
18,r_121_48_127,seq135,r_90_46_48,r_121_48_127,1.0,0,127,127,69
24,r_56_100_175,seq62,r_140_36_155,r_56_100_175,0.45,0,175,175,69
25,r_73_120_64,seq11,seq129,r_73_120_64,1.0,0,64,64,69
42,r_49_110_15,r_102_26_112,seq98,r_49_110_15,1.0,1,16,15,69
6,r_77_115_71,r_140_36_155,seq40,r_77_115_71,0.49,65,136,71,69
38,r_14_136_97,r_106_2_171,seq101,r_14_136_97,1.0,0,97,97,69
44,r_123_8_30,seq39,r_61_12_38,r_123_8_30,0.88,12,42,30,69
34,r_31_114_95,seq117,seq62,r_31_114_95,1.0,0,95,95,69
17,r_5_142_142,seq27,r_93_0_76,r_5_142_142,0.95,0,142,142,69
21,r_78_15_87,r_96_52_86,seq37,r_78_15_87,0.89,-41,46,87,69
28,r_144_66_77,r_34_63_148,seq3,r_144_66_77,1.0,1,78,77,69
0,r_92_83_44,r_130_87_118,r_91_124_67,r_92_83_44,1.0,2,46,44,69
23,r_94_80_147,seq23,seq65,r_94_80_147,0.96,0,147,147,69
30,r_91_124_67,r_92_83_44,seq41,r_91_124_67,0.89,2,69,67,69
41,r_109_50_40,seq138,seq103,r_109_50_40,1.0,0,40,40,69
82,seq141,r_139_45_141,seq27,r_139_45_141,0.88,0,141,141,69
79,seq74,r_96_52_86,seq27,r_96_52_86,1.0,0,86,86,69
12,r_102_26_112,r_94_80_147,r_93_0_76,r_102_26_112,0.99,1,113,112,69
16,r_140_36_155,r_95_28_90,r_121_48_127,r_140_36_155,1.0,0,155,155,69
30,r_42_130_142,seq82,seq54,r_42_130_142,0.64,3,145,142,70
36,r_144_64_165,seq93,r_91_61_1,r_144_64_165,0.63,1,166,165,70
19,r_52_27_36,r_11_51_192,r_88_9_92,r_52_27_36,0.94,0,36,36,70
8,r_123_115_67,seq147,seq84,r_123_115_67,0.98,4,71,67,70
37,r_37_109_141,seq107,r_23_13_3,r_37_109_141,0.91,0,141,141,70
19,r_52_27_36,r_88_9_92,r_74_124_102,r_52_27_36,1.0,61,97,36,70
55,seq137,r_47_81_112,r_118_33_110,r_47_81_112,0.94,0,112,112,70
16,r_8_139_93,seq105,seq128,r_8_139_93,1.0,0,93,93,70
21,r_118_33_110,r_140_80_162,r_122_66_138,r_118_33_110,0.73,44,154,110,70
39,r_22_99_70,r_91_61_1,r_63_141_52,r_91_61_1,0.62,69,70,1,70
29,r_36_30_9,r_29_142_51,r_47_81_112,r_36_30_9,0.82,4,13,9,70
5,r_100_53_88,seq128,seq105,r_100_53_88,1.0,0,88,88,70
46,r_145_50_65,seq134,r_21_129_31,r_145_50_65,0.97,1,66,65,70
42,r_113_14_161,r_72_110_122,seq28,r_72_110_122,0.43,-38,84,122,70
45,r_65_40_95,seq68,seq86,r_65_40_95,1.0,0,95,95,70
15,r_67_73_42,r_144_64_165,r_69_135_177,r_67_73_42,0.99,0,42,42,70
15,r_67_73_42,r_69_135_177,r_122_66_138,r_67_73_42,0.53,109,151,42,70
4,r_88_9_92,r_52_27_36,seq28,r_88_9_92,1.0,5,97,92,70
12,r_21_129_31,seq104,seq25,r_21_129_31,0.99,0,31,31,70
2,r_29_142_51,r_100_53_88,seq77,r_29_142_51,0.78,0,51,51,70
31,r_121_2_143,seq75,r_21_129_31,r_121_2_143,0.73,0,143,143,70
89,seq94,seq68,r_29_142_51,r_29_142_51,1.0,61,112,51,70
44,r_97_101_57,seq26,seq93,r_97_101_57,1.0,0,57,57,70
3,r_83_59_174,r_90_92_179,r_79_58_125,r_90_92_179,0.6,-5,174,179,70
26,r_140_80_162,r_118_33_110,r_29_142_51,r_118_33_110,0.71,52,162,110,70
14,r_148_3_24,seq143,seq70,r_148_3_24,0.99,0,24,24,70
63,seq25,r_133_4_172,r_21_129_31,r_21_129_31,0.74,141,172,31,70
73,seq54,r_108_149_188,r_42_130_142,r_42_130_142,0.94,16,158,142,70
11,r_122_66_138,seq76,r_67_73_42,r_122_66_138,0.71,0,138,138,70
22,r_78_18_53,r_42_130_142,seq1,r_78_18_53,0.95,0,53,53,70
20,r_19_57_169,seq1,seq107,r_19_57_169,0.62,-6,163,169,70
48,r_60_85_94,r_31_138_128,seq76,r_60_85_94,1.0,1,95,94,70
85,seq87,r_133_4_172,r_72_110_122,r_72_110_122,0.9,5,127,122,70
27,r_34_48_71,seq45,r_118_33_110,r_34_48_71,0.56,0,71,71,70
84,seq86,r_67_73_42,seq136,r_67_73_42,0.64,-19,23,42,70
24,r_90_92_179,seq127,seq6,r_90_92_179,0.53,0,179,179,70
33,r_79_58_125,seq105,r_5_44_198,r_79_58_125,0.95,0,125,125,70
88,seq93,r_144_64_165,r_97_101_57,r_97_101_57,1.0,109,166,57,70
6,r_103_56_7,seq82,r_118_33_110,r_118_33_110,0.51,-2,108,110,70
42,r_113_14_161,seq28,r_21_129_31,r_113_14_161,0.88,1,162,161,70
32,r_72_110_122,r_108_149_188,seq87,r_72_110_122,0.99,0,122,122,70
52,seq131,seq137,r_118_33_110,r_118_33_110,0.38,11,121,110,70
25,r_120_116_15,seq82,seq10,r_120_116_15,0.95,6,21,15,70
28,r_69_135_177,r_67_73_42,seq86,r_69_135_177,0.99,0,177,177,70
4,r_88_9_92,seq17,r_52_27_36,r_52_27_36,1.0,2,38,36,70
17,r_133_4_172,seq25,r_29_142_51,r_29_142_51,0.56,121,172,51,70
94,seq107,r_37_109_141,r_122_66_138,r_37_109_141,0.64,0,141,141,70
9,r_132_24_127,seq43,seq46,r_132_24_127,0.93,0,127,127,70
18,r_63_141_52,seq46,seq117,r_63_141_52,1.0,1,53,52,70
29,r_36_30_9,r_47_81_112,r_67_73_42,r_36_30_9,0.89,96,105,9,70
28,r_69_135_177,seq137,r_67_73_42,r_67_73_42,1.0,79,121,42,70
84,seq86,seq136,r_65_40_95,r_65_40_95,0.96,2,97,95,70
49,r_12_0_116,r_108_149_188,r_21_129_31,r_12_0_116,1.0,0,116,116,70
56,seq10,seq134,r_120_116_15,r_120_116_15,0.61,79,94,15,70
7,r_125_49_68,r_37_109_141,r_63_141_52,r_37_109_141,0.78,-73,68,141,70
23,r_47_81_112,seq137,seq32,r_47_81_112,0.89,0,112,112,70
79,seq75,r_121_2_143,seq127,r_121_2_143,0.79,0,143,143,70
35,r_74_124_102,seq1,r_52_27_36,r_74_124_102,0.89,5,107,102,70
36,r_16_93_152,seq94,seq90,r_16_93_152,0.76,0,152,152,71
14,r_53_36_93,seq115,r_112_47_165,r_53_36_93,1.0,0,93,93,71
8,r_30_29_132,r_1_144_118,r_37_78_77,r_30_29_132,0.53,-55,77,132,71
27,r_110_34_131,r_86_141_18,r_46_59_68,r_110_34_131,0.87,-1,130,131,71
37,r_61_118_67,r_64_104_79,seq94,r_61_118_67,1.0,0,67,67,71
3,r_5_127_29,r_38_44_150,r_13_19_84,r_5_127_29,0.7,122,151,29,71
13,r_126_105_195,r_53_36_93,r_51_125_13,r_126_105_195,0.84,-183,12,195,71
27,r_110_34_131,r_38_44_150,r_86_141_18,r_110_34_131,0.62,-51,80,131,71
16,r_68_20_155,r_63_130_30,seq80,r_68_20_155,0.71,1,156,155,71
21,r_32_70_158,r_12_72_177,r_43_137_103,r_32_70_158,0.5,1,159,158,71
39,r_103_76_186,seq97,r_53_36_93,r_53_36_93,0.99,94,187,93,71
34,r_12_72_177,r_124_116_7,r_86_141_18,r_12_72_177,0.66,0,177,177,71
45,r_48_131_144,seq9,seq114,r_48_131_144,0.85,0,144,144,71
8,r_30_29_132,r_37_78_77,r_17_2_63,r_30_29_132,1.0,0,132,132,71
24,r_119_74_174,r_40_101_104,r_30_29_132,r_40_101_104,0.83,73,177,104,71
19,r_135_42_100,r_89_73_141,seq25,r_135_42_100,0.95,0,100,100,71
47,r_64_104_79,seq54,r_119_74_174,r_64_104_79,0.97,0,79,79,71
47,r_64_104_79,r_61_118_67,seq54,r_61_118_67,0.82,-15,52,67,71
4,r_51_125_13,seq22,r_126_105_195,r_51_125_13,1.0,-1,12,13,71
31,r_147_62_86,seq138,seq132,r_147_62_86,1.0,1,87,86,71
41,r_89_73_141,seq80,r_102_87_191,r_89_73_141,0.99,0,141,141,71
89,seq94,r_16_93_152,r_61_118_67,r_61_118_67,0.97,0,67,67,71
10,r_133_45_116,seq31,seq100,r_133_45_116,0.98,5,121,116,71
47,r_64_104_79,r_119_74_174,seq111,r_119_74_174,0.72,-46,128,174,71
5,r_86_141_18,r_99_15_46,seq139,r_86_141_18,1.0,-1,17,18,71
14,r_53_36_93,r_112_47_165,r_18_84_10,r_112_47_165,1.0,0,165,165,71
0,r_121_122_61,r_30_29_132,seq56,r_121_122_61,0.96,3,64,61,71
20,r_128_3_85,r_123_91_169,seq129,r_128_3_85,1.0,-2,83,85,71
15,r_43_137_103,r_38_44_150,seq27,r_43_137_103,0.78,0,103,103,71
48,r_75_39_83,r_46_59_68,r_147_62_86,r_75_39_83,0.74,7,90,83,71
97,seq115,r_53_36_93,seq100,r_53_36_93,1.0,-34,59,93,71
2,r_38_44_150,r_13_19_84,r_146_71_9,r_38_44_150,0.93,1,151,150,71
95,seq113,r_140_0_40,seq4,r_140_0_40,0.82,0,40,40,71
30,r_124_116_7,r_12_72_177,r_123_91_169,r_12_72_177,0.71,0,177,177,71
40,r_46_59_68,r_75_39_83,seq67,r_75_39_83,0.85,-26,57,83,71
2,r_38_44_150,r_43_137_103,r_13_19_84,r_38_44_150,0.83,-65,85,150,71
24,r_119_74_174,seq23,r_40_101_104,r_119_74_174,0.5,-83,91,174,71
25,r_107_145_105,r_126_105_195,r_5_127_29,r_107_145_105,0.97,0,105,105,71
3,r_5_127_29,r_123_91_169,r_38_44_150,r_5_127_29,0.6,0,29,29,71
22,r_112_47_165,r_53_36_93,r_110_34_131,r_112_47_165,0.97,0,165,165,71
64,seq23,r_119_74_174,seq111,r_119_74_174,1.0,-48,126,174,71
46,r_95_35_32,seq8,seq100,r_95_35_32,0.98,0,32,32,71
58,seq139,seq23,r_86_141_18,r_86_141_18,0.9,88,106,18,71
65,seq25,r_37_78_77,r_135_42_100,r_135_42_100,0.65,4,104,100,71
33,r_66_11_15,r_112_47_165,seq14,r_66_11_15,0.99,0,15,15,71
32,r_13_19_84,r_30_29_132,r_5_127_29,r_13_19_84,0.65,0,84,84,71
52,seq4,seq97,r_17_2_63,r_17_2_63,1.0,7,70,63,71
27,r_110_34_131,r_49_109_106,r_38_44_150,r_49_109_106,0.26,-48,58,106,71
34,r_12_72_177,r_32_70_158,r_124_116_7,r_12_72_177,0.66,-18,159,177,71
6,r_140_0_40,seq113,r_28_108_1,r_140_0_40,1.0,0,40,40,71
9,r_37_78_77,seq25,r_63_130_30,r_37_78_77,0.88,2,79,77,71
26,r_18_84_10,r_123_91_169,r_99_15_46,r_99_15_46,0.96,106,152,46,71
96,seq114,r_49_109_106,r_48_131_144,r_48_131_144,0.89,0,144,144,71
28,r_123_91_169,r_18_84_10,r_124_116_7,r_18_84_10,0.62,161,171,10,71
29,r_40_101_104,r_119_74_174,seq23,r_119_74_174,1.0,3,177,174,71
22,r_112_47_165,r_123_91_169,r_53_36_93,r_53_36_93,1.0,30,123,93,71
43,r_99_15_46,seq14,r_18_84_10,r_99_15_46,1.0,0,46,46,71
49,r_49_109_106,seq114,r_66_11_15,r_66_11_15,0.62,127,142,15,71
56,seq9,r_48_131_144,r_52_149_64,r_52_149_64,1.0,20,84,64,71
7,r_24_58_121,seq134,r_86_141_18,r_24_58_121,0.92,1,122,121,71
44,r_17_2_63,seq6,seq4,r_17_2_63,1.0,1,64,63,71
23,r_52_149_64,r_123_91_169,seq9,r_52_149_64,1.0,0,64,64,71
18,r_28_108_1,r_135_42_100,r_140_0_40,r_28_108_1,0.69,39,40,1,71
82,seq80,r_89_73_141,r_82_60_197,r_89_73_141,0.99,0,141,141,71
12,r_1_144_118,r_30_29_132,r_43_137_103,r_30_29_132,0.77,-14,118,132,71
42,r_136_57_162,seq21,r_99_15_46,r_99_15_46,0.52,116,162,46,71
55,seq8,seq139,r_128_3_85,r_128_3_85,0.97,19,104,85,71
40,r_144_135_188,r_147_70_39,r_19_131_72,r_19_131_72,0.54,116,188,72,72
26,r_20_10_128,r_69_65_92,r_147_70_39,r_20_10_128,0.97,2,130,128,72
30,r_17_37_47,r_81_120_80,r_25_146_10,r_17_37_47,0.94,0,47,47,72
53,seq134,r_121_149_121,r_42_93_44,r_42_93_44,1.0,77,121,44,72
43,r_1_46_150,seq53,seq36,r_1_46_150,0.95,0,150,150,72
54,seq136,r_91_137_114,r_105_83_109,r_91_137_114,1.0,-43,71,114,72
59,seq145,r_6_22_173,seq98,r_6_22_173,0.69,0,173,173,72
40,r_144_135_188,r_106_60_77,r_147_70_39,r_147_70_39,1.0,0,39,39,72
69,seq49,r_117_90_17,seq63,r_117_90_17,0.41,16,33,17,72
16,r_74_29_89,r_69_65_92,seq139,r_69_65_92,0.99,-9,83,92,72
1,r_81_120_80,seq77,seq62,r_81_120_80,1.0,-1,79,80,72
46,r_23_61_140,seq15,seq134,r_23_61_140,0.97,0,140,140,72
24,r_80_114_27,r_31_143_59,seq11,r_80_114_27,1.0,0,27,27,72
73,seq58,r_144_135_188,r_117_90_17,r_117_90_17,0.98,0,17,17,72
7,r_69_65_92,seq63,r_6_22_173,r_6_22_173,0.99,1,174,173,72
5,r_33_40_165,seq62,r_4_111_26,r_4_111_26,1.0,3,29,26,72
12,r_117_90_17,r_81_120_80,seq58,r_117_90_17,0.82,0,17,17,72
11,r_91_137_114,r_32_124_175,seq24,r_32_124_175,0.99,0,175,175,72
31,r_32_124_175,r_142_67_147,r_91_137_114,r_91_137_114,0.97,0,114,114,72
55,seq11,seq96,r_80_114_27,r_80_114_27,1.0,0,27,27,72
8,r_86_141_50,seq53,seq58,r_86_141_50,1.0,0,50,50,72
10,r_89_112_123,seq73,r_105_83_109,r_89_112_123,0.99,0,123,123,72
26,r_20_10_128,seq68,r_69_65_92,r_69_65_92,1.0,0,92,92,72
0,r_48_59_115,r_133_107_180,r_138_109_103,r_48_59_115,0.99,0,115,115,72
19,r_55_108_46,seq12,seq77,r_55_108_46,1.0,-1,45,46,72
11,r_91_137_114,seq136,r_32_124_175,r_91_137_114,0.97,0,114,114,72
20,r_71_66_142,r_30_104_199,seq35,r_71_66_142,0.95,0,142,142,72
13,r_44_56_152,seq73,seq53,r_44_56_152,0.84,0,152,152,72
6,r_4_111_26,r_100_18_101,r_33_40_165,r_4_111_26,1.0,0,26,26,72
41,r_31_143_59,seq35,seq72,r_31_143_59,1.0,0,59,59,72
15,r_19_131_72,r_89_112_123,seq47,r_19_131_72,1.0,1,73,72,72
4,r_121_149_121,r_42_93_44,r_117_90_17,r_121_149_121,1.0,0,121,121,72
34,r_129_125_56,r_105_83_109,r_55_108_46,r_129_125_56,0.77,0,56,56,72
5,r_33_40_165,r_4_111_26,seq140,r_33_40_165,0.88,0,165,165,72
27,r_50_5_179,seq136,r_86_141_50,r_50_5_179,0.75,0,179,179,72
7,r_69_65_92,r_20_10_128,seq63,r_20_10_128,0.6,2,130,128,72
39,r_52_28_41,seq51,seq136,r_52_28_41,0.81,0,41,41,72
2,r_100_18_101,r_30_104_199,r_80_114_27,r_100_18_101,1.0,0,101,101,72
25,r_2_8_33,seq68,seq101,r_2_8_33,0.78,-2,31,33,72
28,r_25_146_10,r_100_18_101,seq34,r_25_146_10,0.98,1,11,10,72
74,seq62,r_33_40_165,r_81_120_80,r_81_120_80,0.99,7,87,80,72
18,r_13_118_105,r_30_104_199,r_92_7_85,r_92_7_85,0.99,20,105,85,72
29,r_99_38_87,r_100_18_101,seq49,r_99_38_87,0.95,0,87,87,72
37,r_147_70_39,r_31_143_59,r_144_135_188,r_147_70_39,1.0,0,39,39,72
33,r_115_132_166,seq88,r_81_120_80,r_81_120_80,0.71,86,166,80,72
48,r_42_93_44,r_121_149_121,seq134,r_121_149_121,1.0,0,121,121,72
58,seq15,r_23_61_140,seq21,r_23_61_140,1.0,0,140,140,72
6,r_4_111_26,r_33_40_165,r_81_120_80,r_81_120_80,0.99,85,165,80,72
65,seq36,r_133_107_180,r_126_0_131,r_126_0_131,0.92,49,180,131,72
32,r_148_97_116,r_133_107_180,seq84,r_148_97_116,1.0,0,116,116,72
38,r_57_113_138,seq116,r_94_102_9,r_57_113_138,1.0,0,138,138,72
4,r_121_149_121,r_33_40_165,r_42_93_44,r_42_93_44,1.0,0,44,44,72
48,r_42_93_44,r_86_141_50,r_121_149_121,r_42_93_44,1.0,0,44,44,72
23,r_39_85_58,seq78,seq88,r_39_85_58,1.0,0,58,58,72
81,seq75,r_33_40_165,seq62,r_33_40_165,0.74,-57,108,165,72
17,r_92_7_85,seq14,seq12,r_92_7_85,1.0,0,85,85,72
94,seq110,r_6_22_173,seq98,r_6_22_173,0.35,-1,172,173,72
53,seq134,r_42_93_44,r_23_61_140,r_23_61_140,0.69,0,140,140,72
31,r_32_124_175,r_91_137_114,r_121_149_121,r_32_124_175,0.92,0,175,175,72
37,r_147_70_39,r_144_135_188,r_20_10_128,r_20_10_128,0.97,-2,126,128,72
22,r_133_107_180,seq36,r_52_28_41,r_133_107_180,0.7,0,180,180,72
49,r_26_45_162,seq95,seq130,r_26_45_162,0.54,2,164,162,72
69,seq49,seq63,r_44_56_152,r_44_56_152,0.59,-100,52,152,72
56,seq12,seq51,r_92_7_85,r_92_7_85,1.0,11,96,85,72
7,r_69_65_92,r_23_61_140,r_20_10_128,r_69_65_92,0.94,1,93,92,72
79,seq72,r_16_9_149,r_31_143_59,r_31_143_59,1.0,27,86,59,72
35,r_126_0_131,r_44_56_152,seq36,r_126_0_131,1.0,0,131,131,72
63,seq34,seq35,r_25_146_10,r_25_146_10,1.0,1,11,10,72
24,r_67_17_36,seq135,seq42,r_67_17_36,1.0,0,36,36,73
32,r_137_122_165,r_15_143_55,seq124,r_15_143_55,1.0,0,55,55,73
92,seq103,r_99_127_196,r_109_107_121,r_109_107_121,1.0,42,163,121,73
8,r_16_141_152,r_62_25_66,r_60_74_74,r_60_74_74,0.72,2,76,74,73
43,r_7_59_146,seq10,r_34_132_22,r_7_59_146,0.95,0,146,146,73
99,seq125,r_77_39_48,r_139_22_25,r_77_39_48,0.53,1,49,48,73
3,r_105_27_39,seq52,r_106_68_141,r_106_68_141,0.89,-1,140,141,73
59,seq145,r_78_4_113,r_66_14_7,r_78_4_113,0.9,0,113,113,73
71,seq54,r_73_134_109,seq124,r_73_134_109,0.8,1,110,109,73
16,r_91_104_114,r_106_68_141,r_126_85_123,r_91_104_114,0.82,0,114,114,73
21,r_133_53_95,seq44,r_121_38_28,r_133_53_95,0.86,0,95,95,73
46,r_26_35_78,seq49,seq81,r_26_35_78,0.92,6,84,78,73
42,r_31_110_116,r_73_134_109,seq103,r_31_110_116,0.73,0,116,116,73
80,seq80,r_50_30_173,seq12,r_50_30_173,0.97,0,173,173,73
32,r_137_122_165,seq124,r_51_2_5,r_137_122_165,0.96,0,165,165,73
1,r_13_1_32,r_51_2_5,r_15_143_55,r_15_143_55,0.82,-3,52,55,73
69,seq49,seq79,r_78_4_113,r_78_4_113,1.0,11,124,113,73
15,r_60_74_74,r_16_141_152,seq108,r_16_141_152,0.72,0,152,152,73
5,r_121_38_28,r_105_27_39,seq135,r_121_38_28,0.88,1,29,28,73
1,r_13_1_32,seq0,r_51_2_5,r_13_1_32,0.87,3,35,32,73
31,r_73_134_109,r_31_110_116,seq90,r_73_134_109,0.83,6,115,109,73
41,r_46_149_149,r_147_71_128,r_105_27_39,r_147_71_128,0.84,21,149,128,73
44,r_34_132_22,r_131_6_193,seq119,r_34_132_22,0.92,2,24,22,73
9,r_77_39_48,seq135,seq10,r_77_39_48,0.98,1,49,48,73
40,r_47_93_46,seq52,seq49,r_47_93_46,0.86,-1,45,46,73
26,r_55_102_68,seq90,seq114,r_55_102_68,0.48,11,79,68,73
8,r_16_141_152,r_60_74_74,seq21,r_16_141_152,0.98,0,152,152,73
11,r_139_22_25,r_148_58_175,r_11_140_99,r_139_22_25,0.71,1,26,25,73
20,r_112_32_98,r_109_107_121,seq28,r_112_32_98,1.0,0,98,98,73
13,r_146_95_174,seq56,r_13_1_32,r_13_1_32,0.9,142,174,32,73
15,r_60_74_74,r_92_116_83,r_16_141_152,r_60_74_74,1.0,1,75,74,73
66,seq42,r_36_82_192,r_67_17_36,r_67_17_36,1.0,0,36,36,73
3,r_105_27_39,seq21,seq52,r_105_27_39,1.0,0,39,39,73
6,r_92_116_83,seq145,r_51_2_5,r_92_116_83,1.0,1,84,83,73
62,seq23,r_11_140_99,seq80,r_11_140_99,1.0,0,99,99,73
17,r_138_57_58,seq18,r_51_2_5,r_138_57_58,1.0,1,59,58,73
10,r_126_85_123,r_34_132_22,r_91_104_114,r_91_104_114,0.86,10,124,114,73
27,r_109_107_121,r_147_71_128,r_31_110_116,r_109_107_121,0.81,0,121,121,73
2,r_50_30_173,seq80,seq49,r_50_30_173,0.7,0,173,173,73
47,r_106_68_141,seq115,r_105_27_39,r_106_68_141,0.7,0,141,141,73
37,r_45_136_10,seq125,seq103,r_45_136_10,1.0,0,10,10,73
33,r_11_140_99,seq23,r_47_93_46,r_11_140_99,0.97,0,99,99,73
64,seq28,seq145,r_112_32_98,r_112_32_98,0.78,3,101,98,73
10,r_126_85_123,seq129,r_34_132_22,r_126_85_123,0.67,-79,44,123,73
34,r_72_111_120,seq101,seq70,r_72_111_120,0.99,0,120,120,73
14,r_64_123_12,r_147_71_128,seq29,r_64_123_12,0.99,0,12,12,73
23,r_69_120_125,seq144,r_40_20_90,r_69_120_125,1.0,0,125,125,73
39,r_33_98_34,r_133_53_95,seq142,r_33_98_34,0.99,0,34,34,73
11,r_139_22_25,r_11_140_99,r_121_38_28,r_139_22_25,0.82,11,36,25,73
18,r_41_94_13,r_77_39_48,seq90,r_41_94_13,1.0,-2,11,13,73
94,seq114,seq43,r_55_102_68,r_55_102_68,0.59,32,100,68,73
22,r_130_86_86,r_91_104_114,seq56,r_130_86_86,0.82,0,86,86,73
28,r_15_143_55,r_137_122_165,r_13_1_32,r_15_143_55,0.99,0,55,55,73
75,seq65,seq49,r_60_74_74,r_60_74_74,0.87,63,137,74,73
35,r_62_25_66,r_16_141_152,seq103,r_16_141_152,0.81,-81,71,152,73
30,r_44_54_68,r_100_101_157,r_110_93_44,r_44_54_68,1.0,0,68,68,74
8,r_114_121_49,r_105_91_86,r_9_59_17,r_114_121_49,0.99,-2,47,49,74
76,seq69,r_143_61_137,r_110_93_44,r_110_93_44,1.0,1,45,44,74
19,r_23_66_36,r_103_4_167,seq125,r_23_66_36,0.96,0,36,36,74
25,r_49_76_28,r_19_56_74,seq97,r_49_76_28,1.0,0,28,28,74
33,r_9_59_17,r_63_67_136,seq102,r_9_59_17,1.0,-1,16,17,74
37,r_111_1_91,seq98,seq78,r_111_1_91,1.0,2,93,91,74
55,seq14,r_74_60_78,r_6_104_171,r_74_60_78,1.0,-8,70,78,74
21,r_86_139_132,seq107,seq125,r_86_139_132,0.96,1,133,132,74
1,r_28_106_119,seq73,r_39_88_56,r_28_106_119,0.99,0,119,119,74
5,r_124_141_69,seq16,r_55_142_41,r_124_141_69,0.98,0,69,69,74
46,r_133_40_170,seq72,r_21_140_23,r_133_40_170,0.52,0,170,170,74
42,r_127_126_76,seq51,seq64,r_127_126_76,1.0,0,76,76,74
70,seq47,r_48_109_126,r_65_134_29,r_65_134_29,1.0,0,29,29,74
32,r_55_142_41,r_90_95_177,r_124_141_69,r_124_141_69,0.58,112,181,69,74
41,r_110_93_44,seq70,seq69,r_110_93_44,0.75,0,44,44,74
33,r_9_59_17,seq102,r_114_121_49,r_114_121_49,1.0,34,83,49,74
27,r_39_88_56,seq102,r_28_106_119,r_28_106_119,1.0,14,133,119,74
66,seq36,r_87_113_65,seq130,r_87_113_65,1.0,-1,64,65,74
71,seq51,r_127_126_76,seq77,r_127_126_76,1.0,-31,45,76,74
31,r_103_4_167,seq94,r_65_134_29,r_65_134_29,0.99,139,168,29,74
26,r_100_101_157,seq147,seq78,r_100_101_157,0.88,1,158,157,74
48,r_6_104_171,seq14,seq25,r_6_104_171,1.0,0,171,171,74
32,r_55_142_41,r_114_121_49,r_90_95_177,r_114_121_49,0.85,-8,41,49,74
89,seq97,seq18,r_49_76_28,r_49_76_28,1.0,5,33,28,74
0,r_96_31_82,r_28_106_119,seq20,r_96_31_82,1.0,-2,80,82,74
11,r_48_109_126,r_115_26_51,r_24_43_9,r_115_26_51,0.5,90,141,51,74
99,seq125,r_23_66_36,r_86_139_132,r_86_139_132,1.0,11,143,132,74
13,r_143_61_137,seq16,r_86_139_132,r_86_139_132,0.85,4,136,132,74
99,seq125,r_58_22_124,r_23_66_36,r_23_66_36,0.66,19,55,36,74
48,r_6_104_171,r_146_129_116,seq14,r_146_129_116,0.97,0,116,116,74
6,r_63_67_136,seq33,seq94,r_63_67_136,0.76,1,137,136,74
27,r_39_88_56,r_57_52_198,seq102,r_39_88_56,1.0,0,56,56,74
2,r_90_95_177,r_55_142_41,r_63_67_136,r_90_95_177,0.66,4,181,177,74
2,r_90_95_177,r_0_13_127,r_55_142_41,r_90_95_177,0.88,-48,129,177,74
47,r_119_148_92,r_48_109_126,seq30,r_119_148_92,1.0,0,92,92,74
40,r_37_128_182,seq120,r_87_113_65,r_87_113_65,1.0,117,182,65,74
18,r_32_84_134,seq20,r_45_35_179,r_32_84_134,0.95,0,134,134,74
29,r_74_60_78,seq14,r_65_134_29,r_74_60_78,1.0,0,78,78,74
88,seq94,r_103_4_167,r_63_67_136,r_63_67_136,0.58,32,168,136,74
50,seq130,seq92,r_58_22_124,r_58_22_124,0.97,1,125,124,74
34,r_65_134_29,r_49_76_28,seq47,r_65_134_29,0.98,-1,28,29,74
65,seq33,r_63_67_136,r_86_139_132,r_86_139_132,0.56,5,137,132,74
16,r_21_140_23,r_37_128_182,seq107,r_21_140_23,1.0,0,23,23,74
38,r_19_56_74,seq98,r_85_137_2,r_19_56_74,1.0,0,74,74,74
75,seq64,seq81,r_127_126_76,r_127_126_76,1.0,1,77,76,74
9,r_105_91_86,r_58_22_124,seq72,r_105_91_86,1.0,0,86,86,74
22,r_146_129_116,r_6_104_171,r_117_34_80,r_146_129_116,0.78,0,116,116,74
14,r_136_131_54,r_86_139_132,seq36,r_136_131_54,0.98,-1,53,54,74
28,r_41_8_101,seq42,seq36,r_41_8_101,1.0,2,103,101,74
7,r_118_29_48,r_11_68_187,seq77,r_118_29_48,1.0,2,50,48,74
49,r_117_34_80,r_55_142_41,seq79,r_117_34_80,0.84,1,81,80,74
23,r_58_22_124,seq125,seq130,r_58_22_124,0.74,5,129,124,74
35,r_83_38_71,seq20,r_87_113_65,r_83_38_71,0.99,0,71,71,74
12,r_0_13_127,r_90_95_177,seq120,r_0_13_127,0.84,2,129,127,74
0,r_15_86_28,r_147_130_171,seq124,r_15_86_28,1.0,0,28,28,75
14,r_119_25_148,r_69_121_81,r_44_37_68,r_119_25_148,0.96,-73,75,148,75
8,r_55_57_116,r_88_59_149,seq67,r_55_57_116,1.0,0,116,116,75
43,r_38_116_137,r_87_63_193,r_47_126_120,r_87_63_193,1.0,-56,137,193,75
83,seq140,r_113_58_78,seq67,r_113_58_78,1.0,0,78,78,75
37,r_107_128_98,r_38_116_137,seq41,r_107_128_98,1.0,0,98,98,75
3,r_44_37_68,seq39,r_94_16_186,r_44_37_68,0.38,118,186,68,75
16,r_132_105_70,seq97,seq36,r_132_105_70,1.0,0,70,70,75
39,r_94_16_186,seq122,r_44_37_68,r_44_37_68,1.0,118,186,68,75
42,r_135_64_91,r_129_139_32,seq5,r_135_64_91,0.99,0,91,91,75
5,r_31_32_42,r_92_98_127,r_70_33_37,r_31_32_42,1.0,1,43,42,75
48,r_90_84_41,r_79_13_73,seq4,r_90_84_41,0.48,0,41,41,75
30,r_24_114_22,r_17_148_128,seq22,r_24_114_22,1.0,0,22,22,75
76,seq53,seq76,r_142_29_33,r_142_29_33,0.99,0,33,33,75
28,r_27_101_43,seq43,r_47_126_120,r_27_101_43,1.0,1,44,43,75
66,seq36,seq43,r_132_105_70,r_132_105_70,1.0,1,71,70,75
88,seq83,seq108,r_17_148_128,r_17_148_128,1.0,3,131,128,75
36,r_141_91_44,r_129_139_32,r_70_33_37,r_141_91_44,1.0,0,44,44,75
31,r_40_20_95,r_47_126_120,seq67,r_47_126_120,0.99,-16,104,120,75
41,r_82_73_172,seq71,r_96_134_94,r_96_134_94,1.0,78,172,94,75
3,r_44_37_68,seq99,seq39,r_44_37_68,1.0,0,68,68,75
97,seq124,r_26_52_69,r_15_86_28,r_15_86_28,0.78,2,30,28,75
34,r_70_33_37,seq41,seq99,r_70_33_37,0.99,1,38,37,75
14,r_119_25_148,r_44_37_68,r_17_148_128,r_119_25_148,1.0,-1,147,148,75
20,r_26_52_69,seq124,r_103_23_62,r_103_23_62,0.92,1,63,62,75
46,r_47_126_120,r_27_101_43,seq75,r_47_126_120,0.85,0,120,120,75
15,r_143_120_131,r_11_34_67,r_112_138_135,r_11_34_67,0.98,62,129,67,75
6,r_69_121_81,r_119_25_148,r_27_101_43,r_69_121_81,0.66,0,81,81,75
10,r_142_29_33,r_11_34_67,seq53,r_142_29_33,1.0,0,33,33,75
27,r_113_58_78,seq140,r_132_105_70,r_113_58_78,1.0,0,78,78,75
84,seq75,r_144_106_66,seq117,r_144_106_66,1.0,-13,53,66,75
87,seq81,r_11_34_67,r_79_13_73,r_79_13_73,1.0,6,79,73,75
1,r_123_102_9,r_44_37_68,seq22,r_123_102_9,0.99,1,10,9,75
2,r_17_148_128,seq5,seq83,r_17_148_128,0.97,0,128,128,75
47,r_144_106_66,seq75,seq136,r_144_106_66,1.0,0,66,66,75
40,r_118_3_101,seq83,seq43,r_118_3_101,1.0,0,101,101,75
74,seq136,seq76,r_144_106_66,r_144_106_66,1.0,25,91,66,75
46,r_47_126_120,r_11_34_67,r_27_101_43,r_27_101_43,1.0,1,44,43,75
38,r_109_60_30,r_70_33_37,r_11_34_67,r_109_60_30,1.0,0,30,30,75
24,r_2_9_104,r_129_139_32,seq50,r_2_9_104,0.98,1,105,104,75
25,r_79_13_73,r_94_16_186,seq81,r_79_13_73,1.0,0,73,73,75
33,r_112_138_135,r_49_127_184,r_143_120_131,r_49_127_184,0.9,-49,135,184,75
88,seq83,r_118_3_101,seq108,r_118_3_101,0.98,-8,93,101,75
52,seq4,r_129_139_32,r_90_84_41,r_90_84_41,0.46,8,49,41,75
11,r_100_66_27,r_11_34_67,seq133,r_100_66_27,0.44,1,28,27,75
61,seq21,r_88_59_149,r_92_98_127,r_92_98_127,0.95,22,149,127,75
75,seq50,seq30,r_2_9_104,r_2_9_104,0.99,16,120,104,75
17,r_74_145_80,seq1,r_144_106_66,r_144_106_66,0.53,13,79,66,75
21,r_65_115_52,r_74_145_80,seq122,r_65_115_52,1.0,0,52,52,75
9,r_10_61_115,r_88_59_149,seq83,r_10_61_115,1.0,0,115,115,75
96,seq122,r_94_16_186,r_65_115_52,r_65_115_52,1.0,134,186,52,75
28,r_27_101_43,r_47_126_120,r_69_121_81,r_27_101_43,0.64,77,120,43,75
22,r_35_110_166,seq5,r_55_57_116,r_55_57_116,1.0,50,166,116,75
91,seq97,r_132_105_70,seq108,r_132_105_70,1.0,-2,68,70,75
49,r_96_134_94,seq77,seq36,r_96_134_94,1.0,0,94,94,75
44,r_88_59_149,seq21,r_129_139_32,r_88_59_149,0.88,0,149,149,75
23,r_92_98_127,seq46,seq21,r_92_98_127,1.0,0,127,127,75
19,r_11_34_67,r_40_20_95,r_109_60_30,r_109_60_30,0.96,28,58,30,75
35,r_49_127_184,seq5,r_143_120_131,r_143_120_131,0.98,53,184,131,75
12,r_103_23_62,seq30,r_142_29_33,r_103_23_62,1.0,0,62,62,75
29,r_80_51_10,r_26_52_69,seq62,r_80_51_10,0.94,1,11,10,75
30,r_13_93_122,r_38_80_176,seq48,r_13_93_122,0.98,0,122,122,76
66,seq34,r_128_133_164,r_28_37_15,r_128_133_164,0.95,-26,138,164,76
14,r_20_58_119,r_18_139_127,seq25,r_20_58_119,0.87,0,119,119,76
8,r_101_60_65,seq49,r_72_91_3,r_101_60_65,0.87,0,65,65,76
48,r_56_26_30,r_73_57_94,r_109_125_22,r_73_57_94,0.95,-64,30,94,76
43,r_132_84_168,r_129_70_199,seq47,r_129_70_199,0.45,-31,168,199,76
37,r_74_32_114,seq137,seq121,r_74_32_114,0.99,0,114,114,76
5,r_95_36_16,r_62_141_145,seq48,r_95_36_16,0.96,0,16,16,76
71,seq46,r_140_86_184,r_16_15_163,r_140_86_184,0.47,0,184,184,76
39,r_120_116_90,seq118,r_38_80_176,r_120_116_90,0.98,0,90,90,76
1,r_28_37_15,r_97_53_110,r_6_100_95,r_28_37_15,0.99,87,102,15,76
46,r_79_111_180,seq117,seq31,r_79_111_180,0.69,0,180,180,76
19,r_66_45_160,seq103,r_120_116_90,r_66_45_160,0.89,0,160,160,76
66,seq34,r_97_53_110,r_128_133_164,r_97_53_110,0.46,-50,60,110,76
38,r_17_23_86,r_7_9_171,r_146_105_6,r_17_23_86,0.38,85,171,86,76
39,r_120_116_90,r_38_80_176,r_66_45_160,r_120_116_90,0.6,86,176,90,76
31,r_16_15_163,seq108,seq46,r_16_15_163,0.68,0,163,163,76
41,r_97_53_110,r_102_76_87,r_128_133_164,r_102_76_87,0.92,0,87,87,76
20,r_109_125_22,r_112_40_29,r_75_142_37,r_75_142_37,0.79,-15,22,37,76
89,seq103,r_66_45_160,seq31,r_66_45_160,0.92,-4,156,160,76
3,r_77_33_61,r_65_3_174,seq108,r_77_33_61,1.0,1,62,61,76
41,r_97_53_110,r_128_133_164,seq137,r_97_53_110,0.97,0,110,110,76
5,r_95_36_16,seq48,r_21_51_36,r_95_36_16,0.46,28,44,16,76
4,r_143_67_88,r_6_100_95,seq59,r_6_100_95,1.0,0,95,95,76
73,seq48,r_66_45_160,r_13_93_122,r_13_93_122,0.59,9,131,122,76
1,r_28_37_15,r_66_45_160,r_97_53_110,r_28_37_15,0.95,1,16,15,76
13,r_128_133_164,seq34,r_10_50_45,r_10_50_45,0.85,119,164,45,76
12,r_65_3_174,seq42,seq85,r_65_3_174,0.46,5,179,174,76
6,r_104_145_130,r_38_80_176,seq118,r_104_145_130,0.9,0,130,130,76
74,seq49,seq123,r_18_139_127,r_18_139_127,1.0,4,131,127,76
15,r_122_83_43,seq41,seq118,r_122_83_43,1.0,0,43,43,76
27,r_89_43_182,seq121,r_56_26_30,r_89_43_182,0.61,0,182,182,76
48,r_56_26_30,r_135_29_51,r_89_43_182,r_89_43_182,0.98,1,183,182,76
2,r_62_141_145,seq127,r_112_40_29,r_112_40_29,0.9,120,149,29,76
10,r_112_40_29,r_73_57_94,seq2,r_112_40_29,0.98,0,29,29,76
47,r_38_80_176,r_13_93_122,r_120_116_90,r_120_116_90,0.54,22,112,90,76
74,seq49,r_101_60_65,seq123,r_101_60_65,1.0,0,65,65,76
24,r_18_139_127,seq127,seq49,r_18_139_127,0.58,0,127,127,76
25,r_73_57_94,seq147,seq54,r_73_57_94,0.99,2,96,94,76
47,r_38_80_176,r_120_116_90,r_7_9_171,r_38_80_176,1.0,0,176,176,76
48,r_56_26_30,seq47,r_135_29_51,r_56_26_30,0.52,85,115,30,76
38,r_17_23_86,seq134,r_7_9_171,r_17_23_86,0.69,3,89,86,76
33,r_21_51_36,seq48,r_95_36_16,r_95_36_16,0.99,28,44,16,76
28,r_10_50_45,seq123,seq34,r_10_50_45,0.94,0,45,45,76
34,r_90_24_139,r_132_84_168,seq81,r_90_24_139,0.8,7,146,139,76
17,r_7_9_171,seq2,r_17_23_86,r_17_23_86,0.96,2,88,86,76
94,seq118,r_96_1_172,r_122_83_43,r_122_83_43,1.0,19,62,43,76
42,r_4_71_33,seq54,seq12,r_4_71_33,1.0,0,33,33,76
9,r_138_136_161,seq25,r_135_29_51,r_138_136_161,0.3,0,161,161,76
96,seq123,seq49,r_98_63_126,r_98_63_126,1.0,5,131,126,76
28,r_10_50_45,seq34,r_128_133_164,r_128_133_164,0.79,-7,157,164,76
91,seq108,r_16_15_163,r_77_33_61,r_77_33_61,0.99,11,72,61,76
44,r_98_63_126,seq55,seq123,r_98_63_126,0.95,0,126,126,76
23,r_6_100_95,r_143_67_88,r_28_37_15,r_143_67_88,0.74,7,95,88,76
17,r_7_9_171,r_17_23_86,r_38_80_176,r_38_80_176,0.86,1,177,176,76
32,r_75_142_37,r_135_29_51,r_109_125_22,r_75_142_37,0.73,0,37,37,76
35,r_115_144_135,seq85,r_106_119_9,r_106_119_9,0.86,128,137,9,76
12,r_65_3_174,r_77_33_61,seq42,r_77_33_61,1.0,1,62,61,76
30,r_46_139_68,r_64_115_82,r_17_7_34,r_64_115_82,0.56,-14,68,82,77
36,r_73_127_151,r_112_60_127,r_45_53_152,r_112_60_127,0.75,-4,123,127,77
18,r_20_85_39,seq54,seq35,r_20_85_39,1.0,0,39,39,77
8,r_137_80_85,seq35,r_22_24_17,r_137_80_85,0.97,0,85,85,77
43,r_21_146_67,seq9,seq4,r_21_146_67,1.0,0,67,67,77
35,r_116_67_76,r_28_131_102,r_81_101_175,r_116_67_76,0.53,-15,61,76,77
37,r_118_15_90,seq3,seq25,r_118_15_90,0.71,5,95,90,77
16,r_147_13_107,r_5_68_149,r_55_108_62,r_147_13_107,0.88,0,107,107,77
21,r_28_131_102,seq33,r_36_132_1,r_28_131_102,1.0,0,102,102,77
42,r_70_71_172,seq42,r_19_87_23,r_70_71_172,0.68,2,174,172,77
6,r_76_51_49,r_77_113_97,seq126,r_76_51_49,0.99,0,49,49,77
14,r_44_128_29,r_130_107_164,r_77_113_97,r_44_128_29,0.93,80,109,29,77
14,r_44_128_29,r_64_115_82,r_130_107_164,r_64_115_82,1.0,-1,81,82,77
58,seq9,r_21_146_67,seq37,r_21_146_67,1.0,-17,50,67,77
8,r_137_80_85,r_22_24_17,r_57_66_140,r_57_66_140,0.75,0,140,140,77
5,r_39_91_25,r_118_15_90,seq110,r_39_91_25,0.72,0,25,25,77
19,r_109_89_113,seq110,r_17_7_34,r_109_89_113,0.84,0,113,113,77
1,r_124_144_18,r_96_93_63,seq82,r_124_144_18,0.99,1,19,18,77
76,seq52,r_43_117_60,seq99,r_43_117_60,0.99,-4,56,60,77
39,r_112_60_127,r_73_127_151,seq0,r_112_60_127,1.0,0,127,127,77
31,r_10_27_154,seq82,seq129,r_10_27_154,0.99,0,154,154,77
41,r_123_97_158,seq86,r_21_146_67,r_123_97_158,0.87,1,159,158,77
15,r_122_136_15,r_65_94_155,seq82,r_122_136_15,0.97,0,15,15,77
26,r_77_113_97,r_109_89_113,r_44_128_29,r_77_113_97,0.87,1,98,97,77
36,r_73_127_151,r_45_53_152,r_21_146_67,r_73_127_151,0.69,-3,148,151,77
4,r_149_61_156,seq42,r_28_131_102,r_149_61_156,0.87,0,156,156,77
99,seq126,seq56,r_76_51_49,r_76_51_49,1.0,1,50,49,77
29,r_17_7_34,r_65_94_155,seq4,r_17_7_34,0.92,0,34,34,77
11,r_88_6_86,seq37,r_103_31_50,r_88_6_86,1.0,1,87,86,77
20,r_55_108_62,r_112_60_127,seq23,r_55_108_62,0.71,0,62,62,77
48,r_43_117_60,seq52,seq35,r_43_117_60,0.99,0,60,60,77
35,r_116_67_76,r_81_101_175,seq83,r_116_67_76,0.99,0,76,76,77
27,r_121_125_109,seq92,seq38,r_121_125_109,1.0,0,109,109,77
3,r_64_115_82,r_46_139_68,r_44_128_29,r_44_128_29,0.89,-1,28,29,77
39,r_112_60_127,r_55_108_62,r_73_127_151,r_55_108_62,0.99,-4,58,62,77
40,r_81_101_175,r_96_93_63,r_22_24_17,r_22_24_17,0.48,160,177,17,77
25,r_36_132_1,r_143_102_174,r_28_131_102,r_28_131_102,1.0,12,114,102,77
33,r_145_75_135,seq23,seq99,r_145_75_135,0.91,0,135,135,77
2,r_19_87_23,r_88_6_86,seq92,r_19_87_23,1.0,-1,22,23,77
61,seq142,seq110,r_95_100_44,r_95_100_44,1.0,59,103,44,77
38,r_57_66_140,r_149_61_156,r_137_80_85,r_149_61_156,0.76,-16,140,156,77
47,r_95_100_44,r_81_101_175,seq142,r_95_100_44,1.0,-2,42,44,77
14,r_44_128_29,r_28_131_102,r_64_115_82,r_44_128_29,0.66,-1,28,29,77
9,r_134_48_12,r_88_6_86,seq78,r_134_48_12,0.98,-2,10,12,77
49,r_29_59_119,seq82,seq3,r_29_59_119,1.0,1,120,119,77
23,r_130_107_164,seq79,r_44_128_29,r_130_107_164,0.69,-116,48,164,77
7,r_84_18_142,seq0,r_88_6_86,r_84_18_142,0.78,0,142,142,77
3,r_64_115_82,r_44_128_29,seq74,r_64_115_82,1.0,0,82,82,77
44,r_5_68_149,seq38,seq1,r_5_68_149,0.85,0,149,149,77
12,r_143_102_174,r_36_132_1,r_64_115_82,r_64_115_82,0.58,92,174,82,77
23,r_130_107_164,r_44_128_29,seq90,r_130_107_164,0.77,0,164,164,77
46,r_103_31_50,r_118_15_90,seq138,r_103_31_50,0.87,-4,46,50,77
55,seq133,r_30_11_130,r_119_58_116,r_30_11_130,1.0,-9,121,130,77
36,r_19_119_177,seq85,r_86_8_94,r_86_8_94,0.67,83,177,94,78
8,r_138_46_63,r_49_103_112,seq4,r_138_46_63,0.99,0,63,63,78
53,seq4,r_132_96_126,r_64_110_79,r_132_96_126,0.84,0,126,126,78
86,seq91,r_129_50_119,seq128,r_129_50_119,1.0,0,119,119,78
5,r_113_68_65,r_98_118_184,seq139,r_113_68_65,0.88,1,66,65,78
46,r_43_23_69,seq127,seq104,r_43_23_69,0.92,0,69,69,78
32,r_25_93_179,r_72_87_24,r_113_68_65,r_25_93_179,0.58,3,182,179,78
18,r_35_99_100,r_113_68_65,r_42_2_3,r_35_99_100,0.72,-2,98,100,78
19,r_144_145_117,seq139,r_56_44_13,r_56_44_13,0.94,98,111,13,78
15,r_116_1_21,seq137,seq0,r_116_1_21,0.83,0,21,21,78
31,r_141_140_133,r_66_27_182,r_113_68_65,r_141_140_133,0.91,0,133,133,78
41,r_120_84_165,r_105_100_164,r_129_50_119,r_120_84_165,0.45,-1,164,165,78
3,r_58_28_109,seq107,seq88,r_58_28_109,0.86,2,111,109,78
49,r_130_143_49,r_144_145_117,seq76,r_130_143_49,1.0,0,49,49,78
91,seq107,r_58_28_109,r_42_2_3,r_58_28_109,0.61,-63,46,109,78
92,seq108,r_20_51_85,r_115_106_22,r_115_106_22,0.99,0,22,22,78
26,r_16_57_72,r_129_50_119,r_149_97_198,r_16_57_72,0.99,3,75,72,78
45,r_72_87_24,r_114_89_191,seq125,r_72_87_24,0.82,0,24,24,78
0,r_20_51_85,r_60_90_134,seq147,r_20_51_85,1.0,0,85,85,78
63,seq147,r_14_24_175,r_20_51_85,r_20_51_85,1.0,24,109,85,78
16,r_33_13_56,seq6,seq32,r_33_13_56,0.97,1,57,56,78
48,r_49_103_112,r_138_46_63,r_9_54_2,r_138_46_63,1.0,0,63,63,78
30,r_34_69_52,r_29_134_27,seq39,r_34_69_52,1.0,0,52,52,78
6,r_98_118_184,seq95,r_113_68_65,r_113_68_65,1.0,119,184,65,78
85,seq88,seq142,r_58_28_109,r_58_28_109,1.0,19,128,109,78
87,seq94,r_70_148_141,seq12,r_70_148_141,1.0,0,141,141,78
2,r_129_50_119,seq91,seq77,r_129_50_119,0.74,0,119,119,78
40,r_15_22_58,r_149_97_198,seq36,r_15_22_58,0.89,4,62,58,78
29,r_30_11_183,seq125,r_29_134_27,r_30_11_183,0.61,0,183,183,78
44,r_37_102_68,r_131_83_116,seq112,r_131_83_116,1.0,0,116,116,78
25,r_86_8_94,seq95,seq21,r_86_8_94,0.81,0,94,94,78
33,r_48_61_106,seq36,seq32,r_48_61_106,0.69,2,108,106,78
32,r_25_93_179,seq5,r_72_87_24,r_72_87_24,0.62,33,57,24,78
34,r_64_110_79,r_75_45_121,seq4,r_64_110_79,0.81,7,86,79,78
24,r_56_44_13,seq3,r_144_145_117,r_56_44_13,0.91,0,13,13,78
17,r_149_97_198,r_92_135_131,r_16_57_72,r_149_97_198,0.98,-64,134,198,78
9,r_73_47_185,r_111_117_84,r_16_57_72,r_16_57_72,0.77,114,186,72,78
22,r_75_45_121,r_64_110_79,seq59,r_75_45_121,0.61,-26,95,121,78
48,r_49_103_112,r_9_54_2,r_113_68_65,r_49_103_112,1.0,0,112,112,78
4,r_63_7_34,r_75_45_121,seq136,r_75_45_121,0.76,-86,35,121,78
44,r_37_102_68,r_66_27_182,r_131_83_116,r_37_102_68,0.68,0,68,68,78
23,r_92_135_131,r_149_97_198,r_116_1_21,r_92_135_131,0.61,3,134,131,78
79,seq77,seq139,r_129_50_119,r_129_50_119,0.92,16,135,119,78
35,r_105_100_164,seq107,seq3,r_105_100_164,0.54,0,164,164,78
12,r_131_83_116,seq55,r_37_102_68,r_37_102_68,0.75,3,71,68,78
5,r_113_68_65,seq139,r_49_103_112,r_49_103_112,1.0,9,121,112,78
12,r_131_83_116,r_37_102_68,r_111_117_84,r_131_83_116,1.0,0,116,116,78
36,r_61_62_186,seq58,r_120_89_116,r_120_89_116,0.68,65,181,116,79
14,r_43_17_168,seq137,r_97_123_12,r_43_17_168,0.55,3,171,168,79
8,r_126_32_188,seq36,r_84_85_96,r_84_85_96,0.7,92,188,96,79
53,seq5,r_104_50_103,seq22,r_104_50_103,0.52,62,165,103,79
91,seq106,r_121_18_82,r_112_105_130,r_112_105_130,1.0,0,130,130,79
54,seq135,seq115,r_64_30_85,r_64_30_85,1.0,11,96,85,79
37,r_44_82_198,r_43_17_168,seq102,r_43_17_168,0.97,-29,139,168,79
59,seq16,r_44_82_198,r_91_122_115,r_91_122_115,0.97,2,117,115,79
16,r_134_116_180,r_84_85_96,r_61_62_186,r_84_85_96,0.98,3,99,96,79
21,r_110_39_160,seq24,r_144_7_135,r_110_39_160,0.82,1,161,160,79
1,r_55_77_173,seq137,r_148_79_120,r_55_77_173,0.54,0,173,173,79
42,r_144_7_135,r_126_32_188,seq33,r_126_32_188,0.7,-52,136,188,79
80,seq71,r_128_25_182,seq23,r_128_25_182,0.72,-77,105,182,79
69,seq36,r_126_32_188,r_136_98_3,r_126_32_188,0.78,0,188,188,79
45,r_64_30_85,seq99,seq135,r_64_30_85,0.99,1,86,85,79
19,r_120_89_116,seq0,r_111_10_68,r_111_10_68,0.64,48,116,68,79
2,r_9_88_152,r_96_76_124,r_97_123_12,r_9_88_152,0.98,0,152,152,79
31,r_35_41_150,r_136_98_3,r_84_85_96,r_136_98_3,0.83,147,150,3,79
41,r_128_25_182,seq23,r_26_2_58,r_26_2_58,1.0,125,183,58,79
32,r_86_101_49,seq71,seq59,r_86_101_49,1.0,0,49,49,79
26,r_148_79_120,seq58,r_6_51_40,r_148_79_120,0.95,3,123,120,79
16,r_134_116_180,r_61_62_186,seq20,r_61_62_186,0.59,-4,182,186,79
4,r_136_98_3,r_35_41_150,seq22,r_35_41_150,1.0,0,150,150,79
0,r_84_85_96,r_134_116_180,r_86_101_49,r_134_116_180,0.95,-81,99,180,79
63,seq23,r_121_18_82,r_14_107_31,r_121_18_82,1.0,0,82,82,79
39,r_69_68_45,r_120_89_116,seq58,r_69_68_45,0.98,0,45,45,79
11,r_54_92_179,seq45,r_14_107_31,r_54_92_179,0.64,0,179,179,79
20,r_91_122_115,seq145,r_111_10_68,r_111_10_68,1.0,14,82,68,79
13,r_27_90_70,seq133,seq99,r_27_90_70,0.98,2,72,70,79
49,r_147_146_51,seq22,r_63_3_36,r_147_146_51,0.99,0,51,51,79
15,r_38_119_194,r_54_92_179,seq45,r_54_92_179,0.82,0,179,179,79
0,r_84_85_96,r_86_101_49,r_35_41_150,r_35_41_150,1.0,2,152,150,79
57,seq142,r_15_40_193,r_13_21_63,r_13_21_63,1.0,32,95,63,79
3,r_94_75_35,seq135,seq114,r_94_75_35,0.78,4,39,35,79
48,r_139_140_10,r_70_81_185,seq142,r_139_140_10,0.57,0,10,10,79
2,r_9_88_152,r_54_92_179,r_96_76_124,r_96_76_124,1.0,8,132,124,79
46,r_6_51_40,r_35_41_150,seq72,r_6_51_40,1.0,0,40,40,79
17,r_141_131_18,seq78,seq42,r_141_131_18,1.0,-1,17,18,79
24,r_104_50_103,r_53_52_156,seq20,r_104_50_103,0.55,16,119,103,79
25,r_111_10_68,seq95,seq83,r_111_10_68,1.0,3,71,68,79
33,r_118_73_164,seq95,r_26_2_58,r_118_73_164,0.72,0,164,164,79
61,seq20,r_74_127_155,r_104_50_103,r_74_127_155,0.81,-1,154,155,79
28,r_66_129_34,r_96_76_124,seq1,r_66_129_34,0.81,0,34,34,79
77,seq58,r_128_25_182,r_69_68_45,r_69_68_45,0.91,59,104,45,79
91,seq106,seq114,r_121_18_82,r_121_18_82,0.64,13,95,82,79
27,r_26_2_58,r_84_85_96,seq36,r_26_2_58,0.93,0,58,58,79
34,r_130_138_158,r_53_52_156,r_35_41_150,r_53_52_156,0.99,0,156,156,79
81,seq72,seq67,r_6_51_40,r_6_51_40,1.0,71,111,40,79
5,r_97_123_12,r_96_76_124,seq37,r_97_123_12,0.75,8,20,12,79
9,r_96_76_124,seq42,seq95,r_96_76_124,0.64,0,124,124,79
18,r_63_3_36,seq28,r_147_146_51,r_63_3_36,0.92,17,53,36,79
22,r_12_60_161,seq132,r_147_146_51,r_12_60_161,0.62,2,163,161,79
56,seq137,r_43_17_168,r_91_122_115,r_91_122_115,0.51,56,171,115,79
7,r_13_21_63,r_91_122_115,seq142,r_13_21_63,1.0,0,63,63,79
23,r_112_105_130,seq87,seq106,r_112_105_130,0.99,1,131,130,79
35,r_53_52_156,r_130_138_158,r_121_18_82,r_53_52_156,0.88,0,156,156,79
20,r_91_122_115,r_111_10_68,seq16,r_91_122_115,1.0,0,115,115,79
2,r_9_88_152,r_15_40_193,r_54_92_179,r_9_88_152,0.5,-107,45,152,79
30,r_62_46_140,r_22_75_167,r_71_95_47,r_62_46_140,0.9,-3,137,140,80
46,r_23_80_53,r_141_24_28,r_7_15_8,r_23_80_53,0.55,-35,18,53,80
36,r_0_102_135,seq63,r_70_44_108,r_0_102_135,0.99,5,140,135,80
9,r_81_17_153,r_23_80_53,seq60,r_81_17_153,0.63,0,153,153,80
54,seq137,seq105,r_149_85_51,r_149_85_51,1.0,7,58,51,80
14,r_138_108_180,seq60,r_25_129_18,r_25_129_18,0.93,167,185,18,80
37,r_123_37_144,seq65,r_25_129_18,r_25_129_18,0.54,127,145,18,80
49,r_39_128_54,seq67,seq127,r_39_128_54,1.0,1,55,54,80
16,r_134_136_63,r_57_18_92,seq36,r_57_18_92,0.68,-24,68,92,80
39,r_133_139_165,r_126_64_194,r_89_11_114,r_89_11_114,0.82,4,118,114,80
1,r_145_41_142,seq124,seq74,r_145_41_142,0.95,0,142,142,80
13,r_71_95_47,r_126_64_194,seq48,r_71_95_47,0.97,1,48,47,80
9,r_81_17_153,r_3_103_41,r_23_80_53,r_81_17_153,0.71,-136,17,153,80
19,r_57_18_92,seq74,seq68,r_57_18_92,0.99,0,92,92,80
52,seq6,r_23_80_53,r_92_35_40,r_92_35_40,1.0,0,40,40,80
41,r_125_110_38,seq12,seq94,r_125_110_38,1.0,-1,37,38,80
44,r_14_50_48,seq12,r_142_122_9,r_14_50_48,1.0,0,48,48,80
45,r_141_24_28,seq6,r_33_30_147,r_141_24_28,0.98,0,28,28,80
31,r_70_44_108,seq54,seq45,r_70_44_108,0.88,0,108,108,80
3,r_31_131_179,r_109_78_192,r_142_122_9,r_31_131_179,0.61,0,179,179,80
10,r_32_120_161,r_146_66_152,seq63,r_32_120_161,0.61,0,161,161,80
40,r_89_11_114,r_133_139_165,r_86_27_151,r_133_139_165,0.95,6,171,165,80
26,r_98_20_82,seq99,r_1_111_11,r_98_20_82,0.82,-2,80,82,80
11,r_3_103_41,r_40_47_134,seq105,r_3_103_41,1.0,0,41,41,80
72,seq63,r_0_102_135,r_7_15_8,r_0_102_135,0.84,6,141,135,80
78,seq76,r_117_38_103,seq91,r_117_38_103,1.0,3,106,103,80
31,r_70_44_108,seq45,r_0_102_135,r_0_102_135,0.62,13,148,135,80
98,seq124,r_145_41_142,seq54,r_145_41_142,1.0,0,142,142,80
15,r_40_47_134,r_81_17_153,r_3_103_41,r_40_47_134,0.64,7,141,134,80
48,r_52_72_62,seq83,seq60,r_52_72_62,1.0,0,62,62,80
21,r_149_85_51,seq48,seq137,r_149_85_51,0.75,2,53,51,80
39,r_133_139_165,r_89_11_114,r_7_15_8,r_133_139_165,0.84,6,171,165,80
85,seq91,r_89_11_114,seq76,r_89_11_114,0.92,4,118,114,80
47,r_1_111_11,r_133_139_165,seq100,r_1_111_11,1.0,-1,10,11,80
12,r_25_129_18,seq36,seq87,r_25_129_18,0.95,0,18,18,80
27,r_22_75_167,seq51,r_119_143_90,r_119_143_90,0.8,86,176,90,80
87,seq99,r_98_20_82,r_90_140_84,r_90_140_84,0.99,0,84,84,80
40,r_89_11_114,seq91,r_133_139_165,r_89_11_114,0.77,4,118,114,80
18,r_119_143_90,seq104,seq84,r_119_143_90,0.54,-2,88,90,80
29,r_86_27_151,seq26,r_89_11_114,r_86_27_151,0.56,1,152,151,80
33,r_113_59_172,r_31_131_179,r_34_9_118,r_31_131_179,0.88,-3,176,179,80
73,seq65,r_34_9_118,r_21_53_35,r_21_53_35,1.0,0,35,35,80
20,r_7_15_8,r_81_17_153,seq82,r_81_17_153,0.78,0,153,153,80
68,seq54,r_70_44_108,seq124,r_70_44_108,1.0,0,108,108,80
32,r_146_66_152,r_97_56_160,r_16_88_155,r_16_88_155,0.64,5,160,155,80
23,r_33_30_147,seq67,r_141_24_28,r_141_24_28,1.0,15,43,28,80
75,seq68,r_148_58_105,r_57_18_92,r_57_18_92,0.96,15,107,92,80
45,r_141_24_28,r_33_30_147,seq67,r_33_30_147,1.0,-31,116,147,80
17,r_28_5_177,seq114,seq91,r_28_5_177,0.52,0,177,177,80
65,seq48,seq2,r_71_95_47,r_71_95_47,1.0,3,50,47,80
22,r_148_58_105,seq68,seq127,r_148_58_105,0.84,2,107,105,80
28,r_10_4_176,seq79,r_93_8_122,r_10_4_176,0.72,0,176,176,80
91,seq105,seq137,r_3_103_41,r_3_103_41,1.0,6,47,41,80
8,r_96_130_20,r_34_9_118,seq60,r_96_130_20,0.77,0,20,20,80
84,seq87,seq94,r_25_129_18,r_25_129_18,1.0,1,19,18,80
34,r_21_53_35,r_145_41_142,seq144,r_21_53_35,1.0,0,35,35,80
55,seq12,r_125_110_38,r_126_64_194,r_125_110_38,0.66,-18,20,38,80
77,seq74,r_121_107_1,r_145_41_142,r_145_41_142,0.93,9,151,142,80
7,r_92_35_40,seq135,seq6,r_92_35_40,1.0,0,40,40,80
23,r_33_30_147,r_141_24_28,r_25_129_18,r_33_30_147,0.86,0,147,147,80
44,r_113_148_169,r_27_55_43,seq95,r_113_148_169,0.22,-2,167,169,81
36,r_20_47_108,seq0,r_19_108_80,r_20_47_108,0.57,0,108,108,81
92,seq146,r_123_117_95,seq10,r_123_117_95,1.0,1,96,95,81
14,r_51_59_104,seq15,r_30_14_68,r_51_59_104,1.0,3,107,104,81
83,seq80,r_78_145_86,seq136,r_78_145_86,1.0,0,86,86,81
37,r_125_25_1,r_98_147_96,r_21_139_98,r_125_25_1,0.58,96,97,1,81
55,seq134,seq132,r_36_49_59,r_36_49_59,1.0,2,61,59,81
16,r_133_76_143,r_23_33_184,r_16_7_4,r_133_76_143,0.72,0,143,143,81
1,r_38_86_136,seq15,r_20_47_108,r_38_86_136,0.61,-1,135,136,81
46,r_123_117_95,seq146,seq116,r_123_117_95,1.0,1,96,95,81
80,seq68,r_93_34_67,r_104_37_51,r_104_37_51,0.99,21,72,51,81
29,r_60_127_93,r_88_106_144,seq17,r_88_106_144,0.96,-10,134,144,81
45,r_98_147_96,r_125_25_1,r_120_143_195,r_98_147_96,1.0,1,97,96,81
19,r_122_2_118,seq110,r_45_41_47,r_122_2_118,0.98,0,118,118,81
39,r_45_41_47,seq91,seq53,r_45_41_47,1.0,0,47,47,81
20,r_27_55_43,r_21_139_98,r_23_33_184,r_27_55_43,0.82,0,43,43,81
40,r_75_85_28,r_4_107_126,seq1,r_75_85_28,0.96,1,29,28,81
31,r_87_61_129,seq46,r_27_55_43,r_87_61_129,0.99,1,130,129,81
67,seq22,seq62,r_141_114_138,r_141_114_138,0.99,5,143,138,81
10,r_29_94_13,r_19_108_80,seq144,r_29_94_13,0.93,0,13,13,81
3,r_32_44_64,seq67,r_137_74_22,r_32_44_64,1.0,4,68,64,81
43,r_97_57_26,r_123_117_95,seq1,r_123_117_95,0.95,-66,29,95,81
90,seq95,r_69_100_69,seq128,r_69_100_69,1.0,23,92,69,81
44,r_113_148_169,r_23_33_184,r_27_55_43,r_27_55_43,0.68,-24,19,43,81
33,r_101_83_15,r_122_2_118,r_118_3_137,r_101_83_15,0.97,-2,13,15,81
26,r_24_50_78,seq95,r_137_74_22,r_24_50_78,1.0,0,78,78,81
4,r_89_31_71,seq18,seq26,r_89_31_71,1.0,1,72,71,81
0,r_109_65_33,seq18,r_102_9_41,r_102_9_41,1.0,41,82,41,81
11,r_52_124_141,seq64,r_24_50_78,r_52_124_141,0.73,0,141,141,81
2,r_88_106_144,r_60_127_93,seq64,r_88_106_144,0.96,0,144,144,81
8,r_104_37_51,r_88_106_144,seq68,r_104_37_51,1.0,0,51,51,81
5,r_23_33_184,r_27_55_43,seq17,r_23_33_184,0.71,0,184,184,81
34,r_141_114_138,seq121,seq22,r_141_114_138,1.0,3,141,138,81
2,r_88_106_144,seq126,r_60_127_93,r_60_127_93,0.93,1,94,93,81
74,seq128,seq95,r_54_138_122,r_54_138_122,0.73,12,134,122,81
18,r_21_139_98,r_141_114_138,r_125_25_1,r_21_139_98,0.78,0,98,98,81
29,r_60_127_93,r_123_117_95,r_88_106_144,r_60_127_93,0.84,0,93,93,81
24,r_30_14_68,r_78_145_86,r_101_83_15,r_101_83_15,1.0,53,68,15,81
64,seq17,r_120_143_195,seq110,r_120_143_195,0.73,-53,142,195,81
5,r_23_33_184,r_133_76_143,r_27_55_43,r_23_33_184,0.84,-140,44,184,81
25,r_66_58_58,seq46,seq140,r_66_58_58,1.0,0,58,58,81
20,r_27_55_43,r_23_33_184,r_87_61_129,r_87_61_129,0.98,55,184,129,81
38,r_39_103_61,r_89_31_71,seq67,r_89_31_71,0.66,-1,70,71,81
36,r_20_47_108,r_19_108_80,r_38_86_136,r_38_86_136,0.97,1,137,136,81
47,r_36_49_59,seq5,seq134,r_36_49_59,1.0,0,59,59,81
17,r_69_100_69,seq95,seq91,r_69_100_69,0.63,8,77,69,81
9,r_19_108_80,seq53,seq119,r_19_108_80,1.0,0,80,80,81
35,r_42_130_35,seq134,seq115,r_42_130_35,0.99,0,35,35,81
26,r_24_50_78,r_137_74_22,r_52_124_141,r_52_124_141,1.0,21,162,141,81
22,r_99_111_128,seq116,seq136,r_99_111_128,0.96,2,130,128,81
51,seq1,seq71,r_75_85_28,r_75_85_28,0.98,16,44,28,81
7,r_120_143_195,seq17,r_98_147_96,r_98_147_96,1.0,6,102,96,81
48,r_102_9_41,r_120_143_195,r_109_65_33,r_102_9_41,1.0,1,42,41,81
12,r_54_138_122,seq67,seq128,r_54_138_122,0.68,1,123,122,81
93,seq111,r_10_103_166,r_15_105_88,r_15_105_88,1.0,78,166,88,82
7,r_102_113_18,seq134,seq118,r_102_113_18,1.0,0,18,18,82
40,r_73_85_160,r_42_147_180,r_33_31_177,r_73_85_160,0.98,20,180,160,82
30,r_109_63_184,r_73_85_160,r_6_87_19,r_73_85_160,0.53,24,184,160,82
51,seq132,r_129_106_97,seq1,r_129_106_97,1.0,-18,79,97,82
36,r_129_106_97,r_32_127_131,seq57,r_129_106_97,0.96,1,98,97,82
16,r_115_5_51,seq13,r_73_85_160,r_115_5_51,0.99,4,55,51,82
92,seq107,seq76,r_73_85_160,r_73_85_160,0.49,-96,64,160,82
14,r_144_23_152,r_114_66_196,seq54,r_144_23_152,0.39,0,152,152,82
8,r_70_130_172,seq3,r_49_137_146,r_70_130_172,0.71,0,172,172,82
44,r_94_135_139,seq122,r_89_67_175,r_89_67_175,0.96,-2,173,175,82
54,seq133,r_136_20_174,r_27_39_79,r_27_39_79,1.0,12,91,79,82
37,r_59_138_133,seq50,r_27_39_79,r_59_138_133,0.91,0,133,133,82
21,r_22_119_159,r_144_23_152,r_12_18_31,r_22_119_159,0.6,0,159,159,82
1,r_27_39_79,seq58,seq133,r_27_39_79,1.0,0,79,79,82
46,r_84_46_117,r_73_85_160,r_6_87_19,r_84_46_117,0.99,0,117,117,82
45,r_125_55_119,seq51,seq11,r_125_55_119,0.96,0,119,119,82
19,r_60_120_80,seq122,seq48,r_60_120_80,1.0,0,80,80,82
9,r_78_110_165,r_62_21_190,r_33_31_177,r_62_21_190,0.73,0,190,190,82
31,r_28_90_158,seq37,r_15_105_88,r_15_105_88,1.0,73,161,88,82
41,r_30_61_185,r_40_139_3,seq104,r_30_61_185,0.28,0,185,185,82
89,seq97,r_91_52_183,r_136_20_174,r_136_20_174,0.85,12,186,174,82
3,r_140_16_193,seq13,r_143_24_9,r_143_24_9,0.98,14,23,9,82
10,r_141_47_76,seq4,r_126_108_2,r_141_47_76,1.0,0,76,76,82
39,r_45_35_10,r_70_130_172,seq25,r_45_35_10,0.58,0,10,10,82
26,r_32_127_131,seq1,seq92,r_32_127_131,0.95,0,131,131,82
4,r_77_148_141,seq56,seq17,r_77_148_141,0.64,0,141,141,82
0,r_62_21_190,r_109_63_184,r_78_110_165,r_78_110_165,0.6,0,165,165,82
63,seq25,seq82,r_45_35_10,r_45_35_10,0.69,118,128,10,82
20,r_0_43_198,r_33_31_177,r_26_86_33,r_0_43_198,0.63,-23,175,198,82
13,r_15_105_88,r_64_128_191,seq65,r_15_105_88,1.0,0,88,88,82
15,r_33_31_177,r_0_43_198,r_73_85_160,r_73_85_160,0.76,15,175,160,82
6,r_71_83_154,seq146,seq17,r_71_83_154,0.5,0,154,154,82
48,r_116_19_59,r_125_55_119,seq74,r_116_19_59,1.0,0,59,59,82
2,r_136_20_174,r_64_128_191,seq97,r_136_20_174,0.67,0,174,174,82
40,r_73_85_160,r_84_46_117,r_42_147_180,r_84_46_117,1.0,0,117,117,82
18,r_126_108_2,seq134,r_141_47_76,r_141_47_76,1.0,21,97,76,82
29,r_100_53_81,seq57,r_12_18_31,r_100_53_81,0.66,7,88,81,82
0,r_62_21_190,r_78_110_165,r_70_130_172,r_62_21_190,0.89,0,190,190,82
33,r_68_101_128,seq88,r_73_85_160,r_68_101_128,0.99,0,128,128,82
50,seq1,r_32_127_131,r_40_139_3,r_32_127_131,1.0,0,131,131,82
61,seq146,r_71_83_154,r_26_86_33,r_26_86_33,0.61,121,154,33,82
32,r_7_75_151,r_89_67_175,r_68_101_128,r_7_75_151,0.96,0,151,151,82
34,r_40_139_3,r_89_67_175,seq1,r_40_139_3,0.43,172,175,3,82
60,seq17,r_140_16_193,r_71_83_154,r_71_83_154,0.67,7,161,154,82
9,r_78_110_165,r_8_44_142,r_62_21_190,r_8_44_142,0.66,23,165,142,82
22,r_80_112_150,r_12_18_31,r_143_24_9,r_12_18_31,0.85,119,150,31,82
5,r_6_87_19,r_71_83_154,r_8_44_142,r_6_87_19,1.0,0,19,19,82
49,r_91_52_183,seq97,r_144_23_152,r_144_23_152,0.67,34,186,152,82
44,r_94_135_139,r_77_148_141,seq122,r_77_148_141,0.72,-2,139,141,82
23,r_145_36_157,seq93,seq50,r_145_36_157,0.63,1,158,157,82
38,r_26_86_33,r_140_16_193,seq146,r_26_86_33,0.89,0,33,33,82
79,seq74,seq96,r_116_19_59,r_116_19_59,1.0,28,87,59,82
35,r_89_67_175,r_40_139_3,r_94_135_139,r_40_139_3,0.55,172,175,3,82
12,r_42_147_180,r_73_85_160,r_26_86_33,r_26_86_33,0.94,147,180,33,82
86,seq92,r_102_113_18,r_32_127_131,r_32_127_131,0.97,4,135,131,82
8,r_70_16_38,r_68_19_134,seq131,r_70_16_38,1.0,1,39,38,83
40,r_0_55_58,seq44,r_112_61_34,r_0_55_58,0.89,0,58,58,83
14,r_79_63_125,r_114_149_142,r_132_75_66,r_132_75_66,1.0,59,125,66,83
43,r_147_15_89,seq6,seq22,r_147_15_89,1.0,0,89,89,83
37,r_103_141_105,r_130_34_140,seq76,r_103_141_105,1.0,0,105,105,83
21,r_95_85_166,seq69,seq101,r_95_85_166,0.41,0,166,166,83
39,r_98_58_124,r_80_73_123,seq144,r_98_58_124,0.71,-1,123,124,83
5,r_124_86_177,seq137,seq56,r_124_86_177,0.47,0,177,177,83
32,r_33_46_30,seq17,r_132_75_66,r_33_46_30,0.52,3,33,30,83
45,r_30_29_94,seq108,seq14,r_30_29_94,1.0,-43,51,94,83
33,r_28_36_57,seq13,r_1_20_4,r_28_36_57,1.0,0,57,57,83
3,r_53_104_76,seq140,seq97,r_53_104_76,1.0,1,77,76,83
10,r_138_54_173,r_117_74_187,r_118_113_151,r_138_54_173,0.68,8,181,173,83
90,seq101,r_1_20_4,r_95_85_166,r_95_85_166,0.9,7,173,166,83
4,r_68_19_134,seq108,r_10_40_102,r_68_19_134,0.92,0,134,134,83
0,r_125_59_121,seq145,seq129,r_125_59_121,0.79,0,121,121,83
11,r_102_128_131,r_124_86_177,seq108,r_102_128_131,0.97,0,131,131,83
22,r_21_81_52,seq101,seq110,r_21_81_52,0.99,1,53,52,83
46,r_4_136_43,seq27,seq142,r_4_136_43,1.0,0,43,43,83
20,r_35_49_141,seq99,r_79_63_125,r_35_49_141,0.8,1,142,141,83
13,r_118_113_151,seq122,seq108,r_118_113_151,0.83,0,151,151,83
78,seq72,r_124_86_177,r_52_12_49,r_52_12_49,1.0,7,56,49,83
15,r_117_74_187,r_138_54_173,r_124_86_177,r_117_74_187,0.61,1,188,187,83
6,r_80_73_123,r_98_58_124,r_87_60_9,r_80_73_123,0.75,0,123,123,83
62,seq144,seq13,r_98_58_124,r_98_58_124,0.8,9,133,124,83
85,seq93,seq23,r_9_24_155,r_9_24_155,0.98,1,156,155,83
42,r_112_61_34,seq8,seq144,r_112_61_34,0.99,2,36,34,83
27,r_3_139_185,seq119,r_37_115_24,r_3_139_185,0.57,0,185,185,83
35,r_52_12_49,seq101,seq72,r_52_12_49,1.0,0,49,49,83
2,r_71_127_92,r_80_73_123,r_48_121_16,r_71_127_92,0.88,0,92,92,83
24,r_10_40_102,r_118_113_151,seq133,r_10_40_102,0.98,0,102,102,83
25,r_9_24_155,r_95_85_166,seq93,r_9_24_155,0.83,3,158,155,83
18,r_37_115_24,r_146_109_56,seq17,r_37_115_24,0.71,-10,14,24,83
88,seq97,r_68_19_134,seq145,r_68_19_134,0.94,-27,107,134,83
58,seq140,r_64_134_171,r_79_63_125,r_79_63_125,0.97,46,171,125,83
68,seq39,r_123_2_112,r_132_75_66,r_123_2_112,0.98,0,112,112,83
44,r_82_65_17,r_71_127_92,seq23,r_82_65_17,0.85,9,26,17,83
1,r_146_109_56,r_18_66_81,seq105,r_146_109_56,1.0,0,56,56,83
38,r_26_62_80,seq90,r_52_12_49,r_52_12_49,1.0,31,80,49,83
52,seq133,r_91_148_175,r_10_40_102,r_10_40_102,0.99,73,175,102,83
60,seq14,r_45_32_157,r_30_29_94,r_30_29_94,0.57,63,157,94,83
81,seq142,seq11,r_4_136_43,r_4_136_43,0.99,61,104,43,83
17,r_1_20_4,seq101,r_28_36_57,r_28_36_57,1.0,14,71,57,83
29,r_5_84_42,r_31_111_190,r_51_100_199,r_5_84_42,1.0,0,42,42,83
26,r_89_77_18,r_130_34_140,r_18_66_81,r_89_77_18,0.96,109,127,18,83
96,seq119,r_3_139_185,seq137,r_3_139_185,0.63,0,185,185,83
26,r_89_77_18,r_33_46_30,r_130_34_140,r_89_77_18,0.67,0,18,18,83
28,r_31_111_190,seq78,r_146_109_56,r_146_109_56,1.0,134,190,56,83
91,seq145,r_125_59_121,seq97,r_125_59_121,0.98,-2,119,121,83
49,r_91_148_175,seq133,r_52_12_49,r_52_12_49,0.93,126,175,49,83
56,seq137,r_124_86_177,seq67,r_124_86_177,0.86,-19,158,177,83
7,r_135_83_90,seq90,seq143,r_135_83_90,1.0,0,90,90,83
23,r_116_38_100,seq41,seq93,r_116_38_100,0.96,1,101,100,83
79,seq76,seq22,r_103_141_105,r_103_141_105,1.0,18,123,105,83
12,r_18_66_81,r_114_149_142,r_89_77_18,r_18_66_81,0.61,0,81,81,83
93,seq112,seq93,r_13_50_78,r_13_50_78,1.0,29,107,78,84
36,r_70_23_61,r_140_64_153,seq39,r_70_23_61,1.0,0,61,61,84
14,r_71_37_47,seq146,seq89,r_71_37_47,0.88,14,61,47,84
8,r_138_82_84,seq97,seq55,r_138_82_84,1.0,1,85,84,84
43,r_48_101_124,r_41_56_197,r_70_23_61,r_70_23_61,0.99,63,124,61,84
39,r_14_129_76,seq7,r_51_86_93,r_14_129_76,1.0,2,78,76,84
1,r_143_114_112,r_26_78_191,seq146,r_143_114_112,1.0,0,112,112,84
5,r_148_72_65,r_111_132_131,r_110_36_52,r_148_72_65,1.0,1,66,65,84
46,r_8_134_62,r_88_127_104,seq49,r_8_134_62,1.0,0,62,62,84
42,r_94_92_177,r_131_125_115,r_6_9_23,r_94_92_177,0.98,-62,115,177,84
7,r_88_127_104,r_71_37_47,r_143_114_112,r_143_114_112,1.0,12,124,112,84
21,r_61_73_35,r_80_142_96,r_141_47_127,r_61_73_35,0.98,1,36,35,84
45,r_21_77_180,seq100,r_111_132_131,r_21_77_180,0.54,0,180,180,84
19,r_18_12_86,seq118,r_61_73_35,r_18_12_86,1.0,0,86,86,84
18,r_120_17_68,r_69_53_8,seq93,r_120_17_68,1.0,0,68,68,84
31,r_128_38_111,r_119_59_170,seq76,r_128_38_111,1.0,0,111,111,84
41,r_90_29_135,seq149,seq79,r_90_29_135,0.88,0,135,135,84
25,r_69_53_8,r_71_37_47,r_90_29_135,r_69_53_8,0.93,9,17,8,84
3,r_13_50_78,r_26_78_191,seq112,r_13_50_78,1.0,0,78,78,84
10,r_131_125_115,r_94_92_177,seq74,r_131_125_115,1.0,0,115,115,84
26,r_136_11_121,seq39,seq93,r_136_11_121,1.0,0,121,121,84
4,r_16_145_186,seq28,r_111_132_131,r_16_145_186,0.45,-3,183,186,84
49,r_26_78_191,r_41_56_197,r_120_17_68,r_26_78_191,0.71,-37,154,191,84
15,r_80_142_96,seq93,r_106_33_21,r_80_142_96,1.0,0,96,96,84
40,r_95_35_67,r_98_65_103,r_144_103_88,r_98_65_103,1.0,0,103,103,84
6,r_111_132_131,seq107,seq20,r_111_132_131,0.55,10,141,131,84
62,seq28,r_16_145_186,r_140_64_153,r_16_145_186,0.57,-3,183,186,84
21,r_61_73_35,r_141_47_127,seq43,r_141_47_127,0.99,0,127,127,84
25,r_69_53_8,r_8_134_62,seq122,r_69_53_8,0.62,154,162,8,84
87,seq93,r_139_25_181,r_120_17_68,r_120_17_68,1.0,114,182,68,84
2,r_144_103_88,r_68_1_173,r_131_125_115,r_131_125_115,1.0,58,173,115,84
47,r_116_15_59,r_126_45_162,seq57,r_116_15_59,1.0,3,62,59,84
30,r_110_36_52,r_71_37_47,seq124,r_110_36_52,0.85,-1,51,52,84
40,r_95_35_67,seq49,r_98_65_103,r_95_35_67,0.97,0,67,67,84
74,seq57,seq62,r_116_15_59,r_116_15_59,1.0,55,114,59,84
33,r_42_137_137,seq3,r_109_96_60,r_42_137_137,1.0,0,137,137,84
48,r_141_47_127,r_61_73_35,r_148_72_65,r_141_47_127,1.0,0,127,127,84
58,seq20,r_126_45_162,r_111_132_131,r_126_45_162,0.54,1,163,162,84
32,r_98_65_103,r_95_35_67,seq89,r_98_65_103,1.0,0,103,103,84
32,r_98_65_103,r_68_1_173,r_95_35_67,r_95_35_67,1.0,1,68,67,84
38,r_68_1_173,seq74,r_143_114_112,r_68_1_173,0.83,0,173,173,84
34,r_10_27_95,seq108,r_148_72_65,r_148_72_65,1.0,31,96,65,84
25,r_69_53_8,r_90_29_135,r_8_134_62,r_69_53_8,0.46,68,76,8,84
24,r_91_123_14,r_42_137_137,seq118,r_91_123_14,0.97,-1,13,14,84
18,r_120_17_68,seq49,r_69_53_8,r_69_53_8,0.66,5,13,8,84
27,r_133_4_55,seq147,seq7,r_133_4_55,1.0,2,57,55,84
13,r_6_9_23,r_144_103_88,seq149,r_6_9_23,1.0,0,23,23,84
22,r_63_83_132,seq146,r_91_123_14,r_63_83_132,0.49,-18,114,132,84
28,r_105_46_149,r_106_33_21,seq100,r_105_46_149,0.85,3,152,149,84
49,r_26_78_191,r_143_114_112,r_41_56_197,r_26_78_191,0.91,-79,112,191,84
7,r_88_127_104,r_8_134_62,r_71_37_47,r_8_134_62,1.0,0,62,62,84
48,r_141_47_127,seq43,r_61_73_35,r_61_73_35,1.0,7,42,35,84
44,r_119_59_170,seq7,r_90_29_135,r_90_29_135,0.64,35,170,135,84
23,r_126_45_162,seq20,seq44,r_126_45_162,0.61,1,163,162,84
79,seq74,r_68_1_173,r_131_125_115,r_131_125_115,0.99,58,173,115,84
12,r_51_86_93,seq60,r_14_129_76,r_14_129_76,0.99,17,93,76,84
42,r_94_92_177,r_6_9_23,r_8_134_62,r_94_92_177,0.86,-11,166,177,84
40,r_117_6_90,r_18_63_185,r_47_66_94,r_18_63_185,0.8,-1,184,185,85
51,seq129,r_125_28_167,r_69_46_160,r_69_46_160,0.74,5,165,160,85
26,r_68_82_45,seq64,r_84_107_157,r_68_82_45,1.0,0,45,45,85
92,seq103,r_5_41_152,r_138_94_33,r_5_41_152,1.0,0,152,152,85
37,r_88_116_108,r_23_57_178,seq83,r_88_116_108,1.0,0,108,108,85
16,r_69_46_160,seq86,seq127,r_69_46_160,0.76,0,160,160,85
21,r_78_134_67,r_21_98_190,seq142,r_78_134_67,1.0,0,67,67,85
39,r_23_57_178,r_20_53_4,seq36,r_23_57_178,0.55,0,178,178,85
34,r_148_14_40,seq44,seq86,r_148_14_40,1.0,2,42,40,85
1,r_145_139_70,r_18_63_185,seq95,r_145_139_70,1.0,0,70,70,85
46,r_136_15_101,seq129,r_117_6_90,r_136_15_101,0.93,0,101,101,85
42,r_124_40_105,r_20_53_4,r_50_10_31,r_124_40_105,1.0,0,105,105,85
45,r_104_133_60,r_39_122_127,seq62,r_104_133_60,1.0,0,60,60,85
19,r_9_118_64,r_69_46_160,seq72,r_9_118_64,1.0,0,64,64,85
48,r_131_58_34,r_112_8_75,seq59,r_112_8_75,0.7,-36,39,75,85
27,r_50_10_31,r_37_99_156,r_124_40_105,r_50_10_31,0.99,72,103,31,85
31,r_18_63_185,r_145_139_70,r_73_52_187,r_145_139_70,0.99,0,70,70,85
86,seq93,seq95,r_101_87_7,r_101_87_7,0.61,37,44,7,85
3,r_37_99_156,r_2_74_2,r_9_118_64,r_2_74_2,0.91,154,156,2,85
90,seq100,r_73_52_187,r_47_66_94,r_47_66_94,1.0,40,134,94,85
14,r_126_128_12,r_21_98_190,seq77,r_21_98_190,0.62,-105,85,190,85
4,r_5_41_152,r_138_94_33,r_112_8_75,r_138_94_33,0.92,119,152,33,85
0,r_47_66_94,seq142,seq100,r_47_66_94,1.0,0,94,94,85
11,r_17_19_121,seq127,r_124_40_105,r_17_19_121,0.95,0,121,121,85
15,r_39_122_127,r_115_106_186,r_135_48_54,r_39_122_127,0.81,5,132,127,85
69,seq43,seq72,r_89_49_32,r_89_49_32,1.0,2,34,32,85
31,r_18_63_185,r_117_6_90,r_138_94_33,r_18_63_185,0.71,-1,184,185,85
6,r_21_98_190,r_16_80_170,r_126_128_12,r_21_98_190,0.54,-19,171,190,85
31,r_18_63_185,r_73_52_187,r_117_6_90,r_117_6_90,0.94,1,91,90,85
10,r_141_119_72,r_101_87_7,seq142,r_141_119_72,0.98,0,72,72,85
17,r_33_113_49,seq35,seq96,r_33_113_49,1.0,0,49,49,85
35,r_24_105_44,r_136_15_101,seq86,r_24_105_44,0.99,4,48,44,85
87,seq95,r_146_26_77,r_145_139_70,r_145_139_70,1.0,3,73,70,85
40,r_117_6_90,seq12,r_18_63_185,r_117_6_90,0.8,0,90,90,85
29,r_42_67_139,r_16_80_170,r_68_82_45,r_68_82_45,0.96,96,141,45,85
27,r_50_10_31,r_125_28_167,r_37_99_156,r_50_10_31,0.99,1,32,31,85
36,r_89_49_32,seq96,seq43,r_89_49_32,1.0,2,34,32,85
24,r_149_45_150,seq0,seq12,r_149_45_150,0.86,0,150,150,85
25,r_111_55_188,seq120,r_145_139_70,r_111_55_188,0.32,1,189,188,85
33,r_1_61_85,r_21_98_190,r_135_48_54,r_1_61_85,0.53,0,85,85,85
47,r_101_87_7,r_141_119_72,r_145_139_70,r_145_139_70,0.99,2,72,70,85
58,seq142,r_47_66_94,r_141_119_72,r_47_66_94,0.94,0,94,94,85
32,r_16_80_170,r_21_98_190,r_47_66_94,r_47_66_94,0.9,77,171,94,85
77,seq72,seq43,r_9_118_64,r_9_118_64,1.0,42,106,64,85
30,r_7_147_15,r_84_107_157,seq29,r_7_147_15,0.7,0,15,15,85
6,r_21_98_190,r_126_128_12,r_146_26_77,r_21_98_190,0.89,0,190,190,85
14,r_126_128_12,r_88_116_108,r_21_98_190,r_126_128_12,0.99,0,12,12,85
26,r_68_82_45,r_84_107_157,r_42_67_139,r_68_82_45,0.83,112,157,45,85
28,r_81_143_147,seq59,r_20_53_4,r_81_143_147,0.93,0,147,147,85
49,r_76_38_88,r_39_122_127,seq30,r_76_38_88,0.99,1,89,88,85
7,r_130_54_172,seq109,r_145_139_70,r_145_139_70,1.0,104,174,70,85
23,r_34_51_138,r_37_99_156,r_71_75_27,r_34_51_138,0.96,-7,131,138,85
82,seq86,r_69_46_160,r_24_105_44,r_24_105_44,0.88,84,128,44,85
71,seq59,r_81_143_147,r_135_48_54,r_135_48_54,0.87,5,59,54,85
81,seq83,r_85_56_52,r_88_116_108,r_88_116_108,1.0,2,110,108,85
44,r_71_75_27,r_84_107_157,r_146_26_77,r_71_75_27,1.0,1,28,27,85
38,r_135_48_54,seq25,seq59,r_135_48_54,1.0,3,57,54,85
23,r_99_117_51,seq122,seq21,r_99_117_51,1.0,1,52,51,86
30,r_146_82_95,seq125,seq46,r_146_82_95,0.8,1,96,95,86
44,r_88_84_26,r_35_118_196,seq4,r_35_118_196,0.75,-72,124,196,86
17,r_111_1_57,r_62_37_147,seq91,r_111_1_57,1.0,0,57,57,86
8,r_62_37_147,seq134,seq19,r_62_37_147,0.82,1,148,147,86
43,r_31_79_76,r_59_85_152,seq27,r_31_79_76,1.0,0,76,76,86
59,seq19,seq28,r_62_37_147,r_62_37_147,0.94,2,149,147,86
34,r_90_75_24,r_15_96_167,seq110,r_90_75_24,1.0,0,24,24,86
19,r_76_66_70,r_9_133_185,r_74_81_134,r_74_81_134,0.99,49,183,134,86
16,r_128_98_172,r_15_96_167,r_5_63_8,r_128_98_172,0.49,-60,112,172,86
21,r_59_85_152,seq147,seq45,r_59_85_152,0.9,0,152,152,86
46,r_23_104_166,r_48_24_168,r_88_84_26,r_23_104_166,0.55,0,166,166,86
80,seq89,r_12_121_48,r_120_25_71,r_120_25_71,1.0,20,91,71,86
45,r_105_64_87,r_12_121_48,seq101,r_105_64_87,0.91,0,87,87,86
19,r_76_66_70,seq19,r_9_133_185,r_76_66_70,1.0,0,70,70,86
35,r_129_71_108,r_127_57_40,r_112_44_13,r_129_71_108,0.97,-1,107,108,86
13,r_143_138_53,seq11,seq54,r_143_138_53,1.0,1,54,53,86
41,r_9_133_185,r_62_37_147,r_76_66_70,r_76_66_70,1.0,0,70,70,86
47,r_70_30_28,r_6_114_64,r_136_13_197,r_70_30_28,0.99,0,28,28,86
3,r_15_96_167,r_128_98_172,r_65_126_165,r_128_98_172,0.84,-5,167,172,86
26,r_136_13_197,r_65_126_165,r_70_30_28,r_136_13_197,0.76,-32,165,197,86
16,r_128_98_172,r_5_63_8,seq124,r_128_98_172,1.0,0,172,172,86
4,r_65_126_165,r_136_13_197,r_146_82_95,r_136_13_197,0.51,-32,165,197,86
0,r_74_81_134,seq4,seq134,r_74_81_134,0.99,0,134,134,86
11,r_56_108_99,r_73_102_194,seq113,r_56_108_99,0.97,0,99,99,86
32,r_35_118_196,r_74_81_134,r_88_84_26,r_35_118_196,0.57,-157,39,196,86
20,r_87_53_191,r_130_132_129,r_41_140_50,r_41_140_50,0.99,79,129,50,86
98,seq125,r_146_82_95,seq68,r_146_82_95,0.79,1,96,95,86
15,r_61_39_120,seq33,r_83_42_60,r_83_42_60,0.95,72,132,60,86
48,r_3_106_150,r_59_85_152,seq91,r_3_106_150,0.95,1,151,150,86
29,r_127_57_40,seq93,r_100_52_82,r_127_57_40,0.77,3,43,40,86
27,r_115_2_56,r_73_102_194,seq32,r_115_2_56,1.0,0,56,56,86
29,r_127_57_40,r_100_52_82,r_83_42_60,r_127_57_40,0.95,42,82,40,86
87,seq101,r_7_18_184,r_105_64_87,r_105_64_87,0.95,0,87,87,86
2,r_130_132_129,r_87_53_191,seq147,r_130_132_129,0.59,0,129,129,86
41,r_9_133_185,r_76_66_70,seq91,r_9_133_185,0.66,0,185,185,86
25,r_148_16_65,seq68,seq131,r_148_16_65,1.0,2,67,65,86
33,r_83_42_60,seq28,r_127_57_40,r_83_42_60,1.0,0,60,60,86
6,r_5_63_8,r_15_96_167,seq45,r_15_96_167,0.62,-61,106,167,86
20,r_87_53_191,r_41_140_50,r_9_133_185,r_87_53_191,0.77,-1,190,191,86
44,r_88_84_26,seq69,r_35_118_196,r_88_84_26,1.0,0,26,26,86
38,r_86_17_93,r_23_104_166,seq68,r_86_17_93,0.99,3,96,93,86
52,seq134,r_62_37_147,r_137_78_10,r_62_37_147,0.94,-57,90,147,86
45,r_105_64_87,seq149,r_12_121_48,r_12_121_48,0.81,-17,31,48,86
9,r_120_25_71,seq109,seq89,r_120_25_71,0.99,3,74,71,86
37,r_112_44_13,seq94,r_129_71_108,r_129_71_108,0.98,17,125,108,86
22,r_100_52_82,r_129_71_108,seq43,r_100_52_82,0.93,0,82,82,86
91,seq113,seq38,r_56_108_99,r_56_108_99,0.99,-1,98,99,86
49,r_22_141_84,seq68,seq109,r_22_141_84,0.98,2,86,84,86
7,r_6_114_64,seq131,r_115_2_56,r_6_114_64,1.0,0,64,64,86
42,r_41_140_50,r_65_126_165,r_87_53_191,r_41_140_50,1.0,0,50,50,86
35,r_129_71_108,r_100_52_82,r_127_57_40,r_129_71_108,0.89,-38,70,108,86
30,r_9_135_75,seq57,seq64,r_9_135_75,1.0,-1,74,75,87
38,r_145_119_34,r_143_95_47,seq85,r_145_119_34,0.63,0,34,34,87
36,r_0_60_119,seq101,r_96_110_8,r_0_60_119,0.54,3,122,119,87
22,r_42_36_39,r_10_80_193,r_24_2_50,r_42_36_39,1.0,0,39,39,87
67,seq43,seq104,r_117_38_28,r_117_38_28,1.0,9,37,28,87
90,seq104,seq43,r_65_4_18,r_65_4_18,0.99,19,37,18,87
94,seq120,r_17_141_92,r_147_15_22,r_17_141_92,0.9,-60,32,92,87
83,seq85,r_106_70_132,r_145_119_34,r_106_70_132,0.91,-41,91,132,87
37,r_7_49_195,r_106_70_132,r_14_90_48,r_7_49_195,1.0,-121,74,195,87
86,seq93,r_114_58_197,r_6_51_108,r_6_51_108,1.0,-3,105,108,87
1,r_129_130_131,r_68_55_112,seq123,r_68_55_112,1.0,0,112,112,87
42,r_69_122_171,seq128,seq39,r_69_122_171,0.51,-103,68,171,87
10,r_96_110_8,r_32_140_196,r_0_60_119,r_0_60_119,1.0,-2,117,119,87
14,r_56_108_46,r_40_67_175,r_46_136_165,r_56_108_46,1.0,0,46,46,87
19,r_134_131_97,r_16_92_150,r_24_2_50,r_134_131_97,1.0,1,98,97,87
18,r_65_4_18,r_138_76_53,seq104,r_65_4_18,0.98,0,18,18,87
66,seq39,seq128,r_34_86_164,r_34_86_164,0.71,0,164,164,87
41,r_111_100_102,r_22_18_145,seq123,r_111_100_102,0.93,0,102,102,87
3,r_106_70_132,r_66_45_155,r_113_47_15,r_66_45_155,1.0,0,155,155,87
40,r_149_62_182,r_138_76_53,r_14_90_48,r_149_62_182,0.94,0,182,182,87
3,r_106_70_132,r_7_49_195,r_66_45_155,r_106_70_132,0.76,0,132,132,87
10,r_96_110_8,r_146_13_67,r_32_140_196,r_146_13_67,0.93,3,70,67,87
20,r_66_45_155,r_106_70_132,r_31_144_30,r_66_45_155,0.63,0,155,155,87
26,r_48_20_184,seq29,r_46_136_165,r_46_136_165,0.45,19,184,165,87
72,seq57,r_9_135_75,seq123,r_9_135_75,1.0,-1,74,75,87
12,r_109_1_11,r_56_108_46,seq81,r_109_1_11,0.94,0,11,11,87
27,r_113_47_15,r_31_144_30,seq77,r_113_47_15,0.99,0,15,15,87
4,r_25_37_126,seq26,seq35,r_25_37_126,0.97,0,126,126,87
63,seq133,r_79_11_98,seq88,r_79_11_98,0.99,0,98,98,87
11,r_116_137_151,r_127_98_192,r_41_59_7,r_116_137_151,0.91,0,151,151,87
20,r_66_45_155,seq5,r_106_70_132,r_106_70_132,0.75,12,144,132,87
15,r_68_55_112,r_129_130_131,r_56_108_46,r_68_55_112,0.98,0,112,112,87
6,r_10_80_193,r_3_94_162,r_17_141_92,r_17_141_92,0.98,35,127,92,87
85,seq88,seq33,r_40_67_175,r_40_67_175,0.62,1,176,175,87
2,r_31_144_30,r_102_30_100,r_82_115_183,r_102_30_100,1.0,0,100,100,87
29,r_117_38_28,r_129_130_131,seq43,r_117_38_28,1.0,1,29,28,87
46,r_146_13_67,r_145_119_34,r_96_110_8,r_145_119_34,0.98,14,48,34,87
47,r_89_78_59,r_114_58_197,r_24_2_50,r_89_78_59,1.0,1,60,59,87
46,r_146_13_67,r_96_110_8,r_138_76_53,r_146_13_67,0.95,3,70,67,87
40,r_149_62_182,r_22_18_145,r_138_76_53,r_138_76_53,1.0,79,132,53,87
74,seq64,seq61,r_9_135_75,r_9_135_75,1.0,-1,74,75,87
24,r_34_86_164,r_22_18_145,r_138_76_53,r_138_76_53,1.0,92,145,53,87
80,seq81,r_22_18_145,r_109_1_11,r_109_1_11,0.71,9,20,11,87
2,r_31_144_30,seq87,r_102_30_100,r_31_144_30,1.0,0,30,30,87
33,r_6_51_108,seq61,seq93,r_6_51_108,0.98,1,109,108,87
48,r_40_67_175,r_41_59_7,seq88,r_40_67_175,0.46,1,176,175,87
16,r_24_2_50,seq84,r_42_36_39,r_42_36_39,1.0,9,48,39,87
65,seq35,r_97_132_170,r_25_37_126,r_25_37_126,0.59,44,170,126,87
24,r_34_86_164,r_138_76_53,seq39,r_34_86_164,0.92,0,164,164,87
42,r_69_122_171,seq39,r_145_119_34,r_69_122_171,0.6,0,171,171,87
28,r_102_30_100,seq21,r_31_144_30,r_31_144_30,1.0,4,34,30,87
77,seq73,r_25_37_126,seq74,r_25_37_126,0.99,0,126,126,87
21,r_63_112_49,r_129_130_131,r_109_1_11,r_63_112_49,0.96,2,51,49,87
34,r_79_11_98,seq133,r_102_30_100,r_79_11_98,0.98,1,99,98,87
2,r_31_144_30,r_82_115_183,r_66_45_155,r_66_45_155,0.65,0,155,155,87
75,seq71,r_17_141_92,r_147_15_22,r_17_141_92,1.0,0,92,92,87
49,r_147_15_22,r_40_67_175,seq120,r_147_15_22,0.8,1,23,22,87
0,r_46_136_165,seq43,r_56_108_46,r_56_108_46,1.0,-8,38,46,87
17,r_3_94_162,r_10_80_193,seq12,r_3_94_162,0.91,0,162,162,87
43,r_143_95_47,r_145_119_34,seq148,r_143_95_47,1.0,3,50,47,87
9,r_75_54_87,seq74,seq84,r_75_54_87,0.78,0,87,87,87
57,seq148,seq126,r_143_95_47,r_143_95_47,0.52,2,49,47,87
31,r_41_59_7,r_40_67_175,r_116_137_151,r_116_137_151,0.87,25,176,151,87
28,r_102_30_100,r_31_144_30,seq64,r_102_30_100,1.0,0,100,100,87
7,r_138_76_53,r_97_132_170,r_109_1_11,r_138_76_53,1.0,0,53,53,87
23,r_22_18_145,r_34_86_164,seq71,r_22_18_145,0.56,0,145,145,87
75,seq71,r_147_15_22,r_22_18_145,r_22_18_145,0.96,17,162,145,87
35,r_17_141_92,seq71,seq123,r_17_141_92,1.0,0,92,92,87
39,r_14_90_48,seq64,r_7_49_195,r_14_90_48,0.99,2,50,48,87
30,r_12_72_108,r_67_19_154,r_136_48_31,r_12_72_108,0.99,3,111,108,88
36,r_68_71_101,seq120,r_16_100_80,r_68_71_101,0.99,0,101,101,88
48,r_85_137_47,seq99,r_63_97_194,r_85_137_47,1.0,1,48,47,88
14,r_74_5_164,r_116_141_60,seq58,r_74_5_164,0.79,2,166,164,88
8,r_63_97_194,r_0_15_127,r_85_137_47,r_63_97_194,0.99,-67,127,194,88
37,r_64_79_115,r_95_142_158,r_31_96_117,r_64_79_115,0.47,0,115,115,88
59,seq13,r_87_18_23,r_115_119_65,r_115_119_65,1.0,23,88,65,88
86,seq98,r_149_52_137,r_136_48_31,r_136_48_31,1.0,112,143,31,88
16,r_36_70_74,seq99,r_63_97_194,r_36_70_74,1.0,0,74,74,88
21,r_123_30_187,seq61,r_149_52_137,r_123_30_187,0.6,0,187,187,88
39,r_46_25_109,seq128,seq102,r_46_25_109,0.59,0,109,109,88
27,r_38_121_24,r_87_18_23,seq61,r_38_121_24,0.94,0,24,24,88
97,seq122,r_86_148_19,r_3_112_82,r_3_112_82,0.81,-1,81,82,88
45,r_28_129_85,seq98,r_73_144_11,r_28_129_85,1.0,0,85,85,88
19,r_136_48_31,r_16_100_80,r_86_148_19,r_136_48_31,1.0,0,31,31,88
31,r_125_35_142,r_95_142_158,r_85_137_47,r_85_137_47,0.75,95,142,47,88
26,r_73_144_11,r_16_100_80,seq7,r_73_144_11,0.98,0,11,11,88
13,r_131_44_77,r_67_19_154,r_59_41_111,r_131_44_77,0.92,47,124,77,88
42,r_90_1_56,r_86_148_19,seq99,r_90_1_56,1.0,0,56,56,88
47,r_60_93_18,r_113_127_25,seq108,r_60_93_18,1.0,0,18,18,88
4,r_16_100_80,seq61,r_90_1_56,r_16_100_80,1.0,0,80,80,88
38,r_56_66_124,r_113_127_25,seq29,r_56_66_124,1.0,0,124,124,88
0,r_59_41_111,r_74_5_164,r_131_44_77,r_59_41_111,0.69,0,111,111,88
11,r_21_84_136,seq132,r_73_144_11,r_21_84_136,0.98,0,136,136,88
28,r_110_45_27,r_33_76_84,seq49,r_110_45_27,1.0,-1,26,27,88
13,r_131_44_77,r_117_47_140,r_67_19_154,r_131_44_77,0.99,4,81,77,88
46,r_57_39_44,r_113_127_25,r_115_119_65,r_115_119_65,0.99,83,148,65,88
15,r_31_96_117,r_80_65_163,r_64_79_115,r_31_96_117,0.96,1,118,117,88
10,r_27_91_26,seq11,seq132,r_27_91_26,0.86,7,33,26,88
46,r_57_39_44,seq146,r_113_127_25,r_113_127_25,0.79,15,40,25,88
5,r_109_9_121,r_80_65_163,r_20_51_185,r_80_65_163,0.99,3,166,163,88
12,r_2_77_10,r_26_4_116,seq133,r_2_77_10,0.69,0,10,10,88
2,r_10_40_112,r_95_142_158,r_16_100_80,r_16_100_80,0.98,44,124,80,88
40,r_81_147_132,seq22,seq132,r_81_147_132,0.99,0,132,132,88
18,r_3_112_82,r_103_101_181,seq122,r_3_112_82,1.0,0,82,82,88
29,r_117_47_140,r_131_44_77,r_95_142_158,r_131_44_77,1.0,0,77,77,88
24,r_104_37_15,r_0_15_127,seq58,r_0_15_127,0.98,-52,75,127,88
25,r_80_65_163,r_31_96_117,r_59_41_111,r_80_65_163,0.47,-51,112,163,88
33,r_53_83_75,r_56_66_124,r_73_144_11,r_53_83_75,1.0,0,75,75,88
82,seq82,r_2_77_10,r_67_19_154,r_2_77_10,0.4,152,162,10,88
6,r_113_127_25,r_63_97_194,r_56_66_124,r_113_127_25,1.0,0,25,25,88
47,r_60_93_18,seq108,r_33_76_84,r_33_76_84,1.0,20,104,84,88
6,r_113_127_25,r_56_66_124,seq107,r_56_66_124,0.83,0,124,124,88
38,r_56_66_124,r_53_83_75,r_113_127_25,r_56_66_124,0.85,-49,75,124,88
25,r_80_65_163,r_59_41_111,r_12_72_108,r_80_65_163,1.0,3,166,163,88
17,r_26_4_116,seq62,r_64_79_115,r_26_4_116,0.82,1,117,116,88
9,r_95_142_158,seq6,r_31_96_117,r_95_142_158,0.65,0,158,158,88
29,r_117_47_140,r_95_142_158,r_94_34_199,r_117_47_140,1.0,0,140,140,88
22,r_20_51_185,seq145,r_109_9_121,r_109_9_121,0.68,62,183,121,88
49,r_115_119_65,r_149_52_137,seq13,r_115_119_65,1.0,2,67,65,88
74,seq54,seq14,r_69_138_59,r_69_138_59,1.0,0,59,59,88
7,r_33_76_84,r_0_15_127,r_60_93_18,r_33_76_84,0.98,-3,81,84,88
44,r_0_15_127,r_63_97_194,r_116_141_60,r_0_15_127,1.0,0,127,127,88
23,r_67_19_154,seq118,r_73_144_11,r_67_19_154,0.97,0,154,154,88
43,r_86_148_19,r_149_52_137,r_136_48_31,r_136_48_31,1.0,14,45,31,88
35,r_105_92_93,seq140,r_116_141_60,r_105_92_93,1.0,0,93,93,88
30,r_11_117_125,seq97,r_87_146_46,r_11_117_125,0.97,0,125,125,89
36,r_147_48_66,r_86_55_93,r_92_69_4,r_86_55_93,0.83,-25,68,93,89
58,seq16,r_103_73_50,seq21,r_103_73_50,1.0,1,51,50,89
1,r_98_6_83,seq39,seq110,r_98_6_83,1.0,0,83,83,89
97,seq113,seq99,r_116_0_149,r_116_0_149,0.99,0,149,149,89
5,r_79_17_166,seq32,r_132_20_136,r_79_17_166,0.4,5,171,166,89
46,r_33_123_159,seq104,r_35_125_72,r_33_123_159,0.71,0,159,159,89
42,r_122_111_158,r_132_20_136,r_90_60_33,r_122_111_158,0.87,0,158,158,89
31,r_92_69_4,r_72_124_80,r_118_37_40,r_92_69_4,1.0,38,42,4,89
19,r_131_112_113,seq26,seq47,r_131_112_113,0.49,16,129,113,89
33,r_77_137_160,r_79_17_166,seq22,r_77_137_160,0.92,0,160,160,89
28,r_119_13_18,r_63_58_77,r_132_20_136,r_119_13_18,1.0,0,18,18,89
41,r_105_106_140,seq50,r_118_37_40,r_105_106_140,0.54,0,140,140,89
10,r_89_130_60,seq129,seq101,r_89_130_60,1.0,0,60,60,89
26,r_63_58_77,seq110,seq15,r_63_58_77,1.0,0,77,77,89
4,r_86_55_93,seq68,r_93_115_175,r_86_55_93,1.0,0,93,93,89
0,r_109_53_97,r_77_137_160,r_88_91_137,r_109_53_97,0.91,0,97,97,89
11,r_35_125_72,r_1_36_82,r_145_56_9,r_35_125_72,0.64,3,75,72,89
20,r_34_23_135,r_4_81_20,r_35_125_72,r_34_23_135,0.99,0,135,135,89
13,r_96_27_172,seq26,seq50,r_96_27_172,0.57,0,172,172,89
48,r_29_67_84,r_88_91_137,seq39,r_29_67_84,0.94,0,84,84,89
14,r_90_60_33,seq5,seq128,r_90_60_33,0.91,3,36,33,89
3,r_103_73_50,seq16,seq39,r_103_73_50,1.0,0,50,50,89
2,r_72_124_80,r_66_62_188,r_24_100_197,r_72_124_80,1.0,1,81,80,89
40,r_38_7_167,seq80,r_63_58_77,r_38_7_167,0.68,0,167,167,89
33,r_77_137_160,r_109_53_97,r_79_17_166,r_109_53_97,0.99,0,97,97,89
15,r_120_85_55,r_84_121_109,seq136,r_120_85_55,0.78,2,57,55,89
6,r_57_141_6,r_120_85_55,r_29_67_84,r_29_67_84,1.0,7,91,84,89
65,seq26,r_131_112_113,r_29_67_84,r_29_67_84,1.0,50,134,84,89
32,r_12_41_182,seq25,r_72_124_80,r_12_41_182,0.51,0,182,182,89
38,r_84_121_109,r_120_85_55,seq18,r_84_121_109,0.71,-16,93,109,89
21,r_87_146_46,seq39,seq80,r_87_146_46,0.93,5,51,46,89
23,r_133_59_58,r_96_27_172,seq21,r_133_59_58,1.0,0,58,58,89
37,r_4_81_20,seq40,r_34_23_135,r_4_81_20,0.71,0,20,20,89
17,r_149_127_139,r_4_81_20,r_57_141_6,r_149_127_139,0.92,0,139,139,89
9,r_66_62_188,seq128,r_1_36_82,r_1_36_82,0.66,106,188,82,89
37,r_4_81_20,r_34_23_135,seq43,r_34_23_135,0.8,0,135,135,89
35,r_10_54_13,r_63_58_77,seq114,r_10_54_13,0.49,2,15,13,89
18,r_49_82_25,r_142_108_3,r_24_100_197,r_49_82_25,0.8,0,25,25,89
49,r_71_74_161,r_24_100_197,r_35_125_72,r_35_125_72,1.0,89,161,72,89
8,r_83_31_38,seq144,seq80,r_83_31_38,1.0,0,38,38,89
7,r_1_36_82,r_24_100_197,r_87_146_46,r_1_36_82,1.0,0,82,82,89
94,seq144,r_83_31_38,seq15,r_83_31_38,0.98,0,38,38,89
82,seq68,r_86_55_93,seq128,r_86_55_93,1.0,-20,73,93,89
29,r_118_37_40,r_1_36_82,r_92_69_4,r_118_37_40,1.0,0,40,40,89
12,r_88_91_137,r_29_67_84,r_109_53_97,r_88_91_137,1.0,-53,84,137,89
40,r_43_119_32,seq22,r_142_18_4,r_43_119_32,0.55,-1,31,32,90
44,r_12_40_151,r_129_112_74,seq66,r_12_40_151,1.0,0,151,151,90
36,r_149_121_80,r_115_92_70,r_113_28_16,r_115_92_70,0.72,-3,67,70,90
14,r_30_53_41,r_50_122_182,r_70_80_121,r_30_53_41,0.73,84,125,41,90
60,seq145,seq46,r_16_98_56,r_16_98_56,1.0,-1,55,56,90
8,r_102_81_184,r_2_86_177,r_50_122_182,r_50_122_182,0.51,2,184,182,90
30,r_34_96_46,seq145,seq54,r_34_96_46,1.0,1,47,46,90
43,r_115_92_70,r_149_121_80,seq10,r_115_92_70,1.0,1,71,70,90
86,seq143,r_52_74_96,r_31_63_12,r_52_74_96,0.98,-31,65,96,90
39,r_4_117_120,r_36_79_152,seq59,r_36_79_152,0.9,-31,121,152,90
5,r_20_0_126,r_17_21_124,r_90_99_167,r_17_21_124,0.58,0,124,124,90
42,r_114_1_118,seq134,r_31_63_12,r_114_1_118,1.0,1,119,118,90
45,r_132_23_156,r_12_40_151,r_9_3_112,r_9_3_112,0.97,21,133,112,90
19,r_56_61_149,seq39,seq144,r_56_61_149,0.51,17,166,149,90
66,seq39,r_56_61_149,r_130_60_8,r_130_60_8,0.78,162,170,8,90
45,r_132_23_156,r_9_3_112,seq133,r_132_23_156,0.66,1,157,156,90
38,r_129_112_74,r_12_40_151,r_95_44_145,r_12_40_151,0.8,-3,148,151,90
31,r_107_72_93,seq7,seq47,r_107_72_93,0.84,6,99,93,90
35,r_127_14_52,seq93,seq131,r_127_14_52,0.99,0,52,52,90
53,seq134,r_114_1_118,seq26,r_114_1_118,0.98,-69,49,118,90
3,r_25_6_138,r_95_44_145,seq143,r_95_44_145,0.86,-4,141,145,90
10,r_9_3_112,seq103,seq147,r_9_3_112,0.7,0,112,112,90
26,r_70_80_121,seq118,r_30_53_41,r_70_80_121,0.52,0,121,121,90
4,r_42_120_137,r_24_110_141,r_102_81_184,r_42_120_137,0.79,0,137,137,90
11,r_91_123_110,seq55,r_83_48_65,r_91_123_110,1.0,0,110,110,90
20,r_137_5_83,seq124,seq118,r_137_5_83,1.0,0,83,83,90
98,seq118,r_70_80_121,r_137_5_83,r_137_5_83,0.96,38,121,83,90
46,r_33_139_161,r_31_63_12,seq82,r_33_139_161,0.88,1,162,161,90
15,r_90_99_167,seq66,r_109_58_31,r_109_58_31,0.98,136,167,31,90
48,r_2_86_177,r_102_81_184,r_137_5_83,r_137_5_83,0.61,101,184,83,90
12,r_113_28_16,r_149_121_80,r_17_21_124,r_149_121_80,0.92,0,80,80,90
6,r_49_35_76,r_42_120_137,r_109_58_31,r_49_35_76,1.0,0,76,76,90
0,r_37_65_40,r_30_53_41,seq76,r_37_65_40,0.69,0,40,40,90
46,r_33_139_161,r_52_74_96,r_31_63_12,r_33_139_161,0.85,-149,12,161,90
23,r_78_29_36,seq111,seq93,r_78_29_36,0.99,-1,35,36,90
27,r_84_32_181,r_56_61_149,r_24_110_141,r_24_110_141,0.63,41,182,141,90
22,r_130_60_8,r_84_32_181,r_36_79_152,r_36_79_152,0.67,24,176,152,90
47,r_101_104_101,seq140,r_38_57_13,r_101_104_101,0.71,2,103,101,90
18,r_95_44_145,r_25_6_138,r_129_112_74,r_25_6_138,0.73,9,147,138,90
25,r_17_21_124,r_20_0_126,seq108,r_17_21_124,0.79,0,124,124,90
32,r_83_48_65,seq47,seq124,r_83_48_65,1.0,0,65,65,90
38,r_129_112_74,r_91_123_110,r_12_40_151,r_91_123_110,0.61,-36,74,110,90
52,seq133,r_87_73_173,r_132_23_156,r_87_73_173,0.85,-3,170,173,90
34,r_125_41_163,seq145,r_115_92_70,r_125_41_163,0.56,0,163,163,90
36,r_149_121_80,r_113_28_16,seq128,r_149_121_80,0.97,0,80,80,90
4,r_42_120_137,r_102_81_184,r_78_29_36,r_102_81_184,0.96,0,184,184,90
2,r_109_58_31,seq76,seq7,r_109_58_31,1.0,0,31,31,90
12,r_113_28_16,seq144,r_149_121_80,r_113_28_16,0.93,0,16,16,90
17,r_50_122_182,r_88_11_198,r_102_81_184,r_88_11_198,0.69,-20,178,198,90
9,r_31_63_12,r_33_139_161,seq143,r_33_139_161,0.63,1,162,161,90
51,seq131,seq7,r_127_14_52,r_127_14_52,1.0,0,52,52,90
88,seq94,r_102_81_184,r_13_8_18,r_13_8_18,0.88,-1,17,18,90
56,seq140,r_101_104_101,seq135,r_101_104_101,1.0,-3,98,101,90
44,r_12_40_151,r_132_23_156,r_129_112_74,r_129_112_74,0.7,15,89,74,90
1,r_13_8_18,r_85_126_180,seq94,r_13_8_18,0.86,-1,17,18,90
37,r_38_57_13,seq64,seq71,r_38_57_13,0.95,0,13,13,90
40,r_62_77_56,r_133_79_147,r_127_69_59,r_133_79_147,1.0,1,148,147,91
30,r_32_85_120,seq118,seq110,r_32_85_120,1.0,0,120,120,91
14,r_12_10_90,seq107,r_102_71_43,r_12_10_90,0.67,0,90,90,91
8,r_145_139_184,r_140_7_107,r_67_4_44,r_145_139_184,0.85,-97,87,184,91
83,seq89,seq26,r_19_14_112,r_19_14_112,1.0,23,135,112,91
3,r_133_79_147,r_62_77_56,seq138,r_133_79_147,1.0,1,148,147,91
5,r_140_7_107,seq20,r_25_105_110,r_140_7_107,0.77,1,108,107,91
88,seq103,r_47_54_69,r_140_7_107,r_47_54_69,0.89,63,132,69,91
44,r_19_14_112,seq89,r_88_122_152,r_88_122_152,0.71,3,155,152,91
69,seq43,seq24,r_143_100_76,r_143_100_76,1.0,34,110,76,91
45,r_76_6_77,seq94,seq142,r_76_6_77,0.99,0,77,77,91
27,r_55_1_20,r_73_44_154,seq129,r_55_1_20,0.94,-1,19,20,91
40,r_62_77_56,r_86_5_95,r_133_79_147,r_62_77_56,0.93,0,56,56,91
43,r_102_71_43,r_67_4_44,r_141_22_5,r_102_71_43,1.0,0,43,43,91
76,seq59,r_36_18_106,r_111_149_7,r_36_18_106,1.0,0,106,106,91
1,r_148_48_30,r_127_69_59,seq114,r_148_48_30,0.91,0,30,30,91
41,r_131_39_104,r_92_16_19,r_113_8_37,r_131_39_104,0.99,0,104,104,91
18,r_86_5_95,seq103,seq63,r_86_5_95,0.8,-7,88,95,91
3,r_133_79_147,r_140_7_107,r_62_77_56,r_62_77_56,0.87,31,87,56,91
90,seq107,r_12_10_90,r_97_125_35,r_12_10_90,0.93,-11,79,90,91
16,r_113_8_37,r_133_79_147,seq30,r_113_8_37,0.99,-1,36,37,91
25,r_2_40_188,r_67_4_44,r_81_50_45,r_81_50_45,0.96,0,45,45,91
26,r_73_44_154,seq94,r_75_112_78,r_75_112_78,1.0,7,85,78,91
4,r_36_18_106,seq59,r_140_7_107,r_36_18_106,0.99,0,106,106,91
78,seq63,r_70_135_176,r_86_5_95,r_86_5_95,1.0,10,105,95,91
11,r_23_56_133,seq146,seq95,r_23_56_133,1.0,0,133,133,91
20,r_106_101_144,r_88_122_152,r_34_3_2,r_106_101_144,0.51,1,145,144,91
13,r_47_54_69,r_86_5_95,seq120,r_47_54_69,1.0,0,69,69,91
48,r_123_96_89,r_92_16_19,seq120,r_123_96_89,0.93,1,90,89,91
49,r_66_108_12,seq137,r_83_132_141,r_83_132_141,0.94,-13,128,141,91
6,r_109_49_199,r_88_122_152,r_144_130_13,r_109_49_199,0.79,-171,28,199,91
49,r_66_108_12,r_47_54_69,seq137,r_66_108_12,1.0,1,13,12,91
75,seq137,r_65_74_173,r_66_108_12,r_66_108_12,0.95,16,28,12,91
2,r_67_4_44,r_2_40_188,r_97_125_35,r_67_4_44,0.91,0,44,44,91
47,r_90_80_175,seq41,seq128,r_90_80_175,0.46,0,175,175,91
18,r_86_5_95,r_47_54_69,seq103,r_47_54_69,0.81,0,69,69,91
29,r_88_122_152,r_106_101_144,r_19_14_112,r_88_122_152,0.53,-2,150,152,91
33,r_11_57_96,seq27,r_86_5_95,r_11_57_96,1.0,1,97,96,91
88,seq103,r_86_5_95,r_47_54_69,r_86_5_95,0.7,-7,88,95,91
31,r_81_50_45,seq43,r_2_40_188,r_81_50_45,1.0,1,46,45,91
10,r_141_22_5,r_127_69_59,r_102_71_43,r_141_22_5,1.0,39,44,5,91
68,seq41,r_90_80_175,r_38_98_9,r_90_80_175,0.96,0,175,175,91
38,r_83_132_141,seq20,r_66_108_12,r_83_132_141,0.77,0,141,141,91
17,r_97_125_35,seq142,seq107,r_97_125_35,0.98,-1,34,35,91
34,r_92_16_19,r_131_39_104,seq120,r_131_39_104,0.68,-11,93,104,91
81,seq82,r_70_135_176,seq93,r_70_135_176,0.94,-37,139,176,91
25,r_2_40_188,r_81_50_45,seq59,r_81_50_45,0.61,144,189,45,91
39,r_144_130_13,seq114,r_109_49_199,r_144_130_13,0.47,2,15,13,91
94,seq118,r_32_85_120,seq61,r_32_85_120,1.0,0,120,120,91
26,r_73_44_154,r_75_112_78,r_38_98_9,r_73_44_154,0.99,0,154,154,91
31,r_81_50_45,r_2_40_188,seq137,r_2_40_188,0.85,1,189,188,91
28,r_75_112_78,r_73_44_154,r_123_96_89,r_73_44_154,0.95,0,154,154,91
22,r_115_60_115,seq114,r_34_3_2,r_115_60_115,0.97,0,115,115,91
28,r_75_112_78,r_78_58_125,r_73_44_154,r_75_112_78,0.93,0,78,78,91
32,r_147_117_51,r_140_7_107,seq119,r_147_117_51,0.53,1,52,51,91
44,r_19_14_112,seq72,seq89,r_19_14_112,0.98,0,112,112,91
23,r_25_105_110,seq137,r_140_7_107,r_25_105_110,0.62,1,111,110,91
42,r_127_69_59,seq128,r_67_4_44,r_127_69_59,1.0,0,59,59,91
35,r_143_100_76,seq45,seq43,r_143_100_76,1.0,0,76,76,91
12,r_70_135_176,seq63,r_133_79_147,r_133_79_147,0.69,29,176,147,91
8,r_75_131_65,r_47_117_86,r_107_114_68,r_75_131_65,1.0,3,68,65,92
37,r_60_138_157,seq38,r_110_121_153,r_60_138_157,0.77,3,160,157,92
19,r_107_114_68,r_75_131_65,r_116_56_114,r_116_56_114,0.95,62,176,114,92
21,r_15_112_110,seq96,seq9,r_15_112_110,0.99,0,110,110,92
39,r_18_102_105,seq44,r_75_131_65,r_75_131_65,1.0,14,79,65,92
39,r_18_102_105,r_75_131_65,r_55_63_97,r_18_102_105,0.97,1,106,105,92
16,r_93_147_44,seq19,seq148,r_93_147_44,1.0,0,44,44,92
5,r_55_63_97,seq27,seq19,r_55_63_97,0.82,0,97,97,92
46,r_48_129_73,seq33,seq89,r_48_129_73,0.99,0,73,73,92
42,r_142_26_104,seq86,seq66,r_142_26_104,0.89,0,104,104,92
80,seq72,r_119_105_167,r_14_45_150,r_14_45_150,0.68,17,167,150,92
69,seq46,r_107_114_68,seq97,r_107_114_68,1.0,4,72,68,92
45,r_101_3_156,seq50,seq76,r_101_3_156,0.61,0,156,156,92
73,seq53,r_13_108_39,seq148,r_13_108_39,1.0,1,40,39,92
19,r_107_114_68,seq46,r_75_131_65,r_107_114_68,1.0,0,68,68,92
22,r_37_91_46,seq135,seq89,r_37_91_46,1.0,0,46,46,92
26,r_64_128_48,seq9,seq20,r_64_128_48,1.0,0,48,48,92
41,r_40_69_32,r_75_131_65,seq10,r_75_131_65,0.74,-31,34,65,92
31,r_14_45_150,r_12_109_82,seq61,r_12_109_82,1.0,-4,78,82,92
74,seq59,r_31_146_19,seq46,r_31_146_19,0.46,118,137,19,92
3,r_145_0_139,seq51,r_40_69_32,r_145_0_139,0.8,1,140,139,92
10,r_62_103_135,seq10,seq141,r_62_103_135,0.44,3,138,135,92
14,r_28_52_16,r_85_87_127,seq140,r_28_52_16,0.87,0,16,16,92
4,r_73_79_122,seq59,r_120_133_113,r_73_79_122,0.98,0,122,122,92
63,seq29,r_6_94_187,r_81_99_21,r_81_99_21,0.8,166,187,21,92
11,r_35_78_63,r_54_30_119,seq148,r_35_78_63,1.0,3,66,63,92
20,r_143_67_60,r_6_94_187,r_124_139_196,r_143_67_60,1.0,1,61,60,92
13,r_34_149_136,r_47_117_86,r_13_108_39,r_34_149_136,0.97,-71,65,136,92
15,r_47_117_86,r_34_149_136,seq38,r_47_117_86,1.0,0,86,86,92
48,r_12_109_82,r_14_45_150,seq29,r_12_109_82,1.0,0,82,82,92
6,r_116_56_114,seq23,r_107_114_68,r_107_114_68,0.6,47,115,68,92
62,seq27,r_55_63_97,seq111,r_55_63_97,1.0,0,97,97,92
27,r_113_7_188,seq20,r_31_146_19,r_31_146_19,0.66,169,188,19,92
87,seq89,r_119_105_167,r_48_129_73,r_48_129_73,1.0,-4,69,73,92
17,r_81_99_21,r_116_56_114,seq9,r_81_99_21,0.59,-2,19,21,92
22,r_37_91_46,seq89,r_4_126_109,r_4_126_109,1.0,2,111,109,92
61,seq23,r_116_56_114,r_57_88_11,r_57_88_11,0.99,0,11,11,92
2,r_71_106_80,seq43,r_36_11_6,r_71_106_80,1.0,0,80,80,92
47,r_120_133_113,seq123,r_21_24_103,r_21_24_103,0.66,12,115,103,92
43,r_31_146_19,seq144,seq50,r_31_146_19,1.0,0,19,19,92
12,r_13_108_39,seq53,seq33,r_13_108_39,1.0,1,40,39,92
74,seq59,r_73_79_122,r_31_146_19,r_73_79_122,0.49,0,122,122,92
29,r_54_30_119,r_60_138_157,r_55_63_97,r_54_30_119,0.99,0,119,119,92
35,r_22_17_57,r_116_56_114,seq86,r_22_17_57,1.0,0,57,57,92
25,r_80_100_107,seq68,r_32_74_102,r_32_74_102,0.6,5,107,102,92
33,r_32_74_102,seq96,r_80_100_107,r_32_74_102,1.0,1,103,102,92
70,seq49,seq23,r_42_25_142,r_42_25_142,0.6,15,157,142,92
32,r_6_94_187,seq29,r_73_79_122,r_73_79_122,0.87,65,187,122,92
34,r_134_41_169,seq70,r_71_106_80,r_71_106_80,1.0,91,171,80,92
18,r_57_88_11,r_35_78_63,seq23,r_57_88_11,0.7,0,11,11,92
9,r_4_126_109,seq92,r_37_91_46,r_4_126_109,1.0,0,109,109,92
31,r_14_45_150,seq61,r_48_129_73,r_14_45_150,0.87,0,150,150,92
38,r_21_24_103,r_143_67_60,r_120_133_113,r_120_133_113,0.81,13,126,113,92
28,r_137_118_124,r_124_139_196,seq115,r_137_118_124,1.0,1,125,124,92
49,r_42_25_142,r_110_121_153,seq49,r_110_121_153,0.8,-7,146,153,92
0,r_58_132_53,r_55_63_97,seq92,r_58_132_53,1.0,0,53,53,92
7,r_136_2_78,seq77,r_13_108_39,r_136_2_78,1.0,-2,76,78,92
44,r_90_130_137,r_60_138_157,seq125,r_90_130_137,0.98,0,137,137,92
5,r_55_63_97,seq19,r_54_30_119,r_54_30_119,1.0,3,122,119,92
30,r_48_147_182,seq46,r_143_120_4,r_143_120_4,0.81,179,183,4,93
36,r_78_33_95,r_145_47_140,seq43,r_145_47_140,0.77,-45,95,140,93
37,r_31_0_54,seq62,seq142,r_31_0_54,0.56,1,55,54,93
14,r_45_55_89,r_140_94_161,seq129,r_45_55_89,0.99,1,90,89,93
8,r_27_64_128,r_89_72_143,r_135_34_98,r_89_72_143,1.0,-15,128,143,93
59,seq20,seq144,r_89_72_143,r_89_72_143,1.0,17,160,143,93
10,r_60_125_52,r_25_117_154,r_40_41_20,r_60_125_52,0.91,0,52,52,93
86,seq102,r_140_94_161,r_143_120_4,r_143_120_4,0.66,152,156,4,93
16,r_2_73_162,seq37,seq44,r_2_73_162,0.97,0,162,162,93
21,r_53_4_101,seq118,seq116,r_53_4_101,0.75,4,105,101,93
39,r_145_47_140,r_78_33_95,r_14_96_150,r_78_33_95,1.0,0,95,95,93
28,r_89_72_143,r_115_59_177,seq20,r_89_72_143,0.96,0,143,143,93
93,seq116,r_49_139_49,r_53_4_101,r_49_139_49,1.0,0,49,49,93
45,r_135_34_98,seq39,seq121,r_135_34_98,0.72,3,101,98,93
19,r_14_96_150,seq71,r_30_75_81,r_14_96_150,0.82,3,153,150,93
11,r_74_26_28,r_53_4_101,r_88_23_100,r_88_23_100,0.93,5,105,100,93
31,r_99_100_85,seq52,seq121,r_99_100_85,0.61,0,85,85,93
41,r_25_117_154,seq18,r_14_96_150,r_25_117_154,0.94,0,154,154,93
38,r_97_83_45,r_115_59_177,seq142,r_97_83_45,1.0,0,45,45,93
89,seq108,seq52,r_36_149_109,r_36_149_109,1.0,31,140,109,93
0,r_66_113_56,r_78_33_95,r_111_124_94,r_66_113_56,1.0,2,58,56,93
3,r_115_59_177,seq68,r_61_98_119,r_61_98_119,0.99,60,179,119,93
57,seq17,seq44,r_131_128_16,r_131_128_16,1.0,3,19,16,93
26,r_54_7_188,seq52,r_143_120_4,r_143_120_4,0.76,186,190,4,93
1,r_13_51_13,r_80_130_64,seq108,r_13_51_13,1.0,0,13,13,93
4,r_61_98_119,seq15,seq71,r_61_98_119,0.99,1,120,119,93
78,seq71,r_14_96_150,r_49_139_49,r_49_139_49,0.8,104,153,49,93
20,r_36_149_109,seq8,seq108,r_36_149_109,0.98,0,109,109,93
42,r_12_50_48,r_48_147_182,r_92_87_189,r_12_50_48,1.0,1,49,48,93
15,r_3_136_66,seq43,seq67,r_3_136_66,1.0,0,66,66,93
48,r_138_42_156,r_16_90_75,seq52,r_16_90_75,0.94,7,82,75,93
12,r_92_87_189,r_12_50_48,seq39,r_12_50_48,0.36,142,190,48,93
6,r_16_90_75,r_138_42_156,seq76,r_16_90_75,0.58,7,82,75,93
34,r_11_104_34,seq8,seq67,r_11_104_34,1.0,0,34,34,93
27,r_111_124_94,r_92_87_189,r_66_113_56,r_66_113_56,1.0,43,99,56,93
40,r_80_130_64,seq20,r_63_123_33,r_80_130_64,0.87,7,71,64,93
24,r_109_9_164,seq81,r_141_6_78,r_141_6_78,0.73,86,164,78,93
33,r_79_1_153,seq107,seq129,r_79_1_153,0.66,2,155,153,93
48,r_138_42_156,seq52,seq37,r_138_42_156,0.99,0,156,156,93
88,seq107,r_79_1_153,r_137_103_38,r_137_103_38,0.96,117,155,38,93
70,seq46,r_48_147_182,r_63_123_33,r_63_123_33,1.0,150,183,33,93
44,r_131_128_16,r_66_113_56,seq17,r_131_128_16,0.55,0,16,16,93
68,seq43,seq119,r_78_33_95,r_78_33_95,0.89,1,96,95,93
11,r_74_26_28,r_85_38_192,r_53_4_101,r_74_26_28,1.0,0,28,28,93
42,r_12_50_48,r_92_87_189,r_66_113_56,r_12_50_48,0.55,142,190,48,93
29,r_70_77_50,r_12_50_48,r_134_29_193,r_134_29_193,1.0,-137,56,193,93
52,seq8,r_36_149_109,seq81,r_36_149_109,0.93,0,109,109,93
39,r_145_47_140,r_14_96_150,seq24,r_145_47_140,1.0,1,141,140,93
46,r_49_139_49,seq116,seq71,r_49_139_49,1.0,0,49,49,93
17,r_140_94_161,seq102,r_66_113_56,r_66_113_56,1.0,111,167,56,93
25,r_28_57_35,r_49_139_49,seq58,r_28_57_35,1.0,0,35,35,93
9,r_148_84_134,r_134_29_193,seq52,r_148_84_134,0.88,0,134,134,93
96,seq121,seq76,r_135_34_98,r_135_34_98,0.99,26,124,98,93
28,r_89_72_143,r_27_64_128,r_115_59_177,r_27_64_128,0.81,0,128,128,93
49,r_105_132_141,r_134_29_193,r_131_128_16,r_131_128_16,0.94,126,142,16,93
7,r_63_123_33,r_141_6_78,seq46,r_63_123_33,1.0,0,33,33,93
47,r_137_103_38,seq5,seq107,r_137_103_38,1.0,0,38,38,93
35,r_88_23_100,r_145_47_140,r_74_26_28,r_88_23_100,1.0,0,100,100,93
12,r_92_87_189,r_111_124_94,r_12_50_48,r_12_50_48,1.0,51,99,48,93
32,r_82_6_48,r_41_87_76,r_81_93_70,r_82_6_48,0.83,28,76,48,94
30,r_17_111_112,r_4_139_181,seq53,r_17_111_112,0.84,3,115,112,94
51,seq1,r_108_127_174,seq129,r_108_127_174,0.78,-55,119,174,94
36,r_77_91_161,r_37_11_170,r_105_137_100,r_77_91_161,0.44,0,161,161,94
14,r_140_51_71,r_110_144_197,seq117,r_140_51_71,1.0,0,71,71,94
20,r_130_80_138,r_69_94_165,r_89_136_125,r_69_94_165,0.98,0,165,165,94
8,r_122_30_137,seq128,seq121,r_122_30_137,0.98,0,137,137,94
53,seq134,seq63,r_142_9_109,r_142_9_109,1.0,6,115,109,94
37,r_138_79_117,r_48_99_124,r_131_7_191,r_138_79_117,0.95,0,117,117,94
19,r_41_87_76,r_4_139_181,r_15_10_56,r_41_87_76,0.49,89,165,76,94
55,seq13,r_98_27_116,seq124,r_98_27_116,1.0,0,116,116,94
16,r_105_137_100,r_122_30_137,seq145,r_105_137_100,0.93,1,101,100,94
21,r_59_61_199,r_125_102_131,r_8_132_91,r_59_61_199,0.85,-68,131,199,94
5,r_34_96_3,r_147_65_189,r_118_25_11,r_34_96_3,0.33,186,189,3,94
46,r_0_62_152,seq107,r_122_30_137,r_0_62_152,0.6,1,153,152,94
42,r_75_50_105,seq76,seq128,r_75_50_105,0.58,7,112,105,94
86,seq97,r_33_148_155,r_68_149_20,r_68_149_20,1.0,3,23,20,94
19,r_41_87_76,seq3,r_4_139_181,r_41_87_76,1.0,0,76,76,94
76,seq72,r_17_111_112,r_15_10_56,r_15_10_56,1.0,27,83,56,94
31,r_42_39_60,r_122_30_137,seq117,r_42_39_60,0.55,0,60,60,94
41,r_133_123_98,r_34_96_3,seq145,r_133_123_98,0.99,0,98,98,94
3,r_98_27_116,seq13,seq116,r_98_27_116,0.99,0,116,116,94
26,r_120_22_120,seq135,r_60_49_83,r_60_49_83,0.99,40,123,83,94
72,seq53,seq145,r_31_40_59,r_31_40_59,1.0,11,70,59,94
49,r_74_58_149,r_46_36_194,r_105_137_100,r_74_58_149,0.84,1,150,149,94
0,r_60_49_83,r_75_50_105,seq28,r_60_49_83,1.0,0,83,83,94
11,r_4_139_181,r_17_111_112,r_15_10_56,r_15_10_56,0.99,56,112,56,94
20,r_130_80_138,seq57,r_69_94_165,r_130_80_138,0.89,0,138,138,94
98,seq121,r_125_102_131,r_131_7_191,r_125_102_131,1.0,-17,114,131,94
6,r_12_21_65,seq145,seq43,r_12_21_65,0.99,0,65,65,94
27,r_81_93_70,seq24,r_82_6_48,r_81_93_70,0.99,2,72,70,94
29,r_5_92_49,seq24,seq116,r_5_92_49,1.0,0,49,49,94
2,r_89_136_125,seq107,seq146,r_89_136_125,0.96,0,125,125,94
39,r_68_149_20,seq28,seq97,r_68_149_20,1.0,0,20,20,94
47,r_69_94_165,seq146,r_130_80_138,r_69_94_165,0.46,-26,139,165,94
40,r_64_104_114,r_120_22_120,r_101_54_17,r_64_104_114,0.9,2,116,114,94
74,seq63,seq134,r_8_132_91,r_8_132_91,1.0,24,115,91,94
18,r_125_102_131,seq121,r_59_61_199,r_125_102_131,0.51,-70,61,131,94
12,r_126_47_54,r_12_21_65,seq63,r_126_47_54,0.56,1,55,54,94
24,r_147_65_189,r_34_96_3,r_41_87_76,r_41_87_76,1.0,113,189,76,94
58,seq145,seq53,r_105_137_100,r_105_137_100,0.99,2,102,100,94
38,r_8_132_91,r_74_58_149,seq63,r_8_132_91,0.98,1,92,91,94
52,seq3,seq106,r_81_93_70,r_81_93_70,1.0,32,102,70,94
77,seq76,r_75_50_105,r_48_99_124,r_75_50_105,0.53,-4,101,105,94
34,r_88_55_88,seq116,seq24,r_88_55_88,1.0,0,88,88,94
97,seq119,r_110_144_197,r_101_54_17,r_101_54_17,0.73,6,23,17,94
32,r_82_6_48,r_12_21_65,r_41_87_76,r_82_6_48,0.99,0,48,48,94
17,r_142_9_109,seq76,seq134,r_142_9_109,0.99,0,109,109,94
4,r_101_54_17,r_82_6_48,seq119,r_82_6_48,0.8,-31,17,48,94
9,r_31_40_59,r_48_99_124,seq53,r_31_40_59,1.0,1,60,59,94
96,seq117,seq16,r_140_51_71,r_140_51_71,1.0,9,80,71,94
47,r_69_94_165,r_130_80_138,r_101_54_17,r_69_94_165,0.97,0,165,165,94
28,r_23_32_93,seq119,seq116,r_23_32_93,1.0,0,93,93,94
0,r_60_49_83,seq28,r_120_22_120,r_120_22_120,0.98,3,123,120,94
49,r_74_58_149,r_8_132_91,r_46_36_194,r_8_132_91,0.91,1,92,91,94
56,seq14,seq16,r_125_102_131,r_125_102_131,0.97,4,135,131,94
18,r_125_102_131,r_59_61_199,seq14,r_125_102_131,1.0,0,131,131,94
23,r_56_73_148,seq44,seq72,r_56_73_148,0.97,0,148,148,94
35,r_48_99_124,r_138_79_117,seq76,r_138_79_117,0.95,0,117,117,94
88,seq106,seq3,r_82_6_48,r_82_6_48,1.0,10,58,48,94
93,seq114,seq3,r_81_13_100,r_81_13_100,1.0,15,115,100,95
92,seq110,seq114,r_109_58_15,r_109_58_15,0.99,56,71,15,95
28,r_109_58_15,r_4_66_42,seq110,r_109_58_15,0.49,0,15,15,95
8,r_6_25_78,r_75_149_184,r_11_91_41,r_6_25_78,0.81,4,82,78,95
46,r_4_66_42,seq61,seq85,r_4_66_42,1.0,0,42,42,95
59,seq138,seq68,r_64_63_30,r_64_63_30,1.0,60,90,30,95
55,seq9,r_113_88_143,r_32_53_18,r_113_88_143,0.97,0,143,143,95
21,r_100_39_66,seq121,r_43_29_31,r_100_39_66,1.0,1,67,66,95
39,r_70_15_142,seq120,seq54,r_70_15_142,0.84,0,142,142,95
1,r_132_97_81,r_6_25_78,seq146,r_132_97_81,1.0,0,81,81,95
97,seq121,r_26_40_198,r_135_87_134,r_135_87_134,1.0,3,137,134,95
15,r_76_112_17,seq35,seq9,r_76_112_17,0.88,0,17,17,95
5,r_81_13_100,seq23,seq114,r_81_13_100,0.88,0,100,100,95
42,r_113_88_143,seq9,seq134,r_113_88_143,0.91,0,143,143,95
7,r_0_79_91,r_103_93_35,r_73_95_136,r_73_95_136,1.0,32,168,136,95
45,r_135_87_134,seq144,r_100_39_66,r_100_39_66,1.0,5,71,66,95
24,r_73_95_136,r_76_112_17,seq127,r_73_95_136,1.0,0,136,136,95
19,r_16_147_94,seq30,r_77_140_64,r_16_147_94,0.99,0,94,94,95
43,r_42_18_20,seq134,seq12,r_42_18_20,0.98,0,20,20,95
26,r_122_71_48,r_117_104_197,seq12,r_122_71_48,1.0,0,48,48,95
37,r_103_93_35,seq35,r_41_131_153,r_103_93_35,1.0,1,36,35,95
76,seq61,seq99,r_33_116_40,r_33_116_40,1.0,70,110,40,95
31,r_69_67_69,r_19_96_139,r_11_91_41,r_69_67_69,1.0,0,69,69,95
30,r_64_63_30,seq51,seq138,r_64_63_30,1.0,0,30,30,95
66,seq35,r_34_24_159,r_11_91_41,r_11_91_41,1.0,4,45,41,95
10,r_19_96_139,r_69_67_69,r_46_50_16,r_69_67_69,0.99,0,69,69,95
0,r_32_53_18,r_100_39_66,r_65_125_32,r_100_39_66,1.0,-25,41,66,95
78,seq74,r_8_28_148,r_77_140_64,r_77_140_64,0.93,38,102,64,95
13,r_111_20_63,seq134,r_101_45_2,r_111_20_63,1.0,0,63,63,95
48,r_41_131_153,seq127,seq144,r_41_131_153,0.52,0,153,153,95
16,r_33_116_40,r_122_71_48,seq99,r_33_116_40,1.0,0,40,40,95
70,seq44,r_19_96_139,r_46_50_16,r_46_50_16,1.0,14,30,16,95
3,r_137_141_45,seq37,seq30,r_137_141_45,1.0,0,45,45,95
2,r_129_80_182,r_62_22_187,r_137_141_45,r_137_141_45,0.98,137,182,45,95
74,seq54,seq14,r_70_15_142,r_70_15_142,0.94,5,147,142,95
36,r_43_29_31,seq1,seq5,r_43_29_31,0.67,3,34,31,95
24,r_73_95_136,r_77_140_64,r_76_112_17,r_77_140_64,0.98,0,64,64,95
25,r_148_139_146,r_89_60_177,r_0_79_91,r_148_139_146,1.0,0,146,146,95
88,seq99,seq61,r_33_116_40,r_33_116_40,1.0,2,42,40,95
32,r_84_57_190,r_108_133_29,r_7_136_175,r_7_136_175,0.56,9,184,175,95
38,r_72_48_112,r_41_131_153,seq36,r_72_48_112,0.97,0,112,112,95
45,r_135_87_134,r_100_39_66,seq121,r_135_87_134,1.0,0,134,134,95
18,r_145_59_99,r_19_96_139,r_46_50_16,r_46_50_16,1.0,5,21,16,95
96,seq120,r_70_15_142,r_118_102_7,r_70_15_142,1.0,0,142,142,95
17,r_46_50_16,r_33_116_40,r_145_59_99,r_46_50_16,1.0,0,16,16,95
37,r_103_93_35,r_41_131_153,r_0_79_91,r_103_93_35,0.98,93,128,35,95
29,r_34_24_159,seq35,seq120,r_34_24_159,0.46,-1,158,159,95
49,r_11_91_41,r_72_48_112,seq35,r_11_91_41,1.0,0,41,41,95
22,r_89_60_177,seq83,r_6_25_78,r_89_60_177,0.27,3,180,177,95
56,seq10,r_8_28_148,seq23,r_8_28_148,1.0,0,148,148,95
7,r_0_79_91,seq12,r_103_93_35,r_0_79_91,1.0,0,91,91,95
18,r_145_59_99,r_46_50_16,seq17,r_145_59_99,1.0,1,100,99,95
44,r_75_149_184,r_56_21_3,r_0_79_91,r_0_79_91,0.63,94,185,91,95
23,r_101_45_2,r_81_13_100,r_111_20_63,r_101_45_2,1.0,69,71,2,95
82,seq85,r_62_22_187,r_4_66_42,r_4_66_42,1.0,1,43,42,95
17,r_46_50_16,r_145_59_99,seq44,r_145_59_99,1.0,1,100,99,95
35,r_56_21_3,r_75_149_184,r_81_13_100,r_81_13_100,0.67,86,186,100,95
12,r_8_28_148,seq10,r_108_133_29,r_8_28_148,1.0,0,148,148,95
29,r_34_24_159,r_132_97_81,seq35,r_34_24_159,0.62,-148,11,159,95
14,r_65_125_32,r_0_79_91,r_32_53_18,r_0_79_91,1.0,-52,39,91,95
92,seq101,r_55_105_172,r_134_87_48,r_134_87_48,0.96,120,168,48,96
14,r_113_133_152,r_69_3_90,r_96_65_54,r_113_133_152,0.99,-61,91,152,96
53,seq8,r_119_36_149,r_18_64_28,r_18_64_28,0.98,122,150,28,96
41,r_134_87_48,r_4_17_186,seq101,r_134_87_48,1.0,1,49,48,96
83,seq79,r_56_88_153,r_25_139_85,r_25_139_85,0.98,68,153,85,96
30,r_85_137_53,seq40,seq58,r_85_137_53,0.98,0,53,53,96
48,r_147_33_12,seq57,seq32,r_147_33_12,0.81,-1,11,12,96
21,r_75_131_176,r_25_139_85,r_53_123_47,r_75_131_176,0.9,-91,85,176,96
39,r_1_94_96,r_120_99_191,seq141,r_1_94_96,0.69,1,97,96,96
2,r_38_0_86,r_34_107_121,r_4_17_186,r_38_0_86,0.48,36,122,86,96
1,r_135_59_99,seq111,seq146,r_135_59_99,0.59,3,102,99,96
46,r_61_20_68,r_23_102_193,seq48,r_61_20_68,0.9,0,68,68,96
42,r_120_99_191,r_1_94_96,r_85_137_53,r_120_99_191,0.86,-94,97,191,96
13,r_44_15_17,r_4_17_186,r_109_118_123,r_44_15_17,0.84,115,132,17,96
35,r_127_76_55,r_138_6_159,r_44_15_17,r_127_76_55,0.91,4,59,55,96
32,r_77_93_56,r_96_65_54,r_55_105_172,r_55_105_172,0.89,2,174,172,96
45,r_49_145_40,seq89,r_31_10_76,r_31_10_76,0.85,19,95,76,96
8,r_91_103_5,seq47,r_104_11_15,r_104_11_15,0.49,39,54,15,96
38,r_5_39_33,seq37,r_113_133_152,r_113_133_152,0.81,1,153,152,96
31,r_7_81_183,r_110_74_1,r_121_140_66,r_110_74_1,0.4,185,186,1,96
3,r_69_3_90,r_113_133_152,seq129,r_69_3_90,0.75,1,91,90,96
10,r_109_118_123,seq82,r_44_15_17,r_109_118_123,0.68,1,124,123,96
40,r_128_71_187,seq79,r_91_103_5,r_128_71_187,0.84,0,187,187,96
2,r_38_0_86,r_4_17_186,r_75_131_176,r_38_0_86,0.54,87,173,86,96
14,r_113_133_152,r_96_65_54,r_5_39_33,r_113_133_152,1.0,0,152,152,96
4,r_55_105_172,r_23_102_193,r_77_93_56,r_55_105_172,0.68,0,172,172,96
78,seq66,r_113_133_152,r_77_93_56,r_113_133_152,1.0,0,152,152,96
0,r_110_74_1,r_7_81_183,r_119_36_149,r_7_81_183,0.58,3,186,183,96
63,seq35,seq111,r_51_29_109,r_51_29_109,0.79,2,111,109,96
11,r_51_29_109,r_34_107_121,seq35,r_51_29_109,0.71,1,110,109,96
20,r_56_88_153,r_128_71_187,r_1_94_96,r_56_88_153,0.83,0,153,153,96
15,r_14_144_58,seq62,seq54,r_14_144_58,0.94,2,60,58,96
13,r_44_15_17,r_115_26_102,r_4_17_186,r_115_26_102,1.0,0,102,102,96
45,r_49_145_40,r_91_103_5,seq89,r_49_145_40,1.0,0,40,40,96
21,r_75_131_176,r_53_123_47,r_109_118_123,r_109_118_123,0.54,57,180,123,96
19,r_53_123_47,r_1_94_96,r_136_84_39,r_53_123_47,0.99,2,49,47,96
49,r_104_11_15,r_30_19_155,r_91_103_5,r_104_11_15,0.89,0,15,15,96
27,r_23_102_193,r_61_20_68,seq101,r_61_20_68,0.89,0,68,68,96
87,seq89,r_138_6_159,seq57,r_138_6_159,0.94,2,161,159,96
2,r_38_0_86,seq48,r_34_107_121,r_38_0_86,0.9,0,86,86,96
47,r_21_52_69,r_30_19_155,seq48,r_21_52_69,0.99,2,71,69,96
17,r_115_26_102,r_4_17_186,r_44_15_17,r_44_15_17,1.0,10,27,17,96
24,r_122_97_16,seq146,seq37,r_122_97_16,0.82,1,17,16,96
40,r_128_71_187,r_56_88_153,seq79,r_56_88_153,0.89,0,153,153,96
18,r_96_65_54,r_91_103_5,r_113_133_152,r_96_65_54,0.99,0,54,54,96
25,r_4_17_186,seq148,r_113_133_152,r_113_133_152,0.99,34,186,152,96
34,r_34_107_121,r_38_0_86,r_104_11_15,r_38_0_86,0.86,36,122,86,96
88,seq90,r_110_74_1,r_1_94_96,r_1_94_96,0.82,24,120,96,96
58,seq148,r_4_17_186,r_109_118_123,r_109_118_123,0.8,63,186,123,96
32,r_77_93_56,r_69_3_90,r_96_65_54,r_77_93_56,0.88,21,77,56,96
34,r_34_107_121,r_51_29_109,r_38_0_86,r_38_0_86,0.74,25,111,86,96
9,r_106_95_184,r_114_80_189,seq60,r_114_80_189,0.32,-4,185,189,96
22,r_28_2_136,seq126,r_120_99_191,r_28_2_136,0.86,1,137,136,96
28,r_31_10_76,seq130,r_49_145_40,r_31_10_76,0.62,2,78,76,96
13,r_44_15_17,r_55_105_172,r_115_26_102,r_44_15_17,1.0,0,17,17,96
43,r_136_84_39,r_127_76_55,seq83,r_136_84_39,0.94,0,39,39,96
7,r_121_140_66,r_28_2_136,seq47,r_28_2_136,0.61,-67,69,136,96
18,r_96_65_54,r_113_133_152,r_42_9_98,r_96_65_54,0.99,98,152,54,96
42,r_120_99_191,r_85_137_53,r_28_2_136,r_28_2_136,0.61,-4,132,136,96
23,r_25_139_85,seq83,seq41,r_25_139_85,1.0,0,85,85,96
17,r_115_26_102,r_44_15_17,seq40,r_115_26_102,0.97,0,102,102,96
38,r_5_39_33,r_4_17_186,seq37,r_5_39_33,0.69,0,33,33,96
12,r_142_125_125,seq60,r_86_43_8,r_142_125_125,0.9,0,125,125,96
44,r_18_64_28,r_127_76_55,seq40,r_18_64_28,0.67,0,28,28,96
30,r_59_95_103,r_146_116_171,r_21_26_176,r_59_95_103,1.0,0,103,103,97
44,r_17_145_147,r_78_48_2,seq63,r_17_145_147,0.99,0,147,147,97
9,r_99_71_10,r_58_129_192,r_75_141_197,r_99_71_10,0.56,2,12,10,97
36,r_72_11_88,r_25_130_187,seq0,r_72_11_88,1.0,0,88,88,97
14,r_16_67_186,r_92_13_128,r_105_76_127,r_16_67_186,0.81,-58,128,186,97
18,r_135_115_40,r_91_2_84,seq61,r_135_115_40,0.66,-1,39,40,97
8,r_110_40_70,r_91_2_84,seq126,r_91_2_84,0.91,-14,70,84,97
53,seq6,r_134_60_136,r_103_97_113,r_134_60_136,1.0,1,137,136,97
43,r_105_76_127,r_10_18_50,r_15_140_72,r_105_76_127,0.76,1,128,127,97
37,r_118_108_68,seq143,r_62_79_7,r_118_108_68,1.0,0,68,68,97
24,r_3_128_44,r_105_76_127,seq44,r_3_128_44,0.53,5,49,44,97
16,r_131_68_181,r_53_117_140,seq132,r_53_117_140,1.0,0,140,140,97
39,r_65_57_107,r_21_26_176,r_99_71_10,r_65_57_107,0.58,10,117,107,97
1,r_149_34_114,r_62_79_7,seq61,r_149_34_114,1.0,0,114,114,97
5,r_84_102_95,r_92_13_128,seq148,r_84_102_95,1.0,0,95,95,97
46,r_92_13_128,seq122,r_149_34_114,r_92_13_128,0.9,0,128,128,97
7,r_15_140_72,r_16_67_186,r_100_12_189,r_16_67_186,0.86,-25,161,186,97
45,r_94_66_139,r_25_130_187,seq127,r_94_66_139,0.97,0,139,139,97
32,r_20_36_34,seq127,seq61,r_20_36_34,0.75,0,34,34,97
19,r_119_29_161,r_10_18_50,r_59_95_103,r_119_29_161,0.59,0,161,161,97
15,r_62_79_7,r_149_34_114,r_118_108_68,r_62_79_7,0.6,103,110,7,97
4,r_38_43_138,seq44,r_5_14_82,r_38_43_138,0.97,2,140,138,97
0,r_73_98_35,r_133_144_63,seq61,r_73_98_35,1.0,-2,33,35,97
31,r_33_90_94,r_17_145_147,seq22,r_17_145_147,0.84,-51,96,147,97
41,r_86_124_185,seq142,r_15_140_72,r_86_124_185,0.46,0,185,185,97
3,r_4_85_172,r_47_137_193,r_73_98_35,r_4_85_172,0.81,0,172,172,97
10,r_104_27_184,seq139,r_110_40_70,r_110_40_70,0.57,116,186,70,97
26,r_91_2_84,r_5_14_82,r_100_12_189,r_91_2_84,0.94,0,84,84,97
4,r_38_43_138,r_91_2_84,seq44,r_91_2_84,1.0,-3,81,84,97
73,seq49,r_138_50_165,seq37,r_138_50_165,1.0,1,166,165,97
11,r_146_116_171,seq0,r_84_102_95,r_146_116_171,0.57,0,171,171,97
99,seq127,seq9,r_94_66_139,r_94_66_139,0.95,1,140,139,97
20,r_133_144_63,r_25_130_187,seq28,r_133_144_63,1.0,0,63,63,97
13,r_114_125_132,r_54_39_196,r_5_14_82,r_114_125_132,0.7,0,132,132,97
98,seq126,seq87,r_110_40_70,r_110_40_70,0.96,6,76,70,97
48,r_47_137_193,r_4_85_172,r_84_102_95,r_84_102_95,0.99,77,172,95,97
14,r_16_67_186,r_105_76_127,r_138_50_165,r_16_67_186,1.0,0,186,186,97
1,r_149_34_114,seq121,r_62_79_7,r_62_79_7,1.0,5,12,7,97
2,r_5_14_82,r_91_2_84,seq1,r_5_14_82,1.0,0,82,82,97
47,r_45_19_133,r_103_97_113,seq127,r_45_19_133,0.93,0,133,133,97
40,r_21_26_176,r_65_57_107,r_3_128_44,r_65_57_107,0.59,69,176,107,97
29,r_53_117_140,r_131_68_181,seq6,r_53_117_140,0.62,0,140,140,97
25,r_25_130_187,seq24,r_119_29_161,r_25_130_187,0.29,2,189,187,97
99,seq127,r_20_36_34,seq9,r_20_36_34,1.0,0,34,34,97
58,seq142,r_86_124_185,seq55,r_86_124_185,0.82,0,185,185,97
38,r_10_18_50,r_119_29_161,r_149_34_114,r_149_34_114,0.98,47,161,114,97
34,r_100_12_189,seq122,r_91_2_84,r_91_2_84,1.0,45,129,84,97
44,r_17_145_147,r_89_64_65,r_78_48_2,r_78_48_2,0.62,50,52,2,97
17,r_103_97_113,r_45_19_133,seq6,r_45_19_133,1.0,-20,113,133,97
30,r_59_95_103,r_21_26_176,r_119_29_161,r_119_29_161,0.69,0,161,161,97
96,seq122,r_35_93_182,r_91_2_84,r_91_2_84,0.99,94,178,84,97
28,r_134_60_136,seq6,seq7,r_134_60_136,0.89,0,136,136,97
49,r_89_64_65,r_17_145_147,r_78_48_2,r_17_145_147,0.98,-95,52,147,97
7,r_15_140_72,seq120,r_16_67_186,r_15_140_72,1.0,1,73,72,97
35,r_109_56_104,seq28,r_78_48_2,r_109_56_104,1.0,0,104,104,97
12,r_138_50_165,seq49,r_62_79_7,r_138_50_165,0.92,1,166,165,97
47,r_45_19_133,seq127,r_33_90_94,r_45_19_133,0.53,50,183,133,97
30,r_64_137_64,r_29_85_80,r_60_100_190,r_60_100_190,0.7,-126,64,190,98
44,r_129_44_168,r_88_28_67,seq93,r_129_44_168,0.95,0,168,168,98
8,r_60_100_190,r_13_39_77,r_64_137_64,r_60_100_190,1.0,-111,79,190,98
43,r_13_39_77,r_60_100_190,seq26,r_13_39_77,1.0,2,79,77,98
16,r_95_123_107,seq77,r_76_65_27,r_95_123_107,0.86,7,114,107,98
39,r_145_131_172,r_75_16_103,seq77,r_75_16_103,1.0,0,103,103,98
1,r_72_46_169,seq90,seq6,r_72_46_169,0.72,1,170,169,98
7,r_88_28_67,r_2_23_112,r_129_44_168,r_2_23_112,1.0,0,112,112,98
45,r_22_112_124,seq138,seq15,r_22_112_124,1.0,9,133,124,98
41,r_143_12_31,r_113_0_152,seq78,r_143_12_31,0.98,-1,30,31,98
19,r_9_54_65,r_109_119_185,seq62,r_9_54_65,1.0,2,67,65,98
39,r_145_131_172,seq77,r_5_125_21,r_145_131_172,0.34,3,175,172,98
31,r_110_107_68,r_136_98_130,seq138,r_110_107_68,1.0,3,71,68,98
67,seq35,seq114,r_115_81_108,r_115_81_108,1.0,12,120,108,98
3,r_111_37_89,r_22_112_124,seq21,r_111_37_89,0.8,1,90,89,98
90,seq90,r_113_0_152,r_53_144_84,r_53_144_84,0.75,19,103,84,98
14,r_149_140_41,r_92_130_51,seq78,r_149_140_41,1.0,-1,40,41,98
4,r_2_23_112,r_133_141_95,r_88_28_67,r_88_28_67,0.86,17,84,67,98
13,r_109_119_185,seq80,r_29_85_80,r_29_85_80,1.0,10,90,80,98
85,seq77,r_95_123_107,seq121,r_95_123_107,1.0,19,126,107,98
27,r_104_27_163,seq20,seq138,r_104_27_163,0.79,0,163,163,98
18,r_124_127_116,seq70,r_66_102_85,r_66_102_85,0.99,35,120,85,98
24,r_117_61_91,seq114,seq51,r_117_61_91,1.0,0,91,91,98
36,r_89_116_54,seq1,seq14,r_89_116_54,1.0,-2,52,54,98
25,r_79_63_111,r_118_32_194,seq18,r_79_63_111,0.97,0,111,111,98
33,r_128_122_97,r_147_56_170,seq70,r_128_122_97,1.0,0,97,97,98
37,r_76_65_27,r_104_27_163,r_109_119_185,r_104_27_163,0.64,-131,32,163,98
32,r_53_144_84,r_129_44_168,seq90,r_53_144_84,0.97,0,84,84,98
38,r_29_85_80,seq11,r_109_119_185,r_29_85_80,1.0,1,81,80,98
77,seq51,r_92_130_51,r_128_122_97,r_92_130_51,0.98,90,141,51,98
34,r_50_134_88,seq87,seq59,r_50_134_88,1.0,0,88,88,98
26,r_136_98_130,r_110_107_68,r_43_142_44,r_110_107_68,0.58,-29,39,68,98
63,seq25,r_136_98_130,r_133_141_95,r_133_141_95,0.97,-1,94,95,98
26,r_136_98_130,r_43_142_44,r_95_123_107,r_136_98_130,0.52,8,138,130,98
29,r_43_142_44,r_136_98_130,seq47,r_136_98_130,1.0,2,132,130,98
22,r_115_81_108,seq135,seq35,r_115_81_108,0.97,0,108,108,98
2,r_30_91_35,r_147_56_170,seq96,r_147_56_170,0.84,-136,34,170,98
28,r_75_16_103,r_145_131_172,seq96,r_75_16_103,1.0,0,103,103,98
91,seq93,r_10_73_176,r_129_44_168,r_129_44_168,0.86,13,181,168,98
49,r_66_102_85,r_10_73_176,seq57,r_66_102_85,1.0,0,85,85,98
7,r_88_28_67,seq6,r_2_23_112,r_88_28_67,0.95,1,68,67,98
44,r_129_44_168,r_2_23_112,r_88_28_67,r_88_28_67,0.86,22,89,67,98
11,r_92_130_51,seq51,r_5_125_21,r_92_130_51,1.0,1,52,51,98
23,r_71_99_174,seq135,r_58_86_143,r_71_99_174,0.74,0,174,174,98
4,r_2_23_112,r_88_28_67,r_64_137_64,r_2_23_112,1.0,0,112,112,98
29,r_43_142_44,seq68,r_136_98_130,r_43_142_44,0.88,-4,40,44,98
79,seq57,r_58_86_143,r_66_102_85,r_66_102_85,1.0,0,85,85,98
35,r_24_52_148,r_74_31_182,seq47,r_74_31_182,0.82,-33,149,182,98
12,r_94_69_114,r_109_119_185,r_66_102_85,r_66_102_85,0.98,29,114,85,98
84,seq70,r_124_127_116,r_128_122_97,r_128_122_97,1.0,0,97,97,98
8,r_89_67_39,r_130_36_63,seq65,r_89_67_39,0.86,0,39,39,99
40,r_123_122_30,r_105_79_139,r_98_118_45,r_98_118_45,0.67,98,143,45,99
36,r_35_52_89,r_34_33_100,seq71,r_35_52_89,0.68,0,89,89,99
14,r_131_80_13,seq71,r_62_88_153,r_62_88_153,0.37,-49,104,153,99
43,r_97_66_69,r_102_83_83,seq31,r_97_66_69,0.78,0,69,69,99
21,r_111_11_15,r_105_79_139,r_27_86_123,r_111_11_15,0.71,0,15,15,99
71,seq136,r_26_120_143,r_6_142_10,r_26_120_143,0.99,-20,123,143,99
16,r_105_79_139,r_56_45_102,r_123_122_30,r_105_79_139,0.91,-39,100,139,99
1,r_75_70_106,r_148_112_132,seq77,r_75_70_106,1.0,0,106,106,99
5,r_73_149_141,r_20_113_159,r_147_46_38,r_73_149_141,0.96,0,141,141,99
46,r_102_83_83,r_44_1_136,seq136,r_44_1_136,1.0,-52,84,136,99
42,r_40_138_71,r_44_1_136,seq48,r_40_138_71,0.96,1,72,71,99
24,r_91_47_185,r_94_93_88,r_74_23_59,r_91_47_185,0.78,0,185,185,99
19,r_130_36_63,seq104,r_98_118_45,r_130_36_63,1.0,0,63,63,99
27,r_139_132_92,r_16_61_180,r_96_95_128,r_139_132_92,0.85,88,180,92,99
31,r_129_64_76,seq125,seq21,r_129_64_76,1.0,0,76,76,99
38,r_98_118_45,seq51,r_30_145_26,r_98_118_45,1.0,0,45,45,99
13,r_44_1_136,r_25_50_174,r_148_112_132,r_25_50_174,1.0,0,174,174,99
26,r_63_19_91,r_105_79_139,seq17,r_63_19_91,0.56,2,93,91,99
4,r_26_120_143,seq136,r_27_86_123,r_26_120_143,0.79,0,143,143,99
11,r_72_135_64,seq140,r_98_118_45,r_72_135_64,0.99,4,68,64,99
20,r_49_53_122,r_114_4_124,seq51,r_49_53_122,0.97,0,122,122,99
13,r_44_1_136,r_127_28_47,r_25_50_174,r_44_1_136,0.98,0,136,136,99
15,r_148_112_132,r_10_133_182,seq128,r_148_112_132,0.82,-2,130,132,99
6,r_114_4_124,r_49_53_122,seq109,r_49_53_122,0.89,0,122,122,99
21,r_111_11_15,r_27_86_123,r_139_132_92,r_111_11_15,0.72,108,123,15,99
85,seq90,r_20_113_159,r_144_110_130,r_144_110_130,0.64,29,159,130,99
41,r_30_145_26,r_25_50_174,seq2,r_30_145_26,1.0,0,26,26,99
27,r_139_132_92,seq146,r_16_61_180,r_139_132_92,0.99,0,92,92,99
2,r_62_88_153,r_10_133_182,r_131_80_13,r_62_88_153,0.46,12,165,153,99
47,r_34_33_100,r_35_52_89,r_20_113_159,r_35_52_89,0.76,0,89,89,99
18,r_56_45_102,r_105_79_139,seq3,r_56_45_102,0.95,2,104,102,99
29,r_144_110_130,seq106,seq90,r_144_110_130,0.9,1,131,130,99
24,r_91_47_185,seq101,r_94_93_88,r_94_93_88,1.0,21,109,88,99
34,r_16_61_180,r_139_132_92,seq101,r_16_61_180,0.53,0,180,180,99
33,r_94_93_88,r_91_47_185,r_16_61_180,r_94_93_88,0.49,97,185,88,99
88,seq101,r_91_47_185,r_16_61_180,r_16_61_180,0.91,1,181,180,99
3,r_74_23_59,r_85_54_144,seq103,r_74_23_59,1.0,0,59,59,99
70,seq48,r_96_95_128,seq134,r_96_95_128,0.95,5,133,128,99
68,seq41,r_60_141_168,r_26_120_143,r_26_120_143,0.53,25,168,143,99
32,r_20_113_159,seq90,r_102_83_83,r_20_113_159,0.67,0,159,159,99
47,r_34_33_100,r_20_113_159,seq128,r_34_33_100,0.98,0,100,100,99
77,seq71,r_10_133_182,r_35_52_89,r_35_52_89,0.98,2,91,89,99
35,r_25_50_174,seq41,r_44_1_136,r_44_1_136,1.0,0,136,136,99
34,r_16_61_180,r_27_86_123,r_139_132_92,r_16_61_180,0.8,-93,87,180,99
35,r_25_50_174,r_30_145_26,r_89_67_39,r_30_145_26,0.84,0,26,26,99
80,seq77,r_0_92_74,r_75_70_106,r_75_70_106,1.0,1,107,106,99
40,r_123_122_30,r_0_92_74,r_105_79_139,r_123_122_30,0.97,0,30,30,99
9,r_124_55_65,r_9_42_147,seq14,r_124_55_65,0.9,0,65,65,99
35,r_25_50_174,r_44_1_136,seq117,r_25_50_174,0.97,0,174,174,99
22,r_0_92_74,r_60_141_168,seq77,r_0_92_74,1.0,0,74,74,99
28,r_108_22_110,seq106,seq8,r_108_22_110,0.97,0,110,110,99
91,seq106,r_144_110_130,seq41,r_144_110_130,0.87,2,132,130,99
35,r_25_50_174,r_89_67_39,seq41,r_25_50_174,0.68,-134,40,174,99
49,r_137_100_116,seq31,r_123_122_30,r_123_122_30,0.82,92,122,30,99
44,r_60_141_168,r_0_92_74,seq41,r_0_92_74,1.0,1,75,74,99
23,r_27_86_123,r_111_11_15,seq41,r_27_86_123,0.75,0,123,123,99
16,r_105_79_139,r_123_122_30,r_108_22_110,r_108_22_110,0.67,33,143,110,99
