36,r_16_125_47,r_89_50_86,r_13_99_49,r_89_50_86,1.0,-12,74,86,0
43,r_63_22_73,r_144_130_69,seq82,r_63_22_73,1.0,-4,69,73,0
2,r_79_30_59,r_146_96_72,seq115,r_79_30_59,1.0,0,59,59,0
16,r_17_2_110,seq95,r_85_102_108,r_85_102_108,0.5,2,110,108,0
39,r_105_41_96,r_127_65_185,r_103_64_25,r_105_41_96,0.95,0,96,96,0
1,r_112_43_106,seq134,r_141_76_34,r_112_43_106,0.82,1,107,106,0
32,r_55_28_50,r_68_86_64,r_94_109_32,r_55_28_50,0.76,0,50,50,0
42,r_40_9_85,seq61,seq18,r_40_9_85,1.0,0,85,85,0
63,seq148,r_142_117_118,r_11_104_168,r_142_117_118,0.68,-77,41,118,0
45,r_56_67_84,seq32,r_132_129_9,r_56_67_84,0.99,2,86,84,0
19,r_144_130_69,r_63_22_73,r_120_1_199,r_144_130_69,1.0,0,69,69,0
33,r_78_52_31,r_103_64_25,seq10,r_78_52_31,1.0,3,34,31,0
31,r_46_49_71,r_146_96_72,r_103_64_25,r_146_96_72,0.98,0,72,72,0
41,r_127_65_185,seq93,r_132_129_9,r_132_129_9,0.53,176,185,9,0
26,r_39_136_14,r_113_81_176,r_141_76_34,r_141_76_34,1.0,0,34,34,0
30,r_111_80_29,r_29_90_82,seq118,r_111_80_29,0.72,7,36,29,0
3,r_19_73_190,seq12,r_142_117_118,r_142_117_118,1.0,72,190,118,0
17,r_94_109_32,r_6_97_181,seq92,r_94_109_32,1.0,0,32,32,0
10,r_7_122_99,seq57,r_133_58_162,r_7_122_99,0.61,0,99,99,0
85,seq88,seq34,r_138_53_12,r_138_53_12,1.0,0,12,12,0
56,seq139,r_39_136_14,seq114,r_39_136_14,0.93,0,14,14,0
26,r_39_136_14,seq139,r_113_81_176,r_39_136_14,0.95,0,14,14,0
0,r_38_47_62,seq115,r_69_70_114,r_38_47_62,1.0,0,62,62,0
83,seq82,r_16_125_47,r_111_80_29,r_16_125_47,1.0,0,47,47,0
20,r_142_117_118,seq48,seq14,r_142_117_118,0.99,1,119,118,0
12,r_13_99_49,r_56_67_84,seq75,r_13_99_49,1.0,1,50,49,0
13,r_124_147_127,seq98,seq143,r_124_147_127,0.96,0,127,127,0
56,seq139,seq114,r_38_47_62,r_38_47_62,0.99,24,86,62,0
15,r_54_35_144,seq12,seq77,r_54_35_144,0.84,0,144,144,0
48,r_36_101_182,r_20_45_111,r_56_67_84,r_36_101_182,0.99,-70,112,182,0
57,seq12,r_19_73_190,r_59_0_174,r_59_0_174,0.98,8,182,174,0
6,r_20_45_111,r_36_101_182,r_7_122_99,r_36_101_182,1.0,-70,112,182,0
29,r_113_81_176,r_132_129_9,r_39_136_14,r_39_136_14,0.91,0,14,14,0
4,r_141_76_34,seq18,r_39_136_14,r_141_76_34,0.99,0,34,34,0
40,r_25_33_115,r_59_0_174,seq143,r_25_33_115,0.59,-1,114,115,0
18,r_89_50_86,seq14,seq61,r_89_50_86,1.0,0,86,86,0
5,r_132_129_9,seq34,seq119,r_132_129_9,0.69,1,10,9,0
24,r_120_1_199,seq51,r_144_130_69,r_144_130_69,1.0,1,70,69,0
25,r_146_96_72,r_46_49_71,r_144_130_69,r_46_49_71,0.91,1,72,71,0
48,r_36_101_182,r_56_67_84,r_79_30_59,r_36_101_182,0.99,0,182,182,0
50,seq3,r_133_58_162,r_20_45_111,r_20_45_111,0.99,12,123,111,0
38,r_85_102_108,seq92,r_17_2_110,r_85_102_108,1.0,2,110,108,0
10,r_7_122_99,r_133_58_162,r_20_45_111,r_20_45_111,0.77,9,120,111,0
36,r_16_125_47,seq82,r_89_50_86,r_16_125_47,0.89,0,47,47,0
29,r_113_81_176,r_39_136_14,r_138_53_12,r_113_81_176,0.32,2,178,176,0
22,r_74_15_7,r_59_0_174,r_17_2_110,r_17_2_110,1.0,68,178,110,0
55,seq10,seq34,r_78_52_31,r_78_52_31,1.0,24,55,31,0
34,r_138_53_12,r_38_47_62,seq88,r_138_53_12,0.97,0,12,12,0
28,r_91_106_152,r_27_123_191,r_89_50_86,r_89_50_86,0.47,67,153,86,0
44,r_68_86_64,r_142_117_118,r_25_33_115,r_142_117_118,0.89,1,119,118,0
44,r_68_86_64,seq37,r_142_117_118,r_68_86_64,1.0,0,64,64,0
23,r_83_128_154,seq44,r_103_64_25,r_83_128_154,0.79,1,155,154,0
83,seq82,r_111_80_29,r_63_22_73,r_63_22_73,1.0,2,75,73,0
35,r_133_58_162,seq3,r_40_9_85,r_40_9_85,0.99,79,164,85,0
93,seq98,r_123_56_186,r_6_104_73,r_6_104_73,1.0,113,186,73,1
92,seq97,seq21,r_19_86_118,r_19_86_118,0.99,-1,117,118,1
43,r_143_119_125,r_34_27_187,seq16,r_143_119_125,0.99,1,126,125,1
1,r_144_96_32,r_103_126_109,r_139_57_18,r_144_96_32,1.0,0,32,32,1
54,seq16,r_87_47_181,r_24_147_90,r_24_147_90,1.0,91,181,90,1
37,r_87_47_181,seq16,r_135_108_167,r_135_108_167,0.64,15,182,167,1
55,seq17,r_42_125_155,r_103_126_109,r_103_126_109,1.0,54,163,109,1
86,seq84,seq71,r_133_32_76,r_133_32_76,0.76,25,101,76,1
16,r_123_56_186,seq98,seq44,r_123_56_186,0.45,0,186,186,1
21,r_115_137_126,seq74,r_81_11_9,r_115_137_126,1.0,1,127,126,1
39,r_95_15_93,r_118_75_162,r_144_96_32,r_95_15_93,1.0,0,93,93,1
14,r_43_83_40,seq55,seq148,r_43_83_40,0.99,3,43,40,1
5,r_146_36_139,r_123_56_186,r_131_12_88,r_146_36_139,0.91,0,139,139,1
42,r_106_4_112,seq52,r_144_96_32,r_106_4_112,1.0,0,112,112,1
80,seq74,r_115_137_126,seq46,r_115_137_126,1.0,1,127,126,1
45,r_100_31_58,r_135_108_167,seq148,r_100_31_58,1.0,3,61,58,1
30,r_142_124_22,seq21,seq77,r_142_124_22,0.98,0,22,22,1
89,seq90,r_79_61_36,r_3_69_140,r_3_69_140,1.0,-1,139,140,1
19,r_6_104_73,seq99,seq98,r_6_104_73,1.0,1,74,73,1
38,r_129_41_54,seq90,seq93,r_129_41_54,1.0,0,54,54,1
66,seq52,r_106_4_112,r_29_114_17,r_106_4_112,0.94,0,112,112,1
76,seq70,r_34_27_187,seq82,r_34_27_187,0.72,-9,178,187,1
31,r_118_75_162,seq148,r_129_41_54,r_129_41_54,1.0,115,169,54,1
41,r_19_86_118,r_76_116_108,seq10,r_76_116_108,0.72,0,108,108,1
68,seq55,r_49_88_143,r_120_113_132,r_120_113_132,1.0,0,132,132,1
3,r_103_126_109,r_58_65_158,r_23_0_199,r_103_126_109,1.0,0,109,109,1
10,r_120_113_132,seq78,seq55,r_120_113_132,0.97,0,132,132,1
90,seq93,seq141,r_129_41_54,r_129_41_54,1.0,27,81,54,1
35,r_29_114_17,r_142_124_22,seq52,r_29_114_17,0.97,2,19,17,1
0,r_3_69_140,seq40,seq90,r_3_69_140,0.95,1,141,140,1
73,seq66,seq33,r_128_50_71,r_128_50_71,1.0,31,102,71,1
13,r_110_51_83,r_38_121_174,r_23_0_199,r_110_51_83,1.0,0,83,83,1
98,seq148,r_118_75_162,r_100_31_58,r_100_31_58,1.0,111,169,58,1
15,r_9_136_104,r_76_116_108,seq55,r_76_116_108,0.68,-1,107,108,1
6,r_24_147_90,seq22,seq67,r_24_147_90,1.0,0,90,90,1
23,r_131_12_88,r_63_91_59,r_149_132_10,r_149_132_10,0.92,6,16,10,1
99,seq127,r_145_122_149,seq22,r_145_122_149,0.46,-46,103,149,1
87,seq85,r_145_122_149,r_120_113_132,r_120_113_132,0.88,18,150,132,1
2,r_38_121_174,r_1_117_194,r_131_12_88,r_38_121_174,0.52,0,174,174,1
47,r_48_28_98,seq54,seq16,r_48_28_98,1.0,0,98,98,1
48,r_45_109_46,r_87_47_181,seq35,r_45_109_46,0.99,-1,45,46,1
40,r_128_50_71,r_42_125_155,seq66,r_128_50_71,1.0,0,71,71,1
18,r_1_117_194,r_38_121_174,seq37,r_38_121_174,0.86,0,174,174,1
24,r_18_138_64,r_103_126_109,r_144_96_32,r_103_126_109,0.98,-45,64,109,1
25,r_39_7_91,r_49_88_143,seq68,r_39_7_91,0.99,2,93,91,1
33,r_26_8_94,seq13,r_76_116_108,r_26_8_94,0.85,7,101,94,1
17,r_149_132_10,r_81_11_9,r_131_12_88,r_149_132_10,1.0,0,10,10,1
58,seq22,r_24_147_90,r_63_91_59,r_24_147_90,0.67,0,90,90,1
9,r_49_88_143,seq22,r_120_113_132,r_120_113_132,0.97,17,149,132,1
32,r_76_116_108,r_19_86_118,r_26_8_94,r_76_116_108,0.82,0,108,108,1
68,seq55,r_145_122_149,r_49_88_143,r_145_122_149,0.45,-40,109,149,1
27,r_79_61_36,r_115_137_126,seq67,r_79_61_36,1.0,0,36,36,1
94,seq99,r_6_104_73,seq112,r_6_104_73,1.0,-2,71,73,1
9,r_49_88_143,r_39_7_91,seq22,r_39_7_91,1.0,2,93,91,1
26,r_135_108_167,seq97,seq80,r_135_108_167,1.0,0,167,167,1
22,r_63_91_59,r_101_53_123,r_5_25_6,r_101_53_123,0.6,-62,61,123,1
49,r_34_27_187,seq70,r_24_147_90,r_24_147_90,1.0,97,187,90,1
7,r_133_32_76,seq21,seq84,r_133_32_76,0.63,4,80,76,1
44,r_145_122_149,seq85,r_103_126_109,r_103_126_109,0.91,41,150,109,1
17,r_149_132_10,r_131_12_88,seq70,r_131_12_88,0.95,1,89,88,1
12,r_58_65_158,seq35,seq70,r_58_65_158,0.9,1,159,158,1
89,seq90,r_129_41_54,r_79_61_36,r_129_41_54,0.47,0,54,54,1
23,r_131_12_88,r_149_132_10,seq40,r_131_12_88,0.92,-2,86,88,1
68,seq55,r_43_83_40,r_145_122_149,r_43_83_40,0.93,3,43,40,1
30,r_75_120_101,seq14,seq2,r_75_120_101,0.99,-1,100,101,2
36,r_49_128_71,r_48_109_159,seq137,r_49_128_71,1.0,0,71,71,2
14,r_66_28_16,r_48_109_159,r_32_36_20,r_66_28_16,0.69,143,159,16,2
8,r_55_78_116,r_71_141_162,seq27,r_55_78_116,0.99,0,116,116,2
81,seq82,r_80_87_14,r_139_91_164,r_139_91_164,0.75,2,166,164,2
37,r_122_18_5,r_20_58_167,r_21_74_36,r_122_18_5,0.83,149,154,5,2
59,seq19,r_126_123_147,r_25_4_78,r_25_4_78,0.99,-3,75,78,2
21,r_68_59_107,r_127_24_136,r_21_74_36,r_68_59_107,1.0,0,107,107,2
39,r_136_98_73,seq129,seq43,r_136_98_73,0.48,7,80,73,2
6,r_53_63_70,r_61_70_33,r_8_44_118,r_8_44_118,1.0,0,118,118,2
1,r_71_141_162,seq51,r_32_36_20,r_32_36_20,0.95,146,166,20,2
42,r_126_123_147,seq19,r_15_65_150,r_126_123_147,0.72,2,149,147,2
27,r_32_36_20,r_99_117_135,seq113,r_32_36_20,1.0,3,23,20,2
45,r_41_22_82,seq30,seq83,r_41_22_82,1.0,0,82,82,2
32,r_61_70_33,seq113,seq114,r_61_70_33,0.87,0,33,33,2
31,r_100_23_130,r_95_35_156,seq19,r_100_23_130,0.6,-1,129,130,2
67,seq37,r_95_35_156,seq51,r_95_35_156,0.98,0,156,156,2
3,r_99_117_135,r_140_143_141,r_15_65_150,r_99_117_135,0.69,0,135,135,2
10,r_10_77_62,seq137,seq92,r_10_77_62,0.73,2,64,62,2
0,r_94_52_38,r_136_98_73,seq62,r_94_52_38,1.0,3,41,38,2
47,r_34_112_57,seq33,seq13,r_34_112_57,1.0,1,58,57,2
34,r_138_115_18,r_12_131_76,r_95_35_156,r_95_35_156,1.0,4,160,156,2
4,r_130_145_123,r_20_58_167,r_8_44_118,r_20_58_167,1.0,-44,123,167,2
63,seq27,r_146_64_128,r_55_78_116,r_55_78_116,0.98,0,116,116,2
11,r_39_11_83,r_139_91_164,r_38_132_2,r_39_11_83,1.0,1,84,83,2
13,r_101_31_168,seq83,r_94_52_38,r_94_52_38,0.74,132,170,38,2
48,r_127_24_136,r_68_59_107,r_69_67_179,r_68_59_107,0.99,-7,100,107,2
75,seq62,r_110_97_55,r_94_52_38,r_94_52_38,1.0,19,57,38,2
6,r_53_63_70,seq27,r_61_70_33,r_53_63_70,0.96,0,70,70,2
62,seq26,seq42,r_41_22_82,r_41_22_82,1.0,9,91,82,2
5,r_21_74_36,r_8_44_118,r_68_59_107,r_21_74_36,1.0,82,118,36,2
87,seq92,r_50_134_133,r_10_77_62,r_50_134_133,0.58,-33,100,133,2
41,r_57_0_35,r_56_73_196,seq51,r_57_0_35,0.99,1,36,35,2
2,r_146_64_128,r_99_117_135,seq33,r_146_64_128,0.63,0,128,128,2
18,r_12_131_76,r_100_23_130,r_138_115_18,r_12_131_76,0.99,1,77,76,2
28,r_110_97_55,seq62,seq142,r_110_97_55,0.58,2,57,55,2
24,r_25_4_78,r_101_31_168,seq19,r_25_4_78,1.0,0,78,78,2
34,r_138_115_18,r_47_54_93,r_12_131_76,r_138_115_18,0.49,66,84,18,2
43,r_80_87_14,r_10_77_62,r_130_145_123,r_80_87_14,0.95,4,18,14,2
35,r_139_91_164,r_94_52_38,seq82,r_139_91_164,0.98,1,165,164,2
43,r_80_87_14,r_130_145_123,r_21_74_36,r_130_145_123,1.0,0,123,123,2
33,r_81_133_188,seq111,r_41_22_82,r_41_22_82,0.53,106,188,82,2
46,r_125_90_51,r_39_11_83,seq33,r_125_90_51,0.63,2,53,51,2
38,r_48_109_159,r_66_28_16,seq29,r_48_109_159,0.67,0,159,159,2
77,seq129,r_136_98_73,seq43,r_136_98_73,0.43,62,135,73,2
23,r_118_119_125,r_81_133_188,seq129,r_118_119_125,0.51,-67,58,125,2
44,r_121_93_152,seq14,r_20_58_167,r_20_58_167,0.95,0,167,167,2
81,seq82,r_21_74_36,r_80_87_14,r_80_87_14,0.99,6,20,14,2
5,r_21_74_36,r_126_123_147,r_8_44_118,r_21_74_36,0.82,2,38,36,2
17,r_15_65_150,r_95_35_156,seq13,r_95_35_156,0.57,-2,154,156,2
94,seq107,r_47_54_93,seq84,r_47_54_93,1.0,3,96,93,2
34,r_138_115_18,r_110_97_55,r_47_54_93,r_138_115_18,0.9,3,21,18,2
22,r_95_35_156,r_15_65_150,r_138_115_18,r_95_35_156,0.61,0,156,156,2
49,r_47_54_93,seq107,r_94_52_38,r_47_54_93,1.0,0,93,93,2
7,r_20_58_167,r_122_18_5,r_121_93_152,r_20_58_167,0.67,0,167,167,2
44,r_121_93_152,seq83,seq14,r_121_93_152,0.4,0,152,152,2
82,seq83,r_101_31_168,r_41_22_82,r_41_22_82,1.0,26,108,82,2
35,r_139_91_164,r_39_11_83,r_94_52_38,r_139_91_164,0.91,-86,78,164,2
12,r_50_134_133,seq92,r_94_52_38,r_50_134_133,0.83,3,136,133,2
48,r_127_24_136,r_69_67_179,r_41_22_82,r_127_24_136,1.0,0,136,136,2
23,r_118_119_125,seq129,r_10_77_62,r_118_119_125,1.0,0,125,125,2
30,r_102_33_135,seq70,seq7,r_102_33_135,0.98,0,135,135,3
51,seq1,r_18_133_109,r_100_23_97,r_100_23_97,1.0,15,112,97,3
36,r_10_140_140,seq86,seq136,r_10_140_140,0.98,0,140,140,3
14,r_105_36_141,seq134,r_39_81_139,r_39_81_139,0.9,3,142,139,3
1,r_52_46_188,seq137,seq70,r_52_46_188,0.33,0,188,188,3
97,seq124,r_38_129_137,seq32,r_38_129_137,1.0,0,137,137,3
5,r_116_37_100,r_64_9_183,seq2,r_116_37_100,0.87,-1,99,100,3
85,seq88,r_90_121_142,r_14_11_6,r_90_121_142,0.61,-114,28,142,3
42,r_21_47_93,r_73_110_103,seq20,r_21_47_93,0.94,0,93,93,3
34,r_16_40_14,r_98_79_85,r_69_122_7,r_98_79_85,0.84,-70,15,85,3
45,r_94_147_70,r_116_37_100,seq50,r_94_147_70,0.83,-4,66,70,3
4,r_13_123_83,r_89_119_134,r_135_63_105,r_89_119_134,0.8,0,134,134,3
23,r_92_48_44,r_18_133_109,r_149_3_191,r_92_48_44,1.0,0,44,44,3
3,r_89_119_134,seq24,r_12_35_146,r_12_35_146,0.75,9,155,146,3
39,r_115_107_24,r_92_48_44,r_16_40_14,r_115_107_24,0.62,1,25,24,3
39,r_115_107_24,r_16_40_14,r_38_129_137,r_38_129_137,0.99,3,140,137,3
31,r_98_79_85,r_52_46_188,seq41,r_98_79_85,1.0,0,85,85,3
41,r_12_35_146,r_39_81_139,r_89_119_134,r_39_81_139,0.89,3,142,139,3
0,r_5_42_58,r_21_47_93,seq137,r_5_42_58,1.0,0,58,58,3
3,r_89_119_134,r_57_118_110,r_13_123_83,r_13_123_83,0.89,27,110,83,3
10,r_66_72_181,r_26_62_170,r_16_40_14,r_16_40_14,0.93,57,71,14,3
4,r_13_123_83,r_138_28_193,r_89_119_134,r_13_123_83,0.96,0,83,83,3
20,r_87_56_88,r_52_46_188,seq68,r_87_56_88,1.0,0,88,88,3
15,r_57_118_110,r_89_119_134,seq112,r_57_118_110,1.0,0,110,110,3
46,r_144_106_38,r_90_121_142,seq136,r_144_106_38,1.0,-2,36,38,3
6,r_0_109_130,seq130,r_138_28_193,r_0_109_130,1.0,0,130,130,3
43,r_91_55_10,r_100_23_97,r_113_111_41,r_91_55_10,1.0,33,43,10,3
78,seq65,r_75_148_179,seq136,r_75_148_179,0.8,-124,55,179,3
10,r_66_72_181,r_16_40_14,seq70,r_66_72_181,0.66,0,181,181,3
27,r_39_81_139,r_12_35_146,r_100_23_97,r_39_81_139,0.93,3,142,139,3
22,r_149_3_191,r_75_148_179,r_92_48_44,r_92_48_44,1.0,-1,43,44,3
3,r_89_119_134,r_13_123_83,seq24,r_89_119_134,1.0,0,134,134,3
2,r_61_6_157,r_138_28_193,r_69_122_7,r_61_6_157,0.83,0,157,157,3
47,r_67_54_143,seq4,r_138_28_193,r_67_54_143,0.97,0,143,143,3
40,r_75_148_179,seq50,r_13_123_83,r_13_123_83,0.99,96,179,83,3
29,r_18_133_109,seq142,r_5_42_58,r_5_42_58,1.0,54,112,58,3
24,r_27_82_64,r_67_54_143,seq1,r_27_82_64,1.0,1,65,64,3
34,r_16_40_14,r_69_122_7,r_115_107_24,r_115_107_24,0.75,87,111,24,3
25,r_141_17_60,r_90_121_142,seq131,r_141_17_60,1.0,0,60,60,3
33,r_64_9_183,seq31,r_113_111_41,r_64_9_183,0.46,0,183,183,3
37,r_113_111_41,r_53_71_121,r_91_55_10,r_113_111_41,1.0,1,42,41,3
93,seq104,seq99,r_78_117_5,r_78_117_5,0.72,16,21,5,3
61,seq142,r_18_133_109,r_100_23_97,r_100_23_97,1.0,15,112,97,3
32,r_8_103_131,r_90_121_142,seq41,r_8_103_131,1.0,0,131,131,3
38,r_53_71_121,seq131,seq125,r_53_71_121,0.89,0,121,121,3
81,seq80,r_18_133_109,r_100_23_97,r_100_23_97,1.0,17,114,97,3
9,r_90_121_142,seq7,seq4,r_90_121_142,0.9,0,142,142,3
28,r_135_63_105,seq86,r_13_123_83,r_135_63_105,0.99,3,108,105,3
7,r_139_145_61,seq45,seq84,r_139_145_61,0.78,5,66,61,3
44,r_73_110_103,seq41,seq4,r_73_110_103,1.0,0,103,103,3
43,r_91_55_10,seq99,r_100_23_97,r_91_55_10,0.98,0,10,10,3
82,seq84,r_114_77_2,r_139_145_61,r_139_145_61,0.95,57,118,61,3
79,seq68,seq34,r_87_56_88,r_87_56_88,1.0,22,110,88,3
11,r_49_19_42,r_61_6_157,seq126,r_61_6_157,0.81,-115,42,157,3
12,r_100_23_97,seq20,seq1,r_100_23_97,1.0,0,97,97,3
8,r_14_11_6,r_100_23_97,seq88,r_100_23_97,0.68,-84,13,97,3
23,r_92_48_44,r_149_3_191,seq15,r_149_3_191,0.79,-15,176,191,3
30,r_26_6_65,r_27_102_73,r_57_1_62,r_26_6_65,0.73,4,69,65,4
32,r_9_83_45,seq128,seq33,r_9_83_45,0.92,1,46,45,4
14,r_24_70_83,seq38,seq65,r_24_70_83,1.0,0,83,83,4
8,r_96_72_110,r_47_135_195,r_89_139_28,r_96_72_110,0.72,0,110,110,4
43,r_29_75_125,seq119,seq51,r_29_75_125,0.99,0,125,125,4
37,r_52_58_78,r_74_17_183,seq141,r_52_58_78,1.0,1,79,78,4
16,r_146_112_158,r_66_34_185,r_68_99_13,r_146_112_158,0.75,0,158,158,4
21,r_39_106_67,r_47_135_195,r_123_81_171,r_39_106_67,1.0,1,68,67,4
39,r_4_126_116,seq136,seq44,r_4_126_116,0.97,0,116,116,4
47,r_41_76_166,r_118_77_111,r_130_143_132,r_41_76_166,0.99,0,166,166,4
45,r_27_102_73,seq44,seq18,r_27_102_73,1.0,0,73,73,4
19,r_123_81_171,seq37,r_4_126_116,r_4_126_116,0.87,55,171,116,4
66,seq33,r_146_112_158,r_9_83_45,r_146_112_158,0.6,-98,60,158,4
38,r_114_12_69,r_66_34_185,r_9_83_45,r_66_34_185,0.6,2,187,185,4
31,r_74_17_183,r_52_58_78,r_79_73_76,r_52_58_78,1.0,1,79,78,4
67,seq37,r_123_81_171,r_39_106_67,r_39_106_67,1.0,104,171,67,4
3,r_28_131_92,seq50,seq86,r_28_131_92,0.7,20,112,92,4
72,seq136,r_4_126_116,seq14,r_4_126_116,1.0,0,116,116,4
4,r_149_101_74,seq37,seq62,r_149_101_74,0.95,1,75,74,4
0,r_144_92_96,seq91,r_94_60_41,r_144_92_96,0.97,0,96,96,4
11,r_111_145_164,seq15,r_134_107_188,r_111_145_164,0.85,0,164,164,4
20,r_127_16_99,r_133_85_199,r_149_101_74,r_133_85_199,1.0,-91,108,199,4
36,r_49_23_36,r_82_138_47,r_5_129_189,r_49_23_36,1.0,0,36,36,4
15,r_63_45_142,seq88,seq95,r_63_45_142,1.0,0,142,142,4
57,seq14,r_41_76_166,seq136,r_41_76_166,1.0,0,166,166,4
21,r_39_106_67,r_123_81_171,seq37,r_123_81_171,1.0,0,171,171,4
85,seq88,r_63_45_142,seq14,r_63_45_142,1.0,0,142,142,4
42,r_97_78_17,r_118_77_111,seq13,r_97_78_17,0.88,0,17,17,4
27,r_130_143_132,seq18,seq15,r_130_143_132,0.92,1,133,132,4
26,r_94_60_41,r_93_22_79,seq56,r_94_60_41,1.0,0,41,41,4
87,seq95,r_137_142_101,r_63_45_142,r_63_45_142,1.0,4,146,142,4
2,r_79_73_76,r_74_17_183,r_28_131_92,r_79_73_76,0.58,109,185,76,4
7,r_82_138_47,r_74_17_183,seq148,r_82_138_47,1.0,0,47,47,4
25,r_89_139_28,r_127_16_99,seq110,r_89_139_28,0.97,3,31,28,4
47,r_41_76_166,seq14,r_118_77_111,r_118_77_111,0.55,-4,107,111,4
40,r_134_107_188,r_84_46_84,r_49_23_36,r_134_107_188,1.0,-104,84,188,4
74,seq51,seq122,r_29_75_125,r_29_75_125,1.0,14,139,125,4
18,r_93_22_79,seq132,seq7,r_93_22_79,0.86,6,85,79,4
29,r_84_46_84,r_134_107_188,r_89_139_28,r_84_46_84,1.0,0,84,84,4
24,r_57_1_62,seq14,r_26_6_65,r_57_1_62,1.0,0,62,62,4
95,seq116,seq62,r_121_80_34,r_121_80_34,1.0,9,43,34,4
33,r_103_125_136,r_26_6_65,r_79_73_76,r_103_125_136,0.96,1,137,136,4
65,seq32,r_117_55_149,seq37,r_117_55_149,1.0,0,149,149,4
88,seq98,seq148,r_21_0_114,r_21_0_114,0.53,27,141,114,4
1,r_121_80_34,r_47_135_195,seq116,r_121_80_34,0.98,3,37,34,4
65,seq32,r_149_101_74,r_117_55_149,r_149_101_74,1.0,1,75,74,4
42,r_97_78_17,seq13,r_82_138_47,r_82_138_47,0.94,38,85,47,4
38,r_114_12_69,r_93_22_79,r_66_34_185,r_114_12_69,1.0,0,69,69,4
77,seq62,seq116,r_149_101_74,r_149_101_74,1.0,39,113,74,4
92,seq110,seq116,r_89_139_28,r_89_139_28,0.95,3,31,28,4
81,seq69,r_64_61_151,seq71,r_64_61_151,0.8,0,151,151,4
28,r_48_2_56,r_87_59_126,seq115,r_87_59_126,1.0,-70,56,126,4
17,r_66_34_185,r_146_112_158,r_114_12_69,r_114_12_69,1.0,31,100,69,4
25,r_89_139_28,seq110,r_84_46_84,r_84_46_84,1.0,32,116,84,4
9,r_118_77_111,r_63_45_142,seq136,r_63_45_142,1.0,-7,135,142,4
31,r_74_17_183,r_79_73_76,r_121_80_34,r_79_73_76,0.64,109,185,76,4
22,r_64_61_151,seq69,seq40,r_64_61_151,0.91,0,151,151,4
49,r_117_55_149,r_123_81_171,r_49_23_36,r_117_55_149,0.89,0,149,149,4
44,r_21_0_114,r_68_99_13,seq98,r_21_0_114,0.76,5,119,114,4
41,r_36_104_31,r_84_46_84,seq18,r_36_104_31,0.88,0,31,31,4
23,r_109_140_77,seq67,seq105,r_109_140_77,1.0,0,77,77,4
17,r_66_34_185,r_114_12_69,r_64_61_151,r_64_61_151,0.74,36,187,151,4
93,seq115,r_4_128_133,seq14,r_4_128_133,1.0,1,134,133,5
30,r_20_64_63,seq107,seq35,r_20_64_63,1.0,0,63,63,5
44,r_140_10_158,r_22_146_19,r_119_9_161,r_140_10_158,0.28,28,186,158,5
17,r_47_50_135,seq0,r_48_42_47,r_48_42_47,1.0,0,47,47,5
14,r_88_53_179,seq61,r_119_9_161,r_88_53_179,0.48,0,179,179,5
8,r_15_103_154,seq90,r_148_3_163,r_15_103_154,0.57,3,157,154,5
35,r_131_68_10,r_47_50_135,seq105,r_131_68_10,0.94,0,10,10,5
37,r_117_56_117,seq43,r_119_9_161,r_117_56_117,0.97,0,117,117,5
55,seq7,r_69_45_103,r_47_50_135,r_47_50_135,0.85,20,155,135,5
7,r_104_73_143,r_101_122_31,seq147,r_104_73_143,0.91,0,143,143,5
1,r_77_30_131,r_104_73_143,seq14,r_77_30_131,0.98,0,131,131,5
24,r_44_95_123,r_67_134_57,seq147,r_67_134_57,0.81,-29,28,57,5
46,r_78_25_86,r_77_30_131,seq23,r_78_25_86,1.0,-1,85,86,5
44,r_140_10_158,seq121,r_22_146_19,r_22_146_19,1.0,-1,18,19,5
24,r_44_95_123,seq147,r_41_102_26,r_41_102_26,0.8,114,140,26,5
27,r_125_112_24,r_81_11_187,r_37_83_120,r_37_83_120,1.0,4,124,120,5
66,seq23,seq14,r_78_25_86,r_78_25_86,1.0,1,87,86,5
31,r_92_38_80,r_141_84_139,seq29,r_92_38_80,0.97,1,81,80,5
41,r_98_27_73,r_4_128_133,seq21,r_98_27_73,0.88,0,73,73,5
26,r_79_58_183,seq113,r_88_53_179,r_88_53_179,0.56,4,183,179,5
4,r_138_75_157,r_51_34_181,seq82,r_138_75_157,0.67,0,157,157,5
0,r_100_33_146,seq18,r_63_123_35,r_100_33_146,0.68,0,146,146,5
11,r_37_83_120,seq52,r_125_112_24,r_37_83_120,0.95,1,121,120,5
13,r_13_130_5,seq21,r_89_26_34,r_89_26_34,0.99,51,85,34,5
15,r_69_45_103,seq7,r_86_108_91,r_86_108_91,0.99,35,126,91,5
45,r_67_134_57,r_44_95_123,seq90,r_67_134_57,1.0,-1,56,57,5
10,r_96_2_33,seq6,seq74,r_96_2_33,0.75,0,33,33,5
48,r_22_146_19,seq74,r_140_10_158,r_22_146_19,0.99,-1,18,19,5
16,r_89_26_34,r_138_75_157,r_13_130_5,r_89_26_34,0.98,0,34,34,5
5,r_41_102_26,r_31_71_191,r_44_95_123,r_44_95_123,1.0,53,176,123,5
47,r_63_123_35,r_15_103_154,seq121,r_63_123_35,1.0,1,36,35,5
93,seq115,seq14,r_51_34_181,r_51_34_181,1.0,0,181,181,5
40,r_40_99_104,r_104_73_143,seq120,r_40_99_104,0.96,4,108,104,5
18,r_143_39_169,seq91,r_36_19_88,r_36_19_88,1.0,85,173,88,5
29,r_16_55_72,seq139,r_48_42_47,r_48_42_47,1.0,31,78,47,5
33,r_31_71_191,seq12,r_41_102_26,r_41_102_26,0.8,35,61,26,5
70,seq35,seq74,r_20_64_63,r_20_64_63,1.0,6,69,63,5
65,seq21,r_135_1_165,r_98_27_73,r_98_27_73,0.99,6,79,73,5
38,r_106_60_99,r_32_118_144,seq61,r_106_60_99,0.74,1,100,99,5
34,r_4_128_133,seq115,r_86_108_91,r_4_128_133,0.98,1,134,133,5
60,seq14,r_4_128_133,seq115,r_4_128_133,1.0,-17,116,133,5
96,seq121,r_140_10_158,r_63_123_35,r_63_123_35,0.97,8,43,35,5
9,r_36_19_88,seq90,seq113,r_36_19_88,1.0,1,89,88,5
27,r_125_112_24,r_88_53_179,r_81_11_187,r_125_112_24,0.88,-2,22,24,5
22,r_141_84_139,r_92_38_80,seq113,r_92_38_80,1.0,-3,77,80,5
28,r_87_72_182,seq90,r_104_73_143,r_87_72_182,0.33,0,182,182,5
5,r_41_102_26,seq97,r_31_71_191,r_41_102_26,0.97,1,27,26,5
12,r_51_34_181,r_4_128_133,seq115,r_51_34_181,0.89,1,182,181,5
43,r_48_42_47,r_15_103_154,r_16_55_72,r_48_42_47,1.0,-1,46,47,5
7,r_104_73_143,r_77_30_131,r_101_122_31,r_77_30_131,0.88,0,131,131,5
23,r_126_142_137,r_101_122_31,r_106_60_99,r_126_142_137,0.62,4,141,137,5
17,r_47_50_135,r_48_42_47,seq7,r_47_50_135,0.91,0,135,135,5
79,seq80,r_135_1_165,r_32_118_144,r_135_1_165,0.34,0,165,165,5
12,r_51_34_181,r_138_75_157,r_4_128_133,r_51_34_181,0.65,-19,162,181,5
36,r_81_11_187,r_86_108_91,r_125_112_24,r_81_11_187,0.62,-164,23,187,5
40,r_58_138_17,r_87_26_99,r_113_106_51,r_58_138_17,1.0,82,99,17,6
36,r_74_65_155,seq4,seq2,r_74_65_155,0.83,1,156,155,6
43,r_5_27_133,seq124,r_37_143_32,r_5_27_133,0.99,0,133,133,6
54,seq133,seq23,r_149_38_114,r_149_38_114,1.0,13,127,114,6
19,r_50_108_21,seq42,r_30_123_36,r_30_123_36,0.93,90,126,36,6
55,seq134,r_28_54_145,r_113_106_51,r_113_106_51,0.99,62,113,51,6
86,seq85,r_74_65_155,seq46,r_74_65_155,0.58,-44,111,155,6
16,r_81_125_100,seq96,seq128,r_81_125_100,1.0,1,101,100,6
21,r_92_0_142,r_17_13_141,r_122_8_1,r_92_0_142,0.65,0,142,142,6
39,r_88_16_126,r_139_33_176,r_130_62_65,r_139_33_176,1.0,-50,126,176,6
18,r_89_84_50,r_116_51_86,seq133,r_89_84_50,1.0,0,50,50,6
1,r_112_7_60,seq70,seq137,r_112_7_60,1.0,0,60,60,6
46,r_132_78_185,seq42,r_50_108_21,r_50_108_21,0.94,112,133,21,6
80,seq63,r_141_12_88,r_28_54_145,r_28_54_145,0.56,1,146,145,6
24,r_37_143_32,seq144,r_5_27_133,r_5_27_133,0.99,13,146,133,6
0,r_76_147_158,seq46,r_112_7_60,r_76_147_158,1.0,-4,154,158,6
95,seq114,r_116_51_86,r_98_44_10,r_116_51_86,0.78,7,93,86,6
31,r_43_99_170,seq61,r_22_77_58,r_43_99_170,0.76,0,170,170,6
41,r_116_51_86,seq114,r_49_131_3,r_116_51_86,0.78,7,93,86,6
46,r_132_78_185,r_50_108_21,r_76_147_158,r_132_78_185,0.92,0,185,185,6
86,seq85,seq46,r_11_67_164,r_11_67_164,0.99,0,164,164,6
3,r_94_119_162,seq53,seq144,r_94_119_162,0.79,2,164,162,6
48,r_103_32_53,seq19,r_48_71_2,r_103_32_53,0.98,2,55,53,6
26,r_145_55_70,r_43_99_170,seq70,r_145_55_70,1.0,0,70,70,6
4,r_130_62_65,r_17_13_141,seq53,r_130_62_65,1.0,0,65,65,6
0,r_76_147_158,r_149_38_114,seq46,r_149_38_114,0.9,1,115,114,6
73,seq46,r_66_127_151,seq1,r_66_127_151,0.92,0,151,151,6
98,seq121,r_135_129_182,r_81_125_100,r_81_125_100,0.99,25,125,100,6
10,r_118_36_115,r_69_136_191,seq115,r_118_36_115,0.64,58,173,115,6
15,r_69_136_191,seq31,r_118_36_115,r_118_36_115,1.0,9,124,115,6
14,r_113_106_51,r_98_44_10,r_58_138_17,r_58_138_17,0.71,19,36,17,6
6,r_141_12_88,seq63,seq39,r_141_12_88,0.82,3,91,88,6
19,r_50_108_21,r_112_7_60,seq42,r_50_108_21,0.99,1,22,21,6
99,seq124,seq23,r_110_29_96,r_110_29_96,1.0,31,127,96,6
10,r_118_36_115,seq121,r_69_136_191,r_118_36_115,0.99,0,115,115,6
2,r_28_54_145,seq134,seq63,r_28_54_145,0.72,1,146,145,6
45,r_30_123_36,r_118_36_115,r_50_108_21,r_50_108_21,0.65,15,36,21,6
29,r_9_109_80,r_18_105_129,r_113_106_51,r_9_109_80,1.0,1,81,80,6
25,r_45_40_117,r_110_29_96,r_145_55_70,r_145_55_70,0.88,27,97,70,6
10,r_118_36_115,r_30_123_36,seq121,r_30_123_36,1.0,0,36,36,6
40,r_58_138_17,r_139_33_176,r_87_26_99,r_58_138_17,0.99,1,18,17,6
15,r_69_136_191,r_118_36_115,r_50_108_21,r_69_136_191,0.73,-10,181,191,6
20,r_73_148_5,r_110_29_96,r_21_126_23,r_110_29_96,0.92,-18,78,96,6
61,seq144,r_79_101_168,r_94_119_162,r_94_119_162,0.97,8,170,162,6
32,r_93_68_69,r_5_27_133,r_73_148_5,r_93_68_69,1.0,0,69,69,6
38,r_66_127_151,seq46,r_87_26_99,r_87_26_99,0.99,52,151,99,6
34,r_11_67_164,seq75,seq85,r_11_67_164,0.75,-2,162,164,6
33,r_21_126_23,r_69_136_191,r_73_148_5,r_21_126_23,0.96,1,24,23,6
97,seq117,r_139_33_176,r_83_6_39,r_83_6_39,0.96,0,39,39,6
47,r_83_6_39,r_81_125_100,seq117,r_83_6_39,0.86,0,39,39,6
17,r_34_56_181,seq128,r_145_55_70,r_145_55_70,1.0,111,181,70,6
37,r_107_142_12,seq146,seq137,r_107_142_12,0.97,0,12,12,6
22,r_135_129_182,seq128,r_130_62_65,r_130_62_65,1.0,117,182,65,6
49,r_22_77_58,seq46,seq4,r_22_77_58,0.86,5,63,58,6
12,r_18_105_129,r_145_55_70,seq23,r_18_105_129,1.0,-2,127,129,6
25,r_45_40_117,r_145_55_70,r_149_38_114,r_45_40_117,0.91,0,117,117,6
7,r_149_38_114,r_76_147_158,r_89_84_50,r_149_38_114,1.0,1,115,114,6
44,r_87_26_99,r_11_67_164,r_22_77_58,r_87_26_99,0.64,0,99,99,6
13,r_82_90_28,seq140,seq137,r_82_90_28,1.0,0,28,28,6
23,r_79_101_168,seq144,r_28_54_145,r_28_54_145,1.0,25,170,145,6
35,r_3_104_148,seq35,seq72,r_3_104_148,0.95,1,149,148,6
12,r_18_105_129,r_9_109_80,r_145_55_70,r_18_105_129,0.91,-56,73,129,6
24,r_37_143_32,r_74_65_155,seq144,r_74_65_155,0.6,-116,39,155,6
30,r_102_87_60,r_32_86_65,seq28,r_32_86_65,0.71,7,72,65,7
44,r_92_101_55,r_58_83_159,r_107_39_125,r_107_39_125,0.62,36,161,125,7
47,r_69_62_18,r_12_122_179,r_46_49_185,r_69_62_18,0.99,1,19,18,7
36,r_93_75_180,r_133_141_87,r_81_105_53,r_81_105_53,0.75,43,96,53,7
21,r_27_45_81,r_61_4_178,seq135,r_27_45_81,0.99,0,81,81,7
39,r_22_82_16,r_119_138_184,r_16_29_44,r_16_29_44,1.0,129,173,44,7
1,r_60_143_139,seq6,r_121_99_102,r_60_143_139,0.78,4,143,139,7
5,r_72_91_107,r_93_75_180,seq132,r_72_91_107,0.89,1,108,107,7
46,r_3_73_62,seq63,r_74_127_42,r_3_73_62,0.56,1,63,62,7
69,seq33,r_106_134_170,r_74_127_42,r_74_127_42,1.0,27,69,42,7
80,seq57,r_109_123_49,r_8_118_83,r_8_118_83,1.0,4,87,83,7
19,r_32_86_65,r_19_84_195,seq51,r_32_86_65,0.99,10,75,65,7
3,r_16_29_44,r_100_64_183,r_22_82_16,r_16_29_44,0.98,0,44,44,7
14,r_89_115_31,seq52,r_47_7_147,r_89_115_31,0.95,2,33,31,7
11,r_130_88_12,seq5,r_31_54_198,r_130_88_12,0.54,1,13,12,7
31,r_61_4_178,r_27_45_81,r_112_26_115,r_27_45_81,1.0,0,81,81,7
41,r_107_39_125,seq38,r_92_101_55,r_107_39_125,0.86,2,127,125,7
26,r_40_95_100,r_58_83_159,r_142_24_61,r_142_24_61,0.97,30,91,61,7
18,r_109_123_49,r_102_87_60,seq57,r_109_123_49,1.0,0,49,49,7
0,r_12_122_179,seq124,r_61_4_178,r_12_122_179,0.59,2,181,179,7
73,seq41,r_100_64_183,r_97_1_46,r_97_1_46,0.97,77,123,46,7
13,r_106_134_170,seq33,r_120_55_8,r_106_134_170,0.6,3,173,170,7
98,seq124,r_12_122_179,seq135,r_12_122_179,0.95,-58,121,179,7
15,r_142_24_61,r_119_138_184,r_40_95_100,r_142_24_61,1.0,1,62,61,7
48,r_56_44_108,seq36,r_109_123_49,r_109_123_49,0.98,59,108,49,7
6,r_125_140_121,r_47_7_147,r_3_73_62,r_125_140_121,0.83,0,121,121,7
36,r_93_75_180,r_81_105_53,r_112_26_115,r_93_75_180,0.59,0,180,180,7
27,r_46_49_185,seq10,r_58_83_159,r_46_49_185,0.5,0,185,185,7
87,seq77,r_137_76_119,seq148,r_137_76_119,0.93,-20,99,119,7
2,r_90_9_126,seq65,seq50,r_90_9_126,0.55,0,126,126,7
40,r_47_7_147,r_121_99_102,r_89_115_31,r_89_115_31,0.98,109,140,31,7
29,r_8_118_83,seq11,seq57,r_8_118_83,1.0,0,83,83,7
78,seq52,r_89_115_31,seq33,r_89_115_31,0.99,2,33,31,7
47,r_69_62_18,r_46_49_185,r_126_116_95,r_126_116_95,1.0,3,98,95,7
33,r_81_105_53,r_47_7_147,seq53,r_81_105_53,1.0,0,53,53,7
44,r_92_101_55,r_114_35_134,r_58_83_159,r_92_101_55,1.0,0,55,55,7
42,r_42_30_24,r_3_73_62,seq15,r_42_30_24,0.67,-2,22,24,7
32,r_126_116_95,seq13,r_69_62_18,r_126_116_95,0.98,1,96,95,7
38,r_133_141_87,r_93_75_180,seq20,r_133_141_87,0.91,9,96,87,7
34,r_34_78_135,seq28,seq38,r_34_78_135,0.52,2,137,135,7
24,r_117_85_13,seq57,seq18,r_117_85_13,0.98,0,13,13,7
17,r_68_136_11,r_40_95_100,r_121_99_102,r_68_136_11,0.91,0,11,11,7
96,seq113,r_110_128_161,r_137_76_119,r_110_128_161,0.62,0,161,161,7
31,r_61_4_178,r_112_26_115,r_12_122_179,r_12_122_179,0.87,2,181,179,7
22,r_14_146_131,seq18,seq5,r_14_146_131,0.85,2,133,131,7
80,seq57,r_114_35_134,r_109_123_49,r_109_123_49,0.95,1,50,49,7
43,r_97_1_46,r_27_45_81,seq41,r_97_1_46,0.99,0,46,46,7
49,r_110_128_161,seq113,seq131,r_110_128_161,0.72,0,161,161,7
4,r_74_127_42,r_31_54_198,seq33,r_74_127_42,1.0,3,45,42,7
56,seq135,r_12_122_179,r_27_45_81,r_27_45_81,0.95,1,82,81,7
7,r_137_76_119,seq77,r_142_24_61,r_142_24_61,0.97,66,127,61,7
18,r_109_123_49,seq57,r_56_44_108,r_56_44_108,0.99,6,114,108,7
23,r_121_99_102,r_47_7_147,r_60_143_139,r_60_143_139,0.89,8,147,139,7
17,r_68_136_11,r_121_99_102,r_22_82_16,r_121_99_102,0.54,0,102,102,7
79,seq53,r_133_141_87,r_81_105_53,r_81_105_53,0.64,43,96,53,7
35,r_58_83_159,r_40_95_100,r_97_1_46,r_58_83_159,0.89,-2,157,159,7
30,r_52_73_181,r_79_85_187,r_58_32_3,r_58_32_3,0.95,179,182,3,8
44,r_91_1_10,r_144_89_186,r_36_10_145,r_144_89_186,0.65,-105,81,186,8
14,r_135_5_83,seq40,seq108,r_135_5_83,0.99,0,83,83,8
8,r_9_6_91,r_144_89_186,r_78_99_178,r_9_6_91,0.91,0,91,91,8
59,seq146,r_26_31_127,seq104,r_26_31_127,0.68,7,134,127,8
5,r_105_125_16,r_148_96_101,seq140,r_105_125_16,0.86,0,16,16,8
16,r_149_29_72,seq66,r_105_125_16,r_149_29_72,0.77,1,73,72,8
21,r_132_50_73,r_88_129_153,r_143_109_70,r_143_109_70,0.88,30,100,70,8
39,r_34_11_152,seq38,r_26_31_127,r_26_31_127,0.83,31,158,127,8
1,r_80_24_132,seq127,r_135_5_83,r_135_5_83,0.98,50,133,83,8
35,r_62_27_114,r_14_57_59,seq86,r_62_27_114,0.92,0,114,114,8
42,r_33_56_142,seq131,seq118,r_33_56_142,0.85,3,145,142,8
19,r_17_68_118,seq90,r_72_19_196,r_17_68_118,0.85,0,118,118,8
34,r_133_8_71,seq86,r_18_28_86,r_18_28_86,0.44,0,86,86,8
3,r_92_3_75,r_79_85_187,seq131,r_92_3_75,1.0,1,76,75,8
10,r_88_129_153,r_132_50_73,r_128_30_110,r_132_50_73,0.62,82,155,73,8
14,r_135_5_83,seq108,r_80_24_132,r_80_24_132,1.0,13,145,132,8
20,r_113_13_189,r_70_21_194,r_36_10_145,r_36_10_145,0.55,45,190,145,8
13,r_78_99_178,r_75_123_122,r_9_6_91,r_78_99_178,0.98,-78,100,178,8
15,r_134_46_126,seq130,seq38,r_134_46_126,0.98,1,127,126,8
48,r_35_55_94,seq4,seq127,r_35_55_94,1.0,0,94,94,8
12,r_144_89_186,r_91_1_10,r_142_81_161,r_91_1_10,0.35,177,187,10,8
6,r_26_31_127,seq146,seq84,r_26_31_127,0.74,7,134,127,8
66,seq41,r_82_83_192,r_59_65_43,r_59_65_43,1.0,16,59,43,8
27,r_47_37_141,r_72_19_196,seq111,r_47_37_141,0.74,4,145,141,8
24,r_102_0_45,r_78_99_178,seq131,r_102_0_45,0.96,1,46,45,8
31,r_141_15_41,seq4,seq53,r_141_15_41,0.98,0,41,41,8
2,r_148_96_101,seq146,r_82_83_192,r_148_96_101,1.0,-1,100,101,8
47,r_79_85_187,r_92_3_75,r_52_73_181,r_92_3_75,0.99,1,76,75,8
18,r_39_116_79,seq97,r_92_3_75,r_92_3_75,0.99,6,81,75,8
29,r_75_123_122,r_78_99_178,r_113_13_189,r_75_123_122,0.89,0,122,122,8
25,r_94_107_177,seq131,seq130,r_94_107_177,0.44,0,177,177,8
64,seq38,r_34_11_152,r_134_46_126,r_134_46_126,0.99,32,158,126,8
47,r_79_85_187,r_52_73_181,r_92_3_75,r_79_85_187,0.23,2,189,187,8
50,seq130,r_134_46_126,seq69,r_134_46_126,1.0,1,127,126,8
44,r_91_1_10,r_142_81_161,r_144_89_186,r_91_1_10,0.99,0,10,10,8
32,r_44_136_89,r_33_56_142,seq137,r_44_136_89,0.55,0,89,89,8
38,r_115_138_124,seq86,r_149_29_72,r_115_138_124,0.95,0,124,124,8
75,seq66,r_149_29_72,seq145,r_149_29_72,0.97,1,73,72,8
16,r_149_29_72,r_105_125_16,r_115_138_124,r_115_138_124,1.0,8,132,124,8
9,r_143_109_70,r_70_21_194,r_132_50_73,r_143_109_70,1.0,0,70,70,8
8,r_9_6_91,r_78_99_178,r_2_121_97,r_2_121_97,0.71,29,126,97,8
7,r_110_101_35,seq114,seq4,r_110_101_35,1.0,0,35,35,8
22,r_72_19_196,r_47_37_141,r_134_46_126,r_134_46_126,0.92,19,145,126,8
28,r_2_121_97,seq108,r_9_6_91,r_2_121_97,1.0,0,97,97,8
36,r_59_65_43,r_33_56_142,seq127,r_59_65_43,1.0,0,43,43,8
23,r_128_30_110,seq131,r_26_31_127,r_128_30_110,0.8,16,126,110,8
52,seq4,r_141_15_41,r_110_101_35,r_110_101_35,0.87,6,41,35,8
79,seq140,r_44_136_89,r_105_125_16,r_44_136_89,0.85,0,89,89,8
12,r_144_89_186,seq16,r_91_1_10,r_91_1_10,0.67,65,75,10,8
84,seq90,r_17_68_118,seq147,r_17_68_118,0.97,7,125,118,8
93,seq112,seq67,r_30_70_82,r_30_70_82,0.91,30,112,82,9
44,r_2_3_75,seq7,r_140_9_159,r_140_9_159,1.0,5,164,159,9
14,r_97_143_105,seq83,seq59,r_97_143_105,0.86,4,109,105,9
8,r_39_93_176,r_138_128_74,r_103_147_118,r_138_128_74,1.0,-9,65,74,9
16,r_110_42_133,r_131_124_192,seq22,r_110_42_133,0.96,1,134,133,9
97,seq119,r_27_53_77,seq112,r_27_53_77,0.98,0,77,77,9
80,seq83,seq31,r_144_141_181,r_144_141_181,0.93,0,181,181,9
46,r_28_19_69,r_2_3_75,r_8_23_6,r_28_19_69,0.95,0,69,69,9
42,r_41_13_56,r_136_46_78,r_131_124_192,r_41_13_56,0.77,-1,55,56,9
80,seq83,r_97_143_105,seq31,r_97_143_105,0.57,4,109,105,9
45,r_37_127_61,r_123_48_169,seq108,r_37_127_61,1.0,0,61,61,9
32,r_64_130_32,r_79_84_104,seq14,r_79_84_104,0.67,-71,33,104,9
24,r_8_23_6,seq6,r_28_19_69,r_28_19_69,0.59,1,70,69,9
19,r_142_99_79,r_30_70_82,seq56,r_142_99_79,1.0,0,79,79,9
30,r_101_43_46,seq118,r_2_3_75,r_101_43_46,1.0,0,46,46,9
22,r_58_18_179,r_145_105_80,r_62_86_18,r_62_86_18,0.52,1,19,18,9
97,seq119,seq112,r_61_132_125,r_61_132_125,1.0,16,141,125,9
3,r_5_100_24,seq69,seq35,r_5_100_24,0.86,-1,23,24,9
10,r_145_105_80,r_58_18_179,seq17,r_145_105_80,1.0,-1,79,80,9
90,seq108,seq56,r_37_127_61,r_37_127_61,1.0,2,63,61,9
11,r_136_46_78,seq90,seq91,r_136_46_78,0.82,-3,75,78,9
26,r_78_116_84,seq67,seq6,r_78_116_84,0.6,2,86,84,9
4,r_138_128_74,r_39_93_176,seq76,r_138_128_74,1.0,-1,73,74,9
31,r_120_82_53,r_135_0_93,r_140_9_159,r_120_82_53,1.0,0,53,53,9
20,r_144_141_181,seq71,r_135_0_93,r_135_0_93,0.97,38,131,93,9
13,r_15_50_95,seq76,r_135_0_93,r_15_50_95,1.0,0,95,95,9
15,r_146_149_167,seq107,r_65_113_106,r_146_149_167,0.73,2,169,167,9
48,r_27_53_77,seq119,r_34_125_67,r_34_125_67,1.0,12,79,67,9
6,r_61_132_125,seq71,seq126,r_61_132_125,0.99,0,125,125,9
11,r_136_46_78,r_41_13_56,seq90,r_41_13_56,0.59,-7,49,56,9
30,r_101_43_46,r_2_3_75,r_34_125_67,r_101_43_46,0.58,30,76,46,9
36,r_140_9_159,r_120_82_53,r_2_3_75,r_2_3_75,0.6,82,157,75,9
39,r_106_55_37,r_77_26_54,seq36,r_106_55_37,0.99,-2,35,37,9
22,r_58_18_179,r_62_86_18,r_32_72_22,r_58_18_179,0.62,0,179,179,9
2,r_80_51_102,seq67,seq148,r_80_51_102,0.72,-4,98,102,9
41,r_21_89_33,r_137_68_121,r_11_92_68,r_21_89_33,0.97,88,121,33,9
47,r_122_81_36,r_123_48_169,seq69,r_122_81_36,0.86,-1,35,36,9
40,r_65_113_106,r_131_124_192,seq98,r_65_113_106,0.8,5,111,106,9
18,r_131_124_192,r_110_42_133,r_41_13_56,r_131_124_192,0.81,-120,72,192,9
29,r_25_94_129,r_57_73_153,r_61_132_125,r_61_132_125,1.0,3,128,125,9
1,r_32_72_22,r_2_3_75,seq87,r_32_72_22,0.98,0,22,22,9
43,r_62_86_18,r_24_114_23,r_58_18_179,r_62_86_18,0.86,0,18,18,9
25,r_135_0_93,seq74,r_144_141_181,r_135_0_93,0.62,2,95,93,9
43,r_62_86_18,r_58_18_179,r_103_147_118,r_58_18_179,0.93,0,179,179,9
88,seq102,r_75_133_154,r_140_9_159,r_140_9_159,0.58,-5,154,159,9
36,r_140_9_159,r_75_133_154,r_120_82_53,r_120_82_53,1.0,-3,50,53,9
42,r_41_13_56,r_131_124_192,r_88_47_17,r_131_124_192,0.73,-4,188,192,9
77,seq71,r_61_132_125,r_135_0_93,r_61_132_125,0.8,-32,93,125,9
17,r_11_92_68,seq87,r_21_89_33,r_11_92_68,0.99,0,68,68,9
25,r_135_0_93,r_144_141_181,seq71,r_144_141_181,1.0,0,181,181,9
9,r_103_147_118,r_58_18_179,seq33,r_58_18_179,0.72,-58,121,179,9
20,r_144_141_181,r_135_0_93,seq83,r_144_141_181,1.0,0,181,181,9
31,r_120_82_53,r_140_9_159,seq102,r_120_82_53,0.54,117,170,53,9
34,r_24_114_23,seq6,seq67,r_24_114_23,0.86,-2,21,23,9
28,r_137_68_121,seq1,seq4,r_137_68_121,0.6,0,121,121,9
33,r_104_12_43,seq102,seq107,r_104_12_43,1.0,0,43,43,9
44,r_2_3_75,r_30_70_82,seq7,r_2_3_75,0.87,-2,73,75,9
23,r_79_84_104,seq87,seq17,r_79_84_104,1.0,0,104,104,9
41,r_21_89_33,seq134,r_137_68_121,r_21_89_33,0.92,-1,32,33,9
76,seq69,seq7,r_122_81_36,r_122_81_36,0.82,-1,35,36,9
35,r_30_70_82,r_142_99_79,seq112,r_142_99_79,1.0,0,79,79,9
12,r_75_133_154,seq102,r_34_125_67,r_34_125_67,1.0,87,154,67,9
5,r_77_26_54,r_97_143_105,seq109,r_77_26_54,0.95,1,55,54,9
30,r_65_66_170,seq88,r_105_92_69,r_105_92_69,1.0,104,173,69,10
44,r_69_120_60,r_2_60_197,seq107,r_69_120_60,0.52,106,166,60,10
47,r_96_130_20,r_12_137_176,seq133,r_96_130_20,0.93,-1,19,20,10
36,r_24_113_136,r_56_98_164,r_59_45_48,r_56_98_164,0.68,-28,136,164,10
9,r_37_71_125,r_134_80_17,r_41_32_91,r_134_80_17,0.98,108,125,17,10
13,r_97_90_182,seq147,seq4,r_97_90_182,0.83,0,182,182,10
4,r_109_148_1,r_50_17_155,r_39_82_62,r_39_82_62,0.87,7,69,62,10
14,r_2_60_197,r_106_81_133,r_69_120_60,r_2_60_197,0.64,-105,92,197,10
16,r_29_118_81,r_62_51_166,r_74_40_145,r_29_118_81,1.0,1,82,81,10
25,r_134_80_17,r_37_71_125,r_99_86_56,r_134_80_17,1.0,46,63,17,10
1,r_39_82_62,r_76_5_102,r_109_148_1,r_39_82_62,0.81,-1,61,62,10
4,r_109_148_1,r_59_45_48,r_50_17_155,r_59_45_48,0.99,0,48,48,10
5,r_6_140_66,r_105_92_69,seq141,r_105_92_69,0.98,-2,67,69,10
46,r_100_149_116,seq145,seq1,r_100_149_116,0.93,0,116,116,10
42,r_135_95_171,r_97_90_182,seq129,r_135_95_171,0.34,0,171,171,10
6,r_74_40_145,seq124,r_29_118_81,r_74_40_145,0.54,-64,81,145,10
80,seq87,r_12_137_176,r_105_92_69,r_105_92_69,1.0,17,86,69,10
7,r_101_20_10,r_12_137_176,seq15,r_101_20_10,0.52,167,177,10,10
69,seq42,r_62_51_166,seq13,r_62_51_166,0.43,-19,147,166,10
45,r_106_81_133,r_2_60_197,r_25_9_131,r_106_81_133,1.0,0,133,133,10
23,r_21_77_44,r_76_5_102,seq121,r_21_77_44,0.81,0,44,44,10
25,r_134_80_17,r_33_3_73,r_37_71_125,r_134_80_17,0.97,0,17,17,10
3,r_83_0_94,r_22_123_121,seq145,r_83_0_94,0.69,1,95,94,10
26,r_126_142_132,r_64_49_82,seq138,r_64_49_82,1.0,0,82,82,10
16,r_29_118_81,r_74_40_145,r_134_80_17,r_74_40_145,0.94,0,145,145,10
0,r_25_9_131,r_97_90_182,r_37_71_125,r_25_9_131,0.69,0,131,131,10
11,r_22_123_121,r_47_16_162,seq53,r_47_16_162,0.79,-32,130,162,10
59,seq15,r_65_66_170,r_105_92_69,r_105_92_69,1.0,3,72,69,10
20,r_64_49_82,r_126_142_132,r_70_43_87,r_64_49_82,0.98,0,82,82,10
13,r_97_90_182,r_25_9_131,seq147,r_25_9_131,1.0,0,131,131,10
98,seq124,r_25_9_131,seq119,r_25_9_131,0.89,-38,93,131,10
15,r_33_3_73,seq42,seq128,r_33_3_73,1.0,1,74,73,10
49,r_62_51_166,r_19_7_195,r_69_120_60,r_62_51_166,0.7,2,168,166,10
6,r_74_40_145,r_105_92_69,seq124,r_74_40_145,0.54,-75,70,145,10
21,r_76_5_102,r_96_130_20,seq35,r_76_5_102,1.0,0,102,102,10
6,r_74_40_145,r_29_118_81,seq1,r_74_40_145,1.0,0,145,145,10
10,r_12_137_176,r_101_20_10,r_135_95_171,r_135_95_171,0.76,6,177,171,10
27,r_41_32_91,r_131_91_67,r_37_71_125,r_131_91_67,1.0,0,67,67,10
2,r_114_93_120,seq89,r_41_32_91,r_114_93_120,1.0,0,120,120,10
40,r_70_43_87,r_83_0_94,r_64_49_82,r_64_49_82,1.0,7,89,82,10
74,seq67,r_50_17_155,r_47_16_162,r_50_17_155,0.44,11,166,155,10
29,r_131_91_67,r_41_32_91,r_21_77_44,r_21_77_44,0.88,23,67,44,10
24,r_61_52_72,r_102_31_194,seq1,r_61_52_72,1.0,0,72,72,10
50,seq128,seq53,r_33_3_73,r_33_3_73,1.0,30,103,73,10
43,r_99_86_56,r_34_27_151,r_134_80_17,r_99_86_56,1.0,1,57,56,10
21,r_76_5_102,r_21_77_44,r_96_130_20,r_76_5_102,0.72,-78,24,102,10
61,seq145,r_100_149_116,r_83_0_94,r_100_149_116,1.0,0,116,116,10
32,r_73_8_169,r_34_27_151,seq139,r_73_8_169,0.44,-14,155,169,10
38,r_26_18_158,r_36_127_172,seq133,r_26_18_158,0.85,1,159,158,10
9,r_37_71_125,r_102_31_194,r_134_80_17,r_134_80_17,1.0,13,30,17,10
59,seq15,r_12_137_176,r_65_66_170,r_65_66_170,0.52,-135,35,170,10
7,r_101_20_10,seq129,r_12_137_176,r_101_20_10,1.0,0,10,10,10
96,seq121,r_34_27_151,r_21_77_44,r_21_77_44,1.0,59,103,44,10
28,r_105_92_69,r_6_140_66,seq15,r_105_92_69,1.0,1,70,69,10
91,seq111,r_44_72_190,r_69_120_60,r_69_120_60,1.0,44,104,60,10
49,r_62_51_166,r_29_118_81,r_19_7_195,r_29_118_81,1.0,1,82,81,10
44,r_69_120_60,r_100_149_116,r_2_60_197,r_69_120_60,0.93,0,60,60,10
53,seq133,seq111,r_96_130_20,r_96_130_20,0.81,3,23,20,10
26,r_126_142_132,seq138,seq133,r_126_142_132,0.93,1,133,132,10
10,r_12_137_176,r_96_130_20,r_101_20_10,r_101_20_10,0.91,1,11,10,10
35,r_50_17_155,seq67,r_25_9_131,r_25_9_131,0.77,26,157,131,10
12,r_44_72_190,seq28,r_134_80_17,r_134_80_17,0.84,173,190,17,10
51,seq6,r_118_85_143,r_149_60_68,r_118_85_143,0.62,-1,142,143,11
36,r_53_19_109,seq84,seq75,r_53_19_109,0.97,0,109,109,11
92,seq108,r_47_34_158,seq51,r_47_34_158,0.92,2,160,158,11
14,r_28_92_152,seq20,r_16_0_103,r_28_92_152,0.63,1,153,152,11
30,r_91_44_35,seq99,r_79_2_31,r_91_44_35,0.96,0,35,35,11
43,r_65_49_81,r_107_132_60,seq57,r_107_132_60,1.0,1,61,60,11
54,seq10,r_126_73_178,r_130_138_77,r_130_138_77,1.0,19,96,77,11
21,r_118_85_143,r_61_110_2,seq52,r_118_85_143,0.5,4,147,143,11
1,r_5_89_126,seq55,seq82,r_5_89_126,0.94,2,128,126,11
5,r_39_18_66,r_149_60_68,seq121,r_39_18_66,1.0,0,66,66,11
42,r_114_86_139,seq140,r_65_49_81,r_114_86_139,0.96,0,139,139,11
19,r_61_110_2,r_118_85_143,r_46_48_144,r_46_48_144,0.53,3,147,144,11
11,r_134_25_168,r_136_4_47,r_1_70_30,r_134_25_168,0.88,0,168,168,11
27,r_136_4_47,r_134_25_168,r_58_106_167,r_134_25_168,0.55,0,168,168,11
37,r_107_132_60,r_65_49_81,r_90_127_20,r_107_132_60,0.92,1,61,60,11
95,seq113,r_29_43_97,r_122_101_28,r_29_43_97,0.86,-23,74,97,11
76,seq57,r_15_45_123,r_65_49_81,r_15_45_123,0.94,2,125,123,11
15,r_1_70_30,r_47_34_158,seq9,r_1_70_30,1.0,0,30,30,11
6,r_33_36_53,r_80_74_185,seq137,r_33_36_53,0.72,2,55,53,11
67,seq40,seq32,r_102_120_76,r_102_120_76,1.0,0,76,76,11
10,r_16_0_103,seq109,r_37_11_52,r_16_0_103,0.93,0,103,103,11
8,r_90_127_20,seq41,r_29_43_97,r_29_43_97,1.0,32,129,97,11
4,r_103_35_175,r_83_135_137,r_24_76_40,r_24_76_40,0.86,61,101,40,11
25,r_37_11_52,seq129,r_141_3_108,r_37_11_52,0.98,2,54,52,11
0,r_47_34_158,seq108,r_83_135_137,r_47_34_158,0.64,0,158,158,11
63,seq137,r_29_43_97,r_33_36_53,r_29_43_97,1.0,-27,70,97,11
11,r_134_25_168,r_59_139_145,r_136_4_47,r_136_4_47,1.0,26,73,47,11
20,r_46_48_144,seq41,r_61_110_2,r_61_110_2,0.58,144,146,2,11
13,r_102_120_76,r_47_34_158,seq40,r_102_120_76,1.0,0,76,76,11
48,r_68_30_117,seq121,r_90_127_20,r_68_30_117,0.99,0,117,117,11
4,r_103_35_175,r_24_76_40,seq142,r_24_76_40,0.61,135,175,40,11
27,r_136_4_47,r_39_18_66,r_134_25_168,r_136_4_47,0.99,1,48,47,11
31,r_8_143_48,seq145,seq84,r_8_143_48,1.0,0,48,48,11
37,r_107_132_60,r_24_76_40,r_65_49_81,r_24_76_40,1.0,0,40,40,11
39,r_79_2_31,r_15_45_123,r_91_44_35,r_79_2_31,0.74,25,56,31,11
47,r_21_66_80,seq87,seq146,r_21_66_80,0.99,0,80,80,11
18,r_15_45_123,seq57,seq41,r_15_45_123,0.97,2,125,123,11
24,r_88_64_69,seq97,seq72,r_88_64_69,1.0,0,69,69,11
68,seq41,r_46_48_144,r_15_45_123,r_15_45_123,0.87,19,142,123,11
32,r_29_43_97,r_128_23_180,seq50,r_29_43_97,0.97,0,97,97,11
53,seq9,r_119_38_179,r_1_70_30,r_1_70_30,0.93,16,46,30,11
38,r_141_3_108,seq42,r_37_11_52,r_37_11_52,0.98,57,109,52,11
26,r_62_148_12,r_15_45_123,seq72,r_62_148_12,0.89,0,12,12,11
34,r_81_26_82,r_69_71_89,r_98_117_15,r_69_71_89,0.65,5,94,89,11
41,r_98_117_15,r_16_0_103,seq144,r_98_117_15,0.88,0,15,15,11
81,seq82,seq97,r_5_89_126,r_5_89_126,0.98,12,138,126,11
17,r_149_60_68,r_39_18_66,seq6,r_39_18_66,1.0,0,66,66,11
9,r_112_14_148,seq52,seq142,r_112_14_148,0.95,1,149,148,11
16,r_122_101_28,seq63,seq113,r_122_101_28,0.83,5,33,28,11
28,r_69_71_89,seq84,r_90_127_20,r_69_71_89,0.99,5,94,89,11
8,r_90_127_20,r_88_64_69,seq41,r_90_127_20,0.91,0,20,20,11
49,r_59_139_145,r_134_25_168,seq129,r_134_25_168,0.8,-20,148,168,11
7,r_130_138_77,r_112_14_148,seq10,r_130_138_77,0.89,1,78,77,11
44,r_116_131_118,r_112_14_148,r_88_64_69,r_112_14_148,0.7,-28,120,148,11
23,r_119_38_179,r_126_73_178,r_21_66_80,r_21_66_80,0.74,98,178,80,11
79,seq72,r_124_133_192,r_88_64_69,r_88_64_69,1.0,32,101,69,11
35,r_128_23_180,seq113,seq6,r_128_23_180,0.47,1,181,180,11
30,r_82_65_61,seq18,r_3_79_180,r_82_65_61,1.0,-1,60,61,12
36,r_117_77_125,seq127,r_8_85_13,r_117_77_125,0.93,1,126,125,12
8,r_125_15_69,seq106,seq148,r_125_15_69,1.0,-1,68,69,12
48,r_54_139_40,r_105_50_168,r_95_133_158,r_54_139_40,0.59,-10,30,40,12
48,r_54_139_40,r_95_133_158,seq75,r_54_139_40,0.8,1,41,40,12
83,seq81,r_105_50_168,r_120_6_167,r_105_50_168,0.92,0,168,168,12
69,seq38,r_131_138_25,seq100,r_131_138_25,0.92,0,25,25,12
16,r_131_138_25,seq38,seq60,r_131_138_25,0.88,0,25,25,12
64,seq32,r_26_88_139,r_36_101_33,r_36_101_33,1.0,9,42,33,12
21,r_95_133_158,seq61,seq17,r_95_133_158,0.87,1,159,158,12
39,r_98_39_155,r_95_133_158,r_29_116_18,r_98_39_155,0.54,0,155,155,12
1,r_11_99_110,seq14,seq145,r_11_99_110,1.0,0,110,110,12
23,r_29_116_18,r_47_43_118,seq18,r_29_116_18,0.98,1,19,18,12
5,r_0_27_151,seq56,r_107_144_71,r_107_144_71,1.0,20,91,71,12
42,r_45_141_7,seq137,r_20_104_58,r_20_104_58,1.0,26,84,58,12
45,r_13_102_156,seq76,seq49,r_13_102_156,0.77,0,156,156,12
2,r_63_134_35,r_74_92_188,r_47_43_118,r_63_134_35,1.0,0,35,35,12
33,r_108_31_9,seq111,r_0_27_151,r_108_31_9,0.33,132,141,9,12
76,seq60,seq34,r_131_138_25,r_131_138_25,0.75,56,81,25,12
31,r_90_71_136,r_5_132_165,r_130_73_55,r_90_71_136,0.92,2,138,136,12
41,r_23_112_169,seq136,r_121_67_1,r_23_112_169,0.81,0,169,169,12
24,r_130_73_55,r_82_65_61,seq61,r_130_73_55,1.0,0,55,55,12
3,r_4_86_137,seq59,seq93,r_4_86_137,0.91,1,138,137,12
43,r_72_41_30,r_47_43_118,seq142,r_72_41_30,0.48,-6,24,30,12
4,r_22_44_113,seq56,seq106,r_22_44_113,1.0,0,113,113,12
0,r_5_132_165,r_90_71_136,seq7,r_90_71_136,1.0,2,138,136,12
0,r_5_132_165,seq7,seq109,r_5_132_165,0.91,3,168,165,12
11,r_120_6_167,seq75,seq100,r_120_6_167,0.31,1,168,167,12
20,r_143_103_81,seq140,r_129_78_26,r_143_103_81,0.97,0,81,81,12
13,r_66_94_88,r_124_52_10,seq59,r_66_94_88,1.0,1,89,88,12
59,seq147,seq118,r_68_42_34,r_68_42_34,0.95,0,34,34,12
6,r_74_92_188,seq21,r_120_6_167,r_74_92_188,0.35,1,189,188,12
40,r_30_1_53,seq56,r_122_51_17,r_30_1_53,1.0,0,53,53,12
99,seq127,r_117_77_125,seq12,r_117_77_125,0.96,1,126,125,12
46,r_47_43_118,seq145,r_63_134_35,r_63_134_35,1.0,13,48,35,12
5,r_0_27_151,r_107_144_71,r_108_31_9,r_0_27_151,0.6,7,158,151,12
30,r_82_65_61,r_3_79_180,r_105_50_168,r_82_65_61,0.91,118,179,61,12
29,r_46_57_108,r_95_133_158,r_68_42_34,r_46_57_108,0.96,0,108,108,12
49,r_129_78_26,seq35,seq18,r_129_78_26,0.99,0,26,26,12
25,r_107_144_71,seq148,r_29_116_18,r_107_144_71,1.0,0,71,71,12
37,r_89_55_8,r_13_102_156,seq32,r_89_55_8,0.71,3,11,8,12
28,r_68_42_34,r_80_10_39,seq147,r_68_42_34,0.94,0,34,34,12
32,r_119_19_190,r_122_51_17,r_8_85_13,r_8_85_13,0.73,177,190,13,12
77,seq61,r_95_133_158,r_130_73_55,r_130_73_55,1.0,104,159,55,12
75,seq59,r_4_86_137,r_66_94_88,r_66_94_88,0.86,0,88,88,12
84,seq83,seq142,r_149_91_32,r_149_91_32,1.0,0,32,32,12
17,r_110_146_77,seq18,seq35,r_110_146_77,0.99,0,77,77,12
9,r_8_85_13,r_107_144_71,seq118,r_8_85_13,0.47,2,15,13,12
28,r_68_42_34,seq147,r_46_57_108,r_46_57_108,0.68,6,114,108,12
22,r_69_24_96,seq93,r_124_52_10,r_69_24_96,1.0,2,98,96,12
56,seq16,r_3_79_180,r_105_50_168,r_105_50_168,0.92,13,181,168,12
7,r_105_50_168,seq81,r_82_65_61,r_105_50_168,0.89,0,168,168,12
44,r_26_88_139,seq32,r_54_139_40,r_26_88_139,0.62,7,146,139,12
26,r_149_91_32,r_26_88_139,seq83,r_149_91_32,1.0,0,32,32,12
19,r_36_101_33,seq136,r_89_55_8,r_36_101_33,0.98,-1,32,33,12
35,r_58_97_122,seq56,r_80_10_39,r_58_97_122,0.99,0,122,122,12
38,r_20_104_58,r_69_24_96,r_45_141_7,r_20_104_58,1.0,0,58,58,12
12,r_3_79_180,seq16,r_120_6_167,r_3_79_180,0.52,0,180,180,12
27,r_64_96_11,r_8_85_13,seq76,r_64_96_11,0.77,0,11,11,12
14,r_80_10_39,seq2,seq114,r_80_10_39,1.0,0,39,39,12
30,r_117_50_86,r_140_9_145,r_96_95_138,r_117_50_86,0.98,59,145,86,13
30,r_117_50_86,seq13,r_140_9_145,r_117_50_86,0.93,2,88,86,13
36,r_12_44_153,seq139,seq63,r_12_44_153,0.84,0,153,153,13
14,r_96_95_138,seq69,r_117_50_86,r_96_95_138,0.98,0,138,138,13
8,r_90_41_106,r_118_18_184,r_29_4_70,r_118_18_184,0.55,-78,106,184,13
43,r_36_60_107,r_107_138_187,seq27,r_36_60_107,1.0,0,107,107,13
31,r_108_75_18,r_26_28_61,seq88,r_108_75_18,0.99,0,18,18,13
37,r_29_4_70,seq65,seq134,r_29_4_70,1.0,2,72,70,13
55,seq13,seq63,r_7_127_78,r_7_127_78,1.0,77,155,78,13
21,r_106_10_94,seq109,r_58_92_20,r_106_10_94,1.0,0,94,94,13
39,r_37_51_143,r_140_9_145,r_70_91_147,r_37_51_143,0.98,0,143,143,13
1,r_15_31_135,r_140_9_145,seq87,r_15_31_135,0.95,0,135,135,13
38,r_62_93_48,r_103_35_51,seq102,r_62_93_48,1.0,0,48,48,13
16,r_110_116_44,r_36_60_107,seq141,r_110_116_44,1.0,0,44,44,13
5,r_24_68_129,seq19,r_53_89_103,r_24_68_129,0.99,0,129,129,13
46,r_45_43_119,seq136,seq22,r_45_43_119,0.9,0,119,119,13
68,seq59,seq86,r_77_40_17,r_77_40_17,1.0,27,44,17,13
80,seq83,seq27,r_124_146_15,r_124_146_15,1.0,27,42,15,13
7,r_107_138_187,r_108_75_18,seq14,r_108_75_18,0.52,169,187,18,13
45,r_7_127_78,seq48,seq13,r_7_127_78,1.0,0,78,78,13
24,r_121_145_52,r_140_9_145,r_117_50_86,r_121_145_52,0.56,60,112,52,13
15,r_115_2_190,r_26_28_61,r_120_33_155,r_26_28_61,0.7,129,190,61,13
66,seq46,seq88,r_108_75_18,r_108_75_18,0.73,66,84,18,13
41,r_99_39_115,seq134,r_45_43_119,r_99_39_115,0.95,5,120,115,13
3,r_120_33_155,r_23_55_148,seq71,r_23_55_148,0.96,1,149,148,13
47,r_42_49_12,r_58_92_20,seq136,r_42_49_12,0.97,0,12,12,13
49,r_113_126_49,r_24_68_129,seq109,r_113_126_49,0.98,0,49,49,13
26,r_130_74_156,seq63,r_73_132_91,r_130_74_156,0.59,0,156,156,13
4,r_73_132_91,seq22,seq19,r_73_132_91,0.99,0,91,91,13
0,r_3_79_101,r_115_2_190,r_111_54_188,r_3_79_101,0.98,1,102,101,13
11,r_140_9_145,r_37_51_143,r_103_35_51,r_140_9_145,0.91,-2,143,145,13
13,r_53_89_103,seq102,seq139,r_53_89_103,0.99,2,105,103,13
15,r_115_2_190,r_114_137_77,r_26_28_61,r_115_2_190,0.98,-109,81,190,13
27,r_112_67_97,seq101,r_81_72_93,r_112_67_97,0.94,0,97,97,13
24,r_121_145_52,seq144,r_140_9_145,r_121_145_52,0.99,0,52,52,13
2,r_135_142_111,seq63,r_26_28_61,r_135_142_111,0.99,2,113,111,13
74,seq69,r_96_95_138,r_57_122_72,r_57_122_72,0.64,4,76,72,13
29,r_57_122_72,seq16,seq69,r_57_122_72,1.0,0,72,72,13
33,r_23_55_148,r_120_33_155,r_90_41_106,r_120_33_155,0.93,-6,149,155,13
34,r_77_40_17,r_96_95_138,seq59,r_77_40_17,0.91,0,17,17,13
8,r_90_41_106,r_29_4_70,r_23_55_148,r_23_55_148,1.0,5,153,148,13
42,r_129_147_23,r_96_95_138,seq5,r_129_147_23,0.97,0,23,23,13
61,seq22,r_73_132_91,r_106_10_94,r_106_10_94,0.54,-3,91,94,13
32,r_70_91_147,r_52_133_193,r_90_41_106,r_90_41_106,1.0,44,150,106,13
85,seq88,r_107_138_187,r_108_75_18,r_108_75_18,0.97,1,19,18,13
59,seq20,r_24_68_129,r_128_34_11,r_128_34_11,0.85,0,11,11,13
61,seq22,r_106_10_94,r_45_43_119,r_45_43_119,0.57,16,135,119,13
17,r_47_25_83,seq83,seq82,r_47_25_83,1.0,1,84,83,13
18,r_128_34_11,r_120_33_155,seq20,r_128_34_11,0.9,0,11,11,13
9,r_81_72_93,r_3_79_101,r_64_149_197,r_81_72_93,1.0,1,94,93,13
28,r_26_28_61,r_115_2_190,r_135_142_111,r_135_142_111,0.74,11,122,111,13
22,r_114_137_77,r_115_2_190,seq6,r_114_137_77,1.0,-1,76,77,13
28,r_26_28_61,seq65,r_115_2_190,r_26_28_61,0.95,1,62,61,13
7,r_107_138_187,r_36_60_107,r_108_75_18,r_107_138_187,0.74,-88,99,187,13
23,r_1_0_71,r_56_76_194,seq131,r_1_0_71,1.0,0,71,71,13
20,r_103_35_51,r_30_143_175,r_124_146_15,r_103_35_51,0.77,3,54,51,13
30,r_53_68_149,r_61_108_157,r_62_142_96,r_61_108_157,0.85,-8,149,157,14
32,r_114_3_16,seq52,r_121_42_78,r_121_42_78,1.0,-2,76,78,14
14,r_31_55_4,r_56_87_180,r_92_33_70,r_92_33_70,1.0,110,180,70,14
8,r_109_91_169,r_4_34_156,seq24,r_4_34_156,0.48,-9,147,156,14
43,r_100_136_110,seq38,seq45,r_100_136_110,0.99,0,110,110,14
37,r_78_13_113,seq37,r_95_48_80,r_78_13_113,0.95,0,113,113,14
21,r_110_14_120,seq70,seq112,r_110_14_120,0.98,3,123,120,14
80,seq85,r_140_119_10,r_47_147_91,r_47_147_91,0.97,12,103,91,14
42,r_62_142_96,seq52,r_111_135_141,r_62_142_96,0.69,0,96,96,14
69,seq45,seq105,r_100_136_110,r_100_136_110,1.0,21,131,110,14
45,r_72_12_117,seq27,r_25_65_166,r_72_12_117,0.99,0,117,117,14
46,r_111_135_141,r_62_142_96,seq80,r_111_135_141,0.98,1,142,141,14
19,r_71_6_28,r_4_34_156,r_127_30_195,r_71_6_28,0.9,3,31,28,14
48,r_69_15_73,r_82_81_124,seq24,r_82_81_124,0.8,-10,114,124,14
31,r_89_22_115,seq37,r_106_107_112,r_89_22_115,0.94,0,115,115,14
41,r_29_5_163,r_56_87_180,r_63_36_199,r_63_36_199,0.48,-33,166,199,14
89,seq102,seq149,r_51_19_114,r_51_19_114,0.97,24,138,114,14
39,r_18_9_32,r_23_0_111,r_76_97_39,r_18_9_32,0.98,8,40,32,14
63,seq37,r_78_13_113,r_71_6_28,r_78_13_113,0.87,0,113,113,14
11,r_56_87_180,r_29_5_163,r_71_6_28,r_56_87_180,0.44,0,180,180,14
20,r_20_124_178,seq37,r_140_119_10,r_140_119_10,0.48,168,178,10,14
13,r_61_108_157,seq43,seq59,r_61_108_157,0.79,0,157,157,14
46,r_111_135_141,r_23_0_111,r_62_142_96,r_23_0_111,0.59,-8,103,111,14
15,r_50_77_72,seq94,seq105,r_50_77_72,0.97,0,72,72,14
48,r_69_15_73,r_144_57_197,r_82_81_124,r_69_15_73,0.99,3,76,73,14
57,seq16,r_66_60_130,seq123,r_66_60_130,1.0,0,130,130,14
42,r_62_142_96,r_111_135_141,r_75_46_161,r_111_135_141,0.69,1,142,141,14
16,r_76_97_39,r_144_57_197,seq129,r_76_97_39,0.99,1,40,39,14
17,r_104_21_52,r_74_58_144,seq105,r_104_21_52,1.0,0,52,52,14
6,r_128_145_131,seq112,r_133_146_196,r_128_145_131,0.91,1,132,131,14
0,r_82_81_124,seq24,r_69_15_73,r_82_81_124,0.55,-39,85,124,14
0,r_82_81_124,r_114_3_16,seq24,r_82_81_124,0.71,-106,18,124,14
27,r_74_58_144,seq54,seq101,r_74_58_144,0.97,0,144,144,14
12,r_130_79_48,seq2,seq149,r_130_79_48,1.0,0,48,48,14
1,r_140_119_10,seq41,seq85,r_140_119_10,0.99,0,10,10,14
2,r_92_33_70,r_51_19_114,seq88,r_92_33_70,1.0,0,70,70,14
75,seq70,seq41,r_92_33_70,r_92_33_70,0.63,84,154,70,14
40,r_4_34_156,r_109_91_169,seq141,r_4_34_156,0.59,0,156,156,14
18,r_120_64_50,seq11,seq134,r_120_64_50,0.99,14,64,50,14
29,r_47_147_91,r_23_0_111,seq85,r_23_0_111,0.57,-20,91,111,14
46,r_111_135_141,r_139_32_33,r_23_0_111,r_111_135_141,0.71,-108,33,141,14
0,r_82_81_124,r_69_15_73,seq52,r_82_81_124,0.95,1,125,124,14
24,r_1_138_106,seq27,seq80,r_1_138_106,1.0,0,106,106,14
25,r_75_46_161,r_133_146_196,r_62_142_96,r_62_142_96,0.59,67,163,96,14
88,seq101,r_100_136_110,seq102,r_100_136_110,1.0,0,110,110,14
38,r_63_36_199,seq84,r_29_5_163,r_29_5_163,0.75,3,166,163,14
34,r_23_0_111,r_133_146_196,seq105,r_23_0_111,0.99,0,111,111,14
3,r_139_32_33,r_111_135_141,seq11,r_139_32_33,0.82,0,33,33,14
9,r_51_19_114,seq129,seq102,r_51_19_114,0.83,1,115,114,14
28,r_95_48_80,r_128_145_131,r_103_117_90,r_95_48_80,0.94,1,81,80,14
49,r_121_42_78,seq118,r_114_3_16,r_121_42_78,0.98,1,79,78,14
56,seq141,seq52,r_89_22_115,r_89_22_115,0.99,6,121,115,14
7,r_10_143_173,r_103_117_90,seq54,r_10_143_173,0.66,0,173,173,14
44,r_106_107_112,seq149,seq141,r_106_107_112,0.72,1,113,112,14
82,seq88,r_56_87_180,r_92_33_70,r_92_33_70,1.0,8,78,70,14
32,r_114_3_16,r_82_81_124,seq52,r_114_3_16,0.98,1,17,16,14
80,seq85,r_4_34_156,r_140_119_10,r_140_119_10,0.59,21,31,10,14
93,seq116,seq111,r_8_104_114,r_8_104_114,1.0,7,121,114,15
30,r_57_41_105,seq59,seq114,r_57_41_105,0.85,2,107,105,15
51,seq129,r_106_71_106,seq141,r_106_71_106,0.89,3,109,106,15
36,r_106_71_106,seq129,r_9_80_149,r_106_71_106,1.0,1,107,106,15
12,r_105_64_34,r_133_131_190,seq40,r_105_64_34,1.0,-1,33,34,15
64,seq33,r_12_109_142,r_19_51_26,r_19_51_26,0.98,6,32,26,15
14,r_27_61_83,seq10,seq141,r_27_61_83,1.0,0,83,83,15
8,r_101_47_91,seq149,r_126_76_89,r_101_47_91,0.66,0,91,91,15
37,r_142_30_71,r_38_144_104,r_9_80_149,r_142_30_71,0.95,0,71,71,15
55,seq141,r_69_113_100,r_119_67_145,r_69_113_100,0.93,0,100,100,15
16,r_86_88_98,r_120_148_180,seq138,r_86_88_98,1.0,1,99,98,15
21,r_8_104_114,seq3,seq116,r_8_104_114,0.96,1,115,114,15
39,r_21_32_61,r_27_61_83,seq23,r_21_32_61,0.98,1,62,61,15
46,r_0_139_198,r_119_67_145,seq141,r_119_67_145,0.96,1,146,145,15
32,r_91_140_138,r_135_42_20,r_73_44_17,r_91_140_138,0.67,-4,134,138,15
45,r_1_93_183,seq35,r_68_24_171,r_1_93_183,0.48,1,184,183,15
15,r_39_11_41,seq138,r_73_44_17,r_39_11_41,1.0,1,42,41,15
33,r_56_22_173,r_133_131_190,seq146,r_56_22_173,0.44,0,173,173,15
27,r_135_42_20,r_91_140_138,seq35,r_91_140_138,0.99,-4,134,138,15
31,r_110_4_110,seq108,seq111,r_110_4_110,1.0,0,110,110,15
41,r_38_144_104,r_72_77_123,r_19_51_26,r_19_51_26,0.64,82,108,26,15
27,r_135_42_20,seq111,r_91_140_138,r_135_42_20,1.0,-3,17,20,15
10,r_72_77_123,r_38_144_104,r_98_65_131,r_72_77_123,0.51,-15,108,123,15
90,seq111,seq116,r_110_4_110,r_110_4_110,1.0,11,121,110,15
49,r_73_44_17,seq149,r_39_11_41,r_39_11_41,1.0,13,54,41,15
26,r_96_132_153,r_28_55_155,r_62_14_70,r_96_132_153,0.87,0,153,153,15
8,r_101_47_91,r_126_76_89,r_34_137_45,r_34_137_45,0.55,74,119,45,15
2,r_26_6_12,r_91_140_138,seq116,r_26_6_12,1.0,1,13,12,15
1,r_78_16_52,r_27_61_83,seq147,r_78_16_52,0.99,0,52,52,15
25,r_87_54_56,r_98_65_131,seq103,r_87_54_56,0.9,-2,54,56,15
78,seq79,seq23,r_99_5_97,r_99_5_97,0.99,5,102,97,15
0,r_119_67_145,r_0_139_198,r_86_88_98,r_0_139_198,0.97,-52,146,198,15
63,seq29,r_1_93_183,r_34_137_45,r_34_137_45,0.59,47,92,45,15
11,r_102_45_129,r_9_80_149,r_62_14_70,r_62_14_70,1.0,10,80,70,15
20,r_98_65_131,seq100,seq146,r_98_65_131,0.95,1,132,131,15
13,r_62_14_70,r_52_145_127,r_102_45_129,r_62_14_70,0.99,-4,66,70,15
29,r_19_51_26,r_85_13_47,seq33,r_19_51_26,0.92,0,26,26,15
48,r_69_113_100,seq141,seq10,r_69_113_100,1.0,0,100,100,15
57,seq17,r_97_134_150,r_36_2_74,r_36_2_74,1.0,79,153,74,15
13,r_62_14_70,r_102_45_129,r_9_80_149,r_102_45_129,0.97,1,130,129,15
33,r_56_22_173,r_78_16_52,r_133_131_190,r_78_16_52,0.83,-31,21,52,15
43,r_136_60_28,seq103,seq84,r_136_60_28,0.97,-2,26,28,15
87,seq103,r_124_48_14,r_36_2_74,r_36_2_74,0.49,16,90,74,15
13,r_62_14_70,r_9_80_149,r_96_132_153,r_96_132_153,0.98,8,161,153,15
47,r_99_5_97,seq114,seq79,r_99_5_97,0.99,1,98,97,15
40,r_7_15_112,seq17,seq35,r_7_15_112,0.68,0,112,112,15
24,r_12_109_142,seq33,r_78_16_52,r_78_16_52,0.58,89,141,52,15
82,seq84,r_1_93_183,r_136_60_28,r_136_60_28,0.87,0,28,28,15
66,seq40,r_57_41_105,r_105_64_34,r_105_64_34,0.95,-2,32,34,15
50,seq128,r_120_148_180,r_72_77_123,r_72_77_123,0.87,34,157,123,15
49,r_73_44_17,r_126_76_89,seq149,r_73_44_17,0.88,0,17,17,15
55,seq141,r_119_67_145,r_27_61_83,r_119_67_145,1.0,-5,140,145,15
38,r_36_2_74,r_126_76_89,seq103,r_126_76_89,0.91,-19,70,89,15
52,seq130,r_133_131_190,r_120_148_180,r_133_131_190,0.35,0,190,190,15
60,seq149,seq114,r_52_145_127,r_52_145_127,0.98,5,132,127,15
11,r_102_45_129,r_62_14_70,seq66,r_102_45_129,0.97,1,130,129,15
18,r_85_13_47,r_9_80_149,r_31_18_3,r_85_13_47,0.9,1,48,47,15
9,r_52_145_127,r_49_89_193,seq149,r_52_145_127,0.95,0,127,127,15
29,r_19_51_26,seq33,r_38_144_104,r_38_144_104,1.0,4,108,104,15
7,r_133_131_190,seq130,r_27_61_83,r_27_61_83,1.0,107,190,83,15
23,r_20_58_159,r_133_131_190,r_9_80_149,r_9_80_149,0.46,11,160,149,15
32,r_91_140_138,r_1_93_183,r_135_42_20,r_135_42_20,1.0,-3,17,20,15
35,r_28_55_155,r_96_132_153,seq46,r_28_55_155,0.59,-2,153,155,15
30,r_148_12_109,seq145,r_36_41_35,r_36_41_35,0.85,76,111,35,16
36,r_19_75_121,r_65_97_141,seq13,r_19_75_121,0.77,0,121,121,16
8,r_28_0_149,seq63,r_88_121_45,r_28_0_149,0.68,3,152,149,16
43,r_42_67_128,r_80_52_177,r_124_48_3,r_42_67_128,0.86,0,128,128,16
38,r_37_64_24,r_66_117_28,seq72,r_37_64_24,1.0,1,25,24,16
32,r_88_121_45,r_147_128_51,r_15_83_199,r_88_121_45,1.0,0,45,45,16
21,r_103_43_146,seq55,r_2_34_97,r_103_43_146,0.53,0,146,146,16
42,r_125_120_142,r_101_107_160,r_147_128_51,r_125_120_142,0.57,0,142,142,16
3,r_2_34_97,seq145,r_85_69_140,r_85_69_140,0.95,0,140,140,16
14,r_86_116_182,r_17_122_144,r_88_121_45,r_88_121_45,0.76,1,46,45,16
22,r_133_113_108,seq16,r_36_41_35,r_36_41_35,0.99,1,36,35,16
24,r_8_136_79,r_36_41_35,r_80_52_177,r_80_52_177,0.61,1,178,177,16
19,r_85_69_140,seq127,r_2_34_97,r_85_69_140,0.99,0,140,140,16
66,seq35,r_137_4_173,r_17_122_144,r_17_122_144,0.89,2,146,144,16
37,r_10_51_38,r_36_41_35,seq53,r_10_51_38,1.0,-2,36,38,16
0,r_36_41_35,r_10_51_38,r_133_113_108,r_36_41_35,1.0,0,35,35,16
39,r_126_22_127,r_11_6_25,seq102,r_126_22_127,0.92,1,128,127,16
41,r_24_30_126,seq20,r_71_1_36,r_24_30_126,0.61,5,131,126,16
3,r_2_34_97,r_80_52_177,seq145,r_2_34_97,0.55,1,98,97,16
10,r_57_106_74,seq55,r_76_132_101,r_57_106_74,0.98,0,74,74,16
16,r_76_132_101,seq108,r_37_64_24,r_76_132_101,0.99,0,101,101,16
14,r_86_116_182,r_88_121_45,r_17_122_144,r_17_122_144,0.96,38,182,144,16
13,r_11_6_25,r_86_116_182,r_126_22_127,r_11_6_25,1.0,0,25,25,16
1,r_112_33_13,r_85_69_140,r_15_83_199,r_112_33_13,1.0,0,13,13,16
11,r_7_46_98,seq134,seq104,r_7_46_98,1.0,0,98,98,16
20,r_135_79_76,seq44,r_11_6_25,r_135_79_76,0.95,0,76,76,16
15,r_29_91_103,r_111_25_99,r_37_64_24,r_37_64_24,1.0,75,99,24,16
13,r_11_6_25,r_126_22_127,r_135_79_76,r_11_6_25,0.9,103,128,25,16
53,seq139,seq100,r_147_128_51,r_147_128_51,1.0,0,51,51,16
37,r_10_51_38,seq53,r_70_56_63,r_70_56_63,0.99,28,91,63,16
16,r_76_132_101,r_66_117_28,seq108,r_66_117_28,0.87,0,28,28,16
22,r_133_113_108,r_36_41_35,seq104,r_133_113_108,0.92,0,108,108,16
2,r_137_4_173,seq35,r_49_141_95,r_49_141_95,0.93,81,176,95,16
40,r_80_52_177,seq104,r_8_136_79,r_8_136_79,0.63,99,178,79,16
18,r_61_21_73,r_15_83_199,seq127,r_61_21_73,1.0,0,73,73,16
29,r_105_9_181,r_31_73_137,r_49_141_95,r_105_9_181,0.7,-43,138,181,16
10,r_57_106_74,r_76_132_101,r_99_81_80,r_76_132_101,0.96,1,102,101,16
24,r_8_136_79,seq40,r_36_41_35,r_36_41_35,0.76,46,81,35,16
30,r_148_12_109,r_36_41_35,r_24_30_126,r_24_30_126,0.88,4,130,126,16
5,r_66_117_28,r_76_132_101,seq127,r_66_117_28,1.0,0,28,28,16
25,r_49_141_95,r_125_120_142,r_105_9_181,r_49_141_95,1.0,0,95,95,16
33,r_5_119_67,r_131_90_21,seq3,r_5_119_67,1.0,0,67,67,16
47,r_147_128_51,seq72,seq139,r_147_128_51,1.0,0,51,51,16
58,seq145,r_148_12_109,seq40,r_148_12_109,1.0,-33,76,109,16
89,seq95,r_135_79_76,seq55,r_135_79_76,0.97,-55,21,76,16
34,r_142_109_147,seq87,r_17_122_144,r_142_109_147,0.51,0,147,147,16
75,seq55,r_103_43_146,seq95,r_103_43_146,0.92,6,152,146,16
25,r_49_141_95,r_105_9_181,r_137_4_173,r_49_141_95,0.79,86,181,95,16
94,seq104,r_80_52_177,r_7_46_98,r_7_46_98,1.0,80,178,98,16
39,r_126_22_127,r_24_30_126,r_11_6_25,r_11_6_25,1.0,1,26,25,16
7,r_31_73_137,r_105_9_181,r_88_121_45,r_31_73_137,0.75,1,138,137,16
44,r_138_84_139,r_80_52_177,seq102,r_138_84_139,0.88,0,139,139,16
23,r_123_59_116,r_146_114_156,r_111_25_99,r_123_59_116,0.96,0,116,116,16
26,r_71_1_36,r_85_69_140,seq16,r_71_1_36,1.0,0,36,36,16
12,r_70_56_63,seq45,r_10_51_38,r_70_56_63,0.97,0,63,63,16
29,r_105_9_181,r_49_141_95,seq26,r_105_9_181,0.95,0,181,181,16
30,r_13_4_81,seq79,seq42,r_13_4_81,0.99,1,82,81,17
44,r_67_87_159,r_111_105_197,r_17_46_139,r_67_87_159,0.55,0,159,159,17
36,r_50_130_168,seq69,r_98_33_33,r_50_130_168,0.28,0,168,168,17
21,r_110_76_48,r_34_65_84,r_88_134_3,r_110_76_48,0.84,0,48,48,17
53,seq135,r_58_115_188,r_104_68_93,r_104_68_93,1.0,8,101,93,17
54,seq8,r_44_54_142,seq39,r_44_54_142,0.89,2,144,142,17
37,r_56_93_165,r_28_57_114,r_17_46_139,r_56_93_165,0.73,0,165,165,17
55,seq9,seq90,r_30_97_72,r_30_97_72,0.74,34,106,72,17
16,r_139_132_176,r_123_85_24,seq79,r_139_132_176,0.51,0,176,176,17
1,r_31_14_123,seq42,seq135,r_31_14_123,0.95,4,127,123,17
69,seq42,r_31_14_123,r_28_57_114,r_31_14_123,1.0,4,127,123,17
18,r_126_103_45,r_24_142_66,seq80,r_24_142_66,1.0,-21,45,66,17
45,r_1_47_99,seq129,seq72,r_1_47_99,0.98,0,99,99,17
39,r_120_26_43,seq35,seq117,r_120_26_43,1.0,0,43,43,17
15,r_24_142_66,r_98_33_33,r_86_10_129,r_86_10_129,1.0,1,130,129,17
31,r_2_137_151,seq19,r_53_138_95,r_53_138_95,0.98,60,155,95,17
41,r_133_81_162,seq22,r_44_54_142,r_133_81_162,0.77,0,162,162,17
26,r_108_89_100,seq125,r_120_26_43,r_108_89_100,1.0,0,100,100,17
25,r_34_65_84,r_32_16_131,seq90,r_34_65_84,1.0,0,84,84,17
62,seq22,seq149,r_70_118_14,r_70_118_14,0.93,23,37,14,17
0,r_44_54_142,seq8,seq74,r_44_54_142,0.88,0,142,142,17
20,r_91_95_96,seq75,seq141,r_91_95_96,0.95,0,96,96,17
13,r_104_68_93,r_111_105_197,seq135,r_104_68_93,1.0,0,93,93,17
6,r_148_21_26,seq90,r_58_115_188,r_148_21_26,1.0,0,26,26,17
15,r_24_142_66,seq82,r_98_33_33,r_24_142_66,1.0,0,66,66,17
48,r_5_7_54,r_34_65_84,r_3_41_59,r_5_7_54,0.89,-1,53,54,17
47,r_12_100_53,seq80,seq128,r_12_100_53,0.93,0,53,53,17
29,r_48_60_143,seq101,r_32_16_131,r_48_60_143,0.82,1,144,143,17
24,r_28_57_114,r_56_93_165,seq42,r_56_93_165,1.0,-53,112,165,17
56,seq11,r_98_33_33,r_107_78_29,r_98_33_33,1.0,0,33,33,17
25,r_34_65_84,r_5_7_54,r_32_16_131,r_5_7_54,0.68,-1,53,54,17
6,r_148_21_26,r_58_115_188,r_31_14_123,r_31_14_123,0.7,65,188,123,17
19,r_20_143_13,r_31_14_123,seq117,r_20_143_13,0.78,0,13,13,17
42,r_58_115_188,r_148_21_26,r_70_118_14,r_148_21_26,0.46,162,188,26,17
61,seq149,r_96_64_190,r_70_118_14,r_70_118_14,0.9,176,190,14,17
32,r_71_136_145,seq79,r_98_33_33,r_71_136_145,0.5,0,145,145,17
10,r_70_118_14,r_31_14_123,seq22,r_70_118_14,0.99,0,14,14,17
9,r_98_33_33,seq11,seq35,r_98_33_33,0.98,0,33,33,17
27,r_127_124_58,r_30_97_72,r_12_100_53,r_127_124_58,0.99,0,58,58,17
34,r_17_46_139,seq116,seq83,r_17_46_139,1.0,2,141,139,17
17,r_15_131_78,r_2_137_151,seq72,r_15_131_78,0.96,0,78,78,17
85,seq80,r_12_100_53,r_126_103_45,r_12_100_53,0.49,0,53,53,17
22,r_32_16_131,seq79,seq144,r_32_16_131,0.55,1,132,131,17
49,r_38_37_148,seq94,r_44_54_142,r_44_54_142,1.0,7,149,142,17
7,r_86_10_129,seq23,r_24_142_66,r_86_10_129,0.83,1,130,129,17
44,r_67_87_159,r_30_97_72,r_111_105_197,r_30_97_72,0.72,-4,68,72,17
23,r_66_140_70,r_28_57_114,seq19,r_28_57_114,0.57,-44,70,114,17
42,r_58_115_188,r_86_10_129,r_148_21_26,r_148_21_26,0.78,3,29,26,17
35,r_30_97_72,r_67_87_159,seq9,r_67_87_159,0.65,-81,78,159,17
12,r_121_146_154,seq128,r_59_114_199,r_121_146_154,0.62,0,154,154,17
44,r_50_64_151,seq85,seq124,r_50_64_151,0.96,1,152,151,18
36,r_94_45_69,seq143,seq68,r_94_45_69,1.0,0,69,69,18
21,r_131_88_171,seq1,r_135_73_131,r_131_88_171,0.63,0,171,171,18
39,r_11_126_87,seq95,seq21,r_11_126_87,1.0,0,87,87,18
15,r_52_103_17,seq5,seq134,r_52_103_17,1.0,0,17,17,18
4,r_108_38_38,r_25_8_106,seq1,r_108_38_38,0.99,2,40,38,18
5,r_25_8_106,seq26,r_117_57_103,r_25_8_106,0.97,0,106,106,18
46,r_6_123_159,r_130_144_158,r_109_28_27,r_6_123_159,0.75,0,159,159,18
45,r_99_147_102,seq39,seq101,r_99_147_102,0.66,17,119,102,18
24,r_125_37_31,r_97_129_120,seq80,r_97_129_120,1.0,0,120,120,18
19,r_29_35_73,seq101,r_109_28_27,r_109_28_27,1.0,4,31,27,18
61,seq145,r_46_100_55,r_127_146_181,r_46_100_55,1.0,0,55,55,18
30,r_109_28_27,r_131_88_171,r_29_35_73,r_109_28_27,0.98,0,27,27,18
20,r_139_65_25,r_135_73_131,seq19,r_139_65_25,0.54,-4,21,25,18
76,seq59,r_10_91_190,r_84_138_118,r_84_138_118,0.99,3,121,118,18
41,r_84_138_118,r_31_49_172,seq68,r_84_138_118,0.97,3,121,118,18
3,r_53_106_170,r_41_119_176,r_125_37_31,r_53_106_170,0.58,0,170,170,18
90,seq95,seq14,r_117_57_103,r_117_57_103,1.0,11,114,103,18
26,r_81_98_153,seq59,r_107_113_198,r_81_98_153,0.5,3,156,153,18
16,r_111_44_49,r_76_70_187,r_31_49_172,r_31_49_172,0.84,15,187,172,18
78,seq67,r_2_141_77,seq26,r_2_141_77,1.0,0,77,77,18
73,seq39,r_99_147_102,seq142,r_99_147_102,0.73,17,119,102,18
11,r_32_132_116,seq30,r_110_54_30,r_32_132_116,0.52,1,117,116,18
30,r_109_28_27,seq101,r_61_40_99,r_61_40_99,1.0,0,99,99,18
49,r_97_129_120,r_125_37_31,r_109_28_27,r_97_129_120,1.0,0,120,120,18
67,seq24,r_72_140_43,seq80,r_72_140_43,0.98,0,43,43,18
13,r_110_54_30,seq79,r_118_43_74,r_118_43_74,1.0,4,78,74,18
30,r_109_28_27,r_29_35_73,seq101,r_29_35_73,1.0,0,73,73,18
13,r_110_54_30,r_131_88_171,seq79,r_110_54_30,0.84,9,39,30,18
2,r_148_18_24,r_76_70_187,r_92_83_54,r_148_18_24,1.0,-1,23,24,18
47,r_74_4_146,seq0,seq1,r_74_4_146,0.79,0,146,146,18
40,r_118_43_74,r_25_8_106,r_110_54_30,r_118_43_74,1.0,1,75,74,18
29,r_41_119_176,seq82,seq33,r_41_119_176,0.72,0,176,176,18
25,r_51_15_66,r_25_8_106,seq21,r_51_15_66,0.99,1,67,66,18
33,r_55_122_80,seq105,r_148_18_24,r_55_122_80,0.83,0,80,80,18
31,r_76_70_187,seq142,r_111_44_49,r_111_44_49,1.0,0,49,49,18
68,seq26,r_25_8_106,seq67,r_25_8_106,1.0,0,106,106,18
32,r_61_40_99,r_96_17_194,r_109_28_27,r_61_40_99,0.98,0,99,99,18
38,r_31_49_172,seq104,seq39,r_31_49_172,0.72,0,172,172,18
75,seq58,r_10_91_190,r_84_138_118,r_84_138_118,1.0,72,190,118,18
19,r_29_35_73,r_109_28_27,r_108_38_38,r_29_35_73,1.0,0,73,73,18
42,r_112_137_15,r_109_28_27,seq22,r_112_137_15,0.98,0,15,15,18
81,seq75,r_48_56_97,seq79,r_48_56_97,0.99,0,97,97,18
96,seq115,seq93,r_2_141_77,r_2_141_77,1.0,8,85,77,18
48,r_72_140_43,seq24,r_9_77_1,r_72_140_43,1.0,0,43,43,18
31,r_76_70_187,r_111_44_49,r_131_88_171,r_111_44_49,0.4,138,187,49,18
49,r_97_129_120,r_72_140_43,r_125_37_31,r_97_129_120,0.73,-90,30,120,18
22,r_10_91_190,seq58,r_131_88_171,r_131_88_171,0.88,19,190,171,18
28,r_135_73_131,seq134,seq12,r_135_73_131,0.93,2,133,131,18
91,seq101,r_76_70_187,r_99_147_102,r_99_147_102,0.48,17,119,102,18
7,r_117_57_103,seq87,seq95,r_117_57_103,1.0,1,104,103,18
23,r_136_71_154,seq128,r_148_18_24,r_148_18_24,0.54,130,154,24,18
79,seq68,seq33,r_84_138_118,r_84_138_118,1.0,26,144,118,18
35,r_48_56_97,seq75,seq143,r_48_56_97,0.91,0,97,97,18
16,r_111_44_49,r_63_62_193,r_76_70_187,r_111_44_49,1.0,0,49,49,18
24,r_125_37_31,r_86_149_175,r_97_129_120,r_125_37_31,1.0,0,31,31,18
12,r_2_141_77,seq67,seq115,r_2_141_77,1.0,1,78,77,18
14,r_46_100_55,seq145,seq19,r_46_100_55,1.0,0,55,55,18
30,r_108_77_131,seq85,seq34,r_108_77_131,0.94,0,131,131,19
36,r_38_15_112,r_149_53_103,r_6_60_2,r_38_15_112,1.0,2,114,112,19
92,seq145,r_1_47_125,seq72,r_1_47_125,1.0,1,126,125,19
14,r_109_89_93,r_139_131_187,seq85,r_109_89_93,1.0,0,93,93,19
49,r_21_140_58,seq144,seq129,r_21_140_58,1.0,0,58,58,19
41,r_103_135_49,seq125,seq62,r_103_135_49,0.98,0,49,49,19
50,seq128,r_95_68_54,seq48,r_95_68_54,0.87,0,54,54,19
37,r_46_105_148,seq50,r_123_51_22,r_46_105_148,0.83,0,148,148,19
15,r_123_51_22,r_22_97_89,seq54,r_123_51_22,0.96,0,22,22,19
86,seq91,r_120_13_85,seq146,r_120_13_85,1.0,-25,60,85,19
39,r_58_36_98,r_4_49_121,seq18,r_58_36_98,0.87,0,98,98,19
1,r_113_98_96,seq40,seq128,r_113_98_96,0.71,15,111,96,19
5,r_78_69_122,seq31,seq44,r_78_69_122,0.99,1,123,122,19
80,seq70,seq91,r_147_39_73,r_147_39_73,1.0,25,98,73,19
74,seq54,r_45_0_180,r_123_51_22,r_123_51_22,0.93,0,22,22,19
8,r_142_19_24,r_95_68_54,r_55_115_143,r_95_68_54,0.68,-30,24,54,19
19,r_83_107_95,r_4_49_121,seq8,r_83_107_95,0.83,-1,94,95,19
34,r_95_68_54,r_142_19_24,seq110,r_95_68_54,1.0,0,54,54,19
3,r_117_82_190,seq137,r_79_124_181,r_79_124_181,0.75,-2,179,181,19
10,r_66_93_136,seq62,seq44,r_66_93_136,0.82,1,137,136,19
90,seq101,seq126,r_106_59_106,r_106_59_106,1.0,12,118,106,19
97,seq118,r_92_20_119,r_71_111_32,r_71_111_32,1.0,0,32,32,19
26,r_106_59_106,r_116_37_162,seq101,r_106_59_106,0.99,0,106,106,19
4,r_43_119_124,seq9,seq24,r_43_119_124,0.85,0,124,124,19
78,seq64,r_127_42_179,r_109_89_93,r_109_89_93,1.0,88,181,93,19
20,r_65_63_153,seq31,r_21_140_58,r_21_140_58,1.0,96,154,58,19
3,r_117_82_190,r_79_124_181,seq91,r_117_82_190,0.87,0,190,190,19
46,r_80_10_146,seq61,r_108_77_131,r_80_10_146,0.61,0,146,146,19
48,r_56_148_78,r_38_15_112,r_12_57_46,r_12_57_46,0.99,33,79,46,19
57,seq9,r_43_119_124,seq54,r_43_119_124,0.84,0,124,124,19
50,seq128,seq48,r_113_98_96,r_113_98_96,0.61,-6,90,96,19
6,r_22_97_89,seq34,seq30,r_22_97_89,1.0,0,89,89,19
46,r_80_10_146,r_95_68_54,seq61,r_95_68_54,1.0,-3,51,54,19
47,r_147_39_73,r_55_115_143,seq70,r_147_39_73,1.0,-1,72,73,19
40,r_120_13_85,seq91,seq129,r_120_13_85,1.0,2,87,85,19
18,r_2_29_139,r_139_131_187,r_83_107_95,r_83_107_95,0.97,50,145,95,19
29,r_11_132_107,r_25_90_197,r_6_60_2,r_11_132_107,1.0,2,109,107,19
27,r_71_111_32,r_87_138_170,seq118,r_71_111_32,0.99,0,32,32,19
24,r_127_42_179,seq64,r_123_51_22,r_123_51_22,0.95,157,179,22,19
25,r_45_0_180,r_43_119_124,seq54,r_43_119_124,0.53,-36,88,124,19
33,r_74_32_117,seq126,r_86_121_152,r_74_32_117,0.79,0,117,117,19
64,seq30,seq85,r_22_97_89,r_22_97_89,1.0,25,114,89,19
58,seq144,r_87_138_170,r_66_93_136,r_66_93_136,0.74,18,154,136,19
68,seq35,r_5_26_138,r_2_29_139,r_5_26_138,0.98,0,138,138,19
32,r_149_53_103,r_38_15_112,r_16_27_1,r_38_15_112,1.0,2,114,112,19
38,r_4_49_121,r_7_52_3,r_22_97_89,r_7_52_3,1.0,118,121,3,19
25,r_45_0_180,seq54,r_104_76_7,r_45_0_180,0.59,0,180,180,19
94,seq110,seq34,r_95_68_54,r_95_68_54,1.0,26,80,54,19
0,r_12_57_46,seq145,seq62,r_12_57_46,1.0,0,46,46,19
72,seq48,r_16_27_1,r_100_84_199,r_100_84_199,0.58,-50,149,199,19
7,r_87_138_170,seq144,r_103_135_49,r_103_135_49,0.49,125,174,49,19
82,seq75,seq40,r_122_14_155,r_122_14_155,0.88,22,177,155,19
35,r_122_14_155,r_6_60_2,seq75,r_122_14_155,0.71,0,155,155,19
11,r_143_136_41,r_113_98_96,seq94,r_143_136_41,1.0,1,42,41,19
12,r_6_60_2,r_122_14_155,r_11_132_107,r_11_132_107,0.76,48,155,107,19
93,seq108,seq23,r_33_26_41,r_33_26_41,1.0,52,93,41,20
99,seq125,r_33_26_41,r_148_14_38,r_33_26_41,0.76,1,42,41,20
30,r_140_2_84,seq64,r_12_136_170,r_140_2_84,1.0,0,84,84,20
21,r_12_136_170,r_144_84_95,r_21_146_27,r_12_136_170,0.95,-122,48,170,20
32,r_20_37_54,seq131,seq105,r_20_37_54,1.0,1,55,54,20
92,seq106,r_16_134_174,r_28_126_81,r_28_126_81,1.0,72,153,81,20
8,r_52_112_141,r_39_104_159,seq62,r_52_112_141,0.98,1,142,141,20
43,r_107_69_171,seq34,r_59_74_10,r_59_74_10,0.53,161,171,10,20
54,seq6,r_46_87_185,r_70_25_164,r_70_25_164,0.61,21,185,164,20
37,r_110_77_142,r_41_93_80,seq4,r_110_77_142,0.48,-57,85,142,20
3,r_122_128_43,r_50_98_186,r_39_104_159,r_122_128_43,0.63,128,171,43,20
19,r_45_116_108,r_57_117_21,r_59_74_10,r_45_116_108,0.99,0,108,108,20
45,r_21_146_27,r_85_67_147,r_12_136_170,r_21_146_27,0.83,0,27,27,20
16,r_16_134_174,seq106,r_145_142_158,r_16_134_174,0.43,0,174,174,20
39,r_135_60_144,seq64,seq95,r_135_60_144,0.96,0,144,144,20
5,r_85_67_147,seq81,seq11,r_85_67_147,0.48,3,150,147,20
46,r_68_65_93,r_145_142_158,seq92,r_68_65_93,0.83,0,93,93,20
80,seq81,r_85_67_147,r_33_26_41,r_33_26_41,1.0,77,118,41,20
15,r_33_26_41,seq125,seq108,r_33_26_41,1.0,1,42,41,20
3,r_122_128_43,r_24_71_139,r_50_98_186,r_122_128_43,1.0,0,43,43,20
38,r_50_98_186,r_122_128_43,r_19_123_2,r_50_98_186,0.47,1,187,186,20
31,r_36_141_91,r_107_69_171,seq83,r_36_141_91,0.98,1,92,91,20
38,r_50_98_186,r_133_111_87,r_122_128_43,r_50_98_186,0.97,-141,45,186,20
28,r_148_14_38,seq73,seq125,r_148_14_38,0.84,1,39,38,20
10,r_133_111_87,r_50_98_186,seq131,r_133_111_87,1.0,2,89,87,20
4,r_42_149_82,r_76_80_134,seq121,r_42_149_82,1.0,-1,81,82,20
0,r_24_71_139,seq30,seq125,r_24_71_139,0.96,1,140,139,20
63,seq34,r_107_69_171,r_145_142_158,r_145_142_158,0.82,13,171,158,20
11,r_97_137_126,seq121,seq94,r_97_137_126,0.98,0,126,126,20
9,r_99_101_176,r_148_14_38,r_68_65_93,r_99_101_176,0.99,0,176,176,20
48,r_144_84_95,r_12_136_170,seq34,r_144_84_95,1.0,2,97,95,20
6,r_9_118_127,seq58,r_45_116_108,r_9_118_127,0.8,3,130,127,20
62,seq30,r_24_71_139,seq103,r_24_71_139,1.0,1,140,139,20
7,r_29_114_28,r_36_141_91,seq82,r_29_114_28,0.68,1,29,28,20
27,r_48_63_76,r_39_104_159,r_120_75_45,r_48_63_76,1.0,0,76,76,20
2,r_70_25_164,seq49,seq6,r_70_25_164,0.71,1,165,164,20
47,r_15_102_66,seq143,seq109,r_15_102_66,1.0,0,66,66,20
40,r_145_142_158,seq105,r_144_84_95,r_144_84_95,0.8,63,158,95,20
18,r_127_1_155,r_120_75_45,seq92,r_127_1_155,0.78,1,156,155,20
29,r_32_8_25,r_110_77_142,r_3_89_137,r_32_8_25,0.91,112,137,25,20
24,r_39_104_159,seq109,r_122_128_43,r_39_104_159,0.75,0,159,159,20
37,r_110_77_142,seq4,r_47_22_29,r_110_77_142,1.0,1,143,142,20
34,r_3_89_137,r_47_22_29,r_32_8_25,r_3_89_137,0.99,0,137,137,20
33,r_31_44_104,seq86,r_47_22_29,r_31_44_104,0.99,0,104,104,20
64,seq35,r_145_142_158,r_129_130_4,r_145_142_158,0.95,-47,111,158,20
88,seq95,seq0,r_135_60_144,r_135_60_144,0.97,10,154,144,20
34,r_3_89_137,r_9_118_127,r_47_22_29,r_47_22_29,0.78,33,62,29,20
25,r_57_117_21,r_16_134_174,r_45_116_108,r_57_117_21,0.99,0,21,21,20
17,r_79_90_121,seq125,seq73,r_79_90_121,0.85,0,121,121,20
25,r_57_117_21,r_45_116_108,r_55_18_14,r_45_116_108,0.97,0,108,108,20
94,seq109,r_39_104_159,r_15_102_66,r_15_102_66,1.0,93,159,66,20
9,r_99_101_176,r_79_90_121,r_148_14_38,r_99_101_176,0.88,-55,121,176,20
26,r_47_22_29,r_3_89_137,r_110_77_142,r_47_22_29,0.99,113,142,29,20
96,seq115,r_39_104_159,r_51_10_64,r_51_10_64,0.99,10,74,64,20
22,r_28_126_81,r_46_87_185,seq106,r_28_126_81,1.0,0,81,81,20
91,seq105,r_145_142_158,r_20_37_54,r_20_37_54,0.99,63,117,54,20
74,seq62,r_17_119_55,seq4,r_17_119_55,0.53,4,59,55,20
26,r_47_22_29,r_39_104_159,r_3_89_137,r_47_22_29,1.0,0,29,29,20
49,r_17_119_55,seq62,seq121,r_17_119_55,0.84,4,59,55,20
44,r_51_10_64,r_133_111_87,seq115,r_51_10_64,1.0,1,65,64,20
23,r_46_87_185,r_28_126_81,seq6,r_28_126_81,1.0,0,81,81,20
82,seq83,seq131,r_36_141_91,r_36_141_91,1.0,0,91,91,20
35,r_41_93_80,r_110_77_142,seq53,r_41_93_80,0.71,5,85,80,20
12,r_138_132_172,seq54,seq125,r_138_132_172,0.6,4,176,172,20
19,r_45_116_108,seq13,r_57_117_21,r_57_117_21,1.0,0,21,21,20
23,r_46_87_185,seq6,seq72,r_46_87_185,0.82,0,185,185,20
0,r_60_87_27,seq38,r_24_57_145,r_60_87_27,0.91,1,28,27,21
36,r_64_89_142,r_80_141_8,r_131_54_2,r_64_89_142,0.97,0,142,142,21
46,r_127_9_22,r_96_86_139,r_69_103_136,r_127_9_22,0.99,0,22,22,21
3,r_110_90_33,r_47_134_4,seq93,r_47_134_4,0.65,31,35,4,21
59,seq17,r_111_101_111,r_6_135_102,r_111_101_111,0.94,0,111,111,21
86,seq93,r_50_125_156,seq117,r_50_125_156,0.94,-2,154,156,21
16,r_100_46_84,r_80_141_8,seq146,r_100_46_84,0.96,1,85,84,21
5,r_50_125_156,seq93,r_60_87_27,r_60_87_27,0.92,132,159,27,21
42,r_68_148_174,r_143_120_161,seq3,r_68_148_174,0.55,0,174,174,21
80,seq78,seq62,r_63_66_61,r_63_66_61,1.0,12,73,61,21
1,r_19_12_55,seq23,r_127_9_22,r_19_12_55,1.0,4,59,55,21
19,r_126_142_183,seq23,r_111_101_111,r_111_101_111,0.97,72,183,111,21
32,r_130_14_23,r_36_104_79,seq147,r_36_104_79,1.0,1,80,79,21
95,seq117,r_140_73_162,seq93,r_140_73_162,0.8,4,166,162,21
31,r_75_94_50,r_63_66_61,seq25,r_75_94_50,0.62,0,50,50,21
97,seq121,r_50_125_156,r_96_86_139,r_96_86_139,0.62,8,147,139,21
33,r_109_33_25,r_71_99_115,seq21,r_71_99_115,0.62,-82,33,115,21
89,seq106,r_113_98_17,r_137_82_122,r_137_82_122,1.0,25,147,122,21
30,r_51_92_31,seq0,seq91,r_51_92_31,0.61,2,33,31,21
88,seq145,r_80_141_8,r_72_105_53,r_72_105_53,1.0,-2,51,53,21
14,r_83_58_36,seq25,seq85,r_83_58_36,0.99,4,40,36,21
11,r_32_13_137,r_144_39_172,seq41,r_32_13_137,0.57,4,141,137,21
20,r_2_7_120,r_24_57_145,r_127_9_22,r_2_7_120,0.88,0,120,120,21
62,seq21,r_55_65_158,r_109_33_25,r_109_33_25,0.54,15,40,25,21
13,r_96_86_139,r_143_120_161,seq121,r_96_86_139,0.56,1,140,139,21
46,r_127_9_22,r_69_103_136,r_2_7_120,r_69_103_136,0.57,-14,122,136,21
26,r_36_104_79,r_130_14_23,r_70_77_37,r_36_104_79,0.98,0,79,79,21
15,r_48_56_86,seq61,seq147,r_48_56_86,0.97,1,87,86,21
26,r_36_104_79,seq107,r_130_14_23,r_130_14_23,0.95,2,25,23,21
57,seq15,seq78,r_8_30_93,r_8_30_93,1.0,0,93,93,21
6,r_111_101_111,seq17,seq139,r_111_101_111,0.99,0,111,111,21
23,r_27_31_13,seq16,seq62,r_27_31_13,0.94,2,15,13,21
34,r_76_118_57,seq0,r_75_94_50,r_76_118_57,0.68,2,59,57,21
27,r_63_66_61,seq45,seq78,r_63_66_61,1.0,0,61,61,21
41,r_69_103_136,r_127_9_22,r_88_22_64,r_69_103_136,0.99,1,137,136,21
47,r_11_122_180,seq146,seq136,r_11_122_180,0.6,0,180,180,21
76,seq49,r_72_105_53,seq147,r_72_105_53,1.0,2,55,53,21
37,r_72_105_53,seq49,seq145,r_72_105_53,1.0,0,53,53,21
40,r_143_120_161,r_68_148_174,r_60_87_27,r_143_120_161,0.55,1,162,161,21
24,r_71_99_115,seq136,r_68_148_174,r_71_99_115,0.91,1,116,115,21
25,r_140_73_162,seq117,r_109_33_25,r_140_73_162,0.32,4,166,162,21
63,seq23,r_19_12_55,seq129,r_19_12_55,1.0,4,59,55,21
0,r_60_87_27,r_24_57_145,r_4_123_59,r_60_87_27,0.98,33,60,27,21
41,r_69_103_136,r_70_77_37,r_127_9_22,r_127_9_22,0.92,11,33,22,21
2,r_4_123_59,r_48_56_86,r_60_87_27,r_4_123_59,0.99,-7,52,59,21
48,r_95_40_48,r_96_86_139,seq45,r_95_40_48,1.0,1,49,48,21
60,seq146,r_11_122_180,r_100_46_84,r_100_46_84,1.0,16,100,84,21
17,r_80_141_8,r_64_89_142,seq145,r_64_89_142,0.95,0,142,142,21
9,r_53_74_89,seq28,seq61,r_53_74_89,1.0,2,91,89,21
91,seq108,r_76_118_57,seq0,r_76_118_57,0.58,-32,25,57,21
96,seq119,r_80_141_8,r_88_22_64,r_88_22_64,1.0,8,72,64,21
97,seq121,r_8_30_93,r_50_125_156,r_8_30_93,0.87,-42,51,93,21
28,r_88_22_64,seq25,seq119,r_88_22_64,1.0,0,64,64,21
49,r_1_20_88,r_140_73_162,seq84,r_1_20_88,0.57,6,94,88,21
7,r_8_30_93,seq21,seq15,r_8_30_93,0.98,1,94,93,21
44,r_43_133_188,seq61,r_110_90_33,r_43_133_188,0.37,0,188,188,21
32,r_130_14_23,r_80_141_8,r_36_104_79,r_130_14_23,0.99,0,23,23,21
79,seq62,seq78,r_27_31_13,r_27_31_13,0.87,60,73,13,21
35,r_137_82_122,r_10_5_1,seq106,r_137_82_122,0.99,0,122,122,21
12,r_116_52_103,seq139,r_132_97_90,r_116_52_103,0.86,3,106,103,21
45,r_113_98_17,seq21,seq106,r_113_98_17,0.51,1,18,17,21
14,r_107_148_97,r_70_58_126,seq119,r_107_148_97,0.64,0,97,97,22
6,r_134_41_81,r_111_77_131,seq113,r_111_77_131,1.0,2,133,131,22
60,seq142,r_147_9_52,r_74_3_54,r_147_9_52,1.0,3,55,52,22
43,r_101_90_149,seq119,r_64_65_66,r_64_65_66,0.73,83,149,66,22
32,r_46_131_45,r_145_32_53,seq146,r_46_131_45,0.75,0,45,45,22
16,r_112_51_100,seq11,seq79,r_112_51_100,0.99,0,100,100,22
21,r_50_29_150,seq79,r_2_85_123,r_50_29_150,0.82,-1,149,150,22
24,r_47_71_28,seq1,seq137,r_47_71_28,1.0,2,30,28,22
1,r_56_95_101,r_111_77_131,r_47_71_28,r_56_95_101,0.96,0,101,101,22
0,r_70_58_126,r_18_16_4,r_74_3_54,r_70_58_126,0.99,0,126,126,22
46,r_23_30_77,seq146,seq31,r_23_30_77,0.99,0,77,77,22
42,r_100_86_61,r_64_65_66,r_84_149_9,r_100_86_61,0.91,1,62,61,22
46,r_23_30_77,seq31,r_123_96_133,r_123_96_133,0.81,3,136,133,22
45,r_129_68_188,r_18_16_4,r_20_12_5,r_20_12_5,0.7,183,188,5,22
10,r_45_76_20,r_109_81_82,seq63,r_45_76_20,0.67,0,20,20,22
11,r_64_65_66,r_37_7_154,r_101_90_149,r_64_65_66,0.91,84,150,66,22
66,seq22,r_2_85_123,r_115_43_27,r_115_43_27,1.0,54,81,27,22
38,r_109_81_82,seq146,seq60,r_109_81_82,0.99,1,83,82,22
26,r_53_33_164,r_10_44_50,r_147_9_52,r_53_33_164,0.72,-111,53,164,22
3,r_106_28_120,r_123_96_133,r_99_128_111,r_99_128_111,1.0,9,120,111,22
90,seq97,r_134_41_81,seq31,r_134_41_81,1.0,-5,76,81,22
78,seq57,r_25_108_197,r_13_21_75,r_13_21_75,1.0,36,111,75,22
0,r_70_58_126,r_107_148_97,r_18_16_4,r_107_148_97,0.89,0,97,97,22
75,seq52,r_80_8_144,r_61_120_55,r_61_120_55,1.0,2,57,55,22
34,r_127_130_23,r_126_40_192,r_74_3_54,r_126_40_192,0.8,-137,55,192,22
47,r_111_77_131,r_134_41_81,r_123_96_133,r_111_77_131,0.99,0,131,131,22
6,r_134_41_81,seq24,r_111_77_131,r_134_41_81,1.0,0,81,81,22
27,r_34_116_33,r_20_12_5,r_47_71_28,r_20_12_5,0.99,28,33,5,22
39,r_61_120_55,r_112_51_100,seq52,r_61_120_55,0.87,1,56,55,22
22,r_20_12_5,r_34_116_33,seq1,r_34_116_33,0.99,0,33,33,22
47,r_111_77_131,r_56_95_101,r_134_41_81,r_111_77_131,0.88,-30,101,131,22
38,r_109_81_82,r_45_76_20,seq146,r_45_76_20,0.49,2,22,20,22
40,r_18_16_4,r_129_68_188,r_2_85_123,r_2_85_123,0.56,65,188,123,22
17,r_147_9_52,seq63,seq144,r_147_9_52,0.91,3,55,52,22
18,r_14_141_96,r_121_122_166,r_74_3_54,r_14_141_96,0.77,1,97,96,22
25,r_38_82_106,seq59,r_74_3_54,r_74_3_54,0.57,67,121,54,22
58,seq11,r_112_51_100,r_87_69_14,r_112_51_100,0.98,-27,73,100,22
19,r_87_69_14,r_99_128_111,seq11,r_87_69_14,0.99,0,14,14,22
20,r_91_124_49,seq146,seq113,r_91_124_49,0.98,7,56,49,22
23,r_10_44_50,r_53_33_164,seq59,r_10_44_50,0.93,3,53,50,22
41,r_36_117_26,seq137,r_74_3_54,r_36_117_26,0.99,2,28,26,22
2,r_145_32_53,r_64_65_66,seq17,r_145_32_53,0.95,0,53,53,22
94,seq104,r_114_78_139,r_25_108_197,r_114_78_139,1.0,0,139,139,22
33,r_115_43_27,r_145_32_53,seq24,r_115_43_27,1.0,1,28,27,22
28,r_74_3_54,seq140,r_70_58_126,r_70_58_126,0.99,1,127,126,22
49,r_62_72_116,seq59,seq5,r_62_72_116,0.6,2,118,116,22
7,r_99_128_111,seq83,seq31,r_99_128_111,1.0,0,111,111,22
40,r_60_35_163,r_57_88_58,r_73_137_53,r_60_35_163,0.81,1,164,163,23
30,r_119_43_162,r_133_71_197,seq128,r_119_43_162,0.71,0,162,162,23
36,r_13_130_194,r_49_139_138,seq122,r_49_139_138,1.0,3,141,138,23
5,r_92_64_152,r_65_112_55,r_91_54_35,r_92_64_152,1.0,-107,45,152,23
22,r_103_97_39,r_23_61_87,r_70_38_12,r_70_38_12,0.58,27,39,12,23
14,r_57_88_58,r_63_20_161,r_60_35_163,r_57_88_58,0.72,4,62,58,23
8,r_52_100_114,seq6,r_93_62_72,r_93_62_72,0.88,98,170,72,23
48,r_125_27_36,seq48,r_0_135_105,r_125_27_36,0.99,-3,33,36,23
3,r_91_54_35,seq138,r_92_64_152,r_91_54_35,0.99,0,35,35,23
3,r_91_54_35,r_92_64_152,r_16_110_67,r_91_54_35,0.46,117,152,35,23
18,r_65_112_55,r_92_64_152,r_113_30_95,r_65_112_55,0.99,1,56,55,23
16,r_31_66_65,seq109,seq51,r_31_66_65,1.0,2,67,65,23
39,r_2_105_97,r_50_69_126,seq98,r_2_105_97,0.88,1,98,97,23
46,r_113_30_95,r_15_67_146,r_65_112_55,r_65_112_55,1.0,14,69,55,23
42,r_147_11_175,seq75,r_19_74_29,r_147_11_175,0.43,5,180,175,23
37,r_118_102_80,seq58,r_19_74_29,r_118_102_80,0.66,-50,30,80,23
45,r_17_42_183,seq95,seq75,r_17_42_183,0.52,1,184,183,23
19,r_4_56_130,r_94_120_198,seq131,r_4_56_130,1.0,0,130,130,23
1,r_123_72_31,r_116_9_85,seq29,r_123_72_31,1.0,-1,30,31,23
33,r_111_12_33,r_116_9_85,seq48,r_111_12_33,0.81,0,33,33,23
11,r_93_62_72,r_111_12_33,r_52_100_114,r_52_100_114,0.6,6,120,114,23
89,seq95,r_17_42_183,r_123_72_31,r_123_72_31,0.98,153,184,31,23
2,r_19_74_29,r_52_100_114,r_118_102_80,r_19_74_29,0.94,0,29,29,23
14,r_57_88_58,r_60_35_163,r_113_30_95,r_57_88_58,0.95,87,145,58,23
4,r_16_110_67,seq81,seq95,r_16_110_67,1.0,0,67,67,23
98,seq122,r_49_139_138,r_82_24_50,r_82_24_50,0.51,1,51,50,23
31,r_73_137_53,seq131,seq132,r_73_137_53,1.0,0,53,53,23
11,r_93_62_72,r_94_120_198,r_111_12_33,r_93_62_72,0.66,-1,71,72,23
6,r_70_38_12,r_16_110_67,r_133_71_197,r_70_38_12,0.71,2,14,12,23
20,r_140_96_109,seq44,r_23_61_87,r_140_96_109,0.79,1,110,109,23
15,r_116_9_85,seq51,seq53,r_116_9_85,0.96,1,86,85,23
5,r_92_64_152,r_91_54_35,r_50_69_126,r_92_64_152,0.99,0,152,152,23
0,r_77_40_44,seq29,seq21,r_77_40_44,1.0,0,44,44,23
27,r_144_89_169,seq83,seq45,r_144_89_169,0.7,0,169,169,23
18,r_65_112_55,r_113_30_95,r_52_100_114,r_113_30_95,0.51,5,100,95,23
40,r_60_35_163,seq121,r_57_88_58,r_57_88_58,0.71,15,73,58,23
29,r_0_135_105,r_18_86_150,r_31_66_65,r_18_86_150,0.99,-45,105,150,23
24,r_126_8_181,r_10_59_186,r_77_40_44,r_77_40_44,0.89,137,181,44,23
95,seq109,r_31_66_65,r_77_40_44,r_77_40_44,0.52,-1,43,44,23
25,r_34_104_93,r_118_102_80,seq6,r_34_104_93,0.9,-1,92,93,23
48,r_125_27_36,r_0_135_105,seq5,r_0_135_105,1.0,0,105,105,23
50,seq128,seq138,r_118_102_80,r_118_102_80,0.95,15,95,80,23
70,seq33,r_84_108_167,seq32,r_84_108_167,0.65,2,169,167,23
58,seq138,r_91_54_35,seq33,r_91_54_35,1.0,-4,31,35,23
46,r_113_30_95,r_65_112_55,r_57_88_58,r_113_30_95,0.8,-1,94,95,23
44,r_133_71_197,r_119_43_162,r_70_38_12,r_133_71_197,0.59,-168,29,197,23
17,r_84_108_167,seq33,r_57_88_58,r_84_108_167,0.6,2,169,167,23
2,r_19_74_29,r_118_102_80,seq58,r_19_74_29,0.69,51,80,29,23
10,r_82_24_50,seq148,seq122,r_82_24_50,0.99,1,51,50,23
53,seq132,r_10_59_186,r_73_137_53,r_73_137_53,1.0,1,54,53,23
7,r_15_67_146,r_113_30_95,r_65_112_55,r_65_112_55,1.0,58,113,55,23
23,r_25_3_165,seq148,r_31_66_65,r_31_66_65,1.0,100,165,65,23
79,seq58,seq14,r_49_139_138,r_49_139_138,0.69,0,138,138,23
7,r_15_67_146,r_65_112_55,seq146,r_15_67_146,0.65,-3,143,146,23
35,r_49_139_138,r_13_130_194,seq58,r_49_139_138,0.69,3,141,138,23
37,r_118_102_80,r_19_74_29,seq128,r_118_102_80,0.96,0,80,80,23
12,r_23_61_87,seq6,r_77_40_44,r_77_40_44,1.0,50,94,44,23
36,r_128_22_68,seq0,seq132,r_128_22_68,0.55,-4,64,68,24
25,r_52_8_28,r_129_67_127,r_127_83_74,r_52_8_28,1.0,0,28,28,24
8,r_21_80_106,seq48,r_78_118_90,r_21_80_106,0.95,0,106,106,24
14,r_75_130_95,r_68_97_33,r_89_110_189,r_75_130_95,1.0,2,97,95,24
43,r_100_144_115,r_51_92_145,r_61_65_34,r_100_144_115,0.79,0,115,115,24
54,seq132,r_113_14_107,seq64,r_113_14_107,1.0,-4,103,107,24
37,r_55_42_152,seq53,r_46_119_108,r_46_119_108,0.55,44,152,108,24
19,r_45_20_159,r_138_93_63,r_127_83_74,r_45_20_159,0.97,0,159,159,24
16,r_129_67_127,r_52_8_28,r_66_149_131,r_52_8_28,0.7,-3,25,28,24
29,r_12_30_179,r_50_24_35,r_66_149_131,r_12_30_179,0.77,0,179,179,24
21,r_88_103_126,seq39,seq91,r_88_103_126,1.0,0,126,126,24
39,r_32_25_151,r_12_30_179,r_63_125_118,r_32_25_151,0.94,3,154,151,24
25,r_52_8_28,r_127_83_74,seq1,r_127_83_74,1.0,0,74,74,24
46,r_108_73_161,seq102,seq132,r_108_73_161,0.83,0,161,161,24
42,r_63_125_118,seq43,seq94,r_63_125_118,1.0,1,119,118,24
49,r_27_136_56,seq94,seq146,r_27_136_56,1.0,0,56,56,24
45,r_18_74_86,r_133_109_191,seq44,r_18_74_86,1.0,0,86,86,24
30,r_116_28_47,r_45_20_159,seq134,r_116_28_47,0.59,-3,44,47,24
19,r_45_20_159,r_127_83_74,r_138_93_63,r_45_20_159,1.0,-95,64,159,24
11,r_89_110_189,r_75_130_95,r_5_85_7,r_5_85_7,1.0,182,189,7,24
5,r_68_97_33,r_35_120_122,r_60_57_160,r_68_97_33,1.0,0,33,33,24
26,r_138_93_63,seq146,r_45_20_159,r_138_93_63,1.0,1,64,63,24
0,r_113_14_107,seq132,r_142_137_49,r_113_14_107,1.0,1,108,107,24
73,seq49,r_35_120_122,r_50_24_35,r_50_24_35,1.0,-1,34,35,24
11,r_89_110_189,seq98,r_75_130_95,r_75_130_95,1.0,2,97,95,24
20,r_15_106_169,r_12_30_179,r_148_107_84,r_148_107_84,1.0,4,88,84,24
13,r_51_92_145,seq132,seq41,r_51_92_145,0.98,2,147,145,24
48,r_78_118_90,r_104_4_105,seq105,r_104_4_105,1.0,-8,97,105,24
5,r_68_97_33,r_60_57_160,r_135_95_4,r_60_57_160,1.0,1,161,160,24
16,r_129_67_127,r_66_149_131,r_36_131_50,r_36_131_50,0.77,2,52,50,24
6,r_111_117_13,r_46_119_108,seq147,r_111_117_13,1.0,0,13,13,24
41,r_60_57_160,r_38_47_184,r_68_97_33,r_68_97_33,1.0,19,52,33,24
1,r_142_137_49,r_17_76_182,seq0,r_142_137_49,1.0,0,49,49,24
41,r_60_57_160,r_68_97_33,r_61_65_34,r_60_57_160,0.73,1,161,160,24
47,r_90_145_163,seq19,r_66_149_131,r_90_145_163,0.57,0,163,163,24
40,r_7_6_96,r_113_14_107,r_52_8_28,r_7_6_96,1.0,0,96,96,24
18,r_104_4_105,seq11,seq96,r_104_4_105,1.0,0,105,105,24
29,r_12_30_179,r_32_25_151,r_50_24_35,r_50_24_35,1.0,119,154,35,24
24,r_36_131_50,r_129_67_127,r_46_119_108,r_36_131_50,0.58,58,108,50,24
66,seq37,seq123,r_50_24_35,r_50_24_35,1.0,22,57,35,24
35,r_148_107_84,r_15_106_169,r_50_24_35,r_15_106_169,0.69,9,178,169,24
33,r_29_62_109,r_90_145_163,r_138_93_63,r_29_62_109,0.62,0,109,109,24
14,r_75_130_95,r_89_110_189,r_18_74_86,r_18_74_86,1.0,103,189,86,24
94,seq147,r_104_4_105,r_111_117_13,r_111_117_13,0.81,0,13,13,24
61,seq19,r_90_145_163,r_61_65_34,r_61_65_34,1.0,129,163,34,24
32,r_38_47_184,seq70,r_72_33_175,r_72_33_175,0.51,9,184,175,24
12,r_127_83_74,r_52_8_28,seq96,r_127_83_74,1.0,0,74,74,24
24,r_36_131_50,r_75_130_95,r_129_67_127,r_36_131_50,1.0,1,51,50,24
34,r_101_79_155,r_114_16_144,seq39,r_114_16_144,0.88,-27,117,144,24
14,r_75_130_95,r_36_131_50,r_68_97_33,r_75_130_95,0.95,-44,51,95,24
26,r_138_93_63,r_45_20_159,r_29_62_109,r_138_93_63,0.98,96,159,63,24
16,r_129_67_127,r_36_131_50,r_10_69_190,r_129_67_127,1.0,0,127,127,24
22,r_59_112_116,seq64,r_61_65_34,r_59_112_116,0.99,0,116,116,24
51,seq1,r_45_20_159,r_52_8_28,r_52_8_28,0.69,16,44,28,24
34,r_101_79_155,seq39,r_135_95_4,r_101_79_155,0.99,1,156,155,24
4,r_61_65_34,seq123,seq19,r_61_65_34,1.0,1,35,34,24
44,r_114_16_144,r_101_79_155,r_61_65_34,r_101_79_155,0.67,-11,144,155,24
27,r_77_115_39,seq2,seq0,r_77_115_39,1.0,2,41,39,24
62,seq23,r_35_120_122,r_50_24_35,r_50_24_35,1.0,-1,34,35,24
55,seq134,r_35_120_122,r_116_28_47,r_116_28_47,0.91,2,49,47,24
35,r_148_107_84,seq143,r_15_106_169,r_148_107_84,1.0,0,84,84,24
12,r_127_83_74,r_45_20_159,r_52_8_28,r_52_8_28,1.0,10,38,28,24
44,r_97_44_171,r_83_142_93,r_91_120_128,r_97_44_171,0.87,-2,169,171,25
36,r_91_120_128,r_39_121_164,seq77,r_91_120_128,0.82,0,128,128,25
36,r_91_120_128,seq77,r_97_44_171,r_91_120_128,0.83,46,174,128,25
92,seq110,r_134_84_90,r_29_10_61,r_134_84_90,0.95,1,91,90,25
14,r_79_140_120,seq23,r_13_128_97,r_79_140_120,0.87,1,121,120,25
8,r_64_81_183,seq132,r_83_142_93,r_83_142_93,1.0,91,184,93,25
43,r_27_138_92,seq15,seq41,r_27_138_92,0.98,1,93,92,25
37,r_107_38_107,seq111,r_39_121_164,r_107_38_107,0.97,1,108,107,25
71,seq52,seq9,r_82_100_109,r_82_100_109,0.59,7,116,109,25
24,r_147_56_16,r_134_84_90,r_4_75_139,r_147_56_16,0.95,0,16,16,25
16,r_29_10_61,seq63,r_134_84_90,r_29_10_61,0.72,2,63,61,25
21,r_46_37_104,seq67,r_55_21_28,r_55_21_28,0.53,67,95,28,25
39,r_4_75_139,seq94,seq42,r_4_75_139,0.9,2,141,139,25
1,r_83_142_93,r_97_44_171,r_130_148_89,r_97_44_171,0.9,1,172,171,25
1,r_83_142_93,seq30,r_97_44_171,r_83_142_93,0.98,0,93,93,25
37,r_107_38_107,r_39_121_164,r_116_125_116,r_39_121_164,1.0,0,164,164,25
5,r_31_137_178,seq42,r_70_122_163,r_31_137_178,0.56,0,178,178,25
46,r_73_7_121,seq109,seq95,r_73_7_121,0.99,0,121,121,25
35,r_55_21_28,r_127_20_117,r_8_60_134,r_55_21_28,0.99,-1,27,28,25
7,r_134_84_90,seq94,r_147_56_16,r_134_84_90,0.38,64,154,90,25
31,r_71_135_170,r_8_60_134,r_55_21_28,r_55_21_28,1.0,1,29,28,25
69,seq41,seq52,r_27_138_92,r_27_138_92,0.87,1,93,92,25
83,seq90,seq65,r_83_142_93,r_83_142_93,0.9,85,178,93,25
45,r_1_11_150,seq26,r_62_78_66,r_62_78_66,0.79,88,154,66,25
24,r_147_56_16,r_4_75_139,r_134_84_90,r_134_84_90,0.94,38,128,90,25
19,r_39_121_164,r_91_120_128,r_107_38_107,r_39_121_164,0.89,-36,128,164,25
12,r_133_88_58,r_129_139_24,seq42,r_133_88_58,1.0,0,58,58,25
41,r_58_146_153,seq65,r_127_20_117,r_127_20_117,0.97,45,162,117,25
89,seq104,r_130_148_89,r_62_78_66,r_62_78_66,0.68,1,67,66,25
3,r_82_100_109,r_70_122_163,seq52,r_70_122_163,0.68,-54,109,163,25
10,r_144_123_144,seq86,seq109,r_144_123_144,0.95,10,154,144,25
38,r_129_139_24,r_133_88_58,seq77,r_133_88_58,0.99,0,58,58,25
12,r_133_88_58,seq16,r_129_139_24,r_129_139_24,0.99,0,24,24,25
11,r_32_47_152,r_51_22_191,r_147_56_16,r_51_22_191,0.45,-37,154,191,25
13,r_8_60_134,r_71_135_170,r_113_102_154,r_8_60_134,0.89,20,154,134,25
15,r_118_33_86,r_27_138_92,seq111,r_118_33_86,0.72,0,86,86,25
48,r_48_74_129,seq12,r_61_57_49,r_48_74_129,0.75,3,132,129,25
6,r_51_22_191,r_32_47_152,r_58_146_153,r_51_22_191,0.77,-38,153,191,25
19,r_39_121_164,r_107_38_107,seq132,r_39_121_164,1.0,0,164,164,25
2,r_136_93_76,r_31_137_178,r_133_88_58,r_31_137_178,0.89,-35,143,178,25
70,seq42,r_31_137_178,r_133_88_58,r_133_88_58,1.0,1,59,58,25
27,r_6_143_21,r_29_10_61,r_105_149_9,r_6_143_21,0.96,0,21,21,25
16,r_29_10_61,r_134_84_90,r_101_2_80,r_134_84_90,0.63,0,90,90,25
20,r_43_50_13,r_144_123_144,r_108_92_15,r_108_92_15,0.96,0,15,15,25
2,r_136_93_76,r_115_98_193,r_31_137_178,r_136_93_76,1.0,1,77,76,25
25,r_127_20_117,r_55_21_28,r_147_56_16,r_55_21_28,0.95,-3,25,28,25
40,r_28_76_67,seq0,seq12,r_28_76_67,0.88,5,72,67,25
74,seq63,r_29_10_61,seq72,r_29_10_61,0.87,3,64,61,25
18,r_62_78_66,seq19,seq104,r_62_78_66,1.0,1,67,66,25
34,r_131_87_111,r_6_143_21,seq15,r_131_87_111,1.0,1,112,111,25
35,r_55_21_28,r_8_60_134,r_46_37_104,r_55_21_28,0.69,106,134,28,25
33,r_116_125_116,r_71_135_170,r_107_38_107,r_116_125_116,0.74,0,116,116,25
32,r_113_102_154,seq95,seq67,r_113_102_154,0.79,0,154,154,25
38,r_129_139_24,r_46_37_104,r_133_88_58,r_129_139_24,0.85,-1,23,24,25
17,r_24_68_167,seq35,r_28_76_67,r_24_68_167,0.59,0,167,167,25
25,r_127_20_117,r_147_56_16,r_51_22_191,r_127_20_117,0.97,-8,109,117,25
42,r_141_59_40,seq35,seq104,r_141_59_40,1.0,-1,39,40,25
47,r_61_57_49,seq52,seq30,r_61_57_49,1.0,0,49,49,25
31,r_71_135_170,r_55_21_28,r_45_18_2,r_45_18_2,0.51,168,170,2,25
34,r_131_87_111,r_79_140_120,r_6_143_21,r_6_143_21,1.0,0,21,21,25
28,r_130_148_89,r_49_89_177,r_83_142_93,r_83_142_93,0.62,0,93,93,25
91,seq109,r_70_122_163,r_144_123_144,r_70_122_163,0.61,-3,160,163,25
0,r_105_149_9,r_79_140_120,r_6_143_21,r_6_143_21,0.53,10,31,21,25
7,r_134_84_90,seq99,seq94,r_134_84_90,1.0,0,90,90,25
44,r_97_44_171,seq111,r_83_142_93,r_83_142_93,1.0,6,99,93,25
23,r_101_2_80,r_73_7_121,r_29_10_61,r_101_2_80,1.0,0,80,80,25
83,seq90,r_73_7_121,seq65,r_73_7_121,0.57,-68,53,121,25
29,r_108_92_15,r_31_137_178,r_43_50_13,r_108_92_15,0.99,0,15,15,25
30,r_49_95_159,r_45_130_148,r_8_11_119,r_8_11_119,0.82,18,137,119,26
36,r_59_115_174,r_8_11_119,seq19,r_8_11_119,1.0,0,119,119,26
0,r_33_76_55,r_90_100_92,seq43,r_33_76_55,1.0,0,55,55,26
8,r_66_147_86,seq101,r_138_84_3,r_66_147_86,1.0,2,88,86,26
83,seq77,r_107_51_66,seq71,r_107_51_66,1.0,0,66,66,26
16,r_3_92_117,seq117,r_81_109_15,r_3_92_117,0.86,0,117,117,26
1,r_21_136_106,r_6_20_123,seq94,r_21_136_106,0.64,6,112,106,26
24,r_90_100_92,r_33_76_55,r_96_112_12,r_96_112_12,0.69,-1,11,12,26
7,r_16_89_143,r_139_40_44,r_74_14_79,r_16_89_143,0.99,0,143,143,26
14,r_122_69_45,seq110,seq65,r_122_69_45,1.0,1,46,45,26
45,r_74_14_79,seq71,r_60_126_172,r_74_14_79,1.0,0,79,79,26
30,r_49_95_159,r_8_11_119,r_133_37_94,r_49_95_159,1.0,2,161,159,26
24,r_90_100_92,r_96_112_12,r_105_137_6,r_90_100_92,1.0,0,92,92,26
19,r_133_37_94,seq63,r_85_111_10,r_133_37_94,0.95,0,94,94,26
46,r_4_70_14,r_86_142_190,seq61,r_4_70_14,0.73,0,14,14,26
95,seq117,r_3_92_117,seq0,r_3_92_117,0.98,0,117,117,26
31,r_149_62_26,r_16_89_143,seq38,r_149_62_26,1.0,0,26,26,26
41,r_24_48_138,seq94,seq0,r_24_48_138,0.96,0,138,138,26
3,r_56_87_156,seq61,r_96_112_12,r_56_87_156,0.63,0,156,156,26
11,r_140_83_34,r_127_114_144,seq82,r_140_83_34,1.0,0,34,34,26
10,r_138_84_3,r_120_123_155,r_66_147_86,r_66_147_86,0.94,70,156,86,26
26,r_57_104_157,seq131,seq12,r_57_104_157,0.87,1,158,157,26
5,r_139_40_44,r_85_111_10,r_16_89_143,r_139_40_44,0.87,-2,42,44,26
7,r_16_89_143,seq63,r_139_40_44,r_139_40_44,1.0,13,57,44,26
72,seq50,r_81_109_15,seq47,r_81_109_15,0.66,-4,11,15,26
20,r_8_11_119,r_59_115_174,seq64,r_8_11_119,0.99,0,119,119,26
5,r_139_40_44,seq34,r_85_111_10,r_85_111_10,0.88,4,14,10,26
15,r_45_130_148,r_49_95_159,r_66_147_86,r_45_130_148,0.79,0,148,148,26
48,r_1_99_69,seq94,r_107_51_66,r_107_51_66,1.0,10,76,66,26
12,r_54_44_128,r_122_69_45,seq10,r_54_44_128,1.0,1,129,128,26
5,r_139_40_44,r_16_89_143,seq35,r_16_89_143,1.0,0,143,143,26
6,r_143_32_162,r_25_36_178,r_133_37_94,r_133_37_94,0.91,68,162,94,26
29,r_113_141_13,r_56_87_156,r_25_36_178,r_113_141_13,1.0,1,14,13,26
21,r_29_80_7,r_6_20_123,r_1_99_69,r_1_99_69,1.0,27,96,69,26
21,r_29_80_7,r_1_99_69,r_135_103_136,r_135_103_136,1.0,12,148,136,26
4,r_7_27_32,r_90_100_92,seq9,r_7_27_32,1.0,0,32,32,26
27,r_124_75_72,r_91_134_152,r_2_26_80,r_91_134_152,0.68,-52,100,152,26
18,r_6_20_123,r_107_51_66,seq13,r_6_20_123,0.83,10,133,123,26
87,seq94,r_24_48_138,r_6_20_123,r_24_48_138,0.93,0,138,138,26
12,r_54_44_128,r_33_76_55,r_122_69_45,r_54_44_128,1.0,-80,48,128,26
22,r_144_132_42,r_73_79_110,seq19,r_144_132_42,0.96,1,43,42,26
2,r_60_126_172,seq46,r_6_20_123,r_6_20_123,0.42,49,172,123,26
47,r_135_103_136,r_53_98_198,r_29_80_7,r_135_103_136,0.99,0,136,136,26
25,r_85_111_10,r_139_40_44,r_149_62_26,r_139_40_44,0.56,2,46,44,26
18,r_6_20_123,r_21_136_106,r_107_51_66,r_107_51_66,1.0,40,106,66,26
34,r_96_112_12,r_90_100_92,r_15_41_75,r_96_112_12,1.0,80,92,12,26
33,r_81_109_15,seq50,seq110,r_81_109_15,0.98,0,15,15,26
42,r_105_137_6,r_86_142_190,r_29_80_7,r_86_142_190,0.42,0,190,190,26
32,r_73_79_110,seq65,seq106,r_73_79_110,0.7,2,112,110,26
38,r_120_123_155,r_138_84_3,r_53_98_198,r_120_123_155,0.72,1,156,155,26
25,r_85_111_10,r_138_84_3,r_139_40_44,r_85_111_10,0.65,1,11,10,26
39,r_93_72_50,r_96_112_12,r_15_41_75,r_15_41_75,0.98,32,107,75,26
34,r_96_112_12,r_66_147_86,r_90_100_92,r_96_112_12,0.82,-1,11,12,26
45,r_74_14_79,r_60_126_172,r_16_89_143,r_16_89_143,0.46,0,143,143,26
85,seq82,seq19,r_140_83_34,r_140_83_34,1.0,5,39,34,26
17,r_107_51_66,seq77,r_1_99_69,r_107_51_66,1.0,3,69,66,26
9,r_2_26_80,r_143_32_162,r_124_75_72,r_143_32_162,0.79,-82,80,162,26
36,r_59_115_174,seq19,seq18,r_59_115_174,0.99,0,174,174,26
28,r_127_114_144,seq67,r_81_109_15,r_127_114_144,0.99,0,144,144,26
49,r_108_23_100,seq30,r_81_109_15,r_108_23_100,1.0,0,100,100,26
44,r_91_134_152,r_124_75_72,seq43,r_91_134_152,0.92,0,152,152,26
23,r_25_36_178,r_143_32_162,r_113_141_13,r_25_36_178,0.84,-16,162,178,26
25,r_85_111_10,r_149_62_26,r_133_37_94,r_133_37_94,0.98,1,95,94,26
35,r_15_41_75,r_45_130_148,r_93_72_50,r_45_130_148,1.0,-72,76,148,26
39,r_93_72_50,r_45_130_148,r_96_112_12,r_93_72_50,0.99,0,50,50,26
36,r_27_102_152,seq57,seq88,r_27_102_152,0.57,2,154,152,27
37,r_65_77_53,seq32,r_70_48_8,r_65_77_53,1.0,2,55,53,27
8,r_126_42_76,seq19,r_2_96_31,r_126_42_76,0.64,0,76,76,27
53,seq8,r_97_131_97,seq147,r_97_131_97,0.53,-13,84,97,27
15,r_2_96_31,r_75_51_91,seq141,r_2_96_31,1.0,3,34,31,27
16,r_71_20_81,r_13_23_188,seq95,r_71_20_81,0.99,0,81,81,27
21,r_103_43_185,r_130_128_121,r_133_125_93,r_103_43_185,1.0,-64,121,185,27
39,r_137_118_118,seq100,r_38_16_9,r_137_118_118,0.96,5,123,118,27
5,r_81_90_142,r_134_56_149,r_133_125_93,r_133_125_93,1.0,52,145,93,27
35,r_15_101_165,r_107_35_59,r_55_47_130,r_107_35_59,0.97,0,59,59,27
45,r_55_47_130,r_15_101_165,seq29,r_55_47_130,0.86,0,130,130,27
24,r_133_125_93,r_103_43_185,r_81_90_142,r_133_125_93,0.44,93,186,93,27
19,r_97_131_97,seq8,r_108_58_20,r_97_131_97,0.92,1,98,97,27
27,r_70_48_8,r_13_23_188,r_65_77_53,r_65_77_53,1.0,42,95,53,27
31,r_5_113_126,seq83,r_38_16_9,r_5_113_126,0.91,-1,125,126,27
41,r_130_128_121,r_103_43_185,seq62,r_130_128_121,0.98,0,121,121,27
3,r_75_51_91,r_0_122_178,r_17_112_69,r_0_122_178,0.45,2,180,178,27
11,r_139_50_34,seq32,seq143,r_139_50_34,1.0,0,34,34,27
10,r_10_49_164,r_114_144_125,r_71_20_81,r_10_49_164,1.0,-50,114,164,27
26,r_89_52_181,seq99,seq147,r_89_52_181,0.32,1,182,181,27
4,r_28_66_14,r_61_106_68,seq11,r_28_66_14,1.0,0,14,14,27
20,r_119_7_65,r_115_105_71,seq80,r_115_105_71,0.69,0,71,71,27
13,r_114_144_125,seq147,seq86,r_114_144_125,0.99,0,125,125,27
44,r_63_92_51,seq143,seq100,r_63_92_51,1.0,0,51,51,27
21,r_103_43_185,r_133_125_93,r_10_49_164,r_103_43_185,0.62,1,186,185,27
10,r_10_49_164,r_71_20_81,seq62,r_10_49_164,0.99,1,165,164,27
35,r_15_101_165,seq62,r_107_35_59,r_15_101_165,0.89,0,165,165,27
0,r_108_58_20,seq57,r_97_131_97,r_97_131_97,0.99,48,145,97,27
6,r_107_35_59,r_15_101_165,seq120,r_107_35_59,0.97,0,59,59,27
48,r_136_21_22,seq143,seq95,r_136_21_22,0.87,0,22,22,27
42,r_148_84_45,seq46,seq39,r_148_84_45,1.0,0,45,45,27
2,r_115_105_71,r_119_7_65,seq99,r_115_105_71,0.92,0,71,71,27
47,r_78_132_104,r_9_6_151,seq83,r_78_132_104,0.96,2,106,104,27
29,r_30_87_86,seq99,r_139_50_34,r_30_87_86,1.0,0,86,86,27
24,r_133_125_93,seq39,r_103_43_185,r_133_125_93,1.0,1,94,93,27
66,seq32,r_139_50_34,seq62,r_139_50_34,0.99,0,34,34,27
25,r_9_6_151,seq86,r_107_35_59,r_9_6_151,0.56,0,151,151,27
33,r_127_111_55,r_74_73_137,r_70_48_8,r_74_73_137,0.77,-63,74,137,27
65,seq29,seq143,r_61_106_68,r_61_106_68,1.0,51,119,68,27
59,seq143,r_63_92_51,r_139_50_34,r_63_92_51,0.66,0,51,51,27
61,seq19,r_126_42_76,seq67,r_126_42_76,1.0,0,76,76,27
57,seq141,r_61_106_68,r_2_96_31,r_2_96_31,0.99,0,31,31,27
34,r_74_73_137,seq12,r_109_98_131,r_74_73_137,0.82,0,137,137,27
35,r_15_101_165,r_55_47_130,seq62,r_55_47_130,0.99,-24,106,130,27
22,r_61_106_68,seq138,seq29,r_61_106_68,0.97,2,70,68,27
28,r_4_72_159,r_142_53_64,r_97_131_97,r_4_72_159,0.68,0,159,159,27
56,seq12,seq18,r_137_118_118,r_137_118_118,0.99,4,122,118,27
23,r_37_76_182,r_124_44_26,r_63_92_51,r_63_92_51,1.0,63,114,51,27
23,r_37_76_182,r_63_92_51,seq143,r_37_76_182,0.85,0,182,182,27
30,r_132_117_164,seq10,seq48,r_132_117_164,0.82,0,164,164,28
51,seq129,seq44,r_146_123_50,r_146_123_50,1.0,16,66,50,28
12,r_127_30_57,seq118,seq71,r_127_30_57,1.0,0,57,57,28
36,r_69_103_86,r_87_122_87,seq52,r_69_103_86,1.0,0,86,86,28
14,r_3_18_98,seq85,r_92_133_169,r_3_18_98,0.96,4,102,98,28
8,r_9_8_84,r_73_89_174,seq118,r_9_8_84,1.0,0,84,84,28
43,r_16_140_144,seq51,r_22_148_107,r_16_140_144,0.94,0,144,144,28
37,r_138_58_178,seq106,r_132_117_164,r_132_117_164,0.63,15,179,164,28
16,r_7_47_177,r_40_144_133,r_33_6_94,r_33_6_94,1.0,83,177,94,28
21,r_35_75_148,seq112,seq78,r_35_75_148,0.84,0,148,148,28
39,r_40_144_133,r_7_47_177,r_134_102_142,r_134_102_142,0.72,35,177,142,28
97,seq121,r_134_102_142,r_15_111_55,r_15_111_55,0.88,88,143,55,28
5,r_26_139_112,seq48,seq63,r_26_139_112,0.99,0,112,112,28
46,r_147_143_70,seq71,seq76,r_147_143_70,1.0,0,70,70,28
42,r_15_111_55,seq128,seq124,r_15_111_55,1.0,0,55,55,28
63,seq42,r_94_107_191,r_31_79_13,r_31_79_13,0.98,2,15,13,28
7,r_136_25_20,r_5_119_99,r_29_64_71,r_29_64_71,1.0,30,101,71,28
69,seq51,r_16_140_144,r_74_116_78,r_74_116_78,0.65,66,144,78,28
45,r_120_141_79,seq20,r_15_111_55,r_120_141_79,1.0,0,79,79,28
33,r_5_119_99,r_120_141_79,r_136_25_20,r_5_119_99,0.88,-57,42,99,28
40,r_19_80_51,seq44,seq145,r_19_80_51,1.0,0,51,51,28
65,seq44,r_19_80_51,seq129,r_19_80_51,1.0,0,51,51,28
33,r_5_119_99,r_136_25_20,seq137,r_5_119_99,0.77,2,101,99,28
76,seq63,seq118,r_26_139_112,r_26_139_112,1.0,-1,111,112,28
96,seq118,r_127_30_57,seq63,r_127_30_57,0.99,-1,56,57,28
62,seq39,r_29_64_71,seq53,r_29_64_71,1.0,-21,50,71,28
26,r_21_41_77,r_92_133_169,seq145,r_21_41_77,1.0,1,78,77,28
14,r_3_18_98,r_92_133_169,seq51,r_92_133_169,1.0,0,169,169,28
4,r_135_126_95,r_32_54_175,r_115_1_154,r_135_126_95,0.92,0,95,95,28
11,r_33_6_94,seq28,r_87_122_87,r_33_6_94,0.99,0,94,94,28
20,r_27_70_121,seq66,seq2,r_27_70_121,1.0,0,121,121,28
98,seq124,r_134_102_142,r_15_111_55,r_15_111_55,0.91,20,75,55,28
47,r_94_107_191,seq42,r_65_110_19,r_65_110_19,0.69,1,20,19,28
17,r_92_133_169,r_3_18_98,r_22_148_107,r_92_133_169,0.99,0,169,169,28
15,r_86_99_72,r_73_89_174,r_29_64_71,r_86_99_72,1.0,0,72,72,28
48,r_22_148_107,r_87_122_87,seq43,r_22_148_107,1.0,1,108,107,28
4,r_135_126_95,r_115_1_154,r_62_14_184,r_135_126_95,1.0,64,159,95,28
85,seq93,r_38_4_176,r_69_103_86,r_69_103_86,0.98,90,176,86,28
27,r_134_102_142,seq121,r_40_144_133,r_134_102_142,0.89,2,144,142,28
7,r_136_25_20,r_24_84_125,r_5_119_99,r_136_25_20,1.0,-1,19,20,28
2,r_29_64_71,seq39,seq56,r_29_64_71,0.99,1,72,71,28
18,r_130_95_102,r_115_1_154,seq100,r_130_95_102,1.0,1,103,102,28
25,r_105_61_91,seq10,seq118,r_105_61_91,1.0,0,91,91,28
38,r_87_122_87,r_22_148_107,r_33_6_94,r_87_122_87,1.0,7,94,87,28
61,seq36,r_94_107_191,r_31_79_13,r_31_79_13,0.52,40,53,13,28
89,seq145,seq124,r_19_80_51,r_19_80_51,1.0,2,53,51,28
17,r_92_133_169,r_21_41_77,r_74_116_78,r_92_133_169,0.86,-91,78,169,28
9,r_34_83_60,seq10,seq20,r_34_83_60,0.92,5,65,60,28
22,r_115_1_154,r_135_126_95,seq17,r_115_1_154,1.0,3,157,154,28
3,r_142_81_44,seq71,seq121,r_142_81_44,0.78,2,46,44,28
1,r_31_79_13,r_69_103_86,seq42,r_31_79_13,0.91,2,15,13,28
10,r_146_123_50,seq118,seq129,r_146_123_50,1.0,0,50,50,28
22,r_115_1_154,r_130_95_102,r_135_126_95,r_115_1_154,0.93,-54,100,154,28
17,r_92_133_169,r_74_116_78,r_3_18_98,r_3_18_98,1.0,4,102,98,28
28,r_37_96_141,seq100,r_136_25_20,r_37_96_141,0.93,1,142,141,28
91,seq106,r_138_58_178,r_92_133_169,r_92_133_169,0.72,10,179,169,28
13,r_77_68_47,seq28,seq17,r_77_68_47,1.0,0,47,47,28
49,r_11_12_129,r_37_96_141,seq66,r_11_12_129,0.98,2,131,129,28
44,r_50_72_146,r_142_81_44,r_9_8_84,r_142_81_44,0.85,109,153,44,28
23,r_32_54_175,seq106,r_146_123_50,r_146_123_50,0.6,125,175,50,28
96,seq118,seq63,r_105_61_91,r_105_61_91,1.0,3,94,91,28
30,r_59_147_112,r_128_83_169,seq5,r_59_147_112,0.91,-8,104,112,29
19,r_40_26_43,r_119_148_178,r_21_120_40,r_40_26_43,1.0,0,43,43,29
36,r_48_31_168,seq77,seq66,r_48_31_168,0.39,0,168,168,29
14,r_100_76_150,seq60,r_106_17_102,r_100_76_150,0.49,1,151,150,29
43,r_64_84_148,seq25,r_89_112_109,r_64_84_148,0.67,2,150,148,29
95,seq103,seq28,r_87_46_35,r_87_46_35,0.99,0,35,35,29
83,seq75,r_34_122_84,seq95,r_34_122_84,0.68,29,113,84,29
37,r_117_101_92,r_52_105_65,seq66,r_52_105_65,0.63,0,65,65,29
21,r_131_102_120,r_42_16_123,r_85_71_134,r_42_16_123,0.76,-3,120,123,29
39,r_7_80_151,seq109,seq20,r_7_80_151,0.51,0,151,151,29
25,r_32_138_143,r_107_1_14,r_6_0_105,r_32_138_143,0.99,0,143,143,29
5,r_29_135_164,r_127_47_157,r_40_26_43,r_40_26_43,0.94,122,165,43,29
46,r_85_71_134,r_79_111_129,r_131_102_120,r_79_111_129,0.75,-6,123,129,29
42,r_127_47_157,r_29_135_164,r_128_83_169,r_127_47_157,0.51,13,170,157,29
2,r_107_1_14,seq37,r_32_138_143,r_107_1_14,0.84,4,18,14,29
8,r_50_123_18,seq60,seq98,r_50_123_18,0.97,0,18,18,29
0,r_87_46_35,r_43_110_132,seq103,r_87_46_35,0.99,0,35,35,29
31,r_90_116_82,r_117_101_92,r_87_46_35,r_90_116_82,0.84,1,83,82,29
41,r_106_17_102,r_131_102_120,seq37,r_106_17_102,0.66,4,106,102,29
3,r_53_124_121,seq30,r_94_4_66,r_94_4_66,0.99,55,121,66,29
46,r_85_71_134,r_131_102_120,r_107_1_14,r_85_71_134,0.87,0,134,134,29
26,r_52_105_65,r_117_101_92,seq55,r_52_105_65,0.9,0,65,65,29
4,r_12_126_147,seq49,seq27,r_12_126_147,0.6,1,148,147,29
11,r_43_110_132,r_53_124_121,seq45,r_43_110_132,0.95,0,132,132,29
20,r_92_136_119,seq23,r_107_1_14,r_92_136_119,0.93,0,119,119,29
13,r_79_111_129,r_63_129_199,r_59_147_112,r_79_111_129,0.51,0,129,129,29
1,r_104_88_54,r_59_147_112,seq23,r_104_88_54,0.88,0,54,54,29
6,r_34_122_84,seq75,seq49,r_34_122_84,0.59,1,85,84,29
78,seq65,r_79_111_129,seq41,r_79_111_129,0.51,-93,36,129,29
38,r_115_142_26,r_79_111_129,seq2,r_115_142_26,0.94,2,28,26,29
85,seq77,r_48_31_168,seq60,r_48_31_168,0.64,-6,162,168,29
2,r_107_1_14,r_32_138_143,r_92_136_119,r_107_1_14,0.65,129,143,14,29
27,r_56_99_172,seq5,r_29_135_164,r_56_99_172,0.45,0,172,172,29
18,r_134_108_94,r_32_138_143,seq9,r_134_108_94,0.97,3,97,94,29
29,r_114_62_173,seq27,seq139,r_114_62_173,0.5,0,173,173,29
40,r_21_120_40,r_133_145_163,seq118,r_21_120_40,1.0,0,40,40,29
25,r_32_138_143,r_134_108_94,r_107_1_14,r_134_108_94,0.52,3,97,94,29
33,r_69_74_74,seq2,r_87_46_35,r_69_74_74,1.0,0,74,74,29
48,r_144_38_37,r_106_17_102,r_6_0_105,r_144_38_37,0.66,69,106,37,29
47,r_61_132_183,r_29_135_164,seq41,r_29_135_164,0.59,19,183,164,29
50,seq2,r_69_74_74,r_10_8_9,r_69_74_74,0.82,-2,72,74,29
58,seq18,r_130_93_188,r_39_35_95,r_39_35_95,1.0,6,101,95,29
70,seq41,r_42_16_123,r_68_19_122,r_42_16_123,0.58,0,123,123,29
32,r_94_4_66,seq55,seq15,r_94_4_66,0.91,1,67,66,29
34,r_119_148_178,r_141_36_192,r_53_124_121,r_141_36_192,0.43,-13,179,192,29
17,r_68_19_122,r_56_99_172,seq24,r_68_19_122,0.77,1,123,122,29
9,r_128_83_169,r_59_147_112,r_40_26_43,r_128_83_169,0.46,-57,112,169,29
21,r_131_102_120,r_85_71_134,r_117_101_92,r_131_102_120,0.6,14,134,120,29
22,r_54_51_34,r_6_0_105,seq20,r_6_0_105,1.0,1,106,105,29
28,r_39_35_95,seq15,seq45,r_39_35_95,1.0,0,95,95,29
49,r_130_93_188,r_96_11_194,r_48_31_168,r_96_11_194,0.3,-6,188,194,29
7,r_6_0_105,r_54_51_34,r_144_38_37,r_6_0_105,0.98,1,106,105,29
44,r_42_16_123,r_131_102_120,seq49,r_42_16_123,0.97,0,123,123,29
47,r_61_132_183,r_53_124_121,r_29_135_164,r_29_135_164,0.55,-121,43,164,29
12,r_89_112_109,r_59_147_112,seq30,r_59_147_112,0.94,-3,109,112,29
9,r_128_83_169,r_40_26_43,r_127_47_157,r_128_83_169,0.95,1,170,169,29
36,r_130_99_146,r_42_85_197,seq78,r_130_99_146,0.61,1,147,146,30
14,r_29_71_86,seq93,seq45,r_29_71_86,0.98,0,86,86,30
53,seq6,r_110_47_182,r_111_120_69,r_111_120_69,1.0,114,183,69,30
43,r_95_63_71,seq136,seq4,r_95_63_71,0.96,-3,68,71,30
8,r_61_132_137,r_145_27_75,r_138_15_23,r_61_132_137,0.82,-106,31,137,30
54,seq7,r_19_44_187,r_115_108_176,r_115_108_176,0.92,14,190,176,30
37,r_31_148_160,seq4,seq93,r_31_148_160,0.87,0,160,160,30
16,r_9_23_186,seq26,r_110_47_182,r_110_47_182,0.68,6,188,182,30
21,r_52_30_106,seq8,seq141,r_52_30_106,0.99,1,107,106,30
27,r_143_69_24,r_139_66_152,seq141,r_143_69_24,0.97,-1,23,24,30
80,seq80,r_49_1_107,r_145_27_75,r_145_27_75,0.53,1,76,75,30
69,seq45,r_115_108_176,r_29_71_86,r_29_71_86,1.0,77,163,86,30
45,r_56_22_175,r_115_108_176,r_25_36_164,r_115_108_176,0.6,1,177,176,30
19,r_116_96_117,seq26,seq94,r_116_96_117,0.99,0,117,117,30
13,r_113_127_180,r_61_132_137,r_79_144_21,r_79_144_21,0.9,0,21,21,30
20,r_79_144_21,seq93,r_113_127_180,r_79_144_21,1.0,0,21,21,30
31,r_73_70_64,r_35_2_72,seq135,r_73_70_64,1.0,-1,63,64,30
41,r_145_27_75,r_61_132_137,seq80,r_145_27_75,1.0,0,75,75,30
89,seq101,seq57,r_54_74_68,r_54_74_68,0.62,3,71,68,30
3,r_98_134_108,r_117_33_190,seq57,r_98_134_108,0.93,0,108,108,30
10,r_13_72_97,seq3,r_75_60_59,r_13_72_97,1.0,1,98,97,30
8,r_61_132_137,r_138_15_23,seq32,r_61_132_137,0.89,0,137,137,30
78,seq77,r_51_119_165,seq83,r_51_119_165,0.99,-60,105,165,30
11,r_19_44_187,seq7,r_17_84_17,r_17_84_17,0.76,173,190,17,30
39,r_46_5_14,r_110_47_182,seq62,r_46_5_14,0.96,0,14,14,30
46,r_138_15_23,r_61_132_137,seq147,r_61_132_137,0.96,0,137,137,30
75,seq62,r_19_44_187,r_46_5_14,r_46_5_14,1.0,5,19,14,30
13,r_113_127_180,r_79_144_21,r_35_2_72,r_113_127_180,0.51,0,180,180,30
87,seq93,seq125,r_31_148_160,r_31_148_160,0.92,3,163,160,30
87,seq93,r_29_71_86,seq125,r_29_71_86,0.89,0,86,86,30
48,r_123_133_34,r_116_96_117,seq45,r_123_133_34,1.0,1,35,34,30
47,r_111_120_69,r_145_27_75,seq6,r_111_120_69,0.92,1,70,69,30
15,r_117_33_190,r_64_140_101,r_58_122_39,r_117_33_190,0.83,-151,39,190,30
40,r_0_142_188,seq136,r_25_36_164,r_25_36_164,0.93,25,189,164,30
18,r_14_107_145,r_19_44_187,r_29_71_86,r_14_107_145,0.7,0,145,145,30
29,r_49_1_107,r_53_118_153,seq104,r_49_1_107,0.6,-1,106,107,30
25,r_24_131_171,seq137,r_117_33_190,r_24_131_171,0.59,0,171,171,30
33,r_50_18_124,seq90,r_116_96_117,r_50_18_124,0.66,0,124,124,30
42,r_87_91_46,seq28,r_75_60_59,r_87_91_46,1.0,1,47,46,30
22,r_53_118_153,r_145_27_75,r_79_144_21,r_53_118_153,0.96,-4,149,153,30
20,r_79_144_21,r_113_127_180,r_67_128_50,r_67_128_50,0.83,130,180,50,30
32,r_106_105_110,r_113_127_180,seq83,r_106_105_110,0.93,1,111,110,30
38,r_42_85_197,r_130_99_146,r_64_140_101,r_42_85_197,0.88,-50,147,197,30
34,r_51_119_165,r_43_100_170,seq28,r_51_119_165,0.62,1,166,165,30
2,r_67_128_50,r_13_72_97,r_79_144_21,r_67_128_50,0.91,-3,47,50,30
35,r_146_82_25,r_19_44_187,seq86,r_146_82_25,0.99,1,26,25,30
17,r_43_100_170,r_51_119_165,r_31_148_160,r_51_119_165,0.69,2,167,165,30
46,r_138_15_23,r_116_96_117,r_61_132_137,r_138_15_23,1.0,0,23,23,30
9,r_103_41_22,seq83,seq109,r_103_41_22,1.0,0,22,22,30
22,r_53_118_153,r_49_1_107,r_145_27_75,r_53_118_153,0.68,-46,107,153,30
49,r_64_140_101,r_117_33_190,r_42_85_197,r_64_140_101,0.98,0,101,101,30
4,r_17_84_17,r_68_97_144,seq90,r_17_84_17,0.95,-1,16,17,30
56,seq137,r_24_131_171,r_11_12_84,r_11_12_84,1.0,0,84,84,30
7,r_54_74_68,r_53_118_153,seq101,r_54_74_68,0.79,-4,64,68,30
44,r_11_12_84,r_113_127_180,seq137,r_11_12_84,1.0,0,84,84,30
23,r_68_97_144,r_130_99_146,seq124,r_130_99_146,0.7,-1,145,146,30
0,r_75_60_59,r_35_2_72,r_87_91_46,r_87_91_46,0.87,11,57,46,30
12,r_139_66_152,seq28,r_54_74_68,r_139_66_152,0.82,0,152,152,30
24,r_58_122_39,r_31_148_160,r_117_33_190,r_58_122_39,1.0,0,39,39,30
18,r_95_146_19,r_28_101_65,r_40_63_149,r_40_63_149,0.74,-129,20,149,31
36,r_34_42_93,seq82,seq52,r_34_42_93,1.0,0,93,93,31
14,r_127_112_179,seq6,seq71,r_127_112_179,0.45,0,179,179,31
43,r_21_46_73,r_51_10_78,r_89_58_11,r_21_46_73,1.0,0,73,73,31
37,r_130_79_116,r_74_45_190,r_89_58_11,r_130_79_116,0.69,1,117,116,31
59,seq144,r_121_24_163,seq33,r_121_24_163,0.99,0,163,163,31
19,r_83_27_29,r_110_4_94,r_9_11_47,r_110_4_94,0.8,1,95,94,31
19,r_83_27_29,seq36,r_110_4_94,r_83_27_29,0.95,-1,28,29,31
16,r_126_142_87,seq32,seq82,r_126_142_87,1.0,0,87,87,31
21,r_96_138_77,r_128_70_199,r_55_54_121,r_55_54_121,1.0,5,126,121,31
5,r_109_26_160,r_128_70_199,r_145_85_95,r_109_26_160,0.86,0,160,160,31
46,r_29_39_181,seq97,r_9_11_47,r_9_11_47,1.0,135,182,47,31
42,r_55_54_121,seq134,r_96_138_77,r_55_54_121,0.94,0,121,121,31
90,seq106,seq104,r_89_58_11,r_89_58_11,0.69,1,12,11,31
30,r_91_30_21,r_17_49_125,seq122,r_91_30_21,0.86,0,21,21,31
48,r_105_38_14,r_17_49_125,seq120,r_105_38_14,1.0,0,14,14,31
66,seq35,r_41_5_168,r_69_148_59,r_69_148_59,1.0,110,169,59,31
41,r_128_70_199,r_96_138_77,seq108,r_128_70_199,0.39,-125,74,199,31
3,r_40_63_149,seq19,r_28_101_65,r_28_101_65,1.0,85,150,65,31
10,r_66_13_171,seq100,r_73_149_18,r_73_149_18,0.92,154,172,18,31
16,r_126_142_87,seq82,r_73_149_18,r_126_142_87,0.59,98,185,87,31
4,r_121_24_163,seq144,seq72,r_121_24_163,0.81,0,163,163,31
0,r_28_101_65,r_121_24_163,r_95_146_19,r_28_101_65,0.7,1,66,65,31
73,seq65,seq76,r_147_43_17,r_147_43_17,0.98,102,119,17,31
11,r_145_85_95,seq87,r_56_111_16,r_145_85_95,0.97,0,95,95,31
13,r_99_20_96,seq133,seq0,r_99_20_96,1.0,0,96,96,31
35,r_56_111_16,r_127_112_179,seq67,r_56_111_16,0.99,0,16,16,31
0,r_28_101_65,seq136,r_95_146_19,r_28_101_65,0.53,55,120,65,31
12,r_147_43_17,r_99_20_96,seq6,r_147_43_17,0.55,1,18,17,31
27,r_8_44_71,r_40_63_149,seq133,r_8_44_71,1.0,1,72,71,31
87,seq97,r_29_39_181,r_69_148_59,r_69_148_59,1.0,123,182,59,31
97,seq120,r_127_112_179,r_105_38_14,r_105_38_14,0.88,2,16,14,31
47,r_41_5_168,seq35,r_84_2_26,r_84_2_26,0.68,143,169,26,31
40,r_51_10_78,r_137_68_191,seq90,r_51_10_78,1.0,0,78,78,31
29,r_86_143_150,seq0,seq32,r_86_143_150,0.86,0,150,150,31
26,r_64_14_40,r_137_68_191,r_147_43_17,r_147_43_17,0.99,11,28,17,31
35,r_56_111_16,seq67,r_145_85_95,r_145_85_95,1.0,12,107,95,31
25,r_17_49_125,seq90,r_84_2_26,r_17_49_125,0.96,0,125,125,31
0,r_28_101_65,r_95_146_19,r_40_63_149,r_28_101_65,0.63,80,145,65,31
32,r_69_148_59,seq1,seq35,r_69_148_59,1.0,1,60,59,31
38,r_53_132_152,r_66_13_171,seq76,r_53_132_152,0.85,0,152,152,31
9,r_60_37_55,r_88_61_193,seq25,r_60_37_55,1.0,-1,54,55,31
34,r_48_119_134,seq72,seq65,r_48_119_134,0.94,0,134,134,31
8,r_84_2_26,seq67,r_16_115_178,r_84_2_26,0.95,0,26,26,31
45,r_110_4_94,r_96_138_77,r_83_27_29,r_83_27_29,0.42,1,30,29,31
75,seq71,r_94_141_194,r_84_2_26,r_84_2_26,0.83,106,132,26,31
15,r_9_11_47,r_107_93_196,r_83_27_29,r_9_11_47,1.0,0,47,47,31
60,seq19,r_40_63_149,r_51_10_78,r_51_10_78,1.0,72,150,78,31
45,r_110_4_94,r_83_27_29,seq0,r_110_4_94,0.99,1,95,94,31
44,r_74_45_190,r_107_93_196,r_15_31_8,r_74_45_190,0.58,-34,156,190,31
31,r_89_58_11,seq106,r_21_46_73,r_21_46_73,1.0,3,76,73,31
17,r_18_47_15,r_145_85_95,seq33,r_18_47_15,0.98,1,16,15,31
31,r_89_58_11,r_125_124_86,seq106,r_125_124_86,0.74,-75,11,86,31
49,r_102_117_182,r_94_141_194,r_51_10_78,r_51_10_78,0.77,104,182,78,31
39,r_16_115_178,seq122,r_84_2_26,r_84_2_26,1.0,0,26,26,31
44,r_74_45_190,r_130_79_116,r_107_93_196,r_130_79_116,0.82,2,118,116,31
1,r_73_149_18,r_121_24_163,seq72,r_73_149_18,0.99,2,20,18,31
14,r_149_63_110,seq34,seq93,r_149_63_110,0.77,2,112,110,32
8,r_66_31_157,r_111_33_108,seq82,r_111_33_108,0.71,4,112,108,32
43,r_126_10_91,seq137,seq37,r_126_10_91,0.95,0,91,91,32
59,seq12,r_40_117_166,r_78_90_125,r_78_90_125,0.65,41,166,125,32
39,r_15_17_181,r_86_133_196,r_89_71_16,r_86_133_196,0.43,-8,188,196,32
1,r_62_39_172,seq12,seq81,r_62_39_172,0.42,1,173,172,32
46,r_79_147_197,r_59_110_148,seq6,r_59_110_148,1.0,1,149,148,32
19,r_148_106_97,r_92_108_122,r_123_130_36,r_148_106_97,0.9,2,99,97,32
38,r_144_60_64,r_18_105_3,r_88_121_38,r_144_60_64,0.41,96,160,64,32
31,r_77_139_105,r_15_17_181,r_74_83_190,r_77_139_105,0.77,4,109,105,32
3,r_74_83_190,r_66_31_157,r_119_61_63,r_74_83_190,0.75,-4,186,190,32
17,r_136_47_46,r_78_90_125,seq50,r_136_47_46,0.9,0,46,46,32
3,r_74_83_190,r_123_130_36,seq95,r_123_130_36,0.64,27,63,36,32
72,seq45,r_21_11_177,r_129_4_119,r_129_4_119,0.95,26,145,119,32
3,r_74_83_190,seq95,r_77_139_105,r_74_83_190,0.75,-81,109,190,32
73,seq46,seq81,r_51_68_67,r_51_68_67,1.0,74,141,67,32
20,r_51_68_67,r_77_139_105,seq46,r_51_68_67,0.99,2,69,67,32
13,r_86_133_196,r_15_17_181,r_59_110_148,r_86_133_196,0.42,-21,175,196,32
15,r_119_61_63,seq27,seq109,r_119_61_63,1.0,1,64,63,32
48,r_21_11_177,seq45,seq2,r_21_11_177,0.44,1,178,177,32
57,seq137,r_126_10_91,r_55_69_95,r_126_10_91,0.99,0,91,91,32
3,r_74_83_190,r_77_139_105,r_66_31_157,r_66_31_157,0.89,3,160,157,32
6,r_55_69_95,r_35_16_174,seq32,r_55_69_95,0.53,1,96,95,32
30,r_143_114_18,r_148_106_97,seq50,r_143_114_18,0.93,-1,17,18,32
99,seq125,r_7_24_75,seq44,r_7_24_75,0.71,36,111,75,32
10,r_89_71_16,seq5,r_113_42_135,r_113_42_135,0.9,0,135,135,32
27,r_92_108_122,r_0_122_13,r_51_68_67,r_92_108_122,0.9,1,123,122,32
12,r_80_103_40,seq46,seq99,r_80_103_40,1.0,1,41,40,32
2,r_129_4_119,seq107,seq45,r_129_4_119,0.96,0,119,119,32
18,r_53_70_70,r_148_106_97,r_80_103_40,r_53_70_70,0.98,0,70,70,32
24,r_35_16_174,r_7_24_75,r_20_96_163,r_7_24_75,0.64,100,175,75,32
25,r_98_38_167,seq2,r_78_90_125,r_78_90_125,0.99,44,169,125,32
33,r_29_54_187,seq91,r_76_116_44,r_76_116_44,0.74,144,188,44,32
47,r_132_140_19,r_89_71_16,seq13,r_132_140_19,0.83,-5,14,19,32
32,r_40_117_166,seq12,seq65,r_40_117_166,0.48,0,166,166,32
38,r_144_60_64,seq45,r_18_105_3,r_144_60_64,1.0,0,64,64,32
93,seq99,seq145,r_80_103_40,r_80_103_40,1.0,14,54,40,32
41,r_88_121_38,r_129_4_119,r_104_124_79,r_129_4_119,0.6,-27,92,119,32
77,seq56,r_113_42_135,r_120_28_5,r_120_28_5,0.56,6,11,5,32
31,r_77_139_105,r_74_83_190,r_66_31_157,r_77_139_105,0.65,81,186,105,32
28,r_7_24_75,r_35_16_174,seq85,r_35_16_174,0.86,1,175,174,32
8,r_66_31_157,r_74_83_190,r_77_139_105,r_74_83_190,0.9,-4,186,190,32
49,r_41_142_77,r_148_106_97,r_80_103_40,r_41_142_77,0.91,0,77,77,32
7,r_59_110_148,r_79_147_197,r_86_133_196,r_79_147_197,0.54,-48,149,197,32
44,r_111_33_108,r_66_31_157,r_51_68_67,r_111_33_108,0.71,4,112,108,32
23,r_78_90_125,seq5,seq109,r_78_90_125,0.89,1,126,125,32
41,r_88_121_38,seq97,r_129_4_119,r_88_121_38,0.94,19,57,38,32
34,r_123_130_36,seq125,seq34,r_123_130_36,1.0,0,36,36,32
10,r_89_71_16,r_59_110_148,seq5,r_89_71_16,0.98,0,16,16,32
35,r_58_1_111,r_149_63_110,seq8,r_149_63_110,0.42,1,111,110,32
45,r_76_116_44,seq50,seq134,r_76_116_44,1.0,0,44,44,32
30,r_115_97_119,seq25,seq37,r_115_97_119,0.83,0,119,119,33
31,r_99_52_30,r_9_13_157,seq119,r_9_13_157,0.87,-118,39,157,33
36,r_78_35_71,r_26_106_132,seq117,r_78_35_71,0.97,1,72,71,33
92,seq108,r_8_63_197,r_55_2_81,r_55_2_81,1.0,23,104,81,33
43,r_62_30_66,r_8_63_197,r_100_109_37,r_62_30_66,1.0,0,66,66,33
18,r_59_142_16,r_29_118_109,seq69,r_29_118_109,0.64,-93,16,109,33
86,seq86,seq138,r_23_71_139,r_23_71_139,0.78,27,166,139,33
16,r_55_2_81,seq148,seq108,r_55_2_81,0.81,-10,71,81,33
39,r_73_58_69,seq74,seq27,r_73_58_69,0.98,1,70,69,33
14,r_113_48_43,r_114_51_121,seq139,r_113_48_43,0.72,1,44,43,33
5,r_101_53_122,seq128,r_36_122_33,r_101_53_122,0.88,0,122,122,33
46,r_23_71_139,r_99_52_30,seq86,r_23_71_139,0.49,5,144,139,33
63,seq148,seq83,r_111_135_12,r_111_135_12,1.0,9,21,12,33
77,seq50,r_100_109_37,r_120_18_123,r_120_18_123,0.62,4,127,123,33
48,r_11_98_24,seq50,r_100_109_37,r_100_109_37,0.87,14,51,37,33
76,seq49,r_82_133_158,r_46_105_113,r_46_105_113,0.78,51,164,113,33
32,r_19_42_54,seq67,r_113_48_43,r_19_42_54,0.68,0,54,54,33
41,r_9_13_157,seq132,seq108,r_9_13_157,0.87,0,157,157,33
38,r_4_136_189,seq108,r_40_104_20,r_4_136_189,0.96,0,189,189,33
3,r_82_133_158,seq49,r_101_53_122,r_101_53_122,0.99,42,164,122,33
10,r_88_127_160,seq83,r_100_109_37,r_88_127_160,0.56,1,161,160,33
47,r_31_81_1,r_68_147_67,r_96_121_49,r_96_121_49,0.94,9,58,49,33
11,r_54_124_97,r_46_105_113,seq39,r_54_124_97,0.74,0,97,97,33
20,r_91_66_141,r_4_136_189,seq49,r_91_66_141,0.78,0,141,141,33
15,r_84_38_144,seq144,seq138,r_84_38_144,0.78,0,144,144,33
0,r_40_104_20,r_36_122_33,seq141,r_40_104_20,0.95,0,20,20,33
6,r_26_106_132,seq69,seq17,r_26_106_132,0.95,3,135,132,33
9,r_149_134_59,seq17,r_4_136_189,r_149_134_59,1.0,0,59,59,33
29,r_96_121_49,r_62_30_66,r_31_81_1,r_31_81_1,0.9,49,50,1,33
13,r_36_122_33,seq89,seq132,r_36_122_33,0.84,0,33,33,33
27,r_120_18_123,seq116,seq50,r_120_18_123,0.89,-1,122,123,33
21,r_85_94_18,r_91_66_141,seq49,r_85_94_18,0.98,0,18,18,33
2,r_46_105_113,r_22_90_176,r_85_94_18,r_46_105_113,0.68,0,113,113,33
40,r_61_5_89,seq77,seq37,r_61_5_89,0.96,0,89,89,33
74,seq45,r_99_52_30,r_22_90_176,r_22_90_176,0.52,2,178,176,33
24,r_20_64_103,seq49,r_36_122_33,r_36_122_33,0.69,108,141,33,33
25,r_80_143_101,r_26_106_132,seq139,r_80_143_101,0.95,1,102,101,33
48,r_11_98_24,r_137_57_21,seq50,r_11_98_24,0.77,-5,19,24,33
38,r_4_136_189,r_91_66_141,seq108,r_91_66_141,1.0,0,141,141,33
9,r_149_134_59,r_4_136_189,r_29_118_109,r_29_118_109,0.96,4,113,109,33
1,r_24_79_38,r_46_105_113,r_87_145_68,r_24_79_38,1.0,0,38,38,33
33,r_111_135_12,r_149_134_59,seq148,r_111_135_12,0.94,0,12,12,33
77,seq50,seq112,r_100_109_37,r_100_109_37,0.92,16,53,37,33
8,r_100_109_37,r_146_72_142,r_11_98_24,r_100_109_37,0.65,3,40,37,33
81,seq69,r_26_106_132,r_59_142_16,r_26_106_132,0.96,-14,118,132,33
17,r_146_72_142,seq43,r_96_121_49,r_96_121_49,0.97,93,142,49,33
7,r_114_51_121,r_88_127_160,r_70_14_143,r_88_127_160,0.7,1,161,160,33
22,r_68_147_67,r_26_106_132,seq39,r_68_147_67,0.92,3,70,67,33
28,r_95_7_183,seq12,r_91_66_141,r_91_66_141,0.78,39,180,141,33
49,r_70_14_143,seq108,r_114_51_121,r_70_14_143,0.73,0,143,143,33
7,r_114_51_121,r_99_52_30,r_88_127_160,r_114_51_121,0.7,0,121,121,33
44,r_123_3_174,seq43,r_96_121_49,r_96_121_49,1.0,128,177,49,33
23,r_22_90_176,r_54_124_97,r_113_48_43,r_22_90_176,0.99,-79,97,176,33
35,r_107_140_110,r_9_13_157,seq129,r_9_13_157,0.89,-44,113,157,33
12,r_6_1_168,seq89,r_84_38_144,r_84_38_144,0.59,25,169,144,33
42,r_41_65_50,r_54_124_97,seq93,r_41_65_50,0.96,1,51,50,33
23,r_22_90_176,r_113_48_43,seq45,r_22_90_176,0.83,5,181,176,33
84,seq77,r_61_5_89,r_40_104_20,r_61_5_89,0.98,0,89,89,33
36,r_50_128_4,r_43_67_48,r_80_119_176,r_80_119_176,0.99,8,184,176,34
9,r_25_106_15,r_11_66_81,r_22_53_1,r_11_66_81,1.0,0,81,81,34
92,seq114,r_48_146_155,r_0_37_23,r_48_146_155,0.86,-86,69,155,34
14,r_21_52_112,r_35_138_194,r_57_84_20,r_21_52_112,1.0,1,113,112,34
43,r_68_91_92,seq5,r_148_83_40,r_148_83_40,1.0,29,69,40,34
86,seq98,seq10,r_23_127_164,r_23_127_164,0.93,7,171,164,34
83,seq92,r_80_119_176,r_26_74_25,r_26_74_25,0.82,114,139,25,34
37,r_72_107_156,r_23_127_164,r_31_129_94,r_72_107_156,0.57,0,156,156,34
59,seq29,r_31_129_94,seq90,r_31_129_94,1.0,1,95,94,34
55,seq143,r_7_105_103,r_86_24_3,r_7_105_103,0.99,-32,71,103,34
26,r_101_54_47,seq38,seq19,r_101_54_47,0.68,8,55,47,34
16,r_111_69_187,r_43_67_48,r_7_105_103,r_43_67_48,0.28,141,189,48,34
1,r_96_144_109,seq93,r_86_24_3,r_86_24_3,0.87,63,66,3,34
46,r_131_97_93,seq33,seq40,r_131_97_93,0.83,3,96,93,34
0,r_43_67_48,r_16_13_53,r_116_118_21,r_16_13_53,0.91,-3,50,53,34
95,seq121,r_60_1_143,seq61,r_60_1_143,0.95,5,148,143,34
31,r_70_94_129,seq10,r_102_104_116,r_70_94_129,0.98,0,129,129,34
45,r_11_66_81,seq29,r_25_106_15,r_25_106_15,1.0,6,21,15,34
3,r_23_127_164,r_27_110_10,seq98,r_23_127_164,0.85,0,164,164,34
4,r_148_83_40,seq121,r_27_110_10,r_148_83_40,1.0,1,41,40,34
2,r_30_71_19,r_132_126_168,r_27_110_10,r_30_71_19,1.0,0,19,19,34
63,seq40,seq115,r_131_97_93,r_131_97_93,0.87,3,96,93,34
73,seq64,seq41,r_7_105_103,r_7_105_103,1.0,13,116,103,34
20,r_60_1_143,seq121,seq28,r_60_1_143,1.0,1,144,143,34
48,r_7_105_103,seq143,seq64,r_7_105_103,0.99,0,103,103,34
86,seq98,r_15_2_37,seq10,r_15_2_37,1.0,0,37,37,34
57,seq149,r_9_14_167,r_96_144_109,r_96_144_109,0.8,58,167,109,34
6,r_77_49_198,r_80_119_176,r_26_74_25,r_26_74_25,0.9,152,177,25,34
62,seq38,r_101_54_47,r_11_66_81,r_11_66_81,0.99,1,82,81,34
44,r_132_126_168,r_7_105_103,r_39_139_78,r_132_126_168,0.99,0,168,168,34
27,r_4_34_65,r_77_49_198,seq10,r_4_34_65,1.0,2,67,65,34
35,r_3_109_34,r_48_146_155,seq133,r_3_109_34,1.0,0,34,34,34
47,r_9_14_167,seq149,r_131_97_93,r_9_14_167,0.46,1,168,167,34
29,r_75_20_73,seq98,r_6_65_28,r_75_20_73,0.95,0,73,73,34
24,r_57_84_20,r_77_49_198,seq33,r_57_84_20,1.0,0,20,20,34
25,r_80_119_176,r_77_49_198,r_50_128_4,r_50_128_4,0.74,173,177,4,34
33,r_35_138_194,r_21_52_112,r_134_8_107,r_35_138_194,0.98,-81,113,194,34
28,r_145_17_27,seq59,seq149,r_145_17_27,0.88,3,30,27,34
88,seq100,r_80_119_176,r_108_32_96,r_108_32_96,0.98,11,107,96,34
19,r_26_74_25,seq113,seq123,r_26_74_25,1.0,0,25,25,34
61,seq33,r_131_97_93,r_57_84_20,r_57_84_20,0.71,76,96,20,34
38,r_134_8_107,r_80_119_176,r_35_138_194,r_134_8_107,0.99,0,107,107,34
52,seq10,r_70_94_129,r_4_34_65,r_4_34_65,0.79,4,69,65,34
34,r_36_85_101,seq89,seq137,r_36_85_101,1.0,1,102,101,34
15,r_6_65_28,seq114,r_75_20_73,r_75_20_73,0.98,11,84,73,34
15,r_6_65_28,seq46,seq114,r_6_65_28,0.96,0,28,28,34
45,r_11_66_81,r_25_106_15,seq38,r_11_66_81,1.0,0,81,81,34
32,r_18_44_35,r_108_32_96,seq149,r_108_32_96,0.98,-60,36,96,34
17,r_27_110_10,r_23_127_164,r_148_83_40,r_148_83_40,0.51,115,155,40,34
9,r_25_106_15,r_30_71_19,r_11_66_81,r_25_106_15,0.97,0,15,15,34
18,r_16_13_53,r_43_67_48,seq81,r_16_13_53,1.0,0,53,53,34
22,r_31_129_94,seq29,r_4_34_65,r_31_129_94,1.0,1,95,94,34
1,r_96_144_109,r_86_24_3,r_145_17_27,r_96_144_109,1.0,1,110,109,34
40,r_116_118_21,r_45_120_165,r_43_67_48,r_116_118_21,0.9,0,21,21,34
49,r_47_130_117,seq113,r_6_65_28,r_47_130_117,0.98,2,119,117,34
72,seq62,r_86_24_3,r_131_97_93,r_131_97_93,0.65,70,163,93,34
10,r_0_37_23,seq64,seq114,r_0_37_23,0.87,2,25,23,34
7,r_108_32_96,r_21_52_112,seq100,r_108_32_96,1.0,0,96,96,34
44,r_132_126_168,r_9_14_167,r_7_105_103,r_7_105_103,0.97,32,135,103,34
84,seq93,seq113,r_15_2_37,r_15_2_37,1.0,14,51,37,34
23,r_39_139_78,seq137,r_3_109_34,r_39_139_78,0.92,0,78,78,34
12,r_102_104_116,seq133,r_57_84_20,r_102_104_116,0.98,3,119,116,34
42,r_15_2_37,seq98,seq93,r_15_2_37,1.0,0,37,37,34
51,seq3,r_14_123_125,r_66_143_81,r_14_123_125,0.94,0,125,125,35
36,r_64_73_61,r_141_21_137,seq142,r_64_73_61,0.78,15,76,61,35
98,seq125,r_25_60_58,r_101_51_19,r_25_60_58,0.69,-39,19,58,35
43,r_116_10_111,r_85_138_186,seq17,r_116_10_111,1.0,0,111,111,35
37,r_7_83_84,r_85_138_186,seq47,r_7_83_84,1.0,0,84,84,35
55,seq129,r_19_110_110,seq134,r_19_110_110,1.0,0,110,110,35
71,seq47,seq23,r_7_83_84,r_7_83_84,1.0,26,110,84,35
21,r_37_88_129,seq17,seq134,r_37_88_129,1.0,1,130,129,35
39,r_12_99_104,r_128_52_138,seq129,r_12_99_104,0.77,0,104,104,35
18,r_41_119_50,r_30_57_113,seq113,r_41_119_50,0.67,0,50,50,35
5,r_43_74_88,seq62,seq80,r_43_74_88,1.0,1,89,88,35
42,r_53_76_107,r_126_55_148,r_77_81_91,r_53_76_107,0.93,0,107,107,35
20,r_78_68_20,r_66_143_81,r_32_28_182,r_78_68_20,1.0,0,20,20,35
19,r_19_110_110,seq129,r_135_122_96,r_19_110_110,0.95,0,110,110,35
15,r_32_28_182,r_78_68_20,r_45_145_89,r_45_145_89,0.54,94,183,89,35
76,seq62,r_43_74_88,seq49,r_43_74_88,1.0,-19,69,88,35
0,r_29_15_33,r_30_57_113,seq61,r_29_15_33,0.65,0,33,33,35
41,r_18_9_70,r_75_139_2,seq149,r_18_9_70,1.0,0,70,70,35
89,seq104,r_95_54_97,r_2_92_59,r_2_92_59,0.99,4,63,59,35
15,r_32_28_182,r_37_88_129,r_78_68_20,r_78_68_20,0.67,0,20,20,35
3,r_130_46_130,r_70_58_115,r_144_65_62,r_144_65_62,0.99,56,118,62,35
10,r_140_38_86,seq33,seq50,r_140_38_86,1.0,1,87,86,35
8,r_4_84_23,seq22,seq120,r_4_84_23,0.94,0,23,23,35
93,seq113,seq115,r_41_119_50,r_41_119_50,1.0,8,58,50,35
26,r_42_5_165,seq67,r_25_60_58,r_42_5_165,0.86,0,165,165,35
63,seq149,seq44,r_18_9_70,r_18_9_70,1.0,0,70,70,35
73,seq50,r_89_108_120,r_140_38_86,r_140_38_86,1.0,11,97,86,35
30,r_34_59_12,r_25_60_58,seq69,r_34_59_12,1.0,-1,11,12,35
48,r_126_55_148,seq112,r_70_58_115,r_126_55_148,0.95,1,149,148,35
27,r_14_123_125,seq3,seq132,r_14_123_125,0.99,0,125,125,35
3,r_130_46_130,r_144_65_62,seq117,r_130_46_130,0.86,0,130,130,35
2,r_30_57_113,seq67,seq134,r_30_57_113,1.0,0,113,113,35
40,r_136_106_147,seq129,seq71,r_136_106_147,0.9,0,147,147,35
29,r_79_109_80,seq61,r_95_54_97,r_79_109_80,0.9,11,91,80,35
44,r_94_96_56,r_95_54_97,r_2_92_59,r_95_54_97,0.89,6,103,97,35
35,r_77_81_91,seq17,r_53_76_107,r_53_76_107,0.62,46,153,107,35
6,r_95_54_97,r_94_96_56,r_79_109_80,r_95_54_97,0.83,6,103,97,35
33,r_135_122_96,r_128_52_138,r_8_114_74,r_135_122_96,1.0,0,96,96,35
47,r_6_36_53,r_70_58_115,seq11,r_6_36_53,0.74,-2,51,53,35
64,seq22,r_95_54_97,r_2_92_59,r_2_92_59,0.99,21,80,59,35
44,r_94_96_56,seq134,r_95_54_97,r_94_96_56,1.0,-1,55,56,35
20,r_78_68_20,r_32_28_182,r_70_58_115,r_70_58_115,0.6,68,183,115,35
32,r_128_52_138,seq72,seq23,r_128_52_138,0.99,0,138,138,35
38,r_8_114_74,seq61,r_135_122_96,r_135_122_96,0.63,0,96,96,35
34,r_66_143_81,seq23,seq3,r_66_143_81,0.83,-6,75,81,35
46,r_148_40_10,r_78_68_20,seq72,r_78_68_20,0.66,-10,10,20,35
17,r_144_65_62,seq134,seq33,r_144_65_62,1.0,1,63,62,35
9,r_45_145_89,seq82,seq113,r_45_145_89,1.0,0,89,89,35
28,r_27_63_184,r_12_99_104,r_78_68_20,r_27_63_184,0.51,0,184,184,35
22,r_70_58_115,r_130_46_130,r_78_68_20,r_70_58_115,0.91,3,118,115,35
28,r_27_63_184,seq134,r_12_99_104,r_12_99_104,1.0,4,108,104,35
49,r_141_21_137,seq56,r_116_10_111,r_141_21_137,0.67,1,138,137,35
45,r_2_92_59,seq49,seq104,r_2_92_59,1.0,0,59,59,35
7,r_90_93_143,seq147,r_18_9_70,r_90_93_143,0.93,0,143,143,35
23,r_103_48_101,seq56,r_41_119_50,r_103_48_101,0.59,1,102,101,35
82,seq82,r_13_131_108,r_4_84_23,r_13_131_108,0.97,0,108,108,35
6,r_95_54_97,seq104,r_94_96_56,r_94_96_56,1.0,1,57,56,35
11,r_25_60_58,r_77_81_91,seq147,r_25_60_58,1.0,0,58,58,35
35,r_77_81_91,r_14_123_125,seq17,r_77_81_91,0.74,0,91,91,35
31,r_101_51_19,r_85_138_186,seq125,r_85_138_186,0.9,-167,19,186,35
37,r_128_70_56,r_131_125_146,seq71,r_128_70_56,1.0,0,56,56,36
51,seq130,r_131_125_146,r_60_28_67,r_60_28_67,0.88,15,82,67,36
40,r_139_88_20,r_102_41_105,seq119,r_139_88_20,0.98,0,20,20,36
92,seq99,seq63,r_138_72_79,r_138_72_79,0.75,13,92,79,36
14,r_131_125_146,seq83,r_116_69_68,r_131_125_146,0.88,0,146,146,36
8,r_116_69_68,seq11,r_90_142_48,r_90_142_48,0.56,20,68,48,36
48,r_96_37_30,seq120,seq129,r_96_37_30,0.99,0,30,30,36
57,seq11,r_6_36_84,r_20_49_128,r_20_49_128,1.0,4,132,128,36
3,r_64_87_18,r_0_122_180,r_121_91_59,r_121_91_59,0.97,121,180,59,36
21,r_81_8_86,r_115_74_17,seq112,r_81_8_86,1.0,0,86,86,36
39,r_114_7_71,seq133,seq3,r_114_7_71,1.0,-1,70,71,36
97,seq119,seq34,r_139_88_20,r_139_88_20,0.99,104,124,20,36
5,r_101_123_135,seq130,seq24,r_101_123_135,0.93,3,138,135,36
46,r_121_91_59,seq86,seq133,r_121_91_59,1.0,1,60,59,36
42,r_30_94_65,seq133,seq77,r_30_94_65,1.0,0,65,65,36
62,seq147,r_10_31_167,r_52_50_43,r_52_50_43,1.0,-1,42,43,36
45,r_10_31_167,r_104_23_166,r_52_50_43,r_52_50_43,1.0,84,127,43,36
22,r_143_45_191,r_118_110_57,seq100,r_118_110_57,1.0,-1,56,57,36
19,r_106_16_122,seq108,r_116_69_68,r_106_16_122,0.73,2,124,122,36
41,r_115_74_17,r_81_8_86,r_30_94_65,r_115_74_17,1.0,69,86,17,36
67,seq32,r_15_145_138,r_113_98_143,r_15_145_138,1.0,1,139,138,36
26,r_13_25_94,seq17,seq40,r_13_25_94,1.0,0,94,94,36
35,r_0_122_180,r_103_26_129,r_64_87_18,r_64_87_18,0.81,1,19,18,36
3,r_64_87_18,r_13_25_94,r_0_122_180,r_64_87_18,0.98,0,18,18,36
45,r_10_31_167,r_52_50_43,r_6_36_84,r_6_36_84,0.61,83,167,84,36
34,r_6_36_84,seq11,r_10_31_167,r_10_31_167,0.86,2,169,167,36
73,seq44,r_76_59_153,r_146_58_133,r_76_59_153,0.56,0,153,153,36
11,r_93_2_149,seq38,seq32,r_93_2_149,0.86,2,151,149,36
20,r_20_49_128,seq40,seq11,r_20_49_128,0.95,0,128,128,36
13,r_89_127_114,seq11,r_12_148_26,r_89_127_114,0.88,0,114,114,36
15,r_22_33_78,seq97,seq95,r_22_33_78,1.0,-2,76,78,36
57,seq11,r_116_69_68,r_89_127_114,r_116_69_68,0.91,0,68,68,36
0,r_15_145_138,r_113_98_143,r_79_84_19,r_79_84_19,1.0,21,40,19,36
0,r_15_145_138,r_79_84_19,seq97,r_15_145_138,1.0,1,139,138,36
27,r_104_23_166,r_75_73_124,r_138_72_79,r_75_73_124,0.68,0,124,124,36
31,r_126_9_45,r_121_91_59,seq129,r_126_9_45,1.0,-4,41,45,36
87,seq83,r_131_125_146,r_60_28_67,r_60_28_67,0.91,79,146,67,36
91,seq97,seq133,r_15_145_138,r_15_145_138,1.0,2,140,138,36
2,r_76_59_153,seq44,r_118_110_57,r_76_59_153,0.82,0,153,153,36
4,r_62_61_46,seq82,seq141,r_62_61_46,1.0,-3,43,46,36
24,r_103_26_129,seq133,r_85_29_125,r_103_26_129,0.94,0,129,129,36
35,r_0_122_180,r_64_87_18,r_81_8_86,r_0_122_180,0.73,0,180,180,36
28,r_90_142_48,r_15_145_138,seq43,r_90_142_48,1.0,0,48,48,36
47,r_12_148_26,r_115_74_17,r_89_127_114,r_89_127_114,1.0,1,115,114,36
90,seq95,r_15_145_138,r_79_84_19,r_79_84_19,0.76,2,21,19,36
50,seq1,r_138_72_79,seq4,r_138_72_79,0.33,24,103,79,36
70,seq38,r_93_2_149,r_46_68_27,r_93_2_149,0.94,2,151,149,36
6,r_118_110_57,seq40,r_76_59_153,r_76_59_153,0.93,8,161,153,36
10,r_14_132_33,r_81_8_86,seq32,r_14_132_33,0.92,-1,32,33,36
32,r_75_73_124,r_104_23_166,r_30_94_65,r_75_73_124,1.0,0,124,124,36
38,r_85_29_125,seq40,r_117_55_113,r_85_29_125,0.97,0,125,125,36
34,r_6_36_84,r_85_29_125,r_118_110_57,r_118_110_57,1.0,15,72,57,36
7,r_52_50_43,r_143_45_191,seq147,r_52_50_43,1.0,0,43,43,36
60,seq144,r_12_148_26,r_46_68_27,r_12_148_26,0.99,-1,25,26,36
27,r_104_23_166,r_138_72_79,seq27,r_104_23_166,1.0,0,166,166,36
17,r_60_28_67,r_116_69_68,seq130,r_60_28_67,1.0,0,67,67,36
96,seq112,r_111_19_131,r_81_8_86,r_81_8_86,1.0,1,87,86,36
34,r_6_36_84,r_118_110_57,seq11,r_6_36_84,0.85,0,84,84,36
91,seq97,r_22_33_78,seq133,r_22_33_78,1.0,0,78,78,36
72,seq43,seq92,r_90_142_48,r_90_142_48,1.0,1,49,48,36
23,r_113_98_143,r_15_145_138,r_111_19_131,r_15_145_138,0.86,1,139,138,36
47,r_12_148_26,seq144,r_115_74_17,r_12_148_26,0.95,0,26,26,36
8,r_116_69_68,r_90_142_48,r_106_16_122,r_106_16_122,0.98,4,126,122,36
6,r_118_110_57,r_143_45_191,seq40,r_118_110_57,1.0,0,57,57,36
12,r_107_137_110,seq135,seq4,r_107_137_110,0.99,1,111,110,36
84,seq77,seq82,r_30_94_65,r_30_94_65,1.0,5,70,65,36
30,r_7_88_168,seq134,r_139_92_166,r_139_92_166,0.95,4,170,166,37
51,seq2,seq97,r_8_79_141,r_8_79_141,0.9,-2,139,141,37
36,r_105_11_173,r_91_64_159,r_58_144_161,r_105_11_173,0.67,0,173,173,37
8,r_69_5_169,r_4_3_9,r_42_13_20,r_69_5_169,0.44,0,169,169,37
35,r_56_100_39,r_111_47_83,r_145_63_59,r_111_47_83,0.7,0,83,83,37
9,r_36_14_66,r_41_147_6,r_12_149_90,r_12_149_90,0.99,4,94,90,37
37,r_127_113_106,seq84,r_119_106_25,r_127_113_106,0.76,3,109,106,37
3,r_119_106_25,seq60,r_127_113_106,r_127_113_106,1.0,2,108,106,37
14,r_145_63_59,seq78,r_56_100_39,r_145_63_59,0.99,0,59,59,37
42,r_111_47_83,r_56_100_39,seq26,r_111_47_83,1.0,0,83,83,37
16,r_123_15_73,seq44,seq115,r_123_15_73,1.0,-4,69,73,37
21,r_54_74_124,seq76,r_114_61_76,r_54_74_124,0.66,0,124,124,37
39,r_62_116_88,seq40,r_75_148_89,r_75_148_89,1.0,19,108,89,37
5,r_12_149_90,r_69_5_169,r_36_14_66,r_12_149_90,0.97,1,91,90,37
46,r_75_148_89,seq85,r_62_116_88,r_75_148_89,1.0,2,91,89,37
24,r_96_9_136,seq131,r_109_30_41,r_96_9_136,0.97,1,137,136,37
3,r_119_106_25,r_56_100_39,seq60,r_119_106_25,0.83,-1,24,25,37
32,r_142_83_38,seq26,seq0,r_142_83_38,1.0,0,38,38,37
27,r_48_130_60,r_117_17_57,r_87_57_62,r_87_57_62,0.97,-8,54,62,37
19,r_4_3_9,r_69_5_169,r_58_144_161,r_4_3_9,0.43,160,169,9,37
76,seq60,r_104_53_143,r_114_61_76,r_114_61_76,1.0,8,84,76,37
41,r_143_45_61,r_12_149_90,seq89,r_143_45_61,1.0,0,61,61,37
10,r_24_6_97,r_105_11_173,r_28_128_16,r_24_6_97,1.0,0,97,97,37
0,r_114_61_76,seq0,seq60,r_114_61_76,1.0,0,76,76,37
11,r_58_144_161,r_104_53_143,r_114_61_76,r_114_61_76,1.0,67,143,76,37
13,r_31_77_74,seq29,seq59,r_31_77_74,0.62,-11,63,74,37
98,seq125,r_18_140_185,seq20,r_18_140_185,0.44,-16,169,185,37
15,r_1_35_71,r_23_122_135,seq67,r_1_35_71,0.97,-2,69,71,37
48,r_42_13_20,r_7_88_168,seq99,r_42_13_20,0.92,1,21,20,37
35,r_56_100_39,seq94,r_111_47_83,r_56_100_39,0.99,0,39,39,37
6,r_18_140_185,seq125,r_24_6_97,r_24_6_97,1.0,88,185,97,37
31,r_109_30_41,seq135,r_142_83_38,r_109_30_41,0.77,0,41,41,37
2,r_25_52_174,r_90_103_172,r_37_121_28,r_90_103_172,0.63,5,177,172,37
47,r_138_16_108,r_82_107_12,r_109_30_41,r_138_16_108,0.55,0,108,108,37
40,r_90_103_172,r_21_120_180,r_69_5_169,r_21_120_180,0.61,-6,174,180,37
38,r_95_72_10,r_114_61_76,r_4_3_9,r_95_72_10,0.58,0,10,10,37
24,r_96_9_136,r_22_46_95,seq131,r_22_46_95,0.99,0,95,95,37
11,r_58_144_161,r_114_61_76,r_4_3_9,r_58_144_161,0.95,0,161,161,37
33,r_8_79_141,seq19,seq2,r_8_79_141,0.69,-1,140,141,37
48,r_42_13_20,seq99,r_69_5_169,r_69_5_169,0.66,-1,168,169,37
61,seq19,r_8_79_141,seq137,r_8_79_141,1.0,0,141,141,37
17,r_22_46_95,r_96_9_136,r_142_83_38,r_22_46_95,0.93,0,95,95,37
9,r_36_14_66,seq60,r_41_147_6,r_36_14_66,0.46,1,67,66,37
42,r_111_47_83,r_114_61_76,r_56_100_39,r_56_100_39,0.98,0,39,39,37
63,seq26,r_28_128_16,r_111_47_83,r_111_47_83,1.0,-1,82,83,37
22,r_104_53_143,r_58_144_161,r_111_47_83,r_111_47_83,0.97,60,143,83,37
28,r_23_122_135,seq141,r_31_77_74,r_23_122_135,0.88,2,137,135,37
1,r_117_17_57,seq10,seq32,r_117_17_57,0.97,0,57,57,37
49,r_101_110_94,r_82_107_12,r_12_149_90,r_101_110_94,0.98,0,94,94,37
44,r_129_71_68,seq65,seq98,r_129_71_68,0.92,3,71,68,37
20,r_37_121_28,r_127_113_106,seq132,r_37_121_28,0.99,1,29,28,37
23,r_66_112_80,seq85,seq60,r_66_112_80,0.99,0,80,80,37
82,seq76,r_54_74_124,r_4_3_9,r_54_74_124,0.92,0,124,124,37
12,r_139_92_166,seq51,r_7_88_168,r_139_92_166,0.82,2,168,166,37
45,r_87_57_62,seq73,r_48_130_60,r_87_57_62,1.0,-8,54,62,37
30,r_122_119_153,seq64,seq134,r_122_119_153,0.34,-79,74,153,38
40,r_110_121_41,seq137,seq86,r_110_121_41,0.95,2,43,41,38
43,r_48_147_115,seq33,seq74,r_48_147_115,1.0,1,116,115,38
60,seq144,seq34,r_114_49_19,r_114_49_19,1.0,0,19,19,38
37,r_3_12_77,seq117,r_1_127_68,r_1_127_68,1.0,20,88,68,38
16,r_62_146_63,seq76,seq35,r_62_146_63,1.0,0,63,63,38
25,r_123_111_157,r_53_108_93,r_0_28_52,r_123_111_157,1.0,0,157,157,38
80,seq74,r_55_94_176,r_48_147_115,r_48_147_115,0.94,8,123,115,38
32,r_109_98_24,seq77,r_47_113_158,r_47_113_158,1.0,17,175,158,38
45,r_2_125_171,r_95_139_180,seq141,r_95_139_180,0.58,-8,172,180,38
19,r_101_8_136,seq32,seq124,r_101_8_136,0.92,0,136,136,38
47,r_53_108_93,r_115_118_29,r_123_111_157,r_53_108_93,1.0,0,93,93,38
35,r_73_11_47,seq61,r_56_68_4,r_73_11_47,1.0,0,47,47,38
41,r_65_52_60,r_142_30_64,r_3_12_77,r_65_52_60,1.0,0,60,60,38
3,r_142_30_64,seq21,r_122_119_153,r_142_30_64,0.94,58,122,64,38
8,r_57_44_23,r_88_145_28,seq34,r_57_44_23,0.64,0,23,23,38
38,r_138_29_14,r_104_72_121,seq9,r_138_29_14,0.99,0,14,14,38
32,r_109_98_24,r_104_72_121,seq77,r_109_98_24,1.0,0,24,24,38
20,r_23_40_154,seq134,seq14,r_23_40_154,0.64,0,154,154,38
13,r_87_102_66,r_53_108_93,seq4,r_87_102_66,1.0,0,66,66,38
46,r_59_38_117,r_56_68_4,seq134,r_59_38_117,0.98,0,117,117,38
15,r_15_82_107,r_55_94_176,seq77,r_15_82_107,0.99,0,107,107,38
3,r_142_30_64,r_122_119_153,r_50_130_141,r_142_30_64,0.42,86,150,64,38
6,r_95_139_180,r_22_126_142,r_100_39_123,r_95_139_180,0.45,-45,135,180,38
0,r_0_28_52,r_46_85_143,r_16_7_120,r_16_7_120,1.0,10,130,120,38
10,r_88_145_28,r_2_125_171,r_100_39_123,r_100_39_123,0.9,49,172,123,38
27,r_16_7_120,r_5_10_2,r_57_44_23,r_16_7_120,0.89,0,120,120,38
30,r_122_119_153,seq134,seq103,r_122_119_153,0.94,0,153,153,38
39,r_84_54_22,r_23_40_154,seq132,r_23_40_154,0.76,-131,23,154,38
36,r_60_135_16,r_27_58_75,r_96_120_5,r_96_120_5,0.57,10,15,5,38
2,r_5_10_2,r_16_7_120,seq17,r_16_7_120,1.0,0,120,120,38
10,r_88_145_28,r_47_113_158,r_2_125_171,r_88_145_28,1.0,1,29,28,38
47,r_53_108_93,r_87_102_66,r_115_118_29,r_87_102_66,0.83,0,66,66,38
6,r_95_139_180,r_100_39_123,r_55_94_176,r_95_139_180,0.91,0,180,180,38
18,r_50_130_141,seq107,r_104_72_121,r_50_130_141,0.89,0,141,141,38
29,r_104_72_121,r_116_129_195,seq21,r_104_72_121,0.91,0,121,121,38
24,r_22_126_142,r_95_139_180,seq19,r_22_126_142,0.65,0,142,142,38
47,r_53_108_93,r_123_111_157,seq133,r_123_111_157,1.0,0,157,157,38
93,seq105,r_27_58_75,r_90_131_25,r_90_131_25,0.76,12,37,25,38
25,r_123_111_157,seq133,r_53_108_93,r_53_108_93,1.0,18,111,93,38
21,r_90_131_25,r_75_78_65,seq105,r_90_131_25,1.0,1,26,25,38
82,seq77,r_109_98_24,r_15_82_107,r_15_82_107,1.0,9,116,107,38
0,r_0_28_52,r_62_146_63,r_46_85_143,r_62_146_63,1.0,-9,54,63,38
1,r_81_45_37,seq137,seq18,r_81_45_37,1.0,0,37,37,38
42,r_56_68_4,r_59_38_117,r_73_11_47,r_56_68_4,1.0,113,117,4,38
61,seq17,r_1_127_68,r_5_10_2,r_1_127_68,1.0,0,68,68,38
52,seq133,r_123_111_157,r_53_108_93,r_53_108_93,0.98,64,157,93,38
77,seq66,r_67_71_103,r_41_37_102,r_67_71_103,1.0,-3,100,103,38
75,seq61,r_73_11_47,r_5_10_2,r_73_11_47,1.0,0,47,47,38
34,r_100_39_123,seq66,r_88_145_28,r_100_39_123,0.52,11,134,123,38
17,r_75_78_65,seq117,r_87_102_66,r_75_78_65,1.0,2,67,65,38
49,r_67_71_103,seq66,r_5_10_2,r_67_71_103,0.98,1,104,103,38
7,r_1_127_68,seq17,r_3_12_77,r_1_127_68,1.0,0,68,68,38
11,r_115_118_29,r_46_85_143,seq32,r_115_118_29,0.73,3,32,29,38
82,seq77,r_23_40_154,r_109_98_24,r_109_98_24,0.92,10,34,24,38
0,r_0_28_52,r_16_7_120,r_123_111_157,r_123_111_157,0.96,7,164,157,38
30,r_79_40_78,seq123,r_104_130_9,r_104_130_9,0.72,73,82,9,39
36,r_92_35_176,r_51_96_168,r_50_43_31,r_50_43_31,0.99,88,119,31,39
14,r_88_118_64,seq93,seq149,r_88_118_64,0.88,2,66,64,39
8,r_90_86_156,seq142,r_50_43_31,r_90_86_156,0.84,0,156,156,39
43,r_110_132_177,r_95_73_85,seq93,r_95_73_85,0.63,1,86,85,39
55,seq11,seq129,r_25_18_86,r_25_18_86,1.0,7,93,86,39
21,r_46_63_81,r_127_124_113,r_104_130_9,r_46_63_81,1.0,0,81,81,39
39,r_144_91_144,r_110_132_177,r_67_133_26,r_144_91_144,0.91,0,144,144,39
97,seq148,r_107_26_165,r_19_102_63,r_19_102_63,1.0,103,166,63,39
5,r_80_108_193,r_19_102_63,r_67_133_26,r_80_108_193,0.55,-130,63,193,39
45,r_143_21_139,seq33,seq76,r_143_21_139,0.98,1,140,139,39
19,r_14_55_114,r_62_32_186,r_71_121_39,r_14_55_114,0.99,0,114,114,39
17,r_71_121_39,r_25_18_86,seq44,r_71_121_39,1.0,0,39,39,39
38,r_6_8_57,r_128_22_99,r_64_112_179,r_128_22_99,0.42,62,161,99,39
89,seq93,r_88_118_64,r_110_132_177,r_88_118_64,0.66,17,81,64,39
3,r_128_22_99,seq36,r_19_102_63,r_19_102_63,0.87,38,101,63,39
10,r_13_122_133,seq12,seq52,r_13_122_133,0.99,1,134,133,39
26,r_95_73_85,r_110_132_177,seq33,r_95_73_85,0.56,1,86,85,39
41,r_109_1_56,seq129,seq142,r_109_1_56,1.0,0,56,56,39
0,r_134_138_183,seq45,r_17_24_2,r_134_138_183,0.73,-25,158,183,39
48,r_140_66_77,seq76,r_88_118_64,r_140_66_77,1.0,-1,76,77,39
6,r_82_29_140,r_9_59_142,seq72,r_82_29_140,0.91,0,140,140,39
36,r_92_35_176,r_50_43_31,seq99,r_92_35_176,0.96,1,177,176,39
12,r_67_133_26,seq115,r_80_108_193,r_67_133_26,1.0,0,26,26,39
99,seq126,r_135_77_157,r_117_68_53,r_117_68_53,0.93,104,157,53,39
27,r_62_32_186,seq105,seq93,r_62_32_186,0.59,0,186,186,39
90,seq98,seq27,r_104_130_9,r_104_130_9,0.96,13,22,9,39
4,r_28_39_49,r_147_74_51,seq42,r_28_39_49,0.92,1,50,49,39
24,r_60_70_52,r_82_29_140,seq11,r_60_70_52,1.0,0,52,52,39
2,r_135_77_157,seq126,r_89_113_34,r_135_77_157,0.79,0,157,157,39
18,r_9_59_142,r_82_29_140,r_3_69_145,r_82_29_140,0.98,0,140,140,39
29,r_106_4_138,seq48,seq10,r_106_4_138,0.98,0,138,138,39
25,r_120_5_73,r_9_59_142,seq137,r_120_5_73,0.99,0,73,73,39
33,r_136_111_149,seq20,seq16,r_136_111_149,0.4,5,154,149,39
58,seq142,r_90_86_156,r_109_1_56,r_109_1_56,0.75,18,74,56,39
44,r_89_113_34,r_128_22_99,seq75,r_89_113_34,0.52,2,36,34,39
38,r_6_8_57,r_106_4_138,r_128_22_99,r_106_4_138,0.57,-61,77,138,39
77,seq48,r_106_4_138,r_119_85_10,r_106_4_138,0.99,0,138,138,39
47,r_50_43_31,r_88_118_64,seq101,r_50_43_31,1.0,1,32,31,39
46,r_147_74_51,r_28_39_49,r_89_113_34,r_147_74_51,0.81,-1,50,51,39
32,r_117_68_53,r_95_73_85,r_67_133_26,r_117_68_53,1.0,0,53,53,39
0,r_134_138_183,r_17_24_2,r_25_18_86,r_134_138_183,0.77,-1,182,183,39
94,seq105,r_62_32_186,r_94_83_111,r_94_83_111,0.99,0,111,111,39
9,r_94_83_111,r_107_26_165,seq105,r_94_83_111,0.99,0,111,111,39
1,r_97_100_41,seq10,seq31,r_97_100_41,0.92,0,41,41,39
22,r_127_124_113,seq10,seq115,r_127_124_113,0.96,3,116,113,39
28,r_64_112_179,seq36,r_28_39_49,r_64_112_179,0.19,10,189,179,39
7,r_19_102_63,r_80_108_193,seq148,r_19_102_63,1.0,0,63,63,39
79,seq52,r_90_86_156,r_13_122_133,r_13_122_133,0.64,23,156,133,39
35,r_25_18_86,r_3_69_145,seq11,r_25_18_86,1.0,0,86,86,39
30,r_19_117_159,r_94_6_37,r_109_10_71,r_19_117_159,0.56,0,159,159,40
36,r_149_63_160,seq16,r_70_83_65,r_70_83_65,0.98,95,160,65,40
8,r_29_69_69,r_145_82_192,r_87_7_99,r_29_69_69,0.83,1,70,69,40
21,r_87_7_99,r_29_69_69,seq20,r_87_7_99,0.99,0,99,99,40
43,r_133_107_39,r_96_34_98,r_0_147_80,r_133_107_39,1.0,44,83,39,40
28,r_77_11_112,r_25_13_73,r_131_129_167,r_77_11_112,0.99,0,112,112,40
48,r_126_44_12,r_138_92_174,seq64,r_126_44_12,0.98,0,12,12,40
59,seq132,r_89_24_189,r_96_34_98,r_96_34_98,1.0,91,189,98,40
67,seq48,r_149_63_160,seq105,r_149_63_160,0.85,-26,134,160,40
16,r_3_88_78,seq48,seq116,r_3_88_78,1.0,0,78,78,40
21,r_87_7_99,r_0_147_80,r_29_69_69,r_87_7_99,0.85,-16,83,99,40
39,r_131_129_167,r_36_43_138,r_77_11_112,r_77_11_112,0.56,26,138,112,40
1,r_46_137_154,r_98_66_175,r_84_114_60,r_84_114_60,0.95,94,154,60,40
5,r_113_76_169,r_133_107_39,r_122_119_153,r_122_119_153,0.61,21,174,153,40
46,r_36_43_138,r_131_129_167,r_109_10_71,r_36_43_138,0.81,0,138,138,40
32,r_102_35_185,r_56_5_15,r_3_88_78,r_102_35_185,0.73,0,185,185,40
39,r_131_129_167,r_77_11_112,seq16,r_131_129_167,0.82,0,167,167,40
11,r_56_5_15,r_102_35_185,seq106,r_102_35_185,0.65,0,185,185,40
95,seq116,r_41_17_144,seq65,r_41_17_144,1.0,0,144,144,40
11,r_56_5_15,r_49_140_182,r_102_35_185,r_56_5_15,0.99,0,15,15,40
31,r_118_146_148,r_72_134_184,seq4,r_72_134_184,0.89,-33,151,184,40
67,seq48,r_3_88_78,r_149_63_160,r_3_88_78,1.0,0,78,78,40
3,r_0_147_80,r_87_7_99,r_133_107_39,r_133_107_39,1.0,44,83,39,40
10,r_41_17_144,seq116,seq93,r_41_17_144,0.96,0,144,144,40
90,seq105,r_3_88_78,r_111_47_1,r_3_88_78,1.0,-24,54,78,40
37,r_112_135_53,r_78_75_122,r_19_117_159,r_112_135_53,0.55,6,59,53,40
4,r_1_71_94,r_145_82_192,seq58,r_1_71_94,1.0,0,94,94,40
78,seq65,r_68_28_105,r_3_88_78,r_3_88_78,1.0,34,112,78,40
0,r_122_119_153,seq93,r_97_15_92,r_122_119_153,0.94,0,153,153,40
63,seq33,seq31,r_142_61_34,r_142_61_34,1.0,61,95,34,40
73,seq58,seq45,r_1_71_94,r_1_71_94,1.0,33,127,94,40
8,r_29_69_69,r_87_7_99,r_68_28_105,r_87_7_99,0.62,0,99,99,40
13,r_109_10_71,r_96_34_98,r_111_47_1,r_109_10_71,0.99,0,71,71,40
37,r_112_135_53,r_19_117_159,r_97_15_92,r_112_135_53,0.41,38,91,53,40
15,r_96_34_98,r_22_100_35,seq23,r_96_34_98,1.0,1,99,98,40
6,r_49_140_182,r_111_47_1,r_122_119_153,r_49_140_182,0.38,1,183,182,40
72,seq55,r_112_135_53,r_8_27_44,r_112_135_53,0.65,1,54,53,40
19,r_136_40_55,r_109_10_71,seq38,r_136_40_55,0.71,0,55,55,40
7,r_25_13_73,r_77_11_112,seq124,r_77_11_112,1.0,-4,108,112,40
27,r_148_18_172,seq93,r_77_11_112,r_77_11_112,1.0,61,173,112,40
47,r_51_128_63,seq106,seq64,r_51_128_63,1.0,1,64,63,40
40,r_22_100_35,r_96_34_98,r_0_147_80,r_22_100_35,1.0,64,99,35,40
41,r_8_27_44,r_78_75_122,r_73_91_59,r_8_27_44,0.55,38,82,44,40
18,r_94_6_37,r_19_117_159,r_122_119_153,r_94_6_37,0.61,122,159,37,40
24,r_78_75_122,r_8_27_44,seq30,r_78_75_122,0.47,2,124,122,40
25,r_97_15_92,seq60,r_112_135_53,r_97_15_92,0.77,1,93,92,40
33,r_103_80_146,seq67,r_97_15_92,r_103_80_146,0.81,0,146,146,40
58,seq23,r_12_9_161,r_96_34_98,r_96_34_98,0.95,63,161,98,40
20,r_37_127_32,r_49_140_182,seq85,r_37_127_32,1.0,0,32,32,40
32,r_102_35_185,seq106,r_56_5_15,r_56_5_15,0.46,57,72,15,40
38,r_98_66_175,seq33,r_46_137_154,r_46_137_154,0.53,21,175,154,40
34,r_111_47_1,r_49_140_182,r_109_10_71,r_109_10_71,1.0,13,84,71,40
75,seq60,r_97_15_92,seq141,r_97_15_92,0.99,1,93,92,40
28,r_77_11_112,r_131_129_167,seq141,r_131_129_167,1.0,0,167,167,40
17,r_142_61_34,seq38,seq33,r_142_61_34,1.0,1,35,34,40
22,r_70_83_65,seq144,seq38,r_70_83_65,1.0,0,65,65,40
28,r_77_11_112,seq106,r_25_13_73,r_25_13_73,1.0,4,77,73,40
49,r_86_120_13,r_138_92_174,r_57_74_163,r_86_120_13,0.5,162,175,13,40
45,r_73_91_59,seq58,r_8_27_44,r_73_91_59,1.0,0,59,59,40
7,r_25_13_73,seq105,r_77_11_112,r_25_13_73,0.52,1,74,73,40
44,r_84_114_60,r_109_10_71,seq53,r_84_114_60,1.0,0,60,60,40
23,r_72_134_184,r_118_146_148,r_122_119_153,r_122_119_153,0.48,31,184,153,40
82,seq85,seq26,r_37_127_32,r_37_127_32,1.0,42,74,32,40
79,seq67,r_103_80_146,seq144,r_103_80_146,1.0,0,146,146,40
12,r_57_74_163,seq62,r_86_120_13,r_57_74_163,0.6,0,163,163,40
40,r_100_79_31,seq39,seq7,r_100_79_31,0.84,0,31,31,41
30,r_35_116_152,seq130,r_63_67_118,r_35_116_152,0.95,0,152,152,41
36,r_15_18_60,seq143,seq91,r_15_18_60,1.0,0,60,60,41
46,r_74_1_22,r_21_138_85,seq14,r_74_1_22,0.97,0,22,22,41
43,r_50_44_73,seq84,seq143,r_50_44_73,0.99,1,74,73,41
83,seq86,seq146,r_55_36_70,r_55_36_70,1.0,33,103,70,41
37,r_29_126_99,seq92,seq43,r_29_126_99,0.77,2,101,99,41
16,r_61_135_39,seq5,r_12_97_68,r_12_97_68,0.85,105,173,68,41
21,r_42_112_174,seq114,r_50_44_73,r_50_44_73,0.75,101,174,73,41
1,r_63_67_118,seq41,seq5,r_63_67_118,0.49,1,119,118,41
45,r_141_33_136,seq145,r_59_109_79,r_141_33_136,0.93,0,136,136,41
12,r_49_148_34,r_11_48_89,seq57,r_49_148_34,0.82,1,35,34,41
52,seq7,seq23,r_100_79_31,r_100_79_31,0.99,3,34,31,41
19,r_21_138_85,seq115,seq5,r_21_138_85,0.96,0,85,85,41
6,r_131_38_53,seq41,r_74_1_22,r_131_38_53,0.82,0,53,53,41
38,r_4_134_40,r_54_139_56,seq78,r_4_134_40,0.71,0,40,40,41
27,r_51_16_177,r_72_121_50,r_129_136_129,r_51_16_177,0.97,0,177,177,41
56,seq143,r_49_148_34,r_50_44_73,r_50_44_73,0.65,21,94,73,41
67,seq39,seq88,r_119_62_16,r_119_62_16,0.78,116,132,16,41
18,r_47_125_32,r_3_80_194,seq92,r_47_125_32,1.0,1,33,32,41
42,r_54_139_56,r_104_140_186,seq68,r_54_139_56,1.0,0,56,56,41
72,seq56,r_27_10_184,r_6_117_161,r_6_117_161,0.81,6,167,161,41
46,r_74_1_22,seq14,r_131_38_53,r_131_38_53,0.83,-1,52,53,41
4,r_95_31_131,r_3_80_194,r_29_126_99,r_95_31_131,1.0,0,131,131,41
0,r_6_117_161,seq32,seq56,r_6_117_161,0.72,0,161,161,41
63,seq28,r_129_136_129,seq14,r_129_136_129,0.76,0,129,129,41
73,seq57,r_104_140_186,r_49_148_34,r_49_148_34,0.86,144,178,34,41
11,r_102_127_77,seq84,r_54_139_56,r_102_127_77,0.85,-1,76,77,41
20,r_11_48_89,seq144,seq149,r_11_48_89,1.0,1,90,89,41
13,r_45_81_67,seq130,seq92,r_45_81_67,0.89,1,68,67,41
49,r_137_82_15,r_12_97_68,seq14,r_12_97_68,0.64,-2,66,68,41
48,r_13_122_119,seq93,r_15_18_60,r_15_18_60,1.0,65,125,60,41
57,seq144,r_11_48_89,seq145,r_11_48_89,1.0,3,92,89,41
49,r_137_82_15,r_87_113_196,r_12_97_68,r_137_82_15,0.97,0,15,15,41
27,r_51_16_177,seq43,r_72_121_50,r_72_121_50,1.0,58,108,50,41
87,seq92,r_29_126_99,r_45_81_67,r_29_126_99,0.68,2,101,99,41
2,r_27_10_184,seq56,r_64_0_9,r_27_10_184,0.52,2,186,184,41
24,r_55_36_70,r_99_26_124,seq86,r_55_36_70,0.98,1,71,70,41
25,r_46_101_98,seq76,seq43,r_46_101_98,0.99,3,101,98,41
43,r_50_44_73,seq143,r_42_112_174,r_42_112_174,0.88,6,180,174,41
33,r_60_128_97,r_132_147_182,r_52_83_44,r_60_128_97,0.97,0,97,97,41
9,r_12_97_68,seq142,r_137_82_15,r_12_97_68,0.89,-35,33,68,41
22,r_119_62_16,r_85_133_134,seq39,r_119_62_16,0.96,2,18,16,41
31,r_52_83_44,r_6_117_161,seq93,r_6_117_161,0.71,-116,45,161,41
17,r_85_133_134,seq76,r_15_18_60,r_15_18_60,1.0,80,140,60,41
26,r_129_136_129,r_12_97_68,seq28,r_12_97_68,0.73,-35,33,68,41
26,r_129_136_129,seq28,seq41,r_129_136_129,0.81,0,129,129,41
10,r_72_121_50,seq146,r_70_58_185,r_72_121_50,0.91,0,50,50,41
9,r_12_97_68,r_137_82_15,seq37,r_12_97_68,0.87,-2,66,68,41
28,r_22_89_189,seq75,r_30_24_148,r_30_24_148,0.9,42,190,148,41
56,seq143,r_15_18_60,r_49_148_34,r_15_18_60,0.74,0,60,60,41
44,r_59_109_79,seq53,seq2,r_59_109_79,1.0,0,79,79,41
14,r_69_105_51,seq37,seq53,r_69_105_51,1.0,1,52,51,41
26,r_51_129_25,seq54,seq27,r_51_129_25,0.69,2,27,25,42
30,r_122_111_122,seq110,r_41_112_62,r_122_111_122,0.87,2,124,122,42
51,seq3,r_32_141_126,seq137,r_32_141_126,1.0,0,126,126,42
26,r_51_129_25,seq27,r_149_114_60,r_51_129_25,0.88,37,62,25,42
92,seq104,r_108_133_51,r_16_15_10,r_108_133_51,0.86,-22,29,51,42
14,r_107_71_132,seq8,r_28_125_20,r_107_71_132,0.7,2,134,132,42
98,seq123,r_96_73_154,r_78_106_45,r_78_106_45,0.99,-2,43,45,42
53,seq134,r_146_103_155,r_140_86_117,r_140_86_117,0.81,41,158,117,42
37,r_12_20_105,r_89_19_109,r_79_66_72,r_89_19_109,0.86,-4,105,109,42
71,seq53,r_132_90_123,r_93_67_96,r_132_90_123,0.48,47,170,123,42
21,r_92_34_192,r_11_97_97,r_36_9_69,r_36_9_69,0.81,26,95,69,42
39,r_22_29_187,seq37,r_113_147_46,r_113_147_46,0.51,144,190,46,42
5,r_93_67_96,r_98_40_110,r_96_73_154,r_93_67_96,0.83,2,98,96,42
31,r_55_6_28,r_89_19_109,r_98_40_110,r_55_6_28,0.95,1,29,28,42
69,seq50,r_5_17_189,r_98_40_110,r_98_40_110,0.85,2,112,110,42
47,r_76_143_136,seq14,r_130_138_103,r_76_143_136,0.85,0,136,136,42
41,r_28_125_20,seq128,seq110,r_28_125_20,0.92,5,25,20,42
19,r_140_86_117,seq101,seq134,r_140_86_117,1.0,0,117,117,42
70,seq52,r_118_74_74,r_0_109_4,r_118_74_74,0.51,-21,53,74,42
1,r_41_112_62,r_89_19_109,r_78_106_45,r_41_112_62,0.5,-37,25,62,42
76,seq61,r_118_74_74,r_62_33_64,r_62_33_64,1.0,98,162,64,42
9,r_36_9_69,r_92_34_192,r_44_131_90,r_44_131_90,0.81,2,92,90,42
36,r_119_35_44,r_1_56_168,seq101,r_119_35_44,0.97,0,44,44,42
45,r_149_114_60,r_122_111_122,r_51_129_25,r_149_114_60,0.96,-3,57,60,42
18,r_78_106_45,r_5_17_189,seq123,r_78_106_45,0.98,-2,43,45,42
46,r_69_64_21,r_79_66_72,seq145,r_69_64_21,0.89,0,21,21,42
15,r_108_133_51,seq104,r_119_35_44,r_108_133_51,0.96,0,51,51,42
3,r_44_131_90,r_107_71_132,r_36_9_69,r_44_131_90,0.62,0,90,90,42
42,r_94_100_26,r_0_109_4,seq31,r_94_100_26,1.0,-1,25,26,42
8,r_98_40_110,r_55_6_28,seq50,r_98_40_110,0.76,2,112,110,42
88,seq91,r_95_115_128,r_113_147_46,r_113_147_46,0.76,-1,45,46,42
4,r_42_70_58,r_32_141_126,r_117_7_2,r_42_70_58,0.89,4,62,58,42
0,r_95_115_128,seq46,r_51_129_25,r_95_115_128,0.87,0,128,128,42
11,r_124_58_70,r_26_38_108,r_118_74_74,r_124_58_70,1.0,0,70,70,42
1,r_41_112_62,r_78_106_45,seq68,r_41_112_62,0.91,2,64,62,42
13,r_5_17_189,r_45_84_133,r_98_40_110,r_5_17_189,0.88,-56,133,189,42
20,r_10_80_11,r_130_138_103,seq88,r_10_80_11,0.95,0,11,11,42
48,r_11_97_97,r_92_34_192,seq14,r_11_97_97,0.93,0,97,97,42
6,r_89_19_109,r_146_103_155,seq116,r_89_19_109,0.94,2,111,109,42
85,seq142,r_92_34_192,r_146_103_155,r_146_103_155,0.94,5,160,155,42
5,r_93_67_96,r_96_73_154,seq83,r_96_73_154,1.0,0,154,154,42
87,seq88,r_10_80_11,r_26_38_108,r_26_38_108,1.0,0,108,108,42
47,r_76_143_136,r_85_13_118,seq14,r_85_13_118,0.85,0,118,118,42
40,r_26_38_108,r_124_58_70,r_94_100_26,r_124_58_70,0.78,-7,63,70,42
29,r_132_90_123,seq53,r_36_9_69,r_36_9_69,0.88,58,127,69,42
24,r_79_66_72,seq91,r_108_133_51,r_79_66_72,0.99,0,72,72,42
8,r_98_40_110,r_44_131_90,r_55_6_28,r_55_6_28,0.75,1,29,28,42
87,seq88,seq61,r_10_80_11,r_10_80_11,0.95,6,17,11,42
25,r_18_2_141,seq135,r_119_35_44,r_18_2_141,0.65,0,141,141,42
43,r_30_148_112,r_108_133_51,r_124_58_70,r_30_148_112,1.0,0,112,112,42
46,r_69_64_21,seq145,r_118_74_74,r_69_64_21,0.55,31,52,21,42
20,r_10_80_11,seq88,r_96_73_154,r_96_73_154,0.93,11,165,154,42
32,r_146_103_155,seq134,seq142,r_146_103_155,0.83,3,158,155,42
38,r_118_74_74,seq52,r_69_64_21,r_69_64_21,0.95,52,73,21,42
13,r_5_17_189,r_98_40_110,seq3,r_5_17_189,0.61,0,189,189,42
11,r_124_58_70,r_118_74_74,r_30_148_112,r_30_148_112,0.74,8,120,112,42
68,seq49,seq87,r_51_129_25,r_51_129_25,0.91,-2,23,25,42
17,r_62_33_64,seq14,r_118_74_74,r_62_33_64,1.0,0,64,64,42
94,seq110,r_122_111_122,seq59,r_122_111_122,1.0,-4,118,122,42
9,r_36_9_69,seq91,r_92_34_192,r_36_9_69,0.92,0,69,69,42
31,r_55_6_28,r_98_40_110,r_42_70_58,r_55_6_28,0.44,84,112,28,42
22,r_47_127_89,r_30_148_112,seq4,r_47_127_89,1.0,0,89,89,42
40,r_26_38_108,r_94_100_26,seq88,r_26_38_108,1.0,0,108,108,42
49,r_96_73_154,seq123,r_10_80_11,r_96_73_154,0.75,0,154,154,42
7,r_32_141_126,seq3,r_39_48_7,r_32_141_126,0.88,0,126,126,42
44,r_45_84_133,r_5_17_189,seq145,r_45_84_133,0.99,-1,132,133,42
23,r_130_138_103,seq57,seq31,r_130_138_103,1.0,0,103,103,42
43,r_30_148_112,r_47_127_89,r_108_133_51,r_108_133_51,0.96,0,51,51,42
12,r_85_13_118,r_76_143_136,r_42_70_58,r_85_13_118,0.7,0,118,118,42
2,r_113_147_46,r_62_33_64,seq91,r_113_147_46,0.94,-1,45,46,42
17,r_89_32_173,r_122_45_42,r_87_7_10,r_122_45_42,0.65,3,45,42,43
92,seq109,r_86_118_184,seq5,r_86_118_184,1.0,1,185,184,43
14,r_149_22_94,r_89_32_173,seq18,r_149_22_94,0.95,2,96,94,43
1,r_76_63_192,seq106,r_130_102_36,r_76_63_192,0.62,-150,42,192,43
37,r_81_37_102,seq96,seq72,r_81_37_102,0.99,2,104,102,43
59,seq143,r_134_136_117,seq139,r_134_136_117,0.73,1,118,117,43
16,r_134_136_117,seq143,r_121_29_159,r_134_136_117,0.77,1,118,117,43
21,r_108_13_140,r_0_15_154,seq21,r_0_15_154,0.42,-92,62,154,43
45,r_61_93_74,seq42,seq72,r_61_93_74,0.99,-1,73,74,43
86,seq98,r_56_125_120,r_38_62_3,r_56_125_120,0.82,-73,47,120,43
19,r_30_126_61,r_100_41_174,seq106,r_30_126_61,1.0,0,61,61,43
8,r_23_145_18,r_9_55_169,seq147,r_23_145_18,1.0,0,18,18,43
2,r_104_20_49,r_47_35_127,seq52,r_104_20_49,1.0,0,49,49,43
5,r_9_55_169,r_85_70_39,seq52,r_85_70_39,0.98,-2,37,39,43
49,r_43_140_158,r_130_102_36,r_31_117_12,r_43_140_158,0.87,-147,11,158,43
0,r_121_29_159,r_130_102_36,r_67_68_31,r_130_102_36,0.64,-3,33,36,43
39,r_87_7_10,r_149_22_94,r_146_69_92,r_87_7_10,0.74,86,96,10,43
3,r_65_64_130,r_100_41_174,seq137,r_65_64_130,0.81,1,131,130,43
90,seq106,seq147,r_30_126_61,r_30_126_61,1.0,1,62,61,43
72,seq52,seq79,r_132_135_111,r_132_135_111,1.0,30,141,111,43
40,r_130_102_36,r_121_29_159,r_76_63_192,r_130_102_36,0.92,1,37,36,43
4,r_19_124_63,r_56_125_120,seq116,r_56_125_120,0.88,-51,69,120,43
15,r_56_125_120,seq98,seq113,r_56_125_120,0.99,0,120,120,43
48,r_148_110_96,r_43_140_158,seq96,r_148_110_96,0.48,-32,64,96,43
49,r_43_140_158,r_31_117_12,seq16,r_43_140_158,0.85,0,158,158,43
12,r_31_117_12,r_43_140_158,r_97_44_27,r_43_140_158,0.52,-51,107,158,43
30,r_67_68_31,r_104_20_49,seq71,r_67_68_31,0.97,0,31,31,43
6,r_75_36_77,r_149_22_94,seq79,r_75_36_77,1.0,-4,73,77,43
21,r_108_13_140,seq21,r_121_29_159,r_121_29_159,0.54,-17,142,159,43
5,r_9_55_169,seq52,seq103,r_9_55_169,0.58,0,169,169,43
0,r_121_29_159,r_67_68_31,r_134_136_117,r_134_136_117,0.98,2,119,117,43
27,r_91_51_93,r_134_136_117,r_149_22_94,r_91_51_93,0.92,0,93,93,43
41,r_128_82_20,r_75_36_77,r_8_95_9,r_128_82_20,0.88,3,23,20,43
36,r_122_45_42,r_89_32_173,r_12_1_46,r_122_45_42,0.86,3,45,42,43
47,r_90_48_143,r_133_27_157,seq53,r_133_27_157,0.51,-14,143,157,43
67,seq34,seq18,r_40_74_13,r_40_74_13,0.61,16,29,13,43
18,r_26_17_168,seq3,r_149_22_94,r_26_17_168,0.55,1,169,168,43
25,r_100_41_174,seq4,r_80_14_175,r_100_41_174,0.53,5,179,174,43
33,r_131_88_118,r_46_119_191,seq138,r_131_88_118,0.61,0,118,118,43
95,seq113,r_57_120_57,seq73,r_57_120_57,0.99,-24,33,57,43
38,r_132_135_111,seq147,seq52,r_132_135_111,0.95,0,111,111,43
34,r_133_27_157,seq60,r_149_22_94,r_133_27_157,0.57,7,164,157,43
26,r_57_120_57,seq113,seq39,r_57_120_57,1.0,0,57,57,43
60,seq16,seq147,r_43_140_158,r_43_140_158,0.66,25,183,158,43
24,r_40_74_13,r_121_29_159,seq34,r_40_74_13,0.78,0,13,13,43
39,r_87_7_10,r_31_117_12,r_149_22_94,r_87_7_10,0.6,5,15,10,43
9,r_0_15_154,r_86_118_184,r_67_68_31,r_86_118_184,0.84,-29,155,184,43
32,r_8_95_9,seq137,seq6,r_8_95_9,0.98,2,11,9,43
22,r_83_115_181,seq72,r_90_48_143,r_90_48_143,0.76,42,185,143,43
12,r_31_117_12,r_87_7_10,r_43_140_158,r_31_117_12,0.66,3,15,12,43
11,r_12_1_46,r_133_27_157,r_122_45_42,r_12_1_46,0.98,-1,45,46,43
43,r_85_70_39,r_9_55_169,seq25,r_85_70_39,1.0,0,39,39,43
44,r_24_94_99,r_81_37_102,r_8_95_9,r_24_94_99,1.0,0,99,99,43
20,r_97_44_27,r_77_10_197,r_31_117_12,r_97_44_27,0.98,2,29,27,43
23,r_80_14_175,seq105,r_100_41_174,r_100_41_174,0.76,5,179,174,43
54,seq6,r_46_119_191,r_8_95_9,r_8_95_9,0.96,20,29,9,43
17,r_89_32_173,r_87_7_10,r_12_1_46,r_89_32_173,0.65,3,176,173,43
10,r_129_78_11,r_0_15_154,seq4,r_129_78_11,0.98,0,11,11,43
35,r_146_69_92,seq52,r_87_7_10,r_146_69_92,0.82,2,94,92,43
31,r_58_59_24,r_83_115_181,seq49,r_58_59_24,0.71,-5,19,24,43
95,seq113,seq73,r_56_125_120,r_56_125_120,1.0,4,124,120,43
84,seq96,r_81_37_102,r_148_110_96,r_81_37_102,0.69,3,105,102,43
36,r_68_103_68,r_117_123_115,seq141,r_68_103_68,0.92,7,75,68,44
26,r_49_69_44,seq23,seq67,r_49_69_44,0.99,0,44,44,44
14,r_48_108_162,seq141,r_53_42_2,r_48_108_162,0.73,1,163,162,44
53,seq6,seq79,r_94_31_131,r_94_31_131,0.79,54,185,131,44
43,r_62_97_72,r_129_4_80,r_114_26_70,r_62_97_72,0.98,1,73,72,44
55,seq9,r_149_29_158,seq143,r_149_29_158,0.84,0,158,158,44
16,r_133_2_151,r_142_39_104,r_53_42_2,r_142_39_104,0.97,1,105,104,44
21,r_122_106_130,seq131,seq134,r_122_106_130,0.66,2,132,130,44
1,r_12_38_182,seq85,r_0_109_59,r_12_38_182,0.37,1,183,182,44
49,r_82_7_57,seq1,seq141,r_82_7_57,0.93,-4,53,57,44
5,r_61_102_143,seq3,r_138_83_30,r_61_102_143,0.82,1,144,143,44
46,r_53_42_2,r_77_135_120,r_48_108_162,r_48_108_162,0.66,1,163,162,44
35,r_107_148_34,seq25,seq136,r_107_148_34,0.99,2,36,34,44
31,r_22_41_16,seq118,r_86_34_99,r_86_34_99,0.88,0,99,99,44
41,r_73_88_170,seq85,r_0_109_59,r_73_88_170,0.56,0,170,170,44
89,seq101,r_27_144_129,seq104,r_27_144_129,1.0,0,129,129,44
3,r_74_130_62,r_129_4_80,seq131,r_74_130_62,0.7,0,62,62,44
28,r_132_33_42,seq25,seq139,r_132_33_42,1.0,0,42,42,44
72,seq134,seq136,r_122_106_130,r_122_106_130,0.9,2,132,130,44
4,r_86_34_99,seq139,r_22_41_16,r_86_34_99,0.97,0,99,99,44
0,r_0_109_59,seq92,r_28_32_56,r_0_109_59,0.97,3,62,59,44
20,r_117_123_115,seq89,seq104,r_117_123_115,0.97,0,115,115,44
13,r_114_26_70,seq78,r_62_97_72,r_114_26_70,1.0,5,75,70,44
15,r_129_4_80,r_10_19_97,r_15_127_10,r_129_4_80,0.98,7,87,80,44
6,r_55_84_65,seq95,seq131,r_55_84_65,1.0,1,66,65,44
29,r_15_127_10,r_82_7_57,seq78,r_15_127_10,1.0,0,10,10,44
27,r_45_18_105,seq9,seq67,r_45_18_105,0.87,1,106,105,44
12,r_28_32_56,r_122_106_130,seq139,r_28_32_56,0.99,0,56,56,44
2,r_149_29_158,seq9,r_80_13_21,r_149_29_158,0.69,0,158,158,44
67,seq136,r_76_20_159,r_107_148_34,r_107_148_34,0.91,-3,31,34,44
40,r_11_21_165,seq90,r_149_29_158,r_11_21_165,0.53,1,166,165,44
18,r_10_19_97,r_129_4_80,r_28_32_56,r_10_19_97,1.0,-10,87,97,44
63,seq25,r_107_148_34,seq1,r_107_148_34,0.99,2,36,34,44
25,r_142_39_104,r_133_2_151,seq1,r_142_39_104,0.85,1,105,104,44
33,r_59_116_126,r_11_21_165,seq118,r_59_116_126,0.8,1,127,126,44
47,r_47_16_49,seq95,r_30_50_107,r_30_50_107,1.0,23,130,107,44
50,seq1,seq25,r_142_39_104,r_142_39_104,0.98,-1,103,104,44
58,seq141,r_30_50_107,r_82_7_57,r_82_7_57,0.5,50,107,57,44
61,seq131,r_100_17_161,r_74_130_62,r_74_130_62,0.95,67,129,62,44
32,r_100_17_161,seq131,r_0_109_59,r_100_17_161,0.49,2,163,161,44
38,r_30_50_107,seq141,r_47_16_49,r_30_50_107,0.71,0,107,107,44
69,seq54,r_44_105_45,seq23,r_44_105_45,0.96,-7,38,45,44
34,r_128_36_95,seq140,seq9,r_128_36_95,0.84,8,103,95,44
7,r_94_31_131,r_76_20_159,seq8,r_76_20_159,0.83,-9,150,159,44
17,r_27_144_129,seq101,r_62_97_72,r_27_144_129,0.77,0,129,129,44
94,seq118,r_24_72_101,r_52_146_194,r_24_72_101,1.0,-4,97,101,44
9,r_24_72_101,seq118,seq141,r_24_72_101,0.98,-1,100,101,44
47,r_47_16_49,r_63_98_139,seq95,r_47_16_49,0.64,0,49,49,44
22,r_63_98_139,seq67,r_80_13_21,r_63_98_139,0.84,0,139,139,44
7,r_94_31_131,r_11_21_165,r_76_20_159,r_94_31_131,0.64,1,132,131,44
44,r_87_14_135,r_12_38_182,r_80_13_21,r_87_14_135,0.87,0,135,135,44
23,r_77_135_120,r_53_42_2,r_30_50_107,r_30_50_107,0.98,21,128,107,44
87,seq95,seq136,r_47_16_49,r_47_16_49,1.0,6,55,49,44
82,seq85,r_12_38_182,r_94_31_131,r_94_31_131,0.75,52,183,131,44
11,r_44_105_45,r_117_123_115,r_138_83_30,r_44_105_45,0.75,1,46,45,44
16,r_133_2_151,r_53_42_2,seq3,r_133_2_151,1.0,0,151,151,44
18,r_132_114_59,seq1,r_18_20_43,r_132_114_59,1.0,0,59,59,45
36,r_117_83_182,r_101_47_198,seq21,r_117_83_182,0.48,0,182,182,45
41,r_107_15_17,seq103,seq98,r_107_15_17,1.0,0,17,17,45
14,r_48_106_132,r_46_34_86,r_37_109_35,r_48_106_132,0.92,-55,77,132,45
8,r_133_147_73,r_11_62_40,seq137,r_133_147_73,1.0,1,74,73,45
43,r_135_112_121,seq59,r_108_113_22,r_135_112_121,0.91,1,122,121,45
83,seq69,r_119_148_187,seq52,r_119_148_187,0.83,2,189,187,45
55,seq137,r_77_122_57,r_140_39_19,r_77_122_57,0.81,-14,43,57,45
76,seq56,r_92_22_171,r_9_138_165,r_9_138_165,0.68,2,167,165,45
14,r_48_106_132,r_37_109_35,seq137,r_48_106_132,1.0,0,132,132,45
16,r_140_39_19,r_32_27_155,seq137,r_140_39_19,0.95,0,19,19,45
21,r_46_34_86,r_48_106_132,r_77_122_57,r_46_34_86,1.0,0,86,86,45
1,r_37_109_35,r_48_106_132,seq67,r_48_106_132,0.97,0,132,132,45
46,r_91_131_93,seq17,r_6_78_99,r_91_131_93,0.52,8,101,93,45
42,r_63_51_135,seq12,seq103,r_63_51_135,0.88,1,136,135,45
45,r_141_124_115,seq142,seq137,r_141_124_115,0.41,2,117,115,45
24,r_108_113_22,seq17,r_135_112_121,r_135_112_121,0.91,2,123,121,45
5,r_71_14_21,seq85,r_75_105_164,r_71_14_21,0.81,4,25,21,45
66,seq26,r_102_134_176,seq80,r_102_134_176,0.88,0,176,176,45
1,r_37_109_35,seq13,r_48_106_132,r_37_109_35,0.98,0,35,35,45
31,r_64_120_108,r_102_134_176,seq143,r_64_120_108,0.95,0,108,108,45
89,seq88,r_6_78_99,r_31_144_82,r_6_78_99,0.93,0,99,99,45
3,r_95_136_124,seq149,r_87_57_140,r_95_136_124,0.99,0,124,124,45
10,r_32_27_155,seq8,r_95_136_124,r_95_136_124,0.99,32,156,124,45
26,r_70_139_126,seq24,seq30,r_70_139_126,1.0,0,126,126,45
78,seq59,r_135_112_121,seq13,r_135_112_121,0.93,1,122,121,45
11,r_126_123_64,r_28_35_94,seq137,r_126_123_64,1.0,1,65,64,45
20,r_6_78_99,seq88,r_91_131_93,r_6_78_99,0.89,0,99,99,45
13,r_111_60_65,r_4_76_90,r_132_114_59,r_4_76_90,0.87,-25,65,90,45
15,r_125_40_181,r_31_144_82,r_77_122_57,r_77_122_57,1.0,124,181,57,45
85,seq81,r_89_116_184,r_119_148_187,r_119_148_187,0.63,2,189,187,45
99,seq149,r_95_136_124,seq103,r_95_136_124,1.0,0,124,124,45
57,seq13,r_37_109_35,seq59,r_37_109_35,0.92,0,35,35,45
47,r_96_43_110,r_119_148_187,seq100,r_96_43_110,0.97,0,110,110,45
24,r_108_113_22,r_101_47_198,seq17,r_108_113_22,0.98,0,22,22,45
40,r_4_76_90,seq58,r_71_14_21,r_4_76_90,0.67,1,91,90,45
29,r_9_138_165,seq66,seq56,r_9_138_165,0.76,0,165,165,45
33,r_92_22_171,seq58,r_77_122_57,r_77_122_57,1.0,45,102,57,45
61,seq17,r_96_43_110,r_10_23_45,r_96_43_110,1.0,-50,60,110,45
32,r_3_130_118,seq58,seq80,r_3_130_118,0.82,-4,114,118,45
35,r_11_62_40,r_133_147_73,seq58,r_133_147_73,1.0,-29,44,73,45
30,r_18_20_43,seq103,seq66,r_18_20_43,1.0,0,43,43,45
17,r_87_57_140,seq88,r_95_136_124,r_95_136_124,0.52,16,140,124,45
94,seq100,r_129_0_188,r_77_122_57,r_77_122_57,1.0,131,188,57,45
22,r_75_105_164,r_119_148_187,r_4_76_90,r_4_76_90,0.96,89,179,90,45
7,r_89_116_184,seq81,r_75_105_164,r_75_105_164,0.55,22,186,164,45
44,r_102_134_176,seq26,r_126_123_64,r_126_123_64,1.0,112,176,64,45
23,r_94_54_47,seq142,seq69,r_94_54_47,1.0,0,47,47,45
82,seq67,r_119_148_187,r_37_109_35,r_119_148_187,0.57,-51,136,187,45
79,seq61,r_41_127_158,seq21,r_41_127_158,1.0,-4,154,158,45
6,r_77_122_57,r_70_139_126,seq8,r_77_122_57,0.58,0,57,57,45
12,r_99_2_72,r_119_148_187,seq103,r_99_2_72,1.0,0,72,72,45
30,r_134_32_13,seq142,r_119_52_66,r_119_52_66,0.79,1,67,66,46
12,r_98_112_48,r_7_88_121,seq13,r_98_112_48,1.0,-1,47,48,46
37,r_1_58_15,r_73_72_53,r_62_53_10,r_1_58_15,0.94,1,16,15,46
10,r_65_76_78,r_45_89_30,r_126_77_87,r_126_77_87,0.94,4,91,87,46
39,r_85_40_199,r_80_25_168,r_107_50_94,r_107_50_94,1.0,0,94,94,46
1,r_7_88_121,seq23,r_115_22_166,r_7_88_121,0.79,7,128,121,46
5,r_12_4_158,seq27,r_73_72_53,r_12_4_158,0.71,5,163,158,46
46,r_126_77_87,seq96,r_65_76_78,r_126_77_87,0.99,1,88,87,46
42,r_119_52_66,seq17,r_134_32_13,r_119_52_66,0.96,0,66,66,46
10,r_65_76_78,seq68,r_45_89_30,r_65_76_78,0.92,0,78,78,46
18,r_45_89_30,r_121_70_188,seq103,r_45_89_30,0.99,-1,29,30,46
80,seq143,r_93_51_143,seq148,r_93_51_143,0.89,-51,92,143,46
45,r_18_64_79,seq78,seq23,r_18_64_79,1.0,0,79,79,46
16,r_16_24_42,r_31_74_91,r_0_29_77,r_16_24_42,1.0,0,42,42,46
24,r_11_26_62,r_102_109_140,r_63_127_64,r_102_109_140,1.0,1,141,140,46
20,r_66_123_43,r_84_21_130,r_45_89_30,r_66_123_43,0.49,0,43,43,46
76,seq49,seq83,r_98_112_48,r_98_112_48,1.0,84,132,48,46
31,r_84_21_130,seq106,r_3_144_65,r_84_21_130,0.95,0,130,130,46
41,r_36_101_134,seq103,seq139,r_36_101_134,0.95,0,134,134,46
4,r_99_113_172,seq136,r_61_5_22,r_61_5_22,0.67,154,176,22,46
29,r_73_72_53,seq68,seq125,r_73_72_53,1.0,0,53,53,46
78,seq68,r_85_40_199,r_14_41_124,r_14_41_124,0.96,4,128,124,46
0,r_102_109_140,r_63_127_64,r_11_26_62,r_11_26_62,1.0,1,63,62,46
11,r_121_70_188,seq35,r_99_113_172,r_99_113_172,0.68,18,190,172,46
48,r_80_25_168,r_85_40_199,r_3_144_65,r_80_25_168,0.51,-4,164,168,46
19,r_61_5_22,r_54_133_104,seq106,r_61_5_22,0.98,0,22,22,46
99,seq125,r_95_132_181,r_12_4_158,r_12_4_158,0.98,25,183,158,46
34,r_67_124_16,r_99_113_172,r_85_40_199,r_67_124_16,0.99,0,16,16,46
0,r_102_109_140,r_11_26_62,seq8,r_102_109_140,0.98,0,140,140,46
27,r_95_132_181,r_128_117_197,r_63_127_64,r_63_127_64,0.78,119,183,64,46
2,r_14_41_124,r_138_59_139,seq68,r_14_41_124,0.83,3,127,124,46
47,r_114_137_80,r_85_40_199,r_61_5_22,r_114_137_80,0.96,0,80,80,46
24,r_11_26_62,r_7_88_121,r_102_109_140,r_11_26_62,1.0,0,62,62,46
25,r_48_149_167,seq33,r_18_64_79,r_48_149_167,0.55,3,170,167,46
43,r_55_19_33,r_48_149_167,r_54_133_104,r_54_133_104,0.98,14,118,104,46
38,r_93_51_143,seq143,seq33,r_93_51_143,0.54,5,148,143,46
81,seq78,r_18_64_79,r_0_29_77,r_18_64_79,1.0,-3,76,79,46
17,r_118_69_187,r_63_127_64,r_18_64_79,r_18_64_79,0.81,108,187,79,46
49,r_57_60_186,r_102_109_140,seq37,r_57_60_186,0.79,0,186,186,46
9,r_54_133_104,seq135,r_55_19_33,r_54_133_104,0.99,1,105,104,46
96,seq120,r_90_75_180,r_3_144_65,r_3_144_65,0.9,115,180,65,46
72,seq42,r_107_50_94,seq10,r_107_50_94,1.0,-35,59,94,46
28,r_79_39_141,seq135,seq111,r_79_39_141,0.61,0,141,141,46
49,r_57_60_186,r_105_108_150,r_102_109_140,r_57_60_186,0.66,-36,150,186,46
43,r_55_19_33,r_36_101_134,r_48_149_167,r_55_19_33,1.0,0,33,33,46
7,r_81_100_173,seq139,r_63_127_64,r_81_100_173,0.59,0,173,173,46
35,r_105_108_150,r_57_60_186,seq33,r_57_60_186,0.51,-36,150,186,46
23,r_9_34_39,r_79_39_141,r_94_131_5,r_9_34_39,1.0,0,39,39,46
93,seq103,r_109_92_93,seq125,r_109_92_93,0.99,2,95,93,47
15,r_66_46_49,r_67_72_156,seq47,r_66_46_49,0.99,0,49,49,47
30,r_61_140_65,r_90_14_112,seq122,r_61_140_65,0.93,1,66,65,47
36,r_91_88_76,r_3_137_163,seq142,r_91_88_76,1.0,0,76,76,47
14,r_67_72_156,r_29_89_196,seq87,r_29_89_196,0.41,-40,156,196,47
20,r_75_105_169,seq57,r_144_76_40,r_144_76_40,0.76,23,63,40,47
13,r_145_114_51,r_36_51_62,r_8_2_34,r_145_114_51,0.97,1,52,51,47
37,r_8_2_34,r_75_105_169,seq58,r_8_2_34,0.86,1,35,34,47
23,r_12_16_32,seq95,seq21,r_12_16_32,0.91,0,32,32,47
16,r_90_14_112,r_106_149_91,r_32_53_95,r_90_14_112,0.97,2,114,112,47
39,r_84_42_98,seq47,seq141,r_84_42_98,0.97,0,98,98,47
1,r_129_131_149,seq122,r_11_139_97,r_129_131_149,0.69,-1,148,149,47
46,r_116_54_73,seq65,r_113_52_42,r_116_54_73,1.0,0,73,73,47
42,r_99_120_96,r_38_13_170,r_12_16_32,r_38_13_170,0.83,-75,95,170,47
19,r_29_89_196,r_67_72_156,r_145_114_51,r_145_114_51,1.0,105,156,51,47
20,r_75_105_169,r_144_76_40,r_78_135_60,r_144_76_40,0.63,49,89,40,47
31,r_43_98_118,r_39_19_182,r_66_46_49,r_66_46_49,0.94,69,118,49,47
41,r_126_107_148,r_106_149_91,seq80,r_106_149_91,0.72,59,150,91,47
20,r_75_105_169,r_78_135_60,r_67_72_156,r_75_105_169,0.7,-1,168,169,47
10,r_32_53_95,r_10_50_192,r_90_14_112,r_90_14_112,1.0,44,156,112,47
26,r_37_9_191,r_4_127_133,seq34,r_4_127_133,0.42,3,136,133,47
78,seq65,r_116_54_73,seq142,r_116_54_73,0.97,0,73,73,47
0,r_106_149_91,r_126_107_148,r_77_146_82,r_77_146_82,1.0,17,99,82,47
11,r_94_23_142,seq62,seq34,r_94_23_142,0.74,2,144,142,47
98,seq122,r_129_131_149,r_61_140_65,r_61_140_65,1.0,83,148,65,47
6,r_11_139_97,seq58,seq62,r_11_139_97,0.64,13,110,97,47
21,r_117_110_11,r_10_50_192,seq83,r_117_110_11,0.87,1,12,11,47
26,r_37_9_191,seq34,r_145_114_51,r_37_9_191,0.52,-36,155,191,47
14,r_67_72_156,seq87,r_75_105_169,r_75_105_169,0.77,1,170,169,47
2,r_144_76_40,seq118,r_8_2_34,r_144_76_40,0.83,4,44,40,47
18,r_109_92_93,seq103,r_77_146_82,r_109_92_93,0.76,2,95,93,47
29,r_56_20_131,r_10_50_192,r_108_112_74,r_56_20_131,0.76,0,131,131,47
25,r_4_127_133,r_37_9_191,r_11_139_97,r_4_127_133,0.92,0,133,133,47
65,seq34,seq136,r_94_23_142,r_94_23_142,0.99,0,142,142,47
20,r_75_105_169,r_8_2_34,seq57,r_8_2_34,0.92,4,38,34,47
32,r_78_135_60,seq17,seq97,r_78_135_60,0.74,0,60,60,47
38,r_77_146_82,r_4_127_133,r_106_149_91,r_77_146_82,1.0,0,82,82,47
45,r_69_6_38,r_38_13_170,seq104,r_69_6_38,0.86,0,38,38,47
48,r_113_52_42,r_15_7_158,seq83,r_113_52_42,1.0,2,44,42,47
34,r_22_31_132,seq83,r_32_53_95,r_22_31_132,0.85,0,132,132,47
4,r_124_64_57,seq143,seq47,r_124_64_57,0.98,0,57,57,47
60,seq18,r_15_7_158,seq44,r_15_7_158,0.93,0,158,158,47
17,r_71_147_168,seq102,seq18,r_71_147_168,0.42,0,168,168,47
9,r_128_81_179,r_100_30_1,r_3_137_163,r_100_30_1,0.4,179,180,1,47
22,r_121_93_55,seq34,r_100_30_1,r_121_93_55,0.99,0,55,55,47
91,seq101,r_3_137_163,r_67_72_156,r_3_137_163,0.52,1,164,163,47
56,seq141,seq134,r_84_42_98,r_84_42_98,1.0,2,100,98,47
44,r_15_7_158,seq18,seq118,r_15_7_158,0.67,0,158,158,47
27,r_133_123_39,r_138_79_136,seq102,r_133_123_39,1.0,0,39,39,47
65,seq34,r_121_93_55,seq136,r_121_93_55,1.0,0,55,55,47
51,seq130,r_72_0_169,seq9,r_72_0_169,0.66,-20,149,169,48
14,r_19_7_135,seq103,seq96,r_19_7_135,0.99,0,135,135,48
37,r_18_111_123,seq65,seq113,r_18_111_123,0.83,3,126,123,48
16,r_125_70_106,seq96,r_127_49_25,r_125_70_106,0.58,1,107,106,48
21,r_1_85_88,seq96,r_78_27_89,r_1_85_88,0.99,2,90,88,48
39,r_145_106_183,seq107,r_82_105_149,r_145_106_183,0.25,4,187,183,48
5,r_89_118_131,seq121,r_148_54_9,r_89_118_131,0.87,0,131,131,48
42,r_40_43_164,seq133,seq38,r_40_43_164,0.47,-2,162,164,48
45,r_29_68_73,seq6,seq51,r_29_68_73,1.0,0,73,73,48
15,r_148_54_9,seq96,r_89_118_131,r_89_118_131,0.93,-1,130,131,48
66,seq38,r_80_25_189,r_149_77_85,r_149_77_85,1.0,99,184,85,48
60,seq137,seq121,r_116_92_28,r_116_92_28,1.0,0,28,28,48
41,r_39_97_158,seq107,r_116_92_28,r_116_92_28,0.95,130,158,28,48
6,r_127_49_25,r_40_43_164,seq115,r_127_49_25,0.68,6,31,25,48
3,r_120_117_57,seq8,seq14,r_120_117_57,0.87,3,60,57,48
15,r_148_54_9,r_88_93_111,seq96,r_148_54_9,0.84,2,11,9,48
0,r_26_138_139,seq14,r_29_68_73,r_26_138_139,0.58,2,141,139,48
11,r_75_132_174,r_80_25_189,r_89_118_131,r_80_25_189,0.35,-13,176,189,48
22,r_23_24_51,seq15,seq139,r_23_24_51,1.0,2,53,51,48
13,r_83_58_145,seq46,r_18_111_123,r_18_111_123,0.6,-5,118,123,48
48,r_78_27_89,seq14,r_1_85_88,r_78_27_89,1.0,1,90,89,48
26,r_37_28_30,seq79,seq115,r_37_28_30,1.0,1,31,30,48
2,r_146_21_31,r_147_124_197,r_140_119_112,r_140_119_112,1.0,13,125,112,48
6,r_127_49_25,r_1_85_88,r_125_70_106,r_125_70_106,0.56,32,138,106,48
8,r_144_110_41,r_125_70_106,seq6,r_144_110_41,1.0,0,41,41,48
27,r_80_25_189,seq38,r_82_105_149,r_80_25_189,0.24,0,189,189,48
97,seq115,seq141,r_37_28_30,r_37_28_30,0.99,24,54,30,48
1,r_42_90_13,r_57_17_32,seq15,r_42_90_13,0.93,-1,12,13,48
6,r_127_49_25,seq115,r_1_85_88,r_1_85_88,1.0,-10,78,88,48
38,r_116_92_28,seq6,seq137,r_116_92_28,0.95,2,30,28,48
24,r_13_86_101,r_60_2_173,seq103,r_60_2_173,0.45,-72,101,173,48
33,r_149_77_85,r_26_138_139,seq38,r_149_77_85,0.95,0,85,85,48
47,r_31_76_175,seq11,r_89_118_131,r_89_118_131,0.8,0,131,131,48
13,r_83_58_145,r_18_111_123,seq107,r_83_58_145,0.99,0,145,145,48
70,seq48,r_125_70_106,r_98_109_103,r_98_109_103,0.86,4,107,103,48
32,r_50_66_130,seq15,seq95,r_50_66_130,0.56,1,131,130,48
47,r_31_76_175,r_89_118_131,seq128,r_31_76_175,0.91,0,175,175,48
34,r_131_99_102,seq108,seq121,r_131_99_102,0.68,0,102,102,48
2,r_146_21_31,r_98_109_103,r_147_124_197,r_146_21_31,0.93,0,31,31,48
10,r_57_17_32,seq46,seq133,r_57_17_32,0.95,3,35,32,48
17,r_72_0_169,seq130,r_81_142_5,r_72_0_169,0.43,7,176,169,48
75,seq139,r_40_43_164,r_23_24_51,r_23_24_51,0.93,2,53,51,48
9,r_140_119_112,r_80_25_189,r_146_21_31,r_140_119_112,0.74,2,114,112,48
28,r_98_109_103,seq55,seq48,r_98_109_103,1.0,0,103,103,48
35,r_35_36_26,r_3_12_53,seq103,r_35_36_26,0.93,2,28,26,48
4,r_100_62_35,seq122,seq63,r_100_62_35,0.7,0,35,35,48
49,r_129_135_147,seq9,r_120_117_57,r_129_135_147,0.79,0,147,147,48
7,r_60_2_173,r_123_4_153,r_75_132_174,r_123_4_153,1.0,0,153,153,48
44,r_123_4_153,r_60_2_173,r_83_58_145,r_123_4_153,0.73,0,153,153,48
23,r_88_93_111,r_18_111_123,r_147_124_197,r_88_93_111,0.71,3,114,111,48
79,seq65,r_18_111_123,r_81_142_5,r_18_111_123,0.88,3,126,123,48
12,r_45_143_84,seq63,r_42_90_13,r_45_143_84,0.65,1,85,84,48
84,seq84,r_20_16_118,r_61_30_187,r_20_16_118,1.0,0,118,118,48
27,r_146_10_120,seq135,seq130,r_146_10_120,0.99,1,121,120,49
30,r_97_93_90,r_64_54_95,seq9,r_64_54_95,0.99,1,96,95,49
92,seq109,r_127_0_93,r_96_40_4,r_127_0_93,1.0,-4,89,93,49
14,r_138_43_98,r_56_71_155,seq84,r_138_43_98,0.85,-5,93,98,49
8,r_36_41_113,seq114,r_39_104_74,r_39_104_74,0.67,39,113,74,49
11,r_17_131_29,seq65,seq81,r_17_131_29,1.0,0,29,29,49
36,r_79_63_157,seq20,r_117_49_22,r_117_49_22,1.0,2,24,22,49
37,r_90_89_71,r_127_0_93,seq1,r_90_89_71,0.93,-1,70,71,49
54,seq135,r_44_5_46,r_14_87_144,r_14_87_144,1.0,0,144,144,49
71,seq57,r_13_148_170,r_39_104_74,r_39_104_74,1.0,7,81,74,49
21,r_64_54_95,r_97_93_90,r_134_75_72,r_64_54_95,1.0,1,96,95,49
39,r_126_115_179,seq76,r_133_21_172,r_133_21_172,0.58,8,180,172,49
1,r_30_28_148,r_15_12_2,r_134_75_72,r_30_28_148,1.0,1,149,148,49
5,r_25_3_161,seq100,r_138_43_98,r_25_3_161,0.77,0,161,161,49
42,r_141_107_92,seq61,seq20,r_141_107_92,1.0,0,92,92,49
18,r_33_42_35,r_27_48_42,seq84,r_33_42_35,0.99,0,35,35,49
45,r_51_6_149,seq84,r_117_49_22,r_51_6_149,0.68,0,149,149,49
34,r_72_113_49,seq9,r_15_12_2,r_72_113_49,1.0,0,49,49,49
43,r_14_87_144,r_2_88_70,r_52_95_20,r_14_87_144,0.58,-124,20,144,49
76,seq67,seq65,r_73_136_40,r_73_136_40,0.92,22,62,40,49
7,r_142_82_131,r_133_21_172,seq76,r_142_82_131,0.56,51,182,131,49
31,r_78_35_139,r_98_60_135,r_134_75_72,r_134_75_72,1.0,-1,71,72,49
10,r_133_21_172,r_53_140_103,seq130,r_53_140_103,0.77,1,104,103,49
26,r_119_8_134,r_78_35_139,r_120_69_129,r_120_69_129,0.58,5,134,129,49
9,r_2_88_70,r_44_5_46,r_127_0_93,r_127_0_93,1.0,0,93,93,49
4,r_108_66_167,seq118,r_144_125_54,r_108_66_167,0.54,0,167,167,49
46,r_145_7_43,r_72_113_49,r_52_95_20,r_145_7_43,1.0,0,43,43,49
20,r_147_62_143,seq128,r_129_143_39,r_147_62_143,0.89,0,143,143,49
17,r_73_136_40,seq24,seq67,r_73_136_40,0.99,1,41,40,49
13,r_134_75_72,seq135,r_78_35_139,r_134_75_72,0.75,-2,70,72,49
35,r_4_74_36,r_122_11_137,seq61,r_4_74_36,1.0,1,37,36,49
3,r_27_48_42,seq46,seq114,r_27_48_42,0.95,-3,39,42,49
41,r_52_95_20,seq61,r_14_87_144,r_52_95_20,1.0,0,20,20,49
13,r_134_75_72,r_78_35_139,r_64_54_95,r_78_35_139,0.88,0,139,139,49
36,r_79_63_157,r_117_49_22,r_144_125_54,r_117_49_22,0.73,136,158,22,49
19,r_44_5_46,r_146_10_120,r_2_88_70,r_44_5_46,0.95,33,79,46,49
27,r_146_10_120,r_39_104_74,seq135,r_39_104_74,1.0,-1,73,74,49
48,r_117_49_22,r_108_66_167,r_79_63_157,r_117_49_22,1.0,0,22,22,49
2,r_122_11_137,seq137,r_98_60_135,r_122_11_137,0.86,-1,136,137,49
41,r_52_95_20,r_14_87_144,r_145_7_43,r_14_87_144,0.74,0,144,144,49
47,r_56_71_155,r_138_43_98,r_90_89_71,r_56_71_155,0.52,-84,71,155,49
40,r_111_37_151,seq100,r_138_43_98,r_111_37_151,0.81,2,153,151,49
29,r_53_140_103,r_133_21_172,seq100,r_53_140_103,1.0,1,104,103,49
10,r_133_21_172,seq130,r_142_82_131,r_142_82_131,1.0,1,132,131,49
25,r_13_148_170,seq57,r_108_66_167,r_13_148_170,0.53,0,170,170,49
43,r_14_87_144,r_52_95_20,seq135,r_14_87_144,0.96,0,144,144,49
33,r_112_70_77,r_146_10_120,seq1,r_112_70_77,1.0,2,79,77,49
48,r_117_49_22,r_79_63_157,r_51_6_149,r_51_6_149,0.64,9,158,149,49
47,r_56_71_155,r_90_89_71,seq81,r_56_71_155,1.0,0,155,155,49
0,r_129_143_39,r_64_54_95,seq85,r_64_54_95,0.97,-56,39,95,49
38,r_45_121_162,seq16,r_56_71_155,r_45_121_162,0.73,0,162,162,49
19,r_44_5_46,seq23,r_146_10_120,r_44_5_46,0.74,4,50,46,49
24,r_18_47_53,r_26_99_176,seq55,r_18_47_53,1.0,-2,51,53,49
10,r_133_21_172,r_142_82_131,r_146_10_120,r_133_21_172,0.86,-5,167,172,49
9,r_2_88_70,r_14_87_144,r_44_5_46,r_2_88_70,0.93,1,71,70,49
31,r_78_35_139,r_134_75_72,seq24,r_78_35_139,0.98,0,139,139,49
15,r_144_125_54,seq65,seq22,r_144_125_54,0.99,0,54,54,49
22,r_39_104_74,r_146_10_120,seq57,r_39_104_74,1.0,1,75,74,49
49,r_120_69_129,r_51_6_149,r_119_8_134,r_120_69_129,0.54,6,135,129,49
7,r_142_82_131,seq100,r_133_21_172,r_142_82_131,0.99,0,131,131,49
44,r_98_60_135,r_78_35_139,r_117_49_22,r_98_60_135,0.66,0,135,135,49
23,r_80_77_80,seq76,r_112_70_77,r_80_77_80,0.56,0,80,80,49
30,r_70_112_97,r_97_77_156,r_92_84_7,r_70_112_97,0.97,2,99,97,50
36,r_127_64_181,r_26_93_100,seq100,r_26_93_100,1.0,-19,81,100,50
8,r_129_130_172,r_38_91_137,r_104_59_19,r_129_130_172,0.73,-105,67,172,50
53,seq133,r_2_27_141,seq72,r_2_27_141,1.0,-11,130,141,50
43,r_81_119_106,seq135,seq98,r_81_119_106,1.0,1,107,106,50
37,r_50_28_43,r_114_34_118,r_142_8_126,r_50_28_43,0.82,-19,24,43,50
21,r_2_27_141,seq133,r_143_17_20,r_2_27_141,0.92,0,141,141,50
39,r_106_6_128,seq67,r_51_115_91,r_51_115_91,0.98,39,130,91,50
18,r_142_8_126,r_131_29_80,r_50_28_43,r_50_28_43,0.63,7,50,43,50
93,seq109,r_90_122_49,r_104_59_19,r_90_122_49,0.81,0,49,49,50
45,r_97_77_156,seq1,r_7_53_12,r_7_53_12,0.61,144,156,12,50
0,r_90_122_49,seq109,seq4,r_90_122_49,1.0,0,49,49,50
32,r_138_110_173,r_51_115_91,seq12,r_138_110_173,0.8,4,177,173,50
19,r_13_10_151,seq125,seq98,r_13_10_151,0.74,16,167,151,50
32,r_138_110_173,seq98,r_51_115_91,r_51_115_91,0.94,0,91,91,50
76,seq63,seq30,r_123_134_95,r_123_134_95,0.84,1,96,95,50
11,r_68_149_21,r_13_10_151,seq74,r_68_149_21,0.84,-8,13,21,50
31,r_107_146_93,seq108,r_5_103_199,r_107_146_93,0.98,1,94,93,50
41,r_51_115_91,r_70_112_97,r_138_110_173,r_51_115_91,0.48,0,91,91,50
67,seq30,seq88,r_142_8_126,r_142_8_126,1.0,19,145,126,50
47,r_52_24_130,r_35_23_193,r_85_78_29,r_52_24_130,0.53,55,185,130,50
10,r_114_34_118,seq22,r_68_149_21,r_114_34_118,1.0,0,118,118,50
26,r_62_116_139,seq126,seq1,r_62_116_139,0.95,0,139,139,50
8,r_129_130_172,r_104_59_19,r_107_146_93,r_107_146_93,0.87,90,183,93,50
4,r_99_36_92,seq135,r_131_29_80,r_99_36_92,1.0,2,94,92,50
78,seq71,r_123_134_95,r_114_34_118,r_114_34_118,1.0,8,126,118,50
12,r_85_78_29,r_92_84_7,seq15,r_85_78_29,0.98,0,29,29,50
20,r_35_23_193,seq60,r_52_24_130,r_52_24_130,0.97,13,143,130,50
13,r_113_95_73,seq15,seq141,r_113_95_73,1.0,0,73,73,50
98,seq125,r_13_10_151,seq1,r_13_10_151,0.72,1,152,151,50
15,r_147_69_133,r_2_27_141,seq79,r_147_69_133,0.67,0,133,133,50
48,r_57_31_74,r_37_136_196,seq74,r_57_31_74,1.0,0,74,74,50
1,r_143_17_20,r_114_34_118,r_96_94_39,r_143_17_20,0.96,39,59,20,50
16,r_7_53_12,r_147_69_133,seq56,r_7_53_12,0.96,0,12,12,50
36,r_127_64_181,seq100,r_147_69_133,r_147_69_133,0.68,51,184,133,50
27,r_33_32_65,r_38_91_137,r_99_36_92,r_99_36_92,1.0,47,139,92,50
50,seq0,r_58_41_157,r_3_124_10,r_3_124_10,0.79,1,11,10,50
47,r_52_24_130,r_5_103_199,r_35_23_193,r_52_24_130,0.92,0,130,130,50
34,r_104_59_19,r_107_146_93,seq109,r_104_59_19,0.81,0,19,19,50
40,r_128_40_121,seq72,r_7_53_12,r_128_40_121,0.97,3,124,121,50
41,r_51_115_91,r_138_110_173,r_106_6_128,r_51_115_91,0.59,37,128,91,50
29,r_102_73_153,r_5_103_199,r_147_69_133,r_147_69_133,0.95,21,154,133,50
22,r_46_145_40,r_37_136_196,seq60,r_46_145_40,1.0,1,41,40,50
24,r_117_25_152,seq101,seq45,r_117_25_152,0.6,0,152,152,50
25,r_26_93_100,r_127_64_181,seq89,r_26_93_100,1.0,0,100,100,50
33,r_38_91_137,r_33_32_65,seq100,r_38_91_137,0.8,2,139,137,50
88,seq98,r_102_73_153,r_81_119_106,r_81_119_106,1.0,4,110,106,50
58,seq14,r_61_139_188,r_104_59_19,r_104_59_19,1.0,169,188,19,50
7,r_3_124_10,r_90_122_49,seq0,r_3_124_10,0.9,1,11,10,50
32,r_138_110_173,r_38_91_137,seq98,r_138_110_173,0.46,-106,67,173,50
38,r_75_11_71,r_117_25_152,seq137,r_75_11_71,0.97,0,71,71,50
17,r_131_29_80,r_142_8_126,r_33_32_65,r_131_29_80,0.75,2,82,80,50
1,r_143_17_20,seq30,r_114_34_118,r_143_17_20,0.97,1,21,20,50
9,r_42_105_81,r_37_136_196,r_57_31_74,r_37_136_196,1.0,-115,81,196,50
37,r_50_28_43,r_142_8_126,seq126,r_142_8_126,0.98,2,128,126,50
28,r_66_140_111,seq141,seq47,r_66_140_111,0.91,0,111,111,50
18,r_142_8_126,r_50_28_43,seq30,r_142_8_126,1.0,2,128,126,50
44,r_16_39_123,seq132,r_114_34_118,r_16_39_123,0.94,1,124,123,50
79,seq72,r_128_40_121,seq133,r_128_40_121,1.0,1,122,121,50
5,r_96_94_39,seq19,r_143_17_20,r_96_94_39,0.99,0,39,39,50
30,r_140_49_101,seq112,seq57,r_140_49_101,1.0,1,102,101,51
73,seq57,r_110_53_197,r_131_108_41,r_131_108_41,1.0,11,52,41,51
36,r_51_12_164,seq141,r_42_45_159,r_42_45_159,0.78,5,164,159,51
53,seq136,r_142_99_141,r_100_94_65,r_100_94_65,0.77,9,74,65,51
38,r_139_70_118,r_46_111_55,seq127,r_139_70_118,1.0,1,119,118,51
43,r_31_30_98,r_3_87_119,seq147,r_31_30_98,1.0,0,98,98,51
37,r_3_87_119,r_13_106_66,r_130_50_72,r_3_87_119,0.85,1,120,119,51
37,r_3_87_119,r_31_30_98,r_13_106_66,r_13_106_66,0.93,32,98,66,51
16,r_39_44_100,r_8_101_193,seq81,r_39_44_100,1.0,0,100,100,51
39,r_64_148_108,r_65_80_168,r_17_56_86,r_17_56_86,0.89,26,112,86,51
1,r_13_106_66,seq55,seq118,r_13_106_66,1.0,0,66,66,51
97,seq124,r_78_122_149,r_37_103_1,r_78_122_149,0.99,2,151,149,51
42,r_88_16_59,seq81,seq104,r_88_16_59,1.0,2,61,59,51
14,r_97_54_157,r_131_108_41,r_83_84_99,r_131_108_41,0.98,9,50,41,51
45,r_142_99_141,r_51_12_164,r_18_82_179,r_142_99_141,0.74,0,141,141,51
19,r_120_144_90,seq6,r_92_76_32,r_120_144_90,1.0,0,90,90,51
66,seq28,r_125_4_80,seq127,r_125_4_80,0.45,4,84,80,51
31,r_134_91_26,r_121_48_129,seq114,r_134_91_26,0.95,-1,25,26,51
41,r_85_71_190,seq15,r_109_9_62,r_109_9_62,1.0,128,190,62,51
40,r_92_76_32,r_46_111_55,seq22,r_92_76_32,0.99,0,32,32,51
10,r_109_9_62,seq137,seq47,r_109_9_62,1.0,1,63,62,51
0,r_130_50_72,seq95,seq43,r_130_50_72,1.0,2,74,72,51
82,seq81,seq145,r_39_44_100,r_39_44_100,1.0,1,101,100,51
13,r_18_82_179,r_67_149_170,r_142_99_141,r_142_99_141,0.66,4,145,141,51
98,seq126,r_38_129_102,seq74,r_38_129_102,1.0,5,107,102,51
15,r_42_45_159,seq89,r_51_12_164,r_51_12_164,0.59,-1,163,164,51
62,seq22,seq147,r_92_76_32,r_92_76_32,1.0,47,79,32,51
27,r_78_122_149,seq124,seq59,r_78_122_149,0.99,2,151,149,51
38,r_139_70_118,seq145,r_46_111_55,r_46_111_55,0.59,10,65,55,51
38,r_139_70_118,seq118,seq145,r_139_70_118,0.61,-74,44,118,51
45,r_142_99_141,r_18_82_179,r_139_70_118,r_18_82_179,0.98,0,179,179,51
14,r_97_54_157,r_83_84_99,r_98_116_196,r_83_84_99,1.0,0,99,99,51
17,r_25_23_51,r_133_132_172,seq136,r_25_23_51,0.93,4,55,51,51
18,r_38_129_102,seq126,r_40_93_13,r_38_129_102,0.98,0,102,102,51
29,r_35_105_109,seq47,r_68_146_44,r_35_105_109,1.0,0,109,109,51
24,r_100_94_65,seq79,seq136,r_100_94_65,1.0,1,66,65,51
25,r_20_29_128,seq127,seq90,r_20_29_128,1.0,0,128,128,51
33,r_83_84_99,seq59,seq79,r_83_84_99,0.99,2,101,99,51
58,seq15,r_85_71_190,r_10_75_30,r_10_75_30,1.0,160,190,30,51
65,seq27,r_2_119_46,r_125_4_80,r_125_4_80,0.79,21,101,80,51
52,seq135,r_5_62_71,seq43,r_5_62_71,0.88,-1,70,71,51
35,r_40_93_13,r_133_132_172,seq21,r_40_93_13,0.99,0,13,13,51
34,r_17_56_86,r_8_101_193,r_46_111_55,r_8_101_193,1.0,-105,88,193,51
60,seq147,seq22,r_31_30_98,r_31_30_98,1.0,8,106,98,51
81,seq79,seq28,r_83_84_99,r_83_84_99,1.0,3,102,99,51
9,r_41_36_163,seq43,r_46_111_55,r_46_111_55,1.0,110,165,55,51
22,r_63_102_92,seq95,seq147,r_63_102_92,1.0,0,92,92,51
46,r_131_108_41,r_97_54_157,seq57,r_131_108_41,0.99,0,41,41,51
49,r_125_4_80,seq28,seq27,r_125_4_80,0.69,4,84,80,51
47,r_72_66_43,seq79,r_37_103_1,r_72_66_43,1.0,1,44,43,51
3,r_46_111_55,r_8_101_193,r_33_128_57,r_46_111_55,1.0,1,56,55,51
56,seq141,r_51_12_164,r_25_23_51,r_25_23_51,0.92,113,164,51,51
7,r_77_96_136,r_110_53_197,seq34,r_77_96_136,0.9,-12,124,136,51
44,r_67_149_170,seq21,r_13_106_66,r_67_149_170,0.56,1,171,170,51
23,r_5_62_71,seq135,r_46_111_55,r_5_62_71,0.65,1,72,71,51
82,seq81,r_88_16_59,seq145,r_88_16_59,0.99,4,63,59,51
6,r_33_128_57,seq143,r_46_111_55,r_46_111_55,0.7,2,57,55,51
12,r_19_7_82,r_110_53_197,seq147,r_19_7_82,1.0,1,83,82,51
13,r_18_82_179,r_142_99_141,r_130_50_72,r_18_82_179,0.9,0,179,179,51
15,r_120_141_49,r_72_98_165,seq145,r_120_141_49,1.0,0,49,49,52
30,r_9_84_71,seq143,seq88,r_9_84_71,1.0,0,71,71,52
51,seq2,seq42,r_3_37_75,r_3_37_75,1.0,31,106,75,52
36,r_72_98_165,seq133,r_89_107_7,r_72_98_165,0.73,0,165,165,52
25,r_86_101_28,seq36,seq73,r_86_101_28,0.8,0,28,28,52
14,r_25_99_152,r_21_122_197,seq115,r_25_99_152,0.9,0,152,152,52
8,r_8_47_170,r_126_119_112,r_54_80_29,r_8_47_170,0.87,-68,102,170,52
83,seq78,r_112_132_183,r_89_107_7,r_112_132_183,0.55,0,183,183,52
37,r_134_6_94,seq19,r_83_65_8,r_134_6_94,0.75,0,94,94,52
29,r_93_11_51,seq2,seq52,r_93_11_51,1.0,0,51,51,52
16,r_4_128_142,seq45,seq62,r_4_128_142,0.76,-2,140,142,52
21,r_103_41_82,seq87,seq140,r_103_41_82,0.48,18,100,82,52
39,r_3_37_75,seq77,seq2,r_3_37_75,1.0,1,76,75,52
5,r_91_100_147,seq50,seq27,r_91_100_147,0.97,0,147,147,52
43,r_130_32_20,r_144_113_93,r_20_131_41,r_144_113_93,0.74,-15,78,93,52
18,r_54_80_29,r_33_68_189,r_126_119_112,r_54_80_29,1.0,0,29,29,52
43,r_130_32_20,r_90_18_25,r_144_113_93,r_130_32_20,0.98,0,20,20,52
38,r_38_64_159,r_5_39_27,r_17_60_21,r_38_64_159,0.66,5,164,159,52
31,r_75_59_163,seq46,r_125_137_167,r_75_59_163,0.8,0,163,163,52
41,r_125_137_167,seq19,r_75_59_163,r_75_59_163,0.58,5,168,163,52
44,r_17_60_21,seq147,seq62,r_17_60_21,1.0,0,21,21,52
26,r_76_79_69,r_103_41_82,r_31_105_33,r_103_41_82,0.66,-13,69,82,52
8,r_8_47_170,r_54_80_29,r_5_39_27,r_8_47_170,0.88,2,172,170,52
35,r_71_104_53,r_3_37_75,seq12,r_71_104_53,0.87,0,53,53,52
48,r_1_148_40,seq12,seq147,r_1_148_40,1.0,0,40,40,52
4,r_67_85_95,seq88,r_33_68_189,r_67_85_95,0.91,1,96,95,52
11,r_35_7_108,seq140,r_83_65_8,r_35_7_108,0.99,0,108,108,52
17,r_20_131_41,r_31_105_33,r_130_32_20,r_20_131_41,0.66,0,41,41,52
13,r_58_69_186,seq24,r_67_85_95,r_67_85_95,0.69,91,186,95,52
47,r_149_63_18,r_95_106_198,seq77,r_149_63_18,0.89,2,20,18,52
46,r_14_74_46,r_112_132_183,seq24,r_14_74_46,0.95,1,47,46,52
49,r_144_113_93,r_130_32_20,seq50,r_144_113_93,1.0,0,93,93,52
57,seq143,r_9_84_71,seq142,r_9_84_71,1.0,0,71,71,52
62,seq24,r_58_69_186,r_43_30_162,r_43_30_162,0.76,24,186,162,52
99,seq123,r_144_113_93,r_130_32_20,r_144_113_93,0.56,0,93,93,52
18,r_54_80_29,r_8_47_170,r_86_101_28,r_8_47_170,1.0,0,170,170,52
27,r_136_44_127,r_126_119_112,r_54_80_29,r_54_80_29,0.93,49,78,29,52
2,r_10_16_92,seq27,r_71_104_53,r_10_16_92,1.0,0,92,92,52
40,r_66_28_166,seq70,r_35_7_108,r_66_28_166,0.69,0,166,166,52
24,r_112_132_183,seq78,r_8_47_170,r_112_132_183,0.4,0,183,183,52
88,seq94,seq45,r_5_39_27,r_5_39_27,0.85,127,154,27,52
50,seq129,r_8_47_170,r_124_0_87,r_124_0_87,0.99,48,135,87,52
58,seq145,seq23,r_120_141_49,r_120_141_49,1.0,19,68,49,52
20,r_31_105_33,seq53,r_15_57_30,r_31_105_33,0.82,11,44,33,52
7,r_146_127_11,r_86_101_28,r_89_107_7,r_146_127_11,0.54,0,11,11,52
77,seq140,r_35_7_108,r_103_41_82,r_35_7_108,0.99,0,108,108,52
45,r_15_57_30,r_67_85_95,r_21_122_197,r_15_57_30,1.0,1,31,30,52
49,r_144_113_93,r_5_39_27,r_130_32_20,r_144_113_93,1.0,-70,23,93,52
9,r_21_122_197,r_25_99_152,r_15_57_30,r_15_57_30,0.84,47,77,30,52
28,r_5_39_27,r_38_64_159,seq22,r_38_64_159,0.91,5,164,159,52
22,r_43_30_162,r_112_132_183,r_14_74_46,r_112_132_183,0.82,-20,163,183,52
27,r_136_44_127,r_54_80_29,seq133,r_136_44_127,1.0,0,127,127,52
28,r_5_39_27,r_144_113_93,r_38_64_159,r_5_39_27,0.92,1,28,27,52
18,r_54_80_29,r_126_119_112,r_8_47_170,r_126_119_112,0.97,-10,102,112,52
23,r_126_119_112,r_136_44_127,r_89_107_7,r_126_119_112,0.87,1,113,112,52
3,r_90_18_25,r_31_105_33,seq46,r_90_18_25,1.0,0,25,25,52
32,r_83_65_8,r_135_139_113,r_96_48_2,r_83_65_8,0.72,13,21,8,52
82,seq77,r_3_37_75,seq117,r_3_37_75,1.0,1,76,75,52
12,r_51_81_79,r_124_0_87,r_54_80_29,r_54_80_29,0.98,49,78,29,52
38,r_38_64_159,seq94,r_5_39_27,r_5_39_27,0.97,0,27,27,52
30,r_43_143_152,seq149,r_49_100_57,r_43_143_152,0.9,1,153,152,53
14,r_51_22_140,seq102,seq12,r_51_22_140,0.93,0,140,140,53
8,r_50_44_79,seq93,r_4_147_189,r_50_44_79,1.0,0,79,79,53
0,r_49_100_57,r_127_34_172,seq94,r_49_100_57,0.9,-1,56,57,53
43,r_118_89_107,seq107,seq99,r_118_89_107,0.98,1,108,107,53
26,r_85_67_43,r_53_113_88,r_4_147_189,r_4_147_189,0.76,-146,43,189,53
54,seq132,r_103_40_166,seq47,r_103_40_166,0.97,0,166,166,53
37,r_24_125_84,seq112,seq58,r_24_125_84,1.0,0,84,84,53
59,seq17,seq128,r_142_55_157,r_142_55_157,0.81,4,161,157,53
12,r_127_34_172,r_51_22_140,seq149,r_51_22_140,0.54,33,173,140,53
19,r_110_59_187,r_37_13_184,r_96_64_111,r_96_64_111,0.69,76,187,111,53
16,r_19_70_96,seq52,r_95_79_41,r_19_70_96,0.82,0,96,96,53
1,r_142_55_157,r_114_77_141,r_110_59_187,r_114_77_141,0.68,-20,121,141,53
97,seq120,r_140_62_186,r_49_100_57,r_49_100_57,1.0,129,186,57,53
5,r_138_91_82,r_134_122_116,seq107,r_138_91_82,1.0,0,82,82,53
46,r_131_146_65,r_84_101_104,seq18,r_131_146_65,1.0,0,65,65,53
42,r_124_39_165,seq94,seq29,r_124_39_165,0.93,0,165,165,53
45,r_103_40_166,seq132,seq93,r_103_40_166,0.8,0,166,166,53
23,r_28_72_101,r_14_68_74,seq145,r_14_68_74,0.67,54,128,74,53
19,r_110_59_187,r_117_42_76,r_37_13_184,r_117_42_76,1.0,0,76,76,53
83,seq92,seq133,r_9_148_16,r_9_148_16,1.0,0,16,16,53
35,r_41_57_11,r_84_101_104,seq130,r_41_57_11,0.92,0,11,11,53
41,r_84_101_104,seq12,r_95_79_41,r_84_101_104,0.98,0,104,104,53
67,seq35,r_24_125_84,seq132,r_24_125_84,1.0,-4,80,84,53
67,seq35,seq132,r_1_56_146,r_1_56_146,1.0,0,146,146,53
3,r_1_56_146,seq21,seq35,r_1_56_146,0.59,0,146,146,53
28,r_109_87_59,r_127_34_172,r_14_68_74,r_14_68_74,0.54,9,83,74,53
4,r_96_64_111,r_51_22_140,seq128,r_96_64_111,0.99,0,111,111,53
63,seq29,r_114_77_141,r_110_59_187,r_114_77_141,0.68,0,141,141,53
73,seq58,r_51_22_140,r_24_125_84,r_24_125_84,0.5,11,95,84,53
11,r_117_42_76,r_110_59_187,r_139_25_20,r_117_42_76,1.0,0,76,76,53
2,r_95_79_41,seq132,seq102,r_95_79_41,1.0,1,42,41,53
47,r_139_25_20,r_103_40_166,seq120,r_139_25_20,0.82,0,20,20,53
57,seq12,r_84_101_104,seq145,r_84_101_104,1.0,0,104,104,53
6,r_140_62_186,seq120,r_51_22_140,r_51_22_140,0.86,46,186,140,53
15,r_129_78_56,seq54,seq3,r_129_78_56,1.0,0,56,56,53
1,r_142_55_157,r_110_59_187,seq17,r_142_55_157,1.0,-1,156,157,53
99,seq149,r_115_83_118,r_43_143_152,r_115_83_118,0.98,2,120,118,53
27,r_61_71_69,seq133,r_95_79_41,r_61_71_69,1.0,0,69,69,53
40,r_20_111_147,r_4_147_189,seq21,r_20_111_147,0.9,0,147,147,53
18,r_11_74_99,seq94,seq69,r_11_74_99,0.89,16,115,99,53
29,r_106_6_148,r_127_34_172,seq133,r_106_6_148,0.73,0,148,148,53
24,r_115_83_118,seq149,seq112,r_115_83_118,0.88,0,118,118,53
33,r_37_13_184,r_110_59_187,r_20_111_147,r_20_111_147,0.99,38,185,147,53
58,seq130,r_53_113_88,r_41_57_11,r_53_113_88,1.0,1,89,88,53
0,r_49_100_57,r_9_148_16,r_127_34_172,r_9_148_16,0.65,13,29,16,53
44,r_9_148_16,r_49_100_57,seq92,r_9_148_16,1.0,0,16,16,53
61,seq21,r_1_56_146,seq36,r_1_56_146,0.7,0,146,146,53
32,r_53_113_88,seq130,seq128,r_53_113_88,0.96,1,89,88,53
38,r_134_122_116,seq18,seq30,r_134_122_116,0.51,0,116,116,53
25,r_76_7_31,r_1_56_146,r_95_79_41,r_76_7_31,0.59,11,42,31,53
77,seq69,seq60,r_11_74_99,r_11_74_99,0.97,17,116,99,53
28,r_109_87_59,seq128,r_127_34_172,r_109_87_59,0.96,0,59,59,53
34,r_75_63_138,seq0,seq107,r_75_63_138,0.99,0,138,138,53
60,seq18,r_134_122_116,r_131_146_65,r_131_146_65,1.0,51,116,65,53
17,r_114_77_141,seq29,r_11_74_99,r_114_77_141,0.9,0,141,141,53
94,seq112,r_24_125_84,r_103_40_166,r_24_125_84,0.98,-4,80,84,53
49,r_26_27_97,r_134_122_116,seq145,r_26_27_97,0.97,-1,96,97,53
12,r_127_34_172,r_106_6_148,r_51_22_140,r_106_6_148,0.48,0,148,148,53
84,seq93,r_50_44_79,seq23,r_50_44_79,1.0,0,79,79,53
36,r_141_88_68,r_37_89_108,r_34_119_196,r_141_88_68,1.0,0,68,68,54
9,r_39_138_44,r_109_54_188,r_128_58_110,r_39_138_44,0.4,144,188,44,54
92,seq104,seq133,r_123_32_87,r_123_32_87,1.0,17,104,87,54
8,r_19_139_178,r_82_35_192,seq28,r_19_139_178,0.47,0,178,178,54
30,r_131_145_109,r_106_136_84,r_129_66_23,r_131_145_109,0.89,-54,55,109,54
37,r_83_36_50,r_4_11_142,seq93,r_83_36_50,1.0,0,50,50,54
16,r_103_142_60,r_19_139_178,seq84,r_103_142_60,1.0,3,63,60,54
21,r_46_90_63,seq133,r_81_77_114,r_46_90_63,1.0,3,66,63,54
5,r_95_107_97,seq7,seq101,r_95_107_97,1.0,4,101,97,54
46,r_123_32_87,seq51,seq104,r_123_32_87,0.99,1,88,87,54
42,r_81_77_114,seq73,r_46_90_63,r_46_90_63,1.0,71,134,63,54
32,r_115_6_160,r_106_136_84,seq137,r_115_6_160,1.0,2,162,160,54
19,r_68_47_69,seq133,seq56,r_68_47_69,1.0,0,69,69,54
45,r_143_114_31,r_4_11_142,seq22,r_143_114_31,0.97,1,32,31,54
38,r_98_10_154,r_149_130_64,seq104,r_98_10_154,0.98,3,157,154,54
31,r_149_130_64,r_102_31_79,r_98_10_154,r_98_10_154,0.99,-90,64,154,54
40,r_110_42_37,seq133,r_123_32_87,r_123_32_87,0.98,7,94,87,54
3,r_61_38_132,seq100,r_27_15_120,r_61_38_132,0.99,0,132,132,54
48,r_70_126_15,r_75_60_139,seq22,r_70_126_15,0.91,0,15,15,54
90,seq100,r_61_38_132,r_63_118_2,r_61_38_132,1.0,0,132,132,54
20,r_24_23_47,r_27_15_120,r_17_121_38,r_27_15_120,0.7,-73,47,120,54
91,seq101,r_52_125_51,seq133,r_52_125_51,0.99,0,51,51,54
40,r_110_42_37,r_4_11_142,seq133,r_110_42_37,0.66,0,37,37,54
4,r_140_9_179,r_116_44_184,r_135_43_129,r_116_44_184,0.76,-5,179,184,54
73,seq59,r_106_136_84,r_129_66_23,r_106_136_84,0.76,0,84,84,54
11,r_85_111_118,r_134_55_111,seq108,r_85_111_118,0.61,0,118,118,54
13,r_134_55_111,r_85_111_118,r_30_20_70,r_134_55_111,0.54,0,111,111,54
15,r_21_67_159,r_19_139_178,seq48,r_21_67_159,0.54,1,160,159,54
6,r_62_50_116,r_102_31_79,r_40_3_115,r_102_31_79,1.0,0,79,79,54
14,r_79_86_10,seq93,r_17_121_38,r_17_121_38,1.0,4,42,38,54
87,seq93,r_79_86_10,r_52_125_51,r_52_125_51,1.0,25,76,51,54
27,r_112_33_186,seq64,r_128_58_110,r_128_58_110,0.67,76,186,110,54
39,r_17_121_38,r_123_32_87,r_79_86_10,r_17_121_38,1.0,0,38,38,54
2,r_40_3_115,r_62_50_116,r_27_15_120,r_27_15_120,0.75,5,125,120,54
74,seq64,r_112_33_186,r_75_60_139,r_75_60_139,0.98,47,186,139,54
18,r_135_43_129,seq74,r_70_126_15,r_135_43_129,0.98,0,129,129,54
41,r_29_57_14,r_30_20_70,r_129_66_23,r_30_20_70,0.96,2,72,70,54
24,r_75_60_139,r_98_10_154,seq8,r_75_60_139,0.96,0,139,139,54
43,r_117_148_18,r_98_10_154,seq22,r_117_148_18,0.92,0,18,18,54
25,r_116_44_184,r_140_9_179,r_40_3_115,r_40_3_115,0.92,65,180,115,54
34,r_52_125_51,seq101,r_83_36_50,r_52_125_51,0.84,0,51,51,54
9,r_39_138_44,seq92,r_109_54_188,r_39_138_44,1.0,0,44,44,54
12,r_113_16_32,seq91,seq1,r_113_16_32,1.0,0,32,32,54
14,r_79_86_10,r_68_47_69,seq93,r_79_86_10,0.94,0,10,10,54
32,r_115_6_160,seq147,r_106_136_84,r_106_136_84,1.0,8,92,84,54
38,r_98_10_154,r_75_60_139,r_149_130_64,r_149_130_64,1.0,21,85,64,54
91,seq101,seq133,r_95_107_97,r_95_107_97,1.0,-51,46,97,54
29,r_109_54_188,r_34_119_196,r_39_138_44,r_39_138_44,0.99,0,44,44,54
41,r_29_57_14,r_113_16_32,r_30_20_70,r_30_20_70,0.81,-55,15,70,54
87,seq93,r_102_31_79,r_79_86_10,r_79_86_10,0.93,3,13,10,54
17,r_106_136_84,seq59,r_115_6_160,r_106_136_84,1.0,0,84,84,54
49,r_96_5_27,r_24_23_47,seq22,r_96_5_27,0.97,2,29,27,54
28,r_129_66_23,r_85_111_118,r_131_145_109,r_129_66_23,0.97,0,23,23,54
31,r_149_130_64,r_98_10_154,r_4_11_142,r_98_10_154,0.84,4,158,154,54
28,r_129_66_23,r_131_145_109,seq59,r_131_145_109,1.0,1,110,109,54
29,r_109_54_188,r_39_138_44,r_149_130_64,r_149_130_64,0.69,124,188,64,54
7,r_30_20_70,r_106_136_84,seq80,r_30_20_70,0.89,0,70,70,54
44,r_97_12_105,r_34_119_196,r_17_121_38,r_97_12_105,0.92,0,105,105,54
23,r_27_15_120,seq14,r_29_57_14,r_27_15_120,0.84,1,121,120,54
17,r_106_136_84,r_115_6_160,seq147,r_115_6_160,1.0,2,162,160,54
35,r_128_58_110,r_27_15_120,seq147,r_128_58_110,0.99,0,110,110,54
30,r_131_145_109,r_129_66_23,seq1,r_131_145_109,0.99,1,110,109,54
13,r_92_121_18,r_146_16_53,r_86_67_76,r_92_121_18,0.89,0,18,18,55
36,r_71_52_91,seq135,r_143_103_158,r_71_52_91,0.99,1,92,91,55
92,seq111,r_56_124_57,seq30,r_56_124_57,1.0,4,61,57,55
53,seq4,r_143_103_158,r_86_67_76,r_143_103_158,0.95,-36,122,158,55
14,r_84_122_124,seq38,r_7_120_85,r_7_120_85,0.81,40,125,85,55
43,r_2_100_178,seq4,r_86_67_76,r_86_67_76,1.0,2,78,76,55
12,r_146_16_53,r_7_120_85,r_92_121_18,r_146_16_53,0.84,1,54,53,55
37,r_72_15_147,r_89_10_129,seq14,r_89_10_129,0.86,0,129,129,55
30,r_90_65_122,seq21,r_70_42_30,r_70_42_30,1.0,23,53,30,55
37,r_72_15_147,seq14,seq108,r_72_15_147,0.92,0,147,147,55
39,r_60_113_137,seq115,r_78_140_10,r_60_113_137,0.55,0,137,137,55
1,r_5_8_80,seq19,seq125,r_5_8_80,1.0,0,80,80,55
97,seq123,seq108,r_50_64_159,r_50_64_159,0.76,12,171,159,55
5,r_141_76_95,seq51,seq29,r_141_76_95,0.93,2,97,95,55
42,r_7_120_85,seq129,seq119,r_7_120_85,0.84,1,86,85,55
15,r_86_67_76,r_2_100_178,r_71_52_91,r_71_52_91,0.45,87,178,91,55
27,r_47_63_189,r_75_66_62,r_89_10_129,r_89_10_129,0.63,60,189,129,55
16,r_70_42_30,seq83,r_90_65_122,r_70_42_30,0.78,0,30,30,55
41,r_109_13_102,seq27,seq82,r_109_13_102,0.99,0,102,102,55
10,r_9_25_71,r_147_127_138,seq83,r_9_25_71,1.0,1,72,71,55
90,seq108,seq123,r_72_15_147,r_72_15_147,0.99,24,171,147,55
26,r_45_138_111,r_89_10_129,seq41,r_45_138_111,0.99,0,111,111,55
16,r_70_42_30,r_90_65_122,seq21,r_90_65_122,1.0,0,122,122,55
4,r_117_137_156,r_134_97_172,seq111,r_134_97_172,0.71,-3,169,172,55
0,r_89_10_129,r_72_15_147,r_87_101_47,r_89_10_129,0.87,0,129,129,55
11,r_12_55_77,r_60_113_137,seq51,r_12_55_77,0.99,-6,71,77,55
98,seq125,seq77,r_5_8_80,r_5_8_80,1.0,0,80,80,55
46,r_78_140_10,r_5_8_80,r_37_131_11,r_5_8_80,1.0,0,80,80,55
15,r_86_67_76,r_58_43_144,r_2_100_178,r_86_67_76,1.0,2,78,76,55
48,r_143_103_158,r_98_11_131,r_71_52_91,r_71_52_91,0.89,40,131,91,55
57,seq14,r_72_15_147,seq38,r_72_15_147,1.0,1,148,147,55
13,r_92_121_18,r_86_67_76,seq104,r_86_67_76,1.0,2,78,76,55
6,r_134_97_172,r_117_137_156,r_37_131_11,r_37_131_11,0.74,158,169,11,55
62,seq23,r_107_148_134,r_86_67_76,r_86_67_76,1.0,60,136,76,55
2,r_139_68_24,seq130,seq110,r_139_68_24,0.41,68,92,24,55
36,r_71_52_91,r_143_103_158,seq4,r_143_103_158,0.98,0,158,158,55
27,r_47_63_189,seq19,r_75_66_62,r_75_66_62,1.0,18,80,62,55
49,r_91_106_28,r_117_137_156,seq145,r_91_106_28,1.0,0,28,28,55
19,r_87_101_47,r_109_13_102,seq114,r_87_101_47,0.99,1,48,47,55
30,r_90_65_122,r_70_42_30,r_91_106_28,r_90_65_122,0.77,0,122,122,55
47,r_94_28_174,seq35,seq27,r_94_28_174,0.4,-2,172,174,55
40,r_0_18_75,seq110,seq128,r_0_18_75,1.0,1,76,75,55
18,r_58_43_144,r_88_26_163,r_141_76_95,r_58_43_144,0.76,0,144,144,55
29,r_98_11_131,r_143_103_158,r_90_65_122,r_143_103_158,0.8,-27,131,158,55
24,r_88_26_163,r_58_43_144,r_146_16_53,r_146_16_53,0.88,91,144,53,55
35,r_75_66_62,r_47_63_189,r_37_131_11,r_47_63_189,0.7,0,189,189,55
25,r_56_124_57,r_9_25_71,seq85,r_56_124_57,0.96,4,61,57,55
43,r_2_100_178,r_86_67_76,r_89_10_129,r_89_10_129,0.95,49,178,129,55
33,r_61_102_83,seq14,r_22_62_22,r_61_102_83,0.82,-19,64,83,55
21,r_96_6_45,seq30,seq136,r_96_6_45,1.0,2,47,45,55
70,seq38,seq99,r_31_48_54,r_31_48_54,1.0,37,91,54,55
48,r_143_103_158,r_71_52_91,seq27,r_143_103_158,0.89,0,158,158,55
24,r_88_26_163,r_146_16_53,r_70_42_30,r_88_26_163,0.8,2,165,163,55
32,r_93_32_98,seq105,seq118,r_93_32_98,0.96,0,98,98,55
34,r_107_148_134,seq23,seq30,r_107_148_134,0.6,2,136,134,55
2,r_139_68_24,r_73_116_188,seq130,r_139_68_24,0.99,1,25,24,55
46,r_78_140_10,seq142,r_5_8_80,r_78_140_10,0.85,0,10,10,55
81,seq77,r_73_116_188,r_147_127_138,r_147_127_138,0.98,51,189,138,55
17,r_53_20_108,seq39,seq110,r_53_20_108,1.0,2,110,108,55
9,r_73_116_188,seq77,r_37_131_11,r_37_131_11,0.84,178,189,11,55
96,seq119,seq19,r_7_120_85,r_7_120_85,1.0,2,87,85,55
22,r_3_149_126,r_1_46_151,seq17,r_3_149_126,0.73,1,127,126,55
28,r_80_69_139,seq29,r_37_131_11,r_80_69_139,0.71,1,140,139,55
91,seq110,seq130,r_53_20_108,r_53_20_108,1.0,5,113,108,55
7,r_112_79_99,seq128,seq49,r_112_79_99,1.0,1,100,99,55
44,r_147_127_138,r_134_97_172,seq77,r_147_127_138,0.89,1,139,138,55
23,r_22_62_22,seq119,r_61_102_83,r_61_102_83,0.63,9,92,83,55
31,r_132_33_14,r_117_137_156,r_61_102_83,r_132_33_14,0.97,2,16,14,55
35,r_75_66_62,r_3_149_126,r_47_63_189,r_47_63_189,0.69,-127,62,189,55
20,r_31_48_54,seq130,seq38,r_31_48_54,1.0,0,54,54,55
93,seq107,r_17_113_89,seq20,r_17_113_89,0.99,-11,78,89,56
30,r_21_96_149,seq106,seq60,r_21_96_149,0.93,0,149,149,56
51,seq131,r_18_7_182,seq102,r_18_7_182,0.94,0,182,182,56
4,r_90_36_29,seq52,seq15,r_90_36_29,1.0,0,29,29,56
14,r_120_25_158,r_64_5_62,seq86,r_64_5_62,1.0,0,62,62,56
8,r_43_112_115,seq4,seq86,r_43_112_115,0.78,0,115,115,56
43,r_16_33_154,r_146_30_3,seq20,r_16_33_154,0.71,0,154,154,56
37,r_130_61_141,seq15,seq122,r_130_61_141,0.88,0,141,141,56
16,r_137_119_68,seq109,r_6_65_16,r_137_119_68,1.0,0,68,68,56
21,r_17_113_89,seq107,seq4,r_17_113_89,0.97,0,89,89,56
1,r_79_40_28,seq29,seq140,r_79_40_28,0.61,73,101,28,56
97,seq148,r_143_100_179,seq85,r_143_100_179,0.83,0,179,179,56
11,r_92_132_69,r_90_36_29,r_74_71_103,r_74_71_103,1.0,1,104,103,56
80,seq78,r_73_66_92,seq138,r_73_66_92,1.0,1,93,92,56
45,r_103_58_163,seq122,r_120_25_158,r_120_25_158,0.78,5,163,158,56
95,seq109,r_137_119_68,seq60,r_137_119_68,1.0,-11,57,68,56
23,r_12_110_44,r_97_57_61,seq106,r_97_57_61,0.97,-17,44,61,56
31,r_64_5_62,r_120_25_158,seq88,r_64_5_62,1.0,0,62,62,56
41,r_116_139_73,seq29,r_136_76_33,r_116_139_73,1.0,0,73,73,56
3,r_24_49_81,seq101,seq81,r_24_49_81,0.98,0,81,81,56
10,r_97_57_61,seq94,seq70,r_97_57_61,0.99,1,62,61,56
14,r_120_25_158,seq86,r_12_110_44,r_12_110_44,0.76,117,161,44,56
78,seq70,seq81,r_97_57_61,r_97_57_61,1.0,9,70,61,56
73,seq55,r_141_31_108,seq41,r_141_31_108,0.97,-8,100,108,56
11,r_92_132_69,r_84_68_159,r_90_36_29,r_92_132_69,1.0,0,69,69,56
20,r_22_32_96,seq104,seq101,r_22_32_96,0.98,1,97,96,56
13,r_105_149_60,r_130_61_141,r_27_28_7,r_27_28_7,0.62,55,62,7,56
98,seq122,r_103_58_163,r_130_61_141,r_130_61_141,0.85,16,157,141,56
46,r_27_28_7,seq81,r_105_149_60,r_105_149_60,1.0,10,70,60,56
15,r_73_66_92,seq78,seq23,r_73_66_92,1.0,0,92,92,56
34,r_136_76_33,r_22_32_96,seq101,r_136_76_33,0.56,1,34,33,56
47,r_8_26_127,seq86,seq104,r_8_26_127,0.67,0,127,127,56
24,r_93_126_164,seq81,seq147,r_93_126_164,0.66,0,164,164,56
33,r_141_31_108,seq55,r_64_5_62,r_64_5_62,1.0,46,108,62,56
19,r_54_0_55,seq81,seq140,r_54_0_55,1.0,1,56,55,56
61,seq147,r_95_51_64,r_48_11_162,r_95_51_64,1.0,1,65,64,56
32,r_63_10_184,seq102,r_133_3_22,r_63_10_184,0.53,0,184,184,56
81,seq81,r_93_126_164,r_24_49_81,r_24_49_81,0.61,52,133,81,56
17,r_18_7_182,seq131,r_64_5_62,r_64_5_62,0.86,120,182,62,56
9,r_75_45_91,r_43_112_115,seq55,r_43_112_115,0.9,-20,95,115,56
18,r_50_125_150,seq106,r_89_1_37,r_89_1_37,0.96,16,53,37,56
22,r_48_11_162,seq147,r_120_25_158,r_48_11_162,0.85,0,162,162,56
28,r_95_51_64,seq147,seq41,r_95_51_64,1.0,1,65,64,56
91,seq104,r_22_32_96,r_105_149_60,r_105_149_60,0.99,37,97,60,56
49,r_35_38_140,r_143_100_179,r_133_3_22,r_35_38_140,0.65,3,143,140,56
27,r_59_99_42,r_8_26_127,seq41,r_59_99_42,0.98,0,42,42,56
7,r_89_1_37,r_84_68_159,seq106,r_89_1_37,1.0,0,37,37,56
56,seq140,r_118_2_67,r_54_0_55,r_54_0_55,1.0,114,169,55,56
91,seq104,r_105_149_60,r_8_26_127,r_8_26_127,1.0,0,127,127,56
18,r_50_125_150,r_89_1_37,seq109,r_50_125_150,0.99,0,150,150,56
44,r_47_128_83,seq67,r_90_36_29,r_47_128_83,1.0,0,83,83,56
35,r_121_83_112,seq23,seq131,r_121_83_112,1.0,1,113,112,56
12,r_143_100_179,seq148,r_93_126_164,r_143_100_179,0.76,0,179,179,56
59,seq15,r_130_61_141,r_90_36_29,r_90_36_29,0.9,0,29,29,56
30,r_32_1_148,r_15_33_196,r_30_29_144,r_15_33_196,0.61,-46,150,196,57
36,r_70_64_76,seq136,r_20_119_6,r_70_64_76,1.0,0,76,76,57
66,seq40,r_82_106_20,r_7_69_135,r_7_69_135,0.97,1,136,135,57
14,r_96_105_183,r_95_56_3,seq25,r_96_105_183,0.39,0,183,183,57
8,r_99_6_177,r_31_87_195,seq89,r_99_6_177,0.35,0,177,177,57
43,r_8_94_174,seq137,seq68,r_8_94_174,0.57,0,174,174,57
37,r_118_61_57,r_116_77_175,seq102,r_118_61_57,1.0,0,57,57,57
18,r_84_4_32,r_42_0_73,seq11,r_84_4_32,1.0,0,32,32,57
83,seq75,r_120_63_70,seq71,r_120_63_70,0.99,-6,64,70,57
3,r_30_29_144,seq136,r_35_144_26,r_30_29_144,0.91,0,144,144,57
86,seq83,r_143_124_164,r_100_37_66,r_100_37_66,1.0,51,117,66,57
39,r_100_37_66,r_42_0_73,seq83,r_100_37_66,1.0,0,66,66,57
1,r_140_127_95,seq139,seq108,r_140_127_95,1.0,1,96,95,57
80,seq68,r_114_135_191,r_8_94_174,r_8_94_174,0.71,1,175,174,57
33,r_82_106_20,seq93,seq40,r_82_106_20,0.88,0,20,20,57
5,r_120_63_70,r_17_23_197,r_22_49_63,r_120_63_70,1.0,1,71,70,57
46,r_21_3_161,seq136,seq74,r_21_3_161,0.74,1,162,161,57
42,r_28_80_138,seq142,seq11,r_28_80_138,0.92,1,139,138,57
69,seq46,seq136,r_147_90_94,r_147_90_94,1.0,8,102,94,57
27,r_39_73_54,r_70_64_76,r_82_106_20,r_70_64_76,1.0,-22,54,76,57
19,r_138_101_127,r_149_148_158,r_147_90_94,r_138_101_127,0.98,0,127,127,57
31,r_19_48_49,r_30_29_144,seq2,r_19_48_49,1.0,1,50,49,57
15,r_133_97_59,r_70_64_76,r_95_56_3,r_95_56_3,0.77,56,59,3,57
41,r_141_52_62,r_70_64_76,r_19_48_49,r_70_64_76,1.0,-14,62,76,57
67,seq44,r_91_51_122,seq145,r_91_51_122,1.0,-37,85,122,57
10,r_42_0_73,seq26,r_39_73_54,r_42_0_73,0.59,1,74,73,57
2,r_112_107_28,r_116_77_175,seq10,r_112_107_28,0.83,1,29,28,57
26,r_43_131_125,r_116_77_175,seq139,r_43_131_125,1.0,0,125,125,57
4,r_130_132_61,seq55,seq53,r_130_132_61,1.0,0,61,61,57
23,r_117_16_41,seq62,r_43_131_125,r_117_16_41,1.0,0,41,41,57
13,r_116_77_175,r_43_131_125,r_125_81_97,r_116_77_175,0.96,-50,125,175,57
98,seq121,r_147_90_94,r_129_27_52,r_147_90_94,1.0,1,95,94,57
48,r_92_41_90,r_99_6_177,r_103_5_199,r_92_41_90,1.0,1,91,90,57
6,r_58_111_109,r_43_131_125,r_123_67_92,r_123_67_92,0.91,17,109,92,57
29,r_123_67_92,r_109_59_102,r_58_111_109,r_123_67_92,0.69,17,109,92,57
33,r_82_106_20,seq40,r_39_73_54,r_39_73_54,0.86,15,69,54,57
29,r_123_67_92,r_138_101_127,r_109_59_102,r_123_67_92,0.36,0,92,92,57
24,r_98_54_128,r_17_23_197,seq47,r_98_54_128,0.98,0,128,128,57
3,r_30_29_144,r_19_48_49,seq136,r_19_48_49,1.0,2,51,49,57
32,r_147_90_94,seq121,seq46,r_147_90_94,1.0,1,95,94,57
38,r_15_33_196,r_32_1_148,r_100_37_66,r_100_37_66,0.99,84,150,66,57
34,r_125_81_97,r_129_27_52,seq104,r_125_81_97,1.0,2,99,97,57
17,r_110_36_184,r_103_5_199,r_99_6_177,r_110_36_184,0.51,0,184,184,57
9,r_22_49_63,r_125_81_97,r_19_48_49,r_22_49_63,1.0,0,63,63,57
22,r_126_12_117,seq40,r_125_81_97,r_126_12_117,0.99,0,117,117,57
25,r_35_144_26,seq68,seq38,r_35_144_26,0.97,0,26,26,57
55,seq10,r_28_80_138,r_112_107_28,r_112_107_28,0.5,1,29,28,57
7,r_109_59_102,seq108,seq65,r_109_59_102,0.99,1,103,102,57
44,r_72_88_147,seq86,r_58_111_109,r_72_88_147,0.9,0,147,147,57
35,r_129_27_52,r_22_49_63,r_103_5_199,r_22_49_63,1.0,-3,60,63,57
23,r_117_16_41,r_43_131_125,seq14,r_43_131_125,1.0,0,125,125,57
80,seq68,r_35_144_26,r_114_135_191,r_35_144_26,0.93,-1,25,26,57
14,r_84_95_138,r_116_62_20,seq125,r_84_95_138,0.78,0,138,138,58
8,r_14_15_161,r_67_55_66,seq127,r_67_55_66,1.0,-3,63,66,58
37,r_118_54_92,r_10_76_141,r_18_103_94,r_118_54_92,1.0,0,92,92,58
16,r_28_17_87,r_51_27_131,seq21,r_28_17_87,0.93,0,87,87,58
21,r_67_55_66,r_14_15_161,r_129_121_139,r_67_55_66,1.0,1,67,66,58
39,r_36_25_159,r_90_5_157,seq131,r_90_5_157,0.64,3,160,157,58
5,r_81_130_127,seq136,seq61,r_81_130_127,0.7,4,131,127,58
42,r_73_120_140,seq142,r_104_66_62,r_73_120_140,0.96,0,140,140,58
34,r_92_101_15,r_50_100_169,seq127,r_92_101_15,1.0,0,15,15,58
32,r_141_30_34,seq115,r_78_106_10,r_141_30_34,0.97,-1,33,34,58
35,r_116_62_20,seq21,seq99,r_116_62_20,0.74,2,22,20,58
41,r_138_7_83,r_28_17_87,r_93_12_102,r_93_12_102,0.7,30,132,102,58
20,r_43_128_21,r_60_124_82,r_137_49_185,r_60_124_82,0.61,-60,22,82,58
89,seq131,r_32_144_179,r_36_25_159,r_32_144_179,0.55,0,179,179,58
8,r_14_15_161,seq127,seq3,r_14_15_161,0.78,9,170,161,58
4,r_37_47_77,r_50_100_169,seq4,r_37_47_77,1.0,1,78,77,58
0,r_57_111_183,r_79_119_163,r_51_27_131,r_57_111_183,0.22,4,187,183,58
11,r_51_27_131,r_32_144_179,r_78_106_10,r_51_27_131,0.74,0,131,131,58
13,r_88_6_75,r_98_117_3,r_71_135_11,r_88_6_75,1.0,0,75,75,58
15,r_60_124_82,seq33,seq23,r_60_124_82,1.0,-1,81,82,58
48,r_149_9_142,seq139,seq114,r_149_9_142,0.82,0,142,142,58
6,r_39_83_146,r_20_26_155,seq3,r_39_83_146,0.82,1,147,146,58
40,r_71_135_11,r_91_113_188,seq16,r_71_135_11,1.0,-1,10,11,58
27,r_89_148_111,seq61,r_79_119_163,r_89_148_111,1.0,0,111,111,58
2,r_109_75_150,r_79_119_163,seq133,r_109_75_150,0.76,0,150,150,58
47,r_143_48_173,r_90_5_157,r_93_12_102,r_93_12_102,0.48,30,132,102,58
18,r_34_13_175,r_79_119_163,r_28_17_87,r_34_13_175,0.49,0,175,175,58
46,r_65_35_17,r_37_47_77,seq136,r_65_35_17,0.59,-4,13,17,58
25,r_104_66_62,seq133,seq146,r_104_66_62,1.0,0,62,62,58
36,r_59_1_50,r_79_119_163,seq86,r_59_1_50,1.0,0,50,50,58
47,r_143_48_173,r_93_12_102,r_104_66_62,r_143_48_173,0.95,0,173,173,58
20,r_43_128_21,r_137_49_185,r_122_64_76,r_122_64_76,0.99,66,142,76,58
68,seq33,r_60_124_82,seq139,r_60_124_82,1.0,-8,74,82,58
61,seq21,seq107,r_28_17_87,r_28_17_87,1.0,55,142,87,58
52,seq4,r_110_45_152,r_37_47_77,r_37_47_77,1.0,1,78,77,58
94,seq114,r_32_144_179,r_149_9_142,r_149_9_142,0.93,37,179,142,58
9,r_40_82_133,seq99,seq16,r_40_82_133,0.89,0,133,133,58
19,r_0_147_32,r_88_6_75,seq142,r_0_147_32,1.0,1,33,32,58
33,r_94_134_24,r_60_124_82,seq19,r_94_134_24,0.85,-1,23,24,58
1,r_50_100_169,seq136,r_81_130_127,r_50_100_169,0.87,0,169,169,58
22,r_105_63_113,seq125,r_92_101_15,r_105_63_113,0.99,0,113,113,58
28,r_91_113_188,seq22,r_36_25_159,r_36_25_159,0.76,29,188,159,58
49,r_122_64_76,r_79_119_163,r_43_128_21,r_122_64_76,0.61,-1,75,76,58
7,r_90_5_157,r_36_25_159,r_81_130_127,r_90_5_157,0.79,0,157,157,58
44,r_145_85_70,seq29,r_116_62_20,r_145_85_70,0.96,0,70,70,58
79,seq69,seq46,r_110_45_152,r_110_45_152,0.97,21,173,152,58
99,seq127,r_14_15_161,r_92_101_15,r_92_101_15,1.0,0,15,15,58
30,r_0_23_86,seq65,seq37,r_0_23_86,0.92,0,86,86,59
23,r_7_6_18,r_0_23_86,seq148,r_7_6_18,0.88,0,18,18,59
36,r_106_104_115,r_13_59_137,r_123_34_51,r_13_59_137,0.81,-21,116,137,59
8,r_13_59_137,r_146_3_148,seq65,r_13_59_137,0.72,1,138,137,59
43,r_69_118_59,seq60,r_115_74_16,r_69_118_59,0.92,1,60,59,59
37,r_21_87_83,seq58,seq37,r_21_87_83,1.0,-1,82,83,59
59,seq19,r_144_113_109,r_69_118_59,r_144_113_109,0.96,-12,97,109,59
86,seq92,r_30_39_82,r_41_1_10,r_30_39_82,0.72,-17,65,82,59
16,r_16_22_170,r_10_62_33,seq25,r_16_22_170,0.59,0,170,170,59
21,r_54_27_177,seq28,r_123_34_51,r_123_34_51,0.9,126,177,51,59
46,r_82_138_156,seq58,r_91_49_98,r_82_138_156,0.56,0,156,156,59
42,r_24_105_84,r_41_1_10,r_90_96_155,r_24_105_84,0.95,2,86,84,59
2,r_124_72_63,r_85_109_60,r_142_122_38,r_124_72_63,1.0,-6,57,63,59
31,r_86_127_184,seq121,r_89_114_94,r_89_114_94,0.92,91,185,94,59
6,r_29_77_31,r_35_128_61,r_32_17_166,r_29_77_31,0.78,0,31,31,59
3,r_89_114_94,r_107_15_196,seq11,r_89_114_94,1.0,0,94,94,59
10,r_70_43_120,seq102,r_131_103_112,r_70_43_120,0.99,0,120,120,59
24,r_50_68_188,seq61,r_40_145_20,r_40_145_20,1.0,1,21,20,59
34,r_142_122_38,seq38,seq65,r_142_122_38,1.0,0,38,38,59
5,r_32_17_166,r_0_23_86,r_29_77_31,r_32_17_166,0.77,-136,30,166,59
26,r_10_62_33,r_16_22_170,r_88_36_81,r_88_36_81,0.93,89,170,81,59
4,r_31_99_76,r_24_105_84,seq135,r_31_99_76,1.0,0,76,76,59
0,r_81_12_172,seq97,r_86_127_184,r_81_12_172,0.38,-28,144,172,59
63,seq28,r_131_103_112,r_73_132_113,r_131_103_112,0.76,2,114,112,59
20,r_85_109_60,r_124_72_63,seq60,r_85_109_60,0.99,0,60,60,59
13,r_93_143_68,r_71_98_194,r_2_117_49,r_71_98_194,0.66,-125,69,194,59
98,seq125,seq28,r_144_113_109,r_144_113_109,0.98,23,132,109,59
15,r_57_42_5,r_14_101_161,r_111_134_91,r_111_134_91,0.77,72,163,91,59
48,r_88_36_81,seq63,r_10_62_33,r_88_36_81,0.99,0,81,81,59
5,r_32_17_166,r_29_77_31,r_31_99_76,r_29_77_31,0.76,135,166,31,59
40,r_131_103_112,seq28,r_41_1_10,r_131_103_112,0.95,2,114,112,59
74,seq60,r_69_118_59,r_85_109_60,r_85_109_60,1.0,0,60,60,59
18,r_73_132_113,r_90_96_155,seq28,r_73_132_113,0.48,5,118,113,59
29,r_75_136_185,r_30_39_82,r_35_128_61,r_35_128_61,0.54,125,186,61,59
25,r_35_128_61,seq141,seq76,r_35_128_61,1.0,0,61,61,59
7,r_40_145_20,r_48_120_192,r_50_68_188,r_40_145_20,1.0,0,20,20,59
33,r_14_101_161,r_57_42_5,seq112,r_14_101_161,0.62,2,163,161,59
27,r_2_117_49,r_111_134_91,seq149,r_2_117_49,1.0,0,49,49,59
6,r_29_77_31,r_32_17_166,r_124_72_63,r_29_77_31,0.58,135,166,31,59
42,r_24_105_84,r_90_96_155,r_144_113_109,r_144_113_109,0.83,60,169,109,59
0,r_81_12_172,r_86_127_184,r_70_43_120,r_81_12_172,0.86,0,172,172,59
39,r_26_139_52,r_75_136_185,seq65,r_26_139_52,0.98,0,52,52,59
9,r_123_34_51,seq25,seq38,r_123_34_51,1.0,0,51,51,59
45,r_55_56_56,seq60,seq58,r_55_56_56,0.95,-4,52,56,59
22,r_111_134_91,r_107_15_196,r_9_46_55,r_107_15_196,0.76,-106,90,196,59
28,r_94_52_133,seq79,r_69_118_59,r_69_118_59,0.68,85,144,59,59
49,r_144_113_109,seq97,seq141,r_144_113_109,1.0,1,110,109,59
44,r_146_3_148,r_13_59_137,seq18,r_13_59_137,1.0,1,138,137,59
41,r_9_46_55,seq44,seq129,r_9_46_55,1.0,-1,54,55,59
35,r_107_15_196,r_111_134_91,seq112,r_111_134_91,1.0,-3,88,91,59
12,r_91_49_98,r_30_39_82,seq37,r_91_49_98,0.98,0,98,98,59
89,seq148,r_140_110_186,r_7_6_18,r_7_6_18,0.63,36,54,18,59
30,r_37_34_113,seq27,r_3_100_149,r_37_34_113,0.96,1,114,113,60
92,seq108,r_117_101_95,r_15_83_136,r_117_101_95,1.0,0,95,95,60
14,r_25_44_122,seq38,r_10_11_52,r_25_44_122,0.98,1,123,122,60
8,r_1_91_86,r_54_89_193,r_4_76_19,r_1_91_86,0.51,-1,85,86,60
53,seq134,seq133,r_144_148_117,r_144_148_117,0.99,-1,116,117,60
43,r_141_80_187,r_120_142_196,r_86_6_118,r_86_6_118,0.65,69,187,118,60
37,r_53_13_160,seq28,r_46_118_45,r_46_118_45,0.85,117,162,45,60
71,seq48,seq23,r_2_51_108,r_2_51_108,1.0,2,110,108,60
16,r_82_81_3,seq116,r_52_0_62,r_52_0_62,1.0,5,67,62,60
5,r_145_87_158,r_40_125_155,seq75,r_145_87_158,0.92,0,158,158,60
42,r_29_105_133,seq97,r_3_100_149,r_29_105_133,0.6,0,133,133,60
41,r_9_19_179,r_131_84_162,r_7_66_11,r_7_66_11,0.76,3,14,11,60
80,seq68,r_40_125_155,r_117_101_95,r_117_101_95,1.0,72,167,95,60
12,r_24_63_165,r_53_13_160,r_111_21_15,r_111_21_15,0.87,20,35,15,60
36,r_129_71_38,seq20,seq106,r_129_71_38,1.0,0,38,38,60
34,r_107_103_9,r_1_91_86,seq95,r_107_103_9,0.75,1,10,9,60
10,r_46_118_45,seq12,r_74_113_29,r_46_118_45,1.0,1,46,45,60
69,seq41,seq128,r_10_11_52,r_10_11_52,0.94,6,58,52,60
39,r_123_78_31,r_2_51_108,seq8,r_2_51_108,1.0,1,109,108,60
31,r_67_104_161,seq8,r_57_32_97,r_67_104_161,0.76,0,161,161,60
67,seq38,seq133,r_30_137_47,r_30_137_47,1.0,38,85,47,60
3,r_86_6_118,seq97,r_33_109_198,r_33_109_198,0.46,-65,133,198,60
90,seq102,seq12,r_79_60_102,r_79_60_102,0.72,-8,94,102,60
26,r_2_51_108,r_123_78_31,seq48,r_2_51_108,0.98,1,109,108,60
48,r_10_11_52,r_22_16_171,seq41,r_10_11_52,1.0,0,52,52,60
2,r_111_21_15,r_25_44_122,r_24_63_165,r_111_21_15,1.0,1,16,15,60
0,r_15_83_136,seq108,r_74_113_29,r_15_83_136,0.7,1,137,136,60
11,r_138_18_88,r_141_80_187,seq12,r_138_18_88,1.0,0,88,88,60
46,r_30_137_47,seq48,seq38,r_30_137_47,0.98,0,47,47,60
57,seq12,seq133,r_138_18_88,r_138_18_88,1.0,5,93,88,60
12,r_24_63_165,r_111_21_15,seq27,r_111_21_15,0.65,150,165,15,60
2,r_111_21_15,r_24_63_165,r_77_126_112,r_77_126_112,0.74,53,165,112,60
45,r_7_66_11,r_111_21_15,r_9_19_179,r_7_66_11,0.92,0,11,11,60
47,r_79_60_102,r_130_47_35,r_124_36_111,r_130_47_35,0.91,1,36,35,60
24,r_114_56_24,seq62,seq20,r_114_56_24,0.98,0,24,24,60
41,r_9_19_179,r_7_66_11,seq143,r_9_19_179,0.56,0,179,179,60
40,r_144_148_117,seq65,seq134,r_144_148_117,0.91,0,117,117,60
74,seq58,r_22_16_171,seq43,r_22_16_171,0.99,-17,154,171,60
18,r_52_0_62,r_29_105_133,r_82_81_3,r_52_0_62,1.0,0,62,62,60
29,r_22_16_171,seq59,r_1_91_86,r_1_91_86,1.0,85,171,86,60
25,r_33_109_198,r_29_105_133,r_86_6_118,r_29_105_133,0.61,-18,115,133,60
47,r_79_60_102,r_124_36_111,seq102,r_124_36_111,0.97,-8,103,111,60
39,r_123_78_31,seq135,r_2_51_108,r_123_78_31,0.73,28,59,31,60
58,seq14,seq135,r_17_147_42,r_17_147_42,0.39,63,105,42,60
38,r_117_101_95,seq108,seq68,r_117_101_95,1.0,0,95,95,60
45,r_7_66_11,r_9_19_179,r_40_125_155,r_9_19_179,0.67,0,179,179,60
27,r_130_47_35,r_79_60_102,seq132,r_130_47_35,1.0,1,36,35,60
17,r_131_84_162,seq119,r_3_100_149,r_131_84_162,0.58,0,162,162,60
94,seq112,seq110,r_99_85_129,r_99_85_129,0.98,0,129,129,60
9,r_77_126_112,seq139,r_111_21_15,r_77_126_112,0.93,0,112,112,60
22,r_94_149_141,seq59,seq68,r_94_149_141,0.84,0,141,141,60
7,r_40_125_155,r_145_87_158,r_7_66_11,r_145_87_158,0.51,0,158,158,60
44,r_88_72_77,r_67_104_161,r_10_11_52,r_88_72_77,1.0,0,77,77,60
23,r_99_85_129,seq106,seq112,r_99_85_129,0.68,0,129,129,60
35,r_92_70_70,r_22_16_171,r_17_147_42,r_92_70_70,1.0,0,70,70,60
51,seq130,r_83_123_181,r_34_1_89,r_34_1_89,0.77,1,90,89,61
29,r_38_26_25,seq9,seq12,r_38_26_25,0.54,2,27,25,61
14,r_117_15_162,r_3_53_199,r_50_124_100,r_50_124_100,0.99,68,168,100,61
8,r_127_126_191,r_129_16_145,seq77,r_129_16_145,0.99,3,148,145,61
10,r_95_19_31,r_25_28_28,seq145,r_95_19_31,0.98,0,31,31,61
21,r_55_139_84,r_34_1_89,r_6_21_142,r_6_21_142,0.79,5,147,142,61
1,r_67_45_171,seq57,r_108_42_47,r_108_42_47,0.79,124,171,47,61
5,r_89_64_108,r_72_93_125,seq14,r_89_64_108,0.99,1,109,108,61
46,r_5_2_68,r_92_11_72,seq130,r_5_2_68,0.9,0,68,68,61
42,r_13_85_133,r_68_69_195,seq60,r_13_85_133,0.97,1,134,133,61
80,seq70,r_44_78_157,r_32_107_137,r_32_107_137,0.77,20,157,137,61
76,seq60,seq100,r_13_85_133,r_13_85_133,0.92,2,135,133,61
45,r_128_22_155,seq122,seq130,r_128_22_155,0.54,-1,154,155,61
44,r_101_115_46,r_72_93_125,seq125,r_101_115_46,1.0,0,46,46,61
40,r_33_18_29,r_67_45_171,r_39_146_130,r_33_18_29,0.66,5,34,29,61
76,seq60,r_75_91_95,seq100,r_75_91_95,0.55,0,95,95,61
31,r_141_90_121,seq133,seq40,r_141_90_121,0.82,5,126,121,61
41,r_54_138_65,r_34_1_89,seq110,r_54_138_65,0.78,2,67,65,61
67,seq37,r_32_107_137,r_108_42_47,r_108_42_47,0.85,90,137,47,61
26,r_75_91_95,seq60,seq86,r_75_91_95,1.0,0,95,95,61
16,r_44_78_157,r_114_137_22,seq0,r_44_78_157,0.86,0,157,157,61
12,r_111_84_11,r_44_78_157,r_109_106_148,r_111_84_11,0.92,0,11,11,61
4,r_72_93_125,r_32_107_137,seq60,r_72_93_125,0.86,0,125,125,61
0,r_136_24_77,seq144,seq122,r_136_24_77,0.99,0,77,77,61
11,r_59_147_120,seq125,seq35,r_59_147_120,0.85,5,125,120,61
20,r_56_140_180,seq131,r_47_149_177,r_47_149_177,0.51,3,180,177,61
37,r_114_137_22,r_127_126_191,r_44_78_157,r_114_137_22,0.97,0,22,22,61
13,r_92_11_72,r_80_8_168,seq57,r_92_11_72,1.0,0,72,72,61
98,seq122,r_80_8_168,r_136_24_77,r_136_24_77,0.92,71,148,77,61
15,r_43_17_106,seq100,r_4_46_5,r_43_17_106,0.99,1,107,106,61
6,r_34_1_89,seq27,r_5_2_68,r_5_2_68,1.0,33,101,68,61
43,r_108_42_47,r_56_140_180,seq37,r_108_42_47,1.0,0,47,47,61
16,r_44_78_157,seq70,r_114_137_22,r_114_137_22,0.97,24,46,22,61
99,seq125,r_59_147_120,r_101_115_46,r_101_115_46,1.0,79,125,46,61
8,r_127_126_191,seq77,r_136_24_77,r_127_126_191,0.91,-1,190,191,61
27,r_63_134_124,r_6_21_142,seq7,r_63_134_124,0.6,0,124,124,61
2,r_96_82_131,seq66,seq57,r_96_82_131,0.98,1,132,131,61
47,r_129_16_145,r_127_126_191,r_95_19_31,r_127_126_191,0.65,-45,146,191,61
74,seq57,r_67_45_171,r_96_82_131,r_96_82_131,0.93,40,171,131,61
24,r_83_123_181,r_25_28_28,r_109_106_148,r_109_106_148,0.72,30,178,148,61
25,r_142_31_175,seq35,r_34_1_89,r_142_31_175,0.65,0,175,175,61
33,r_32_107_137,seq37,seq70,r_32_107_137,0.85,0,137,137,61
61,seq144,r_136_24_77,r_55_139_84,r_136_24_77,0.98,-9,68,77,61
32,r_23_113_185,seq41,seq60,r_23_113_185,0.43,1,186,185,61
34,r_47_149_177,r_68_69_195,r_96_82_131,r_96_82_131,0.99,48,179,131,61
9,r_81_29_128,seq14,seq100,r_81_29_128,0.9,0,128,128,61
40,r_33_18_29,r_39_146_130,r_120_148_67,r_33_18_29,0.95,61,90,29,61
37,r_114_137_22,r_44_78_157,r_32_107_137,r_32_107_137,0.91,16,153,137,61
22,r_20_103_166,r_67_45_171,seq51,r_20_103_166,0.47,1,167,166,61
35,r_6_21_142,seq145,r_55_139_84,r_6_21_142,0.98,2,144,142,61
49,r_120_148_67,r_34_1_89,seq57,r_120_148_67,1.0,0,67,67,61
23,r_39_146_130,r_33_18_29,r_43_17_106,r_39_146_130,0.95,2,132,130,61
35,r_6_21_142,r_63_134_124,seq145,r_6_21_142,0.61,-18,124,142,61
30,r_31_146_155,r_122_110_184,r_34_117_2,r_31_146_155,0.91,0,155,155,62
8,r_126_80_114,r_145_78_130,r_58_127_34,r_58_127_34,0.98,80,114,34,62
2,r_35_105_33,r_102_51_154,r_113_25_7,r_35_105_33,0.83,0,33,33,62
16,r_83_101_92,seq71,seq132,r_83_101_92,0.99,0,92,92,62
21,r_108_109_146,seq128,seq67,r_108_109_146,0.94,0,146,146,62
39,r_41_27_81,seq71,r_77_37_19,r_41_27_81,1.0,1,82,81,62
25,r_77_37_19,r_23_53_143,r_133_90_70,r_77_37_19,0.52,46,65,19,62
5,r_56_4_84,seq59,seq38,r_56_4_84,1.0,0,84,84,62
42,r_62_43_95,seq79,seq88,r_62_43_95,1.0,0,95,95,62
13,r_138_63_41,r_41_27_81,seq121,r_138_63_41,0.84,0,41,41,62
45,r_119_47_141,seq38,r_16_24_39,r_16_24_39,0.53,104,143,39,62
19,r_36_12_175,seq3,r_75_73_144,r_36_12_175,0.53,0,175,175,62
33,r_58_127_34,seq95,r_84_30_48,r_58_127_34,0.94,0,34,34,62
1,r_92_129_116,r_62_43_95,r_75_73_144,r_75_73_144,0.82,0,144,144,62
20,r_74_85_43,r_126_80_114,seq40,r_74_85_43,1.0,0,43,43,62
31,r_42_115_172,r_133_90_70,r_134_0_57,r_134_0_57,0.43,14,71,57,62
49,r_102_51_154,r_2_64_68,seq104,r_102_51_154,0.95,0,154,154,62
10,r_17_57_122,r_102_51_154,seq136,r_17_57_122,0.98,0,122,122,62
9,r_99_39_27,r_49_32_23,seq9,r_99_39_27,0.89,0,27,27,62
73,seq136,r_42_115_172,r_17_57_122,r_17_57_122,1.0,0,122,122,62
11,r_13_111_93,seq97,seq130,r_13_111_93,0.99,1,94,93,62
15,r_2_64_68,r_108_109_146,r_135_93_35,r_2_64_68,1.0,0,68,68,62
48,r_145_78_130,r_126_80_114,seq136,r_126_80_114,0.85,-47,67,114,62
4,r_135_93_35,r_17_57_122,r_2_64_68,r_135_93_35,0.95,87,122,35,62
25,r_77_37_19,r_133_90_70,r_41_27_81,r_41_27_81,0.99,1,82,81,62
13,r_138_63_41,seq121,r_10_81_73,r_10_81_73,0.71,59,132,73,62
6,r_131_86_110,seq91,seq98,r_131_86_110,0.56,1,111,110,62
46,r_16_24_39,r_131_86_110,seq70,r_16_24_39,1.0,1,40,39,62
22,r_133_90_70,r_77_37_19,r_23_53_143,r_23_53_143,0.91,10,153,143,62
47,r_147_45_69,seq38,seq132,r_147_45_69,0.55,2,71,69,62
40,r_10_81_73,seq141,r_138_63_41,r_138_63_41,0.53,33,74,41,62
24,r_6_139_67,seq67,seq130,r_6_139_67,1.0,0,67,67,62
36,r_7_140_51,r_147_45_69,seq95,r_7_140_51,1.0,1,52,51,62
48,r_145_78_130,seq136,r_135_93_35,r_145_78_130,1.0,1,131,130,62
32,r_23_53_143,seq142,r_133_90_70,r_23_53_143,0.56,1,144,143,62
38,r_21_100_90,seq44,seq97,r_21_100_90,0.69,4,94,90,62
69,seq40,seq5,r_74_85_43,r_74_85_43,1.0,10,53,43,62
93,seq104,r_148_15_171,r_113_25_7,r_148_15_171,0.69,-128,43,171,62
17,r_55_50_100,r_103_94_149,r_99_39_27,r_55_50_100,1.0,0,100,100,62
27,r_134_0_57,r_13_111_93,seq136,r_134_0_57,1.0,0,57,57,62
31,r_42_115_172,r_134_0_57,seq1,r_42_115_172,0.78,1,173,172,62
22,r_133_90_70,r_42_115_172,r_77_37_19,r_133_90_70,0.73,1,71,70,62
4,r_135_93_35,r_10_81_73,r_17_57_122,r_135_93_35,1.0,0,35,35,62
49,r_102_51_154,r_17_57_122,r_2_64_68,r_2_64_68,0.97,54,122,68,62
7,r_103_94_149,seq112,seq128,r_103_94_149,0.95,-1,148,149,62
41,r_84_30_48,r_6_139_67,r_58_127_34,r_6_139_67,0.97,-14,53,67,62
82,seq76,r_148_15_171,seq104,r_148_15_171,0.99,-104,67,171,62
25,r_77_37_19,r_103_94_149,r_23_53_143,r_77_37_19,0.94,0,19,19,62
79,seq70,r_148_15_171,r_16_24_39,r_16_24_39,1.0,61,100,39,62
35,r_11_124_105,seq26,seq132,r_11_124_105,0.99,0,105,105,62
12,r_148_15_171,seq70,seq14,r_148_15_171,0.66,2,173,171,62
30,r_109_36_128,r_97_87_125,seq47,r_109_36_128,0.68,0,128,128,63
97,seq122,r_123_137_145,r_93_67_10,r_123_137_145,0.89,-103,42,145,63
36,r_92_63_157,r_28_135_101,r_34_79_28,r_34_79_28,0.84,73,101,28,63
75,seq70,r_7_68_20,seq46,r_7_68_20,0.97,2,22,20,63
14,r_56_20_139,r_77_16_185,r_64_10_112,r_56_20_139,0.59,1,140,139,63
53,seq8,seq147,r_52_15_102,r_52_15_102,1.0,0,102,102,63
9,r_64_10_112,r_92_63_157,r_56_20_139,r_64_10_112,0.91,27,139,112,63
37,r_6_32_77,r_28_135_101,r_96_42_168,r_96_42_168,1.0,-91,77,168,63
21,r_123_137_145,seq122,r_44_35_81,r_123_137_145,0.94,0,145,145,63
39,r_111_78_149,r_77_16_185,seq104,r_111_78_149,0.76,1,150,149,63
42,r_118_86_88,r_26_143_118,seq17,r_118_86_88,0.95,1,89,88,63
80,seq84,seq46,r_142_11_93,r_142_11_93,1.0,8,101,93,63
61,seq27,r_127_50_148,r_23_60_6,r_23_60_6,0.98,4,10,6,63
31,r_28_135_101,r_92_63_157,r_148_139_57,r_28_135_101,0.63,0,101,101,63
24,r_45_131_111,r_105_30_62,seq113,r_45_131_111,0.83,0,111,111,63
12,r_38_89_19,r_4_24_195,r_121_40_198,r_4_24_195,0.62,-168,27,195,63
23,r_61_81_75,r_2_98_37,r_117_119_146,r_61_81_75,0.71,-49,26,75,63
89,seq106,seq122,r_140_22_40,r_140_22_40,0.94,69,109,40,63
3,r_105_30_62,r_148_139_57,seq144,r_105_30_62,1.0,1,63,62,63
36,r_92_63_157,r_34_79_28,r_64_10_112,r_92_63_157,0.57,-41,116,157,63
26,r_97_87_125,seq17,r_62_99_51,r_97_87_125,0.5,3,128,125,63
4,r_26_143_118,r_111_78_149,seq46,r_26_143_118,0.83,2,120,118,63
0,r_127_50_148,seq110,r_38_89_19,r_38_89_19,0.84,135,154,19,63
73,seq65,r_77_16_185,r_105_30_62,r_105_30_62,1.0,124,186,62,63
36,r_92_63_157,r_64_10_112,seq46,r_92_63_157,0.99,0,157,157,63
20,r_48_41_135,r_127_50_148,r_140_22_40,r_48_41_135,0.83,0,135,135,63
13,r_52_15_102,seq18,seq8,r_52_15_102,1.0,0,102,102,63
15,r_44_35_81,r_39_66_167,seq90,r_44_35_81,0.88,0,81,81,63
48,r_39_66_167,seq31,r_123_137_145,r_39_66_167,0.75,0,167,167,63
23,r_61_81_75,r_117_119_146,seq70,r_61_81_75,0.9,1,76,75,63
12,r_38_89_19,r_121_40_198,r_127_50_148,r_121_40_198,0.47,-44,154,198,63
10,r_121_40_198,r_38_89_19,r_91_108_140,r_121_40_198,0.45,-44,154,198,63
27,r_117_119_146,seq69,seq8,r_117_119_146,0.93,0,146,146,63
33,r_2_98_37,r_146_3_113,seq73,r_2_98_37,0.46,3,40,37,63
2,r_133_136_87,r_45_131_111,r_44_35_81,r_133_136_87,0.99,2,89,87,63
40,r_101_80_67,r_97_87_125,r_105_30_62,r_101_80_67,1.0,-4,63,67,63
46,r_76_120_33,r_105_30_62,seq47,r_76_120_33,0.98,4,37,33,63
18,r_51_130_61,r_97_87_125,r_77_16_185,r_51_130_61,0.94,2,63,61,63
29,r_141_71_79,seq144,seq112,r_141_71_79,1.0,0,79,79,63
24,r_45_131_111,r_133_136_87,r_105_30_62,r_45_131_111,0.92,-23,88,111,63
19,r_62_99_51,seq128,seq43,r_62_99_51,0.51,0,51,51,63
50,seq0,r_146_3_113,r_38_89_19,r_146_3_113,0.99,2,115,113,63
45,r_25_149_17,r_64_10_112,seq102,r_25_149_17,0.51,-2,15,17,63
49,r_140_22_40,r_51_130_61,r_93_67_10,r_140_22_40,0.6,2,42,40,63
32,r_59_75_150,seq17,r_51_130_61,r_51_130_61,0.69,89,150,61,63
38,r_146_3_113,seq0,r_93_67_10,r_146_3_113,0.98,2,115,113,63
16,r_49_13_54,r_105_30_62,seq110,r_49_13_54,1.0,0,54,54,63
34,r_91_108_140,seq103,r_121_40_198,r_91_108_140,0.64,10,150,140,63
1,r_34_79_28,r_105_30_62,seq73,r_34_79_28,1.0,0,28,28,63
43,r_53_88_21,seq47,seq54,r_53_88_21,1.0,0,21,21,63
67,seq47,r_64_10_112,r_76_120_33,r_76_120_33,0.67,0,33,33,63
17,r_142_11_93,seq147,seq84,r_142_11_93,0.54,3,96,93,63
5,r_7_68_20,seq70,seq74,r_7_68_20,1.0,0,20,20,63
9,r_64_10_112,seq47,r_92_63_157,r_92_63_157,0.59,-45,112,157,63
67,seq47,r_53_88_21,r_64_10_112,r_53_88_21,0.97,0,21,21,63
28,r_134_14_84,r_29_115_192,seq19,r_134_14_84,1.0,1,85,84,63
7,r_72_132_137,seq46,r_2_98_37,r_72_132_137,0.98,0,137,137,63
18,r_51_130_61,r_77_16_185,r_59_75_150,r_59_75_150,0.54,7,157,150,63
82,seq90,r_117_119_146,r_44_35_81,r_44_35_81,0.91,23,104,81,63
25,r_93_67_10,r_142_11_93,seq122,r_93_67_10,0.75,2,12,10,63
35,r_148_139_57,r_105_30_62,r_96_42_168,r_148_139_57,0.95,3,60,57,63
75,seq70,seq46,r_61_81_75,r_61_81_75,1.0,5,80,75,63
40,r_42_24_66,r_47_28_144,r_128_10_110,r_42_24_66,0.98,80,146,66,64
37,r_122_12_133,r_82_40_57,r_67_27_27,r_67_27_27,0.96,29,56,27,64
17,r_3_140_44,r_68_79_46,r_135_127_33,r_3_140_44,0.75,1,45,44,64
2,r_106_5_25,seq78,seq81,r_106_5_25,0.69,2,27,25,64
27,r_102_23_21,r_68_79_46,seq14,r_102_23_21,1.0,-1,20,21,64
14,r_45_118_161,r_86_120_179,r_104_16_198,r_45_118_161,0.59,0,161,161,64
8,r_50_13_130,seq14,seq20,r_50_13_130,0.67,3,133,130,64
55,seq14,r_50_13_130,r_102_23_21,r_102_23_21,0.54,2,23,21,64
3,r_135_127_33,r_47_28_144,r_143_56_176,r_135_127_33,0.73,2,35,33,64
39,r_136_96_78,seq119,r_128_10_110,r_136_96_78,0.78,0,78,78,64
42,r_25_93_7,r_26_59_129,r_121_109_40,r_121_109_40,0.62,90,130,40,64
45,r_1_137_126,seq6,seq53,r_1_137_126,0.96,0,126,126,64
30,r_7_60_86,r_128_10_110,r_139_84_20,r_139_84_20,1.0,1,21,20,64
13,r_141_31_35,seq65,r_139_84_20,r_139_84_20,0.84,31,51,20,64
19,r_19_73_178,seq81,r_86_120_179,r_86_120_179,0.65,0,179,179,64
11,r_47_28_144,r_42_24_66,r_0_113_15,r_47_28_144,0.99,0,144,144,64
38,r_89_48_26,seq2,r_17_124_62,r_17_124_62,1.0,19,81,62,64
10,r_17_124_62,seq107,r_89_48_26,r_17_124_62,1.0,0,62,62,64
26,r_133_125_80,seq6,r_0_113_15,r_133_125_80,1.0,0,80,80,64
7,r_147_43_50,r_0_113_15,r_63_101_56,r_147_43_50,0.95,7,57,50,64
11,r_47_28_144,r_11_77_180,r_42_24_66,r_42_24_66,1.0,5,71,66,64
48,r_82_40_57,r_122_12_133,seq132,r_122_12_133,1.0,-12,121,133,64
35,r_36_146_19,r_68_79_46,seq91,r_36_146_19,0.59,-3,16,19,64
62,seq32,seq74,r_112_39_82,r_112_39_82,1.0,9,91,82,64
39,r_136_96_78,r_128_10_110,r_36_146_19,r_128_10_110,0.99,0,110,110,64
18,r_11_77_180,r_111_52_11,r_131_117_139,r_11_77_180,0.84,0,180,180,64
34,r_112_39_82,r_68_79_46,seq32,r_112_39_82,0.97,0,82,82,64
30,r_7_60_86,r_139_84_20,r_94_58_48,r_7_60_86,1.0,1,87,86,64
82,seq91,seq132,r_36_146_19,r_36_146_19,1.0,16,35,19,64
47,r_85_15_60,seq108,seq33,r_85_15_60,1.0,0,60,60,64
40,r_42_24_66,seq83,r_47_28_144,r_42_24_66,0.99,2,68,66,64
18,r_11_77_180,r_47_28_144,r_111_52_11,r_47_28_144,0.87,0,144,144,64
29,r_88_114_75,r_75_34_156,seq83,r_88_114_75,1.0,0,75,75,64
24,r_86_120_179,r_45_118_161,r_82_40_57,r_86_120_179,0.54,-32,147,179,64
33,r_75_34_156,seq65,r_102_23_21,r_75_34_156,0.52,1,157,156,64
0,r_68_79_46,r_111_52_11,r_128_10_110,r_128_10_110,1.0,0,110,110,64
22,r_121_109_40,r_46_9_199,seq21,r_121_109_40,0.99,0,40,40,64
50,seq129,seq108,r_70_145_58,r_70_145_58,1.0,16,74,58,64
58,seq21,r_26_59_129,r_121_109_40,r_121_109_40,0.91,45,85,40,64
25,r_70_145_58,seq92,seq129,r_70_145_58,1.0,0,58,58,64
23,r_67_27_27,r_89_48_26,r_122_12_133,r_67_27_27,0.89,6,33,27,64
32,r_49_126_69,r_11_77_180,r_102_23_21,r_49_126_69,1.0,0,69,69,64
52,seq4,seq72,r_94_58_48,r_94_58_48,1.0,14,62,48,64
4,r_139_84_20,r_54_64_131,r_141_31_35,r_139_84_20,1.0,0,20,20,64
34,r_112_39_82,r_11_77_180,r_68_79_46,r_68_79_46,0.94,19,65,46,64
0,r_68_79_46,r_112_39_82,r_111_52_11,r_112_39_82,0.78,0,82,82,64
46,r_94_58_48,r_54_64_131,seq4,r_94_58_48,1.0,2,50,48,64
0,r_68_79_46,r_0_113_15,r_112_39_82,r_68_79_46,1.0,1,47,46,64
9,r_8_38_112,r_104_16_198,seq138,r_8_38_112,1.0,0,112,112,64
51,seq2,r_104_16_198,r_89_48_26,r_89_48_26,0.97,9,35,26,64
37,r_122_12_133,r_67_27_27,r_94_58_48,r_122_12_133,1.0,0,133,133,64
31,r_111_52_11,seq14,seq107,r_111_52_11,0.89,0,11,11,64
49,r_26_59_129,r_25_93_7,seq144,r_26_59_129,0.82,1,130,129,64
56,seq144,seq100,r_26_59_129,r_26_59_129,0.73,4,133,129,64
44,r_131_117_139,seq108,seq72,r_131_117_139,1.0,0,139,139,64
20,r_41_130_51,seq105,r_0_113_15,r_41_130_51,1.0,0,51,51,64
41,r_63_101_56,r_47_28_144,r_147_43_50,r_63_101_56,1.0,1,57,56,64
38,r_89_48_26,r_67_27_27,seq2,r_89_48_26,0.8,7,33,26,64
12,r_54_64_131,r_19_73_178,r_128_10_110,r_128_10_110,0.54,24,134,110,64
23,r_67_27_27,r_122_12_133,r_82_40_57,r_122_12_133,1.0,0,133,133,64
8,r_93_12_47,seq54,seq10,r_93_12_47,1.0,0,47,47,65
26,r_110_94_174,seq146,r_67_126_170,r_110_94_174,0.98,0,174,174,65
14,r_137_19_98,seq98,seq54,r_137_19_98,1.0,1,99,98,65
43,r_64_138_103,r_102_117_133,seq15,r_64_138_103,1.0,2,105,103,65
19,r_6_111_38,r_53_60_190,r_127_87_104,r_127_87_104,1.0,43,147,104,65
16,r_92_99_159,r_18_41_5,r_97_118_27,r_97_118_27,0.56,48,75,27,65
39,r_127_87_104,r_1_7_16,r_6_111_38,r_127_87_104,0.98,1,105,104,65
1,r_81_43_80,seq59,seq4,r_81_43_80,0.98,4,84,80,65
5,r_134_71_145,seq84,seq75,r_134_71_145,0.81,0,145,145,65
46,r_47_44_161,r_78_114_175,seq30,r_47_44_161,0.77,0,161,161,65
42,r_96_27_61,r_1_7_16,r_69_88_198,r_96_27_61,0.99,1,62,61,65
32,r_97_118_27,r_92_99_159,r_18_41_5,r_92_99_159,1.0,-13,146,159,65
31,r_77_61_169,r_53_60_190,r_82_34_138,r_82_34_138,0.82,31,169,138,65
41,r_39_106_124,r_102_117_133,r_68_26_23,r_39_106_124,0.97,0,124,124,65
89,seq91,seq62,r_37_31_68,r_37_31_68,1.0,1,69,68,65
10,r_25_136_115,r_67_126_170,r_120_148_33,r_25_136_115,0.54,3,118,115,65
20,r_29_121_58,r_56_73_186,r_68_26_23,r_29_121_58,0.8,1,59,58,65
84,seq75,seq9,r_134_71_145,r_134_71_145,0.5,20,165,145,65
26,r_110_94_174,r_48_145_128,seq146,r_48_145_128,0.96,2,130,128,65
16,r_92_99_159,r_97_118_27,r_56_73_186,r_92_99_159,0.95,0,159,159,65
4,r_46_70_60,seq2,seq14,r_46_70_60,0.91,0,60,60,65
23,r_78_114_175,r_48_145_128,r_134_71_145,r_78_114_175,0.91,1,176,175,65
13,r_69_88_198,r_123_23_74,r_96_27_61,r_123_23_74,0.61,-14,60,74,65
48,r_8_57_164,seq3,r_97_118_27,r_8_57_164,0.82,0,164,164,65
27,r_143_5_48,r_77_61_169,seq104,r_143_5_48,1.0,0,48,48,65
45,r_53_60_190,r_16_17_70,r_6_111_38,r_53_60_190,1.0,-143,47,190,65
0,r_56_73_186,r_116_135_135,r_92_99_159,r_92_99_159,0.99,1,160,159,65
19,r_6_111_38,seq139,r_53_60_190,r_6_111_38,1.0,0,38,38,65
12,r_129_89_40,r_116_135_135,r_120_148_33,r_116_135_135,1.0,-94,41,135,65
2,r_18_41_5,r_92_99_159,r_107_49_88,r_107_49_88,0.77,6,94,88,65
47,r_42_38_65,r_79_52_153,seq59,r_42_38_65,1.0,0,65,65,65
40,r_35_90_54,seq132,r_68_26_23,r_35_90_54,1.0,1,55,54,65
32,r_97_118_27,r_120_148_33,r_92_99_159,r_97_118_27,1.0,0,27,27,65
18,r_24_133_181,seq51,r_36_58_31,r_36_58_31,0.97,151,182,31,65
29,r_102_117_133,r_39_106_124,r_25_136_115,r_39_106_124,1.0,0,124,124,65
24,r_82_34_138,seq72,r_16_17_70,r_16_17_70,0.58,68,138,70,65
25,r_16_17_70,r_122_108_162,r_37_31_68,r_16_17_70,1.0,0,70,70,65
21,r_45_76_25,r_92_99_159,seq84,r_45_76_25,1.0,1,26,25,65
33,r_48_145_128,r_110_94_174,seq144,r_48_145_128,0.81,2,130,128,65
42,r_96_27_61,r_69_88_198,r_142_124_122,r_142_124_122,1.0,31,153,122,65
38,r_122_108_162,seq51,r_81_43_80,r_122_108_162,0.84,0,162,162,65
34,r_37_31_68,seq104,seq91,r_37_31_68,1.0,0,68,68,65
75,seq54,seq72,r_137_19_98,r_137_19_98,1.0,32,130,98,65
67,seq132,r_35_90_54,r_120_148_33,r_35_90_54,0.72,1,55,54,65
60,seq14,seq95,r_46_70_60,r_46_70_60,0.97,2,62,60,65
45,r_53_60_190,r_6_111_38,r_142_124_122,r_142_124_122,1.0,68,190,122,65
6,r_120_148_33,r_107_49_88,seq132,r_120_148_33,0.99,0,33,33,65
17,r_67_126_170,r_25_136_115,r_47_44_161,r_25_136_115,0.59,55,170,115,65
22,r_142_124_122,seq72,r_96_27_61,r_142_124_122,0.95,0,122,122,65
28,r_107_49_88,seq30,r_18_41_5,r_107_49_88,1.0,0,88,88,65
49,r_79_52_153,seq30,r_1_7_16,r_79_52_153,0.94,0,153,153,65
7,r_123_23_74,r_69_88_198,seq51,r_123_23_74,1.0,1,75,74,65
23,r_78_114_175,r_47_44_161,r_48_145_128,r_78_114_175,0.6,-21,154,175,65
35,r_36_58_31,r_142_124_122,seq2,r_36_58_31,1.0,0,31,31,65
30,r_40_5_121,r_123_98_174,r_118_81_45,r_123_98_174,1.0,-53,121,174,66
14,r_104_3_112,r_48_45_151,r_121_39_72,r_121_39_72,1.0,42,114,72,66
8,r_36_57_98,r_104_3_112,seq0,r_36_57_98,0.98,7,105,98,66
37,r_115_22_153,seq125,r_27_7_127,r_115_22_153,0.94,0,153,153,66
71,seq59,r_48_45_151,r_75_10_164,r_75_10_164,0.87,-13,151,164,66
29,r_110_2_74,r_44_95_46,r_142_145_75,r_110_2_74,0.95,1,75,74,66
21,r_143_96_160,seq33,seq31,r_143_96_160,0.52,2,162,160,66
39,r_56_28_101,r_46_72_115,r_20_102_88,r_46_72_115,0.79,-14,101,115,66
1,r_44_95_46,seq26,r_110_2_74,r_110_2_74,0.66,-28,46,74,66
97,seq125,r_115_22_153,r_20_102_88,r_20_102_88,0.61,65,153,88,66
5,r_6_73_144,r_123_98_174,r_66_138_43,r_123_98_174,1.0,-29,145,174,66
42,r_29_9_185,seq69,r_66_138_43,r_66_138_43,0.96,144,187,43,66
45,r_17_30_79,r_143_96_160,r_14_132_27,r_17_30_79,0.98,3,82,79,66
19,r_142_145_75,seq4,r_110_2_74,r_142_145_75,0.88,0,75,75,66
46,r_118_81_45,seq131,r_146_149_55,r_146_149_55,0.99,5,60,55,66
3,r_66_138_43,r_24_88_51,seq4,r_66_138_43,1.0,0,43,43,66
43,r_27_7_127,seq103,r_141_91_20,r_27_7_127,0.53,-89,38,127,66
31,r_122_76_94,seq4,r_16_147_9,r_122_76_94,1.0,0,94,94,66
41,r_16_147_9,r_46_72_115,r_122_76_94,r_122_76_94,0.96,22,116,94,66
89,seq106,r_71_61_116,seq86,r_71_61_116,1.0,4,120,116,66
10,r_20_102_88,seq69,seq125,r_20_102_88,1.0,0,88,88,66
9,r_18_109_38,seq116,seq94,r_18_109_38,0.94,0,38,38,66
47,r_141_91_20,r_36_57_98,r_27_7_127,r_141_91_20,0.79,-2,18,20,66
72,seq60,seq129,r_27_7_127,r_27_7_127,0.57,5,132,127,66
4,r_47_119_157,seq124,r_66_138_43,r_66_138_43,0.99,114,157,43,66
0,r_80_134_199,seq1,r_47_119_157,r_80_134_199,0.35,-59,140,199,66
11,r_51_34_129,seq59,r_85_21_4,r_51_34_129,0.99,0,129,129,66
18,r_14_132_27,r_128_38_68,seq116,r_14_132_27,0.61,0,27,27,66
32,r_120_49_32,seq35,seq12,r_120_49_32,0.52,0,32,32,66
20,r_46_72_115,r_16_147_9,r_93_105_109,r_93_105_109,0.56,7,116,109,66
98,seq126,r_123_98_174,r_128_38_68,r_128_38_68,1.0,106,174,68,66
48,r_62_74_110,r_123_98_174,r_13_108_91,r_123_98_174,0.84,-64,110,174,66
46,r_118_81_45,r_24_88_51,seq131,r_118_81_45,0.51,0,45,45,66
44,r_13_108_91,seq53,r_62_74_110,r_13_108_91,0.47,19,110,91,66
6,r_41_83_86,seq94,r_92_137_125,r_41_83_86,0.63,2,88,86,66
26,r_23_52_21,r_121_39_72,seq25,r_23_52_21,0.87,-1,20,21,66
29,r_110_2_74,r_24_88_51,r_44_95_46,r_44_95_46,0.73,4,50,46,66
25,r_24_88_51,seq129,seq100,r_24_88_51,0.96,0,51,51,66
2,r_123_98_174,seq126,r_36_57_98,r_123_98_174,0.29,0,174,174,66
15,r_54_70_39,r_123_98_174,seq37,r_54_70_39,1.0,0,39,39,66
24,r_99_68_22,r_14_132_27,seq112,r_99_68_22,0.99,0,22,22,66
40,r_97_90_58,seq131,r_42_11_49,r_97_90_58,1.0,2,60,58,66
34,r_121_39_72,r_6_73_144,r_104_3_112,r_6_73_144,0.97,0,144,144,66
43,r_27_7_127,r_141_91_20,seq60,r_27_7_127,0.74,3,130,127,66
33,r_128_38_68,seq136,seq126,r_128_38_68,0.96,1,69,68,66
47,r_141_91_20,r_27_7_127,seq33,r_27_7_127,0.71,-25,102,127,66
88,seq103,r_27_7_127,seq126,r_27_7_127,0.63,-25,102,127,66
1,r_44_95_46,r_110_2_74,r_16_147_9,r_110_2_74,0.94,0,74,74,66
38,r_42_11_49,r_63_133_131,r_97_90_58,r_42_11_49,1.0,11,60,49,66
34,r_121_39_72,r_58_32_148,r_6_73_144,r_121_39_72,1.0,1,73,72,66
6,r_41_83_86,r_92_137_125,r_46_72_115,r_41_83_86,0.86,40,126,86,66
17,r_93_105_109,seq106,r_46_72_115,r_93_105_109,0.96,1,110,109,66
1,r_44_95_46,r_16_147_9,r_27_7_127,r_44_95_46,0.56,84,130,46,66
28,r_92_137_125,seq8,r_42_11_49,r_92_137_125,0.57,1,126,125,66
0,r_80_134_199,r_47_119_157,r_71_61_116,r_47_119_157,0.58,5,162,157,66
49,r_75_10_164,seq59,r_122_76_94,r_122_76_94,0.97,67,161,94,66
7,r_117_82_130,seq79,seq129,r_117_82_130,0.76,0,130,130,66
44,r_13_108_91,seq107,seq53,r_13_108_91,0.8,1,92,91,66
23,r_77_148_128,seq4,r_51_34_129,r_51_34_129,0.8,-3,126,129,66
82,seq87,seq26,r_142_145_75,r_142_145_75,1.0,56,131,75,66
1,r_44_95_46,r_27_7_127,r_93_105_109,r_44_95_46,0.51,135,181,46,66
35,r_71_61_116,seq106,seq1,r_71_61_116,0.99,0,116,116,66
12,r_58_32_148,seq144,r_120_49_32,r_58_32_148,0.93,2,150,148,66
36,r_37_121_76,r_110_49_114,seq117,r_37_121_76,0.99,0,76,76,67
2,r_63_39_165,r_91_112_72,r_92_146_15,r_63_39_165,0.97,-150,15,165,67
14,r_93_100_101,seq41,r_92_146_15,r_92_146_15,0.86,97,112,15,67
53,seq10,r_64_33_159,seq52,r_64_33_159,1.0,0,159,159,67
21,r_78_65_167,seq124,seq42,r_78_65_167,0.83,0,167,167,67
39,r_6_57_155,seq38,r_110_49_114,r_110_49_114,0.6,44,158,114,67
97,seq123,r_6_57_155,r_3_86_176,r_6_57_155,0.97,-50,105,155,67
5,r_59_139_95,seq42,seq60,r_59_139_95,0.99,0,95,95,67
46,r_11_43_157,seq18,r_46_127_5,r_11_43_157,0.62,2,159,157,67
80,seq80,r_69_32_173,r_4_50_141,r_4_50_141,0.96,33,174,141,67
69,seq45,r_7_21_160,r_74_142_124,r_74_142_124,0.67,36,160,124,67
45,r_107_2_103,r_135_131_145,r_6_57_155,r_107_2_103,0.75,1,104,103,67
66,seq40,seq13,r_110_49_114,r_110_49_114,0.97,5,119,114,67
19,r_48_16_51,seq94,r_114_84_19,r_48_16_51,1.0,1,52,51,67
26,r_46_127_5,seq8,r_11_43_157,r_11_43_157,0.89,7,164,157,67
31,r_108_17_128,seq138,seq104,r_108_17_128,1.0,1,129,128,67
3,r_110_49_114,r_37_121_76,seq105,r_37_121_76,0.96,0,76,76,67
90,seq104,seq116,r_20_130_45,r_20_130_45,1.0,20,65,45,67
26,r_46_127_5,r_137_27_133,seq8,r_137_27_133,0.91,0,133,133,67
8,r_92_146_15,r_63_39_165,r_93_100_101,r_63_39_165,0.72,1,166,165,67
34,r_90_23_174,r_111_67_16,r_132_128_14,r_90_23_174,1.0,0,174,174,67
42,r_114_84_19,seq124,r_48_16_51,r_48_16_51,1.0,2,53,51,67
3,r_110_49_114,seq105,seq40,r_110_49_114,0.57,2,116,114,67
4,r_54_134_99,r_135_131_145,seq140,r_54_134_99,0.95,3,102,99,67
8,r_92_146_15,r_70_96_34,r_63_39_165,r_92_146_15,0.55,0,15,15,67
20,r_137_27_133,r_46_127_5,r_56_126_8,r_137_27_133,0.98,0,133,133,67
13,r_7_21_160,seq45,r_3_86_176,r_7_21_160,0.56,0,160,160,67
15,r_74_142_124,seq8,seq45,r_74_142_124,0.92,0,124,124,67
48,r_28_35_149,seq19,seq123,r_28_35_149,0.68,0,149,149,67
6,r_1_62_74,seq19,seq82,r_1_62_74,1.0,0,74,74,67
43,r_111_67_16,r_6_57_155,seq124,r_111_67_16,0.99,1,17,16,67
2,r_63_39_165,r_92_146_15,r_76_115_111,r_92_146_15,0.47,151,166,15,67
42,r_114_84_19,seq143,seq124,r_114_84_19,0.98,-2,17,19,67
27,r_91_112_72,r_66_122_163,r_56_126_8,r_91_112_72,1.0,2,74,72,67
0,r_70_96_34,seq104,r_20_130_45,r_20_130_45,1.0,8,53,45,67
40,r_145_103_77,r_147_133_188,r_114_84_19,r_145_103_77,1.0,1,78,77,67
16,r_20_130_45,seq124,r_70_96_34,r_20_130_45,0.95,0,45,45,67
29,r_119_113_170,r_3_86_176,r_46_127_5,r_119_113_170,0.23,1,171,170,67
24,r_31_88_140,seq82,r_111_67_16,r_31_88_140,1.0,0,140,140,67
5,r_59_139_95,seq60,r_14_30_134,r_14_30_134,1.0,11,145,134,67
34,r_90_23_174,r_114_84_19,r_111_67_16,r_114_84_19,0.44,85,104,19,67
38,r_58_129_11,r_147_133_188,seq99,r_58_129_11,1.0,0,11,11,67
25,r_135_131_145,seq101,seq29,r_135_131_145,0.97,0,145,145,67
45,r_107_2_103,r_6_57_155,r_83_144_126,r_6_57_155,0.8,3,158,155,67
33,r_76_115_111,seq22,seq5,r_76_115_111,0.98,0,111,111,67
34,r_90_23_174,r_20_130_45,r_114_84_19,r_90_23_174,0.81,-157,17,174,67
88,seq101,r_135_131_145,r_24_87_22,r_135_131_145,1.0,0,145,145,67
32,r_83_144_126,seq13,r_107_2_103,r_83_144_126,0.96,0,126,126,67
77,seq75,r_53_73_83,seq41,r_53_73_83,1.0,3,86,83,67
60,seq22,r_76_115_111,r_89_136_53,r_76_115_111,0.86,-41,70,111,67
17,r_15_0_61,r_37_121_76,seq140,r_15_0_61,1.0,0,61,61,67
94,seq117,seq82,r_37_121_76,r_37_121_76,1.0,8,84,76,67
90,seq104,r_20_130_45,r_108_17_128,r_108_17_128,1.0,31,159,128,67
22,r_132_128_14,r_70_96_34,seq105,r_70_96_34,0.74,-21,13,34,67
28,r_53_73_83,seq75,seq120,r_53_73_83,0.89,1,84,83,67
7,r_4_50_141,r_46_127_5,seq80,r_4_50_141,0.65,0,141,141,67
10,r_89_136_53,seq72,seq22,r_89_136_53,0.61,0,53,53,67
35,r_66_122_163,seq102,r_108_17_128,r_108_17_128,0.97,35,163,128,67
12,r_69_32_173,seq80,r_3_86_176,r_3_86_176,0.91,-2,174,176,67
30,r_64_26_186,seq6,r_136_139_112,r_64_26_186,0.44,0,186,186,68
36,r_123_29_172,seq73,r_99_46_58,r_99_46_58,0.99,114,172,58,68
8,r_5_103_81,seq138,seq33,r_5_103_81,0.94,-4,77,81,68
53,seq6,r_86_108_161,seq143,r_86_108_161,0.98,0,161,161,68
43,r_81_53_182,seq66,seq44,r_81_53_182,0.44,1,183,182,68
78,seq134,r_99_46_58,seq83,r_99_46_58,1.0,-23,35,58,68
55,seq10,r_63_47_141,r_3_18_4,r_63_47_141,0.92,4,145,141,68
16,r_28_89_63,seq83,r_112_71_35,r_28_89_63,1.0,1,64,63,68
41,r_142_127_21,r_52_20_66,r_32_11_10,r_142_127_21,0.99,0,21,21,68
5,r_136_139_112,r_79_9_129,r_5_103_81,r_136_139_112,0.91,2,114,112,68
42,r_63_47_141,seq10,seq0,r_63_47_141,0.96,4,145,141,68
19,r_65_42_70,r_79_9_129,seq144,r_65_42_70,1.0,0,70,70,68
27,r_72_104_103,seq44,r_41_22_40,r_72_104_103,0.88,5,108,103,68
98,seq124,r_31_60_45,r_2_109_193,r_31_60_45,0.9,-4,41,45,68
1,r_41_22_40,seq24,r_16_69_22,r_41_22_40,0.69,-5,35,40,68
45,r_87_34_56,r_98_27_145,seq93,r_87_34_56,1.0,1,57,56,68
31,r_130_23_84,seq38,seq83,r_130_23_84,0.86,3,87,84,68
67,seq37,r_52_20_66,seq50,r_52_20_66,0.94,3,69,66,68
3,r_117_85_78,r_140_82_86,r_32_11_10,r_117_85_78,1.0,1,79,78,68
4,r_99_46_58,seq134,seq40,r_99_46_58,1.0,0,58,58,68
10,r_59_45_176,seq21,r_86_108_161,r_59_45_176,0.75,0,176,176,68
9,r_125_116_197,seq40,r_35_131_51,r_35_131_51,1.0,-2,49,51,68
26,r_12_62_100,r_136_139_112,r_55_49_65,r_55_49_65,0.97,34,99,65,68
11,r_119_102_102,r_39_7_149,seq138,r_119_102_102,0.8,0,102,102,68
20,r_55_49_65,r_130_23_84,r_19_61_164,r_55_49_65,1.0,1,66,65,68
15,r_114_121_153,seq24,r_52_20_66,r_114_121_153,0.45,3,156,153,68
57,seq143,seq17,r_90_76_109,r_90_76_109,1.0,62,171,109,68
37,r_88_128_37,seq146,seq21,r_88_128_37,1.0,0,37,37,68
13,r_112_71_35,r_136_139_112,r_28_89_63,r_112_71_35,0.97,63,98,35,68
6,r_86_108_161,seq6,r_98_27_145,r_86_108_161,0.9,0,161,161,68
62,seq21,r_59_45_176,r_88_128_37,r_88_128_37,0.85,139,176,37,68
27,r_72_104_103,r_120_137_39,seq44,r_120_137_39,0.98,8,47,39,68
2,r_90_76_109,seq126,r_140_82_86,r_90_76_109,0.98,0,109,109,68
40,r_15_105_151,seq78,seq73,r_15_105_151,0.92,0,151,151,68
46,r_149_75_195,r_19_61_164,r_120_137_39,r_120_137_39,1.0,-2,37,39,68
25,r_4_68_114,r_39_7_149,seq129,r_39_7_149,0.78,-35,114,149,68
33,r_140_82_86,seq93,seq143,r_140_82_86,0.93,0,86,86,68
64,seq25,r_98_27_145,r_39_7_149,r_98_27_145,0.88,1,146,145,68
13,r_112_71_35,r_63_47_141,r_136_139_112,r_112_71_35,0.72,0,35,35,68
88,seq92,r_2_109_193,r_19_61_164,r_2_109_193,0.29,-54,139,193,68
70,seq43,r_94_56_113,r_91_51_94,r_91_51_94,0.77,22,116,94,68
20,r_55_49_65,r_19_61_164,r_12_62_100,r_55_49_65,0.91,100,165,65,68
32,r_141_107_87,seq100,seq33,r_141_107_87,0.99,0,87,87,68
77,seq138,r_149_75_195,r_119_102_102,r_119_102_102,0.71,3,105,102,68
24,r_120_137_39,r_72_104_103,r_149_75_195,r_120_137_39,0.98,-2,37,39,68
17,r_19_61_164,r_149_75_195,r_55_49_65,r_55_49_65,1.0,32,97,65,68
50,seq0,seq83,r_63_47_141,r_63_47_141,0.99,0,141,141,68
48,r_31_60_45,seq124,seq143,r_31_60_45,1.0,-2,43,45,68
28,r_111_14_77,seq54,seq93,r_111_14_77,1.0,3,80,77,68
23,r_35_131_51,r_39_7_149,r_125_116_197,r_35_131_51,1.0,-3,48,51,68
17,r_19_61_164,r_55_49_65,seq92,r_19_61_164,0.9,1,165,164,68
82,seq73,r_19_61_164,r_119_102_102,r_119_102_102,0.54,59,161,102,68
35,r_91_51_94,seq48,seq43,r_91_51_94,1.0,1,95,94,68
84,seq78,r_15_105_151,seq0,r_15_105_151,0.97,0,151,151,68
36,r_114_139_104,r_125_137_180,r_83_44_68,r_114_139_104,0.99,0,104,104,69
9,r_51_94_93,r_115_30_162,r_70_87_145,r_51_94_93,1.0,69,162,93,69
44,r_4_14_13,r_115_30_162,seq97,r_4_14_13,1.0,0,13,13,69
14,r_13_2_193,r_52_24_184,r_41_132_10,r_41_132_10,0.62,176,186,10,69
17,r_27_76_49,r_110_43_94,seq62,r_27_76_49,1.0,1,50,49,69
46,r_119_131_15,r_110_43_94,seq62,r_119_131_15,0.95,0,15,15,69
16,r_11_103_117,seq50,r_140_49_167,r_11_103_117,1.0,0,117,117,69
21,r_81_126_106,seq42,seq72,r_81_126_106,1.0,0,106,106,69
39,r_140_49_167,r_99_47_190,r_115_30_162,r_99_47_190,0.68,-23,167,190,69
1,r_110_43_94,seq109,seq8,r_110_43_94,1.0,0,94,94,69
97,seq120,r_102_127_176,r_11_103_117,r_11_103_117,0.94,57,174,117,69
28,r_117_36_52,seq112,seq88,r_117_36_52,0.99,-1,51,52,69
42,r_82_57_22,seq18,r_15_98_147,r_15_98_147,0.89,3,150,147,69
38,r_56_9_37,r_145_66_186,seq3,r_56_9_37,1.0,2,39,37,69
45,r_69_84_199,r_83_44_68,r_101_142_34,r_69_84_199,0.91,-131,68,199,69
94,seq112,r_117_36_52,seq91,r_117_36_52,0.97,-1,51,52,69
76,seq63,r_130_45_183,r_148_92_90,r_148_92_90,0.99,93,183,90,69
31,r_25_35_148,seq73,r_56_9_37,r_25_35_148,0.85,0,148,148,69
41,r_28_86_124,r_34_58_2,r_11_103_117,r_28_86_124,0.96,1,125,124,69
89,seq95,r_145_66_186,seq0,r_145_66_186,0.94,-14,172,186,69
3,r_96_38_61,r_115_30_162,seq75,r_96_38_61,1.0,0,61,61,69
10,r_71_60_127,seq95,r_110_43_94,r_71_60_127,1.0,0,127,127,69
90,seq97,r_52_24_184,r_83_44_68,r_83_44_68,1.0,117,185,68,69
26,r_70_87_145,r_102_127_176,r_51_94_93,r_70_87_145,0.75,0,145,145,69
0,r_145_66_186,seq95,r_110_43_94,r_145_66_186,0.51,0,186,186,69
11,r_52_24_184,r_13_2_193,seq138,r_13_2_193,0.42,-8,185,193,69
99,seq124,seq85,r_102_127_176,r_102_127_176,0.88,1,177,176,69
20,r_15_98_147,seq105,r_82_57_22,r_15_98_147,0.72,0,147,147,69
37,r_21_19_21,r_52_24_184,r_79_100_192,r_21_19_21,1.0,1,22,21,69
13,r_68_122_177,seq138,r_102_127_176,r_68_122_177,0.62,0,177,177,69
33,r_41_132_10,r_117_36_52,seq65,r_41_132_10,0.59,4,14,10,69
33,r_41_132_10,seq65,r_106_7_66,r_106_7_66,1.0,0,66,66,69
6,r_99_47_190,r_140_49_167,r_11_103_117,r_11_103_117,0.98,50,167,117,69
99,seq124,r_33_129_84,seq85,r_33_129_84,1.0,0,84,84,69
27,r_61_78_165,seq141,seq29,r_61_78_165,0.87,0,165,165,69
19,r_101_142_34,r_79_100_192,r_69_84_199,r_101_142_34,1.0,0,34,34,69
2,r_34_58_2,r_28_86_124,r_146_26_178,r_28_86_124,1.0,1,125,124,69
47,r_136_46_152,seq8,seq18,r_136_46_152,0.94,0,152,152,69
74,seq138,r_68_122_177,r_148_92_90,r_148_92_90,0.49,87,177,90,69
18,r_144_128_146,seq63,seq54,r_144_128_146,0.63,1,147,146,69
29,r_106_7_66,r_25_35_148,r_41_132_10,r_106_7_66,1.0,0,66,66,69
24,r_12_20_112,r_125_137_180,r_82_57_22,r_12_20_112,1.0,2,114,112,69
50,seq0,seq143,r_125_137_180,r_125_137_180,0.81,0,180,180,69
77,seq65,r_41_132_10,r_39_1_58,r_39_1_58,1.0,1,59,58,69
32,r_104_31_129,r_64_147_143,seq10,r_104_31_129,0.38,15,144,129,69
43,r_39_1_58,r_68_122_177,seq65,r_39_1_58,1.0,1,59,58,69
51,seq3,seq54,r_56_9_37,r_56_9_37,1.0,19,56,37,69
9,r_51_94_93,seq63,r_115_30_162,r_51_94_93,0.86,2,95,93,69
16,r_11_103_117,r_140_49_167,r_28_86_124,r_140_49_167,1.0,0,167,167,69
22,r_64_147_143,r_145_66_186,r_101_142_34,r_101_142_34,0.93,109,143,34,69
49,r_33_129_84,seq124,seq29,r_33_129_84,0.99,0,84,84,69
7,r_148_92_90,r_99_47_190,seq63,r_148_92_90,1.0,2,92,90,69
23,r_115_30_162,seq22,seq80,r_115_30_162,0.49,0,162,162,69
82,seq75,r_125_137_180,r_96_38_61,r_96_38_61,1.0,81,142,61,69
79,seq72,seq118,r_81_126_106,r_81_126_106,1.0,43,149,106,69
35,r_83_44_68,r_69_84_199,r_4_14_13,r_83_44_68,1.0,0,68,68,69
12,r_125_137_180,seq75,seq0,r_125_137_180,0.54,0,180,180,69
93,seq111,r_69_143_148,r_70_91_70,r_70_91_70,1.0,3,73,70,70
30,r_90_34_162,seq107,seq106,r_90_34_162,0.6,2,164,162,70
36,r_133_89_120,seq8,r_112_59_17,r_133_89_120,1.0,0,120,120,70
37,r_79_74_55,r_67_71_149,seq148,r_79_74_55,1.0,0,55,55,70
92,seq110,r_126_3_152,r_115_14_63,r_115_14_63,0.99,26,89,63,70
53,seq7,r_116_58_186,r_125_149_59,r_125_149_59,1.0,127,186,59,70
43,r_42_75_168,seq113,r_94_144_144,r_42_75_168,0.81,0,168,168,70
16,r_114_35_154,r_126_3_152,seq99,r_114_35_154,0.93,-1,153,154,70
21,r_33_48_85,r_57_61_103,r_10_96_90,r_57_61_103,0.87,-18,85,103,70
1,r_65_17_116,seq72,seq11,r_65_17_116,0.43,0,116,116,70
5,r_67_71_149,seq106,r_23_19_29,r_23_19_29,0.97,122,151,29,70
42,r_73_27_183,seq8,r_98_129_48,r_98_129_48,1.0,139,187,48,70
69,seq135,seq4,r_10_96_90,r_10_96_90,1.0,43,133,90,70
45,r_63_134_83,seq106,r_76_124_79,r_63_134_83,1.0,2,85,83,70
47,r_68_18_6,seq51,r_132_137_51,r_132_137_51,0.97,2,53,51,70
9,r_83_38_40,r_105_92_110,seq100,r_83_38_40,1.0,0,40,40,70
76,seq53,seq46,r_86_55_91,r_86_55_91,0.99,1,92,91,70
31,r_117_31_75,seq135,seq8,r_117_31_75,1.0,1,76,75,70
27,r_112_59_17,r_86_55_91,seq30,r_112_59_17,0.93,0,17,17,70
89,seq106,r_63_134_83,r_141_140_10,r_63_134_83,0.96,-10,73,83,70
3,r_25_54_157,seq100,seq107,r_25_54_157,0.25,2,159,157,70
10,r_77_102_92,r_105_92_110,r_83_38_40,r_105_92_110,1.0,-17,93,110,70
26,r_123_87_181,seq37,r_69_143_148,r_69_143_148,0.51,35,183,148,70
64,seq22,r_101_103_31,r_69_143_148,r_101_103_31,0.31,122,153,31,70
12,r_132_137_51,seq148,r_68_18_6,r_132_137_51,1.0,0,51,51,70
20,r_126_3_152,r_114_35_154,seq15,r_126_3_152,0.93,-1,151,152,70
13,r_116_58_186,seq7,r_112_59_17,r_116_58_186,0.35,0,186,186,70
48,r_146_26_160,seq60,seq20,r_146_26_160,0.87,0,160,160,70
6,r_119_131_147,r_24_39_188,r_10_96_90,r_119_131_147,0.96,0,147,147,70
19,r_23_19_29,r_32_13_197,seq113,r_23_19_29,1.0,0,29,29,70
49,r_43_56_24,r_86_55_91,seq136,r_43_56_24,1.0,1,25,24,70
2,r_47_64_104,seq138,r_147_128_89,r_147_128_89,0.75,43,132,89,70
41,r_32_13_197,r_116_58_186,seq99,r_116_58_186,0.4,-3,183,186,70
4,r_101_103_31,seq46,r_23_19_29,r_23_19_29,1.0,18,47,29,70
40,r_57_61_103,seq22,seq142,r_57_61_103,1.0,2,105,103,70
18,r_105_92_110,seq127,r_125_149_59,r_125_149_59,1.0,75,134,59,70
24,r_115_14_63,seq135,seq110,r_115_14_63,1.0,1,64,63,70
34,r_41_108_56,seq100,r_141_140_10,r_41_108_56,1.0,2,58,56,70
35,r_80_2_28,seq135,r_10_96_90,r_10_96_90,1.0,16,106,90,70
33,r_70_91_70,seq45,seq111,r_70_91_70,1.0,1,71,70,70
64,seq22,r_57_61_103,r_101_103_31,r_57_61_103,0.99,2,105,103,70
11,r_125_149_59,seq15,r_79_74_55,r_125_149_59,0.93,0,59,59,70
25,r_141_140_10,seq7,r_79_74_55,r_141_140_10,0.95,0,10,10,70
68,seq37,r_123_87_181,r_130_97_81,r_130_97_81,1.0,102,183,81,70
35,r_80_2_28,r_47_64_104,seq135,r_80_2_28,1.0,1,29,28,70
32,r_10_96_90,r_62_49_199,r_80_2_28,r_10_96_90,0.88,1,91,90,70
25,r_141_140_10,r_79_74_55,r_41_108_56,r_79_74_55,0.87,0,55,55,70
77,seq60,r_146_26_160,r_98_129_48,r_98_129_48,0.99,106,154,48,70
17,r_24_39_188,r_119_131_147,r_79_74_55,r_79_74_55,0.97,18,73,55,70
38,r_36_5_49,seq22,seq20,r_36_5_49,1.0,0,49,49,70
22,r_86_55_91,seq4,seq53,r_86_55_91,0.97,0,91,91,70
28,r_76_124_79,r_77_102_92,r_63_134_83,r_76_124_79,1.0,1,80,79,70
63,seq21,r_67_71_149,r_112_59_17,r_112_59_17,0.96,12,29,17,70
41,r_32_13_197,r_23_19_29,r_116_58_186,r_23_19_29,0.81,0,29,29,70
39,r_98_129_48,r_90_34_162,seq60,r_98_129_48,1.0,0,48,48,70
23,r_130_97_81,seq113,seq29,r_130_97_81,1.0,1,82,81,70
17,r_24_39_188,r_79_74_55,seq136,r_24_39_188,0.37,0,188,188,70
51,seq129,r_105_70_120,seq143,r_105_70_120,1.0,1,121,120,71
36,r_128_75_158,seq109,r_127_79_141,r_128_75_158,0.87,0,158,158,71
66,seq36,r_110_126_32,r_132_33_131,r_132_33_131,1.0,0,131,131,71
43,r_19_131_66,r_53_119_159,r_81_80_50,r_53_119_159,0.99,-93,66,159,71
37,r_86_28_149,seq25,r_65_123_6,r_65_123_6,0.79,146,152,6,71
59,seq20,r_114_93_191,r_55_24_124,r_55_24_124,1.0,58,182,124,71
5,r_138_64_46,r_132_33_131,r_12_111_100,r_138_64_46,1.0,0,46,46,71
71,seq43,r_114_93_191,r_57_144_10,r_57_144_10,0.5,88,98,10,71
16,r_105_70_120,seq129,r_46_66_107,r_105_70_120,1.0,1,121,120,71
21,r_6_29_128,r_77_133_143,seq23,r_6_29_128,0.89,0,128,128,71
39,r_53_119_159,r_19_131_66,seq43,r_19_131_66,1.0,0,66,66,71
1,r_100_121_163,r_103_96_51,seq44,r_100_121_163,0.92,0,163,163,71
1,r_100_121_163,r_14_47_97,r_103_96_51,r_100_121_163,0.79,-66,97,163,71
46,r_46_66_107,seq41,seq36,r_46_66_107,0.99,0,107,107,71
32,r_147_40_160,r_103_96_51,r_120_10_123,r_103_96_51,0.72,109,160,51,71
31,r_81_80_50,seq112,seq45,r_81_80_50,1.0,0,50,50,71
41,r_52_91_87,seq122,seq130,r_52_91_87,1.0,3,90,87,71
23,r_62_49_104,r_110_126_32,r_52_91_87,r_62_49_104,0.73,0,104,104,71
26,r_120_10_123,seq23,seq73,r_120_10_123,0.95,0,123,123,71
9,r_50_94_26,r_4_59_101,seq41,r_50_94_26,0.99,1,27,26,71
73,seq45,seq84,r_81_80_50,r_81_80_50,1.0,20,70,50,71
11,r_82_146_177,r_12_111_100,seq54,r_12_111_100,0.43,78,178,100,71
20,r_56_61_187,seq73,r_6_29_128,r_6_29_128,0.77,60,188,128,71
13,r_127_79_141,seq22,r_65_123_6,r_65_123_6,0.77,138,144,6,71
98,seq124,r_145_97_151,seq43,r_145_97_151,1.0,5,156,151,71
38,r_140_7_47,seq67,r_50_94_26,r_140_7_47,0.68,4,51,47,71
48,r_83_101_127,r_147_40_160,r_19_131_66,r_147_40_160,0.71,-33,127,160,71
10,r_103_96_51,r_147_40_160,r_125_31_164,r_147_40_160,0.99,1,161,160,71
27,r_71_9_132,seq41,r_30_35_112,r_71_9_132,0.98,0,132,132,71
47,r_14_47_97,r_100_121_163,seq42,r_14_47_97,0.91,0,97,97,71
18,r_90_92_119,r_77_133_143,r_104_34_20,r_90_92_119,0.99,0,119,119,71
24,r_12_111_100,r_82_146_177,r_138_64_46,r_138_64_46,1.0,132,178,46,71
65,seq32,r_132_33_131,r_48_1_62,r_48_1_62,0.82,3,65,62,71
44,r_57_144_10,r_87_38_193,r_5_107_13,r_57_144_10,0.97,0,10,10,71
34,r_132_33_131,r_2_99_194,r_46_66_107,r_132_33_131,0.99,0,131,131,71
25,r_5_107_13,r_52_91_87,r_57_144_10,r_5_107_13,0.92,9,22,13,71
33,r_104_34_20,seq27,r_62_49_104,r_104_34_20,0.94,4,24,20,71
81,seq73,r_56_61_187,r_138_64_46,r_138_64_46,1.0,142,188,46,71
17,r_77_133_143,r_125_31_164,seq139,r_77_133_143,0.96,0,143,143,71
33,r_104_34_20,r_110_126_32,r_90_92_119,r_90_92_119,1.0,1,120,119,71
0,r_134_137_31,r_83_101_127,seq122,r_134_137_31,1.0,1,32,31,71
33,r_104_34_20,r_62_49_104,r_110_126_32,r_62_49_104,0.91,-33,71,104,71
22,r_4_59_101,seq23,r_65_123_6,r_65_123_6,0.51,103,109,6,71
10,r_103_96_51,seq22,r_147_40_160,r_103_96_51,0.67,0,51,51,71
28,r_145_97_151,seq124,r_62_49_104,r_145_97_151,0.55,5,156,151,71
91,seq109,r_128_75_158,seq69,r_128_75_158,0.93,0,158,158,71
4,r_110_126_32,r_118_117_181,seq36,r_110_126_32,0.99,3,35,32,71
7,r_125_31_164,r_142_3_186,r_103_96_51,r_125_31_164,0.48,0,164,164,71
32,r_147_40_160,r_83_101_127,r_103_96_51,r_147_40_160,0.86,-108,52,160,71
23,r_62_49_104,r_48_1_62,r_110_126_32,r_48_1_62,0.62,0,62,62,71
35,r_118_117_181,r_77_133_143,r_90_92_119,r_118_117_181,0.98,0,181,181,71
35,r_118_117_181,seq139,r_77_133_143,r_77_133_143,0.95,9,152,143,71
12,r_8_17_182,seq112,r_57_144_10,r_57_144_10,1.0,156,166,10,71
6,r_37_18_18,r_4_59_101,seq63,r_37_18_18,0.99,1,19,18,71
30,r_80_29_84,r_61_27_129,seq125,r_80_29_84,0.71,1,85,84,72
36,r_26_97_135,seq110,seq8,r_26_97_135,1.0,0,135,135,72
7,r_128_98_20,r_148_4_181,r_135_102_137,r_128_98_20,0.51,117,137,20,72
37,r_39_6_128,seq110,seq77,r_39_6_128,0.94,1,129,128,72
39,r_28_103_143,r_9_132_152,r_148_4_181,r_28_103_143,0.76,2,145,143,72
5,r_115_131_89,seq54,seq51,r_115_131_89,0.88,1,90,89,72
46,r_50_83_180,r_49_139_198,r_149_118_80,r_49_139_198,0.56,-18,180,198,72
42,r_30_86_94,r_148_4_181,seq93,r_30_86_94,0.72,0,94,94,72
45,r_133_99_141,r_88_117_190,seq54,r_88_117_190,0.61,-49,141,190,72
23,r_134_37_24,r_16_81_78,r_22_85_11,r_16_81_78,1.0,1,79,78,72
19,r_20_75_178,r_88_117_190,r_26_97_135,r_26_97_135,0.89,40,175,135,72
11,r_124_7_8,r_88_117_190,r_31_5_174,r_31_5_174,0.55,16,190,174,72
95,seq116,r_61_27_129,r_127_23_67,r_127_23_67,0.98,62,129,67,72
66,seq48,seq13,r_16_81_78,r_16_81_78,1.0,8,86,78,72
31,r_57_119_142,r_70_73_63,r_59_114_122,r_57_119_142,0.87,2,144,142,72
41,r_68_45_134,r_43_130_121,r_115_131_89,r_115_131_89,0.5,31,120,89,72
67,seq51,seq78,r_115_131_89,r_115_131_89,1.0,53,142,89,72
3,r_66_112_101,r_148_4_181,r_49_139_198,r_66_112_101,0.98,1,102,101,72
10,r_43_130_121,r_68_45_134,seq10,r_43_130_121,0.53,2,123,121,72
26,r_52_18_82,seq71,seq19,r_52_18_82,1.0,1,83,82,72
0,r_148_4_181,r_66_112_101,r_33_1_92,r_148_4_181,0.85,-79,102,181,72
15,r_35_121_99,r_43_130_121,seq93,r_35_121_99,0.57,0,99,99,72
48,r_9_132_152,r_28_103_143,r_24_92_77,r_9_132_152,0.87,-1,151,152,72
4,r_138_47_19,r_149_118_80,seq116,r_138_47_19,0.95,0,19,19,72
7,r_128_98_20,r_30_86_94,seq91,r_30_86_94,0.65,-40,54,94,72
47,r_127_23_67,r_96_56_185,seq116,r_127_23_67,1.0,0,67,67,72
40,r_0_55_158,seq93,r_104_3_102,r_0_55_158,0.76,4,162,158,72
74,seq74,seq143,r_57_119_142,r_57_119_142,0.72,5,147,142,72
18,r_42_38_100,seq101,seq137,r_42_38_100,0.83,0,100,100,72
24,r_33_1_92,seq108,seq126,r_33_1_92,0.76,0,92,92,72
33,r_59_114_122,r_61_27_129,seq74,r_59_114_122,0.67,0,122,122,72
43,r_69_136_44,r_16_81_78,r_96_56_185,r_69_136_44,0.81,0,44,44,72
61,seq19,seq110,r_52_18_82,r_52_18_82,1.0,67,149,82,72
32,r_16_81_78,seq32,seq48,r_16_81_78,1.0,0,78,78,72
77,seq78,seq51,r_149_118_80,r_149_118_80,1.0,62,142,80,72
23,r_134_37_24,r_61_27_129,r_16_81_78,r_16_81_78,0.47,-58,20,78,72
7,r_128_98_20,seq101,r_30_86_94,r_128_98_20,0.85,10,30,20,72
9,r_149_118_80,r_9_132_152,seq78,r_149_118_80,0.94,0,80,80,72
29,r_88_117_190,r_124_7_8,r_22_85_11,r_22_85_11,0.81,179,190,11,72
41,r_68_45_134,r_115_131_89,r_69_136_44,r_68_45_134,0.77,0,134,134,72
49,r_104_3_102,seq72,seq101,r_104_3_102,0.84,30,132,102,72
44,r_135_102_137,seq40,r_128_98_20,r_135_102_137,0.62,1,138,137,72
35,r_24_92_77,seq72,seq71,r_24_92_77,0.99,1,78,77,72
12,r_11_25_148,r_96_56_185,r_33_1_92,r_96_56_185,0.6,-35,150,185,72
14,r_12_122_55,r_65_106_138,r_96_56_185,r_12_122_55,1.0,0,55,55,72
1,r_141_62_26,seq2,seq116,r_141_62_26,1.0,0,26,26,72
36,r_92_18_80,seq36,seq60,r_92_18_80,0.6,3,83,80,73
17,r_142_21_57,r_35_61_75,seq94,r_142_21_57,1.0,0,57,57,73
14,r_20_128_184,seq24,r_72_93_112,r_72_93_112,1.0,72,184,112,73
8,r_98_66_60,seq82,seq100,r_98_66_60,1.0,0,60,60,73
43,r_123_27_77,seq111,seq32,r_123_27_77,1.0,0,77,77,73
83,seq76,r_86_38_151,r_89_41_21,r_86_38_151,0.52,1,152,151,73
37,r_17_11_188,seq102,r_72_93_112,r_72_93_112,1.0,76,188,112,73
16,r_116_117_135,seq110,r_85_57_37,r_116_117_135,0.52,3,138,135,73
21,r_4_147_89,seq79,seq34,r_4_147_89,0.96,0,89,89,73
1,r_67_63_109,seq13,seq6,r_67_63_109,0.99,0,109,109,73
5,r_104_43_177,r_19_107_125,seq9,r_19_107_125,1.0,-36,89,125,73
46,r_31_143_126,r_10_115_194,r_84_108_67,r_10_115_194,0.89,-68,126,194,73
42,r_10_115_194,r_31_143_126,seq76,r_31_143_126,0.74,0,126,126,73
91,seq100,r_55_127_171,r_85_57_37,r_85_57_37,0.95,-3,34,37,73
80,seq69,r_99_135_166,r_72_93_112,r_72_93_112,0.89,45,157,112,73
88,seq94,r_142_21_57,r_146_44_144,r_146_44_144,1.0,10,154,144,73
13,r_105_118_56,r_67_63_109,seq39,r_67_63_109,0.53,-53,56,109,73
45,r_29_12_79,r_5_78_164,seq32,r_29_12_79,0.95,0,79,79,73
34,r_122_49_10,r_53_113_110,seq6,r_122_49_10,1.0,0,10,10,73
19,r_62_126_93,r_5_78_164,r_103_109_85,r_62_126_93,1.0,0,93,93,73
19,r_62_126_93,r_103_109_85,r_96_119_72,r_103_109_85,0.73,57,142,85,73
31,r_146_44_144,seq32,seq94,r_146_44_144,0.91,1,145,144,73
41,r_103_109_85,r_67_63_109,r_105_118_56,r_67_63_109,1.0,-24,85,109,73
3,r_48_129_73,seq125,r_142_21_57,r_142_21_57,0.83,15,72,57,73
10,r_84_108_67,r_55_127_171,seq40,r_84_108_67,1.0,-1,66,67,73
0,r_131_1_156,r_16_121_187,seq30,r_16_121_187,0.54,-30,157,187,73
20,r_53_113_110,r_99_135_166,seq9,r_53_113_110,0.97,0,110,110,73
4,r_35_61_75,r_64_15_111,r_51_52_63,r_35_61_75,0.95,0,75,75,73
15,r_51_52_63,r_5_78_164,seq24,r_51_52_63,1.0,-1,62,63,73
44,r_136_0_178,r_72_93_112,r_139_46_97,r_136_0_178,0.88,0,178,178,73
85,seq81,r_55_127_171,r_98_66_60,r_98_66_60,1.0,113,173,60,73
99,seq125,r_48_129_73,seq149,r_48_129_73,1.0,-3,70,73,73
5,r_104_43_177,seq9,r_72_93_112,r_104_43_177,0.81,2,179,177,73
27,r_59_50_147,r_99_135_166,r_116_117_135,r_59_50_147,0.92,0,147,147,73
7,r_88_68_19,r_72_93_112,seq30,r_88_68_19,1.0,0,19,19,73
17,r_142_21_57,seq94,r_48_129_73,r_48_129_73,0.9,3,76,73,73
2,r_72_93_112,seq97,seq32,r_72_93_112,1.0,0,112,112,73
39,r_137_77_20,seq6,r_91_70_2,r_137_77_20,0.96,0,20,20,73
47,r_86_38_151,seq76,r_105_118_56,r_86_38_151,0.31,1,152,151,73
40,r_19_107_125,r_104_43_177,r_51_52_63,r_104_43_177,0.7,-51,126,177,73
29,r_16_121_187,r_131_1_156,r_29_12_79,r_16_121_187,0.83,-28,159,187,73
24,r_80_45_88,seq9,seq73,r_80_45_88,1.0,0,88,88,73
16,r_116_117_135,r_85_57_37,r_59_50_147,r_116_117_135,0.41,15,150,135,73
33,r_139_46_97,seq144,r_105_118_56,r_139_46_97,0.99,4,101,97,73
68,seq33,r_91_70_2,r_5_78_164,r_5_78_164,0.71,1,165,164,73
32,r_23_83_191,seq97,seq102,r_23_83_191,0.31,-112,79,191,73
26,r_74_54_39,r_72_93_112,r_137_77_20,r_72_93_112,0.92,-74,38,112,73
38,r_145_2_25,seq149,seq140,r_145_2_25,0.98,-2,23,25,73
18,r_91_70_2,r_90_133_138,r_137_77_20,r_137_77_20,0.98,1,21,20,73
66,seq30,r_101_120_170,r_88_68_19,r_88_68_19,1.0,0,19,19,73
22,r_99_135_166,r_136_0_178,r_141_132_165,r_99_135_166,0.85,0,166,166,73
49,r_85_57_37,seq39,seq100,r_85_57_37,0.97,-2,35,37,73
44,r_136_0_178,r_99_135_166,r_72_93_112,r_72_93_112,1.0,54,166,112,73
35,r_5_78_164,seq14,seq33,r_5_78_164,0.66,0,164,164,73
12,r_96_119_72,seq124,seq13,r_96_119_72,0.99,1,73,72,73
88,seq94,seq7,r_142_21_57,r_142_21_57,1.0,1,58,57,73
4,r_35_61_75,r_142_21_57,r_64_15_111,r_142_21_57,0.99,-1,56,57,73
30,r_143_139_113,seq134,r_61_146_29,r_143_139_113,1.0,0,113,113,74
21,r_29_57_54,r_51_84_66,r_35_103_123,r_29_57_54,1.0,0,54,54,74
46,r_48_114_18,r_120_15_158,seq21,r_48_114_18,1.0,0,18,18,74
9,r_28_50_78,r_70_7_152,seq134,r_28_50_78,0.6,94,172,78,74
14,r_25_66_161,seq31,seq19,r_25_66_161,0.8,2,163,161,74
43,r_70_7_152,r_58_17_151,r_29_57_54,r_29_57_54,0.89,97,151,54,74
10,r_69_138_26,r_54_12_8,seq85,r_69_138_26,1.0,0,26,26,74
1,r_79_38_168,r_93_102_5,seq26,r_79_38_168,0.91,1,169,168,74
7,r_93_102_5,r_79_38_168,r_5_40_174,r_79_38_168,0.99,1,169,168,74
45,r_45_125_90,r_54_12_8,seq142,r_45_125_90,1.0,0,90,90,74
39,r_35_103_123,r_105_10_85,r_29_57_54,r_29_57_54,0.69,0,54,54,74
19,r_106_124_124,seq60,seq62,r_106_124_124,0.61,4,128,124,74
5,r_61_146_29,seq59,seq2,r_61_146_29,0.92,0,29,29,74
1,r_79_38_168,r_111_20_94,r_93_102_5,r_79_38_168,0.66,-143,25,168,74
39,r_35_103_123,r_29_57_54,r_121_39_102,r_35_103_123,0.99,1,124,123,74
31,r_55_88_86,seq68,seq141,r_55_88_86,0.94,1,87,86,74
41,r_24_16_76,r_54_12_8,r_93_102_5,r_24_16_76,1.0,0,76,76,74
93,seq101,seq107,r_86_78_34,r_86_78_34,1.0,1,35,34,74
26,r_58_17_151,r_70_7_152,r_35_103_123,r_70_7_152,0.95,-1,151,152,74
16,r_145_92_23,seq52,r_115_22_67,r_115_22_67,1.0,25,92,67,74
74,seq59,r_61_146_29,seq41,r_61_146_29,0.54,4,33,29,74
4,r_13_53_60,seq31,seq109,r_13_53_60,1.0,0,60,60,74
0,r_123_108_71,r_4_42_149,seq3,r_123_108_71,1.0,0,71,71,74
63,seq23,seq99,r_136_72_98,r_136_72_98,1.0,1,99,98,74
11,r_126_89_63,r_147_128_69,seq148,r_126_89_63,0.95,0,63,63,74
22,r_82_32_51,seq133,r_54_12_8,r_82_32_51,1.0,0,51,51,74
23,r_44_119_189,r_147_128_69,r_144_75_7,r_147_128_69,0.62,-28,41,69,74
13,r_96_33_130,seq62,seq130,r_96_33_130,0.71,1,131,130,74
8,r_86_78_34,r_49_37_129,seq101,r_86_78_34,1.0,0,34,34,74
48,r_112_129_106,seq60,seq97,r_112_129_106,0.54,-16,90,106,74
46,r_48_114_18,seq68,seq21,r_48_114_18,0.68,156,174,18,74
6,r_147_128_69,r_44_119_189,seq3,r_147_128_69,0.95,0,69,69,74
62,seq21,seq133,r_46_0_99,r_46_0_99,0.65,-12,87,99,74
21,r_29_57_54,r_35_103_123,r_120_15_158,r_35_103_123,1.0,0,123,123,74
74,seq59,seq41,r_11_140_146,r_11_140_146,1.0,3,149,146,74
87,seq90,seq110,r_111_20_94,r_111_20_94,1.0,8,102,94,74
22,r_82_32_51,r_54_12_8,r_121_39_102,r_121_39_102,1.0,13,115,102,74
47,r_4_42_149,seq19,seq26,r_4_42_149,0.71,7,156,149,74
25,r_43_9_25,seq34,r_47_117_156,r_43_9_25,1.0,0,25,25,74
40,r_120_15_158,r_105_10_85,r_29_57_54,r_120_15_158,1.0,-73,85,158,74
29,r_18_149_95,r_47_117_156,seq133,r_18_149_95,1.0,0,95,95,74
24,r_63_76_105,r_87_94_162,r_123_108_71,r_63_76_105,1.0,0,105,105,74
33,r_136_72_98,seq64,r_120_15_158,r_136_72_98,1.0,0,98,98,74
20,r_47_117_156,r_43_9_25,r_13_53_60,r_13_53_60,0.8,96,156,60,74
16,r_145_92_23,seq27,seq52,r_145_92_23,1.0,0,23,23,74
52,seq3,seq141,r_123_108_71,r_123_108_71,1.0,24,95,71,74
34,r_11_140_146,seq85,seq59,r_11_140_146,0.95,0,146,146,74
75,seq60,r_131_104_75,seq130,r_131_104_75,0.72,-4,71,75,74
86,seq85,r_11_140_146,r_69_138_26,r_69_138_26,0.93,3,29,26,74
17,r_49_37_129,seq2,r_43_9_25,r_43_9_25,1.0,118,143,25,74
25,r_43_9_25,r_47_117_156,r_49_37_129,r_47_117_156,0.99,-28,128,156,74
9,r_28_50_78,seq107,r_70_7_152,r_28_50_78,0.9,0,78,78,74
6,r_147_128_69,seq3,r_105_10_85,r_105_10_85,0.97,8,93,85,74
28,r_111_20_94,seq36,seq90,r_111_20_94,1.0,-1,93,94,74
51,seq2,r_86_78_34,r_61_146_29,r_86_78_34,0.84,-5,29,34,74
49,r_115_22_67,r_47_117_156,r_145_92_23,r_115_22_67,1.0,0,67,67,74
44,r_51_84_66,r_79_38_168,r_61_146_29,r_51_84_66,1.0,1,67,66,74
20,r_47_117_156,r_115_22_67,r_43_9_25,r_47_117_156,0.83,-127,29,156,74
79,seq68,r_55_88_86,r_131_104_75,r_55_88_86,0.85,-16,70,86,74
35,r_131_104_75,seq60,seq97,r_131_104_75,0.84,-8,67,75,74
12,r_105_10_85,r_120_15_158,r_147_128_69,r_120_15_158,1.0,-73,85,158,74
2,r_77_83_11,seq137,seq142,r_77_83_11,0.98,0,11,11,74
23,r_44_119_189,r_144_75_7,seq8,r_144_75_7,0.44,182,189,7,74
27,r_105_25_42,seq114,r_32_140_91,r_32_140_91,0.89,0,91,91,75
51,seq131,r_87_71_78,r_103_46_32,r_87_71_78,0.76,2,80,78,75
36,r_60_24_110,seq66,seq38,r_60_24_110,1.0,0,110,110,75
14,r_89_13_124,seq7,seq100,r_89_13_124,0.99,0,124,124,75
29,r_138_113_45,r_58_22_169,seq14,r_138_113_45,1.0,0,45,45,75
8,r_74_80_79,seq79,seq54,r_74_80_79,1.0,0,79,79,75
53,seq6,r_53_124_182,r_89_13_124,r_89_13_124,1.0,58,182,124,75
54,seq7,r_89_13_124,seq114,r_89_13_124,0.99,0,124,124,75
16,r_52_102_135,r_51_109_168,r_91_55_84,r_52_102_135,1.0,0,135,135,75
39,r_20_95_99,seq77,seq81,r_20_95_99,0.74,-10,89,99,75
46,r_1_9_134,seq129,seq120,r_1_9_134,0.75,6,140,134,75
42,r_43_4_126,seq81,seq11,r_43_4_126,0.92,0,126,126,75
45,r_145_3_132,r_134_125_176,r_116_83_175,r_145_3_132,0.94,1,133,132,75
32,r_70_10_100,seq69,r_127_67_27,r_70_10_100,1.0,1,101,100,75
6,r_68_118_53,seq54,seq69,r_68_118_53,1.0,0,53,53,75
31,r_21_45_39,r_49_56_191,r_127_67_27,r_21_45_39,0.71,41,80,39,75
41,r_141_148_147,seq39,seq135,r_141_148_147,0.98,-1,146,147,75
67,seq39,r_141_148_147,r_2_88_44,r_2_88_44,0.61,34,78,44,75
30,r_48_63_36,seq100,seq131,r_48_63_36,1.0,0,36,36,75
27,r_105_25_42,r_70_10_100,seq114,r_105_25_42,1.0,1,43,42,75
10,r_58_22_169,r_94_123_116,seq38,r_58_22_169,0.8,-42,127,169,75
26,r_116_83_175,r_112_27_145,r_74_80_79,r_74_80_79,0.74,66,145,79,75
4,r_119_142_133,seq107,seq14,r_119_142_133,0.99,0,133,133,75
0,r_53_124_182,seq6,seq38,r_53_124_182,0.51,0,182,182,75
63,seq28,r_91_55_84,seq149,r_91_55_84,1.0,1,85,84,75
73,seq66,r_49_56_191,r_73_44_61,r_73_44_61,1.0,36,97,61,75
11,r_36_143_90,seq98,seq34,r_36_143_90,1.0,0,90,90,75
20,r_32_140_91,seq19,r_105_25_42,r_105_25_42,1.0,49,91,42,75
98,seq120,r_137_40_122,r_1_9_134,r_1_9_134,0.83,7,141,134,75
15,r_127_67_27,r_60_24_110,r_70_10_100,r_127_67_27,1.0,73,100,27,75
48,r_29_57_97,r_43_4_126,seq77,r_43_4_126,0.79,-19,107,126,75
21,r_144_130_16,r_126_15_121,r_12_128_31,r_126_15_121,1.0,0,121,121,75
23,r_31_90_35,r_89_13_124,seq107,r_31_90_35,1.0,0,35,35,75
38,r_2_88_44,r_70_10_100,seq39,r_2_88_44,0.82,0,44,44,75
7,r_104_50_19,r_49_56_191,seq14,r_104_50_19,0.9,0,19,19,75
2,r_73_44_61,seq121,seq66,r_73_44_61,1.0,0,61,61,75
47,r_8_37_105,r_1_9_134,seq14,r_8_37_105,0.86,0,105,105,75
18,r_134_125_176,seq132,r_32_140_91,r_32_140_91,0.64,88,179,91,75
24,r_112_27_145,r_116_83_175,seq7,r_112_27_145,0.97,0,145,145,75
99,seq121,r_47_133_57,r_110_0_6,r_47_133_57,1.0,1,58,57,75
25,r_91_55_84,seq28,seq81,r_91_55_84,1.0,1,85,84,75
33,r_126_15_121,seq54,r_127_67_27,r_126_15_121,1.0,0,121,121,75
12,r_103_46_32,r_141_148_147,seq131,r_141_148_147,0.88,-115,32,147,75
21,r_144_130_16,seq114,r_126_15_121,r_144_130_16,0.95,0,16,16,75
10,r_58_22_169,seq38,r_64_23_13,r_58_22_169,0.96,0,169,169,75
52,seq132,r_134_125_176,r_58_22_169,r_58_22_169,0.91,10,179,169,75
37,r_47_133_57,seq121,seq131,r_47_133_57,1.0,1,58,57,75
34,r_111_41_165,seq17,r_89_13_124,r_111_41_165,0.83,0,165,165,75
32,r_70_10_100,r_2_88_44,seq69,r_2_88_44,1.0,0,44,44,75
91,seq100,r_48_63_36,seq6,r_48_63_36,1.0,0,36,36,75
60,seq19,r_32_140_91,seq79,r_32_140_91,0.51,45,136,91,75
81,seq81,r_43_4_126,seq34,r_43_4_126,1.0,0,126,126,75
94,seq107,r_119_142_133,seq121,r_119_142_133,1.0,-5,128,133,75
22,r_87_71_78,seq131,seq39,r_87_71_78,0.9,2,80,78,75
28,r_94_123_116,r_58_22_169,seq98,r_94_123_116,0.98,0,116,116,75
49,r_18_96_140,seq131,seq85,r_18_96_140,0.94,1,141,140,75
43,r_12_128_31,seq149,r_144_130_16,r_144_130_16,0.59,17,33,16,75
44,r_59_75_77,r_89_13_124,r_64_23_13,r_89_13_124,0.96,-38,86,124,75
35,r_137_40_122,seq120,r_127_67_27,r_137_40_122,0.68,19,141,122,75
84,seq85,seq38,r_18_96_140,r_18_96_140,1.0,34,174,140,75
2,r_108_14_27,r_146_17_84,r_127_56_154,r_108_14_27,1.0,0,27,27,76
18,r_30_59_102,r_148_124_38,r_19_4_7,r_148_124_38,0.81,-6,32,38,76
30,r_70_58_23,r_94_93_78,seq134,r_70_58_23,1.0,0,23,23,76
97,seq122,r_125_135_190,r_146_17_84,r_146_17_84,0.9,106,190,84,76
46,r_46_90_70,seq55,r_141_113_14,r_46_90_70,1.0,6,76,70,76
42,r_102_144_86,r_64_99_2,seq100,r_102_144_86,0.98,0,86,86,76
45,r_136_21_172,r_61_86_139,r_28_25_89,r_136_21_172,0.75,-68,104,172,76
41,r_127_56_154,seq97,r_108_14_27,r_108_14_27,1.0,-2,25,27,76
19,r_96_31_133,seq51,r_140_13_64,r_96_31_133,0.98,1,134,133,76
27,r_68_109_58,r_60_29_184,r_3_74_20,r_60_29_184,0.93,-42,142,184,76
99,seq126,seq121,r_148_124_38,r_148_124_38,1.0,0,38,38,76
26,r_145_5_164,seq138,r_42_83_108,r_42_83_108,0.92,56,164,108,76
32,r_67_149_25,r_33_41_59,seq101,r_67_149_25,0.66,-1,24,25,76
0,r_94_93_78,r_125_135_190,seq95,r_94_93_78,0.73,-1,77,78,76
8,r_3_74_20,r_63_26_138,seq34,r_3_74_20,0.85,-5,15,20,76
11,r_35_44_197,r_23_117_153,r_148_124_38,r_148_124_38,0.98,116,154,38,76
20,r_54_16_179,seq132,r_57_78_28,r_54_16_179,0.54,1,180,179,76
13,r_61_86_139,seq139,seq115,r_61_86_139,1.0,0,139,139,76
98,seq123,seq48,r_140_13_64,r_140_13_64,1.0,28,92,64,76
15,r_103_110_88,seq95,seq134,r_103_110_88,1.0,0,88,88,76
48,r_81_7_97,r_145_5_164,r_19_4_7,r_81_7_97,0.69,0,97,97,76
45,r_136_21_172,r_28_25_89,r_2_128_19,r_136_21_172,0.58,-33,139,172,76
2,r_108_14_27,r_127_56_154,seq97,r_127_56_154,1.0,0,154,154,76
31,r_88_22_118,r_33_41_59,r_148_124_38,r_88_22_118,1.0,-81,37,118,76
87,seq98,seq147,r_33_41_59,r_33_41_59,1.0,7,66,59,76
7,r_2_128_19,r_54_16_179,seq51,r_2_128_19,0.98,0,19,19,76
4,r_146_17_84,r_108_14_27,seq122,r_108_14_27,1.0,-4,23,27,76
41,r_127_56_154,r_108_14_27,r_80_112_91,r_127_56_154,0.97,0,154,154,76
47,r_140_13_64,r_145_5_164,seq123,r_140_13_64,1.0,0,64,64,76
29,r_18_24_80,r_23_117_153,r_148_124_38,r_148_124_38,0.95,116,154,38,76
5,r_57_78_28,r_23_117_153,seq55,r_57_78_28,0.94,0,28,28,76
25,r_23_117_153,r_35_44_197,r_80_112_91,r_80_112_91,0.94,63,154,91,76
33,r_114_73_74,r_20_77_177,seq37,r_114_73_74,1.0,-1,73,74,76
38,r_143_130_186,seq85,r_146_17_84,r_143_130_186,0.18,0,186,186,76
27,r_68_109_58,r_46_90_70,r_60_29_184,r_68_109_58,1.0,0,58,58,76
34,r_42_83_108,r_145_5_164,r_19_4_7,r_42_83_108,0.57,0,108,108,76
21,r_148_124_38,r_30_59_102,r_88_22_118,r_148_124_38,1.0,0,38,38,76
17,r_28_25_89,r_62_10_93,seq100,r_28_25_89,0.77,0,89,89,76
9,r_80_112_91,seq34,seq142,r_80_112_91,1.0,0,91,91,76
37,r_19_4_7,r_30_59_102,r_81_7_97,r_19_4_7,1.0,96,103,7,76
22,r_87_137_151,seq40,r_35_44_197,r_87_137_151,0.3,0,151,151,76
40,r_33_41_59,r_88_22_118,seq98,r_33_41_59,1.0,0,59,59,76
49,r_125_135_190,seq122,r_52_120_191,r_52_120_191,0.62,-1,190,191,76
18,r_30_59_102,r_19_4_7,r_62_10_93,r_19_4_7,1.0,96,103,7,76
23,r_60_29_184,r_8_89_66,r_68_109_58,r_60_29_184,1.0,-118,66,184,76
79,seq75,r_9_106_147,seq0,r_9_106_147,0.73,0,147,147,76
35,r_20_77_177,seq15,r_62_10_93,r_20_77_177,0.7,1,178,177,76
85,seq95,r_103_110_88,r_94_93_78,r_103_110_88,0.99,-30,58,88,76
89,seq101,seq129,r_67_149_25,r_67_149_25,1.0,-1,24,25,76
12,r_8_89_66,r_60_29_184,r_36_104_4,r_8_89_66,1.0,0,66,66,76
28,r_141_113_14,r_94_93_78,seq84,r_141_113_14,1.0,0,14,14,76
23,r_60_29_184,r_68_109_58,r_146_17_84,r_68_109_58,0.4,126,184,58,76
93,seq106,r_116_51_185,r_66_60_1,r_116_51_185,0.45,1,186,185,77
0,r_112_138_25,r_100_1_27,seq67,r_112_138_25,0.55,3,28,25,77
16,r_32_3_10,r_81_107_123,seq120,r_32_3_10,0.79,6,16,10,77
25,r_2_135_59,seq102,seq130,r_2_135_59,0.71,-31,28,59,77
92,seq105,r_96_46_124,r_9_124_69,r_9_124_69,0.83,58,127,69,77
14,r_25_24_133,r_79_31_118,seq43,r_79_31_118,0.73,7,125,118,77
8,r_23_139_112,r_66_60_1,r_8_52_63,r_8_52_63,0.99,52,115,63,77
53,seq136,r_79_31_118,r_122_22_86,r_122_22_86,0.79,6,92,86,77
27,r_8_52_63,r_79_31_118,r_23_139_112,r_79_31_118,0.51,0,118,118,77
37,r_79_31_118,r_93_88_151,seq128,r_79_31_118,0.67,0,118,118,77
21,r_108_30_134,seq126,r_32_3_10,r_108_30_134,0.82,1,135,134,77
39,r_9_124_69,seq64,seq105,r_9_124_69,0.99,0,69,69,77
1,r_97_35_83,r_114_61_140,seq57,r_114_61_140,0.55,-56,84,140,77
42,r_47_0_60,seq50,seq74,r_47_0_60,0.96,4,64,60,77
80,seq75,r_56_83_183,r_81_107_123,r_81_107_123,1.0,67,190,123,77
69,seq142,r_4_18_121,r_134_48_40,r_134_48_40,0.97,87,127,40,77
43,r_77_12_58,seq121,seq102,r_77_12_58,1.0,0,58,58,77
3,r_114_61_140,seq143,r_49_76_97,r_49_76_97,0.79,43,140,97,77
26,r_49_76_97,seq14,seq6,r_49_76_97,1.0,0,97,97,77
35,r_145_69_53,r_108_30_134,seq110,r_145_69_53,0.99,0,53,53,77
4,r_140_26_113,seq38,r_47_0_60,r_47_0_60,0.91,49,109,60,77
11,r_27_21_195,r_54_20_175,seq103,r_54_20_175,1.0,2,177,175,77
20,r_125_113_116,seq82,seq128,r_125_113_116,0.94,0,116,116,77
13,r_96_46_124,seq105,r_45_36_64,r_96_46_124,0.41,3,127,124,77
98,seq121,r_81_107_123,r_4_18_121,r_81_107_123,0.99,0,123,123,77
46,r_29_148_164,r_131_144_21,seq14,r_29_148_164,0.9,0,164,164,77
15,r_4_18_121,seq142,seq121,r_4_18_121,0.47,6,127,121,77
49,r_68_78_7,r_133_127_166,seq85,r_133_127_166,0.9,-5,161,166,77
57,seq14,r_49_76_97,r_65_58_14,r_49_76_97,0.76,0,97,97,77
12,r_99_115_39,r_93_88_151,r_122_22_86,r_99_115_39,0.78,112,151,39,77
6,r_122_22_86,r_10_87_182,seq136,r_122_22_86,0.99,0,86,86,77
38,r_116_51_185,seq106,r_7_129_96,r_116_51_185,0.93,1,186,185,77
27,r_8_52_63,r_122_22_86,r_79_31_118,r_8_52_63,0.77,-2,61,63,77
31,r_65_58_14,seq11,seq38,r_65_58_14,0.94,0,14,14,77
40,r_132_119_159,r_93_88_151,r_29_148_164,r_93_88_151,0.45,0,151,151,77
18,r_73_94_162,r_116_51_185,r_65_58_14,r_73_94_162,0.58,0,162,162,77
24,r_54_20_175,r_27_21_195,r_37_16_170,r_37_16_170,0.76,7,177,170,77
48,r_95_62_47,seq136,seq41,r_95_62_47,1.0,0,47,47,77
33,r_45_36_64,r_5_117_168,seq57,r_45_36_64,0.99,-2,62,64,77
40,r_132_119_159,r_29_148_164,r_114_61_140,r_29_148_164,0.55,-2,162,164,77
70,seq50,seq41,r_133_127_166,r_133_127_166,0.99,2,168,166,77
64,seq38,r_140_26_113,r_65_58_14,r_65_58_14,0.64,102,116,14,77
47,r_131_144_21,r_29_148_164,seq11,r_29_148_164,1.0,-4,160,164,77
50,seq128,seq33,r_79_31_118,r_79_31_118,0.81,1,119,118,77
70,seq50,r_47_0_60,seq41,r_47_0_60,0.59,23,83,60,77
38,r_116_51_185,r_73_94_162,seq106,r_73_94_162,0.96,0,162,162,77
52,seq6,r_10_87_182,r_114_61_140,r_114_61_140,0.66,42,182,140,77
57,seq14,r_65_58_14,r_29_148_164,r_29_148_164,1.0,-1,163,164,77
75,seq64,r_9_124_69,seq137,r_9_124_69,0.76,0,69,69,77
36,r_133_127_166,r_65_58_14,r_68_78_7,r_65_58_14,0.63,0,14,14,77
32,r_100_1_27,r_112_138_25,r_66_60_1,r_100_1_27,0.88,1,28,27,77
34,r_134_48_40,seq13,seq142,r_134_48_40,1.0,0,40,40,77
9,r_81_107_123,seq121,seq75,r_81_107_123,1.0,0,123,123,77
47,r_131_144_21,r_97_35_83,r_29_148_164,r_131_144_21,0.9,0,21,21,77
22,r_7_129_96,r_37_16_170,seq142,r_37_16_170,0.76,-74,96,170,77
28,r_93_88_151,r_132_119_159,r_7_129_96,r_93_88_151,0.66,0,151,151,77
46,r_29_148_164,r_99_115_39,r_131_144_21,r_29_148_164,0.91,-136,28,164,77
23,r_10_87_182,seq6,r_97_35_83,r_97_35_83,0.59,99,182,83,77
12,r_99_115_39,r_29_148_164,r_93_88_151,r_99_115_39,0.99,-1,38,39,77
40,r_31_100_126,seq99,r_23_128_80,r_31_100_126,0.71,1,127,126,78
30,r_29_10_116,r_68_0_121,seq99,r_29_10_116,1.0,0,116,116,78
51,seq1,r_38_64_115,seq65,r_38_64_115,1.0,0,115,115,78
36,r_61_117_84,r_137_47_1,seq110,r_61_117_84,1.0,0,84,84,78
11,r_43_122_47,r_102_85_197,seq79,r_43_122_47,0.84,0,47,47,78
13,r_125_32_23,r_137_47_1,seq79,r_125_32_23,1.0,1,24,23,78
14,r_119_41_77,seq22,r_132_80_173,r_119_41_77,1.0,2,79,77,78
53,seq133,r_132_80_173,r_119_41_77,r_119_41_77,1.0,97,174,77,78
18,r_34_72_107,seq87,r_39_52_8,r_39_52_8,0.82,26,34,8,78
54,seq6,seq30,r_12_83_75,r_12_83_75,1.0,5,80,75,78
27,r_95_146_90,r_29_10_116,r_137_47_1,r_95_146_90,0.38,-3,87,90,78
16,r_38_64_115,seq1,seq13,r_38_64_115,0.97,0,115,115,78
39,r_68_0_121,seq7,seq86,r_68_0_121,0.96,0,121,121,78
1,r_132_80_173,r_35_97_167,seq28,r_132_80_173,0.62,1,174,173,78
5,r_124_9_97,r_37_3_52,seq79,r_124_9_97,0.95,3,100,97,78
42,r_17_15_143,seq14,r_108_142_95,r_108_142_95,0.54,52,147,95,78
45,r_50_77_185,seq14,r_132_80_173,r_132_80_173,0.74,12,185,173,78
10,r_37_3_52,r_124_9_97,r_82_139_30,r_37_3_52,0.99,-4,48,52,78
12,r_51_2_34,seq79,seq25,r_51_2_34,1.0,1,35,34,78
95,seq110,r_125_32_23,r_145_116_85,r_145_116_85,1.0,5,90,85,78
19,r_67_60_108,seq143,r_119_41_77,r_119_41_77,1.0,30,107,77,78
76,seq59,seq42,r_90_121_92,r_90_121_92,0.67,11,103,92,78
68,seq30,r_54_92_42,seq6,r_54_92_42,0.98,0,42,42,78
31,r_12_83_75,r_16_135_120,seq6,r_12_83_75,1.0,0,75,75,78
41,r_23_128_80,r_58_114_38,r_4_76_65,r_4_76_65,0.59,16,81,65,78
35,r_140_106_53,r_31_100_126,seq70,r_140_106_53,1.0,2,55,53,78
8,r_88_56_124,r_131_69_10,seq14,r_88_56_124,0.99,0,124,124,78
6,r_89_136_58,seq46,r_19_94_2,r_89_136_58,1.0,0,58,58,78
14,r_119_41_77,r_132_80_173,r_67_60_108,r_132_80_173,0.9,1,174,173,78
4,r_111_5_132,seq70,r_124_9_97,r_111_5_132,0.81,3,135,132,78
0,r_8_109_168,r_132_80_173,r_31_100_126,r_8_109_168,0.71,4,172,168,78
15,r_108_142_95,seq86,seq87,r_108_142_95,1.0,0,95,95,78
48,r_18_20_64,r_105_98_145,r_54_92_42,r_18_20_64,1.0,1,65,64,78
26,r_82_139_30,r_19_94_2,r_37_3_52,r_82_139_30,0.99,0,30,30,78
95,seq110,r_8_109_168,r_125_32_23,r_125_32_23,0.52,17,40,23,78
27,r_95_146_90,r_4_76_65,r_29_10_116,r_4_76_65,1.0,0,65,65,78
87,seq87,r_34_72_107,r_108_142_95,r_108_142_95,0.72,15,110,95,78
47,r_4_76_65,r_95_146_90,seq107,r_4_76_65,1.0,0,65,65,78
40,r_31_100_126,r_140_106_53,seq99,r_140_106_53,0.88,2,55,53,78
29,r_126_40_140,seq81,seq138,r_126_40_140,0.93,1,141,140,78
8,r_88_56_124,r_119_41_77,r_131_69_10,r_88_56_124,0.59,-114,10,124,78
33,r_145_116_85,r_68_0_121,seq110,r_145_116_85,1.0,0,85,85,78
38,r_16_135_120,seq55,r_39_52_8,r_16_135_120,0.91,1,121,120,78
73,seq46,r_89_136_58,seq1,r_89_136_58,1.0,0,58,58,78
55,seq7,r_131_69_10,seq130,r_131_69_10,0.45,145,155,10,78
46,r_113_57_17,r_27_33_186,seq144,r_113_57_17,0.66,6,23,17,78
25,r_131_69_10,r_88_56_124,seq22,r_88_56_124,1.0,0,124,124,78
94,seq107,r_71_141_172,r_8_109_168,r_71_141_172,0.46,11,183,172,78
9,r_35_97_167,r_132_80_173,r_61_117_84,r_61_117_84,0.8,83,167,84,78
86,seq86,r_88_56_124,r_68_0_121,r_68_0_121,0.64,1,122,121,78
22,r_105_98_145,seq13,seq86,r_105_98_145,0.66,2,147,145,78
91,seq99,r_31_100_126,r_29_10_116,r_29_10_116,0.73,11,127,116,78
18,r_34_72_107,r_39_52_8,seq44,r_34_72_107,0.99,5,112,107,78
21,r_54_92_42,seq30,seq134,r_54_92_42,1.0,0,42,42,78
17,r_39_52_8,seq87,r_16_135_120,r_16_135_120,0.88,29,149,120,78
25,r_131_69_10,r_108_142_95,r_88_56_124,r_131_69_10,0.97,2,12,10,78
44,r_58_114_38,seq78,r_23_128_80,r_58_114_38,0.98,0,38,38,78
36,r_148_7_69,r_120_98_193,r_97_38_11,r_148_7_69,0.98,4,73,69,79
8,r_140_103_72,r_114_2_139,r_144_17_26,r_140_103_72,0.99,3,75,72,79
53,seq131,r_87_6_126,r_26_51_114,r_87_6_126,0.95,-1,125,126,79
37,r_145_65_159,seq22,r_149_96_47,r_149_96_47,0.4,112,159,47,79
39,r_69_18_133,r_107_48_143,r_42_95_46,r_69_18_133,0.75,0,133,133,79
1,r_114_2_139,r_140_103_72,r_90_21_61,r_114_2_139,0.92,-62,77,139,79
5,r_4_133_166,seq131,r_126_37_189,r_4_133_166,0.51,1,167,166,79
42,r_97_38_11,seq12,r_148_7_69,r_148_7_69,1.0,12,81,69,79
45,r_70_0_96,seq11,seq16,r_70_0_96,0.99,2,98,96,79
19,r_40_58_157,r_9_104_167,r_140_103_72,r_40_58_157,0.73,0,157,157,79
30,r_144_17_26,r_67_63_134,r_140_103_72,r_144_17_26,0.85,59,85,26,79
95,seq108,r_24_113_165,r_64_122_3,r_24_113_165,0.59,0,165,165,79
31,r_115_59_127,seq49,r_42_95_46,r_42_95_46,1.0,91,137,46,79
16,r_67_63_134,r_115_59_127,r_144_17_26,r_144_17_26,0.98,3,29,26,79
90,seq94,r_9_104_167,r_42_95_46,r_42_95_46,1.0,124,170,46,79
26,r_20_8_85,seq137,seq41,r_20_8_85,0.98,4,89,85,79
16,r_67_63_134,r_144_17_26,r_70_0_96,r_67_63_134,0.91,1,135,134,79
11,r_26_51_114,seq14,r_71_80_14,r_71_80_14,0.99,110,124,14,79
30,r_144_17_26,r_47_84_118,r_67_63_134,r_144_17_26,0.98,0,26,26,79
15,r_44_35_160,r_61_135_87,r_64_122_3,r_61_135_87,0.51,74,161,87,79
48,r_107_48_143,r_69_18_133,r_54_36_7,r_69_18_133,0.67,0,133,133,79
1,r_114_2_139,r_90_21_61,r_47_84_118,r_114_2_139,1.0,-5,134,139,79
6,r_24_113_165,seq108,r_39_56_94,r_24_113_165,0.52,0,165,165,79
40,r_149_96_47,r_9_104_167,seq74,r_149_96_47,0.81,2,49,47,79
91,seq100,seq74,r_9_104_167,r_9_104_167,0.76,3,170,167,79
2,r_136_141_95,seq72,r_85_31_50,r_136_141_95,1.0,0,95,95,79
47,r_10_102_119,seq146,seq116,r_10_102_119,0.81,2,121,119,79
20,r_42_95_46,seq50,seq94,r_42_95_46,0.95,0,46,46,79
18,r_87_6_126,seq131,r_120_98_193,r_87_6_126,0.94,0,126,126,79
29,r_46_138_99,seq81,r_140_103_72,r_140_103_72,0.93,32,104,72,79
34,r_90_21_61,r_114_2_139,seq142,r_114_2_139,0.98,-7,132,139,79
38,r_79_118_36,seq100,r_126_37_189,r_79_118_36,0.95,0,36,36,79
33,r_82_119_9,seq11,r_126_37_189,r_82_119_9,0.35,154,163,9,79
49,r_30_124_22,r_85_31_50,r_19_1_104,r_19_1_104,0.57,-80,24,104,79
34,r_90_21_61,r_70_0_96,r_114_2_139,r_90_21_61,0.99,-1,60,61,79
4,r_126_37_189,seq128,r_79_118_36,r_79_118_36,1.0,2,38,36,79
81,seq72,r_136_141_95,seq134,r_136_141_95,1.0,-1,94,95,79
17,r_47_84_118,seq66,seq146,r_47_84_118,0.69,2,120,118,79
9,r_92_143_145,r_54_36_7,r_140_103_72,r_54_36_7,0.86,141,148,7,79
13,r_73_29_23,r_10_102_119,seq72,r_73_29_23,0.99,0,23,23,79
22,r_39_56_94,r_126_37_189,r_20_8_85,r_39_56_94,0.47,4,98,94,79
28,r_61_135_87,r_44_35_160,r_112_93_4,r_61_135_87,0.48,74,161,87,79
23,r_117_33_180,seq139,r_145_65_159,r_145_65_159,0.79,21,180,159,79
25,r_85_31_50,seq74,seq86,r_85_31_50,0.84,-1,49,50,79
10,r_83_127_27,r_126_37_189,seq50,r_83_127_27,0.99,0,27,27,79
35,r_43_28_66,r_64_122_3,r_54_36_7,r_54_36_7,0.58,62,69,7,79
27,r_71_80_14,r_136_141_95,seq131,r_71_80_14,0.87,0,14,14,79
93,seq112,seq147,r_107_8_74,r_107_8_74,1.0,0,74,74,80
51,seq5,r_43_32_130,seq24,r_43_32_130,1.0,1,131,130,80
36,r_69_38_103,seq106,seq21,r_69_38_103,1.0,0,103,103,80
9,r_67_0_49,r_59_140_165,r_49_1_112,r_67_0_49,0.54,79,128,49,80
6,r_26_92_1,r_89_134_35,r_41_12_126,r_89_134_35,0.53,11,46,35,80
14,r_49_1_112,seq22,r_67_0_49,r_49_1_112,0.99,1,113,112,80
8,r_11_6_65,seq70,seq98,r_11_6_65,0.58,9,74,65,80
55,seq139,r_2_15_189,r_26_92_1,r_2_15_189,0.38,0,189,189,80
16,r_13_142_75,r_129_74_96,seq81,r_13_142_75,0.91,1,76,75,80
21,r_45_4_166,seq73,r_17_113_98,r_17_113_98,0.71,71,169,98,80
1,r_107_8_74,r_127_75_114,seq112,r_107_8_74,0.56,8,82,74,80
46,r_144_79_160,r_18_36_175,seq131,r_18_36_175,0.48,-14,161,175,80
42,r_41_12_126,r_48_88_83,r_26_92_1,r_48_88_83,1.0,0,83,83,80
45,r_47_86_169,seq28,r_41_12_126,r_41_12_126,0.79,43,169,126,80
38,r_124_54_32,r_129_74_96,seq103,r_124_54_32,1.0,0,32,32,80
8,r_11_6_65,seq98,r_53_68_113,r_53_68_113,1.0,10,123,113,80
37,r_34_111_25,r_43_32_130,seq52,r_34_111_25,0.99,0,25,25,80
15,r_77_90_3,r_91_138_29,seq63,r_91_138_29,0.98,1,30,29,80
41,r_129_74_96,seq98,r_34_111_25,r_129_74_96,0.99,0,96,96,80
10,r_78_84_135,seq57,r_11_6_65,r_78_84_135,0.92,1,136,135,80
90,seq104,r_127_75_114,r_85_130_141,r_85_130_141,0.97,0,141,141,80
9,r_67_0_49,seq16,r_59_140_165,r_67_0_49,1.0,0,49,49,80
4,r_89_134_35,seq139,seq83,r_89_134_35,0.81,6,41,35,80
26,r_35_93_152,seq135,seq101,r_35_93_152,0.74,3,155,152,80
0,r_43_32_130,r_47_86_169,seq22,r_43_32_130,0.91,1,131,130,80
11,r_143_80_145,seq31,r_123_114_72,r_143_80_145,0.92,0,145,145,80
20,r_53_68_113,seq37,r_11_6_65,r_53_68_113,1.0,0,113,113,80
62,seq22,r_49_1_112,seq101,r_49_1_112,1.0,1,113,112,80
27,r_137_148_84,seq141,seq136,r_137_148_84,1.0,0,84,84,80
22,r_3_105_10,r_107_8_74,seq24,r_3_105_10,0.71,2,12,10,80
12,r_122_62_56,r_45_4_166,r_124_54_32,r_122_62_56,0.94,0,56,56,80
2,r_46_128_159,seq7,r_82_58_88,r_46_128_159,0.66,0,159,159,80
47,r_72_9_90,r_127_75_114,seq98,r_72_9_90,1.0,0,90,90,80
40,r_2_15_189,seq139,r_120_56_23,r_120_56_23,0.76,166,189,23,80
18,r_123_114_72,r_49_1_112,seq101,r_49_1_112,1.0,-2,110,112,80
29,r_85_130_141,seq109,seq104,r_85_130_141,0.99,0,141,141,80
24,r_82_58_88,r_97_116_155,seq115,r_82_58_88,0.89,7,95,88,80
25,r_87_146_179,r_123_114_72,r_65_66_27,r_123_114_72,0.54,107,179,72,80
98,seq125,r_127_75_114,r_65_66_27,r_65_66_27,1.0,0,27,27,80
6,r_26_92_1,r_41_12_126,seq139,r_41_12_126,1.0,0,126,126,80
68,seq39,r_121_132_105,r_41_12_126,r_41_12_126,1.0,10,136,126,80
31,r_91_138_29,r_77_90_3,seq28,r_91_138_29,0.99,1,30,29,80
32,r_59_140_165,seq7,r_76_51_66,r_76_51_66,0.64,101,167,66,80
52,seq7,r_46_128_159,r_120_56_23,r_46_128_159,0.97,0,159,159,80
34,r_18_36_175,r_144_79_160,r_89_134_35,r_18_36_175,0.38,-14,161,175,80
42,r_41_12_126,r_26_92_1,seq39,r_41_12_126,0.99,0,126,126,80
17,r_127_75_114,seq104,r_65_66_27,r_65_66_27,0.95,96,123,27,80
94,seq115,r_95_94_194,r_82_58_88,r_82_58_88,0.5,5,93,88,80
56,seq141,seq64,r_96_30_104,r_96_30_104,1.0,1,105,104,80
28,r_97_116_155,r_122_62_56,r_102_50_134,r_97_116_155,1.0,1,156,155,80
28,r_97_116_155,r_82_58_88,r_122_62_56,r_122_62_56,1.0,39,95,56,80
5,r_65_66_27,r_122_62_56,seq125,r_65_66_27,0.55,0,27,27,80
35,r_110_33_40,r_49_1_112,seq7,r_110_33_40,0.75,0,40,40,80
49,r_102_50_134,seq136,r_120_56_23,r_102_50_134,0.96,0,134,134,80
16,r_13_142_75,seq81,r_14_133_100,r_14_133_100,1.0,18,118,100,80
7,r_48_88_83,r_41_12_126,r_25_44_2,r_25_44_2,0.75,81,83,2,80
44,r_14_133_100,seq19,r_13_142_75,r_14_133_100,0.97,0,100,100,80
23,r_96_30_104,r_85_130_141,seq141,r_96_30_104,0.97,0,104,104,80
82,seq73,r_45_4_166,r_120_56_23,r_45_4_166,0.82,3,169,166,80
34,r_18_36_175,r_89_134_35,r_67_0_49,r_18_36_175,0.67,0,175,175,80
30,r_11_30_80,seq72,seq65,r_11_30_80,1.0,0,80,80,81
14,r_12_14_198,r_141_3_191,r_75_132_20,r_75_132_20,0.84,152,172,20,81
8,r_64_42_72,seq66,seq48,r_64_42_72,1.0,0,72,72,81
43,r_8_38_105,seq32,r_7_50_54,r_8_38_105,0.99,0,105,105,81
54,seq135,seq18,r_84_33_140,r_84_33_140,0.99,4,144,140,81
45,r_79_28_120,r_95_41_131,r_130_100_17,r_130_100_17,1.0,2,19,17,81
55,seq10,r_126_82_71,r_49_88_16,r_126_82_71,1.0,0,71,71,81
86,seq74,r_1_98_119,seq59,r_1_98_119,1.0,0,119,119,81
16,r_53_52_94,seq65,seq39,r_53_52_94,1.0,0,94,94,81
39,r_126_82_71,seq10,r_71_107_25,r_126_82_71,1.0,0,71,71,81
1,r_1_98_119,seq74,r_35_148_84,r_1_98_119,1.0,0,119,119,81
5,r_84_33_140,r_138_44_158,seq135,r_84_33_140,0.86,0,140,140,81
46,r_101_93_74,seq83,r_85_131_30,r_85_131_30,1.0,61,91,30,81
42,r_145_125_64,r_95_41_131,r_123_40_136,r_145_125_64,1.0,0,64,64,81
22,r_7_50_54,seq62,seq90,r_7_50_54,0.99,2,56,54,81
38,r_130_100_17,seq63,r_79_28_120,r_130_100_17,1.0,0,17,17,81
23,r_60_122_173,r_95_41_131,r_130_100_17,r_130_100_17,1.0,12,29,17,81
88,seq83,r_101_93_74,r_67_146_27,r_67_146_27,1.0,0,27,27,81
38,r_130_100_17,r_79_28_120,r_136_103_46,r_130_100_17,0.89,103,120,17,81
2,r_137_127_32,seq2,seq113,r_137_127_32,1.0,0,32,32,81
31,r_24_119_152,r_9_99_182,r_64_42_72,r_24_119_152,0.9,0,152,152,81
3,r_35_148_84,r_110_37_184,seq66,r_35_148_84,1.0,1,85,84,81
10,r_123_40_136,seq59,r_145_125_64,r_145_125_64,1.0,4,68,64,81
90,seq86,r_21_76_133,r_5_112_181,r_5_112_181,0.51,7,188,181,81
20,r_71_107_25,r_101_93_74,seq65,r_71_107_25,1.0,0,25,25,81
13,r_108_15_156,r_141_3_191,seq10,r_108_15_156,0.96,1,157,156,81
4,r_89_142_63,seq56,seq13,r_89_142_63,1.0,0,63,63,81
0,r_138_44_158,r_58_87_177,r_31_116_141,r_138_44_158,0.78,3,161,158,81
11,r_4_81_76,seq48,r_49_88_16,r_4_81_76,1.0,0,76,76,81
37,r_136_103_46,r_126_82_71,r_130_100_17,r_130_100_17,1.0,29,46,17,81
19,r_67_146_27,r_136_103_46,seq83,r_67_146_27,1.0,0,27,27,81
13,r_108_15_156,seq32,r_141_3_191,r_108_15_156,0.44,-44,112,156,81
78,seq62,r_7_50_54,seq140,r_7_50_54,1.0,2,56,54,81
48,r_31_116_141,seq113,seq22,r_31_116_141,0.94,0,141,141,81
36,r_75_132_20,r_95_41_131,seq32,r_75_132_20,1.0,-1,19,20,81
6,r_110_37_184,r_35_148_84,seq25,r_35_148_84,1.0,1,85,84,81
10,r_123_40_136,r_145_125_64,r_149_17_103,r_149_17_103,0.94,33,136,103,81
27,r_58_87_177,seq128,seq47,r_58_87_177,0.66,-2,175,177,81
47,r_111_120_92,r_8_38_105,seq72,r_8_38_105,0.8,-12,93,105,81
40,r_46_57_96,r_31_116_141,seq45,r_46_57_96,1.0,2,98,96,81
29,r_78_144_176,r_141_3_191,r_111_120_92,r_111_120_92,0.95,80,172,92,81
24,r_5_112_181,seq54,seq86,r_5_112_181,0.56,1,182,181,81
25,r_9_99_182,seq39,seq59,r_9_99_182,0.66,0,182,182,81
33,r_80_124_127,seq140,r_71_107_25,r_80_124_127,0.93,0,127,127,81
68,seq39,r_9_99_182,r_53_52_94,r_53_52_94,1.0,88,182,94,81
17,r_85_131_30,r_9_99_182,seq118,r_85_131_30,1.0,0,30,30,81
42,r_145_125_64,r_123_40_136,r_109_0_124,r_109_0_124,1.0,38,162,124,81
32,r_51_121_150,r_12_14_198,r_89_142_63,r_12_14_198,0.96,-46,152,198,81
34,r_114_6_1,r_149_17_103,r_105_27_4,r_149_17_103,0.89,0,103,103,81
45,r_79_28_120,r_130_100_17,seq133,r_79_28_120,1.0,0,120,120,81
81,seq66,r_64_42_72,r_69_92_110,r_64_42_72,0.93,0,72,72,81
9,r_49_88_16,seq10,r_4_81_76,r_4_81_76,1.0,5,81,76,81
91,seq90,r_91_23_188,r_7_50_54,r_7_50_54,1.0,12,66,54,81
49,r_149_17_103,r_114_6_1,seq140,r_149_17_103,0.98,0,103,103,81
7,r_102_143_97,r_1_98_119,r_71_107_25,r_102_143_97,1.0,1,98,97,81
44,r_109_0_124,r_24_119_152,r_145_125_64,r_109_0_124,0.81,0,124,124,81
35,r_21_76_133,seq86,seq32,r_21_76_133,0.43,20,153,133,81
12,r_69_92_110,seq96,seq2,r_69_92_110,1.0,0,110,110,81
23,r_60_122_173,r_130_100_17,r_75_132_20,r_60_122_173,0.89,0,173,173,81
84,seq72,seq128,r_111_120_92,r_111_120_92,0.92,60,152,92,81
55,seq10,r_49_88_16,r_108_15_156,r_108_15_156,0.51,2,158,156,81
93,seq111,r_59_58_187,r_103_131_65,r_103_131_65,1.0,54,119,65,82
26,r_126_57_27,r_137_67_32,r_82_143_168,r_126_57_27,1.0,0,27,27,82
36,r_139_15_158,seq118,seq107,r_139_15_158,0.75,0,158,158,82
14,r_70_26_181,seq21,seq72,r_70_26_181,0.6,1,182,181,82
43,r_31_35_103,r_68_147_11,seq101,r_31_35_103,1.0,1,104,103,82
37,r_69_33_24,r_88_38_144,r_0_45_2,r_69_33_24,1.0,0,24,24,82
22,r_133_39_56,r_73_132_119,r_112_127_28,r_133_39_56,1.0,1,57,56,82
19,r_137_67_32,r_59_58_187,r_103_131_65,r_103_131_65,1.0,54,119,65,82
55,seq129,r_114_105_81,r_112_127_28,r_112_127_28,0.53,57,85,28,82
16,r_7_148_165,seq87,r_112_127_28,r_112_127_28,0.99,139,167,28,82
21,r_81_90_72,r_51_42_194,seq43,r_81_90_72,0.97,0,72,72,82
39,r_82_143_168,r_99_149_85,r_126_57_27,r_126_57_27,0.69,58,85,27,82
1,r_124_66_150,r_37_120_37,r_31_35_103,r_124_66_150,0.84,3,153,150,82
1,r_124_66_150,r_92_13_178,r_37_120_37,r_37_120_37,0.76,52,89,37,82
5,r_27_146_146,r_135_6_170,r_113_61_52,r_27_146_146,0.8,1,147,146,82
46,r_86_30_184,seq19,r_91_3_172,r_86_30_184,0.47,0,184,184,82
42,r_59_58_187,seq111,r_103_131_65,r_103_131_65,1.0,27,92,65,82
80,seq75,seq56,r_84_79_99,r_84_79_99,1.0,7,106,99,82
45,r_68_147_11,r_31_35_103,seq50,r_31_35_103,1.0,1,104,103,82
35,r_63_62_33,r_11_53_38,seq18,r_63_62_33,1.0,0,33,33,82
24,r_11_53_38,r_73_132_119,seq138,r_73_132_119,0.53,26,145,119,82
30,r_48_52_59,seq18,seq74,r_48_52_59,0.97,0,59,59,82
39,r_82_143_168,r_126_57_27,r_81_90_72,r_82_143_168,0.61,1,169,168,82
31,r_34_10_134,r_84_79_99,r_113_61_52,r_84_79_99,0.97,0,99,99,82
41,r_4_49_93,seq128,seq72,r_4_49_93,0.65,13,106,93,82
67,seq32,r_34_10_134,r_113_61_52,r_34_10_134,0.91,-56,78,134,82
89,seq101,r_29_144_121,r_31_35_103,r_31_35_103,0.97,24,127,103,82
85,seq95,r_103_131_65,seq107,r_103_131_65,1.0,-8,57,65,82
24,r_11_53_38,r_59_58_187,r_73_132_119,r_11_53_38,0.94,10,48,38,82
3,r_25_47_91,seq43,seq129,r_25_47_91,0.91,1,92,91,82
72,seq44,r_109_104_157,r_23_108_192,r_109_104_157,0.98,1,158,157,82
4,r_16_100_45,r_51_42_194,r_136_145_26,r_16_100_45,0.49,63,108,45,82
0,r_84_79_99,r_34_10_134,seq75,r_84_79_99,1.0,0,99,99,82
20,r_99_149_85,r_82_143_168,seq2,r_99_149_85,0.9,0,85,85,82
98,seq122,r_89_60_176,r_34_10_134,r_34_10_134,0.94,50,184,134,82
7,r_136_145_26,r_142_46_191,r_16_100_45,r_136_145_26,0.81,0,26,26,82
10,r_37_120_37,seq64,r_124_66_150,r_37_120_37,0.62,-9,28,37,82
15,r_135_6_170,r_27_146_146,seq95,r_27_146_146,0.99,1,147,146,82
48,r_83_17_185,seq8,r_16_100_45,r_16_100_45,0.69,141,186,45,82
6,r_88_38_144,seq102,r_113_61_52,r_88_38_144,0.93,0,144,144,82
40,r_113_61_52,seq72,seq32,r_113_61_52,0.9,1,53,52,82
2,r_140_77_23,r_84_79_99,seq74,r_140_77_23,1.0,0,23,23,82
10,r_37_120_37,r_124_66_150,r_23_108_192,r_124_66_150,0.66,3,153,150,82
27,r_73_132_119,seq138,seq98,r_73_132_119,0.93,3,122,119,82
30,r_48_52_59,seq74,r_29_144_121,r_29_144_121,0.95,11,132,121,82
47,r_89_60_176,r_28_130_159,r_81_90_72,r_81_90_72,0.88,94,166,72,82
29,r_91_3_172,seq74,seq40,r_91_3_172,0.57,0,172,172,82
25,r_28_130_159,r_89_60_176,seq14,r_28_130_159,0.71,7,166,159,82
33,r_114_105_81,seq129,seq106,r_114_105_81,0.97,4,85,81,82
88,seq98,seq128,r_73_132_119,r_73_132_119,0.97,5,124,119,82
42,r_59_58_187,r_103_131_65,seq1,r_103_131_65,0.36,122,187,65,82
31,r_34_10_134,r_113_61_52,r_89_60_176,r_34_10_134,0.97,1,135,134,82
38,r_24_115_67,r_51_42_194,r_125_78_74,r_24_115_67,1.0,0,67,67,82
34,r_125_78_74,seq9,r_24_115_67,r_24_115_67,1.0,28,95,67,82
9,r_54_119_123,seq50,seq2,r_54_119_123,0.99,1,124,123,82
26,r_126_57_27,r_82_143_168,r_114_105_81,r_114_105_81,0.46,88,169,81,82
96,seq118,r_139_15_158,r_103_131_65,r_103_131_65,0.97,93,158,65,82
31,r_34_10_134,r_89_60_176,r_80_71_153,r_34_10_134,0.73,37,171,134,82
28,r_29_144_121,seq101,r_48_52_59,r_29_144_121,0.85,6,127,121,82
91,seq106,seq121,r_114_105_81,r_114_105_81,0.97,2,83,81,82
49,r_92_13_178,r_23_108_192,r_84_79_99,r_92_13_178,0.54,2,180,178,82
82,seq85,r_27_146_146,seq95,r_27_146_146,0.92,1,147,146,82
19,r_137_67_32,seq21,r_59_58_187,r_137_67_32,1.0,0,32,32,82
12,r_103_131_65,r_91_3_172,r_137_67_32,r_103_131_65,1.0,5,70,65,82
93,seq105,r_61_108_178,r_45_145_96,r_45_145_96,1.0,16,112,96,83
30,r_61_108_178,seq105,seq88,r_61_108_178,0.51,0,178,178,83
36,r_100_52_89,r_39_24_199,seq76,r_100_52_89,0.95,0,89,89,83
38,r_23_9_132,r_138_13_111,r_147_27_60,r_23_9_132,0.76,-77,55,132,83
26,r_49_144_44,r_138_13_111,seq73,r_49_144_44,1.0,0,44,44,83
92,seq104,r_70_149_118,seq37,r_70_149_118,1.0,2,120,118,83
14,r_98_14_82,r_66_47_13,r_136_128_1,r_98_14_82,1.0,0,82,82,83
8,r_122_44_93,seq78,seq117,r_122_44_93,0.93,0,93,93,83
43,r_132_41_86,r_121_99_149,seq112,r_132_41_86,0.95,1,87,86,83
37,r_64_12_24,r_45_145_96,r_134_72_98,r_45_145_96,1.0,0,96,96,83
19,r_146_77_141,r_0_22_143,r_147_27_60,r_147_27_60,0.51,84,144,60,83
71,seq48,r_56_101_95,seq40,r_56_101_95,0.95,0,95,95,83
16,r_142_86_3,r_106_26_160,r_32_85_146,r_142_86_3,0.78,160,163,3,83
39,r_107_141_80,seq65,r_136_128_1,r_107_141_80,1.0,0,80,80,83
28,r_62_94_35,r_130_6_49,seq124,r_62_94_35,0.84,1,36,35,83
5,r_95_123_130,seq112,r_70_149_118,r_70_149_118,0.86,15,133,118,83
46,r_20_46_109,seq105,seq11,r_20_46_109,1.0,0,109,109,83
42,r_116_82_177,r_0_22_143,r_97_36_84,r_97_36_84,1.0,34,118,84,83
19,r_146_77_141,r_34_68_99,r_0_22_143,r_34_68_99,0.99,-37,62,99,83
41,r_110_28_37,r_129_75_91,seq59,r_110_28_37,0.72,0,37,37,83
95,seq112,r_95_123_130,r_132_41_86,r_132_41_86,0.96,18,104,86,83
31,r_7_8_85,seq88,r_64_12_24,r_7_8_85,0.85,0,85,85,83
3,r_89_55_67,seq137,seq78,r_89_55_67,0.84,2,69,67,83
4,r_138_13_111,seq133,r_131_119_114,r_138_13_111,0.6,2,113,111,83
0,r_120_92_76,r_113_118_161,seq91,r_120_92_76,0.8,0,76,76,83
99,seq125,r_130_6_49,r_136_128_1,r_130_6_49,0.98,1,50,49,83
11,r_56_101_95,seq48,seq29,r_56_101_95,0.95,0,95,95,83
20,r_147_27_60,r_122_44_93,r_23_9_132,r_147_27_60,0.97,5,65,60,83
13,r_66_47_13,r_98_14_82,seq88,r_98_14_82,1.0,0,82,82,83
15,r_113_118_161,r_127_111_174,r_121_99_149,r_113_118_161,0.75,0,161,161,83
57,seq143,seq3,r_129_75_91,r_129_75_91,0.73,-3,88,91,83
12,r_97_36_84,r_116_82_177,r_89_55_67,r_116_82_177,0.85,0,177,177,83
6,r_0_22_143,r_116_82_177,seq3,r_0_22_143,0.77,2,145,143,83
85,seq81,r_102_58_140,seq91,r_102_58_140,0.93,-14,126,140,83
48,r_57_115_18,seq65,seq105,r_57_115_18,1.0,0,18,18,83
29,r_130_6_49,seq125,seq3,r_130_6_49,1.0,1,50,49,83
87,seq88,seq103,r_61_108_178,r_61_108_178,0.68,2,180,178,83
27,r_34_68_99,r_146_77_141,seq133,r_34_68_99,0.96,0,99,99,83
87,seq88,r_7_8_85,seq103,r_7_8_85,0.82,0,85,85,83
2,r_32_85_146,seq104,seq53,r_32_85_146,0.89,0,146,146,83
47,r_129_75_91,r_15_126_104,seq143,r_15_126_104,0.89,-11,93,104,83
75,seq59,r_121_99_149,r_110_28_37,r_110_28_37,1.0,7,44,37,83
18,r_136_128_1,seq125,r_107_141_80,r_107_141_80,1.0,14,94,80,83
56,seq11,seq65,r_20_46_109,r_20_46_109,1.0,2,111,109,83
24,r_121_99_149,seq4,r_113_118_161,r_113_118_161,0.85,5,166,161,83
10,r_74_80_36,r_5_83_135,seq16,r_74_80_36,1.0,0,36,36,83
33,r_102_58_140,seq81,r_110_28_37,r_102_58_140,0.71,0,140,140,83
38,r_23_9_132,r_147_27_60,r_34_68_99,r_23_9_132,0.76,-15,117,132,83
65,seq29,seq90,r_56_101_95,r_56_101_95,1.0,45,140,95,83
32,r_45_145_96,r_64_12_24,seq105,r_45_145_96,1.0,0,96,96,83
34,r_96_1_105,r_121_99_149,seq105,r_96_1_105,0.89,0,105,105,83
20,r_147_27_60,r_23_9_132,r_5_83_135,r_147_27_60,0.5,54,114,60,83
60,seq18,r_131_119_114,r_50_30_4,r_131_119_114,1.0,0,114,114,83
81,seq73,seq114,r_49_144_44,r_49_144_44,0.99,25,69,44,83
17,r_84_139_100,seq124,r_132_41_86,r_84_139_100,1.0,2,102,100,83
9,r_70_149_118,seq104,seq137,r_70_149_118,0.94,2,120,118,83
22,r_127_111_174,seq10,seq65,r_127_111_174,0.52,0,174,174,83
20,r_147_27_60,r_5_83_135,r_146_77_141,r_5_83_135,0.65,-4,131,135,83
7,r_131_119_114,seq18,r_138_13_111,r_131_119_114,1.0,0,114,114,83
44,r_106_26_160,r_142_86_3,seq4,r_106_26_160,0.8,1,161,160,83
42,r_116_82_177,r_97_36_84,r_32_85_146,r_116_82_177,0.97,0,177,177,83
35,r_140_43_83,seq10,r_49_144_44,r_140_43_83,1.0,0,83,83,83
38,r_23_9_132,r_107_141_80,r_138_13_111,r_23_9_132,0.37,-114,18,132,83
12,r_97_36_84,seq76,r_116_82_177,r_97_36_84,0.99,1,85,84,83
30,r_52_72_91,r_49_135_104,seq112,r_52_72_91,0.66,1,92,91,84
36,r_131_118_142,r_61_51_166,r_17_43_65,r_61_51_166,1.0,-21,145,166,84
22,r_104_54_39,r_115_32_107,seq41,r_104_54_39,1.0,0,39,39,84
92,seq106,seq123,r_120_18_122,r_120_18_122,1.0,5,127,122,84
8,r_75_59_186,seq40,r_100_144_120,r_100_144_120,1.0,4,124,120,84
43,r_111_95_108,seq15,seq137,r_111_95_108,0.97,0,108,108,84
21,r_35_129_184,r_121_134_85,r_0_109_199,r_0_109_199,0.46,-108,91,199,84
39,r_56_116_143,r_121_134_85,r_149_146_109,r_56_116_143,0.99,-1,142,143,84
33,r_119_108_175,r_73_37_35,r_48_141_1,r_73_37_35,0.91,3,38,35,84
45,r_99_22_177,seq39,seq15,r_99_22_177,0.67,0,177,177,84
19,r_61_51_166,r_87_71_194,r_45_98_79,r_45_98_79,0.64,91,170,79,84
25,r_100_144_120,r_48_141_1,seq137,r_100_144_120,0.95,-7,113,120,84
37,r_136_113_40,seq23,r_48_141_1,r_136_113_40,0.98,1,41,40,84
31,r_90_3_63,r_28_7_22,seq1,r_90_3_63,0.87,1,64,63,84
41,r_79_91_102,r_17_43_65,r_21_34_62,r_21_34_62,0.91,40,102,62,84
90,seq101,r_57_30_145,r_48_141_1,r_57_30_145,1.0,-3,142,145,84
26,r_88_103_128,seq97,r_73_37_35,r_73_37_35,1.0,95,130,35,84
8,r_75_59_186,r_100_144_120,r_19_96_148,r_75_59_186,0.93,0,186,186,84
12,r_70_13_11,r_57_30_145,seq2,r_70_13_11,0.87,0,11,11,84
9,r_11_130_25,r_24_69_144,seq42,r_11_130_25,0.97,0,25,25,84
4,r_17_43_65,r_110_53_95,r_70_13_11,r_70_13_11,0.93,67,78,11,84
0,r_49_135_104,r_52_72_91,r_121_134_85,r_52_72_91,0.77,1,92,91,84
11,r_115_32_107,r_17_43_65,seq107,r_115_32_107,0.83,1,108,107,84
32,r_4_26_32,r_17_43_65,r_11_130_25,r_17_43_65,0.53,-33,32,65,84
20,r_8_140_115,seq74,seq133,r_8_140_115,1.0,2,117,115,84
13,r_78_33_74,r_100_144_120,seq127,r_78_33_74,1.0,0,74,74,84
15,r_149_146_109,r_31_142_132,r_28_7_22,r_149_146_109,0.74,1,110,109,84
48,r_110_53_95,r_17_43_65,seq139,r_17_43_65,0.59,13,78,65,84
46,r_73_37_35,r_119_108_175,r_110_53_95,r_73_37_35,1.0,1,36,35,84
21,r_35_129_184,r_0_109_199,r_49_135_104,r_35_129_184,0.78,0,184,184,84
99,seq127,seq122,r_78_33_74,r_78_33_74,1.0,40,114,74,84
2,r_105_5_110,seq106,seq47,r_105_5_110,1.0,1,111,110,84
47,r_87_71_194,r_61_51_166,seq132,r_61_51_166,0.65,4,170,166,84
29,r_57_30_145,seq101,r_17_43_65,r_57_30_145,0.93,0,145,145,84
24,r_19_96_148,r_20_14_100,r_119_108_175,r_20_14_100,0.72,48,148,100,84
16,r_6_83_37,r_149_146_109,seq82,r_6_83_37,1.0,0,37,37,84
25,r_100_144_120,r_78_33_74,r_48_141_1,r_78_33_74,0.89,1,75,74,84
50,seq1,seq60,r_21_34_62,r_21_34_62,1.0,8,70,62,84
68,seq40,r_75_59_186,r_45_98_79,r_45_98_79,1.0,4,83,79,84
38,r_45_98_79,seq123,seq40,r_45_98_79,1.0,0,79,79,84
52,seq132,r_24_69_144,r_38_138_121,r_38_138_121,1.0,23,144,121,84
34,r_31_142_132,seq97,seq147,r_31_142_132,0.83,2,134,132,84
51,seq2,r_17_43_65,r_70_13_11,r_70_13_11,0.98,2,13,11,84
17,r_21_34_62,r_99_22_177,seq1,r_21_34_62,1.0,0,62,62,84
75,seq62,r_149_146_109,r_143_66_46,r_143_66_46,1.0,5,51,46,84
94,seq112,seq106,r_52_72_91,r_52_72_91,1.0,1,92,91,84
3,r_143_66_46,seq25,seq62,r_143_66_46,1.0,0,46,46,84
28,r_120_18_122,seq97,seq106,r_120_18_122,0.99,1,123,122,84
49,r_28_7_22,seq122,r_149_146_109,r_149_146_109,0.98,1,110,109,84
56,seq139,seq122,r_110_53_95,r_110_53_95,0.46,3,98,95,84
79,seq74,r_8_140_115,seq47,r_8_140_115,1.0,1,116,115,84
35,r_38_138_121,seq133,seq63,r_38_138_121,0.96,0,121,121,84
0,r_49_135_104,r_121_134_85,r_44_117_20,r_49_135_104,0.62,0,104,104,84
93,seq109,r_66_101_182,r_42_83_62,r_42_83_62,1.0,120,182,62,85
21,r_29_118_45,seq147,seq0,r_29_118_45,0.93,3,48,45,85
8,r_11_86_141,r_89_64_144,r_40_88_32,r_11_86_141,0.78,0,141,141,85
30,r_135_9_44,r_134_119_54,seq109,r_135_9_44,0.92,3,47,44,85
43,r_47_87_97,seq137,r_23_98_60,r_23_98_60,1.0,38,98,60,85
54,seq136,r_21_68_188,r_113_52_75,r_113_52_75,0.97,0,75,75,85
35,r_19_58_10,r_22_38_87,seq35,r_19_58_10,0.97,0,10,10,85
37,r_140_72_96,seq35,r_4_126_160,r_140_72_96,0.99,0,96,96,85
55,seq137,r_47_87_97,seq33,r_47_87_97,0.85,1,98,97,85
16,r_42_83_62,seq92,r_135_9_44,r_42_83_62,1.0,0,62,62,85
1,r_128_6_140,seq148,r_80_85_3,r_128_6_140,0.99,0,140,140,85
5,r_125_48_137,r_44_2_171,r_31_143_89,r_125_48_137,0.93,0,137,137,85
46,r_149_63_118,seq146,seq147,r_149_63_118,0.85,1,119,118,85
80,seq145,r_55_141_149,seq115,r_55_141_149,1.0,0,149,149,85
19,r_36_24_116,seq81,r_108_116_13,r_36_24_116,0.61,2,118,116,85
94,seq112,r_8_46_34,seq54,r_8_46_34,0.69,16,50,34,85
41,r_97_15_151,seq92,seq33,r_97_15_151,0.77,0,151,151,85
43,r_47_87_97,r_23_98_60,r_73_78_112,r_47_87_97,0.59,32,129,97,85
34,r_25_53_38,r_97_15_151,seq148,r_25_53_38,0.99,1,39,38,85
3,r_120_75_69,r_140_72_96,seq81,r_120_75_69,1.0,0,69,69,85
10,r_80_85_3,r_44_2_171,r_128_6_140,r_128_6_140,0.71,33,173,140,85
0,r_4_126_160,r_31_143_89,r_140_72_96,r_4_126_160,0.86,-143,17,160,85
90,seq103,r_22_38_87,r_11_86_141,r_22_38_87,0.99,0,87,87,85
26,r_134_119_54,r_22_38_87,seq17,r_22_38_87,0.97,-12,75,87,85
72,seq41,r_7_62_114,seq147,r_7_62_114,0.95,2,116,114,85
20,r_31_143_89,r_149_63_118,r_11_86_141,r_31_143_89,0.96,1,90,89,85
13,r_44_2_171,r_80_85_3,r_36_24_116,r_44_2_171,0.64,2,173,171,85
15,r_39_74_159,seq35,seq26,r_39_74_159,0.9,0,159,159,85
90,seq103,r_11_86_141,r_7_62_114,r_11_86_141,0.82,3,144,141,85
6,r_129_130_37,r_29_118_45,seq146,r_129_130_37,0.99,0,37,37,85
23,r_59_70_17,r_8_46_34,seq35,r_59_70_17,1.0,-2,15,17,85
20,r_31_143_89,r_11_86_141,r_125_48_137,r_31_143_89,1.0,52,141,89,85
0,r_4_126_160,r_140_72_96,seq1,r_140_72_96,0.88,64,160,96,85
27,r_89_64_144,r_11_86_141,seq41,r_11_86_141,0.95,0,141,141,85
24,r_23_98_60,r_47_87_97,r_91_37_109,r_91_37_109,1.0,2,111,109,85
2,r_51_16_92,seq1,r_43_144_191,r_51_16_92,0.98,1,93,92,85
18,r_91_37_109,seq61,r_23_98_60,r_91_37_109,0.97,1,110,109,85
29,r_71_133_91,seq27,seq138,r_71_133_91,0.68,27,118,91,85
24,r_23_98_60,seq60,r_47_87_97,r_23_98_60,1.0,2,62,60,85
25,r_21_68_188,seq136,r_51_16_92,r_51_16_92,1.0,96,188,92,85
33,r_113_52_75,r_149_63_118,seq136,r_113_52_75,1.0,0,75,75,85
36,r_111_67_21,r_55_141_149,seq92,r_111_67_21,0.92,1,22,21,85
58,seq13,r_77_106_110,seq131,r_77_106_110,1.0,1,111,110,85
31,r_7_62_114,r_89_64_144,r_82_121_143,r_7_62_114,0.74,36,150,114,85
32,r_18_124_130,r_66_101_182,r_65_107_178,r_18_124_130,0.84,0,130,130,85
38,r_3_49_101,seq92,r_59_70_17,r_3_49_101,0.98,0,101,101,85
40,r_57_110_22,r_129_130_37,seq131,r_129_130_37,0.79,-14,23,37,85
83,seq92,r_42_83_62,r_40_88_32,r_42_83_62,0.87,-39,23,62,85
81,seq81,r_36_24_116,r_120_75_69,r_120_75_69,1.0,49,118,69,85
26,r_134_119_54,seq17,r_8_46_34,r_8_46_34,0.86,126,160,34,85
22,r_22_38_87,seq103,seq76,r_22_38_87,1.0,0,87,87,85
28,r_77_106_110,seq13,r_59_70_17,r_77_106_110,0.66,1,111,110,85
49,r_108_116_13,seq147,r_36_24_116,r_36_24_116,0.84,14,130,116,85
7,r_55_141_149,seq145,seq14,r_55_141_149,0.92,0,149,149,85
44,r_66_101_182,seq109,r_43_144_191,r_66_101_182,0.53,0,182,182,85
36,r_109_104_81,seq145,r_16_142_25,r_109_104_81,0.97,2,83,81,86
92,seq100,r_92_65_197,r_40_61_130,r_40_61_130,1.0,2,132,130,86
14,r_42_60_97,seq137,seq147,r_42_60_97,1.0,1,98,97,86
53,seq4,r_15_24_93,r_95_136_125,r_95_136_125,0.46,-9,116,125,86
43,r_67_7_167,seq3,r_64_87_116,r_67_7_167,0.8,0,167,167,86
35,r_96_57_145,seq81,r_116_75_72,r_96_57_145,0.46,-75,70,145,86
54,seq133,r_80_146_169,seq128,r_80_146_169,0.76,0,169,169,86
71,seq37,r_85_144_63,seq127,r_85_144_63,1.0,0,63,63,86
16,r_76_121_79,seq147,r_9_52_29,r_9_52_29,0.86,54,83,29,86
21,r_18_59_153,seq63,seq93,r_18_59_153,0.51,2,155,153,86
39,r_126_103_131,seq119,seq38,r_126_103_131,0.89,1,132,131,86
1,r_98_123_89,r_15_24_93,r_131_118_75,r_98_123_89,1.0,0,89,89,86
5,r_114_45_115,seq139,r_47_149_94,r_114_45_115,1.0,0,115,115,86
46,r_80_146_169,seq133,r_42_60_97,r_42_60_97,0.6,72,169,97,86
42,r_14_72_175,seq74,r_17_56_70,r_17_56_70,1.0,100,170,70,86
35,r_96_57_145,r_39_77_28,seq81,r_39_77_28,0.9,2,30,28,86
69,seq32,r_64_87_116,r_36_94_64,r_36_94_64,1.0,51,115,64,86
45,r_6_106_170,seq91,r_42_60_97,r_6_106_170,0.63,0,170,170,86
81,seq70,r_47_149_94,r_62_50_132,r_62_50_132,0.77,15,147,132,86
19,r_20_68_198,r_73_5_99,r_85_144_63,r_85_144_63,0.63,35,98,63,86
41,r_36_94_64,seq129,seq32,r_36_94_64,1.0,0,64,64,86
89,seq91,r_6_106_170,seq3,r_6_106_170,0.99,0,170,170,86
10,r_148_30_179,r_20_68_198,r_0_48_36,r_148_30_179,0.52,0,179,179,86
26,r_116_75_72,seq70,r_96_57_145,r_116_75_72,0.87,6,78,72,86
72,seq38,r_47_149_94,seq51,r_47_149_94,1.0,4,98,94,86
11,r_64_87_116,seq32,r_17_56_70,r_17_56_70,0.99,45,115,70,86
13,r_47_149_94,seq38,seq31,r_47_149_94,0.99,4,98,94,86
15,r_62_50_132,r_20_68_198,seq70,r_62_50_132,0.9,0,132,132,86
20,r_39_77_28,r_96_57_145,seq53,r_39_77_28,0.93,2,30,28,86
6,r_69_19_76,r_117_135_156,r_10_88_82,r_69_19_76,1.0,0,76,76,86
99,seq127,r_40_61_130,r_99_34_5,r_40_61_130,0.86,-1,129,130,86
27,r_107_140_119,seq70,r_85_144_63,r_85_144_63,0.59,57,120,63,86
22,r_85_144_63,r_62_50_132,r_107_140_119,r_85_144_63,0.94,69,132,63,86
2,r_49_102_154,seq74,seq55,r_49_102_154,0.94,0,154,154,86
47,r_110_1_120,r_49_102_154,seq11,r_110_1_120,0.96,-1,119,120,86
18,r_17_56_70,seq71,seq139,r_17_56_70,1.0,0,70,70,86
29,r_73_5_99,r_20_68_198,r_108_27_43,r_73_5_99,1.0,-1,98,99,86
38,r_9_52_29,seq129,r_76_121_79,r_9_52_29,0.9,1,30,29,86
4,r_108_27_43,r_69_19_76,r_54_26_4,r_108_27_43,0.94,0,43,43,86
25,r_15_24_93,r_110_1_120,seq143,r_110_1_120,1.0,-26,94,120,86
64,seq147,r_76_121_79,r_42_60_97,r_42_60_97,1.0,0,97,97,86
68,seq31,seq70,r_47_149_94,r_47_149_94,0.89,5,99,94,86
32,r_111_86_143,seq91,seq97,r_111_86_143,0.65,3,146,143,86
35,r_96_57_145,r_116_75_72,seq71,r_96_57_145,0.99,1,146,145,86
34,r_131_118_75,r_105_58_173,r_67_7_167,r_131_118_75,0.97,4,79,75,86
26,r_116_75_72,r_96_57_145,seq81,r_96_57_145,0.98,-7,138,145,86
22,r_85_144_63,seq37,r_62_50_132,r_85_144_63,1.0,0,63,63,86
28,r_10_88_82,r_92_65_197,r_69_19_76,r_69_19_76,1.0,38,114,76,86
49,r_40_61_130,seq127,seq100,r_40_61_130,0.97,-1,129,130,86
7,r_25_2_160,seq113,r_16_142_25,r_25_2_160,0.71,2,162,160,86
23,r_124_122_77,r_76_121_79,r_85_144_63,r_124_122_77,0.98,3,80,77,86
82,seq71,seq55,r_96_57_145,r_96_57_145,0.85,-1,144,145,86
34,r_131_118_75,r_67_7_167,r_98_123_89,r_131_118_75,0.63,46,121,75,86
12,r_117_135_156,seq51,seq90,r_117_135_156,0.49,0,156,156,86
36,r_56_13_177,seq24,r_108_89_141,r_56_13_177,0.51,1,178,177,87
14,r_131_126_185,seq47,r_18_115_133,r_131_126_185,0.41,1,186,185,87
8,r_72_41_158,seq31,seq34,r_72_41_158,0.81,0,158,158,87
43,r_48_141_138,r_37_82_32,seq21,r_48_141_138,0.72,2,140,138,87
31,r_84_25_18,r_29_112_182,seq54,r_84_25_18,0.84,0,18,18,87
55,seq11,r_42_142_166,r_88_9_17,r_88_9_17,0.77,152,169,17,87
42,r_4_124_28,r_86_137_29,r_87_33_11,r_4_124_28,0.81,2,30,28,87
21,r_37_82_32,r_48_141_138,r_66_35_161,r_48_141_138,1.0,2,140,138,87
39,r_10_59_59,seq67,seq130,r_10_59_59,0.84,4,63,59,87
1,r_134_116_110,seq53,seq47,r_134_116_110,0.58,3,113,110,87
86,seq76,r_81_60_41,seq80,r_81_60_41,0.92,0,41,41,87
46,r_8_143_69,r_37_82_32,seq11,r_8_143_69,0.99,4,73,69,87
80,seq62,r_108_89_141,r_84_25_18,r_108_89_141,0.85,-29,112,141,87
19,r_74_140_102,seq24,r_78_49_38,r_74_140_102,0.92,0,102,102,87
41,r_75_97_12,r_108_89_141,seq76,r_75_97_12,0.94,0,12,12,87
37,r_81_60_41,seq76,seq67,r_81_60_41,0.91,0,41,41,87
66,seq34,r_29_112_182,r_72_41_158,r_72_41_158,0.92,3,161,158,87
16,r_5_16_30,r_72_41_158,seq30,r_5_16_30,0.87,0,30,30,87
33,r_65_23_37,seq130,seq53,r_65_23_37,0.95,-1,36,37,87
26,r_147_50_52,seq132,r_86_137_29,r_86_137_29,0.73,24,53,29,87
49,r_138_26_33,seq47,seq53,r_138_26_33,0.98,0,33,33,87
0,r_18_115_133,r_15_91_136,seq22,r_18_115_133,0.93,0,133,133,87
73,seq47,r_131_126_185,r_134_116_110,r_134_116_110,1.0,76,186,110,87
2,r_70_148_55,r_74_140_102,seq73,r_70_148_55,0.94,1,56,55,87
13,r_105_6_164,seq127,r_145_102_10,r_145_102_10,0.76,155,165,10,87
48,r_117_104_21,seq47,seq127,r_117_104_21,0.95,0,21,21,87
6,r_69_17_74,r_149_95_100,seq28,r_69_17_74,0.9,2,76,74,87
62,seq28,r_12_94_6,r_69_17_74,r_69_17_74,0.88,6,80,74,87
9,r_90_128_189,seq32,r_78_49_38,r_78_49_38,0.89,-2,36,38,87
99,seq127,r_105_6_164,r_149_95_100,r_149_95_100,0.89,23,123,100,87
27,r_20_113_61,seq53,seq43,r_20_113_61,0.96,0,61,61,87
41,r_75_97_12,seq76,r_145_102_10,r_145_102_10,0.35,75,85,10,87
47,r_129_40_162,seq96,r_86_137_29,r_86_137_29,0.93,135,164,29,87
3,r_108_89_141,r_100_39_53,seq30,r_100_39_53,0.97,0,53,53,87
18,r_29_112_182,seq34,r_109_2_51,r_29_112_182,0.41,2,184,182,87
29,r_149_95_100,r_1_119_139,seq127,r_149_95_100,0.91,3,103,100,87
24,r_79_0_175,seq146,r_123_101_73,r_123_101_73,1.0,97,170,73,87
15,r_100_39_53,r_108_89_141,seq130,r_100_39_53,1.0,0,53,53,87
12,r_78_49_38,seq103,r_90_128_189,r_78_49_38,0.95,1,39,38,87
64,seq31,r_72_41_158,r_20_113_61,r_20_113_61,0.99,97,158,61,87
50,seq130,seq19,r_10_59_59,r_10_59_59,0.99,3,62,59,87
32,r_123_101_73,seq57,r_20_113_61,r_123_101_73,0.69,0,73,73,87
28,r_109_2_51,r_1_119_139,r_65_23_37,r_109_2_51,0.97,3,54,51,87
34,r_92_114_104,seq3,seq71,r_92_114_104,0.82,-1,103,104,87
11,r_111_98_25,r_14_93_198,seq121,r_111_98_25,0.94,-1,24,25,87
23,r_86_137_29,r_4_124_28,seq19,r_86_137_29,0.82,1,30,29,87
22,r_120_110_84,seq43,seq53,r_120_110_84,0.88,2,86,84,87
7,r_15_91_136,seq58,seq76,r_15_91_136,0.83,3,139,136,87
57,seq19,seq130,r_86_137_29,r_86_137_29,1.0,22,51,29,87
82,seq67,r_10_59_59,r_81_60_41,r_81_60_41,0.88,22,63,41,87
40,r_44_37_169,r_15_63_12,seq144,r_44_37_169,0.67,0,169,169,88
15,r_117_112_50,seq33,seq133,r_117_112_50,1.0,-1,49,50,88
30,r_130_74_161,r_47_56_125,r_17_98_91,r_17_98_91,0.74,21,112,91,88
36,r_42_16_69,seq21,seq32,r_42_16_69,1.0,-2,67,69,88
37,r_28_66_56,r_111_55_82,r_15_63_12,r_28_66_56,0.96,-1,55,56,88
92,seq113,r_88_54_142,r_45_26_29,r_45_26_29,1.0,0,29,29,88
14,r_143_110_97,r_147_10_157,seq138,r_147_10_157,0.79,-62,95,157,88
8,r_85_125_92,r_95_145_134,r_117_112_50,r_85_125_92,1.0,0,92,92,88
4,r_96_124_26,r_52_136_73,seq30,r_96_124_26,0.87,0,26,26,88
40,r_44_37_169,seq39,r_15_63_12,r_15_63_12,1.0,0,12,12,88
43,r_94_148_31,seq22,seq78,r_94_148_31,0.8,-1,30,31,88
55,seq139,seq115,r_47_56_125,r_47_56_125,0.97,17,142,125,88
16,r_62_105_174,seq36,r_53_38_160,r_53_38_160,0.79,15,175,160,88
39,r_69_104_86,r_88_54_142,seq138,r_69_104_86,1.0,-1,85,86,88
5,r_47_56_125,r_102_60_96,r_6_2_18,r_47_56_125,0.83,-28,97,125,88
27,r_80_65_24,seq30,seq36,r_80_65_24,0.98,0,24,24,88
69,seq33,seq12,r_108_35_72,r_108_35_72,0.72,-1,71,72,88
45,r_149_51_137,seq1,r_18_68_110,r_149_51_137,0.98,1,138,137,88
29,r_75_4_58,seq73,r_24_142_41,r_75_4_58,1.0,0,58,58,88
78,seq64,seq77,r_8_119_42,r_8_119_42,1.0,1,43,42,88
19,r_53_38_160,r_130_74_161,seq21,r_53_38_160,0.59,2,162,160,88
1,r_40_140_17,r_117_112_50,seq36,r_40_140_17,0.56,2,19,17,88
35,r_81_11_74,seq139,r_82_93_10,r_82_93_10,1.0,1,11,10,88
38,r_6_2_18,r_47_56_125,r_17_98_91,r_6_2_18,0.68,110,128,18,88
49,r_18_68_110,r_8_119_42,r_149_51_137,r_149_51_137,1.0,5,142,137,88
33,r_79_128_57,r_48_13_65,seq87,r_48_13_65,0.81,-8,57,65,88
41,r_52_136_73,r_114_9_179,seq20,r_52_136_73,1.0,0,73,73,88
89,seq100,r_17_98_91,r_88_54_142,r_17_98_91,0.6,-20,71,91,88
26,r_34_131_165,seq78,r_82_93_10,r_82_93_10,0.88,158,168,10,88
9,r_24_142_41,r_71_106_133,r_132_92_35,r_24_142_41,0.97,-2,39,41,88
0,r_3_29_172,r_107_61_164,r_71_106_133,r_3_29_172,0.53,1,173,172,88
73,seq41,r_114_9_179,seq27,r_114_9_179,0.99,0,179,179,88
11,r_95_145_134,seq7,seq57,r_95_145_134,0.96,2,136,134,88
20,r_127_90_175,seq126,r_42_16_69,r_42_16_69,0.54,107,176,69,88
13,r_147_10_157,r_143_110_97,r_15_63_12,r_143_110_97,0.72,62,159,97,88
71,seq133,seq101,r_117_112_50,r_117_112_50,1.0,-1,49,50,88
48,r_99_46_140,seq14,seq5,r_99_46_140,0.61,1,141,140,88
12,r_15_63_12,r_44_37_169,r_81_11_74,r_15_63_12,0.78,157,169,12,88
6,r_48_13_65,seq49,r_111_55_82,r_48_13_65,1.0,0,65,65,88
99,seq126,r_127_90_175,r_130_74_161,r_130_74_161,0.75,15,176,161,88
24,r_71_106_133,r_114_9_179,r_3_29_172,r_114_9_179,0.52,-17,162,179,88
87,seq91,r_102_60_96,r_44_37_169,r_44_37_169,0.57,7,176,169,88
38,r_6_2_18,r_127_90_175,r_47_56_125,r_6_2_18,0.96,1,19,18,88
87,seq91,seq31,r_102_60_96,r_102_60_96,1.0,14,110,96,88
2,r_58_76_98,seq72,r_143_110_97,r_58_76_98,1.0,1,99,98,88
47,r_120_23_148,seq144,r_82_93_10,r_120_23_148,0.9,0,148,148,88
24,r_71_106_133,seq20,r_114_9_179,r_71_106_133,0.69,0,133,133,88
35,r_81_11_74,r_82_93_10,r_15_63_12,r_81_11_74,0.96,0,74,74,88
25,r_17_98_91,seq100,r_6_2_18,r_17_98_91,0.71,0,91,91,88
3,r_103_67_59,r_3_29_172,r_82_93_10,r_103_67_59,1.0,0,59,59,88
32,r_43_134_116,r_149_51_137,seq100,r_43_134_116,0.9,6,122,116,88
52,seq5,seq12,r_99_46_140,r_99_46_140,1.0,3,143,140,88
75,seq49,r_127_90_175,r_96_124_26,r_96_124_26,1.0,119,145,26,88
5,r_47_56_125,r_6_2_18,seq139,r_47_56_125,0.86,3,128,125,88
17,r_102_60_96,r_47_56_125,seq12,r_102_60_96,1.0,1,97,96,88
18,r_82_93_10,r_99_46_140,r_81_11_74,r_82_93_10,1.0,1,11,10,88
30,r_130_74_161,r_17_98_91,seq126,r_130_74_161,0.97,0,161,161,88
22,r_108_35_72,r_120_23_148,seq33,r_120_23_148,0.57,-69,79,148,88
46,r_137_19_39,seq87,seq31,r_137_19_39,0.99,2,41,39,88
49,r_18_68_110,seq12,r_8_119_42,r_18_68_110,0.87,0,110,110,88
12,r_15_63_12,r_85_125_92,r_44_37_169,r_15_63_12,0.71,0,12,12,88
18,r_82_93_10,r_81_11_74,seq84,r_82_93_10,0.55,69,79,10,88
44,r_114_9_179,seq41,r_40_140_17,r_114_9_179,0.48,0,179,179,88
21,r_8_119_42,seq87,seq64,r_8_119_42,1.0,0,42,42,88
23,r_111_55_82,seq36,r_48_13_65,r_48_13_65,1.0,8,73,65,88
82,seq78,r_34_131_165,seq89,r_34_131_165,0.9,3,168,165,88
79,seq72,r_58_76_98,r_82_93_10,r_58_76_98,0.94,0,98,98,88
36,r_53_29_139,seq112,r_69_146_123,r_53_29_139,0.75,7,146,139,89
43,r_58_5_175,seq147,seq133,r_58_5_175,0.52,0,175,175,89
54,seq135,r_95_17_148,r_19_110_86,r_19_110_86,0.66,-10,76,86,89
37,r_131_61_71,r_139_96_93,seq125,r_131_61_71,0.95,0,71,71,89
25,r_102_42_155,seq113,seq135,r_102_42_155,0.99,-4,151,155,89
46,r_132_134_128,seq94,r_83_109_18,r_132_134_128,0.97,0,128,128,89
45,r_107_127_185,r_73_54_191,r_19_110_86,r_107_127_185,0.25,0,185,185,89
95,seq118,r_74_38_179,r_103_12_96,r_103_12_96,1.0,65,161,96,89
66,seq31,r_2_1_172,r_124_0_104,r_124_0_104,0.98,-2,102,104,89
28,r_69_146_123,seq149,r_53_29_139,r_53_29_139,0.56,18,157,139,89
79,seq68,r_40_35_193,r_90_59_14,r_90_59_14,0.86,2,16,14,89
31,r_136_11_134,seq128,seq27,r_136_11_134,0.97,0,134,134,89
41,r_79_70_68,r_87_104_85,seq45,r_79_70_68,1.0,0,68,68,89
3,r_8_20_138,seq149,seq32,r_8_20_138,0.63,4,142,138,89
72,seq47,seq118,r_63_86_164,r_63_86_164,0.6,2,166,164,89
5,r_16_77_16,r_69_146_123,seq140,r_16_77_16,0.99,1,17,16,89
0,r_21_39_121,seq32,seq113,r_21_39_121,0.99,2,123,121,89
11,r_87_104_85,seq67,r_138_106_35,r_87_104_85,0.96,4,89,85,89
15,r_91_130_113,r_129_75_176,r_18_123_30,r_18_123_30,0.62,101,131,30,89
19,r_52_7_55,r_46_114_88,seq31,r_52_7_55,0.77,4,59,55,89
70,seq43,r_40_35_193,r_83_109_18,r_83_109_18,1.0,4,22,18,89
6,r_103_12_96,r_102_42_155,seq118,r_103_12_96,0.99,0,96,96,89
27,r_63_86_164,seq65,r_136_11_134,r_136_11_134,0.69,27,161,134,89
12,r_9_115_20,r_2_1_172,seq137,r_9_115_20,0.75,0,20,20,89
87,seq92,r_148_143_4,r_46_114_88,r_46_114_88,0.98,3,91,88,89
67,seq32,r_23_26_29,r_8_20_138,r_8_20_138,0.95,4,142,138,89
2,r_3_66_76,seq92,r_121_48_10,r_3_66_76,1.0,2,78,76,89
83,seq81,seq49,r_18_123_30,r_18_123_30,1.0,11,41,30,89
40,r_2_1_172,seq31,seq49,r_2_1_172,0.73,3,175,172,89
18,r_50_14_107,seq145,r_138_106_35,r_50_14_107,0.89,3,110,107,89
29,r_129_75_176,r_91_130_113,r_95_17_148,r_129_75_176,0.64,-1,175,176,89
24,r_13_72_118,seq68,seq30,r_13_72_118,0.98,2,120,118,89
25,r_102_42_155,r_103_12_96,seq113,r_103_12_96,1.0,0,96,96,89
33,r_99_82_61,r_87_104_85,seq56,r_99_82_61,1.0,0,61,61,89
13,r_138_106_35,seq15,seq128,r_138_106_35,1.0,0,35,35,89
42,r_90_59_14,r_8_20_138,seq68,r_90_59_14,0.57,2,16,14,89
14,r_18_123_30,r_116_24_53,seq81,r_116_24_53,0.59,-23,30,53,89
61,seq149,r_73_54_191,r_126_93_46,r_126_93_46,1.0,32,78,46,89
77,seq65,r_63_86_164,r_64_44_73,r_64_44_73,0.88,88,161,73,89
34,r_139_96_93,r_142_41_186,r_18_123_30,r_142_41_186,0.56,-96,90,186,89
97,seq120,r_98_28_57,r_23_26_29,r_98_28_57,0.9,-1,56,57,89
4,r_98_28_57,seq120,seq25,r_98_28_57,1.0,0,57,57,89
10,r_144_117_9,r_103_12_96,r_121_48_10,r_144_117_9,0.9,3,12,9,89
17,r_46_114_88,seq147,seq92,r_46_114_88,1.0,1,89,88,89
94,seq113,r_103_12_96,seq78,r_103_12_96,1.0,0,96,96,89
9,r_19_110_86,seq119,r_83_109_18,r_83_109_18,0.97,72,90,18,89
21,r_83_109_18,r_97_33_199,seq43,r_83_109_18,0.96,3,21,18,89
96,seq119,r_19_110_86,r_116_24_53,r_116_24_53,1.0,80,133,53,89
22,r_74_38_179,seq118,r_9_115_20,r_74_38_179,0.27,1,180,179,89
28,r_69_146_123,r_132_134_128,seq149,r_69_146_123,0.85,0,123,123,89
7,r_124_0_104,r_129_75_176,seq31,r_124_0_104,1.0,0,104,104,89
32,r_116_24_53,seq32,seq147,r_116_24_53,1.0,3,56,53,89
20,r_23_26_29,r_46_114_88,seq120,r_23_26_29,1.0,0,29,29,89
23,r_64_44_73,r_74_38_179,seq65,r_64_44_73,0.92,9,82,73,89
49,r_126_93_46,seq145,seq149,r_126_93_46,1.0,0,46,46,89
38,r_57_88_58,seq85,r_138_106_35,r_57_88_58,0.96,0,58,58,89
64,seq29,r_83_87_46,r_135_41_1,r_83_87_46,0.59,-30,16,46,90
21,r_78_69_48,seq132,seq21,r_78_69_48,0.96,0,48,48,90
14,r_27_10_87,r_75_96_175,r_103_149_57,r_103_149_57,0.8,4,61,57,90
22,r_103_149_57,r_138_120_161,r_27_10_87,r_103_149_57,0.92,0,57,57,90
32,r_65_147_178,r_142_35_24,seq49,r_65_147_178,0.59,0,178,178,90
7,r_100_24_90,seq72,r_14_77_27,r_100_24_90,0.31,78,168,90,90
45,r_17_5_95,seq118,r_27_10_87,r_17_5_95,0.91,-2,93,95,90
19,r_99_145_72,r_75_96_175,r_105_89_10,r_99_145_72,1.0,0,72,72,90
61,seq21,r_39_52_142,r_78_69_48,r_78_69_48,0.53,0,48,48,90
95,seq118,r_17_5_95,seq64,r_17_5_95,0.86,-4,91,95,90
15,r_94_36_20,r_122_11_156,r_74_26_2,r_94_36_20,0.98,0,20,20,90
3,r_54_58_123,r_6_101_164,seq136,r_54_58_123,0.8,3,126,123,90
26,r_16_60_89,r_17_5_95,seq111,r_16_60_89,0.93,0,89,89,90
4,r_138_120_161,r_103_149_57,r_144_88_15,r_138_120_161,0.69,-147,14,161,90
0,r_82_20_122,seq34,seq113,r_82_20_122,0.99,0,122,122,90
11,r_122_11_156,seq136,seq50,r_122_11_156,0.72,2,158,156,90
20,r_30_18_153,seq49,r_32_51_54,r_32_51_54,0.5,100,154,54,90
5,r_144_88_15,r_116_45_41,r_138_120_161,r_144_88_15,0.66,-1,14,15,90
13,r_2_127_66,seq126,r_92_67_16,r_2_127_66,1.0,-1,65,66,90
46,r_80_104_101,seq132,r_68_57_147,r_68_57_147,0.97,22,169,147,90
48,r_8_37_74,seq43,seq1,r_8_37_74,0.99,1,75,74,90
30,r_129_63_52,r_65_147_178,seq50,r_129_63_52,1.0,0,52,52,90
4,r_138_120_161,r_144_88_15,r_99_145_72,r_144_88_15,0.56,146,161,15,90
35,r_142_35_24,seq111,r_65_147_178,r_142_35_24,1.0,1,25,24,90
5,r_144_88_15,r_138_120_161,seq111,r_138_120_161,1.0,0,161,161,90
6,r_22_124_28,seq43,seq55,r_22_124_28,1.0,0,28,28,90
8,r_14_77_27,seq113,seq33,r_14_77_27,0.97,1,28,27,90
2,r_75_96_175,seq148,r_78_69_48,r_78_69_48,0.63,128,176,48,90
47,r_115_110_103,seq128,seq113,r_115_110_103,1.0,0,103,103,90
74,seq49,r_30_18_153,seq42,r_30_18_153,0.82,1,154,153,90
18,r_66_143_183,r_74_26_2,r_62_134_107,r_74_26_2,0.3,182,184,2,90
29,r_102_137_68,r_0_140_189,seq50,r_102_137_68,1.0,0,68,68,90
24,r_38_109_86,r_92_67_16,seq3,r_38_109_86,1.0,0,86,86,90
35,r_142_35_24,r_65_147_178,r_83_87_46,r_83_87_46,0.46,132,178,46,90
25,r_71_13_120,seq118,seq132,r_71_13_120,0.89,1,121,120,90
49,r_105_89_10,r_56_25_169,r_117_133_149,r_105_89_10,1.0,0,10,10,90
70,seq43,r_8_37_74,seq111,r_8_37_74,0.99,2,76,74,90
68,seq40,r_0_140_189,r_117_133_149,r_0_140_189,0.52,0,189,189,90
22,r_103_149_57,r_27_10_87,seq148,r_27_10_87,0.78,-6,81,87,90
9,r_32_51_54,r_66_143_183,r_44_76_198,r_32_51_54,0.96,0,54,54,90
32,r_65_147_178,r_129_63_52,r_142_35_24,r_65_147_178,0.97,-150,28,178,90
40,r_107_84_42,r_116_45_41,seq113,r_107_84_42,0.99,0,42,42,90
44,r_68_57_147,r_75_96_175,r_80_104_101,r_68_57_147,1.0,1,148,147,90
28,r_91_70_114,r_130_141_140,seq59,r_91_70_114,0.54,0,114,114,90
7,r_100_24_90,seq132,seq72,r_100_24_90,0.61,-54,36,90,90
66,seq33,r_56_25_169,r_14_77_27,r_14_77_27,1.0,1,28,27,90
14,r_27_10_87,r_103_149_57,r_17_5_95,r_27_10_87,0.7,9,96,87,90
23,r_130_141_140,r_44_76_198,r_54_58_123,r_130_141_140,0.76,0,140,140,90
1,r_116_45_41,r_107_84_42,seq90,r_107_84_42,1.0,-2,40,42,90
30,r_50_143_96,r_27_57_148,r_11_103_59,r_11_103_59,0.86,37,96,59,91
20,r_23_100_39,r_149_81_175,seq95,r_23_100_39,1.0,-4,35,39,91
44,r_72_117_17,r_63_9_84,r_76_133_69,r_72_117_17,0.61,68,85,17,91
51,seq2,seq138,r_21_114_15,r_21_114_15,0.58,74,89,15,91
92,seq113,r_122_86_105,r_128_7_142,r_122_86_105,0.86,-76,29,105,91
21,r_63_9_84,r_60_80_194,r_72_117_17,r_72_117_17,1.0,0,17,17,91
8,r_18_59_73,r_97_78_121,r_128_7_142,r_18_59_73,1.0,0,73,73,91
11,r_56_93_192,r_4_73_197,r_58_42_21,r_58_42_21,1.0,8,29,21,91
43,r_112_67_53,seq26,r_122_86_105,r_122_86_105,1.0,19,124,105,91
14,r_11_103_59,r_92_71_156,seq138,r_11_103_59,1.0,0,59,59,91
86,seq96,seq123,r_22_108_97,r_22_108_97,1.0,18,115,97,91
16,r_97_78_121,r_20_48_160,seq51,r_97_78_121,0.88,2,123,121,91
1,r_20_48_160,r_97_78_121,r_38_31_189,r_97_78_121,0.82,2,123,121,91
42,r_22_108_97,seq142,seq96,r_22_108_97,0.94,8,105,97,91
80,seq83,seq26,r_64_105_40,r_64_105_40,1.0,102,142,40,91
44,r_72_117_17,r_144_32_199,r_63_9_84,r_72_117_17,0.71,1,18,17,91
19,r_47_130_187,seq70,r_116_49_1,r_47_130_187,0.35,1,188,187,91
45,r_92_71_156,r_11_103_59,r_98_125_26,r_92_71_156,1.0,-127,29,156,91
61,seq148,r_47_130_187,r_89_17_46,r_89_17_46,1.0,-1,45,46,91
41,r_8_94_90,r_144_32_199,r_53_3_72,r_53_3_72,0.98,7,79,72,91
37,r_38_31_189,seq140,r_54_69_18,r_54_69_18,0.98,30,48,18,91
17,r_64_105_40,r_144_32_199,r_112_67_53,r_64_105_40,0.99,0,40,40,91
10,r_10_106_85,seq107,r_21_114_15,r_10_106_85,0.81,6,91,85,91
40,r_54_69_18,r_38_31_189,r_110_40_58,r_110_40_58,1.0,8,66,58,91
4,r_60_80_194,r_79_132_122,r_112_67_53,r_79_132_122,1.0,-42,80,122,91
0,r_5_35_145,seq61,r_64_105_40,r_5_35_145,0.37,3,148,145,91
13,r_53_3_72,r_16_39_196,r_8_94_90,r_53_3_72,1.0,-2,70,72,91
15,r_43_25_114,seq44,seq34,r_43_25_114,0.86,0,114,114,91
1,r_20_48_160,r_38_31_189,r_30_146_79,r_20_48_160,0.87,1,161,160,91
6,r_79_132_122,r_60_80_194,r_16_39_196,r_60_80_194,0.73,-72,122,194,91
21,r_63_9_84,r_72_117_17,r_98_125_26,r_63_9_84,1.0,1,85,84,91
85,seq95,r_112_67_53,r_23_100_39,r_23_100_39,1.0,27,66,39,91
23,r_98_125_26,r_5_35_145,r_92_71_156,r_98_125_26,1.0,1,27,26,91
27,r_30_146_79,r_20_48_160,seq24,r_30_146_79,0.99,8,87,79,91
2,r_4_73_197,r_56_93_192,r_58_42_21,r_58_42_21,0.69,115,136,21,91
47,r_126_124_169,seq113,seq109,r_126_124_169,0.46,1,170,169,91
33,r_145_28_30,seq140,r_128_7_142,r_145_28_30,1.0,0,30,30,91
18,r_101_87_106,seq123,r_11_103_59,r_11_103_59,0.96,47,106,59,91
24,r_15_62_95,r_122_86_105,r_21_114_15,r_15_62_95,0.95,1,96,95,91
6,r_79_132_122,r_16_39_196,r_92_71_156,r_79_132_122,0.7,21,143,122,91
25,r_122_86_105,r_126_124_169,r_112_67_53,r_122_86_105,0.95,0,105,105,91
40,r_54_69_18,r_16_39_196,r_38_31_189,r_54_69_18,0.95,0,18,18,91
65,seq34,r_92_71_156,r_12_75_80,r_12_75_80,0.77,76,156,80,91
32,r_12_75_80,seq83,seq19,r_12_75_80,1.0,0,80,80,91
77,seq70,r_47_130_187,r_89_17_46,r_89_17_46,1.0,142,188,46,91
34,r_76_133_69,seq138,r_72_117_17,r_76_133_69,0.99,0,69,69,91
45,r_92_71_156,r_98_125_26,r_79_132_122,r_92_71_156,0.83,0,156,156,91
94,seq118,r_129_136_128,r_10_106_85,r_129_136_128,1.0,0,128,128,91
9,r_149_81_175,seq138,r_20_48_160,r_149_81_175,0.41,4,179,175,91
49,r_29_99_29,seq127,seq138,r_29_99_29,0.96,0,29,29,91
29,r_58_42_21,seq96,r_56_93_192,r_58_42_21,0.97,-1,20,21,91
37,r_38_31_189,r_54_69_18,r_76_133_69,r_76_133_69,0.79,121,190,69,91
55,seq138,r_149_81_175,r_29_99_29,r_29_99_29,1.0,0,29,29,91
28,r_110_40_58,seq14,r_54_69_18,r_110_40_58,1.0,-3,55,58,91
56,seq139,seq26,r_64_105_40,r_64_105_40,1.0,102,142,40,91
7,r_77_115_131,r_92_71_156,seq51,r_77_115_131,0.65,1,132,131,91
23,r_98_125_26,r_92_71_156,r_63_9_84,r_63_9_84,0.95,72,156,84,91
93,seq114,r_46_91_154,r_130_64_101,r_130_64_101,0.75,55,156,101,92
30,r_138_56_182,seq22,r_141_120_151,r_138_56_182,0.47,0,182,182,92
14,r_100_70_148,r_147_137_171,seq85,r_100_70_148,0.96,0,148,148,92
62,seq19,r_97_42_100,r_83_116_30,r_83_116_30,0.9,1,31,30,92
43,r_129_16_72,r_71_88_91,seq12,r_129_16_72,0.95,0,72,72,92
17,r_29_38_22,seq128,seq140,r_29_38_22,1.0,0,22,22,92
34,r_1_30_24,r_118_11_147,r_99_86_130,r_1_30_24,0.99,0,24,24,92
86,seq102,r_76_80_183,r_97_42_100,r_97_42_100,1.0,4,104,100,92
16,r_118_11_147,seq134,seq52,r_118_11_147,0.94,2,149,147,92
21,r_112_7_118,seq67,r_126_119_175,r_112_7_118,0.93,0,118,118,92
39,r_126_119_175,seq135,r_112_7_118,r_112_7_118,1.0,12,130,118,92
1,r_76_80_183,seq102,seq115,r_76_80_183,0.54,0,183,183,92
5,r_26_149_122,seq31,r_97_42_100,r_26_149_122,1.0,0,122,122,92
80,seq85,r_76_80_183,r_97_42_100,r_97_42_100,1.0,67,167,100,92
45,r_8_75_61,r_132_74_159,r_29_38_22,r_8_75_61,1.0,0,61,61,92
24,r_48_146_161,r_1_30_24,seq136,r_48_146_161,0.85,1,162,161,92
22,r_66_110_190,r_104_33_116,r_4_89_62,r_66_110_190,0.7,0,190,190,92
18,r_122_63_12,r_118_11_147,seq50,r_122_63_12,0.92,0,12,12,92
31,r_109_23_129,r_101_143_192,r_107_79_10,r_109_23_129,0.98,1,130,129,92
10,r_4_89_62,seq57,r_29_38_22,r_4_89_62,1.0,0,62,62,92
4,r_148_103_199,r_107_79_10,r_46_91_154,r_148_103_199,0.77,-37,162,199,92
48,r_21_45_28,r_97_42_100,seq17,r_21_45_28,0.99,0,28,28,92
20,r_20_92_105,seq127,r_126_119_175,r_20_92_105,0.99,1,106,105,92
36,r_9_90_36,r_107_79_10,seq5,r_9_90_36,1.0,0,36,36,92
13,r_97_42_100,seq19,seq102,r_97_42_100,1.0,0,100,100,92
4,r_148_103_199,r_138_56_182,r_107_79_10,r_107_79_10,0.35,105,115,10,92
12,r_99_86_130,r_1_30_24,r_112_7_118,r_1_30_24,1.0,106,130,24,92
6,r_72_49_96,seq84,seq10,r_72_49_96,1.0,0,96,96,92
26,r_147_137_171,r_53_51_87,r_6_44_29,r_147_137_171,0.99,-141,30,171,92
99,seq127,r_20_92_105,seq105,r_20_92_105,1.0,1,106,105,92
47,r_18_34_127,r_132_74_159,r_53_51_87,r_132_74_159,1.0,0,159,159,92
27,r_142_28_158,r_76_80_183,r_113_58_109,r_113_58_109,0.86,50,159,109,92
33,r_13_0_40,r_60_61_50,seq98,r_13_0_40,1.0,0,40,40,92
22,r_66_110_190,r_83_116_30,r_104_33_116,r_104_33_116,1.0,9,125,116,92
19,r_81_54_38,r_76_80_183,seq134,r_81_54_38,1.0,0,38,38,92
22,r_66_110_190,r_118_11_147,r_83_116_30,r_83_116_30,1.0,3,33,30,92
2,r_53_51_87,r_147_137_171,seq65,r_53_51_87,1.0,2,89,87,92
47,r_18_34_127,r_147_137_171,r_132_74_159,r_132_74_159,0.62,-31,128,159,92
74,seq59,seq40,r_141_120_151,r_141_120_151,0.96,28,179,151,92
24,r_48_146_161,seq67,r_1_30_24,r_1_30_24,1.0,72,96,24,92
34,r_1_30_24,r_99_86_130,r_43_69_3,r_99_86_130,1.0,0,130,130,92
46,r_83_116_30,r_107_79_10,seq19,r_83_116_30,1.0,1,31,30,92
64,seq25,r_32_121_196,r_6_44_29,r_6_44_29,1.0,137,166,29,92
20,r_20_92_105,r_126_119_175,r_112_7_118,r_126_119_175,0.93,1,176,175,92
32,r_71_88_91,r_141_120_151,r_9_90_36,r_71_88_91,1.0,1,92,91,92
38,r_132_74_159,r_41_68_187,r_6_44_29,r_132_74_159,0.89,0,159,159,92
39,r_126_119_175,r_112_7_118,r_1_30_24,r_126_119_175,1.0,1,176,175,92
4,r_148_103_199,r_24_15_103,r_138_56_182,r_148_103_199,0.37,-179,20,199,92
75,seq65,seq84,r_53_51_87,r_53_51_87,1.0,33,120,87,92
81,seq87,r_130_64_101,r_13_0_40,r_13_0_40,1.0,75,115,40,92
9,r_46_91_154,seq136,r_118_11_147,r_118_11_147,1.0,16,163,147,92
26,r_147_137_171,r_6_44_29,seq17,r_147_137_171,0.28,5,176,171,92
96,seq123,seq87,r_13_0_40,r_13_0_40,1.0,103,143,40,92
12,r_99_86_130,r_48_146_161,r_1_30_24,r_1_30_24,1.0,1,25,24,92
49,r_113_58_109,seq140,seq144,r_113_58_109,1.0,0,109,109,92
21,r_112_7_118,r_126_119_175,r_20_92_105,r_126_119_175,1.0,1,176,175,92
56,seq136,r_46_91_154,r_48_146_161,r_48_146_161,0.93,2,163,161,92
7,r_104_33_116,seq39,r_66_110_190,r_104_33_116,0.85,0,116,116,92
44,r_141_120_151,seq144,seq59,r_141_120_151,0.6,0,151,151,92
23,r_24_15_103,seq52,seq31,r_24_15_103,0.92,0,103,103,92
84,seq98,r_130_64_101,r_13_0_40,r_13_0_40,1.0,75,115,40,92
30,r_64_101_127,seq107,r_61_5_114,r_61_5_114,0.74,-34,80,114,93
36,r_57_22_126,r_36_50_77,r_132_99_131,r_36_50_77,0.75,10,87,77,93
30,r_64_101_127,r_61_5_114,seq7,r_64_101_127,0.41,0,127,127,93
36,r_57_22_126,r_132_99_131,seq45,r_57_22_126,0.74,4,130,126,93
14,r_8_113_172,r_88_72_187,r_55_27_153,r_8_113_172,0.51,2,174,172,93
8,r_81_38_159,r_0_93_174,seq51,r_0_93_174,0.7,-46,128,174,93
41,r_56_141_65,r_95_115_16,r_127_149_169,r_127_149_169,1.0,0,169,169,93
9,r_48_122_34,r_88_72_187,r_106_58_1,r_48_122_34,1.0,0,34,34,93
54,seq7,r_20_147_173,r_64_101_127,r_64_101_127,0.66,49,176,127,93
37,r_131_142_132,seq90,seq4,r_131_142_132,0.94,3,135,132,93
4,r_116_77_13,seq144,r_94_137_134,r_94_137_134,0.78,4,138,134,93
55,seq10,seq40,r_1_125_99,r_1_125_99,0.96,6,105,99,93
16,r_60_102_108,r_0_93_174,r_1_125_99,r_60_102_108,1.0,1,109,108,93
21,r_61_5_114,r_94_137_134,r_34_18_116,r_61_5_114,0.9,3,117,114,93
39,r_88_72_187,seq11,r_95_115_16,r_88_72_187,0.28,1,188,187,93
97,seq117,r_44_105_115,seq139,r_44_105_115,1.0,1,116,115,93
5,r_75_110_103,r_52_86_68,r_100_16_51,r_75_110_103,0.91,-34,69,103,93
46,r_55_27_153,seq76,r_31_112_5,r_55_27_153,0.94,0,153,153,93
42,r_36_50_77,r_57_22_126,seq30,r_36_50_77,0.99,2,79,77,93
45,r_132_99_131,r_94_137_134,r_44_105_115,r_44_105_115,0.8,18,133,115,93
24,r_69_126_112,r_116_77_13,r_12_87_111,r_12_87_111,0.48,1,112,111,93
19,r_1_125_99,seq80,seq10,r_1_125_99,1.0,2,101,99,93
33,r_29_92_44,r_131_142_132,r_129_130_54,r_131_142_132,0.91,-27,105,132,93
1,r_95_115_16,r_1_125_99,r_61_5_114,r_95_115_16,0.56,3,19,16,93
4,r_116_77_13,r_31_112_5,r_69_126_112,r_116_77_13,0.43,2,15,13,93
28,r_135_6_43,seq15,seq76,r_135_6_43,1.0,1,44,43,93
31,r_123_9_80,r_67_111_122,r_48_122_34,r_123_9_80,0.9,0,80,80,93
41,r_56_141_65,r_62_32_156,r_94_137_134,r_56_141_65,1.0,0,65,65,93
3,r_140_120_60,r_62_32_156,seq80,r_140_120_60,1.0,1,61,60,93
26,r_62_32_156,r_140_120_60,seq76,r_140_120_60,1.0,1,61,60,93
32,r_106_58_1,r_12_87_111,r_48_122_34,r_106_58_1,0.99,39,40,1,93
11,r_52_86_68,r_75_110_103,seq128,r_52_86_68,0.85,1,69,68,93
7,r_127_149_169,r_28_43_23,r_56_141_65,r_127_149_169,1.0,0,169,169,93
20,r_41_124_150,seq144,seq84,r_41_124_150,0.55,0,150,150,93
13,r_94_137_134,r_19_85_61,r_56_141_65,r_56_141_65,0.83,0,65,65,93
4,r_116_77_13,r_69_126_112,seq144,r_69_126_112,0.69,0,112,112,93
13,r_94_137_134,r_56_141_65,r_116_77_13,r_56_141_65,0.9,70,135,65,93
6,r_67_111_122,r_127_149_169,seq128,r_67_111_122,0.96,0,122,122,93
85,seq80,r_1_125_99,r_140_120_60,r_140_120_60,0.92,5,65,60,93
22,r_21_26_181,r_44_105_115,r_75_110_103,r_21_26_181,0.97,0,181,181,93
33,r_29_92_44,r_44_105_115,r_131_142_132,r_29_92_44,0.94,2,46,44,93
27,r_63_114_104,seq45,r_140_120_60,r_140_120_60,0.71,49,109,60,93
49,r_129_130_54,r_12_87_111,r_29_92_44,r_129_130_54,1.0,0,54,54,93
2,r_31_112_5,seq97,r_55_27_153,r_55_27_153,0.97,4,157,153,93
41,r_56_141_65,r_94_137_134,r_95_115_16,r_56_141_65,0.77,70,135,65,93
47,r_34_18_116,seq82,r_61_5_114,r_34_18_116,0.85,0,116,116,93
15,r_118_24_38,seq10,seq53,r_118_24_38,0.9,-5,33,38,93
18,r_2_65_151,r_21_26_181,seq11,r_2_65_151,0.43,0,151,151,93
29,r_138_73_146,seq128,r_116_77_13,r_138_73_146,0.83,0,146,146,93
10,r_136_66_49,r_44_105_115,seq89,r_136_66_49,1.0,0,49,49,93
35,r_28_43_23,r_127_149_169,r_136_66_49,r_28_43_23,0.69,124,147,23,93
25,r_44_105_115,seq117,seq47,r_44_105_115,0.79,1,116,115,93
35,r_28_43_23,r_118_24_38,r_127_149_169,r_28_43_23,0.99,0,23,23,93
38,r_133_33_79,seq30,seq78,r_133_33_79,1.0,0,79,79,93
52,seq4,seq46,r_131_142_132,r_131_142_132,0.75,3,135,132,93
34,r_103_83_135,seq78,seq42,r_103_83_135,0.95,3,138,135,93
81,seq74,seq40,r_1_125_99,r_1_125_99,0.74,-4,95,99,93
5,r_75_110_103,r_100_16_51,seq76,r_75_110_103,1.0,2,105,103,93
17,r_19_85_61,r_94_137_134,seq47,r_19_85_61,0.98,0,61,61,93
26,r_62_32_156,seq76,r_131_142_132,r_62_32_156,0.99,0,156,156,93
96,seq109,r_145_108_166,r_118_24_38,r_118_24_38,0.99,131,169,38,93
22,r_21_26_181,r_2_65_151,r_44_105_115,r_21_26_181,0.89,-30,151,181,93
40,r_100_16_51,r_19_85_61,seq78,r_100_16_51,0.99,8,59,51,93
24,r_69_126_112,r_95_115_16,r_116_77_13,r_69_126_112,0.4,-97,15,112,93
1,r_95_115_16,r_61_5_114,r_56_141_65,r_56_141_65,0.97,-1,64,65,93
7,r_127_149_169,r_67_111_122,r_28_43_23,r_127_149_169,0.75,-47,122,169,93
44,r_145_108_166,seq109,r_19_85_61,r_19_85_61,0.89,108,169,61,93
23,r_12_87_111,seq89,r_69_126_112,r_12_87_111,0.99,1,112,111,93
12,r_0_93_174,seq30,r_62_32_156,r_0_93_174,0.27,0,174,174,93
93,seq103,r_80_64_111,seq141,r_80_64_111,0.64,-47,64,111,94
30,r_80_64_111,seq103,r_109_2_54,r_109_2_54,1.0,61,115,54,94
8,r_90_88_178,r_124_34_153,r_48_6_132,r_90_88_178,0.46,1,179,178,94
43,r_71_27_191,r_117_129_102,seq14,r_117_129_102,1.0,0,102,102,94
36,r_125_100_28,seq83,seq18,r_125_100_28,0.77,11,39,28,94
83,seq141,r_48_6_132,seq103,r_48_6_132,0.93,2,134,132,94
37,r_131_146_161,seq140,r_134_1_174,r_131_146_161,0.38,10,171,161,94
3,r_109_2_54,seq8,r_23_139_155,r_23_139_155,0.92,-3,152,155,94
2,r_119_66_58,r_38_35_195,seq17,r_119_66_58,1.0,0,58,58,94
49,r_107_39_55,r_15_41_121,seq72,r_107_39_55,0.92,0,55,55,94
26,r_69_85_51,r_135_115_189,seq83,r_69_85_51,0.99,1,52,51,94
16,r_135_115_189,seq95,r_108_113_5,r_135_115_189,0.39,0,189,189,94
42,r_23_139_155,r_37_70_193,r_109_2_54,r_109_2_54,1.0,104,158,54,94
84,seq83,seq12,r_69_85_51,r_69_85_51,1.0,1,52,51,94
69,seq30,r_43_143_180,r_80_64_111,r_80_64_111,0.94,69,180,111,94
19,r_49_62_119,r_124_34_153,seq58,r_49_62_119,0.97,8,127,119,94
4,r_61_133_91,r_73_56_31,seq127,r_61_133_91,0.78,3,94,91,94
12,r_73_56_31,seq97,r_61_133_91,r_73_56_31,0.96,0,31,31,94
31,r_117_129_102,r_71_27_191,r_124_34_153,r_117_129_102,0.9,0,102,102,94
41,r_4_126_122,seq140,r_73_56_31,r_73_56_31,0.96,98,129,31,94
10,r_147_68_107,r_15_41_121,seq46,r_147_68_107,0.44,-39,68,107,94
72,seq52,r_15_41_121,r_110_57_159,r_110_57_159,0.36,-119,40,159,94
9,r_118_75_39,r_15_41_121,seq74,r_118_75_39,0.55,0,39,39,94
72,seq52,seq3,r_118_75_39,r_118_75_39,0.77,116,155,39,94
11,r_11_22_120,r_76_77_148,r_108_113_5,r_11_22_120,0.8,0,120,120,94
39,r_93_148_14,r_105_96_81,seq84,r_93_148_14,0.9,0,14,14,94
20,r_105_96_81,seq67,seq25,r_105_96_81,0.74,0,81,81,94
13,r_50_81_62,r_11_22_120,r_92_32_150,r_50_81_62,0.91,0,62,62,94
15,r_76_77_148,seq121,seq116,r_76_77_148,0.61,0,148,148,94
48,r_138_45_146,r_37_70_193,seq121,r_37_70_193,0.7,-43,150,193,94
12,r_73_56_31,r_61_133_91,seq25,r_61_133_91,0.72,3,94,91,94
13,r_50_81_62,r_92_32_150,r_36_79_80,r_50_81_62,0.91,65,127,62,94
23,r_89_47_45,r_90_88_178,r_114_44_42,r_90_88_178,0.98,-133,45,178,94
47,r_134_1_174,r_43_143_180,r_131_146_161,r_43_143_180,0.58,-6,174,180,94
40,r_124_34_153,r_90_88_178,r_119_66_58,r_119_66_58,1.0,121,179,58,94
29,r_43_143_180,seq30,r_31_42_73,r_31_42_73,0.92,107,180,73,94
24,r_60_33_129,seq84,seq17,r_60_33_129,0.7,0,129,129,94
33,r_112_98_86,r_82_53_197,seq91,r_112_98_86,0.73,1,87,86,94
5,r_87_40_22,r_118_75_39,r_125_100_28,r_87_40_22,0.96,1,23,22,94
3,r_109_2_54,seq130,seq8,r_109_2_54,0.98,0,54,54,94
25,r_114_44_42,r_69_85_51,r_125_100_28,r_125_100_28,1.0,14,42,28,94
32,r_102_63_44,r_37_70_193,seq140,r_102_63_44,0.75,0,44,44,94
60,seq17,r_90_88_178,r_119_66_58,r_119_66_58,1.0,46,104,58,94
17,r_24_123_90,seq0,seq121,r_24_123_90,0.82,0,90,90,94
21,r_136_120_33,r_125_100_28,seq72,r_136_120_33,1.0,1,34,33,94
28,r_31_42_73,r_49_62_119,r_43_143_180,r_49_62_119,0.34,62,181,119,94
28,r_31_42_73,r_15_41_121,r_49_62_119,r_31_42_73,0.92,0,73,73,94
4,r_61_133_91,seq25,r_73_56_31,r_73_56_31,1.0,4,35,31,94
7,r_48_6_132,seq141,seq116,r_48_6_132,0.87,2,134,132,94
44,r_36_79_80,r_38_35_195,seq78,r_36_79_80,0.94,0,80,80,94
82,seq78,r_15_41_121,r_36_79_80,r_36_79_80,1.0,0,80,80,94
30,r_79_113_68,r_139_43_100,seq101,r_79_113_68,0.91,0,68,68,95
95,seq118,r_58_80_44,r_141_123_57,r_58_80_44,0.78,-3,41,44,95
8,r_40_61_93,r_77_104_130,r_147_96_26,r_40_61_93,0.75,0,93,93,95
98,seq125,r_30_49_71,seq66,r_30_49_71,1.0,-14,57,71,95
83,seq140,r_5_92_188,r_81_50_82,r_81_50_82,0.98,16,98,82,95
37,r_20_132_60,r_71_67_186,r_141_123_57,r_20_132_60,1.0,4,64,60,95
71,seq41,r_108_145_136,seq66,r_108_145_136,1.0,-9,127,136,95
21,r_111_15_107,r_120_51_75,r_90_62_52,r_111_15_107,0.89,0,107,107,95
39,r_30_49_71,seq125,seq27,r_30_49_71,0.69,-2,69,71,95
1,r_81_50_82,seq4,seq140,r_81_50_82,0.86,1,83,82,95
5,r_44_130_133,r_74_42_139,seq128,r_44_130_133,0.64,0,133,133,95
19,r_103_110_78,seq11,seq146,r_103_110_78,0.92,1,79,78,95
31,r_108_145_136,seq41,r_117_35_94,r_108_145_136,0.97,0,136,136,95
3,r_117_35_94,seq60,seq112,r_117_35_94,0.87,3,97,94,95
10,r_55_134_163,seq140,r_117_35_94,r_117_35_94,0.53,71,165,94,95
26,r_131_84_147,seq93,seq11,r_131_84_147,0.97,0,147,147,95
65,seq148,r_71_67_186,r_64_94_25,r_64_94_25,1.0,1,26,25,95
4,r_100_65_180,seq3,r_117_35_94,r_100_65_180,0.44,0,180,180,95
0,r_74_42_139,seq12,r_64_94_25,r_74_42_139,0.88,0,139,139,95
48,r_147_96_26,seq75,seq1,r_147_96_26,1.0,0,26,26,95
17,r_82_115_45,r_87_124_127,seq66,r_82_115_45,0.99,3,48,45,95
20,r_6_102_134,seq72,seq21,r_6_102_134,0.46,11,145,134,95
13,r_141_123_57,r_30_49_71,seq118,r_30_49_71,1.0,1,72,71,95
11,r_73_25_59,seq118,r_9_126_34,r_73_25_59,0.52,-8,51,59,95
66,seq21,seq101,r_14_22_36,r_14_22_36,0.95,0,36,36,95
6,r_149_10_187,seq19,r_119_45_72,r_119_45_72,1.0,115,187,72,95
62,seq17,r_32_23_111,seq105,r_32_23_111,1.0,2,113,111,95
23,r_58_80_44,seq118,seq106,r_58_80_44,0.92,1,45,44,95
64,seq19,r_149_10_187,r_88_2_40,r_88_2_40,1.0,-7,33,40,95
27,r_135_144_196,r_71_67_186,r_9_126_34,r_71_67_186,0.46,1,187,186,95
25,r_90_62_52,r_117_35_94,seq12,r_90_62_52,1.0,-1,51,52,95
2,r_119_45_72,r_77_104_130,seq16,r_119_45_72,1.0,-2,70,72,95
40,r_97_54_143,seq4,seq106,r_97_54_143,0.64,7,150,143,95
18,r_77_104_130,r_119_45_72,seq112,r_119_45_72,1.0,-7,65,72,95
29,r_32_23_111,seq17,seq118,r_32_23_111,0.5,2,113,111,95
24,r_9_126_34,seq3,seq136,r_9_126_34,0.8,-5,29,34,95
48,r_147_96_26,seq1,r_40_61_93,r_40_61_93,1.0,18,111,93,95
15,r_64_94_25,r_32_23_111,seq148,r_64_94_25,1.0,0,25,25,95
59,seq12,r_74_42_139,r_90_62_52,r_90_62_52,0.97,-1,51,52,95
32,r_0_107_85,r_53_52_137,r_88_2_40,r_0_107_85,0.66,3,88,85,95
47,r_14_22_36,r_149_10_187,seq21,r_14_22_36,0.65,-3,33,36,95
74,seq136,seq70,r_9_126_34,r_9_126_34,0.96,-5,29,34,95
34,r_53_52_137,r_6_102_134,r_9_126_34,r_6_102_134,0.48,9,143,134,95
9,r_33_13_142,seq48,seq75,r_33_13_142,0.72,1,143,142,95
91,seq101,seq3,r_79_113_68,r_79_113_68,1.0,15,83,68,95
51,seq1,r_131_84_147,r_147_96_26,r_147_96_26,0.79,3,29,26,95
49,r_83_143_141,seq93,r_33_13_142,r_83_143_141,0.97,1,142,141,95
43,r_98_116_33,seq75,seq4,r_98_116_33,0.99,0,33,33,95
18,r_77_104_130,seq112,r_98_116_33,r_77_104_130,1.0,1,131,130,95
79,seq68,r_109_99_197,r_147_96_26,r_147_96_26,0.94,14,40,26,95
38,r_88_2_40,r_74_42_139,seq19,r_88_2_40,1.0,-7,33,40,95
82,seq72,r_6_102_134,seq70,r_6_102_134,0.57,39,173,134,95
35,r_87_124_127,seq19,r_90_62_52,r_90_62_52,0.61,75,127,52,95
12,r_71_67_186,r_135_144_196,seq68,r_71_67_186,0.64,0,186,186,95
93,seq100,r_15_30_148,r_62_67_131,r_62_67_131,0.53,17,148,131,96
40,r_121_42_125,r_70_7_194,r_134_129_14,r_121_42_125,1.0,0,125,125,96
30,r_103_0_151,seq64,seq145,r_103_0_151,0.96,0,151,151,96
31,r_97_112_4,r_15_30_148,seq86,r_97_112_4,0.43,35,39,4,96
36,r_81_114_95,seq9,r_17_122_104,r_81_114_95,0.94,6,101,95,96
38,r_65_10_58,r_4_109_79,r_125_123_74,r_65_10_58,0.7,26,84,58,96
7,r_140_44_30,r_95_88_142,seq22,r_140_44_30,1.0,1,31,30,96
43,r_132_55_120,seq13,r_43_128_162,r_132_55_120,0.91,0,120,120,96
83,seq64,r_103_0_151,seq120,r_103_0_151,1.0,0,151,151,96
37,r_105_58_153,r_76_61_6,seq25,r_105_58_153,0.81,0,153,153,96
59,seq13,r_132_55_120,seq37,r_132_55_120,1.0,-12,108,120,96
71,seq27,r_95_88_142,seq28,r_95_88_142,1.0,0,142,142,96
16,r_116_73_159,r_48_149_180,r_127_148_9,r_116_73_159,0.91,0,159,159,96
21,r_41_141_135,seq35,r_118_99_116,r_41_141_135,0.8,0,135,135,96
17,r_4_109_79,r_43_128_162,r_6_40_145,r_43_128_162,0.91,-8,154,162,96
5,r_74_146_92,seq130,r_97_112_4,r_74_146_92,1.0,0,92,92,96
42,r_48_149_180,r_116_73_159,r_5_54_13,r_48_149_180,0.79,-21,159,180,96
43,r_132_55_120,r_43_128_162,r_38_85_152,r_132_55_120,0.99,42,162,120,96
45,r_124_20_128,seq18,r_127_148_9,r_127_148_9,0.77,124,133,9,96
40,r_121_42_125,r_139_143_78,r_70_7_194,r_139_143_78,0.81,-54,24,78,96
19,r_62_67_131,seq91,seq100,r_62_67_131,0.97,0,131,131,96
12,r_93_33_34,seq13,seq39,r_93_33_34,0.8,-3,31,34,96
17,r_4_109_79,r_65_10_58,r_77_106_105,r_4_109_79,0.63,9,88,79,96
22,r_134_129_14,r_93_33_34,r_95_88_142,r_95_88_142,1.0,0,142,142,96
3,r_15_30_148,seq100,seq26,r_15_30_148,0.74,0,148,148,96
10,r_101_45_107,r_38_85_152,seq51,r_101_45_107,0.81,1,108,107,96
4,r_43_128_162,r_132_55_120,r_34_126_93,r_43_128_162,1.0,0,162,162,96
8,r_2_32_55,r_3_94_149,seq104,r_2_32_55,1.0,0,55,55,96
26,r_47_84_110,seq91,seq130,r_47_84_110,0.64,-23,87,110,96
4,r_43_128_162,r_15_30_148,r_132_55_120,r_132_55_120,0.99,9,129,120,96
63,seq18,r_124_20_128,r_113_79_76,r_113_79_76,0.89,57,133,76,96
29,r_136_83_56,r_139_143_78,r_31_110_85,r_139_143_78,0.98,-19,59,78,96
15,r_111_53_73,seq37,seq46,r_111_53_73,0.8,-2,71,73,96
48,r_17_122_104,seq100,r_81_114_95,r_81_114_95,0.61,-34,61,95,96
62,seq145,seq1,r_103_0_151,r_103_0_151,0.65,1,152,151,96
76,seq39,seq144,r_93_33_34,r_93_33_34,0.94,-4,30,34,96
27,r_139_143_78,r_121_42_125,seq46,r_139_143_78,1.0,0,78,78,96
42,r_48_149_180,r_5_54_13,r_87_90_65,r_48_149_180,0.97,0,180,180,96
18,r_125_123_74,r_38_85_152,r_65_10_58,r_38_85_152,1.0,-78,74,152,96
24,r_70_7_194,r_95_88_142,seq28,r_95_88_142,1.0,-16,126,142,96
47,r_68_69_11,r_6_40_145,r_5_54_13,r_6_40_145,0.79,-134,11,145,96
25,r_77_106_105,r_14_92_122,seq119,r_77_106_105,0.94,3,108,105,96
33,r_118_99_116,seq130,r_41_141_135,r_41_141_135,1.0,2,137,135,96
46,r_78_96_32,r_52_71_8,seq50,r_78_96_32,1.0,0,32,32,96
32,r_14_92_122,seq50,seq137,r_14_92_122,1.0,0,122,122,96
31,r_97_112_4,seq86,r_74_146_92,r_74_146_92,0.79,1,93,92,96
77,seq46,seq145,r_111_53_73,r_111_53_73,0.81,-2,71,73,96
2,r_5_54_13,r_81_114_95,seq36,r_81_114_95,0.92,-83,12,95,96
34,r_87_90_65,seq137,seq60,r_87_90_65,0.98,0,65,65,96
17,r_4_109_79,r_77_106_105,r_43_128_162,r_4_109_79,0.64,31,110,79,96
17,r_4_109_79,r_124_20_128,r_65_10_58,r_65_10_58,0.98,2,60,58,96
9,r_113_79_76,r_34_126_93,seq18,r_34_126_93,1.0,-17,76,93,96
22,r_134_129_14,seq25,r_93_33_34,r_93_33_34,0.43,58,92,34,96
28,r_3_94_149,seq26,seq100,r_3_94_149,0.77,0,149,149,96
49,r_95_88_142,seq27,r_134_129_14,r_95_88_142,0.94,0,142,142,96
44,r_34_126_93,seq50,seq12,r_34_126_93,1.0,0,93,93,96
23,r_6_40_145,r_103_0_151,r_4_109_79,r_103_0_151,0.86,-1,150,151,96
82,seq60,seq24,r_87_90_65,r_87_90_65,1.0,0,65,65,96
38,r_65_10_58,seq89,r_4_109_79,r_65_10_58,0.97,0,58,58,96
93,seq110,seq59,r_16_75_78,r_16_75_78,1.0,37,115,78,97
30,r_101_48_150,seq24,r_16_75_78,r_16_75_78,1.0,72,150,78,97
44,r_114_123_32,r_14_62_181,r_88_5_147,r_114_123_32,0.49,150,182,32,97
51,seq3,r_97_94_157,r_12_124_132,r_12_124_132,0.63,25,157,132,97
36,r_45_83_125,seq102,r_16_75_78,r_45_83_125,0.73,0,125,125,97
2,r_132_106_27,seq59,seq77,r_132_106_27,0.97,0,27,27,97
92,seq105,r_14_62_181,r_43_10_105,r_43_10_105,0.97,4,109,105,97
83,seq77,r_130_31_182,r_132_106_27,r_132_106_27,0.99,159,186,27,97
37,r_4_141_189,seq129,r_50_22_80,r_50_22_80,1.0,109,189,80,97
16,r_19_93_83,r_122_118_133,seq82,r_19_93_83,1.0,1,84,83,97
21,r_137_39_69,seq136,r_42_91_20,r_137_39_69,0.57,0,69,69,97
1,r_66_84_136,r_80_117_36,seq69,r_66_84_136,0.88,0,136,136,97
97,seq121,seq144,r_20_18_76,r_20_18_76,1.0,36,112,76,97
5,r_50_22_80,r_42_91_20,r_78_53_172,r_50_22_80,0.94,0,80,80,97
46,r_13_56_167,seq81,seq23,r_13_56_167,0.57,0,167,167,97
42,r_143_49_137,seq149,seq24,r_143_49_137,0.98,0,137,137,97
63,seq25,r_97_94_157,r_76_47_195,r_97_94_157,0.88,-29,128,157,97
45,r_109_95_148,seq33,r_128_71_21,r_109_95_148,0.84,2,150,148,97
19,r_145_11_89,seq144,r_19_93_83,r_145_11_89,1.0,1,90,89,97
33,r_115_111_190,r_100_2_46,r_137_39_69,r_115_111_190,0.86,0,190,190,97
31,r_88_5_147,seq125,seq142,r_88_5_147,0.74,0,147,147,97
41,r_60_138_122,r_126_30_176,seq33,r_60_138_122,0.95,0,122,122,97
5,r_50_22_80,r_78_53_172,r_122_118_133,r_50_22_80,0.96,59,139,80,97
3,r_131_72_124,seq6,seq7,r_131_72_124,0.96,0,124,124,97
24,r_128_71_21,r_14_62_181,seq127,r_128_71_21,1.0,0,21,21,97
26,r_130_31_182,seq77,r_61_96_47,r_61_96_47,1.0,139,186,47,97
72,seq135,r_76_47_195,seq86,r_76_47_195,0.49,-71,124,195,97
4,r_92_99_68,seq82,seq127,r_92_99_68,1.0,1,69,68,97
78,seq64,r_107_9_163,r_113_28_30,r_113_28_30,1.0,43,73,30,97
11,r_27_70_179,seq116,r_88_5_147,r_88_5_147,0.59,38,185,147,97
20,r_55_35_94,seq82,r_76_47_195,r_55_35_94,0.77,4,98,94,97
13,r_126_30_176,r_60_138_122,seq64,r_60_138_122,1.0,-1,121,122,97
14,r_40_57_18,r_61_96_47,r_90_148_5,r_40_57_18,0.81,0,18,18,97
49,r_42_91_20,r_50_22_80,r_137_39_69,r_50_22_80,0.98,0,80,80,97
6,r_98_58_154,seq69,r_38_54_62,r_38_54_62,0.79,94,156,62,97
62,seq24,r_101_48_150,r_143_49_137,r_143_49_137,0.98,11,148,137,97
99,seq127,seq23,r_92_99_68,r_92_99_68,1.0,24,92,68,97
0,r_14_62_181,r_114_123_32,r_107_9_163,r_114_123_32,0.56,150,182,32,97
8,r_74_37_34,r_97_94_157,seq32,r_74_37_34,0.99,1,35,34,97
47,r_140_112_95,seq142,r_137_39_69,r_140_112_95,0.97,-5,90,95,97
40,r_133_17_82,r_36_104_170,r_21_0_199,r_133_17_82,0.55,0,82,82,97
18,r_16_75_78,r_19_93_83,seq110,r_16_75_78,1.0,0,78,78,97
25,r_36_104_170,r_133_17_82,r_80_117_36,r_133_17_82,0.7,4,86,82,97
43,r_100_2_46,r_115_111_190,r_74_37_34,r_100_2_46,0.75,144,190,46,97
49,r_42_91_20,r_4_141_189,r_50_22_80,r_50_22_80,0.82,-70,10,80,97
33,r_115_111_190,r_67_44_119,r_100_2_46,r_115_111_190,1.0,-71,119,190,97
44,r_114_123_32,r_76_47_195,r_14_62_181,r_114_123_32,0.84,1,33,32,97
34,r_146_8_14,r_38_54_62,seq6,r_38_54_62,0.67,-48,14,62,97
39,r_113_28_30,seq134,seq64,r_113_28_30,1.0,0,30,30,97
32,r_20_18_76,seq32,seq144,r_20_18_76,0.96,1,77,76,97
38,r_12_124_132,r_108_79_29,seq3,r_12_124_132,1.0,0,132,132,97
22,r_61_96_47,r_109_95_148,seq85,r_61_96_47,1.0,1,48,47,97
60,seq149,r_143_49_137,seq139,r_143_49_137,1.0,0,137,137,97
81,seq69,r_98_58_154,r_66_84_136,r_66_84_136,0.62,20,156,136,97
17,r_122_118_133,r_108_79_29,r_50_22_80,r_108_79_29,0.95,104,133,29,97
94,seq116,r_27_70_179,r_107_9_163,r_27_70_179,0.5,1,180,179,97
9,r_43_10_105,r_66_84_136,r_114_123_32,r_43_10_105,0.95,0,105,105,97
28,r_67_44_119,r_115_111_190,r_132_106_27,r_67_44_119,0.49,0,119,119,97
43,r_100_2_46,r_130_31_182,r_115_111_190,r_100_2_46,1.0,0,46,46,97
7,r_38_54_62,r_130_31_182,seq15,r_38_54_62,1.0,0,62,62,97
0,r_14_62_181,r_140_112_95,r_114_123_32,r_14_62_181,0.93,-145,36,181,97
84,seq81,r_13_56_167,seq33,r_13_56_167,0.76,-7,160,167,97
40,r_87_33_177,r_32_34_23,seq81,r_87_33_177,0.6,1,178,177,98
30,r_2_42_131,r_41_147_112,r_135_128_105,r_135_128_105,0.84,10,115,105,98
92,seq113,r_43_103_109,seq122,r_43_103_109,1.0,1,110,109,98
30,r_2_42_131,r_135_128_105,seq94,r_2_42_131,0.56,4,135,131,98
8,r_83_19_133,r_67_97_155,r_126_102_108,r_126_102_108,0.81,25,133,108,98
23,r_32_34_23,r_135_128_105,r_87_33_177,r_32_34_23,0.55,0,23,23,98
16,r_43_103_109,seq113,seq127,r_43_103_109,0.96,1,110,109,98
45,r_71_107_122,r_89_37_163,r_50_72_37,r_71_107_122,0.97,1,123,122,98
19,r_21_13_65,r_41_147_112,r_108_106_33,r_21_13_65,0.7,2,67,65,98
76,seq69,r_100_78_123,seq64,r_100_78_123,0.99,0,123,123,98
11,r_108_106_33,r_126_102_108,seq144,r_108_106_33,1.0,4,37,33,98
31,r_14_136_140,r_138_148_106,r_45_31_7,r_14_136_140,0.88,-29,111,140,98
24,r_135_128_105,r_2_42_131,r_60_74_142,r_135_128_105,0.78,33,138,105,98
41,r_11_146_186,r_131_44_73,r_76_7_171,r_11_146_186,0.36,0,186,186,98
47,r_73_56_68,r_14_136_140,r_100_78_123,r_100_78_123,0.98,1,124,123,98
3,r_60_74_142,seq139,r_135_128_105,r_60_74_142,0.97,0,142,142,98
10,r_101_46_115,seq9,r_143_24_118,r_101_46_115,0.93,0,115,115,98
0,r_111_120_174,seq105,r_89_37_163,r_89_37_163,0.8,12,175,163,98
32,r_6_130_38,r_110_99_96,seq139,r_6_130_38,0.99,1,39,38,98
20,r_131_44_73,r_11_146_186,r_86_39_24,r_86_39_24,0.95,49,73,24,98
13,r_75_114_130,seq20,seq132,r_75_114_130,0.99,0,130,130,98
15,r_143_24_118,seq15,r_21_13_65,r_143_24_118,0.91,1,119,118,98
6,r_76_7_171,seq77,r_108_106_33,r_108_106_33,0.69,139,172,33,98
33,r_50_72_37,r_111_120_174,seq90,r_50_72_37,0.98,0,37,37,98
85,seq94,r_133_53_170,r_2_42_131,r_2_42_131,0.89,6,137,131,98
12,r_141_66_25,r_101_46_115,seq95,r_141_66_25,0.92,1,26,25,98
36,r_65_1_198,r_80_17_20,r_27_40_47,r_27_40_47,0.36,132,179,47,98
27,r_126_102_108,seq20,r_47_49_57,r_47_49_57,0.96,51,108,57,98
2,r_138_148_106,r_14_136_140,r_61_55_41,r_61_55_41,0.91,65,106,41,98
47,r_73_56_68,seq16,r_14_136_140,r_73_56_68,0.96,1,69,68,98
4,r_27_40_47,seq64,r_57_118_26,r_27_40_47,0.94,0,47,47,98
18,r_35_26_182,r_134_25_9,seq29,r_35_26_182,0.4,-2,180,182,98
29,r_10_82_152,r_137_52_162,r_134_25_9,r_137_52_162,1.0,0,162,162,98
49,r_57_118_26,seq70,seq15,r_57_118_26,0.99,0,26,26,98
24,r_135_128_105,seq0,r_2_42_131,r_2_42_131,0.76,-16,115,131,98
35,r_45_31_7,r_87_33_177,r_14_136_140,r_45_31_7,0.57,68,75,7,98
25,r_137_52_162,r_10_82_152,seq63,r_137_52_162,0.9,0,162,162,98
1,r_86_39_24,seq91,r_131_44_73,r_86_39_24,1.0,0,24,24,98
36,r_65_1_198,r_18_79_196,r_80_17_20,r_65_1_198,0.49,-177,21,198,98
19,r_21_13_65,r_108_106_33,r_143_24_118,r_143_24_118,1.0,5,123,118,98
34,r_3_125_128,seq20,r_12_58_36,r_3_125_128,0.87,0,128,128,98
28,r_89_37_163,r_27_40_47,r_111_120_174,r_89_37_163,1.0,0,163,163,98
7,r_67_97_155,r_14_136_140,r_110_99_96,r_67_97_155,0.93,-1,154,155,98
43,r_117_5_35,seq9,r_119_30_1,r_117_5_35,1.0,0,35,35,98
5,r_61_55_41,seq22,seq145,r_61_55_41,1.0,0,41,41,98
86,seq95,seq129,r_141_66_25,r_141_66_25,1.0,7,32,25,98
9,r_133_53_170,seq94,r_60_74_142,r_133_53_170,0.27,0,170,170,98
37,r_47_49_57,r_4_85_56,r_126_102_108,r_126_102_108,0.82,3,111,108,98
22,r_8_104_120,seq38,seq70,r_8_104_120,1.0,0,120,120,98
28,r_89_37_163,r_71_107_122,r_27_40_47,r_89_37_163,0.83,-40,123,163,98
7,r_67_97_155,r_83_19_133,r_14_136_140,r_67_97_155,0.63,-22,133,155,98
44,r_134_25_9,r_35_26_182,r_10_82_152,r_35_26_182,0.58,1,183,182,98
40,r_87_33_177,r_12_58_36,r_32_34_23,r_87_33_177,1.0,-155,22,177,98
39,r_12_58_36,r_87_33_177,seq15,r_12_58_36,1.0,-3,33,36,98
23,r_32_34_23,r_87_33_177,r_101_46_115,r_32_34_23,0.65,155,178,23,98
40,r_84_22_165,r_89_11_48,r_149_99_70,r_84_22_165,0.35,-14,151,165,99
53,seq5,r_147_8_39,r_17_148_83,r_17_148_83,1.0,1,84,83,99
36,r_3_120_102,seq80,seq146,r_3_120_102,1.0,6,108,102,99
12,r_71_54_40,r_41_78_60,r_82_37_53,r_82_37_53,0.92,3,56,53,99
8,r_128_18_97,r_60_73_66,r_52_42_122,r_60_73_66,1.0,0,66,66,99
30,r_17_148_83,r_117_9_42,seq5,r_17_148_83,0.99,2,85,83,99
37,r_116_88_105,seq129,r_48_47_4,r_116_88_105,0.53,42,147,105,99
43,r_117_9_42,r_17_148_83,seq44,r_17_148_83,1.0,2,85,83,99
12,r_71_54_40,seq19,r_41_78_60,r_71_54_40,0.95,2,42,40,99
16,r_149_99_70,seq136,seq19,r_149_99_70,0.86,7,77,70,99
39,r_114_123_171,seq146,seq51,r_114_123_171,0.65,0,171,171,99
97,seq122,r_84_22_165,r_105_29_35,r_105_29_35,1.0,130,165,35,99
5,r_81_39_108,r_84_22_165,r_41_78_60,r_81_39_108,1.0,0,108,108,99
45,r_2_141_125,seq86,r_139_119_98,r_2_141_125,0.9,0,125,125,99
33,r_96_95_37,seq5,seq127,r_96_95_37,1.0,5,42,37,99
19,r_124_56_143,seq134,r_96_95_37,r_124_56_143,0.9,0,143,143,99
27,r_27_115_27,r_149_99_70,seq14,r_27_115_27,1.0,0,27,27,99
27,r_27_115_27,seq14,r_139_119_98,r_139_119_98,1.0,0,98,98,99
95,seq110,r_92_15_182,seq125,r_92_15_182,0.44,-2,180,182,99
17,r_147_8_39,seq16,seq5,r_147_8_39,1.0,0,39,39,99
31,r_92_15_182,seq110,r_106_104_120,r_92_15_182,0.38,0,182,182,99
41,r_7_28_61,seq93,seq83,r_7_28_61,1.0,0,61,61,99
3,r_140_109_80,r_108_143_128,r_121_97_194,r_140_109_80,1.0,1,81,80,99
73,seq51,seq83,r_114_123_171,r_114_123_171,0.57,1,172,171,99
33,r_96_95_37,seq86,r_40_4_119,r_40_4_119,0.54,-2,117,119,99
11,r_106_104_120,seq83,seq127,r_106_104_120,1.0,2,122,120,99
15,r_132_31_96,r_108_143_128,seq35,r_132_31_96,0.45,1,97,96,99
48,r_48_47_4,r_114_123_171,r_116_88_105,r_114_123_171,0.84,-31,140,171,99
4,r_89_11_48,r_84_22_165,seq122,r_84_22_165,0.83,-21,144,165,99
6,r_126_118_94,seq80,seq134,r_126_118_94,1.0,1,95,94,99
99,seq127,r_40_4_119,r_106_104_120,r_106_104_120,1.0,-1,119,120,99
33,r_96_95_37,seq127,seq86,r_96_95_37,0.4,54,91,37,99
43,r_117_9_42,seq138,r_17_148_83,r_117_9_42,0.97,0,42,42,99
4,r_89_11_48,r_114_123_171,r_84_22_165,r_89_11_48,1.0,2,50,48,99
25,r_10_57_34,r_81_39_108,seq80,r_10_57_34,1.0,0,34,34,99
49,r_12_53_54,r_128_18_97,r_59_87_33,r_12_53_54,0.61,0,54,54,99
74,seq55,r_114_123_171,r_32_45_151,r_114_123_171,0.61,-101,70,171,99
24,r_142_43_74,seq135,r_147_8_39,r_142_43_74,0.99,0,74,74,99
18,r_79_70_19,r_108_143_128,seq64,r_79_70_19,0.98,0,19,19,99
50,seq0,seq133,r_61_144_110,r_61_144_110,1.0,1,111,110,99
70,seq135,seq77,r_128_18_97,r_128_18_97,1.0,19,116,97,99
65,seq25,r_13_30_192,r_60_73_66,r_60_73_66,1.0,110,176,66,99
20,r_72_74_38,r_98_75_196,r_147_8_39,r_147_8_39,0.87,5,44,39,99
61,seq146,r_114_123_171,r_81_39_108,r_81_39_108,1.0,63,171,108,99
32,r_52_42_122,r_114_123_171,seq44,r_52_42_122,0.94,0,122,122,99
47,r_100_112_30,r_71_54_40,r_107_26_2,r_107_26_2,1.0,28,30,2,99
38,r_6_36_23,r_49_131_41,seq113,r_6_36_23,1.0,0,23,23,99
30,r_17_148_83,seq44,r_117_9_42,r_117_9_42,1.0,1,43,42,99
62,seq19,r_71_54_40,r_149_99_70,r_71_54_40,0.97,1,41,40,99
21,r_49_131_41,r_6_36_23,seq83,r_6_36_23,0.94,-2,21,23,99
9,r_76_33_11,r_71_54_40,seq77,r_76_33_11,0.89,-1,10,11,99
40,r_84_22_165,r_81_39_108,r_89_11_48,r_84_22_165,0.8,-106,59,165,99
44,r_61_144_110,r_40_4_119,seq0,r_61_144_110,0.98,0,110,110,99
0,r_105_29_35,seq93,seq38,r_105_29_35,1.0,1,36,35,99
23,r_40_4_119,seq127,r_96_95_37,r_96_95_37,1.0,82,119,37,99
35,r_139_119_98,seq16,r_117_9_42,r_139_119_98,0.99,0,98,98,99
