30,r_65_21_141,seq63,r_0_22_131,r_65_21_141,0.97,0,141,141,0
36,r_132_33_133,seq134,r_64_35_100,r_132_33_133,0.88,0,133,133,0
25,r_3_139_18,r_0_22_131,seq140,r_3_139_18,1,0,18,18,0
8,r_39_141_151,seq37,r_3_139_18,r_39_141_151,0.91,1,152,151,0
43,r_119_31_154,r_122_120_37,r_38_32_148,r_119_31_154,0.64,0,154,154,0
37,r_61_43_66,r_60_86_132,seq45,r_60_86_132,0.71,-55,77,132,0
52,seq4,r_2_100_88,seq11,r_2_100_88,1,-42,46,88,0
71,seq54,r_52_47_155,r_146_56_19,r_146_56_19,1,62,81,19,0
1,r_121_28_99,r_119_31_154,seq27,r_121_28_99,0.99,0,99,99,0
28,r_128_17_188,r_6_129_184,seq18,r_128_17_188,0.61,0,188,188,0
5,r_83_49_154,seq79,r_52_47_155,r_52_47_155,0.51,-1,154,155,0
29,r_36_126_52,r_38_32_148,r_67_136_84,r_36_126_52,0.43,-20,32,52,0
46,r_10_103_81,seq5,r_104_114_180,r_10_103_81,1,0,81,81,0
42,r_71_75_184,r_72_111_170,r_84_74_126,r_84_74_126,0.96,44,170,126,0
80,seq85,r_84_74_126,r_112_88_16,r_84_74_126,0.98,0,126,126,0
12,r_19_137_34,r_25_115_85,seq138,r_19_137_34,0.99,0,34,34,0
28,r_128_17_188,r_93_42_75,r_16_145_16,r_128_17_188,0.78,-160,28,188,0
32,r_77_149_37,seq130,seq148,r_77_149_37,0.5,67,104,37,0
59,seq140,seq148,r_3_139_18,r_3_139_18,1,5,23,18,0
19,r_29_57_49,r_61_43_66,r_77_149_37,r_61_43_66,0.59,-20,46,66,0
28,r_128_17_188,seq148,r_6_129_184,r_128_17_188,0.31,-10,178,188,0
29,r_36_126_52,r_67_136_84,seq127,r_36_126_52,0.85,0,52,52,0
31,r_135_101_116,seq138,seq102,r_135_101_116,0.97,0,116,116,0
89,seq102,seq94,r_135_101_116,r_135_101_116,1,8,124,116,0
40,r_16_145_16,r_142_59_73,r_3_139_18,r_142_59_73,0.99,0,73,73,0
3,r_38_32_148,r_39_141_151,r_62_30_72,r_39_141_151,0.95,-3,148,151,0
10,r_8_124_104,seq5,r_23_123_92,r_8_124_104,0.97,0,104,104,0
26,r_41_78_76,seq44,seq76,r_41_78_76,0.99,0,76,76,0
0,r_15_34_85,seq14,r_53_69_82,r_15_34_85,0.69,0,85,85,0
18,r_2_100_88,seq11,seq102,r_2_100_88,1,0,88,88,0
15,r_143_81_40,r_142_59_73,seq76,r_143_81_40,0.99,0,40,40,0
11,r_95_144_109,seq94,r_16_145_16,r_95_144_109,1,0,109,109,0
13,r_93_42_75,seq90,r_1_40_58,r_93_42_75,0.94,1,76,75,0
46,r_10_103_81,r_104_114_180,r_24_106_99,r_24_106_99,0.93,80,179,99,0
44,r_24_106_99,r_133_26_2,seq105,r_24_106_99,1,0,99,99,0
6,r_0_22_131,seq4,r_121_28_99,r_0_22_131,0.88,0,131,131,0
27,r_147_113_126,seq148,seq116,r_147_113_126,0.86,0,126,126,0
4,r_146_56_19,r_143_81_40,seq55,r_146_56_19,0.99,0,19,19,0
57,seq138,r_135_101_116,r_19_137_34,r_19_137_34,0.93,1,35,34,0
35,r_62_30_72,seq76,seq68,r_62_30_72,0.53,33,105,72,0
47,r_67_136_84,seq68,r_19_137_34,r_67_136_84,0.99,0,84,84,0
72,seq55,r_52_47_155,r_146_56_19,r_146_56_19,1,1,20,19,0
40,r_16_145_16,r_15_34_85,r_142_59_73,r_16_145_16,0.89,0,16,16,0
35,r_62_30_72,seq68,r_38_32_148,r_62_30_72,0.83,65,137,72,0
20,r_12_58_50,r_10_103_81,r_29_57_49,r_12_58_50,1,0,50,50,0
33,r_84_74_126,seq85,r_71_75_184,r_84_74_126,0.98,0,126,126,0
65,seq37,r_38_32_148,seq63,r_38_32_148,0.59,0,148,148,0
68,seq46,r_48_20_175,r_52_47_155,r_48_20_175,1,-10,165,175,0
22,r_60_86_132,r_142_59_73,r_112_88_16,r_60_86_132,0.99,0,132,132,0
34,r_122_120_37,r_119_31_154,r_36_126_52,r_36_126_52,0.96,69,121,52,0
19,r_29_57_49,r_61_43_66,r_142_59_73,r_142_59_73,0.84,7,80,73,0
75,seq68,r_67_136_84,r_53_69_82,r_67_136_84,0.83,0,84,84,0
41,r_1_40_58,r_146_56_19,r_93_42_75,r_1_40_58,0.64,25,83,58,0
17,r_48_20_175,seq46,r_121_28_99,r_48_20_175,0.73,0,175,175,0
18,r_2_100_88,r_1_40_58,seq11,r_1_40_58,0.98,-10,48,58,0
28,r_128_17_188,r_16_145_16,seq148,r_128_17_188,0.72,-88,100,188,0
9,r_53_69_82,r_52_47_155,r_71_75_184,r_53_69_82,0.81,0,82,82,0
0,r_15_34_85,r_53_69_82,r_64_35_100,r_64_35_100,0.6,0,100,100,0
22,r_60_86_132,r_61_43_66,r_142_59_73,r_142_59_73,1,6,79,73,0
7,r_142_59_73,r_16_145_16,r_29_57_49,r_142_59_73,1,0,73,73,0
49,r_64_35_100,r_65_21_141,r_15_34_85,r_64_35_100,0.97,0,100,100,0
41,r_1_40_58,seq4,r_146_56_19,r_1_40_58,0.78,0,58,58,0
44,r_24_106_99,r_25_115_85,r_133_26_2,r_25_115_85,0.82,1,86,85,0
7,r_142_59_73,r_143_81_40,r_16_145_16,r_142_59_73,0.82,-41,32,73,0
32,r_77_149_37,seq76,seq130,r_77_149_37,0.98,0,37,37,0
84,seq94,r_95_144_109,seq96,r_95_144_109,1,-1,108,109,0
37,r_101_102_47,r_98_52_54,seq104,r_101_102_47,0.78,0,47,47,1
30,r_47_24_133,seq48,seq23,r_47_24_133,0.87,0,133,133,1
47,r_20_128_36,r_22_87_181,r_83_132_17,r_20_128_36,1,1,37,36,1
36,r_143_126_129,seq145,r_8_125_67,r_8_125_67,0.91,64,131,67,1
20,r_64_55_142,r_62_99_40,seq56,r_62_99_40,1,5,45,40,1
43,r_88_72_87,seq85,seq71,r_88_72_87,0.99,0,87,87,1
83,seq71,seq73,r_88_72_87,r_88_72_87,1,41,128,87,1
3,r_81_49_166,r_74_79_41,seq48,r_81_49_166,0.41,0,166,166,1
20,r_64_55_142,seq56,r_98_52_54,r_98_52_54,0.69,10,64,54,1
16,r_25_90_87,r_27_14_192,r_89_91_74,r_25_90_87,1,0,87,87,1
21,r_94_116_91,seq93,seq122,r_94_116_91,0.96,5,96,91,1
39,r_89_91_74,seq93,r_25_90_87,r_25_90_87,1,11,98,87,1
1,r_9_54_63,r_8_125_67,seq56,r_9_54_63,1,0,63,63,1
46,r_114_80_68,r_113_137_152,r_74_79_41,r_114_80_68,1,0,68,68,1
8,r_98_52_54,seq100,seq56,r_98_52_54,1,0,54,54,1
45,r_107_4_159,seq104,seq2,r_107_4_159,0.55,0,159,159,1
24,r_8_125_67,r_127_86_139,r_143_126_129,r_8_125_67,0.89,73,140,67,1
33,r_27_14_192,r_69_26_54,seq15,r_27_14_192,0.47,0,192,192,1
77,seq56,r_9_54_63,r_64_55_142,r_64_55_142,0.52,0,142,142,1
27,r_17_67_140,seq16,r_88_72_87,r_17_67_140,0.92,0,140,140,1
66,seq30,r_31_109_74,r_37_32_193,r_31_109_74,0.98,0,74,74,1
41,r_41_84_157,seq42,r_127_86_139,r_41_84_157,0.45,0,157,157,1
42,r_77_118_54,r_75_45_139,seq119,r_77_118_54,1,0,54,54,1
26,r_83_132_17,r_75_45_139,seq133,r_83_132_17,0.92,0,17,17,1
8,r_98_52_54,seq56,r_9_54_63,r_9_54_63,0.53,70,133,63,1
4,r_115_19_167,r_117_53_166,r_47_24_133,r_47_24_133,0.99,32,165,133,1
11,r_70_60_69,seq71,r_61_29_123,r_70_60_69,0.91,0,69,69,1
40,r_61_29_123,r_70_60_69,seq30,r_61_29_123,1,0,123,123,1
8,r_98_52_54,r_9_54_63,r_70_60_69,r_98_52_54,0.63,113,167,54,1
13,r_148_95_137,seq149,seq93,r_148_95_137,0.5,0,137,137,1
15,r_75_45_139,seq76,seq46,r_75_45_139,0.92,0,139,139,1
48,r_124_68_85,seq123,seq66,r_124_68_85,1,0,85,85,1
12,r_113_137_152,r_94_116_91,seq136,r_113_137_152,0.49,0,152,152,1
25,r_127_86_139,r_113_137_152,r_148_95_137,r_127_86_139,0.5,-119,20,139,1
85,seq76,r_75_45_139,r_74_79_41,r_75_45_139,0.9,0,139,139,1
27,r_17_67_140,seq18,seq16,r_17_67_140,0.4,-107,33,140,1
25,r_127_86_139,r_8_125_67,seq85,r_127_86_139,0.84,0,139,139,1
6,r_112_78_30,seq111,r_77_118_54,r_112_78_30,0.84,0,30,30,1
9,r_65_39_13,r_62_99_40,seq38,r_65_39_13,0.65,0,13,13,1
10,r_96_146_56,r_94_116_91,r_82_147_2,r_96_146_56,1,-2,54,56,1
2,r_130_105_60,r_129_28_118,seq106,r_130_105_60,0.61,0,60,60,1
40,r_61_29_123,seq57,r_70_60_69,r_70_60_69,0.81,3,72,69,1
18,r_138_103_105,seq136,r_101_102_47,r_138_103_105,0.85,0,105,105,1
24,r_8_125_67,seq6,r_127_86_139,r_8_125_67,0.99,0,67,67,1
33,r_27_14_192,r_25_90_87,r_69_26_54,r_27_14_192,1,-105,87,192,1
17,r_142_108_38,seq145,seq111,r_142_108_38,0.97,0,38,38,1
64,seq149,r_148_95_137,seq139,r_148_95_137,0.88,-15,122,137,1
23,r_63_140_14,r_62_99_40,seq141,r_63_140_14,0.95,0,14,14,1
58,seq11,r_10_50_135,seq6,r_10_50_135,0.99,0,135,135,1
65,seq23,r_22_87_181,r_47_24_133,r_47_24_133,1,13,146,133,1
3,r_81_49_166,r_77_118_54,r_74_79_41,r_77_118_54,1,0,54,54,1
68,seq34,r_37_32_193,r_134_44_90,r_134_44_90,1,10,100,90,1
32,r_117_53_166,r_115_19_167,r_98_52_54,r_98_52_54,0.96,113,167,54,1
38,r_31_109_74,seq30,seq110,r_31_109_74,1,0,74,74,1
77,seq56,seq57,r_9_54_63,r_9_54_63,1,7,70,63,1
0,r_62_99_40,r_64_55_142,seq100,r_62_99_40,1,2,42,40,1
34,r_131_97_108,r_129_28_118,r_62_99_40,r_131_97_108,0.9,0,108,108,1
35,r_74_79_41,seq71,r_112_78_30,r_112_78_30,1,11,41,30,1
25,r_127_86_139,r_148_95_137,r_8_125_67,r_8_125_67,0.82,0,67,67,1
66,seq30,r_37_32_193,r_129_28_118,r_129_28_118,1,0,118,118,1
6,r_112_78_30,r_77_118_54,r_74_79_41,r_77_118_54,1,0,54,54,1
28,r_129_28_118,seq133,seq30,r_129_28_118,0.88,0,118,118,1
49,r_12_120_82,seq11,r_77_118_54,r_12_120_82,1,0,82,82,1
7,r_10_50_135,seq11,seq51,r_10_50_135,0.92,0,135,135,1
44,r_134_44_90,r_148_95_137,r_21_40_6,r_134_44_90,0.98,1,91,90,1
14,r_69_26_54,r_70_60_69,seq23,r_69_26_54,1,0,54,54,1
11,r_70_60_69,r_61_29_123,r_9_54_63,r_61_29_123,1,0,123,123,1
12,r_113_137_152,r_114_80_68,r_94_116_91,r_113_137_152,0.58,-84,68,152,1
28,r_88_49_43,r_91_147_80,seq52,r_88_49_43,1,0,43,43,2
30,r_20_32_72,r_23_66_176,seq33,r_20_32_72,1,0,72,72,2
36,r_71_100_109,seq67,seq101,r_71_100_109,1,0,109,109,2
56,seq9,seq8,r_93_10_38,r_93_10_38,1,8,46,38,2
92,seq101,r_99_129_149,r_71_100_109,r_71_100_109,0.98,12,121,109,2
14,r_76_123_4,seq124,r_111_122_146,r_111_122_146,0.53,-6,140,146,2
43,r_51_16_93,r_53_136_129,seq18,r_51_16_93,0.99,1,94,93,2
54,seq7,r_6_132_163,r_115_3_71,r_115_3_71,0.95,92,163,71,2
37,r_61_89_64,seq62,seq90,r_61_89_64,1,0,64,64,2
17,r_12_86_23,seq9,r_72_85_2,r_12_86_23,0.73,0,23,23,2
16,r_99_129_149,seq98,seq130,r_99_129_149,0.86,0,149,149,2
39,r_40_70_158,seq41,seq67,r_40_70_158,0.91,0,158,158,2
1,r_23_66_176,r_24_131_151,r_51_16_93,r_51_16_93,0.93,57,150,93,2
46,r_47_80_167,seq46,r_102_79_30,r_47_80_167,0.59,0,167,167,2
42,r_31_74_102,seq33,seq75,r_31_74_102,1,1,103,102,2
63,seq145,r_148_54_56,r_138_13_127,r_148_54_56,0.79,0,56,56,2
80,seq55,r_56_38_82,r_50_58_139,r_56_38_82,1,0,82,82,2
50,seq0,r_6_132_163,r_77_1_122,r_77_1_122,0.73,3,125,122,2
45,r_143_64_123,r_138_13_127,seq63,r_143_64_123,0.98,0,123,123,2
11,r_146_78_35,r_77_1_122,r_141_95_122,r_146_78_35,0.97,87,122,35,2
11,r_146_78_35,seq145,r_77_1_122,r_146_78_35,1,0,35,35,2
9,r_137_45_58,r_138_13_127,seq41,r_137_45_58,1,0,58,58,2
3,r_21_112_162,r_23_66_176,r_69_114_163,r_21_112_162,0.74,1,163,162,2
10,r_111_122_146,r_113_28_146,r_76_123_4,r_111_122_146,0.63,0,146,146,2
26,r_113_28_146,r_111_122_146,seq26,r_113_28_146,0.8,0,146,146,2
72,seq37,r_40_70_158,r_56_38_82,r_56_38_82,0.92,12,94,82,2
41,r_148_54_56,seq145,seq55,r_148_54_56,1,0,56,56,2
8,r_102_79_30,r_103_118_181,seq83,r_102_79_30,1,0,30,30,2
64,seq18,r_17_84_52,r_19_57_162,r_17_84_52,1,1,53,52,2
15,r_5_133_177,seq7,seq134,r_5_133_177,0.68,0,177,177,2
48,r_24_131_151,r_23_66_176,r_99_129_149,r_24_131_151,0.96,1,152,151,2
13,r_17_84_52,seq18,seq83,r_17_84_52,1,1,53,52,2
12,r_60_43_180,seq63,r_56_38_82,r_60_43_180,0.97,0,180,180,2
6,r_69_114_163,seq63,r_21_112_162,r_69_114_163,0.47,0,163,163,2
21,r_77_1_122,r_146_78_35,seq0,r_77_1_122,0.99,0,122,122,2
24,r_35_65_24,seq34,seq67,r_35_65_24,1,0,24,24,2
2,r_115_3_71,r_113_28_146,seq2,r_115_3_71,0.99,0,71,71,2
47,r_141_95_122,r_138_13_127,seq90,r_141_95_122,0.99,0,122,122,2
40,r_56_38_82,seq55,seq37,r_56_38_82,1,0,82,82,2
29,r_103_118_181,r_104_105_3,r_69_114_163,r_69_114_163,0.94,17,180,163,2
33,r_59_142_117,r_60_43_180,seq139,r_59_142_117,1,0,117,117,2
21,r_77_1_122,r_82_121_41,r_146_78_35,r_77_1_122,0.99,-83,39,122,2
1,r_23_66_176,r_51_16_93,r_40_70_158,r_23_66_176,0.98,0,176,176,2
32,r_138_13_127,seq139,r_22_11_101,r_138_13_127,0.91,0,127,127,2
38,r_22_11_101,r_21_112_162,seq9,r_21_112_162,0.56,-61,101,162,2
52,seq2,seq0,r_115_3_71,r_115_3_71,1,19,90,71,2
77,seq46,r_47_80_167,r_56_38_82,r_56_38_82,0.95,83,165,82,2
34,r_106_87_116,r_104_105_3,seq90,r_106_87_116,0.92,0,116,116,2
94,seq110,r_111_122_146,r_69_114_163,r_69_114_163,0.77,4,167,163,2
22,r_19_57_162,seq18,r_50_58_139,r_19_57_162,0.65,0,162,162,2
62,seq144,seq134,r_91_147_80,r_91_147_80,0.92,66,146,80,2
91,seq98,r_99_129_149,r_71_100_109,r_71_100_109,0.86,40,149,109,2
18,r_82_121_41,r_81_117_190,seq120,r_82_121_41,1,0,41,41,2
64,seq18,r_19_57_162,r_51_16_93,r_51_16_93,0.92,6,99,93,2
49,r_94_119_132,seq92,seq110,r_94_119_132,0.97,0,132,132,2
7,r_6_132_163,seq7,seq134,r_6_132_163,0.89,0,163,163,2
44,r_91_147_80,seq90,seq145,r_91_147_80,1,0,80,80,2
27,r_93_10_38,r_82_121_41,seq9,r_93_10_38,1,1,39,38,2
12,r_60_43_180,r_59_142_117,seq63,r_59_142_117,0.98,0,117,117,2
28,r_130_69_15,r_129_20_67,seq64,r_130_69_15,0.95,0,15,15,3
14,r_91_42_206,r_90_100_88,r_0_92_92,r_0_92_92,1,16,108,92,3
8,r_46_65_112,r_47_127_157,r_130_69_15,r_46_65_112,1,0,112,112,3
43,r_88_66_111,seq86,r_130_69_15,r_88_66_111,0.94,0,111,111,3
16,r_73_68_196,r_74_12_123,seq78,r_74_12_123,1,0,123,123,3
5,r_94_107_136,seq102,r_110_97_3,r_94_107_136,0.59,-22,114,136,3
46,r_129_20_67,seq128,r_44_22_35,r_129_20_67,1,0,67,67,3
42,r_118_85_125,seq119,seq84,r_118_85_125,0.92,0,125,125,3
80,seq71,r_72_87_137,seq70,r_72_87_137,0.94,-1,136,137,3
99,seq125,r_118_85_125,r_8_126_47,r_8_126_47,1,0,47,47,3
45,r_23_51_106,seq21,r_45_4_161,r_23_51_106,0.46,0,106,106,3
19,r_117_77_113,r_118_85_125,r_49_79_49,r_49_79_49,0.99,64,113,49,3
22,r_116_122_44,r_117_77_113,seq123,r_117_77_113,0.6,-82,31,113,3
27,r_8_126_47,seq125,r_47_127_157,r_47_127_157,1,11,168,157,3
95,seq119,r_118_85_125,seq121,r_118_85_125,0.98,0,125,125,3
39,r_2_93_9,r_90_100_88,r_0_92_92,r_0_92_92,1,46,138,92,3
41,r_45_4_161,seq48,r_139_5_142,r_45_4_161,0.98,0,161,161,3
10,r_36_28_122,seq35,r_25_30_61,r_36_28_122,0.83,0,122,122,3
16,r_73_68_196,seq78,r_104_63_152,r_73_68_196,0.56,-1,195,196,3
23,r_44_22_35,r_45_4_161,seq21,r_44_22_35,0.98,-1,34,35,3
14,r_91_42_206,r_0_92_92,r_39_38_135,r_39_38_135,0.66,72,207,135,3
0,r_104_63_152,seq102,r_46_65_112,r_104_63_152,0.96,0,152,152,3
11,r_41_3_121,r_40_135_107,r_33_137_177,r_40_135_107,0.98,0,107,107,3
20,r_72_87_137,seq71,r_118_85_125,r_72_87_137,0.95,0,137,137,3
13,r_39_38_135,r_33_137_177,seq35,r_33_137_177,0.8,-1,176,177,3
15,r_105_50_148,seq106,r_23_51_106,r_105_50_148,0.85,0,148,148,3
48,r_25_30_61,seq27,seq29,r_25_30_61,0.64,34,95,61,3
6,r_47_127_157,seq48,r_8_126_47,r_47_127_157,0.94,0,157,157,3
85,seq86,r_88_66_111,seq84,r_88_66_111,1,2,113,111,3
36,r_96_43_52,r_47_127_157,r_23_51_106,r_96_43_52,0.75,79,131,52,3
27,r_8_126_47,seq9,seq125,r_8_126_47,1,0,47,47,3
11,r_41_3_121,seq7,r_139_5_142,r_139_5_142,0.76,1,143,142,3
1,r_49_79_49,r_47_127_157,seq78,r_49_79_49,1,0,49,49,3
2,r_33_137_177,r_39_38_135,r_120_138_180,r_33_137_177,0.38,0,177,177,3
47,r_134_147_149,seq148,r_76_146_28,r_76_146_28,0.97,121,149,28,3
3,r_76_146_28,seq78,seq145,r_76_146_28,0.93,0,28,28,3
40,r_40_135_107,r_41_3_121,r_76_146_28,r_40_135_107,0.89,0,107,107,3
18,r_60_113_91,seq57,seq114,r_60_113_91,0.98,0,91,91,3
29,r_139_5_142,seq140,r_41_3_121,r_139_5_142,0.94,0,142,142,3
36,r_96_43_52,r_110_97_3,r_47_127_157,r_96_43_52,0.99,0,52,52,3
25,r_142_34_159,r_136_6_192,r_39_38_135,r_142_34_159,0.81,0,159,159,3
33,r_115_59_80,seq114,seq56,r_115_59_80,1,0,80,80,3
50,seq128,r_129_20_67,seq132,r_129_20_67,1,-3,64,67,3
37,r_75_99_45,r_74_12_123,r_110_97_3,r_75_99_45,0.99,0,45,45,3
32,r_19_14_139,seq18,seq15,r_19_14_139,0.99,0,139,139,3
38,r_81_31_183,seq80,r_25_30_61,r_81_31_183,0.65,0,183,183,3
34,r_83_26_101,seq84,seq24,r_83_26_101,1,0,101,101,3
65,seq21,r_23_51_106,r_44_22_35,r_44_22_35,0.61,-3,32,35,3
79,seq70,r_72_87_137,r_130_69_15,r_72_87_137,0.64,-37,100,137,3
45,r_23_51_106,r_45_4_161,r_105_50_148,r_23_51_106,0.99,42,148,106,3
94,seq114,seq119,r_60_113_91,r_60_113_91,1,70,161,91,3
9,r_0_92_92,seq1,r_2_93_9,r_0_92_92,1,0,92,92,3
96,seq121,r_120_138_180,r_60_113_91,r_60_113_91,1,88,179,91,3
91,seq106,r_105_50_148,r_94_107_136,r_105_50_148,0.81,0,148,148,3
49,r_32_141_75,r_41_3_121,r_76_146_28,r_32_141_75,0.99,0,75,75,3
11,r_41_3_121,r_33_137_177,seq7,r_41_3_121,0.75,0,121,121,3
7,r_74_12_123,r_73_68_196,seq10,r_74_12_123,1,0,123,123,3
82,seq80,r_81_31_183,r_118_85_125,r_118_85_125,0.8,57,182,125,3
79,seq70,seq71,r_72_87_137,r_72_87_137,0.31,-71,66,137,3
12,r_67_103_60,seq64,seq102,r_67_103_60,1,1,61,60,3
17,r_89_61_42,r_88_66_111,seq57,r_89_61_42,1,0,42,42,3
84,seq84,r_83_26_101,seq82,r_83_26_101,1,0,101,101,3
30,r_11_90_93,r_10_56_137,seq87,r_11_90_93,1,0,93,93,4
36,r_45_17_63,seq43,seq16,r_45_17_63,1,0,63,63,4
14,r_3_38_149,r_4_141_119,seq0,r_4_141_119,1,0,119,119,4
8,r_57_121_97,seq60,r_79_123_1,r_57_121_97,0.98,0,97,97,4
22,r_6_68_26,seq5,seq67,r_6_68_26,1,0,26,26,4
37,r_79_123_1,r_119_76_178,r_57_121_97,r_57_121_97,0.87,5,102,97,4
3,r_109_107_31,r_106_128_156,r_147_108_82,r_109_107_31,0.59,110,141,31,4
16,r_52_71_75,r_54_138_168,seq72,r_52_71_75,1,0,75,75,4
39,r_48_19_153,r_54_138_168,seq23,r_48_19_153,0.66,0,153,153,4
1,r_120_32_40,seq31,r_88_33_8,r_88_33_8,0.58,100,108,8,4
33,r_34_104_21,r_4_141_119,seq103,r_34_104_21,0.83,-1,20,21,4
42,r_58_92_101,seq60,seq95,r_58_92_101,0.96,2,103,101,4
61,seq146,r_145_73_31,seq134,r_145_73_31,0.98,1,32,31,4
49,r_147_108_82,seq146,r_109_107_31,r_147_108_82,0.83,0,82,82,4
7,r_135_139_55,r_136_110_151,seq140,r_136_110_151,0.84,-96,55,151,4
80,seq72,r_70_96_181,r_52_71_75,r_52_71_75,0.98,69,144,75,4
21,r_21_82_45,seq23,seq83,r_21_82_45,1,0,45,45,4
41,r_131_115_25,r_137_94_202,seq111,r_131_115_25,0.84,0,25,25,4
24,r_75_63_193,r_145_73_31,r_99_65_35,r_145_73_31,0.42,162,193,31,4
5,r_62_114_101,seq66,r_99_65_35,r_99_65_35,0.86,17,52,35,4
83,seq83,r_78_81_3,r_21_82_45,r_21_82_45,1,7,52,45,4
43,r_132_69_12,r_131_115_25,r_70_96_181,r_132_69_12,0.99,0,12,12,4
44,r_1_130_18,r_137_94_202,r_77_129_142,r_77_129_142,0.99,5,147,142,4
4,r_10_56_137,seq8,seq59,r_10_56_137,0.91,0,137,137,4
78,seq66,seq67,r_6_68_26,r_6_68_26,0.98,89,115,26,4
11,r_13_98_128,seq14,r_149_97_68,r_13_98_128,0.9,0,128,128,4
20,r_4_141_119,r_3_38_149,seq142,r_4_141_119,0.93,0,119,119,4
13,r_54_138_168,seq55,r_135_139_55,r_54_138_168,0.91,-1,167,168,4
5,r_62_114_101,r_99_65_35,r_131_115_25,r_62_114_101,1,0,101,101,4
46,r_88_33_8,seq31,r_120_32_40,r_120_32_40,0.98,69,109,40,4
15,r_137_94_202,seq140,r_109_107_31,r_109_107_31,0.68,172,203,31,4
48,r_25_42_72,seq27,r_117_41_16,r_25_42_72,0.97,0,72,72,4
6,r_102_50_160,seq101,r_51_93_196,r_102_50_160,0.6,0,160,160,4
0,r_113_122_44,seq111,r_79_123_1,r_113_122_44,0.8,0,44,44,4
9,r_99_65_35,seq100,r_62_114_101,r_99_65_35,0.97,0,35,35,4
10,r_117_41_16,seq43,r_25_42_72,r_25_42_72,1,20,92,72,4
53,seq5,seq0,r_48_19_153,r_48_19_153,0.96,10,163,153,4
29,r_145_73_31,seq146,r_74_30_125,r_145_73_31,0.99,0,31,31,4
87,seq87,r_89_18_164,r_11_90_93,r_11_90_93,0.91,71,164,93,4
47,r_20_133_119,seq23,seq134,r_20_133_119,0.99,0,119,119,4
40,r_35_64_69,r_37_148_100,r_99_65_35,r_35_64_69,1,0,69,69,4
18,r_49_91_165,r_51_93_196,r_58_92_101,r_51_93_196,0.56,-31,165,196,4
53,seq5,r_6_68_26,seq0,r_6_68_26,1,0,26,26,4
61,seq146,seq134,r_37_148_100,r_37_148_100,1,0,100,100,4
24,r_75_63_193,r_74_30_125,r_145_73_31,r_75_63_193,0.95,-97,96,193,4
9,r_99_65_35,r_62_114_101,r_35_64_69,r_99_65_35,1,43,78,35,4
45,r_106_128_156,seq103,r_109_107_31,r_109_107_31,1,8,39,31,4
34,r_70_96_181,r_132_69_12,seq95,r_132_69_12,0.44,169,181,12,4
43,r_132_69_12,r_70_96_181,r_52_71_75,r_52_71_75,1,106,181,75,4
88,seq95,r_89_18_164,r_149_97_68,r_149_97_68,0.82,49,117,68,4
58,seq14,r_13_98_128,r_40_15_13,r_13_98_128,0.88,-15,113,128,4
32,r_116_124_167,seq118,r_113_122_44,r_116_124_167,0.33,0,167,167,4
38,r_37_148_100,seq36,seq146,r_37_148_100,0.99,0,100,100,4
3,r_109_107_31,r_113_122_44,r_106_128_156,r_109_107_31,1,0,31,31,4
60,seq16,seq31,r_45_17_63,r_45_17_63,1,12,75,63,4
45,r_106_128_156,r_109_107_31,seq127,r_106_128_156,0.88,0,156,156,4
81,seq140,r_137_94_202,r_135_139_55,r_135_139_55,0.89,10,65,55,4
34,r_70_96_181,seq72,r_132_69_12,r_132_69_12,0.98,19,31,12,4
96,seq118,r_116_124_167,r_113_122_44,r_116_124_167,0.31,-3,164,167,4
29,r_145_73_31,r_74_30_125,r_52_71_75,r_145_73_31,0.98,93,124,31,4
28,r_74_30_125,r_77_129_142,seq23,r_74_30_125,0.88,0,125,125,4
35,r_77_129_142,r_145_73_31,r_1_130_18,r_77_129_142,1,0,142,142,4
49,r_147_108_82,r_149_97_68,seq146,r_149_97_68,0.98,0,68,68,4
23,r_119_76_178,r_79_123_1,r_145_73_31,r_119_76_178,0.67,0,178,178,4
10,r_117_41_16,r_116_124_167,seq43,r_117_41_16,0.98,0,16,16,4
79,seq67,seq66,r_6_68_26,r_6_68_26,0.99,35,61,26,4
35,r_77_129_142,r_74_30_125,r_145_73_31,r_77_129_142,0.58,-46,96,142,4
14,r_3_38_149,seq0,r_117_41_16,r_3_38_149,0.91,0,149,149,4
12,r_39_22_66,seq43,seq23,r_39_22_66,1,0,66,66,4
1,r_120_32_40,r_119_76_178,seq31,r_120_32_40,0.8,0,40,40,4
18,r_79_130_58,r_83_78_77,seq131,r_79_130_58,1,1,59,58,5
36,r_51_121_64,seq50,seq120,r_51_121_64,1,0,64,64,5
48,r_117_41_114,r_102_97_135,r_27_118_56,r_27_118_56,0.42,0,56,56,5
14,r_26_128_69,r_28_81_156,r_127_4_149,r_26_128_69,0.99,0,69,69,5
30,r_69_148_53,r_73_76_190,r_129_149_40,r_69_148_53,1,0,53,53,5
21,r_83_78_77,seq80,seq87,r_83_78_77,0.59,0,77,77,5
39,r_42_19_77,r_43_20_135,r_28_81_156,r_28_81_156,0.53,-80,76,156,5
5,r_5_22_122,r_6_39_83,r_8_56_187,r_6_39_83,0.97,0,83,83,5
43,r_129_149_40,seq131,seq147,r_129_149_40,0.69,0,40,40,5
48,r_117_41_114,r_27_118_56,seq45,r_117_41_114,1,0,114,114,5
45,r_142_113_145,seq143,seq103,r_142_113_145,0.96,0,145,145,5
9,r_119_21_97,r_42_19_77,r_5_22_122,r_5_22_122,0.94,4,126,122,5
35,r_63_12_47,seq62,r_0_13_23,r_63_12_47,1,0,47,47,5
66,seq32,r_31_1_137,seq30,r_31_1_137,0.94,0,137,137,5
26,r_93_53_23,r_98_59_130,seq55,r_93_53_23,0.9,0,23,23,5
39,r_42_19_77,r_28_81_156,r_43_20_135,r_28_81_156,0.93,-9,147,156,5
41,r_96_105_144,r_95_11_164,seq103,r_96_105_144,0.93,0,144,144,5
67,seq36,r_35_44_159,r_6_39_83,r_6_39_83,1,32,115,83,5
89,seq101,seq99,r_139_100_43,r_139_100_43,1,43,86,43,5
3,r_94_65_110,r_98_59_130,r_144_66_11,r_94_65_110,1,0,110,110,5
68,seq37,seq30,r_6_39_83,r_6_39_83,0.81,4,87,83,5
90,seq103,r_102_97_135,seq104,r_102_97_135,1,0,135,135,5
33,r_23_75_13,r_27_118_56,seq74,r_23_75_13,1,0,13,13,5
72,seq50,seq52,r_47_48_50,r_47_48_50,0.93,60,110,50,5
14,r_26_128_69,r_127_4_149,seq131,r_127_4_149,1,1,150,149,5
4,r_18_122_14,r_16_61_49,seq125,r_18_122_14,0.75,0,14,14,5
46,r_0_13_23,r_5_22_122,seq14,r_0_13_23,0.57,3,26,23,5
0,r_35_44_159,seq32,r_117_41_114,r_117_41_114,0.71,38,152,114,5
84,seq80,r_89_24_194,r_10_82_115,r_10_82_115,0.93,12,127,115,5
20,r_28_81_156,seq29,seq80,r_28_81_156,0.86,0,156,156,5
13,r_127_4_149,seq131,r_26_128_69,r_26_128_69,1,15,84,69,5
17,r_95_11_164,r_102_97_135,r_63_12_47,r_95_11_164,0.75,0,164,164,5
15,r_15_124_37,r_16_61_49,seq125,r_15_124_37,1,0,37,37,5
57,seq14,seq17,r_0_13_23,r_0_13_23,0.96,105,128,23,5
11,r_27_118_56,seq104,r_139_100_43,r_139_100_43,0.7,104,147,43,5
13,r_127_4_149,r_26_128_69,seq2,r_127_4_149,0.97,1,150,149,5
6,r_102_97_135,seq103,r_139_100_43,r_102_97_135,0.91,0,135,135,5
12,r_91_60_22,seq99,seq58,r_91_60_22,0.92,0,22,22,5
2,r_98_59_130,r_95_11_164,r_91_60_22,r_95_11_164,0.82,-34,130,164,5
38,r_134_33_43,seq138,seq32,r_134_33_43,1,0,43,43,5
40,r_92_86_184,seq101,r_28_81_156,r_92_86_184,0.53,0,184,184,5
29,r_109_70_142,r_108_49_157,r_73_76_190,r_108_49_157,0.61,-15,142,157,5
27,r_85_111_32,r_89_24_194,seq110,r_85_111_32,1,0,32,32,5
24,r_31_1_137,seq32,seq2,r_31_1_137,0.84,0,137,137,5
35,r_63_12_47,r_0_13_23,r_95_11_164,r_95_11_164,0.97,11,175,164,5
19,r_144_66_11,seq146,seq71,r_144_66_11,0.95,0,11,11,5
5,r_5_22_122,r_8_56_187,r_119_21_97,r_5_22_122,1,0,122,122,5
11,r_27_118_56,r_139_100_43,r_38_133_68,r_139_100_43,0.68,126,169,43,5
68,seq37,r_38_133_68,seq30,r_38_133_68,0.88,0,68,68,5
32,r_116_84_181,seq115,r_28_81_156,r_28_81_156,0.72,23,179,156,5
34,r_108_49_157,seq110,seq50,r_108_49_157,0.72,0,157,157,5
11,r_27_118_56,r_117_41_114,seq104,r_117_41_114,0.93,0,114,114,5
47,r_34_140_38,r_35_44_159,seq136,r_34_140_38,1,1,39,38,5
17,r_95_11_164,r_96_105_144,r_102_97_135,r_102_97_135,0.56,8,143,135,5
9,r_119_21_97,seq120,r_42_19_77,r_119_21_97,0.89,1,98,97,5
48,r_117_41_114,r_127_4_149,r_102_97_135,r_127_4_149,0.8,-106,43,149,5
11,r_27_118_56,r_26_128_69,r_117_41_114,r_117_41_114,0.73,-58,56,114,5
28,r_46_141_106,seq45,seq143,r_46_141_106,1,0,106,106,5
49,r_3_112_142,seq2,r_85_111_32,r_3_112_142,0.89,0,142,142,5
7,r_38_133_68,seq37,seq138,r_38_133_68,1,0,68,68,5
44,r_10_82_115,seq17,seq80,r_10_82_115,1,0,115,115,5
23,r_106_135_74,r_102_97_135,seq136,r_106_135_74,0.99,0,74,74,5
82,seq74,seq71,r_23_75_13,r_23_75_13,0.98,55,68,13,5
16,r_16_61_49,seq14,seq62,r_16_61_49,1,0,49,49,5
43,r_129_149_40,seq147,r_69_148_53,r_69_148_53,0.63,-3,50,53,5
40,r_20_104_22,r_102_42_143,r_143_103_81,r_143_103_81,0.87,62,143,81,6
30,r_63_9_148,r_62_81_139,r_31_8_98,r_63_9_148,0.83,0,148,148,6
36,r_85_34_179,r_84_55_116,seq82,r_84_55_116,0.57,-20,96,116,6
28,r_38_56_98,seq72,r_84_55_116,r_38_56_98,0.53,38,136,98,6
8,r_71_132_164,seq72,seq131,r_71_132_164,0.76,0,164,164,6
43,r_136_43_161,seq134,r_102_42_143,r_136_43_161,0.49,0,161,161,6
83,seq80,r_85_34_179,r_62_81_139,r_85_34_179,0.35,-30,149,179,6
61,seq17,r_18_115_46,seq22,r_18_115_46,1,0,46,46,6
46,r_109_41_11,r_111_112_115,seq46,r_109_41_11,0.73,0,11,11,6
55,seq5,seq4,r_31_8_98,r_31_8_98,1,67,165,98,6
16,r_126_98_55,r_127_120_114,seq99,r_126_98_55,1,3,58,55,6
21,r_69_148_68,r_71_132_164,seq149,r_69_148_68,0.96,0,68,68,6
1,r_30_123_101,r_33_2_126,seq122,r_30_123_101,0.86,0,101,101,6
5,r_57_87_116,seq58,r_88_90_13,r_88_90_13,0.26,106,119,13,6
42,r_139_7_122,r_144_79_181,r_31_8_98,r_139_7_122,0.98,0,122,122,6
11,r_75_135_157,seq72,r_49_137_29,r_75_135_157,0.91,0,157,157,6
95,seq113,seq114,r_111_112_115,r_111_112_115,0.86,20,135,115,6
6,r_33_2_126,r_139_7_122,seq0,r_33_2_126,0.46,35,161,126,6
3,r_101_47_181,seq99,r_78_48_7,r_78_48_7,0.68,174,181,7,6
10,r_19_36_156,seq22,r_60_39_108,r_60_39_108,0.95,44,152,108,6
4,r_144_79_181,seq145,r_6_70_102,r_6_70_102,0.93,79,181,102,6
12,r_83_35_24,r_85_34_179,seq27,r_83_35_24,0.99,0,24,24,6
11,r_75_135_157,r_76_86_82,seq72,r_76_86_82,0.87,2,84,82,6
20,r_66_108_99,seq68,seq110,r_66_108_99,0.65,0,99,99,6
48,r_61_95_137,seq65,seq94,r_61_95_137,0.9,0,137,137,6
57,seq10,seq16,r_26_11_84,r_26_11_84,0.91,6,90,84,6
6,r_33_2_126,seq32,r_139_7_122,r_33_2_126,0.58,0,126,126,6
75,seq50,r_51_128_48,r_74_52_11,r_51_128_48,0.99,0,48,48,6
0,r_102_42_143,r_20_104_22,seq44,r_102_42_143,0.75,0,143,143,6
36,r_85_34_179,seq82,r_83_35_24,r_83_35_24,0.69,155,179,24,6
27,r_125_100_185,r_133_124_5,r_143_103_81,r_143_103_81,1,105,186,81,6
2,r_127_120_114,r_125_100_185,r_30_123_101,r_127_120_114,0.94,0,114,114,6
47,r_3_129_87,seq1,r_51_128_48,r_3_129_87,0.72,0,87,87,6
18,r_31_8_98,r_30_123_101,seq5,r_31_8_98,0.93,0,98,98,6
25,r_143_103_81,seq142,r_20_104_22,r_143_103_81,1,0,81,81,6
64,seq22,r_19_36_156,seq17,r_19_36_156,0.56,1,157,156,6
1,r_30_123_101,seq122,r_127_120_114,r_127_120_114,0.99,15,129,114,6
32,r_119_13_131,seq122,seq14,r_119_13_131,0.82,0,131,131,6
38,r_84_55_116,r_85_34_179,r_38_56_98,r_84_55_116,0.89,3,119,116,6
34,r_26_11_84,r_25_118_192,seq10,r_26_11_84,0.97,0,84,84,6
81,seq72,r_71_132_164,r_6_70_102,r_6_70_102,0.89,57,159,102,6
17,r_77_140_183,r_75_135_157,seq72,r_75_135_157,0.69,-32,125,157,6
9,r_6_70_102,seq5,seq72,r_6_70_102,1,0,102,102,6
41,r_51_128_48,seq131,r_3_129_87,r_3_129_87,1,11,98,87,6
22,r_121_141_102,seq122,seq145,r_121_141_102,0.98,0,102,102,6
28,r_38_56_98,r_37_146_153,seq72,r_38_56_98,0.83,0,98,98,6
41,r_51_128_48,seq50,seq131,r_51_128_48,1,0,48,48,6
7,r_76_86_82,r_75_135_157,r_88_90_13,r_75_135_157,0.61,-73,84,157,6
0,r_102_42_143,r_101_47_181,r_20_104_22,r_20_104_22,1,14,36,22,6
40,r_20_104_22,r_19_36_156,r_102_42_143,r_20_104_22,0.99,0,22,22,6
23,r_60_39_108,r_61_95_137,seq40,r_60_39_108,0.92,0,108,108,6
49,r_18_115_46,seq17,seq116,r_18_115_46,1,0,46,46,6
35,r_111_112_115,seq110,seq113,r_111_112_115,0.88,0,115,115,6
93,seq104,r_106_137_115,seq109,r_106_137_115,1,-1,114,115,7
36,r_10_92_112,seq11,r_91_127_173,r_10_92_112,0.93,0,112,112,7
48,r_31_73_48,r_34_3_59,r_78_75_43,r_31_73_48,0.97,0,48,48,7
17,r_68_99_50,seq69,seq101,r_68_99_50,0.97,0,50,50,7
43,r_36_8_105,r_42_112_173,seq7,r_36_8_105,1,0,105,105,7
54,seq7,seq14,r_36_8_105,r_36_8_105,1,32,137,105,7
83,seq79,r_80_94_144,r_128_77_131,r_128_77_131,0.85,12,143,131,7
41,r_105_142_66,r_138_49_122,r_102_141_114,r_105_142_66,1,56,122,66,7
37,r_9_126_77,r_10_92_112,seq125,r_9_126_77,1,0,77,77,7
59,seq18,r_21_90_165,seq19,r_21_90_165,1,0,165,165,7
31,r_78_75_43,r_80_94_144,seq74,r_78_75_43,0.81,0,43,43,7
16,r_97_6_40,r_98_53_177,seq7,r_97_6_40,1,1,41,40,7
21,r_98_53_177,r_96_132_145,r_59_47_140,r_96_132_145,0.92,0,145,145,7
1,r_42_112_173,seq40,r_86_113_24,r_86_113_24,0.8,149,173,24,7
97,seq118,r_119_12_110,r_103_117_54,r_119_12_110,1,0,110,110,7
46,r_76_62_134,r_80_94_144,seq95,r_76_62_134,0.61,-52,82,134,7
42,r_96_132_145,r_98_53_177,r_66_133_99,r_98_53_177,0.99,-32,145,177,7
8,r_86_113_24,r_91_127_173,seq101,r_86_113_24,1,0,24,24,7
14,r_129_122_45,r_128_77_131,r_140_121_37,r_129_122_45,0.76,1,46,45,7
45,r_128_77_131,r_129_122_45,seq79,r_128_77_131,0.9,0,131,131,7
19,r_138_49_122,r_136_124_116,r_105_142_66,r_105_142_66,0.97,10,76,66,7
61,seq148,seq143,r_87_147_40,r_87_147_40,1,7,47,40,7
41,r_105_142_66,seq104,r_138_49_122,r_105_142_66,0.97,0,66,66,7
30,r_139_16_30,r_138_49_122,seq17,r_139_16_30,0.99,0,30,30,7
46,r_76_62_134,seq95,seq54,r_76_62_134,0.63,0,134,134,7
3,r_2_144_104,seq4,seq145,r_2_144_104,1,0,104,104,7
19,r_138_49_122,r_139_16_30,r_136_124_116,r_139_16_30,0.81,-7,23,30,7
26,r_35_13_113,seq32,seq14,r_35_13_113,0.98,0,113,113,7
4,r_119_12_110,seq118,seq14,r_119_12_110,0.74,0,110,110,7
63,seq25,seq26,r_36_8_105,r_36_8_105,1,6,111,105,7
11,r_136_124_116,r_138_49_122,r_9_126_77,r_136_124_116,0.95,0,116,116,7
5,r_103_117_54,r_105_142_66,seq118,r_105_142_66,1,-12,54,66,7
20,r_37_57_65,r_36_8_105,r_15_51_2,r_37_57_65,0.95,-1,64,65,7
15,r_21_90_165,seq18,r_10_92_112,r_10_92_112,0.75,53,165,112,7
62,seq23,r_24_58_135,seq25,r_24_58_135,0.95,0,135,135,7
9,r_34_3_59,r_35_13_113,seq4,r_34_3_59,1,0,59,59,7
36,r_10_92_112,r_91_127_173,r_21_90_165,r_10_92_112,0.99,61,173,112,7
2,r_59_47_140,seq61,r_72_56_120,r_72_56_120,0.99,21,141,120,7
47,r_108_39_84,seq109,seq40,r_108_39_84,1,0,84,84,7
18,r_91_127_173,seq82,r_68_99_50,r_68_99_50,0.71,124,174,50,7
29,r_22_149_154,r_21_90_165,seq148,r_21_90_165,0.82,-11,154,165,7
40,r_87_147_40,seq82,seq148,r_87_147_40,0.95,0,40,40,7
25,r_52_116_150,seq54,seq101,r_52_116_150,0.82,1,151,150,7
50,seq0,r_1_43_186,r_34_3_59,r_34_3_59,1,127,186,59,7
20,r_37_57_65,r_15_51_2,r_24_58_135,r_24_58_135,1,2,137,135,7
77,seq61,r_59_47_140,r_146_60_68,r_146_60_68,1,73,141,68,7
24,r_28_81_34,seq26,seq79,r_28_81_34,1,0,34,34,7
19,r_138_49_122,r_105_142_66,seq46,r_138_49_122,0.99,0,122,122,7
51,seq130,r_107_135_8,r_66_133_99,r_66_133_99,0.86,16,115,99,7
28,r_146_60_68,seq148,seq61,r_146_60_68,1,1,69,68,7
27,r_66_133_99,seq67,seq134,r_66_133_99,1,1,100,99,7
49,r_24_58_135,seq23,r_37_57_65,r_24_58_135,1,0,135,135,7
56,seq14,r_21_90_165,r_35_13_113,r_35_13_113,0.8,31,144,113,7
72,seq45,r_59_47_140,r_71_44_45,r_71_44_45,0.97,11,56,45,7
82,seq74,seq70,r_78_75_43,r_78_75_43,0.95,17,60,43,7
35,r_80_94_144,seq79,seq95,r_80_94_144,0.59,0,144,144,7
12,r_131_5_86,seq130,seq4,r_131_5_86,0.98,0,86,86,7
14,r_100_47_29,r_98_31_178,r_52_144_78,r_100_47_29,0.99,0,29,29,8
36,r_73_16_93,r_74_22_179,seq15,r_73_16_93,0.73,0,93,93,8
49,r_116_63_58,r_64_138_80,seq67,r_64_138_80,0.98,0,80,80,8
8,r_102_42_36,r_105_35_35,r_81_40_57,r_81_40_57,1,15,72,57,8
10,r_143_8_40,r_140_72_141,seq9,r_143_8_40,1,0,40,40,8
34,r_139_7_45,r_140_72_141,r_143_8_40,r_140_72_141,0.99,-96,45,141,8
15,r_105_35_35,r_102_42_36,r_37_34_115,r_37_34_115,1,-80,35,115,8
59,seq15,r_17_61_187,r_73_16_93,r_73_16_93,1,13,106,93,8
93,seq103,r_101_126_59,seq106,r_101_126_59,1,0,59,59,8
21,r_147_137_57,seq148,r_133_65_151,r_147_137_57,0.95,3,60,57,8
1,r_69_89_137,seq70,r_107_93_103,r_69_89_137,0.91,0,137,137,8
65,seq29,seq27,r_109_30_34,r_109_30_34,1,10,44,34,8
46,r_136_57_67,r_135_66_130,r_62_58_98,r_136_57_67,0.95,0,67,67,8
42,r_133_65_151,r_135_66_130,r_147_137_57,r_147_137_57,0.62,73,130,57,8
3,r_109_30_34,r_110_134_117,seq29,r_109_30_34,1,0,34,34,8
45,r_75_92_129,r_74_22_179,r_107_93_103,r_75_92_129,1,0,129,129,8
35,r_45_2_33,seq43,seq1,r_45_2_33,1,0,33,33,8
19,r_52_144_78,r_49_23_102,seq142,r_52_144_78,1,0,78,78,8
40,r_24_46_52,seq11,seq43,r_24_46_52,0.68,0,52,52,8
25,r_64_138_80,r_130_99_181,r_52_144_78,r_64_138_80,0.45,17,97,80,8
37,r_59_12_25,r_62_58_98,seq13,r_59_12_25,1,0,25,25,8
14,r_100_47_29,r_52_144_78,seq53,r_52_144_78,1,-8,70,78,8
61,seq19,r_20_146_45,r_90_18_5,r_20_146_45,0.96,0,45,45,8
31,r_111_112_113,r_110_134_117,r_0_115_106,r_0_115_106,0.65,11,117,106,8
41,r_85_108_166,seq87,r_111_112_113,r_111_112_113,0.61,53,166,113,8
89,seq91,r_85_108_166,r_107_93_103,r_107_93_103,0.98,5,108,103,8
78,seq67,r_71_124_188,r_135_66_130,r_135_66_130,0.97,0,130,130,8
13,r_68_127_103,r_69_89_137,r_101_126_59,r_68_127_103,1,0,103,103,8
62,seq148,r_147_137_57,r_120_149_58,r_120_149_58,0.97,2,60,58,8
21,r_147_137_57,r_133_65_151,r_110_134_117,r_110_134_117,0.77,16,133,117,8
20,r_118_28_18,r_117_5_90,seq27,r_118_28_18,1,0,18,18,8
99,seq123,seq122,r_101_126_59,r_101_126_59,1,10,69,59,8
9,r_20_146_45,seq19,seq148,r_20_146_45,1,0,45,45,8
5,r_71_124_188,r_73_16_93,seq70,r_73_16_93,1,-40,53,93,8
12,r_125_54_56,seq122,seq60,r_125_54_56,1,0,56,56,8
2,r_21_104_105,r_17_61_187,seq106,r_21_104_105,0.82,0,105,105,8
47,r_37_34_115,seq39,r_105_35_35,r_105_35_35,1,99,134,35,8
42,r_133_65_151,r_147_137_57,seq67,r_133_65_151,0.93,0,151,151,8
18,r_140_72_141,seq142,r_71_124_188,r_140_72_141,0.67,1,142,141,8
40,r_24_46_52,r_41_94_173,seq11,r_24_46_52,0.41,-39,13,52,8
24,r_110_134_117,r_111_112_113,r_147_137_57,r_110_134_117,0.87,0,117,117,8
25,r_64_138_80,r_73_16_93,r_130_99_181,r_64_138_80,0.78,0,80,80,8
33,r_49_23_102,seq51,r_90_18_5,r_49_23_102,1,0,102,102,8
88,seq87,r_85_108_166,r_132_88_7,r_85_108_166,0.58,0,166,166,8
39,r_101_126_59,seq103,seq123,r_101_126_59,1,0,59,59,8
32,r_107_93_103,seq106,seq91,r_107_93_103,1,0,103,103,8
38,r_0_115_106,seq1,seq114,r_0_115_106,0.99,0,106,106,8
43,r_120_149_58,seq122,seq148,r_120_149_58,0.99,1,59,58,8
26,r_81_40_57,seq80,r_102_42_36,r_81_40_57,1,0,57,57,8
27,r_128_50_36,seq122,seq51,r_128_50_36,1,0,36,36,8
28,r_56_82_49,seq55,seq80,r_56_82_49,1,0,49,49,8
90,seq95,seq121,r_41_94_173,r_41_94_173,0.55,0,173,173,8
44,r_74_22_179,r_71_124_188,r_49_23_102,r_74_22_179,0.97,0,179,179,8
22,r_117_5_90,r_119_6_174,r_45_2_33,r_117_5_90,0.93,0,90,90,8
49,r_116_63_58,r_110_134_117,r_64_138_80,r_116_63_58,0.46,1,59,58,8
44,r_74_22_179,r_75_92_129,r_71_124_188,r_75_92_129,0.92,0,129,129,8
79,seq70,r_69_89_137,r_71_124_188,r_69_89_137,0.76,0,137,137,8
64,seq27,seq29,r_118_28_18,r_118_28_18,1,26,44,18,8
40,r_127_71_12,seq73,r_93_76_150,r_93_76_150,0.98,3,153,150,9
51,seq3,r_4_34_160,seq1,r_4_34_160,0.53,-35,125,160,9
36,r_98_116_62,r_99_96_45,r_38_117_10,r_98_116_62,1,0,62,62,9
14,r_107_20_76,r_104_109_9,r_78_19_63,r_107_20_76,0.91,0,76,76,9
8,r_4_34_160,seq3,r_83_36_64,r_4_34_160,0.84,1,161,160,9
45,r_137_103_14,seq138,r_104_109_9,r_137_103_14,1,0,14,14,9
40,r_127_71_12,r_136_124_82,seq73,r_127_71_12,0.91,0,12,12,9
80,seq62,r_75_55_167,seq63,r_75_55_167,0.72,-133,34,167,9
54,seq9,r_7_126_142,seq13,r_7_126_142,0.99,-1,141,142,9
86,seq73,seq67,r_129_72_137,r_129_72_137,0.98,8,145,137,9
21,r_22_74_111,seq21,r_75_55_167,r_22_74_111,0.64,0,111,111,9
1,r_23_64_123,seq24,seq63,r_23_64_123,0.52,0,123,123,9
5,r_41_50_129,r_132_40_1,seq51,r_41_50_129,0.53,0,129,129,9
46,r_132_40_1,r_41_50_129,seq42,r_41_50_129,0.46,0,129,129,9
32,r_27_82_59,r_88_79_188,r_46_81_112,r_27_82_59,0.72,72,131,59,9
69,seq37,seq39,r_83_36_64,r_83_36_64,1,17,81,64,9
19,r_139_12_117,r_141_97_117,seq13,r_139_12_117,0.97,0,117,117,9
9,r_45_119_48,seq42,seq118,r_45_119_48,1,0,48,48,9
25,r_59_60_163,seq56,r_147_58_40,r_147_58_40,1,7,47,40,9
12,r_146_49_31,r_145_16_124,seq51,r_146_49_31,0.97,0,31,31,9
3,r_91_123_84,r_88_79_188,r_45_119_48,r_88_79_188,1,-104,84,188,9
26,r_87_131_65,r_88_79_188,r_129_72_137,r_87_131_65,1,0,65,65,9
11,r_18_135_26,r_23_64_123,r_130_133_18,r_18_135_26,1,0,26,26,9
48,r_78_19_63,r_23_64_123,r_107_20_76,r_23_64_123,0.89,-6,117,123,9
4,r_145_16_124,seq144,seq17,r_145_16_124,0.99,0,124,124,9
0,r_7_126_142,seq9,seq125,r_7_126_142,0.56,0,142,142,9
50,seq1,r_0_61_64,seq3,r_0_61_64,1,-11,53,64,9
20,r_8_11_101,seq9,seq10,r_8_11_101,0.58,-2,99,101,9
13,r_100_142_160,r_101_6_182,seq148,r_101_6_182,0.55,-22,160,182,9
98,seq125,r_122_140_111,r_136_124_82,r_136_124_82,0.47,3,85,82,9
15,r_141_97_117,r_139_12_117,r_99_96_45,r_139_12_117,0.61,0,117,117,9
48,r_78_19_63,seq77,r_23_64_123,r_78_19_63,0.89,6,69,63,9
16,r_147_58_40,seq144,r_59_60_163,r_147_58_40,1,0,40,40,9
6,r_121_80_126,seq118,r_75_55_167,r_121_80_126,0.92,0,126,126,9
62,seq21,r_22_74_111,seq25,r_22_74_111,1,0,111,111,9
2,r_129_72_137,r_87_131_65,seq73,r_129_72_137,1,0,137,137,9
52,seq5,r_8_11_101,r_101_6_182,r_101_6_182,0.65,0,182,182,9
27,r_28_68_139,seq29,seq67,r_28_68_139,0.9,0,139,139,9
39,r_84_106_20,r_91_123_84,r_104_109_9,r_91_123_84,0.87,-61,23,84,9
87,seq77,r_88_79_188,r_121_80_126,r_121_80_126,0.95,4,130,126,9
42,r_94_66_45,seq95,seq67,r_94_66_45,0.95,0,45,45,9
2,r_129_72_137,r_128_43_76,r_87_131_65,r_129_72_137,1,-71,66,137,9
47,r_0_61_64,seq1,r_147_58_40,r_0_61_64,1,0,64,64,9
29,r_92_35_115,r_88_79_188,r_83_36_64,r_88_79_188,0.87,-70,118,188,9
24,r_83_36_64,r_91_123_84,seq37,r_91_123_84,0.75,-20,64,84,9
10,r_105_52_47,r_107_20_76,seq54,r_105_52_47,0.91,-3,44,47,9
32,r_27_82_59,r_23_64_123,r_88_79_188,r_27_82_59,0.9,1,60,59,9
76,seq54,r_75_55_167,r_105_52_47,r_105_52_47,0.96,-11,36,47,9
97,seq118,r_122_140_111,r_45_119_48,r_45_119_48,0.86,0,48,48,9
37,r_2_32_27,seq3,seq31,r_2_32_27,1,0,27,27,9
34,r_93_76_150,r_99_96_45,r_147_58_40,r_147_58_40,0.99,110,150,40,9
90,seq95,r_94_66_45,r_99_96_45,r_94_66_45,0.63,-2,43,45,9
60,seq17,seq15,r_145_16_124,r_145_16_124,1,32,156,124,9
81,seq63,seq65,r_23_64_123,r_23_64_123,0.58,12,135,123,9
17,r_122_140_111,r_121_80_126,seq144,r_122_140_111,1,0,111,111,9
26,r_87_131_65,r_129_72_137,r_18_135_26,r_129_72_137,1,0,137,137,9
28,r_136_124_82,seq134,r_45_119_48,r_136_124_82,0.99,0,82,82,9
49,r_46_81_112,seq47,r_27_82_59,r_27_82_59,0.55,55,114,59,9
33,r_38_117_10,seq37,seq118,r_38_117_10,0.98,0,10,10,9
44,r_89_120_92,r_88_79_188,r_91_123_84,r_88_79_188,1,-96,92,188,9
35,r_99_96_45,r_98_116_62,seq95,r_98_116_62,1,-19,43,62,9
23,r_128_43_76,r_129_72_137,seq42,r_128_43_76,0.54,0,76,76,9
79,seq138,r_145_16_124,seq149,r_145_16_124,0.95,3,127,124,9
68,seq31,r_28_68_139,r_2_32_27,r_2_32_27,0.99,7,34,27,9
83,seq67,seq65,r_94_66_45,r_94_66_45,0.98,7,52,45,9
30,r_124_31_107,r_125_15_171,seq30,r_124_31_107,1,0,107,107,10
36,r_35_22_3,r_23_67_101,r_2_17_100,r_2_17_100,0.61,1,101,100,10
96,seq140,r_68_138_83,r_92_139_113,r_92_139_113,0.94,26,139,113,10
14,r_127_133_182,r_128_87_108,r_147_129_3,r_128_87_108,0.93,0,108,108,10
43,r_2_17_100,r_1_48_72,r_20_3_51,r_2_17_100,0.91,-28,72,100,10
21,r_90_107_92,r_92_139_113,seq109,r_90_107_92,1,0,92,92,10
39,r_32_146_73,seq30,r_44_145_8,r_32_146_73,1,0,73,73,10
97,seq115,r_114_83_99,seq113,r_114_83_99,1,-7,92,99,10
5,r_79_123_179,seq76,r_147_129_3,r_147_129_3,0.92,174,177,3,10
16,r_42_134_13,seq61,seq135,r_42_134_13,1,0,13,13,10
69,seq58,r_59_122_134,seq62,r_59_122_134,0.7,0,134,134,10
45,r_27_24_130,r_29_57_177,r_106_33_124,r_106_33_124,0.98,10,134,124,10
23,r_21_4_69,seq6,r_121_5_104,r_121_5_104,1,13,117,104,10
24,r_80_28_115,r_29_57_177,r_106_33_124,r_29_57_177,0.62,0,177,177,10
19,r_120_0_93,r_121_5_104,r_20_3_51,r_20_3_51,0.98,42,93,51,10
59,seq30,seq36,r_124_31_107,r_124_31_107,1,3,110,107,10
31,r_125_15_171,r_124_31_107,r_127_133_182,r_124_31_107,1,0,107,107,10
41,r_101_77_73,seq100,seq76,r_101_77_73,1,0,73,73,10
3,r_106_33_124,seq109,r_124_31_107,r_106_33_124,0.8,0,124,124,10
10,r_75_85_105,seq73,r_101_77_73,r_101_77_73,1,35,108,73,10
90,seq105,r_104_51_104,seq118,r_104_51_104,0.99,0,104,104,10
40,r_102_55_28,seq110,seq54,r_102_55_28,0.99,0,28,28,10
37,r_108_136_59,r_106_33_124,seq135,r_108_136_59,0.98,0,59,59,10
26,r_10_141_67,r_8_26_192,seq142,r_10_141_67,1,0,67,67,10
4,r_50_14_147,r_52_45_176,r_132_13_83,r_50_14_147,0.67,0,147,147,10
59,seq30,r_32_146_73,seq36,r_32_146_73,1,-18,55,73,10
0,r_7_149_90,seq6,seq144,r_7_149_90,0.99,0,90,90,10
11,r_121_5_104,seq118,r_21_4_69,r_121_5_104,1,0,104,104,10
20,r_34_97_117,seq30,seq91,r_34_97_117,0.69,0,117,117,10
98,seq118,r_120_0_93,r_117_95_168,r_120_0_93,1,0,93,93,10
2,r_29_57_177,r_80_28_115,r_104_51_104,r_29_57_177,0.82,1,178,177,10
27,r_92_139_113,seq91,seq140,r_92_139_113,0.9,2,115,113,10
2,r_29_57_177,r_27_24_130,r_80_28_115,r_29_57_177,0.36,-46,131,177,10
47,r_59_122_134,seq58,seq118,r_59_122_134,0.95,0,134,134,10
29,r_68_138_83,seq76,seq140,r_68_138_83,1,0,83,83,10
24,r_80_28_115,r_79_123_179,r_29_57_177,r_80_28_115,0.78,1,116,115,10
25,r_19_137_71,r_18_78_163,seq140,r_19_137_71,1,0,71,71,10
33,r_147_129_3,r_130_119_143,r_127_133_182,r_130_119_143,0.56,1,144,143,10
32,r_128_87_108,r_127_133_182,r_101_77_73,r_128_87_108,0.88,0,108,108,10
43,r_2_17_100,r_20_3_51,r_35_22_3,r_2_17_100,1,0,100,100,10
38,r_18_78_163,r_35_22_3,r_75_85_105,r_75_85_105,0.46,55,160,105,10
17,r_94_43_124,r_35_22_3,r_52_45_176,r_35_22_3,0.67,170,173,3,10
18,r_148_116_36,seq144,seq118,r_148_116_36,0.98,2,38,36,10
17,r_94_43_124,r_79_123_179,r_35_22_3,r_79_123_179,0.96,-20,159,179,10
17,r_94_43_124,r_93_41_133,r_79_123_179,r_79_123_179,0.79,-63,116,179,10
9,r_130_119_143,r_147_129_3,r_59_122_134,r_59_122_134,0.78,10,144,134,10
96,seq140,seq135,r_68_138_83,r_68_138_83,0.95,3,86,83,10
31,r_125_15_171,r_127_133_182,r_50_14_147,r_50_14_147,0.69,24,171,147,10
22,r_89_86_137,seq91,r_75_85_105,r_89_86_137,0.26,0,137,137,10
48,r_20_3_51,r_2_17_100,r_120_0_93,r_20_3_51,0.97,49,100,51,10
49,r_52_45_176,seq54,r_94_43_124,r_52_45_176,0.28,0,176,176,10
7,r_23_67_101,r_35_22_3,r_101_77_73,r_101_77_73,0.77,29,102,73,10
44,r_70_46_53,r_75_85_105,r_102_55_28,r_70_46_53,0.67,11,64,53,10
23,r_21_4_69,r_19_137_71,seq6,r_21_4_69,1,0,69,69,10
35,r_1_48_72,r_2_17_100,seq47,r_1_48_72,0.63,0,72,72,10
12,r_132_13_83,seq131,seq16,r_132_13_83,0.99,1,84,83,10
48,r_20_3_51,r_21_4_69,r_2_17_100,r_2_17_100,0.94,-49,51,100,10
84,seq91,r_92_139_113,seq98,r_92_139_113,0.93,2,115,113,10
14,r_49_144_137,r_55_67_56,r_124_50_29,r_124_50_29,0.67,0,29,29,11
30,r_85_20_140,seq87,seq16,r_85_20_140,0.86,1,141,140,11
48,r_135_83_30,r_136_141_78,seq87,r_135_83_30,1,0,30,30,11
39,r_119_110_2,seq106,r_18_108_111,r_18_108_111,0.98,6,117,111,11
43,r_103_69_132,seq102,seq72,r_103_69_132,1,0,132,132,11
13,r_96_62_42,r_105_134_186,seq63,r_96_62_42,1,1,43,42,11
59,seq16,r_18_108_111,seq13,r_18_108_111,1,0,111,111,11
55,seq10,r_9_89_140,seq2,r_9_89_140,1,0,140,140,11
16,r_38_17_148,seq31,seq16,r_38_17_148,0.9,0,148,148,11
21,r_70_104_71,r_71_130_79,seq102,r_70_104_71,0.94,0,71,71,11
39,r_119_110_2,r_103_69_132,seq106,r_103_69_132,0.5,-50,82,132,11
34,r_84_43_42,r_85_20_140,r_45_121_114,r_84_43_42,0.99,0,42,42,11
1,r_44_26_152,r_45_121_114,r_84_43_42,r_44_26_152,0.97,-39,113,152,11
5,r_19_75_79,r_11_53_153,seq77,r_19_75_79,1,0,79,79,11
46,r_18_108_111,seq16,r_119_110_2,r_18_108_111,1,0,111,111,11
42,r_9_89_140,seq10,r_98_81_13,r_9_89_140,0.99,0,140,140,11
32,r_136_141_78,r_147_46_165,r_113_142_134,r_136_141_78,0.87,82,160,78,11
69,seq47,r_48_39_149,r_124_50_29,r_124_50_29,0.9,122,151,29,11
45,r_25_148_92,seq28,seq145,r_25_148_92,0.97,0,92,92,11
74,seq63,seq65,r_96_62_42,r_96_62_42,1,2,44,42,11
0,r_23_132_139,r_147_46_165,r_149_131_151,r_23_132_139,0.92,12,151,139,11
19,r_45_121_114,r_44_26_152,seq122,r_45_121_114,1,0,114,114,11
69,seq47,r_124_50_29,r_147_46_165,r_147_46_165,0.5,13,178,165,11
26,r_149_131_151,r_25_148_92,r_23_132_139,r_23_132_139,0.78,12,151,139,11
31,r_95_4_60,r_105_134_186,seq3,r_95_4_60,1,0,60,60,11
89,seq102,r_103_69_132,r_70_104_71,r_70_104_71,0.64,61,132,71,11
26,r_149_131_151,r_147_46_165,r_25_148_92,r_25_148_92,0.97,12,104,92,11
14,r_49_144_137,r_124_50_29,r_113_142_134,r_49_144_137,0.93,0,137,137,11
4,r_27_1_112,seq28,seq5,r_27_1_112,0.65,0,112,112,11
0,r_23_132_139,seq28,r_147_46_165,r_23_132_139,0.48,-2,137,139,11
38,r_90_52_28,seq91,seq51,r_90_52_28,1,1,29,28,11
11,r_74_137_196,seq77,r_105_134_186,r_105_134_186,0.49,10,196,186,11
3,r_98_81_13,seq97,seq80,r_98_81_13,0.81,0,13,13,11
1,r_44_26_152,r_84_43_42,seq28,r_44_26_152,1,0,152,152,11
20,r_71_130_79,r_73_6_139,seq128,r_71_130_79,0.97,0,79,79,11
25,r_24_116_33,r_27_1_112,seq114,r_24_116_33,1,0,33,33,11
15,r_15_40_77,r_18_108_111,seq31,r_15_40_77,0.97,0,77,77,11
27,r_55_67_56,r_54_22_204,r_73_6_139,r_55_67_56,0.98,0,56,56,11
9,r_86_125_13,r_85_20_140,seq128,r_86_125_13,0.85,0,13,13,11
10,r_124_50_29,r_49_144_137,r_90_52_28,r_49_144_137,0.95,2,139,137,11
72,seq57,r_59_143_193,seq56,r_59_143_193,0.99,0,193,193,11
36,r_93_78_27,r_94_109_192,seq79,r_93_78_27,0.82,0,27,27,11
22,r_59_143_193,seq57,r_113_142_134,r_59_143_193,0.61,0,193,193,11
2,r_113_142_134,seq114,r_136_141_78,r_113_142_134,0.81,2,136,134,11
10,r_124_50_29,seq128,r_49_144_137,r_124_50_29,0.99,0,29,29,11
40,r_58_101_109,r_59_143_193,r_70_104_71,r_59_143_193,1,-83,110,193,11
18,r_138_68_143,seq139,r_103_69_132,r_138_68_143,0.89,0,143,143,11
29,r_21_66_77,r_25_148_92,r_55_67_56,r_21_66_77,0.99,1,78,77,11
24,r_11_53_153,seq12,seq51,r_11_53_153,0.85,0,153,153,11
27,r_55_67_56,r_73_6_139,r_21_66_77,r_55_67_56,0.8,43,99,56,11
58,seq13,r_14_64_194,r_38_17_148,r_38_17_148,0.95,43,191,148,11
70,seq51,r_54_22_204,r_90_52_28,r_90_52_28,1,88,116,28,11
32,r_136_141_78,seq133,r_147_46_165,r_136_141_78,0.4,-5,73,78,11
90,seq106,r_107_61_36,r_119_110_2,r_107_61_36,0.94,0,36,36,11
6,r_107_61_36,seq106,seq60,r_107_61_36,1,0,36,36,11
45,r_25_148_92,seq145,r_113_142_134,r_113_142_134,0.99,53,187,134,11
22,r_59_143_193,r_58_101_109,seq57,r_58_101_109,1,0,109,109,11
34,r_84_43_42,r_45_121_114,r_35_42_73,r_45_121_114,0.98,-34,80,114,11
49,r_35_42_73,seq33,r_84_43_42,r_84_43_42,1,31,73,42,11
7,r_37_8_96,r_38_17_148,r_95_4_60,r_95_4_60,0.69,36,96,60,11
44,r_73_6_139,seq72,seq5,r_73_6_139,0.78,0,139,139,11
23,r_0_32_99,r_9_89_140,seq31,r_0_32_99,0.99,1,100,99,11
12,r_48_39_149,seq47,r_15_40_77,r_48_39_149,0.83,0,149,149,11
14,r_51_145_142,seq52,seq149,r_51_145_142,0.94,0,142,142,12
54,seq6,r_5_135_57,seq3,r_5_135_57,1,0,57,57,12
8,r_24_12_97,r_31_108_172,r_9_13_81,r_24_12_97,1,0,97,97,12
43,r_28_73_162,r_31_108_172,r_83_76_92,r_28_73_162,0.51,0,162,162,12
59,seq14,seq18,r_65_15_87,r_65_15_87,1,1,88,87,12
71,seq128,r_125_133_152,r_82_127_91,r_82_127_91,1,61,152,91,12
16,r_60_16_125,r_61_26_121,seq14,r_60_16_125,0.91,1,126,125,12
21,r_140_33_75,seq141,seq34,r_140_33_75,0.99,0,75,75,12
39,r_97_78_107,seq98,seq77,r_97_78_107,0.75,1,108,107,12
1,r_40_87_129,seq38,r_67_85_114,r_40_87_129,0.7,0,129,129,12
5,r_66_22_2,r_21_99_105,seq18,r_21_99_105,0.98,1,106,105,12
46,r_67_85_114,seq70,seq86,r_67_85_114,0.43,0,114,114,12
42,r_131_134_160,r_130_41_77,r_5_135_57,r_131_134_160,1,-83,77,160,12
45,r_42_89_166,r_43_94_174,r_120_104_59,r_42_89_166,0.41,0,166,166,12
19,r_57_48_163,seq59,seq49,r_57_48_163,0.77,0,163,163,12
66,seq34,seq36,r_140_33_75,r_140_33_75,1,33,108,75,12
12,r_63_47_31,r_65_15_87,r_45_20_106,r_63_47_31,1,0,31,31,12
41,r_8_126_143,r_7_124_120,r_44_11_89,r_44_11_89,0.81,17,106,89,12
3,r_100_142_76,seq101,seq143,r_100_142_76,1,0,76,76,12
41,r_8_126_143,r_44_11_89,r_82_127_91,r_8_126_143,1,0,143,143,12
10,r_23_118_83,r_24_12_97,seq119,r_23_118_83,1,4,87,83,12
26,r_109_84_171,r_106_93_149,r_40_87_129,r_40_87_129,1,41,170,129,12
7,r_5_135_57,seq6,seq132,r_5_135_57,1,0,57,57,12
0,r_130_41_77,r_131_134_160,r_43_94_174,r_130_41_77,1,0,77,77,12
63,seq149,r_148_96_170,r_51_145_142,r_51_145_142,0.86,28,170,142,12
11,r_7_124_120,r_8_126_143,r_144_17_57,r_144_17_57,1,40,97,57,12
11,r_7_124_120,r_144_17_57,r_82_127_91,r_7_124_120,0.98,0,120,120,12
85,seq86,r_81_46_126,r_64_27_170,r_81_46_126,0.37,-108,18,126,12
20,r_35_146_154,seq34,r_51_145_142,r_35_146_154,0.89,0,154,154,12
98,seq119,r_120_104_59,r_23_118_83,r_23_118_83,1,4,87,83,12
15,r_148_96_170,seq149,r_106_93_149,r_106_93_149,0.67,21,170,149,12
48,r_64_27_170,seq62,r_90_29_22,r_90_29_22,0.73,148,170,22,12
12,r_63_47_31,r_45_20_106,r_130_41_77,r_63_47_31,0.96,75,106,31,12
37,r_45_20_106,r_44_11_89,r_63_47_31,r_63_47_31,0.76,6,37,31,12
6,r_9_13_81,r_8_126_143,r_24_12_97,r_9_13_81,0.95,16,97,81,12
62,seq19,seq10,r_45_20_106,r_45_20_106,1,1,107,106,12
99,seq123,seq128,r_82_127_91,r_82_127_91,1,49,140,91,12
0,r_130_41_77,r_43_94_174,r_63_47_31,r_43_94_174,0.9,1,175,174,12
27,r_81_46_126,seq80,seq72,r_81_46_126,0.49,-55,71,126,12
18,r_82_127_91,r_83_76_92,r_125_133_152,r_82_127_91,1,0,91,91,12
29,r_106_93_149,r_109_84_171,seq91,r_109_84_171,0.65,-6,165,171,12
27,r_81_46_126,seq72,r_63_47_31,r_81_46_126,1,0,126,126,12
24,r_83_76_92,r_82_127_91,seq75,r_82_127_91,0.94,0,91,91,12
33,r_65_15_87,r_64_27_170,seq14,r_65_15_87,0.96,0,87,87,12
36,r_90_29_22,r_109_84_171,seq30,r_109_84_171,0.7,-149,22,171,12
12,r_63_47_31,r_130_41_77,r_81_46_126,r_81_46_126,1,4,130,126,12
64,seq132,r_131_134_160,r_5_135_57,r_5_135_57,1,18,75,57,12
85,seq86,r_64_27_170,r_67_85_114,r_67_85_114,0.68,1,115,114,12
65,seq30,r_31_108_172,r_90_29_22,r_90_29_22,0.95,150,172,22,12
61,seq18,seq14,r_144_17_57,r_144_17_57,1,16,73,57,12
32,r_39_2_123,r_40_87_129,seq3,r_39_2_123,1,0,123,123,12
38,r_61_26_121,r_60_16_125,r_138_25_9,r_60_16_125,0.63,-4,121,125,12
81,seq75,seq79,r_83_76_92,r_83_76_92,0.95,22,114,92,12
17,r_71_112_92,seq70,seq115,r_71_112_92,0.87,3,95,92,12
2,r_144_17_57,r_140_33_75,seq18,r_144_17_57,0.97,0,57,57,12
37,r_45_20_106,r_63_47_31,seq19,r_45_20_106,1,0,106,106,12
22,r_113_53_54,seq116,seq54,r_113_53_54,0.62,40,94,54,12
2,r_144_17_57,r_148_96_170,r_140_33_75,r_140_33_75,0.48,-37,38,75,12
28,r_110_117_94,seq111,r_23_118_83,r_23_118_83,1,11,94,83,12
49,r_125_133_152,seq128,r_82_127_91,r_82_127_91,1,9,100,91,12
56,seq10,r_8_126_143,r_44_11_89,r_44_11_89,0.8,15,104,89,12
18,r_82_127_91,r_125_133_152,r_8_126_143,r_82_127_91,0.88,62,153,91,12
44,r_21_99_105,r_66_22_2,seq95,r_21_99_105,0.84,0,105,105,12
13,r_129_69_28,seq128,seq68,r_129_69_28,1,0,28,28,12
49,r_125_133_152,r_82_127_91,r_131_134_160,r_125_133_152,1,0,152,152,12
84,seq80,r_81_46_126,seq72,r_81_46_126,0.99,-53,73,126,12
40,r_103_111_62,r_110_55_140,r_1_107_105,r_103_111_62,0.87,60,122,62,13
30,r_110_55_140,seq112,r_1_107_105,r_1_107_105,1,8,113,105,13
47,r_113_14_38,r_115_130_141,r_13_12_109,r_113_14_38,1,-1,37,38,13
12,r_34_8_124,r_6_58_162,r_120_7_137,r_6_58_162,1,0,162,162,13
6,r_91_5_32,r_90_118_74,r_6_58_162,r_91_5_32,0.96,0,32,32,13
14,r_148_72_174,r_149_59_179,r_135_69_90,r_149_59_179,0.76,-6,173,179,13
54,seq139,r_140_109_153,seq142,r_140_109_153,0.73,0,153,153,13
37,r_40_106_182,seq39,r_89_114_37,r_89_114_37,0.65,145,182,37,13
16,r_75_15_108,seq77,r_113_14_38,r_75_15_108,0.91,0,108,108,13
21,r_132_71_143,r_145_131_6,r_135_69_90,r_145_131_6,0.48,137,143,6,13
39,r_0_128_121,seq2,r_144_127_48,r_0_128_121,0.95,0,121,121,13
1,r_52_99_161,seq53,r_74_98_106,r_52_99_161,0.54,0,161,161,13
46,r_145_131_6,r_132_71_143,r_115_130_141,r_115_130_141,0.5,1,142,141,13
42,r_97_79_186,seq101,seq80,r_97_79_186,0.35,0,186,186,13
34,r_19_42_15,seq20,seq43,r_19_42_15,0.86,0,15,15,13
45,r_38_22_119,r_40_106_182,seq21,r_38_22_119,0.85,2,121,119,13
19,r_90_118_74,seq86,seq117,r_90_118_74,0.69,0,74,74,13
18,r_126_25_18,r_125_121_55,seq26,r_126_25_18,1,0,18,18,13
27,r_133_85_176,r_149_59_179,r_28_84_18,r_149_59_179,0.54,-6,173,179,13
5,r_93_54_37,seq92,r_56_83_158,r_93_54_37,1,0,37,37,13
31,r_149_59_179,seq146,r_137_60_167,r_149_59_179,0.56,0,179,179,13
10,r_123_67_174,r_120_7_137,r_125_121_55,r_123_67_174,0.95,-90,84,174,13
8,r_125_121_55,seq124,r_123_67_174,r_125_121_55,0.93,0,55,55,13
26,r_120_7_137,r_123_67_174,r_34_8_124,r_120_7_137,0.99,0,137,137,13
4,r_82_4_91,seq81,seq3,r_82_4_91,1,0,91,91,13
2,r_56_83_158,seq53,r_93_54_37,r_93_54_37,1,1,38,37,13
63,seq24,r_23_108_167,r_105_29_137,r_105_29_137,0.97,30,167,137,13
20,r_115_130_141,seq112,r_145_131_6,r_115_130_141,0.87,0,141,141,13
15,r_23_108_167,seq24,r_89_114_37,r_23_108_167,0.73,0,167,167,13
48,r_74_98_106,seq73,seq101,r_74_98_106,0.92,0,106,106,13
11,r_135_69_90,r_136_70_59,r_138_122_184,r_136_70_59,0.85,-10,49,59,13
0,r_33_88_26,r_34_8_124,r_28_84_18,r_33_88_26,0.6,0,26,26,13
2,r_56_83_158,r_93_54_37,seq81,r_56_83_158,0.82,0,158,158,13
5,r_93_54_37,r_56_83_158,r_110_55_140,r_93_54_37,0.47,121,158,37,13
10,r_123_67_174,r_125_121_55,r_135_69_90,r_123_67_174,0.67,0,174,174,13
27,r_133_85_176,r_141_102_85,r_149_59_179,r_141_102_85,0.62,-4,81,85,13
44,r_36_18_32,r_34_8_124,seq21,r_36_18_32,0.96,0,32,32,13
30,r_110_55_140,r_1_107_105,r_93_54_37,r_110_55_140,0.93,0,140,140,13
40,r_103_111_62,seq104,r_110_55_140,r_103_111_62,0.81,0,62,62,13
29,r_119_94_143,seq117,seq92,r_119_94_143,0.6,0,143,143,13
24,r_96_51_165,seq101,seq50,r_96_51_165,0.72,0,165,165,13
25,r_35_27_169,seq32,r_105_29_137,r_105_29_137,0.82,34,171,137,13
28,r_144_127_48,seq142,r_132_71_143,r_144_127_48,0.82,0,48,48,13
33,r_138_122_184,r_137_60_167,r_129_134_91,r_129_134_91,0.85,70,161,91,13
17,r_28_84_18,seq24,seq86,r_28_84_18,1,0,18,18,13
43,r_13_12_109,r_11_46_183,r_113_14_38,r_113_14_38,1,-1,37,38,13
6,r_91_5_32,r_6_58_162,r_34_8_124,r_91_5_32,0.51,112,144,32,13
23,r_6_58_162,r_0_128_121,r_91_5_32,r_91_5_32,0.9,1,33,32,13
32,r_129_134_91,r_132_71_143,r_138_122_184,r_129_134_91,0.73,0,91,91,13
38,r_140_109_153,seq139,r_89_114_37,r_140_109_153,0.89,0,153,153,13
77,seq53,r_56_83_158,r_93_54_37,r_93_54_37,0.9,121,158,37,13
33,r_138_122_184,r_129_134_91,r_125_121_55,r_129_134_91,0.45,87,178,91,13
99,seq124,r_125_121_55,r_145_131_6,r_125_121_55,0.98,-7,48,55,13
9,r_1_107_105,seq2,r_103_111_62,r_1_107_105,1,1,106,105,13
96,seq112,r_110_55_140,r_89_114_37,r_110_55_140,0.69,-28,112,140,13
11,r_135_69_90,r_138_122_184,seq68,r_135_69_90,0.99,0,90,90,13
28,r_144_127_48,r_132_71_143,r_0_128_121,r_0_128_121,0.75,10,131,121,13
49,r_141_102_85,seq142,seq101,r_141_102_85,0.92,6,91,85,13
7,r_105_29_137,r_119_94_143,r_126_25_18,r_105_29_137,0.97,0,137,137,13
41,r_100_76_31,r_97_79_186,seq68,r_100_76_31,0.98,0,31,31,13
3,r_89_114_37,r_90_118_74,seq112,r_89_114_37,0.87,0,37,37,13
35,r_11_46_183,r_13_12_109,r_19_42_15,r_19_42_15,0.73,168,183,15,13
12,r_34_8_124,r_35_27_169,r_6_58_162,r_35_27_169,0.47,-44,125,169,13
23,r_6_58_162,r_91_5_32,seq61,r_91_5_32,0.36,130,162,32,13
4,r_29_109_22,r_45_127_149,seq111,r_29_109_22,0.96,0,22,22,14
3,r_36_117_92,r_59_115_58,r_8_116_121,r_8_116_121,1,0,121,121,14
92,seq107,r_106_50_127,seq101,r_106_50_127,1,1,128,127,14
16,r_103_54_106,seq101,seq53,r_103_54_106,0.99,0,106,106,14
21,r_130_125_187,seq131,r_110_129_48,r_110_129_48,1,69,117,48,14
39,r_75_15_65,seq72,seq17,r_75_15_65,1,0,65,65,14
97,seq120,seq119,r_146_121_84,r_146_121_84,0.98,30,114,84,14
5,r_143_95_134,seq141,seq96,r_143_95_134,0.93,0,134,134,14
46,r_38_62_7,r_61_136_181,seq60,r_61_136_181,0.62,0,181,181,14
42,r_70_73_70,seq67,seq72,r_70_73_70,0.94,0,70,70,14
45,r_88_55_104,r_87_133_113,seq53,r_88_55_104,0.75,0,104,104,14
19,r_105_114_150,seq107,r_8_116_121,r_8_116_121,0.98,29,150,121,14
30,r_18_40_27,seq17,seq39,r_18_40_27,0.99,0,27,27,14
40,r_76_128_34,r_75_15_65,seq123,r_76_128_34,1,0,34,34,14
38,r_2_37_151,r_4_100_167,r_118_41_72,r_2_37_151,1,0,151,151,14
9,r_56_5_130,r_4_100_167,r_24_6_170,r_56_5_130,0.98,35,165,130,14
31,r_4_100_167,r_2_37_151,r_56_5_130,r_56_5_130,0.69,0,130,130,14
26,r_21_11_162,r_24_6_170,r_98_12_90,r_21_11_162,0.56,0,162,162,14
0,r_112_58_72,r_118_41_72,seq57,r_112_58_72,0.9,0,72,72,14
73,seq57,r_70_73_70,r_56_5_130,r_56_5_130,0.58,-67,63,130,14
1,r_139_10_58,seq17,r_98_12_90,r_98_12_90,1,1,91,90,14
20,r_3_148_76,r_2_37_151,r_122_149_44,r_3_148_76,1,0,76,76,14
13,r_92_140_159,seq93,seq141,r_92_140_159,0.72,0,159,159,14
15,r_90_84_152,r_91_31_166,seq86,r_91_31_166,0.92,0,166,166,14
48,r_97_7_66,seq96,seq9,r_97_7_66,1,0,66,66,14
85,seq89,r_87_133_113,r_90_84_152,r_87_133_113,1,0,113,113,14
74,seq60,r_59_115_58,r_38_62_7,r_59_115_58,0.99,-22,36,58,14
27,r_1_65_163,seq0,seq66,r_1_65_163,0.88,0,163,163,14
35,r_110_129_48,seq111,r_130_125_187,r_110_129_48,1,0,48,48,14
88,seq96,r_97_7_66,seq94,r_97_7_66,1,-27,39,66,14
18,r_145_34_74,r_146_121_84,seq35,r_145_34_74,1,0,74,74,14
1,r_139_10_58,r_143_95_134,seq17,r_139_10_58,0.93,0,58,58,14
29,r_142_14_74,r_143_95_134,r_75_15_65,r_142_14_74,1,0,74,74,14
24,r_98_12_90,seq99,r_139_10_58,r_98_12_90,0.91,0,90,90,14
25,r_8_116_121,seq9,r_36_117_92,r_8_116_121,0.99,0,121,121,14
33,r_27_33_140,seq26,r_52_32_44,r_27_33_140,0.53,0,140,140,14
64,seq35,seq46,r_145_34_74,r_145_34_74,1,16,90,74,14
58,seq17,seq13,r_75_15_65,r_75_15_65,1,3,68,65,14
70,seq51,r_49_78_191,r_106_50_127,r_106_50_127,0.86,25,152,127,14
31,r_4_100_167,r_56_5_130,seq101,r_4_100_167,0.98,0,167,167,14
61,seq23,r_24_6_170,r_126_22_72,r_126_22_72,1,60,132,72,14
38,r_2_37_151,r_3_148_76,r_4_100_167,r_3_148_76,1,-1,75,76,14
10,r_52_32_44,seq53,seq35,r_52_32_44,0.7,-2,42,44,14
14,r_59_115_58,r_29_109_22,r_36_117_92,r_36_117_92,0.88,3,95,92,14
17,r_132_30_119,seq131,r_52_32_44,r_132_30_119,1,0,119,119,14
14,r_59_115_58,seq60,r_29_109_22,r_59_115_58,0.97,0,58,58,14
9,r_56_5_130,seq53,r_4_100_167,r_56_5_130,0.71,0,130,130,14
22,r_87_133_113,seq89,seq131,r_87_133_113,0.98,0,113,113,14
28,r_118_41_72,r_112_58_72,r_18_40_27,r_118_41_72,0.91,0,72,72,14
37,r_102_63_31,r_103_54_106,seq68,r_102_63_31,1,0,31,31,14
49,r_91_31_166,r_90_84_152,r_52_32_44,r_91_31_166,0.67,0,166,166,14
7,r_146_121_84,seq147,seq120,r_146_121_84,0.92,0,84,84,14
44,r_126_22_72,seq123,seq23,r_126_22_72,1,0,72,72,14
23,r_106_50_127,seq107,seq51,r_106_50_127,0.81,1,128,127,14
94,seq111,r_29_109_22,r_105_114_150,r_105_114_150,0.87,16,166,150,14
43,r_122_149_44,r_126_22_72,seq147,r_126_22_72,0.65,-27,45,72,14
84,seq86,r_85_25_153,r_90_84_152,r_85_25_153,1,0,153,153,14
40,r_119_17_8,r_16_104_87,r_13_116_172,r_16_104_87,1,0,87,87,15
36,r_111_37_162,r_129_109_9,r_139_30_73,r_139_30_73,0.81,89,162,73,15
25,r_1_147_119,r_70_5_14,r_26_57_55,r_26_57_55,0.7,-12,43,55,15
14,r_67_98_183,seq66,r_65_68_87,r_67_98_183,0.3,-93,90,183,15
37,r_120_35_181,r_122_125_166,seq135,r_120_35_181,0.38,-32,149,181,15
16,r_139_30_73,seq140,seq31,r_139_30_73,1,0,73,73,15
21,r_142_28_128,r_143_51_195,r_139_30_73,r_139_30_73,0.58,55,128,73,15
39,r_81_2_141,r_86_84_61,r_80_0_57,r_86_84_61,0.44,80,141,61,15
1,r_65_68_87,r_67_98_183,seq66,r_67_98_183,0.27,0,183,183,15
70,seq38,r_29_11_181,r_100_39_19,r_100_39_19,1,10,29,19,15
80,seq66,r_67_98_183,r_65_68_87,r_67_98_183,0.27,-60,123,183,15
13,r_93_64_8,r_92_101_53,seq63,r_92_101_53,0.53,-40,13,53,15
20,r_99_78_17,r_97_43_50,seq77,r_99_78_17,0.8,3,20,17,15
45,r_115_22_164,r_114_112_153,r_139_30_73,r_139_30_73,0.97,91,164,73,15
19,r_16_104_87,r_119_17_8,seq103,r_16_104_87,0.9,0,87,87,15
33,r_102_75_92,seq103,r_92_101_53,r_92_101_53,0.98,1,54,53,15
30,r_97_43_50,seq96,seq47,r_97_43_50,0.96,0,50,50,15
53,seq6,seq4,r_70_5_14,r_70_5_14,0.99,-2,12,14,15
33,r_102_75_92,r_92_101_53,seq74,r_102_75_92,1,0,92,92,15
38,r_117_71_5,r_69_33_105,r_102_75_92,r_117_71_5,0.73,100,105,5,15
31,r_133_85_87,r_131_40_157,r_86_84_61,r_133_85_87,1,0,87,87,15
41,r_48_138_139,r_50_15_190,seq135,r_48_138_139,0.97,0,139,139,15
0,r_59_79_96,seq47,r_89_118_172,r_59_79_96,0.36,44,140,96,15
91,seq96,r_97_43_50,seq94,r_97_43_50,0.81,-4,46,50,15
5,r_124_7_33,r_123_45_181,r_126_10_9,r_124_7_33,0.97,0,33,33,15
8,r_56_49_166,r_26_57_55,seq44,r_26_57_55,0.53,111,166,55,15
35,r_100_39_19,seq103,seq38,r_100_39_19,0.83,0,19,19,15
92,seq103,r_102_75_92,r_92_101_53,r_92_101_53,0.94,1,54,53,15
4,r_58_121_68,r_59_79_96,r_122_125_166,r_58_121_68,0.99,0,68,68,15
0,r_59_79_96,r_61_149_175,seq47,r_61_149_175,0.68,-79,96,175,15
46,r_80_0_57,r_1_147_119,r_65_68_87,r_80_0_57,0.74,62,119,57,15
37,r_120_35_181,seq135,r_139_30_73,r_120_35_181,0.9,0,181,181,15
8,r_56_49_166,r_58_121_68,r_26_57_55,r_56_49_166,1,-115,51,166,15
49,r_26_57_55,r_56_49_166,r_105_55_2,r_56_49_166,0.77,0,166,166,15
4,r_58_121_68,r_122_125_166,r_1_147_119,r_1_147_119,1,52,171,119,15
57,seq141,r_143_51_195,r_58_121_68,r_58_121_68,1,101,169,68,15
12,r_123_45_181,seq135,r_56_49_166,r_123_45_181,0.69,0,181,181,15
18,r_20_76_33,r_29_11_181,r_99_78_17,r_20_76_33,0.99,-2,31,33,15
40,r_119_17_8,r_13_116_172,seq19,r_13_116_172,0.57,-35,137,172,15
48,r_92_101_53,seq94,seq103,r_92_101_53,0.97,0,53,53,15
25,r_1_147_119,r_80_0_57,seq145,r_1_147_119,1,0,119,119,15
26,r_69_33_105,r_70_5_14,r_117_71_5,r_69_33_105,0.82,-90,15,105,15
47,r_122_125_166,r_120_35_181,r_58_121_68,r_58_121_68,1,9,77,68,15
92,seq103,r_92_101_53,r_16_104_87,r_16_104_87,0.85,7,94,87,15
64,seq132,r_131_40_157,seq130,r_131_40_157,1,-49,108,157,15
46,r_80_0_57,r_81_2_141,r_1_147_119,r_80_0_57,0.99,0,57,57,15
46,r_80_0_57,r_65_68_87,r_81_2_141,r_65_68_87,0.52,54,141,87,15
58,seq14,r_13_116_172,r_119_17_8,r_13_116_172,0.86,0,172,172,15
3,r_70_5_14,r_69_33_105,seq6,r_70_5_14,0.56,1,15,14,15
0,r_59_79_96,r_89_118_172,r_102_75_92,r_89_118_172,0.85,0,172,172,15
34,r_131_40_157,seq132,r_100_39_19,r_131_40_157,0.65,0,157,157,15
9,r_86_84_61,seq82,r_133_85_87,r_133_85_87,1,0,87,87,15
26,r_69_33_105,r_117_71_5,seq31,r_69_33_105,0.92,0,105,105,15
79,seq63,r_58_121_68,r_93_64_8,r_58_121_68,0.97,-39,29,68,15
25,r_1_147_119,r_26_57_55,r_80_0_57,r_1_147_119,0.81,-62,57,119,15
22,r_29_11_181,seq31,r_124_7_33,r_124_7_33,1,144,177,33,15
49,r_26_57_55,r_29_11_181,r_56_49_166,r_26_57_55,1,-3,52,55,15
56,seq140,r_139_30_73,seq128,r_139_30_73,1,0,73,73,15
7,r_114_112_153,r_115_22_164,seq113,r_115_22_164,0.99,-10,154,164,15
23,r_50_15_190,r_48_138_139,seq44,r_48_138_139,0.98,0,139,139,15
84,seq82,r_81_2_141,r_133_85_87,r_133_85_87,0.95,6,93,87,15
93,seq112,r_114_96_118,r_44_121_47,r_44_121_47,1,16,63,47,16
30,r_98_105_75,r_116_102_4,seq110,r_98_105_75,0.66,0,75,75,16
38,r_69_4_34,r_67_54_118,seq5,r_69_4_34,0.99,0,34,34,16
47,r_106_8_19,seq107,seq10,r_106_8_19,0.99,0,19,19,16
9,r_72_93_152,r_21_73_41,r_58_89_53,r_72_93_152,0.67,0,152,152,16
37,r_70_68_145,r_72_93_152,r_1_149_74,r_1_149_74,0.92,84,158,74,16
16,r_1_149_74,r_0_117_194,r_38_148_62,r_1_149_74,0.71,0,74,74,16
21,r_17_77_145,r_20_52_190,seq75,r_17_77_145,0.87,0,145,145,16
1,r_132_19_77,r_95_131_7,seq16,r_132_19_77,1,0,77,77,16
97,seq125,r_124_80_152,seq122,r_124_80_152,0.75,0,152,152,16
42,r_95_131_7,r_132_19_77,seq134,r_132_19_77,0.99,0,77,77,16
29,r_67_54_118,r_69_4_34,r_72_93_152,r_69_4_34,0.79,-1,33,34,16
48,r_36_22_41,r_38_148_62,seq23,r_36_22_41,0.54,0,41,41,16
34,r_28_81_10,r_27_140_51,seq84,r_28_81_10,0.74,0,10,10,16
19,r_38_148_62,seq37,r_147_85_114,r_38_148_62,0.99,0,62,62,16
39,r_21_73_41,r_72_93_152,seq71,r_72_93_152,0.81,-4,148,152,16
41,r_64_92_84,seq65,seq87,r_64_92_84,1,0,84,84,16
37,r_70_68_145,r_1_149_74,r_31_74_26,r_70_68_145,0.37,35,180,145,16
3,r_20_52_190,r_17_77_145,r_83_13_3,r_17_77_145,1,0,145,145,16
72,seq50,r_62_138_116,seq65,r_62_138_116,0.79,-105,11,116,16
78,seq71,r_72_93_152,r_21_73_41,r_21_73_41,0.97,55,96,41,16
0,r_62_138_116,r_57_53_172,seq137,r_62_138_116,0.96,0,116,116,16
5,r_120_129_54,r_116_102_4,seq126,r_120_129_54,0.62,0,54,54,16
20,r_124_80_152,seq125,r_28_81_10,r_124_80_152,0.43,0,152,152,16
15,r_88_136_86,seq90,seq134,r_88_136_86,0.95,0,86,86,16
57,seq16,r_17_77_145,r_83_13_3,r_17_77_145,0.99,0,145,145,16
19,r_38_148_62,r_147_85_114,r_1_149_74,r_38_148_62,0.85,20,82,62,16
5,r_120_129_54,seq126,r_48_133_129,r_48_133_129,1,0,129,129,16
39,r_21_73_41,r_20_52_190,r_72_93_152,r_21_73_41,1,0,41,41,16
9,r_72_93_152,seq71,r_21_73_41,r_21_73_41,1,12,53,41,16
40,r_48_133_129,seq43,r_95_131_7,r_48_133_129,0.97,0,129,129,16
24,r_86_103_149,seq90,r_116_102_4,r_86_103_149,0.32,0,149,149,16
33,r_113_46_94,seq115,r_128_45_21,r_113_46_94,0.76,0,94,94,16
70,seq43,r_48_133_129,seq47,r_48_133_129,1,0,129,129,16
32,r_18_14_90,r_17_77_145,seq15,r_17_77_145,1,-54,91,145,16
8,r_31_74_26,seq30,seq75,r_31_74_26,1,0,26,26,16
25,r_128_45_21,seq144,r_48_133_129,r_128_45_21,1,0,21,21,16
6,r_27_140_51,seq26,seq139,r_27_140_51,1,0,51,51,16
36,r_44_121_47,r_48_133_129,seq112,r_44_121_47,1,0,47,47,16
11,r_58_89_53,r_57_53_172,seq90,r_58_89_53,1,0,53,53,16
25,r_128_45_21,r_48_133_129,r_113_46_94,r_128_45_21,1,108,129,21,16
94,seq115,r_114_96_118,seq112,r_114_96_118,0.68,-31,87,118,16
96,seq122,r_124_80_152,r_38_148_62,r_38_148_62,1,20,82,62,16
26,r_82_25_18,seq84,seq26,r_82_25_18,1,0,18,18,16
29,r_67_54_118,r_72_93_152,r_61_60_124,r_67_54_118,0.91,0,118,118,16
22,r_12_104_138,seq15,r_116_102_4,r_12_104_138,0.47,0,138,138,16
28,r_0_117_194,r_2_59_114,r_83_13_3,r_2_59_114,0.98,0,114,114,16
49,r_2_59_114,r_0_117_194,r_61_60_124,r_2_59_114,0.92,0,114,114,16
44,r_147_85_114,r_38_148_62,r_58_89_53,r_147_85_114,0.95,0,114,114,16
7,r_6_94_152,seq7,r_72_93_152,r_6_94_152,0.78,0,152,152,16
44,r_147_85_114,seq144,r_38_148_62,r_38_148_62,1,5,67,62,16
23,r_135_9_115,seq134,seq10,r_135_9_115,1,0,115,115,16
12,r_3_49_77,seq5,seq50,r_3_49_77,0.99,0,77,77,16
37,r_18_119_47,r_16_110_71,r_70_121_30,r_70_121_30,0.98,17,47,30,17
30,r_16_110_71,seq14,r_111_96_168,r_16_110_71,0.98,0,71,71,17
47,r_8_130_22,seq9,seq131,r_8_130_22,0.97,0,22,22,17
8,r_87_57_134,r_88_98_147,seq55,r_87_57_134,0.84,0,134,134,17
48,r_64_95_11,r_63_101_96,r_94_103_165,r_64_95_11,0.48,0,11,11,17
16,r_125_142_124,r_124_133_165,r_2_144_58,r_2_144_58,1,66,124,58,17
21,r_20_81_167,r_24_127_175,r_42_83_105,r_20_81_167,0.55,0,167,167,17
39,r_91_139_170,r_92_143_199,seq138,r_91_139_170,0.44,0,170,170,17
1,r_42_83_105,seq46,seq79,r_42_83_105,0.75,0,105,105,17
46,r_45_109_90,seq46,r_106_107_125,r_45_109_90,0.97,0,90,90,17
42,r_51_50_125,seq52,r_118_47_107,r_118_47_107,1,25,132,107,17
35,r_70_121_30,seq68,r_125_142_124,r_70_121_30,0.89,0,30,30,17
45,r_27_82_72,r_28_148_72,seq79,r_27_82_72,0.93,0,72,72,17
43,r_113_12_20,r_118_47_107,r_16_110_71,r_113_12_20,0.9,0,20,20,17
31,r_23_80_178,seq25,r_42_83_105,r_42_83_105,0.56,74,179,105,17
41,r_100_117_91,seq102,r_141_115_87,r_100_117_91,1,-1,90,91,17
3,r_89_149_4,seq146,r_28_148_72,r_28_148_72,1,-1,71,72,17
90,seq77,seq79,r_72_73_70,r_72_73_70,0.39,13,83,70,17
26,r_39_10_99,seq38,seq14,r_39_10_99,1,0,99,99,17
4,r_28_148_72,r_27_82_72,r_89_149_4,r_28_148_72,0.97,0,72,72,17
0,r_141_115_87,seq140,r_100_117_91,r_141_115_87,0.88,3,90,87,17
11,r_124_133_165,r_125_142_124,r_116_123_50,r_124_133_165,0.47,-41,124,165,17
20,r_88_98_147,r_87_57_134,r_43_97_101,r_43_97_101,0.45,34,135,101,17
13,r_63_101_96,seq74,seq102,r_63_101_96,0.99,0,96,96,17
15,r_49_32_63,seq48,seq33,r_49_32_63,0.95,0,63,63,17
51,seq3,r_2_144_58,seq1,r_2_144_58,1,-12,46,58,17
6,r_118_47_107,r_112_61_191,seq48,r_118_47_107,1,0,107,107,17
10,r_2_144_58,seq3,seq140,r_2_144_58,1,0,58,58,17
9,r_15_5_13,r_16_110_71,seq4,r_16_110_71,0.58,-58,13,71,17
27,r_56_132_60,seq55,seq131,r_56_132_60,1,0,60,60,17
5,r_136_66_32,seq137,r_65_78_59,r_136_66_32,0.97,0,32,32,17
49,r_85_93_38,r_87_57_134,seq90,r_87_57_134,0.58,-106,28,134,17
30,r_16_110_71,r_111_96_168,r_45_109_90,r_16_110_71,0.93,97,168,71,17
29,r_43_97_101,seq46,r_64_95_11,r_43_97_101,1,0,101,101,17
24,r_106_107_125,r_108_71_118,r_141_115_87,r_106_107_125,0.93,-7,118,125,17
25,r_111_96_168,r_106_107_125,r_88_98_147,r_106_107_125,0.55,43,168,125,17
48,r_64_95_11,r_94_103_165,r_88_98_147,r_94_103_165,0.63,0,165,165,17
35,r_70_121_30,r_125_142_124,r_18_119_47,r_18_119_47,0.97,6,53,47,17
54,seq9,r_8_130_22,seq7,r_8_130_22,1,0,22,22,17
58,seq14,r_16_110_71,seq13,r_16_110_71,1,0,71,71,17
65,seq25,r_24_127_175,seq19,r_24_127_175,0.85,-82,93,175,17
32,r_108_71_118,r_106_107_125,r_72_73_70,r_108_71_118,0.94,0,118,118,17
84,seq59,seq58,r_126_60_8,r_126_60_8,0.84,16,24,8,17
34,r_104_6_83,r_100_117_91,r_15_5_13,r_104_6_83,1,0,83,83,17
17,r_112_61_191,r_106_107_125,r_126_60_8,r_126_60_8,0.73,184,192,8,17
78,seq48,seq41,r_118_47_107,r_118_47_107,1,2,109,107,17
43,r_113_12_20,r_16_110_71,r_128_11_32,r_16_110_71,0.7,-19,52,71,17
22,r_116_123_50,r_118_47_107,seq122,r_118_47_107,0.62,-57,50,107,17
14,r_128_11_32,r_129_0_173,r_113_12_20,r_128_11_32,0.84,0,32,32,17
11,r_124_133_165,r_116_123_50,r_56_132_60,r_124_133_165,0.86,0,165,165,17
28,r_26_35_175,seq19,seq37,r_26_35_175,0.49,0,175,175,17
28,r_26_35_175,r_28_148_72,seq19,r_28_148_72,1,0,72,72,17
91,seq79,seq77,r_27_82_72,r_27_82_72,1,6,78,72,17
56,seq140,r_141_115_87,r_2_144_58,r_2_144_58,0.95,30,88,58,17
44,r_24_127_175,seq25,r_124_133_165,r_24_127_175,0.57,0,175,175,17
95,seq131,r_129_0_173,r_8_130_22,r_8_130_22,0.97,7,29,22,17
7,r_134_69_44,r_129_0_173,seq67,r_134_69_44,1,0,44,44,17
93,seq94,r_93_26_152,seq91,r_93_26_152,0.73,0,152,152,18
30,r_32_112_99,seq27,r_34_113_71,r_32_112_99,0.98,0,99,99,18
92,seq91,r_86_29_173,seq94,r_86_29_173,0.53,-87,86,173,18
14,r_111_49_92,seq109,seq50,r_111_49_92,0.99,0,92,92,18
21,r_39_99_46,r_101_147_72,r_106_100_52,r_101_147_72,0.97,-5,67,72,18
43,r_136_131_152,seq138,r_36_130_54,r_36_130_54,0.77,98,152,54,18
83,seq74,r_71_75_79,seq72,r_71_75_79,0.91,10,89,79,18
1,r_69_28_163,seq68,r_93_26_152,r_69_28_163,0.65,0,163,163,18
42,r_134_35_58,r_129_145_74,seq33,r_134_35_58,1,2,60,58,18
10,r_116_9_128,r_60_115_74,r_119_10_76,r_116_9_128,1,0,128,128,18
41,r_92_114_44,r_86_29_173,r_121_0_163,r_92_114_44,0.66,0,44,44,18
22,r_14_78_114,seq17,seq79,r_14_78_114,0.95,0,114,114,18
45,r_119_10_76,seq118,seq8,r_119_10_76,0.99,0,76,76,18
24,r_96_62_136,r_106_100_52,r_52_61_98,r_52_61_98,0.39,38,136,98,18
70,seq40,r_39_99_46,seq50,r_39_99_46,0.88,0,46,46,18
19,r_98_146_3,r_139_144_78,r_101_147_72,r_101_147_72,1,16,88,72,18
69,seq37,r_36_130_54,seq50,r_36_130_54,0.52,4,58,54,18
4,r_19_48_46,r_16_103_112,seq50,r_19_48_46,1,0,46,46,18
11,r_34_113_71,seq118,r_32_112_99,r_32_112_99,0.52,36,135,99,18
6,r_36_130_54,seq37,r_128_132_73,r_36_130_54,0.85,1,55,54,18
89,seq84,r_86_29_173,r_4_85_64,r_4_85_64,1,18,82,64,18
46,r_43_126_34,seq41,seq125,r_43_126_34,0.98,0,34,34,18
10,r_116_9_128,r_121_0_163,r_60_115_74,r_60_115_74,0.94,5,79,74,18
26,r_4_85_64,r_6_95_186,seq84,r_4_85_64,0.99,0,64,64,18
8,r_18_44_7,r_46_97_177,r_30_45_56,r_30_45_56,0.95,16,72,56,18
0,r_121_0_163,r_123_120_153,seq1,r_121_0_163,0.74,0,163,163,18
11,r_34_113_71,seq33,seq118,r_34_113_71,0.98,3,74,71,18
20,r_70_127_153,r_71_75_79,r_43_126_34,r_71_75_79,0.46,74,153,79,18
13,r_129_145_74,r_128_132_73,r_139_144_78,r_129_145_74,0.87,7,81,74,18
15,r_16_103_112,seq17,r_39_99_46,r_16_103_112,0.99,1,113,112,18
57,seq12,r_6_95_186,r_87_13_19,r_87_13_19,0.91,76,95,19,18
5,r_107_47_50,r_111_49_92,r_19_48_46,r_19_48_46,1,4,50,46,18
2,r_86_29_173,seq88,r_69_28_163,r_69_28_163,0.57,10,173,163,18
47,r_123_120_153,r_122_21_134,r_60_115_74,r_123_120_153,0.94,-19,134,153,18
24,r_96_62_136,r_101_147_72,r_106_100_52,r_96_62_136,0.38,-114,22,136,18
40,r_52_61_98,r_53_148_105,seq63,r_52_61_98,0.96,0,98,98,18
18,r_128_132_73,r_129_145_74,r_36_130_54,r_36_130_54,0.95,27,81,54,18
25,r_105_102_119,seq109,r_16_103_112,r_16_103_112,0.83,7,119,112,18
36,r_133_3_31,r_129_145_74,seq2,r_133_3_31,0.98,0,31,31,18
33,r_122_21_134,r_123_120_153,seq22,r_122_21_134,0.97,0,134,134,18
88,seq83,r_89_77_162,r_4_85_64,r_4_85_64,1,48,112,64,18
37,r_73_38_38,r_71_75_79,seq37,r_73_38_38,0.79,0,38,38,18
50,seq1,seq2,r_121_0_163,r_121_0_163,0.67,13,176,163,18
35,r_59_135_26,seq55,r_128_132_73,r_59_135_26,0.95,-3,23,26,18
32,r_46_97_177,seq50,r_16_103_112,r_16_103_112,0.93,66,178,112,18
39,r_106_100_52,r_111_49_92,r_39_99_46,r_106_100_52,0.99,0,52,52,18
38,r_54_64_97,seq57,seq66,r_54_64_97,0.56,3,100,97,18
41,r_92_114_44,r_121_0_163,r_60_115_74,r_92_114_44,0.9,35,79,44,18
94,seq104,r_121_0_163,r_129_145_74,r_129_145_74,0.52,-25,49,74,18
27,r_101_147_72,r_96_62_136,r_39_99_46,r_39_99_46,0.76,2,48,46,18
34,r_139_144_78,seq141,r_129_145_74,r_129_145_74,0.75,8,82,74,18
94,seq104,r_129_145_74,seq109,r_129_145_74,0.62,7,81,74,18
17,r_89_77_162,seq88,seq76,r_89_77_162,0.41,1,163,162,18
21,r_39_99_46,seq40,r_101_147_72,r_39_99_46,0.81,0,46,46,18
9,r_143_20_92,r_139_144_78,seq22,r_143_20_92,1,0,92,92,18
22,r_14_78_114,r_15_117_89,seq17,r_15_117_89,0.9,0,89,89,18
84,seq76,r_71_75_79,r_89_77_162,r_89_77_162,1,22,184,162,18
51,seq2,seq1,r_133_3_31,r_133_3_31,1,9,40,31,18
27,r_101_147_72,r_39_99_46,r_98_146_3,r_101_147_72,0.61,0,72,72,18
49,r_124_42_92,seq125,seq41,r_124_42_92,1,1,93,92,18
3,r_87_13_19,r_86_29_173,seq12,r_87_13_19,0.96,0,19,19,18
7,r_60_115_74,seq63,r_92_114_44,r_60_115_74,0.99,4,78,74,18
44,r_15_117_89,r_14_78_114,seq118,r_15_117_89,0.77,0,89,89,18
16,r_30_45_56,seq27,r_18_44_7,r_30_45_56,0.99,0,56,56,18
23,r_93_26_152,seq94,seq27,r_93_26_152,0.39,0,152,152,18
12,r_53_148_105,seq50,seq149,r_53_148_105,0.93,3,108,105,18
30,r_111_10_142,seq112,seq9,r_111_10_142,0.96,0,142,142,19
36,r_38_135_64,r_34_101_172,seq137,r_38_135_64,0.99,1,65,64,19
8,r_17_67_178,seq16,r_43_70_77,r_17_67_178,0.56,0,178,178,19
43,r_28_88_79,r_29_98_169,seq92,r_28_88_79,1,0,79,79,19
37,r_105_145_24,seq96,seq144,r_105_145_24,0.99,0,24,24,19
1,r_26_82_42,r_29_98_169,r_81_147_202,r_26_82_42,0.89,0,42,42,19
71,seq44,seq57,r_104_91_15,r_104_91_15,0.78,93,108,15,19
39,r_90_97_93,r_87_85_169,seq96,r_90_97_93,1,0,93,93,19
97,seq122,r_120_86_162,r_6_119_148,r_6_119_148,0.46,5,153,148,19
7,r_124_76_94,seq73,r_14_75_143,r_14_75_143,1,3,146,143,19
5,r_118_136_179,seq122,r_38_135_64,r_38_135_64,1,115,179,64,19
42,r_99_94_99,seq100,seq95,r_99_94_99,1,0,99,99,19
46,r_58_18_35,seq59,seq16,r_58_18_35,1,0,35,35,19
69,seq36,r_34_101_172,r_50_37_80,r_50_37_80,1,42,122,80,19
45,r_68_30_149,r_69_62_215,seq31,r_68_30_149,0.85,0,149,149,19
15,r_47_54_42,seq48,seq56,r_47_54_42,0.72,0,42,42,19
19,r_52_49_128,seq53,seq48,r_52_49_128,0.69,0,128,128,19
96,seq116,r_117_121_45,r_65_115_9,r_65_115_9,1,2,11,9,19
31,r_15_20_160,r_29_98_169,r_60_25_132,r_60_25_132,1,28,160,132,19
67,seq31,r_29_98_169,r_68_30_149,r_68_30_149,0.97,20,169,149,19
16,r_83_142_18,r_52_49_128,seq143,r_83_142_18,0.98,0,18,18,19
26,r_64_27_118,seq46,seq31,r_64_27_118,0.8,-1,117,118,19
72,seq46,seq63,r_129_45_144,r_129_45_144,1,0,144,144,19
4,r_43_70_77,seq46,seq71,r_43_70_77,0.97,-8,69,77,19
63,seq148,r_146_109_169,r_51_149_125,r_51_149_125,0.75,0,125,125,19
13,r_51_149_125,r_50_37_80,r_47_54_42,r_50_37_80,0.99,-13,67,80,19
53,seq4,seq9,r_80_5_44,r_80_5_44,1,1,45,44,19
44,r_65_115_9,r_64_27_118,seq116,r_65_115_9,0.99,2,11,9,19
6,r_40_8_70,seq42,r_80_5_44,r_40_8_70,1,0,70,70,19
21,r_80_5_44,r_6_119_148,r_111_10_142,r_80_5_44,0.99,104,148,44,19
99,seq125,r_124_76_94,r_127_126_61,r_124_76_94,1,-21,73,94,19
27,r_0_89_187,seq1,r_104_91_15,r_0_89_187,0.41,0,187,187,19
3,r_104_91_15,r_105_145_24,seq92,r_104_91_15,1,1,16,15,19
2,r_146_109_169,seq148,seq112,r_146_109_169,0.67,0,169,169,19
47,r_50_37_80,r_51_149_125,seq36,r_50_37_80,1,0,80,80,19
40,r_39_72_153,seq42,r_124_76_94,r_39_72_153,0.91,1,154,153,19
74,seq53,r_52_49_128,seq56,r_52_49_128,0.99,0,128,128,19
18,r_29_98_169,seq31,r_90_97_93,r_90_97_93,0.76,76,169,93,19
29,r_87_85_169,seq92,r_78_84_64,r_87_85_169,0.59,0,169,169,19
24,r_6_119_148,seq4,r_74_114_37,r_6_119_148,0.83,0,148,148,19
33,r_78_84_64,seq79,r_26_82_42,r_26_82_42,1,22,64,42,19
50,seq1,r_0_89_187,r_80_5_44,r_80_5_44,0.99,137,181,44,19
20,r_81_147_202,r_80_5_44,seq59,r_80_5_44,1,0,44,44,19
32,r_130_134_216,r_129_45_144,r_38_135_64,r_38_135_64,0.97,21,85,64,19
88,seq144,seq143,r_105_145_24,r_105_145_24,1,1,25,24,19
57,seq11,r_14_75_143,r_80_5_44,r_80_5_44,0.61,0,44,44,19
34,r_117_121_45,seq116,seq122,r_117_121_45,0.55,31,76,45,19
20,r_81_147_202,seq77,r_51_149_125,r_81_147_202,0.8,0,202,202,19
38,r_74_114_37,seq73,seq116,r_74_114_37,1,0,37,37,19
81,seq71,r_69_62_215,r_43_70_77,r_43_70_77,1,139,216,77,19
17,r_139_103_100,seq140,seq107,r_139_103_100,1,0,100,100,19
85,seq92,r_87_85_169,r_104_91_15,r_104_91_15,1,1,16,15,19
14,r_102_93_58,seq96,seq95,r_102_93_58,1,0,58,58,19
94,seq113,r_118_136_179,r_74_114_37,r_74_114_37,1,47,84,37,19
9,r_21_13_185,seq22,seq12,r_21_13_185,0.42,0,185,185,19
13,r_51_149_125,r_47_54_42,seq148,r_51_149_125,1,0,125,125,19
1,r_26_82_42,r_81_147_202,r_78_84_64,r_26_82_42,0.3,25,67,42,19
22,r_32_55_148,r_34_101_172,seq56,r_32_55_148,1,0,148,148,19
28,r_14_75_143,seq12,r_124_76_94,r_14_75_143,0.67,0,143,143,19
49,r_133_61_82,seq131,seq63,r_133_61_82,1,0,82,82,19
7,r_124_76_94,seq125,seq73,r_124_76_94,0.98,0,94,94,19
23,r_129_45_144,r_130_134_216,seq46,r_129_45_144,0.96,2,146,144,19
86,seq95,r_87_85_169,r_102_93_58,r_102_93_58,1,1,59,58,19
82,seq73,seq79,r_124_76_94,r_124_76_94,1,13,107,94,19
35,r_69_62_215,seq71,r_47_54_42,r_47_54_42,0.77,174,216,42,19
12,r_34_101_172,seq33,r_29_98_169,r_34_101_172,0.73,0,172,172,19
21,r_80_5_44,r_81_147_202,r_6_119_148,r_80_5_44,1,0,44,44,19
93,seq99,seq95,r_20_97_137,r_20_97_137,0.89,7,144,137,20
40,r_146_2_11,r_4_59_181,seq5,r_4_59_181,0.76,-56,125,181,20
36,r_44_18_112,r_43_57_190,seq19,r_44_18_112,0.62,0,112,112,20
25,r_110_81_16,seq108,r_82_100_142,r_110_81_16,0.98,2,18,16,20
14,r_80_72_99,r_78_79_22,r_17_75_53,r_17_75_53,1,50,103,53,20
8,r_124_55_171,r_123_109_79,r_62_122_82,r_124_55_171,0.99,-90,81,171,20
53,seq5,r_4_59_181,r_118_3_17,r_118_3_17,0.94,164,181,17,20
74,seq49,r_28_137_101,seq51,r_28_137_101,0.98,-64,37,101,20
45,r_37_26_31,r_39_148_118,r_25_58_185,r_37_26_31,0.92,-12,19,31,20
16,r_39_148_118,seq40,seq149,r_39_148_118,0.98,0,118,118,20
1,r_28_137_101,seq27,seq139,r_28_137_101,1,0,101,101,20
46,r_90_98_179,seq87,r_20_97_137,r_90_98_179,0.76,0,179,179,20
42,r_42_64_146,r_43_57_190,r_115_65_110,r_115_65_110,0.97,36,146,110,20
22,r_102_12_161,r_145_101_102,seq7,r_102_12_161,1,0,161,161,20
6,r_104_83_42,seq108,r_82_100_142,r_104_83_42,1,0,42,42,20
15,r_89_111_14,r_90_98_179,r_131_91_158,r_89_111_14,0.73,2,16,14,20
33,r_74_88_169,r_17_75_53,seq87,r_74_88_169,0.71,0,169,169,20
31,r_123_109_79,r_124_55_171,r_125_106_44,r_124_55_171,0.96,-91,80,171,20
41,r_62_122_82,seq60,seq120,r_62_122_82,1,0,82,82,20
10,r_43_57_190,r_44_18_112,seq40,r_44_18_112,0.59,0,112,112,20
26,r_85_105_71,seq84,r_125_106_44,r_85_105_71,1,0,71,71,20
8,r_124_55_171,r_62_122_82,r_41_56_93,r_124_55_171,0.79,0,171,171,20
72,seq40,r_39_148_118,seq35,r_39_148_118,1,0,118,118,20
4,r_15_113_61,r_10_114_92,r_89_111_14,r_15_113_61,1,0,61,61,20
0,r_70_138_77,seq66,seq139,r_70_138_77,1,-1,76,77,20
20,r_48_68_137,seq47,r_115_65_110,r_115_65_110,1,29,139,110,20
48,r_131_91_158,seq130,seq87,r_131_91_158,0.97,0,158,158,20
17,r_145_101_102,r_102_12_161,r_82_100_142,r_145_101_102,0.98,59,161,102,20
33,r_74_88_169,r_80_72_99,r_17_75_53,r_17_75_53,1,1,54,53,20
85,seq84,r_85_105_71,seq86,r_85_105_71,0.94,0,71,71,20
99,seq149,seq142,r_39_148_118,r_39_148_118,1,10,128,118,20
5,r_17_75_53,r_74_88_169,r_80_72_99,r_17_75_53,0.52,116,169,53,20
13,r_25_58_185,r_28_137_101,r_37_26_31,r_28_137_101,0.77,-65,36,101,20
27,r_46_50_140,r_43_57_190,seq47,r_46_50_140,0.34,0,140,140,20
5,r_17_75_53,r_10_114_92,r_74_88_169,r_17_75_53,1,0,53,53,20
47,r_92_14_165,seq93,r_22_31_139,r_92_14_165,0.78,0,165,165,20
18,r_10_114_92,r_9_76_96,seq116,r_10_114_92,1,0,92,92,20
29,r_41_56_93,r_39_148_118,seq53,r_39_148_118,0.66,-25,93,118,20
15,r_89_111_14,r_131_91_158,r_15_113_61,r_15_113_61,0.95,0,61,61,20
43,r_82_100_142,r_104_83_42,r_145_101_102,r_82_100_142,0.9,0,142,142,20
30,r_127_29_49,seq128,seq30,r_127_29_49,1,0,49,49,20
85,seq84,seq86,r_9_76_96,r_9_76_96,0.7,49,145,96,20
50,seq0,r_4_59_181,r_118_3_17,r_118_3_17,0.69,165,182,17,20
6,r_104_83_42,r_82_100_142,r_9_76_96,r_104_83_42,0.99,100,142,42,20
21,r_69_33_30,r_63_11_185,seq27,r_69_33_30,0.91,3,33,30,20
61,seq19,r_20_97_137,r_44_18_112,r_20_97_137,0.62,0,137,137,20
32,r_9_76_96,seq7,r_78_79_22,r_9_76_96,0.99,0,96,96,20
38,r_71_73_177,seq66,r_17_75_53,r_17_75_53,0.96,124,177,53,20
52,seq130,r_131_91_158,r_121_129_43,r_131_91_158,0.85,0,158,158,20
34,r_107_135_149,seq108,r_112_136_4,r_107_135_149,0.89,0,149,149,20
43,r_82_100_142,r_80_72_99,r_104_83_42,r_104_83_42,1,12,54,42,20
17,r_145_101_102,seq143,r_102_12_161,r_145_101_102,0.99,0,102,102,20
25,r_110_81_16,r_82_100_142,r_104_83_42,r_110_81_16,0.98,98,114,16,20
94,seq108,r_107_135_149,r_125_106_44,r_125_106_44,0.87,105,149,44,20
9,r_22_31_139,seq23,r_127_29_49,r_127_29_49,1,70,119,49,20
3,r_118_3_17,r_121_129_43,seq5,r_118_3_17,0.97,0,17,17,20
22,r_102_12_161,r_107_135_149,r_145_101_102,r_145_101_102,0.89,6,108,102,20
28,r_115_65_110,seq116,seq66,r_115_65_110,0.99,0,110,110,20
11,r_125_106_44,r_124_55_171,seq108,r_125_106_44,1,1,45,44,20
49,r_20_97_137,seq19,seq99,r_20_97_137,0.88,0,137,137,20
12,r_117_45_67,seq120,r_43_57_190,r_117_45_67,1,0,67,67,20
40,r_146_2_11,r_118_3_17,r_4_59_181,r_4_59_181,1,-171,10,181,20
30,r_46_3_160,seq53,seq2,r_46_3_160,0.89,0,160,160,21
25,r_39_19_27,r_54_30_75,r_80_20_9,r_80_20_9,1,19,28,9,21
14,r_52_94_97,r_51_72_103,r_149_92_83,r_149_92_83,1,14,97,83,21
33,r_96_118_16,r_95_16_89,seq117,r_96_118_16,1,0,16,16,21
83,seq74,r_76_40_60,seq69,r_76_40_60,0.96,0,60,60,21
12,r_122_91_54,seq121,seq88,r_122_91_54,1,0,54,54,21
16,r_4_93_192,seq1,r_128_6_109,r_128_6_109,1,3,112,109,21
21,r_50_110_90,r_52_94_97,seq111,r_50_110_90,1,0,90,90,21
1,r_13_86_113,seq12,seq87,r_13_86_113,1,0,113,113,21
5,r_148_0_203,r_149_92_83,r_103_34_117,r_149_92_83,0.5,0,83,83,21
46,r_95_16_89,seq88,r_15_90_163,r_95_16_89,0.98,1,90,89,21
32,r_18_21_208,seq24,r_80_20_9,r_18_21_208,0.85,0,208,208,21
19,r_10_14_140,seq9,r_95_16_89,r_10_14_140,0.63,0,140,140,21
3,r_98_67_142,seq97,r_143_68_3,r_98_67_142,0.99,1,143,142,21
36,r_147_127_43,r_148_0_203,seq126,r_147_127_43,0.97,1,44,43,21
31,r_76_40_60,seq74,seq53,r_76_40_60,0.74,0,60,60,21
5,r_148_0_203,seq116,r_128_6_109,r_148_0_203,0.96,0,203,203,21
37,r_137_112_13,seq138,seq115,r_137_112_13,0.88,2,15,13,21
3,r_98_67_142,r_99_7_113,seq97,r_99_7_113,1,0,113,113,21
90,seq111,r_109_44_116,r_137_112_13,r_109_44_116,1,-12,104,116,21
95,seq121,r_122_91_54,r_119_129_25,r_122_91_54,0.95,0,54,54,21
5,r_148_0_203,r_103_34_117,r_62_144_13,r_148_0_203,0.59,-107,96,203,21
72,seq49,r_48_108_205,r_109_44_116,r_109_44_116,1,91,207,116,21
16,r_4_93_192,r_128_6_109,r_13_86_113,r_4_93_192,0.8,0,192,192,21
4,r_99_7_113,r_98_67_142,r_128_6_109,r_99_7_113,1,0,113,113,21
0,r_128_6_109,r_119_129_25,r_81_5_69,r_128_6_109,0.99,1,110,109,21
26,r_139_83_36,r_132_37_151,seq82,r_139_83_36,0.89,-1,35,36,21
11,r_36_135_153,seq35,seq138,r_36_135_153,0.83,0,153,153,21
39,r_62_144_13,seq87,seq142,r_62_144_13,0.89,1,14,13,21
20,r_109_44_116,seq111,seq45,r_109_44_116,1,0,116,116,21
46,r_95_16_89,r_15_90_163,r_10_14_140,r_95_16_89,0.87,72,161,89,21
12,r_122_91_54,seq88,r_149_92_83,r_149_92_83,0.99,43,126,83,21
6,r_149_92_83,r_148_0_203,r_122_91_54,r_149_92_83,0.89,0,83,83,21
27,r_71_141_48,seq69,seq138,r_71_141_48,1,0,48,48,21
85,seq87,seq88,r_13_86_113,r_13_86_113,1,9,122,113,21
39,r_62_144_13,seq142,seq133,r_62_144_13,0.48,17,30,13,21
2,r_64_85_109,seq65,seq87,r_64_85_109,0.86,0,109,109,21
41,r_140_79_15,r_78_70_64,r_113_77_87,r_113_77_87,1,16,103,87,21
47,r_123_106_183,seq124,seq104,r_123_106_183,0.23,0,183,183,21
40,r_78_70_64,r_81_5_69,r_143_68_3,r_81_5_69,1,0,69,69,21
18,r_113_77_87,seq115,r_140_79_15,r_113_77_87,1,0,87,87,21
29,r_58_27_170,seq53,seq31,r_58_27_170,0.72,0,170,170,21
24,r_51_72_103,r_48_108_205,seq73,r_51_72_103,0.43,0,103,103,21
13,r_80_20_9,r_81_5_69,r_23_17_196,r_80_20_9,0.79,1,10,9,21
58,seq12,r_11_59_200,seq8,r_11_59_200,0.89,-12,188,200,21
32,r_18_21_208,seq26,seq24,r_18_21_208,0.46,-90,118,208,21
38,r_23_17_196,r_22_25_183,r_95_16_89,r_95_16_89,1,107,196,89,21
52,seq131,r_132_37_151,r_123_106_183,r_132_37_151,0.75,1,152,151,21
41,r_140_79_15,r_139_83_36,r_78_70_64,r_78_70_64,0.93,-49,15,64,21
17,r_103_34_117,r_105_38_125,seq33,r_103_34_117,0.95,0,117,117,21
28,r_100_84_185,r_101_107_173,r_13_86_113,r_13_86_113,0.85,72,185,113,21
91,seq115,r_113_77_87,r_137_112_13,r_113_77_87,1,0,87,87,21
13,r_80_20_9,r_23_17_196,r_39_19_27,r_39_19_27,1,0,27,27,21
42,r_47_114_35,r_48_108_205,r_137_112_13,r_47_114_35,1,0,35,35,21
49,r_48_108_205,seq49,r_50_110_90,r_50_110_90,1,116,206,90,21
35,r_105_38_125,r_76_40_60,r_132_37_151,r_132_37_151,0.93,-1,150,151,21
56,seq9,r_10_14_140,seq8,r_10_14_140,1,0,140,140,21
7,r_81_5_69,r_78_70_64,seq1,r_81_5_69,1,0,69,69,21
23,r_15_90_163,seq29,r_95_16_89,r_95_16_89,0.92,1,90,89,21
7,r_81_5_69,seq1,r_128_6_109,r_128_6_109,1,3,112,109,21
95,seq121,r_119_129_25,seq116,r_119_129_25,0.33,154,179,25,21
23,r_15_90_163,r_95_16_89,r_149_92_83,r_15_90_163,0.98,0,163,163,21
30,r_31_57_147,r_32_0_179,r_16_59_11,r_31_57_147,0.63,0,147,147,22
46,r_72_90_18,r_70_143_101,r_91_127_40,r_72_90_18,0.96,0,18,18,22
13,r_115_78_152,r_114_28_26,r_30_113_9,r_114_28_26,0.95,-2,24,26,22
70,seq54,r_136_61_6,r_44_53_30,r_44_53_30,0.73,-2,28,30,22
22,r_79_119_4,r_124_89_38,r_118_122_62,r_79_119_4,0.71,35,39,4,22
8,r_63_55_2,r_58_69_68,r_16_59_11,r_58_69_68,0.82,0,68,68,22
37,r_48_12_107,r_45_9_130,seq13,r_48_12_107,0.87,0,107,107,22
59,seq146,r_145_42_88,seq148,r_145_42_88,1,0,88,88,22
16,r_102_21_127,seq103,r_126_23_20,r_102_21_127,0.99,0,127,127,22
21,r_110_138_138,seq106,r_56_137_67,r_110_138_138,0.91,0,138,138,22
39,r_131_41_154,r_129_82_135,r_73_134_3,r_129_82_135,0.99,0,135,135,22
1,r_49_101_77,r_45_9_130,seq100,r_49_101_77,1,0,77,77,22
97,seq117,r_118_122_62,seq116,r_118_122_62,0.77,8,70,62,22
80,seq77,r_81_17_192,r_115_78_152,r_115_78_152,1,17,169,152,22
69,seq52,r_51_108_142,r_43_64_138,r_51_108_142,0.49,0,142,142,22
45,r_80_39_63,r_81_17_192,r_40_14_130,r_80_39_63,1,2,65,63,22
31,r_91_127_40,r_141_86_1,r_73_134_3,r_91_127_40,0.49,2,42,40,22
19,r_81_17_192,r_80_39_63,seq75,r_80_39_63,0.97,2,65,63,22
33,r_10_98_101,seq8,r_36_11_46,r_36_11_46,1,8,54,46,22
11,r_36_11_46,seq8,r_45_9_130,r_45_9_130,1,1,131,130,22
42,r_111_3_53,seq112,seq2,r_111_3_53,1,0,53,53,22
15,r_44_53_30,r_45_9_130,seq54,r_44_53_30,0.93,0,30,30,22
41,r_56_137_67,r_58_69_68,seq140,r_56_137_67,1,0,67,67,22
89,seq99,seq97,r_10_98_101,r_10_98_101,1,72,173,101,22
3,r_40_14_130,r_37_144_146,seq13,r_40_14_130,0.95,0,130,130,22
90,seq100,seq106,r_49_101_77,r_49_101_77,1,9,86,77,22
5,r_147_35_32,seq146,seq38,r_147_35_32,1,1,33,32,22
26,r_145_42_88,seq146,r_80_39_63,r_145_42_88,1,0,88,88,22
14,r_30_113_9,r_115_78_152,seq104,r_115_78_152,1,0,152,152,22
4,r_118_122_62,seq117,seq120,r_118_122_62,0.58,8,70,62,22
10,r_124_89_38,r_125_109_92,r_72_90_18,r_72_90_18,0.56,21,39,18,22
13,r_115_78_152,r_30_113_9,seq77,r_115_78_152,0.89,0,152,152,22
6,r_129_82_135,r_131_41_154,seq75,r_129_82_135,0.93,0,135,135,22
43,r_92_107_159,r_141_86_1,r_124_89_38,r_124_89_38,0.74,9,47,38,22
11,r_36_11_46,r_10_98_101,seq8,r_10_98_101,1,0,101,101,22
27,r_123_33_161,seq120,r_147_35_32,r_123_33_161,0.77,0,161,161,22
22,r_79_119_4,r_118_122_62,seq117,r_79_119_4,0.39,163,167,4,22
2,r_37_144_146,seq38,seq146,r_37_144_146,0.89,0,146,146,22
46,r_72_90_18,r_91_127_40,r_124_89_38,r_72_90_18,0.51,22,40,18,22
40,r_32_0_179,seq38,r_111_3_53,r_32_0_179,0.45,0,179,179,22
29,r_15_149_108,seq13,seq148,r_15_149_108,1,0,108,108,22
38,r_83_47_10,r_81_17_192,seq46,r_83_47_10,0.9,0,10,10,22
24,r_58_69_68,r_56_137_67,seq62,r_58_69_68,0.86,0,68,68,22
43,r_92_107_159,r_124_89_38,r_125_109_92,r_125_109_92,0.76,67,159,92,22
64,seq25,seq22,r_142_26_77,r_142_26_77,1,69,146,77,22
88,seq148,seq146,r_15_149_108,r_15_149_108,1,33,141,108,22
31,r_91_127_40,seq100,r_130_128_76,r_91_127_40,0.97,36,76,40,22
77,seq71,r_70_143_101,seq75,r_70_143_101,0.97,0,101,101,22
36,r_126_23_20,r_147_35_32,seq24,r_126_23_20,0.69,1,21,20,22
34,r_51_108_142,seq52,r_125_109_92,r_51_108_142,0.91,0,142,142,22
0,r_74_4_46,seq75,seq2,r_74_4_46,1,1,47,46,22
45,r_80_39_63,r_40_14_130,r_145_42_88,r_40_14_130,0.97,0,130,130,22
17,r_34_50_74,r_37_144_146,r_83_47_10,r_34_50_74,0.64,57,131,74,22
58,seq13,r_48_12_107,r_40_14_130,r_40_14_130,1,0,130,130,22
32,r_114_28_26,r_115_78_152,seq29,r_114_28_26,1,0,26,26,22
39,r_131_41_154,r_73_134_3,r_147_35_32,r_131_41_154,0.97,0,154,154,22
9,r_43_64_138,r_37_144_146,seq62,r_43_64_138,0.92,0,138,138,22
33,r_10_98_101,r_36_11_46,seq99,r_10_98_101,1,0,101,101,22
28,r_125_109_92,r_123_33_161,seq106,r_125_109_92,0.84,1,93,92,22
91,seq103,r_102_21_127,r_125_109_92,r_102_21_127,0.53,-10,117,127,22
49,r_142_26_77,r_135_139_47,seq25,r_142_26_77,1,0,77,77,22
7,r_135_139_47,r_142_26_77,seq140,r_142_26_77,1,-1,76,77,22
44,r_84_18_74,r_141_86_1,seq19,r_84_18_74,1,0,74,74,22
11,r_36_11_46,r_37_144_146,r_10_98_101,r_36_11_46,1,0,46,46,22
25,r_16_59_11,r_15_149_108,r_63_55_2,r_16_59_11,0.91,1,12,11,22
35,r_130_128_76,r_129_82_135,r_91_127_40,r_130_128_76,1,0,76,76,22
12,r_70_143_101,seq71,seq140,r_70_143_101,0.99,0,101,101,22
30,r_89_119_98,r_77_39_120,r_102_118_22,r_77_39_120,0.55,-22,98,120,23
14,r_92_76_135,r_91_78_143,r_95_82_93,r_95_82_93,0.9,42,135,93,23
8,r_134_83_103,seq131,r_95_82_93,r_134_83_103,0.99,0,103,103,23
96,seq114,r_92_76_135,r_49_115_41,r_49_115_41,1,1,42,41,23
43,r_135_140_99,r_134_83_103,seq139,r_134_83_103,1,-4,99,103,23
16,r_65_35_95,r_69_101_130,r_36_28_198,r_65_35_95,1,0,95,95,23
39,r_125_68_174,r_126_141_107,r_110_124_89,r_126_141_107,0.69,-14,93,107,23
5,r_71_22_113,seq74,r_30_23_28,r_71_22_113,1,0,113,113,23
46,r_6_113_93,seq4,seq112,r_6_113_93,1,0,93,93,23
42,r_94_64_96,r_93_73_159,seq63,r_94_64_96,0.98,0,96,96,23
7,r_96_1_60,r_0_87_148,r_47_9_28,r_0_87_148,0.93,1,149,148,23
6,r_70_104_35,r_71_22_113,r_111_103_27,r_70_104_35,0.96,0,35,35,23
11,r_122_145_173,r_102_118_22,r_18_121_19,r_18_121_19,1,0,19,19,23
45,r_142_100_63,seq139,seq99,r_142_100_63,1,0,63,63,23
22,r_111_103_27,r_107_32_105,r_70_104_35,r_111_103_27,0.96,9,36,27,23
19,r_43_24_61,r_42_137_156,r_120_26_28,r_43_24_61,1,1,62,61,23
33,r_0_87_148,r_96_1_60,r_37_86_129,r_0_87_148,1,0,148,148,23
37,r_49_115_41,r_51_45_93,seq114,r_49_115_41,1,0,41,41,23
11,r_122_145_173,r_18_121_19,seq146,r_122_145_173,0.58,0,173,173,23
27,r_93_73_159,seq97,seq74,r_93_73_159,0.75,0,159,159,23
39,r_125_68_174,r_110_124_89,r_94_64_96,r_125_68_174,0.73,0,174,174,23
17,r_88_105_73,r_107_32_105,r_116_106_90,r_107_32_105,1,0,105,105,23
41,r_53_132_133,seq54,seq131,r_53_132_133,0.84,0,133,133,23
53,seq3,r_120_26_28,seq27,r_120_26_28,0.15,155,183,28,23
20,r_2_14_42,seq3,seq13,r_2_14_42,1,0,42,42,23
26,r_12_138_134,seq13,r_126_141_107,r_12_138_134,0.8,0,134,134,23
4,r_110_124_89,seq112,r_125_68_174,r_110_124_89,0.86,0,89,89,23
0,r_95_82_93,r_94_64_96,seq85,r_95_82_93,0.88,0,93,93,23
73,seq40,r_42_137_156,r_133_41_76,r_133_41_76,0.92,0,76,76,23
13,r_37_86_129,r_42_137_156,r_95_82_93,r_37_86_129,0.97,0,129,129,23
15,r_36_28_198,r_30_23_28,r_107_32_105,r_107_32_105,1,60,165,105,23
48,r_107_32_105,r_111_103_27,seq33,r_107_32_105,1,0,105,105,23
36,r_18_121_19,seq19,r_122_145_173,r_18_121_19,0.98,0,19,19,23
4,r_110_124_89,r_125_68_174,r_81_123_124,r_110_124_89,0.83,85,174,89,23
36,r_18_121_19,r_122_145_173,r_102_118_22,r_18_121_19,0.5,155,174,19,23
21,r_30_23_28,r_31_79_188,seq21,r_30_23_28,0.6,0,28,28,23
27,r_93_73_159,r_94_64_96,seq97,r_94_64_96,1,0,96,96,23
68,seq25,seq10,r_120_26_28,r_120_26_28,0.98,0,28,28,23
87,seq139,r_142_100_63,seq129,r_142_100_63,1,0,63,63,23
2,r_69_101_130,seq67,r_142_100_63,r_142_100_63,1,67,130,63,23
47,r_80_55_161,seq85,seq54,r_80_55_161,0.76,0,161,161,23
40,r_42_137_156,seq40,r_108_143_152,r_42_137_156,0.84,0,156,156,23
58,seq8,seq7,r_47_9_28,r_47_9_28,1,0,28,28,23
29,r_15_38_154,seq13,r_77_39_120,r_15_38_154,0.86,0,154,154,23
25,r_126_141_107,seq128,r_135_140_99,r_126_141_107,0.96,0,107,107,23
49,r_77_39_120,r_95_82_93,r_56_44_10,r_95_82_93,0.61,27,120,93,23
33,r_0_87_148,r_6_113_93,r_96_1_60,r_0_87_148,0.7,-88,60,148,23
92,seq131,seq139,r_53_132_133,r_53_132_133,0.95,15,148,133,23
53,seq3,r_0_87_148,r_120_26_28,r_120_26_28,0.7,12,40,28,23
61,seq13,r_12_138_134,seq11,r_12_138_134,1,0,134,134,23
32,r_91_78_143,r_92_76_135,r_95_82_93,r_95_82_93,0.87,36,129,93,23
38,r_60_90_82,seq61,seq85,r_60_90_82,0.74,-5,77,82,23
77,seq54,r_53_132_133,r_136_50_58,r_136_50_58,0.88,76,134,58,23
34,r_116_106_90,seq117,r_88_105_73,r_88_105_73,0.89,17,90,73,23
1,r_120_26_28,seq117,seq25,r_120_26_28,1,0,28,28,23
17,r_88_105_73,r_77_39_120,r_107_32_105,r_88_105_73,0.88,2,75,73,23
28,r_133_41_76,r_135_140_99,seq40,r_133_41_76,1,0,76,76,23
91,seq99,seq114,r_142_100_63,r_142_100_63,1,3,66,63,23
49,r_77_39_120,r_89_119_98,r_95_82_93,r_77_39_120,0.38,-23,97,120,23
12,r_136_50_58,r_142_100_63,seq52,r_136_50_58,1,0,58,58,23
56,seq149,seq146,r_72_148_60,r_72_148_60,1,5,65,60,23
7,r_96_1_60,seq97,r_0_87_148,r_96_1_60,1,0,60,60,23
44,r_81_123_124,r_80_55_161,r_110_124_89,r_81_123_124,0.63,1,125,124,23
36,r_18_121_19,r_102_118_22,r_69_101_130,r_69_101_130,0.91,55,185,130,23
23,r_108_143_152,seq112,r_126_141_107,r_126_141_107,0.6,46,153,107,23
35,r_72_148_60,r_71_22_113,seq149,r_72_148_60,1,0,60,60,23
95,seq112,r_110_124_89,seq109,r_110_124_89,0.94,-44,45,89,23
40,r_57_141_59,seq56,seq142,r_57_141_59,0.99,-1,58,59,24
36,r_87_123_89,seq85,r_127_121_93,r_87_123_89,0.96,4,93,89,24
71,seq51,r_49_132_180,r_43_55_46,r_43_55_46,1,10,56,46,24
43,r_4_90_101,r_3_1_9,seq91,r_4_90_101,1,0,101,101,24
37,r_103_147_80,seq107,seq148,r_103_147_80,0.55,0,80,80,24
39,r_13_82_136,r_12_17_13,r_104_15_38,r_104_15_38,0.98,23,61,38,24
1,r_80_128_155,seq78,r_46_130_149,r_80_128_155,0.53,0,155,155,24
5,r_76_134_196,r_75_20_189,seq73,r_76_134_196,0.35,-10,186,196,24
42,r_125_92_106,r_115_54_196,r_94_124_70,r_94_124_70,0.67,0,70,70,24
70,seq135,seq131,r_96_136_12,r_96_136_12,1,-2,10,12,24
39,r_13_82_136,r_14_69_28,r_12_17_13,r_14_69_28,0.89,0,28,28,24
31,r_47_109_92,r_46_130_149,seq111,r_47_109_92,0.97,0,92,92,24
41,r_46_130_149,r_44_36_171,seq129,r_44_36_171,0.64,-22,149,171,24
30,r_50_37_34,r_49_132_180,r_29_34_23,r_50_37_34,0.98,0,34,34,24
89,seq91,r_98_137_176,r_125_92_106,r_125_92_106,0.84,-15,91,106,24
20,r_14_69_28,r_13_82_136,seq66,r_14_69_28,0.87,0,28,28,24
90,seq95,r_98_137_176,r_25_93_82,r_25_93_82,1,10,92,82,24
26,r_67_138_83,seq66,r_96_136_12,r_67_138_83,0.98,0,83,83,24
16,r_102_97_100,seq107,r_98_137_176,r_98_137_176,0.41,-76,100,176,24
42,r_125_92_106,r_94_124_70,seq91,r_125_92_106,0.8,0,106,106,24
4,r_45_30_70,r_44_36_171,seq28,r_45_30_70,1,0,70,70,24
45,r_113_22_24,r_115_54_196,seq23,r_113_22_24,0.98,0,24,24,24
11,r_3_1_9,r_4_90_101,r_79_2_62,r_3_1_9,0.77,78,87,9,24
7,r_98_137_176,r_102_97_100,r_67_138_83,r_98_137_176,0.86,0,176,176,24
13,r_122_32_91,seq120,seq31,r_122_32_91,0.97,-2,89,91,24
98,seq126,r_127_121_93,seq129,r_127_121_93,0.81,0,93,93,24
48,r_143_108_104,r_146_10_155,seq111,r_143_108_104,0.54,0,104,104,24
6,r_25_93_82,seq23,seq95,r_25_93_82,1,0,82,82,24
27,r_127_121_93,seq126,r_87_123_89,r_87_123_89,0.95,4,93,89,24
87,seq85,r_86_9_90,seq89,r_86_9_90,0.99,0,90,90,24
2,r_79_2_62,r_80_128_155,r_3_1_9,r_79_2_62,0.99,0,62,62,24
47,r_19_105_136,seq21,seq106,r_19_105_136,1,0,136,136,24
9,r_94_124_70,r_125_92_106,seq126,r_125_92_106,0.87,2,108,106,24
39,r_13_82_136,r_104_15_38,seq83,r_13_82_136,0.99,0,136,136,24
74,seq60,r_59_101_177,r_99_62_150,r_99_62_150,0.95,27,177,150,24
18,r_114_61_186,r_115_54_196,r_99_62_150,r_99_62_150,0.81,36,186,150,24
29,r_26_16_174,seq23,r_104_15_38,r_104_15_38,1,136,174,38,24
24,r_44_36_171,r_46_130_149,seq39,r_46_130_149,0.82,0,149,149,24
25,r_75_20_189,r_76_134_196,r_12_17_13,r_75_20_189,0.19,0,189,189,24
33,r_110_40_163,seq111,seq39,r_110_40_163,0.69,0,163,163,24
63,seq28,r_29_34_23,r_27_70_99,r_29_34_23,0.43,-7,16,23,24
64,seq31,seq33,r_122_32_91,r_122_32_91,1,13,104,91,24
15,r_104_15_38,seq106,seq21,r_104_15_38,1,0,38,38,24
50,seq129,seq126,r_46_130_149,r_46_130_149,0.78,1,150,149,24
82,seq73,r_74_6_60,r_76_134_196,r_74_6_60,1,-1,59,60,24
38,r_53_112_132,seq51,r_143_108_104,r_53_112_132,0.92,0,132,132,24
21,r_43_55_46,r_44_36_171,seq51,r_43_55_46,1,0,46,46,24
9,r_94_124_70,r_98_137_176,r_125_92_106,r_94_124_70,0.8,0,70,70,24
16,r_102_97_100,r_98_137_176,r_25_93_82,r_98_137_176,1,1,177,176,24
22,r_86_9_90,seq85,seq7,r_86_9_90,0.98,0,90,90,24
28,r_38_119_149,seq33,seq118,r_38_119_149,0.59,0,149,149,24
46,r_52_144_55,r_49_132_180,seq148,r_52_144_55,0.99,-1,54,55,24
24,r_44_36_171,seq39,r_50_37_34,r_44_36_171,0.56,0,171,171,24
56,seq142,r_143_108_104,r_57_141_59,r_57_141_59,0.92,18,77,59,24
7,r_98_137_176,seq95,r_102_97_100,r_102_97_100,1,29,129,100,24
44,r_27_70_99,seq23,r_14_69_28,r_27_70_99,0.94,0,99,99,24
32,r_29_34_23,seq28,seq33,r_29_34_23,1,0,23,23,24
23,r_100_0_141,r_99_62_150,r_3_1_9,r_100_0_141,0.8,0,141,141,24
16,r_102_97_100,r_115_54_196,seq107,r_115_54_196,0.5,-165,31,196,24
36,r_128_135_96,seq129,r_74_136_23,r_74_136_23,1,80,103,23,25
47,r_141_49_107,r_59_63_8,seq51,r_141_49_107,0.55,17,124,107,25
14,r_124_148_162,seq121,r_139_145_89,r_124_148_162,0.47,0,162,162,25
8,r_139_145_89,r_133_0_139,seq147,r_133_0_139,0.73,-49,90,139,25
43,r_24_46_133,r_22_38_150,r_80_43_68,r_80_43_68,0.95,65,133,68,25
37,r_133_0_139,seq134,r_1_19_182,r_133_0_139,0.83,0,139,139,25
19,r_25_28_54,r_31_69_144,r_27_11_42,r_31_69_144,0.9,0,144,144,25
34,r_33_16_121,seq34,r_22_38_150,r_33_16_121,0.6,-96,25,121,25
71,seq51,r_52_3_63,r_58_47_162,r_52_3_63,0.9,0,63,63,25
16,r_58_47_162,r_64_76_197,r_94_60_97,r_94_60_97,1,2,99,97,25
21,r_94_60_97,r_91_26_196,r_58_47_162,r_94_60_97,0.99,0,97,97,25
1,r_17_21_181,r_18_84_144,r_33_16_121,r_17_21_181,0.85,-45,136,181,25
46,r_108_123_65,seq107,seq121,r_108_123_65,1,0,65,65,25
45,r_117_32_162,seq116,r_25_28_54,r_117_32_162,0.57,0,162,162,25
19,r_25_28_54,r_27_11_42,r_70_29_169,r_70_29_169,0.99,1,170,169,25
9,r_132_101_40,r_133_0_139,seq98,r_132_101_40,1,0,40,40,25
27,r_53_37_35,seq42,r_22_38_150,r_22_38_150,0.99,12,162,150,25
41,r_149_110_115,seq147,seq111,r_149_110_115,0.99,1,116,115,25
4,r_30_90_77,r_27_11_42,r_31_69_144,r_30_90_77,0.67,-37,40,77,25
28,r_62_71_33,r_58_47_162,r_70_29_169,r_62_71_33,0.97,0,33,33,25
16,r_58_47_162,r_94_60_97,r_78_41_84,r_58_47_162,0.82,0,162,162,25
34,r_33_16_121,r_137_36_7,r_17_21_181,r_33_16_121,0.72,1,122,121,25
0,r_55_57_177,seq56,r_94_60_97,r_94_60_97,0.97,80,177,97,25
63,seq147,r_149_110_115,r_139_145_89,r_149_110_115,0.89,-14,101,115,25
11,r_78_41_84,seq75,seq42,r_78_41_84,0.99,0,84,84,25
39,r_93_12_31,r_78_41_84,seq13,r_93_12_31,1,0,31,31,25
15,r_2_99_101,seq4,seq98,r_2_99_101,0.98,0,101,101,25
48,r_39_146_124,seq44,r_139_145_89,r_39_146_124,0.93,0,124,124,25
6,r_1_19_182,r_133_0_139,r_33_16_121,r_1_19_182,0.97,0,182,182,25
49,r_31_69_144,r_25_28_54,seq67,r_31_69_144,0.97,0,144,144,25
13,r_40_97_16,r_96_81_150,r_61_95_78,r_61_95_78,0.91,77,155,78,25
21,r_94_60_97,r_58_47_162,r_59_63_8,r_58_47_162,0.74,0,162,162,25
27,r_53_37_35,r_52_3_63,seq42,r_53_37_35,0.98,-2,33,35,25
10,r_8_115_33,seq7,seq114,r_8_115_33,0.99,0,33,33,25
2,r_96_81_150,r_40_97_16,r_100_79_101,r_40_97_16,0.9,134,150,16,25
64,seq20,r_24_46_133,r_93_12_31,r_93_12_31,0.99,1,32,31,25
42,r_70_29_169,seq67,r_62_71_33,r_62_71_33,0.97,-1,32,33,25
19,r_25_28_54,r_24_46_133,r_31_69_144,r_25_28_54,0.74,0,54,54,25
2,r_96_81_150,r_100_79_101,r_40_97_16,r_40_97_16,0.88,1,17,16,25
34,r_33_16_121,r_17_21_181,seq15,r_17_21_181,0.54,-2,179,181,25
6,r_1_19_182,r_5_113_73,seq4,r_5_113_73,0.81,-35,38,73,25
30,r_125_112_112,seq118,seq111,r_125_112_112,0.96,0,112,112,25
47,r_141_49_107,r_142_82_139,r_59_63_8,r_141_49_107,0.78,0,107,107,25
40,r_52_3_63,seq51,seq4,r_52_3_63,1,0,63,63,25
18,r_54_92_184,r_55_57_177,r_94_60_97,r_94_60_97,0.67,17,114,97,25
29,r_91_26_196,r_94_60_97,r_30_90_77,r_91_26_196,0.75,-119,77,196,25
25,r_18_84_144,r_17_21_181,seq85,r_18_84_144,0.82,0,144,144,25
33,r_22_38_150,seq23,r_53_37_35,r_22_38_150,0.85,0,150,150,25
4,r_30_90_77,r_31_69_144,seq89,r_30_90_77,0.62,1,78,77,25
6,r_1_19_182,seq4,r_133_0_139,r_1_19_182,0.56,-43,139,182,25
65,seq23,r_22_38_150,seq20,r_22_38_150,1,0,150,150,25
68,seq42,seq44,r_78_41_84,r_78_41_84,1,40,124,84,25
42,r_70_29_169,r_62_71_33,r_25_28_54,r_70_29_169,0.77,0,169,169,25
61,seq15,seq14,r_1_19_182,r_1_19_182,0.6,7,189,182,25
37,r_133_0_139,r_1_19_182,r_52_3_63,r_133_0_139,0.53,42,181,139,25
38,r_142_82_139,seq129,r_100_79_101,r_142_82_139,0.84,0,139,139,25
77,seq75,seq77,r_100_79_101,r_100_79_101,1,45,146,101,25
71,seq51,r_58_47_162,r_141_49_107,r_141_49_107,0.69,16,123,107,25
64,seq20,r_93_12_31,seq23,r_93_12_31,0.41,157,188,31,25
30,r_125_112_112,seq119,seq118,r_125_112_112,0.36,-80,32,112,25
28,r_62_71_33,r_70_29_169,r_48_72_142,r_62_71_33,0.76,136,169,33,25
29,r_91_26_196,r_30_90_77,r_17_21_181,r_17_21_181,0.34,15,196,181,25
22,r_59_63_8,r_64_76_197,r_94_60_97,r_94_60_97,0.99,69,166,97,25
13,r_40_97_16,r_39_146_124,r_96_81_150,r_40_97_16,0.99,1,17,16,25
49,r_31_69_144,r_30_90_77,r_25_28_54,r_31_69_144,0.61,-69,75,144,25
1,r_17_21_181,r_33_16_121,seq20,r_17_21_181,0.45,0,181,181,25
20,r_74_136_23,r_70_29_169,seq140,r_74_136_23,0.97,0,23,23,25
7,r_100_79_101,seq98,seq75,r_100_79_101,1,0,101,101,25
18,r_54_92_184,r_94_60_97,r_30_90_77,r_54_92_184,0.77,0,184,184,25
44,r_61_95_78,r_58_47_162,r_40_97_16,r_61_95_78,1,0,78,78,25
35,r_27_11_42,r_30_90_77,r_93_12_31,r_27_11_42,1,1,43,42,25
23,r_48_72_142,seq42,r_62_71_33,r_48_72_142,0.79,-1,141,142,25
34,r_33_16_121,r_22_38_150,r_137_36_7,r_33_16_121,0.52,-65,56,121,25
30,r_29_80_102,r_30_18_183,seq79,r_29_80_102,1,0,102,102,26
29,r_72_52_112,r_74_47_83,seq83,r_72_52_112,0.65,-67,45,112,26
8,r_70_103_68,seq68,r_125_102_45,r_70_103_68,0.49,1,69,68,26
37,r_130_10_86,r_133_28_114,r_7_9_127,r_130_10_86,0.86,0,86,86,26
20,r_57_45_91,r_86_61_46,seq44,r_57_45_91,0.99,0,91,91,26
16,r_92_108_173,seq94,r_111_107_122,r_111_107_122,0.46,52,174,122,26
21,r_110_93_157,r_111_107_122,r_22_87_148,r_22_87_148,0.89,7,155,148,26
1,r_118_131_116,r_117_106_145,r_135_132_66,r_118_131_116,0.98,0,116,116,26
5,r_64_75_40,seq65,seq83,r_64_75_40,0.78,22,62,40,26
46,r_58_59_75,r_57_45_91,r_86_61_46,r_57_45_91,0.89,-16,75,91,26
42,r_117_106_145,r_116_146_174,r_111_107_122,r_116_146_174,0.65,-29,145,174,26
80,seq56,r_57_45_91,r_58_59_75,r_57_45_91,1,-12,79,91,26
96,seq113,seq123,r_5_112_131,r_5_112_131,1,9,140,131,26
69,seq31,r_33_98_129,seq36,r_33_98_129,0.91,1,130,129,26
45,r_48_104_168,r_49_43_178,r_70_103_68,r_49_43_178,0.47,-9,169,178,26
7,r_60_15_54,seq62,r_7_9_127,r_60_15_54,1,0,54,54,26
31,r_30_18_183,r_29_80_102,r_76_25_35,r_30_18_183,0.64,-81,102,183,26
41,r_22_87_148,seq23,r_110_93_157,r_22_87_148,0.9,0,148,148,26
49,r_119_20_33,r_120_141_48,seq23,r_119_20_33,1,0,33,33,26
10,r_5_112_131,seq4,seq113,r_5_112_131,0.94,0,131,131,26
26,r_35_40_90,r_34_144_122,seq41,r_34_144_122,0.57,-31,91,122,26
36,r_86_61_46,seq83,seq62,r_86_61_46,0.84,3,49,46,26
4,r_49_43_178,r_48_104_168,r_35_40_90,r_35_40_90,0.61,87,177,90,26
0,r_50_127_152,seq53,seq129,r_50_127_152,0.73,-1,151,152,26
23,r_90_71_36,r_92_108_173,seq68,r_90_71_36,0.88,5,41,36,26
20,r_57_45_91,r_58_59_75,r_86_61_46,r_86_61_46,0.72,27,73,46,26
19,r_91_66_27,r_90_71_36,seq65,r_91_66_27,0.81,0,27,27,26
13,r_32_99_99,r_34_144_122,seq97,r_32_99_99,0.86,0,99,99,26
15,r_145_105_162,seq147,r_111_107_122,r_145_105_162,0.77,0,162,162,26
6,r_88_17_144,r_89_77_119,r_100_16_25,r_89_77_119,0.77,26,145,119,26
5,r_64_75_40,seq83,r_89_77_119,r_64_75_40,0.54,105,145,40,26
27,r_120_141_48,r_116_146_174,r_140_142_18,r_120_141_48,1,-1,47,48,26
79,seq55,r_90_71_36,r_58_59_75,r_90_71_36,0.52,84,120,36,26
2,r_133_28_114,seq136,r_30_18_183,r_133_28_114,0.89,0,114,114,26
40,r_101_95_49,seq97,r_114_96_78,r_114_96_78,0.7,0,78,78,26
18,r_38_137_161,seq44,r_140_142_18,r_140_142_18,0.58,143,161,18,26
25,r_34_144_122,r_33_98_129,seq147,r_34_144_122,0.95,0,122,122,26
35,r_37_27_125,seq36,r_133_28_114,r_37_27_125,0.86,0,125,125,26
35,r_37_27_125,r_32_99_99,seq36,r_32_99_99,0.92,-2,97,99,26
70,seq36,r_33_98_129,seq31,r_33_98_129,0.88,-6,123,129,26
64,seq147,r_145_105_162,seq148,r_145_105_162,0.89,0,162,162,26
44,r_100_16_25,r_88_17_144,seq4,r_100_16_25,1,0,25,25,26
95,seq97,r_101_95_49,r_125_102_45,r_125_102_45,1,7,52,45,26
38,r_114_96_78,r_118_131_116,r_101_95_49,r_118_131_116,0.66,-38,78,116,26
31,r_30_18_183,r_76_25_35,r_133_28_114,r_30_18_183,0.64,-69,114,183,26
17,r_111_107_122,r_110_93_157,r_117_106_145,r_110_93_157,0.39,-2,155,157,26
94,seq94,r_92_108_173,r_110_93_157,r_110_93_157,0.52,18,175,157,26
79,seq55,seq56,r_90_71_36,r_90_71_36,0.85,10,46,36,26
29,r_72_52_112,seq83,seq51,r_72_52_112,0.71,0,112,112,26
22,r_39_67_137,r_42_73_150,r_91_66_27,r_91_66_27,0.65,113,140,27,26
28,r_74_47_83,r_72_52_112,seq46,r_74_47_83,0.57,0,83,83,26
14,r_76_25_35,r_72_52_112,seq24,r_76_25_35,1,0,35,35,26
56,seq129,r_128_122_166,r_50_127_152,r_50_127_152,0.58,4,156,152,26
12,r_89_77_119,r_88_17_144,r_64_75_40,r_89_77_119,0.66,0,119,119,26
93,seq106,r_108_112_71,r_149_107_117,r_149_107_117,1,10,127,117,27
30,r_83_122_114,seq86,r_139_121_91,r_83_122_114,0.99,0,114,114,27
51,seq128,seq123,r_139_121_91,r_139_121_91,0.97,45,136,91,27
36,r_28_19_193,r_27_11_152,r_4_30_125,r_4_30_125,0.49,27,152,125,27
5,r_84_13_51,r_83_122_114,r_54_12_17,r_84_13_51,0.95,0,51,51,27
14,r_100_116_1,r_118_114_160,r_56_115_67,r_56_115_67,1,83,150,67,27
8,r_64_120_179,seq63,r_148_119_110,r_64_120_179,0.7,0,179,179,27
43,r_149_107_117,r_148_119_110,seq106,r_149_107_117,1,-7,110,117,27
37,r_5_16_197,seq9,r_36_7_65,r_36_7_65,1,1,66,65,27
3,r_54_12_17,seq15,r_84_13_51,r_84_13_51,1,27,78,51,27
57,seq141,seq140,r_8_142_19,r_8_142_19,1,9,28,19,27
71,seq42,r_43_135_174,seq40,r_43_135_174,1,0,174,174,27
86,seq77,r_78_2_74,seq88,r_78_2_74,1,1,75,74,27
16,r_139_121_91,seq140,seq123,r_139_121_91,0.46,0,91,91,27
21,r_18_133_164,seq20,seq144,r_18_133_164,0.58,0,164,164,27
39,r_118_114_160,r_100_116_1,seq109,r_118_114_160,0.58,0,160,160,27
36,r_28_19_193,r_4_30_125,r_54_12_17,r_28_19_193,0.99,0,193,193,27
46,r_91_45_92,r_92_137_199,seq136,r_92_137_199,0.9,-100,99,199,27
32,r_92_137_199,r_38_90_4,r_8_142_19,r_8_142_19,0.81,180,199,19,27
45,r_147_49_213,r_149_107_117,r_8_142_19,r_147_49_213,0.99,-96,117,213,27
16,r_139_121_91,seq123,r_83_122_114,r_83_122_114,0.52,1,115,114,27
24,r_76_29_201,seq75,r_4_30_125,r_76_29_201,0.9,0,201,201,27
19,r_39_6_144,seq40,r_129_17_67,r_39_6_144,0.92,0,144,144,27
11,r_46_74_56,r_44_32_31,seq75,r_46_74_56,0.99,-25,31,56,27
25,r_146_31_22,r_27_11_152,r_44_32_31,r_44_32_31,0.95,3,34,31,27
26,r_36_7_65,seq35,r_5_16_197,r_36_7_65,1,0,65,65,27
4,r_98_138_208,seq102,r_8_142_19,r_8_142_19,0.78,189,208,19,27
0,r_96_131_170,seq102,r_139_121_91,r_96_131_170,0.69,6,176,170,27
73,seq52,r_51_34_123,r_143_50_6,r_51_34_123,0.97,0,123,123,27
1,r_79_124_20,r_125_94_157,seq126,r_125_94_157,0.89,-98,59,157,27
20,r_41_105_164,r_43_135_174,r_59_104_139,r_41_105_164,0.79,0,164,164,27
13,r_43_135_174,seq42,r_18_133_164,r_43_135_174,0.78,0,174,174,27
98,seq123,r_125_94_157,seq126,r_125_94_157,0.99,-88,69,157,27
15,r_148_119_110,r_149_107_117,r_139_121_91,r_149_107_117,0.88,-7,110,117,27
6,r_134_57_159,r_147_49_213,seq58,r_134_57_159,0.7,0,159,159,27
21,r_18_133_164,seq144,r_43_135_174,r_43_135_174,0.82,15,189,174,27
85,seq75,r_95_73_4,r_46_74_56,r_46_74_56,1,8,64,56,27
27,r_127_14_169,seq126,r_54_12_17,r_127_14_169,0.7,0,169,169,27
47,r_89_48_220,r_92_137_199,r_98_138_208,r_98_138_208,0.38,-42,166,208,27
74,seq58,r_59_104_139,seq60,r_59_104_139,1,0,139,139,27
18,r_27_11_152,r_28_19_193,seq10,r_27_11_152,0.75,0,152,152,27
24,r_76_29_201,r_81_82_7,seq75,r_76_29_201,0.45,-121,80,201,27
33,r_130_117_107,seq123,r_100_116_1,r_130_117_107,0.86,1,108,107,27
88,seq86,r_83_122_114,seq80,r_83_122_114,1,0,114,114,27
50,seq0,r_4_30_125,r_78_2_74,r_78_2_74,0.66,51,125,74,27
70,seq40,r_41_105_164,seq42,r_41_105_164,1,-4,160,164,27
34,r_3_53_96,r_4_30_125,seq58,r_3_53_96,1,0,96,96,27
25,r_146_31_22,r_148_119_110,r_27_11_152,r_146_31_22,0.96,0,22,22,27
45,r_147_49_213,r_8_142_19,r_143_50_6,r_147_49_213,0.33,0,213,213,27
17,r_56_115_67,r_59_104_139,r_100_116_1,r_56_115_67,1,0,67,67,27
9,r_78_2_74,seq77,seq0,r_78_2_74,0.96,0,74,74,27
3,r_54_12_17,r_59_104_139,seq15,r_54_12_17,0.84,0,17,17,27
31,r_38_90_4,r_92_137_199,r_134_57_159,r_134_57_159,0.68,40,199,159,27
28,r_129_17_67,r_130_117_107,seq15,r_129_17_67,1,0,67,67,27
47,r_89_48_220,r_98_138_208,r_38_90_4,r_89_48_220,0.54,-41,179,220,27
49,r_99_93_174,seq102,r_125_94_157,r_99_93_174,0.43,3,177,174,27
41,r_85_103_58,r_83_122_114,seq111,r_85_103_58,1,0,58,58,27
7,r_4_30_125,seq0,r_146_31_22,r_4_30_125,0.82,0,125,125,27
44,r_125_94_157,r_127_14_169,r_99_93_174,r_125_94_157,0.65,0,157,157,27
82,seq69,r_68_1_150,seq71,r_68_1_150,0.98,0,150,150,27
1,r_79_124_20,r_81_82_7,r_125_94_157,r_79_124_20,0.85,0,20,20,27
42,r_55_21_50,r_59_104_139,seq22,r_55_21_50,1,0,50,50,27
35,r_44_32_31,r_46_74_56,r_146_31_22,r_44_32_31,1,0,31,31,27
22,r_8_142_19,r_5_16_197,seq141,r_8_142_19,1,1,20,19,27
12,r_51_34_123,seq52,seq35,r_51_34_123,1,0,123,123,27
92,seq107,r_108_56_183,seq110,r_108_56_183,0.66,-1,182,183,28
8,r_87_114_129,seq86,seq115,r_87_114_129,0.57,0,129,129,28
43,r_34_50_113,seq35,r_121_48_90,r_34_50_113,0.73,0,113,113,28
83,seq142,seq143,r_60_136_68,r_60_136_68,1,89,157,68,28
86,seq91,r_92_148_115,seq88,r_92_148_115,1,-21,94,115,28
16,r_118_27_143,r_119_81_151,r_128_26_51,r_118_27_143,0.56,0,143,143,28
21,r_31_113_62,r_36_13_65,seq112,r_31_113_62,0.84,0,62,62,28
14,r_69_29_43,r_70_140_44,r_22_0_194,r_69_29_43,0.72,0,43,43,28
5,r_74_85_150,seq75,seq83,r_74_85_150,0.51,2,152,150,28
46,r_121_48_90,r_119_81_151,seq51,r_121_48_90,0.96,0,90,90,28
11,r_37_139_37,r_137_4_174,r_43_138_144,r_37_139_37,0.77,124,161,37,28
32,r_145_149_4,r_47_147_84,r_92_148_115,r_92_148_115,0.89,21,136,115,28
1,r_84_10_47,r_87_114_129,r_49_11_141,r_87_114_129,0.63,-82,47,129,28
11,r_37_139_37,r_36_13_65,r_137_4_174,r_37_139_37,0.75,0,37,37,28
41,r_90_19_107,r_92_148_115,seq18,r_90_19_107,0.68,0,107,107,28
14,r_69_29_43,r_22_0_194,r_128_26_51,r_69_29_43,0.64,26,69,43,28
20,r_94_77_15,seq95,r_15_76_9,r_94_77_15,0.65,1,16,15,28
10,r_36_13_65,seq35,seq14,r_36_13_65,0.99,0,65,65,28
25,r_1_109_45,r_3_28_106,seq111,r_1_109_45,1,0,45,45,28
26,r_47_147_84,r_43_138_144,r_145_149_4,r_43_138_144,0.84,-60,84,144,28
4,r_106_96_65,r_104_39_101,r_97_98_18,r_106_96_65,0.66,1,66,65,28
15,r_119_81_151,seq120,r_74_85_150,r_119_81_151,0.65,0,151,151,28
37,r_126_71_37,r_128_26_51,seq72,r_126_71_37,0.97,0,37,37,28
6,r_122_38_79,seq123,seq35,r_122_38_79,0.67,0,79,79,28
38,r_12_55_175,r_87_114_129,r_33_54_58,r_12_55_175,0.6,-6,169,175,28
27,r_104_39_101,seq105,seq40,r_104_39_101,0.52,0,101,101,28
47,r_66_16_87,r_62_65_184,r_36_13_65,r_66_16_87,0.68,0,87,87,28
6,r_122_38_79,seq35,r_104_39_101,r_104_39_101,0.52,26,127,101,28
40,r_116_103_92,seq115,seq105,r_116_103_92,0.81,0,92,92,28
18,r_3_28_106,seq5,r_69_29_43,r_3_28_106,1,0,106,106,28
24,r_61_23_84,r_62_65_184,seq21,r_61_23_84,0.6,0,84,84,28
64,seq35,r_34_50_113,r_30_146_149,r_34_50_113,0.84,0,113,113,28
32,r_145_149_4,seq143,r_47_147_84,r_47_147_84,0.45,5,89,84,28
45,r_137_4_174,r_141_46_148,r_37_139_37,r_37_139_37,0.82,1,38,37,28
29,r_70_140_44,seq72,seq142,r_70_140_44,0.93,0,44,44,28
34,r_117_124_67,r_116_103_92,seq130,r_117_124_67,0.98,0,67,67,28
2,r_32_133_25,r_31_113_62,seq132,r_32_133_25,0.92,0,25,25,28
45,r_137_4_174,r_37_139_37,r_8_2_161,r_37_139_37,0.63,137,174,37,28
9,r_60_136_68,seq59,seq142,r_60_136_68,0.61,0,68,68,28
26,r_47_147_84,r_145_149_4,r_30_146_149,r_30_146_149,1,8,157,149,28
22,r_108_56_183,seq107,r_33_54_58,r_33_54_58,0.78,119,177,58,28
30,r_52_68_54,seq53,seq72,r_52_68_54,0.86,0,54,54,28
7,r_99_7_158,seq100,seq5,r_99_7_158,0.79,0,158,158,28
0,r_128_26_51,seq123,r_69_29_43,r_128_26_51,0.84,0,51,51,28
44,r_92_148_115,r_89_25_137,r_145_149_4,r_92_148_115,0.72,1,116,115,28
39,r_24_64_22,r_22_0_194,r_62_65_184,r_24_64_22,0.84,0,22,22,28
30,r_3_6_136,seq4,seq7,r_3_6_136,0.97,0,136,136,29
36,r_78_136_62,seq79,r_137_24_152,r_78_136_62,1,0,62,62,29
9,r_82_37_66,r_38_65_177,r_25_36_163,r_25_36_163,0.8,15,178,163,29
92,seq107,seq113,r_98_106_144,r_98_106_144,1,9,153,144,29
43,r_139_31_159,seq140,r_122_29_29,r_139_31_159,0.74,0,159,159,29
25,r_0_93_24,r_2_57_71,seq94,r_0_93_24,1,0,24,24,29
83,seq81,r_82_37_66,seq79,r_82_37_66,1,3,69,66,29
37,r_98_106_144,seq99,r_22_105_74,r_98_106_144,0.84,0,144,144,29
59,seq145,r_144_33_109,seq146,r_144_33_109,1,0,109,109,29
17,r_64_116_23,r_49_130_38,r_111_119_2,r_111_119_2,0.87,21,23,2,29
16,r_28_87_130,r_26_129_159,seq86,r_28_87_130,0.93,0,130,130,29
39,r_2_57_71,r_1_34_154,r_56_9_164,r_2_57_71,1,0,71,71,29
97,seq120,r_125_102_110,seq121,r_125_102_110,1,-34,76,110,29
36,r_78_136_62,r_137_24_152,r_80_135_51,r_137_24_152,0.87,-49,103,152,29
46,r_132_62_102,r_131_108_152,r_44_60_45,r_132_62_102,1,0,102,102,29
42,r_27_14_81,r_28_87_130,r_74_15_30,r_27_14_81,1,4,85,81,29
7,r_38_65_177,r_82_37_66,r_128_66_59,r_38_65_177,0.62,0,177,177,29
35,r_117_141_1,seq138,r_123_142_47,r_123_142_47,0.99,3,50,47,29
45,r_1_34_154,r_2_57_71,seq4,r_2_57_71,1,0,71,71,29
19,r_13_88_159,seq12,r_59_92_115,r_59_92_115,0.5,44,159,115,29
5,r_122_29_29,r_125_102_110,seq30,r_122_29_29,1,0,29,29,29
11,r_137_24_152,r_78_136_62,seq7,r_137_24_152,0.89,0,152,152,29
39,r_2_57_71,r_56_9_164,r_54_53_12,r_56_9_164,0.56,0,164,164,29
22,r_131_108_152,r_49_130_38,seq110,r_131_108_152,0.68,0,152,152,29
41,r_55_41_99,r_56_9_164,seq42,r_56_9_164,0.56,-65,99,164,29
10,r_56_9_164,r_54_53_12,r_2_57_71,r_2_57_71,1,0,71,71,29
11,r_137_24_152,seq134,r_78_136_62,r_78_136_62,1,-2,60,62,29
20,r_59_92_115,r_61_63_172,seq94,r_59_92_115,0.98,0,115,115,29
13,r_144_33_109,seq145,seq48,r_144_33_109,0.97,0,109,109,29
98,seq121,r_125_102_110,seq120,r_125_102_110,1,-25,85,110,29
4,r_49_130_38,r_131_108_152,seq126,r_131_108_152,0.72,0,152,152,29
26,r_18_100_19,seq20,seq99,r_18_100_19,1,0,19,19,29
99,seq126,r_127_43_194,r_109_115_39,r_127_43_194,0.51,0,194,194,29
33,r_101_103_15,r_112_104_130,r_64_116_23,r_101_103_15,0.46,31,46,15,29
27,r_25_36_163,seq30,r_82_37_66,r_82_37_66,1,96,162,66,29
34,r_123_142_47,r_125_102_110,seq146,r_123_142_47,1,0,47,47,29
44,r_23_143_111,r_74_15_30,r_123_142_47,r_23_143_111,0.98,0,111,111,29
40,r_22_105_74,r_23_143_111,seq107,r_22_105_74,0.99,0,74,74,29
74,seq140,r_139_31_159,seq138,r_139_31_159,1,0,159,159,29
18,r_70_84_187,seq72,seq83,r_70_84_187,0.36,0,187,187,29
2,r_74_15_30,seq73,seq16,r_74_15_30,1,0,30,30,29
48,r_80_135_51,r_137_24_152,r_78_136_62,r_137_24_152,0.6,0,152,152,29
31,r_44_60_45,seq45,r_61_63_172,r_61_63_172,0.62,-127,45,172,29
58,seq16,seq20,r_74_15_30,r_74_15_30,0.98,54,84,30,29
33,r_101_103_15,r_98_106_144,r_112_104_130,r_101_103_15,0.96,0,15,15,29
32,r_124_19_137,r_125_102_110,seq120,r_125_102_110,0.72,-24,86,110,29
38,r_90_32_167,seq94,r_144_33_109,r_90_32_167,0.58,0,167,167,29
4,r_49_130_38,seq45,r_131_108_152,r_49_130_38,0.93,0,38,38,29
45,r_1_34_154,seq4,r_144_33_109,r_1_34_154,0.92,-1,153,154,29
33,r_101_103_15,r_64_116_23,seq110,r_101_103_15,0.39,75,90,15,29
9,r_82_37_66,seq81,r_38_65_177,r_82_37_66,1,1,67,66,29
13,r_144_33_109,seq48,r_90_32_167,r_90_32_167,0.8,0,167,167,29
22,r_131_108_152,r_132_62_102,r_49_130_38,r_131_108_152,0.92,-50,102,152,29
28,r_125_102_110,r_124_19_137,r_18_100_19,r_125_102_110,0.98,0,110,110,29
29,r_17_47_21,seq16,seq48,r_17_47_21,0.72,3,24,21,29
49,r_128_66_59,r_127_43_194,seq69,r_128_66_59,0.99,0,59,59,29
7,r_38_65_177,seq39,r_82_37_66,r_82_37_66,1,41,107,66,29
44,r_23_143_111,r_22_105_74,r_74_15_30,r_23_143_111,0.63,-37,74,111,29
41,r_55_41_99,r_54_53_12,r_56_9_164,r_55_41_99,0.34,-42,57,99,29
82,seq79,r_78_136_62,seq77,r_78_136_62,0.87,0,62,62,29
32,r_124_19_137,seq120,seq21,r_124_19_137,1,0,137,137,29
12,r_67_35_160,seq69,r_1_34_154,r_1_34_154,0.89,8,162,154,29
48,r_80_135_51,seq81,r_137_24_152,r_80_135_51,0.99,0,51,51,29
49,r_115_15_43,r_121_80_91,seq16,r_115_15_43,1,1,44,43,30
29,r_78_99_45,seq73,seq100,r_78_99_45,0.98,0,45,45,30
8,r_59_7_114,seq58,seq6,r_59_7_114,0.72,1,115,114,30
37,r_124_35_73,r_121_80_91,r_20_34_13,r_124_35_73,1,0,73,73,30
59,seq11,r_12_81_127,seq10,r_12_81_127,0.98,0,127,127,30
55,seq6,seq10,r_59_7_114,r_59_7_114,0.91,9,123,114,30
71,seq51,r_52_0_85,r_55_64_144,r_52_0_85,0.75,0,85,85,30
16,r_71_145_169,seq70,r_109_146_123,r_71_145_169,0.83,0,169,169,30
21,r_3_42_178,r_4_104_189,r_14_41_148,r_4_104_189,0.6,-11,178,189,30
71,seq51,r_126_50_88,r_127_53_150,r_127_53_150,1,8,158,150,30
1,r_28_74_150,r_29_136_188,r_27_75_101,r_27_75_101,0.7,49,150,101,30
45,r_52_0_85,seq51,seq1,r_52_0_85,1,0,85,85,30
13,r_76_24_42,seq77,seq30,r_76_24_42,1,0,42,42,30
19,r_45_130_149,seq46,r_125_132_106,r_45_130_149,0.78,0,149,149,30
33,r_37_107_185,r_67_36_58,r_19_129_161,r_67_36_58,0.85,127,185,58,30
66,seq30,r_31_97_137,r_20_34_13,r_31_97_137,1,0,137,137,30
40,r_140_26_34,r_139_137_124,seq25,r_140_26_34,1,0,34,34,30
35,r_147_72_22,r_148_82_65,seq73,r_147_72_22,0.75,0,22,22,30
31,r_14_41_148,seq13,seq40,r_14_41_148,0.9,2,150,148,30
3,r_4_104_189,r_3_42_178,seq10,r_4_104_189,0.24,-53,136,189,30
10,r_19_129_161,r_21_68_158,r_45_130_149,r_21_68_158,0.53,-1,157,158,30
24,r_49_90_53,r_45_130_149,seq89,r_49_90_53,1,0,53,53,30
26,r_31_97_137,seq30,r_123_88_103,r_31_97_137,0.9,0,137,137,30
72,seq58,r_59_7_114,r_66_61_57,r_59_7_114,0.59,1,115,114,30
4,r_148_82_65,seq149,r_133_84_17,r_148_82_65,1,0,65,65,30
78,seq70,r_71_145_169,r_91_48_80,r_91_48_80,0.95,86,166,80,30
0,r_91_48_80,seq92,seq47,r_91_48_80,0.99,0,80,80,30
11,r_86_118_84,seq87,r_105_119_3,r_86_118_84,0.97,0,84,84,30
5,r_133_84_17,r_135_54_192,r_83_56_199,r_133_84_17,0.9,-6,11,17,30
48,r_60_79_159,r_66_61_57,r_121_80_91,r_60_79_159,0.69,0,159,159,30
13,r_76_24_42,seq30,r_120_23_150,r_120_23_150,0.96,0,150,150,30
17,r_29_136_188,r_20_34_13,r_139_137_124,r_29_136_188,0.83,0,188,188,30
2,r_55_64_144,seq51,seq65,r_55_64_144,0.58,0,144,144,30
18,r_106_57_152,seq110,seq58,r_106_57_152,0.76,0,152,152,30
33,r_37_107_185,seq40,r_67_36_58,r_67_36_58,0.99,59,117,58,30
42,r_21_68_158,r_19_129_161,seq69,r_19_129_161,0.89,-2,159,161,30
61,seq142,seq149,r_22_141_33,r_22_141_33,1,82,115,33,30
32,r_109_146_123,seq110,seq149,r_109_146_123,0.83,1,124,123,30
77,seq69,r_71_145_169,r_21_68_158,r_71_145_169,0.89,-10,159,169,30
34,r_135_54_192,r_139_137_124,r_127_53_150,r_127_53_150,0.54,37,187,150,30
5,r_133_84_17,r_83_56_199,r_148_82_65,r_148_82_65,1,0,65,65,30
43,r_67_36_58,r_66_61_57,r_32_38_79,r_67_36_58,1,0,58,58,30
17,r_29_136_188,r_28_74_150,r_20_34_13,r_28_74_150,0.89,0,150,150,30
20,r_22_141_33,r_21_68_158,seq142,r_22_141_33,1,1,34,33,30
42,r_21_68_158,r_22_141_33,r_19_129_161,r_22_141_33,1,0,33,33,30
22,r_43_134_94,seq44,r_139_137_124,r_43_134_94,1,0,94,94,30
28,r_127_53_150,seq128,seq51,r_127_53_150,0.93,0,150,150,30
7,r_12_81_127,seq11,r_148_82_65,r_12_81_127,0.88,0,127,127,30
3,r_4_104_189,seq10,seq142,r_4_104_189,0.98,1,190,189,30
23,r_123_88_103,seq122,seq89,r_123_88_103,0.98,0,103,103,30
12,r_121_80_91,r_127_53_150,seq73,r_121_80_91,0.98,0,91,91,30
30,r_84_50_147,r_83_59_102,seq91,r_83_59_102,1,0,102,102,31
47,r_4_134_18,r_5_63_193,r_131_133_83,r_4_134_18,1,1,19,18,31
14,r_45_70_159,seq44,r_137_64_96,r_137_64_96,0.69,63,159,96,31
8,r_83_59_102,r_84_50_147,seq58,r_83_59_102,0.6,0,102,102,31
43,r_41_124_107,r_45_70_159,seq122,r_41_124_107,0.98,0,107,107,31
3,r_142_61_26,seq143,seq57,r_142_61_26,0.6,0,26,26,31
54,seq6,r_5_63_193,seq3,r_5_63_193,0.51,0,193,193,31
37,r_138_148_110,seq139,r_104_147_23,r_104_147_23,0.97,87,110,23,31
59,seq140,r_141_78_166,r_77_144_7,r_141_78_166,0.74,-1,165,166,31
16,r_33_47_141,r_28_80_106,r_109_31_68,r_33_47_141,0.8,-60,81,141,31
21,r_48_93_135,seq49,seq94,r_48_93_135,0.56,0,135,135,31
39,r_43_60_98,r_45_70_159,r_142_61_26,r_43_60_98,0.94,0,98,98,31
1,r_17_34_146,r_146_20_27,seq30,r_17_34_146,0.37,0,146,146,31
97,seq120,r_119_71_136,seq122,r_119_71_136,0.98,0,136,136,31
35,r_146_20_27,r_17_34_146,r_130_21_71,r_130_21_71,0.99,5,76,71,31
42,r_87_121_166,seq88,r_118_125_113,r_87_121_166,0.62,0,166,166,31
3,r_142_61_26,r_56_66_5,seq57,r_142_61_26,0.52,54,80,26,31
35,r_146_20_27,r_145_29_36,r_17_34_146,r_17_34_146,0.91,-121,25,146,31
41,r_145_29_36,seq143,seq30,r_145_29_36,0.99,1,37,36,31
31,r_131_133_83,r_130_21_71,r_73_132_8,r_130_21_71,1,-1,70,71,31
49,r_18_110_22,r_45_70_159,seq111,r_18_110_22,1,0,22,22,31
24,r_116_26_49,seq117,seq24,r_116_26_49,1,-1,48,49,31
10,r_97_19_123,seq95,r_149_22_115,r_97_19_123,0.95,0,123,123,31
26,r_109_31_68,seq108,r_37_81_193,r_109_31_68,1,1,69,68,31
16,r_33_47_141,r_109_31_68,seq49,r_33_47_141,0.96,0,141,141,31
4,r_92_9_184,seq96,r_48_93_135,r_48_93_135,0.78,0,135,135,31
0,r_101_46_167,seq103,r_84_50_147,r_101_46_167,0.59,0,167,167,31
63,seq24,r_27_25_75,r_116_26_49,r_116_26_49,1,43,92,49,31
11,r_137_64_96,r_136_102_175,seq74,r_137_64_96,0.97,0,96,96,31
13,r_119_71_136,seq120,r_54_69_73,r_119_71_136,0.88,0,136,136,31
15,r_118_125_113,seq117,seq122,r_118_125_113,1,0,113,113,31
40,r_141_78_166,r_109_31_68,r_101_46_167,r_141_78_166,0.39,26,192,166,31
61,seq143,r_142_61_26,r_77_144_7,r_142_61_26,0.97,0,26,26,31
6,r_105_62_119,r_101_46_167,r_142_61_26,r_105_62_119,0.95,0,119,119,31
30,r_84_50_147,seq91,seq49,r_84_50_147,0.92,0,147,147,31
85,seq94,seq95,r_48_93_135,r_48_93_135,0.84,30,165,135,31
5,r_149_22_115,r_104_147_23,r_100_23_112,r_149_22_115,1,0,115,115,31
79,seq79,r_53_12_127,r_142_61_26,r_53_12_127,0.62,-33,94,127,31
4,r_92_9_184,r_48_93_135,seq11,r_92_9_184,0.77,0,184,184,31
40,r_141_78_166,seq140,r_109_31_68,r_141_78_166,0.48,0,166,166,31
74,seq58,seq57,r_83_59_102,r_83_59_102,1,32,134,102,31
18,r_136_102_175,r_137_64_96,r_114_135_81,r_136_102_175,1,-79,96,175,31
29,r_5_63_193,seq6,r_137_64_96,r_137_64_96,0.98,97,193,96,31
1,r_17_34_146,r_18_110_22,r_146_20_27,r_17_34_146,0.98,-124,22,146,31
33,r_130_21_71,r_131_133_83,r_146_20_27,r_130_21_71,0.64,0,71,71,31
12,r_55_115_39,seq51,seq117,r_55_115_39,1,0,39,39,31
88,seq98,r_101_46_167,seq111,r_101_46_167,1,-33,134,167,31
5,r_149_22_115,r_145_29_36,r_104_147_23,r_149_22_115,0.91,-92,23,115,31
3,r_142_61_26,r_43_60_98,r_105_62_119,r_105_62_119,0.86,23,142,119,31
70,seq49,r_48_93_135,seq51,r_48_93_135,0.99,0,135,135,31
20,r_104_147_23,r_149_22_115,r_138_148_110,r_149_22_115,0.9,0,115,115,31
38,r_53_12_127,seq52,seq13,r_53_12_127,0.91,0,127,127,31
34,r_100_23_112,r_101_46_167,r_146_20_27,r_100_23_112,0.87,0,112,112,31
17,r_90_67_72,r_87_121_166,r_56_66_5,r_90_67_72,1,0,72,72,31
9,r_114_135_81,seq117,r_131_133_83,r_114_135_81,0.98,0,81,81,31
26,r_109_31_68,r_37_81_193,r_89_32_176,r_89_32_176,0.99,0,176,176,31
3,r_142_61_26,seq57,r_56_66_5,r_142_61_26,0.7,14,40,26,31
22,r_28_80_106,seq30,seq82,r_28_80_106,0.99,1,107,106,31
28,r_15_72_77,seq16,seq74,r_15_72_77,1,0,77,77,31
20,r_104_147_23,r_101_46_167,r_149_22_115,r_104_147_23,0.91,0,23,23,31
7,r_54_69_73,seq51,seq74,r_54_69_73,0.99,2,75,73,31
18,r_136_102_175,r_114_135_81,seq103,r_136_102_175,0.84,0,175,175,31
84,seq91,r_89_32_176,seq82,r_89_32_176,0.93,1,177,176,31
40,r_58_142_142,seq52,r_143_87_159,r_58_142_142,0.38,0,142,142,32
42,r_11_99_69,r_41_91_180,r_139_12_30,r_139_12_30,0.91,1,31,30,32
8,r_131_137_79,r_132_27_79,seq136,r_131_137_79,0.99,0,79,79,32
43,r_34_6_90,seq36,seq5,r_34_6_90,1,0,90,90,32
37,r_41_91_180,seq42,r_49_94_171,r_49_94_171,0.53,9,180,171,32
88,seq89,r_77_134_184,r_115_51_97,r_77_134_184,0.74,-117,67,184,32
40,r_58_142_142,r_59_95_48,seq52,r_59_95_48,1,-1,47,48,32
10,r_97_135_130,r_90_112_87,r_58_142_142,r_58_142_142,0.65,5,147,142,32
55,seq136,r_141_147_193,r_131_137_79,r_131_137_79,1,0,79,79,32
21,r_132_27_79,r_131_137_79,seq26,r_132_27_79,1,1,80,79,32
39,r_96_17_139,r_97_135_130,r_55_98_4,r_97_135_130,0.58,-22,108,130,32
1,r_56_73_72,r_58_142_142,r_75_140_193,r_56_73_72,0.98,0,72,72,32
46,r_61_2_69,seq60,seq5,r_61_2_69,1,0,69,69,32
45,r_129_74_50,r_131_137_79,r_75_140_193,r_129_74_50,0.91,1,51,50,32
30,r_43_81_22,seq42,seq83,r_43_81_22,0.93,0,22,22,32
29,r_139_12_30,r_141_147_193,r_11_99_69,r_139_12_30,0.84,0,30,30,32
2,r_143_87_159,r_58_142_142,seq88,r_143_87_159,0.92,0,159,159,32
10,r_97_135_130,r_58_142_142,r_77_134_184,r_97_135_130,0.51,49,179,130,32
41,r_53_127_111,seq52,seq130,r_53_127_111,0.97,0,111,111,32
40,r_58_142_142,r_143_87_159,seq146,r_143_87_159,0.6,0,159,159,32
88,seq89,r_115_51_97,r_56_73_72,r_56_73_72,0.57,29,101,72,32
3,r_1_79_175,seq3,seq80,r_1_79_175,0.64,0,175,175,32
10,r_97_135_130,r_55_98_4,r_90_112_87,r_55_98_4,0.51,126,130,4,32
22,r_110_76_169,r_90_112_87,seq78,r_90_112_87,0.63,82,169,87,32
26,r_90_112_87,seq93,r_138_113_17,r_90_112_87,0.92,0,87,87,32
6,r_104_31_57,seq101,seq32,r_104_31_57,1,1,58,57,32
20,r_38_71_187,r_37_30_185,r_56_73_72,r_56_73_72,0.78,113,185,72,32
13,r_49_94_171,r_48_39_153,r_59_95_48,r_59_95_48,0.82,124,172,48,32
98,seq125,r_124_33_99,seq122,r_124_33_99,1,0,99,99,32
15,r_108_119_166,seq111,r_118_120_55,r_118_120_55,0.74,111,166,55,32
48,r_141_147_193,r_148_128_174,r_131_137_79,r_131_137_79,0.94,28,107,79,32
36,r_138_113_17,r_141_147_193,r_116_145_184,r_138_113_17,0.91,0,17,17,32
14,r_75_140_193,r_77_134_184,seq83,r_75_140_193,0.41,-178,15,193,32
99,seq149,r_148_128_174,seq146,r_148_128_174,0.94,0,174,174,32
36,r_138_113_17,r_116_145_184,r_90_112_87,r_90_112_87,1,34,121,87,32
27,r_126_22_80,r_131_137_79,seq16,r_126_22_80,0.99,0,80,80,32
0,r_117_62_197,seq35,r_56_73_72,r_117_62_197,0.41,-91,106,197,32
2,r_143_87_159,r_148_128_174,r_58_142_142,r_148_128_174,0.45,-32,142,174,32
24,r_63_85_73,seq64,seq83,r_63_85_73,0.56,1,74,73,32
92,seq105,r_104_31_57,r_50_107_20,r_104_31_57,0.61,-34,23,57,32
25,r_124_33_99,seq125,seq35,r_124_33_99,0.99,0,99,99,32
33,r_55_98_4,r_97_135_130,r_90_112_87,r_55_98_4,0.74,126,130,4,32
0,r_117_62_197,r_96_17_139,r_108_119_166,r_96_17_139,0.46,33,172,139,32
38,r_114_45_79,r_116_145_184,seq42,r_114_45_79,0.99,0,79,79,32
77,seq60,r_61_2_69,seq66,r_61_2_69,1,0,69,69,32
75,seq52,r_53_127_111,seq54,r_53_127_111,0.99,-53,58,111,32
14,r_75_140_193,seq83,r_129_74_50,r_129_74_50,0.97,1,51,50,32
0,r_117_62_197,r_56_73_72,r_96_17_139,r_96_17_139,0.56,-7,132,139,32
23,r_28_100_25,r_25_106_64,seq101,r_28_100_25,0.67,0,25,25,32
4,r_50_107_20,r_49_94_171,seq105,r_49_94_171,0.6,-151,20,171,32
34,r_115_51_97,r_116_145_184,r_114_45_79,r_116_145_184,1,-83,101,184,32
31,r_92_24_47,seq93,seq32,r_92_24_47,1,0,47,47,32
32,r_59_95_48,r_58_142_142,seq93,r_59_95_48,0.9,0,48,48,32
17,r_116_145_184,r_115_51_97,r_138_113_17,r_116_145_184,0.64,-85,99,184,32
94,seq111,r_116_145_184,r_90_112_87,r_90_112_87,1,34,121,87,32
76,seq54,r_53_127_111,seq52,r_53_127_111,0.79,-63,48,111,32
91,seq101,r_104_31_57,r_28_100_25,r_104_31_57,0.94,1,58,57,32
29,r_139_12_30,r_11_99_69,seq21,r_139_12_30,0.88,66,96,30,32
22,r_110_76_169,r_109_68_131,r_90_112_87,r_90_112_87,0.56,44,131,87,32
28,r_25_106_64,seq26,r_50_107_20,r_25_106_64,1,3,67,64,32
42,r_11_99_69,r_139_12_30,r_28_100_25,r_11_99_69,0.96,0,69,69,32
7,r_37_30_185,r_38_71_187,seq29,r_38_71_187,0.32,-2,185,187,32
44,r_109_68_131,r_110_76_169,seq66,r_109_68_131,0.63,0,131,131,32
16,r_7_103_31,seq3,r_28_100_25,r_7_103_31,0.98,0,31,31,32
82,seq78,r_77_134_184,r_110_76_169,r_110_76_169,0.96,15,184,169,32
35,r_15_8_64,seq14,seq5,r_15_8_64,1,0,64,64,32
12,r_77_134_184,seq78,r_97_135_130,r_97_135_130,0.73,54,184,130,32
43,r_26_52_84,r_23_42_192,seq53,r_26_52_84,0.86,0,84,84,33
37,r_68_56_28,seq69,r_48_57_23,r_68_56_28,0.78,0,28,28,33
71,seq53,seq44,r_26_52_84,r_26_52_84,0.62,4,88,84,33
21,r_70_90_81,seq72,seq91,r_70_90_81,0.63,1,82,81,33
39,r_36_77_118,r_35_82_143,r_49_76_58,r_35_82_143,0.89,-25,118,143,33
1,r_97_54_93,r_96_95_109,r_68_56_28,r_97_54_93,1,0,93,93,33
5,r_112_129_95,r_109_148_119,r_74_131_83,r_112_129_95,0.88,0,95,95,33
46,r_43_116_61,seq38,seq115,r_43_116_61,1,0,61,61,33
42,r_134_17_134,seq135,r_23_42_192,r_134_17_134,0.98,0,134,134,33
66,seq38,r_40_84_39,seq30,r_40_84_39,0.77,1,40,39,33
45,r_11_60_138,seq9,r_61_133_180,r_61_133_180,0.59,-42,138,180,33
19,r_114_21_89,seq115,seq20,r_114_21_89,1,0,89,89,33
34,r_146_128_59,r_138_10_133,r_130_28_164,r_146_128_59,0.97,-9,50,59,33
95,seq108,r_109_148_119,r_2_110_76,r_2_110_76,0.62,44,120,76,33
13,r_45_29_133,r_0_32_19,r_130_28_164,r_45_29_133,0.67,42,175,133,33
31,r_2_110_76,r_1_39_84,r_109_148_119,r_2_110_76,0.98,0,76,76,33
41,r_5_88_116,seq4,seq91,r_5_88_116,0.78,0,116,116,33
3,r_136_51_121,seq135,seq50,r_136_51_121,1,0,121,121,33
10,r_83_123_78,seq81,seq124,r_83_123_78,1,0,78,78,33
32,r_61_133_180,r_11_60_138,seq135,r_61_133_180,0.94,0,180,180,33
6,r_49_76_58,seq50,seq78,r_49_76_58,0.94,0,58,58,33
40,r_126_14_37,seq124,seq15,r_126_14_37,1,0,37,37,33
11,r_35_82_143,r_36_77_118,r_1_39_84,r_36_77_118,0.71,0,118,118,33
16,r_149_86_9,r_89_143_60,r_118_87_26,r_149_86_9,0.54,34,43,9,33
20,r_16_137_103,seq15,r_83_123_78,r_16_137_103,0.65,0,103,103,33
13,r_45_29_133,seq46,r_0_32_19,r_0_32_19,0.55,117,136,19,33
85,seq91,r_89_143_60,r_149_86_9,r_89_143_60,0.96,-13,47,60,33
66,seq38,seq30,r_1_39_84,r_1_39_84,0.51,10,94,84,33
48,r_74_131_83,seq78,seq132,r_74_131_83,1,0,83,83,33
36,r_0_32_19,r_1_39_84,seq33,r_0_32_19,0.52,0,19,19,33
27,r_109_148_119,seq100,r_47_147_100,r_109_148_119,0.96,0,119,119,33
70,seq50,r_49_76_58,seq53,r_49_76_58,0.9,0,58,58,33
4,r_41_3_23,r_40_84_39,r_1_39_84,r_41_3_23,0.69,0,23,23,33
2,r_138_10_133,seq140,r_117_6_127,r_138_10_133,0.96,0,133,133,33
24,r_130_28_164,seq132,r_45_29_133,r_45_29_133,0.85,31,164,133,33
8,r_71_18_29,seq72,seq19,r_71_18_29,0.93,0,29,29,33
34,r_146_128_59,r_130_28_164,seq135,r_130_28_164,0.97,-6,158,164,33
25,r_111_27_65,r_109_148_119,r_0_32_19,r_111_27_65,1,1,66,65,33
38,r_65_101_36,seq64,seq100,r_65_101_36,1,0,36,36,33
70,seq50,seq53,r_136_51_121,r_136_51_121,1,11,132,121,33
65,seq33,r_34_12_177,r_0_32_19,r_0_32_19,1,1,20,19,33
50,seq132,seq135,r_74_131_83,r_74_131_83,1,14,97,83,33
14,r_48_57_23,r_47_147_100,r_68_56_28,r_48_57_23,0.73,0,23,23,33
29,r_119_24_56,seq120,r_23_42_192,r_119_24_56,1,0,56,56,33
32,r_61_133_180,seq64,r_11_60_138,r_61_133_180,0.5,-31,149,180,33
11,r_35_82_143,r_1_39_84,r_40_84_39,r_35_82_143,0.71,0,143,143,33
0,r_40_84_39,r_43_116_61,seq85,r_40_84_39,0.64,0,39,39,33
26,r_47_147_100,r_48_57_23,r_45_29_133,r_48_57_23,0.73,1,24,23,33
45,r_11_60_138,r_61_133_180,r_41_3_23,r_61_133_180,0.78,0,180,180,33
31,r_2_110_76,r_109_148_119,seq108,r_109_148_119,1,1,120,119,33
9,r_34_12_177,seq33,r_138_10_133,r_138_10_133,0.99,44,177,133,33
26,r_47_147_100,r_45_29_133,r_109_148_119,r_47_147_100,1,5,105,100,33
99,seq124,r_126_14_37,r_31_122_4,r_126_14_37,1,0,37,37,33
20,r_16_137_103,r_47_147_100,r_89_143_60,r_16_137_103,0.5,69,172,103,33
22,r_89_143_60,seq91,seq140,r_89_143_60,1,0,60,60,33
28,r_37_66_88,r_36_77_118,r_127_67_28,r_37_66_88,0.56,0,88,88,33
49,r_55_13_127,seq58,r_117_6_127,r_117_6_127,0.73,1,128,127,33
7,r_117_6_127,seq115,seq4,r_117_6_127,0.97,0,127,127,33
23,r_92_75_140,r_96_95_109,r_49_76_58,r_92_75_140,0.87,1,141,140,33
47,r_118_87_26,r_117_6_127,r_149_86_9,r_118_87_26,1,0,26,26,33
20,r_16_137_103,r_83_123_78,r_47_147_100,r_83_123_78,0.6,46,124,78,33
35,r_107_8_81,seq100,seq7,r_107_8_81,0.99,0,81,81,33
99,seq124,r_31_122_4,r_83_123_78,r_83_123_78,1,4,82,78,33
30,r_127_67_28,r_136_51_121,seq69,r_127_67_28,0.84,0,28,28,33
84,seq85,r_83_123_78,r_40_84_39,r_83_123_78,0.82,-15,63,78,33
30,r_48_89_60,seq45,r_91_93_158,r_48_89_60,1,0,60,60,34
51,seq1,r_2_101_104,seq0,r_2_101_104,1,1,105,104,34
36,r_52_116_74,r_53_82_63,r_66_56_39,r_53_82_63,0.85,0,63,63,34
43,r_61_47_143,r_66_56_39,seq51,r_61_47_143,0.92,2,145,143,34
15,r_90_75_32,r_91_93_158,seq76,r_90_75_32,0.73,0,32,32,34
37,r_31_12_182,r_41_33_1,r_36_17_75,r_36_17_75,1,109,184,75,34
16,r_36_17_75,r_38_35_109,r_46_19_62,r_38_35_109,0.96,-34,75,109,34
21,r_137_25_82,seq139,r_27_34_155,r_137_25_82,0.99,0,82,82,34
39,r_15_22_79,r_20_144_145,r_23_21_185,r_15_22_79,0.96,0,79,79,34
5,r_2_101_104,seq1,r_119_99_15,r_2_101_104,1,0,104,104,34
46,r_72_44_102,r_73_74_125,seq45,r_72_44_102,1,0,102,102,34
80,seq64,r_63_30_170,r_127_69_37,r_127_69_37,0.93,133,170,37,34
28,r_18_112_190,r_36_17_75,seq113,r_18_112_190,0.95,0,190,190,34
83,seq68,r_61_47_143,r_127_69_37,r_127_69_37,0.78,15,52,37,34
66,seq28,r_29_37_155,r_63_30_170,r_63_30_170,0.71,0,170,170,34
31,r_53_82_63,r_52_116_74,r_142_86_46,r_53_82_63,1,0,63,63,34
26,r_104_26_129,seq105,r_137_25_82,r_104_26_129,0.94,0,129,129,34
72,seq45,seq50,r_72_44_102,r_72_44_102,1,1,103,102,34
4,r_27_34_155,r_23_21_185,r_137_25_82,r_137_25_82,1,6,88,82,34
44,r_91_93_158,seq92,r_48_89_60,r_48_89_60,1,4,64,60,34
63,seq16,r_18_112_190,r_36_17_75,r_36_17_75,0.98,115,190,75,34
20,r_39_103_85,seq42,seq105,r_39_103_85,0.98,0,85,85,34
13,r_146_111_164,r_145_4_162,seq113,r_146_111_164,0.67,-1,163,164,34
14,r_3_135_18,r_2_101_104,seq133,r_3_135_18,1,0,18,18,34
4,r_27_34_155,r_137_25_82,r_41_33_1,r_27_34_155,0.9,0,155,155,34
62,seq143,r_146_111_164,r_20_144_145,r_20_144_145,0.88,19,164,145,34
21,r_137_25_82,r_27_34_155,r_104_26_129,r_137_25_82,0.68,74,156,82,34
95,seq113,r_81_94_120,r_18_112_190,r_18_112_190,0.48,1,191,190,34
30,r_48_89_60,r_91_93_158,r_81_94_120,r_81_94_120,0.66,1,121,120,34
44,r_91_93_158,r_90_75_32,seq92,r_90_75_32,0.73,0,32,32,34
22,r_46_19_62,r_20_144_145,r_36_17_75,r_20_144_145,1,0,145,145,34
2,r_141_97_128,seq139,r_81_94_120,r_141_97_128,0.83,0,128,128,34
18,r_145_4_162,r_146_111_164,seq5,r_145_4_162,0.91,1,163,162,34
29,r_14_120_82,seq13,seq123,r_14_120_82,0.99,0,82,82,34
24,r_87_130_103,r_81_94_120,seq129,r_87_130_103,1,0,103,103,34
48,r_115_117_47,r_114_67_53,seq118,r_115_117_47,1,0,47,47,34
94,seq110,seq106,r_121_108_16,r_121_108_16,1,11,27,16,34
33,r_85_59_132,r_81_94_120,seq64,r_85_59_132,0.91,0,132,132,34
36,r_52_116_74,r_66_56_39,r_115_117_47,r_52_116_74,0.73,0,74,74,34
47,r_142_86_46,r_141_97_128,seq79,r_142_86_46,0.55,0,46,46,34
61,seq13,r_14_120_82,seq11,r_14_120_82,1,0,82,82,34
32,r_23_21_185,r_27_34_155,r_15_22_79,r_15_22_79,0.98,10,89,79,34
38,r_62_122_97,r_63_30_170,seq126,r_62_122_97,1,0,97,97,34
34,r_102_147_41,seq92,seq149,r_102_147_41,0.99,0,41,41,34
0,r_127_69_37,seq128,seq68,r_127_69_37,1,1,38,37,34
81,seq65,r_66_56_39,r_127_69_37,r_127_69_37,1,110,147,37,34
17,r_20_144_145,r_18_112_190,seq143,r_20_144_145,0.99,0,145,145,34
27,r_121_108_16,r_125_60_188,seq110,r_121_108_16,1,0,16,16,34
45,r_114_67_53,seq113,r_127_69_37,r_114_67_53,1,0,53,53,34
22,r_46_19_62,seq45,r_20_144_145,r_46_19_62,0.98,0,62,62,34
28,r_18_112_190,r_20_144_145,r_36_17_75,r_18_112_190,0.88,-45,145,190,34
49,r_134_109_128,seq133,seq110,r_134_109_128,0.88,0,128,128,34
56,seq7,r_6_88_85,seq10,r_6_88_85,1,0,85,85,34
23,r_6_88_85,seq7,r_53_82_63,r_6_88_85,0.99,0,85,85,34
44,r_91_93_158,r_48_89_60,r_141_97_128,r_141_97_128,1,30,158,128,34
95,seq113,r_114_67_53,seq110,r_114_67_53,0.89,-2,51,53,34
12,r_71_40_135,r_73_74_125,seq51,r_71_40_135,0.91,1,136,135,34
40,r_34_132_183,r_55_31_55,r_143_131_99,r_34_132_183,0.7,1,184,183,35
30,r_59_134_98,seq56,r_136_100_175,r_59_134_98,0.99,0,98,98,35
36,r_23_60_175,seq24,r_20_57_102,r_20_57_102,1,73,175,102,35
8,r_124_58_123,seq123,r_20_57_102,r_124_58_123,0.97,0,123,123,35
46,r_138_80_42,r_139_52_92,seq81,r_138_80_42,1,0,42,42,35
37,r_112_32_115,r_111_86_148,r_55_31_55,r_112_32_115,0.98,0,115,115,35
39,r_19_62_143,seq17,r_137_63_95,r_19_62_143,0.63,0,143,143,35
1,r_29_82_76,seq28,seq83,r_29_82_76,1,0,76,76,35
5,r_114_106_173,r_117_118_29,r_67_99_144,r_114_106_173,0.45,0,173,173,35
12,r_145_126_30,r_144_128_138,seq127,r_145_126_30,0.87,0,30,30,35
45,r_137_63_95,r_136_100_175,r_33_61_78,r_137_63_95,0.99,0,95,95,35
21,r_94_21_33,r_90_25_133,seq17,r_94_21_33,0.82,-1,32,33,35
19,r_136_100_175,r_133_119_148,r_146_135_128,r_146_135_128,1,25,153,128,35
25,r_91_98_32,seq101,r_37_97_45,r_37_97_45,0.99,24,69,45,35
26,r_111_86_148,r_114_106_173,r_39_110_12,r_39_110_12,0.94,41,53,12,35
41,r_67_99_144,seq64,seq101,r_67_99_144,0.62,0,144,144,35
89,seq89,r_88_149_180,r_138_80_42,r_138_80_42,0.99,36,78,42,35
3,r_20_57_102,r_23_60_175,seq56,r_20_57_102,0.92,0,102,102,35
10,r_90_25_133,seq93,seq26,r_90_25_133,0.9,0,133,133,35
90,seq93,r_90_25_133,r_33_61_78,r_33_61_78,0.61,55,133,78,35
27,r_102_95_19,seq101,seq96,r_102_95_19,0.64,-4,15,19,35
4,r_9_109_90,seq10,r_39_110_12,r_9_109_90,1,0,90,90,35
0,r_5_43_104,seq7,r_44_40_165,r_5_43_104,0.97,0,104,104,35
73,seq50,r_51_104_153,r_139_52_92,r_139_52_92,0.92,1,93,92,35
11,r_143_131_99,r_142_42_138,r_145_126_30,r_143_131_99,0.52,0,99,99,35
20,r_133_119_148,r_136_100_175,r_117_118_29,r_136_100_175,0.99,-22,153,175,35
91,seq96,r_90_25_133,r_102_95_19,r_90_25_133,0.55,-118,15,133,35
48,r_92_140_117,r_90_25_133,seq141,r_92_140_117,1,0,117,117,35
6,r_51_104_153,seq50,seq103,r_51_104_153,0.65,0,153,153,35
15,r_37_97_45,seq36,r_91_98_32,r_37_97_45,1,0,45,45,35
30,r_59_134_98,r_136_100_175,r_146_135_128,r_59_134_98,0.75,77,175,98,35
22,r_39_110_12,r_51_104_153,r_111_86_148,r_51_104_153,0.57,-141,12,153,35
22,r_39_110_12,r_111_86_148,r_9_109_90,r_9_109_90,0.63,57,147,90,35
25,r_91_98_32,r_90_25_133,seq101,r_91_98_32,0.98,-1,31,32,35
47,r_142_42_138,seq141,r_5_43_104,r_142_42_138,0.97,0,138,138,35
40,r_34_132_183,r_33_61_78,r_55_31_55,r_34_132_183,0.57,-105,78,183,35
17,r_55_31_55,r_59_134_98,r_34_132_183,r_55_31_55,0.75,0,55,55,35
24,r_116_73_79,r_117_118_29,r_138_80_42,r_116_73_79,1,0,79,79,35
64,seq28,r_29_82_76,seq26,r_29_82_76,1,-15,61,76,35
66,seq36,r_37_97_45,r_34_132_183,r_37_97_45,0.98,2,47,45,35
65,seq30,r_34_132_183,seq36,r_34_132_183,0.34,-90,93,183,35
34,r_2_115_163,r_3_71_164,r_117_118_29,r_117_118_29,0.83,134,163,29,35
81,seq72,seq81,r_33_61_78,r_33_61_78,1,96,174,78,35
19,r_136_100_175,r_146_135_128,r_114_106_173,r_146_135_128,0.54,47,175,128,35
9,r_15_125_79,r_20_57_102,r_145_126_30,r_15_125_79,1,0,79,79,35
26,r_111_86_148,r_39_110_12,r_29_82_76,r_111_86_148,0.99,-1,147,148,35
31,r_147_22_102,r_144_128_138,r_94_21_33,r_147_22_102,1,0,102,102,35
99,seq127,r_117_118_29,r_145_126_30,r_145_126_30,1,-1,29,30,35
28,r_3_71_164,r_2_115_163,seq70,r_3_71_164,0.58,0,164,164,35
42,r_65_87_24,r_67_99_144,seq89,r_67_99_144,0.93,-123,21,144,35
14,r_33_61_78,seq69,r_137_63_95,r_137_63_95,0.98,3,98,95,35
31,r_147_22_102,r_148_121_36,r_144_128_138,r_148_121_36,1,-5,31,36,35
7,r_4_66_125,seq7,seq68,r_4_66_125,0.98,0,125,125,35
23,r_146_135_128,r_144_128_138,r_59_134_98,r_59_134_98,0.88,30,128,98,35
65,seq30,seq36,r_112_32_115,r_112_32_115,0.74,18,133,115,35
17,r_55_31_55,r_34_132_183,r_112_32_115,r_112_32_115,1,69,184,115,35
32,r_148_121_36,r_147_22_102,seq120,r_148_121_36,0.98,1,37,36,35
35,r_79_8_125,seq81,seq7,r_79_8_125,0.92,0,125,125,35
82,seq74,r_88_149_180,r_35_75_39,r_35_75_39,1,-1,38,39,35
23,r_6_2_44,seq0,r_20_3_89,r_20_3_89,0.88,4,93,89,36
43,r_12_21_65,seq11,r_24_146_132,r_12_21_65,0.78,0,65,65,36
86,seq88,seq84,r_4_90_65,r_4_90_65,1,0,65,65,36
16,r_101_66_96,r_102_77_132,r_89_67_60,r_101_66_96,0.61,0,96,96,36
1,r_74_104_137,seq82,r_23_86_1,r_23_86_1,0.48,105,106,1,36
5,r_8_5_81,r_10_22_135,r_17_76_182,r_8_5_81,0.48,1,82,81,36
42,r_49_78_185,r_47_15_191,r_127_75_138,r_127_75_138,0.75,48,186,138,36
13,r_20_3_89,seq27,r_69_18_40,r_69_18_40,0.99,1,41,40,36
35,r_30_122_36,r_33_65_178,r_123_1_159,r_30_122_36,1,0,36,36,36
5,r_8_5_81,r_17_76_182,r_117_9_121,r_8_5_81,0.89,52,133,81,36
23,r_6_2_44,r_8_5_81,r_4_90_65,r_6_2_44,0.85,0,44,44,36
13,r_20_3_89,r_69_18_40,r_6_2_44,r_20_3_89,1,0,89,89,36
14,r_123_1_159,r_121_63_84,r_30_122_36,r_123_1_159,0.79,-122,37,159,36
45,r_134_36_29,seq136,seq37,r_134_36_29,1,0,29,29,36
3,r_92_149_43,r_97_39_88,r_147_79_70,r_92_149_43,0.82,0,43,43,36
36,r_147_79_70,r_145_144_47,r_92_149_43,r_92_149_43,0.79,12,55,43,36
31,r_115_26_138,seq116,seq27,r_115_26_138,0.57,0,138,138,36
67,seq46,r_47_15_191,r_134_36_29,r_134_36_29,0.99,71,100,29,36
10,r_93_142_167,seq94,seq141,r_93_142_167,0.51,0,167,167,36
48,r_100_96_184,r_40_98_4,r_127_75_138,r_127_75_138,0.66,49,187,138,36
14,r_123_1_159,r_30_122_36,seq0,r_123_1_159,0.83,0,159,159,36
4,r_127_75_138,seq124,seq94,r_127_75_138,0.93,1,139,138,36
78,seq68,seq64,r_89_67_60,r_89_67_60,1,17,77,60,36
0,r_121_63_84,r_123_1_159,seq61,r_121_63_84,1,0,84,84,36
11,r_117_9_121,seq120,r_10_22_135,r_10_22_135,0.67,-14,121,135,36
21,r_69_18_40,r_20_3_89,seq27,r_20_3_89,0.99,1,90,89,36
46,r_59_133_47,seq58,seq140,r_59_133_47,1,0,47,47,36
15,r_143_148_101,r_145_144_47,r_92_149_43,r_92_149_43,1,58,101,43,36
48,r_100_96_184,r_74_104_137,r_40_98_4,r_74_104_137,0.97,-3,134,137,36
44,r_4_90_65,r_6_2_44,seq88,r_4_90_65,0.97,2,67,65,36
6,r_81_25_157,seq82,r_115_26_138,r_81_25_157,0.8,0,157,157,36
3,r_92_149_43,r_147_79_70,r_143_148_101,r_147_79_70,1,0,70,70,36
67,seq46,r_134_36_29,r_107_48_137,r_107_48_137,0.65,20,157,137,36
27,r_102_77_132,r_101_66_96,r_100_96_184,r_102_77_132,0.6,-55,77,132,36
21,r_69_18_40,r_70_44_153,r_20_3_89,r_69_18_40,1,0,40,40,36
47,r_33_65_178,seq37,r_101_66_96,r_33_65_178,0.6,1,179,178,36
36,r_147_79_70,r_92_149_43,seq80,r_147_79_70,0.91,0,70,70,36
40,r_7_31_72,r_8_5_81,r_52_32_68,r_52_32_68,0.9,4,72,68,36
29,r_108_114_130,r_107_48_137,seq116,r_107_48_137,1,-42,95,137,36
5,r_8_5_81,r_117_9_121,r_47_15_191,r_47_15_191,0.98,4,195,191,36
24,r_97_39_88,r_95_19_164,r_134_36_29,r_97_39_88,0.98,0,88,88,36
2,r_10_22_135,r_117_9_121,r_12_21_65,r_10_22_135,0.81,0,135,135,36
35,r_30_122_36,r_123_1_159,seq139,r_123_1_159,1,0,159,159,36
25,r_24_146_132,seq27,r_92_149_43,r_24_146_132,0.95,1,133,132,36
43,r_12_21_65,r_24_146_132,r_10_22_135,r_24_146_132,0.82,3,135,132,36
33,r_70_44_153,seq73,r_57_34_103,r_57_34_103,0.51,50,153,103,36
23,r_6_2_44,r_4_90_65,seq0,r_4_90_65,0.54,2,67,65,36
18,r_112_83_37,r_107_48_137,seq85,r_112_83_37,1,0,37,37,36
81,seq80,seq82,r_147_79_70,r_147_79_70,1,56,126,70,36
17,r_107_48_137,r_108_114_130,r_47_15_191,r_107_48_137,0.99,1,138,137,36
94,seq116,r_115_26_138,r_108_114_130,r_115_26_138,1,-43,95,138,36
50,seq0,r_6_2_44,r_123_1_159,r_123_1_159,0.91,1,160,159,36
44,r_4_90_65,seq0,r_6_2_44,r_4_90_65,0.51,-15,50,65,36
28,r_89_67_60,seq84,seq68,r_89_67_60,0.87,1,61,60,36
11,r_117_9_121,r_10_22_135,r_8_5_81,r_10_22_135,0.54,0,135,135,36
7,r_138_109_123,seq135,seq106,r_138_109_123,0.84,0,123,123,36
2,r_10_22_135,seq27,r_117_9_121,r_10_22_135,0.44,-14,121,135,36
1,r_74_104_137,r_23_86_1,seq105,r_74_104_137,0.94,0,137,137,36
20,r_72_35_58,seq73,r_134_36_29,r_72_35_58,1,0,58,58,36
82,seq82,r_81_25_157,seq94,r_81_25_157,0.89,0,157,157,36
79,seq73,r_70_44_153,seq94,r_70_44_153,0.88,0,153,153,36
30,r_72_90_193,r_69_140_195,r_82_74_160,r_82_74_160,0.49,1,161,160,37
23,r_31_144_68,r_37_147_41,r_15_143_119,r_15_143_119,1,24,143,119,37
36,r_82_74_160,r_83_26_161,r_72_90_193,r_82_74_160,0.76,1,161,160,37
22,r_0_16_38,seq1,seq17,r_0_16_38,1,1,39,38,37
8,r_92_110_191,seq91,r_106_62_43,r_106_62_43,0.67,145,188,43,37
54,seq129,r_127_42_157,r_113_133_80,r_113_133_80,0.64,97,177,80,37
21,r_131_63_87,r_130_7_178,seq64,r_131_63_87,0.82,0,87,87,37
39,r_83_26_161,r_82_74_160,seq25,r_83_26_161,0.56,-1,160,161,37
14,r_148_119_191,r_142_103_127,r_37_147_41,r_148_119_191,0.62,-147,44,191,37
5,r_85_94_97,r_84_68_108,seq91,r_84_68_108,0.93,-19,89,108,37
42,r_130_7_178,r_131_63_87,r_128_146_33,r_130_7_178,0.9,-91,87,178,37
43,r_27_44_38,seq24,seq43,r_27_44_38,1,0,38,38,37
16,r_9_99_13,r_8_101_195,r_100_20_150,r_9_99_13,0.99,0,13,13,37
25,r_37_147_41,seq38,r_148_119_191,r_37_147_41,1,0,41,41,37
19,r_115_33_135,seq116,seq34,r_115_33_135,1,0,135,135,37
77,seq59,r_69_140_195,r_106_62_43,r_106_62_43,0.62,87,130,43,37
95,seq116,r_115_33_135,seq117,r_115_33_135,1,0,135,135,37
54,seq129,r_126_11_37,r_127_42_157,r_126_11_37,1,-22,15,37,37
3,r_77_122_77,seq80,r_28_123_62,r_28_123_62,0.99,15,77,62,37
10,r_113_133_80,seq112,seq135,r_113_133_80,1,0,80,80,37
90,seq97,r_95_57_187,r_134_98_88,r_134_98_88,1,1,89,88,37
16,r_9_99_13,r_100_20_150,r_142_103_127,r_9_99_13,0.91,139,152,13,37
32,r_107_50_30,seq108,seq49,r_107_50_30,0.97,10,40,30,37
4,r_136_52_80,seq138,r_27_44_38,r_136_52_80,0.95,0,80,80,37
78,seq64,seq66,r_131_63_87,r_131_63_87,1,17,104,87,37
11,r_95_57_187,seq97,r_136_52_80,r_136_52_80,0.99,112,192,80,37
67,seq40,r_41_13_57,r_107_50_30,r_41_13_57,0.96,2,59,57,37
47,r_100_20_150,seq102,r_9_99_13,r_9_99_13,0.99,7,20,13,37
15,r_142_103_127,r_148_119_191,seq102,r_142_103_127,0.99,0,127,127,37
48,r_124_30_127,seq125,seq24,r_124_30_127,0.88,1,128,127,37
13,r_22_67_28,seq64,r_84_68_108,r_84_68_108,1,14,122,108,37
62,seq25,seq24,r_83_26_161,r_83_26_161,1,1,162,161,37
46,r_69_140_195,r_65_109_85,r_29_71_9,r_29_71_9,0.98,3,12,9,37
27,r_114_55_76,seq112,seq53,r_114_55_76,0.99,3,79,76,37
31,r_14_10_2,r_8_101_195,r_126_11_37,r_126_11_37,1,4,41,37,37
68,seq43,seq48,r_27_44_38,r_27_44_38,1,3,41,38,37
2,r_106_62_43,seq120,r_93_61_8,r_106_62_43,0.64,1,44,43,37
40,r_65_109_85,seq66,seq108,r_65_109_85,0.91,0,85,85,37
18,r_32_45_136,seq34,r_107_50_30,r_32_45_136,0.94,0,136,136,37
29,r_149_21_17,r_148_119_191,seq23,r_149_21_17,0.98,0,17,17,37
33,r_28_123_62,r_31_144_68,seq125,r_28_123_62,1,0,62,62,37
47,r_100_20_150,r_9_99_13,r_149_21_17,r_100_20_150,0.75,0,150,150,37
1,r_126_11_37,seq129,r_14_10_2,r_126_11_37,1,0,37,37,37
20,r_105_141_130,seq108,seq138,r_105_141_130,0.98,-2,128,130,37
42,r_130_7_178,r_128_146_33,r_0_16_38,r_130_7_178,0.73,0,178,178,37
61,seq24,seq25,r_124_30_127,r_124_30_127,0.99,10,137,127,37
86,seq88,r_92_110_191,seq89,r_92_110_191,1,-180,11,191,37
34,r_134_98_88,seq138,seq97,r_134_98_88,1,0,88,88,37
77,seq59,seq66,r_69_140_195,r_69_140_195,0.5,-142,53,195,37
25,r_37_147_41,r_148_119_191,r_128_146_33,r_37_147_41,0.39,144,185,41,37
77,seq59,r_106_62_43,r_35_60_175,r_35_60_175,0.97,1,176,175,37
26,r_128_146_33,seq129,r_104_145_29,r_128_146_33,0.45,0,33,33,37
49,r_104_145_29,r_105_141_130,r_128_146_33,r_104_145_29,0.78,0,29,29,37
45,r_93_61_8,seq66,r_106_62_43,r_106_62_43,0.84,8,51,43,37
28,r_84_68_108,r_85_94_97,r_22_67_28,r_22_67_28,0.77,80,108,28,37
41,r_70_4_29,r_69_140_195,r_78_3_8,r_70_4_29,1,0,29,29,37
56,seq12,r_14_10_2,r_41_13_57,r_41_13_57,1,58,115,57,37
20,r_105_141_130,r_104_145_29,seq108,r_104_145_29,0.88,0,29,29,37
13,r_22_67_28,seq23,seq64,r_22_67_28,1,0,28,28,37
35,r_35_60_175,seq36,seq59,r_35_60_175,0.5,0,175,175,37
38,r_41_13_57,seq40,seq12,r_41_13_57,1,0,57,57,37
30,r_105_117_73,seq108,seq118,r_105_117_73,1,0,73,73,38
58,seq10,seq11,r_143_16_35,r_143_16_35,0.47,85,120,35,38
43,r_92_45_155,seq93,seq44,r_92_45_155,0.7,0,155,155,38
36,r_101_28_24,seq100,r_27_75_187,r_101_28_24,0.97,0,24,24,38
3,r_15_96_48,r_21_131_104,seq93,r_15_96_48,0.94,0,48,48,38
83,seq83,r_84_120_90,r_15_96_48,r_15_96_48,0.56,41,89,48,38
15,r_143_16_35,seq144,r_52_17_22,r_143_16_35,0.89,0,35,35,38
21,r_59_50_137,seq58,r_81_49_107,r_81_49_107,0.78,30,137,107,38
97,seq121,seq122,r_84_120_90,r_84_120_90,0.59,38,128,90,38
5,r_62_139_124,r_61_88_122,r_110_138_113,r_62_139_124,0.92,0,124,124,38
46,r_13_127_177,r_14_31_100,seq10,r_14_31_100,1,-4,96,100,38
34,r_132_107_15,r_134_148_70,seq108,r_132_107_15,0.86,0,15,15,38
11,r_57_130_39,r_105_117_73,r_82_112_6,r_82_112_6,0.41,163,169,6,38
1,r_125_69_59,r_123_79_134,r_98_70_85,r_125_69_59,1,0,59,59,38
40,r_113_85_24,r_82_112_6,seq93,r_113_85_24,0.91,0,24,24,38
76,seq55,r_56_12_162,seq58,r_56_12_162,0.97,0,162,162,38
31,r_80_128_173,seq78,r_57_130_39,r_57_130_39,0.61,134,173,39,38
41,r_111_103_108,seq116,seq100,r_111_103_108,0.93,0,108,108,38
10,r_64_40_46,r_65_37_16,r_54_19_78,r_65_37_16,0.92,-3,13,16,38
44,r_52_17_22,seq51,seq18,r_52_17_22,0.99,0,22,22,38
26,r_110_138_113,r_109_145_91,seq137,r_110_138_113,0.45,-22,91,113,38
4,r_106_66_61,r_105_117_73,r_33_67_38,r_106_66_61,1,0,61,61,38
0,r_46_73_67,seq44,seq71,r_46_73_67,0.98,-1,66,67,38
59,seq11,r_14_31_100,seq10,r_14_31_100,1,-48,52,100,38
42,r_5_63_49,seq2,r_33_67_38,r_5_63_49,1,0,49,49,38
11,r_57_130_39,r_60_99_165,r_109_145_91,r_57_130_39,0.82,1,40,39,38
48,r_20_1_66,r_21_131_104,seq6,r_20_1_66,0.89,0,66,66,38
57,seq137,r_136_146_81,r_110_138_113,r_110_138_113,0.54,-2,111,113,38
10,r_64_40_46,r_54_19_78,r_65_37_16,r_64_40_46,0.59,0,46,46,38
99,seq126,r_123_79_134,seq122,r_123_79_134,0.51,0,134,134,38
36,r_101_28_24,r_27_75_187,r_64_40_46,r_64_40_46,0.93,141,187,46,38
16,r_33_67_38,r_54_19_78,r_106_66_61,r_33_67_38,0.83,32,70,38,38
27,r_53_34_105,seq55,r_14_31_100,r_14_31_100,0.69,5,105,100,38
58,seq10,r_14_31_100,seq11,r_14_31_100,0.5,-47,53,100,38
45,r_124_39_25,r_125_69_59,r_65_37_16,r_124_39_25,0.91,0,25,25,38
2,r_123_79_134,seq126,seq78,r_123_79_134,0.58,0,134,134,38
18,r_61_88_122,r_62_139_124,seq87,r_61_88_122,0.7,0,122,122,38
29,r_81_49_107,r_80_128_173,seq44,r_80_128_173,0.59,-66,107,173,38
16,r_33_67_38,r_41_68_176,r_54_19_78,r_33_67_38,0.96,-1,37,38,38
6,r_21_131_104,r_20_1_66,r_143_16_35,r_143_16_35,0.89,3,38,35,38
47,r_129_29_10,r_80_128_173,seq30,r_129_29_10,0.98,0,10,10,38
25,r_54_19_78,r_53_34_105,r_143_16_35,r_54_19_78,1,0,78,78,38
63,seq149,r_147_135_65,r_134_148_70,r_134_148_70,0.74,-13,57,70,38
6,r_21_131_104,r_143_16_35,r_147_135_65,r_21_131_104,1,0,104,104,38
77,seq58,r_59_50_137,seq55,r_59_50_137,0.88,0,137,137,38
29,r_81_49_107,seq44,r_59_50_137,r_81_49_107,0.57,35,142,107,38
19,r_14_31_100,seq11,r_74_35_6,r_14_31_100,0.94,0,100,100,38
17,r_98_70_85,r_95_90_113,r_125_69_59,r_98_70_85,0.96,11,96,85,38
33,r_136_146_81,r_143_16_35,r_134_148_70,r_143_16_35,0.91,-12,23,35,38
56,seq8,r_9_97_21,r_14_31_100,r_9_97_21,0.79,-1,20,21,38
7,r_109_145_91,r_110_138_113,r_136_146_81,r_109_145_91,0.6,0,91,91,38
11,r_57_130_39,r_109_145_91,r_105_117_73,r_109_145_91,0.62,-3,88,91,38
82,seq78,r_80_128_173,r_46_73_67,r_46_73_67,1,107,174,67,38
56,seq8,r_14_31_100,seq10,r_14_31_100,0.89,-47,53,100,38
35,r_41_68_176,seq38,r_80_128_173,r_80_128_173,0.63,-2,171,173,38
23,r_9_97_21,seq8,r_98_70_85,r_9_97_21,0.99,0,21,21,38
12,r_147_135_65,seq149,r_134_148_70,r_134_148_70,0.63,-5,65,70,38
23,r_9_97_21,r_98_70_85,r_15_96_48,r_9_97_21,0.98,75,96,21,38
30,r_92_82_109,seq89,seq80,r_92_82_109,0.78,0,109,109,39
36,r_59_126_2,seq131,r_87_129_1,r_87_129_1,0.71,59,60,1,39
9,r_107_37_102,r_6_109_15,seq38,r_107_37_102,1,0,102,102,39
28,r_60_16_94,seq62,r_36_30_92,r_60_16_94,1,0,94,94,39
14,r_63_69_68,r_60_16_94,seq67,r_60_16_94,0.84,-9,85,94,39
8,r_90_52_98,r_92_82_109,r_11_51_85,r_90_52_98,0.96,0,98,98,39
37,r_124_130_57,r_121_136_69,r_0_134_41,r_0_134_41,1,16,57,41,39
42,r_111_108_167,r_113_70_102,r_14_117_4,r_14_117_4,0.88,56,60,4,39
3,r_8_75_48,seq7,seq76,r_8_75_48,1,0,48,48,39
54,seq10,r_11_51_85,seq12,r_11_51_85,0.99,0,85,85,39
83,seq76,r_77_125_143,r_8_75_48,r_8_75_48,1,95,143,48,39
54,seq10,seq12,r_40_9_162,r_40_9_162,1,0,162,162,39
10,r_11_51_85,r_50_68_141,r_90_52_98,r_50_68_141,1,0,141,141,39
55,seq139,seq135,r_146_137_72,r_146_137_72,0.98,0,72,72,39
21,r_96_54_97,r_97_94_123,seq53,r_96_54_97,1,0,97,97,39
39,r_42_141_112,seq41,r_93_143_62,r_42_141_112,0.97,0,112,112,39
5,r_50_68_141,seq56,r_11_51_85,r_11_51_85,1,1,86,85,39
46,r_86_49_150,seq89,r_48_91_27,r_48_91_27,1,31,58,27,39
19,r_93_143_62,r_101_45_147,seq144,r_101_45_147,0.8,-90,57,147,39
15,r_6_109_15,r_107_37_102,r_79_110_45,r_6_109_15,0.89,87,102,15,39
76,seq43,seq41,r_101_45_147,r_101_45_147,0.75,16,163,147,39
31,r_36_30_92,seq38,seq27,r_36_30_92,0.96,0,92,92,39
41,r_24_103_160,seq27,r_1_100_147,r_1_100_147,0.7,13,160,147,39
89,seq102,r_101_45_147,r_1_100_147,r_1_100_147,0.6,0,147,147,39
53,seq7,r_8_75_48,seq15,r_8_75_48,1,1,49,48,39
10,r_11_51_85,seq10,r_50_68_141,r_11_51_85,1,0,85,85,39
40,r_79_110_45,seq78,r_6_109_15,r_79_110_45,0.96,0,45,45,39
15,r_6_109_15,r_1_100_147,r_107_37_102,r_6_109_15,1,0,15,15,39
4,r_85_2_82,r_90_52_98,seq3,r_85_2_82,0.97,2,84,82,39
0,r_148_88_110,seq147,r_48_91_27,r_148_88_110,0.97,-1,109,110,39
11,r_72_138_79,seq73,r_146_137_72,r_72_138_79,0.93,0,79,79,39
13,r_121_136_69,seq122,seq135,r_121_136_69,0.98,0,69,69,39
46,r_86_49_150,r_48_91_27,r_96_54_97,r_86_49_150,0.95,0,150,150,39
33,r_0_134_41,seq3,r_65_132_12,r_0_134_41,1,0,41,41,39
48,r_113_70_102,r_111_108_167,seq71,r_113_70_102,0.91,0,102,102,39
7,r_46_115_156,r_96_54_97,r_61_112_95,r_46_115_156,0.97,0,156,156,39
9,r_107_37_102,seq114,r_6_109_15,r_6_109_15,0.92,21,36,15,39
5,r_50_68_141,r_11_51_85,r_63_69_68,r_50_68_141,1,0,141,141,39
36,r_59_126_2,r_87_129_1,r_65_132_12,r_87_129_1,0.27,130,131,1,39
27,r_140_120_138,r_142_133_123,r_42_141_112,r_140_120_138,0.3,-16,122,138,39
87,seq135,seq139,r_121_136_69,r_121_136_69,1,-4,65,69,39
2,r_146_137_72,r_148_88_110,seq139,r_146_137_72,0.53,0,72,72,39
17,r_48_91_27,r_47_66_95,seq89,r_48_91_27,0.93,0,27,27,39
74,seq39,r_40_9_162,r_107_37_102,r_107_37_102,0.64,61,163,102,39
18,r_44_84_75,seq43,seq80,r_44_84_75,1,-1,74,75,39
29,r_77_125_143,seq76,seq116,r_77_125_143,0.8,0,143,143,39
25,r_40_9_162,seq39,seq10,r_40_9_162,0.76,0,162,162,39
47,r_81_149_50,seq80,seq147,r_81_149_50,1,1,51,50,39
27,r_140_120_138,r_42_141_112,seq122,r_140_120_138,0.9,0,138,138,39
32,r_95_145_84,r_96_54_97,seq144,r_96_54_97,0.73,-13,84,97,39
38,r_28_64_100,seq27,seq62,r_28_64_100,0.96,0,100,100,39
42,r_111_108_167,r_14_117_4,r_61_112_95,r_61_112_95,0.91,4,99,95,39
22,r_18_74_155,r_29_19_12,r_113_70_102,r_113_70_102,0.44,53,155,102,39
49,r_101_45_147,seq102,seq43,r_101_45_147,0.67,0,147,147,39
28,r_60_16_94,r_61_112_95,seq62,r_60_16_94,0.67,-39,55,94,39
7,r_46_115_156,r_47_66_95,r_96_54_97,r_46_115_156,0.97,-59,97,156,39
44,r_61_112_95,r_60_16_94,r_6_109_15,r_61_112_95,0.81,0,95,95,39
23,r_47_66_95,r_46_115_156,seq80,r_47_66_95,1,0,95,95,39
6,r_65_132_12,r_60_16_94,seq131,r_65_132_12,0.82,0,12,12,39
79,seq62,r_63_69_68,r_28_64_100,r_28_64_100,1,2,102,100,39
12,r_1_100_147,seq3,seq102,r_1_100_147,0.73,0,147,147,39
93,seq98,r_99_89_114,r_9_101_73,r_9_101_73,0.52,41,114,73,40
30,r_97_100_176,r_95_93_70,r_90_96_87,r_97_100_176,0.78,-89,87,176,40
51,seq130,r_131_47_112,seq144,r_131_47_112,1,1,113,112,40
37,r_9_101_73,r_10_3_134,seq102,r_9_101_73,1,0,73,73,40
59,seq16,r_14_26_177,r_138_15_43,r_138_15_43,1,122,165,43,40
16,r_121_46_179,r_110_122_32,seq38,r_121_46_179,0.56,0,179,179,40
21,r_83_117_75,r_79_78_149,r_118_24_122,r_83_117_75,0.65,0,75,75,40
97,seq106,r_107_54_182,seq105,r_107_54_182,0.83,0,182,182,40
5,r_10_3_134,seq12,seq4,r_10_3_134,0.31,0,134,134,40
46,r_79_78_149,seq80,r_120_77_118,r_120_77_118,0.99,32,150,118,40
42,r_107_54_182,seq106,r_59_53_181,r_107_54_182,0.38,0,182,182,40
9,r_118_24_122,r_83_117_75,r_136_25_123,r_83_117_75,0.91,48,123,75,40
83,seq76,r_79_78_149,r_120_77_118,r_120_77_118,1,0,118,118,40
45,r_5_42_190,seq4,r_11_37_19,r_11_37_19,0.85,174,193,19,40
39,r_137_33_54,r_136_25_123,seq34,r_137_33_54,1,0,54,54,40
43,r_116_23_47,r_112_126_183,r_139_22_9,r_116_23_47,1,2,49,47,40
95,seq103,r_104_73_130,seq106,r_104_73_130,1,0,130,130,40
66,seq34,seq38,r_137_33_54,r_137_33_54,1,16,70,54,40
83,seq76,r_84_140_105,r_79_78_149,r_84_140_105,0.79,-48,57,105,40
31,r_125_31_153,r_121_46_179,seq32,r_125_31_153,0.9,0,153,153,40
41,r_147_108_75,seq149,r_112_126_183,r_147_108_75,0.51,0,75,75,40
67,seq35,r_36_69_103,seq38,r_36_69_103,1,0,103,103,40
3,r_41_65_93,seq43,r_59_53_181,r_41_65_93,0.45,0,93,93,40
10,r_27_129_143,r_28_44_202,seq144,r_27_129_143,0.94,0,143,143,40
26,r_112_126_183,r_111_67_93,r_55_114_93,r_112_126_183,0.99,-90,93,183,40
38,r_120_77_118,seq76,r_79_78_149,r_79_78_149,0.97,4,153,149,40
4,r_99_89_114,seq98,seq91,r_99_89_114,0.99,0,114,114,40
73,seq56,r_55_114_93,r_1_49_9,r_55_114_93,0.86,0,93,93,40
11,r_28_44_202,r_27_129_143,seq32,r_27_129_143,1,0,143,143,40
20,r_14_26_177,seq16,r_125_31_153,r_14_26_177,0.74,0,177,177,40
98,seq115,r_112_126_183,r_55_114_93,r_55_114_93,1,9,102,93,40
21,r_83_117_75,r_118_24_122,r_72_109_98,r_118_24_122,0.94,3,125,122,40
15,r_87_145_160,seq88,r_18_133_137,r_87_145_160,0.63,0,160,160,40
48,r_2_113_177,r_5_42_190,r_55_114_93,r_55_114_93,0.89,84,177,93,40
49,r_128_82_97,seq80,seq88,r_128_82_97,0.25,81,178,97,40
12,r_30_40_72,r_39_20_197,r_11_37_19,r_11_37_19,0.75,181,200,19,40
6,r_59_53_181,seq60,r_107_54_182,r_59_53_181,0.64,1,182,181,40
99,seq127,r_121_46_179,r_72_109_98,r_72_109_98,1,65,163,98,40
19,r_136_25_123,r_137_33_54,seq142,r_137_33_54,1,0,54,54,40
27,r_39_20_197,r_41_65_93,r_30_40_72,r_39_20_197,0.99,-104,93,197,40
36,r_45_85_45,r_41_65_93,seq86,r_45_85_45,0.87,0,45,45,40
2,r_123_68_153,r_110_122_32,r_36_69_103,r_123_68_153,0.63,0,153,153,40
40,r_110_122_32,r_123_68_153,r_72_109_98,r_72_109_98,0.9,52,150,98,40
18,r_131_47_112,seq130,r_1_49_9,r_131_47_112,1,1,113,112,40
29,r_90_96_87,seq91,r_97_100_176,r_90_96_87,0.96,0,87,87,40
43,r_116_23_47,r_139_22_9,r_118_24_122,r_118_24_122,1,16,138,122,40
69,seq38,r_36_69_103,r_11_37_19,r_11_37_19,0.94,1,20,19,40
82,seq74,seq66,r_119_75_109,r_119_75_109,0.81,23,132,109,40
0,r_11_37_19,r_10_3_134,seq38,r_11_37_19,1,0,19,19,40
3,r_41_65_93,r_59_53_181,r_48_64_135,r_48_64_135,0.61,2,137,135,40
32,r_111_67_93,r_112_126_183,seq70,r_111_67_93,1,0,93,93,40
34,r_36_69_103,seq35,seq70,r_36_69_103,0.95,0,103,103,40
23,r_138_15_43,r_136_25_123,seq16,r_138_15_43,1,0,43,43,40
94,seq102,r_99_89_114,r_9_101_73,r_9_101_73,0.7,11,84,73,40
9,r_118_24_122,r_119_75_109,r_83_117_75,r_83_117_75,0.99,19,94,75,40
96,seq105,r_107_54_182,seq106,r_107_54_182,0.89,-44,138,182,40
22,r_18_133_137,r_14_26_177,seq134,r_18_133_137,0.97,0,137,137,40
28,r_55_114_93,seq56,seq115,r_55_114_93,1,0,93,93,40
73,seq56,r_1_49_9,r_59_53_181,r_59_53_181,0.78,5,186,181,40
44,r_7_57_44,r_10_3_134,seq58,r_7_57_44,0.99,0,44,44,40
49,r_128_82_97,seq127,seq80,r_128_82_97,0.98,0,97,97,40
82,seq74,r_72_109_98,seq66,r_72_109_98,0.73,1,99,98,40
12,r_30_40_72,seq32,r_39_20_197,r_30_40_72,1,0,72,72,40
30,r_20_29_79,seq14,seq30,r_20_29_79,1,0,79,79,41
31,r_121_25_40,r_124_91_150,r_24_26_168,r_121_25_40,1,0,40,40,41
40,r_116_83_37,r_124_91_150,r_88_86_119,r_116_83_37,0.98,2,39,37,41
73,seq137,r_135_134_164,r_132_136_71,r_132_136_71,0.64,-20,51,71,41
86,seq143,r_144_52_195,r_69_145_168,r_69_145_168,0.88,10,178,168,41
16,r_24_26_168,r_23_67_141,r_121_25_40,r_24_26_168,0.55,-76,92,168,41
1,r_104_105_59,r_103_92_87,r_94_106_45,r_104_105_59,0.99,14,73,59,41
5,r_63_40_115,r_62_65_41,seq43,r_63_40_115,0.98,1,116,115,41
46,r_49_85_118,seq46,seq82,r_49_85_118,0.94,0,118,118,41
7,r_126_7_132,r_38_128_20,r_3_5_60,r_126_7_132,0.97,0,132,132,41
45,r_108_133_180,r_104_105_59,r_135_134_164,r_108_133_180,0.33,1,181,180,41
19,r_119_81_147,seq115,seq80,r_119_81_147,0.51,0,147,147,41
11,r_11_84_154,seq18,seq82,r_11_84_154,0.71,0,154,154,41
95,seq114,r_113_8_111,seq102,r_113_8_111,0.81,0,111,111,41
6,r_13_110_34,r_11_84_154,r_104_105_59,r_13_110_34,1,0,34,34,41
41,r_53_55_182,r_146_99_5,r_12_71_18,r_12_71_18,0.49,52,70,18,41
21,r_38_128_20,r_37_89_180,r_126_7_132,r_38_128_20,0.99,0,20,20,41
15,r_36_22_148,r_63_40_115,r_121_25_40,r_36_22_148,0.57,0,148,148,41
3,r_87_117_114,r_88_86_119,seq115,r_87_117_114,0.86,1,115,114,41
11,r_11_84_154,r_13_110_34,seq18,r_13_110_34,0.84,0,34,34,41
26,r_57_59_195,r_58_39_177,r_23_67_141,r_23_67_141,0.99,36,177,141,41
35,r_118_125_42,r_124_91_150,r_38_128_20,r_118_125_42,0.68,0,42,42,41
4,r_113_8_111,seq114,seq9,r_113_8_111,0.98,0,111,111,41
78,seq76,r_75_73_184,r_119_81_147,r_119_81_147,1,37,184,147,41
0,r_23_67_141,r_24_26_168,seq66,r_23_67_141,0.99,-1,140,141,41
63,seq30,seq32,r_20_29_79,r_20_29_79,1,1,80,79,41
20,r_144_52_195,seq143,seq51,r_144_52_195,0.43,1,196,195,41
13,r_75_73_184,seq76,seq72,r_75_73_184,0.33,0,184,184,41
7,r_126_7_132,r_132_136_71,r_38_128_20,r_38_128_20,1,6,26,20,41
15,r_36_22_148,r_35_127_136,r_63_40_115,r_63_40_115,0.6,20,135,115,41
48,r_35_127_136,r_36_22_148,r_38_128_20,r_36_22_148,0.73,-13,135,148,41
12,r_3_5_60,r_11_84_154,r_126_7_132,r_3_5_60,0.68,73,133,60,41
62,seq28,r_27_4_168,r_24_26_168,r_27_4_168,0.72,0,168,168,41
21,r_38_128_20,r_126_7_132,r_118_125_42,r_126_7_132,1,0,132,132,41
29,r_42_140_154,r_63_40_115,seq139,r_42_140_154,1,0,154,154,41
17,r_56_33_59,r_57_59_195,seq34,r_56_33_59,1,0,59,59,41
27,r_17_107_190,seq18,r_13_110_34,r_13_110_34,0.77,156,190,34,41
41,r_53_55_182,r_12_71_18,r_144_52_195,r_12_71_18,0.53,87,105,18,41
2,r_10_112_120,seq9,seq114,r_10_112_120,0.9,0,120,120,41
10,r_41_138_29,r_42_140_154,seq139,r_41_138_29,0.97,0,29,29,41
47,r_74_21_73,seq72,r_121_25_40,r_74_21_73,1,0,73,73,41
29,r_42_140_154,seq44,r_63_40_115,r_63_40_115,0.97,0,115,115,41
24,r_37_89_180,seq44,r_119_81_147,r_119_81_147,0.66,33,180,147,41
37,r_6_60_39,seq18,r_111_61_1,r_6_60_39,1,0,39,39,41
33,r_103_92_87,r_104_105_59,seq93,r_103_92_87,0.99,0,87,87,41
41,r_53_55_182,r_144_52_195,r_49_85_118,r_53_55_182,0.67,-32,150,182,41
28,r_94_106_45,seq93,r_13_110_34,r_94_106_45,0.96,1,46,45,41
65,seq34,r_36_22_148,r_56_33_59,r_56_33_59,1,15,74,59,41
23,r_90_50_54,seq93,seq44,r_90_50_54,1,-1,53,54,41
77,seq72,r_74_21_73,r_12_71_18,r_74_21_73,0.99,0,73,73,41
75,seq66,r_62_65_41,r_23_67_141,r_23_67_141,1,1,142,141,41
9,r_96_54_173,seq97,r_11_84_154,r_11_84_154,0.93,12,166,154,41
9,r_96_54_173,r_11_84_154,r_53_55_182,r_96_54_173,0.79,9,182,173,41
31,r_121_25_40,r_24_26_168,r_36_22_148,r_36_22_148,0.87,20,168,148,41
22,r_88_86_119,r_87_117_114,seq82,r_87_117_114,1,1,115,114,41
41,r_53_55_182,r_49_85_118,r_96_54_173,r_96_54_173,0.67,9,182,173,41
44,r_27_4_168,seq28,seq1,r_27_4_168,0.52,0,168,168,41
82,seq80,seq77,r_116_83_37,r_116_83_37,1,41,78,37,41
38,r_12_71_18,r_11_84_154,seq72,r_12_71_18,0.86,0,18,18,41
12,r_3_5_60,seq1,r_11_84_154,r_3_5_60,0.77,0,60,60,41
84,seq82,r_75_73_184,r_116_83_37,r_116_83_37,1,54,91,37,41
36,r_14_78_124,seq19,r_108_79_49,r_14_78_124,0.81,0,124,124,42
8,r_57_122_71,r_54_126_115,r_53_123_40,r_57_122_71,0.69,0,71,71,42
43,r_80_143_170,r_77_23_176,r_39_144_159,r_80_143_170,0.71,0,170,170,42
37,r_9_116_105,seq11,seq113,r_9_116_105,1,0,105,105,42
40,r_120_8_11,r_117_110_27,r_75_7_15,r_120_8_11,0.99,4,15,11,42
21,r_71_16_170,seq72,r_103_13_83,r_71_16_170,0.67,0,170,170,42
1,r_39_144_159,seq37,seq145,r_39_144_159,0.59,0,159,159,42
25,r_75_7_15,r_74_47_129,r_120_8_11,r_75_7_15,1,0,15,15,42
5,r_28_112_112,seq29,r_117_110_27,r_28_112_112,1,0,112,112,42
42,r_86_55_94,seq88,seq58,r_86_55_94,1,0,94,94,42
29,r_53_123_40,seq121,r_57_122_71,r_57_122_71,1,10,81,71,42
45,r_10_67_103,r_9_116_105,r_94_65_79,r_10_67_103,0.98,0,103,103,42
24,r_34_96_102,seq26,seq98,r_34_96_102,1,0,102,102,42
19,r_32_128_169,r_31_107_113,seq29,r_31_107_113,0.89,1,114,113,42
16,r_43_62_38,r_44_136_158,seq68,r_43_62_38,0.88,0,38,38,42
66,seq29,r_28_112_112,seq26,r_28_112_112,1,0,112,112,42
31,r_114_12_50,seq115,seq11,r_114_12_50,1,0,50,50,42
41,r_77_23_176,seq76,seq19,r_77_23_176,0.56,0,176,176,42
3,r_30_118_81,r_28_112_112,r_49_119_80,r_30_118_81,0.91,0,81,81,42
26,r_54_126_115,r_56_93_161,r_34_96_102,r_54_126_115,0.52,0,115,115,42
11,r_108_79_49,r_94_65_79,seq76,r_108_79_49,0.98,-1,48,49,42
4,r_146_131_156,r_148_40_151,seq147,r_148_40_151,0.54,-13,138,151,42
0,r_41_137_150,r_54_126_115,seq51,r_54_126_115,0.45,-38,77,115,42
73,seq58,r_56_93_161,r_86_55_94,r_86_55_94,0.9,67,161,94,42
20,r_148_40_151,r_146_131_156,r_33_38_37,r_148_40_151,0.64,0,151,151,42
0,r_41_137_150,seq51,seq139,r_41_137_150,1,0,150,150,42
4,r_146_131_156,seq147,r_46_132_2,r_146_131_156,0.87,0,156,156,42
13,r_124_6_36,seq121,seq5,r_124_6_36,1,0,36,36,42
27,r_94_65_79,r_106_89_171,seq66,r_94_65_79,1,0,79,79,42
2,r_44_136_158,seq42,r_41_137_150,r_44_136_158,0.58,0,158,158,42
47,r_21_1_161,seq19,r_141_0_7,r_141_0_7,0.82,154,161,7,42
13,r_124_6_36,seq5,r_135_4_95,r_135_4_95,1,0,95,95,42
18,r_134_149_90,seq130,seq147,r_134_149_90,0.77,0,90,90,42
34,r_56_93_161,seq58,r_102_92_13,r_56_93_161,0.98,0,161,161,42
70,seq42,r_44_136_158,r_84_45_85,r_84_45_85,0.98,79,164,85,42
14,r_141_0_7,r_75_7_15,r_21_1_161,r_141_0_7,0.35,154,161,7,42
53,seq5,seq2,r_124_6_36,r_124_6_36,1,12,48,36,42
32,r_73_99_163,seq72,seq100,r_73_99_163,0.76,0,163,163,42
38,r_135_4_95,r_146_131_156,r_124_6_36,r_135_4_95,0.96,0,95,95,42
77,seq66,seq64,r_94_65_79,r_94_65_79,1,9,88,79,42
22,r_138_81_48,seq139,seq83,r_138_81_48,0.98,1,49,48,42
19,r_32_128_169,seq29,r_146_131_156,r_32_128_169,0.91,0,169,169,42
34,r_56_93_161,r_54_126_115,seq58,r_54_126_115,1,-40,75,115,42
24,r_34_96_102,r_33_38_37,seq26,r_34_96_102,0.63,-65,37,102,42
75,seq60,r_61_125_117,seq59,r_61_125_117,1,1,118,117,42
49,r_35_50_19,r_39_144_159,seq51,r_35_50_19,0.74,4,23,19,42
30,r_27_142_43,r_28_112_112,seq147,r_27_142_43,0.88,0,43,43,42
14,r_141_0_7,seq2,r_75_7_15,r_75_7_15,0.51,39,54,15,42
9,r_84_45_85,seq83,seq51,r_84_45_85,0.98,0,85,85,42
28,r_61_125_117,seq60,r_57_122_71,r_61_125_117,0.77,1,118,117,42
10,r_33_38_37,r_34_96_102,seq37,r_33_38_37,0.98,0,37,37,42
7,r_48_104_140,seq51,r_127_97_34,r_48_104_140,0.86,-1,139,140,42
44,r_103_13_83,r_106_89_171,seq19,r_103_13_83,1,0,83,83,42
23,r_70_85_61,r_71_16_170,seq83,r_70_85_61,1,1,62,61,42
82,seq76,r_80_143_170,r_108_79_49,r_108_79_49,0.92,78,127,49,42
29,r_53_123_40,r_54_126_115,seq121,r_53_123_40,0.98,0,40,40,42
35,r_74_47_129,seq76,r_35_50_19,r_74_47_129,0.96,0,129,129,42
12,r_31_107_113,r_32_128_169,seq105,r_31_107_113,0.82,0,113,113,42
44,r_61_36_11,seq41,r_72_37_46,r_72_37_46,1,53,99,46,43
66,seq33,r_34_85_35,seq41,r_34_85_35,1,0,35,35,43
36,r_113_80_107,r_112_47_164,seq81,r_113_80_107,0.99,0,107,107,43
14,r_97_144_85,r_101_71_63,r_127_104_53,r_97_144_85,0.98,-22,63,85,43
29,r_72_37_46,seq70,r_61_36_11,r_72_37_46,0.87,0,46,46,43
57,seq146,r_147_40_43,seq149,r_147_40_43,0.95,0,43,43,43
22,r_103_64_52,r_101_71_63,seq62,r_103_64_52,0.65,2,54,52,43
13,r_147_40_43,seq146,seq41,r_147_40_43,1,0,43,43,43
16,r_79_44_109,seq82,r_45_60_172,r_79_44_109,0.76,0,109,109,43
21,r_132_5_163,r_134_75_180,r_49_8_156,r_134_75_180,0.59,-16,164,180,43
39,r_87_17_165,seq82,r_63_12_24,r_87_17_165,0.42,0,165,165,43
1,r_77_111_154,seq78,r_13_108_53,r_13_108_53,0.54,101,154,53,43
42,r_91_50_173,seq90,r_43_52_16,r_91_50_173,0.46,0,173,173,43
45,r_45_60_172,r_43_52_16,r_79_44_109,r_79_44_109,1,20,129,109,43
35,r_43_52_16,r_45_60_172,r_137_51_36,r_137_51_36,1,2,38,36,43
30,r_109_135_46,seq115,seq138,r_109_135_46,0.91,0,46,46,43
31,r_101_71_63,r_97_144_85,seq70,r_101_71_63,1,0,63,63,43
5,r_92_136_54,seq93,r_109_135_46,r_92_136_54,0.65,0,54,54,43
50,seq130,r_134_75_180,r_98_126_2,r_134_75_180,0.78,-11,169,180,43
11,r_129_89_41,r_131_139_126,seq90,r_129_89_41,1,0,41,41,43
16,r_79_44_109,r_45_60_172,r_128_46_94,r_45_60_172,0.86,0,172,172,43
12,r_63_12_24,seq59,r_148_14_4,r_63_12_24,0.99,0,24,24,43
44,r_61_36_11,r_63_12_24,seq41,r_61_36_11,0.61,0,11,11,43
6,r_22_110_120,seq23,seq114,r_22_110_120,1,0,120,120,43
27,r_131_139_126,seq130,seq141,r_131_139_126,0.99,0,126,126,43
14,r_97_144_85,r_127_104_53,seq141,r_97_144_85,1,0,85,85,43
41,r_137_51_36,r_140_1_97,r_43_52_16,r_137_51_36,0.49,0,36,36,43
2,r_128_46_94,r_131_139_126,r_43_52_16,r_128_46_94,0.98,0,94,94,43
3,r_13_108_53,seq11,seq114,r_13_108_53,1,0,53,53,43
40,r_29_96_192,seq28,r_127_104_53,r_127_104_53,0.74,143,196,53,43
5,r_92_136_54,r_91_50_173,seq93,r_92_136_54,0.52,-18,36,54,43
18,r_133_74_168,r_134_75_180,r_101_71_63,r_101_71_63,0.85,105,168,63,43
24,r_99_25_20,r_106_105_20,seq24,r_99_25_20,1,0,20,20,43
25,r_48_38_93,r_49_8_156,r_72_37_46,r_48_38_93,0.74,0,93,93,43
4,r_7_35_28,seq6,seq41,r_7_35_28,0.84,3,31,28,43
20,r_49_8_156,r_48_38_93,r_43_52_16,r_49_8_156,0.71,-137,19,156,43
50,seq130,r_131_139_126,r_134_75_180,r_131_139_126,0.88,0,126,126,43
20,r_49_8_156,r_43_52_16,seq4,r_43_52_16,0.92,134,150,16,43
75,seq62,seq59,r_103_64_52,r_103_64_52,1,19,71,52,43
45,r_45_60_172,r_79_44_109,r_103_64_52,r_45_60_172,0.66,0,172,172,43
17,r_34_85_35,seq33,seq84,r_34_85_35,0.66,0,35,35,43
38,r_124_53_23,r_116_123_4,seq55,r_124_53_23,0.99,0,23,23,43
9,r_134_75_180,r_133_74_168,r_98_126_2,r_134_75_180,0.46,-12,168,180,43
23,r_145_16_59,seq138,r_148_14_4,r_145_16_59,1,0,59,59,43
32,r_100_10_11,r_99_25_20,r_148_14_4,r_148_14_4,0.99,7,11,4,43
28,r_106_105_20,r_101_71_63,r_127_104_53,r_106_105_20,1,43,63,20,43
46,r_127_104_53,seq125,r_106_105_20,r_127_104_53,1,1,54,53,43
49,r_140_1_97,seq141,r_18_3_48,r_140_1_97,1,0,97,97,43
0,r_18_3_48,r_32_19_4,seq4,r_18_3_48,0.84,0,48,48,43
30,r_109_135_46,seq138,r_92_136_54,r_92_136_54,0.54,9,63,54,43
82,seq78,r_77_111_154,seq86,r_77_111_154,0.87,0,154,154,43
44,r_129_63_57,r_60_66_175,r_91_62_112,r_91_62_112,0.75,16,128,112,44
36,r_74_116_99,seq75,r_131_114_4,r_74_116_99,0.48,0,99,99,44
44,r_129_63_57,seq126,r_60_66_175,r_129_63_57,1,1,58,57,44
14,r_88_134_174,r_89_3_177,r_149_135_64,r_149_135_64,0.67,111,175,64,44
8,r_31_102_99,seq32,r_54_101_62,r_31_102_99,0.99,1,100,99,44
53,seq138,r_141_59_148,r_22_139_120,r_22_139_120,0.99,3,123,120,44
43,r_81_6_129,r_82_65_150,seq8,r_81_6_129,0.99,0,129,129,44
37,r_40_45_173,r_39_84_149,r_33_37_85,r_39_84_149,1,0,149,149,44
16,r_54_101_62,r_55_97_65,r_105_108_128,r_54_101_62,0.68,0,62,62,44
21,r_95_127_115,seq94,seq132,r_95_127_115,0.83,0,115,115,44
39,r_7_78_95,seq8,r_80_25_145,r_7_78_95,0.89,0,95,95,44
1,r_33_37_85,r_31_102_99,seq38,r_31_102_99,1,-14,85,99,44
5,r_103_100_161,r_105_108_128,r_67_104_41,r_67_104_41,0.74,87,128,41,44
46,r_60_66_175,r_58_125_127,r_144_68_107,r_60_66_175,0.51,-55,120,175,44
42,r_82_65_150,r_81_6_129,r_89_3_177,r_81_6_129,0.83,0,129,129,44
46,r_60_66_175,r_141_59_148,r_82_65_150,r_60_66_175,0.67,0,175,175,44
45,r_144_68_107,seq143,r_91_62_112,r_144_68_107,0.98,2,109,107,44
42,r_82_65_150,r_89_3_177,r_91_62_112,r_89_3_177,0.9,-26,151,177,44
24,r_148_64_151,seq142,r_129_63_57,r_148_64_151,0.86,0,151,151,44
19,r_55_97_65,seq56,seq94,r_55_97_65,0.93,0,65,65,44
39,r_7_78_95,r_80_25_145,seq77,r_80_25_145,1,0,145,145,44
31,r_26_9_67,seq24,seq11,r_26_9_67,0.95,1,68,67,44
41,r_13_35_208,r_14_0_88,r_137_16_3,r_13_35_208,0.46,-118,90,208,44
46,r_60_66_175,r_144_68_107,r_141_59_148,r_60_66_175,0.78,-22,153,175,44
89,seq107,r_106_128_173,r_96_109_48,r_96_109_48,0.87,124,172,48,44
90,seq110,seq111,r_96_109_48,r_96_109_48,0.97,19,67,48,44
26,r_133_21_80,seq123,seq8,r_133_21_80,0.99,0,80,80,44
16,r_54_101_62,r_105_108_128,r_31_102_99,r_54_101_62,0.95,66,128,62,44
0,r_91_62_112,seq69,r_144_68_107,r_144_68_107,0.72,16,123,107,44
63,seq24,r_26_9_67,seq27,r_26_9_67,0.79,1,68,67,44
20,r_14_0_88,r_13_35_208,seq2,r_14_0_88,0.62,7,95,88,44
13,r_93_4_121,seq92,r_47_19_37,r_93_4_121,0.96,0,121,121,44
98,seq124,seq123,r_95_127_115,r_95_127_115,0.77,35,150,115,44
48,r_146_5_91,r_148_64_151,seq8,r_146_5_91,0.99,0,91,91,44
15,r_49_53_46,r_12_48_7,seq52,r_49_53_46,0.59,0,46,46,44
12,r_122_44_95,r_49_53_46,r_1_43_157,r_122_44_95,0.75,67,162,95,44
47,r_80_25_145,r_7_78_95,seq24,r_80_25_145,0.99,0,145,145,44
6,r_83_113_125,seq85,r_131_114_4,r_83_113_125,0.76,0,125,125,44
27,r_106_128_173,seq107,r_95_127_115,r_95_127_115,0.78,58,173,115,44
87,seq99,r_91_62_112,r_72_61_172,r_91_62_112,0.64,-15,97,112,44
3,r_141_59_148,r_60_66_175,r_72_61_172,r_141_59_148,0.71,27,175,148,44
2,r_149_135_64,r_148_64_151,seq124,r_149_135_64,0.75,0,64,64,44
47,r_80_25_145,r_79_136_115,r_7_78_95,r_7_78_95,0.96,18,113,95,44
40,r_79_136_115,r_80_25_145,seq138,r_79_136_115,0.72,0,115,115,44
18,r_1_43_157,seq2,r_122_44_95,r_122_44_95,0.8,62,157,95,44
29,r_58_125_127,r_60_66_175,seq126,r_58_125_127,0.64,0,127,127,44
24,r_148_64_151,r_146_5_91,seq142,r_146_5_91,1,-5,86,91,44
28,r_96_109_48,r_95_127_115,seq110,r_96_109_48,0.77,0,48,48,44
33,r_72_61_172,seq70,r_141_59_148,r_141_59_148,0.84,31,179,148,44
61,seq20,seq15,r_47_19_37,r_47_19_37,0.94,2,39,37,44
65,seq28,seq27,r_98_29_93,r_98_29_93,1,8,101,93,44
32,r_105_108_128,r_103_100_161,r_96_109_48,r_105_108_128,0.64,0,128,128,44
38,r_98_29_93,r_95_127_115,seq28,r_98_29_93,1,0,93,93,44
77,seq70,r_72_61_172,seq69,r_72_61_172,0.34,7,179,172,44
34,r_71_112_129,r_72_61_172,seq111,r_71_112_129,0.8,0,129,129,44
75,seq56,r_55_97_65,r_115_57_23,r_55_97_65,1,0,65,65,44
4,r_47_19_37,r_49_53_46,seq20,r_47_19_37,0.74,0,37,37,44
9,r_39_84_149,r_40_45_173,r_147_86_28,r_39_84_149,0.95,0,149,149,44
63,seq24,seq27,r_80_25_145,r_80_25_145,1,16,161,145,44
26,r_133_21_80,seq8,r_47_19_37,r_47_19_37,0.59,153,190,37,44
10,r_12_48_7,r_49_53_46,seq46,r_12_48_7,0.66,39,46,7,44
49,r_147_86_28,r_149_135_64,seq85,r_147_86_28,0.97,1,29,28,44
36,r_74_116_99,r_131_114_4,seq117,r_131_114_4,0.49,130,134,4,44
72,seq46,r_47_19_37,r_12_48_7,r_47_19_37,0.78,0,37,37,44
7,r_22_139_120,seq23,seq138,r_22_139_120,0.97,0,120,120,44
23,r_73_10_150,seq75,r_26_9_67,r_73_10_150,0.87,0,150,150,44
12,r_122_44_95,seq126,r_49_53_46,r_122_44_95,0.99,0,95,95,44
36,r_82_47_159,seq84,r_68_56_74,r_68_56_74,0.93,92,166,74,45
47,r_85_43_17,r_80_116_159,seq45,r_85_43_17,0.97,0,17,17,45
14,r_8_73_92,seq10,r_72_55_156,r_8_73_92,1,0,92,92,45
8,r_42_71_164,seq41,r_8_73_92,r_42_71_164,0.51,1,165,164,45
53,seq132,r_130_9_189,r_87_131_87,r_87_131_87,0.99,102,189,87,45
52,seq3,r_2_58_198,r_112_7_44,r_112_7_44,1,2,46,44,45
23,r_33_104_32,r_34_139_130,r_107_134_171,r_33_104_32,0.98,0,32,32,45
16,r_77_76_78,r_72_55_156,r_31_75_123,r_77_76_78,0.74,57,135,78,45
40,r_26_103_167,r_5_23_10,seq101,r_26_103_167,0.87,0,167,167,45
1,r_24_38_109,seq21,r_32_37_64,r_24_38_109,1,0,109,109,45
42,r_95_96_115,seq90,r_19_94_112,r_19_94_112,1,20,132,112,45
43,r_34_139_130,r_33_104_32,r_32_37_64,r_33_104_32,0.9,0,32,32,45
55,seq137,seq136,r_59_138_33,r_59_138_33,1,1,34,33,45
69,seq48,seq53,r_113_49_121,r_113_49_121,1,50,171,121,45
12,r_112_7_44,seq3,r_14_4_64,r_112_7_44,0.27,53,97,44,45
35,r_133_13_50,r_130_9_189,r_92_11_37,r_133_13_50,0.98,1,51,50,45
23,r_33_104_32,r_107_134_171,r_57_105_82,r_57_105_82,1,0,82,82,45
19,r_57_105_82,seq53,r_33_104_32,r_57_105_82,0.98,1,83,82,45
2,r_46_109_81,r_79_51_20,seq110,r_46_109_81,0.96,0,81,81,45
95,seq119,seq126,r_80_116_159,r_80_116_159,0.96,14,173,159,45
66,seq41,r_42_71_164,seq45,r_42_71_164,1,1,165,164,45
21,r_67_83_19,r_63_93_126,seq84,r_63_93_126,0.65,-108,18,126,45
38,r_50_148_33,r_57_105_82,seq149,r_50_148_33,0.82,2,35,33,45
31,r_2_58_198,r_1_122_61,seq3,r_1_122_61,1,0,61,61,45
41,r_31_75_123,seq30,r_77_76_78,r_31_75_123,0.82,0,123,123,45
89,seq101,r_107_134_171,r_57_105_82,r_57_105_82,1,27,109,82,45
30,r_79_51_20,r_80_116_159,seq53,r_79_51_20,1,0,20,20,45
3,r_80_116_159,seq81,seq115,r_80_116_159,0.67,0,159,159,45
10,r_117_22_188,seq118,r_5_23_10,r_5_23_10,0.52,179,189,10,45
26,r_62_144_85,seq60,seq145,r_62_144_85,1,0,85,85,45
72,seq60,r_62_144_85,r_125_66_11,r_62_144_85,0.98,0,85,85,45
14,r_8_73_92,r_72_55_156,seq69,r_72_55_156,1,0,156,156,45
32,r_32_37_64,seq36,r_24_38_109,r_24_38_109,1,1,110,109,45
45,r_59_138_33,r_57_105_82,seq137,r_59_138_33,0.85,2,35,33,45
11,r_52_121_110,seq53,r_1_122_61,r_52_121_110,0.96,2,112,110,45
57,seq12,seq10,r_92_11_37,r_92_11_37,1,5,42,37,45
13,r_27_15_111,r_26_103_167,seq16,r_27_15_111,0.84,0,111,111,45
15,r_40_143_165,seq39,r_62_144_85,r_40_143_165,0.59,0,165,165,45
48,r_25_61_144,r_26_103_167,seq60,r_25_61_144,0.84,0,144,144,45
49,r_74_111_46,r_113_49_121,seq115,r_113_49_121,1,0,121,121,45
37,r_92_11_37,r_87_131_87,seq12,r_92_11_37,0.99,0,37,37,45
0,r_113_49_121,r_112_7_44,r_74_111_46,r_113_49_121,1,-76,45,121,45
4,r_28_120_36,seq126,r_1_122_61,r_1_122_61,1,7,68,61,45
49,r_74_111_46,r_77_76_78,r_113_49_121,r_74_111_46,1,1,47,46,45
63,seq30,r_24_38_109,r_85_43_17,r_24_38_109,0.51,75,184,109,45
0,r_113_49_121,r_74_111_46,seq48,r_113_49_121,1,0,121,121,45
27,r_72_55_156,r_77_76_78,r_68_56_74,r_68_56_74,0.99,82,156,74,45
40,r_26_103_167,r_25_61_144,r_5_23_10,r_26_103_167,0.78,-22,145,167,45
18,r_106_141_99,r_107_134_171,r_62_144_85,r_62_144_85,0.73,14,99,85,45
29,r_1_122_61,r_2_58_198,r_28_120_36,r_1_122_61,1,0,61,61,45
25,r_19_94_112,seq16,r_95_96_115,r_19_94_112,1,0,112,112,45
43,r_34_139_130,r_32_37_64,seq140,r_34_139_130,0.58,0,130,130,45
33,r_87_131_87,seq90,seq132,r_87_131_87,1,0,87,87,45
7,r_125_66_11,seq124,seq65,r_125_66_11,0.79,0,11,11,45
32,r_32_37_64,r_31_75_123,seq36,r_32_37_64,0.71,1,65,64,45
12,r_112_7_44,r_113_49_121,seq3,r_112_7_44,0.98,0,44,44,45
4,r_28_120_36,r_27_15_111,seq126,r_28_120_36,0.95,0,36,36,45
17,r_63_93_126,r_72_55_156,r_19_94_112,r_63_93_126,0.63,0,126,126,45
94,seq118,r_117_22_188,r_80_116_159,r_80_116_159,0.84,28,187,159,45
2,r_46_109_81,r_52_121_110,r_79_51_20,r_79_51_20,0.84,25,45,20,45
9,r_68_56_74,seq70,seq53,r_68_56_74,1,0,74,74,45
22,r_14_4_64,seq12,r_112_7_44,r_112_7_44,0.91,20,64,44,45
28,r_107_134_171,seq110,r_59_138_33,r_59_138_33,0.91,137,170,33,45
72,seq60,r_125_66_11,r_25_61_144,r_25_61_144,1,13,157,144,45
44,r_135_102_169,r_142_147_90,r_26_103_167,r_135_102_169,0.39,0,169,169,45
6,r_146_108_20,r_142_147_90,seq110,r_146_108_20,0.88,3,23,20,45
39,r_35_127_5,seq128,seq132,r_35_127_5,0.57,29,34,5,45
36,r_58_113_105,seq59,r_145_115_16,r_58_113_105,1,0,105,105,46
14,r_90_79_133,r_94_43_161,r_133_78_47,r_90_79_133,0.91,0,133,133,46
8,r_94_43_161,r_93_0_87,r_73_91_82,r_94_43_161,0.99,-74,87,161,46
43,r_137_37_76,r_139_10_119,r_35_8_141,r_137_37_76,1,0,76,76,46
47,r_70_9_75,r_5_4_88,r_139_10_119,r_139_10_119,1,1,120,119,46
94,seq114,seq117,r_145_115_16,r_145_115_16,0.95,16,32,16,46
54,seq138,r_139_10_119,seq140,r_139_10_119,1,0,119,119,46
37,r_38_148_86,r_41_97_192,seq147,r_38_148_86,0.98,0,86,86,46
55,seq11,r_12_18_203,r_110_13_36,r_110_13_36,1,36,72,36,46
86,seq89,r_94_43_161,r_73_91_82,r_73_91_82,0.8,54,136,82,46
21,r_71_40_118,seq64,seq39,r_71_40_118,0.91,1,119,118,46
39,r_120_127_172,seq117,seq126,r_120_127_172,0.54,1,173,172,46
46,r_16_99_70,seq21,seq100,r_16_99_70,1,0,70,70,46
42,r_49_146_122,seq50,seq147,r_49_146_122,0.99,0,122,122,46
80,seq80,r_83_36_152,seq81,r_83_36_152,0.98,-46,106,152,46
12,r_129_96_34,r_128_131_127,seq100,r_129_96_34,1,0,34,34,46
45,r_101_136_109,seq103,seq135,r_101_136_109,0.99,0,109,109,46
7,r_53_30_50,r_62_72_136,r_118_33_37,r_53_30_50,0.94,-1,49,50,46
43,r_137_37_76,r_119_48_49,r_83_36_152,r_83_36_152,0.9,2,154,152,46
19,r_42_144_75,r_41_97_192,seq142,r_42_144_75,1,0,75,75,46
31,r_108_92_179,seq107,r_73_91_82,r_73_91_82,0.97,97,179,82,46
41,r_29_46_192,seq32,r_94_43_161,r_94_43_161,1,31,192,161,46
67,seq142,r_143_19_122,r_42_144_75,r_42_144_75,0.58,47,122,75,46
30,r_15_55_20,seq14,seq56,r_15_55_20,0.91,0,20,20,46
49,r_119_48_49,r_120_127_172,seq45,r_119_48_49,1,0,49,49,46
64,seq32,r_29_46_192,r_118_33_37,r_118_33_37,1,2,39,37,46
20,r_133_78_47,r_134_27_61,seq77,r_133_78_47,1,0,47,47,46
26,r_98_7_158,seq100,r_52_6_95,r_98_7_158,0.87,0,158,158,46
8,r_94_43_161,r_73_91_82,r_119_48_49,r_94_43_161,0.99,0,161,161,46
4,r_141_66_76,seq140,r_88_65_42,r_141_66_76,1,0,76,76,46
16,r_125_76_51,seq123,seq77,r_125_76_51,1,0,51,51,46
0,r_52_6_95,r_57_121_149,r_5_4_88,r_52_6_95,0.77,0,95,95,46
63,seq28,r_41_97_192,r_134_27_61,r_134_27_61,1,0,61,61,46
73,seq59,r_62_72_136,seq56,r_62_72_136,0.98,-71,65,136,46
2,r_88_65_42,seq87,seq64,r_88_65_42,0.87,0,42,42,46
13,r_143_19_122,seq142,seq21,r_143_19_122,0.95,0,122,122,46
15,r_41_97_192,seq39,r_73_91_82,r_73_91_82,0.95,113,195,82,46
40,r_110_13_36,r_108_92_179,seq11,r_110_13_36,1,0,36,36,46
48,r_139_10_119,seq138,r_70_9_75,r_139_10_119,0.99,0,119,119,46
22,r_130_109_10,r_129_96_34,seq107,r_130_109_10,0.9,0,10,10,46
6,r_5_4_88,seq3,r_70_9_75,r_70_9_75,0.99,2,77,75,46
2,r_88_65_42,seq64,r_141_66_76,r_141_66_76,1,57,133,76,46
0,r_52_6_95,r_5_4_88,r_98_7_158,r_98_7_158,1,0,158,158,46
27,r_134_27_61,seq132,seq28,r_134_27_61,1,0,61,61,46
24,r_73_91_82,r_90_79_133,r_16_99_70,r_90_79_133,1,0,133,133,46
87,seq100,r_98_7_158,r_16_99_70,r_16_99_70,1,1,71,70,46
59,seq21,r_16_99_70,r_60_20_8,r_16_99_70,0.55,-49,21,70,46
47,r_70_9_75,seq69,r_5_4_88,r_70_9_75,0.94,0,75,75,46
18,r_83_36_152,seq82,r_137_37_76,r_137_37_76,0.98,76,152,76,46
29,r_35_8_141,r_41_97_192,r_137_37_76,r_137_37_76,1,6,82,76,46
24,r_73_91_82,seq74,r_90_79_133,r_73_91_82,0.98,0,82,82,46
25,r_44_112_60,r_42_144_75,r_130_109_10,r_44_112_60,1,0,60,60,46
43,r_137_37_76,r_35_8_141,r_119_48_49,r_119_48_49,0.57,93,142,49,46
33,r_93_0_87,r_94_43_161,seq2,r_93_0_87,1,0,87,87,46
50,seq2,r_1_31_67,seq3,r_1_31_67,0.59,-1,66,67,46
58,seq147,r_143_19_122,r_38_148_86,r_38_148_86,0.95,5,91,86,46
56,seq140,r_141_66_76,seq138,r_141_66_76,1,-17,59,76,46
65,seq39,r_41_97_192,r_94_43_161,r_94_43_161,0.94,30,191,161,46
32,r_57_121_149,seq56,seq122,r_57_121_149,0.85,0,149,149,46
81,seq81,r_83_36_152,seq80,r_83_36_152,1,-4,148,152,46
17,r_84_61_138,seq85,seq56,r_84_61_138,0.83,1,139,138,46
1,r_68_17_23,r_70_9_75,seq21,r_68_17_23,0.93,0,23,23,46
50,seq2,seq3,r_93_0_87,r_93_0_87,0.84,1,88,87,46
29,r_35_8_141,r_137_37_76,r_70_9_75,r_35_8_141,0.96,0,141,141,46
28,r_1_31_67,seq2,seq32,r_1_31_67,0.98,0,67,67,46
23,r_111_149_129,seq106,r_38_148_86,r_111_149_129,0.99,0,129,129,46
82,seq82,r_83_36_152,seq81,r_83_36_152,1,-69,83,152,46
10,r_145_115_16,r_143_19_122,seq114,r_145_115_16,0.96,0,16,16,46
3,r_118_33_37,r_120_127_172,seq32,r_118_33_37,1,0,37,37,46
58,seq147,r_38_148_86,r_49_146_122,r_49_146_122,0.99,16,138,122,46
79,seq77,r_75_124_194,r_125_76_51,r_125_76_51,1,48,99,51,46
35,r_62_72_136,seq59,seq69,r_62_72_136,0.63,0,136,136,46
11,r_95_23_42,r_94_43_161,seq24,r_95_23_42,1,0,42,42,46
37,r_38_148_86,seq147,r_111_149_129,r_111_149_129,0.99,9,138,129,46
30,r_57_71_126,r_56_148_138,r_80_75_28,r_56_148_138,0.96,-10,128,138,47
36,r_34_36_182,seq35,r_30_67_51,r_30_67_51,0.84,133,184,51,47
92,seq146,seq149,r_70_147_113,r_70_147_113,1,11,124,113,47
19,r_117_133_14,r_115_88_192,seq132,r_117_133_14,1,1,15,14,47
14,r_55_82_53,seq54,seq85,r_55_82_53,0.61,7,60,53,47
53,seq134,r_135_5_166,r_117_133_14,r_135_5_166,0.86,0,166,166,47
54,seq7,r_27_78_207,r_44_6_96,r_44_6_96,0.76,1,97,96,47
14,r_55_82_53,seq85,r_4_84_115,r_4_84_115,1,0,115,115,47
40,r_130_94_46,seq131,r_39_95_24,r_130_94_46,1,1,47,46,47
10,r_107_3_98,seq110,r_83_108_24,r_83_108_24,1,2,26,24,47
55,seq10,r_11_74_178,seq12,r_11_74_178,0.87,1,179,178,47
16,r_44_6_96,r_42_79_203,seq7,r_44_6_96,0.69,0,96,96,47
21,r_24_96_209,r_25_72_142,r_60_21_39,r_24_96_209,0.48,-67,142,209,47
1,r_145_109_155,seq143,r_104_111_44,r_145_109_155,0.78,0,155,155,47
5,r_53_100_125,r_57_71_126,r_106_101_120,r_57_71_126,0.5,-1,125,126,47
46,r_127_14_177,seq131,seq13,r_127_14_177,0.75,0,177,177,47
80,seq73,seq76,r_25_72_142,r_25_72_142,1,19,161,142,47
8,r_39_95_24,seq40,r_8_97_20,r_39_95_24,0.93,0,24,24,47
20,r_1_23_20,r_0_19_198,seq22,r_1_23_20,0.99,0,20,20,47
45,r_103_128_107,seq102,r_123_129_90,r_103_128_107,0.99,0,107,107,47
48,r_83_108_24,seq85,r_107_3_98,r_83_108_24,0.99,0,24,24,47
95,seq114,r_115_88_192,r_69_116_38,r_69_116_38,1,154,192,38,47
66,seq35,r_34_36_182,seq26,r_34_36_182,0.77,0,182,182,47
76,seq140,seq142,r_63_141_24,r_63_141_24,1,58,82,24,47
31,r_135_5_166,seq134,r_44_6_96,r_135_5_166,0.94,0,166,166,47
41,r_77_62_4,r_59_92_128,r_91_61_150,r_77_62_4,0.59,139,143,4,47
39,r_45_124_17,r_44_6_96,r_115_88_192,r_45_124_17,0.97,0,17,17,47
11,r_37_68_161,r_86_105_19,r_53_100_125,r_37_68_161,0.65,-107,54,161,47
4,r_32_20_179,r_34_36_182,r_60_21_39,r_60_21_39,0.8,141,180,39,47
2,r_69_116_38,seq76,seq114,r_69_116_38,1,0,38,38,47
0,r_33_28_143,r_34_36_182,seq29,r_33_28_143,0.51,8,151,143,47
7,r_30_67_51,r_31_120_150,seq65,r_30_67_51,1,1,52,51,47
13,r_59_92_128,r_77_62_4,seq98,r_59_92_128,0.63,0,128,128,47
11,r_37_68_161,r_53_100_125,r_30_67_51,r_30_67_51,0.48,43,94,51,47
15,r_63_141_24,seq66,seq142,r_63_141_24,0.99,0,24,24,47
6,r_136_119_78,r_137_118_207,r_69_116_38,r_136_119_78,1,0,78,78,47
62,seq149,seq142,r_56_148_138,r_56_148_138,1,17,155,138,47
10,r_107_3_98,r_83_108_24,r_4_84_115,r_107_3_98,0.86,0,98,98,47
18,r_91_61_150,r_93_43_155,r_77_62_4,r_91_61_150,0.54,1,151,150,47
24,r_11_74_178,seq10,r_80_75_28,r_11_74_178,0.38,0,178,178,47
8,r_39_95_24,r_8_97_20,r_130_94_46,r_130_94_46,0.99,22,68,46,47
25,r_50_139_205,seq51,seq138,r_50_139_205,0.32,0,205,205,47
33,r_70_147_113,seq73,seq146,r_70_147_113,1,0,113,113,47
51,seq131,r_127_14_177,seq132,r_127_14_177,0.44,-118,59,177,47
65,seq29,r_31_120_150,r_33_28_143,r_31_120_150,0.69,1,151,150,47
38,r_56_148_138,r_58_112_201,seq149,r_56_148_138,0.97,0,138,138,47
28,r_4_84_115,r_107_3_98,r_55_82_53,r_4_84_115,0.8,0,115,115,47
35,r_104_111_44,r_106_101_120,seq110,r_104_111_44,1,0,44,44,47
10,r_107_3_98,r_4_84_115,seq2,r_4_84_115,0.97,0,115,115,47
17,r_58_112_201,seq52,seq113,r_58_112_201,0.41,0,201,201,47
48,r_83_108_24,r_107_3_98,r_104_111_44,r_107_3_98,0.75,-24,74,98,47
9,r_64_9_91,seq73,seq10,r_64_9_91,0.7,0,91,91,47
42,r_60_21_39,r_77_62_4,seq22,r_60_21_39,0.96,0,39,39,47
34,r_8_97_20,r_11_74_178,seq90,r_8_97_20,0.64,1,21,20,47
22,r_123_129_90,seq122,seq131,r_123_129_90,0.99,0,90,90,47
28,r_4_84_115,r_0_19_198,r_107_3_98,r_0_19_198,0.26,-100,98,198,47
91,seq102,r_103_128_107,r_106_101_120,r_103_128_107,1,0,107,107,47
88,seq144,r_145_109_155,seq143,r_145_109_155,0.91,-119,36,155,47
23,r_115_88_192,seq114,r_53_100_125,r_115_88_192,0.6,0,192,192,47
94,seq113,r_115_88_192,r_45_124_17,r_45_124_17,0.85,21,38,17,47
58,seq142,seq140,r_63_141_24,r_63_141_24,1,16,40,24,47
30,r_40_11_62,r_43_60_118,seq13,r_40_11_62,0.96,0,62,62,48
44,r_75_35_59,r_36_2_130,seq38,r_36_2_130,1,-4,126,130,48
36,r_107_10_99,r_105_142_103,seq7,r_107_10_99,1,0,99,99,48
46,r_124_46_127,seq28,r_139_44_170,r_139_44_170,0.99,3,173,170,48
20,r_31_78_41,seq28,seq76,r_31_78_41,0.99,0,41,41,48
44,r_75_35_59,r_82_133_169,r_36_2_130,r_75_35_59,0.99,0,59,59,48
14,r_102_64_187,r_103_3_137,r_83_106_159,r_103_3_137,0.94,0,137,137,48
8,r_96_63_92,seq91,seq65,r_96_63_92,0.95,0,92,92,48
24,r_45_15_93,r_49_147_155,seq14,r_45_15_93,1,0,93,93,48
83,seq84,r_83_106_159,r_31_78_41,r_31_78_41,1,118,159,41,48
37,r_103_3_137,r_102_64_187,r_36_2_130,r_103_3_137,0.9,0,137,137,48
19,r_139_44_170,r_8_138_78,r_124_46_127,r_139_44_170,0.97,0,170,170,48
55,seq141,r_144_32_177,r_101_140_68,r_101_140_68,1,6,74,68,48
16,r_146_22_41,seq148,r_23_61_170,r_146_22_41,1,0,41,41,48
21,r_82_133_169,seq84,r_109_130_28,r_82_133_169,0.64,0,169,169,48
39,r_119_135_129,seq120,r_109_130_28,r_119_135_129,0.81,0,129,129,48
1,r_101_140_68,r_102_64_187,seq141,r_101_140_68,1,0,68,68,48
5,r_4_58_183,seq7,r_36_2_130,r_36_2_130,0.72,16,146,130,48
46,r_124_46_127,seq123,seq28,r_124_46_127,0.7,0,127,127,48
42,r_8_138_78,r_12_53_137,r_139_44_170,r_8_138_78,1,0,78,78,48
18,r_1_0_52,r_104_5_69,r_36_2_130,r_36_2_130,0.83,6,136,130,48
61,seq28,r_31_78_41,seq33,r_31_78_41,0.99,-1,40,41,48
45,r_6_77_104,r_12_53_137,r_31_78_41,r_6_77_104,0.96,0,104,104,48
19,r_139_44_170,seq136,r_8_138_78,r_8_138_78,1,19,97,78,48
11,r_16_48_51,r_49_147_155,r_41_50_68,r_49_147_155,0.96,0,155,155,48
66,seq47,r_49_147_155,seq52,r_49_147_155,0.96,-71,84,155,48
31,r_41_50_68,r_43_60_118,r_16_48_51,r_16_48_51,0.99,17,68,51,48
41,r_85_66_151,seq86,r_118_67_8,r_85_66_151,0.59,0,151,151,48
3,r_12_53_137,seq9,r_43_60_118,r_12_53_137,0.62,0,137,137,48
10,r_36_2_130,r_39_57_79,r_75_35_59,r_36_2_130,0.88,-69,61,130,48
26,r_105_142_103,r_107_10_99,r_101_140_68,r_107_10_99,0.54,5,104,99,48
4,r_49_147_155,seq51,r_16_48_51,r_16_48_51,1,28,79,51,48
0,r_108_20_182,seq111,seq19,r_108_20_182,0.66,0,182,182,48
15,r_39_57_79,seq38,seq59,r_39_57_79,0.94,0,79,79,48
48,r_144_32_177,seq145,seq33,r_144_32_177,0.44,0,177,177,48
11,r_16_48_51,seq14,r_49_147_155,r_16_48_51,1,0,51,51,48
49,r_127_24_189,r_25_128_72,r_146_22_41,r_127_24_189,0.67,1,190,189,48
4,r_49_147_155,r_16_48_51,seq148,r_49_147_155,0.69,0,155,155,48
6,r_95_143_118,seq91,seq148,r_95_143_118,0.97,0,118,118,48
10,r_36_2_130,r_75_35_59,r_1_0_52,r_36_2_130,1,0,130,130,48
22,r_131_30_175,r_109_130_28,seq28,r_131_30_175,0.88,0,175,175,48
47,r_70_110_84,seq68,seq111,r_70_110_84,1,0,84,84,48
24,r_45_15_93,r_39_57_79,r_49_147_155,r_45_15_93,0.34,-32,61,93,48
25,r_83_106_159,seq84,r_117_94_148,r_117_94_148,0.94,13,161,148,48
64,seq38,r_39_57_79,r_75_35_59,r_75_35_59,0.52,20,79,59,48
14,r_102_64_187,r_83_106_159,seq65,r_102_64_187,0.55,0,187,187,48
42,r_8_138_78,r_139_44_170,r_105_142_103,r_8_138_78,0.9,92,170,78,48
32,r_104_5_69,r_105_142_103,seq7,r_104_5_69,1,0,69,69,48
38,r_18_129_152,seq19,r_25_128_72,r_18_129_152,0.87,0,152,152,48
5,r_4_58_183,r_36_2_130,r_12_53_137,r_4_58_183,0.79,0,183,183,48
60,seq27,r_25_128_72,r_23_61_170,r_25_128_72,1,0,72,72,48
17,r_134_62_159,r_131_30_175,r_118_67_8,r_134_62_159,0.73,0,159,159,48
93,seq115,r_117_94_148,r_89_116_20,r_89_116_20,0.93,2,22,20,48
29,r_89_116_20,r_95_143_118,seq115,r_89_116_20,0.99,0,20,20,48
28,r_109_130_28,r_131_30_175,r_82_133_169,r_109_130_28,0.73,147,175,28,48
22,r_131_30_175,r_134_62_159,r_109_130_28,r_109_130_28,0.71,44,72,28,48
49,r_127_24_189,r_134_62_159,r_25_128_72,r_25_128_72,1,7,79,72,48
26,r_105_142_103,r_101_140_68,r_95_143_118,r_95_143_118,0.86,21,139,118,48
28,r_109_130_28,seq111,r_131_30_175,r_109_130_28,0.98,0,28,28,48
43,r_100_121_39,r_101_140_68,seq123,r_100_121_39,0.96,0,39,39,48
56,seq145,r_144_32_177,r_101_140_68,r_101_140_68,1,109,177,68,48
7,r_117_94_148,seq115,seq93,r_117_94_148,0.91,0,148,148,48
23,r_25_128_72,seq27,r_127_24_189,r_25_128_72,1,0,72,72,48
60,seq27,r_23_61_170,r_146_22_41,r_23_61_170,0.94,0,170,170,48
35,r_132_37_119,r_134_62_159,r_75_35_59,r_132_37_119,0.99,0,119,119,48
12,r_71_90_99,seq68,seq91,r_71_90_99,0.9,0,99,99,48
23,r_25_128_72,r_127_24_189,r_18_129_152,r_18_129_152,0.97,38,190,152,48
30,r_105_99_130,seq106,seq100,r_105_99_130,0.73,0,130,130,49
70,seq45,r_118_35_86,r_104_44_151,r_104_44_151,0.98,-1,150,151,49
36,r_42_127_143,r_43_120_176,seq135,r_42_127_143,0.9,0,143,143,49
14,r_133_78_155,seq132,r_144_80_52,r_133_78_155,0.93,0,155,155,49
8,r_6_83_193,seq5,r_53_82_2,r_6_83_193,0.06,1,194,193,49
43,r_97_20_71,seq94,r_11_23_151,r_97_20_71,0.99,0,71,71,49
32,r_66_109_31,r_65_123_154,seq108,r_66_109_31,0.98,0,31,31,49
37,r_138_32_116,r_137_3_178,r_15_30_13,r_138_32_116,0.87,0,116,116,49
55,seq135,r_137_3_178,r_42_127_143,r_42_127_143,0.9,2,145,143,49
16,r_114_136_121,r_113_64_180,seq135,r_114_136_121,0.67,0,121,121,49
21,r_91_67_3,r_65_123_154,r_117_68_108,r_117_68_108,0.82,46,154,108,49
39,r_104_44_151,seq106,r_140_46_150,r_140_46_150,0.79,2,152,150,49
1,r_53_82_2,r_81_61_92,r_26_85_12,r_81_61_92,0.72,-15,77,92,49
5,r_110_89_117,seq108,seq88,r_110_89_117,0.79,0,117,117,49
46,r_22_54_123,r_21_14_193,seq55,r_22_54_123,0.9,0,123,123,49
19,r_41_107_153,seq37,r_66_109_31,r_41_107_153,0.72,0,153,153,49
11,r_65_123_154,r_66_109_31,r_91_67_3,r_66_109_31,0.85,0,31,31,49
11,r_65_123_154,r_91_67_3,seq124,r_65_123_154,0.63,0,154,154,49
76,seq60,seq56,r_47_59_129,r_47_59_129,0.71,14,143,129,49
31,r_81_61_92,r_53_82_2,r_62_38_150,r_81_61_92,0.91,0,92,92,49
33,r_74_149_57,seq75,seq147,r_74_149_57,0.99,0,57,57,49
3,r_118_35_86,r_117_68_108,seq33,r_118_35_86,0.99,0,86,86,49
10,r_11_23_151,r_13_119_167,r_4_2_128,r_11_23_151,0.49,19,170,151,49
47,r_26_85_12,seq25,seq84,r_26_85_12,0.97,0,12,12,49
90,seq98,r_113_64_180,r_102_96_133,r_113_64_180,0.43,-16,164,180,49
26,r_129_116_163,seq128,r_41_107_153,r_129_116_163,0.81,0,163,163,49
63,seq19,r_21_14_193,seq5,r_21_14_193,0.32,-30,163,193,49
13,r_69_50_159,r_65_123_154,r_117_68_108,r_117_68_108,0.72,2,110,108,49
15,r_102_96_133,r_104_44_151,seq94,r_102_96_133,0.78,0,133,133,49
48,r_87_29_99,seq86,r_27_24_158,r_87_29_99,0.99,0,99,99,49
0,r_15_30_13,r_21_14_193,seq33,r_15_30_13,1,0,13,13,49
13,r_69_50_159,r_117_68_108,seq51,r_69_50_159,0.93,0,159,159,49
80,seq75,r_74_149_57,seq76,r_74_149_57,1,0,57,57,49
27,r_117_68_108,r_110_89_117,r_69_50_159,r_117_68_108,0.77,0,108,108,49
25,r_47_59_129,seq60,seq51,r_47_59_129,0.37,-95,34,129,49
41,r_144_80_52,r_145_48_158,seq79,r_144_80_52,1,0,52,52,49
2,r_13_119_167,r_11_23_151,r_66_109_31,r_13_119_167,0.44,0,167,167,49
40,r_140_46_150,seq141,r_104_44_151,r_140_46_150,0.71,0,150,150,49
29,r_125_7_76,seq124,r_6_83_193,r_125_7_76,0.85,0,76,76,49
24,r_63_49_105,r_62_38_150,seq51,r_63_49_105,0.9,0,105,105,49
9,r_27_24_158,r_87_29_99,seq25,r_27_24_158,0.66,11,169,158,49
44,r_62_38_150,r_91_67_3,r_16_36_14,r_62_38_150,0.99,0,150,150,49
42,r_16_36_14,r_21_14_193,seq37,r_16_36_14,0.9,0,14,14,49
50,seq0,seq1,r_4_2_128,r_4_2_128,0.36,7,135,128,49
38,r_43_120_176,r_42_127_143,seq39,r_42_127_143,0.89,0,143,143,49
34,r_101_134_165,seq100,r_114_136_121,r_114_136_121,0.5,43,164,121,49
27,r_117_68_108,r_69_50_159,r_91_67_3,r_69_50_159,1,0,159,159,49
31,r_81_61_92,r_62_38_150,r_117_68_108,r_81_61_92,0.64,44,136,92,49
81,seq76,r_77_115_127,seq75,r_77_115_127,0.97,0,127,127,49
17,r_77_115_127,seq76,r_66_109_31,r_77_115_127,0.81,0,127,127,49
70,seq45,r_42_127_143,r_118_35_86,r_118_35_86,0.62,28,114,86,49
9,r_27_24_158,r_28_130_126,r_87_29_99,r_27_24_158,0.99,-32,126,158,49
96,seq147,r_145_48_158,r_74_149_57,r_74_149_57,0.98,8,65,57,49
28,r_146_131_98,seq147,seq135,r_146_131_98,1,0,98,98,49
49,r_142_103_113,seq143,seq106,r_142_103_113,0.93,0,113,113,49
7,r_21_14_193,r_22_54_123,r_97_20_71,r_21_14_193,0.85,-104,89,193,49
44,r_62_38_150,r_63_49_105,r_91_67_3,r_62_38_150,0.7,-46,104,150,49
23,r_122_31_86,seq121,r_15_30_13,r_122_31_86,0.99,1,87,86,49
82,seq79,seq84,r_144_80_52,r_144_80_52,1,67,119,52,49
22,r_12_58_23,r_13_119_167,seq56,r_12_58_23,0.97,0,23,23,49
35,r_145_48_158,seq147,r_47_59_129,r_145_48_158,0.75,1,159,158,49
12,r_28_130_126,r_27_24_158,seq135,r_28_130_126,1,0,126,126,49
18,r_112_25_60,seq110,seq24,r_112_25_60,0.99,-1,59,60,50
43,r_55_28_78,seq57,r_112_25_60,r_55_28_78,0.99,0,78,78,50
37,r_137_39_141,r_135_94_142,r_18_38_66,r_18_38_66,1,75,141,66,50
21,r_136_72_113,r_137_39_141,seq69,r_136_72_113,0.89,0,113,113,50
39,r_47_106_62,r_50_30_115,seq113,r_47_106_62,0.94,0,62,62,50
14,r_67_84_42,seq66,seq86,r_67_84_42,0.85,2,44,42,50
5,r_50_30_115,seq49,r_112_25_60,r_50_30_115,0.74,0,115,115,50
80,seq77,r_76_79_144,r_136_72_113,r_136_72_113,1,20,133,113,50
1,r_65_123_47,seq66,seq124,r_65_123_47,0.97,0,47,47,50
41,r_81_90_188,seq80,r_97_98_55,r_97_98_55,0.87,134,189,55,50
30,r_1_78_191,seq0,r_129_2_13,r_129_2_13,0.8,21,34,13,50
46,r_85_26_21,r_87_107_195,seq24,r_85_26_21,1,0,21,21,50
10,r_40_95_165,seq42,r_97_98_55,r_97_98_55,0.53,110,165,55,50
90,seq145,seq126,r_101_146_28,r_101_146_28,0.77,45,73,28,50
42,r_115_31_174,seq122,r_131_20_189,r_115_31_174,0.61,-118,56,174,50
26,r_119_93_59,r_118_35_166,r_97_98_55,r_119_93_59,0.99,1,60,59,50
8,r_134_6_38,r_7_63_177,seq5,r_7_63_177,0.99,-2,175,177,50
32,r_120_108_24,seq122,seq110,r_120_108_24,0.98,0,24,24,50
50,seq0,r_1_78_191,r_129_2_13,r_129_2_13,0.67,26,39,13,50
11,r_48_91_70,r_50_30_115,r_87_107_195,r_48_91_70,0.87,0,70,70,50
83,seq86,r_87_107_195,r_67_84_42,r_67_84_42,0.92,1,43,42,50
20,r_18_38_66,r_19_109_99,r_37_128_191,r_18_38_66,1,0,66,66,50
13,r_141_46_121,seq142,seq42,r_141_46_121,0.83,0,121,121,50
15,r_19_109_99,seq17,seq110,r_19_109_99,0.69,0,99,99,50
48,r_8_121_102,seq9,r_65_123_47,r_8_121_102,0.96,0,102,102,50
0,r_15_53_44,r_14_83_193,seq54,r_15_53_44,1,0,44,44,50
27,r_149_3_84,seq147,seq13,r_149_3_84,0.78,0,84,84,50
47,r_116_45_168,seq117,r_141_46_121,r_141_46_121,0.66,47,168,121,50
40,r_118_35_166,seq117,r_61_34_54,r_61_34_54,0.82,113,167,54,50
28,r_36_51_201,seq33,r_61_34_54,r_61_34_54,0.98,3,57,54,50
24,r_4_43_124,seq5,r_141_46_121,r_4_43_124,0.94,0,124,124,50
33,r_71_32_173,seq69,r_115_31_174,r_115_31_174,0.68,0,174,174,50
65,seq33,r_36_51_201,r_61_34_54,r_61_34_54,0.99,70,124,54,50
3,r_61_34_54,seq60,r_36_51_201,r_61_34_54,0.97,0,54,54,50
20,r_18_38_66,r_37_128_191,r_137_39_141,r_137_39_141,1,33,174,141,50
42,r_115_31_174,r_131_20_189,r_71_32_173,r_115_31_174,0.79,0,174,174,50
38,r_37_128_191,r_36_51_201,r_18_38_66,r_18_38_66,0.87,1,67,66,50
52,seq9,r_8_121_102,r_14_83_193,r_8_121_102,1,0,102,102,50
34,r_130_29_124,r_131_20_189,r_112_25_60,r_130_29_124,0.76,0,124,124,50
19,r_56_59_35,seq57,seq60,r_56_59_35,0.97,0,35,35,50
29,r_7_63_177,seq12,r_134_6_38,r_134_6_38,1,10,48,38,50
17,r_73_88_131,r_74_10_184,r_48_91_70,r_48_91_70,0.57,62,132,70,50
45,r_16_125_33,r_19_109_99,seq126,r_16_125_33,0.95,0,33,33,50
49,r_101_146_28,seq102,seq147,r_101_146_28,1,2,30,28,50
29,r_7_63_177,r_134_6_38,seq62,r_134_6_38,0.24,139,177,38,50
91,seq105,r_104_41_168,r_103_68_37,r_103_68_37,0.55,124,161,37,50
8,r_134_6_38,r_135_94_142,r_7_63_177,r_134_6_38,0.95,0,38,38,50
44,r_104_41_168,seq105,seq49,r_104_41_168,0.54,0,168,168,50
23,r_74_10_184,seq69,r_71_32_173,r_71_32_173,0.99,14,187,173,50
36,r_129_2_13,r_130_29_124,r_1_78_191,r_129_2_13,0.57,0,13,13,50
84,seq89,seq86,r_48_91_70,r_48_91_70,1,10,80,70,50
12,r_27_57_48,seq18,seq60,r_27_57_48,1,-1,47,48,51
36,r_130_29_69,seq129,seq30,r_130_29_69,1,1,70,69,51
26,r_53_55_94,r_54_25_132,r_139_56_122,r_54_25_132,0.66,0,132,132,51
43,r_89_114_14,seq90,r_113_82_159,r_89_114_14,0.91,0,14,14,51
10,r_140_100_35,seq141,seq99,r_140_100_35,0.9,-5,30,35,51
21,r_110_35_166,r_113_82_159,r_131_109_119,r_131_109_119,0.67,19,138,119,51
39,r_93_92_115,seq94,seq90,r_93_92_115,0.8,0,115,115,51
1,r_112_68_91,r_113_82_159,seq69,r_112_68_91,0.6,0,91,91,51
5,r_139_56_122,seq148,seq136,r_139_56_122,0.47,-49,73,122,51
46,r_121_20_83,r_119_97_146,seq18,r_121_20_83,1,1,84,83,51
42,r_19_144_113,seq21,seq147,r_19_144_113,0.95,0,113,113,51
45,r_119_97_146,seq117,r_140_100_35,r_140_100_35,0.73,111,146,35,51
19,r_107_13_86,seq117,r_84_14_17,r_107_13_86,0.9,0,86,86,51
21,r_110_35_166,r_131_109_119,r_54_25_132,r_110_35_166,0.67,0,166,166,51
20,r_2_116_21,r_1_43_28,r_96_118_15,r_96_118_15,0.97,6,21,15,51
2,r_24_7_1,seq5,r_36_8_33,r_36_8_33,1,-1,32,33,51
37,r_36_8_33,r_33_98_120,r_24_7_1,r_36_8_33,1,0,33,33,51
3,r_131_109_119,seq133,r_87_111_104,r_131_109_119,0.84,0,119,119,51
26,r_53_55_94,r_51_52_126,r_54_25_132,r_53_55_94,0.55,0,94,94,51
29,r_1_43_28,seq0,r_45_126_135,r_1_43_28,1,0,28,28,51
50,seq0,r_1_43_28,r_4_39_148,r_1_43_28,1,0,28,28,51
0,r_4_39_148,r_3_17_160,r_101_40_125,r_4_39_148,0.46,0,148,148,51
13,r_42_32_168,r_45_126_135,r_1_43_28,r_1_43_28,0.95,79,107,28,51
5,r_139_56_122,seq136,r_53_55_94,r_139_56_122,0.9,0,122,122,51
41,r_138_41_52,seq64,r_101_40_125,r_101_40_125,0.48,0,125,125,51
4,r_33_98_120,seq30,r_140_100_35,r_33_98_120,0.97,0,120,120,51
8,r_143_83_17,r_140_100_35,seq88,r_143_83_17,0.78,0,17,17,51
13,r_42_32_168,r_1_43_28,r_110_35_166,r_42_32_168,0.59,0,168,168,51
18,r_3_17_160,seq5,seq10,r_3_17_160,0.91,-1,159,160,51
25,r_45_126_135,r_42_32_168,r_1_43_28,r_1_43_28,1,1,29,28,51
24,r_146_26_38,seq147,seq23,r_146_26_38,1,0,38,38,51
87,seq88,r_86_76_119,r_93_92_115,r_93_92_115,0.88,11,126,115,51
50,seq0,seq5,r_24_7_1,r_24_7_1,0.29,192,193,1,51
41,r_138_41_52,r_38_120_115,seq64,r_138_41_52,0.52,63,115,52,51
47,r_34_50_62,r_33_98_120,r_51_52_126,r_34_50_62,0.96,0,62,62,51
35,r_78_124_35,r_67_132_158,r_9_59_109,r_9_59_109,0.99,8,117,109,51
43,r_89_114_14,r_113_82_159,r_131_109_119,r_131_109_119,0.95,40,159,119,51
14,r_84_14_17,r_85_80_45,seq12,r_84_14_17,1,0,17,17,51
28,r_38_120_115,r_44_95_7,r_138_41_52,r_138_41_52,0.54,-1,51,52,51
32,r_54_25_132,r_53_55_94,r_146_26_38,r_53_55_94,0.77,38,132,94,51
38,r_104_66_168,r_105_106_133,r_112_68_91,r_112_68_91,0.93,77,168,91,51
4,r_33_98_120,r_34_50_62,seq30,r_34_50_62,0.93,-8,54,62,51
34,r_31_49_67,seq30,r_51_52_126,r_31_49_67,1,0,67,67,51
40,r_16_47_14,seq10,seq46,r_16_47_14,0.95,0,14,14,51
35,r_78_124_35,r_9_59_109,r_112_68_91,r_9_59_109,0.4,42,151,109,51
17,r_77_123_124,seq79,seq122,r_77_123_124,0.68,0,124,124,51
25,r_45_126_135,r_1_43_28,seq128,r_45_126_135,0.84,0,135,135,51
35,r_78_124_35,r_77_123_124,r_67_132_158,r_78_124_35,0.98,0,35,35,51
50,seq0,r_4_39_148,seq5,r_4_39_148,0.99,-9,139,148,51
6,r_37_15_16,r_33_98_120,seq12,r_37_15_16,1,0,16,16,51
41,r_138_41_52,r_131_109_119,r_38_120_115,r_138_41_52,0.99,-1,51,52,51
28,r_38_120_115,r_138_41_52,r_2_116_21,r_38_120_115,0.97,0,115,115,51
29,r_1_43_28,r_45_126_135,r_16_47_14,r_1_43_28,0.53,107,135,28,51
49,r_87_111_104,seq88,r_89_114_14,r_87_111_104,0.86,0,104,104,51
7,r_113_82_159,seq117,r_112_68_91,r_112_68_91,0.99,70,161,91,51
44,r_67_132_158,r_51_52_126,r_45_126_135,r_51_52_126,0.42,32,158,126,51
23,r_9_59_109,seq12,seq60,r_9_59_109,0.88,0,109,109,51
93,seq109,seq106,r_63_108_48,r_63_108_48,1,12,60,48,52
36,r_131_49_90,r_130_124_170,seq53,r_131_49_90,0.91,0,90,90,52
9,r_21_99_150,r_10_22_19,r_15_101_1,r_21_99_150,0.94,0,150,150,52
14,r_136_9_135,r_138_11_172,seq8,r_136_9_135,0.95,0,135,135,52
43,r_134_123_60,seq135,seq122,r_134_123_60,0.99,0,60,60,52
16,r_19_119_43,r_21_99_150,seq122,r_19_119_43,1,0,43,43,52
37,r_16_69_115,r_21_99_150,r_104_17_67,r_104_17_67,1,7,74,67,52
28,r_28_140_24,seq27,r_139_94_166,r_28_140_24,1,0,24,24,52
1,r_115_7_161,seq117,r_20_5_125,r_115_7_161,0.93,0,161,161,52
37,r_16_69_115,r_104_17_67,r_79_72_15,r_16_69_115,0.99,0,115,115,52
7,r_130_124_170,seq133,r_12_121_86,r_130_124_170,0.61,0,170,170,52
8,r_148_149_87,r_139_94_166,seq147,r_148_149_87,0.41,-44,43,87,52
45,r_70_47_56,r_26_51_18,r_93_48_89,r_93_48_89,1,17,106,89,52
41,r_12_121_86,seq13,r_134_123_60,r_12_121_86,0.99,0,86,86,52
30,r_142_137_83,r_138_11_172,r_73_146_81,r_142_137_83,0.54,52,135,83,52
10,r_138_11_172,seq145,seq14,r_138_11_172,0.41,0,172,172,52
4,r_68_35_13,r_66_62_103,r_36_60_167,r_68_35_13,0.75,1,14,13,52
11,r_120_65_149,seq122,r_66_62_103,r_120_65_149,0.71,0,149,149,52
80,seq83,r_79_72_15,r_112_84_18,r_79_72_15,0.47,0,15,15,52
20,r_20_5_125,r_21_99_150,seq4,r_20_5_125,0.82,0,125,125,52
13,r_45_144_135,seq46,r_37_141_62,r_37_141_62,0.82,73,135,62,52
98,seq122,r_120_65_149,r_134_123_60,r_134_123_60,0.84,3,63,60,52
57,seq145,r_138_11_172,r_73_146_81,r_73_146_81,1,9,90,81,52
45,r_70_47_56,r_73_146_81,r_26_51_18,r_73_146_81,0.54,-25,56,81,52
6,r_43_89_141,seq38,r_107_90_89,r_43_89_141,0.82,0,141,141,52
5,r_139_94_166,r_28_140_24,r_43_89_141,r_43_89_141,0.62,25,166,141,52
27,r_93_48_89,seq91,r_70_47_56,r_93_48_89,1,0,89,89,52
5,r_139_94_166,r_138_11_172,r_28_140_24,r_28_140_24,0.95,29,53,24,52
2,r_113_41_66,r_115_7_161,seq38,r_113_41_66,1,0,66,66,52
47,r_95_67_75,seq109,r_66_62_103,r_95_67_75,0.99,0,75,75,52
18,r_33_81_147,r_36_60_167,r_25_80_38,r_25_80_38,0.85,109,147,38,52
29,r_114_0_63,r_115_7_161,r_74_1_37,r_114_0_63,1,0,63,63,52
46,r_6_125_29,r_3_127_116,seq122,r_6_125_29,0.99,1,30,29,52
44,r_104_17_67,r_16_69_115,r_128_18_100,r_104_17_67,0.83,48,115,67,52
25,r_107_90_89,seq109,seq91,r_107_90_89,0.49,0,89,89,52
48,r_10_22_19,r_21_99_150,r_128_18_100,r_128_18_100,0.9,47,147,100,52
42,r_118_77_47,r_115_7_161,seq78,r_118_77_47,1,0,47,47,52
64,seq32,r_36_60_167,seq46,r_36_60_167,0.4,0,167,167,52
15,r_25_80_38,seq23,r_112_84_18,r_25_80_38,1,0,38,38,52
50,seq4,r_3_127_116,seq8,r_3_127_116,0.85,0,116,116,52
21,r_74_1_37,r_66_62_103,r_3_127_116,r_74_1_37,0.86,0,37,37,52
32,r_128_18_100,r_130_124_170,r_10_22_19,r_128_18_100,1,0,100,100,52
48,r_10_22_19,seq8,r_21_99_150,r_10_22_19,0.81,0,19,19,52
38,r_102_61_19,r_104_17_67,r_66_62_103,r_102_61_19,0.98,2,21,19,52
52,seq135,r_134_123_60,seq133,r_134_123_60,1,0,60,60,52
34,r_73_146_81,seq78,seq145,r_73_146_81,1,0,81,81,52
22,r_26_51_18,r_25_80_38,seq52,r_25_80_38,0.51,-20,18,38,52
31,r_30_2_45,r_36_60_167,r_74_1_37,r_36_60_167,0.56,-122,45,167,52
0,r_112_84_18,r_113_41_66,seq83,r_112_84_18,0.48,3,21,18,52
9,r_21_99_150,r_20_5_125,r_10_22_19,r_20_5_125,0.6,-49,76,125,52
28,r_28_140_24,r_139_94_166,r_45_144_135,r_45_144_135,0.66,29,164,135,52
35,r_79_72_15,seq83,seq78,r_79_72_15,1,0,15,15,52
49,r_37_141_62,r_43_89_141,seq143,r_37_141_62,1,0,62,62,52
56,seq143,r_142_137_83,r_37_141_62,r_37_141_62,1,21,83,62,52
7,r_130_124_170,r_131_49_90,seq133,r_131_49_90,1,0,90,90,52
39,r_63_108_48,r_31_64_1,seq109,r_63_108_48,1,0,48,48,52
44,r_104_17_67,seq103,r_16_69_115,r_104_17_67,0.98,0,67,67,52
23,r_3_127_116,seq4,seq133,r_3_127_116,0.92,0,116,116,52
21,r_74_1_37,r_3_127_116,r_30_2_45,r_74_1_37,0.69,23,60,37,52
33,r_129_75_29,r_130_124_170,seq76,r_129_75_29,0.99,0,29,29,52
51,seq132,r_134_144_139,seq133,r_134_144_139,0.33,0,139,139,53
36,r_94_17_120,seq95,r_130_14_29,r_94_17_120,0.9,0,120,120,53
13,r_9_54_103,r_57_8_52,r_4_53_32,r_9_54_103,1,0,103,103,53
8,r_99_68_146,seq100,r_43_70_58,r_99_68_146,0.82,3,149,146,53
11,r_130_14_29,seq129,seq15,r_130_14_29,1,0,29,29,53
43,r_39_146_87,seq40,r_138_147_18,r_39_146_87,1,0,87,87,53
31,r_114_64_18,seq115,seq65,r_114_64_18,1,0,18,18,53
83,seq86,r_92_32_185,r_7_87_74,r_7_87_74,1,66,140,74,53
37,r_102_93_166,r_103_33_111,seq101,r_103_33_111,0.84,0,111,111,53
86,seq100,r_99_68_146,r_1_98_66,r_1_98_66,1,83,149,66,53
16,r_73_71_171,r_72_51_113,seq75,r_72_51_113,0.77,0,113,113,53
21,r_37_128_172,r_38_50_69,seq41,r_38_50_69,0.9,0,69,69,53
39,r_82_76_175,r_83_48_204,seq75,r_82_76_175,0.42,0,175,175,53
1,r_104_89_132,r_109_3_184,seq88,r_104_89_132,0.53,-1,131,132,53
23,r_136_2_26,r_135_97_19,r_143_5_31,r_135_97_19,1,0,19,19,53
5,r_96_127_85,r_94_17_120,seq126,r_96_127_85,0.99,0,85,85,53
42,r_72_51_113,r_73_71_171,seq52,r_72_51_113,0.7,0,113,113,53
80,seq75,r_73_71_171,r_103_33_111,r_103_33_111,1,52,163,111,53
45,r_42_139_149,seq41,seq132,r_42_139_149,0.74,1,150,149,53
85,seq95,seq100,r_102_93_166,r_102_93_166,0.38,5,171,166,53
24,r_61_30_101,seq22,seq29,r_61_30_101,0.43,60,161,101,53
19,r_143_5_31,r_145_125_76,r_7_87_74,r_143_5_31,1,0,31,31,53
19,r_143_5_31,r_136_2_26,r_31_6_111,r_31_6_111,1,39,150,111,53
30,r_43_70_58,seq44,seq69,r_43_70_58,0.92,1,59,58,53
95,seq118,r_119_21_143,seq117,r_119_21_143,1,0,143,143,53
38,r_138_147_18,r_149_16_192,r_39_146_87,r_39_146_87,1,67,154,87,53
3,r_103_33_111,r_102_93_166,seq34,r_103_33_111,0.96,0,111,111,53
10,r_149_16_192,r_145_125_76,r_138_147_18,r_145_125_76,0.95,-2,74,76,53
14,r_135_97_19,r_136_2_26,seq100,r_135_97_19,0.98,2,21,19,53
50,seq129,r_130_14_29,r_140_113_130,r_130_14_29,0.61,0,29,29,53
26,r_38_50_69,r_37_128_172,seq52,r_38_50_69,0.55,0,69,69,53
16,r_73_71_171,seq75,r_43_70_58,r_73_71_171,0.62,0,171,171,53
32,r_91_131_40,r_92_32_185,seq129,r_91_131_40,0.96,0,40,40,53
98,seq123,r_145_125_76,r_149_16_192,r_149_16_192,0.37,-138,54,192,53
4,r_140_113_130,r_145_125_76,r_91_131_40,r_91_131_40,0.93,40,80,40,53
63,seq29,r_31_6_111,r_61_30_101,r_31_6_111,0.98,0,111,111,53
73,seq52,seq49,r_72_51_113,r_72_51_113,0.93,17,130,113,53
80,seq75,r_103_33_111,r_82_76_175,r_103_33_111,0.7,65,176,111,53
49,r_7_87_74,r_143_5_31,seq86,r_7_87_74,1,0,74,74,53
33,r_77_62_14,r_74_13_126,r_114_64_18,r_77_62_14,0.77,27,41,14,53
15,r_92_32_185,seq88,seq35,r_92_32_185,0.48,0,185,185,53
48,r_78_63_60,r_83_48_204,r_114_64_18,r_78_63_60,0.73,4,64,60,53
12,r_4_53_32,seq49,r_9_54_103,r_9_54_103,1,39,142,103,53
4,r_140_113_130,r_91_131_40,seq141,r_91_131_40,0.79,72,112,40,53
6,r_122_137_161,seq121,seq133,r_122_137_161,0.9,0,161,161,53
21,r_37_128_172,seq41,r_91_131_40,r_37_128_172,0.94,0,172,172,53
49,r_7_87_74,r_4_53_32,r_143_5_31,r_7_87_74,0.99,-42,32,74,53
85,seq95,r_94_17_120,seq100,r_94_17_120,0.8,0,120,120,53
79,seq69,seq19,r_43_70_58,r_43_70_58,0.39,1,59,58,53
4,r_140_113_130,seq141,seq115,r_140_113_130,0.89,0,130,130,53
10,r_149_16_192,r_138_147_18,r_94_17_120,r_149_16_192,0.66,0,192,192,53
27,r_18_11_88,seq15,seq10,r_18_11_88,1,3,91,88,53
99,seq126,r_145_125_76,r_96_127_85,r_96_127_85,0.99,24,109,85,53
87,seq101,r_102_93_166,r_135_97_19,r_135_97_19,0.9,146,165,19,53
41,r_57_8_52,r_55_112_129,r_9_54_103,r_57_8_52,1,0,52,52,53
2,r_109_3_184,seq111,r_136_2_26,r_109_3_184,0.44,0,184,184,53
47,r_134_144_139,seq133,r_138_147_18,r_138_147_18,0.73,122,140,18,53
40,r_84_85_132,seq86,r_7_87_74,r_7_87_74,1,58,132,74,53
18,r_46_58_160,seq49,seq59,r_46_58_160,0.4,-18,142,160,53
29,r_145_125_76,r_149_16_192,seq126,r_145_125_76,0.63,-5,71,76,53
24,r_61_30_101,seq66,seq22,r_61_30_101,0.57,0,101,101,53
34,r_24_79_181,r_107_23_67,seq80,r_24_79_181,0.55,0,181,181,53
35,r_107_23_67,r_24_79_181,r_119_21_143,r_119_21_143,0.81,42,185,143,53
12,r_4_53_32,r_7_87_74,seq49,r_4_53_32,1,0,32,32,53
88,seq106,r_105_148_203,seq116,r_105_148_203,0.38,-13,190,203,53
58,seq22,r_20_90_153,r_119_21_143,r_20_90_153,0.77,-4,149,153,53
99,seq126,seq129,r_145_125_76,r_145_125_76,0.41,-24,52,76,53
19,r_143_5_31,r_7_87_74,r_136_2_26,r_7_87_74,0.81,-18,56,74,53
34,r_24_79_181,r_20_90_153,r_107_23_67,r_107_23_67,0.96,3,70,67,53
52,seq133,seq132,r_122_137_161,r_122_137_161,0.95,8,169,161,53
38,r_138_147_18,r_140_113_130,r_149_16_192,r_140_113_130,0.57,-107,23,130,53
17,r_31_6_111,seq29,r_143_5_31,r_31_6_111,0.98,0,111,111,53
9,r_74_13_126,r_73_71_171,r_124_12_7,r_73_71_171,0.6,-39,132,171,53
41,r_57_8_52,r_9_54_103,seq10,r_9_54_103,1,0,103,103,53
22,r_60_0_91,r_61_30_101,r_136_2_26,r_60_0_91,0.98,1,92,91,53
13,r_9_54_103,seq10,r_57_8_52,r_57_8_52,0.98,5,57,52,53
7,r_55_112_129,seq56,seq111,r_55_112_129,0.85,1,130,129,53
35,r_107_23_67,r_105_148_203,r_24_79_181,r_107_23_67,0.95,0,67,67,53
93,seq100,r_101_88_160,r_55_103_50,r_55_103_50,0.83,76,126,50,54
30,r_41_110_96,r_40_39_149,seq111,r_41_110_96,1,0,96,96,54
36,r_30_79_109,r_29_118_108,seq76,r_30_79_109,0.98,0,109,109,54
9,r_29_118_108,r_121_42_199,r_104_119_34,r_121_42_199,1,-11,188,199,54
19,r_65_13_126,r_78_123_59,r_141_64_25,r_65_13_126,0.96,-90,36,126,54
14,r_53_12_107,seq56,r_5_14_7,r_53_12_107,1,0,107,107,54
19,r_65_13_126,r_141_64_25,r_5_14_7,r_65_13_126,0.98,0,126,126,54
16,r_144_32_95,seq146,seq33,r_144_32_95,0.89,0,95,95,54
39,r_59_97_162,seq60,r_91_96_36,r_59_97_162,0.92,0,162,162,54
23,r_137_135_117,r_136_127_33,seq133,r_137_135_117,0.77,-98,19,117,54
28,r_55_103_50,r_54_148_102,seq100,r_55_103_50,0.81,1,51,50,54
46,r_1_17_111,r_4_113_211,seq23,r_1_17_111,0.65,0,111,111,54
42,r_40_39_149,seq43,r_18_36_123,r_18_36_123,0.54,64,187,123,54
97,seq120,r_121_42_199,r_104_119_34,r_104_119_34,1,-5,29,34,54
41,r_5_14_7,seq7,seq31,r_5_14_7,0.47,7,14,7,54
33,r_78_123_59,seq75,seq124,r_78_123_59,1,0,59,59,54
69,seq33,r_35_16_58,r_41_110_96,r_35_16_58,0.82,2,60,58,54
21,r_91_96_36,r_90_89_58,seq114,r_91_96_36,0.75,0,36,36,54
35,r_80_8_47,seq82,seq7,r_80_8_47,0.99,0,47,47,54
90,seq143,r_141_64_25,r_131_140_216,r_141_64_25,0.84,0,25,25,54
37,r_69_28_28,seq71,r_29_118_108,r_69_28_28,0.99,1,29,28,54
4,r_34_67_12,r_35_16_58,seq68,r_34_67_12,1,0,12,12,54
96,seq114,r_136_127_33,r_52_115_94,r_52_115_94,0.87,0,94,94,54
31,r_2_122_191,seq3,r_104_119_34,r_2_122_191,0.53,0,191,191,54
81,seq68,r_70_83_183,r_34_67_12,r_34_67_12,1,0,12,12,54
6,r_0_108_208,r_4_113_211,r_48_109_10,r_48_109_10,0.73,198,208,10,54
3,r_99_22_175,r_98_85_190,r_107_25_129,r_107_25_129,0.85,46,175,129,54
1,r_136_127_33,r_137_135_117,seq126,r_136_127_33,0.58,0,33,33,54
10,r_77_138_154,seq76,seq139,r_77_138_154,0.91,0,154,154,54
12,r_90_89_58,r_91_96_36,r_63_92_164,r_90_89_58,0.88,-22,36,58,54
11,r_35_16_58,seq33,seq15,r_35_16_58,0.47,2,60,58,54
5,r_116_72_10,r_117_142_111,seq71,r_116_72_10,0.98,1,11,10,54
20,r_20_86_155,r_18_36_123,r_1_17_111,r_1_17_111,1,14,125,111,54
13,r_18_36_123,r_20_86_155,r_40_39_149,r_20_86_155,0.95,-32,123,155,54
98,seq124,seq126,r_78_123_59,r_78_123_59,1,2,61,59,54
0,r_48_109_10,r_54_148_102,seq111,r_48_109_10,0.44,0,10,10,54
57,seq7,seq6,r_80_8_47,r_80_8_47,1,1,48,47,54
15,r_54_148_102,seq56,seq145,r_54_148_102,1,0,102,102,54
48,r_93_24_158,seq94,seq23,r_93_24_158,0.57,0,158,158,54
6,r_0_108_208,seq7,r_2_122_191,r_0_108_208,0.64,-131,77,208,54
41,r_5_14_7,seq31,r_65_13_126,r_65_13_126,0.99,3,129,126,54
47,r_37_45_184,r_40_39_149,seq44,r_37_45_184,0.31,0,184,184,54
45,r_104_119_34,r_107_25_129,seq120,r_104_119_34,0.94,2,36,34,54
29,r_149_106_139,seq146,r_48_109_10,r_149_106_139,0.53,2,141,139,54
24,r_58_105_191,seq56,r_149_106_139,r_58_105_191,0.65,0,191,191,54
20,r_20_86_155,r_1_17_111,r_70_83_183,r_20_86_155,0.93,0,155,155,54
32,r_125_66_13,seq124,r_34_67_12,r_125_66_13,1,0,13,13,54
43,r_141_64_25,r_65_13_126,r_70_83_183,r_65_13_126,1,0,126,126,54
6,r_0_108_208,r_2_122_191,r_80_8_47,r_2_122_191,0.5,-40,151,191,54
38,r_52_115_94,seq56,seq114,r_52_115_94,1,0,94,94,54
34,r_63_92_164,seq62,r_90_89_58,r_63_92_164,0.95,0,164,164,54
21,r_91_96_36,r_99_22_175,r_59_97_162,r_91_96_36,0.91,127,163,36,54
17,r_101_88_160,r_102_134_172,r_52_115_94,r_52_115_94,0.7,74,168,94,54
9,r_29_118_108,r_30_79_109,r_121_42_199,r_29_118_108,0.88,0,108,108,54
96,seq114,r_117_142_111,r_136_127_33,r_117_142_111,0.3,-34,77,111,54
43,r_141_64_25,seq143,r_65_13_126,r_141_64_25,0.99,0,25,25,54
90,seq143,r_131_140_216,r_117_142_111,r_131_140_216,0.59,-103,113,216,54
37,r_69_28_28,r_29_118_108,seq46,r_29_118_108,1,-17,91,108,54
22,r_19_38_92,r_18_36_123,r_40_39_149,r_19_38_92,0.53,0,92,92,54
89,seq87,r_80_8_47,r_70_83_183,r_80_8_47,1,-3,44,47,54
7,r_107_25_129,seq112,seq23,r_107_25_129,0.98,0,129,129,54
44,r_102_134_172,seq100,r_77_138_154,r_102_134_172,0.48,0,172,172,54
6,r_0_108_208,r_80_8_47,r_4_113_211,r_0_108_208,0.33,-20,188,208,54
79,seq62,r_63_92_164,seq61,r_63_92_164,0.87,-17,147,164,54
21,r_91_96_36,seq114,r_99_22_175,r_91_96_36,0.47,12,48,36,54
30,r_128_146_127,r_127_92_145,r_37_145_29,r_128_146_127,0.81,0,127,127,55
36,r_122_82_173,r_120_43_188,seq81,r_120_43_188,0.65,-15,173,188,55
13,r_8_61_146,r_17_78_93,seq28,r_17_78_93,0.88,-69,24,93,55
5,r_121_142_51,r_122_82_173,seq147,r_121_142_51,0.98,0,51,51,55
8,r_102_129_87,seq107,r_127_92_145,r_102_129_87,0.98,0,87,87,55
43,r_53_116_181,r_58_67_164,r_84_45_130,r_53_116_181,0.48,-17,164,181,55
16,r_74_109_178,seq75,r_105_101_185,r_74_109_178,0.34,3,181,178,55
46,r_60_88_105,r_62_136_165,seq89,r_60_88_105,0.94,0,105,105,55
31,r_48_26_56,r_46_51_99,seq25,r_48_26_56,1,0,56,56,55
56,seq135,r_138_93_177,r_134_56_136,r_138_93_177,0.77,-130,47,177,55
32,r_138_93_177,r_131_139_50,r_105_101_185,r_138_93_177,0.79,0,177,177,55
45,r_52_21_89,r_58_67_164,seq23,r_52_21_89,0.97,0,89,89,55
24,r_132_50_185,r_4_130_98,r_84_45_130,r_132_50_185,0.95,0,185,185,55
19,r_4_130_98,seq5,r_102_129_87,r_4_130_98,0.73,0,98,98,55
32,r_138_93_177,seq135,r_131_139_50,r_131_139_50,0.98,-3,47,50,55
33,r_44_68_58,r_13_69_40,seq59,r_13_69_40,0.44,102,142,40,55
5,r_121_142_51,seq147,r_123_143_93,r_123_143_93,1,1,94,93,55
67,seq29,r_64_39_72,r_46_51_99,r_64_39_72,0.68,-5,67,72,55
67,seq29,r_46_51_99,r_133_47_111,r_133_47_111,0.82,31,142,111,55
3,r_36_149_146,seq33,seq148,r_36_149_146,0.83,0,146,146,55
58,seq14,r_140_19_1,r_113_15_121,r_113_15_121,0.99,-1,120,121,55
10,r_87_137_78,seq89,r_131_139_50,r_87_137_78,0.95,0,78,78,55
26,r_46_51_99,r_58_67_164,r_77_49_99,r_77_49_99,0.55,54,153,99,55
48,r_55_118_63,r_125_97_117,r_4_130_98,r_55_118_63,0.97,48,111,63,55
4,r_62_136_165,seq63,seq135,r_62_136_165,0.62,0,165,165,55
63,seq23,seq25,r_65_22_95,r_65_22_95,1,34,129,95,55
57,seq12,r_13_69_40,r_140_19_1,r_13_69_40,1,2,42,40,55
15,r_84_45_130,seq85,r_133_47_111,r_84_45_130,0.9,0,130,130,55
48,r_55_118_63,r_58_67_164,r_125_97_117,r_55_118_63,1,0,63,63,55
0,r_10_144_45,seq12,r_37_145_29,r_10_144_45,1,0,45,45,55
35,r_72_96_39,seq70,seq95,r_72_96_39,0.97,0,39,39,55
6,r_90_115_153,seq98,r_76_106_125,r_76_106_125,0.56,17,142,125,55
85,seq85,r_84_45_130,seq81,r_84_45_130,1,0,130,130,55
99,seq124,r_120_43_188,r_38_126_151,r_38_126_151,0.8,40,191,151,55
87,seq89,r_87_137_78,r_9_91_13,r_87_137_78,0.97,-1,77,78,55
27,r_34_79_30,r_36_149_146,seq80,r_34_79_30,0.91,0,30,30,55
21,r_37_145_29,r_36_149_146,seq147,r_37_145_29,0.91,0,29,29,55
33,r_44_68_58,seq42,r_13_69_40,r_13_69_40,0.71,15,55,40,55
29,r_20_141_71,seq25,r_131_139_50,r_20_141_71,1,0,71,71,55
24,r_132_50_185,r_133_47_111,r_4_130_98,r_132_50_185,0.99,-74,111,185,55
25,r_127_92_145,r_102_129_87,r_9_91_13,r_127_92_145,0.98,0,145,145,55
25,r_127_92_145,r_128_146_127,r_102_129_87,r_102_129_87,1,44,131,87,55
20,r_131_139_50,r_132_50_185,r_138_93_177,r_131_139_50,0.98,0,50,50,55
18,r_9_91_13,r_10_144_45,seq98,r_9_91_13,0.91,1,14,13,55
88,seq95,seq98,r_54_94_44,r_54_94_44,1,82,126,44,55
58,seq14,r_27_11_119,r_140_19_1,r_140_19_1,0.49,72,73,1,55
42,r_103_57_15,r_105_101_185,r_58_67_164,r_103_57_15,0.66,1,16,15,55
20,r_131_139_50,r_138_93_177,r_87_137_78,r_131_139_50,0.47,127,177,50,55
42,r_103_57_15,r_58_67_164,r_84_45_130,r_103_57_15,0.67,149,164,15,55
74,seq42,r_44_68_58,seq33,r_44_68_58,0.93,-1,57,58,55
40,r_13_69_40,seq12,seq73,r_13_69_40,1,1,41,40,55
38,r_64_39_72,r_65_22_95,seq33,r_65_22_95,1,-22,73,95,55
77,seq66,r_65_22_95,r_58_67_164,r_65_22_95,1,0,95,95,55
57,seq12,r_140_19_1,r_27_11_119,r_27_11_119,0.51,3,122,119,55
34,r_134_56_136,seq135,r_103_57_15,r_134_56_136,0.94,0,136,136,55
21,r_37_145_29,r_10_144_45,r_128_146_127,r_128_146_127,1,20,147,127,55
81,seq75,r_76_106_125,seq85,r_76_106_125,0.98,2,127,125,55
9,r_119_30_174,seq124,seq31,r_119_30_174,0.53,0,174,174,55
22,r_58_67_164,r_53_116_181,seq66,r_53_116_181,0.65,-17,164,181,55
28,r_76_106_125,seq75,seq107,r_76_106_125,0.45,2,127,125,55
87,seq89,r_9_91_13,r_60_88_105,r_60_88_105,0.98,2,107,105,55
49,r_17_78_93,seq18,r_34_79_30,r_17_78_93,1,0,93,93,55
47,r_54_94_44,r_58_67_164,seq95,r_54_94_44,0.97,0,44,44,55
7,r_7_117_100,seq6,r_105_101_185,r_7_117_100,1,0,100,100,55
43,r_53_116_181,r_84_45_130,r_7_117_100,r_53_116_181,0.84,0,181,181,55
23,r_133_47_111,r_132_50_185,r_103_57_15,r_133_47_111,0.98,0,111,111,55
8,r_102_129_87,r_127_92_145,seq124,r_127_92_145,1,-6,139,145,55
21,r_37_145_29,seq147,r_10_144_45,r_10_144_45,0.77,29,74,45,55
13,r_8_61_146,seq12,seq59,r_8_61_146,0.97,0,146,146,55
93,seq110,r_111_59_180,r_19_114_123,r_19_114_123,1,57,180,123,56
90,seq103,seq105,r_1_102_129,r_1_102_129,0.92,13,142,129,56
30,r_19_114_123,seq29,seq115,r_19_114_123,0.98,0,123,123,56
46,r_2_57_18,r_1_102_129,seq58,r_2_57_18,1,0,18,18,56
58,seq15,r_13_119_50,r_26_24_49,r_13_119_50,0.86,1,51,50,56
8,r_124_14_191,r_125_130_118,seq127,r_125_130_118,0.99,0,118,118,56
53,seq132,seq131,r_122_133_152,r_122_133_152,0.81,23,175,152,56
43,r_125_130_118,r_124_14_191,seq131,r_125_130_118,0.9,0,118,118,56
36,r_75_63_39,r_76_25_128,seq64,r_75_63_39,0.91,0,39,39,56
37,r_100_70_179,seq99,r_33_69_127,r_33_69_127,0.99,53,180,127,56
16,r_122_133_152,seq117,r_19_114_123,r_19_114_123,1,-2,121,123,56
21,r_45_147_190,r_44_27_185,r_39_43_84,r_39_43_84,1,2,86,84,56
1,r_111_59_180,seq110,seq58,r_111_59_180,0.41,0,180,180,56
49,r_89_53_57,r_54_108_118,r_149_51_66,r_89_53_57,0.38,25,82,57,56
5,r_30_144_77,seq28,seq146,r_30_144_77,1,0,77,77,56
42,r_46_87_107,seq48,seq88,r_46_87_107,0.88,0,107,107,56
7,r_3_41_179,r_0_12_201,r_79_42_127,r_3_41_179,0.89,0,179,179,56
69,seq40,r_45_147_190,r_79_42_127,r_79_42_127,0.57,34,161,127,56
3,r_134_82_14,seq132,seq81,r_134_82_14,0.97,0,14,14,56
24,r_149_51_66,r_89_53_57,r_90_52_115,r_90_52_115,0.99,22,137,115,56
19,r_74_148_131,seq73,r_30_144_77,r_30_144_77,0.66,53,130,77,56
11,r_39_43_84,r_45_147_190,r_79_42_127,r_39_43_84,0.76,80,164,84,56
27,r_13_119_50,seq15,seq117,r_13_119_50,1,1,51,50,56
74,seq64,seq58,r_75_63_39,r_75_63_39,1,-1,38,39,56
39,r_62_126_160,r_75_63_39,seq127,r_62_126_160,0.86,0,160,160,56
31,r_91_6_149,seq95,r_0_12_201,r_91_6_149,0.84,-1,148,149,56
41,r_76_25_128,seq73,r_26_24_49,r_76_25_128,0.87,0,128,128,56
89,seq99,r_100_70_179,r_85_101_90,r_85_101_90,0.62,89,179,90,56
10,r_90_52_115,seq95,r_149_51_66,r_90_52_115,0.96,2,117,115,56
58,seq15,r_26_24_49,r_33_69_127,r_33_69_127,0.43,-56,71,127,56
26,r_121_21_90,r_112_139_173,seq22,r_121_21_90,1,0,90,90,56
72,seq50,r_47_118_78,seq49,r_47_118_78,0.98,-4,74,78,56
4,r_79_42_127,seq78,r_39_43_84,r_79_42_127,0.72,0,127,127,56
0,r_61_11_122,r_62_126_160,seq15,r_61_11_122,0.99,1,123,122,56
73,seq58,r_62_126_160,seq64,r_62_126_160,0.84,-37,123,160,56
11,r_39_43_84,seq37,r_45_147_190,r_39_43_84,0.98,0,84,84,56
20,r_44_27_185,r_45_147_190,r_121_21_90,r_121_21_90,0.84,95,185,90,56
13,r_33_69_127,seq32,r_107_71_110,r_33_69_127,0.9,0,127,127,56
98,seq136,r_137_31_147,seq146,r_137_31_147,0.76,-1,146,147,56
46,r_2_57_18,seq58,r_7_56_111,r_7_56_111,1,4,115,111,56
15,r_55_94_153,r_54_108_118,r_149_51_66,r_149_51_66,0.74,37,103,66,56
48,r_7_56_111,r_3_41_179,r_2_57_18,r_7_56_111,0.85,0,111,111,56
32,r_0_12_201,r_3_41_179,r_91_6_149,r_3_41_179,0.58,0,179,179,56
6,r_85_101_90,seq83,seq99,r_85_101_90,0.6,0,90,90,56
21,r_45_147_190,r_39_43_84,r_74_148_131,r_45_147_190,0.74,0,190,190,56
49,r_89_53_57,r_90_52_115,r_54_108_118,r_89_53_57,0.59,0,57,57,56
16,r_122_133_152,r_19_114_123,seq132,r_122_133_152,0.85,0,152,152,56
87,seq95,r_91_6_149,r_55_94_153,r_91_6_149,0.89,0,149,149,56
18,r_120_109_103,r_122_133_152,seq105,r_120_109_103,0.59,0,103,103,56
29,r_5_60_101,r_3_41_179,seq64,r_5_60_101,1,0,101,101,56
24,r_149_51_66,seq141,r_89_53_57,r_149_51_66,0.95,2,68,66,56
25,r_4_97_64,r_3_41_179,r_104_98_16,r_4_97_64,1,0,64,64,56
58,seq15,r_61_11_122,r_142_16_158,r_142_16_158,0.98,3,161,158,56
70,seq48,r_47_118_78,seq49,r_47_118_78,1,-1,77,78,56
32,r_0_12_201,r_1_102_129,r_3_41_179,r_1_102_129,1,0,129,129,56
52,seq131,seq132,r_125_130_118,r_125_130_118,0.8,29,147,118,56
34,r_142_16_158,seq143,seq15,r_142_16_158,0.88,0,158,158,56
39,r_62_126_160,seq58,r_75_63_39,r_75_63_39,0.96,16,55,39,56
60,seq18,r_17_92_168,r_121_21_90,r_121_21_90,0.98,53,143,90,56
17,r_26_24_49,seq29,r_76_25_128,r_76_25_128,1,5,133,128,56
9,r_54_108_118,r_55_94_153,r_120_109_103,r_54_108_118,0.79,1,119,118,56
18,r_120_109_103,seq105,r_54_108_118,r_54_108_118,0.67,9,127,118,56
22,r_107_71_110,seq105,seq68,r_107_71_110,0.56,0,110,110,56
28,r_47_118_78,seq48,r_13_119_50,r_47_118_78,0.63,-1,77,78,56
40,r_123_10_21,r_124_14_191,seq9,r_123_10_21,0.94,0,21,21,56
82,seq81,r_79_42_127,r_134_82_14,r_134_82_14,0.73,0,14,14,56
7,r_3_41_179,r_5_60_101,r_0_12_201,r_5_60_101,1,1,102,101,56
23,r_137_31_147,seq136,seq34,r_137_31_147,0.94,0,147,147,56
35,r_17_92_168,seq18,r_55_94_153,r_17_92_168,0.74,0,168,168,56
12,r_1_102_129,r_0_12_201,seq103,r_1_102_129,1,0,129,129,56
15,r_55_94_153,r_149_51_66,seq95,r_55_94_153,0.96,0,153,153,56
93,seq106,seq118,r_86_107_34,r_86_107_34,1,27,61,34,57
30,r_144_30_157,seq142,r_42_29_155,r_144_30_157,0.7,0,157,157,57
40,r_102_109_38,seq138,r_80_110_16,r_102_109_38,0.56,-18,20,38,57
36,r_39_125_76,seq38,seq129,r_39_125_76,0.97,0,76,76,57
22,r_0_141_169,seq7,r_103_5_21,r_103_5_21,0.84,11,32,21,57
14,r_60_24_96,r_59_134_102,seq23,r_60_24_96,1,0,96,96,57
53,seq132,r_131_85_170,r_59_134_102,r_59_134_102,0.83,69,171,102,57
59,seq142,r_146_112_116,r_128_143_56,r_128_143_56,0.56,42,98,56,57
45,r_18_122_20,r_17_21_186,seq123,r_18_122_20,1,-1,19,20,57
71,seq40,r_41_147_126,seq44,r_41_147_126,0.98,-28,98,126,57
39,r_8_136_70,r_11_36_160,seq137,r_8_136_70,0.99,0,70,70,57
1,r_59_134_102,seq61,r_81_133_26,r_59_134_102,0.79,0,102,102,57
46,r_58_91_85,r_59_134_102,r_90_33_198,r_58_91_85,0.94,0,85,85,57
80,seq66,r_59_134_102,seq62,r_59_134_102,1,-2,100,102,57
68,seq35,r_32_121_191,r_11_36_160,r_11_36_160,0.92,2,162,160,57
19,r_11_36_160,seq9,seq35,r_11_36_160,0.63,0,160,160,57
78,seq61,r_113_63_68,seq54,r_113_63_68,0.78,110,178,68,57
0,r_117_52_62,seq118,r_53_72_195,r_117_52_62,1,0,62,62,57
38,r_94_96_55,r_93_111_65,seq99,r_93_111_65,1,-10,55,65,57
99,seq123,seq138,r_18_122_20,r_18_122_20,0.94,30,50,20,57
63,seq137,seq138,r_8_136_70,r_8_136_70,1,2,72,70,57
11,r_70_124_116,seq73,seq123,r_70_124_116,0.88,0,116,116,57
20,r_98_78_92,seq99,seq82,r_98_78_92,0.94,0,92,92,57
8,r_45_101_52,r_46_47_56,r_102_109_38,r_45_101_52,0.94,0,52,52,57
44,r_89_104_53,r_90_33_198,r_102_109_38,r_89_104_53,0.83,5,58,53,57
15,r_32_121_191,seq35,r_86_107_34,r_32_121_191,0.42,0,191,191,57
48,r_19_79_182,seq23,r_98_78_92,r_19_79_182,0.43,0,182,182,57
21,r_88_6_53,seq77,seq7,r_88_6_53,1,0,53,53,57
34,r_128_143_56,seq129,r_115_145_12,r_128_143_56,0.68,0,56,56,57
6,r_41_147_126,seq40,r_115_145_12,r_41_147_126,0.91,0,126,126,57
62,seq23,r_26_69_164,r_60_24_96,r_60_24_96,0.95,41,137,96,57
22,r_0_141_169,r_57_14_59,r_115_145_12,r_115_145_12,0.74,157,169,12,57
31,r_17_21_186,r_18_122_20,seq16,r_18_122_20,0.99,0,20,20,57
27,r_146_112_116,seq142,seq108,r_146_112_116,0.48,0,116,116,57
18,r_50_135_119,r_53_72_195,r_59_134_102,r_50_135_119,0.96,1,120,119,57
22,r_0_141_169,r_103_5_21,r_57_14_59,r_57_14_59,0.58,63,122,59,57
32,r_81_133_26,seq82,seq132,r_81_133_26,0.9,1,27,26,57
18,r_50_135_119,r_51_84_87,r_53_72_195,r_51_84_87,1,0,87,87,57
29,r_76_22_114,seq82,seq27,r_76_22_114,0.9,0,114,114,57
24,r_113_63_68,seq118,seq62,r_113_63_68,1,0,68,68,57
25,r_13_2_102,r_11_36_160,r_1_92_164,r_13_2_102,0.75,0,102,102,57
33,r_42_29_155,seq44,seq27,r_42_29_155,0.68,0,155,155,57
3,r_57_14_59,r_59_134_102,seq9,r_57_14_59,1,0,59,59,57
68,seq35,r_34_10_123,r_32_121_191,r_34_10_123,1,0,123,123,57
52,seq3,r_4_126_185,r_57_14_59,r_57_14_59,1,125,184,59,57
4,r_86_107_34,seq77,seq106,r_86_107_34,0.99,2,36,34,57
43,r_103_5_21,r_113_63_68,seq7,r_103_5_21,0.95,0,21,21,57
47,r_56_114_39,seq54,r_102_109_38,r_56_114_39,0.95,0,39,39,57
10,r_115_145_12,r_117_52_62,seq142,r_115_145_12,0.76,0,12,12,57
17,r_53_72_195,r_51_84_87,r_117_52_62,r_53_72_195,0.95,-108,87,195,57
25,r_13_2_102,r_1_92_164,r_103_5_21,r_1_92_164,0.81,1,165,164,57
31,r_17_21_186,seq16,r_15_20_25,r_15_20_25,0.62,159,184,25,57
28,r_149_97_116,seq142,seq95,r_149_97_116,0.7,0,116,116,57
13,r_80_110_16,r_81_133_26,r_102_109_38,r_80_110_16,0.72,1,17,16,57
12,r_90_33_198,r_89_104_53,r_94_96_55,r_89_104_53,0.59,5,58,53,57
7,r_1_92_164,r_13_2_102,r_58_91_85,r_58_91_85,0.63,80,165,85,57
23,r_51_84_87,r_50_135_119,seq77,r_51_84_87,0.95,0,87,87,57
42,r_65_87_29,r_59_134_102,seq77,r_65_87_29,0.97,0,29,29,57
79,seq62,r_64_140_151,r_113_63_68,r_113_63_68,0.65,83,151,68,57
35,r_93_111_65,r_94_96_55,r_80_110_16,r_93_111_65,0.98,0,65,65,57
12,r_90_33_198,r_94_96_55,r_58_91_85,r_90_33_198,0.79,-92,106,198,57
30,r_138_106_170,seq139,r_40_101_17,r_138_106_170,0.55,0,170,170,58
36,r_146_121_131,r_145_63_135,seq139,r_145_63_135,0.85,-4,131,135,58
9,r_122_98_146,r_53_124_8,seq92,r_122_98_146,0.97,0,146,146,58
43,r_89_141_97,r_79_22_149,seq92,r_89_141_97,0.37,-42,55,97,58
43,r_89_141_97,r_105_143_59,r_75_140_126,r_75_140_126,0.98,5,131,126,58
15,r_29_60_32,r_28_67_148,r_45_59_3,r_29_60_32,0.98,2,34,32,58
71,seq43,seq41,r_120_44_48,r_120_44_48,1,41,89,48,58
16,r_133_85_67,r_135_15_180,seq86,r_133_85_67,1,0,67,67,58
21,r_55_147_127,seq56,r_114_149_61,r_55_147_127,0.78,0,127,127,58
39,r_142_148_146,seq144,r_114_149_61,r_114_149_61,1,92,153,61,58
29,r_80_125_13,seq81,r_53_124_8,r_80_125_13,0.91,0,13,13,58
1,r_117_134_62,r_135_15_180,r_13_127_154,r_117_134_62,0.87,118,180,62,58
69,seq35,r_34_69_85,r_7_36_34,r_34_69_85,0.93,0,85,85,58
45,r_32_30_173,r_28_67_148,r_27_31_65,r_28_67_148,0.52,-54,94,148,58
19,r_77_12_156,seq76,r_39_14_83,r_77_12_156,0.9,0,156,156,58
43,r_89_141_97,seq92,r_105_143_59,r_89_141_97,0.86,0,97,97,58
38,r_136_57_17,r_138_106_170,seq56,r_136_57_17,0.99,0,17,17,58
20,r_107_94_43,seq108,seq97,r_107_94_43,0.89,0,43,43,58
41,r_25_137_42,r_27_31_65,seq139,r_25_137_42,1,0,42,42,58
10,r_34_69_85,seq35,seq66,r_34_69_85,1,0,85,85,58
26,r_13_127_154,seq10,seq128,r_13_127_154,0.88,0,154,154,58
0,r_132_2_150,seq128,r_87_1_54,r_132_2_150,0.52,0,150,150,58
98,seq118,r_123_4_83,seq119,r_123_4_83,1,-7,76,83,58
48,r_99_96_172,r_116_113_35,seq109,r_99_96_172,0.9,-109,63,172,58
85,seq78,r_79_22_149,seq81,r_79_22_149,0.98,0,149,149,58
68,seq33,r_120_44_48,r_111_16_30,r_120_44_48,0.46,72,120,48,58
27,r_114_149_61,r_116_113_35,r_142_148_146,r_114_149_61,0.99,0,61,61,58
49,r_61_72_25,seq66,seq71,r_61_72_25,1,0,25,25,58
22,r_54_3_21,seq0,r_87_1_54,r_87_1_54,1,49,103,54,58
2,r_39_14_83,seq41,seq11,r_39_14_83,1,0,83,83,58
40,r_52_73_165,seq51,r_61_72_25,r_52_73_165,0.65,0,165,165,58
33,r_37_47_136,seq35,seq46,r_37_47_136,0.42,0,136,136,58
48,r_99_96_172,seq109,r_122_98_146,r_122_98_146,0.5,26,172,146,58
47,r_62_42_104,r_90_65_9,r_120_44_48,r_62_42_104,1,0,104,104,58
88,seq86,seq88,r_133_85_67,r_133_85_67,1,26,93,67,58
58,seq11,r_13_127_154,r_39_14_83,r_39_14_83,0.55,71,154,83,58
22,r_54_3_21,r_55_147_127,seq0,r_54_3_21,0.57,0,21,21,58
7,r_40_101_17,r_39_14_83,seq100,r_40_101_17,0.97,0,17,17,58
31,r_111_16_30,r_116_113_35,seq23,r_111_16_30,1,0,30,30,58
32,r_50_83_170,seq51,r_103_84_164,r_50_83_170,0.54,0,170,170,58
34,r_28_67_148,r_32_30_173,r_90_65_9,r_28_67_148,0.75,0,148,148,58
45,r_32_30_173,r_27_31_65,seq0,r_27_31_65,0.78,101,166,65,58
18,r_120_44_48,seq119,seq43,r_120_44_48,1,0,48,48,58
50,seq0,r_32_30_173,r_54_3_21,r_54_3_21,0.98,-3,18,21,58
99,seq119,r_120_44_48,r_135_15_180,r_120_44_48,1,0,48,48,58
9,r_122_98_146,r_123_4_83,r_53_124_8,r_123_4_83,0.89,-6,77,83,58
47,r_62_42_104,seq66,r_90_65_9,r_62_42_104,0.53,-83,21,104,58
43,r_89_141_97,r_91_58_25,r_79_22_149,r_91_58_25,0.94,0,25,25,58
37,r_38_112_31,r_37_47_136,seq109,r_38_112_31,1,0,31,31,58
46,r_87_1_54,seq88,r_54_3_21,r_87_1_54,1,0,54,54,58
23,r_135_15_180,r_133_85_67,r_117_134_62,r_135_15_180,1,-113,67,180,58
3,r_91_58_25,r_89_141_97,r_136_57_17,r_91_58_25,0.77,0,25,25,58
8,r_7_36_34,seq8,seq35,r_7_36_34,0.94,-1,33,34,58
5,r_126_9_24,r_132_2_150,seq10,r_126_9_24,0.98,0,24,24,58
79,seq139,r_138_106_170,r_25_137_42,r_25_137_42,1,128,170,42,58
12,r_75_140_126,r_79_22_149,r_89_141_97,r_75_140_126,0.98,0,126,126,58
12,r_75_140_126,r_77_12_156,r_79_22_149,r_77_12_156,0.19,-54,102,156,58
23,r_135_15_180,r_117_134_62,r_39_14_83,r_135_15_180,0.73,0,180,180,58
84,seq76,r_77_12_156,seq81,r_77_12_156,0.86,2,158,156,58
20,r_0_74_209,r_1_65_35,seq7,r_1_65_35,0.74,0,35,35,59
36,r_51_127_171,seq50,r_139_129_112,r_51_127_171,0.65,0,171,171,59
48,r_77_3_128,r_15_64_154,r_17_2_140,r_17_2_140,0.51,2,142,140,59
29,r_123_24_45,r_125_100_111,seq21,r_123_24_45,1,0,45,45,59
8,r_145_132_147,seq146,r_68_133_71,r_68_133_71,0.94,76,147,71,59
37,r_46_83_75,r_47_39_100,seq82,r_46_83_75,1,1,76,75,59
30,r_52_62_12,seq54,seq66,r_52_62_12,0.42,0,12,12,59
71,seq44,r_47_39_100,r_91_45_61,r_91_45_61,1,11,72,61,59
16,r_135_31_138,seq134,seq30,r_135_31_138,0.99,0,138,138,59
1,r_131_113_106,r_135_31_138,r_27_95_31,r_131_113_106,1,0,106,106,59
46,r_38_87_91,seq40,r_103_86_77,r_38_87_91,1,0,91,91,59
42,r_90_105_124,r_91_45_61,r_111_114_18,r_91_45_61,1,1,62,61,59
45,r_69_10_107,seq70,seq8,r_69_10_107,0.95,0,107,107,59
39,r_111_114_18,r_112_98_44,seq115,r_111_114_18,0.75,6,24,18,59
24,r_148_72_54,r_73_56_156,seq78,r_73_56_156,1,1,157,156,59
11,r_1_65_35,r_0_74_209,seq67,r_1_65_35,0.97,0,35,35,59
20,r_0_74_209,r_47_39_100,r_77_3_128,r_0_74_209,0.51,-79,130,209,59
43,r_25_94_43,r_23_57_120,r_27_95_31,r_23_57_120,0.75,-77,43,120,59
41,r_29_88_94,seq30,r_89_97_191,r_29_88_94,1,0,94,94,59
67,seq146,r_145_132_147,r_118_149_152,r_118_149_152,0.59,0,152,152,59
90,seq99,seq106,r_125_100_111,r_125_100_111,1,2,113,111,59
26,r_22_53_83,seq21,seq54,r_22_53_83,0.92,0,83,83,59
18,r_13_37_48,r_20_61_58,seq40,r_13_37_48,0.86,1,49,48,59
4,r_15_64_154,seq16,seq66,r_15_64_154,0.56,0,154,154,59
0,r_85_4_2,seq7,r_122_5_116,r_122_5_116,1,1,117,116,59
13,r_136_93_80,r_135_31_138,r_25_94_43,r_136_93_80,1,2,82,80,59
10,r_41_141_28,r_38_87_91,seq134,r_41_141_28,1,0,28,28,59
48,r_77_3_128,seq78,r_15_64_154,r_77_3_128,0.43,1,129,128,59
6,r_73_56_156,r_77_3_128,r_148_72_54,r_148_72_54,1,67,121,54,59
6,r_73_56_156,r_148_72_54,r_23_57_120,r_73_56_156,1,1,157,156,59
85,seq84,r_89_97_191,r_38_87_91,r_38_87_91,1,92,183,91,59
64,seq33,r_34_126_33,seq36,r_34_126_33,1,0,33,33,59
27,r_11_32_189,seq12,r_135_31_138,r_135_31_138,1,54,192,138,59
1,r_131_113_106,r_27_95_31,seq115,r_27_95_31,0.7,119,150,31,59
2,r_68_133_71,seq66,r_41_141_28,r_68_133_71,1,0,71,71,59
41,r_29_88_94,r_89_97_191,r_38_87_91,r_38_87_91,1,100,191,91,59
47,r_89_97_191,seq84,r_29_88_94,r_29_88_94,1,18,112,94,59
15,r_34_126_33,seq33,seq121,r_34_126_33,1,0,33,33,59
40,r_107_26_180,seq108,r_123_24_45,r_123_24_45,0.72,135,180,45,59
34,r_20_61_58,seq19,seq60,r_20_61_58,0.99,0,58,58,59
33,r_118_149_152,r_119_147_180,seq146,r_118_149_152,0.66,-3,149,152,59
5,r_112_98_44,seq109,r_27_95_31,r_27_95_31,0.95,13,44,31,59
20,r_0_74_209,seq7,r_47_39_100,r_0_74_209,0.34,-106,103,209,59
61,seq21,r_23_57_120,r_123_24_45,r_123_24_45,1,75,120,45,59
32,r_9_48_138,seq7,seq44,r_9_48_138,0.55,0,138,138,59
38,r_17_2_140,seq18,r_77_3_128,r_77_3_128,0.78,12,140,128,59
17,r_103_86_77,seq106,seq84,r_103_86_77,1,1,78,77,59
9,r_125_100_111,seq121,seq99,r_125_100_111,1,1,112,111,59
24,r_148_72_54,seq146,r_73_56_156,r_148_72_54,1,0,54,54,59
22,r_47_39_100,r_49_104_183,seq40,r_47_39_100,0.61,0,100,100,59
28,r_117_76_134,r_118_149_152,r_59_75_135,r_117_76_134,0.91,0,134,134,59
44,r_63_130_44,r_68_133_71,r_34_126_33,r_63_130_44,0.55,0,44,44,59
49,r_122_5_116,seq121,r_85_4_2,r_122_5_116,0.88,0,116,116,59
7,r_23_57_120,seq21,r_20_61_58,r_23_57_120,0.68,0,120,120,59
23,r_49_104_183,seq50,r_90_105_124,r_90_105_124,0.62,59,183,124,59
35,r_59_75_135,seq60,r_117_76_134,r_59_75_135,0.61,1,136,135,59
12,r_91_45_61,r_90_105_124,seq50,r_91_45_61,1,0,61,61,59
84,seq82,r_89_97_191,r_46_83_75,r_46_83_75,1,5,80,75,59
30,r_1_34_125,seq0,seq46,r_1_34_125,0.54,0,125,125,60
18,r_65_135_59,seq66,seq133,r_65_135_59,1,0,59,59,60
36,r_138_75_79,r_142_73_107,r_40_74_48,r_40_74_48,1,31,79,48,60
14,r_26_131_127,r_25_28_59,seq128,r_26_131_127,0.93,1,128,127,60
8,r_127_8_97,seq128,r_88_9_24,r_127_8_97,1,0,97,97,60
53,seq4,r_3_85_66,seq2,r_3_85_66,1,0,66,66,60
37,r_47_78_83,seq46,r_17_76_12,r_47_78_83,1,0,83,83,60
23,r_40_74_48,r_17_76_12,r_138_75_79,r_138_75_79,0.98,8,87,79,60
86,seq144,r_148_140_175,seq149,r_148_140_175,0.46,-70,105,175,60
16,r_141_113_78,r_142_73_107,r_114_79_173,r_141_113_78,0.93,0,78,78,60
21,r_51_89_169,r_50_125_184,r_95_87_44,r_95_87_44,0.6,125,169,44,60
32,r_114_79_173,r_141_113_78,r_119_80_99,r_141_113_78,0.45,95,173,78,60
23,r_40_74_48,r_45_70_82,r_17_76_12,r_40_74_48,1,1,49,48,60
73,seq59,seq57,r_126_58_52,r_126_58_52,1,3,55,52,60
46,r_23_52_190,r_11_29_73,r_25_28_59,r_25_28_59,0.74,-29,30,59,60
19,r_126_58_52,seq128,seq59,r_126_58_52,0.98,0,52,52,60
31,r_100_81_161,seq111,r_119_80_99,r_119_80_99,0.59,62,161,99,60
67,seq41,r_45_70_82,r_32_43_75,r_45_70_82,0.65,0,82,82,60
27,r_27_14_17,r_26_131_127,seq15,r_27_14_17,0.65,0,17,17,60
79,seq71,r_88_9_24,r_10_72_8,r_88_9_24,0.8,-4,20,24,60
46,r_23_52_190,r_116_19_147,r_54_53_52,r_23_52_190,0.48,0,190,190,60
80,seq83,seq60,r_39_82_35,r_39_82_35,1,11,46,35,60
26,r_99_77_102,seq98,r_17_76_12,r_99_77_102,0.9,0,102,102,60
16,r_141_113_78,r_114_79_173,r_124_115_165,r_124_115_165,0.73,8,173,165,60
0,r_50_125_184,r_54_53_52,r_26_131_127,r_50_125_184,0.54,0,184,184,60
0,r_50_125_184,r_51_89_169,r_54_53_52,r_51_89_169,0.99,0,169,169,60
30,r_1_34_125,seq46,r_103_31_131,r_1_34_125,0.59,12,137,125,60
20,r_11_29_73,r_7_30_93,r_25_28_59,r_25_28_59,0.63,14,73,59,60
47,r_32_43_75,r_47_78_83,seq41,r_47_78_83,0.6,-12,71,83,60
46,r_23_52_190,r_25_28_59,r_116_19_147,r_116_19_147,0.76,15,162,147,60
15,r_116_19_147,r_114_79_173,seq20,r_116_19_147,0.77,0,147,147,60
48,r_45_70_82,seq44,r_10_72_8,r_45_70_82,1,0,82,82,60
6,r_13_145_185,seq15,r_94_146_185,r_94_146_185,0.93,0,185,185,60
5,r_49_5_39,r_7_30_93,r_27_14_17,r_7_30_93,0.69,39,132,93,60
42,r_88_9_24,seq90,seq16,r_88_9_24,1,0,24,24,60
47,r_32_43_75,r_40_74_48,r_47_78_83,r_40_74_48,0.61,-14,34,48,60
87,seq98,r_99_77_102,r_42_97_3,r_99_77_102,0.85,-15,87,102,60
29,r_94_146_185,seq93,r_13_145_185,r_13_145_185,0.71,0,185,185,60
24,r_119_80_99,seq118,r_39_82_35,r_119_80_99,0.87,3,102,99,60
43,r_95_87_44,seq96,seq90,r_95_87_44,0.76,0,44,44,60
81,seq90,r_88_9_24,r_95_87_44,r_88_9_24,0.68,0,24,24,60
11,r_6_37_59,r_7_30_93,r_143_35_26,r_6_37_59,1,0,59,59,60
30,r_1_34_125,r_103_31_131,r_32_43_75,r_1_34_125,0.54,63,188,125,60
50,seq0,r_1_34_125,seq2,r_1_34_125,1,0,125,125,60
58,seq139,r_142_73_107,seq136,r_142_73_107,1,0,107,107,60
32,r_114_79_173,r_116_19_147,r_141_113_78,r_114_79_173,0.52,-74,99,173,60
38,r_25_28_59,r_24_137_160,r_11_29_73,r_25_28_59,0.79,62,121,59,60
3,r_12_67_31,seq16,seq68,r_12_67_31,1,0,31,31,60
78,seq68,seq71,r_12_67_31,r_12_67_31,0.85,23,54,31,60
34,r_38_112_41,seq36,seq111,r_38_112_41,1,0,41,41,60
17,r_106_132_74,r_105_107_84,r_65_135_59,r_105_107_84,0.72,-10,74,84,60
28,r_17_76_12,r_12_67_31,seq83,r_17_76_12,0.42,0,12,12,60
28,r_17_76_12,seq83,r_138_75_79,r_138_75_79,1,44,123,79,60
22,r_3_85_66,seq4,r_39_82_35,r_3_85_66,1,0,66,66,60
35,r_103_31_131,r_32_43_75,r_63_33_171,r_63_33_171,0.85,0,171,171,60
49,r_24_137_160,r_25_28_59,seq139,r_24_137_160,0.92,0,160,160,60
9,r_143_35_26,r_148_140_175,seq36,r_143_35_26,0.98,0,26,26,60
35,r_103_31_131,seq104,r_32_43_75,r_103_31_131,0.57,0,131,131,60
12,r_55_84_111,r_50_125_184,r_39_82_35,r_50_125_184,0.88,-73,111,184,60
5,r_49_5_39,r_50_125_184,r_7_30_93,r_49_5_39,1,0,39,39,60
40,r_76_29_49,r_41_7_19,r_70_6_74,r_70_6_74,0.69,70,144,74,61
30,r_51_123_106,r_53_110_171,r_28_125_40,r_51_123_106,0.73,0,106,106,61
36,r_112_1_80,seq111,seq3,r_112_1_80,0.95,0,80,80,61
8,r_106_114_167,seq107,r_26_119_20,r_26_119_20,0.8,148,168,20,61
10,r_98_146_39,r_97_72_120,r_144_84_163,r_98_146_39,0.93,1,40,39,61
29,r_9_91_179,r_143_16_89,seq27,r_9_91_179,0.6,-29,150,179,61
54,seq4,r_41_7_19,r_70_6_74,r_70_6_74,1,63,137,74,61
37,r_55_105_68,r_43_96_118,seq107,r_55_105_68,1,0,68,68,61
71,seq52,r_53_110_171,r_115_54_82,r_115_54_82,0.99,1,83,82,61
16,r_36_99_96,r_50_64_60,r_32_82_176,r_32_82_176,0.59,-116,60,176,61
1,r_145_81_74,r_144_84_163,seq85,r_145_81_74,1,0,74,74,61
97,seq116,r_115_54_82,seq117,r_115_54_82,1,-10,72,82,61
46,r_143_16_89,r_144_84_163,seq13,r_143_16_89,1,0,89,89,61
7,r_70_6_74,r_41_7_19,r_149_5_133,r_149_5_133,1,8,141,133,61
65,seq27,r_9_91_179,r_132_22_128,r_132_22_128,0.9,1,129,128,61
43,r_28_125_40,seq27,r_127_124_50,r_28_125_40,1,1,41,40,61
66,seq31,r_30_122_130,r_50_64_60,r_30_122_130,1,-16,114,130,61
31,r_48_18_181,seq47,r_95_19_144,r_95_19_144,0.88,40,184,144,61
41,r_95_19_144,seq94,seq17,r_95_19_144,0.92,0,144,144,61
29,r_9_91_179,seq27,seq86,r_9_91_179,0.92,0,179,179,61
5,r_41_7_19,seq4,r_70_6_74,r_70_6_74,1,0,74,74,61
53,seq3,r_2_90_54,r_24_102_98,r_2_90_54,0.89,-5,49,54,61
11,r_115_54_82,seq116,seq52,r_115_54_82,1,0,82,82,61
13,r_20_136_150,seq17,r_134_126_188,r_20_136_150,0.78,0,150,150,61
15,r_141_135_113,r_144_84_163,r_134_126_188,r_141_135_113,0.48,0,113,113,61
48,r_33_133_186,r_32_82_176,r_50_64_60,r_50_64_60,0.83,116,176,60,61
4,r_45_120_172,r_23_44_42,r_106_114_167,r_45_120_172,0.56,0,172,172,61
6,r_113_63_97,r_132_22_128,r_50_64_60,r_113_63_97,0.83,0,97,97,61
45,r_144_84_163,r_143_16_89,r_98_146_39,r_144_84_163,0.85,-123,40,163,61
40,r_76_29_49,r_77_88_140,r_41_7_19,r_76_29_49,1,0,49,49,61
10,r_98_146_39,r_144_84_163,seq139,r_144_84_163,1,0,163,163,61
27,r_60_147_156,seq58,seq142,r_60_147_156,0.7,0,156,156,61
14,r_23_44_42,r_24_102_98,seq47,r_23_44_42,0.96,0,42,42,61
2,r_34_138_87,r_32_82_176,seq137,r_34_138_87,0.99,0,87,87,61
47,r_42_109_149,seq39,seq111,r_42_109_149,0.58,0,149,149,61
18,r_32_82_176,r_33_133_186,r_145_81_74,r_33_133_186,0.29,-10,176,186,61
29,r_9_91_179,seq10,r_143_16_89,r_143_16_89,1,19,108,89,61
24,r_108_56_98,r_106_114_167,r_25_57_62,r_108_56_98,0.99,0,98,98,61
25,r_118_71_67,seq121,seq73,r_118_71_67,1,0,67,67,61
20,r_61_103_50,r_45_120_172,seq104,r_61_103_50,1,0,50,50,61
65,seq27,r_24_102_98,r_9_91_179,r_24_102_98,0.9,0,98,98,61
4,r_45_120_172,r_43_96_118,r_23_44_42,r_45_120_172,0.78,-130,42,172,61
32,r_77_88_140,seq75,seq89,r_77_88_140,0.77,0,140,140,61
38,r_24_102_98,r_25_57_62,seq27,r_25_57_62,0.93,-2,60,62,61
93,seq104,seq100,r_61_103_50,r_61_103_50,1,4,54,50,61
77,seq73,seq78,r_118_71_67,r_118_71_67,1,6,73,67,61
34,r_93_38_116,r_95_19_144,seq39,r_93_38_116,0.61,0,116,116,61
16,r_36_99_96,r_32_82_176,seq101,r_36_99_96,1,0,96,96,61
45,r_144_84_163,r_98_146_39,r_145_81_74,r_145_81_74,0.63,89,163,74,61
50,seq0,r_21_35_98,r_112_1_80,r_21_35_98,0.66,-38,60,98,61
17,r_2_90_54,seq3,seq86,r_2_90_54,1,0,54,54,61
94,seq107,r_106_114_167,r_55_105_68,r_55_105_68,1,99,167,68,61
9,r_21_35_98,r_20_136_150,r_50_64_60,r_21_35_98,0.77,0,98,98,61
22,r_43_96_118,r_45_120_172,seq94,r_43_96_118,0.87,0,118,118,61
28,r_132_22_128,seq137,seq27,r_132_22_128,0.99,0,128,128,61
38,r_24_102_98,seq27,seq104,r_24_102_98,1,0,98,98,61
7,r_70_6_74,seq69,r_41_7_19,r_70_6_74,1,0,74,74,61
44,r_25_57_62,r_24_102_98,seq58,r_25_57_62,0.64,-1,61,62,61
23,r_149_5_133,r_148_59_131,r_70_6_74,r_149_5_133,0.75,0,133,133,61
35,r_148_59_131,r_149_5_133,r_25_57_62,r_25_57_62,0.69,69,131,62,61
12,r_40_68_71,seq39,seq67,r_40_68_71,0.99,0,71,71,61
5,r_41_7_19,r_40_68_71,seq4,r_41_7_19,0.56,-4,15,19,61
42,r_127_124_50,r_149_5_133,r_28_125_40,r_28_125_40,0.8,10,50,40,61
95,seq111,r_55_105_68,r_42_109_149,r_42_109_149,1,12,161,149,61
30,r_29_136_78,r_32_1_127,r_135_138_12,r_29_136_78,1,0,78,78,62
36,r_141_130_103,seq140,r_3_134_21,r_141_130_103,0.96,5,108,103,62
5,r_87_50_147,r_81_21_161,r_144_88_36,r_144_88_36,1,20,56,36,62
14,r_98_96_157,r_100_27_144,seq91,r_100_27_144,0.95,0,144,144,62
18,r_54_80_39,seq55,r_81_21_161,r_54_80_39,0.96,0,39,39,62
8,r_81_21_161,r_83_113_145,r_103_82_132,r_83_113_145,0.36,0,145,145,62
43,r_117_72_65,seq118,seq73,r_117_72_65,1,0,65,65,62
37,r_38_2_24,seq37,r_0_133_84,r_38_2_24,0.94,0,24,24,62
55,seq140,r_141_130_103,seq148,r_141_130_103,0.92,0,103,103,62
16,r_77_110_182,r_78_126_183,r_124_123_72,r_124_123_72,0.84,108,180,72,62
21,r_146_85_169,seq149,r_94_86_152,r_146_85_169,0.61,0,169,169,62
1,r_97_99_110,r_94_86_152,r_98_96_157,r_94_86_152,0.63,-44,108,152,62
42,r_11_31_78,seq7,seq55,r_11_31_78,0.9,0,78,78,62
80,seq73,r_71_45_165,r_117_72_65,r_117_72_65,0.92,0,65,65,62
3,r_143_49_34,r_144_88_36,seq48,r_143_49_34,1,0,34,34,62
45,r_137_95_85,r_135_138_12,seq93,r_137_95_85,1,0,85,85,62
37,r_38_2_24,seq24,r_32_1_127,r_32_1_127,0.75,-11,116,127,62
46,r_147_17_20,seq149,r_16_65_129,r_147_17_20,1,0,20,20,62
31,r_67_8_91,r_70_30_168,r_111_10_18,r_67_8_91,0.99,0,91,91,62
41,r_94_86_152,seq93,r_144_88_36,r_144_88_36,1,116,152,36,62
89,seq102,r_103_82_132,r_120_106_47,r_103_82_132,0.85,0,132,132,62
20,r_132_12_121,r_135_138_12,r_3_134_21,r_3_134_21,1,4,25,21,62
0,r_40_131_125,r_43_84_180,r_141_130_103,r_40_131_125,0.88,0,125,125,62
29,r_16_65_129,seq13,r_147_17_20,r_147_17_20,1,20,40,20,62
11,r_58_44_128,seq57,seq41,r_58_44_128,0.96,0,128,128,62
12,r_0_133_84,r_3_134_21,r_38_2_24,r_3_134_21,0.66,0,21,21,62
13,r_105_142_168,seq108,seq145,r_105_142_168,0.82,0,168,168,62
46,r_147_17_20,r_16_65_129,r_34_18_133,r_16_65_129,0.55,-2,127,129,62
15,r_63_76_107,seq64,seq79,r_63_76_107,0.91,0,107,107,62
48,r_43_84_180,seq42,r_144_88_36,r_43_84_180,0.17,0,180,180,62
49,r_144_88_36,r_87_50_147,r_103_82_132,r_144_88_36,0.5,111,147,36,62
12,r_0_133_84,r_38_2_24,r_3_134_21,r_0_133_84,1,0,84,84,62
62,seq24,r_26_52_8,r_104_25_50,r_104_25_50,1,1,51,50,62
74,seq60,r_70_30_168,seq59,r_70_30_168,0.48,-1,167,168,62
5,r_87_50_147,r_144_88_36,r_143_49_34,r_87_50_147,0.78,0,147,147,62
27,r_92_46_136,r_94_86_152,seq47,r_92_46_136,0.56,0,136,136,62
36,r_141_130_103,r_3_134_21,r_40_131_125,r_40_131_125,0.64,36,161,125,62
47,r_70_30_168,seq69,r_100_27_144,r_70_30_168,0.58,0,168,168,62
40,r_116_53_66,seq115,r_26_52_8,r_116_53_66,1,0,66,66,62
74,seq60,seq73,r_70_30_168,r_70_30_168,0.79,-89,79,168,62
24,r_83_113_145,r_81_21_161,seq91,r_81_21_161,0.92,-16,145,161,62
25,r_128_9_166,seq129,r_111_10_18,r_111_10_18,0.92,148,166,18,62
33,r_103_82_132,seq102,r_144_88_36,r_144_88_36,1,96,132,36,62
64,seq35,seq55,r_11_31_78,r_11_31_78,0.79,87,165,78,62
2,r_15_68_18,seq13,seq69,r_15_68_18,0.95,2,20,18,62
20,r_132_12_121,r_3_134_21,r_111_10_18,r_132_12_121,1,0,121,121,62
8,r_81_21_161,r_103_82_132,r_19_23_145,r_81_21_161,0.75,0,161,161,62
32,r_32_1_127,seq33,r_38_2_24,r_32_1_127,0.63,0,127,127,62
52,seq6,seq7,r_111_10_18,r_111_10_18,1,65,83,18,62
77,seq64,r_63_76_107,seq61,r_63_76_107,1,-9,98,107,62
19,r_104_25_50,r_105_142_168,seq24,r_104_25_50,1,0,50,50,62
54,seq139,r_137_95_85,r_135_138_12,r_137_95_85,1,-48,37,85,62
26,r_3_134_21,r_0_133_84,r_132_12_121,r_132_12_121,0.58,-99,22,121,62
26,r_3_134_21,r_132_12_121,r_0_133_84,r_0_133_84,0.64,27,111,84,62
37,r_38_2_24,r_0_133_84,seq24,r_0_133_84,0.97,0,84,84,62
29,r_16_65_129,r_147_17_20,r_15_68_18,r_16_65_129,0.94,0,129,129,62
22,r_78_126_183,seq79,r_97_99_110,r_97_99_110,0.62,72,182,110,62
28,r_5_74_103,seq4,seq75,r_5_74_103,1,0,103,103,62
49,r_144_88_36,seq145,r_87_50_147,r_144_88_36,1,0,36,36,62
18,r_54_80_39,r_81_21_161,r_144_88_36,r_81_21_161,0.55,-60,101,161,62
44,r_39_109_96,seq48,r_120_106_47,r_39_109_96,0.99,-1,95,96,62
9,r_111_10_18,seq112,seq7,r_111_10_18,1,0,18,18,62
17,r_34_18_133,seq33,r_147_17_20,r_34_18_133,0.83,6,139,133,62
79,seq69,r_70_30_168,r_15_68_18,r_15_68_18,0.47,150,168,18,62
30,r_43_117_118,seq44,r_114_116_64,r_43_117_118,0.97,0,118,118,63
36,r_119_94_120,seq118,seq91,r_119_94_120,1,0,120,120,63
4,r_130_42_172,r_46_140_113,r_52_39_147,r_130_42_172,1,0,172,172,63
14,r_92_60_89,seq90,seq58,r_92_60_89,0.79,0,89,89,63
8,r_5_56_156,r_3_84_163,r_92_60_89,r_5_56_156,0.73,0,156,156,63
43,r_124_32_130,seq125,seq33,r_124_32_130,0.88,1,131,130,63
3,r_115_127_58,r_124_32_130,r_4_128_91,r_115_127_58,0.89,66,124,58,63
16,r_20_147_155,r_31_19_4,seq149,r_20_147_155,0.63,0,155,155,63
21,r_102_69_185,seq101,r_73_74_109,r_102_69_185,0.33,0,185,185,63
39,r_79_48_184,seq80,seq45,r_79_48_184,0.6,0,184,184,63
1,r_120_76_131,seq121,seq81,r_120_76_131,0.95,0,131,131,63
5,r_82_75_138,seq83,seq67,r_82_75_138,0.58,0,138,138,63
42,r_4_128_91,seq7,r_115_127_58,r_4_128_91,1,0,91,91,63
69,seq51,r_52_39_147,r_55_50_149,r_52_39_147,0.89,0,147,147,63
45,r_2_143_126,seq7,r_142_59_145,r_2_143_126,0.64,0,126,126,63
13,r_35_9_51,seq36,seq10,r_35_9_51,0.98,0,51,51,63
19,r_144_49_187,seq149,r_55_50_149,r_55_50_149,0.56,38,187,149,63
11,r_93_26_20,r_25_37_180,r_40_27_69,r_40_27_69,0.9,11,80,69,63
31,r_46_140_113,seq45,r_145_139_7,r_46_140_113,0.94,0,113,113,63
68,seq45,r_47_132_160,r_105_8_131,r_47_132_160,0.89,1,161,160,63
29,r_146_108_16,seq149,seq107,r_146_108_16,0.82,0,16,16,63
41,r_138_22_83,r_136_16_145,seq21,r_138_22_83,0.99,0,83,83,63
67,seq44,r_43_117_118,seq45,r_43_117_118,0.77,1,119,118,63
3,r_115_127_58,r_119_94_120,r_124_32_130,r_115_127_58,0.8,0,58,58,63
10,r_1_95_145,seq0,seq96,r_1_95_145,0.74,0,145,145,63
4,r_130_42_172,r_131_64_116,r_46_140_113,r_130_42_172,0.55,-56,116,172,63
38,r_122_6_55,r_120_76_131,seq7,r_122_6_55,1,0,55,55,63
20,r_47_132_160,seq45,r_71_134_147,r_47_132_160,0.76,0,160,160,63
98,seq125,r_124_32_130,r_68_126_56,r_68_126_56,0.98,16,72,56,63
48,r_131_64_116,r_130_42_172,r_57_65_46,r_131_64_116,0.93,0,116,116,63
6,r_113_28_107,seq112,r_72_29_56,r_113_28_107,0.98,0,107,107,63
0,r_72_29_56,r_73_74_109,seq33,r_72_29_56,1,0,56,56,63
15,r_68_126_56,r_71_134_147,seq125,r_68_126_56,0.94,0,56,56,63
37,r_88_129_68,r_92_60_89,seq133,r_88_129_68,0.97,1,69,68,63
26,r_87_17_54,r_88_129_68,r_31_19_4,r_87_17_54,0.87,0,54,54,63
45,r_2_143_126,r_142_59_145,seq149,r_142_59_145,0.72,0,145,145,63
7,r_41_11_19,r_40_27_69,seq10,r_41_11_19,0.91,0,19,19,63
40,r_40_27_69,seq38,r_93_26_20,r_93_26_20,0.62,52,72,20,63
24,r_55_50_149,seq58,seq51,r_55_50_149,0.49,5,154,149,63
64,seq36,r_35_9_51,seq34,r_35_9_51,1,0,51,51,63
33,r_18_141_63,r_20_147_155,seq133,r_18_141_63,0.82,0,63,63,63
65,seq38,seq21,r_52_39_147,r_52_39_147,1,1,148,147,63
50,seq0,r_1_95_145,r_122_6_55,r_122_6_55,1,90,145,55,63
65,seq38,r_40_27_69,seq21,r_40_27_69,0.61,11,80,69,63
37,r_88_129_68,r_87_17_54,r_92_60_89,r_87_17_54,0.69,0,54,54,63
68,seq45,r_46_140_113,r_47_132_160,r_46_140_113,0.97,1,114,113,63
32,r_71_134_147,seq70,r_145_139_7,r_71_134_147,0.94,0,147,147,63
52,seq7,r_5_56_156,r_122_6_55,r_122_6_55,1,17,72,55,63
18,r_25_37_180,seq34,r_93_26_20,r_93_26_20,1,18,38,20,63
60,seq23,r_25_37_180,r_93_26_20,r_93_26_20,1,76,96,20,63
11,r_93_26_20,r_92_60_89,r_25_37_180,r_93_26_20,0.56,0,20,20,63
81,seq86,r_85_97_167,r_3_84_163,r_3_84_163,0.62,10,173,163,63
17,r_52_39_147,seq51,seq38,r_52_39_147,0.71,0,147,147,63
46,r_114_116_64,r_115_127_58,r_124_32_130,r_114_116_64,0.45,-36,28,64,63
18,r_25_37_180,r_93_26_20,r_130_42_172,r_130_42_172,1,7,179,172,63
44,r_31_19_4,r_20_147_155,r_87_17_54,r_31_19_4,0.87,80,84,4,63
35,r_136_16_145,seq133,r_87_17_54,r_136_16_145,0.91,0,145,145,63
93,seq113,r_117_103_134,r_128_115_72,r_128_115_72,1,0,72,72,64
30,r_68_62_116,r_69_42_195,seq63,r_68_62_116,0.66,0,116,116,64
20,r_81_75_37,r_84_3_109,r_141_73_7,r_81_75_37,0.68,-2,35,37,64
36,r_127_33_142,seq126,r_80_35_28,r_127_33_142,0.79,0,142,142,64
14,r_119_17_85,seq123,r_93_15_15,r_119_17_85,0.99,0,85,85,64
8,r_11_91_120,r_12_31_148,r_39_92_115,r_11_91_120,0.97,0,120,120,64
46,r_93_15_15,r_97_96_65,r_18_51_117,r_93_15_15,0.71,0,15,15,64
16,r_78_129_104,seq76,seq130,r_78_129_104,0.97,0,104,104,64
21,r_22_70_82,seq21,r_124_71_67,r_22_70_82,1,0,82,82,64
1,r_18_51_117,r_16_125_140,r_9_50_113,r_16_125_140,0.88,-23,117,140,64
49,r_9_50_113,seq19,seq52,r_9_50_113,0.74,1,114,113,64
69,seq52,seq54,r_18_51_117,r_18_51_117,1,1,118,117,64
45,r_55_41_74,seq56,seq40,r_55_41_74,1,0,74,74,64
81,seq79,r_72_24_133,seq86,r_72_24_133,0.87,-82,51,133,64
24,r_16_125_140,r_93_15_15,seq123,r_16_125_140,0.83,0,140,140,64
19,r_7_14_112,seq6,r_93_15_15,r_7_14_112,0.88,0,112,112,64
31,r_65_23_44,seq66,seq27,r_65_23_44,0.99,0,44,44,64
17,r_39_92_115,r_87_28_187,r_11_91_120,r_39_92_115,0.55,31,146,115,64
23,r_37_48_26,r_39_92_115,r_49_0_113,r_37_48_26,0.96,0,26,26,64
89,seq102,seq101,r_117_103_134,r_117_103_134,0.87,0,134,134,64
18,r_120_29_33,r_119_17_85,seq27,r_120_29_33,1,0,33,33,64
10,r_90_57_74,seq94,seq58,r_90_57_74,1,0,74,74,64
5,r_104_139_54,r_128_115_72,r_8_140_68,r_104_139_54,0.56,13,67,54,64
0,r_128_115_72,seq134,seq113,r_128_115_72,0.99,0,72,72,64
63,seq21,r_22_70_82,seq19,r_22_70_82,1,1,83,82,64
73,seq58,seq60,r_90_57_74,r_90_57_74,1,28,102,74,64
11,r_84_3_109,seq83,seq1,r_84_3_109,0.84,0,109,109,64
5,r_104_139_54,seq105,r_128_115_72,r_104_139_54,0.79,0,54,54,64
13,r_49_0_113,r_47_34_117,seq1,r_49_0_113,0.95,0,113,113,64
98,seq123,r_122_100_170,r_16_125_140,r_16_125_140,0.95,32,172,140,64
46,r_93_15_15,r_18_51_117,r_7_14_112,r_18_51_117,0.92,0,117,117,64
15,r_4_45_87,seq1,seq43,r_4_45_87,1,0,87,87,64
48,r_142_136_142,seq145,r_30_138_132,r_142_136_142,0.75,0,142,142,64
6,r_13_95_136,r_12_31_148,seq94,r_12_31_148,0.69,-12,136,148,64
85,seq89,r_87_28_187,r_26_88_62,r_26_88_62,1,1,63,62,64
41,r_47_34_117,r_55_41_74,r_37_48_26,r_37_48_26,0.87,0,26,26,64
27,r_8_140_68,r_9_50_113,r_104_139_54,r_8_140_68,1,0,68,68,64
9,r_124_71_67,r_146_133_62,r_22_70_82,r_22_70_82,0.56,0,82,82,64
41,r_47_34_117,r_37_48_26,r_80_35_28,r_47_34_117,1,0,117,117,64
47,r_72_24_133,seq74,r_65_23_44,r_72_24_133,0.86,0,133,133,64
40,r_149_61_71,seq148,seq60,r_149_61_71,1,0,71,71,64
74,seq60,seq63,r_149_61_71,r_149_61_71,1,24,95,71,64
29,r_69_42_195,r_68_62_116,seq66,r_68_62_116,0.66,0,116,116,64
35,r_80_35_28,seq40,r_47_34_117,r_47_34_117,1,16,133,117,64
25,r_26_88_62,seq27,seq89,r_26_88_62,1,0,62,62,64
33,r_20_114_146,r_12_31_148,r_128_115_72,r_20_114_146,0.8,0,146,146,64
65,seq27,seq25,r_120_29_33,r_120_29_33,1,71,104,33,64
3,r_106_112_54,r_108_111_8,seq113,r_106_112_54,0.8,0,54,54,64
81,seq79,r_81_75_37,r_72_24_133,r_72_24_133,0.78,-118,15,133,64
61,seq19,r_20_114_146,seq21,r_20_114_146,1,-31,115,146,64
32,r_122_100_170,seq123,seq116,r_122_100_170,0.62,2,172,170,64
38,r_30_138_132,seq40,seq137,r_30_138_132,0.76,0,132,132,64
34,r_12_31_148,r_11_91_120,seq19,r_11_91_120,0.93,0,120,120,64
34,r_12_31_148,seq19,r_80_35_28,r_12_31_148,0.68,0,148,148,64
75,seq63,seq60,r_68_62_116,r_68_62_116,0.99,4,120,116,64
17,r_39_92_115,seq40,r_87_28_187,r_39_92_115,0.85,0,115,115,64
96,seq118,r_117_103_134,r_128_115_72,r_128_115_72,1,60,132,72,64
31,r_65_23_44,seq27,r_72_24_133,r_72_24_133,1,0,133,133,64
29,r_69_42_195,seq66,r_44_36_130,r_44_36_130,0.55,65,195,130,64
22,r_38_107_83,r_39_92_115,seq109,r_38_107_83,0.6,0,83,83,64
24,r_16_125_140,r_18_51_117,r_93_15_15,r_93_15_15,0.69,0,15,15,64
35,r_80_35_28,r_81_75_37,seq40,r_80_35_28,0.93,0,28,28,64
49,r_9_50_113,r_8_140_68,seq19,r_8_140_68,1,0,68,68,64
44,r_59_46_103,seq60,r_4_45_87,r_59_46_103,0.86,0,103,103,64
12,r_87_28_187,seq89,r_120_29_33,r_120_29_33,0.8,154,187,33,64
23,r_37_48_26,r_49_0_113,r_4_45_87,r_37_48_26,0.99,87,113,26,64
46,r_118_51_18,r_111_21_41,r_49_37_89,r_118_51_18,1,0,18,18,65
16,r_12_110_71,r_5_127_136,r_135_116_67,r_12_110_71,1,-17,54,71,65
14,r_135_116_67,seq136,seq115,r_135_116_67,1,0,67,67,65
29,r_71_75_46,seq72,seq74,r_71_75_46,0.77,0,46,46,65
0,r_111_21_41,r_32_13_15,r_24_20_55,r_24_20_55,1,14,69,55,65
53,seq132,r_133_149_170,r_120_134_27,r_133_149_170,0.4,-3,167,170,65
43,r_128_123_8,r_121_108_87,seq131,r_121_108_87,1,0,87,87,65
37,r_58_87_16,seq55,seq88,r_58_87_16,0.87,1,17,16,65
30,r_24_20_55,seq23,r_111_21_41,r_24_20_55,1,0,55,55,65
86,seq79,r_85_117_183,r_69_78_94,r_69_78_94,0.9,29,123,94,65
39,r_93_44_124,r_91_18_160,r_14_46_91,r_93_44_124,0.78,1,125,124,65
95,seq104,r_91_18_160,r_40_105_12,r_40_105_12,1,0,12,12,65
28,r_17_73_35,seq19,seq65,r_17_73_35,0.99,1,36,35,65
62,seq19,r_15_64_111,r_111_21_41,r_111_21_41,0.6,1,42,41,65
46,r_118_51_18,r_49_37_89,seq55,r_49_37_89,1,-12,77,89,65
19,r_40_105_12,seq41,seq104,r_40_105_12,0.94,0,12,12,65
35,r_1_52_32,r_0_139_69,r_99_54_10,r_1_52_32,0.98,0,32,32,65
31,r_141_26_119,seq140,seq27,r_141_26_119,1,0,119,119,65
41,r_101_56_86,seq103,seq55,r_101_56_86,0.99,0,86,86,65
8,r_11_36_50,r_10_113_74,seq28,r_11_36_50,1,0,50,50,65
13,r_0_139_69,seq19,seq140,r_0_139_69,0.94,-11,58,69,65
5,r_62_125_47,seq130,r_38_126_60,r_38_126_60,0.98,22,82,60,65
3,r_107_86_100,seq100,seq84,r_107_86_100,0.96,0,100,100,65
10,r_80_22_107,r_82_83_161,r_11_36_50,r_80_22_107,0.89,1,108,107,65
26,r_61_96_115,seq63,r_40_105_12,r_61_96_115,0.77,0,115,115,65
8,r_11_36_50,seq28,r_49_37_89,r_49_37_89,1,50,139,89,65
2,r_90_31_131,seq115,r_91_18_160,r_91_18_160,0.57,-119,41,160,65
5,r_62_125_47,seq63,seq130,r_62_125_47,0.97,0,47,47,65
25,r_34_57_121,r_24_20_55,r_122_33_33,r_34_57_121,0.99,-89,32,121,65
15,r_5_127_136,r_8_94_160,seq129,r_5_127_136,0.99,0,136,136,65
48,r_121_108_87,r_128_123_8,r_40_105_12,r_121_108_87,1,0,87,87,65
2,r_90_31_131,r_91_18_160,seq29,r_90_31_131,0.97,1,132,131,65
20,r_49_37_89,r_50_6_30,r_118_51_18,r_49_37_89,0.82,-71,18,89,65
13,r_0_139_69,r_1_52_32,seq19,r_0_139_69,0.83,-36,33,69,65
77,seq63,r_62_125_47,r_61_96_115,r_62_125_47,0.98,-18,29,47,65
49,r_2_43_16,r_1_52_32,seq48,r_2_43_16,0.95,0,16,16,65
1,r_99_54_10,r_111_21_41,seq53,r_99_54_10,0.93,0,10,10,65
7,r_15_64_111,r_32_13_15,seq65,r_15_64_111,0.99,0,111,111,65
47,r_89_146_163,seq88,r_147_144_31,r_89_146_163,0.95,0,163,163,65
40,r_14_46_91,r_15_64_111,seq48,r_14_46_91,0.98,0,91,91,65
74,seq55,seq53,r_101_56_86,r_101_56_86,1,6,92,86,65
18,r_120_134_27,r_133_149_170,seq132,r_133_149_170,0.38,-3,167,170,65
24,r_10_113_74,r_8_94_160,seq112,r_10_113_74,1,0,74,74,65
33,r_98_148_108,r_91_18_160,seq145,r_98_148_108,0.98,1,109,108,65
88,seq84,r_85_117_183,r_107_86_100,r_107_86_100,1,83,183,100,65
58,seq140,r_141_26_119,r_0_139_69,r_0_139_69,0.61,1,70,69,65
45,r_32_13_15,r_34_57_121,seq19,r_32_13_15,0.99,0,15,15,65
20,r_49_37_89,r_118_51_18,r_11_36_50,r_49_37_89,1,0,89,89,65
38,r_82_83_161,seq81,r_107_86_100,r_107_86_100,1,92,192,100,65
0,r_111_21_41,seq112,r_32_13_15,r_111_21_41,1,1,42,41,65
34,r_8_94_160,seq7,r_42_106_121,r_8_94_160,0.52,0,160,160,65
17,r_69_78_94,r_70_35_179,seq79,r_69_78_94,0.92,0,94,94,65
25,r_34_57_121,r_122_33_33,r_101_56_86,r_34_57_121,0.99,2,123,121,65
32,r_50_6_30,r_49_37_89,seq9,r_50_6_30,1,0,30,30,65
22,r_133_149_170,r_120_134_27,r_98_148_108,r_98_148_108,1,62,170,108,65
4,r_122_33_33,r_121_108_87,seq29,r_122_33_33,1,0,33,33,65
7,r_15_64_111,r_14_46_91,r_32_13_15,r_14_46_91,0.57,-4,87,91,65
23,r_38_126_60,seq39,r_62_125_47,r_38_126_60,0.71,0,60,60,65
12,r_70_35_179,seq72,r_11_36_50,r_11_36_50,0.6,129,179,50,65
7,r_51_81_15,r_52_70_61,seq80,r_51_81_15,0.7,3,18,15,66
30,r_25_118_177,seq27,r_13_117_93,r_13_117_93,0.96,84,177,93,66
23,r_29_76_17,r_36_21_194,seq77,r_29_76_17,0.56,1,18,17,66
36,r_52_70_61,r_53_140_121,r_74_133_193,r_52_70_61,1,1,62,61,66
18,r_89_24_192,r_8_87_51,r_94_95_132,r_89_24_192,0.43,-82,110,192,66
25,r_145_93_138,r_89_24_192,r_143_92_160,r_145_93_138,0.86,32,170,138,66
14,r_22_39_152,r_23_3_141,r_73_38_121,r_22_39_152,0.53,0,152,152,66
8,r_75_35_183,r_74_133_193,r_22_39_152,r_74_133_193,0.52,-10,183,193,66
43,r_53_140_121,r_54_146_102,seq55,r_54_146_102,1,-14,88,102,66
37,r_136_139_194,r_135_42_184,seq130,r_136_139_194,0.63,-47,147,194,66
16,r_59_7_191,seq58,r_122_6_14,r_122_6_14,0.91,177,191,14,66
1,r_82_79_130,r_78_84_27,r_51_81_15,r_82_79_130,0.99,0,130,130,66
46,r_100_83_183,seq101,r_78_84_27,r_78_84_27,0.89,156,183,27,66
42,r_121_0_93,r_120_43_118,r_2_1_28,r_121_0_93,1,0,93,93,66
80,seq69,r_74_133_193,r_71_67_113,r_71_67_113,0.42,75,188,113,66
35,r_98_47_50,r_94_95_132,seq49,r_98_47_50,1,0,50,50,66
11,r_91_114_28,seq113,seq116,r_91_114_28,0.36,63,91,28,66
66,seq27,r_25_118_177,r_65_26_150,r_65_26_150,0.65,20,170,150,66
41,r_60_32_107,seq61,r_112_31_2,r_60_32_107,0.84,0,107,107,66
28,r_141_45_39,r_143_92_160,seq44,r_141_45_39,1,0,39,39,66
20,r_142_64_25,r_145_93_138,r_65_26_150,r_142_64_25,1,0,25,25,66
18,r_89_24_192,r_94_95_132,r_145_93_138,r_145_93_138,0.74,5,143,138,66
1,r_82_79_130,r_88_127_153,r_78_84_27,r_78_84_27,1,0,27,27,66
4,r_122_6_14,r_126_46_58,seq10,r_122_6_14,0.98,0,14,14,66
0,r_56_63_152,seq55,r_90_62_87,r_90_62_87,0.83,65,152,87,66
13,r_13_117_93,r_15_20_182,r_119_115_160,r_13_117_93,1,0,93,93,66
81,seq77,r_78_84_27,r_29_76_17,r_78_84_27,0.8,-11,16,27,66
10,r_78_84_27,seq80,r_82_79_130,r_78_84_27,1,1,28,27,66
18,r_89_24_192,r_145_93_138,r_15_20_182,r_89_24_192,0.94,0,192,192,66
96,seq113,seq111,r_91_114_28,r_91_114_28,1,-1,27,28,66
13,r_13_117_93,r_119_115_160,r_103_125_12,r_119_115_160,0.73,1,161,160,66
6,r_143_92_160,r_132_138_24,r_145_93_138,r_132_138_24,0.82,136,160,24,66
43,r_53_140_121,seq55,r_132_138_24,r_53_140_121,1,0,121,121,66
21,r_65_26_150,r_142_64_25,seq27,r_65_26_150,0.97,0,150,150,66
10,r_78_84_27,r_8_87_51,r_100_83_183,r_78_84_27,0.76,159,186,27,66
5,r_88_127_153,r_8_87_51,r_103_125_12,r_103_125_12,0.46,141,153,12,66
36,r_52_70_61,r_74_133_193,r_71_67_113,r_74_133_193,0.46,-34,159,193,66
51,seq129,r_126_46_58,seq137,r_126_46_58,1,-1,57,58,66
21,r_65_26_150,seq61,r_142_64_25,r_142_64_25,1,3,28,25,66
10,r_78_84_27,r_82_79_130,r_8_87_51,r_82_79_130,0.84,1,131,130,66
44,r_119_115_160,r_13_117_93,seq116,r_119_115_160,0.95,0,160,160,66
2,r_120_43_118,r_119_115_160,seq44,r_120_43_118,0.95,0,118,118,66
47,r_131_72_64,seq130,r_52_70_61,r_131_72_64,1,0,64,64,66
40,r_74_133_193,r_75_35_183,r_71_67_113,r_75_35_183,0.69,0,183,183,66
18,r_89_24_192,r_90_62_87,r_8_87_51,r_8_87_51,0.49,34,85,51,66
24,r_2_1_28,seq5,r_121_0_93,r_121_0_93,1,36,129,93,66
25,r_145_93_138,seq144,r_89_24_192,r_145_93_138,0.65,0,138,138,66
82,seq80,r_78_84_27,r_51_81_15,r_78_84_27,0.8,-9,18,27,66
31,r_8_87_51,r_15_20_182,r_88_127_153,r_8_87_51,1,-2,49,51,66
98,seq116,seq111,r_91_114_28,r_91_114_28,1,1,29,28,66
20,r_142_64_25,r_65_26_150,r_90_62_87,r_142_64_25,0.65,120,145,25,66
11,r_91_114_28,r_90_62_87,seq113,r_91_114_28,0.98,0,28,28,66
61,seq17,seq19,r_15_20_182,r_15_20_182,0.91,1,183,182,66
32,r_90_62_87,r_89_24_192,r_142_64_25,r_90_62_87,1,0,87,87,66
48,r_66_9_19,r_65_26_150,seq10,r_66_9_19,0.96,0,19,19,66
38,r_23_3_141,r_22_39_152,r_121_0_93,r_121_0_93,0.54,57,150,93,66
52,seq130,r_131_72_64,r_136_139_194,r_131_72_64,1,-4,60,64,66
29,r_103_125_12,seq104,seq128,r_103_125_12,0.92,0,12,12,66
34,r_73_38_121,r_74_133_193,r_16_41_3,r_73_38_121,0.54,0,121,121,66
73,seq44,r_59_7_191,r_141_45_39,r_141_45_39,1,0,39,39,66
5,r_88_127_153,seq85,r_8_87_51,r_8_87_51,1,6,57,51,66
9,r_57_48_108,r_59_7_191,seq49,r_57_48_108,0.57,4,112,108,66
31,r_8_87_51,r_88_127_153,seq85,r_8_87_51,0.57,92,143,51,66
22,r_71_67_113,r_73_38_121,seq68,r_73_38_121,0.94,-7,114,121,66
44,r_119_115_160,r_120_43_118,r_13_117_93,r_13_117_93,0.75,16,109,93,66
19,r_126_46_58,seq128,seq44,r_126_46_58,1,0,58,58,66
12,r_132_138_24,r_143_92_160,r_53_140_121,r_53_140_121,0.54,4,125,121,66
6,r_139_8_22,r_136_46_44,r_10_26_94,r_139_8_22,0.93,0,22,22,67
14,r_130_20_94,seq129,seq22,r_130_20_94,0.89,0,94,94,67
38,r_87_132_110,r_149_13_176,r_63_131_127,r_63_131_127,0.56,8,135,127,67
43,r_79_102_118,seq80,r_142_98_57,r_79_102_118,0.76,0,118,118,67
37,r_88_90_69,r_92_120_62,r_104_89_49,r_92_120_62,0.67,-1,61,62,67
10,r_64_77_154,seq66,seq80,r_64_77_154,0.89,0,154,154,67
16,r_57_12_164,seq58,r_130_20_94,r_130_20_94,0.91,72,166,94,67
80,seq80,r_79_102_118,seq81,r_79_102_118,0.99,0,118,118,67
45,r_10_26_94,r_7_3_172,r_127_28_71,r_127_28_71,0.99,23,94,71,67
22,r_116_16_36,r_118_62_39,seq21,r_116_16_36,0.84,0,36,36,67
19,r_105_119_133,seq106,r_24_128_84,r_24_128_84,0.97,40,124,84,67
27,r_126_52_160,r_101_121_20,seq51,r_126_52_160,0.56,0,160,160,67
41,r_127_28_71,r_130_20_94,r_23_113_113,r_127_28_71,0.93,0,71,71,67
49,r_93_9_81,r_142_98_57,r_139_8_22,r_93_9_81,0.92,0,81,81,67
39,r_138_144_106,r_139_8_22,seq148,r_139_8_22,0.87,-5,17,22,67
10,r_64_77_154,r_63_131_127,seq66,r_63_131_127,0.9,0,127,127,67
36,r_15_108_16,r_7_3_172,seq106,r_15_108_16,0.91,0,16,16,67
26,r_18_53_164,seq19,r_70_56_86,r_70_56_86,0.83,80,166,86,67
72,seq58,r_57_12_164,r_146_54_41,r_146_54_41,1,38,79,41,67
4,r_17_76_68,r_18_53_164,seq80,r_17_76_68,0.99,0,68,68,67
38,r_87_132_110,r_104_89_49,r_149_13_176,r_87_132_110,0.5,0,110,110,67
0,r_24_128_84,r_25_95_116,seq129,r_24_128_84,1,0,84,84,67
11,r_78_65_79,r_79_102_118,seq66,r_78_65_79,0.98,0,79,79,67
12,r_47_69_100,r_48_103_50,r_136_46_44,r_47_69_100,0.99,-50,50,100,67
3,r_104_89_49,r_105_119_133,r_88_90_69,r_104_89_49,0.9,0,49,49,67
13,r_44_84_167,seq45,seq85,r_44_84_167,0.24,0,167,167,67
67,seq41,r_37_40_76,r_60_42_26,r_60_42_26,0.97,33,59,26,67
48,r_23_113_113,r_25_95_116,seq112,r_23_113_113,0.8,0,113,113,67
8,r_142_98_57,seq140,seq100,r_142_98_57,1,0,57,57,67
5,r_48_103_50,r_47_69_100,r_15_108_16,r_48_103_50,1,0,50,50,67
49,r_93_9_81,r_88_90_69,r_142_98_57,r_93_9_81,0.57,-22,59,81,67
46,r_118_62_39,seq117,seq61,r_118_62_39,1,0,39,39,67
40,r_135_5_10,seq133,seq6,r_135_5_10,0.98,0,10,10,67
27,r_126_52_160,r_130_20_94,r_101_121_20,r_126_52_160,0.63,-71,89,160,67
2,r_0_34_131,seq1,r_33_14_103,r_0_34_131,0.66,0,131,131,67
56,seq145,r_146_54_41,seq148,r_146_54_41,0.97,-28,13,41,67
18,r_70_56_86,seq73,r_146_54_41,r_70_56_86,0.87,0,86,86,67
24,r_101_121_20,r_96_38_163,seq124,r_101_121_20,0.91,0,20,20,67
25,r_136_46_44,r_138_144_106,seq45,r_136_46_44,1,0,44,44,67
33,r_25_95_116,r_23_113_113,r_142_98_57,r_25_95_116,0.9,-1,115,116,67
6,r_139_8_22,r_10_26_94,r_93_9_81,r_93_9_81,1,12,93,81,67
41,r_127_28_71,r_23_113_113,r_10_26_94,r_23_113_113,1,2,115,113,67
32,r_27_143_82,r_24_128_84,seq148,r_27_143_82,0.86,0,82,82,67
38,r_87_132_110,r_92_120_62,r_104_89_49,r_92_120_62,0.9,-1,61,62,67
34,r_7_3_172,r_10_26_94,r_93_9_81,r_93_9_81,0.93,14,95,81,67
73,seq59,r_48_103_50,r_0_34_131,r_0_34_131,0.74,-107,24,131,67
55,seq140,r_142_98_57,seq148,r_142_98_57,1,0,57,57,67
30,r_146_54_41,seq51,r_70_56_86,r_70_56_86,0.98,11,97,86,67
17,r_33_14_103,seq32,r_139_8_22,r_33_14_103,0.44,0,103,103,67
28,r_83_75_163,seq85,r_141_71_20,r_141_71_20,0.63,142,162,20,67
42,r_11_36_21,r_10_26_94,seq35,r_11_36_21,0.87,0,21,21,67
74,seq61,r_64_77_154,r_118_62_39,r_118_62_39,0.92,1,40,39,67
44,r_109_137_112,seq106,seq133,r_109_137_112,0.93,0,112,112,67
23,r_63_131_127,r_64_77_154,r_87_132_110,r_64_77_154,0.51,-27,127,154,67
12,r_47_69_100,r_136_46_44,r_43_74_53,r_47_69_100,0.97,0,100,100,67
30,r_146_54_41,seq145,seq51,r_146_54_41,0.93,0,41,41,67
1,r_141_71_20,seq140,seq73,r_141_71_20,1,0,20,20,67
35,r_96_38_163,seq97,r_37_40_76,r_96_38_163,0.64,0,163,163,67
44,r_139_84_39,seq88,r_49_85_157,r_49_85_157,0.96,0,157,157,68
42,r_34_78_174,r_5_29_42,r_33_89_148,r_34_78_174,0.49,-1,173,174,68
36,r_7_123_67,r_9_45_147,seq124,r_7_123_67,1,1,68,67,68
49,r_44_62_161,r_125_43_136,r_77_60_57,r_44_62_161,0.67,0,161,161,68
92,seq147,r_146_26_151,r_51_148_122,r_51_148_122,0.82,30,152,122,68
8,r_114_31_77,r_115_37_144,seq30,r_114_31_77,0.88,0,77,77,68
66,seq30,r_33_89_148,r_5_29_42,r_5_29_42,0.98,0,42,42,68
26,r_105_142_43,seq95,seq138,r_105_142_43,1,0,43,43,68
83,seq92,r_94_21_162,r_14_91_73,r_14_91_73,1,94,167,73,68
71,seq53,r_52_133_33,r_42_55_8,r_52_133_33,1,0,33,33,68
37,r_42_55_8,r_54_130_153,r_102_59_75,r_102_59_75,0.59,78,153,75,68
14,r_110_144_59,r_109_63_103,r_105_142_43,r_110_144_59,0.98,0,59,59,68
59,seq12,r_11_87_163,r_28_8_73,r_28_8_73,0.63,90,163,73,68
2,r_52_133_33,seq53,seq136,r_52_133_33,0.93,0,33,33,68
21,r_11_87_163,seq12,seq88,r_11_87_163,0.92,0,163,163,68
40,r_125_43_136,r_44_62_161,r_9_45_147,r_125_43_136,0.72,25,161,136,68
1,r_27_107_69,r_28_8_73,r_80_108_128,r_28_8_73,0.82,-3,70,73,68
5,r_94_21_162,seq92,r_143_24_25,r_143_24_25,0.48,138,163,25,68
46,r_70_106_105,seq72,seq97,r_70_106_105,0.88,0,105,105,68
42,r_34_78_174,r_33_89_148,r_5_29_42,r_5_29_42,0.95,103,145,42,68
43,r_15_90_40,r_13_50_170,r_94_21_162,r_15_90_40,1,0,40,40,68
7,r_134_66_37,seq67,seq65,r_134_66_37,0.22,86,123,37,68
45,r_115_37_144,seq113,r_47_36_21,r_115_37_144,0.79,0,144,144,68
10,r_77_60_57,r_70_106_105,seq61,r_77_60_57,0.99,0,57,57,68
19,r_16_96_159,seq17,seq97,r_16_96_159,0.5,1,160,159,68
33,r_119_18_121,seq22,r_77_60_57,r_119_18_121,0.51,63,184,121,68
44,r_139_84_39,seq138,seq88,r_139_84_39,0.99,0,39,39,68
39,r_99_132_47,r_98_81_44,r_52_133_33,r_99_132_47,1,0,47,47,68
76,seq65,seq67,r_134_66_37,r_134_66_37,1,106,143,37,68
41,r_109_63_103,r_110_144_59,r_77_60_57,r_109_63_103,1,-8,95,103,68
3,r_33_89_148,r_34_78_174,r_15_90_40,r_33_89_148,0.58,0,148,148,68
4,r_28_8_73,r_25_86_175,seq12,r_28_8_73,0.63,0,73,73,68
11,r_9_45_147,r_11_87_163,r_125_43_136,r_125_43_136,0.73,11,147,136,68
77,seq67,seq65,r_134_66_37,r_134_66_37,1,3,40,37,68
13,r_93_82_140,r_94_21_162,r_98_81_44,r_93_82_140,0.74,1,141,140,68
98,seq124,r_126_73_168,seq121,r_126_73_168,0.89,0,168,168,68
15,r_71_40_67,r_70_106_105,r_47_36_21,r_71_40_67,0.93,3,70,67,68
49,r_44_62_161,seq57,r_125_43_136,r_125_43_136,0.94,1,137,136,68
6,r_13_50_170,seq12,seq48,r_13_50_170,0.56,0,170,170,68
0,r_143_24_25,r_25_86_175,r_0_23_100,r_0_23_100,1,51,151,100,68
17,r_80_108_128,r_83_75_54,r_98_81_44,r_80_108_128,0.52,-75,53,128,68
27,r_51_148_122,r_49_85_157,seq149,r_51_148_122,0.98,0,122,122,68
30,r_25_86_175,r_143_24_25,r_49_85_157,r_49_85_157,0.94,18,175,157,68
87,seq101,r_102_59_75,seq97,r_102_59_75,1,0,75,75,68
40,r_125_43_136,r_126_73_168,r_44_62_161,r_125_43_136,0.86,0,136,136,68
18,r_54_130_153,r_49_85_157,r_42_55_8,r_49_85_157,0.85,-94,63,157,68
29,r_79_74_103,r_94_21_162,seq72,r_79_74_103,0.93,0,103,103,68
43,r_15_90_40,r_94_21_162,r_33_89_148,r_15_90_40,0.38,116,156,40,68
48,r_98_81_44,r_80_108_128,r_93_82_140,r_80_108_128,0.98,0,128,128,68
64,seq149,seq147,r_51_148_122,r_51_148_122,1,3,125,122,68
70,seq48,r_49_85_157,r_39_46_50,r_49_85_157,0.53,0,157,157,68
65,seq22,r_25_86_175,r_143_24_25,r_143_24_25,0.98,91,116,25,68
61,seq17,r_16_96_159,seq2,r_16_96_159,0.58,1,160,159,68
89,seq111,r_114_31_77,seq124,r_114_31_77,0.97,-54,23,77,68
47,r_5_29_42,seq4,seq30,r_5_29_42,0.98,0,42,42,68
34,r_126_73_168,seq124,r_79_74_103,r_126_73_168,0.53,0,168,168,68
75,seq61,r_64_104_192,r_77_60_57,r_77_60_57,1,10,67,57,68
48,r_98_81_44,r_99_132_47,r_80_108_128,r_99_132_47,0.72,-1,46,47,68
20,r_32_19_34,r_33_89_148,seq20,r_32_19_34,0.9,0,34,34,68
9,r_14_91_73,r_13_50_170,seq92,r_14_91_73,1,0,73,73,68
24,r_83_75_54,r_80_108_128,seq72,r_83_75_54,0.99,0,54,54,68
7,r_134_66_37,seq136,seq67,r_134_66_37,0.99,1,38,37,68
0,r_143_24_25,r_139_84_39,r_25_86_175,r_143_24_25,0.97,0,25,25,68
22,r_0_23_100,seq1,r_143_24_25,r_0_23_100,0.84,1,101,100,68
28,r_102_59_75,seq101,seq58,r_102_59_75,0.98,0,75,75,68
2,r_52_133_33,seq136,r_99_132_47,r_99_132_47,1,6,53,47,68
49,r_44_62_161,r_49_85_157,seq57,r_49_85_157,0.44,-85,72,157,68
18,r_54_130_153,r_42_55_8,seq131,r_54_130_153,0.76,0,153,153,68
23,r_41_6_117,r_49_85_157,r_44_62_161,r_41_6_117,0.32,-47,70,117,68
17,r_80_108_128,r_98_81_44,r_27_107_69,r_80_108_128,0.7,0,128,128,68
12,r_49_85_157,seq48,r_139_84_39,r_49_85_157,0.58,0,157,157,68
30,r_25_86_175,r_27_107_69,r_143_24_25,r_143_24_25,0.63,3,28,25,68
23,r_41_6_117,r_44_62_161,r_28_8_73,r_41_6_117,1,0,117,117,68
59,seq17,seq14,r_137_19_172,r_137_19_172,0.81,1,173,172,69
30,r_83_105_60,seq84,seq100,r_83_105_60,0.9,0,60,60,69
21,r_65_46_48,r_63_107_189,r_49_69_179,r_65_46_48,0.87,0,48,48,69
14,r_148_35_94,r_149_68_138,r_99_36_8,r_148_35_94,0.89,-2,92,94,69
8,r_124_51_149,r_125_147_163,r_106_52_4,r_125_147_163,0.49,-14,149,163,69
16,r_128_45_141,seq130,r_65_46_48,r_128_45_141,0.81,0,141,141,69
39,r_49_69_179,r_50_20_175,r_65_46_48,r_65_46_48,1,21,69,48,69
1,r_119_53_142,r_120_93_159,r_106_52_4,r_120_93_159,0.74,-17,142,159,69
32,r_121_144_16,r_119_53_142,seq146,r_121_144_16,0.73,0,16,16,69
42,r_137_19_172,seq132,seq17,r_137_19_172,0.21,0,172,172,69
38,r_74_123_38,r_71_73_117,r_125_147_163,r_74_123_38,1,1,39,38,69
69,seq41,r_44_31_148,r_148_35_94,r_148_35_94,1,84,178,94,69
19,r_16_22_91,r_18_118_155,seq23,r_16_22_91,0.95,0,91,91,69
95,seq113,seq115,r_136_114_18,r_136_114_18,0.47,105,123,18,69
38,r_74_123_38,r_125_147_163,r_142_143_57,r_74_123_38,0.56,120,158,38,69
39,r_49_69_179,r_65_46_48,r_108_67_77,r_49_69_179,0.65,0,179,179,69
31,r_109_94_87,r_108_67_77,r_136_114_18,r_109_94_87,0.38,-10,77,87,69
3,r_9_87_179,seq6,r_60_97_98,r_60_97_98,0.77,83,181,98,69
26,r_37_66_154,r_99_36_8,r_108_67_77,r_99_36_8,0.83,146,154,8,69
0,r_30_5_73,r_28_104_133,seq6,r_30_5_73,0.98,0,73,73,69
15,r_102_10_130,seq100,r_30_5_73,r_102_10_130,0.67,0,130,130,69
93,seq110,r_108_67_77,r_136_114_18,r_136_114_18,0.85,1,19,18,69
21,r_65_46_48,r_49_69_179,r_128_45_141,r_128_45_141,0.79,38,179,141,69
20,r_136_114_18,r_131_103_107,seq115,r_136_114_18,0.95,0,18,18,69
49,r_15_135_28,r_18_118_155,seq134,r_15_135_28,0.92,0,28,28,69
30,r_83_105_60,seq100,r_28_104_133,r_28_104_133,0.99,7,140,133,69
2,r_125_147_163,r_74_123_38,r_18_118_155,r_74_123_38,0.64,140,178,38,69
35,r_127_29_195,r_126_2_58,seq139,r_126_2_58,1,-2,56,58,69
96,seq115,seq113,r_136_114_18,r_136_114_18,1,0,18,18,69
2,r_125_147_163,r_124_51_149,r_74_123_38,r_74_123_38,0.79,107,145,38,69
40,r_80_40_134,seq78,r_148_35_94,r_80_40_134,0.9,2,136,134,69
74,seq64,r_63_107_189,r_108_67_77,r_108_67_77,1,107,184,77,69
18,r_149_68_138,r_148_35_94,r_108_67_77,r_149_68_138,0.73,0,138,138,69
29,r_60_97_98,r_63_107_189,seq89,r_60_97_98,0.73,0,98,98,69
33,r_48_32_114,r_50_20_175,r_47_33_50,r_50_20_175,0.97,-61,114,175,69
70,seq43,r_44_31_148,r_148_35_94,r_148_35_94,0.97,84,178,94,69
65,seq27,r_28_104_133,r_44_31_148,r_28_104_133,1,1,134,133,69
61,seq21,seq23,r_50_20_175,r_50_20_175,0.64,0,175,175,69
10,r_138_76_14,r_131_103_107,seq78,r_138_76_14,0.94,0,14,14,69
31,r_109_94_87,r_136_114_18,seq95,r_109_94_87,0.58,0,87,87,69
25,r_140_82_42,r_141_39_147,seq81,r_140_82_42,0.99,0,42,42,69
75,seq139,r_141_39_147,r_142_143_57,r_141_39_147,1,-10,137,147,69
17,r_141_39_147,seq139,r_148_35_94,r_141_39_147,0.82,0,147,147,69
9,r_131_103_107,seq132,seq100,r_131_103_107,0.94,3,110,107,69
48,r_42_77_54,r_37_66_154,seq78,r_42_77_54,1,0,54,54,69
5,r_126_2_58,r_127_29_195,seq0,r_126_2_58,0.97,0,58,58,69
7,r_108_67_77,r_109_94_87,seq61,r_108_67_77,0.96,0,77,77,69
46,r_112_24_27,seq111,seq25,r_112_24_27,0.99,0,27,27,69
30,r_12_0_113,seq11,r_83_1_38,r_83_1_38,1,77,115,38,70
44,r_148_25_106,r_21_149_39,r_28_27_147,r_148_25_106,1,0,106,106,70
23,r_83_1_38,r_82_97_86,r_15_112_171,r_83_1_38,1,0,38,38,70
51,seq131,r_134_7_132,r_142_133_120,r_134_7_132,0.62,0,132,132,70
36,r_19_78_183,seq23,r_66_80_106,r_19_78_183,0.44,0,183,183,70
14,r_134_7_132,seq131,r_30_5_51,r_134_7_132,0.97,0,132,132,70
8,r_67_121_80,r_68_146_131,seq122,r_67_121_80,0.98,0,80,80,70
43,r_47_56_60,seq45,seq55,r_47_56_60,0.59,31,91,60,70
37,r_82_97_86,seq77,seq98,r_82_97_86,0.77,1,87,86,70
55,seq11,r_12_0_113,r_42_16_74,r_42_16_74,1,39,113,74,70
71,seq59,r_57_93_109,r_43_60_78,r_57_93_109,1,-1,108,109,70
39,r_68_146_131,seq69,r_13_147_101,r_68_146_131,1,0,131,131,70
1,r_20_70_115,r_19_78_183,seq69,r_20_70_115,0.98,0,115,115,70
97,seq122,r_124_110_174,r_67_121_80,r_67_121_80,1,9,89,80,70
5,r_130_54_59,r_134_7_132,seq50,r_130_54_59,1,1,60,59,70
42,r_144_138_106,seq143,seq136,r_144_138_106,0.64,0,106,106,70
18,r_24_46_35,seq26,seq45,r_24_46_35,1,0,35,35,70
7,r_124_110_174,r_51_123_46,r_139_109_74,r_139_109_74,1,100,174,74,70
45,r_57_93_109,seq59,r_3_94_45,r_3_94_45,0.75,64,109,45,70
13,r_30_5_51,seq29,seq6,r_30_5_51,1,0,51,51,70
19,r_14_63_130,r_15_112_171,seq64,r_14_63_130,0.9,0,130,130,70
44,r_148_25_106,r_134_7_132,r_21_149_39,r_21_149_39,1,7,46,39,70
27,r_3_94_45,seq4,seq89,r_3_94_45,1,0,45,45,70
31,r_74_84_83,seq77,r_3_94_45,r_3_94_45,0.63,59,104,45,70
41,r_135_9_94,seq136,seq8,r_135_9_94,0.95,0,94,94,70
67,seq45,r_53_132_161,r_24_46_35,r_24_46_35,0.8,13,48,35,70
10,r_142_133_120,seq143,seq136,r_142_133_120,0.7,0,120,120,70
90,seq107,r_106_37_141,seq104,r_106_37_141,1,0,141,141,70
26,r_95_48_170,seq98,r_130_54_59,r_130_54_59,0.61,111,170,59,70
0,r_117_41_181,seq116,r_130_54_59,r_130_54_59,0.73,122,181,59,70
63,seq33,r_34_101_123,seq36,r_34_101_123,1,-1,122,123,70
11,r_53_132_161,seq50,r_142_133_120,r_53_132_161,0.86,0,161,161,70
22,r_76_58_51,seq75,seq59,r_76_58_51,0.75,0,51,51,70
12,r_21_149_39,r_148_25_106,r_13_147_101,r_21_149_39,1,67,106,39,70
21,r_38_87_28,r_53_132_161,seq86,r_53_132_161,0.69,-133,28,161,70
2,r_22_10_105,r_20_70_115,r_135_9_94,r_22_10_105,0.99,0,105,105,70
33,r_129_44_58,seq126,seq39,r_129_44_58,0.99,0,58,58,70
74,seq65,r_66_80_106,seq64,r_66_80_106,0.66,0,106,106,70
29,r_42_16_74,r_53_132_161,seq8,r_42_16_74,0.95,0,74,74,70
32,r_13_147_101,seq141,r_68_146_131,r_68_146_131,1,2,133,131,70
53,seq6,seq8,r_30_5_51,r_30_5_51,1,2,53,51,70
24,r_92_115_176,seq89,r_118_114_9,r_92_115_176,0.71,0,176,176,70
25,r_15_112_171,r_14_63_130,r_42_16_74,r_42_16_74,0.99,20,94,74,70
48,r_51_123_46,r_124_110_174,seq120,r_124_110_174,0.55,1,175,174,70
12,r_21_149_39,r_20_70_115,r_148_25_106,r_21_149_39,1,0,39,39,70
88,seq102,seq104,r_34_101_123,r_34_101_123,0.89,5,128,123,70
28,r_49_127_46,r_53_132_161,r_35_128_44,r_53_132_161,0.98,-115,46,161,70
58,seq23,r_19_78_183,r_28_27_147,r_19_78_183,0.57,0,183,183,70
68,seq136,r_137_52_73,r_85_140_18,r_137_52_73,1,-1,72,73,70
32,r_13_147_101,r_12_0_113,seq141,r_13_147_101,0.97,0,101,101,70
38,r_103_61_123,seq104,r_43_60_78,r_103_61_123,0.93,0,123,123,70
34,r_139_109_74,seq136,seq108,r_139_109_74,0.95,0,74,74,70
3,r_105_96_32,r_106_37_141,seq98,r_105_96_32,1,1,33,32,70
48,r_51_123_46,r_53_132_161,r_124_110_174,r_51_123_46,0.99,0,46,46,70
17,r_34_101_123,seq33,seq102,r_34_101_123,0.98,0,123,123,70
25,r_15_112_171,r_42_16_74,seq111,r_15_112_171,0.99,0,171,171,70
96,seq120,r_124_110_174,r_67_121_80,r_67_121_80,1,74,154,80,70
16,r_88_17_35,r_92_115_176,seq8,r_88_17_35,0.99,0,35,35,70
9,r_85_140_18,r_88_17_35,seq136,r_85_140_18,0.98,0,18,18,70
85,seq98,r_95_48_170,r_105_96_32,r_105_96_32,0.93,16,48,32,70
35,r_106_37_141,seq107,seq36,r_106_37_141,0.69,0,141,141,70
23,r_83_1_38,r_15_112_171,r_12_0_113,r_12_0_113,0.46,4,117,113,70
7,r_124_110_174,seq120,r_51_123_46,r_51_123_46,1,0,46,46,70
26,r_55_75_26,seq56,seq77,r_55_75_26,0.96,0,26,26,71
36,r_1_90_168,seq0,r_85_86_89,r_85_86_89,0.81,79,168,89,71
13,r_95_28_111,r_85_86_89,r_121_27_16,r_95_28_111,1,0,111,111,71
83,seq89,r_87_24_162,r_85_86_89,r_87_24_162,0.5,0,162,162,71
37,r_73_12_138,seq72,r_25_5_65,r_73_12_138,0.86,0,138,138,71
6,r_25_5_65,r_32_62_121,r_11_7_103,r_25_5_65,1,0,65,65,71
5,r_121_27_16,seq120,r_29_74_101,r_121_27_16,0.95,0,16,16,71
11,r_142_40_11,r_143_138_180,seq41,r_142_40_11,0.95,-1,10,11,71
69,seq44,r_39_18_144,r_26_45_54,r_26_45_54,0.99,0,54,54,71
16,r_93_20_76,seq92,r_21_103_124,r_93_20_76,0.99,0,76,76,71
21,r_96_43_71,r_95_28_111,r_142_40_11,r_96_43_71,1,0,71,71,71
1,r_98_82_146,seq101,seq81,r_98_82_146,0.7,0,146,146,71
46,r_87_24_162,seq89,r_23_35_13,r_87_24_162,0.52,0,162,162,71
42,r_78_2_79,seq77,seq0,r_78_2_79,1,0,79,79,71
43,r_58_80_40,r_60_46_121,seq77,r_58_80_40,1,0,40,40,71
45,r_29_74_101,r_32_62_121,r_106_67_61,r_106_67_61,0.62,41,102,61,71
19,r_143_138_180,seq145,seq139,r_143_138_180,0.21,0,180,180,71
8,r_131_22_21,seq135,r_23_35_13,r_131_22_21,0.91,0,21,21,71
66,seq37,r_42_134_123,r_112_36_84,r_112_36_84,1,1,85,84,71
35,r_33_119_46,r_29_74_101,seq120,r_33_119_46,0.98,0,46,46,71
31,r_124_83_142,seq125,seq92,r_124_83_142,0.52,10,152,142,71
41,r_117_127_103,seq118,r_59_126_5,r_117_127_103,0.53,0,103,103,71
30,r_60_46_121,r_58_80_40,r_146_57_34,r_60_46_121,0.99,-87,34,121,71
3,r_32_62_121,seq34,seq61,r_32_62_121,0.93,0,121,121,71
14,r_109_52_21,r_117_127_103,seq50,r_109_52_21,0.99,0,21,21,71
0,r_42_134_123,seq41,seq135,r_42_134_123,0.83,1,124,123,71
13,r_95_28_111,r_96_43_71,r_85_86_89,r_96_43_71,1,0,71,71,71
15,r_102_149_158,seq105,r_141_148_36,r_102_149_158,0.49,1,159,158,71
48,r_99_104_85,r_98_82_146,seq105,r_98_82_146,0.99,-75,71,146,71
2,r_59_126_5,r_124_83_142,r_117_127_103,r_59_126_5,0.77,127,132,5,71
99,seq125,r_124_83_142,seq122,r_124_83_142,0.77,0,142,142,71
5,r_121_27_16,r_29_74_101,r_123_30_69,r_121_27_16,1,85,101,16,71
27,r_123_30_69,r_124_83_142,r_121_27_16,r_123_30_69,1,0,69,69,71
30,r_60_46_121,r_146_57_34,r_26_45_54,r_60_46_121,1,0,121,121,71
41,r_117_127_103,r_59_126_5,r_14_128_167,r_14_128_167,1,0,167,167,71
18,r_63_94_160,seq61,r_85_86_89,r_63_94_160,0.69,0,160,160,71
29,r_106_67_61,r_123_30_69,seq72,r_106_67_61,0.98,0,61,61,71
24,r_3_31_150,seq0,r_121_27_16,r_121_27_16,0.83,134,150,16,71
82,seq81,seq72,r_98_82_146,r_98_82_146,1,7,153,146,71
6,r_25_5_65,r_26_45_54,r_32_62_121,r_25_5_65,0.58,-40,25,65,71
50,seq0,r_3_31_150,r_78_2_79,r_78_2_79,0.99,41,120,79,71
58,seq139,r_140_144_109,seq129,r_140_144_109,0.35,-34,75,109,71
9,r_21_103_124,r_93_20_76,r_19_100_24,r_21_103_124,1,0,124,124,71
70,seq47,r_60_46_121,r_65_48_61,r_65_48_61,1,3,64,61,71
20,r_146_57_34,r_60_46_121,r_109_52_21,r_60_46_121,1,1,122,121,71
28,r_26_45_54,r_25_5_65,seq44,r_26_45_54,1,0,54,54,71
38,r_65_48_61,r_64_130_80,seq47,r_65_48_61,1,0,61,61,71
34,r_9_54_78,seq6,r_109_52_21,r_9_54_78,0.9,0,78,78,71
75,seq61,r_63_94_160,r_32_62_121,r_32_62_121,0.82,39,160,121,71
60,seq15,r_14_128_167,r_25_5_65,r_25_5_65,1,79,144,65,71
40,r_19_100_24,seq16,seq101,r_19_100_24,0.99,1,25,24,71
16,r_93_20_76,r_21_103_124,seq16,r_21_103_124,1,0,124,124,71
17,r_64_130_80,r_63_94_160,seq135,r_64_130_80,0.69,0,80,80,71
20,r_146_57_34,seq147,r_60_46_121,r_146_57_34,1,0,34,34,71
9,r_21_103_124,seq17,r_93_20_76,r_93_20_76,1,0,76,76,71
7,r_112_36_84,seq114,seq37,r_112_36_84,0.99,0,84,84,71
44,r_14_128_167,seq15,r_117_127_103,r_117_127_103,0.76,64,167,103,71
23,r_68_88_112,r_73_12_138,seq89,r_68_88_112,0.99,0,112,112,71
68,seq41,r_42_134_123,r_142_40_11,r_142_40_11,1,0,11,11,71
12,r_66_113_115,r_73_12_138,seq114,r_66_113_115,1,0,115,115,71
88,seq101,r_98_82_146,r_19_100_24,r_19_100_24,0.99,0,24,24,71
93,seq112,r_110_81_112,r_32_115_97,r_32_115_97,0.99,16,113,97,72
30,r_138_90_116,r_139_100_78,r_68_137_69,r_138_90_116,0.89,-48,68,116,72
36,r_30_87_186,seq34,r_105_31_148,r_105_31_148,0.95,0,148,148,72
48,r_75_67_48,r_76_13_120,seq66,r_76_13_120,0.86,-72,48,120,72
33,r_2_133_35,seq5,seq132,r_2_133_35,1,0,35,35,72
92,seq109,r_110_81_112,r_145_108_105,r_145_108_105,0.98,6,111,105,72
14,r_110_81_112,seq112,r_25_80_49,r_25_80_49,0.99,63,112,49,72
13,r_85_52_164,seq109,seq53,r_85_52_164,0.51,0,164,164,72
8,r_89_148_112,r_88_21_122,seq144,r_89_148_112,1,0,112,112,72
37,r_72_47_195,seq71,r_42_48_105,r_42_48_105,0.51,90,195,105,72
20,r_55_1_183,r_130_56_128,r_129_3_20,r_55_1_183,0.91,0,183,183,72
55,seq9,r_11_70_180,r_91_10_50,r_91_10_50,1,42,92,50,72
16,r_15_95_95,r_16_23_35,seq104,r_15_95_95,0.99,0,95,95,72
21,r_111_123_77,r_110_81_112,seq122,r_111_123_77,1,1,78,77,72
39,r_147_135_86,seq146,r_68_137_69,r_68_137_69,0.51,14,83,69,72
1,r_130_56_128,r_125_126_84,r_55_1_183,r_130_56_128,0.97,0,128,128,72
5,r_57_77_166,r_55_1_183,r_50_78_61,r_55_1_183,0.59,-17,166,183,72
30,r_138_90_116,r_57_77_166,seq63,r_57_77_166,0.85,21,187,166,72
45,r_86_46_155,r_89_148_112,r_85_52_164,r_89_148_112,0.6,0,112,112,72
19,r_105_31_148,seq101,seq35,r_105_31_148,0.93,0,148,148,72
36,r_30_87_186,r_105_31_148,r_138_90_116,r_30_87_186,0.96,1,187,186,72
15,r_59_45_109,r_42_48_105,r_86_46_155,r_86_46_155,0.94,16,171,155,72
43,r_116_18_57,r_130_56_128,seq20,r_116_18_57,0.83,1,58,57,72
31,r_42_48_105,seq44,r_59_45_109,r_59_45_109,0.96,9,118,109,72
41,r_32_115_97,r_30_87_186,seq113,r_32_115_97,1,1,98,97,72
3,r_62_49_188,seq61,r_134_106_161,r_134_106_161,0.78,26,187,161,72
10,r_76_13_120,r_72_47_195,seq12,r_76_13_120,0.98,0,120,120,72
90,seq101,seq97,r_117_102_118,r_117_102_118,1,14,132,118,72
1,r_130_56_128,r_55_1_183,r_0_58_167,r_130_56_128,0.9,56,184,128,72
26,r_142_54_185,seq141,r_85_52_164,r_85_52_164,0.95,21,185,164,72
0,r_131_136_133,seq132,r_68_137_69,r_131_136_133,0.82,0,133,133,72
20,r_55_1_183,r_57_77_166,r_130_56_128,r_130_56_128,1,38,166,128,72
15,r_59_45_109,r_57_77_166,r_42_48_105,r_59_45_109,0.97,0,109,109,72
57,seq141,r_142_54_185,r_107_143_10,r_107_143_10,0.52,76,86,10,72
13,r_85_52_164,r_89_148_112,seq109,r_89_148_112,0.79,0,112,112,72
6,r_118_43_195,r_117_102_118,r_125_126_84,r_117_102_118,1,0,118,118,72
62,seq132,r_134_106_161,r_2_133_35,r_2_133_35,0.79,126,161,35,72
45,r_86_46_155,r_85_52_164,r_59_45_109,r_86_46_155,0.98,0,155,155,72
17,r_14_149_44,r_15_95_95,seq144,r_14_149_44,1,0,44,44,72
27,r_134_106_161,seq132,r_28_103_95,r_134_106_161,0.8,0,161,161,72
30,r_138_90_116,r_68_137_69,r_57_77_166,r_138_90_116,0.97,0,116,116,72
4,r_25_80_49,r_27_24_212,seq79,r_25_80_49,1,0,49,49,72
40,r_0_58_167,seq5,r_130_56_128,r_0_58_167,0.62,0,167,167,72
74,seq61,r_62_49_188,r_75_67_48,r_75_67_48,0.67,136,184,48,72
18,r_119_19_93,r_130_56_128,r_116_18_57,r_119_19_93,0.84,0,93,93,72
29,r_28_103_95,r_30_87_186,seq104,r_28_103_95,0.95,0,95,95,72
24,r_129_3_20,r_130_56_128,seq5,r_129_3_20,0.98,0,20,20,72
25,r_117_102_118,r_118_43_195,seq101,r_117_102_118,1,0,118,118,72
44,r_107_143_10,r_94_37_165,seq141,r_107_143_10,0.97,0,10,10,72
30,r_138_90_116,seq63,r_30_87_186,r_30_87_186,0.7,7,193,186,72
47,r_16_23_35,seq44,seq26,r_16_23_35,0.47,22,57,35,72
49,r_91_10_50,seq92,seq9,r_91_10_50,1,0,50,50,72
9,r_94_37_165,seq101,r_38_39_195,r_94_37_165,0.72,0,165,165,72
82,seq79,seq82,r_25_80_49,r_25_80_49,1,0,49,49,72
13,r_85_52_164,r_86_46_155,r_89_148_112,r_89_148_112,0.65,-62,50,112,72
32,r_27_24_212,r_25_80_49,seq26,r_25_80_49,0.91,-38,11,49,72
22,r_140_128_79,r_139_100_78,r_125_126_84,r_140_128_79,0.99,3,82,79,72
28,r_120_96_195,seq121,r_15_95_95,r_15_95_95,0.91,100,195,95,72
91,seq104,seq101,r_28_103_95,r_28_103_95,1,72,167,95,72
56,seq12,r_11_70_180,r_76_13_120,r_76_13_120,0.93,7,127,120,72
7,r_88_21_122,r_89_148_112,r_86_46_155,r_88_21_122,0.5,-11,111,122,72
23,r_68_137_69,seq65,r_138_90_116,r_68_137_69,0.98,0,69,69,72
35,r_139_100_78,seq144,seq101,r_139_100_78,1,0,78,78,72
12,r_145_108_105,seq144,seq109,r_145_108_105,0.97,1,106,105,72
23,r_68_137_69,r_138_90_116,r_147_135_86,r_138_90_116,1,0,116,116,72
36,r_67_110_110,r_127_66_2,r_112_11_154,r_67_110_110,0.36,0,110,110,73
8,r_74_15_164,seq73,r_47_14_111,r_47_14_111,0.56,55,166,111,73
17,r_28_41_36,r_36_16_103,r_119_40_40,r_36_16_103,0.97,-16,87,103,73
40,r_36_16_103,r_119_40_40,r_23_13_15,r_119_40_40,0.64,74,114,40,73
16,r_103_80_150,seq104,r_49_102_94,r_103_80_150,0.47,-54,96,150,73
39,r_90_141_110,r_91_146_136,seq142,r_90_141_110,0.81,0,110,110,73
15,r_112_11_154,r_144_68_83,r_47_14_111,r_112_11_154,0.76,-1,153,154,73
1,r_8_133_110,seq9,r_86_139_54,r_8_133_110,0.88,0,110,110,73
25,r_125_116_16,r_128_117_137,seq115,r_125_116_16,0.96,0,16,16,73
5,r_38_89_69,r_36_16_103,r_59_92_44,r_38_89_69,0.64,5,74,69,73
46,r_84_32_62,r_87_93_137,seq31,r_84_32_62,0.98,0,62,62,73
80,seq70,seq72,r_17_69_93,r_17_69_93,1,20,113,93,73
45,r_65_101_157,seq64,r_33_100_117,r_65_101_157,0.31,0,157,157,73
7,r_86_139_54,r_87_93_137,seq138,r_86_139_54,1,0,54,54,73
60,seq145,seq147,r_91_146_136,r_91_146_136,1,1,137,136,73
30,r_132_26_36,r_134_39_136,seq25,r_132_26_36,0.98,0,36,36,73
3,r_71_7_181,seq72,r_12_6_50,r_12_6_50,0.9,132,182,50,73
10,r_33_100_117,seq34,seq94,r_33_100_117,0.71,0,117,117,73
14,r_119_40_40,r_121_108_86,r_28_41_36,r_28_41_36,0.55,3,39,36,73
26,r_134_39_136,seq138,r_28_41_36,r_134_39_136,0.53,0,136,136,73
41,r_120_109_48,r_63_10_192,r_121_108_86,r_121_108_86,1,3,89,86,73
4,r_111_21_109,r_112_11_154,seq20,r_112_11_154,0.47,-45,109,154,73
0,r_3_82_113,seq4,r_38_89_69,r_3_82_113,0.66,4,117,113,73
55,seq129,r_128_117_137,r_42_126_14,r_42_126_14,0.99,3,17,14,73
20,r_24_60_126,seq25,seq58,r_24_60_126,0.62,0,126,126,73
18,r_29_46_188,r_28_41_36,seq35,r_29_46_188,0.44,-152,36,188,73
15,r_112_11_154,r_111_21_109,r_144_68_83,r_112_11_154,0.6,-45,109,154,73
2,r_91_146_136,r_59_92_44,seq145,r_91_146_136,0.99,0,136,136,73
21,r_59_92_44,seq58,r_91_146_136,r_59_92_44,0.87,6,50,44,73
12,r_49_102_94,r_103_80_150,seq105,r_49_102_94,0.64,54,148,94,73
21,r_59_92_44,r_91_146_136,r_87_93_137,r_91_146_136,1,0,136,136,73
85,seq81,r_87_93_137,r_17_69_93,r_17_69_93,0.99,23,116,93,73
99,seq122,r_121_108_86,r_125_116_16,r_121_108_86,1,0,86,86,73
57,seq9,r_51_75_48,r_23_13_15,r_23_13_15,0.39,131,146,15,73
16,r_103_80_150,r_49_102_94,seq81,r_103_80_150,0.64,0,150,150,73
87,seq85,r_87_93_137,r_114_88_106,r_114_88_106,1,18,124,106,73
6,r_17_69_93,r_12_6_50,r_23_13_15,r_12_6_50,0.85,0,50,50,73
2,r_91_146_136,r_90_141_110,r_59_92_44,r_91_146_136,0.9,-26,110,136,73
40,r_36_16_103,r_38_89_69,r_119_40_40,r_36_16_103,0.65,-29,74,103,73
36,r_67_110_110,r_112_11_154,r_121_108_86,r_67_110_110,0.67,35,145,110,73
24,r_128_117_137,r_130_98_179,r_125_116_16,r_130_98_179,0.47,-42,137,179,73
64,seq25,r_24_60_126,r_132_26_36,r_132_26_36,0.77,15,51,36,73
28,r_51_75_48,seq53,seq77,r_51_75_48,0.93,0,48,48,73
6,r_17_69_93,r_23_13_15,seq70,r_17_69_93,0.94,0,93,93,73
58,seq138,seq136,r_86_139_54,r_86_139_54,1,30,84,54,73
32,r_127_66_2,r_67_110_110,r_144_68_83,r_127_66_2,0.77,108,110,2,73
31,r_23_13_15,r_19_124_165,r_36_16_103,r_23_13_15,0.74,91,106,15,73
34,r_143_57_134,seq142,r_24_60_126,r_143_57_134,0.45,0,134,134,73
48,r_12_6_50,r_17_69_93,seq4,r_12_6_50,1,0,50,50,73
60,seq145,r_144_68_83,seq147,r_144_68_83,0.97,0,83,83,73
81,seq72,r_71_7_181,r_17_69_93,r_17_69_93,0.99,60,153,93,73
9,r_43_52_98,r_36_16_103,seq50,r_43_52_98,0.51,0,98,98,73
31,r_23_13_15,r_17_69_93,r_19_124_165,r_19_124_165,0.62,-73,92,165,73
22,r_114_88_106,seq122,seq85,r_114_88_106,0.99,0,106,106,73
41,r_120_109_48,r_121_108_86,r_63_10_192,r_120_109_48,1,0,48,48,73
49,r_97_76_119,seq99,r_123_78_58,r_123_78_58,1,61,119,58,73
31,r_23_13_15,seq22,r_17_69_93,r_23_13_15,0.77,1,16,15,73
12,r_49_102_94,seq50,r_103_80_150,r_49_102_94,0.7,2,96,94,73
29,r_42_126_14,r_43_52_98,r_113_131_7,r_42_126_14,0.97,1,15,14,73
17,r_28_41_36,r_29_46_188,r_36_16_103,r_36_16_103,0.72,-66,37,103,73
92,seq105,seq120,r_35_104_100,r_35_104_100,1,2,102,100,74
14,r_94_40_93,seq96,seq37,r_94_40_93,1,0,93,93,74
8,r_89_98_119,r_86_108_199,r_76_102_55,r_76_102_55,0.98,64,119,55,74
17,r_71_19_147,seq78,seq18,r_71_19_147,0.97,0,147,147,74
37,r_50_44_112,seq51,seq42,r_50_44_112,0.38,0,112,112,74
42,r_56_49_173,seq61,r_110_47_82,r_56_49_173,0.57,0,173,173,74
55,seq9,r_10_117_89,seq13,r_10_117_89,1,0,89,89,74
71,seq42,r_43_138_139,r_50_44_112,r_43_138_139,0.63,0,139,139,74
16,r_10_117_89,seq9,seq113,r_10_117_89,1,0,89,89,74
21,r_59_136_61,r_58_131_101,r_139_123_180,r_139_123_180,0.96,-119,61,180,74
39,r_20_116_175,seq21,r_10_117_89,r_10_117_89,0.98,86,175,89,74
1,r_58_131_101,r_57_111_158,seq132,r_58_131_101,1,1,102,101,74
5,r_106_68_76,seq105,seq66,r_106_68_76,1,1,77,76,74
46,r_70_122_152,seq69,seq121,r_70_122_152,0.81,0,152,152,74
42,r_56_49_173,r_57_111_158,seq61,r_57_111_158,0.7,0,158,158,74
32,r_124_32_65,r_45_137_172,r_22_31_118,r_45_137_172,0.67,-24,148,172,74
45,r_143_6_87,r_139_123_180,seq1,r_143_6_87,0.97,0,87,87,74
95,seq115,seq113,r_92_114_152,r_92_114_152,0.78,2,154,152,74
66,seq29,r_28_149_172,r_147_30_41,r_147_30_41,0.79,50,91,41,74
76,seq61,r_60_148_154,r_56_49_173,r_60_148_154,0.7,0,154,154,74
3,r_110_47_82,seq115,seq48,r_110_47_82,1,0,82,82,74
48,r_76_102_55,r_74_36_120,seq99,r_76_102_55,1,0,55,55,74
26,r_74_36_120,seq73,seq37,r_74_36_120,1,0,120,120,74
72,seq135,r_139_123_180,r_130_134_119,r_130_134_119,0.43,39,158,119,74
16,r_10_117_89,seq113,r_20_116_175,r_20_116_175,0.99,4,179,175,74
63,seq21,r_20_116_175,r_147_30_41,r_147_30_41,0.99,136,177,41,74
73,seq48,r_50_44_112,r_110_47_82,r_110_47_82,1,5,87,82,74
11,r_65_54_63,seq66,seq55,r_65_54_63,1,0,63,63,74
20,r_22_31_118,seq23,r_124_32_65,r_124_32_65,0.94,53,118,65,74
98,seq121,r_139_123_180,r_70_122_152,r_70_122_152,0.95,2,154,152,74
15,r_130_134_119,seq132,seq135,r_130_134_119,0.46,33,152,119,74
40,r_24_119_44,seq23,seq120,r_24_119_44,1,0,44,44,74
36,r_72_34_19,r_71_19_147,seq37,r_72_34_19,1,0,19,19,74
17,r_71_19_147,seq78,seq73,r_71_19_147,0.92,-95,52,147,74
6,r_5_125_103,seq1,r_59_136_61,r_5_125_103,1,0,103,103,74
76,seq61,r_56_49_173,r_27_62_173,r_56_49_173,0.47,0,173,173,74
21,r_59_136_61,r_139_123_180,r_45_137_172,r_45_137_172,1,8,180,172,74
85,seq83,r_85_4_157,r_88_82_186,r_85_4_157,0.87,0,157,157,74
31,r_147_30_41,r_139_123_180,seq29,r_147_30_41,1,0,41,41,74
87,seq93,r_92_114_152,seq90,r_92_114_152,0.43,0,152,152,74
22,r_139_123_180,r_59_136_61,r_3_142_50,r_59_136_61,0.37,119,180,61,74
47,r_85_4_157,seq83,seq1,r_85_4_157,0.52,0,157,157,74
74,seq51,r_50_44_112,r_84_46_49,r_84_46_49,1,56,105,49,74
18,r_97_64_76,seq120,r_133_63_60,r_97_64_76,0.95,1,77,76,74
29,r_53_87_166,seq55,r_86_108_199,r_53_87_166,0.65,0,166,166,74
24,r_11_126_180,seq13,r_58_131_101,r_11_126_180,0.44,0,180,180,74
33,r_133_63_60,r_139_123_180,seq66,r_133_63_60,1,0,60,60,74
64,seq23,r_22_31_118,r_147_30_41,r_147_30_41,0.82,77,118,41,74
88,seq96,r_94_40_93,seq115,r_94_40_93,0.98,0,93,93,74
32,r_124_32_65,r_139_123_180,r_45_137_172,r_124_32_65,1,0,65,65,74
38,r_57_111_158,r_56_49_173,r_91_112_152,r_57_111_158,0.71,0,158,158,74
51,seq1,r_3_142_50,r_5_125_103,r_3_142_50,1,0,50,50,74
75,seq55,r_53_87_166,r_65_54_63,r_65_54_63,1,18,81,63,74
79,seq69,r_70_122_152,seq66,r_70_122_152,0.99,-99,53,152,74
9,r_28_149_172,r_27_62_173,r_60_148_154,r_28_149_172,0.76,0,172,172,74
10,r_3_142_50,seq1,seq141,r_3_142_50,0.98,0,50,50,74
44,r_84_46_49,r_85_4_157,seq48,r_84_46_49,1,1,50,49,74
22,r_139_123_180,r_130_134_119,r_59_136_61,r_59_136_61,1,0,61,61,74
27,r_60_148_154,r_146_2_181,r_28_149_172,r_60_148_154,0.65,27,181,154,74
28,r_43_138_139,seq42,r_59_136_61,r_43_138_139,0.65,0,139,139,74
7,r_45_137_172,seq42,r_59_136_61,r_45_137_172,0.55,0,172,172,74
23,r_35_104_100,seq37,seq105,r_35_104_100,0.92,0,100,100,74
84,seq80,r_81_0_158,r_88_82_186,r_81_0_158,0.58,0,158,158,74
65,seq25,r_20_116_175,r_147_30_41,r_147_30_41,0.91,14,55,41,74
37,r_94_55_78,r_93_46_55,seq95,r_93_46_55,1,-8,47,55,75
40,r_62_38_166,r_145_63_79,seq39,r_62_38_166,0.93,0,166,166,75
30,r_145_63_79,seq143,r_62_38_166,r_145_63_79,0.98,0,79,79,75
14,r_84_15_72,seq83,seq18,r_84_15_72,1,0,72,72,75
8,r_35_75_104,r_36_27_149,seq72,r_35_75_104,1,0,104,104,75
10,r_17_3_67,r_1_22_117,r_71_2_107,r_17_3_67,0.99,52,119,67,75
39,r_142_92_60,r_145_63_79,r_91_136_165,r_142_92_60,0.89,0,60,60,75
1,r_120_51_95,seq117,r_122_49_22,r_120_51_95,0.96,0,95,95,75
5,r_71_2_107,seq72,r_17_3_67,r_71_2_107,0.83,0,107,107,75
42,r_100_85_183,r_101_77_188,r_130_82_44,r_130_82_44,1,138,182,44,75
32,r_122_49_22,seq52,r_120_51_95,r_122_49_22,0.72,73,95,22,75
45,r_104_33_105,seq108,seq34,r_104_33_105,1,1,106,105,75
15,r_1_22_117,r_17_3_67,seq21,r_1_22_117,1,0,117,117,75
33,r_36_27_149,r_60_37_91,seq29,r_36_27_149,0.88,0,149,149,75
11,r_9_28_183,r_141_10_12,r_36_27_149,r_36_27_149,0.83,34,183,149,75
38,r_69_134_23,r_133_50_144,seq127,r_133_50_144,1,-11,133,144,75
39,r_142_92_60,r_91_136_165,r_130_82_44,r_91_136_165,0.98,0,165,165,75
31,r_105_81_73,r_104_33_105,r_130_82_44,r_105_81_73,1,-1,72,73,75
37,r_94_55_78,seq95,seq59,r_94_55_78,0.97,0,78,78,75
67,seq29,r_31_61_158,r_36_27_149,r_31_61_158,0.53,0,158,158,75
89,seq99,r_101_77_188,r_119_98_125,r_119_98_125,0.59,-22,103,125,75
44,r_0_11_57,r_1_22_117,seq13,r_0_11_57,0.6,0,57,57,75
3,r_57_126_112,seq59,seq139,r_57_126_112,0.51,2,114,112,75
32,r_122_49_22,seq127,seq52,r_122_49_22,0.92,2,24,22,75
4,r_101_77_188,seq99,r_90_102_71,r_90_102_71,0.99,3,74,71,75
63,seq21,r_25_48_178,r_1_22_117,r_1_22_117,0.95,0,117,117,75
20,r_40_16_140,seq39,r_84_15_72,r_40_16_140,0.89,0,140,140,75
13,r_30_43_103,r_31_61_158,seq45,r_30_43_103,0.8,0,103,103,75
48,r_86_113_200,seq87,r_130_82_44,r_130_82_44,1,57,101,44,75
49,r_133_50_144,r_69_134_23,r_120_51_95,r_133_50_144,0.63,0,144,144,75
4,r_101_77_188,r_90_102_71,r_130_82_44,r_130_82_44,0.56,144,188,44,75
6,r_112_4_62,r_105_81_73,seq6,r_112_4_62,1,-1,61,62,75
96,seq117,r_116_53_176,r_80_121_12,r_80_121_12,0.65,16,28,12,75
41,r_144_131_26,r_145_63_79,seq128,r_145_63_79,0.94,-53,26,79,75
27,r_47_140_81,seq45,seq147,r_47_140_81,1,0,81,81,75
30,r_145_63_79,r_62_38_166,r_31_61_158,r_145_63_79,0.93,87,166,79,75
11,r_9_28_183,seq5,r_141_10_12,r_141_10_12,0.8,6,18,12,75
47,r_119_98_125,seq117,seq99,r_119_98_125,0.6,1,126,125,75
40,r_62_38_166,seq67,r_145_63_79,r_145_63_79,1,2,81,79,75
24,r_129_56_165,seq128,r_94_55_78,r_129_56_165,0.54,0,165,165,75
34,r_141_10_12,r_9_28_183,r_84_15_72,r_84_15_72,1,109,181,72,75
25,r_91_136_165,r_94_55_78,r_142_92_60,r_91_136_165,1,-104,61,165,75
33,r_36_27_149,r_35_75_104,r_60_37_91,r_36_27_149,0.93,-45,104,149,75
48,r_86_113_200,seq87,r_78_111_32,r_86_113_200,0.35,0,200,200,75
22,r_80_121_12,r_96_138_205,seq117,r_80_121_12,0.79,4,16,12,75
21,r_93_46_55,r_94_55_78,seq45,r_93_46_55,1,0,55,55,75
50,seq128,r_129_56_165,r_144_131_26,r_129_56_165,0.67,0,165,165,75
70,seq39,r_40_16_140,seq41,r_40_16_140,0.88,-25,115,140,75
15,r_1_22_117,r_0_11_57,r_17_3_67,r_1_22_117,0.59,-60,57,117,75
65,seq24,r_25_48_178,r_1_22_117,r_1_22_117,0.99,61,178,117,75
29,r_130_82_44,r_129_56_165,seq79,r_130_82_44,1,0,44,44,75
38,r_69_134_23,seq70,r_133_50_144,r_69_134_23,1,0,23,23,75
18,r_14_109_30,r_12_124_96,seq110,r_14_109_30,1,0,30,30,75
17,r_42_44_90,seq39,seq45,r_42_44_90,0.77,0,90,90,75
25,r_91_136_165,r_142_92_60,seq137,r_91_136_165,0.96,0,165,165,75
86,seq87,r_90_102_71,r_106_88_9,r_106_88_9,0.61,8,17,9,75
34,r_141_10_12,seq149,r_9_28_183,r_141_10_12,0.99,0,12,12,75
28,r_90_102_71,seq87,r_101_77_188,r_90_102_71,0.91,3,74,71,75
49,r_133_50_144,seq127,r_69_134_23,r_69_134_23,1,-4,19,23,75
46,r_118_66_22,r_116_53_176,seq67,r_118_66_22,0.89,6,28,22,75
72,seq45,r_93_46_55,r_30_43_103,r_30_43_103,0.99,18,121,103,75
59,seq143,r_145_63_79,seq147,r_145_63_79,1,-37,42,79,75
23,r_31_61_158,seq29,r_145_63_79,r_31_61_158,0.92,0,158,158,75
7,r_78_111_32,seq79,r_115_107_19,r_78_111_32,0.83,1,33,32,75
48,r_86_113_200,r_130_82_44,seq87,r_86_113_200,0.48,-76,124,200,75
35,r_12_124_96,seq13,seq125,r_12_124_96,0.98,0,96,96,75
82,seq73,seq72,r_64_74_41,r_64_74_41,0.97,-7,34,41,75
43,r_132_123_49,r_129_56_165,seq125,r_132_123_49,0.64,-1,48,49,75
12,r_25_48_178,seq24,r_30_43_103,r_30_43_103,0.9,75,178,103,75
37,r_97_145_47,r_96_53_139,seq144,r_97_145_47,1,0,47,47,76
51,seq131,r_129_109_174,r_93_132_152,r_93_132_152,0.81,22,174,152,76
0,r_99_60_11,r_101_104_107,seq61,r_99_60_11,0.84,0,11,11,76
30,r_121_39_41,r_35_128_108,r_113_38_70,r_121_39_41,0.72,35,76,41,76
14,r_35_128_108,r_17_69_146,r_121_39_41,r_121_39_41,1,4,45,41,76
59,seq142,r_143_138_174,r_17_69_146,r_17_69_146,0.9,33,179,146,76
16,r_5_119_146,seq6,seq115,r_5_119_146,0.83,0,146,146,76
21,r_93_132_152,r_91_123_180,seq131,r_93_132_152,0.55,0,152,152,76
97,seq115,r_116_112_117,seq118,r_116_112_117,0.69,1,118,117,76
5,r_116_112_117,seq115,r_76_110_69,r_76_110_69,0.91,49,118,69,76
42,r_65_8_112,seq66,seq6,r_65_8_112,0.99,-1,111,112,76
45,r_117_108_76,seq118,r_76_110_69,r_76_110_69,0.74,7,76,69,76
19,r_11_49_119,seq13,seq51,r_11_49_119,0.89,0,119,119,76
95,seq105,r_106_14_83,seq98,r_106_14_83,1,1,84,83,76
76,seq59,r_63_33_135,r_148_57_3,r_63_33_135,0.94,0,135,135,76
35,r_43_29_46,r_46_74_46,r_1_28_14,r_43_29_46,1,0,46,46,76
31,r_63_33_135,seq61,seq31,r_63_33_135,0.97,0,135,135,76
6,r_27_55_31,r_17_69_146,r_63_33_135,r_63_33_135,0.48,-104,31,135,76
14,r_35_128_108,r_121_39_41,seq131,r_35_128_108,1,0,108,108,76
4,r_133_16_77,r_137_100_151,seq15,r_133_16_77,1,1,78,77,76
20,r_76_110_69,seq77,seq111,r_76_110_69,0.99,0,69,69,76
98,seq118,r_117_108_76,seq115,r_117_108_76,0.92,0,76,76,76
15,r_136_146_149,r_137_100_151,r_87_147_103,r_136_146_149,0.59,0,149,149,76
91,seq89,r_88_36_112,seq92,r_88_36_112,0.94,-72,40,112,76
52,seq4,seq2,r_64_3_23,r_64_3_23,0.99,19,42,23,76
26,r_127_30_30,r_129_109_174,seq32,r_127_30_30,0.99,0,30,30,76
99,seq125,r_124_40_97,seq131,r_124_40_97,1,0,97,97,76
9,r_46_74_46,r_42_24_151,seq80,r_46_74_46,0.96,0,46,46,76
6,r_27_55_31,r_99_60_11,r_148_57_3,r_99_60_11,0.35,137,148,11,76
36,r_96_53_139,seq98,seq54,r_96_53_139,0.71,0,139,139,76
27,r_18_120_103,r_17_69_146,seq115,r_18_120_103,1,0,103,103,76
87,seq80,r_79_34_131,seq77,r_79_34_131,1,0,131,131,76
88,seq81,r_75_37_55,r_140_82_12,r_75_37_55,1,0,55,55,76
2,r_17_69_146,r_18_120_103,r_133_16_77,r_133_16_77,0.43,5,82,77,76
47,r_91_123_180,seq92,r_5_119_146,r_5_119_146,0.7,35,181,146,76
40,r_83_7_118,r_84_126_163,r_65_8_112,r_83_7_118,0.81,0,118,118,76
18,r_122_20_171,seq115,r_42_24_151,r_122_20_171,0.48,1,172,171,76
24,r_129_109_174,seq131,r_116_112_117,r_129_109_174,0.36,0,174,174,76
33,r_87_147_103,seq86,seq142,r_87_147_103,0.99,0,103,103,76
13,r_140_82_12,r_133_16_77,seq81,r_140_82_12,0.85,-2,10,12,76
30,r_121_39_41,r_122_20_171,r_35_128_108,r_121_39_41,0.86,1,42,41,76
50,seq2,seq4,r_90_0_104,r_90_0_104,1,1,105,104,76
61,seq144,r_143_138_174,r_97_145_47,r_97_145_47,1,103,150,47,76
38,r_94_73_190,r_95_102_98,seq92,r_95_102_98,0.98,1,99,98,76
60,seq15,r_17_69_146,r_133_16_77,r_133_16_77,0.65,2,79,77,76
17,r_95_102_98,r_94_73_190,seq103,r_95_102_98,0.95,1,99,98,76
94,seq103,r_101_104_107,r_95_102_98,r_95_102_98,0.98,9,107,98,76
22,r_90_0_104,r_93_132_152,seq2,r_90_0_104,1,1,105,104,76
10,r_75_37_55,seq81,r_121_39_41,r_75_37_55,0.96,0,55,55,76
28,r_113_38_70,seq111,r_121_39_41,r_113_38_70,0.59,0,70,70,76
34,r_64_3_23,r_63_33_135,seq4,r_64_3_23,0.98,0,23,23,76
7,r_106_14_83,seq105,seq13,r_106_14_83,1,1,84,83,76
44,r_84_126_163,r_83_7_118,seq85,r_83_7_118,0.77,0,118,118,76
23,r_42_24_151,r_45_41_122,r_21_19_109,r_42_24_151,0.9,0,151,151,76
6,r_27_55_31,r_63_33_135,r_99_60_11,r_99_60_11,0.39,44,55,11,76
43,r_1_28_14,seq4,r_43_29_46,r_43_29_46,1,5,51,46,76
36,r_96_53_139,r_97_145_47,seq98,r_97_145_47,0.91,-12,35,47,76
2,r_17_69_146,r_133_16_77,r_114_70_105,r_17_69_146,0.95,0,146,146,76
12,r_137_100_151,seq135,r_95_102_98,r_137_100_151,0.78,1,152,151,76
3,r_107_47_42,r_122_20_171,seq44,r_107_47_42,0.99,0,42,42,76
30,r_26_25_173,seq23,r_130_14_54,r_130_14_54,1,120,174,54,77
36,r_149_134_131,seq147,seq136,r_149_134_131,0.56,0,131,131,77
8,r_123_125_135,seq117,r_27_124_121,r_27_124_121,1,12,133,121,77
37,r_56_146_171,r_58_113_130,seq64,r_58_113_130,0.98,0,130,130,77
34,r_103_19_24,seq102,seq17,r_103_19_24,0.99,0,24,24,77
71,seq50,r_51_67_159,r_148_49_57,r_148_49_57,1,103,160,57,77
16,r_119_68_155,seq118,r_88_71_33,r_119_68_155,0.9,0,155,155,77
39,r_53_28_97,r_51_67_159,r_130_14_54,r_53_28_97,0.78,0,97,97,77
46,r_8_43_135,seq11,r_116_44_24,r_8_43_135,0.66,1,136,135,77
6,r_42_36_49,r_39_57_206,r_35_30_163,r_42_36_49,0.55,7,56,49,77
43,r_89_107_41,seq87,seq104,r_89_107_41,1,0,41,41,77
0,r_88_71_33,r_85_47_39,r_66_72_148,r_88_71_33,0.86,0,33,33,77
41,r_83_0_121,r_76_79_194,r_32_6_43,r_83_0_121,0.65,1,122,121,77
3,r_84_96_72,seq87,seq95,r_84_96_72,1,0,72,72,77
26,r_108_59_181,seq104,r_77_63_158,r_108_59_181,0.65,0,181,181,77
4,r_15_111_88,r_16_132_133,seq115,r_15_111_88,1,0,88,88,77
11,r_35_30_163,seq34,r_130_14_54,r_130_14_54,1,109,163,54,77
20,r_120_106_113,seq121,r_89_107_41,r_89_107_41,1,72,113,41,77
13,r_3_86_116,r_4_1_189,seq87,r_3_86_116,0.67,0,116,116,77
48,r_12_126_29,r_3_86_116,seq121,r_12_126_29,1,0,29,29,77
23,r_116_44_24,r_123_125_135,r_39_57_206,r_116_44_24,1,0,24,24,77
62,seq31,r_32_6_43,r_130_14_54,r_130_14_54,1,21,75,54,77
45,r_105_141_14,r_110_69_203,r_37_142_10,r_105_141_14,0.87,-3,11,14,77
27,r_16_132_133,r_24_13_160,r_2_131_51,r_24_13_160,0.87,-27,133,160,77
22,r_144_93_164,seq147,r_84_96_72,r_144_93_164,0.89,0,164,164,77
2,r_77_63_158,r_76_79_194,seq61,r_77_63_158,0.65,0,158,158,77
47,r_27_124_121,r_24_13_160,r_12_126_29,r_27_124_121,0.65,0,121,121,77
14,r_148_49_57,r_149_134_131,seq50,r_148_49_57,1,0,57,57,77
40,r_58_113_130,r_56_146_171,r_133_114_108,r_58_113_130,0.97,0,130,130,77
6,r_42_36_49,r_35_30_163,seq31,r_42_36_49,0.43,54,103,49,77
18,r_133_114_108,seq136,seq115,r_133_114_108,0.78,0,108,108,77
33,r_122_60_79,seq121,seq61,r_122_60_79,1,0,79,79,77
61,seq23,r_24_13_160,r_130_14_54,r_130_14_54,1,131,185,54,77
37,r_56_146_171,seq64,seq147,r_56_146_171,1,0,171,171,77
24,r_2_131_51,r_3_86_116,seq129,r_2_131_51,1,0,51,51,77
9,r_130_14_54,seq129,seq23,r_130_14_54,1,0,54,54,77
49,r_94_52_23,seq95,seq50,r_94_52_23,0.95,0,23,23,77
15,r_138_10_52,seq139,seq11,r_138_10_52,1,0,52,52,77
17,r_143_80_96,r_144_93_164,r_76_79_194,r_143_80_96,1,0,96,96,77
94,seq112,seq102,r_133_114_108,r_133_114_108,0.98,0,108,108,77
28,r_37_142_10,r_3_86_116,r_105_141_14,r_37_142_10,0.94,2,12,10,77
18,r_133_114_108,seq115,r_58_113_130,r_58_113_130,0.87,7,137,130,77
22,r_144_93_164,r_143_80_96,seq147,r_143_80_96,0.96,0,96,96,77
56,seq11,r_4_1_189,r_138_10_52,r_138_10_52,1,42,94,52,77
9,r_71_137_147,r_24_72_103,r_98_139_25,r_71_137_147,1,0,147,147,78
53,seq5,r_8_30_149,r_9_3_137,r_8_30_149,1,-29,120,149,78
49,r_116_110_55,seq118,r_108_107_17,r_116_110_55,0.93,0,55,55,78
16,r_50_56_70,seq49,seq58,r_50_56_70,0.83,0,70,70,78
21,r_53_6_187,seq54,r_9_3_137,r_9_3_137,0.94,50,187,137,78
39,r_89_106_115,r_87_31_147,r_108_107_17,r_89_106_115,0.97,0,115,115,78
1,r_68_67_97,r_65_134_161,r_122_96_152,r_68_67_97,0.66,66,163,97,78
1,r_68_67_97,r_69_1_83,r_65_134_161,r_69_1_83,1,0,83,83,78
46,r_102_119_94,seq101,r_126_120_18,r_102_119_94,0.66,1,95,94,78
70,seq38,seq39,r_52_40_27,r_52_40_27,0.56,13,40,27,78
2,r_126_120_18,r_122_96_152,r_102_119_94,r_126_120_18,0.98,84,102,18,78
24,r_92_36_170,r_37_93_42,r_52_40_27,r_92_36_170,0.68,0,170,170,78
5,r_98_139_25,seq97,r_148_140_114,r_98_139_25,0.98,0,25,25,78
19,r_8_30_149,seq5,r_87_31_147,r_8_30_149,0.95,0,149,149,78
8,r_4_41_27,r_9_3_137,r_52_40_27,r_4_41_27,1,0,27,27,78
38,r_23_114_182,seq25,seq112,r_23_114_182,0.74,0,182,182,78
36,r_2_48_44,seq0,seq49,r_2_48_44,1,0,44,44,78
31,r_66_20_86,r_68_67_97,seq25,r_66_20_86,0.96,0,86,86,78
89,seq90,r_92_36_170,r_59_91_134,r_59_91_134,0.42,12,146,134,78
26,r_65_134_161,r_64_127_146,r_68_67_97,r_64_127_146,0.81,0,146,146,78
4,r_52_40_27,r_50_56_70,r_4_41_27,r_52_40_27,0.69,0,27,27,78
0,r_123_22_80,r_122_96_152,seq25,r_123_22_80,0.97,0,80,80,78
11,r_7_144_107,seq5,seq149,r_7_144_107,0.91,0,107,107,78
20,r_147_75_161,seq149,r_136_82_18,r_136_82_18,0.43,143,161,18,78
26,r_65_134_161,r_68_67_97,seq135,r_65_134_161,0.89,0,161,161,78
6,r_79_16_186,seq80,seq14,r_79_16_186,0.43,0,186,186,78
71,seq39,seq38,r_52_40_27,r_52_40_27,0.68,4,31,27,78
27,r_69_1_83,r_68_67_97,seq0,r_69_1_83,1,0,83,83,78
47,r_130_51_93,seq132,seq54,r_130_51_93,0.86,0,93,93,78
40,r_33_18_67,seq32,seq17,r_33_18_67,1,0,67,67,78
18,r_122_96_152,r_123_22_80,r_126_120_18,r_123_22_80,1,0,80,80,78
29,r_59_91_134,seq58,r_37_93_42,r_59_91_134,0.71,0,134,134,78
15,r_136_82_18,r_133_138_196,seq80,r_136_82_18,0.98,0,18,18,78
24,r_92_36_170,r_95_141_157,r_37_93_42,r_37_93_42,0.98,68,110,42,78
25,r_24_72_103,r_23_114_182,r_136_82_18,r_24_72_103,1,0,103,103,78
33,r_94_142_65,r_95_141_157,r_133_138_196,r_94_142_65,1,0,65,65,78
30,r_57_104_48,r_59_91_134,seq105,r_57_104_48,1,1,49,48,78
42,r_42_131_37,seq44,seq132,r_42_131_37,1,1,38,37,78
3,r_115_61_51,r_111_129_173,seq60,r_115_61_51,1,0,51,51,78
2,r_126_120_18,seq124,r_122_96_152,r_126_120_18,0.55,30,48,18,78
65,seq28,seq34,r_143_27_100,r_143_27_100,0.91,0,100,100,78
61,seq19,r_21_77_81,seq25,r_21_77_81,0.99,-10,71,81,78
38,r_23_114_182,r_24_72_103,seq25,r_24_72_103,0.89,-30,73,103,78
60,seq17,r_15_13_33,r_33_18_67,r_33_18_67,1,2,69,67,78
45,r_37_93_42,r_92_36_170,r_59_91_134,r_37_93_42,0.57,128,170,42,78
17,r_87_31_147,seq88,seq29,r_87_31_147,0.79,-1,146,147,78
9,r_71_137_147,seq73,r_24_72_103,r_24_72_103,1,3,106,103,78
96,seq112,r_111_129_173,r_23_114_182,r_23_114_182,0.8,0,182,182,78
45,r_37_93_42,seq38,r_92_36_170,r_37_93_42,0.97,0,42,42,78
28,r_21_77_81,r_24_72_103,r_86_76_37,r_86_76_37,1,45,82,37,78
7,r_95_141_157,r_92_36_170,r_98_139_25,r_95_141_157,0.7,0,157,157,78
18,r_122_96_152,r_126_120_18,r_59_91_134,r_122_96_152,0.84,0,152,152,78
43,r_113_100_68,r_111_129_173,seq99,r_113_100_68,0.65,0,68,68,78
23,r_143_27_100,r_147_75_161,seq28,r_143_27_100,0.99,0,100,100,78
43,r_113_100_68,r_115_61_51,r_111_129_173,r_115_61_51,0.95,0,51,51,78
35,r_74_146_142,seq73,seq145,r_74_146_142,0.77,0,142,142,78
12,r_111_129_173,seq112,r_98_139_25,r_98_139_25,0.63,148,173,25,78
36,r_79_74_117,r_81_104_159,r_52_73_76,r_79_74_117,0.91,0,117,117,79
14,r_72_45_134,seq71,r_47_22_188,r_72_45_134,0.94,0,134,134,79
8,r_100_146_152,seq99,seq147,r_100_146_152,0.72,0,152,152,79
3,r_12_94_133,r_42_11_41,r_98_136_202,r_12_94_133,0.98,0,133,133,79
24,r_149_125_167,r_139_49_189,seq147,r_139_49_189,0.84,-140,49,189,79
5,r_96_82_15,r_95_53_90,seq80,r_96_82_15,0.93,1,16,15,79
18,r_132_114_56,r_133_148_135,r_14_112_43,r_132_114_56,0.64,0,56,56,79
16,r_138_56_88,r_139_49_189,seq57,r_138_56_88,0.99,0,88,88,79
21,r_139_49_189,seq145,r_7_44_142,r_7_44_142,0.92,48,190,142,79
39,r_101_18_100,r_100_146_152,seq17,r_101_18_100,1,0,100,100,79
30,r_20_29_23,r_19_63_177,seq31,r_20_29_23,1,0,23,23,79
1,r_19_63_177,seq17,r_138_56_88,r_19_63_177,0.77,0,177,177,79
29,r_102_6_32,r_100_146_152,r_78_5_6,r_102_6_32,0.98,0,32,32,79
42,r_134_83_177,seq135,r_96_82_15,r_134_83_177,0.55,0,177,177,79
7,r_50_91_32,seq90,r_137_92_131,r_137_92_131,1,19,150,131,79
69,seq43,r_41_58_121,seq38,r_41_58_121,1,0,121,121,79
24,r_149_125_167,seq147,seq126,r_149_125_167,0.65,0,167,167,79
19,r_68_3_97,seq70,r_78_5_6,r_68_3_97,1,0,97,97,79
33,r_21_54_159,r_33_39_194,r_115_55_57,r_21_54_159,0.66,0,159,159,79
11,r_7_44_142,r_102_6_32,seq43,r_7_44_142,1,0,142,142,79
85,seq90,seq88,r_50_91_32,r_50_91_32,0.99,1,33,32,79
76,seq70,r_68_3_97,r_84_69_17,r_68_3_97,1,-21,76,97,79
97,seq122,seq120,r_98_136_202,r_98_136_202,0.71,-46,156,202,79
31,r_47_22_188,r_46_87_171,r_72_45_134,r_72_45_134,0.86,37,171,134,79
44,r_40_143_57,r_41_58_121,r_113_142_28,r_40_143_57,1,0,57,57,79
38,r_133_148_135,r_149_125_167,r_128_141_59,r_149_125_167,0.72,0,167,167,79
82,seq86,seq77,r_96_82_15,r_96_82_15,0.38,45,60,15,79
0,r_95_53_90,r_117_0_123,r_115_55_57,r_117_0_123,1,-33,90,123,79
46,r_15_85_196,r_14_112_43,seq17,r_14_112_43,0.99,0,43,43,79
13,r_36_51_132,seq35,r_115_55_57,r_36_51_132,0.82,1,133,132,79
15,r_117_0_123,seq116,seq8,r_117_0_123,0.76,0,123,123,79
48,r_37_119_137,r_41_58_121,seq23,r_37_119_137,0.66,-74,63,137,79
57,seq13,r_15_85_196,r_101_18_100,r_101_18_100,1,81,181,100,79
6,r_111_34_182,r_110_32_121,r_132_114_56,r_111_34_182,0.63,-62,120,182,79
11,r_7_44_142,seq4,r_102_6_32,r_102_6_32,1,17,49,32,79
26,r_128_141_59,seq126,r_40_143_57,r_128_141_59,0.99,0,59,59,79
4,r_121_131_28,seq122,seq130,r_121_131_28,0.86,0,28,28,79
2,r_84_69_17,r_81_104_159,seq70,r_84_69_17,0.84,0,17,17,79
49,r_113_142_28,r_111_34_182,seq145,r_113_142_28,0.98,0,28,28,79
40,r_137_92_131,seq135,r_50_91_32,r_137_92_131,0.67,0,131,131,79
34,r_14_112_43,r_111_34_182,r_12_94_133,r_12_94_133,0.85,48,181,133,79
34,r_14_112_43,r_15_85_196,r_111_34_182,r_14_112_43,1,0,43,43,79
48,r_37_119_137,seq23,seq120,r_37_119_137,0.93,-3,134,137,79
80,seq77,r_79_74_117,r_96_82_15,r_79_74_117,0.62,-63,54,117,79
6,r_111_34_182,r_132_114_56,r_103_28_119,r_111_34_182,0.98,0,182,182,79
47,r_115_55_57,r_72_45_134,r_95_53_90,r_115_55_57,0.73,38,95,57,79
32,r_46_87_171,r_47_22_188,seq86,r_47_22_188,0.43,-16,172,188,79
38,r_133_148_135,r_124_129_18,r_149_125_167,r_133_148_135,0.66,0,135,135,79
45,r_42_11_41,r_41_58_121,r_12_94_133,r_42_11_41,1,0,41,41,79
47,r_115_55_57,r_117_0_123,r_72_45_134,r_115_55_57,0.92,0,57,57,79
45,r_42_11_41,r_12_94_133,seq13,r_12_94_133,0.96,0,133,133,79
3,r_12_94_133,seq13,r_42_11_41,r_42_11_41,1,0,41,41,79
9,r_140_109_91,r_139_49_189,seq108,r_140_109_91,0.98,0,91,91,79
96,seq120,seq122,r_37_119_137,r_37_119_137,0.84,0,137,137,79
22,r_41_58_121,seq43,r_59_48_206,r_41_58_121,0.88,0,121,121,79
28,r_103_28_119,seq99,r_20_29_23,r_103_28_119,0.91,0,119,119,79
20,r_107_26_23,r_111_34_182,seq27,r_107_26_23,0.99,0,23,23,79
41,r_52_73_76,r_50_91_32,seq75,r_50_91_32,0.98,-1,31,32,79
7,r_50_91_32,r_52_73_76,seq90,r_50_91_32,0.8,0,32,32,79
82,seq86,seq77,r_96_82_15,r_96_82_15,0.83,132,147,15,79
35,r_110_32_121,r_111_34_182,r_20_29_23,r_110_32_121,0.65,-1,120,121,79
12,r_81_104_159,seq80,r_98_136_202,r_81_104_159,0.73,0,159,159,79
44,r_111_1_165,r_118_112_45,r_102_28_67,r_118_112_45,0.65,120,165,45,80
14,r_47_142_74,r_48_14_85,seq143,r_47_142_74,1,0,74,74,80
8,r_87_132_193,seq85,r_47_142_74,r_47_142_74,0.76,119,193,74,80
43,r_140_11_148,seq141,r_34_5_142,r_140_11_148,0.8,0,148,148,80
37,r_56_59_102,r_77_54_1,r_32_55_30,r_56_59_102,0.58,-45,57,102,80
54,seq12,seq19,r_48_14_85,r_48_14_85,0.88,47,132,85,80
44,r_111_1_165,seq108,r_118_112_45,r_118_112_45,0.97,2,47,45,80
26,r_81_36_47,r_84_42_113,seq39,r_81_36_47,0.82,0,47,47,80
71,seq41,r_44_50_54,r_129_40_72,r_129_40_72,0.99,6,78,72,80
86,seq80,r_79_92_132,seq74,r_79_92_132,1,0,132,132,80
21,r_119_144_174,r_120_98_78,seq116,r_120_98_78,1,0,78,78,80
39,r_72_24_157,seq73,seq25,r_72_24_157,0.49,0,157,157,80
1,r_64_3_82,seq66,seq6,r_64_3_82,1,0,82,82,80
97,seq116,r_117_106_134,r_119_144_174,r_117_106_134,1,1,135,134,80
5,r_62_53_70,r_61_15_155,r_77_54_1,r_62_53_70,1,0,70,70,80
42,r_146_115_167,seq145,r_138_114_108,r_138_114_108,0.96,61,169,108,80
32,r_123_126_18,seq127,r_65_124_38,r_65_124_38,0.79,70,108,38,80
7,r_48_14_85,r_9_17_74,r_61_15_155,r_61_15_155,1,11,166,155,80
11,r_10_149_20,r_9_17_74,r_63_148_15,r_10_149_20,0.97,-1,19,20,80
45,r_120_98_78,r_119_144_174,seq96,r_120_98_78,1,0,78,78,80
19,r_95_103_191,seq96,seq99,r_95_103_191,0.41,0,191,191,80
38,r_4_107_24,seq99,r_135_105_94,r_135_105_94,1,-2,92,94,80
41,r_128_30_41,seq127,seq31,r_128_30_41,1,1,42,41,80
67,seq33,r_34_5_142,r_81_36_47,r_81_36_47,0.98,101,148,47,80
66,seq31,r_32_55_30,r_128_30_41,r_128_30_41,0.98,1,42,41,80
10,r_135_105_94,seq134,r_4_107_24,r_135_105_94,0.97,0,94,94,80
38,r_4_107_24,r_9_17_74,seq99,r_4_107_24,1,0,24,24,80
90,seq96,r_95_103_191,r_90_94_92,r_90_94_92,0.58,99,191,92,80
25,r_118_112_45,r_120_98_78,r_111_1_165,r_118_112_45,0.86,0,45,45,80
13,r_13_52_25,seq12,r_77_54_1,r_13_52_25,0.8,0,25,25,80
98,seq121,r_122_131_85,r_101_125_71,r_101_125_71,1,14,85,71,80
22,r_32_55_30,seq31,r_56_59_102,r_32_55_30,0.85,2,32,30,80
48,r_102_28_67,r_104_49_111,seq29,r_102_28_67,0.87,0,67,67,80
57,seq145,r_146_115_167,seq137,r_146_115_167,0.95,0,167,167,80
6,r_84_42_113,r_82_16_150,seq41,r_84_42_113,1,0,113,113,80
99,seq127,r_129_40_72,r_123_126_18,r_129_40_72,1,0,72,72,80
31,r_139_38_10,r_135_105_94,seq37,r_139_38_10,0.99,0,10,10,80
24,r_65_124_38,r_64_3_82,seq121,r_65_124_38,1,0,38,38,80
22,r_32_55_30,r_56_59_102,r_77_54_1,r_77_54_1,0.51,101,102,1,80
2,r_89_60_140,seq88,seq66,r_89_60_140,0.63,0,140,140,80
47,r_2_21_77,r_9_17_74,seq22,r_2_21_77,0.94,-6,71,77,80
40,r_82_16_150,seq83,r_48_14_85,r_82_16_150,0.87,0,150,150,80
18,r_104_49_111,seq99,r_57_46_13,r_104_49_111,0.97,0,111,111,80
29,r_101_125_71,seq99,seq121,r_101_125_71,1,0,71,71,80
33,r_93_113_71,seq96,r_118_112_45,r_93_113_71,1,0,71,71,80
88,seq85,r_87_132_193,r_79_92_132,r_79_92_132,0.92,33,165,132,80
65,seq29,seq27,r_102_28_67,r_102_28_67,1,4,71,67,80
34,r_90_94_92,r_89_60_140,seq96,r_89_60_140,0.91,-44,96,140,80
99,seq127,r_123_126_18,r_65_124_38,r_65_124_38,0.46,74,112,38,80
4,r_77_54_1,r_56_59_102,r_13_52_25,r_13_52_25,0.63,32,57,25,80
81,seq71,seq66,r_89_60_140,r_89_60_140,0.97,61,201,140,80
17,r_23_43_170,seq25,r_84_42_113,r_84_42_113,0.88,57,170,113,80
25,r_118_112_45,r_111_1_165,r_93_113_71,r_118_112_45,0.78,82,127,45,80
9,r_97_130_179,seq96,seq127,r_97_130_179,0.48,0,179,179,80
28,r_138_114_108,r_118_112_45,r_146_115_167,r_146_115_167,0.99,1,168,167,80
28,r_138_114_108,seq137,r_118_112_45,r_138_114_108,0.73,0,108,108,80
3,r_44_50_54,seq41,r_57_46_13,r_44_50_54,0.91,2,56,54,80
49,r_91_133_35,r_89_60_140,seq134,r_91_133_35,1,0,35,35,80
7,r_48_14_85,seq45,r_9_17_74,r_48_14_85,0.78,0,85,85,80
10,r_135_105_94,r_4_107_24,r_117_106_134,r_117_106_134,1,9,143,134,80
23,r_79_92_132,seq80,seq88,r_79_92_132,0.86,0,132,132,80
82,seq73,r_72_24_157,seq74,r_72_24_157,0.98,0,157,157,80
35,r_122_131_85,seq121,seq137,r_122_131_85,0.42,1,86,85,80
12,r_129_40_72,seq127,seq41,r_129_40_72,1,0,72,72,80
65,seq25,r_63_52_27,r_93_23_20,r_93_23_20,0.5,29,49,20,81
30,r_80_121_93,r_78_112_81,seq84,r_80_121_93,0.81,-32,61,93,81
14,r_42_55_24,r_63_52_27,r_141_50_107,r_141_50_107,1,23,130,107,81
21,r_114_107_15,seq115,r_108_140_117,r_114_107_15,0.75,0,15,15,81
19,r_144_4_148,r_46_142_19,r_79_7_27,r_144_4_148,0.98,0,148,148,81
55,seq134,seq132,r_145_135_78,r_145_135_78,1,8,86,78,81
16,r_146_133_173,r_147_62_146,seq148,r_147_62_146,0.98,0,146,146,81
39,r_1_59_165,seq0,r_42_55_24,r_42_55_24,0.61,141,165,24,81
43,r_68_139_24,r_67_27_106,r_146_133_173,r_68_139_24,0.55,3,27,24,81
34,r_48_8_61,r_42_55_24,r_89_49_41,r_89_49_41,0.9,1,42,41,81
5,r_147_62_146,r_146_133_173,r_42_55_24,r_147_62_146,0.95,0,146,146,81
46,r_76_83_108,seq75,seq84,r_76_83_108,0.96,0,108,108,81
74,seq45,seq40,r_89_49_41,r_89_49_41,1,1,42,41,81
19,r_144_4_148,r_145_135_78,r_46_142_19,r_144_4_148,0.65,-70,78,148,81
8,r_44_95_85,r_42_55_24,r_89_49_41,r_89_49_41,0.97,18,59,41,81
27,r_79_7_27,r_80_121_93,seq10,r_79_7_27,0.73,0,27,27,81
30,r_80_121_93,r_79_7_27,r_78_112_81,r_79_7_27,0.67,0,27,27,81
22,r_46_142_19,r_48_8_61,r_144_4_148,r_46_142_19,0.99,0,19,19,81
95,seq115,seq120,r_14_113_77,r_14_113_77,1,41,118,77,81
24,r_119_56_95,r_70_116_49,r_149_57_84,r_119_56_95,1,0,95,95,81
32,r_136_90_54,seq137,seq96,r_136_90_54,1,0,54,54,81
97,seq148,r_146_133_173,r_46_142_19,r_146_133_173,0.5,-10,163,173,81
41,r_26_110_99,seq32,seq109,r_26_110_99,0.99,0,99,99,81
3,r_141_50_107,r_146_133_173,seq53,r_141_50_107,1,1,108,107,81
10,r_58_130_108,r_63_52_27,seq129,r_58_130_108,1,0,108,108,81
90,seq103,r_102_24_154,seq100,r_102_24_154,0.94,0,154,154,81
8,r_44_95_85,r_89_49_41,seq96,r_44_95_85,1,0,85,85,81
4,r_92_41_74,r_91_6_172,seq40,r_92_41_74,0.99,0,74,74,81
2,r_108_140_117,seq106,r_114_107_15,r_114_107_15,0.58,23,38,15,81
78,seq66,r_67_27_106,r_60_65_3,r_67_27_106,1,0,106,106,81
0,r_123_117_70,r_124_39_75,r_70_116_49,r_123_117_70,0.98,0,70,70,81
73,seq40,seq45,r_92_41_74,r_92_41_74,1,0,74,74,81
99,seq127,r_128_126_27,seq129,r_128_126_27,0.94,-8,19,27,81
20,r_67_27_106,seq66,seq28,r_67_27_106,0.7,0,106,106,81
9,r_17_131_82,seq132,seq125,r_17_131_82,0.37,55,137,82,81
13,r_51_34_118,seq53,r_122_33_60,r_122_33_60,1,56,116,60,81
98,seq125,r_124_39_75,seq129,r_124_39_75,1,0,75,75,81
79,seq75,r_69_31_137,r_47_74_18,r_47_74_18,0.65,0,18,18,81
48,r_64_22_91,r_58_130_108,r_143_21_6,r_58_130_108,0.77,-43,65,108,81
6,r_145_135_78,r_144_4_148,seq134,r_145_135_78,0.91,0,78,78,81
21,r_114_107_15,r_108_140_117,seq106,r_108_140_117,1,0,117,117,81
50,seq0,r_2_82_152,r_92_41_74,r_2_82_152,0.66,21,173,152,81
34,r_48_8_61,r_89_49_41,r_79_7_27,r_48_8_61,0.81,5,66,61,81
2,r_108_140_117,r_114_107_15,r_68_139_24,r_108_140_117,1,0,117,117,81
16,r_146_133_173,seq148,r_145_135_78,r_146_133_173,0.63,0,173,173,81
97,seq148,r_149_57_84,r_146_133_173,r_149_57_84,1,-30,54,84,81
22,r_46_142_19,r_144_4_148,seq148,r_144_4_148,0.99,0,148,148,81
7,r_149_57_84,r_58_130_108,r_119_56_95,r_58_130_108,0.87,0,108,108,81
40,r_124_39_75,seq125,seq38,r_124_39_75,1,0,75,75,81
18,r_14_113_77,seq13,r_123_117_70,r_14_113_77,1,0,77,77,81
24,r_119_56_95,r_118_73_49,r_70_116_49,r_119_56_95,0.97,-45,50,95,81
35,r_143_21_6,seq25,r_64_22_91,r_64_22_91,0.55,12,103,91,81
25,r_91_6_172,r_92_41_74,r_136_90_54,r_91_6_172,0.97,-98,74,172,81
43,r_68_139_24,r_146_133_173,r_108_140_117,r_108_140_117,0.92,2,119,117,81
47,r_70_116_49,seq120,r_123_117_70,r_70_116_49,0.55,69,118,49,81
33,r_98_77_53,seq99,r_47_74_18,r_98_77_53,1,0,53,53,81
50,seq0,r_1_59_165,r_2_82_152,r_1_59_165,0.4,0,165,165,81
70,seq35,seq37,r_122_33_60,r_122_33_60,1,22,82,60,81
61,seq15,r_14_113_77,r_61_16_1,r_14_113_77,1,-10,67,77,81
38,r_78_112_81,r_80_121_93,r_114_107_15,r_78_112_81,0.61,0,81,81,81
52,seq3,r_2_82_152,r_144_4_148,r_144_4_148,0.74,4,152,148,81
37,r_93_23_20,r_92_41_74,seq25,r_93_23_20,0.67,0,20,20,81
60,seq13,r_14_113_77,r_61_16_1,r_14_113_77,1,0,77,77,81
81,seq84,seq81,r_76_83_108,r_76_83_108,0.87,1,109,108,81
25,r_91_6_172,r_136_90_54,r_144_4_148,r_91_6_172,0.54,0,172,172,81
30,r_80_121_93,seq84,seq115,r_80_121_93,0.99,1,94,93,81
9,r_17_131_82,seq18,seq132,r_17_131_82,1,0,82,82,81
47,r_70_116_49,r_69_31_137,seq120,r_70_116_49,0.98,0,49,49,81
26,r_47_74_18,r_46_142_19,seq75,r_46_142_19,0.67,-1,18,19,81
29,r_54_87_24,r_63_52_27,seq88,r_54_87_24,0.93,0,24,24,81
49,r_94_43_85,seq99,seq45,r_94_43_85,1,0,85,85,81
7,r_149_57_84,r_146_133_173,r_58_130_108,r_149_57_84,0.76,0,84,84,81
44,r_69_31_137,seq75,seq30,r_69_31_137,0.53,0,137,137,81
23,r_118_73_49,r_119_56_95,r_71_72_44,r_118_73_49,1,1,50,49,81
93,seq106,r_102_24_154,r_114_107_15,r_102_24_154,0.93,-41,113,154,81
12,r_122_33_60,r_123_117_70,seq35,r_122_33_60,1,0,60,60,81
93,seq108,r_109_148_137,r_38_110_54,r_38_110_54,0.99,45,99,54,82
30,r_40_9_156,seq41,r_99_8_89,r_99_8_89,0.83,66,155,89,82
44,r_146_33_43,r_32_80_176,r_105_27_3,r_32_80_176,0.48,1,177,176,82
36,r_30_66_71,r_29_43_135,seq68,r_30_66_71,1,0,71,71,82
14,r_125_25_139,r_123_4_163,r_105_27_3,r_125_25_139,0.84,0,139,139,82
8,r_138_128_82,seq140,r_37_124_82,r_37_124_82,1,0,82,82,82
83,seq79,r_81_69_191,r_32_80_176,r_32_80_176,1,15,191,176,82
35,r_131_52_9,r_132_22_131,seq51,r_131_52_9,0.97,1,10,9,82
71,seq48,seq47,r_28_49_115,r_28_49_115,0.81,14,129,115,82
16,r_130_98_100,r_132_22_131,seq101,r_130_98_100,0.74,5,105,100,82
20,r_132_22_131,seq133,seq23,r_132_22_131,0.97,0,131,131,82
5,r_32_80_176,r_31_70_153,r_146_33_43,r_146_33_43,1,23,66,43,82
42,r_64_141_198,seq65,r_21_63_65,r_21_63_65,1,0,65,65,82
73,seq51,seq50,r_131_52_9,r_131_52_9,1,8,17,9,82
69,seq46,r_44_35_124,seq47,r_44_35_124,0.6,0,124,124,82
45,r_31_70_153,r_32_80_176,r_30_66_71,r_32_80_176,0.54,-23,153,176,82
19,r_73_20_132,seq78,seq19,r_73_20_132,0.82,0,132,132,82
61,seq17,seq16,r_102_18_27,r_102_18_27,1,21,48,27,82
43,r_0_76_140,r_1_87_86,seq10,r_1_87_86,1,-28,58,86,82
41,r_29_43_135,r_30_66_71,r_28_49_115,r_30_66_71,1,0,71,71,82
11,r_60_24_23,seq61,seq23,r_60_24_23,0.99,0,23,23,82
37,r_75_6_15,r_73_20_132,seq2,r_75_6_15,0.96,0,15,15,82
3,r_99_8_89,seq95,r_75_6_15,r_99_8_89,0.77,0,89,89,82
10,r_3_77_63,seq2,seq78,r_3_77_63,1,0,63,63,82
44,r_146_33_43,seq149,r_32_80_176,r_146_33_43,1,0,43,43,82
26,r_74_96_88,seq78,seq95,r_74_96_88,0.73,-1,87,88,82
4,r_45_113_94,r_44_35_124,seq114,r_45_113_94,1,0,94,94,82
25,r_38_110_54,r_37_124_82,seq108,r_38_110_54,0.54,0,54,54,82
0,r_1_87_86,seq2,seq88,r_1_87_86,1,0,86,86,82
9,r_122_55_32,r_125_25_139,r_54_71_90,r_122_55_32,0.98,0,32,32,82
39,r_111_85_47,r_83_97_125,r_1_87_86,r_1_87_86,1,15,101,86,82
20,r_132_22_131,r_130_98_100,seq133,r_132_22_131,0.78,-26,105,131,82
13,r_93_116_90,seq94,r_36_118_61,r_36_118_61,1,29,90,61,82
48,r_44_35_124,seq46,r_146_33_43,r_146_33_43,1,80,123,43,82
17,r_54_71_90,seq57,r_122_55_32,r_122_55_32,0.94,5,37,32,82
12,r_21_63_65,r_64_141_198,r_126_62_77,r_21_63_65,0.5,133,198,65,82
6,r_83_97_125,r_82_136_135,r_74_96_88,r_74_96_88,0.71,40,128,88,82
17,r_54_71_90,r_122_55_32,r_3_77_63,r_54_71_90,1,1,91,90,82
47,r_34_145_128,r_32_80_176,r_91_147_63,r_34_145_128,0.72,0,128,128,82
74,seq53,r_122_55_32,r_86_59_79,r_122_55_32,0.5,156,188,32,82
85,seq88,r_90_92_171,r_1_87_86,r_1_87_86,1,85,171,86,82
99,seq127,r_123_4_163,r_37_124_82,r_37_124_82,0.96,72,154,82,82
5,r_32_80_176,r_146_33_43,seq79,r_32_80_176,0.51,1,177,176,82
41,r_29_43_135,r_28_49_115,seq42,r_29_43_135,0.75,-11,124,135,82
63,seq149,seq144,r_91_147_63,r_91_147_63,0.82,-9,54,63,82
77,seq61,r_60_24_23,seq68,r_60_24_23,0.94,0,23,23,82
2,r_86_59_79,r_90_92_171,seq57,r_86_59_79,1,0,79,79,82
47,r_34_145_128,r_36_118_61,seq47,r_36_118_61,1,0,61,61,82
40,r_91_147_63,r_93_116_90,seq149,r_91_147_63,0.9,0,63,63,82
74,seq53,seq58,r_122_55_32,r_122_55_32,0.69,55,87,32,82
29,r_90_92_171,seq88,r_83_97_125,r_83_97_125,0.78,46,171,125,82
24,r_126_62_77,r_123_4_163,r_21_63_65,r_21_63_65,0.98,12,77,65,82
43,r_0_76_140,seq10,r_3_77_63,r_0_76_140,0.77,0,140,140,82
33,r_123_4_163,seq127,seq2,r_123_4_163,0.72,0,163,163,82
64,seq23,r_26_143_127,r_105_27_3,r_26_143_127,1,0,127,127,82
88,seq144,seq149,r_26_143_127,r_26_143_127,1,0,127,127,82
42,r_64_141_198,r_21_63_65,r_109_148_137,r_109_148_137,0.57,63,200,137,82
34,r_37_124_82,r_34_145_128,r_138_128_82,r_138_128_82,0.96,0,82,82,82
9,r_122_55_32,r_54_71_90,r_86_59_79,r_122_55_32,1,59,91,32,82
81,seq72,seq65,r_54_71_90,r_54_71_90,0.99,12,102,90,82
94,seq114,seq115,r_45_113_94,r_45_113_94,1,0,94,94,82
63,seq149,r_91_147_63,r_109_148_137,r_109_148_137,0.88,1,138,137,82
96,seq117,seq120,r_93_116_90,r_93_116_90,0.98,12,102,90,82
37,r_75_6_15,seq2,r_99_8_89,r_99_8_89,1,28,117,89,82
28,r_81_69_191,seq79,r_30_66_71,r_30_66_71,1,120,191,71,82
49,r_26_143_127,seq23,seq144,r_26_143_127,1,0,127,127,82
7,r_109_148_137,seq108,seq149,r_109_148_137,0.61,0,137,137,82
39,r_111_85_47,r_109_148_137,r_83_97_125,r_111_85_47,0.85,1,48,47,82
23,r_82_136_135,seq79,r_142_135_9,r_142_135_9,0.79,127,136,9,82
82,seq78,r_73_20_132,r_3_77_63,r_3_77_63,0.74,24,87,63,82
12,r_21_63_65,r_37_124_82,r_64_141_198,r_64_141_198,1,-133,65,198,82
46,r_102_18_27,seq103,seq17,r_102_18_27,1,0,27,27,82
84,seq84,r_83_97_125,seq88,r_83_97_125,0.64,1,126,125,82
30,r_47_74_163,seq46,r_79_78_53,r_79_78_53,0.87,110,163,53,83
51,seq128,r_129_57_108,seq134,r_129_57_108,1,-4,104,108,83
9,r_143_63_16,r_49_55_13,r_81_65_111,r_81_65_111,1,14,125,111,83
54,seq5,seq13,r_130_9_32,r_130_9_32,1,89,121,32,83
10,r_32_144_120,r_33_96_52,seq27,r_33_96_52,1,0,52,52,83
18,r_66_31_56,seq59,r_58_30_28,r_66_31_56,0.85,0,56,56,83
16,r_70_41_159,seq71,r_40_39_174,r_70_41_159,0.72,0,159,159,83
1,r_112_7_128,seq114,seq5,r_112_7_128,0.97,1,129,128,83
97,seq117,r_120_119_75,r_26_116_22,r_26_116_22,1,125,147,22,83
42,r_35_76_92,seq36,seq73,r_35_76_92,0.99,0,92,92,83
91,seq100,r_101_15_34,seq98,r_101_15_34,1,0,34,34,83
5,r_33_96_52,r_32_144_120,seq97,r_33_96_52,1,0,52,52,83
2,r_130_9_32,r_129_57_108,seq13,r_130_9_32,0.97,0,32,32,83
39,r_1_20_50,seq23,r_85_22_110,r_85_22_110,1,7,117,110,83
31,r_14_121_77,r_12_68_154,r_122_82_175,r_14_121_77,1,0,77,77,83
67,seq36,r_37_51_140,r_48_28_64,r_48_28_64,1,83,147,64,83
41,r_49_55_13,r_48_28_64,seq59,r_49_55_13,0.93,0,13,13,83
3,r_61_38_163,seq60,seq36,r_61_38_163,0.53,0,163,163,83
9,r_143_63_16,r_142_113_22,r_49_55_13,r_143_63_16,0.52,0,16,16,83
82,seq77,seq75,r_79_78_53,r_79_78_53,1,2,55,53,83
24,r_79_78_53,r_81_65_111,seq77,r_79_78_53,0.64,0,53,53,83
44,r_43_16_43,seq46,r_19_21_215,r_43_16_43,0.96,0,43,43,83
26,r_89_44_155,seq94,seq46,r_89_44_155,0.78,0,155,155,83
78,seq71,r_70_41_159,r_79_78_53,r_79_78_53,1,106,159,53,83
73,seq54,seq73,r_81_65_111,r_81_65_111,0.97,69,180,111,83
11,r_34_148_73,r_37_51_140,seq149,r_34_148_73,1,0,73,73,83
20,r_131_102_100,r_133_106_131,seq98,r_131_102_100,0.98,0,100,100,83
13,r_122_82_175,seq125,r_14_121_77,r_14_121_77,1,2,79,77,83
4,r_85_22_110,seq86,r_1_20_50,r_85_22_110,1,-2,108,110,83
46,r_3_103_36,seq2,seq98,r_3_103_36,1,0,36,36,83
13,r_122_82_175,r_14_121_77,r_87_84_14,r_122_82_175,0.67,0,175,175,83
6,r_19_21_215,r_18_92_78,seq17,r_18_92_78,1,1,79,78,83
19,r_142_113_22,seq138,seq114,r_142_113_22,0.98,0,22,22,83
2,r_130_9_32,seq13,r_95_11_100,r_95_11_100,1,21,121,100,83
99,seq125,r_122_82_175,r_14_121_77,r_14_121_77,1,-2,75,77,83
8,r_53_107_23,seq54,seq105,r_53_107_23,0.99,2,25,23,83
10,r_32_144_120,seq27,r_90_139_38,r_32_144_120,1,0,120,120,83
84,seq80,r_79_78_53,r_87_84_14,r_79_78_53,0.94,-16,37,53,83
47,r_37_51_140,seq36,seq52,r_37_51_140,0.8,1,141,140,83
57,seq138,seq140,r_90_139_38,r_90_139_38,1,9,47,38,83
40,r_25_146_70,seq24,seq147,r_25_146_70,1,0,70,70,83
29,r_127_64_66,r_126_115_72,r_143_63_16,r_127_64_66,1,0,66,66,83
35,r_10_136_84,r_135_45_167,seq128,r_135_45_167,0.87,0,167,167,83
25,r_135_45_167,r_131_102_100,r_10_136_84,r_135_45_167,0.95,-74,93,167,83
33,r_95_11_100,seq94,r_130_9_32,r_95_11_100,0.93,0,100,100,83
44,r_43_16_43,seq17,seq13,r_43_16_43,0.58,144,187,43,83
88,seq97,seq100,r_33_96_52,r_33_96_52,1,33,85,52,83
45,r_87_84_14,seq88,seq80,r_87_84_14,0.68,1,15,14,83
27,r_101_15_34,seq100,seq13,r_101_15_34,0.97,0,34,34,83
65,seq27,seq29,r_48_28_64,r_48_28_64,1,28,92,64,83
15,r_26_116_22,seq29,r_126_115_72,r_26_116_22,1,3,25,22,83
32,r_12_68_154,seq13,r_79_78_53,r_12_68_154,0.93,0,154,154,83
38,r_133_106_131,seq132,r_53_107_23,r_133_106_131,0.96,0,131,131,83
77,seq67,r_69_123_180,r_79_78_53,r_79_78_53,1,127,180,53,83
4,r_85_22_110,r_83_91_4,seq86,r_85_22_110,0.4,-90,20,110,83
34,r_129_57_108,seq128,seq59,r_129_57_108,0.93,0,108,108,83
43,r_111_93_21,r_112_7_128,r_83_91_4,r_111_93_21,0.99,0,21,21,83
0,r_90_139_38,r_83_91_4,seq138,r_90_139_38,0.91,0,38,38,83
60,seq17,seq24,r_85_22_110,r_85_22_110,1,44,154,110,83
17,r_81_65_111,seq80,r_143_63_16,r_81_65_111,0.88,0,111,111,83
25,r_135_45_167,r_10_136_84,seq46,r_10_136_84,0.87,83,167,84,83
67,seq36,r_48_28_64,r_61_38_163,r_61_38_163,0.63,7,170,163,83
21,r_58_30_28,r_61_38_163,seq29,r_58_30_28,0.99,-3,25,28,83
31,r_14_121_77,r_122_82_175,r_142_113_22,r_14_121_77,0.57,98,175,77,83
22,r_18_92_78,r_19_21_215,r_83_91_4,r_18_92_78,1,1,79,78,83
28,r_69_123_180,seq67,r_53_107_23,r_53_107_23,0.63,158,181,23,83
96,seq114,r_112_7_128,r_142_113_22,r_142_113_22,0.89,0,22,22,83
7,r_48_28_64,r_47_74_163,seq27,r_48_28_64,0.81,1,65,64,83
23,r_126_115_72,r_127_64_66,r_26_116_22,r_126_115_72,0.76,-6,66,72,83
35,r_10_136_84,r_12_68_154,r_135_45_167,r_10_136_84,0.96,0,84,84,83
12,r_83_91_4,r_90_139_38,r_111_93_21,r_83_91_4,0.76,34,38,4,83
93,seq99,r_100_81_91,seq130,r_100_81_91,0.97,0,91,91,84
40,r_103_127_144,r_140_104_87,r_72_126_149,r_103_127_144,0.75,6,150,144,84
30,r_87_26_142,r_86_146_192,r_113_25_38,r_87_26_142,0.69,0,142,142,84
36,r_30_38_88,seq28,seq37,r_30_38_88,0.93,3,91,88,84
14,r_141_52_148,r_142_106_102,r_7_144_56,r_7_144_56,1,46,102,56,84
14,r_141_52_148,r_7_144_56,r_39_51_91,r_141_52_148,1,0,148,148,84
43,r_97_145_133,r_98_3_99,r_147_96_36,r_97_145_133,0.85,-35,98,133,84
33,r_39_51_91,seq56,r_141_52_148,r_141_52_148,1,1,149,148,84
3,r_7_144_56,r_143_1_148,r_97_145_133,r_7_144_56,0.87,92,148,56,84
16,r_91_60_140,seq92,r_121_61_70,r_121_61_70,1,65,135,70,84
21,r_112_115_197,seq117,r_11_111_80,r_11_111_80,1,3,83,80,84
39,r_143_1_148,seq136,r_7_144_56,r_7_144_56,1,10,66,56,84
1,r_118_82_179,seq122,seq131,r_118_82_179,0.55,-91,88,179,84
5,r_98_3_99,r_97_145_133,r_80_4_14,r_98_3_99,0.5,0,99,99,84
46,r_20_0_129,seq21,r_80_4_14,r_20_0_129,0.97,0,129,129,84
80,seq64,r_66_34_175,r_6_65_41,r_6_65_41,0.98,134,175,41,84
4,r_15_116_25,r_12_23_155,seq117,r_15_116_25,1,0,25,25,84
19,r_76_84_155,seq77,r_55_85_94,r_55_85_94,0.8,61,155,94,84
11,r_11_111_80,r_112_115_197,r_15_116_25,r_112_115_197,0.2,0,197,197,84
38,r_129_105_27,r_103_127_144,r_140_104_87,r_129_105_27,0.49,123,150,27,84
37,r_36_108_29,r_39_51_91,seq110,r_36_108_29,1,0,29,29,84
35,r_17_93_45,r_16_137_137,r_97_145_133,r_17_93_45,1,1,46,45,84
39,r_143_1_148,r_7_144_56,r_20_0_129,r_143_1_148,0.99,0,148,148,84
31,r_95_149_123,seq94,seq136,r_95_149_123,0.99,0,123,123,84
41,r_19_120_61,r_20_0_129,seq122,r_19_120_61,1,0,61,61,84
38,r_129_105_27,seq130,r_103_127_144,r_129_105_27,0.98,-1,26,27,84
10,r_12_23_155,seq13,r_113_25_38,r_12_23_155,0.56,1,156,155,84
50,seq130,r_129_105_27,r_143_1_148,r_129_105_27,0.61,2,29,27,84
8,r_48_57_136,r_98_3_99,seq49,r_98_3_99,0.59,-69,30,99,84
73,seq49,seq56,r_44_59_11,r_44_59_11,0.96,131,142,11,84
11,r_11_111_80,seq10,r_112_115_197,r_11_111_80,1,0,80,80,84
15,r_140_104_87,seq136,r_129_105_27,r_140_104_87,0.88,8,95,87,84
48,r_50_14_67,seq56,seq13,r_50_14_67,1,0,67,67,84
1,r_118_82_179,seq131,r_54_79_165,r_118_82_179,0.64,0,179,179,84
57,seq13,r_12_23_155,r_50_14_67,r_50_14_67,1,90,157,67,84
13,r_2_119_164,r_80_4_14,seq133,r_2_119_164,0.91,0,164,164,84
6,r_121_61_70,seq122,seq62,r_121_61_70,1,0,70,70,84
45,r_16_137_137,r_17_93_45,seq136,r_16_137_137,0.98,-92,45,137,84
27,r_102_128_88,r_103_127_144,seq130,r_102_128_88,0.5,0,88,88,84
7,r_6_65_41,r_7_144_56,seq64,r_6_65_41,1,0,41,41,84
51,seq131,r_118_82_179,seq133,r_118_82_179,0.99,-21,158,179,84
47,r_100_81_91,seq99,r_89_148_190,r_100_81_91,1,0,91,91,84
40,r_103_127_144,r_102_128_88,r_140_104_87,r_103_127_144,0.83,-56,88,144,84
74,seq53,r_54_79_165,r_44_59_11,r_44_59_11,0.71,154,165,11,84
29,r_142_106_102,r_141_52_148,r_36_108_29,r_142_106_102,0.99,0,102,102,84
24,r_72_126_149,seq92,r_103_127_144,r_72_126_149,0.7,0,149,149,84
0,r_80_4_14,r_2_119_164,r_135_5_32,r_135_5_32,0.99,7,39,32,84
35,r_17_93_45,r_97_145_133,r_147_96_36,r_97_145_133,1,-23,110,133,84
25,r_66_34_175,seq64,seq35,r_66_34_175,0.71,0,175,175,84
33,r_39_51_91,seq37,seq56,r_39_51_91,0.99,0,91,91,84
47,r_100_81_91,r_89_148_190,r_54_79_165,r_100_81_91,0.61,78,169,91,84
20,r_135_5_32,r_132_123_199,r_80_4_14,r_135_5_32,1,0,32,32,84
68,seq37,r_39_51_91,r_30_38_88,r_39_51_91,0.7,0,91,91,84
42,r_114_101_18,r_103_127_144,r_140_104_87,r_140_104_87,0.61,65,152,87,84
32,r_83_125_154,r_86_146_192,r_72_126_149,r_86_146_192,0.71,-38,154,192,84
26,r_113_25_38,r_112_115_197,seq24,r_113_25_38,1,0,38,38,84
0,r_80_4_14,r_98_3_99,r_2_119_164,r_80_4_14,0.69,0,14,14,84
43,r_97_145_133,r_147_96_36,r_7_144_56,r_97_145_133,1,0,133,133,84
9,r_54_79_165,seq53,r_100_81_91,r_100_81_91,1,74,165,91,84
13,r_2_119_164,r_6_65_41,r_80_4_14,r_2_119_164,0.96,-141,23,164,84
34,r_139_47_37,r_140_104_87,seq46,r_139_47_37,1,0,37,37,84
28,r_107_18_121,seq109,seq21,r_107_18_121,0.98,0,121,121,84
49,r_147_96_36,r_132_123_199,seq94,r_147_96_36,1,0,36,36,84
3,r_7_144_56,r_2_119_164,r_143_1_148,r_7_144_56,1,0,56,56,84
56,seq10,r_11_111_80,seq8,r_11_111_80,1,0,80,80,84
44,r_41_69_82,seq40,seq70,r_41_69_82,1,0,82,82,84
1,r_118_82_179,r_132_123_199,seq122,r_118_82_179,0.33,-162,17,179,84
23,r_45_67_67,seq46,seq70,r_45_67_67,1,1,68,67,84
42,r_114_101_18,seq117,r_103_127_144,r_114_101_18,0.83,0,18,18,84
12,r_17_86_57,seq16,r_87_39_201,r_17_86_57,0.99,0,57,57,85
36,r_113_36_82,seq114,seq42,r_113_36_82,1,0,82,82,85
48,r_105_68_137,r_104_147_48,seq99,r_104_147_48,1,0,48,48,85
8,r_35_78_87,r_34_49_120,seq81,r_35_78_87,0.9,1,88,87,85
43,r_135_69_132,seq137,seq72,r_135_69_132,1,0,132,132,85
83,seq81,r_80_92_135,r_35_78_87,r_35_78_87,0.89,49,136,87,85
26,r_83_124_55,r_84_134_120,r_130_129_156,r_130_129_156,0.97,-101,55,156,85
16,r_80_92_135,seq81,seq93,r_80_92_135,0.56,0,135,135,85
1,r_140_50_153,seq131,r_34_49_120,r_140_50_153,0.97,0,153,153,85
1,r_140_50_153,r_145_96_90,seq131,r_145_96_90,1,-14,76,90,85
97,seq118,r_122_8_104,r_146_123_87,r_122_8_104,0.76,0,104,104,85
5,r_70_53_152,seq72,r_10_54_65,r_10_54_65,1,87,152,65,85
46,r_132_103_180,seq137,r_133_102_127,r_133_102_127,1,52,179,127,85
42,r_146_123_87,r_145_96_90,r_121_63_154,r_145_96_90,0.73,-3,87,90,85
80,seq72,r_70_53_152,r_135_69_132,r_135_69_132,1,10,142,132,85
45,r_130_129_156,r_128_60_151,r_83_124_55,r_83_124_55,0.87,98,153,55,85
76,seq55,seq59,r_98_56_19,r_98_56_19,1,46,65,19,85
10,r_10_54_65,seq13,r_97_58_35,r_10_54_65,1,1,66,65,85
41,r_126_32_138,r_1_0_143,r_21_33_161,r_21_33_161,0.59,0,161,161,85
81,seq74,seq75,r_52_73_47,r_52_73_47,0.96,2,49,47,85
72,seq44,r_45_76_82,r_29_46_71,r_29_46_71,0.77,12,83,71,85
37,r_77_57_18,seq81,r_98_56_19,r_98_56_19,0.94,0,19,19,85
0,r_40_5_78,seq41,seq4,r_40_5_78,1,0,78,78,85
63,seq23,r_22_30_195,r_148_15_45,r_148_15_45,1,150,195,45,85
11,r_116_24_71,r_113_36_82,seq25,r_116_24_71,0.97,0,71,71,85
20,r_108_71_168,seq109,seq72,r_108_71_168,0.6,0,168,168,85
15,r_138_67_78,seq139,seq65,r_138_67_78,1,0,78,78,85
12,r_17_86_57,r_87_39_201,r_119_82_161,r_119_82_161,1,40,201,161,85
85,seq90,r_91_149_192,r_17_86_57,r_17_86_57,1,134,191,57,85
10,r_10_54_65,r_97_58_35,r_70_53_152,r_10_54_65,0.35,78,143,65,85
39,r_14_37_55,seq13,seq38,r_14_37_55,1,1,56,55,85
2,r_62_20_147,seq64,seq16,r_62_20_147,0.7,0,147,147,85
40,r_121_63_154,r_119_82_161,r_138_67_78,r_119_82_161,0.78,-7,154,161,85
14,r_52_73_47,seq48,seq74,r_52_73_47,0.97,0,47,47,85
18,r_21_33_161,r_22_30_195,r_126_32_138,r_21_33_161,0.92,0,161,161,85
57,seq13,r_14_37_55,seq12,r_14_37_55,1,1,56,55,85
24,r_84_134_120,r_87_39_201,seq137,r_84_134_120,0.89,0,120,120,85
25,r_34_49_120,r_35_78_87,r_14_37_55,r_35_78_87,0.5,1,88,87,85
33,r_95_85_91,seq94,r_17_86_57,r_95_85_91,1,0,91,91,85
48,r_105_68_137,seq99,r_135_69_132,r_105_68_137,0.9,0,137,137,85
13,r_98_56_19,r_97_58_35,r_77_57_18,r_77_57_18,1,1,19,18,85
88,seq99,seq100,r_145_96_90,r_145_96_90,1,7,97,90,85
31,r_144_3_46,r_145_96_90,seq4,r_144_3_46,1,0,46,46,85
50,seq131,r_145_96_90,seq137,r_145_96_90,1,-26,64,90,85
42,r_146_123_87,r_121_63_154,seq118,r_121_63_154,1,0,154,154,85
34,r_107_61_109,seq106,seq59,r_107_61_109,1,0,109,109,85
30,r_104_147_48,r_105_68_137,seq143,r_104_147_48,1,0,48,48,85
17,r_128_60_151,r_130_129_156,r_107_61_109,r_128_60_151,0.86,0,151,151,85
9,r_45_76_82,seq44,seq75,r_45_76_82,0.9,0,82,82,85
77,seq59,seq55,r_97_58_35,r_97_58_35,1,17,52,35,85
22,r_87_39_201,r_84_134_120,r_17_86_57,r_87_39_201,0.96,-93,108,201,85
28,r_2_31_162,r_1_0_143,seq28,r_1_0_143,0.41,24,167,143,85
49,r_79_117_117,r_80_92_135,seq115,r_79_117_117,0.82,0,117,117,85
7,r_122_8_104,r_119_82_161,seq12,r_122_8_104,0.99,0,104,104,85
44,r_145_96_90,seq143,seq99,r_145_96_90,0.99,0,90,90,85
35,r_29_46_71,seq28,seq44,r_29_46_71,1,0,71,71,85
23,r_120_112_11,r_119_82_161,seq114,r_120_112_11,0.94,0,11,11,85
51,seq1,r_2_136_161,r_55_0_82,r_55_0_82,1,43,125,82,86
9,r_44_100_16,r_101_72_160,r_103_107_143,r_101_72_160,0.88,0,160,160,86
92,seq109,r_108_80_78,r_103_107_143,r_108_80_78,1,0,78,78,86
8,r_99_50_192,seq124,r_38_98_65,r_38_98_65,1,11,76,65,86
53,seq6,r_7_56_176,r_130_9_113,r_130_9_113,1,63,176,113,86
43,r_28_46_69,r_29_61_176,r_45_115_187,r_28_46_69,1,0,69,69,86
23,r_27_40_24,r_22_105_69,seq41,r_27_40_24,0.98,-1,23,24,86
37,r_7_56_176,seq6,r_42_57_33,r_7_56_176,0.39,0,176,176,86
14,r_42_57_33,r_36_83_142,r_119_58_34,r_42_57_33,1,1,34,33,86
71,seq52,seq54,r_102_53_66,r_102_53_66,1,17,83,66,86
16,r_36_83_142,seq37,r_122_79_124,r_36_83_142,0.92,0,142,142,86
21,r_108_80_78,seq109,seq87,r_108_80_78,0.95,2,80,78,86
1,r_116_49_174,seq113,r_149_48_136,r_116_49_174,0.55,0,174,174,86
39,r_45_115_187,r_44_100_16,r_59_140_115,r_45_115_187,0.76,-169,18,187,86
5,r_68_144_73,r_69_117_152,seq141,r_68_144_73,1,0,73,73,86
42,r_149_48_136,r_146_32_195,r_28_46_69,r_28_46_69,0.84,68,137,69,86
45,r_26_74_170,r_29_61_176,r_90_76_169,r_90_76_169,0.79,1,170,169,86
47,r_123_12_33,r_5_4_150,r_55_0_82,r_123_12_33,0.58,152,185,33,86
47,r_123_12_33,r_122_79_124,seq14,r_123_12_33,1,1,34,33,86
19,r_122_79_124,r_121_17_129,r_108_80_78,r_121_17_129,1,-5,124,129,86
27,r_22_105_69,r_104_3_194,r_103_107_143,r_22_105_69,0.58,125,194,69,86
31,r_8_35_62,r_7_56_176,seq34,r_8_35_62,0.91,0,62,62,86
67,seq34,seq31,r_8_35_62,r_8_35_62,0.98,2,64,62,86
3,r_110_33_152,seq113,r_8_35_62,r_110_33_152,0.48,0,152,152,86
10,r_94_19_185,r_93_24_116,r_13_88_24,r_94_19_185,0.97,-78,107,185,86
9,r_44_100_16,r_45_115_187,r_101_72_160,r_44_100_16,1,0,16,16,86
26,r_73_138_80,seq70,seq139,r_73_138_80,1,0,80,80,86
4,r_106_148_150,r_104_3_194,seq147,r_106_148_150,0.91,0,150,150,86
0,r_101_72_160,r_102_53_66,r_44_100_16,r_102_53_66,0.93,0,66,66,86
11,r_102_53_66,r_101_72_160,seq52,r_102_53_66,1,0,66,66,86
20,r_38_98_65,seq37,r_99_50_192,r_38_98_65,1,0,65,65,86
13,r_11_43_125,seq10,r_27_40_24,r_11_43_125,0.64,0,125,125,86
59,seq14,seq18,r_71_15_153,r_71_15_153,0.95,2,155,153,86
39,r_45_115_187,r_59_140_115,r_42_57_33,r_42_57_33,0.58,9,42,33,86
48,r_82_134_79,seq84,seq133,r_82_134_79,0.99,0,79,79,86
15,r_13_88_24,seq14,seq87,r_13_88_24,1,0,24,24,86
44,r_93_24_116,r_108_80_78,r_131_25_71,r_93_24_116,1,1,117,116,86
57,seq139,seq137,r_73_138_80,r_73_138_80,1,19,99,80,86
6,r_103_107_143,r_106_148_150,r_22_105_69,r_22_105_69,0.99,81,150,69,86
0,r_101_72_160,r_44_100_16,seq70,r_44_100_16,0.58,144,160,16,86
10,r_94_19_185,r_13_88_24,seq18,r_94_19_185,0.97,0,185,185,86
27,r_22_105_69,r_29_61_176,r_104_3_194,r_22_105_69,1,0,69,69,86
30,r_142_120_41,r_122_79_124,r_63_118_123,r_142_120_41,0.68,83,124,41,86
59,seq14,r_13_88_24,r_16_126_159,r_13_88_24,0.95,-3,21,24,86
40,r_59_140_115,seq60,seq137,r_59_140_115,1,0,115,115,86
18,r_16_126_159,seq20,seq127,r_16_126_159,0.85,0,159,159,86
29,r_2_136_161,seq1,seq137,r_2_136_161,0.83,0,161,161,86
43,r_28_46_69,r_45_115_187,r_116_49_174,r_116_49_174,0.9,11,185,174,86
33,r_71_15_153,seq70,seq14,r_71_15_153,0.84,0,153,153,86
47,r_123_12_33,seq14,r_5_4_150,r_123_12_33,0.45,112,145,33,86
65,seq23,r_29_61_176,r_131_25_71,r_131_25_71,1,22,93,71,86
20,r_38_98_65,r_99_50_192,r_44_100_16,r_99_50_192,0.23,0,192,192,86
68,seq37,r_36_83_142,r_27_40_24,r_36_83_142,0.54,0,142,142,86
32,r_131_25_71,seq133,seq23,r_131_25_71,1,0,71,71,86
38,r_29_61_176,r_26_74_170,r_47_21_11,r_47_21_11,0.92,121,132,11,86
25,r_47_21_11,r_44_100_16,seq23,r_47_21_11,1,0,11,11,86
81,seq78,seq92,r_13_88_24,r_13_88_24,0.92,93,117,24,86
2,r_30_132_53,seq31,seq133,r_30_132_53,1,0,53,53,86
39,r_45_115_187,r_28_46_69,seq111,r_45_115_187,0.45,0,187,187,86
22,r_104_3_194,r_106_148_150,r_22_105_69,r_22_105_69,0.99,20,89,69,86
28,r_63_118_123,seq64,r_142_120_41,r_63_118_123,0.94,0,123,123,86
7,r_130_9_113,seq129,seq6,r_130_9_113,0.97,0,113,113,86
66,seq31,r_30_132_53,r_27_40_24,r_30_132_53,0.81,-20,33,53,86
44,r_93_24_116,r_94_19_185,r_108_80_78,r_108_80_78,0.99,10,88,78,86
38,r_29_61_176,r_47_21_11,seq60,r_29_61_176,0.95,0,176,176,86
30,r_142_120_41,seq141,r_122_79_124,r_142_120_41,0.98,0,41,41,86
34,r_119_58_34,r_116_49_174,r_42_57_33,r_119_58_34,0.99,2,36,34,86
12,r_55_0_82,seq54,seq1,r_55_0_82,1,0,82,82,86
39,r_45_115_187,r_42_57_33,r_28_46_69,r_28_46_69,0.99,1,70,69,86
93,seq104,r_105_96_116,seq102,r_105_96_116,0.98,3,119,116,87
13,r_11_33_14,seq9,seq31,r_11_33_14,0.83,4,18,14,87
92,seq102,r_103_89_85,seq104,r_103_89_85,0.99,0,85,85,87
14,r_106_68_88,r_107_43_151,seq70,r_106_68_88,0.96,1,89,88,87
43,r_36_42_99,r_37_3_118,seq40,r_36_42_99,1,0,99,99,87
47,r_91_125_131,r_74_92_83,r_135_124_4,r_91_125_131,0.98,0,131,131,87
83,seq75,r_74_92_83,seq82,r_74_92_83,0.92,0,83,83,87
37,r_15_113_84,seq14,seq112,r_15_113_84,1,0,84,84,87
26,r_139_120_21,r_138_142_28,seq115,r_139_120_21,0.95,0,21,21,87
86,seq86,r_85_129_81,seq87,r_85_129_81,1,3,84,81,87
16,r_77_25_164,r_119_79_8,r_54_24_156,r_119_79_8,0.69,156,164,8,87
21,r_8_72_62,seq13,seq75,r_8_72_62,1,0,62,62,87
46,r_119_79_8,r_77_25_164,r_131_78_51,r_131_78_51,0.55,113,164,51,87
42,r_12_136_184,seq13,r_121_137_158,r_12_136_184,0.53,0,184,184,87
44,r_94_26_17,r_77_25_164,r_21_61_196,r_94_26_17,0.82,0,17,17,87
4,r_84_127_24,r_85_129_81,r_128_51_103,r_84_127_24,0.71,1,25,24,87
32,r_146_50_23,r_49_88_133,r_128_51_103,r_146_50_23,0.75,87,110,23,87
45,r_107_43_151,seq109,r_36_42_99,r_107_43_151,0.71,0,151,151,87
22,r_65_53_13,r_84_127_24,r_49_88_133,r_65_53_13,0.88,2,15,13,87
95,seq112,seq115,r_15_113_84,r_15_113_84,1,1,85,84,87
94,seq109,r_106_68_88,r_39_108_47,r_39_108_47,0.76,4,51,47,87
38,r_128_51_103,r_84_127_24,r_146_50_23,r_128_51_103,1,0,103,103,87
31,r_74_92_83,seq75,r_91_125_131,r_74_92_83,0.72,0,83,83,87
41,r_105_96_116,seq104,r_122_95_112,r_105_96_116,0.97,3,119,116,87
89,seq98,r_97_46_91,r_74_92_83,r_97_46_91,0.88,0,91,91,87
20,r_130_110_10,r_131_78_51,seq115,r_130_110_10,0.53,7,17,10,87
3,r_35_148_131,r_37_3_118,r_2_149_31,r_37_3_118,0.97,12,130,118,87
0,r_37_3_118,r_35_148_131,seq4,r_35_148_131,0.73,-11,120,131,87
63,seq132,r_133_147_135,r_85_129_81,r_85_129_81,1,17,98,81,87
11,r_116_29_96,r_118_32_139,seq30,r_116_29_96,0.51,0,96,96,87
39,r_126_17_56,r_16_7_81,seq20,r_126_17_56,0.55,25,81,56,87
31,r_74_92_83,r_91_125_131,r_122_95_112,r_74_92_83,0.7,48,131,83,87
15,r_1_111_171,seq4,r_130_110_10,r_1_111_171,0.46,0,171,171,87
48,r_103_89_85,seq102,seq87,r_103_89_85,0.73,0,85,85,87
4,r_84_127_24,r_128_51_103,r_135_124_4,r_128_51_103,1,0,103,103,87
17,r_16_7_81,r_126_17_56,seq9,r_16_7_81,0.64,0,81,81,87
6,r_122_95_112,seq123,seq98,r_122_95_112,0.93,0,112,112,87
85,seq82,r_77_25_164,r_71_83_76,r_77_25_164,0.68,-69,95,164,87
27,r_85_129_81,seq86,seq132,r_85_129_81,1,3,84,81,87
38,r_128_51_103,r_122_95_112,r_84_127_24,r_84_127_24,0.63,22,46,24,87
22,r_65_53_13,r_49_88_133,r_80_52_41,r_65_53_13,0.95,108,121,13,87
39,r_126_17_56,r_122_95_112,r_16_7_81,r_126_17_56,0.94,0,56,56,87
2,r_48_10_118,seq47,seq9,r_48_10_118,0.97,0,118,118,87
47,r_91_125_131,r_93_57_73,r_74_92_83,r_91_125_131,0.71,-45,86,131,87
40,r_54_24_156,r_49_88_133,r_80_52_41,r_80_52_41,0.91,80,121,41,87
29,r_41_64_142,seq40,seq62,r_41_64_142,0.91,0,142,142,87
24,r_38_18_124,r_35_148_131,seq20,r_38_18_124,0.53,0,124,124,87
25,r_76_145_153,r_77_25_164,seq144,r_77_25_164,0.6,-11,153,164,87
33,r_93_57_73,r_91_125_131,seq56,r_93_57_73,1,0,73,73,87
64,seq28,seq30,r_77_25_164,r_77_25_164,1,20,184,164,87
65,seq30,seq28,r_116_29_96,r_116_29_96,1,6,102,96,87
20,r_130_110_10,seq115,r_39_108_47,r_39_108_47,0.99,105,152,47,87
68,seq40,r_41_64_142,r_36_42_99,r_36_42_99,0.6,43,142,99,87
58,seq144,seq140,r_2_149_31,r_2_149_31,1,1,32,31,87
34,r_27_99_114,seq23,r_122_95_112,r_27_99_114,1,0,114,114,87
40,r_54_24_156,r_80_52_41,r_94_26_17,r_54_24_156,1,0,156,156,87
17,r_16_7_81,seq19,r_126_17_56,r_126_17_56,0.91,9,65,56,87
9,r_118_32_139,seq117,r_11_33_14,r_118_32_139,0.99,0,139,139,87
1,r_0_81_41,r_1_111_171,seq82,r_0_81_41,1,0,41,41,87
28,r_97_46_91,seq98,seq45,r_97_46_91,1,0,91,91,87
18,r_80_52_41,r_77_25_164,r_65_53_13,r_80_52_41,0.77,0,41,41,87
49,r_69_34_135,seq70,r_11_33_14,r_69_34_135,0.99,0,135,135,87
30,r_131_78_51,r_133_147_135,r_119_79_8,r_131_78_51,0.99,3,54,51,87
5,r_2_149_31,seq4,seq144,r_2_149_31,1,0,31,31,87
23,r_39_108_47,r_38_18_124,seq109,r_39_108_47,1,0,47,47,87
32,r_146_50_23,seq144,r_49_88_133,r_146_50_23,1,0,23,23,87
89,seq98,r_74_92_83,r_122_95_112,r_122_95_112,0.92,14,126,112,87
35,r_133_147_135,seq132,r_35_148_131,r_35_148_131,0.84,6,137,131,87
12,r_49_88_133,r_54_24_156,r_103_89_85,r_49_88_133,0.88,0,133,133,87
32,r_8_56_126,r_40_9_63,seq58,r_8_56_126,1,1,127,126,88
14,r_40_9_63,seq44,r_10_125_180,r_40_9_63,1,0,63,63,88
54,seq11,r_12_45_108,seq13,r_12_45_108,1,0,108,108,88
21,r_97_121_166,r_93_96_78,seq117,r_97_121_166,0.61,2,168,166,88
30,r_47_4_23,r_51_80_36,seq3,r_47_4_23,1,0,23,23,88
1,r_12_45_108,seq11,seq44,r_12_45_108,1,0,108,108,88
5,r_140_59_84,r_142_143_154,seq60,r_140_59_84,0.98,0,84,84,88
46,r_124_35_160,r_123_114_163,seq36,r_124_35_160,0.5,0,160,160,88
45,r_62_139_162,seq63,seq141,r_62_139_162,0.54,1,163,162,88
19,r_76_5_185,r_71_118_193,r_69_6_168,r_69_6_168,0.81,17,185,168,88
15,r_29_14_137,r_148_27_19,r_129_16_110,r_129_16_110,1,27,137,110,88
95,seq116,r_113_17_136,r_128_115_37,r_113_17_136,0.82,0,136,136,88
39,r_48_66_42,seq64,r_46_65_124,r_46_65_124,1,29,153,124,88
41,r_49_103_14,r_47_4_23,r_100_24_183,r_49_103_14,0.87,-1,13,14,88
15,r_29_14_137,seq33,r_148_27_19,r_148_27_19,1,1,20,19,88
10,r_68_108_85,r_76_5_185,seq109,r_68_108_85,0.92,1,86,85,88
90,seq131,r_129_16_110,seq135,r_129_16_110,1,-20,90,110,88
26,r_75_126_137,r_74_130_149,r_123_114_163,r_75_126_137,0.66,-1,136,137,88
14,r_40_9_63,r_10_125_180,r_69_6_168,r_10_125_180,0.53,0,180,180,88
4,r_102_0_170,seq98,r_84_2_108,r_84_2_108,0.45,61,169,108,88
0,r_71_118_193,r_69_6_168,r_134_72_142,r_71_118_193,0.54,-25,168,193,88
20,r_112_53_95,r_113_17_136,seq54,r_112_53_95,0.96,0,95,95,88
13,r_69_6_168,r_71_118_193,r_40_9_63,r_71_118_193,0.78,-25,168,193,88
66,seq30,r_34_43_148,r_145_32_46,r_145_32_46,0.58,4,50,46,88
48,r_86_73_1,r_74_130_149,r_134_72_142,r_86_73_1,0.5,147,148,1,88
6,r_74_130_149,r_86_73_1,seq131,r_74_130_149,0.47,0,149,149,88
99,seq149,r_146_70_96,r_31_147_2,r_146_70_96,0.93,0,96,96,88
3,r_137_101_50,r_134_72_142,seq98,r_137_101_50,0.98,0,50,50,88
68,seq36,r_145_32_46,r_124_35_160,r_124_35_160,0.97,0,160,160,88
27,r_111_38_97,seq110,r_77_37_19,r_111_38_97,0.95,1,98,97,88
2,r_134_72_142,r_136_132_163,r_71_118_193,r_134_72_142,0.52,0,142,142,88
41,r_49_103_14,r_100_24_183,r_137_101_50,r_137_101_50,0.76,25,75,50,88
43,r_77_37_19,r_71_118_193,seq44,r_77_37_19,0.95,0,19,19,88
42,r_50_107_36,r_51_80_36,seq105,r_50_107_36,1,4,40,36,88
18,r_82_89_174,r_76_5_185,seq91,r_82_89_174,0.69,0,174,174,88
29,r_84_2_108,r_82_89_174,r_47_4_23,r_84_2_108,0.99,0,108,108,88
24,r_146_70_96,seq149,r_71_118_193,r_146_70_96,0.91,0,96,96,88
25,r_88_99_141,seq87,r_68_108_85,r_88_99_141,0.54,0,141,141,88
43,r_77_37_19,seq44,r_111_38_97,r_111_38_97,1,8,105,97,88
28,r_148_27_19,r_145_32_46,r_29_14_137,r_29_14_137,0.68,-118,19,137,88
68,seq36,r_34_43_148,r_145_32_46,r_145_32_46,1,88,134,46,88
32,r_8_56_126,r_7_79_79,r_40_9_63,r_8_56_126,0.92,-47,79,126,88
52,seq135,r_136_132_163,r_74_130_149,r_74_130_149,0.7,14,163,149,88
75,seq58,seq52,r_127_57_56,r_127_57_56,0.93,5,61,56,88
7,r_127_57_56,r_128_115_37,seq58,r_127_57_56,0.94,0,56,56,88
81,seq141,r_142_143_154,r_62_139_162,r_62_139_162,0.7,3,165,162,88
17,r_1_39_124,seq3,r_111_38_97,r_1_39_124,0.99,0,124,124,88
34,r_51_80_36,r_50_107_36,seq81,r_51_80_36,0.99,4,40,36,88
94,seq110,r_111_38_97,seq119,r_111_38_97,1,-1,96,97,88
9,r_67_106_160,r_82_89_174,r_137_101_50,r_137_101_50,0.57,110,160,50,88
40,r_145_32_46,seq149,seq30,r_145_32_46,1,0,46,46,88
28,r_148_27_19,r_29_14_137,r_90_28_125,r_90_28_125,1,12,137,125,88
49,r_90_28_125,seq91,r_148_27_19,r_90_28_125,0.86,0,125,125,88
44,r_123_114_163,r_124_35_160,r_128_115_37,r_124_35_160,0.86,0,160,160,88
23,r_10_125_180,r_7_79_79,r_40_9_63,r_10_125_180,1,-109,71,180,88
11,r_128_115_37,r_127_57_56,seq116,r_127_57_56,1,-17,39,56,88
38,r_83_120_41,r_74_130_149,seq119,r_83_120_41,0.95,0,41,41,88
35,r_129_16_110,seq131,seq15,r_129_16_110,0.98,0,110,110,88
12,r_7_79_79,r_8_56_126,r_51_80_36,r_7_79_79,1,0,79,79,88
39,r_48_66_42,r_46_65_124,seq64,r_48_66_42,0.93,0,42,42,88
23,r_10_125_180,r_40_9_63,r_97_121_166,r_10_125_180,0.53,0,180,180,88
30,r_134_36_70,seq135,r_87_35_41,r_134_36_70,1,0,70,70,89
6,r_39_56_33,r_46_75_178,seq55,r_39_56_33,0.9,-1,32,33,89
37,r_43_129_16,r_39_56_33,seq130,r_43_129_16,1,0,16,16,89
8,r_128_21_140,seq130,seq22,r_128_21_140,0.91,0,140,140,89
53,seq7,seq8,r_13_5_84,r_13_5_84,0.57,3,87,84,89
40,r_20_67_12,r_24_111_20,seq71,r_20_67_12,0.59,0,12,12,89
36,r_41_121_11,r_44_144_162,r_123_86_181,r_41_121_11,0.92,0,11,11,89
32,r_118_73_45,r_120_9_58,seq74,r_118_73_45,0.79,0,45,45,89
19,r_137_16_32,seq22,r_132_42_58,r_132_42_58,0.68,53,111,58,89
75,seq61,seq55,r_19_50_27,r_19_50_27,0.67,29,56,27,89
71,seq52,r_54_25_168,r_48_53_44,r_48_53_44,1,16,60,44,89
16,r_78_63_93,r_76_145_78,seq61,r_78_63_93,0.68,-16,77,93,89
39,r_54_25_168,seq52,r_38_27_124,r_38_27_124,0.56,45,169,124,89
46,r_47_32_157,r_46_75_178,r_132_42_58,r_132_42_58,1,31,89,58,89
42,r_148_143_174,seq149,r_76_145_78,r_76_145_78,0.86,96,174,78,89
10,r_68_18_133,r_76_145_78,r_20_67_12,r_76_145_78,1,-35,43,78,89
24,r_123_86_181,r_41_121_11,r_66_124_111,r_66_124_111,1,2,113,111,89
31,r_48_53_44,r_78_63_93,seq52,r_48_53_44,0.88,0,44,44,89
17,r_87_35_41,seq31,r_134_36_70,r_134_36_70,1,2,72,70,89
56,seq130,r_132_42_58,r_43_129_16,r_132_42_58,0.49,-30,28,58,89
41,r_17_30_69,seq22,r_117_28_20,r_17_30_69,0.57,0,69,69,89
23,r_6_139_26,seq7,seq140,r_6_139_26,1,0,26,26,89
9,r_51_84_24,r_54_25_168,seq85,r_51_84_24,0.49,0,24,24,89
26,r_65_49_62,r_68_18_133,seq31,r_65_49_62,0.64,0,62,62,89
5,r_29_101_17,seq33,seq103,r_29_101_17,0.93,0,17,17,89
98,seq119,r_120_9_58,seq116,r_120_9_58,0.99,-2,56,58,89
36,r_41_121_11,r_123_86_181,r_10_122_49,r_10_122_49,1,14,63,49,89
0,r_109_64_137,seq119,seq61,r_109_64_137,0.95,0,137,137,89
20,r_76_145_78,r_77_92_81,seq146,r_76_145_78,0.99,0,78,78,89
17,r_87_35_41,seq80,seq31,r_87_35_41,0.95,0,41,41,89
12,r_10_122_49,seq8,r_41_121_11,r_10_122_49,0.99,1,50,49,89
13,r_90_102_157,seq91,r_29_101_17,r_90_102_157,0.43,0,157,157,89
19,r_137_16_32,r_132_42_58,r_68_18_133,r_137_16_32,0.55,105,137,32,89
15,r_44_144_162,seq45,r_76_145_78,r_44_144_162,0.56,0,162,162,89
48,r_147_113_155,seq149,seq114,r_147_113_155,0.84,0,155,155,89
26,r_65_49_62,r_77_92_81,r_46_75_178,r_46_75_178,0.55,-6,172,178,89
10,r_68_18_133,r_20_67_12,seq22,r_68_18_133,0.62,0,133,133,89
3,r_24_111_20,r_19_50_27,seq116,r_24_111_20,1,0,20,20,89
2,r_93_112_125,seq96,r_24_111_20,r_93_112_125,1,0,125,125,89
28,r_127_138_41,r_132_42_58,seq141,r_127_138_41,0.98,0,41,41,89
18,r_81_60_136,seq82,r_39_56_33,r_39_56_33,0.79,103,136,33,89
1,r_132_42_58,seq130,r_47_32_157,r_132_42_58,1,0,58,58,89
29,r_95_133_62,seq96,r_43_129_16,r_95_133_62,1,0,62,62,89
22,r_26_79_37,seq22,seq71,r_26_79_37,0.98,4,41,37,89
61,seq22,seq8,r_128_21_140,r_128_21_140,0.65,8,148,140,89
34,r_117_28_20,seq33,r_17_30_69,r_17_30_69,1,33,102,69,89
25,r_66_124_111,seq71,r_123_86_181,r_66_124_111,0.98,1,112,111,89
43,r_23_88_36,seq22,seq91,r_23_88_36,1,-2,34,36,89
33,r_115_99_103,seq116,seq97,r_115_99_103,1,0,103,103,89
50,seq1,r_0_69_165,r_131_3_12,r_131_3_12,0.99,153,165,12,89
65,seq37,r_38_27_124,r_47_32_157,r_38_27_124,0.76,-31,93,124,89
68,seq45,r_44_144_162,r_132_42_58,r_132_42_58,1,104,162,58,89
25,r_66_124_111,r_123_86_181,r_10_122_49,r_123_86_181,0.45,-10,171,181,89
45,r_131_3_12,r_132_42_58,seq2,r_131_3_12,0.9,0,12,12,89
14,r_120_9_58,seq119,seq12,r_120_9_58,1,0,58,58,89
95,seq110,r_115_99_103,r_24_111_20,r_24_111_20,0.79,0,20,20,89
11,r_59_125_24,seq55,seq126,r_59_125_24,1,0,24,24,89
96,seq114,seq116,r_147_113_155,r_147_113_155,1,28,183,155,89
79,seq140,seq146,r_6_139_26,r_6_139_26,1,3,29,26,89
34,r_117_28_20,r_120_9_58,seq33,r_117_28_20,1,1,21,20,89
24,r_123_86_181,r_109_64_137,r_41_121_11,r_41_121_11,0.88,4,15,11,89
49,r_0_69_165,seq1,r_26_79_37,r_26_79_37,0.61,128,165,37,89
44,r_77_92_81,r_76_145_78,seq96,r_76_145_78,0.98,0,78,78,89
19,r_137_16_32,r_134_36_70,seq22,r_137_16_32,0.87,0,32,32,89
21,r_135_35_54,seq144,seq39,r_135_35_54,1,0,54,54,90
6,r_109_138_20,r_117_110_54,seq146,r_109_138_20,0.98,0,20,20,90
70,seq49,r_52_47_180,r_20_48_56,r_20_48_56,1,0,56,56,90
95,seq108,r_106_113_42,seq123,r_106_113_42,0.77,5,47,42,90
8,r_42_115_71,seq41,r_106_113_42,r_42_115_71,1,0,71,71,90
54,seq133,seq146,r_18_134_122,r_18_134_122,1,7,129,122,90
3,r_61_17_134,r_65_57_49,r_63_21_81,r_61_17_134,0.85,1,135,134,90
22,r_45_8_17,r_42_115_71,seq10,r_45_8_17,1,0,17,17,90
26,r_106_113_42,seq108,r_117_110_54,r_106_113_42,0.93,5,47,42,90
40,r_116_85_15,r_109_138_20,seq84,r_116_85_15,0.96,0,15,15,90
86,seq86,r_87_11_128,r_58_80_1,r_87_11_128,1,-1,127,128,90
1,r_44_75_167,r_43_9_141,r_68_31_144,r_44_75_167,0.5,-26,141,167,90
97,seq121,r_118_7_152,r_16_120_84,r_16_120_84,0.99,39,123,84,90
28,r_26_73_51,seq27,r_70_72_16,r_26_73_51,0.72,0,51,51,90
46,r_148_50_115,seq146,r_20_48_56,r_148_50_115,0.98,0,115,115,90
7,r_18_134_122,r_23_19_15,seq133,r_18_134_122,1,0,122,122,90
45,r_16_120_84,seq10,seq121,r_16_120_84,1,0,84,84,90
10,r_81_104_20,seq82,seq105,r_81_104_20,1,0,20,20,90
19,r_34_60_61,seq32,r_65_57_49,r_34_60_61,0.84,0,61,61,90
11,r_65_57_49,r_61_17_134,r_34_60_61,r_61_17_134,0.86,1,135,134,90
31,r_97_149_152,seq95,seq145,r_97_149_152,0.99,0,152,152,90
94,seq105,seq103,r_81_104_20,r_81_104_20,0.96,15,35,20,90
3,r_61_17_134,seq55,r_65_57_49,r_65_57_49,0.85,18,67,49,90
42,r_4_141_71,seq2,seq140,r_4_141_71,1,0,71,71,90
36,r_25_69_29,r_24_12_104,seq62,r_25_69_29,0.99,0,29,29,90
47,r_23_19_15,r_24_12_104,r_18_134_122,r_23_19_15,0.61,0,15,15,90
14,r_89_119_9,r_118_7_152,r_16_120_84,r_16_120_84,0.91,68,152,84,90
48,r_3_96_40,r_4_141_71,r_126_98_40,r_3_96_40,0.99,0,40,40,90
4,r_52_47_180,seq49,r_139_51_27,r_139_51_27,0.88,38,65,27,90
0,r_67_107_163,seq66,seq108,r_67_107_163,0.24,0,163,163,90
63,seq27,r_24_12_104,seq41,r_24_12_104,0.97,0,104,104,90
20,r_63_21_81,seq64,r_23_19_15,r_63_21_81,1,0,81,81,90
69,seq46,r_42_115_71,seq49,r_42_115_71,1,-27,44,71,90
98,seq123,r_122_137_69,seq125,r_122_137_69,1,0,69,69,90
34,r_126_98_40,r_18_134_122,r_3_96_40,r_126_98_40,0.79,-6,34,40,90
99,seq125,seq123,r_54_124_149,r_54_124_149,0.95,6,155,149,90
2,r_40_1_141,seq41,seq0,r_40_1_141,0.86,0,141,141,90
42,r_4_141_71,r_3_96_40,seq2,r_3_96_40,1,0,40,40,90
18,r_71_129_99,seq84,seq128,r_71_129_99,0.97,0,99,99,90
29,r_88_114_148,r_71_129_99,r_22_90_65,r_22_90_65,0.75,12,77,65,90
25,r_24_12_104,seq27,seq10,r_24_12_104,1,0,104,104,90
33,r_43_9_141,r_44_75_167,r_24_12_104,r_24_12_104,0.65,37,141,104,90
64,seq30,r_29_131_136,r_147_28_5,r_29_131_136,0.92,0,136,136,90
47,r_23_19_15,r_18_134_122,r_63_21_81,r_23_19_15,0.93,107,122,15,90
23,r_118_7_152,r_122_137_69,r_89_119_9,r_118_7_152,0.73,-142,10,152,90
50,seq0,r_4_141_71,r_6_37_154,r_4_141_71,1,2,73,71,90
6,r_109_138_20,seq146,r_122_137_69,r_122_137_69,1,31,100,69,90
68,seq41,r_40_1_141,seq27,r_40_1_141,0.89,0,141,141,90
38,r_22_90_65,r_18_134_122,r_88_114_148,r_22_90_65,1,0,65,65,90
52,seq2,r_4_141_71,r_45_8_17,r_4_141_71,0.58,0,71,71,90
37,r_6_37_154,r_4_141_71,r_23_19_15,r_6_37_154,0.9,-128,26,154,90
44,r_70_72_16,r_67_107_163,r_26_73_51,r_26_73_51,0.97,1,52,51,90
13,r_139_51_27,r_135_35_54,r_52_47_180,r_52_47_180,0.89,-153,27,180,90
38,r_22_90_65,r_88_114_148,seq66,r_88_114_148,0.95,-33,115,148,90
7,r_18_134_122,r_22_90_65,r_23_19_15,r_18_134_122,0.92,-92,30,122,90
17,r_101_59_142,seq100,r_65_57_49,r_101_59_142,0.87,0,142,142,90
29,r_88_114_148,r_22_90_65,r_58_80_1,r_22_90_65,0.36,50,115,65,90
26,r_106_113_42,r_117_110_54,r_42_115_71,r_42_115_71,1,50,121,71,90
37,r_6_37_154,r_23_19_15,r_68_31_144,r_6_37_154,0.56,0,154,154,90
29,r_88_114_148,r_58_80_1,r_106_113_42,r_88_114_148,0.93,0,148,148,90
49,r_127_136_143,seq130,r_122_137_69,r_122_137_69,1,74,143,69,90
32,r_99_53_55,r_101_59_142,r_139_51_27,r_99_53_55,0.96,0,55,55,90
11,r_65_57_49,r_67_107_163,r_61_17_134,r_65_57_49,0.92,3,52,49,90
35,r_54_124_149,seq49,seq125,r_54_124_149,0.85,0,149,149,90
12,r_15_112_74,r_16_120_84,r_42_115_71,r_42_115_71,0.71,3,74,71,90
95,seq108,seq123,r_67_107_163,r_67_107_163,0.7,1,164,163,90
23,r_118_7_152,r_89_119_9,r_61_17_134,r_61_17_134,0.52,19,153,134,90
36,r_28_10_75,r_29_18_185,seq14,r_28_10_75,1,0,75,75,91
29,r_124_50_141,r_125_37_41,r_146_122_27,r_125_37_41,0.63,-14,27,41,91
11,r_114_76_142,r_115_128_51,seq111,r_114_76_142,0.72,-95,47,142,91
8,r_119_43_128,seq120,seq44,r_119_43_128,0.96,0,128,128,91
43,r_54_17_129,seq55,seq11,r_54_17_129,1,0,129,129,91
26,r_27_94_38,seq24,seq93,r_27_94_38,0.99,-1,37,38,91
90,seq93,r_95_62_116,r_27_94_38,r_27_94_38,0.91,-1,37,38,91
1,r_34_97_122,r_36_6_136,r_61_96_96,r_36_6_136,0.53,-9,127,136,91
97,seq140,seq134,r_35_139_116,r_35_139_116,1,6,122,116,91
48,r_125_37_41,r_124_50_141,seq39,r_125_37_41,1,0,41,41,91
69,seq42,r_40_33_159,r_104_41_105,r_104_41_105,0.99,19,124,105,91
11,r_114_76_142,r_147_118_15,r_45_78_8,r_114_76_142,1,0,142,142,91
30,r_89_88_87,seq80,r_108_90_36,r_108_90_36,1,1,37,36,91
19,r_133_23_139,seq134,r_142_22_8,r_133_23_139,0.91,1,140,139,91
13,r_143_135_22,seq145,seq134,r_143_135_22,0.8,0,22,22,91
15,r_66_144_192,r_68_100_177,r_95_62_116,r_66_144_192,0.5,-27,165,192,91
4,r_115_128_51,r_114_76_142,seq127,r_115_128_51,1,0,51,51,91
10,r_146_122_27,r_35_139_116,r_13_126_159,r_13_126_159,0.96,4,163,159,91
76,seq56,seq57,r_109_58_20,r_109_58_20,1,82,102,20,91
16,r_109_58_20,r_104_41_105,seq57,r_109_58_20,0.99,0,20,20,91
31,r_87_8_81,r_89_88_87,r_69_5_44,r_89_88_87,0.62,-6,81,87,91
41,r_35_139_116,r_36_6_136,seq140,r_35_139_116,0.93,1,117,116,91
27,r_38_70_13,r_69_5_44,r_121_63_39,r_38_70_13,1,31,44,13,91
46,r_131_77_26,seq132,r_45_78_8,r_131_77_26,1,0,26,26,91
78,seq64,r_65_123_181,r_95_62_116,r_95_62_116,0.88,65,181,116,91
0,r_117_112_65,r_114_76_142,seq113,r_117_112_65,0.87,1,66,65,91
73,seq51,seq56,r_124_50_141,r_124_50_141,1,9,150,141,91
98,seq120,r_119_43_128,r_147_118_15,r_119_43_128,0.75,0,128,128,91
10,r_146_122_27,seq141,r_124_50_141,r_146_122_27,0.84,1,28,27,91
15,r_66_144_192,seq67,r_68_100_177,r_66_144_192,0.45,-155,37,192,91
27,r_38_70_13,r_121_63_39,r_124_50_141,r_121_63_39,0.4,100,139,39,91
2,r_61_96_96,r_102_84_200,r_34_97_122,r_34_97_122,1,0,122,122,91
72,seq49,r_34_97_122,r_137_48_13,r_137_48_13,0.84,0,13,13,91
6,r_72_129_80,r_74_99_158,r_115_128_51,r_72_129_80,1,0,80,80,91
27,r_38_70_13,r_35_139_116,r_69_5_44,r_38_70_13,0.78,0,13,13,91
85,seq83,r_82_110_123,seq85,r_82_110_123,0.99,-60,63,123,91
99,seq127,seq134,r_115_128_51,r_115_128_51,1,71,122,51,91
42,r_108_90_36,r_104_41_105,r_89_88_87,r_108_90_36,1,0,36,36,91
10,r_146_122_27,r_124_50_141,r_35_139_116,r_35_139_116,0.82,24,140,116,91
38,r_147_118_15,seq148,seq120,r_147_118_15,0.87,-2,13,15,91
27,r_38_70_13,r_124_50_141,r_95_62_116,r_38_70_13,0.46,137,150,13,91
2,r_61_96_96,r_60_32_188,r_102_84_200,r_61_96_96,0.57,0,96,96,91
11,r_114_76_142,seq111,r_147_118_15,r_147_118_15,0.44,69,84,15,91
40,r_107_71_106,seq106,seq73,r_107_71_106,1,0,106,106,91
12,r_137_48_13,r_133_23_139,seq49,r_137_48_13,0.99,0,13,13,91
18,r_15_81_132,r_13_126_159,seq80,r_15_81_132,0.98,0,132,132,91
23,r_9_105_55,seq3,seq106,r_9_105_55,1,0,55,55,91
25,r_65_123_181,seq64,r_115_128_51,r_65_123_181,0.55,1,182,181,91
33,r_104_41_105,r_107_71_106,seq42,r_104_41_105,0.85,0,105,105,91
3,r_47_20_29,seq42,r_21_31_168,r_47_20_29,0.99,0,29,29,91
50,seq0,r_1_25_99,seq14,r_1_25_99,1,-4,95,99,91
32,r_136_116_126,seq140,r_147_118_15,r_136_116_126,0.83,0,126,126,91
77,seq57,seq56,r_109_58_20,r_109_58_20,0.99,77,97,20,91
34,r_1_25_99,seq0,r_142_22_8,r_1_25_99,1,0,99,99,91
45,r_21_31_168,r_27_94_38,r_47_20_29,r_21_31_168,0.74,-138,30,168,91
45,r_21_31_168,r_47_20_29,r_142_22_8,r_142_22_8,0.83,177,185,8,91
17,r_95_62_116,seq93,r_121_63_39,r_121_63_39,0.78,78,117,39,91
96,seq113,seq111,r_117_112_65,r_117_112_65,0.85,10,75,65,91
29,r_124_50_141,r_146_122_27,seq51,r_124_50_141,0.94,0,141,141,91
22,r_68_100_177,seq67,seq101,r_68_100_177,0.31,0,177,177,91
28,r_82_110_123,seq83,r_117_112_65,r_82_110_123,0.99,0,123,123,91
24,r_121_63_39,seq134,seq64,r_121_63_39,0.9,1,40,39,91
7,r_40_33_159,seq42,r_125_37_41,r_125_37_41,0.96,123,164,41,91
44,r_19_138_129,r_29_18_185,r_35_139_116,r_29_18_185,0.7,-56,129,185,91
79,seq67,r_66_144_192,r_95_62_116,r_95_62_116,0.67,24,140,116,91
35,r_13_126_159,seq14,r_146_122_27,r_13_126_159,0.74,0,159,159,91
30,r_21_51_65,seq23,seq52,r_21_51_65,1,0,65,65,92
51,seq128,r_132_12_203,r_15_129_145,r_15_129_145,1,35,180,145,92
6,r_39_114_46,r_43_8_91,seq115,r_39_114_46,1,0,46,46,92
36,r_9_111_58,r_15_129_145,r_124_107_11,r_9_111_58,1,0,58,58,92
8,r_15_129_145,seq10,r_108_19_80,r_108_19_80,1,32,112,80,92
50,seq0,r_4_47_143,r_88_1_52,r_88_1_52,0.79,2,54,52,92
19,r_60_130_32,r_132_12_203,r_15_129_145,r_15_129_145,1,23,168,145,92
55,seq10,r_15_129_145,r_43_8_91,r_43_8_91,0.5,20,111,91,92
39,r_135_126_59,r_132_12_203,r_84_127_67,r_84_127_67,1,20,87,67,92
1,r_134_36_65,r_132_12_203,r_38_41_28,r_134_36_65,1,0,65,65,92
97,seq119,r_118_49_115,seq121,r_118_49_115,1,0,115,115,92
5,r_94_65_212,r_85_42_176,r_14_95_66,r_14_95_66,1,16,82,66,92
46,r_53_81_67,seq55,seq75,r_53_81_67,0.61,0,67,67,92
42,r_137_140_144,r_132_12_203,seq139,r_137_140_144,0.65,0,144,144,92
21,r_117_125_25,r_116_146_137,r_135_126_59,r_116_146_137,0.81,-101,36,137,92
27,r_76_20_25,r_78_131_139,seq16,r_76_20_25,1,0,25,25,92
15,r_44_11_147,r_134_36_65,r_43_8_91,r_44_11_147,0.62,0,147,147,92
66,seq28,r_29_63_119,seq26,r_29_63_119,0.96,0,119,119,92
41,r_108_19_80,seq106,r_76_20_25,r_108_19_80,0.95,0,80,80,92
89,seq91,r_85_42_176,r_14_95_66,r_14_95_66,1,72,138,66,92
61,seq23,seq24,r_76_20_25,r_76_20_25,0.4,155,180,25,92
28,r_88_1_52,r_85_42_176,seq0,r_88_1_52,1,0,52,52,92
44,r_50_82_141,r_123_48_106,r_53_81_67,r_50_82_141,0.87,0,141,141,92
4,r_143_142_51,seq145,r_149_144_96,r_149_144_96,0.65,5,101,96,92
0,r_110_33_87,seq113,seq34,r_110_33_87,0.97,0,87,87,92
17,r_123_48_106,r_50_82_141,r_4_47_143,r_4_47_143,0.51,-2,141,143,92
20,r_64_58_175,r_66_22_207,r_21_51_65,r_21_51_65,1,111,176,65,92
13,r_133_18_194,r_132_12_203,r_76_20_25,r_132_12_203,0.35,-9,194,203,92
46,r_53_81_67,seq75,r_7_80_156,r_7_80_156,1,0,156,156,92
15,r_44_11_147,seq37,r_134_36_65,r_134_36_65,1,5,70,65,92
48,r_5_69_95,r_4_47_143,seq67,r_5_69_95,0.96,0,95,95,92
82,seq70,r_71_112_52,r_73_72_18,r_73_72_18,0.88,-2,16,18,92
87,seq86,r_85_42_176,r_46_87_98,r_46_87_98,0.93,78,176,98,92
2,r_149_144_96,r_148_136_150,r_143_142_51,r_148_136_150,0.89,-54,96,150,92
40,r_66_22_207,seq62,r_64_58_175,r_66_22_207,0.37,-123,84,207,92
96,seq115,r_116_146_137,r_39_114_46,r_39_114_46,0.89,1,47,46,92
33,r_124_107_11,r_123_48_106,seq109,r_124_107_11,0.77,0,11,11,92
18,r_148_136_150,seq147,r_92_138_64,r_148_136_150,0.97,0,150,150,92
29,r_4_47_143,seq3,r_123_48_106,r_123_48_106,0.71,37,143,106,92
45,r_83_99_46,r_84_127_67,r_120_105_5,r_84_127_67,0.95,-21,46,67,92
35,r_92_138_64,r_133_18_194,r_39_114_46,r_133_18_194,0.28,0,194,194,92
25,r_97_93_90,seq104,r_14_95_66,r_14_95_66,1,54,120,66,92
70,seq34,seq35,r_110_33_87,r_110_33_87,0.95,23,110,87,92
61,seq23,r_21_51_65,seq10,r_21_51_65,0.95,2,67,65,92
32,r_14_95_66,r_15_129_145,r_94_65_212,r_14_95_66,1,0,66,66,92
38,r_89_45_84,r_85_42_176,r_134_36_65,r_134_36_65,1,23,88,65,92
47,r_71_112_52,seq70,seq113,r_71_112_52,0.61,-7,45,52,92
8,r_15_129_145,r_108_19_80,r_60_130_32,r_15_129_145,1,0,145,145,92
34,r_85_42_176,seq86,r_38_41_28,r_85_42_176,0.56,0,176,176,92
40,r_66_22_207,r_64_58_175,r_29_63_119,r_29_63_119,1,0,119,119,92
17,r_123_48_106,seq121,r_50_82_141,r_123_48_106,0.8,0,106,106,92
9,r_68_96_197,seq67,r_14_95_66,r_14_95_66,1,131,197,66,92
22,r_116_146_137,seq115,seq147,r_116_146_137,0.97,0,137,137,92
49,r_29_63_119,seq28,r_66_22_207,r_29_63_119,1,0,119,119,92
7,r_7_80_156,seq3,r_53_81_67,r_7_80_156,0.75,0,156,156,92
44,r_50_82_141,r_46_87_98,r_123_48_106,r_123_48_106,0.84,0,106,106,92
23,r_84_127_67,seq75,r_135_126_59,r_84_127_67,1,0,67,67,92
19,r_60_130_32,r_64_58_175,r_132_12_203,r_60_130_32,1,0,32,32,92
35,r_92_138_64,r_85_42_176,r_133_18_194,r_92_138_64,1,0,64,64,92
93,seq147,r_149_76_166,r_143_137_109,r_149_76_166,0.86,0,166,166,93
30,r_17_3_185,seq19,seq1,r_17_3_185,0.29,0,185,185,93
16,r_113_95_15,r_114_60_125,r_6_92_2,r_113_95_15,0.95,0,15,15,93
92,seq109,r_108_35_68,r_115_110_153,r_108_35_68,1,0,68,68,93
63,seq36,seq42,r_108_35_68,r_108_35_68,0.6,19,87,68,93
14,r_71_50_75,seq73,seq51,r_71_50_75,1,0,75,75,93
8,r_31_93_99,seq36,seq94,r_31_93_99,0.99,0,99,99,93
43,r_27_44_131,r_29_107_180,seq43,r_27_44_131,0.79,2,133,131,93
83,seq84,r_83_119_197,r_145_80_40,r_145_80_40,0.98,157,197,40,93
37,r_90_14_106,seq89,seq13,r_90_14_106,1,0,106,106,93
3,r_114_60_125,seq116,seq61,r_114_60_125,0.87,0,125,125,93
39,r_2_134_177,seq1,r_87_133_37,r_2_134_177,0.63,0,177,177,93
1,r_29_107_180,r_30_16_194,r_103_102_28,r_29_107_180,0.65,0,180,180,93
45,r_144_72_110,seq147,seq73,r_144_72_110,0.95,0,110,110,93
19,r_97_11_86,seq99,seq19,r_97_11_86,1,0,86,86,93
33,r_70_85_37,r_86_12_157,r_69_88_47,r_86_12_157,0.93,0,157,157,93
29,r_86_12_157,r_87_133_37,r_70_85_37,r_86_12_157,0.81,-119,38,157,93
31,r_124_130_121,seq123,seq127,r_124_130_121,0.48,-24,97,121,93
41,r_4_121_190,r_5_141_115,r_46_9_57,r_4_121_190,0.98,-75,115,190,93
10,r_30_16_194,r_29_107_180,r_49_22_131,r_49_22_131,0.8,45,176,131,93
4,r_100_26_135,r_103_102_28,r_29_107_180,r_100_26_135,0.68,0,135,135,93
81,seq79,r_83_119_197,r_37_78_22,r_37_78_22,1,0,22,22,93
0,r_75_136_155,r_74_53_162,seq120,r_75_136_155,0.68,0,155,155,93
63,seq36,r_34_57_64,seq42,r_34_57_64,0.96,-1,63,64,93
73,seq58,seq59,r_34_57_64,r_34_57_64,1,9,73,64,93
11,r_74_53_162,r_77_135_183,r_45_54_116,r_74_53_162,0.82,0,162,162,93
27,r_41_140_29,r_148_125_161,r_62_139_54,r_62_139_54,1,0,54,54,93
20,r_49_22_131,seq52,seq20,r_49_22_131,0.88,0,131,131,93
15,r_5_141_115,r_4_121_190,seq147,r_5_141_115,0.96,0,115,115,93
48,r_108_35_68,seq109,seq36,r_108_35_68,1,0,68,68,93
4,r_100_26_135,r_29_107_180,r_112_25_150,r_29_107_180,0.5,-13,167,180,93
62,seq23,r_24_32_142,r_100_26_135,r_100_26_135,0.79,7,142,135,93
33,r_70_85_37,r_69_88_47,r_86_12_157,r_70_85_37,0.67,0,37,37,93
99,seq127,r_126_138_134,r_124_130_121,r_126_138_134,0.78,-37,97,134,93
26,r_62_139_54,seq64,r_143_137_109,r_62_139_54,1,0,54,54,93
27,r_41_140_29,seq38,r_148_125_161,r_41_140_29,0.98,0,29,29,93
36,r_67_81_45,seq65,seq84,r_67_81_45,0.95,0,45,45,93
47,r_68_111_109,seq73,seq109,r_68_111_109,0.63,0,109,109,93
18,r_148_125_161,r_149_76_166,r_124_130_121,r_149_76_166,0.85,-5,161,166,93
28,r_46_9_57,r_45_54_116,r_33_7_8,r_46_9_57,1,0,57,57,93
13,r_145_80_40,r_143_137_109,seq79,r_145_80_40,1,0,40,40,93
32,r_126_138_134,seq127,r_143_137_109,r_126_138_134,0.72,0,134,134,93
38,r_34_57_64,seq36,seq58,r_34_57_64,0.99,0,64,64,93
25,r_37_78_22,r_41_140_29,seq79,r_37_78_22,0.99,0,22,22,93
3,r_114_60_125,r_113_95_15,seq116,r_113_95_15,0.75,6,21,15,93
53,seq132,seq131,r_87_133_37,r_87_133_37,1,0,37,37,93
9,r_28_15_159,r_29_107_180,r_97_11_86,r_97_11_86,1,74,160,86,93
29,r_86_12_157,r_70_85_37,r_97_11_86,r_86_12_157,0.8,0,157,157,93
44,r_45_54_116,r_71_50_75,r_74_53_162,r_74_53_162,0.99,1,163,162,93
56,seq13,r_17_3_185,r_90_14_106,r_90_14_106,1,1,107,106,93
44,r_45_54_116,seq43,r_71_50_75,r_45_54_116,0.97,0,116,116,93
23,r_128_48_142,seq127,seq51,r_128_48_142,0.8,0,142,142,93
24,r_69_88_47,seq73,seq89,r_69_88_47,0.95,0,47,47,93
12,r_24_32_142,seq23,r_108_35_68,r_108_35_68,1,74,142,68,93
2,r_87_133_37,r_90_14_106,seq132,r_87_133_37,0.6,-1,36,37,93
36,r_102_137_102,r_101_82_142,seq138,r_102_137_102,0.97,0,102,102,94
8,r_34_69_193,seq32,r_27_71_117,r_27_71_117,0.96,76,193,117,94
54,seq7,seq10,r_42_9_6,r_42_9_6,0.98,9,15,6,94
43,r_93_139_188,r_94_46_168,r_40_95_18,r_40_95_18,0.49,151,169,18,94
7,r_29_2_15,r_34_69_193,r_3_6_181,r_29_2_15,0.94,0,15,15,94
83,seq79,r_78_116_119,r_48_81_9,r_78_116_119,1,-1,118,119,94
37,r_56_115_79,seq61,seq118,r_56_115_79,0.94,0,79,79,94
71,seq47,r_45_11_154,r_4_49_75,r_4_49_75,0.61,70,145,75,94
21,r_145_24_133,seq146,seq23,r_145_24_133,0.95,0,133,133,94
1,r_94_46_168,r_93_139_188,r_4_49_75,r_4_49_75,0.97,93,168,75,94
5,r_99_85_127,r_97_33_140,r_48_81_9,r_97_33_140,0.65,-6,134,140,94
99,seq123,seq122,r_141_124_104,r_141_124_104,0.99,-4,100,104,94
7,r_29_2_15,r_3_6_181,r_12_1_111,r_29_2_15,0.4,167,182,15,94
30,r_107_8_45,seq109,seq7,r_107_8_45,1,0,45,45,94
19,r_12_1_111,seq18,seq0,r_12_1_111,0.88,0,111,111,94
99,seq123,r_125_144_48,seq122,r_125_144_48,0.92,11,59,48,94
39,r_66_147_146,r_56_115_79,seq68,r_56_115_79,1,-42,37,79,94
39,r_66_147_146,seq68,r_125_144_48,r_66_147_146,0.69,0,146,146,94
31,r_89_76_179,seq90,r_48_81_9,r_48_81_9,0.71,170,179,9,94
41,r_50_110_127,seq52,seq111,r_50_110_127,0.83,0,127,127,94
3,r_4_49_75,r_3_6_181,seq47,r_4_49_75,0.99,0,75,75,94
10,r_143_73_96,r_145_24_133,seq70,r_143_73_96,0.9,0,96,96,94
14,r_19_134_6,seq133,r_92_135_151,r_92_135_151,0.81,13,164,151,94
0,r_48_81_9,seq83,r_129_80_72,r_129_80_72,1,13,85,72,94
73,seq138,r_141_124_104,r_102_137_102,r_102_137_102,0.55,1,103,102,94
11,r_96_103_127,r_40_95_18,seq106,r_96_103_127,0.49,0,127,127,94
38,r_104_100_49,seq106,r_14_98_12,r_104_100_49,0.86,3,52,49,94
15,r_78_116_119,seq79,seq118,r_78_116_119,0.49,0,119,119,94
4,r_65_25_108,seq68,seq23,r_65_25_108,1,0,108,108,94
57,seq142,r_145_24_133,seq148,r_145_24_133,1,-74,59,133,94
6,r_27_71_117,r_26_55_187,r_143_73_96,r_27_71_117,0.79,0,117,117,94
62,seq23,seq21,r_65_25_108,r_65_25_108,1,-2,106,108,94
44,r_101_82_142,seq106,seq83,r_101_82_142,0.79,1,143,142,94
17,r_125_144_48,seq123,seq146,r_125_144_48,0.74,11,59,48,94
18,r_40_95_18,r_94_46_168,r_20_91_36,r_94_46_168,0.82,-9,159,168,94
27,r_16_149_157,seq18,r_125_144_48,r_16_149_157,0.94,0,157,157,94
16,r_105_5_28,r_104_100_49,seq7,r_105_5_28,1,0,28,28,94
2,r_39_136_181,r_38_140_195,r_102_137_102,r_102_137_102,0.93,79,181,102,94
47,r_141_124_104,seq138,seq123,r_141_124_104,0.76,0,104,104,94
29,r_3_6_181,r_4_49_75,r_29_2_15,r_4_49_75,0.79,0,75,75,94
24,r_43_51_98,r_45_11_154,r_120_53_15,r_43_51_98,0.8,0,98,98,94
18,r_40_95_18,r_65_25_108,r_96_103_127,r_40_95_18,0.7,1,19,18,94
25,r_97_33_140,r_99_85_127,seq28,r_99_85_127,0.59,13,140,127,94
33,r_26_55_187,seq28,r_72_57_152,r_72_57_152,0.77,35,187,152,94
88,seq90,r_89_76_179,r_40_95_18,r_40_95_18,0.59,159,177,18,94
50,seq0,r_3_6_181,r_29_2_15,r_29_2_15,0.95,75,90,15,94
45,r_120_53_15,seq121,seq52,r_120_53_15,0.99,0,15,15,94
53,seq133,r_126_67_89,r_19_134_6,r_126_67_89,0.59,-59,30,89,94
32,r_92_135_151,r_89_76_179,r_19_134_6,r_92_135_151,0.87,0,151,151,94
23,r_20_91_36,seq18,r_92_135_151,r_20_91_36,1,0,36,36,94
26,r_14_98_12,r_20_91_36,r_97_33_140,r_97_33_140,0.98,-128,12,140,94
34,r_119_128_74,seq117,r_19_134_6,r_119_128_74,0.53,0,74,74,94
60,seq148,r_145_24_133,seq133,r_145_24_133,0.49,-77,56,133,94
43,r_93_139_188,r_40_95_18,r_39_136_181,r_93_139_188,0.74,0,188,188,94
9,r_45_11_154,seq47,r_130_17_3,r_45_11_154,0.8,0,154,154,94
26,r_14_98_12,r_97_33_140,r_104_100_49,r_97_33_140,0.78,0,140,140,94
29,r_3_6_181,r_29_2_15,r_107_8_45,r_3_6_181,0.32,1,182,181,94
22,r_108_75_151,seq109,r_143_73_96,r_108_75_151,0.53,4,155,151,94
54,seq7,r_42_9_6,r_107_8_45,r_107_8_45,1,7,52,45,94
28,r_38_140_195,r_39_136_181,seq35,r_38_140_195,0.56,-14,181,195,94
49,r_129_80_72,seq131,r_48_81_9,r_129_80_72,0.99,0,72,72,94
18,r_40_95_18,r_96_103_127,r_94_46_168,r_40_95_18,0.47,72,90,18,94
44,r_101_82_142,r_102_137_102,seq106,r_102_137_102,0.9,-1,101,102,94
82,seq70,r_74_54_127,r_143_73_96,r_143_73_96,0.99,32,128,96,94
35,r_126_67_89,seq133,seq68,r_126_67_89,1,0,89,89,94
12,r_127_44_73,r_129_80_72,r_4_49_75,r_4_49_75,0.92,2,77,75,94
23,r_20_91_36,r_92_135_151,r_40_95_18,r_92_135_151,0.95,0,151,151,94
4,r_65_25_108,r_56_115_79,seq68,r_56_115_79,0.96,-42,37,79,94
93,seq97,seq98,r_32_124_67,r_32_124_67,1,28,95,67,95
36,r_39_91_127,seq36,r_87_94_107,r_39_91_127,1,0,127,127,95
2,r_141_76_15,seq140,seq74,r_141_76_15,1,0,15,15,95
8,r_78_45_115,seq79,r_123_44_55,r_78_45_115,0.95,0,115,115,95
43,r_6_30_146,r_7_52_176,r_15_29_24,r_7_52_176,0.56,-30,146,176,95
37,r_11_146_149,seq5,seq145,r_11_146_149,0.87,0,149,149,95
86,seq79,r_78_45_115,r_40_61_12,r_78_45_115,0.8,-17,98,115,95
1,r_109_35_66,r_107_95_89,seq36,r_109_35_66,1,0,66,66,95
39,r_113_3_18,r_109_35_66,r_22_121_127,r_113_3_18,0.89,0,18,18,95
80,seq65,seq62,r_101_64_86,r_101_64_86,1,22,108,86,95
45,r_48_2_92,seq47,seq1,r_48_2_92,0.98,0,92,92,95
47,r_133_66_184,seq145,seq149,r_133_66_184,0.37,-49,135,184,95
16,r_55_33_20,r_32_124_67,r_109_35_66,r_55_33_20,0.93,47,67,20,95
19,r_22_121_127,r_23_117_135,r_72_122_7,r_72_122_7,0.67,120,127,7,95
33,r_70_128_133,r_4_71_39,r_81_129_20,r_70_128_133,0.97,0,133,133,95
11,r_4_71_39,r_70_128_133,seq73,r_70_128_133,0.89,0,133,133,95
34,r_148_112_26,seq147,r_107_95_89,r_148_112_26,0.71,0,26,26,95
27,r_85_103_194,r_37_83_14,r_69_105_86,r_69_105_86,0.99,108,194,86,95
46,r_15_29_24,r_109_35_66,r_6_30_146,r_6_30_146,0.98,1,147,146,95
16,r_55_33_20,r_54_126_46,r_32_124_67,r_55_33_20,0.67,0,20,20,95
39,r_113_3_18,r_22_121_127,seq16,r_22_121_127,0.97,-12,115,127,95
31,r_87_94_107,seq86,r_92_93_56,r_87_94_107,0.84,0,107,107,95
41,r_116_119_63,r_107_95_89,r_104_120_41,r_107_95_89,1,-26,63,89,95
89,seq86,r_87_94_107,r_85_103_194,r_87_94_107,0.94,0,107,107,95
30,r_130_19_20,seq138,seq16,r_130_19_20,0.92,0,20,20,95
7,r_81_129_20,seq80,r_142_18_131,r_81_129_20,0.91,2,22,20,95
47,r_133_66_184,seq149,seq67,r_133_66_184,0.49,0,184,184,95
26,r_37_83_14,r_38_135_106,seq79,r_37_83_14,0.99,0,14,14,95
0,r_132_50_88,r_133_66_184,r_144_53_42,r_133_66_184,0.62,-96,88,184,95
13,r_107_95_89,r_108_14_125,seq96,r_107_95_89,0.65,0,89,89,95
33,r_70_128_133,seq73,r_4_71_39,r_4_71_39,1,0,39,39,95
46,r_15_29_24,seq36,r_109_35_66,r_109_35_66,0.93,48,114,66,95
15,r_131_57_91,seq140,seq56,r_131_57_91,1,0,91,91,95
48,r_34_77_98,seq36,r_141_76_15,r_34_77_98,1,0,98,98,95
35,r_104_120_41,seq98,r_72_122_7,r_72_122_7,0.88,18,25,7,95
6,r_108_14_125,r_110_31_138,seq16,r_108_14_125,0.92,0,125,125,95
5,r_143_111_49,r_110_31_138,r_148_112_26,r_110_31_138,0.99,0,138,138,95
27,r_85_103_194,r_84_0_83,r_37_83_14,r_85_103_194,0.56,-165,29,194,95
29,r_110_31_138,r_109_35_66,r_143_111_49,r_110_31_138,0.62,-89,49,138,95
47,r_133_66_184,r_132_50_88,seq145,r_132_50_88,0.92,0,88,88,95
24,r_59_127_118,seq58,r_63_125_48,r_59_127_118,0.51,0,118,118,95
7,r_81_129_20,r_142_18_131,seq145,r_142_18_131,0.73,-74,57,131,95
34,r_148_112_26,r_107_95_89,r_143_111_49,r_107_95_89,0.92,0,89,89,95
4,r_144_53_42,r_143_111_49,seq51,r_144_53_42,0.91,0,42,42,95
7,r_81_129_20,seq145,r_70_128_133,r_70_128_133,0.76,1,134,133,95
38,r_7_52_176,seq9,r_144_53_42,r_7_52_176,0.37,0,176,176,95
22,r_10_26_14,r_11_146_149,seq25,r_10_26_14,1,0,14,14,95
18,r_54_126_46,seq51,r_63_125_48,r_54_126_46,0.99,0,46,46,95
20,r_142_18_131,r_133_66_184,r_130_19_20,r_142_18_131,0.87,0,131,131,95
3,r_32_124_67,r_55_33_20,r_54_126_46,r_32_124_67,1,0,67,67,95
28,r_20_102_53,seq21,seq100,r_20_102_53,0.95,0,53,53,95
17,r_101_64_86,seq98,seq65,r_101_64_86,0.96,1,87,86,95
46,r_15_29_24,seq13,seq36,r_15_29_24,0.98,0,24,24,95
10,r_63_125_48,seq62,r_54_126_46,r_63_125_48,0.99,-1,47,48,95
9,r_38_135_106,r_39_91_127,seq140,r_38_135_106,0.99,0,106,106,95
16,r_55_33_20,r_109_35_66,r_110_31_138,r_110_31_138,1,2,140,138,95
29,r_110_31_138,r_143_111_49,r_55_33_20,r_110_31_138,0.99,0,138,138,95
49,r_90_114_160,seq89,r_143_111_49,r_90_114_160,0.74,0,160,160,95
3,r_32_124_67,r_34_77_98,r_55_33_20,r_55_33_20,0.55,-1,19,20,95
44,r_115_106_180,r_116_119_63,r_148_112_26,r_115_106_180,0.78,-117,63,180,95
23,r_84_0_83,r_85_103_194,seq1,r_84_0_83,1,0,83,83,95
11,r_4_71_39,r_22_121_127,r_70_128_133,r_4_71_39,1,0,39,39,95
78,seq60,r_69_105_86,r_40_61_12,r_69_105_86,0.69,-55,31,86,95
25,r_40_61_12,seq41,seq62,r_40_61_12,0.87,0,12,12,95
12,r_69_105_86,seq67,seq98,r_69_105_86,0.96,1,87,86,95
14,r_123_44_55,seq118,seq43,r_123_44_55,1,0,55,55,95
5,r_143_111_49,r_144_53_42,r_110_31_138,r_143_111_49,0.72,-10,39,49,95
40,r_71_45_46,r_44_94_162,r_88_43_73,r_44_94_162,0.48,0,162,162,96
30,r_96_146_87,seq98,seq140,r_96_146_87,0.86,0,87,87,96
36,r_145_54_88,seq140,seq49,r_145_54_88,0.5,1,89,88,96
2,r_20_113_15,r_19_56_162,r_112_114_24,r_20_113_15,1,0,15,15,96
8,r_92_52_62,r_89_85_109,seq51,r_92_52_62,0.99,0,62,62,96
43,r_12_144_156,r_13_2_94,r_36_26_11,r_12_144_156,0.62,-61,95,156,96
14,r_44_94_162,seq42,r_71_45_46,r_71_45_46,1,-1,45,46,96
37,r_112_114_24,seq110,r_20_113_15,r_20_113_15,0.99,69,84,15,96
19,r_88_43_73,seq86,r_71_45_46,r_88_43_73,0.98,0,73,73,96
86,seq98,r_97_59_84,seq78,r_97_59_84,0.84,0,84,84,96
21,r_4_6_195,seq3,r_13_2_94,r_13_2_94,1,98,192,94,96
1,r_28_90_95,seq27,r_58_87_63,r_28_90_95,0.94,0,95,95,96
5,r_107_24_68,r_106_55_114,r_22_11_162,r_107_24_68,1,0,68,68,96
46,r_79_74_151,seq78,r_123_66_141,r_79_74_151,0.49,0,151,151,96
42,r_134_69_77,seq135,r_15_68_55,r_15_68_55,0.54,23,78,55,96
70,seq38,seq35,r_34_39_22,r_34_39_22,0.49,10,32,22,96
45,r_22_11_162,r_23_29_70,r_107_24_68,r_107_24_68,1,2,70,68,96
39,r_149_64_43,r_147_60_170,seq67,r_149_64_43,0.92,0,43,43,96
34,r_102_122_10,r_107_24_68,seq121,r_107_24_68,0.95,-58,10,68,96
11,r_36_26_11,seq35,r_28_90_95,r_36_26_11,0.55,2,13,11,96
31,r_41_132_111,seq40,r_33_133_107,r_41_132_111,0.87,0,111,111,96
3,r_5_84_5,r_79_74_151,r_65_83_44,r_65_83_44,0.88,11,55,44,96
41,r_57_72_172,r_58_87_63,r_82_75_13,r_57_72_172,0.78,-110,62,172,96
86,seq98,seq78,r_76_95_135,r_76_95_135,0.94,2,137,135,96
41,r_57_72_172,r_82_75_13,r_97_59_84,r_57_72_172,0.39,-81,91,172,96
16,r_77_21_36,r_76_95_135,seq16,r_77_21_36,0.84,0,36,36,96
4,r_47_91_41,seq46,seq86,r_47_91_41,1,0,41,41,96
72,seq42,r_44_94_162,r_88_43_73,r_88_43_73,0.96,89,162,73,96
14,r_44_94_162,r_71_45_46,r_76_95_135,r_71_45_46,0.75,116,162,46,96
0,r_97_59_84,seq98,r_57_72_172,r_97_59_84,1,0,84,84,96
13,r_89_85_109,seq86,r_5_84_5,r_5_84_5,0.91,105,110,5,96
15,r_13_2_94,r_12_144_156,seq3,r_13_2_94,0.98,0,94,94,96
4,r_47_91_41,seq86,r_28_90_95,r_28_90_95,1,19,114,95,96
74,seq46,r_145_54_88,r_47_91_41,r_145_54_88,0.71,31,119,88,96
22,r_124_139_22,r_123_66_141,seq138,r_123_66_141,0.76,-119,22,141,96
23,r_82_75_13,r_79_74_151,r_76_95_135,r_82_75_13,0.77,2,15,13,96
27,r_15_68_55,seq16,seq67,r_15_68_55,0.98,1,56,55,96
5,r_107_24_68,r_22_11_162,r_36_26_11,r_22_11_162,0.99,0,162,162,96
0,r_97_59_84,r_57_72_172,r_19_56_162,r_19_56_162,0.98,8,170,162,96
47,r_76_95_135,r_77_21_36,r_82_75_13,r_77_21_36,0.98,0,36,36,96
50,seq130,r_131_136_149,r_53_129_25,r_53_129_25,1,13,38,25,96
49,r_14_1_46,seq16,seq3,r_14_1_46,0.96,-1,45,46,96
36,r_145_54_88,seq49,r_106_55_114,r_145_54_88,0.75,39,127,88,96
18,r_123_66_141,seq125,r_15_68_55,r_15_68_55,0.91,86,141,55,96
25,r_33_133_107,seq32,r_53_129_25,r_33_133_107,0.99,0,107,107,96
19,r_88_43_73,seq93,seq86,r_88_43_73,0.62,-62,11,73,96
43,r_12_144_156,r_36_26_11,seq140,r_12_144_156,0.99,0,156,156,96
64,seq27,r_28_90_95,r_23_29_70,r_28_90_95,1,0,95,95,96
47,r_76_95_135,r_82_75_13,seq98,r_82_75_13,0.88,122,135,13,96
88,seq108,r_106_55_114,seq100,r_106_55_114,1,0,114,114,96
44,r_104_25_55,r_112_114_24,r_36_26_11,r_104_25_55,1,0,55,55,96
38,r_23_29_70,r_22_11_162,seq27,r_22_11_162,0.84,-92,70,162,96
11,r_36_26_11,r_28_90_95,r_104_25_55,r_36_26_11,0.99,45,56,11,96
32,r_128_101_48,seq127,r_117_103_81,r_128_101_48,0.54,0,48,48,96
79,seq67,seq70,r_15_68_55,r_15_68_55,1,2,57,55,96
45,r_22_11_162,r_107_24_68,r_9_10_73,r_22_11_162,0.7,0,162,162,96
17,r_58_87_63,r_57_72_172,seq86,r_58_87_63,0.99,-1,62,63,96
99,seq127,r_128_101_48,r_53_129_25,r_53_129_25,0.6,23,48,25,96
40,r_71_45_46,seq67,r_44_94_162,r_71_45_46,1,0,46,46,96
12,r_65_83_44,r_71_45_46,r_5_84_5,r_65_83_44,0.94,1,45,44,96
28,r_73_99_154,seq67,r_117_103_81,r_117_103_81,0.71,74,155,81,96
29,r_34_39_22,r_33_133_107,seq38,r_33_133_107,0.39,-83,24,107,96
55,seq138,r_134_69_77,r_124_139_22,r_134_69_77,0.94,-48,29,77,96
41,r_57_72_172,r_97_59_84,r_123_66_141,r_123_66_141,0.97,32,173,141,96
35,r_50_105_108,seq49,r_117_103_81,r_50_105_108,0.94,0,108,108,96
23,r_82_75_13,r_76_95_135,seq61,r_76_95_135,0.99,0,135,135,96
84,seq86,r_89_85_109,r_58_87_63,r_58_87_63,1,3,66,63,96
56,seq144,r_3_126_64,r_52_145_115,r_52_145_115,0.82,0,115,115,97
51,seq1,r_2_24_155,seq0,r_2_24_155,0.66,0,155,155,97
36,r_2_24_155,seq1,r_5_28_7,r_2_24_155,0.44,0,155,155,97
14,r_98_65_176,seq97,seq70,r_98_65_176,0.59,0,176,176,97
4,r_54_124_99,r_60_131_142,r_42_56_42,r_42_56_42,0.95,13,55,42,97
27,r_69_130_6,r_68_23_22,r_95_141_10,r_69_130_6,0.55,6,12,6,97
31,r_107_16_40,seq108,r_14_7_149,r_107_16_40,1,0,40,40,97
42,r_110_9_73,seq6,r_51_8_93,r_51_8_93,0.81,25,118,93,97
39,r_101_11_192,r_102_127_168,r_100_140_195,r_102_127_168,0.64,0,168,168,97
1,r_100_140_195,r_101_11_192,r_87_136_136,r_87_136_136,0.79,55,191,136,97
41,r_133_89_21,r_134_33_174,seq92,r_133_89_21,1,0,21,21,97
5,r_40_112_161,seq41,r_113_114_5,r_40_112_161,0.67,0,161,161,97
46,r_15_30_142,r_14_7_149,seq31,r_15_30_142,0.59,0,142,142,97
42,r_110_9_73,seq104,seq6,r_110_9_73,1,1,74,73,97
34,r_143_148_176,seq147,r_53_118_116,r_143_148_176,0.52,20,196,176,97
45,r_39_84_188,seq41,seq80,r_39_84_188,0.26,0,188,188,97
16,r_42_56_42,r_40_112_161,r_54_124_99,r_42_56_42,0.98,0,42,42,97
21,r_68_23_22,r_66_90_79,seq19,r_68_23_22,1,0,22,22,97
0,r_35_106_22,r_36_62_19,seq108,r_35_106_22,1,0,22,22,97
34,r_143_148_176,r_134_33_174,r_95_141_10,r_95_141_10,0.95,0,10,10,97
19,r_25_77_184,seq29,seq76,r_25_77_184,0.33,0,184,184,97
13,r_36_62_19,r_35_106_22,seq57,r_36_62_19,1,3,22,19,97
30,r_43_137_13,r_40_112_161,r_138_55_144,r_43_137_13,0.92,0,13,13,97
78,seq147,r_134_33_174,seq144,r_134_33_174,0.48,-43,131,174,97
95,seq115,r_116_75_188,r_50_117_9,r_116_75_188,0.98,1,189,188,97
66,seq41,r_40_112_161,seq38,r_40_112_161,0.99,0,161,161,97
78,seq147,r_149_4_106,r_134_33_174,r_149_4_106,0.67,-6,100,106,97
76,seq63,r_64_103_84,r_36_62_19,r_64_103_84,0.83,0,84,84,97
38,r_138_55_144,r_43_137_13,r_42_56_42,r_138_55_144,0.62,0,144,144,97
10,r_113_114_5,seq104,r_40_112_161,r_40_112_161,0.98,2,163,161,97
49,r_52_145_115,seq144,r_34_146_152,r_34_146_152,1,0,152,152,97
56,seq144,r_149_4_106,r_3_126_64,r_149_4_106,0.59,-12,94,106,97
38,r_138_55_144,r_143_148_176,r_43_137_13,r_43_137_13,1,1,14,13,97
11,r_123_26_160,seq122,r_5_28_7,r_123_26_160,0.66,0,160,160,97
20,r_64_103_84,seq63,seq104,r_64_103_84,1,0,84,84,97
37,r_34_146_152,r_35_106_22,seq31,r_35_106_22,0.97,0,22,22,97
16,r_42_56_42,seq57,r_138_55_144,r_138_55_144,1,0,144,144,97
48,r_96_72_119,r_98_65_176,r_22_71_64,r_22_71_64,0.97,55,119,64,97
52,seq6,r_110_9_73,r_149_4_106,r_149_4_106,1,12,118,106,97
6,r_53_118_116,seq49,seq119,r_53_118_116,0.95,-4,112,116,97
2,r_3_126_64,seq120,r_54_124_99,r_54_124_99,0.9,31,130,99,97
43,r_88_142_47,r_91_82_186,r_95_141_10,r_88_142_47,1,0,47,47,97
99,seq122,r_123_26_160,r_3_126_64,r_3_126_64,1,97,161,64,97
30,r_43_137_13,r_138_55_144,r_87_136_136,r_43_137_13,0.89,131,144,13,97
87,seq92,r_91_82_186,r_66_90_79,r_66_90_79,1,107,186,79,97
2,r_3_126_64,r_2_24_155,seq120,r_3_126_64,1,0,64,64,97
47,r_79_109_188,seq78,r_35_106_22,r_79_109_188,0.52,0,188,188,97
40,r_12_111_165,seq10,r_40_112_161,r_12_111_165,0.56,0,165,165,97
23,r_125_17_145,r_3_126_64,r_107_16_40,r_125_17_145,1,-1,144,145,97
29,r_51_8_93,seq49,r_110_9_73,r_51_8_93,1,0,93,93,97
24,r_128_139_112,r_125_17_145,r_95_141_10,r_128_139_112,0.99,0,112,112,97
34,r_143_148_176,r_95_141_10,seq147,r_143_148_176,0.47,1,177,176,97
25,r_14_7_149,r_12_111_165,r_149_4_106,r_149_4_106,1,43,149,106,97
33,r_22_71_64,r_14_7_149,seq74,r_22_71_64,1,0,64,64,97
32,r_149_4_106,r_43_137_13,seq6,r_149_4_106,0.83,0,106,106,97
32,r_149_4_106,seq144,r_43_137_13,r_43_137_13,0.48,75,88,13,97
52,seq6,seq0,r_110_9_73,r_110_9_73,1,8,81,73,97
44,r_86_21_29,r_87_136_136,r_68_23_22,r_86_21_29,0.99,0,29,29,97
26,r_95_141_10,r_98_65_176,r_143_148_176,r_95_141_10,0.89,0,10,10,97
4,r_54_124_99,r_42_56_42,r_3_126_64,r_54_124_99,1,0,99,99,97
16,r_42_56_42,r_54_124_99,seq57,r_54_124_99,1,0,99,99,97
17,r_87_136_136,seq92,r_43_137_13,r_87_136_136,0.98,0,136,136,97
18,r_61_132_48,r_64_103_84,r_69_130_6,r_61_132_48,1,0,48,48,97
27,r_69_130_6,r_95_141_10,r_61_132_48,r_61_132_48,0.98,11,59,48,97
9,r_102_127_168,r_101_11_192,r_3_126_64,r_3_126_64,0.97,104,168,64,97
78,seq147,r_143_148_176,r_149_4_106,r_143_148_176,0.57,-166,10,176,97
26,r_95_141_10,r_143_148_176,r_128_139_112,r_128_139_112,0.93,61,173,112,97
31,r_107_16_40,r_14_7_149,r_125_17_145,r_125_17_145,1,4,149,145,97
37,r_34_146_152,seq31,r_40_112_161,r_40_112_161,0.91,-40,121,161,97
22,r_66_90_79,seq70,seq92,r_66_90_79,0.95,0,79,79,97
49,r_52_145_115,seq49,seq144,r_52_145_115,0.88,0,115,115,97
7,r_73_129_85,seq74,r_95_141_10,r_73_129_85,0.89,0,85,85,97
23,r_125_17_145,r_128_139_112,r_3_126_64,r_3_126_64,0.99,48,112,64,97
82,seq78,r_79_109_188,r_116_75_188,r_79_109_188,0.59,0,188,188,97
37,r_34_146_152,r_40_112_161,r_52_145_115,r_34_146_152,0.94,0,152,152,97
36,r_141_16_178,seq143,r_142_19_3,r_141_16_178,0.43,0,178,178,98
8,r_102_135_93,r_98_99_41,seq133,r_102_135_93,1,1,94,93,98
43,r_79_23_189,seq80,seq24,r_79_23_189,0.25,0,189,189,98
41,r_51_36_179,seq53,r_89_35_14,r_51_36_179,1,0,179,179,98
83,seq80,r_79_23_189,r_95_78_97,r_79_23_189,0.69,0,189,189,98
37,r_86_11_162,r_87_137_211,r_40_12_141,r_86_11_162,0.56,0,162,162,98
16,r_66_148_140,seq69,r_144_136_95,r_66_148_140,0.59,0,140,140,98
21,r_129_100_67,seq132,seq96,r_129_100_67,0.89,0,67,67,98
39,r_145_39_76,r_144_136_95,r_92_33_19,r_145_39_76,1,0,76,76,98
1,r_116_67_101,seq117,r_84_68_85,r_116_67_101,0.91,0,101,101,98
7,r_57_109_10,seq96,r_107_110_125,r_107_110_125,0.24,5,130,125,98
19,r_27_59_170,seq25,seq58,r_27_59_170,0.76,0,170,170,98
99,seq127,r_126_149_181,r_20_128_32,r_20_128_32,0.96,1,33,32,98
95,seq119,r_120_81_178,seq112,r_120_81_178,0.75,0,178,178,98
66,seq32,seq30,r_92_33_19,r_92_33_19,1,50,69,19,98
2,r_20_128_32,r_21_83_38,seq127,r_20_128_32,0.99,0,32,32,98
31,r_40_12_141,r_44_108_110,seq69,r_40_12_141,0.38,-65,76,141,98
41,r_51_36_179,seq41,seq53,r_51_36_179,0.67,-40,139,179,98
67,seq41,seq49,r_61_42_79,r_61_42_79,1,29,108,79,98
26,r_37_48_194,r_34_105_185,r_17_54_195,r_37_48_194,0.65,-9,185,194,98
46,r_73_0_26,seq72,r_122_1_24,r_73_0_26,0.65,0,26,26,98
73,seq65,r_64_13_189,r_134_63_111,r_134_63_111,1,77,188,111,98
11,r_3_50_172,r_2_31_151,r_122_1_24,r_122_1_24,0.87,127,151,24,98
72,seq58,seq121,r_27_59_170,r_27_59_170,0.97,5,175,170,98
32,r_21_83_38,seq22,r_6_85_5,r_21_83_38,0.94,1,39,38,98
20,r_126_149_181,seq127,r_90_125_127,r_90_125_127,0.72,0,127,127,98
48,r_146_97_147,r_144_136_95,r_129_100_67,r_144_136_95,0.99,51,146,95,98
6,r_90_125_127,r_86_11_162,r_126_149_181,r_90_125_127,0.68,0,127,127,98
62,seq25,r_27_59_170,r_93_26_54,r_93_26_54,1,116,170,54,98
13,r_82_131_204,r_90_125_127,r_21_83_38,r_82_131_204,0.59,-149,55,204,98
30,r_89_35_14,r_34_105_185,r_51_36_179,r_89_35_14,0.37,171,185,14,98
47,r_138_52_154,seq139,seq53,r_138_52_154,0.64,0,154,154,98
74,seq139,r_138_52_154,r_144_136_95,r_138_52_154,0.97,0,154,154,98
29,r_60_140_131,seq65,seq143,r_60_140_131,0.96,0,131,131,98
24,r_61_42_79,r_62_8_166,seq41,r_62_8_166,0.69,-87,79,166,98
25,r_2_31_151,r_3_50_172,seq30,r_2_31_151,0.64,0,151,151,98
33,r_120_81_178,seq119,r_21_83_38,r_21_83_38,0.83,140,178,38,98
38,r_107_110_125,seq104,r_57_109_10,r_107_110_125,0.62,0,125,125,98
52,seq5,seq10,r_91_15_36,r_91_15_36,1,94,130,36,98
4,r_93_26_54,r_90_125_127,seq25,r_93_26_54,1,0,54,54,98
16,r_66_148_140,seq147,r_126_149_181,r_126_149_181,0.95,0,181,181,98
34,r_134_63_111,seq133,seq65,r_134_63_111,0.99,0,111,111,98
75,seq69,r_66_148_140,r_84_68_85,r_66_148_140,0.52,-3,137,140,98
17,r_44_108_110,seq46,r_57_109_10,r_44_108_110,0.87,9,119,110,98
94,seq117,r_120_81_178,r_101_118_171,r_101_118_171,0.8,7,178,171,98
9,r_115_45_100,seq114,seq46,r_115_45_100,0.94,1,101,100,98
7,r_57_109_10,seq58,seq96,r_57_109_10,0.72,0,10,10,98
11,r_3_50_172,r_122_1_24,seq49,r_3_50_172,0.74,0,172,172,98
31,r_40_12_141,seq69,r_91_15_36,r_40_12_141,0.91,0,141,141,98
6,r_90_125_127,r_126_149_181,r_20_128_32,r_126_149_181,0.78,0,181,181,98
72,seq58,r_56_28_59,seq65,r_56_28_59,0.98,0,59,59,98
10,r_92_33_19,r_93_26_54,r_89_35_14,r_92_33_19,0.5,0,19,19,98
20,r_126_149_181,r_90_125_127,r_66_148_140,r_126_149_181,0.98,0,181,181,98
49,r_6_85_5,r_84_68_85,r_21_83_38,r_21_83_38,0.93,47,85,38,98
0,r_56_28_59,seq58,r_89_35_14,r_56_28_59,1,0,59,59,98
56,seq14,seq10,r_91_15_36,r_91_15_36,1,51,87,36,98
23,r_84_68_85,r_82_131_204,seq69,r_82_131_204,0.5,-119,85,204,98
35,r_62_8_166,seq65,r_9_38_196,r_62_8_166,0.55,0,166,166,98
12,r_144_136_95,r_146_97_147,seq139,r_146_97_147,1,-20,127,147,98
30,r_89_35_14,r_93_26_54,r_34_105_185,r_34_105_185,0.89,-171,14,185,98
93,seq112,r_111_67_113,r_68_110_8,r_111_67_113,0.68,0,113,113,99
36,r_111_67_113,seq112,seq66,r_111_67_113,0.99,0,113,113,99
55,seq134,seq129,r_123_135_24,r_123_135_24,1,23,47,24,99
22,r_74_88_26,r_77_81_18,seq87,r_74_88_26,0.74,13,39,26,99
14,r_141_33_92,r_143_108_83,r_114_136_79,r_141_33_92,0.71,-10,82,92,99
8,r_52_58_181,seq53,r_149_61_62,r_149_61_62,1,119,181,62,99
43,r_3_17_182,seq5,r_78_16_56,r_78_16_56,0.97,135,191,56,99
54,seq5,r_3_17_182,r_24_4_82,r_24_4_82,0.92,3,85,82,99
39,r_107_64_122,seq106,r_133_60_40,r_133_60_40,0.92,80,120,40,99
1,r_77_81_18,seq79,r_56_82_56,r_56_82_56,0.99,21,77,56,99
5,r_137_80_95,seq139,seq73,r_137_80_95,1,0,95,95,99
46,r_143_108_83,r_141_33_92,r_68_110_8,r_143_108_83,0.99,0,83,83,99
42,r_50_128_80,r_52_58_181,seq126,r_50_128_80,1,0,80,80,99
3,r_47_120_24,r_56_82_56,seq117,r_47_120_24,1,0,24,24,99
7,r_121_145_174,r_99_122_51,seq144,r_99_122_51,0.57,123,174,51,99
69,seq46,r_56_82_56,r_133_60_40,r_133_60_40,0.79,41,81,40,99
45,r_48_100_123,r_52_58_181,seq102,r_48_100_123,0.81,0,123,123,99
19,r_115_70_166,seq116,r_111_67_113,r_111_67_113,0.62,53,166,113,99
7,r_121_145_174,seq116,r_99_122_51,r_99_122_51,1,3,54,51,99
27,r_133_60_40,r_63_1_161,r_140_59_106,r_140_59_106,1,0,106,106,99
41,r_26_29_81,r_25_101_127,seq28,r_25_101_127,0.96,-41,86,127,99
50,seq0,r_63_1_161,r_142_40_72,r_63_1_161,0.46,-28,133,161,99
26,r_34_138_105,r_36_38_89,seq139,r_34_138_105,1,0,105,105,99
72,seq62,r_63_1_161,r_149_61_62,r_149_61_62,1,23,85,62,99
16,r_63_1_161,r_133_60_40,seq0,r_63_1_161,0.85,0,161,161,99
78,seq79,r_77_81_18,r_86_75_65,r_86_75_65,0.97,32,97,65,99
0,r_114_136_79,seq113,seq148,r_114_136_79,0.99,0,79,79,99
63,seq22,r_24_4_82,r_19_9_197,r_24_4_82,0.55,0,82,82,99
82,seq92,seq94,r_146_90_161,r_146_90_161,0.98,9,170,161,99
20,r_20_132_120,r_19_9_197,seq129,r_20_132_120,0.99,0,120,120,99
13,r_37_10_95,r_44_125_123,seq13,r_37_10_95,0.5,0,95,95,99
48,r_93_147_131,seq92,seq148,r_93_147_131,1,1,132,131,99
25,r_78_16_56,seq79,r_2_8_48,r_78_16_56,0.95,0,56,56,99
50,seq0,seq22,r_63_1_161,r_63_1_161,0.57,-65,96,161,99
6,r_86_75_65,seq87,r_57_76_42,r_86_75_65,0.93,1,66,65,99
62,seq148,r_149_61_62,r_146_90_161,r_149_61_62,1,0,62,62,99
16,r_63_1_161,seq62,r_133_60_40,r_133_60_40,1,6,46,40,99
32,r_57_76_42,r_77_81_18,r_86_75_65,r_86_75_65,0.93,1,66,65,99
35,r_19_9_197,seq22,r_78_16_56,r_78_16_56,0.64,91,147,56,99
47,r_140_59_106,seq139,r_133_60_40,r_140_59_106,0.52,0,106,106,99
18,r_149_61_62,seq148,seq62,r_149_61_62,1,0,62,62,99
29,r_24_4_82,seq22,seq5,r_24_4_82,0.93,0,82,82,99
24,r_83_54_95,seq84,seq53,r_83_54_95,0.86,0,95,95,99
40,r_23_72_40,r_24_4_82,r_21_71_41,r_24_4_82,1,-42,40,82,99
33,r_35_12_71,r_36_38_89,seq13,r_35_12_71,1,1,72,71,99
2,r_2_8_48,r_3_17_182,seq7,r_2_8_48,0.79,0,48,48,99
38,r_146_90_161,seq148,seq92,r_146_90_161,0.65,0,161,161,99
4,r_56_82_56,seq62,r_77_81_18,r_56_82_56,0.89,-2,54,56,99
34,r_25_101_127,r_26_29_81,seq102,r_25_101_127,0.62,0,127,127,99
32,r_57_76_42,r_56_82_56,r_77_81_18,r_57_76_42,0.66,2,44,42,99
81,seq87,r_86_75_65,r_74_88_26,r_86_75_65,0.78,1,66,65,99
17,r_142_40_72,r_143_108_83,seq43,r_142_40_72,1,0,72,72,99
14,r_141_33_92,r_114_136_79,seq31,r_141_33_92,0.94,0,92,92,99
27,r_133_60_40,seq129,r_63_1_161,r_133_60_40,1,0,40,40,99
94,seq113,r_114_136_79,r_68_110_8,r_114_136_79,1,1,80,79,99
9,r_55_118_158,r_63_1_161,seq117,r_55_118_158,0.81,0,158,158,99
28,r_91_97_73,r_93_147_131,seq102,r_93_147_131,0.98,-54,77,131,99
49,r_41_6_109,r_44_125_123,seq7,r_41_6_109,0.89,0,109,109,99
56,seq7,seq15,r_41_6_109,r_41_6_109,1,9,118,109,99
44,r_36_38_89,r_34_138_105,seq43,r_34_138_105,1,-7,98,105,99
82,seq92,r_93_147_131,seq94,r_93_147_131,0.67,1,132,131,99
35,r_19_9_197,r_20_132_120,seq22,r_20_132_120,0.79,0,120,120,99
11,r_18_27_40,seq15,seq28,r_18_27_40,0.95,2,42,40,99
12,r_39_45_150,seq42,seq46,r_39_45_150,0.52,0,150,150,99