37,r_147_109_45,r_148_80_129,seq108,r_147_109_45,0.86,2,47,45,0
44,r_6_81_147,r_42_7_41,r_148_80_129,r_6_81_147,0.96,0,147,147,0
36,r_145_141_72,r_148_80_129,seq142,r_148_80_129,0.99,-56,73,129,0
38,r_138_3_53,r_136_91_189,seq2,r_138_3_53,1,0,53,53,0
14,r_83_131_97,r_87_55_81,r_72_114_175,r_83_131_97,0.71,-26,71,97,0
54,seq13,seq12,r_8_10_16,r_8_10_16,0.62,143,159,16,0
16,r_148_80_129,r_145_141_72,seq82,r_148_80_129,0.99,1,130,129,0
39,r_105_126_159,seq102,r_51_128_103,r_51_128_103,0.96,55,158,103,0
1,r_113_26_88,r_115_14_168,seq30,r_113_26_88,0.96,0,88,88,0
5,r_88_1_122,r_89_57_129,seq2,r_88_1_122,0.98,0,122,122,0
46,r_86_28_91,r_87_55_81,r_56_84_32,r_86_28_91,0.58,-10,81,91,0
6,r_18_110_49,seq19,seq111,r_18_110_49,1,0,49,49,0
42,r_25_99_70,seq33,r_85_98_40,r_25_99_70,1,0,70,70,0
45,r_43_107_121,seq38,r_79_103_78,r_43_107_121,0.77,0,121,121,0
19,r_115_14_168,seq111,seq13,r_115_14_168,0.77,0,168,168,0
1,r_113_26_88,seq30,r_139_27_128,r_139_27_128,1,6,134,128,0
84,seq82,r_56_84_32,r_148_80_129,r_148_80_129,1,1,130,129,0
41,r_51_128_103,seq53,seq127,r_51_128_103,1,0,103,103,0
14,r_83_131_97,r_72_114_175,r_130_132_28,r_83_131_97,0.97,0,97,97,0
89,seq100,seq92,r_75_101_66,r_75_101_66,1,9,75,66,0
18,r_56_84_32,r_62_52_74,r_83_131_97,r_56_84_32,0.99,1,33,32,0
10,r_104_63_84,r_105_126_159,r_106_64_5,r_104_63_84,1,0,84,84,0
90,seq102,r_105_126_159,r_79_103_78,r_79_103_78,1,80,158,78,0
47,r_85_98_40,r_87_55_81,seq100,r_85_98_40,0.48,0,40,40,0
26,r_79_103_78,seq82,seq102,r_79_103_78,0.98,-1,77,78,0
4,r_136_91_189,seq137,r_44_97_158,r_44_97_158,0.59,30,188,158,0
73,seq53,r_51_128_103,r_62_52_74,r_51_128_103,1,-4,99,103,0
11,r_0_146_129,r_4_36_188,r_145_141_72,r_0_146_129,0.99,0,129,129,0
13,r_89_57_129,r_88_1_122,r_93_58_42,r_88_1_122,1,0,122,122,0
15,r_75_101_66,r_74_120_95,seq100,r_75_101_66,1,0,66,66,0
20,r_123_122_64,r_105_126_159,seq134,r_123_122_64,0.36,39,103,64,0
12,r_42_7_41,r_6_81_147,seq9,r_6_81_147,0.52,0,147,147,0
55,seq142,seq140,r_145_141_72,r_145_141_72,0.68,-33,39,72,0
30,r_8_10_16,r_6_81_147,r_129_11_8,r_129_11_8,0.95,9,17,8,0
99,seq127,seq124,r_51_128_103,r_51_128_103,1,4,107,103,0
27,r_72_114_175,seq77,r_18_110_49,r_72_114_175,0.55,0,175,175,0
42,r_25_99_70,r_18_110_49,seq33,r_25_99_70,0.45,-57,13,70,0
52,seq9,r_6_81_147,r_42_7_41,r_42_7_41,1,8,49,41,0
46,r_86_28_91,r_56_84_32,r_90_29_27,r_86_28_91,0.87,0,91,91,0
31,r_149_112_13,r_148_80_129,r_115_14_168,r_149_112_13,0.99,1,14,13,0
12,r_42_7_41,seq33,r_6_81_147,r_42_7_41,1,0,41,41,0
3,r_37_15_28,r_42_7_41,seq16,r_42_7_41,0.93,-13,28,41,0
17,r_90_29_27,r_89_57_129,seq34,r_90_29_27,0.99,0,27,27,0
40,r_62_52_74,seq60,seq53,r_62_52_74,0.86,1,75,74,0
44,r_6_81_147,r_8_10_16,r_42_7_41,r_42_7_41,1,0,41,41,0
25,r_74_120_95,seq73,seq121,r_74_120_95,1,0,95,95,0
33,r_49_116_163,seq48,seq118,r_49_116_163,0.62,0,163,163,0
50,seq2,r_4_36_188,r_88_1_122,r_88_1_122,1,53,175,122,0
68,seq45,r_44_97_158,seq33,r_44_97_158,1,-3,155,158,0
32,r_69_68_81,seq71,seq67,r_69_68_81,0.69,18,99,81,0
75,seq137,r_136_91_189,r_133_135_110,r_136_91_189,0.87,0,189,189,0
43,r_20_65_50,r_17_144_95,r_76_66_5,r_20_65_50,1,0,50,50,0
28,r_139_27_128,r_130_132_28,r_113_26_88,r_130_132_28,1,96,124,28,0
9,r_17_144_95,seq19,r_145_141_72,r_17_144_95,1,0,95,95,0
49,r_143_117_28,seq142,seq118,r_143_117_28,0.96,1,29,28,0
31,r_149_112_13,r_115_14_168,r_18_110_49,r_18_110_49,0.76,119,168,49,0
22,r_130_132_28,r_136_91_189,r_83_131_97,r_83_131_97,0.99,8,105,97,0
35,r_129_11_8,seq12,r_8_10_16,r_8_10_16,0.96,3,19,16,0
7,r_44_97_158,seq45,seq94,r_44_97_158,0.46,0,158,158,0
48,r_93_58_42,seq92,seq60,r_93_58_42,1,0,42,42,0
18,r_56_84_32,r_83_131_97,r_69_68_81,r_83_131_97,1,0,97,97,0
23,r_106_64_5,r_86_28_91,r_104_63_84,r_106_64_5,0.88,83,88,5,0
17,r_90_29_27,seq34,r_86_28_91,r_86_28_91,1,9,100,91,0
21,r_76_66_5,r_106_64_5,r_20_65_50,r_20_65_50,1,1,51,50,0
29,r_70_21_37,r_69_68_81,seq19,r_70_21_37,1,0,37,37,0
56,seq16,r_18_110_49,r_37_15_28,r_18_110_49,0.97,-19,30,49,0
47,r_85_98_40,seq100,r_25_99_70,r_25_99_70,1,6,76,70,0
30,r_80_1_95,seq79,r_0_49_137,r_80_1_95,1,0,95,95,1
16,r_21_67_14,r_24_136_117,r_146_69_6,r_21_67_14,1,0,14,14,1
14,r_78_3_136,seq77,seq2,r_78_3_136,0.98,0,136,136,1
30,r_80_1_95,r_0_49_137,r_78_3_136,r_80_1_95,0.72,42,137,95,1
0,r_74_28_79,seq34,r_90_29_123,r_90_29_123,0.99,15,138,123,1
83,seq77,r_78_3_136,r_146_69_6,r_78_3_136,0.84,0,136,136,1
37,r_144_97_73,seq145,seq98,r_144_97_73,1,0,73,73,1
31,r_149_120_47,r_141_81_86,seq126,r_141_81_86,0.91,-43,43,86,1
10,r_89_25_177,seq92,seq20,r_89_25_177,1,1,178,177,1
71,seq53,r_52_127_127,seq56,r_52_127_127,0.98,-61,66,127,1
63,seq26,r_18_14_184,r_88_33_54,r_18_14_184,0.95,-5,179,184,1
86,seq86,r_87_135_194,r_76_96_145,r_76_96_145,0.65,45,190,145,1
21,r_111_139_93,r_113_59_196,r_31_133_14,r_111_139_93,0.54,0,93,93,1
33,r_132_102_20,r_141_81_86,seq103,r_132_102_20,0.84,0,20,20,1
42,r_138_19_65,r_140_101_86,r_18_14_184,r_138_19_65,1,1,66,65,1
22,r_114_105_58,r_113_59_196,seq103,r_114_105_58,0.98,0,58,58,1
5,r_95_51_43,r_94_66_177,seq53,r_95_51_43,0.97,0,43,43,1
28,r_46_124_153,r_134_47_16,r_52_127_127,r_46_124_153,0.95,2,155,153,1
7,r_31_133_14,seq147,r_111_139_93,r_31_133_14,0.59,81,95,14,1
69,seq43,seq45,r_134_47_16,r_134_47_16,0.85,89,105,16,1
45,r_62_58_187,seq64,r_91_50_43,r_62_58_187,0.32,0,187,187,1
13,r_24_136_117,r_17_22_184,r_31_133_14,r_24_136_117,0.96,0,117,117,1
19,r_76_96_145,seq77,r_144_97_73,r_76_96_145,0.65,1,146,145,1
34,r_88_33_54,seq86,seq34,r_88_33_54,1,0,54,54,1
76,seq60,r_61_11_159,seq54,r_61_11_159,0.97,0,159,159,1
3,r_91_50_43,r_89_25_177,r_95_51_43,r_89_25_177,0.94,-134,43,177,1
39,r_113_59_196,r_38_112_47,r_62_58_187,r_38_112_47,0.45,149,196,47,1
41,r_128_115_161,seq130,r_38_112_47,r_38_112_47,0.84,114,161,47,1
43,r_134_47_16,r_141_81_86,seq45,r_134_47_16,0.71,0,16,16,1
10,r_89_25_177,r_90_29_123,seq92,r_90_29_123,1,0,123,123,1
26,r_90_29_123,r_89_25_177,r_74_28_79,r_89_25_177,0.71,-54,123,177,1
0,r_74_28_79,seq75,seq34,r_74_28_79,1,0,79,79,1
13,r_24_136_117,seq23,r_17_22_184,r_17_22_184,0.68,-89,95,184,1
47,r_142_107_19,r_141_81_86,seq108,r_142_107_19,0.77,1,20,19,1
15,r_52_127_127,seq53,r_30_123_105,r_30_123_105,0.54,22,127,105,1
4,r_38_112_47,r_113_59_196,r_128_115_161,r_128_115_161,0.79,14,175,161,1
12,r_84_119_167,seq83,seq116,r_84_119_167,0.8,1,168,167,1
62,seq23,r_24_136_117,seq20,r_24_136_117,1,0,117,117,1
85,seq83,r_82_4_84,seq79,r_82_4_84,1,0,84,84,1
2,r_27_32_102,seq26,seq34,r_27_32_102,0.64,0,102,102,1
4,r_38_112_47,seq37,r_113_59_196,r_38_112_47,1,0,47,47,1
18,r_117_131_139,seq116,seq130,r_117_131_139,0.77,0,139,139,1
25,r_82_4_84,seq83,seq5,r_82_4_84,0.99,0,84,84,1
88,seq98,r_94_66_177,r_144_97_73,r_144_97_73,1,3,76,73,1
39,r_113_59_196,r_114_105_58,r_38_112_47,r_113_59_196,0.8,-139,57,196,1
42,r_138_19_65,r_18_14_184,r_89_25_177,r_89_25_177,0.75,10,187,177,1
32,r_0_49_137,seq2,r_80_1_95,r_80_1_95,0.99,0,95,95,1
36,r_48_40_42,seq45,seq42,r_48_40_42,1,0,42,42,1
7,r_31_133_14,r_38_112_47,seq147,r_31_133_14,0.95,0,14,14,1
17,r_140_101_86,seq147,seq100,r_140_101_86,0.94,0,86,86,1
96,seq110,r_113_59_196,seq129,r_113_59_196,0.58,-101,95,196,1
28,r_46_124_153,seq45,r_134_47_16,r_134_47_16,0.91,90,106,16,1
49,r_118_72_147,seq116,r_71_73_121,r_118_72_147,0.81,0,147,147,1
32,r_0_49_137,r_80_1_95,r_134_47_16,r_0_49_137,1,0,137,137,1
44,r_15_106_85,seq16,r_114_105_58,r_15_106_85,1,0,85,85,1
23,r_35_122_92,seq34,seq126,r_35_122_92,1,0,92,92,1
35,r_18_14_184,r_17_22_184,r_61_11_159,r_61_11_159,0.94,24,183,159,1
12,r_84_119_167,r_85_9_91,seq83,r_85_9_91,1,1,92,91,1
22,r_69_120_44,r_65_141_120,seq122,r_69_120_44,1,0,44,44,2
30,r_57_135_183,r_55_52_196,r_64_132_88,r_64_132_88,1,95,183,88,2
44,r_104_0_11,seq9,r_83_1_119,r_83_1_119,0.99,7,126,119,2
51,seq3,seq9,r_83_1_119,r_83_1_119,1,17,136,119,2
8,r_81_77_141,r_85_95_106,seq60,r_85_95_106,0.92,-7,99,106,2
55,seq12,seq13,r_54_11_111,r_54_11_111,1,22,133,111,2
86,seq89,r_90_115_92,seq91,r_90_115_92,1,0,92,92,2
16,r_140_21_88,seq131,seq20,r_140_21_88,1,0,88,88,2
21,r_116_88_76,r_118_4_112,seq84,r_116_88_76,1,0,76,76,2
39,r_14_110_189,seq15,r_5_109_124,r_5_109_124,0.93,65,189,124,2
1,r_133_80_111,seq131,seq84,r_133_80_111,1,0,111,111,2
5,r_85_95_106,r_83_1_119,seq94,r_83_1_119,0.74,-13,106,119,2
46,r_90_115_92,seq89,seq114,r_90_115_92,1,0,92,92,2
42,r_142_46_76,seq143,seq47,r_142_46_76,1,0,76,76,2
32,r_2_144_30,r_145_121_152,r_64_132_88,r_64_132_88,0.99,42,130,88,2
45,r_87_39_32,r_85_95_106,seq40,r_87_39_32,0.84,0,32,32,2
14,r_139_8_8,r_5_109_124,r_36_7_24,r_139_8_8,0.98,40,48,8,2
36,r_75_123_56,r_74_50_192,r_113_124_108,r_75_123_56,1,0,56,56,2
31,r_5_109_124,seq9,r_71_106_6,r_5_109_124,0.94,1,125,124,2
41,r_126_101_67,r_113_124_108,seq100,r_126_101_67,1,0,67,67,2
6,r_56_99_31,r_57_135_183,seq100,r_57_135_183,0.61,-152,31,183,2
90,seq100,seq94,r_126_101_67,r_126_101_67,1,0,67,67,2
20,r_149_127_176,seq148,r_45_117_122,r_149_127_176,0.44,0,176,176,2
26,r_38_6_58,r_5_109_124,r_118_4_112,r_38_6_58,1,54,112,58,2
48,r_83_1_119,seq84,seq3,r_83_1_119,0.99,0,119,119,2
15,r_59_128_24,r_55_52_196,seq129,r_59_128_24,1,0,24,24,2
57,seq15,r_14_110_189,seq20,r_14_110_189,0.59,-55,134,189,2
44,r_104_0_11,seq102,seq9,r_104_0_11,1,0,11,11,2
99,seq143,r_142_46_76,r_2_144_30,r_142_46_76,0.73,0,76,76,2
8,r_81_77_141,seq60,r_73_78_115,r_81_77_141,0.39,0,141,141,2
9,r_137_43_42,r_140_21_88,seq42,r_137_43_42,0.99,0,42,42,2
27,r_118_4_112,r_113_124_108,r_38_6_58,r_118_4_112,1,0,112,112,2
29,r_107_105_67,seq112,r_71_106_6,r_71_106_6,0.61,25,31,6,2
25,r_108_147_29,r_107_105_67,seq146,r_108_147_29,1,0,29,29,2
87,seq91,r_92_58_142,seq89,r_92_58_142,0.96,-41,101,142,2
74,seq47,r_45_117_122,r_142_46_76,r_142_46_76,0.9,45,121,76,2
32,r_2_144_30,r_64_132_88,r_108_147_29,r_108_147_29,0.59,132,161,29,2
2,r_36_7_24,r_34_70_40,r_139_8_8,r_36_7_24,1,0,24,24,2
50,seq129,r_113_124_108,r_59_128_24,r_59_128_24,1,77,101,24,2
58,seq17,r_14_110_189,r_98_16_6,r_98_16_6,0.76,5,11,6,2
61,seq20,seq18,r_140_21_88,r_140_21_88,1,8,96,88,2
38,r_24_61_182,seq25,r_55_52_196,r_24_61_182,0.39,0,182,182,2
52,seq136,r_134_96_162,r_64_132_88,r_64_132_88,1,45,133,88,2
72,seq42,seq44,r_137_43_42,r_137_43_42,1,16,58,42,2
17,r_55_52_196,r_54_11_111,r_19_53_1,r_54_11_111,1,-1,110,111,2
32,r_2_144_30,seq3,r_145_121_152,r_2_144_30,0.97,0,30,30,2
28,r_33_51_129,seq35,r_55_52_196,r_33_51_129,0.7,0,129,129,2
18,r_28_68_25,r_29_130_114,seq66,r_28_68_25,0.95,0,25,25,2
24,r_34_70_40,seq35,r_28_68_25,r_34_70_40,0.84,0,40,40,2
49,r_82_125_82,r_85_95_106,r_113_124_108,r_82_125_82,1,0,82,82,2
7,r_113_124_108,seq122,r_82_125_82,r_82_125_82,1,57,139,82,2
23,r_134_96_162,seq136,seq97,r_134_96_162,0.85,0,162,162,2
35,r_54_11_111,r_55_52_196,seq12,r_54_11_111,1,0,111,111,2
12,r_145_121_152,seq148,r_45_117_122,r_145_121_152,0.64,0,152,152,2
26,r_38_6_58,seq40,r_5_109_124,r_38_6_58,1,0,58,58,2
36,r_35_81_65,seq34,seq79,r_35_81_65,1,0,65,65,3
92,seq107,seq144,r_59_110_11,r_59_110_11,0.46,18,29,11,3
14,r_23_72_90,seq27,r_71_6_155,r_23_72_90,1,0,90,90,3
8,r_74_52_75,r_71_6_155,seq50,r_74_52_75,1,0,75,75,3
86,seq90,r_91_70_154,r_119_87_13,r_91_70_154,0.75,0,154,154,3
28,r_75_24_149,r_77_60_157,r_71_6_155,r_75_24_149,0.34,-73,76,149,3
71,seq50,seq49,r_74_52_75,r_74_52_75,1,25,100,75,3
39,r_118_25_96,seq116,r_98_28_13,r_118_25_96,1,0,96,96,3
1,r_63_99_168,seq62,seq95,r_63_99_168,0.69,0,168,168,3
5,r_71_6_155,r_74_52_75,r_35_81_65,r_71_6_155,0.51,-80,75,155,3
46,r_69_31_135,r_37_68_5,r_103_32_22,r_69_31_135,0.83,2,137,135,3
42,r_41_61_114,seq40,seq62,r_41_61_114,0.87,0,114,114,3
7,r_148_43_163,r_89_147_52,r_103_32_22,r_148_43_163,0.97,0,163,163,3
44,r_4_21_5,seq27,r_111_22_45,r_111_22_45,1,9,54,45,3
69,seq48,r_46_9_153,seq49,r_46_9_153,0.89,-38,115,153,3
9,r_59_110_11,r_63_99_168,seq109,r_59_110_11,0.95,0,11,11,3
19,r_113_55_112,r_26_112_5,seq56,r_113_55_112,0.99,0,112,112,3
43,r_103_32_22,r_16_38_32,r_69_31_135,r_103_32_22,0.78,143,165,22,3
28,r_75_24_149,r_71_6_155,r_77_60_157,r_71_6_155,0.59,-111,44,155,3
4,r_119_87_13,r_118_25_96,r_88_20_101,r_119_87_13,0.77,-1,12,13,3
41,r_100_83_176,seq101,r_29_85_119,r_29_85_119,0.96,57,176,119,3
67,seq40,r_41_61_114,seq39,r_41_61_114,0.97,0,114,114,3
3,r_91_70_154,seq90,r_23_72_90,r_23_72_90,0.58,62,152,90,3
10,r_29_85_119,seq44,seq86,r_29_85_119,1,0,119,119,3
86,seq90,r_89_147_52,r_91_70_154,r_89_147_52,0.88,0,52,52,3
26,r_10_30_111,r_8_133_142,r_103_32_22,r_10_30_111,0.91,1,112,111,3
14,r_23_72_90,r_71_6_155,r_91_70_154,r_23_72_90,0.81,65,155,90,3
13,r_77_60_157,seq79,r_94_76_85,r_94_76_85,1,0,85,85,3
4,r_119_87_13,r_88_20_101,seq90,r_88_20_101,0.66,1,102,101,3
44,r_4_21_5,seq11,seq27,r_4_21_5,0.88,6,11,5,3
5,r_71_6_155,r_23_72_90,r_46_9_153,r_71_6_155,0.87,0,155,155,3
17,r_14_140_52,r_13_17_113,seq137,r_14_140_52,1,0,52,52,3
13,r_77_60_157,r_94_76_85,r_41_61_114,r_77_60_157,0.87,0,157,157,3
6,r_26_112_5,r_113_55_112,r_59_110_11,r_113_55_112,0.9,0,112,112,3
62,seq18,r_8_133_142,r_47_19_67,r_47_19_67,0.72,8,75,67,3
23,r_78_114_16,seq79,r_59_110_11,r_78_114_16,0.87,0,16,16,3
79,seq66,r_65_130_43,seq64,r_65_130_43,1,0,43,43,3
15,r_98_28_13,r_96_73_154,seq27,r_98_28_13,1,0,13,13,3
99,seq127,r_128_92_179,r_149_121_88,r_149_121_88,0.48,88,176,88,3
45,r_115_1_50,seq109,seq0,r_115_1_50,1,0,50,50,3
27,r_36_131_96,seq34,r_65_130_43,r_36_131_96,0.75,0,96,96,3
29,r_88_20_101,r_89_147_52,r_119_87_13,r_88_20_101,0.69,-79,22,101,3
2,r_37_68_5,r_69_31_135,seq67,r_69_31_135,0.94,2,137,135,3
47,r_45_138_69,seq44,seq137,r_45_138_69,1,0,69,69,3
38,r_65_130_43,seq66,seq127,r_65_130_43,0.98,0,43,43,3
74,seq56,seq54,r_113_55_112,r_113_55_112,1,9,121,112,3
18,r_46_9_153,seq48,r_105_7_121,r_105_7_121,0.49,32,153,121,3
24,r_42_129_172,seq44,r_36_131_96,r_36_131_96,1,76,172,96,3
35,r_94_76_85,r_77_60_157,r_35_81_65,r_77_60_157,1,0,157,157,3
25,r_149_121_88,r_148_43_163,seq122,r_149_121_88,0.75,4,92,88,3
43,r_103_32_22,r_29_85_119,r_16_38_32,r_29_85_119,1,0,119,119,3
33,r_105_7_121,seq106,seq5,r_105_7_121,0.92,0,121,121,3
64,seq34,r_35_81_65,seq39,r_35_81_65,1,1,66,65,3
80,seq67,r_69_31_135,r_37_68_5,r_69_31_135,0.58,-118,17,135,3
37,r_111_22_45,r_115_1_50,r_23_72_90,r_111_22_45,0.98,0,45,45,3
68,seq44,r_45_138_69,seq39,r_45_138_69,1,0,69,69,3
32,r_47_19_67,seq48,seq18,r_47_19_67,1,0,67,67,3
77,seq62,r_63_99_168,seq66,r_63_99_168,0.75,0,168,168,3
0,r_89_147_52,seq90,seq145,r_89_147_52,0.97,0,52,52,3
34,r_96_73_154,r_100_83_176,r_91_70_154,r_100_83_176,0.75,-22,154,176,3
28,r_75_24_149,r_71_6_155,r_98_28_13,r_75_24_149,0.66,-2,147,149,3
94,seq116,seq120,r_36_131_96,r_36_131_96,1,41,137,96,3
40,r_33_93_30,r_35_81_65,seq120,r_33_93_30,0.96,0,30,30,3
5,r_71_6_155,r_35_81_65,r_23_72_90,r_23_72_90,0.95,0,90,90,3
49,r_97_132_30,r_96_73_154,seq136,r_97_132_30,0.89,0,30,30,3
29,r_88_20_101,r_119_87_13,r_47_19_67,r_88_20_101,1,1,102,101,3
22,r_135_108_155,seq141,r_59_110_11,r_135_108_155,0.52,0,155,155,3
91,seq106,r_105_7_121,seq102,r_105_7_121,0.98,0,121,121,3
50,seq0,seq2,r_115_1_50,r_115_1_50,1,5,55,50,3
7,r_148_43_163,r_149_121_88,r_89_147_52,r_89_147_52,0.73,40,92,52,3
43,r_103_32_22,seq102,r_29_85_119,r_103_32_22,1,0,22,22,3
11,r_16_38_32,r_8_133_142,seq34,r_16_38_32,0.96,0,32,32,3
35,r_94_76_85,seq95,r_77_60_157,r_94_76_85,0.99,0,85,85,3
12,r_8_133_142,seq5,r_97_132_30,r_8_133_142,0.97,0,142,142,3
37,r_111_22_45,r_23_72_90,r_4_21_5,r_23_72_90,0.99,-10,80,90,3
30,r_133_146_162,r_136_121_171,seq148,r_136_121_171,0.47,-9,162,171,4
51,seq2,r_1_26_156,seq0,r_1_26_156,0.7,0,156,156,4
36,r_43_35_99,seq44,r_31_82_170,r_43_35_99,0.65,-1,98,99,4
8,r_95_83_114,seq100,seq87,r_95_83_114,0.65,0,114,114,4
43,r_103_75_105,seq104,seq76,r_103_75_105,1,0,105,105,4
45,r_147_20_10,r_145_113_177,r_5_15_192,r_147_20_10,0.91,0,10,10,4
80,seq78,r_73_141_121,seq76,r_73_141_121,0.8,-109,12,121,4
37,r_45_22_95,r_46_66_95,seq21,r_45_22_95,0.55,0,95,95,4
21,r_115_124_172,seq114,seq123,r_115_124_172,0.36,0,172,172,4
39,r_48_96_132,seq49,r_81_97_132,r_48_96_132,0.73,1,133,132,4
5,r_32_64_89,seq29,seq65,r_32_64_89,0.84,0,89,89,4
5,r_32_64_89,r_36_98_43,seq29,r_36_98_43,1,0,43,43,4
27,r_81_97_132,r_84_67_21,seq92,r_84_67_21,1,4,25,21,4
64,seq38,r_43_35_99,seq39,r_43_35_99,0.63,-5,94,99,4
10,r_85_40_15,r_86_55_69,r_11_41_9,r_85_40_15,0.91,0,15,15,4
41,r_106_17_166,seq109,r_52_7_128,r_106_17_166,0.37,0,166,166,4
46,r_84_67_21,r_81_97_132,seq68,r_84_67_21,0.91,0,21,21,4
26,r_42_34_153,r_11_41_9,r_63_33_133,r_63_33_133,0.6,27,160,133,4
4,r_52_7_128,seq49,r_37_18_37,r_52_7_128,0.64,0,128,128,4
64,seq38,r_37_18_37,r_43_35_99,r_37_18_37,0.95,0,37,37,4
63,seq29,r_32_64_89,r_31_82_170,r_32_64_89,0.89,-2,87,89,4
11,r_86_55_69,seq87,r_138_54_36,r_86_55_69,0.78,0,69,69,4
99,seq127,r_137_116_146,r_144_132_22,r_144_132_22,0.54,134,156,22,4
27,r_81_97_132,seq92,r_131_88_1,r_131_88_1,0.54,79,80,1,4
15,r_73_141_121,r_74_79_155,r_56_143_113,r_73_141_121,0.6,0,121,121,4
48,r_89_6_96,r_131_88_1,r_16_9_101,r_89_6_96,0.97,0,96,96,4
6,r_63_33_133,r_59_125_182,r_43_35_99,r_59_125_182,0.62,-48,134,182,4
1,r_110_47_2,r_31_82_170,r_138_54_36,r_110_47_2,0.4,49,51,2,4
29,r_31_82_170,r_36_98_43,seq29,r_36_98_43,1,0,43,43,4
33,r_80_24_75,r_91_30_189,r_73_141_121,r_91_30_189,0.49,-151,38,189,4
36,r_43_35_99,r_31_82_170,r_63_33_133,r_43_35_99,0.78,63,162,99,4
40,r_61_10_90,r_59_125_182,r_16_9_101,r_61_10_90,0.96,0,90,90,4
24,r_28_105_96,r_25_58_106,r_128_107_63,r_28_105_96,1,0,96,96,4
25,r_46_66_95,r_45_22_95,r_74_79_155,r_46_66_95,0.64,0,95,95,4
27,r_81_97_132,r_131_88_1,r_48_96_132,r_48_96_132,0.66,0,132,132,4
44,r_129_53_103,seq127,seq50,r_129_53_103,0.95,0,103,103,4
38,r_137_116_146,r_136_121_171,r_117_112_140,r_137_116_146,0.37,1,147,146,4
33,r_80_24_75,r_73_141_121,r_91_30_189,r_80_24_75,0.53,-13,62,75,4
34,r_56_143_113,r_59_125_182,seq139,r_56_143_113,0.93,0,113,113,4
45,r_147_20_10,r_5_15_192,r_140_19_80,r_140_19_80,1,19,99,80,4
9,r_1_26_156,seq2,r_80_24_75,r_1_26_156,0.53,0,156,156,4
56,seq139,seq142,r_73_141_121,r_73_141_121,1,3,124,121,4
31,r_145_113_177,r_149_120_191,r_117_112_140,r_117_112_140,0.6,37,177,140,4
29,r_31_82_170,seq29,r_95_83_114,r_31_82_170,0.6,0,170,170,4
22,r_117_112_140,seq123,seq111,r_117_112_140,0.54,0,140,140,4
28,r_11_41_9,r_42_34_153,seq39,r_42_34_153,0.83,1,154,153,4
18,r_144_132_22,seq142,seq135,r_144_132_22,1,3,25,22,4
49,r_140_19_80,seq139,r_147_20_10,r_140_19_80,1,0,80,80,4
42,r_138_54_36,r_52_7_128,r_86_55_69,r_86_55_69,0.92,6,75,69,4
56,seq139,r_140_19_80,seq142,r_140_19_80,1,0,80,80,4
44,r_129_53_103,r_128_107_63,seq127,r_128_107_63,1,0,63,63,4
23,r_25_58_106,seq23,seq57,r_25_58_106,0.9,0,106,106,4
8,r_95_83_114,seq87,r_31_82_170,r_31_82_170,0.59,0,170,170,4
31,r_145_113_177,r_147_20_10,r_149_120_191,r_147_20_10,0.81,6,16,10,4
1,r_110_47_2,seq76,r_31_82_170,r_110_47_2,0.54,30,32,2,4
1,r_110_47_2,r_52_7_128,seq76,r_110_47_2,0.45,18,20,2,4
33,r_80_24_75,r_91_30_189,seq23,r_80_24_75,0.77,0,75,75,4
47,r_36_98_43,r_32_64_89,seq99,r_36_98_43,1,0,43,43,4
35,r_128_107_63,r_129_53_103,seq108,r_128_107_63,1,0,63,63,4
42,r_138_54_36,r_136_121_171,r_52_7_128,r_138_54_36,0.92,1,37,36,4
93,seq101,r_103_36_103,r_26_99_23,r_103_36_103,0.76,-1,102,103,5
33,r_71_49_45,seq73,r_10_51_44,r_10_51_44,1,1,45,44,5
30,r_103_36_103,seq101,seq38,r_103_36_103,0.9,0,103,103,5
31,r_7_58_39,r_5_111_132,seq59,r_7_58_39,1,0,39,39,5
92,seq98,r_102_15_63,r_26_99_23,r_102_15_63,1,-3,60,63,5
14,r_119_79_134,r_120_92_177,seq81,r_119_79_134,1,0,134,134,5
43,r_85_62_174,seq86,r_10_51_44,r_10_51_44,1,130,174,44,5
12,r_91_72_54,seq89,seq73,r_91_72_54,1,0,54,54,5
55,seq11,r_16_112_178,r_102_15_63,r_102_15_63,1,115,178,63,5
16,r_105_56_150,seq113,r_10_51_44,r_10_51_44,0.81,106,150,44,5
21,r_37_19_67,seq38,r_57_17_40,r_37_19_67,0.9,0,67,67,5
39,r_120_92_177,r_119_79_134,r_122_128_159,r_119_79_134,1,0,134,134,5
1,r_12_100_106,seq11,seq101,r_12_100_106,0.92,1,107,106,5
54,seq9,r_10_51_44,seq2,r_10_51_44,1,0,44,44,5
5,r_16_112_178,seq11,r_102_15_63,r_102_15_63,1,13,76,63,5
42,r_44_52_138,seq46,r_10_51_44,r_10_51_44,0.74,94,138,44,5
3,r_144_31_14,r_147_83_190,seq29,r_144_31_14,0.99,0,14,14,5
45,r_96_45_70,seq93,seq46,r_96_45_70,0.94,0,70,70,5
15,r_8_125_73,r_126_42_155,r_122_128_159,r_126_42_155,0.81,0,155,155,5
62,seq29,seq27,r_144_31_14,r_144_31_14,1,0,14,14,5
27,r_102_15_63,r_16_112_178,r_117_14_46,r_16_112_178,0.78,0,178,178,5
37,r_53_65_33,r_57_17_40,seq69,r_57_17_40,1,-7,33,40,5
41,r_6_148_86,r_1_123_107,seq146,r_6_148_86,0.76,0,86,86,5
26,r_33_68_89,r_39_104_181,seq69,r_33_68_89,0.89,0,89,89,5
0,r_126_42_155,r_127_47_95,r_8_125_73,r_126_42_155,0.65,-60,95,155,5
65,seq38,r_39_104_181,r_103_36_103,r_103_36_103,0.91,0,103,103,5
20,r_66_54_113,seq69,r_10_51_44,r_10_51_44,1,69,113,44,5
19,r_13_95_27,r_16_112_178,seq93,r_13_95_27,1,0,27,27,5
13,r_39_104_181,seq38,r_13_95_27,r_13_95_27,1,155,182,27,5
15,r_8_125_73,seq9,r_126_42_155,r_8_125_73,1,1,74,73,5
48,r_118_145_149,r_122_128_159,seq143,r_118_145_149,0.56,0,149,149,5
6,r_122_128_159,r_121_136_119,r_1_123_107,r_1_123_107,0.96,12,119,107,5
99,seq124,r_126_42_155,seq116,r_126_42_155,0.87,0,155,155,5
5,r_16_112_178,r_102_15_63,r_40_108_49,r_102_15_63,0.53,115,178,63,5
0,r_126_42_155,r_8_125_73,seq43,r_126_42_155,1,0,155,155,5
11,r_10_51_44,seq9,seq50,r_10_51_44,1,0,44,44,5
27,r_102_15_63,r_96_45_70,r_16_112_178,r_102_15_63,1,0,63,63,5
25,r_57_17_40,seq22,r_37_19_67,r_37_19_67,0.97,2,69,67,5
18,r_48_34_17,r_57_17_40,r_33_68_89,r_57_17_40,0.65,-23,17,40,5
4,r_40_108_49,r_39_104_181,seq109,r_40_108_49,0.99,0,49,49,5
29,r_131_80_145,r_130_32_72,seq132,r_130_32_72,1,0,72,72,5
58,seq20,r_24_149_175,r_134_21_52,r_134_21_52,1,0,52,52,5
39,r_120_92_177,r_122_128_159,seq88,r_120_92_177,0.97,0,177,177,5
50,seq129,r_131_80_145,seq132,r_131_80_145,0.95,0,145,145,5
34,r_133_82_28,r_147_83_190,seq81,r_133_82_28,1,0,28,28,5
65,seq38,r_37_19_67,r_39_104_181,r_37_19_67,1,0,67,67,5
68,seq46,r_44_52_138,r_127_47_95,r_127_47_95,0.99,19,114,95,5
46,r_117_14_46,r_12_100_106,r_102_15_63,r_12_100_106,0.65,-16,90,106,5
32,r_5_111_132,seq3,r_40_108_49,r_5_111_132,0.99,0,132,132,5
38,r_121_136_119,r_122_128_159,r_106_140_10,r_121_136_119,0.59,0,119,119,5
25,r_57_17_40,seq61,seq22,r_57_17_40,0.99,2,42,40,5
24,r_142_28_23,r_147_83_190,seq27,r_142_28_23,1,0,23,23,5
97,seq115,r_117_14_46,seq132,r_117_14_46,0.94,-7,39,46,5
60,seq25,r_24_149_175,seq22,r_24_149_175,0.53,0,175,175,5
9,r_106_140_10,r_110_107_25,seq137,r_106_140_10,0.9,0,10,10,5
29,r_131_80_145,seq132,seq81,r_131_80_145,0.63,1,146,145,5
22,r_130_32_72,r_131_80_145,r_18_30_15,r_130_32_72,1,0,72,72,5
35,r_18_30_15,seq22,seq29,r_18_30_15,1,0,15,15,5
40,r_134_21_52,r_141_60_64,seq20,r_134_21_52,1,0,52,52,5
28,r_127_47_95,r_126_42_155,seq46,r_127_47_95,0.91,0,95,95,5
49,r_23_138_59,r_24_149_175,seq137,r_23_138_59,0.99,0,59,59,5
7,r_1_123_107,seq2,r_122_128_159,r_1_123_107,0.88,0,107,107,5
18,r_48_34_17,r_33_68_89,seq38,r_33_68_89,0.93,-3,86,89,5
44,r_141_60_64,seq137,seq61,r_141_60_64,1,0,64,64,5
46,r_117_14_46,r_118_145_149,r_12_100_106,r_117_14_46,1,0,46,46,5
40,r_126_93_7,r_92_25_136,seq95,r_92_25_136,1,0,136,136,6
30,r_66_16_62,r_65_134_125,seq15,r_66_16_62,0.95,0,62,62,6
51,seq130,r_131_31_153,r_23_135_82,r_23_135_82,0.88,76,158,82,6
14,r_96_142_60,r_92_25_136,seq139,r_96_142_60,1,0,60,60,6
21,r_56_103_63,seq55,r_124_104_8,r_56_103_63,1,1,64,63,6
1,r_120_112_137,r_122_148_202,seq111,r_120_112_137,0.43,7,144,137,6
28,r_64_81_36,r_65_134_125,seq80,r_64_81_36,1,0,36,36,6
42,r_107_62_89,r_108_105_163,r_51_63_30,r_107_62_89,1,0,89,89,6
19,r_106_119_170,seq110,seq118,r_106_119_170,0.31,0,170,170,6
25,r_92_25_136,r_96_142_60,r_126_93_7,r_96_142_60,0.99,-24,36,60,6
43,r_144_50_20,seq146,seq46,r_144_50_20,0.97,0,20,20,6
26,r_100_1_174,seq102,r_30_101_18,r_30_101_18,1,38,56,18,6
31,r_121_26_92,r_120_112_137,seq27,r_121_26_92,0.95,0,92,92,6
41,r_74_117_114,seq75,seq116,r_74_117_114,0.98,0,114,114,6
3,r_23_135_82,r_22_19_93,r_113_128_53,r_23_135_82,0.87,-1,81,82,6
10,r_0_97_138,r_3_2_14,r_4_98_112,r_3_2_14,1,124,138,14,6
4,r_7_86_184,seq10,seq87,r_7_86_184,0.51,0,184,184,6
15,r_3_2_14,seq13,r_100_1_174,r_3_2_14,0.72,169,183,14,6
11,r_65_134_125,r_66_16_62,seq73,r_65_134_125,0.79,-63,62,125,6
15,r_3_2_14,r_0_97_138,seq13,r_0_97_138,0.59,0,138,138,6
12,r_30_101_18,r_100_1_174,r_56_103_63,r_56_103_63,1,111,174,63,6
62,seq27,seq43,r_121_26_92,r_121_26_92,0.99,-2,90,92,6
6,r_4_98_112,seq95,r_0_97_138,r_0_97_138,0.81,11,149,138,6
12,r_30_101_18,seq29,r_100_1_174,r_30_101_18,1,0,18,18,6
53,seq136,seq146,r_14_132_126,r_14_132_126,1,0,126,126,6
5,r_113_128_53,r_108_105_163,seq129,r_113_128_53,1,0,53,53,6
1,r_120_112_137,r_121_26_92,r_122_148_202,r_121_26_92,0.9,-41,51,92,6
2,r_77_82_95,seq78,r_64_81_36,r_64_81_36,1,106,142,36,6
48,r_88_79_44,seq87,r_64_81_36,r_64_81_36,0.99,9,45,36,6
24,r_59_76_111,r_58_147_107,seq75,r_58_147_107,0.86,0,107,107,6
16,r_21_53_18,r_42_36_31,r_68_54_10,r_42_36_31,0.47,6,37,31,6
68,seq45,seq52,r_137_44_32,r_137_44_32,1,79,111,32,6
32,r_8_5_112,seq10,seq6,r_8_5_112,0.86,0,112,112,6
52,seq6,r_12_9_15,r_8_5_112,r_8_5_112,0.55,8,120,112,6
34,r_108_105_163,seq110,r_56_103_63,r_56_103_63,1,101,164,63,6
3,r_23_135_82,r_113_128_53,r_65_134_125,r_65_134_125,1,3,128,125,6
33,r_114_141_12,r_120_112_137,seq139,r_114_141_12,0.98,0,12,12,6
81,seq75,r_74_117_114,r_59_76_111,r_74_117_114,0.66,0,114,114,6
13,r_137_44_32,r_138_145_72,seq45,r_137_44_32,1,0,32,32,6
25,r_92_25_136,r_126_93_7,r_121_26_92,r_126_93_7,1,129,136,7,6
50,seq129,seq130,r_113_128_53,r_113_128_53,0.99,8,61,53,6
26,r_100_1_174,r_30_101_18,r_3_2_14,r_100_1_174,0.83,0,174,174,6
7,r_42_36_31,r_51_63_30,seq39,r_51_63_30,0.76,8,38,30,6
49,r_58_147_107,r_59_76_111,r_96_142_60,r_58_147_107,1,0,107,107,6
44,r_18_94_133,seq15,seq95,r_18_94_133,0.99,0,133,133,6
27,r_51_63_30,r_42_36_31,seq61,r_42_36_31,0.81,6,37,31,6
35,r_20_37_150,r_22_19_93,seq39,r_20_37_150,0.39,0,150,150,6
40,r_116_109_25,seq105,r_36_108_88,r_36_108_88,1,12,100,88,7
12,r_59_106_47,r_60_22_61,seq105,r_59_106_47,1,0,47,47,7
36,r_46_124_100,r_45_99_171,seq127,r_46_124_100,1,0,100,100,7
8,r_119_5_84,r_123_63_106,seq4,r_119_5_84,1,1,85,84,7
26,r_88_84_131,r_94_96_151,r_125_89_37,r_125_89_37,1,0,37,37,7
83,seq74,seq79,r_138_86_119,r_138_86_119,1,9,128,119,7
71,seq44,r_45_99_171,r_31_47_72,r_31_47_72,0.72,45,117,72,7
21,r_30_102_97,r_18_32_47,r_59_106_47,r_30_102_97,0.99,0,97,97,7
1,r_26_97_81,r_30_102_97,r_110_98_30,r_26_97_81,1,0,81,81,7
5,r_16_103_205,r_19_78_170,r_15_17_80,r_19_78_170,0.88,-12,158,170,7
46,r_28_95_83,seq27,seq92,r_28_95_83,1,0,83,83,7
78,seq65,r_64_37_150,seq62,r_64_37_150,0.93,2,152,150,7
10,r_123_63_106,r_119_5_84,r_93_122_18,r_93_122_18,1,2,20,18,7
2,r_77_129_18,seq75,seq130,r_77_129_18,0.99,0,18,18,7
19,r_64_37_150,seq65,r_132_35_35,r_64_37_150,0.83,0,150,150,7
51,seq130,seq134,r_1_131_35,r_1_131_35,1,1,36,35,7
11,r_132_35_35,seq134,r_36_108_88,r_132_35_35,0.82,0,35,35,7
27,r_58_49_35,r_50_2_132,r_9_51_15,r_50_2_132,0.95,4,136,132,7
39,r_125_89_37,seq134,r_88_84_131,r_125_89_37,1,0,37,37,7
38,r_50_2_132,r_58_49_35,r_119_5_84,r_50_2_132,0.9,1,133,132,7
31,r_15_17_80,seq13,r_18_32_47,r_15_17_80,0.53,0,80,80,7
27,r_58_49_35,r_60_22_61,r_50_2_132,r_58_49_35,1,0,35,35,7
3,r_138_86_119,seq142,r_88_84_131,r_138_86_119,0.93,0,119,119,7
95,seq111,r_110_98_30,r_116_109_25,r_110_98_30,0.92,0,30,30,7
78,seq65,r_66_100_117,r_64_37_150,r_66_100_117,0.96,0,117,117,7
0,r_126_81_140,seq127,seq82,r_126_81_140,0.98,0,140,140,7
18,r_38_104_184,r_70_41_5,r_59_106_47,r_38_104_184,0.95,0,184,184,7
20,r_118_120_194,seq112,r_137_117_72,r_137_117_72,1,29,101,72,7
30,r_36_108_88,r_16_103_205,r_34_113_134,r_36_108_88,0.33,-62,26,88,7
13,r_66_100_117,seq65,r_59_106_47,r_66_100_117,1,0,117,117,7
34,r_93_122_18,r_77_129_18,r_123_63_106,r_123_63_106,1,-86,20,106,7
4,r_70_41_5,r_45_99_171,r_31_47_72,r_31_47_72,0.75,20,92,72,7
11,r_132_35_35,r_15_17_80,r_6_39_170,r_132_35_35,0.33,102,137,35,7
57,seq8,r_7_29_194,seq10,r_7_29_194,0.44,1,195,194,7
6,r_137_117_72,r_138_86_119,r_118_120_194,r_137_117_72,0.59,-5,67,72,7
74,seq52,seq53,r_9_51_15,r_9_51_15,1,30,45,15,7
99,seq127,r_126_81_140,r_46_124_100,r_46_124_100,0.61,39,139,100,7
45,r_57_25_181,r_60_22_61,r_0_55_43,r_57_25_181,1,-133,48,181,7
10,r_123_63_106,r_93_122_18,seq62,r_123_63_106,0.97,0,106,106,7
30,r_36_108_88,r_34_113_134,r_132_35_35,r_132_35_35,0.68,8,43,35,7
41,r_56_48_15,r_45_99_171,r_31_47_72,r_31_47_72,0.86,13,85,72,7
11,r_132_35_35,r_36_108_88,r_15_17_80,r_36_108_88,1,-2,86,88,7
29,r_146_90_63,r_147_121_86,r_125_89_37,r_146_90_63,0.75,0,63,63,7
24,r_128_61_99,seq134,seq62,r_128_61_99,0.99,0,99,99,7
34,r_93_122_18,r_123_63_106,r_147_121_86,r_123_63_106,0.68,0,106,106,7
25,r_45_99_171,seq44,r_26_97_81,r_26_97_81,0.97,90,171,81,7
38,r_50_2_132,seq52,r_58_49_35,r_58_49_35,1,1,36,35,7
33,r_19_78_170,seq21,r_83_76_116,r_19_78_170,0.81,0,170,170,7
50,seq149,r_147_121_86,r_145_148_157,r_147_121_86,0.91,5,91,86,7
6,r_137_117_72,r_118_120_194,seq115,r_137_117_72,0.44,58,130,72,7
20,r_118_120_194,r_137_117_72,r_147_121_86,r_118_120_194,0.41,0,194,194,7
68,seq33,r_15_17_80,r_132_35_35,r_132_35_35,0.93,32,67,35,7
14,r_107_71_30,seq101,seq73,r_107_71_30,0.93,0,30,30,7
47,r_110_98_30,seq111,r_94_96_151,r_110_98_30,0.97,0,30,30,7
41,r_56_48_15,r_57_25_181,r_45_99_171,r_56_48_15,0.95,0,15,15,7
45,r_57_25_181,r_0_55_43,r_18_32_47,r_57_25_181,0.64,0,181,181,7
42,r_9_51_15,r_6_39_170,seq52,r_9_51_15,0.97,0,15,15,7
9,r_24_40_180,r_18_32_47,r_31_47_72,r_31_47_72,1,110,182,72,7
30,r_36_108_88,r_132_35_35,r_116_109_25,r_36_108_88,1,0,88,88,7
15,r_34_113_134,r_24_40_180,r_137_117_72,r_34_113_134,0.98,0,134,134,7
16,r_1_131_35,r_0_55_43,seq130,r_1_131_35,1,0,35,35,7
22,r_147_121_86,seq149,r_93_122_18,r_93_122_18,0.89,73,91,18,7
28,r_31_47_72,r_30_102_97,r_56_48_15,r_31_47_72,0.97,0,72,72,7
11,r_132_35_35,r_6_39_170,r_64_37_150,r_132_35_35,0.67,123,158,35,7
7,r_6_39_170,r_7_29_194,seq54,r_7_29_194,0.54,-20,174,194,7
44,r_60_22_61,r_57_25_181,seq21,r_60_22_61,1,0,61,61,7
40,r_116_109_25,r_132_35_35,seq105,r_116_109_25,0.49,-3,22,25,7
23,r_72_80_165,seq73,r_83_76_116,r_72_80_165,0.9,0,165,165,7
40,r_74_129_25,r_136_1_190,r_39_130_161,r_39_130_161,0.87,0,161,161,8
14,r_63_20_168,r_61_4_106,r_69_62_82,r_61_4_106,1,-16,90,106,8
8,r_42_13_11,r_83_121_135,seq14,r_42_13_11,1,0,11,11,8
43,r_52_148_112,seq53,r_3_143_62,r_52_148_112,0.69,0,112,112,8
37,r_47_11_180,seq48,r_8_6_30,r_8_6_30,0.75,153,183,30,8
59,seq24,r_22_107_99,seq29,r_22_107_99,1,-29,70,99,8
55,seq144,seq142,r_3_143_62,r_3_143_62,1,0,62,62,8
16,r_139_58_125,r_140_126_159,r_115_59_113,r_139_58_125,0.82,0,125,125,8
23,r_119_18_156,r_114_118_88,seq21,r_119_18_156,0.61,0,156,156,8
39,r_36_43_62,seq35,seq44,r_36_43_62,1,0,62,62,8
1,r_30_116_78,r_45_33_6,seq117,r_30_116_78,1,0,78,78,8
5,r_9_76_127,r_8_6_30,r_51_79_96,r_9_76_127,0.95,0,127,127,8
42,r_108_26_102,seq109,seq24,r_108_26_102,1,0,102,102,8
18,r_149_147_29,r_140_126_159,seq146,r_149_147_29,0.38,0,29,29,8
63,seq35,seq34,r_57_37_101,r_57_37_101,1,1,102,101,8
7,r_39_130_161,r_82_78_78,r_74_129_25,r_39_130_161,0.51,0,161,161,8
45,r_61_4_106,r_63_20_168,r_8_6_30,r_61_4_106,1,0,106,106,8
93,seq111,seq110,r_80_112_33,r_80_112_33,1,6,39,33,8
19,r_41_32_73,seq40,r_45_33_6,r_41_32_73,0.99,0,73,73,8
46,r_97_17_29,seq98,seq29,r_97_17_29,1,0,29,29,8
95,seq117,r_115_59_113,r_30_116_78,r_30_116_78,0.87,35,113,78,8
66,seq44,seq54,r_36_43_62,r_36_43_62,1,12,74,62,8
31,r_55_138_129,seq54,r_3_143_62,r_55_138_129,0.66,0,129,129,8
36,r_68_99_32,r_69_62_82,seq100,r_68_99_32,1,0,32,32,8
10,r_115_59_113,seq117,r_60_65_108,r_115_59_113,0.99,0,113,113,8
64,seq38,r_39_130_161,r_60_65_108,r_39_130_161,0.57,-30,131,161,8
4,r_0_46_121,r_9_76_127,r_36_43_62,r_0_46_121,0.24,0,121,121,8
26,r_133_31_14,seq137,r_45_33_6,r_133_31_14,0.99,0,14,14,8
0,r_83_121_135,seq84,seq122,r_83_121_135,0.73,0,135,135,8
63,seq35,r_36_43_62,seq34,r_36_43_62,0.99,0,62,62,8
73,seq66,r_67_10_133,r_60_65_108,r_67_10_133,0.96,0,133,133,8
11,r_67_10_133,seq66,r_8_6_30,r_67_10_133,0.73,0,133,133,8
13,r_22_107_99,seq24,seq109,r_22_107_99,1,0,99,99,8
85,seq98,seq94,r_12_96_118,r_12_96_118,0.96,3,121,118,8
3,r_45_33_6,r_30_116_78,r_133_31_14,r_45_33_6,0.8,12,18,6,8
48,r_23_15_35,r_22_107_99,r_16_71_113,r_22_107_99,0.58,-64,35,99,8
2,r_3_143_62,r_8_6_30,seq144,r_3_143_62,1,0,62,62,8
47,r_82_78_78,r_83_121_135,r_51_79_96,r_83_121_135,1,-27,108,135,8
24,r_25_77_84,seq24,r_82_78_78,r_25_77_84,1,0,84,84,8
34,r_69_62_82,r_63_20_168,r_139_58_125,r_69_62_82,0.77,86,168,82,8
48,r_23_15_35,r_16_71_113,seq29,r_16_71_113,0.97,0,113,113,8
65,seq40,seq48,r_115_59_113,r_115_59_113,0.94,6,119,113,8
21,r_28_132_37,seq29,seq137,r_28_132_37,1,0,37,37,8
61,seq29,seq27,r_97_17_29,r_97_17_29,1,52,81,29,8
92,seq110,seq111,r_80_112_33,r_80_112_33,0.99,7,40,33,8
32,r_5_134_93,r_8_6_30,seq137,r_5_134_93,0.99,0,93,93,8
52,seq137,r_136_1_190,r_50_131_68,r_50_131_68,1,14,82,68,8
77,seq84,r_83_121_135,r_51_79_96,r_83_121_135,0.99,0,135,135,8
41,r_80_112_33,r_82_78_78,seq111,r_80_112_33,1,0,33,33,8
34,r_69_62_82,seq73,r_63_20_168,r_69_62_82,0.47,6,88,82,8
40,r_74_129_25,r_69_62_82,r_136_1_190,r_74_129_25,0.99,0,25,25,8
9,r_57_37_101,r_61_4_106,seq35,r_57_37_101,1,0,101,101,8
22,r_60_65_108,r_63_20_168,seq66,r_63_20_168,0.71,-60,108,168,8
28,r_16_71_113,r_23_15_35,seq72,r_16_71_113,0.99,0,113,113,8
49,r_102_64_130,seq103,r_60_65_108,r_102_64_130,0.88,0,130,130,8
7,r_39_130_161,r_55_138_129,r_82_78_78,r_55_138_129,1,-54,75,129,8
44,r_50_131_68,seq49,r_28_132_37,r_50_131_68,0.95,0,68,68,8
15,r_140_126_159,r_55_138_129,r_83_121_135,r_140_126_159,0.89,0,159,159,8
23,r_119_18_156,r_120_145_110,r_114_118_88,r_120_145_110,0.5,0,110,110,8
35,r_120_145_110,r_119_18_156,seq146,r_120_145_110,0.9,0,110,110,8
40,r_26_32_55,seq37,r_83_33_122,r_83_33_122,0.99,44,166,122,9
51,seq129,r_132_14_194,seq127,r_132_14_194,0.99,-29,165,194,9
36,r_107_114_127,seq109,r_92_116_3,r_107_114_127,0.77,0,127,127,9
5,r_13_106_45,seq11,seq104,r_13_106_45,1,0,45,45,9
7,r_71_52_90,r_69_144_159,r_49_53_84,r_71_52_90,0.51,0,90,90,9
14,r_51_31_198,r_50_136_134,seq47,r_50_136_134,1,-1,133,134,9
8,r_140_25_196,r_143_139_177,r_80_23_26,r_140_25_196,0.39,0,196,196,9
24,r_24_39_108,r_120_19_49,r_72_17_71,r_24_39_108,0.86,0,108,108,9
69,seq44,seq43,r_135_45_41,r_135_45_41,1,1,42,41,9
71,seq54,seq61,r_49_53_84,r_49_53_84,1,2,86,84,9
16,r_119_10_60,r_121_29_169,seq11,r_119_10_60,0.99,0,60,60,9
21,r_115_95_139,r_92_116_3,seq96,r_115_95_139,0.87,0,139,139,9
39,r_50_136_134,r_51_31_198,seq134,r_50_136_134,1,0,134,134,9
46,r_146_82_134,r_143_139_177,r_128_85_88,r_143_139_177,0.97,-43,134,177,9
42,r_84_89_66,r_83_33_122,r_62_90_4,r_83_33_122,0.57,-57,65,122,9
45,r_72_17_71,r_71_52_90,r_120_19_49,r_72_17_71,1,0,71,71,9
9,r_133_60_52,r_143_139_177,seq59,r_133_60_52,1,0,52,52,9
19,r_128_85_88,seq126,seq81,r_128_85_88,0.99,0,88,88,9
1,r_16_56_16,r_24_39_108,seq57,r_16_56_16,0.95,1,17,16,9
47,r_48_12_38,seq47,seq11,r_48_12_38,1,3,41,38,9
76,seq64,seq61,r_5_63_92,r_5_63_92,1,18,110,92,9
3,r_137_117_43,r_133_60_52,r_2_118_40,r_137_117_43,1,0,43,43,9
31,r_75_145_112,seq73,r_143_139_177,r_75_145_112,1,0,112,112,9
37,r_100_55_64,r_103_15_137,r_70_101_34,r_100_55_64,0.57,-16,48,64,9
38,r_80_23_26,r_83_33_122,r_22_105_54,r_80_23_26,0.94,0,26,26,9
10,r_66_18_179,seq61,r_72_17_71,r_72_17_71,1,106,177,71,9
14,r_51_31_198,seq47,r_121_29_169,r_51_31_198,0.69,0,198,198,9
4,r_67_20_200,seq68,r_120_19_49,r_120_19_49,0.7,150,199,49,9
78,seq73,r_75_145_112,r_77_74_122,r_75_145_112,1,-1,111,112,9
11,r_132_14_194,seq129,r_103_15_137,r_132_14_194,0.56,0,194,194,9
15,r_92_116_3,r_115_95_139,r_107_114_127,r_92_116_3,0.81,136,139,3,9
48,r_4_141_201,r_1_3_206,r_143_139_177,r_1_3_206,0.32,-6,200,206,9
24,r_24_39_108,r_72_17_71,r_34_46_202,r_24_39_108,0.35,29,137,108,9
28,r_87_130_13,r_88_21_71,seq129,r_87_130_13,0.87,0,13,13,9
26,r_135_45_41,r_137_117_43,seq44,r_135_45_41,1,0,41,41,9
38,r_80_23_26,r_22_105_54,r_120_19_49,r_80_23_26,0.91,28,54,26,9
2,r_34_46_202,seq37,r_135_45_41,r_135_45_41,0.7,162,203,41,9
67,seq40,seq43,r_51_31_198,r_51_31_198,0.54,-167,31,198,9
40,r_26_32_55,seq27,seq37,r_26_32_55,0.84,0,55,55,9
29,r_49_53_84,r_51_31_198,seq54,r_49_53_84,1,0,84,84,9
92,seq110,seq111,r_41_112_3,r_41_112_3,0.84,19,22,3,9
20,r_65_123_55,seq64,seq125,r_65_123_55,0.99,0,55,55,9
33,r_5_63_92,seq6,seq64,r_5_63_92,1,0,92,92,9
70,seq47,r_51_31_198,r_135_45_41,r_135_45_41,1,155,196,41,9
44,r_149_78_55,seq147,seq76,r_149_78_55,1,0,55,55,9
32,r_69_144_159,seq61,r_75_145_112,r_69_144_159,0.58,0,159,159,9
17,r_83_33_122,seq81,seq36,r_83_33_122,0.98,0,122,122,9
25,r_120_19_49,r_80_23_26,r_88_21_71,r_88_21_71,0.76,45,116,71,9
24,r_24_39_108,r_22_105_54,r_120_19_49,r_24_39_108,1,-54,54,108,9
22,r_58_35_141,seq57,seq36,r_58_35_141,0.8,0,141,141,9
49,r_86_42_183,seq81,seq40,r_86_42_183,0.67,0,183,183,9
34,r_70_101_34,r_72_17_71,seq99,r_70_101_34,0.98,1,35,34,9
7,r_71_52_90,r_72_17_71,r_69_144_159,r_72_17_71,0.93,0,71,71,9
41,r_22_105_54,r_24_39_108,r_13_106_45,r_24_39_108,0.7,-54,54,108,9
18,r_2_118_40,r_1_3_206,r_137_117_43,r_2_118_40,1,0,40,40,9
25,r_120_19_49,r_119_10_60,r_80_23_26,r_80_23_26,0.6,23,49,26,9
79,seq76,r_77_74_122,r_149_78_55,r_149_78_55,1,38,93,55,9
35,r_88_21_71,r_103_15_137,r_120_19_49,r_88_21_71,0.87,0,71,71,9
37,r_100_55_64,r_70_101_34,r_16_56_16,r_100_55_64,0.97,0,64,64,9
24,r_24_39_108,r_34_46_202,seq47,r_34_46_202,0.42,-15,187,202,9
92,seq95,r_97_104_121,r_120_96_71,r_120_96_71,1,52,123,71,10
8,r_126_75_152,r_127_94_101,seq129,r_127_94_101,1,0,101,101,10
53,seq3,seq4,r_117_5_83,r_117_5_83,1,3,86,83,10
34,r_100_13_45,seq102,seq14,r_100_13_45,1,0,45,45,10
61,seq14,r_15_68_157,r_100_13_45,r_100_13_45,1,1,46,45,10
37,r_67_11_122,r_64_73_168,seq10,r_67_11_122,0.99,1,123,122,10
42,r_128_35_29,r_126_75_152,seq34,r_128_35_29,1,1,30,29,10
21,r_84_26_192,seq82,r_113_33_56,r_113_33_56,1,136,192,56,10
39,r_111_114_191,r_117_5_83,r_16_115_87,r_111_114_191,1,-107,84,191,10
5,r_64_73_168,seq63,r_89_70_9,r_89_70_9,0.73,159,168,9,10
80,seq63,r_64_73_168,r_29_62_29,r_29_62_29,1,136,165,29,10
45,r_116_110_144,r_119_36_165,r_93_109_107,r_93_109_107,0.89,37,144,107,10
15,r_136_91_42,seq137,r_93_109_107,r_136_91_42,1,0,42,42,10
19,r_118_66_64,r_117_5_83,r_29_62_29,r_118_66_64,1,1,65,64,10
49,r_16_115_87,r_116_110_144,seq129,r_16_115_87,0.42,57,144,87,10
15,r_136_91_42,r_93_109_107,r_106_92_47,r_93_109_107,1,0,107,107,10
95,seq102,seq99,r_76_101_74,r_76_101_74,1,68,142,74,10
38,r_22_90_35,r_21_24_66,seq88,r_22_90_35,1,0,35,35,10
68,seq34,seq37,r_128_35_29,r_128_35_29,0.96,8,37,29,10
10,r_119_36_165,r_117_5_83,r_16_115_87,r_119_36_165,1,-80,85,165,10
1,r_93_109_107,r_106_92_47,seq105,r_93_109_107,1,0,107,107,10
26,r_112_147_79,r_117_5_83,seq146,r_112_147_79,0.82,0,79,79,10
4,r_138_9_98,seq137,seq10,r_138_9_98,1,0,98,98,10
0,r_117_5_83,r_119_36_165,seq6,r_117_5_83,0.99,0,83,83,10
63,seq17,r_19_30_121,r_15_68_157,r_15_68_157,0.62,-42,115,157,10
73,seq46,r_45_65_74,seq77,r_45_65_74,0.58,0,74,74,10
11,r_108_50_120,seq107,seq51,r_108_50_120,0.97,0,120,120,10
13,r_142_80_158,seq143,seq81,r_142_80_158,0.83,0,158,158,10
48,r_55_139_95,r_56_23_177,seq137,r_55_139_95,1,0,95,95,10
1,r_93_109_107,seq105,r_116_110_144,r_116_110_144,0.77,24,168,144,10
67,seq28,r_21_24_66,r_18_27_42,r_18_27_42,1,1,43,42,10
16,r_106_92_47,seq105,r_136_91_42,r_106_92_47,1,0,47,47,10
9,r_60_141_37,r_56_23_177,seq146,r_60_141_37,1,0,37,37,10
6,r_29_62_29,r_22_90_35,seq63,r_29_62_29,0.99,-1,28,29,10
10,r_119_36_165,r_16_115_87,r_128_35_29,r_119_36_165,0.73,0,165,165,10
27,r_122_39_78,r_121_20_126,r_135_38_74,r_122_39_78,0.84,0,78,78,10
28,r_121_20_126,r_126_75_152,seq17,r_121_20_126,0.97,0,126,126,10
2,r_120_96_71,r_122_39_78,seq95,r_120_96_71,1,0,71,71,10
59,seq10,seq8,r_117_5_83,r_117_5_83,0.84,73,156,83,10
40,r_45_65_74,seq46,r_29_62_29,r_45_65_74,0.93,0,74,74,10
29,r_1_31_107,seq0,r_113_33_56,r_113_33_56,0.58,51,107,56,10
8,r_126_75_152,seq129,seq77,r_126_75_152,1,1,153,152,10
25,r_56_23_177,seq58,r_113_33_56,r_113_33_56,1,125,181,56,10
43,r_87_57_175,r_32_86_6,r_29_62_29,r_32_86_6,0.34,171,177,6,10
33,r_133_144_161,seq137,r_112_147_79,r_112_147_79,1,82,161,79,10
91,seq88,seq99,r_22_90_35,r_22_90_35,1,7,42,35,10
1,r_93_109_107,r_97_104_121,r_106_92_47,r_106_92_47,1,9,56,47,10
32,r_19_30_121,seq17,r_113_33_56,r_19_30_121,0.92,0,121,121,10
62,seq143,r_142_80_158,r_60_141_37,r_60_141_37,1,1,38,37,10
17,r_15_68_157,seq14,r_142_80_158,r_15_68_157,0.57,1,158,157,10
43,r_87_57_175,r_84_26_192,r_32_86_6,r_87_57_175,0.59,-119,56,175,10
22,r_103_132_136,seq102,seq131,r_103_132_136,0.88,0,136,136,10
28,r_121_20_126,r_122_39_78,r_126_75_152,r_122_39_78,1,-2,76,78,10
49,r_16_115_87,r_19_30_121,r_116_110_144,r_16_115_87,1,0,87,87,10
3,r_113_33_56,r_112_147_79,seq28,r_113_33_56,1,0,56,56,10
23,r_76_101_74,seq79,seq102,r_76_101_74,1,0,74,74,10
18,r_44_54_40,seq46,seq58,r_44_54_40,0.99,0,40,40,10
47,r_21_24_66,seq28,r_18_27_42,r_18_27_42,1,5,47,42,10
35,r_127_94_101,r_126_75_152,r_120_96_71,r_126_75_152,1,-51,101,152,10
12,r_53_78_120,seq52,seq81,r_53_78_120,0.58,1,121,120,10
93,seq112,seq114,r_148_113_54,r_148_113_54,1,47,101,54,11
40,r_81_146_102,r_147_138_178,r_64_145_153,r_64_145_153,0.68,25,178,153,11
30,r_30_25_74,r_31_32_163,seq22,r_30_25_74,1,0,74,74,11
36,r_63_76_208,seq62,r_34_77_163,r_34_77_163,0.78,44,207,163,11
13,r_61_49_30,r_48_73_70,r_31_32_163,r_61_49_30,0.54,40,70,30,11
14,r_7_134_158,r_8_102_161,seq133,r_7_134_158,0.8,1,159,158,11
18,r_47_130_43,r_43_28_173,seq129,r_47_130_43,1,1,44,43,11
8,r_19_5_101,seq17,seq6,r_19_5_101,0.96,0,101,101,11
19,r_91_85_217,r_12_90_23,seq83,r_91_85_217,0.55,0,217,217,11
86,seq83,r_84_128_99,r_87_44_228,r_84_128_99,1,4,103,99,11
16,r_88_13_103,r_61_49_30,seq69,r_61_49_30,0.62,44,74,30,11
1,r_43_28_173,seq46,r_31_32_163,r_43_28_173,0.39,32,205,173,11
5,r_86_59_95,r_87_44_228,seq58,r_86_59_95,0.72,2,97,95,11
46,r_144_121_84,r_147_138_178,seq119,r_144_121_84,1,0,84,84,11
42,r_75_72_112,r_74_125_186,r_48_73_70,r_75_72_112,0.67,0,112,112,11
32,r_21_66_37,seq69,r_48_73_70,r_48_73_70,0.81,127,197,70,11
45,r_87_44_228,r_86_59_95,seq83,r_86_59_95,0.98,14,109,95,11
19,r_91_85_217,r_94_124_203,r_12_90_23,r_12_90_23,1,146,169,23,11
31,r_147_138_178,r_149_20_87,r_142_50_208,r_149_20_87,0.91,-1,86,87,11
20,r_37_104_17,r_40_10_125,seq109,r_37_104_17,0.9,0,17,17,11
35,r_8_102_161,r_7_134_158,r_92_9_27,r_92_9_27,1,28,55,27,11
88,seq96,r_99_67_63,r_110_98_36,r_99_67_63,1,-12,51,63,11
64,seq26,r_43_28_173,r_97_27_35,r_97_27_35,1,4,39,35,11
26,r_18_143_72,r_19_5_101,r_142_50_208,r_18_143_72,1,0,72,72,11
29,r_92_9_27,r_91_85_217,r_8_102_161,r_92_9_27,0.9,1,28,27,11
4,r_106_101_117,r_108_11_129,seq100,r_108_11_129,1,-11,118,129,11
0,r_105_54_78,seq111,seq53,r_105_54_78,1,0,78,78,11
11,r_99_67_63,seq96,r_21_66_37,r_99_67_63,1,0,63,63,11
48,r_71_23_75,r_81_146_102,seq22,r_71_23_75,1,0,75,75,11
57,seq129,r_131_136_108,r_47_130_43,r_47_130_43,1,66,109,43,11
31,r_147_138_178,r_81_146_102,seq139,r_147_138_178,0.61,0,178,178,11
6,r_48_73_70,r_61_49_30,r_79_82_167,r_79_82_167,0.33,-98,69,167,11
62,seq22,r_19_5_101,r_71_23_75,r_71_23_75,0.99,1,76,75,11
15,r_89_33_64,r_64_145_153,seq35,r_89_33_64,0.44,-19,45,64,11
27,r_115_78_206,seq112,r_48_73_70,r_48_73_70,0.3,137,207,70,11
16,r_88_13_103,seq69,r_15_51_135,r_88_13_103,0.94,0,103,103,11
41,r_12_90_23,r_19_5_101,r_91_85_217,r_12_90_23,1,0,23,23,11
87,seq95,seq96,r_110_98_36,r_110_98_36,0.54,35,71,36,11
13,r_61_49_30,r_31_32_163,r_15_51_135,r_15_51_135,1,10,145,135,11
47,r_34_77_163,seq35,seq80,r_34_77_163,0.61,2,165,163,11
40,r_81_146_102,r_74_125_186,r_147_138_178,r_81_146_102,0.99,-1,101,102,11
16,r_88_13_103,r_15_51_135,seq17,r_15_51_135,1,0,135,135,11
24,r_108_11_129,seq109,r_88_13_103,r_108_11_129,0.58,0,129,129,11
35,r_8_102_161,r_92_9_27,r_106_101_117,r_8_102_161,0.65,0,161,161,11
25,r_140_107_207,seq141,r_37_104_17,r_37_104_17,0.77,190,207,17,11
6,r_48_73_70,r_79_82_167,r_75_72_112,r_48_73_70,0.51,46,116,70,11
33,r_31_32_163,seq29,r_43_28_173,r_31_32_163,0.33,38,201,163,11
61,seq17,seq22,r_88_13_103,r_88_13_103,0.98,34,137,103,11
2,r_148_113_54,r_147_138_178,seq112,r_148_113_54,1,0,54,54,11
22,r_24_116_14,r_19_5_101,seq117,r_24_116_14,1,0,14,14,11
34,r_40_10_125,seq39,r_92_9_27,r_40_10_125,0.87,0,125,125,11
75,seq53,seq55,r_105_54_78,r_105_54_78,1,37,115,78,11
17,r_84_128_99,seq83,seq127,r_84_128_99,1,0,99,99,11
26,r_18_143_72,r_142_50_208,r_64_145_153,r_64_145_153,1,55,208,153,11
96,seq119,r_120_93_205,r_148_113_54,r_148_113_54,1,148,202,54,11
29,r_92_9_27,r_8_102_161,r_40_10_125,r_40_10_125,0.96,36,161,125,11
28,r_120_93_205,seq119,r_12_90_23,r_12_90_23,0.99,182,205,23,11
91,seq109,r_108_11_129,seq111,r_108_11_129,1,1,130,129,11
49,r_94_124_203,r_91_85_217,r_148_113_54,r_148_113_54,1,148,202,54,11
7,r_118_126_63,seq117,seq122,r_118_126_63,0.7,0,63,63,11
44,r_74_125_186,r_79_82_167,r_118_126_63,r_79_82_167,0.38,20,187,167,11
23,r_142_50_208,r_147_138_178,r_18_143_72,r_18_143_72,1,28,100,72,11
31,r_147_138_178,r_142_50_208,r_81_146_102,r_81_146_102,1,4,106,102,11
32,r_21_66_37,r_19_5_101,seq69,r_21_66_37,1,0,37,37,11
79,seq58,seq60,r_86_59_95,r_86_59_95,0.99,-26,69,95,11
95,seq117,r_115_78_206,r_24_116_14,r_24_116_14,1,0,14,14,11
12,r_149_20_87,r_147_138_178,seq17,r_149_20_87,1,0,87,87,11
13,r_61_49_30,r_64_145_153,r_48_73_70,r_61_49_30,0.66,0,30,30,11
39,r_110_98_36,r_105_54_78,seq96,r_105_54_78,0.99,-42,36,78,11
23,r_142_50_208,r_18_143_72,r_61_49_30,r_142_50_208,0.8,0,208,208,11
30,r_31_19_110,r_30_101_97,seq20,r_31_19_110,0.82,-11,99,110,12
14,r_11_118_188,seq16,seq10,r_11_118_188,0.4,-75,113,188,12
8,r_41_57_105,r_40_90_176,r_39_36_64,r_41_57_105,0.63,42,147,105,12
58,seq10,r_14_15_44,r_8_77_195,r_8_77_195,0.57,-81,114,195,12
43,r_116_9_130,seq119,seq10,r_116_9_130,0.99,0,130,130,12
1,r_6_109_180,r_105_0_71,seq110,r_6_109_180,0.93,0,180,180,12
37,r_106_92_75,r_107_28_173,seq91,r_106_92_75,0.97,-1,74,75,12
59,seq139,r_138_4_65,r_135_65_151,r_138_4_65,0.94,0,65,65,12
15,r_98_33_91,r_106_92_75,r_99_145_185,r_106_92_75,0.68,-46,29,75,12
16,r_102_137_91,seq103,seq139,r_102_137_91,0.98,0,91,91,12
39,r_141_130_105,r_142_78_121,r_94_132_74,r_141_130_105,0.99,0,105,105,12
1,r_6_109_180,r_7_124_154,r_105_0_71,r_105_0_71,0.49,64,135,71,12
27,r_94_132_74,seq79,r_63_96_52,r_94_132_74,0.67,-15,59,74,12
5,r_56_35_49,seq58,r_39_36_64,r_56_35_49,0.48,20,69,49,12
46,r_111_26_65,r_112_95_159,r_27_146_107,r_111_26_65,1,0,65,65,12
42,r_99_145_185,r_107_28_173,r_40_90_176,r_40_90_176,0.66,-3,173,176,12
47,r_107_28_173,r_43_108_116,seq29,r_107_28_173,0.81,0,173,173,12
46,r_111_26_65,r_8_77_195,r_98_33_91,r_111_26_65,0.58,59,124,65,12
15,r_98_33_91,r_99_145_185,seq34,r_98_33_91,0.95,0,91,91,12
41,r_5_104_175,r_6_109_180,r_30_101_97,r_5_104_175,0.57,0,175,175,12
67,seq34,r_32_23_69,r_30_101_97,r_32_23_69,0.68,-2,67,69,12
36,r_100_117_32,r_105_0_71,seq119,r_100_117_32,0.98,0,32,32,12
40,r_43_108_116,r_107_28_173,r_30_101_97,r_107_28_173,0.99,0,173,173,12
3,r_60_42_72,seq61,r_122_45_47,r_122_45_47,1,19,66,47,12
10,r_105_0_71,r_102_137_91,r_138_4_65,r_105_0_71,1,0,71,71,12
27,r_94_132_74,r_63_96_52,seq133,r_94_132_74,0.97,0,74,74,12
4,r_66_37_159,r_71_70_77,r_41_57_105,r_71_70_77,0.33,48,125,77,12
18,r_143_83_156,r_27_146_107,r_142_78_121,r_143_83_156,1,-13,143,156,12
63,seq147,seq148,r_27_146_107,r_27_146_107,1,2,109,107,12
73,seq55,seq58,r_126_54_66,r_126_54_66,1,41,107,66,12
11,r_18_67_142,seq22,seq74,r_18_67_142,0.81,0,142,142,12
20,r_7_124_154,r_6_109_180,r_121_120_169,r_7_124_154,0.86,0,154,154,12
13,r_27_146_107,seq29,r_111_26_65,r_111_26_65,0.99,7,72,65,12
22,r_25_59_147,r_18_67_142,r_12_24_32,r_25_59_147,0.56,-115,32,147,12
48,r_142_78_121,r_141_130_105,r_149_140_99,r_141_130_105,0.51,0,105,105,12
4,r_66_37_159,r_41_57_105,seq38,r_66_37_159,0.66,0,159,159,12
6,r_30_101_97,r_31_19_110,seq103,r_30_101_97,0.9,1,98,97,12
0,r_12_24_32,r_25_59_147,r_32_23_69,r_12_24_32,0.74,103,135,32,12
22,r_25_59_147,r_12_24_32,r_41_57_105,r_25_59_147,0.49,0,147,147,12
2,r_149_140_99,seq148,r_142_78_121,r_149_140_99,0.69,0,99,99,12
47,r_107_28_173,r_106_92_75,r_99_145_185,r_106_92_75,0.77,6,81,75,12
76,seq62,r_63_96_52,r_53_64_108,r_63_96_52,0.83,3,55,52,12
40,r_43_108_116,r_41_57_105,r_107_28_173,r_43_108_116,0.58,0,116,116,12
18,r_143_83_156,r_144_46_102,r_27_146_107,r_143_83_156,0.9,-53,103,156,12
24,r_126_54_66,seq125,seq55,r_126_54_66,1,0,66,66,12
25,r_69_89_109,seq68,r_106_92_75,r_69_89_109,0.89,0,109,109,12
13,r_27_146_107,r_111_26_65,seq147,r_27_146_107,1,0,107,107,12
32,r_32_23_69,seq34,seq22,r_32_23_69,0.88,0,69,69,12
58,seq10,r_8_77_195,r_116_9_130,r_116_9_130,0.57,2,132,130,12
29,r_63_96_52,seq62,r_94_132_74,r_63_96_52,0.92,0,52,52,12
77,seq68,r_69_89_109,seq74,r_69_89_109,1,0,109,109,12
48,r_142_78_121,r_149_140_99,seq79,r_142_78_121,0.96,0,121,121,12
34,r_144_46_102,r_143_83_156,r_122_45_47,r_144_46_102,0.99,0,102,102,12
45,r_8_77_195,seq29,r_14_15_44,r_8_77_195,0.61,-154,41,195,12
46,r_111_26_65,r_27_146_107,r_8_77_195,r_27_146_107,0.98,0,107,107,12
75,seq61,r_60_42_72,r_41_57_105,r_60_42_72,0.61,29,101,72,12
45,r_8_77_195,r_14_15_44,seq10,r_8_77_195,0.41,-81,114,195,12
29,r_63_96_52,r_88_131_122,r_73_97_87,r_63_96_52,0.8,38,90,52,12
17,r_40_90_176,r_41_57_105,r_21_87_142,r_40_90_176,0.37,0,176,176,12
9,r_72_48_176,seq75,r_122_45_47,r_122_45_47,1,131,178,47,12
96,seq148,r_149_140_99,seq147,r_149_140_99,1,-6,93,99,12
0,r_12_24_32,seq16,r_25_59_147,r_12_24_32,0.53,0,32,32,12
91,seq110,r_112_95_159,seq113,r_112_95_159,0.78,-58,101,159,12
47,r_107_28_173,r_99_145_185,r_43_108_116,r_43_108_116,0.98,14,130,116,12
49,r_138_4_65,seq139,seq2,r_138_4_65,1,0,65,65,12
59,seq139,r_135_65_151,r_102_137_91,r_102_137_91,0.7,5,96,91,12
23,r_112_95_159,r_111_26_65,seq113,r_111_26_65,1,-1,64,65,12
29,r_63_96_52,r_94_132_74,r_88_131_122,r_94_132_74,0.97,0,74,74,12
35,r_135_65_151,seq134,r_18_67_142,r_18_67_142,0.78,9,151,142,12
12,r_21_87_142,seq20,r_106_92_75,r_21_87_142,0.66,0,142,142,12
23,r_112_95_159,seq113,r_21_87_142,r_112_95_159,0.95,0,159,159,12
30,r_0_94_178,r_1_96_177,r_113_10_24,r_113_10_24,0.78,133,157,24,13
51,seq6,r_1_96_177,r_86_9_72,r_86_9_72,0.88,5,77,72,13
92,seq97,r_98_131_154,seq95,r_98_131_154,0.94,2,156,154,13
14,r_149_112_93,seq146,r_128_111_91,r_128_111_91,0.81,2,93,91,13
15,r_33_125_29,r_31_17_24,seq127,r_33_125_29,0.99,0,29,29,13
37,r_42_143_61,seq43,seq145,r_42_143_61,1,0,61,61,13
17,r_83_100_23,seq77,r_108_102_89,r_83_100_23,1,0,23,23,13
29,r_37_79_51,r_39_141_192,r_121_78_11,r_37_79_51,1,0,51,51,13
86,seq87,r_86_9_72,seq90,r_86_9_72,1,-1,71,72,13
16,r_30_129_132,r_34_55_142,r_33_125_29,r_34_55_142,0.61,-10,132,142,13
21,r_115_74_125,r_118_28_177,r_25_114_75,r_25_114_75,1,2,77,75,13
5,r_34_55_142,r_35_8_150,seq57,r_34_55_142,0.78,0,142,142,13
42,r_119_124_159,seq120,r_33_125_29,r_33_125_29,0.83,133,162,29,13
16,r_30_129_132,r_33_125_29,r_98_131_154,r_30_129_132,0.52,28,160,132,13
66,seq146,seq145,r_5_147_32,r_5_147_32,1,9,41,32,13
21,r_115_74_125,r_25_114_75,seq75,r_115_74_125,0.99,0,125,125,13
46,r_49_137_14,r_58_59_159,seq140,r_49_137_14,0.96,0,14,14,13
33,r_62_81_8,seq80,r_61_82_99,r_61_82_99,1,19,118,99,13
1,r_101_27_55,r_108_102_89,seq29,r_101_27_55,1,0,55,55,13
95,seq140,r_139_48_104,r_104_138_44,r_139_48_104,0.58,0,104,104,13
31,r_142_19_135,seq146,seq18,r_142_19_135,0.74,0,135,135,13
41,r_123_32_81,seq122,r_35_8_150,r_123_32_81,0.97,0,81,81,13
3,r_25_114_75,r_26_22_111,r_115_74_125,r_25_114_75,1,0,75,75,13
30,r_0_94_178,r_113_10_24,seq92,r_0_94_178,0.94,0,178,178,13
90,seq92,r_93_107_180,r_0_94_178,r_0_94_178,0.71,2,180,178,13
9,r_113_10_24,seq110,seq12,r_113_10_24,0.99,0,24,24,13
4,r_86_9_72,seq87,seq6,r_86_9_72,1,0,72,72,13
45,r_5_147_32,seq6,seq146,r_5_147_32,1,3,35,32,13
63,seq29,seq24,r_101_27_55,r_101_27_55,1,34,89,55,13
73,seq57,r_58_59_159,r_34_55_142,r_34_55_142,0.85,17,159,142,13
11,r_1_96_177,r_0_94_178,r_108_102_89,r_108_102_89,0.64,89,178,89,13
13,r_26_22_111,seq24,r_21_2_169,r_26_22_111,0.9,0,111,111,13
38,r_39_141_192,r_37_79_51,r_11_40_32,r_37_79_51,0.96,0,51,51,13
48,r_58_59_159,seq57,r_126_65_56,r_126_65_56,1,103,159,56,13
6,r_44_53_182,seq47,seq51,r_44_53_182,0.28,0,182,182,13
85,seq85,seq88,r_41_84_8,r_41_84_8,0.93,18,26,8,13
7,r_31_17_24,r_33_125_29,seq18,r_31_17_24,0.99,0,24,24,13
27,r_144_15_111,seq145,seq14,r_144_15_111,1,0,111,111,13
2,r_108_102_89,r_106_103_166,r_68_105_91,r_68_105_91,1,11,102,91,13
41,r_123_32_81,r_35_8_150,r_116_46_37,r_35_8_150,0.93,0,150,150,13
47,r_68_105_91,r_67_7_161,r_108_102_89,r_68_105_91,1,0,91,91,13
40,r_118_28_177,seq117,r_101_27_55,r_101_27_55,1,122,177,55,13
24,r_21_2_169,r_1_96_177,r_26_22_111,r_26_22_111,0.63,5,116,111,13
99,seq127,r_128_111_91,r_33_125_29,r_33_125_29,0.75,29,58,29,13
8,r_99_38_7,r_37_79_51,r_11_40_32,r_37_79_51,0.99,0,51,51,13
25,r_3_72_113,r_1_96_177,seq73,r_3_72_113,0.68,0,113,113,13
64,seq36,seq43,r_11_40_32,r_11_40_32,1,51,83,32,13
68,seq47,seq43,r_116_46_37,r_116_46_37,1,49,86,37,13
20,r_104_138_44,r_101_27_55,r_49_137_14,r_101_27_55,0.47,-11,44,55,13
34,r_128_111_91,seq127,r_149_112_93,r_128_111_91,0.65,7,98,91,13
3,r_25_114_75,r_115_74_125,r_149_112_93,r_115_74_125,1,-3,122,125,13
0,r_116_46_37,r_115_74_125,seq47,r_116_46_37,0.99,1,38,37,13
24,r_21_2_169,r_26_22_111,r_86_9_72,r_86_9_72,0.74,98,170,72,13
94,seq110,r_119_124_159,r_149_112_93,r_149_112_93,0.68,56,149,93,13
43,r_126_65_56,r_128_111_91,seq64,r_126_65_56,1,0,56,56,13
96,seq117,r_118_28_177,seq122,r_118_28_177,0.69,-26,151,177,13
19,r_11_40_32,seq12,r_99_38_7,r_11_40_32,0.99,1,33,32,13
51,seq6,r_5_147_32,r_1_96_177,r_5_147_32,0.98,3,35,32,13
22,r_89_45_108,seq90,seq47,r_89_45_108,0.99,0,108,108,13
28,r_76_56_85,seq75,seq57,r_76_56_85,0.89,4,89,85,13
56,seq14,seq12,r_144_15_111,r_144_15_111,1,15,126,111,13
89,seq91,r_93_107_180,seq92,r_93_107_180,0.67,-136,44,180,13
44,r_98_131_154,seq97,r_30_129_132,r_98_131_154,0.46,2,156,154,13
23,r_67_7_161,seq66,r_35_8_150,r_67_7_161,0.7,0,161,161,13
82,seq75,r_76_56_85,seq73,r_76_56_85,1,4,89,85,13
35,r_61_82_99,r_67_7_161,r_62_81_8,r_61_82_99,0.92,0,99,99,13
12,r_139_48_104,seq140,r_76_56_85,r_139_48_104,1,0,104,104,13
36,r_121_78_11,r_116_46_37,seq80,r_121_78_11,0.81,2,13,11,13
84,seq80,seq77,r_37_79_51,r_37_79_51,1,12,63,51,13
6,r_118_14_20,seq119,seq11,r_118_14_20,0.99,0,20,20,14
29,r_148_0_90,r_19_106_117,r_57_43_101,r_148_0_90,0.54,12,102,90,14
14,r_127_138_106,r_122_44_161,r_116_136_54,r_122_44_161,1,-55,106,161,14
8,r_101_15_66,seq105,seq16,r_101_15_66,1,0,66,66,14
37,r_50_66_175,r_48_135_198,r_76_65_96,r_76_65_96,1,79,175,96,14
55,seq141,r_142_111_197,seq144,r_142_111_197,0.29,-46,151,197,14
86,seq97,seq105,r_54_98_118,r_54_98_118,1,13,131,118,14
16,r_48_135_198,r_50_66_175,r_41_146_117,r_41_146_117,0.9,81,198,117,14
21,r_73_7_115,seq72,seq6,r_73_7_115,0.85,0,115,115,14
39,r_74_30_84,r_73_7_115,r_56_29_56,r_74_30_84,0.96,1,85,84,14
1,r_92_123_99,seq94,r_51_125_39,r_51_125_39,1,59,98,39,14
46,r_54_98_118,seq53,seq97,r_54_98_118,0.99,0,118,118,14
42,r_47_86_175,r_46_90_103,r_76_65_96,r_47_86_175,0.99,-72,103,175,14
24,r_99_28_41,r_101_15_66,r_62_26_38,r_99_28_41,0.71,0,41,41,14
19,r_76_65_96,r_73_7_115,seq67,r_76_65_96,0.88,0,96,96,14
5,r_49_4_52,r_48_135_198,seq6,r_49_4_52,1,0,52,52,14
36,r_56_29_56,seq55,r_112_20_11,r_56_29_56,0.9,0,56,56,14
31,r_8_143_157,seq6,seq144,r_8_143_157,0.85,0,157,157,14
89,seq105,seq107,r_19_106_117,r_19_106_117,1,51,168,117,14
18,r_61_129_57,seq55,seq128,r_61_129_57,1,0,57,57,14
15,r_112_20_11,r_113_103_33,seq39,r_112_20_11,0.98,0,11,11,14
4,r_41_146_117,seq39,seq147,r_41_146_117,0.54,0,117,117,14
45,r_93_36_24,r_92_123_99,seq35,r_93_36_24,1,0,24,24,14
78,seq77,seq139,r_61_129_57,r_61_129_57,1,14,71,57,14
20,r_121_132_108,r_122_44_161,seq133,r_122_44_161,0.96,-51,110,161,14
13,r_19_106_117,seq18,seq105,r_19_106_117,0.96,1,118,117,14
29,r_148_0_90,r_57_43_101,r_145_1_120,r_148_0_90,0.78,31,121,90,14
98,seq126,r_127_138_106,seq119,r_127_138_106,0.66,-28,78,106,14
49,r_71_117_156,seq107,seq115,r_71_117_156,1,0,156,156,14
41,r_2_96_55,r_27_9_180,seq95,r_2_96_55,0.99,1,56,55,14
12,r_51_125_39,r_122_44_161,r_92_123_99,r_51_125_39,0.76,73,112,39,14
85,seq95,seq105,r_2_96_55,r_2_96_55,1,17,72,55,14
0,r_116_136_54,r_140_124_204,r_127_138_106,r_127_138_106,0.52,29,135,106,14
27,r_46_90_103,r_47_86_175,seq91,r_46_90_103,0.97,0,103,103,14
25,r_31_79_34,r_22_137_116,r_80_85_32,r_31_79_34,0.59,0,34,34,14
22,r_57_43_101,seq39,r_122_44_161,r_122_44_161,1,5,166,161,14
12,r_51_125_39,r_49_4_52,r_122_44_161,r_51_125_39,1,1,40,39,14
40,r_104_32_157,seq105,seq21,r_104_32_157,0.75,0,157,157,14
29,r_148_0_90,seq147,r_19_106_117,r_148_0_90,0.66,0,90,90,14
33,r_83_134_163,seq84,seq133,r_83_134_163,0.58,0,163,163,14
50,seq128,seq139,r_61_129_57,r_61_129_57,1,1,58,57,14
0,r_116_136_54,r_122_44_161,r_140_124_204,r_116_136_54,0.82,0,54,54,14
42,r_47_86_175,r_76_65_96,r_80_85_32,r_47_86_175,0.85,0,175,175,14
52,seq6,r_8_143_157,r_49_4_52,r_49_4_52,0.76,17,69,52,14
54,seq11,seq10,r_118_14_20,r_118_14_20,0.94,16,36,20,14
34,r_130_13_41,r_140_124_204,r_118_14_20,r_130_13_41,0.95,0,41,41,14
17,r_131_45_67,seq139,r_12_58_9,r_131_45_67,1,0,67,67,14
9,r_122_44_161,r_120_38_168,r_57_43_101,r_57_43_101,0.65,60,161,101,14
48,r_37_25_43,seq35,seq23,r_37_25_43,0.52,0,43,43,14
22,r_57_43_101,seq67,seq39,r_57_43_101,1,1,102,101,14
28,r_27_9_180,seq23,r_73_7_115,r_73_7_115,0.95,69,184,115,14
36,r_56_29_56,r_112_20_11,r_74_30_84,r_74_30_84,0.97,16,100,84,14
49,r_71_117_156,seq139,seq107,r_71_117_156,0.88,-51,105,156,14
56,seq16,r_17_5_156,r_101_15_66,r_101_15_66,1,0,66,66,14
7,r_22_137_116,seq21,r_127_138_106,r_22_137_116,1,0,116,116,14
44,r_78_68_70,r_82_42_166,seq67,r_78_68_70,1,0,70,70,14
23,r_142_111_197,seq144,r_113_103_33,r_113_103_33,0.67,165,198,33,14
35,r_17_5_156,seq16,r_73_7_115,r_73_7_115,0.96,41,156,115,14
51,seq2,r_3_145_169,r_88_4_70,r_88_4_70,1,100,170,70,15
20,r_54_46_34,r_57_66_122,seq44,r_54_46_34,0.76,3,37,34,15
36,r_60_137_166,seq71,r_47_134_60,r_47_134_60,0.65,106,166,60,15
10,r_12_105_40,r_16_25_116,seq106,r_12_105_40,1,0,40,40,15
43,r_148_138_109,r_147_35_133,seq139,r_147_35_133,0.99,-24,109,133,15
54,seq139,r_146_45_140,r_148_138_109,r_146_45_140,0.98,-17,123,140,15
83,seq97,r_96_129_150,r_93_87_81,r_96_129_150,0.95,0,150,150,15
37,r_5_110_123,r_6_8_26,r_1_111_33,r_6_8_26,0.87,98,124,26,15
86,seq106,seq102,r_12_105_40,r_12_105_40,1,79,119,40,15
21,r_113_68_152,seq112,seq71,r_113_68_152,0.95,0,152,152,15
39,r_41_90_156,seq39,r_67_42_67,r_67_42_67,1,2,69,67,15
5,r_95_103_78,r_96_129_150,seq102,r_95_103_78,0.98,-1,77,78,15
45,r_67_42_67,r_75_53_92,r_41_90_156,r_67_42_67,1,0,67,67,15
65,seq44,r_47_134_60,r_54_46_34,r_47_134_60,0.78,-9,51,60,15
39,r_41_90_156,r_67_42_67,r_0_91_112,r_41_90_156,0.9,1,157,156,15
31,r_56_78_145,r_55_82_93,r_30_58_29,r_56_78_145,0.7,-50,95,145,15
3,r_93_87_81,seq92,seq97,r_93_87_81,0.8,1,82,81,15
62,seq38,seq36,r_50_37_34,r_50_37_34,1,20,54,34,15
15,r_144_101_22,r_147_35_133,seq100,r_144_101_22,0.68,1,23,22,15
4,r_16_25_116,seq14,r_65_29_36,r_16_25_116,0.87,0,116,116,15
61,seq36,seq38,r_50_37_34,r_50_37_34,1,8,42,34,15
6,r_28_131_189,r_30_58_29,r_99_26_14,r_28_131_189,0.47,-172,17,189,15
11,r_88_4_70,r_89_10_142,seq2,r_88_4_70,0.77,0,70,70,15
13,r_0_91_112,r_3_145_169,seq92,r_0_91_112,1,0,112,112,15
49,r_50_37_34,seq52,seq36,r_50_37_34,1,0,34,34,15
25,r_47_134_60,seq139,seq124,r_47_134_60,0.39,41,101,60,15
48,r_121_109_176,seq117,r_5_110_123,r_5_110_123,0.79,52,175,123,15
17,r_1_111_33,r_3_145_169,seq112,r_1_111_33,0.99,0,33,33,15
49,r_50_37_34,seq36,seq38,r_50_37_34,0.56,74,108,34,15
12,r_59_115_189,r_30_58_29,r_1_111_33,r_59_115_189,0.58,0,189,189,15
85,seq102,seq106,r_95_103_78,r_95_103_78,1,41,119,78,15
34,r_22_142_12,seq143,seq139,r_22_142_12,0.4,54,66,12,15
7,r_51_11_25,seq52,r_6_8_26,r_51_11_25,1,0,25,25,15
6,r_28_131_189,r_65_29_36,r_96_129_150,r_96_129_150,0.68,39,189,150,15
8,r_65_29_36,seq64,r_99_26_14,r_65_29_36,1,0,36,36,15
25,r_47_134_60,seq124,r_60_137_166,r_60_137_166,0.96,2,168,166,15
2,r_141_17_17,seq139,r_18_20_156,r_141_17_17,0.96,0,17,17,15
9,r_147_35_133,r_146_45_140,r_140_34_11,r_147_35_133,0.98,0,133,133,15
41,r_30_58_29,r_59_115_189,r_75_53_92,r_59_115_189,0.59,-3,186,189,15
47,r_15_7_88,r_16_25_116,r_6_8_26,r_16_25_116,0.92,-28,88,116,15
28,r_140_34_11,r_141_17_17,seq33,r_140_34_11,0.99,0,11,11,15
40,r_146_45_140,seq143,seq44,r_146_45_140,0.98,0,140,140,15
18,r_89_10_142,r_88_4_70,seq92,r_88_4_70,1,0,70,70,15
35,r_136_13_73,r_47_134_60,seq14,r_136_13_73,0.86,0,73,73,15
61,seq36,r_50_37_34,seq38,r_50_37_34,0.5,95,129,34,15
25,r_47_134_60,seq44,seq139,r_47_134_60,0.99,0,60,60,15
33,r_96_129_150,seq97,seq128,r_96_129_150,0.82,0,150,150,15
19,r_104_77_56,seq102,seq71,r_104_77_56,1,0,56,56,15
65,seq44,r_54_46_34,r_146_45_140,r_146_45_140,1,0,140,140,15
42,r_99_26_14,r_104_77_56,r_28_131_189,r_99_26_14,1,0,14,14,15
32,r_98_43_123,seq106,r_67_42_67,r_98_43_123,0.97,0,123,123,15
38,r_57_66_122,r_59_115_189,seq71,r_57_66_122,0.68,1,123,122,15
45,r_67_42_67,r_41_90_156,r_98_43_123,r_67_42_67,0.83,84,151,67,15
68,seq52,r_51_11_25,seq49,r_51_11_25,0.69,0,25,25,15
9,r_147_35_133,r_148_138_109,r_146_45_140,r_148_138_109,0.43,0,109,109,15
22,r_55_82_93,r_56_78_145,seq85,r_55_82_93,0.79,2,95,93,15
34,r_22_142_12,r_19_24_35,seq143,r_22_142_12,0.98,0,12,12,15
42,r_99_26_14,r_28_131_189,r_65_29_36,r_65_29_36,1,20,56,36,15
41,r_30_58_29,r_28_131_189,r_59_115_189,r_30_58_29,0.88,0,29,29,15
56,seq143,r_146_45_140,r_148_138_109,r_146_45_140,1,0,140,140,15
18,r_89_10_142,seq92,r_6_8_26,r_89_10_142,1,0,142,142,15
44,r_149_62_80,r_147_35_133,seq63,r_149_62_80,1,0,80,80,15
23,r_135_81_60,r_136_13_73,seq85,r_135_81_60,1,0,60,60,15
6,r_28_131_189,r_99_26_14,r_65_29_36,r_65_29_36,1,8,44,36,15
27,r_32_80_39,seq33,seq71,r_32_80_39,0.98,0,39,39,15
35,r_136_13_73,r_135_81_60,r_47_134_60,r_47_134_60,0.48,0,60,60,15
12,r_59_115_189,r_57_66_122,r_30_58_29,r_30_58_29,0.85,94,123,29,15
30,r_130_108_14,seq133,seq107,r_130_108_14,0.56,0,14,14,15
31,r_56_78_145,r_30_58_29,seq79,r_56_78_145,0.49,0,145,145,15
46,r_114_132_27,r_113_68_152,seq133,r_114_132_27,0.73,0,27,27,15
30,r_99_137_62,seq108,seq135,r_99_137_62,0.8,2,64,62,16
51,seq4,r_3_111_101,seq7,r_3_111_101,1,0,101,101,16
9,r_20_119_145,r_63_17_70,seq118,r_20_119_145,0.99,0,145,145,16
14,r_45_24_119,r_44_116_120,seq23,r_45_24_119,1,0,119,119,16
43,r_142_27_90,r_143_81_169,seq25,r_142_27_90,1,1,91,90,16
54,seq8,r_20_119_145,r_127_9_60,r_127_9_60,1,5,65,60,16
55,seq138,r_140_33_154,r_1_139_57,r_1_139_57,1,98,155,57,16
21,r_19_37_103,r_12_15_197,seq40,r_19_37_103,0.88,0,103,103,16
39,r_104_39_84,r_102_2_128,seq40,r_104_39_84,0.91,0,84,84,16
1,r_28_60_110,seq25,r_98_56_14,r_28_60_110,0.98,0,110,110,16
32,r_6_121_16,r_5_21_202,seq120,r_6_121_16,1,0,16,16,16
5,r_3_111_101,seq4,r_78_107_64,r_3_111_101,0.97,0,101,101,16
46,r_127_9_60,r_132_114_33,seq8,r_127_9_60,1,0,60,60,16
42,r_149_75_158,r_87_148_2,r_82_72_79,r_82_72_79,0.51,80,159,79,16
11,r_34_53_11,seq36,seq49,r_34_53_11,0.69,0,11,11,16
45,r_78_107_64,r_80_71_122,seq109,r_78_107_64,0.97,0,64,64,16
66,seq146,r_147_128_111,r_87_148_2,r_87_148_2,0.78,87,89,2,16
3,r_80_71_122,r_112_79_101,seq62,r_80_71_122,0.92,0,122,122,16
31,r_90_122_76,r_95_54_75,seq115,r_95_54_75,0.96,1,76,75,16
41,r_125_97_34,r_132_114_33,r_78_107_64,r_78_107_64,1,3,67,64,16
3,r_80_71_122,r_78_107_64,seq83,r_78_107_64,0.97,0,64,64,16
10,r_113_10_134,r_132_114_33,r_127_9_60,r_127_9_60,0.59,74,134,60,16
50,seq0,r_1_139_57,seq4,r_1_139_57,1,-1,56,57,16
26,r_5_21_202,seq7,r_12_15_197,r_12_15_197,0.59,3,200,197,16
48,r_132_114_33,r_127_9_60,seq109,r_127_9_60,1,-8,52,60,16
4,r_136_31_71,seq135,seq32,r_136_31_71,1,0,71,71,16
78,seq76,r_77_55_95,r_134_74_56,r_134_74_56,1,41,97,56,16
0,r_87_148_2,r_149_75_158,seq146,r_87_148_2,0.58,157,159,2,16
63,seq32,seq23,r_136_31_71,r_136_31_71,1,9,80,71,16
34,r_82_72_79,seq83,r_80_71_122,r_82_72_79,0.48,-49,30,79,16
37,r_67_46_34,seq64,seq43,r_67_46_34,0.99,0,34,34,16
25,r_112_79_101,r_80_71_122,seq83,r_80_71_122,0.98,0,122,122,16
44,r_134_74_56,r_130_48_86,seq76,r_134_74_56,1,0,56,56,16
98,seq123,r_127_9_60,seq115,r_127_9_60,1,-13,47,60,16
20,r_16_110_127,r_14_129_132,r_50_105_87,r_50_105_87,0.93,41,128,87,16
15,r_77_55_95,seq76,r_98_56_14,r_77_55_95,0.71,2,97,95,16
19,r_59_91_18,seq58,seq92,r_59_91_18,0.97,0,18,18,16
6,r_147_128_111,r_87_148_2,r_26_131_63,r_26_131_63,1,45,108,63,16
8,r_1_139_57,seq0,seq138,r_1_139_57,1,0,57,57,16
79,seq135,r_136_31_71,r_99_137_62,r_136_31_71,0.97,-23,48,71,16
47,r_14_129_132,r_12_15_197,r_147_128_111,r_14_129_132,0.83,0,132,132,16
40,r_51_38_137,seq49,r_19_37_103,r_51_38_137,0.95,0,137,137,16
18,r_63_17_70,seq69,seq18,r_63_17_70,1,0,70,70,16
29,r_86_126_22,r_127_9_60,seq133,r_127_9_60,1,1,61,60,16
24,r_50_105_87,r_51_38_137,seq103,r_50_105_87,0.98,0,87,87,16
35,r_70_47_127,seq73,r_130_48_86,r_70_47_127,1,0,127,127,16
25,r_112_79_101,r_113_10_134,r_80_71_122,r_113_10_134,0.64,-33,101,134,16
33,r_44_116_120,seq43,seq115,r_44_116_120,0.99,0,120,120,16
70,seq49,r_51_38_137,r_34_53_11,r_51_38_137,0.58,-1,136,137,16
61,seq25,r_28_60_110,seq23,r_28_60_110,1,-11,99,110,16
38,r_95_54_75,seq92,r_34_53_11,r_95_54_75,0.98,1,76,75,16
60,seq23,seq25,r_45_24_119,r_45_24_119,0.99,1,120,119,16
9,r_20_119_145,r_19_37_103,r_63_17_70,r_20_119_145,0.69,-70,75,145,16
50,seq0,seq4,r_102_2_128,r_102_2_128,1,3,131,128,16
3,r_80_71_122,seq83,r_112_79_101,r_112_79_101,1,-1,100,101,16
28,r_143_81_169,r_142_27_90,seq141,r_142_27_90,1,1,91,90,16
49,r_52_30_112,r_51_38_137,seq32,r_52_30_112,0.98,0,112,112,16
7,r_26_131_63,seq23,seq133,r_26_131_63,1,0,63,63,16
16,r_22_57_56,r_20_119_145,r_98_56_14,r_22_57_56,1,0,56,56,16
23,r_102_2_128,seq103,seq0,r_102_2_128,0.89,0,128,128,16
12,r_130_48_86,seq133,r_67_46_34,r_130_48_86,1,0,86,86,16
30,r_25_9_3,r_8_24_153,r_98_5_95,r_98_5_95,1,32,127,95,17
36,r_127_36_113,seq128,seq39,r_127_36_113,0.99,0,113,113,17
54,seq6,r_2_51_62,r_25_9_3,r_2_51_62,1,-4,58,62,17
8,r_58_55_69,r_68_122_81,r_50_59_32,r_50_59_32,0.61,-13,19,32,17
41,r_34_89_129,r_35_134_30,r_38_74_159,r_35_134_30,0.74,-13,17,30,17
89,seq101,r_103_77_167,r_71_102_25,r_71_102_25,0.84,0,25,25,17
43,r_38_74_159,seq39,seq72,r_38_74_159,0.65,0,159,159,17
22,r_1_18_53,r_0_111_136,seq17,r_1_18_53,0.98,1,54,53,17
37,r_3_22_132,r_2_51_62,r_25_9_3,r_2_51_62,0.99,0,62,62,17
39,r_0_111_136,r_109_10_162,r_112_116_141,r_109_10_162,0.94,0,162,162,17
59,seq14,seq17,r_49_16_47,r_49_16_47,1,18,65,47,17
16,r_79_19_67,seq78,r_1_18_53,r_79_19_67,1,0,67,67,17
21,r_68_122_81,seq67,seq123,r_68_122_81,0.62,0,81,81,17
5,r_45_88_82,r_46_133_140,seq83,r_45_88_82,1,0,82,82,17
38,r_48_108_187,r_60_118_113,r_2_51_62,r_48_108_187,0.86,-118,69,187,17
32,r_84_107_65,r_109_10_162,r_13_113_49,r_109_10_162,0.6,-10,152,162,17
45,r_109_10_162,r_110_92_131,r_84_107_65,r_84_107_65,1,63,128,65,17
19,r_60_118_113,seq67,seq119,r_60_118_113,0.96,0,113,113,17
38,r_48_108_187,r_49_16_47,r_60_118_113,r_49_16_47,0.84,0,47,47,17
66,seq39,r_38_74_159,r_127_36_113,r_127_36_113,0.79,6,119,113,17
78,seq78,seq76,r_45_88_82,r_45_88_82,0.56,107,189,82,17
1,r_49_16_47,r_48_108_187,r_7_15_7,r_49_16_47,0.98,0,47,47,17
39,r_0_111_136,r_25_9_3,r_109_10_162,r_0_111_136,0.9,0,136,136,17
31,r_37_32_118,r_38_74_159,r_4_31_44,r_37_32_118,0.99,0,118,118,17
3,r_54_57_83,seq67,r_2_51_62,r_2_51_62,1,14,76,62,17
10,r_47_42_105,r_64_93_158,r_46_133_140,r_47_42_105,0.49,-6,99,105,17
26,r_8_24_153,r_25_9_3,r_27_26_144,r_25_9_3,0.52,150,153,3,17
72,seq67,r_68_122_81,seq66,r_68_122_81,1,-7,74,81,17
18,r_13_113_49,seq14,seq114,r_13_113_49,1,0,49,49,17
78,seq78,r_79_19_67,seq76,r_79_19_67,1,-1,66,67,17
0,r_27_26_144,seq39,r_8_24_153,r_27_26_144,0.31,26,170,144,17
11,r_112_116_141,r_109_10_162,seq117,r_109_10_162,0.87,-21,141,162,17
98,seq123,r_121_147_123,r_68_122_81,r_68_122_81,0.55,12,93,81,17
32,r_84_107_65,r_13_113_49,r_48_108_187,r_84_107_65,0.48,126,191,65,17
15,r_121_147_123,seq123,r_53_149_51,r_53_149_51,0.73,72,123,51,17
27,r_50_59_32,r_58_55_69,r_2_51_62,r_2_51_62,1,2,64,62,17
46,r_28_65_45,seq30,seq63,r_28_65_45,1,0,45,45,17
27,r_50_59_32,r_49_16_47,r_58_55_69,r_50_59_32,0.64,1,33,32,17
34,r_46_133_140,r_4_31_44,r_35_134_30,r_46_133_140,1,0,140,140,17
41,r_34_89_129,r_38_74_159,seq83,r_34_89_129,0.9,1,130,129,17
47,r_64_93_158,seq63,seq94,r_64_93_158,0.98,0,158,158,17
25,r_71_102_25,r_75_44_132,seq101,r_71_102_25,0.79,0,25,25,17
8,r_58_55_69,r_50_59_32,r_143_56_62,r_143_56_62,1,9,71,62,17
50,seq128,r_127_36_113,r_146_126_118,r_127_36_113,1,0,113,113,17
38,r_48_108_187,r_2_51_62,r_84_107_65,r_48_108_187,0.4,0,187,187,17
10,r_47_42_105,r_46_133_140,r_75_44_132,r_47_42_105,0.63,35,140,105,17
45,r_109_10_162,r_0_111_136,r_61_21_2,r_109_10_162,0.67,0,162,162,17
39,r_0_111_136,r_1_18_53,r_25_9_3,r_1_18_53,0.92,4,57,53,17
32,r_84_107_65,r_87_12_182,r_109_10_162,r_84_107_65,1,0,65,65,17
77,seq76,seq73,r_103_77_167,r_103_77_167,0.52,6,173,167,17
22,r_1_18_53,seq17,r_79_19_67,r_79_19_67,0.85,43,110,67,17
34,r_46_133_140,r_45_88_82,r_4_31_44,r_46_133_140,0.77,-58,82,140,17
23,r_43_11_43,r_45_88_82,r_7_15_7,r_45_88_82,0.66,-39,43,82,17
60,seq17,seq20,r_79_19_67,r_79_19_67,1,9,76,67,17
17,r_110_92_131,r_109_10_162,r_34_89_129,r_110_92_131,0.97,0,131,131,17
40,r_35_134_30,r_34_89_129,seq135,r_35_134_30,1,0,30,30,17
9,r_91_52_142,r_87_12_182,r_2_51_62,r_2_51_62,0.47,80,142,62,17
45,r_109_10_162,r_84_107_65,r_0_111_136,r_109_10_162,0.68,-20,142,162,17
37,r_3_22_132,r_25_9_3,seq23,r_3_22_132,0.94,0,132,132,17
4,r_4_31_44,seq6,seq33,r_4_31_44,1,1,45,44,17
7,r_80_131_102,seq81,seq139,r_80_131_102,1,0,102,102,17
44,r_82_90_147,seq81,r_110_92_131,r_110_92_131,1,16,147,131,17
20,r_53_149_51,r_48_108_187,seq148,r_53_149_51,1,0,51,51,17
35,r_98_5_95,seq95,r_25_9_3,r_98_5_95,1,0,95,95,17
12,r_2_51_62,r_3_22_132,r_48_108_187,r_2_51_62,1,0,62,62,17
30,r_3_66_186,r_2_49_164,r_5_1_43,r_3_66_186,0.79,-22,164,186,18
8,r_120_105_8,r_106_69_166,r_42_112_159,r_120_105_8,0.34,158,166,8,18
53,seq6,r_5_1_43,r_4_119_161,r_5_1_43,0.53,28,71,43,18
58,seq14,seq20,r_131_15_141,r_131_15_141,0.82,6,147,141,18
31,r_48_135_14,seq82,r_138_117_192,r_48_135_14,0.89,4,18,14,18
37,r_86_137_84,r_89_10_195,seq139,r_86_137_84,0.99,0,84,84,18
24,r_84_92_39,r_85_71_46,r_88_90_119,r_85_71_46,0.71,13,59,46,18
21,r_107_76_114,r_28_108_2,r_8_80_7,r_107_76_114,0.95,1,115,114,18
1,r_131_15_141,seq132,seq14,r_131_15_141,0.91,0,141,141,18
97,seq121,r_122_143_87,seq125,r_122_143_87,1,0,87,87,18
5,r_45_54_138,seq44,r_21_60_2,r_21_60_2,0.58,136,138,2,18
46,r_28_108_2,r_107_76_114,seq113,r_107_76_114,1,1,115,114,18
42,r_42_112_159,seq44,seq113,r_42_112_159,0.68,0,159,159,18
45,r_88_90_119,r_89_10_195,r_84_92_39,r_88_90_119,0.53,3,122,119,18
39,r_5_1_43,seq6,r_142_0_21,r_5_1_43,0.78,0,43,43,18
19,r_24_93_93,seq23,seq94,r_24_93_93,0.98,2,95,93,18
41,r_46_74_105,r_45_54_138,r_55_75_34,r_46_74_105,0.69,1,106,105,18
88,seq95,r_55_75_34,r_134_96_13,r_134_96_13,0.75,2,15,13,18
44,r_142_0_21,seq141,r_5_1_43,r_142_0_21,0.9,0,21,21,18
58,seq14,r_16_40_158,seq20,r_16_40_158,0.3,-142,16,158,18
33,r_43_116_48,seq44,r_97_114_5,r_43_116_48,0.97,0,48,48,18
11,r_53_91_134,seq58,r_84_92_39,r_84_92_39,0.52,98,137,39,18
32,r_56_136_32,r_55_75_34,r_138_117_192,r_56_136_32,0.78,0,32,32,18
20,r_103_38_104,r_107_76_114,seq39,r_103_38_104,0.64,1,105,104,18
30,r_3_66_186,r_5_1_43,r_8_80_7,r_3_66_186,0.74,1,187,186,18
48,r_148_111_60,r_149_12_192,seq110,r_148_111_60,0.99,0,60,60,18
57,seq13,r_7_129_79,seq9,r_7_129_79,1,0,79,79,18
0,r_134_96_13,seq133,seq95,r_134_96_13,0.9,0,13,13,18
6,r_106_69_166,r_120_105_8,r_55_75_34,r_106_69_166,0.46,0,166,166,18
34,r_85_71_46,r_84_92_39,seq73,r_85_71_46,0.92,13,59,46,18
0,r_134_96_13,seq95,r_53_91_134,r_53_91_134,0.92,24,158,134,18
53,seq6,r_4_119_161,r_5_1_43,r_4_119_161,0.99,0,161,161,18
87,seq94,r_89_10_195,r_24_93_93,r_24_93_93,1,29,122,93,18
7,r_19_35_16,seq20,seq36,r_19_35_16,0.78,0,16,16,18
2,r_97_114_5,r_115_67_132,r_43_116_48,r_97_114_5,0.9,127,132,5,18
47,r_64_25_147,seq63,seq22,r_64_25_147,0.97,0,147,147,18
74,seq44,r_45_54_138,r_21_60_2,r_21_60_2,0.5,148,150,2,18
18,r_7_129_79,seq13,seq128,r_7_129_79,1,0,79,79,18
29,r_37_59_158,seq36,r_21_60_2,r_37_59_158,0.37,0,158,158,18
61,seq20,seq22,r_102_18_170,r_102_18_170,0.93,1,171,170,18
25,r_31_62_99,seq32,r_118_61_87,r_31_62_99,0.91,-8,91,99,18
65,seq27,seq41,r_19_35_16,r_19_35_16,0.53,156,172,16,18
50,seq128,seq132,r_7_129_79,r_7_129_79,1,23,102,79,18
38,r_130_83_132,seq128,seq82,r_130_83_132,0.78,2,134,132,18
3,r_146_124_31,r_147_65_134,seq125,r_146_124_31,0.9,0,31,31,18
75,seq47,seq52,r_21_60_2,r_21_60_2,0.87,66,68,2,18
10,r_55_75_34,seq58,r_8_80_7,r_55_75_34,0.6,1,35,34,18
17,r_115_67_132,r_97_114_5,seq68,r_115_67_132,0.87,0,132,132,18
94,seq104,r_120_105_8,r_148_111_60,r_148_111_60,1,83,143,60,18
28,r_102_18_170,r_109_101_47,seq20,r_102_18_170,0.75,0,170,170,18
49,r_118_61_87,r_109_101_47,r_31_62_99,r_118_61_87,0.71,0,87,87,18
36,r_57_11_40,seq58,seq13,r_57_11_40,1,0,40,40,18
35,r_2_49_164,r_3_66_186,r_21_60_2,r_2_49_164,0.71,0,164,164,18
12,r_122_143_87,seq121,seq144,r_122_143_87,0.96,0,87,87,18
30,r_143_43_106,seq139,seq42,r_143_43_106,1,-1,105,106,19
51,seq4,r_3_125_68,r_58_10_20,r_3_125_68,0.68,0,68,68,19
36,r_142_110_58,r_143_43_106,r_109_73_180,r_142_110_58,1,0,58,58,19
14,r_17_75_124,r_18_106_181,seq78,r_17_75_124,0.79,0,124,124,19
8,r_121_87_129,r_122_116_180,r_23_90_24,r_121_87_129,1,0,129,129,19
43,r_123_76_89,r_124_1_162,seq78,r_123_76_89,1,0,89,89,19
20,r_15_135_71,seq133,r_140_134_98,r_140_134_98,0.59,20,118,98,19
83,seq82,r_81_64_132,r_23_90_24,r_23_90_24,0.77,108,132,24,19
37,r_109_73_180,r_107_111_204,r_142_110_58,r_142_110_58,1,4,62,58,19
59,seq16,r_15_135_71,seq26,r_15_135_71,0.97,1,72,71,19
4,r_124_1_162,seq115,r_84_2_74,r_124_1_162,0.87,0,162,162,19
13,r_96_129_12,r_101_141_154,seq130,r_96_129_12,0.72,0,12,12,19
71,seq42,seq38,r_118_41_147,r_118_41_147,0.91,18,165,147,19
86,seq89,r_91_37_167,r_121_87_129,r_121_87_129,0.52,36,165,129,19
16,r_122_116_180,r_124_1_162,seq115,r_122_116_180,0.58,-19,161,180,19
21,r_68_0_153,r_69_34_186,r_84_2_74,r_84_2_74,0.69,79,153,74,19
5,r_84_2_74,r_88_51_93,seq4,r_84_2_74,0.99,0,74,74,19
46,r_46_83_73,seq45,r_23_90_24,r_46_83_73,1,1,74,73,19
42,r_93_148_103,seq97,seq149,r_93_148_103,0.99,0,103,103,19
89,seq102,r_105_21_59,r_101_141_154,r_105_21_59,1,-2,57,59,19
34,r_137_24_137,r_143_43_106,r_29_136_7,r_143_43_106,0.58,-91,15,106,19
84,seq139,r_29_136_7,r_36_138_116,r_36_138_116,1,2,118,116,19
69,seq35,r_36_138_116,r_22_39_13,r_36_138_116,0.67,-5,111,116,19
10,r_117_47_48,r_118_41_147,seq45,r_117_47_48,1,0,48,48,19
89,seq102,r_101_141_154,seq95,r_101_141_154,0.99,-7,147,154,19
19,r_88_51_93,r_91_37_167,r_117_47_48,r_88_51_93,0.96,0,93,93,19
27,r_62_65_49,seq66,r_81_64_132,r_81_64_132,1,2,134,132,19
31,r_98_50_148,r_101_141_154,r_77_49_120,r_101_141_154,0.63,-4,150,154,19
26,r_6_30_76,seq8,seq32,r_6_30_76,0.95,0,76,76,19
78,seq67,r_69_34_186,seq66,r_69_34_186,0.87,0,186,186,19
11,r_54_80_145,seq56,seq82,r_54_80_145,0.93,0,145,145,19
20,r_15_135_71,seq16,seq133,r_15_135_71,0.94,0,71,71,19
7,r_23_90_24,r_17_75_124,seq86,r_23_90_24,0.56,2,26,24,19
15,r_107_111_204,r_109_73_180,r_79_108_139,r_79_108_139,1,33,172,139,19
23,r_22_39_13,r_23_90_24,seq38,r_22_39_13,0.99,0,13,13,19
50,seq130,r_131_132_122,r_96_129_12,r_96_129_12,1,45,57,12,19
51,seq4,r_58_10_20,r_84_2_74,r_84_2_74,0.85,5,79,74,19
70,seq38,r_44_63_163,r_22_39_13,r_22_39_13,1,3,16,13,19
0,r_53_19_30,r_18_106_181,r_58_10_20,r_18_106_181,0.73,0,181,181,19
36,r_142_110_58,r_109_73_180,r_79_108_139,r_79_108_139,1,41,180,139,19
90,seq103,r_105_21_59,seq102,r_105_21_59,1,0,59,59,19
2,r_101_141_154,r_100_99_1,r_36_138_116,r_101_141_154,0.82,0,154,154,19
47,r_85_5_148,r_91_37_167,seq4,r_85_5_148,0.79,0,148,148,19
40,r_91_37_167,seq89,seq35,r_91_37_167,0.69,0,167,167,19
18,r_74_104_161,seq78,seq103,r_74_104_161,0.5,0,161,161,19
29,r_3_125_68,seq4,seq127,r_3_125_68,1,0,68,68,19
24,r_52_31_85,seq45,r_6_30_76,r_6_30_76,0.61,10,86,76,19
45,r_18_106_181,r_17_75_124,r_53_19_30,r_53_19_30,0.61,9,39,30,19
34,r_137_24_137,r_29_136_7,r_53_19_30,r_137_24_137,0.94,1,138,137,19
25,r_20_7_179,r_18_106_181,r_105_21_59,r_105_21_59,1,17,76,59,19
33,r_59_48_130,seq60,r_117_47_48,r_117_47_48,1,82,130,48,19
3,r_105_21_59,seq103,r_20_7_179,r_105_21_59,0.96,0,59,59,19
6,r_29_136_7,r_137_24_137,r_36_138_116,r_29_136_7,0.88,131,138,7,19
68,seq32,r_36_138_116,r_52_31_85,r_36_138_116,0.56,-30,86,116,19
85,seq86,r_88_51_93,r_23_90_24,r_23_90_24,0.91,2,26,24,19
32,r_140_134_98,r_143_43_106,r_15_135_71,r_140_134_98,0.91,0,98,98,19
38,r_36_138_116,seq35,seq139,r_36_138_116,0.99,0,116,116,19
52,seq133,r_131_132_122,r_15_135_71,r_15_135_71,1,10,81,71,19
48,r_92_128_56,r_93_148_103,r_96_129_12,r_92_128_56,0.96,0,56,56,19
45,r_18_106_181,r_53_19_30,r_74_104_161,r_18_106_181,0.74,0,181,181,19
83,seq82,r_23_90_24,r_54_80_145,r_54_80_145,0.83,9,154,145,19
9,r_44_63_163,seq38,seq66,r_44_63_163,0.64,0,163,163,19
90,seq103,seq102,r_74_104_161,r_74_104_161,0.91,8,169,161,19
0,r_53_19_30,r_54_80_145,r_18_106_181,r_53_19_30,0.98,2,32,30,19
37,r_109_73_180,r_142_110_58,seq71,r_109_73_180,0.44,0,180,180,19
27,r_62_65_49,r_61_33_104,seq66,r_62_65_49,0.49,4,53,49,19
22,r_118_41_147,seq115,seq42,r_118_41_147,0.73,0,147,147,19
28,r_79_108_139,seq82,r_142_110_58,r_79_108_139,0.9,1,140,139,19
49,r_100_99_1,r_101_141_154,seq95,r_101_141_154,0.93,0,154,154,19
44,r_81_64_132,seq82,r_62_65_49,r_81_64_132,1,0,132,132,19
82,seq78,r_74_104_161,r_17_75_124,r_17_75_124,0.79,37,161,124,19
1,r_58_10_20,seq56,seq11,r_58_10_20,0.64,0,20,20,19
35,r_61_33_104,r_62_65_49,r_52_31_85,r_61_33_104,0.88,0,104,104,19
12,r_40_94_148,seq38,seq95,r_40_94_148,0.92,0,148,148,19
84,seq139,r_143_43_106,r_29_136_7,r_143_43_106,0.59,-4,102,106,19
30,r_142_88_97,r_144_101_134,seq87,r_142_88_97,1,0,97,97,20
51,seq130,seq131,r_29_126_16,r_29_126_16,0.83,77,93,16,20
14,r_12_81_108,r_9_4_190,seq85,r_12_81_108,0.99,0,108,108,20
43,r_123_43_154,seq122,r_68_45_7,r_123_43_154,0.76,0,154,154,20
37,r_39_103_177,seq40,r_144_101_134,r_39_103_177,0.79,0,177,177,20
2,r_72_133_59,r_76_14_138,seq131,r_72_133_59,1,0,59,59,20
59,seq143,r_145_92_149,seq140,r_145_92_149,0.94,0,149,149,20
55,seq129,r_127_48_97,r_29_126_16,r_127_48_97,0.93,-29,68,97,20
29,r_141_136_13,r_142_88_97,seq137,r_141_136_13,0.78,0,13,13,20
5,r_18_128_182,r_19_138_184,r_79_124_39,r_79_124_39,0.67,143,182,39,20
46,r_70_10_107,seq71,r_9_4_190,r_70_10_107,1,0,107,107,20
42,r_121_11_88,r_123_43_154,r_7_15_84,r_121_11_88,0.69,0,88,88,20
34,r_58_44_49,seq57,r_68_45_7,r_58_44_49,0.96,0,49,49,20
27,r_94_0_134,seq87,seq1,r_94_0_134,1,3,137,134,20
66,seq134,r_135_147_181,r_141_136_13,r_141_136_13,0.56,161,174,13,20
31,r_127_48_97,seq129,r_61_37_54,r_127_48_97,0.99,0,97,97,20
26,r_104_53_101,seq109,r_46_52_61,r_104_53_101,0.96,0,101,101,20
4,r_89_23_102,seq87,r_113_24_5,r_89_23_102,1,0,102,102,20
78,seq77,r_76_14_138,r_54_73_22,r_76_14_138,0.69,0,138,138,20
79,seq78,r_79_124_39,seq82,r_79_124_39,0.81,-18,21,39,20
15,r_46_52_61,seq42,seq55,r_46_52_61,0.88,0,61,61,20
8,r_93_64_51,r_94_0_134,seq62,r_93_64_51,0.99,0,51,51,20
16,r_118_2_32,r_127_48_97,seq1,r_118_2_32,0.9,0,32,32,20
13,r_49_3_7,r_7_15_84,r_63_5_120,r_63_5_120,0.91,2,122,120,20
6,r_19_138_184,r_18_128_182,r_141_136_13,r_19_138_184,0.44,-1,183,184,20
27,r_94_0_134,r_93_64_51,seq87,r_93_64_51,0.99,-3,48,51,20
16,r_118_2_32,seq1,r_49_3_7,r_49_3_7,0.45,63,70,7,20
79,seq78,seq82,r_12_81_108,r_12_81_108,1,38,146,108,20
1,r_16_60_49,seq17,seq59,r_16_60_49,1,0,49,49,20
49,r_38_107_45,r_39_103_177,seq109,r_38_107_45,0.96,0,45,45,20
67,seq40,r_39_103_177,r_74_41_34,r_74_41_34,1,1,35,34,20
74,seq59,r_66_22_187,r_16_60_49,r_16_60_49,1,29,78,49,20
24,r_76_14_138,seq77,r_7_15_84,r_76_14_138,0.96,0,138,138,20
15,r_46_52_61,seq55,r_104_53_101,r_104_53_101,1,5,106,101,20
33,r_7_15_84,seq6,r_121_11_88,r_121_11_88,1,4,92,88,20
36,r_54_73_22,seq55,seq77,r_54_73_22,0.93,0,22,22,20
88,seq98,seq97,r_83_99_107,r_83_99_107,1,17,124,107,20
21,r_29_126_16,seq20,seq122,r_29_126_16,1,0,16,16,20
61,seq146,seq143,r_135_147_181,r_135_147_181,0.71,-18,163,181,20
25,r_117_106_10,r_118_2_32,seq105,r_117_106_10,0.88,0,10,10,20
39,r_74_41_34,r_72_133_59,seq40,r_74_41_34,0.92,0,34,34,20
40,r_32_28_25,r_33_112_137,r_149_31_2,r_32_28_25,0.92,0,25,25,20
60,seq17,r_16_60_49,r_32_28_25,r_16_60_49,0.93,-12,37,49,20
17,r_83_99_107,seq82,seq98,r_83_99_107,0.97,0,107,107,20
9,r_102_27_124,seq109,r_89_23_102,r_102_27_124,1,0,124,124,20
90,seq105,r_102_27_124,r_117_106_10,r_102_27_124,0.81,-86,38,124,20
51,seq130,r_29_126_16,r_141_136_13,r_29_126_16,0.56,110,126,16,20
44,r_33_112_137,r_7_15_84,r_79_124_39,r_33_112_137,0.98,0,137,137,20
41,r_47_36_58,r_35_67_133,r_61_37_54,r_61_37_54,0.93,4,58,54,20
68,seq42,r_46_52_61,r_68_45_7,r_46_52_61,0.67,-32,29,61,20
7,r_35_67_133,seq40,seq69,r_35_67_133,0.9,0,133,133,20
44,r_33_112_137,r_32_28_25,r_7_15_84,r_7_15_84,0.73,-2,82,84,20
23,r_91_115_165,seq90,seq116,r_91_115_165,0.99,0,165,165,20
54,seq6,r_7_15_84,r_148_8_4,r_148_8_4,0.93,26,30,4,20
11,r_79_124_39,seq78,seq125,r_79_124_39,1,0,39,39,20
35,r_63_5_120,seq62,r_49_3_7,r_63_5_120,0.96,0,120,120,20
20,r_61_37_54,r_66_22_187,r_74_41_34,r_61_37_54,1,0,54,54,20
4,r_113_11_22,r_116_73_77,seq12,r_113_11_22,0.99,0,22,22,21
36,r_6_115_66,r_7_0_105,seq114,r_6_115_66,1,0,66,66,21
14,r_10_78_178,r_9_61_133,r_113_11_22,r_10_78_178,0.65,-45,133,178,21
8,r_7_0_105,r_6_115_66,r_113_11_22,r_6_115_66,0.99,2,68,66,21
73,seq59,r_110_64_96,r_66_58_141,r_110_64_96,0.98,53,149,96,21
39,r_69_42_111,r_67_82_113,r_146_46_50,r_69_42_111,0.96,0,111,111,21
1,r_60_2_101,seq59,r_7_0_105,r_60_2_101,0.97,1,102,101,21
97,seq122,r_132_53_168,r_128_123_98,r_132_53_168,0.94,-43,125,168,21
42,r_101_143_141,seq97,seq144,r_101_143_141,0.98,1,142,141,21
8,r_7_0_105,r_113_11_22,r_60_2_101,r_60_2_101,1,4,105,101,21
45,r_1_26_132,r_3_134_162,r_24_29_41,r_1_26_132,0.79,-1,131,132,21
24,r_32_81_18,r_28_127_78,seq87,r_32_81_18,0.99,0,18,18,21
19,r_147_34_78,seq144,seq33,r_147_34_78,1,0,78,78,21
30,r_71_99_27,seq72,seq97,r_71_99_27,1,0,27,27,21
35,r_112_22_22,r_116_73_77,seq23,r_112_22_22,1,0,22,22,21
51,seq5,r_3_134_162,r_130_4_51,r_130_4_51,1,4,55,51,21
31,r_146_46_50,r_147_34_78,seq39,r_146_46_50,0.99,0,50,50,21
96,seq120,seq137,r_92_121_18,r_92_121_18,1,25,43,18,21
3,r_100_135_81,r_101_143_141,r_91_136_49,r_100_135_81,0.96,0,81,81,21
28,r_76_25_159,seq84,r_51_77_44,r_51_77_44,0.42,8,52,44,21
14,r_10_78_178,r_113_11_22,r_51_77_44,r_10_78_178,0.97,0,178,178,21
63,seq23,seq20,r_112_22_22,r_112_22_22,1,11,33,22,21
26,r_132_53_168,seq129,r_9_61_133,r_9_61_133,0.56,35,168,133,21
16,r_93_75_116,seq96,r_141_74_93,r_93_75_116,1,0,116,116,21
54,seq12,r_10_78_178,r_113_11_22,r_113_11_22,1,8,30,22,21
44,r_102_55_120,seq59,r_9_61_133,r_9_61_133,0.74,20,153,133,21
0,r_116_73_77,r_111_30_128,seq72,r_116_73_77,1,0,77,77,21
20,r_9_61_133,r_10_78_178,r_102_55_120,r_9_61_133,0.72,0,133,133,21
15,r_48_85_158,seq50,r_31_79_35,r_48_85_158,0.69,0,158,158,21
48,r_67_82_113,seq68,r_56_83_36,r_67_82_113,0.87,0,113,113,21
12,r_24_29_41,r_27_44_134,r_111_30_128,r_24_29_41,0.98,93,134,41,21
6,r_28_127_78,r_24_29_41,seq129,r_28_127_78,1,0,78,78,21
5,r_109_103_24,seq108,r_131_105_129,r_131_105_129,1,34,163,129,21
32,r_130_4_51,r_132_53_168,seq5,r_130_4_51,1,0,51,51,21
27,r_54_47_117,r_62_19_132,r_146_46_50,r_54_47_117,0.88,0,117,117,21
41,r_37_138_38,r_35_36_40,seq140,r_37_138_38,1,0,38,38,21
2,r_141_74_93,seq144,r_31_79_35,r_31_79_35,0.92,59,94,35,21
47,r_111_30_128,r_118_142_183,r_24_29_41,r_111_30_128,0.96,0,128,128,21
40,r_63_18_153,seq65,r_113_11_22,r_113_11_22,0.47,134,156,22,21
74,seq65,r_66_58_141,seq68,r_66_58_141,0.56,0,141,141,21
29,r_62_19_132,seq59,r_112_22_22,r_62_19_132,0.99,0,132,132,21
25,r_57_139_124,r_62_19_132,seq140,r_57_139_124,0.95,0,124,124,21
38,r_56_83_36,r_57_139_124,r_32_81_18,r_56_83_36,1,0,36,36,21
43,r_51_77_44,r_76_25_159,seq84,r_51_77_44,0.88,90,134,44,21
33,r_27_44_134,r_24_29_41,r_69_42_111,r_27_44_134,0.82,0,134,134,21
43,r_51_77_44,seq52,r_76_25_159,r_51_77_44,0.94,0,44,44,21
16,r_93_75_116,r_91_136_49,seq96,r_91_136_49,0.93,-1,48,49,21
5,r_109_103_24,r_116_73_77,seq108,r_109_103_24,1,-1,23,24,21
50,seq129,r_132_53_168,r_28_127_78,r_28_127_78,1,81,159,78,21
21,r_89_149_11,seq80,seq144,r_89_149_11,1,0,11,11,21
34,r_3_134_162,seq5,r_91_136_49,r_3_134_162,0.55,0,162,162,21
75,seq68,r_69_42_111,seq65,r_69_42_111,0.97,-41,70,111,21
17,r_110_64_96,r_111_30_128,seq65,r_110_64_96,1,0,96,96,21
53,seq137,seq133,r_91_136_49,r_91_136_49,1,1,50,49,21
9,r_131_105_129,r_132_53_168,r_109_103_24,r_132_53_168,0.54,-39,129,168,21
13,r_91_136_49,r_93_75_116,seq137,r_91_136_49,1,0,49,49,21
31,r_146_46_50,seq39,r_54_47_117,r_54_47_117,1,6,123,117,21
28,r_76_25_159,r_51_77_44,r_1_26_132,r_76_25_159,0.89,0,159,159,21
22,r_126_94_153,r_132_53_168,seq95,r_126_94_153,0.79,2,155,153,21
11,r_31_79_35,r_28_127_78,seq80,r_31_79_35,1,1,36,35,21
49,r_104_148_78,seq107,r_89_149_11,r_104_148_78,0.98,0,78,78,21
2,r_141_74_93,r_31_79_35,r_93_75_116,r_93_75_116,0.69,5,121,116,21
44,r_102_55_120,r_101_143_141,seq59,r_102_55_120,0.82,1,121,120,21
79,seq80,seq86,r_31_79_35,r_31_79_35,1,1,36,35,21
78,seq140,seq120,r_37_138_38,r_37_138_38,1,0,38,38,21
12,r_24_29_41,r_28_127_78,r_27_44_134,r_28_127_78,1,-9,69,78,21
30,r_34_21_114,seq32,seq22,r_34_21_114,0.8,0,114,114,22
36,r_95_27_63,r_100_29_65,r_106_25_62,r_95_27_63,0.83,0,63,63,22
17,r_26_141_186,r_28_90_49,seq19,r_28_90_49,0.69,-2,47,49,22
92,seq114,seq115,r_58_113_104,r_58_113_104,1,21,125,104,22
14,r_111_107_86,r_112_50_160,r_2_105_51,r_2_105_51,0.99,36,87,51,22
53,seq4,r_5_45_146,seq7,r_5_45_146,1,0,146,146,22
43,r_43_20_138,seq44,seq22,r_43_20_138,0.85,0,138,138,22
19,r_33_147_16,r_31_39_79,r_139_133_180,r_33_147_16,0.8,0,16,16,22
37,r_80_143_167,r_79_81_190,seq142,r_80_143_167,0.49,0,167,167,22
3,r_28_90_49,seq99,r_120_91_118,r_120_91_118,0.95,22,140,118,22
71,seq48,r_47_65_141,seq52,r_47_65_141,0.96,0,141,141,22
16,r_54_109_77,r_58_113_104,r_118_69_183,r_54_109_77,0.63,-1,76,77,22
21,r_49_1_130,r_47_65_141,r_0_63_176,r_49_1_130,0.71,0,130,130,22
1,r_47_65_141,seq48,seq66,r_47_65_141,0.67,0,141,141,22
5,r_31_39_79,r_34_21_114,r_15_38_22,r_31_39_79,0.74,0,79,79,22
42,r_100_29_65,seq99,r_62_41_46,r_100_29_65,0.56,0,65,65,22
69,seq44,r_43_20_138,seq46,r_43_20_138,1,0,138,138,22
45,r_126_149_187,seq125,r_53_148_40,r_53_148_40,0.98,149,189,40,22
24,r_3_93_62,r_94_40_148,seq97,r_94_40_148,0.97,0,148,148,22
4,r_2_105_51,r_5_45_146,r_103_37_161,r_2_105_51,0.9,0,51,51,22
4,r_2_105_51,r_103_37_161,r_111_107_86,r_2_105_51,0.81,39,90,51,22
40,r_89_14_37,r_95_27_63,seq24,r_89_14_37,0.99,0,37,37,22
32,r_30_13_29,seq11,r_135_12_55,r_135_12_55,1,21,76,55,22
35,r_15_38_22,r_23_127_78,seq35,r_15_38_22,0.57,0,22,22,22
31,r_123_70_115,r_126_149_187,r_67_68_119,r_123_70_115,0.93,3,118,115,22
67,seq32,r_34_21_114,r_62_41_46,r_62_41_46,1,46,92,46,22
10,r_0_63_176,seq11,r_49_1_130,r_49_1_130,0.92,-2,128,130,22
90,seq102,r_103_37_161,r_110_101_162,r_103_37_161,0.93,1,162,161,22
16,r_54_109_77,r_118_69_183,r_58_113_104,r_54_109_77,0.57,106,183,77,22
10,r_0_63_176,r_49_1_130,r_47_65_141,r_0_63_176,0.99,0,176,176,22
20,r_5_45_146,seq4,seq44,r_5_45_146,0.88,0,146,146,22
3,r_28_90_49,r_26_141_186,seq99,r_28_90_49,0.99,0,49,49,22
13,r_71_92_173,seq74,r_120_91_118,r_71_92_173,0.45,-15,158,173,22
17,r_26_141_186,r_106_25_62,r_80_143_167,r_26_141_186,0.65,0,186,186,22
12,r_146_83_160,r_53_148_40,r_17_78_32,r_146_83_160,0.64,0,160,160,22
17,r_26_141_186,seq19,r_106_25_62,r_26_141_186,0.53,-123,63,186,22
6,r_67_68_119,seq74,r_123_70_115,r_123_70_115,1,19,134,115,22
41,r_62_41_46,seq60,r_15_38_22,r_62_41_46,0.92,0,46,46,22
87,seq137,r_138_122_83,seq144,r_138_122_83,1,0,83,83,22
26,r_98_56_16,r_76_87_195,seq55,r_98_56_16,0.76,-1,15,16,22
2,r_58_113_104,seq55,seq114,r_58_113_104,0.92,0,104,104,22
47,r_16_108_118,seq24,r_111_107_86,r_16_108_118,0.91,0,118,118,22
18,r_103_37_161,seq102,r_6_36_83,r_103_37_161,0.7,0,161,161,22
24,r_3_93_62,r_5_45_146,r_94_40_148,r_3_93_62,1,0,62,62,22
25,r_112_50_160,r_111_107_86,r_110_101_162,r_111_107_86,0.64,-10,76,86,22
33,r_6_36_83,r_5_45_146,r_62_41_46,r_6_36_83,1,0,83,83,22
64,seq22,seq24,r_34_21_114,r_34_21_114,0.67,43,157,114,22
29,r_79_81_190,r_76_87_195,r_17_78_32,r_17_78_32,1,3,35,32,22
0,r_106_25_62,seq104,r_95_27_63,r_106_25_62,0.9,-8,54,62,22
14,r_111_107_86,r_2_105_51,r_16_108_118,r_16_108_118,1,18,136,118,22
38,r_139_133_180,seq140,r_77_130_7,r_139_133_180,0.26,0,180,180,22
34,r_118_69_183,seq119,r_67_68_119,r_118_69_183,0.31,0,183,183,22
49,r_96_136_23,r_95_27_63,seq137,r_96_136_23,0.96,0,23,23,22
19,r_33_147_16,r_139_133_180,r_53_148_40,r_33_147_16,0.71,44,60,16,22
25,r_112_50_160,r_110_101_162,seq52,r_112_50_160,0.97,0,160,160,22
32,r_30_13_29,r_31_39_79,seq11,r_30_13_29,0.96,0,29,29,22
9,r_23_127_78,seq24,seq125,r_23_127_78,1,0,78,78,22
96,seq119,r_118_69_183,r_58_113_104,r_58_113_104,0.57,77,181,104,22
21,r_49_1_130,r_0_63_176,seq7,r_0_63_176,0.98,0,176,176,22
35,r_15_38_22,seq35,r_31_39_79,r_31_39_79,0.83,1,80,79,22
22,r_110_101_162,r_118_69_183,seq102,r_118_69_183,0.42,-21,162,183,22
28,r_120_91_118,r_118_69_183,r_28_90_49,r_120_91_118,0.52,0,118,118,22
8,r_135_12_55,r_139_133_180,r_30_13_29,r_135_12_55,1,1,56,55,22
48,r_17_78_32,r_16_108_118,r_79_81_190,r_17_78_32,0.98,0,32,32,22
7,r_138_122_83,seq137,seq121,r_138_122_83,0.94,0,83,83,22
44,r_72_10_99,seq74,seq11,r_72_10_99,0.99,0,99,99,22
23,r_42_88_60,seq35,seq84,r_42_88_60,0.99,0,60,60,22
27,r_53_148_40,seq51,r_33_147_16,r_53_148_40,0.97,1,41,40,22
12,r_146_83_160,seq134,r_53_148_40,r_53_148_40,0.82,34,74,40,22
30,r_128_98_187,r_131_119_132,r_147_129_17,r_128_98_187,0.62,-101,86,187,23
47,r_89_35_19,r_83_134_132,r_37_3_132,r_89_35_19,0.95,0,19,19,23
43,r_135_11_67,seq137,seq9,r_135_11_67,1,0,67,67,23
83,seq88,r_87_41_118,seq90,r_87_41_118,1,0,118,118,23
19,r_21_111_27,r_114_108_145,seq115,r_21_111_27,0.47,118,145,27,23
16,r_131_119_132,seq133,r_101_120_37,r_101_120_37,0.84,101,138,37,23
1,r_0_99_72,seq1,seq102,r_0_99_72,1,0,72,72,23
5,r_141_30_163,seq140,r_122_25_64,r_122_25_64,1,103,167,64,23
63,seq29,r_24_62_56,r_7_27_44,r_24_62_56,1,0,56,56,23
10,r_74_149_18,r_76_85_49,seq143,r_74_149_18,0.85,0,18,18,23
45,r_2_68_179,seq4,r_58_71_36,r_2_68_179,0.56,0,179,179,23
39,r_113_139_31,r_114_108_145,seq140,r_114_108_145,0.74,-113,32,145,23
27,r_58_71_36,r_73_44_167,r_42_70_114,r_42_70_114,0.98,53,167,114,23
66,seq34,seq22,r_53_33_49,r_53_33_49,1,41,90,49,23
31,r_112_26_182,r_114_108_145,r_21_111_27,r_21_111_27,0.99,118,145,27,23
41,r_100_126_113,seq102,r_93_130_24,r_100_126_113,0.63,1,114,113,23
67,seq40,r_43_59_156,r_87_41_118,r_87_41_118,0.74,32,150,118,23
3,r_110_64_145,seq104,seq66,r_110_64_145,0.51,0,145,145,23
11,r_72_92_192,r_73_44_167,r_58_71_36,r_58_71_36,0.99,101,137,36,23
20,r_76_85_49,r_78_81_37,seq90,r_78_81_37,0.49,109,146,37,23
19,r_21_111_27,r_24_62_56,r_114_108_145,r_21_111_27,0.96,0,27,27,23
42,r_53_33_49,seq52,seq34,r_53_33_49,1,0,49,49,23
15,r_114_108_145,r_112_26_182,seq104,r_114_108_145,0.47,0,145,145,23
48,r_28_125_56,seq22,r_101_120_37,r_28_125_56,0.99,0,56,56,23
44,r_37_3_132,r_89_35_19,seq4,r_37_3_132,0.98,0,132,132,23
6,r_43_59_156,r_42_70_114,seq40,r_42_70_114,0.95,0,114,114,23
85,seq143,r_145_20_174,r_74_149_18,r_74_149_18,0.89,156,174,18,23
86,seq96,seq97,r_56_95_20,r_56_95_20,1,0,20,20,23
10,r_74_149_18,seq143,r_117_146_113,r_117_146_113,0.97,8,121,113,23
0,r_147_129_17,r_145_20_174,r_128_98_187,r_147_129_17,0.87,1,18,17,23
2,r_122_25_64,seq123,seq22,r_122_25_64,1,0,64,64,23
40,r_117_146_113,r_118_116_84,r_74_149_18,r_117_146_113,0.59,0,113,113,23
28,r_144_109_39,r_145_20_174,seq104,r_144_109_39,0.93,2,41,39,23
74,seq63,seq66,r_91_51_121,r_91_51_121,0.81,22,143,121,23
18,r_46_86_143,seq47,seq90,r_46_86_143,0.76,0,143,143,23
29,r_69_50_85,r_73_44_167,seq52,r_69_50_85,0.98,0,85,85,23
25,r_91_51_121,seq88,r_69_50_85,r_69_50_85,0.32,37,122,85,23
31,r_112_26_182,r_21_111_27,r_122_25_64,r_112_26_182,0.66,1,183,182,23
47,r_89_35_19,r_37_3_132,r_7_27_44,r_37_3_132,1,0,132,132,23
88,seq102,r_100_126_113,r_0_99_72,r_0_99_72,1,42,114,72,23
6,r_43_59_156,seq40,r_69_50_85,r_43_59_156,0.97,0,156,156,23
21,r_93_130_24,r_83_134_132,seq133,r_93_130_24,0.73,0,24,24,23
32,r_42_70_114,r_43_59_156,r_58_71_36,r_42_70_114,0.97,0,114,114,23
38,r_148_57_71,r_145_20_174,seq54,r_148_57_71,0.95,0,71,71,23
52,seq133,r_131_119_132,r_83_134_132,r_83_134_132,1,6,138,132,23
34,r_36_10_87,r_37_3_132,seq9,r_37_3_132,0.59,-45,87,132,23
75,seq66,r_65_39_179,r_110_64_145,r_110_64_145,0.64,31,176,145,23
9,r_73_44_167,r_72_92_192,r_38_45_12,r_38_45_12,0.62,156,168,12,23
49,r_5_67_167,seq4,r_110_64_145,r_5_67_167,0.63,0,167,167,23
13,r_24_62_56,seq22,r_55_61_26,r_24_62_56,1,0,56,56,23
82,seq142,r_135_11_67,seq143,r_135_11_67,0.79,-18,49,67,23
7,r_83_134_132,seq82,seq133,r_83_134_132,0.88,0,132,132,23
44,r_37_3_132,r_36_10_87,r_89_35_19,r_37_3_132,0.62,-45,87,132,23
23,r_87_41_118,seq88,seq40,r_87_41_118,1,0,118,118,23
27,r_58_71_36,r_55_61_26,r_73_44_167,r_58_71_36,0.98,1,37,36,23
22,r_56_95_20,r_55_61_26,seq96,r_56_95_20,1,0,20,20,23
12,r_118_116_84,r_117_146_113,seq115,r_118_116_84,0.55,29,113,84,23
30,r_139_78_148,r_142_140_200,r_16_80_39,r_139_78_148,0.92,0,148,148,24
36,r_105_17_59,seq106,seq20,r_105_17_59,1,1,60,59,24
14,r_142_140_200,r_139_78_148,r_86_144_43,r_86_144_43,0.71,105,148,43,24
8,r_135_125_106,seq136,r_40_128_47,r_135_125_106,0.92,0,106,106,24
43,r_70_74_157,r_69_7_174,seq72,r_69_7_174,0.56,-17,157,174,24
37,r_29_1_163,seq26,seq3,r_29_1_163,0.71,0,163,163,24
3,r_40_128_47,r_126_47_148,r_135_125_106,r_135_125_106,0.51,42,148,106,24
59,seq20,r_18_11_152,r_127_21_68,r_127_21_68,1,5,73,68,24
19,r_2_122_24,r_126_47_148,r_133_123_142,r_2_122_24,0.78,122,146,24,24
86,seq82,r_84_93_153,r_131_85_19,r_131_85_19,0.66,134,153,19,24
16,r_53_45_148,seq54,r_126_47_148,r_126_47_148,0.95,0,148,148,24
21,r_83_44_115,r_84_93_153,seq43,r_83_44_115,0.97,0,115,115,24
39,r_127_21_68,r_126_47_148,seq20,r_127_21_68,0.97,0,68,68,24
5,r_100_49_1,seq43,r_145_48_64,r_145_48_64,1,29,93,64,24
46,r_5_92_77,seq6,seq89,r_5_92_77,1,0,77,77,24
42,r_84_93_153,seq82,r_32_102_2,r_32_102_2,0.6,151,153,2,24
7,r_34_149_55,r_29_1_163,r_148_66_180,r_34_149_55,1,0,55,55,24
7,r_34_149_55,r_148_66_180,r_8_147_109,r_8_147_109,1,58,167,109,24
45,r_65_129_90,r_53_45_148,seq130,r_65_129_90,1,0,90,90,24
38,r_57_137_21,r_148_66_180,r_34_149_55,r_34_149_55,0.89,74,129,55,24
31,r_145_48_64,r_148_66_180,r_100_49_1,r_145_48_64,1,0,64,64,24
15,r_86_144_43,r_148_66_180,r_34_149_55,r_34_149_55,0.81,34,89,55,24
41,r_133_123_142,seq136,r_2_122_24,r_2_122_24,0.71,120,144,24,24
67,seq43,seq51,r_83_44_115,r_83_44_115,0.96,7,122,115,24
12,r_19_108_175,r_105_17_59,r_52_111_121,r_19_108_175,0.92,1,176,175,24
44,r_131_85_19,r_126_47_148,seq82,r_131_85_19,1,0,19,19,24
27,r_62_112_51,seq63,seq110,r_62_112_51,1,1,52,51,24
4,r_18_11_152,r_19_108_175,seq9,r_18_11_152,0.93,1,153,152,24
0,r_115_37_129,seq114,seq36,r_115_37_129,0.95,0,129,129,24
11,r_8_147_109,seq9,r_34_149_55,r_8_147_109,0.94,0,109,109,24
2,r_126_47_148,r_127_21_68,r_40_128_47,r_126_47_148,1,-92,56,148,24
20,r_132_46_135,seq130,r_100_49_1,r_132_46_135,0.81,0,135,135,24
48,r_42_30_66,seq43,r_107_33_54,r_107_33_54,0.68,12,66,54,24
17,r_120_87_197,seq117,r_2_122_24,r_2_122_24,0.99,9,33,24,24
49,r_107_33_54,seq26,r_141_31_61,r_107_33_54,0.5,114,168,54,24
6,r_91_60_128,seq89,seq59,r_91_60_128,0.96,0,128,128,24
2,r_126_47_148,r_40_128_47,r_132_46_135,r_40_128_47,0.94,101,148,47,24
13,r_16_80_39,r_18_11_152,seq79,r_16_80_39,0.97,0,39,39,24
15,r_86_144_43,r_99_88_52,r_148_66_180,r_86_144_43,0.98,0,43,43,24
10,r_39_124_177,r_41_38_182,r_40_128_47,r_39_124_177,0.79,0,177,177,24
87,seq89,r_90_143_191,r_5_92_77,r_5_92_77,1,1,78,77,24
25,r_81_121_148,seq79,r_120_87_197,r_120_87_197,0.71,-49,148,197,24
65,seq36,r_39_124_177,r_109_35_139,r_109_35_139,0.75,5,144,139,24
18,r_41_38_182,r_40_128_47,seq36,r_40_128_47,1,0,47,47,24
50,seq130,r_126_47_148,r_65_129_90,r_65_129_90,0.94,4,94,90,24
58,seq146,r_148_66_180,r_34_149_55,r_34_149_55,1,112,167,55,24
70,seq54,r_53_45_148,seq55,r_53_45_148,1,0,148,148,24
19,r_2_122_24,r_0_28_182,r_126_47_148,r_2_122_24,0.99,1,25,24,24
3,r_40_128_47,r_41_38_182,r_126_47_148,r_40_128_47,1,0,47,47,24
32,r_141_31_61,r_142_140_200,r_107_33_54,r_141_31_61,1,0,61,61,24
34,r_32_102_2,r_101_104_189,r_12_103_88,r_12_103_88,1,27,115,88,24
67,seq43,r_42_30_66,seq51,r_42_30_66,0.95,-13,53,66,24
29,r_52_111_121,r_81_121_148,r_62_112_51,r_52_111_121,0.96,0,121,121,24
22,r_90_143_191,seq89,r_142_140_200,r_90_143_191,0.43,0,191,191,24
28,r_109_35_139,seq110,seq36,r_109_35_139,0.96,0,139,139,24
99,seq119,seq117,r_138_118_40,r_138_118_40,1,3,43,40,24
23,r_148_66_180,seq146,r_34_149_55,r_34_149_55,1,58,113,55,24
17,r_120_87_197,r_2_122_24,r_81_121_148,r_81_121_148,1,3,151,148,24
29,r_52_111_121,seq55,r_81_121_148,r_81_121_148,0.6,-111,37,148,24
35,r_12_103_88,r_14_15_65,r_32_102_2,r_12_103_88,1,0,88,88,24
12,r_19_108_175,r_18_11_152,r_105_17_59,r_105_17_59,1,94,153,59,24
23,r_148_66_180,r_34_149_55,r_91_60_128,r_148_66_180,0.87,0,180,180,24
1,r_138_118_40,r_139_78_148,seq119,r_138_118_40,0.94,0,40,40,24
38,r_57_137_21,seq58,r_148_66_180,r_57_137_21,1,6,27,21,24
30,r_146_6_93,r_148_52_145,r_3_7_27,r_146_6_93,0.88,0,93,93,25
16,r_132_86_23,seq129,r_64_88_19,r_64_88_19,0.4,8,27,19,25
75,seq71,r_140_102_116,seq134,r_140_102_116,0.64,40,156,116,25
33,r_54_83_157,r_55_116_32,r_47_20_88,r_54_83_157,0.56,-141,16,157,25
54,seq139,r_140_102_116,r_138_141_127,r_140_102_116,0.63,3,119,116,25
71,seq61,seq62,r_135_63_42,r_135_63_42,1,35,77,42,25
21,r_48_69_93,r_46_72_182,seq66,r_48_69_93,1,0,93,93,25
39,r_2_113_119,seq9,r_78_119_39,r_2_113_119,0.99,0,119,119,25
1,r_5_100_92,r_3_7_27,seq96,r_5_100_92,1,0,92,92,25
38,r_89_11_47,r_84_8_85,r_10_143_122,r_89_11_47,0.57,1,48,47,25
5,r_136_108_80,r_138_141_127,r_111_137_167,r_136_108_80,0.91,10,90,80,25
42,r_47_20_88,r_48_69_93,seq22,r_47_20_88,0.6,6,94,88,25
19,r_68_128_147,seq65,r_56_127_29,r_56_127_29,0.66,118,147,29,25
33,r_54_83_157,r_47_20_88,r_57_51_88,r_54_83_157,0.45,-64,93,157,25
11,r_13_0_96,r_146_6_93,r_42_17_106,r_13_0_96,0.46,64,160,96,25
27,r_93_59_40,r_60_30_124,r_135_63_42,r_60_30_124,1,0,124,124,25
66,seq43,r_42_17_106,seq44,r_42_17_106,1,0,106,106,25
38,r_89_11_47,r_10_143_122,r_15_12_147,r_10_143_122,1,-1,121,122,25
41,r_94_38_128,seq91,seq39,r_94_38_128,1,1,129,128,25
36,r_67_53_53,seq66,seq50,r_67_53_53,1,0,53,53,25
33,r_54_83_157,r_57_51_88,r_132_86_23,r_54_83_157,0.96,0,157,157,25
10,r_84_8_85,r_85_77_145,r_3_7_27,r_84_8_85,1,0,85,85,25
26,r_111_137_167,r_104_147_192,r_136_108_80,r_136_108_80,1,16,96,80,25
72,seq62,seq61,r_135_63_42,r_135_63_42,1,35,77,42,25
4,r_42_17_106,seq43,seq19,r_42_17_106,1,0,106,106,25
44,r_57_51_88,r_47_20_88,r_94_38_128,r_57_51_88,0.4,64,152,88,25
11,r_13_0_96,r_10_143_122,r_146_6_93,r_13_0_96,0.87,0,96,96,25
13,r_85_77_145,r_84_8_85,r_64_88_19,r_84_8_85,1,0,85,85,25
98,seq126,r_125_117_133,r_56_127_29,r_56_127_29,0.91,38,67,29,25
48,r_25_14_123,seq27,seq16,r_25_14_123,0.99,0,123,123,25
40,r_135_63_42,r_133_1_176,seq62,r_135_63_42,1,2,44,42,25
13,r_85_77_145,r_64_88_19,seq75,r_85_77_145,0.83,0,145,145,25
6,r_35_131_94,seq39,seq129,r_35_131_94,1,0,94,94,25
5,r_136_108_80,r_111_137_167,r_26_107_137,r_136_108_80,0.61,87,167,80,25
36,r_67_53_53,seq50,r_148_52_145,r_67_53_53,0.65,94,147,53,25
8,r_55_116_32,r_56_127_29,seq118,r_55_116_32,0.6,0,32,32,25
31,r_60_30_124,seq61,r_93_59_40,r_93_59_40,1,-3,37,40,25
2,r_130_97_149,seq139,r_35_131_94,r_35_131_94,1,8,102,94,25
47,r_80_109_103,seq79,r_136_108_80,r_80_109_103,0.89,1,104,103,25
14,r_110_115_27,r_111_137_167,seq118,r_110_115_27,0.9,0,27,27,25
29,r_104_147_192,r_111_137_167,seq103,r_111_137_167,0.91,-71,96,167,25
24,r_120_41_88,seq118,seq40,r_120_41_88,0.98,0,88,88,25
18,r_64_88_19,seq61,r_89_11_47,r_64_88_19,0.85,0,19,19,25
25,r_140_102_116,seq139,r_5_100_92,r_5_100_92,0.99,27,119,92,25
43,r_10_143_122,r_89_11_47,seq145,r_10_143_122,1,0,122,122,25
70,seq58,r_57_51_88,seq65,r_57_51_88,0.65,31,119,88,25
65,seq40,seq39,r_120_41_88,r_120_41_88,1,8,96,88,25
44,r_57_51_88,r_26_107_137,r_47_20_88,r_26_107_137,0.82,-2,135,137,25
61,seq27,r_26_107_137,seq21,r_26_107_137,0.82,0,137,137,25
32,r_125_117_133,seq126,r_78_119_39,r_125_117_133,0.59,5,138,133,25
52,seq134,r_133_1_176,r_10_143_122,r_10_143_122,1,54,176,122,25
0,r_78_119_39,seq75,r_110_115_27,r_78_119_39,0.99,8,47,39,25
17,r_18_24_141,seq19,seq27,r_18_24_141,0.99,0,141,141,25
43,r_10_143_122,r_13_0_96,r_89_11_47,r_89_11_47,1,2,49,47,25
94,seq118,r_120_41_88,r_78_119_39,r_120_41_88,0.78,0,88,88,25
9,r_133_1_176,seq134,r_84_8_85,r_84_8_85,0.64,93,178,85,25
26,r_111_137_167,r_136_108_80,seq134,r_111_137_167,0.66,0,167,167,25
31,r_60_30_124,r_93_59_40,r_70_34_8,r_60_30_124,0.94,0,124,124,25
2,r_130_97_149,r_35_131_94,r_5_100_92,r_130_97_149,0.85,-2,147,149,25
18,r_64_88_19,r_89_11_47,r_132_86_23,r_89_11_47,0.99,1,48,47,25
22,r_114_23_95,seq118,seq22,r_114_23_95,1,0,95,95,25
28,r_138_141_127,r_136_108_80,seq139,r_136_108_80,0.82,10,90,80,25
75,seq71,seq73,r_140_102_116,r_140_102_116,0.79,-37,79,116,25
56,seq16,r_15_12_147,r_25_14_123,r_25_14_123,1,25,148,123,25
7,r_15_12_147,seq16,r_89_11_47,r_89_11_47,1,99,146,47,25
44,r_57_51_88,seq58,r_26_107_137,r_57_51_88,0.84,0,88,88,25
27,r_93_59_40,r_94_38_128,r_60_30_124,r_93_59_40,0.98,1,41,40,25
33,r_54_83_157,r_47_20_88,r_57_51_88,r_54_83_157,0.52,-20,137,157,25
35,r_26_107_137,seq27,r_136_108_80,r_26_107_137,0.86,0,137,137,25
33,r_54_83_157,r_57_51_88,r_47_20_88,r_47_20_88,0.57,23,111,88,25
50,seq129,r_140_102_116,r_56_127_29,r_56_127_29,1,9,38,29,25
30,r_82_118_104,seq83,seq128,r_82_118_104,0.96,0,104,104,26
36,r_19_125_67,seq20,seq128,r_19_125_67,1,0,67,67,26
14,r_79_136_134,r_80_84_189,r_4_138_8,r_79_136_134,0.74,0,134,134,26
9,r_85_70_56,r_65_1_153,r_123_68_66,r_123_68_66,0.8,1,67,66,26
29,r_65_1_153,r_143_67_82,seq6,r_65_1_153,1,0,153,153,26
8,r_25_10_137,seq28,r_8_18_155,r_8_18_155,0.8,-17,138,155,26
37,r_126_140_92,r_127_69_121,r_4_138_8,r_126_140_92,0.92,27,119,92,26
48,r_98_22_20,r_97_96_8,r_23_21_74,r_98_22_20,0.99,0,20,20,26
16,r_23_21_74,r_39_90_107,r_98_22_20,r_23_21_74,0.89,-53,21,74,26
2,r_135_14_59,r_143_67_82,r_124_13_10,r_135_14_59,0.98,0,59,59,26
46,r_12_66_67,r_124_13_10,r_85_70_56,r_12_66_67,0.98,1,68,67,26
9,r_85_70_56,r_82_118_104,r_65_1_153,r_85_70_56,0.81,0,56,56,26
7,r_78_120_6,r_127_69_121,r_81_121_70,r_78_120_6,0.92,80,86,6,26
45,r_143_67_82,seq144,r_12_66_67,r_143_67_82,1,0,82,82,26
47,r_101_71_34,seq100,r_65_1_153,r_101_71_34,0.99,0,34,34,26
19,r_80_84_189,r_79_136_134,r_97_96_8,r_80_84_189,0.62,-55,134,189,26
49,r_124_13_10,r_12_66_67,r_135_14_59,r_124_13_10,0.98,57,67,10,26
11,r_62_86_146,r_30_63_42,seq83,r_62_86_146,0.92,0,146,146,26
8,r_25_10_137,r_8_18_155,r_97_96_8,r_25_10_137,0.79,19,156,137,26
26,r_99_48_47,r_97_96_8,seq47,r_99_48_47,1,1,48,47,26
41,r_87_61_98,seq88,r_30_63_42,r_87_61_98,1,0,98,98,26
3,r_91_55_74,seq92,seq56,r_91_55_74,1,0,74,74,26
10,r_81_121_70,r_80_84_189,r_78_120_6,r_81_121_70,1,0,70,70,26
20,r_37_27_71,r_49_129_181,seq28,r_37_27_71,0.79,2,73,71,26
13,r_116_132_120,seq117,r_4_138_8,r_116_132_120,0.78,0,120,120,26
15,r_54_111_130,seq56,seq112,r_54_111_130,0.87,0,130,130,26
0,r_139_73_146,r_4_138_8,seq74,r_139_73_146,0.82,0,146,146,26
39,r_7_141_39,r_5_53_140,seq142,r_7_141_39,1,0,39,39,26
42,r_30_63_42,r_32_46_90,r_62_86_146,r_30_63_42,0.96,0,42,42,26
40,r_127_69_121,seq128,r_85_70_56,r_127_69_121,0.89,0,121,121,26
27,r_72_134_38,r_65_1_153,seq137,r_72_134_38,1,0,38,38,26
18,r_75_102_146,seq76,seq100,r_75_102_146,0.81,0,146,146,26
29,r_65_1_153,seq64,r_143_67_82,r_143_67_82,1,14,96,82,26
24,r_49_129_181,seq47,r_4_138_8,r_49_129_181,0.38,0,181,181,26
11,r_62_86_146,r_65_1_153,r_30_63_42,r_30_63_42,0.97,0,42,42,26
25,r_0_108_165,seq2,seq112,r_0_108_165,0.53,0,165,165,26
49,r_124_13_10,r_123_68_66,r_12_66_67,r_124_13_10,0.73,0,10,10,26
33,r_45_34_59,r_49_129_181,seq31,r_45_34_59,0.91,6,65,59,26
38,r_8_18_155,r_25_10_137,r_9_16_118,r_25_10_137,0.66,18,155,137,26
50,seq128,r_127_69_121,r_78_120_6,r_127_69_121,0.9,-35,86,121,26
6,r_4_138_8,r_139_73_146,r_126_140_92,r_4_138_8,0.92,115,123,8,26
38,r_8_18_155,seq104,r_25_10_137,r_8_18_155,0.83,-17,138,155,26
68,seq38,r_39_90_107,seq41,r_39_90_107,1,0,107,107,26
42,r_30_63_42,r_62_86_146,r_87_61_98,r_87_61_98,0.65,49,147,98,26
61,seq20,r_19_125_67,r_25_10_137,r_19_125_67,0.84,0,67,67,26
38,r_8_18_155,r_9_16_118,seq104,r_8_18_155,0.52,-37,118,155,26
77,seq64,r_65_1_153,r_85_70_56,r_85_70_56,1,40,96,56,26
19,r_80_84_189,r_97_96_8,r_62_86_146,r_80_84_189,0.48,0,189,189,26
34,r_44_57_140,r_49_129_181,r_91_55_74,r_44_57_140,0.58,-1,139,140,26
60,seq131,r_143_67_82,r_145_130_75,r_143_67_82,0.84,-6,76,82,26
81,seq83,r_82_118_104,seq88,r_82_118_104,1,0,104,104,26
17,r_123_68_66,seq122,r_85_70_56,r_123_68_66,0.99,0,66,66,26
22,r_39_90_107,seq38,seq94,r_39_90_107,0.96,0,107,107,26
28,r_5_53_140,seq6,r_91_55_74,r_5_53_140,0.94,0,140,140,26
8,r_25_10_137,r_97_96_8,seq15,r_25_10_137,0.74,46,183,137,26
44,r_32_46_90,seq36,r_99_48_47,r_99_48_47,1,43,90,47,26
23,r_89_113_70,r_91_55_74,seq114,r_89_113_70,0.97,0,70,70,26
61,seq20,r_25_10_137,r_37_27_71,r_25_10_137,0.54,-14,123,137,26
79,seq76,r_75_102_146,seq74,r_75_102_146,0.97,0,146,146,26
47,r_101_71_34,r_65_1_153,r_85_70_56,r_101_71_34,0.72,33,67,34,26
12,r_26_133_188,seq28,r_4_138_8,r_4_138_8,0.89,180,188,8,26
30,r_136_23_89,seq135,seq25,r_136_23_89,1,0,89,89,27
44,r_130_33_89,r_32_28_175,r_71_24_113,r_71_24_113,0.99,60,173,113,27
36,r_11_123_92,seq12,r_31_126_69,r_11_123_92,1,0,92,92,27
14,r_115_93_61,r_122_96_102,r_2_118_29,r_2_118_29,0.93,30,59,29,27
11,r_2_118_29,seq7,seq117,r_2_118_29,1,0,29,29,27
0,r_113_84_94,seq131,r_74_85_24,r_113_84_94,0.93,0,94,94,27
54,seq14,seq15,r_34_13_42,r_34_13_42,1,37,79,42,27
37,r_17_0_93,r_20_137_142,r_34_13_42,r_17_0_93,0.55,0,93,93,27
3,r_48_10_14,r_9_4_200,r_88_5_126,r_88_5_126,1,61,187,126,27
59,seq148,seq146,r_139_149_45,r_139_149_45,0.66,84,129,45,27
87,seq83,r_82_63_174,r_74_85_24,r_74_85_24,1,14,38,24,27
12,r_32_28_175,r_34_13_42,seq25,r_34_13_42,1,0,42,42,27
1,r_44_91_86,r_45_108_60,seq36,r_45_108_60,0.85,0,60,60,27
97,seq120,r_121_133_69,r_2_118_29,r_2_118_29,1,39,68,29,27
5,r_71_24_113,seq72,seq25,r_71_24_113,1,0,113,113,27
46,r_29_114_96,seq27,r_68_112_63,r_29_114_96,1,0,96,96,27
84,seq76,r_82_63_174,r_62_147_21,r_82_63_174,0.44,-69,105,174,27
3,r_48_10_14,r_47_79_135,r_9_4_200,r_48_10_14,0.96,0,14,14,27
19,r_128_111_61,r_130_33_89,r_45_108_60,r_128_111_61,1,0,61,61,27
27,r_88_5_126,r_116_90_33,seq7,r_88_5_126,1,0,126,126,27
95,seq109,seq106,r_45_108_60,r_45_108_60,1,31,91,60,27
31,r_95_142_110,seq106,r_102_97_52,r_102_97_52,0.36,34,86,52,27
41,r_61_46_107,seq64,seq42,r_61_46_107,0.65,1,108,107,27
14,r_115_93_61,r_2_118_29,r_44_91_86,r_44_91_86,1,1,87,86,27
1,r_44_91_86,seq36,r_115_93_61,r_44_91_86,0.99,0,86,86,27
10,r_16_77_182,seq14,seq76,r_16_77_182,0.36,0,182,182,27
26,r_141_38_92,seq131,seq36,r_141_38_92,1,0,92,92,27
4,r_121_133_69,seq120,seq135,r_121_133_69,0.67,0,69,69,27
21,r_124_81_58,r_122_96_102,seq83,r_124_81_58,0.98,0,58,58,27
20,r_49_94_81,seq50,r_102_97_52,r_49_94_81,1,0,81,81,27
13,r_102_97_52,r_103_39_198,r_122_96_102,r_103_39_198,0.65,-97,101,198,27
98,seq125,r_122_96_102,r_31_126_69,r_31_126_69,1,11,80,69,27
15,r_101_70_158,seq99,r_43_69_6,r_101_70_158,0.62,0,158,158,27
57,seq146,seq145,r_62_147_21,r_62_147_21,1,4,25,21,27
7,r_132_8_48,r_138_26_87,seq14,r_132_8_48,1,0,48,48,27
12,r_32_28_175,seq25,r_130_33_89,r_130_33_89,1,29,118,89,27
37,r_17_0_93,r_34_13_42,r_54_1_140,r_54_1_140,0.99,8,148,140,27
66,seq42,r_45_108_60,r_47_79_135,r_45_108_60,0.97,-4,56,60,27
96,seq117,r_121_133_69,r_2_118_29,r_2_118_29,1,9,38,29,27
80,seq67,r_68_112_63,r_110_73_4,r_68_112_63,0.98,-4,59,63,27
31,r_95_142_110,r_102_97_52,r_92_143_84,r_92_143_84,0.62,26,110,84,27
38,r_19_18_172,r_88_5_126,r_48_10_14,r_88_5_126,0.24,50,176,126,27
42,r_34_13_42,r_32_28_175,seq14,r_34_13_42,0.83,0,42,42,27
2,r_20_137_142,r_19_18_172,r_121_133_69,r_20_137_142,0.94,1,143,142,27
28,r_92_143_84,r_102_97_52,seq131,r_92_143_84,0.49,-44,40,84,27
84,seq76,r_62_147_21,r_2_118_29,r_2_118_29,0.42,106,135,29,27
29,r_31_126_69,r_32_28_175,seq125,r_31_126_69,1,0,69,69,27
25,r_87_129_149,seq86,r_20_137_142,r_20_137_142,0.58,3,145,142,27
33,r_139_149_45,r_138_26_87,seq148,r_138_26_87,0.95,-18,69,87,27
88,seq86,r_87_129_149,seq78,r_87_129_149,0.68,-23,126,149,27
70,seq52,r_53_35_105,seq51,r_53_35_105,1,0,105,105,27
22,r_68_112_63,seq106,r_29_114_96,r_29_114_96,0.99,22,118,96,27
27,r_88_5_126,seq89,r_116_90_33,r_116_90_33,0.98,16,49,33,27
68,seq50,r_49_94_81,seq55,r_49_94_81,1,0,81,81,27
23,r_116_90_33,r_121_133_69,r_88_5_126,r_116_90_33,0.92,0,33,33,27
38,r_19_18_172,r_20_137_142,r_88_5_126,r_19_18_172,0.61,-28,144,172,27
49,r_74_85_24,seq72,seq83,r_74_85_24,0.99,0,24,24,27
16,r_53_35_105,seq64,r_141_38_92,r_53_35_105,0.67,16,121,105,27
34,r_144_119_121,seq146,r_2_118_29,r_2_118_29,0.9,88,117,29,27
43,r_62_147_21,r_61_46_107,seq146,r_62_147_21,1,0,21,21,27
47,r_9_4_200,seq14,r_48_10_14,r_48_10_14,0.97,35,49,14,27
28,r_92_143_84,seq131,r_95_142_110,r_95_142_110,0.64,10,120,110,27
22,r_68_112_63,seq67,seq106,r_68_112_63,0.99,0,63,63,27
44,r_130_33_89,seq127,r_32_28_175,r_130_33_89,0.98,0,89,89,27
92,seq105,r_102_97_52,r_30_104_7,r_30_104_7,0.98,3,10,7,27
35,r_54_1_140,seq55,r_17_0_93,r_54_1_140,0.93,0,140,140,27
23,r_116_90_33,r_88_5_126,seq89,r_88_5_126,1,0,126,126,27
84,seq76,seq106,r_82_63_174,r_82_63_174,0.51,-99,75,174,27
33,r_34_17_111,r_33_40_51,r_107_28_38,r_34_17_111,0.97,-60,51,111,28
17,r_32_5_29,r_33_40_51,r_4_69_60,r_32_5_29,1,0,29,29,28
2,r_75_136_15,r_70_141_36,seq135,r_75_136_15,0.54,0,15,15,28
14,r_47_97_92,r_48_21_150,r_58_95_27,r_47_97_92,0.98,0,92,92,28
43,r_119_117_17,r_116_8_96,r_140_120_9,r_116_8_96,1,-4,92,96,28
86,seq92,r_93_7_111,seq85,r_93_7_111,1,0,111,111,28
16,r_67_36_71,r_65_109_116,seq35,r_67_36_71,1,0,71,71,28
21,r_65_109_116,r_66_63_158,seq110,r_65_109_116,0.88,2,118,116,28
39,r_116_8_96,r_119_117_17,r_122_9_86,r_119_117_17,1,79,96,17,28
46,r_19_41_165,r_15_52_172,r_33_40_51,r_19_41_165,0.43,0,165,165,28
42,r_30_18_158,r_26_12_173,r_34_17_111,r_26_12_173,0.55,-15,158,173,28
24,r_122_9_86,r_11_71_153,r_116_8_96,r_122_9_86,0.85,30,116,86,28
97,seq121,r_107_28_38,r_140_120_9,r_107_28_38,0.99,-9,29,38,28
80,seq83,seq79,r_22_84_60,r_22_84_60,1,0,60,60,28
53,seq135,r_133_128_171,r_75_136_15,r_75_136_15,0.98,1,16,15,28
33,r_34_17_111,r_107_28_38,r_19_41_165,r_34_17_111,0.64,1,112,111,28
17,r_32_5_29,r_4_69_60,r_39_6_40,r_4_69_60,0.82,0,60,60,28
76,seq77,seq72,r_37_76_90,r_37_76_90,1,52,142,90,28
31,r_133_128_171,seq135,r_24_132_148,r_24_132_148,1,16,164,148,28
41,r_129_73_165,seq127,r_37_76_90,r_37_76_90,0.64,72,162,90,28
29,r_78_2_20,r_39_6_40,r_130_3_87,r_130_3_87,1,2,89,87,28
15,r_33_40_51,r_34_17_111,r_42_46_152,r_33_40_51,1,0,51,51,28
3,r_62_118_82,r_65_109_116,r_119_117_17,r_119_117_17,0.78,65,82,17,28
0,r_24_132_148,seq25,seq127,r_24_132_148,0.94,0,148,148,28
13,r_20_14_189,seq25,r_122_9_86,r_122_9_86,1,103,189,86,28
10,r_58_95_27,r_57_61_145,r_96_91_46,r_58_95_27,0.91,1,28,27,28
48,r_123_29_113,seq126,r_125_27_1,r_123_29_113,1,0,113,113,28
57,seq16,r_19_41_165,r_34_17_111,r_34_17_111,0.72,53,164,111,28
30,r_37_76_90,r_47_97_92,r_4_69_60,r_4_69_60,0.6,30,90,60,28
27,r_148_100_56,r_124_113_144,seq102,r_148_100_56,0.98,0,56,56,28
99,seq127,r_129_73_165,r_24_132_148,r_24_132_148,0.9,17,165,148,28
30,r_37_76_90,r_39_6_40,r_47_97_92,r_39_6_40,1,0,40,40,28
10,r_58_95_27,seq99,r_47_97_92,r_47_97_92,0.89,6,98,92,28
47,r_22_84_60,r_24_132_148,seq83,r_22_84_60,1,0,60,60,28
40,r_11_71_153,r_19_41_165,r_4_69_60,r_4_69_60,0.53,93,153,60,28
24,r_122_9_86,seq121,r_11_71_153,r_122_9_86,0.89,0,86,86,28
1,r_96_91_46,r_101_149_98,r_58_95_27,r_58_95_27,0.71,1,28,27,28
22,r_107_28_38,seq106,r_125_27_1,r_107_28_38,1,0,38,38,28
25,r_10_98_10,r_15_52_172,seq102,r_10_98_10,0.96,0,10,10,28
32,r_94_68_72,r_93_7_111,r_4_69_60,r_94_68_72,1,0,72,72,28
38,r_124_113_144,seq126,r_142_112_71,r_124_113_144,0.44,0,144,144,28
75,seq72,r_74_38_120,r_4_69_60,r_4_69_60,0.9,6,66,60,28
4,r_70_141_36,seq72,seq144,r_70_141_36,0.96,0,36,36,28
34,r_39_6_40,r_37_76_90,r_32_5_29,r_39_6_40,0.88,0,40,40,28
10,r_58_95_27,r_96_91_46,seq99,r_96_91_46,0.57,0,46,46,28
9,r_101_149_98,seq99,r_89_143_1,r_101_149_98,0.84,0,98,98,28
1,r_96_91_46,r_58_95_27,seq90,r_96_91_46,0.6,0,46,46,28
29,r_78_2_20,r_82_103_162,r_4_69_60,r_78_2_20,0.95,0,20,20,28
28,r_26_12_173,r_125_27_1,seq13,r_26_12_173,0.42,0,173,173,28
49,r_82_103_162,seq80,seq104,r_82_103_162,0.47,1,163,162,28
12,r_4_69_60,r_78_2_20,seq72,r_4_69_60,1,0,60,60,28
7,r_142_112_71,seq139,r_44_114_3,r_142_112_71,0.8,0,71,71,28
44,r_130_3_87,r_129_73_165,r_78_2_20,r_130_3_87,1,0,87,87,28
23,r_93_7_111,seq92,r_39_6_40,r_93_7_111,0.99,0,111,111,28
29,r_78_2_20,r_4_69_60,r_39_6_40,r_78_2_20,0.9,40,60,20,28
20,r_137_60_58,seq138,r_57_61_145,r_137_60_58,1,0,58,58,28
33,r_34_17_111,r_19_41_165,r_30_18_158,r_34_17_111,0.75,53,164,111,28
35,r_146_131_163,seq144,r_24_132_148,r_24_132_148,1,16,164,148,28
30,r_58_88_88,r_62_44_186,r_45_87_23,r_58_88_88,0.81,0,88,88,29
36,r_31_10_150,seq34,seq11,r_31_10_150,0.85,0,150,150,29
8,r_26_114_135,r_24_104_85,r_15_27_79,r_26_114_135,0.65,-50,85,135,29
17,r_95_13_195,r_133_91_36,r_4_17_141,r_95_13_195,0.9,0,195,195,29
37,r_0_33_112,seq1,seq34,r_0_33_112,1,0,112,112,29
59,seq21,r_22_140_64,seq18,r_22_140_64,1,-3,61,64,29
71,seq60,r_62_44_186,r_109_61_153,r_109_61_153,0.82,33,186,153,29
16,r_15_27_79,r_23_14_9,r_26_114_135,r_15_27_79,0.72,1,80,79,29
39,r_42_57_81,r_50_145_151,seq56,r_42_57_81,0.81,0,81,81,29
28,r_147_90_26,seq146,r_133_91_36,r_147_90_26,0.57,10,36,26,29
46,r_25_122_109,r_24_104_85,r_26_114_135,r_25_122_109,0.67,-24,85,109,29
42,r_144_131_112,seq142,seq132,r_144_131_112,0.76,1,113,112,29
69,seq53,r_58_88_88,seq56,r_58_88_88,0.62,-24,64,88,29
1,r_24_104_85,seq106,r_81_103_92,r_24_104_85,0.44,19,104,85,29
20,r_96_121_102,r_147_90_26,r_102_19_131,r_96_121_102,0.54,-49,53,102,29
0,r_81_103_92,r_102_19_131,r_24_104_85,r_102_19_131,1,0,131,131,29
41,r_2_83_176,seq1,r_119_74_153,r_2_83_176,0.65,0,176,176,29
11,r_20_40_3,seq39,seq48,r_20_40_3,0.52,20,23,3,29
13,r_94_110_176,r_62_44_186,r_95_13_195,r_94_110_176,0.78,-165,11,176,29
3,r_134_47_163,r_128_138_3,r_144_131_112,r_144_131_112,0.44,-3,109,112,29
23,r_82_129_43,seq132,r_38_130_90,r_38_130_90,1,2,92,90,29
26,r_75_37_88,r_81_103_92,seq34,r_75_37_88,0.95,0,88,88,29
43,r_133_91_36,seq132,r_92_32_164,r_133_91_36,0.98,0,36,36,29
16,r_15_27_79,r_26_114_135,seq18,r_26_114_135,0.98,0,135,135,29
0,r_81_103_92,r_89_51_191,r_102_19_131,r_102_19_131,0.72,-39,92,131,29
5,r_73_124_54,seq72,seq126,r_73_124_54,1,0,54,54,29
15,r_22_140_64,seq21,r_46_141_25,r_22_140_64,1,0,64,64,29
48,r_23_14_9,r_15_27_79,r_4_17_141,r_23_14_9,0.91,133,142,9,29
12,r_16_8_6,r_7_54_153,r_78_5_135,r_16_8_6,0.55,147,153,6,29
13,r_94_110_176,r_95_13_195,seq108,r_94_110_176,0.27,0,176,176,29
6,r_38_130_90,seq39,r_82_129_43,r_38_130_90,0.58,0,90,90,29
8,r_26_114_135,r_15_27_79,r_143_116_33,r_26_114_135,0.98,0,135,135,29
52,seq132,r_82_129_43,r_144_131_112,r_144_131_112,0.86,0,112,112,29
27,r_119_74_153,r_117_98_196,seq76,r_119_74_153,0.56,0,153,153,29
47,r_92_32_164,r_81_103_92,r_133_91_36,r_133_91_36,0.62,0,36,36,29
22,r_7_54_153,r_16_8_6,r_42_57_81,r_7_54_153,0.72,0,153,153,29
69,seq53,seq56,r_9_52_153,r_9_52_153,0.88,1,154,153,29
2,r_4_17_141,r_2_83_176,r_23_14_9,r_4_17_141,0.74,0,141,141,29
18,r_55_67_132,seq56,seq66,r_55_67_132,0.46,0,132,132,29
29,r_102_19_131,seq106,seq18,r_102_19_131,0.97,0,131,131,29
43,r_133_91_36,r_92_32_164,r_147_90_26,r_92_32_164,0.86,0,164,164,29
78,seq72,r_73_124_54,seq71,r_73_124_54,0.86,-21,33,54,29
47,r_92_32_164,r_133_91_36,r_0_33_112,r_0_33_112,0.91,55,167,112,29
88,seq106,r_105_135_154,r_81_103_92,r_81_103_92,0.88,64,156,92,29
70,seq56,r_55_67_132,r_42_57_81,r_42_57_81,0.78,51,132,81,29
65,seq39,r_38_130_90,seq43,r_38_130_90,0.91,3,93,90,29
45,r_101_59_34,r_102_19_131,seq60,r_101_59_34,0.96,0,34,34,29
23,r_82_129_43,r_81_103_92,seq132,r_82_129_43,0.86,0,43,43,29
49,r_46_141_25,r_45_87_23,seq142,r_46_141_25,0.91,-2,23,25,29
46,r_25_122_109,r_26_114_135,seq123,r_25_122_109,0.97,0,109,109,29
17,r_95_13_195,r_94_110_176,r_133_91_36,r_133_91_36,0.8,140,176,36,29
96,seq123,seq126,r_25_122_109,r_25_122_109,1,25,134,109,29
33,r_86_136_53,r_81_103_92,r_3_139_5,r_86_136_53,0.95,-1,52,53,29
34,r_45_87_23,r_46_141_25,r_89_51_191,r_45_87_23,0.82,0,23,23,29
4,r_143_116_33,r_144_131_112,seq118,r_143_116_33,0.63,0,33,33,29
7,r_109_61_153,seq111,r_101_59_34,r_109_61_153,0.66,0,153,153,29
3,r_134_47_163,r_144_131_112,r_6_41_159,r_134_47_163,0.65,0,163,163,29
44,r_9_52_153,seq11,seq53,r_9_52_153,0.88,0,153,153,29
35,r_28_112_184,seq29,r_143_116_33,r_28_112_184,0.25,1,185,184,29
84,seq93,r_94_110_176,r_147_90_26,r_147_90_26,0.48,150,176,26,29
30,r_70_47_147,seq68,r_114_48_106,r_70_47_147,0.52,0,147,147,30
48,r_98_1_29,r_106_133_66,seq0,r_98_1_29,0.98,1,30,29,30
37,r_112_97_119,r_110_43_87,r_72_109_94,r_110_43_87,0.74,8,95,87,30
15,r_55_3_46,seq56,r_98_1_29,r_55_3_46,0.98,-2,44,46,30
7,r_83_136_186,r_84_75_42,r_100_26_132,r_83_136_186,0.36,-144,42,186,30
16,r_126_86_86,r_127_63_92,seq87,r_126_86_86,0.82,0,86,86,30
21,r_61_138_79,seq60,seq139,r_61_138_79,0.98,0,79,79,30
39,r_88_27_198,seq87,r_100_26_132,r_100_26_132,1,66,198,132,30
5,r_13_96_196,seq12,r_125_108_123,r_125_108_123,0.62,75,198,123,30
46,r_113_45_128,r_115_20_127,r_110_43_87,r_115_20_127,1,0,127,127,30
34,r_69_32_14,r_66_117_209,seq34,r_66_117_209,0.63,-194,15,209,30
7,r_83_136_186,r_100_26_132,seq80,r_100_26_132,0.96,-24,108,132,30
13,r_130_57_68,r_66_117_209,r_29_58_99,r_29_58_99,1,11,110,99,30
1,r_122_16_62,r_123_49_30,seq17,r_122_16_62,0.95,-32,30,62,30
31,r_127_63_92,seq128,seq67,r_127_63_92,1,0,92,92,30
67,seq23,r_33_24_12,r_100_26_132,r_33_24_12,0.48,127,139,12,30
44,r_15_118_23,r_10_6_38,r_120_111_151,r_15_118_23,0.96,1,24,23,30
3,r_125_108_123,seq128,seq107,r_125_108_123,0.99,0,123,123,30
10,r_65_74_36,seq59,r_84_75_42,r_65_74_36,0.49,26,62,36,30
90,seq87,r_88_27_198,r_126_86_86,r_126_86_86,1,112,198,86,30
26,r_39_21_133,seq40,seq22,r_39_21_133,0.77,0,133,133,30
4,r_106_133_66,seq99,seq135,r_106_133_66,1,0,66,66,30
45,r_41_132_24,r_44_148_159,seq135,r_41_132_24,1,0,24,24,30
0,r_29_58_99,r_30_54_85,r_33_24_12,r_30_54_85,0.59,-8,77,85,30
11,r_92_51_173,seq91,seq38,r_92_51_173,0.66,2,175,173,30
13,r_130_57_68,seq131,r_66_117_209,r_130_57_68,1,0,68,68,30
98,seq116,r_92_51_173,r_120_111_151,r_92_51_173,0.87,-76,97,173,30
33,r_114_48_106,r_123_49_30,r_70_47_147,r_70_47_147,1,0,147,147,30
32,r_121_11_18,r_83_136_186,seq12,r_121_11_18,0.75,0,18,18,30
49,r_144_73_47,r_137_145_12,r_104_71_5,r_144_73_47,1,0,47,47,30
62,seq17,seq18,r_122_16_62,r_122_16_62,1,2,64,62,30
59,seq139,r_41_132_24,r_61_138_79,r_61_138_79,1,1,80,79,30
19,r_50_42_202,seq52,r_123_49_30,r_123_49_30,1,25,55,30,30
27,r_104_71_5,r_72_109_94,r_144_73_47,r_144_73_47,0.7,47,94,47,30
47,r_115_20_127,r_114_48_106,r_113_45_128,r_114_48_106,0.71,-7,99,106,30
40,r_30_54_85,r_29_58_99,seq56,r_30_54_85,0.99,2,87,85,30
14,r_137_145_12,r_144_73_47,r_124_143_6,r_144_73_47,0.99,0,47,47,30
29,r_110_43_87,r_112_97_119,seq40,r_110_43_87,0.99,3,90,87,30
24,r_5_85_173,seq4,r_125_108_123,r_5_85_173,0.48,0,173,173,30
25,r_44_148_159,seq40,seq149,r_44_148_159,0.81,1,160,159,30
2,r_123_49_30,r_122_16_62,r_50_42_202,r_123_49_30,0.97,0,30,30,30
33,r_114_48_106,r_115_20_127,r_123_49_30,r_114_48_106,0.58,5,111,106,30
59,seq139,r_137_145_12,r_41_132_24,r_41_132_24,1,4,28,24,30
20,r_10_6_38,r_13_96_196,seq4,r_10_6_38,0.99,0,38,38,30
7,r_83_136_186,seq80,r_106_133_66,r_83_136_186,0.85,0,186,186,30
38,r_100_26_132,seq99,seq25,r_100_26_132,0.59,1,133,132,30
37,r_112_97_119,r_72_109_94,seq99,r_112_97_119,0.62,0,119,119,30
22,r_62_93_48,r_70_47_147,seq91,r_62_93_48,0.91,1,49,48,30
61,seq142,r_141_140_172,r_124_143_6,r_124_143_6,0.59,47,53,6,30
60,seq12,r_14_95_126,r_121_11_18,r_14_95_126,0.82,-27,99,126,30
17,r_94_76_163,r_92_51_173,r_84_75_42,r_92_51_173,0.57,-10,163,173,30
9,r_120_111_151,seq119,r_72_109_94,r_120_111_151,0.54,23,174,151,30
47,r_115_20_127,r_113_45_128,seq22,r_115_20_127,0.98,0,127,127,30
0,r_29_58_99,r_33_24_12,r_130_57_68,r_29_58_99,0.91,0,99,99,30
18,r_84_75_42,r_83_136_186,r_104_71_5,r_84_75_42,0.75,0,42,42,30
18,r_84_75_42,r_104_71_5,r_94_76_163,r_84_75_42,0.26,141,183,42,30
35,r_72_109_94,r_104_71_5,r_120_111_151,r_72_109_94,0.6,0,94,94,30
12,r_105_53_199,seq102,r_30_54_85,r_30_54_85,0.78,114,199,85,30
30,r_71_28_113,seq72,r_49_29_74,r_71_28_113,0.96,0,113,113,31
36,r_35_111_189,seq39,r_135_113_54,r_35_111_189,0.52,0,189,189,31
14,r_14_16_174,seq17,r_62_13_140,r_62_13_140,1,32,172,140,31
8,r_44_64_64,seq45,r_63_60_82,r_44_64_64,0.99,3,67,64,31
54,seq134,r_136_70_165,r_55_137_40,r_55_137_40,0.88,125,165,40,31
37,r_54_25_176,seq57,r_49_29_74,r_54_25_176,0.41,1,177,176,31
16,r_33_94_108,seq34,seq95,r_33_94_108,1,-1,107,108,31
21,r_86_68_110,seq87,seq67,r_86_68_110,0.87,1,111,110,31
97,seq118,seq121,r_78_120_61,r_78_120_61,1,71,132,61,31
46,r_126_84_176,seq128,seq87,r_126_84_176,0.68,0,176,176,31
80,seq81,r_86_68_110,r_76_82_93,r_76_82_93,0.46,16,109,93,31
62,seq149,r_147_77_133,r_116_148_44,r_147_77_133,0.62,-107,26,133,31
45,r_3_18_145,seq4,r_62_13_140,r_3_18_145,0.65,0,145,145,31
15,r_50_12_58,seq52,seq19,r_50_12_58,0.8,0,58,58,31
73,seq57,r_55_137_40,r_54_25_176,r_55_137_40,0.97,0,40,40,31
19,r_91_66_197,seq89,r_80_90_142,r_80_90_142,1,8,150,142,31
73,seq57,r_54_25_176,r_97_56_77,r_97_56_77,0.98,16,93,77,31
43,r_115_22_37,r_1_27_17,r_47_23_69,r_47_23_69,1,9,78,69,31
31,r_78_120_61,r_76_82_93,r_21_119_50,r_78_120_61,1,0,61,61,31
3,r_97_56_77,r_99_106_156,seq57,r_97_56_77,1,0,77,77,31
10,r_47_23_69,seq48,r_115_22_37,r_47_23_69,0.57,0,69,69,31
4,r_10_127_140,seq17,seq128,r_10_127_140,0.86,0,140,140,31
12,r_24_130_24,seq30,seq132,r_24_130_24,1,0,24,24,31
78,seq74,seq73,r_147_77_133,r_147_77_133,1,25,158,133,31
0,r_49_29_74,seq48,r_1_27_17,r_49_29_74,0.78,0,74,74,31
11,r_136_70_165,seq134,r_75_69_29,r_136_70_165,0.85,0,165,165,31
20,r_63_60_82,r_62_13_140,r_44_64_64,r_44_64_64,0.8,76,140,64,31
5,r_26_102_14,r_24_130_24,seq103,r_26_102_14,0.45,0,14,14,31
13,r_133_139_90,seq129,seq140,r_133_139_90,0.89,0,90,90,31
48,r_80_90_142,seq79,r_33_94_108,r_80_90_142,0.81,1,143,142,31
33,r_135_113_54,r_136_70_165,seq112,r_135_113_54,0.69,0,54,54,31
34,r_144_146_172,r_136_70_165,r_7_143_21,r_144_146_172,0.72,-113,59,172,31
6,r_75_69_29,r_76_82_93,seq72,r_75_69_29,0.97,0,29,29,31
27,r_43_85_183,seq45,r_126_84_176,r_126_84_176,0.84,7,183,176,31
2,r_147_77_133,seq149,seq74,r_147_77_133,0.85,0,133,133,31
40,r_61_0_84,r_62_13_140,seq4,r_61_0_84,0.97,0,84,84,31
18,r_108_145_88,seq109,r_7_143_21,r_108_145_88,0.97,0,88,88,31
25,r_96_65_178,seq98,r_75_69_29,r_96_65_178,0.81,0,178,178,31
9,r_46_53_57,seq45,seq52,r_46_53_57,0.74,0,57,57,31
43,r_115_22_37,r_117_107_39,r_1_27_17,r_115_22_37,0.99,0,37,37,31
70,seq48,r_49_29_74,seq52,r_49_29_74,1,-1,73,74,31
65,seq34,r_33_94_108,r_1_27_17,r_33_94_108,0.9,0,108,108,31
38,r_138_8_106,r_136_70_165,seq9,r_138_8_106,1,0,106,106,31
26,r_117_107_39,r_116_148_44,seq109,r_117_107_39,0.94,0,39,39,31
17,r_76_82_93,seq74,seq81,r_76_82_93,0.75,3,96,93,31
1,r_7_143_21,seq5,seq142,r_7_143_21,1,0,21,21,31
96,seq112,seq110,r_135_113_54,r_135_113_54,0.84,7,61,54,31
98,seq121,r_11_123_4,r_20_122_102,r_20_122_102,1,37,139,102,31
72,seq52,r_49_29_74,r_46_53_57,r_49_29_74,0.8,-15,59,74,31
28,r_99_106_156,seq98,r_117_107_39,r_99_106_156,0.77,0,156,156,31
91,seq103,seq100,r_26_102_14,r_26_102_14,0.97,55,69,14,31
35,r_55_137_40,seq57,seq134,r_55_137_40,1,0,40,40,31
49,r_20_122_102,seq19,seq121,r_20_122_102,0.99,0,102,102,31
39,r_116_148_44,seq121,seq149,r_116_148_44,0.54,0,44,44,31
7,r_62_13_140,r_63_60_82,r_50_12_58,r_62_13_140,0.65,0,140,140,31
44,r_2_114_180,seq4,r_135_113_54,r_2_114_180,0.67,0,180,180,31
23,r_38_31_157,seq39,r_49_29_74,r_49_29_74,1,89,163,74,31
42,r_21_119_50,seq118,r_78_120_61,r_78_120_61,0.9,29,90,61,31
42,r_21_119_50,r_20_122_102,seq118,r_21_119_50,0.96,0,50,50,31
79,seq79,r_80_90_142,seq73,r_80_90_142,0.6,1,143,142,31
84,seq89,r_91_66_197,r_33_94_108,r_33_94_108,1,85,193,108,31
93,seq109,r_114_144_163,r_15_112_124,r_15_112_124,0.94,39,163,124,32
30,r_31_20_113,seq30,r_98_17_38,r_31_20_113,0.96,0,113,113,32
51,seq131,r_130_126_150,r_85_133_80,r_85_133_80,1,70,150,80,32
92,seq104,r_105_45_102,r_103_64_129,r_105_45_102,0.96,0,102,102,32
14,r_76_93_115,r_77_94_61,seq78,r_77_94_61,0.91,1,62,61,32
43,r_85_133_80,seq84,seq134,r_85_133_80,0.98,0,80,80,32
25,r_140_12_57,seq141,r_22_10_12,r_140_12_57,1,0,57,57,32
54,seq6,r_7_52_165,r_146_8_75,r_146_8_75,1,91,166,75,32
33,r_2_108_56,r_3_48_134,r_114_144_163,r_2_108_56,0.85,0,56,56,32
37,r_103_64_129,seq104,seq66,r_103_64_129,0.99,0,129,129,32
71,seq44,r_43_75_161,r_105_45_102,r_105_45_102,1,59,161,102,32
21,r_3_48_134,seq4,r_16_0_86,r_16_0_86,0.91,6,92,86,32
39,r_82_51_82,seq81,r_27_42_138,r_82_51_82,0.78,0,82,82,32
1,r_34_124_27,r_125_38_152,r_130_126_150,r_125_38_152,0.74,1,153,152,32
5,r_83_24_78,r_85_133_80,r_70_25_51,r_83_24_78,1,0,78,78,32
46,r_15_112_124,seq19,seq113,r_15_112_124,0.91,0,124,124,32
14,r_76_93_115,seq78,r_102_95_64,r_76_93_115,0.91,0,115,115,32
21,r_3_48_134,r_16_0_86,r_106_46_114,r_3_48_134,1,0,134,134,32
35,r_98_17_38,seq97,seq19,r_98_17_38,0.94,0,38,38,32
19,r_130_126_150,seq131,r_34_124_27,r_34_124_27,1,123,150,27,32
33,r_2_108_56,r_114_144_163,r_15_112_124,r_15_112_124,0.98,14,138,124,32
22,r_9_59_31,r_7_52_165,r_137_58_11,r_9_59_31,1,0,31,31,32
95,seq115,r_114_144_163,r_13_116_146,r_13_116_146,0.74,17,163,146,32
31,r_114_144_163,seq109,seq141,r_114_144_163,0.55,0,163,163,32
10,r_55_50_141,r_62_101_165,r_123_54_94,r_55_50_141,0.82,0,141,141,32
72,seq57,r_62_101_165,r_9_59_31,r_9_59_31,0.99,9,40,31,32
26,r_88_29_76,seq87,seq30,r_88_29_76,0.99,0,76,76,32
8,r_56_119_6,seq117,r_107_118_76,r_107_118_76,1,36,112,76,32
41,r_32_127_21,seq129,r_34_124_27,r_32_127_21,0.41,41,62,21,32
1,r_34_124_27,r_33_1_82,r_125_38_152,r_34_124_27,0.98,0,27,27,32
4,r_106_46_114,r_107_118_76,r_114_144_163,r_107_118_76,0.95,0,76,76,32
38,r_135_26_7,seq23,r_70_25_51,r_70_25_51,1,5,56,51,32
0,r_146_8_75,seq145,seq6,r_146_8_75,1,0,75,75,32
73,seq61,r_62_101_165,r_139_63_137,r_139_63_137,0.91,28,165,137,32
20,r_123_54_94,r_125_38_152,r_82_51_82,r_123_54_94,1,0,94,94,32
13,r_27_42_138,seq30,seq44,r_27_42_138,0.81,0,138,138,32
48,r_71_96_97,r_74_28_166,seq97,r_71_96_97,0.96,2,99,97,32
39,r_82_51_82,r_27_42_138,r_123_54_94,r_123_54_94,0.76,3,97,94,32
6,r_102_95_64,seq99,seq86,r_102_95_64,1,0,64,64,32
34,r_125_38_152,r_34_124_27,r_53_40_9,r_125_38_152,1,0,152,152,32
27,r_43_75_161,seq44,seq78,r_43_75_161,0.51,0,161,161,32
36,r_70_25_51,seq68,r_135_26_7,r_70_25_51,1,0,51,51,32
16,r_100_138_28,seq99,seq145,r_100_138_28,0.98,0,28,28,32
47,r_22_10_12,r_13_116_146,r_140_12_57,r_140_12_57,1,91,148,57,32
40,r_11_128_128,r_13_116_146,r_32_127_21,r_11_128_128,0.89,1,129,128,32
74,seq66,seq67,r_103_64_129,r_103_64_129,1,1,130,129,32
29,r_139_63_137,seq145,seq61,r_139_63_137,0.94,0,137,137,32
4,r_106_46_114,r_114_144_163,r_105_45_102,r_106_46_114,0.99,0,114,114,32
12,r_49_60_38,r_31_20_113,r_9_59_31,r_49_60_38,0.96,-1,37,38,32
32,r_16_0_86,r_15_112_124,r_33_1_82,r_16_0_86,0.96,-1,85,86,32
34,r_125_38_152,r_123_54_94,r_34_124_27,r_125_38_152,0.74,-58,94,152,32
91,seq99,r_102_95_64,seq97,r_102_95_64,0.85,-18,46,64,32
94,seq113,r_114_144_163,r_15_112_124,r_15_112_124,0.95,39,163,124,32
9,r_105_45_102,seq104,seq44,r_105_45_102,1,0,102,102,32
90,seq97,r_98_17_38,seq99,r_98_17_38,1,0,38,38,32
90,seq97,seq99,r_71_96_97,r_71_96_97,0.99,23,120,97,32
12,r_49_60_38,r_53_40_9,r_31_20_113,r_49_60_38,0.54,-23,15,38,32
28,r_107_118_76,r_106_46_114,r_56_119_6,r_107_118_76,0.96,0,76,76,32
49,r_74_28_166,seq72,r_88_29_76,r_88_29_76,0.92,94,170,76,32
7,r_33_1_82,seq35,r_16_0_86,r_33_1_82,1,0,82,82,32
41,r_32_127_21,r_34_124_27,r_11_128_128,r_11_128_128,1,0,128,128,32
82,seq81,r_82_51_82,seq80,r_82_51_82,1,0,82,82,32
23,r_137_58_11,seq136,seq57,r_137_58_11,0.99,0,11,11,32
40,r_92_59_32,r_41_64_32,r_65_3_151,r_92_59_32,0.36,64,96,32,33
30,r_53_109_206,seq52,r_10_104_93,r_53_109_206,0.27,0,206,206,33
18,r_95_15_59,seq96,seq16,r_95_15_59,1,0,59,59,33
9,r_146_17_171,r_87_148_63,r_22_11_67,r_87_148_63,0.87,108,171,63,33
40,r_92_59_32,r_65_3_151,r_94_58_140,r_92_59_32,0.86,112,144,32,33
48,r_68_139_30,r_67_61_152,seq138,r_68_139_30,1,1,31,30,33
14,r_72_63_71,r_81_76_72,r_41_64_32,r_72_63_71,1,0,71,71,33
8,r_12_74_76,seq13,r_81_76_72,r_12_74_76,1,0,76,76,33
43,r_121_4_120,r_119_71_185,r_55_5_48,r_121_4_120,1,0,120,120,33
37,r_48_28_120,seq49,r_100_29_3,r_48_28_120,0.96,0,120,120,33
50,seq0,r_6_2_134,r_101_1_40,r_101_1_40,1,0,40,40,33
38,r_127_108_20,seq128,seq105,r_127_108_20,0.76,-4,16,20,33
41,r_18_56_74,r_30_57_173,r_92_59_32,r_18_56_74,0.98,1,75,74,33
39,r_35_137_149,r_36_140_190,r_68_139_30,r_68_139_30,0.89,119,149,30,33
1,r_30_57_173,r_100_29_3,r_92_59_32,r_30_57_173,0.47,0,173,173,33
5,r_10_104_93,seq9,r_127_108_20,r_10_104_93,1,0,93,93,33
46,r_91_117_186,seq97,r_54_123_146,r_54_123_146,0.91,40,186,146,33
6,r_75_99_41,r_72_63_71,seq97,r_72_63_71,0.76,-29,42,71,33
27,r_87_148_63,r_146_17_171,r_107_149_113,r_87_148_63,0.9,108,171,63,33
31,r_8_118_61,r_6_2_134,seq116,r_8_118_61,1,1,62,61,33
67,seq38,seq40,r_93_39_168,r_93_39_168,0.88,3,171,168,33
36,r_23_45_32,r_37_77_116,seq51,r_23_45_32,1,0,32,32,33
89,seq103,r_107_149_113,r_10_104_93,r_10_104_93,0.99,16,109,93,33
3,r_93_39_168,seq97,seq38,r_93_39_168,0.86,0,168,168,33
10,r_62_136_176,seq60,r_35_137_149,r_62_136_176,0.55,0,176,176,33
42,r_55_5_48,r_54_123_146,r_6_2_134,r_55_5_48,1,0,48,48,33
26,r_100_29_3,r_30_57_173,r_48_28_120,r_48_28_120,0.84,53,173,120,33
16,r_19_144_54,r_146_17_171,r_107_149_113,r_19_144_54,0.84,58,112,54,33
11,r_54_123_146,r_53_109_206,r_8_118_61,r_54_123_146,0.98,0,146,146,33
20,r_37_77_116,r_35_137_149,r_81_76_72,r_37_77_116,0.74,0,116,116,33
13,r_86_21_75,seq88,seq13,r_86_21_75,1,0,75,75,33
49,r_6_2_134,r_55_5_48,r_101_1_40,r_6_2_134,0.48,0,134,134,33
57,seq9,r_10_104_93,seq13,r_10_104_93,1,-4,89,93,33
0,r_20_89_26,r_19_144_54,r_90_135_48,r_20_89_26,0.69,0,26,26,33
40,r_92_59_32,r_93_39_168,r_41_64_32,r_92_59_32,0.98,1,33,32,33
24,r_90_135_48,r_20_89_26,r_68_139_30,r_90_135_48,0.96,0,48,48,33
27,r_87_148_63,r_86_21_75,r_146_17_171,r_87_148_63,0.97,0,63,63,33
19,r_24_44_42,r_37_77_116,seq43,r_24_44_42,1,0,42,42,33
2,r_132_143_195,seq133,r_19_144_54,r_19_144_54,1,141,195,54,33
47,r_142_73_102,r_141_7_92,r_146_17_171,r_141_7_92,0.75,0,92,92,33
25,r_81_76_72,seq80,r_37_77_116,r_37_77_116,1,0,116,116,33
33,r_107_149_113,seq105,r_87_148_63,r_107_149_113,0.85,0,113,113,33
22,r_115_70_40,r_124_14_65,seq69,r_115_70_40,1,0,40,40,33
58,seq138,seq129,r_68_139_30,r_68_139_30,1,60,90,30,33
24,r_90_135_48,r_93_39_168,r_20_89_26,r_20_89_26,0.92,0,26,26,33
42,r_55_5_48,r_6_2_134,r_121_4_120,r_121_4_120,1,14,134,120,33
32,r_141_7_92,r_142_73_102,r_55_5_48,r_141_7_92,0.99,0,92,92,33
16,r_19_144_54,r_18_56_74,r_146_17_171,r_19_144_54,0.99,0,54,54,33
21,r_101_1_40,r_93_39_168,seq0,r_101_1_40,1,0,40,40,33
9,r_146_17_171,r_141_7_92,r_87_148_63,r_146_17_171,1,-106,65,171,33
34,r_41_64_32,seq40,r_92_59_32,r_92_59_32,0.96,0,32,32,33
60,seq16,r_37_77_116,r_95_15_59,r_95_15_59,0.8,0,59,59,33
28,r_98_82_65,r_93_39_168,seq80,r_98_82_65,0.81,0,65,65,33
0,r_20_89_26,r_90_135_48,seq88,r_90_135_48,0.76,0,48,48,33
49,r_6_2_134,r_8_118_61,r_55_5_48,r_6_2_134,1,-72,62,134,33
23,r_119_71_185,seq120,r_115_70_40,r_115_70_40,1,145,185,40,33
41,r_18_56_74,r_19_144_54,r_30_57_173,r_19_144_54,1,0,54,54,33
82,seq80,r_81_76_72,r_98_82_65,r_98_82_65,0.99,7,72,65,33
47,r_142_73_102,r_146_17_171,r_12_74_76,r_142_73_102,0.64,0,102,102,33
35,r_102_145_102,seq103,r_87_148_63,r_87_148_63,0.55,39,102,63,33
34,r_41_64_32,r_92_59_32,r_72_63_71,r_72_63_71,1,3,74,71,33
12,r_124_14_65,seq116,seq13,r_124_14_65,1,1,66,65,33
30,r_1_81_69,seq7,r_90_85_41,r_1_81_69,1,0,69,69,34
64,seq31,seq93,r_15_35_41,r_15_35_41,0.57,0,41,41,34
43,r_60_52_182,r_84_59_28,r_11_50_96,r_11_50_96,1,93,189,96,34
37,r_70_125_63,r_71_61_194,seq122,r_70_125_63,0.99,0,63,63,34
16,r_43_13_63,seq45,r_12_33_135,r_43_13_63,1,0,63,63,34
21,r_126_97_97,r_121_0_170,r_79_100_84,r_126_97_97,0.89,-2,95,97,34
1,r_103_37_190,r_104_78_154,r_16_105_113,r_16_105_113,0.99,25,138,113,34
97,seq119,r_117_34_184,seq114,r_117_34_184,0.98,0,184,184,34
13,r_77_123_16,r_79_100_84,seq122,r_77_123_16,0.93,-1,15,16,34
5,r_62_39_166,r_60_52_182,r_145_40_25,r_62_39_166,0.6,0,166,166,34
42,r_66_46_182,seq63,r_11_50_96,r_11_50_96,1,87,183,96,34
48,r_15_35_41,r_16_105_113,seq31,r_15_35_41,1,0,41,41,34
69,seq45,seq42,r_120_44_35,r_120_44_35,0.99,37,72,35,34
19,r_53_32_189,seq55,r_12_33_135,r_53_32_189,0.28,0,189,189,34
22,r_16_105_113,r_104_78_154,seq102,r_104_78_154,0.89,2,156,154,34
95,seq114,r_115_136_141,seq119,r_115_136_141,1,0,141,141,34
31,r_145_40_25,r_141_36_107,seq41,r_145_40_25,0.93,0,25,25,34
1,r_103_37_190,r_94_19_146,r_104_78_154,r_94_19_146,0.87,-116,30,146,34
20,r_146_67_22,r_141_36_107,r_66_46_182,r_146_67_22,0.95,0,22,22,34
40,r_12_33_135,r_43_13_63,seq31,r_12_33_135,1,0,135,135,34
3,r_121_0_170,seq122,r_98_9_122,r_98_9_122,0.87,49,171,122,34
10,r_94_19_146,seq95,r_3_20_49,r_94_19_146,0.99,0,146,146,34
90,seq102,r_103_37_190,r_126_97_97,r_126_97_97,0.61,0,97,97,34
26,r_98_9_122,seq95,seq8,r_98_9_122,0.94,0,122,122,34
16,r_43_13_63,r_12_33_135,r_98_9_122,r_43_13_63,1,71,134,63,34
4,r_11_50_96,r_12_33_135,seq49,r_11_50_96,0.99,0,96,96,34
0,r_22_64_131,seq23,seq63,r_22_64_131,0.98,0,131,131,34
63,seq28,r_22_64_131,r_27_2_86,r_22_64_131,0.69,-63,68,131,34
56,seq10,r_43_13_63,r_27_2_86,r_43_13_63,0.48,115,178,63,34
49,r_89_82_148,r_21_91_104,r_90_85_41,r_89_82_148,0.77,7,155,148,34
11,r_3_20_49,seq7,r_109_17_13,r_3_20_49,1,0,49,49,34
33,r_30_147_21,seq28,seq149,r_30_147_21,0.99,0,21,21,34
99,seq127,r_128_129_150,r_30_147_21,r_30_147_21,0.99,130,151,21,34
17,r_5_47_56,seq7,seq49,r_5_47_56,1,0,56,56,34
36,r_109_17_13,r_16_105_113,r_3_20_49,r_109_17_13,0.97,65,78,13,34
27,r_48_107_170,seq49,seq106,r_48_107_170,0.55,0,170,170,34
87,seq95,r_98_9_122,r_126_97_97,r_98_9_122,0.69,0,122,122,34
22,r_16_105_113,r_109_17_13,r_104_78_154,r_16_105_113,0.98,0,113,113,34
2,r_58_14_176,r_60_52_182,r_94_19_146,r_60_52_182,0.79,-5,177,182,34
40,r_12_33_135,r_11_50_96,r_43_13_63,r_43_13_63,0.72,14,77,63,34
74,seq56,r_57_88_97,r_84_59_28,r_57_88_97,0.66,1,98,97,34
18,r_84_59_28,r_60_52_182,r_90_85_41,r_90_85_41,0.41,148,189,41,34
29,r_27_2_86,r_22_64_131,seq8,r_27_2_86,1,0,86,86,34
24,r_148_124_73,seq149,seq122,r_148_124_73,0.76,0,73,73,34
25,r_141_36_107,r_140_132_93,r_15_35_41,r_141_36_107,0.98,0,107,107,34
70,seq49,r_48_107_170,r_11_50_96,r_11_50_96,1,25,121,96,34
1,r_103_37_190,r_16_105_113,r_53_32_189,r_16_105_113,0.67,78,191,113,34
20,r_146_67_22,r_66_46_182,r_22_64_131,r_22_64_131,0.99,10,141,131,34
32,r_131_18_137,seq137,r_3_20_49,r_3_20_49,0.58,88,137,49,34
38,r_128_129_150,seq127,r_118_139_78,r_118_139_78,0.76,34,112,78,34
12,r_104_78_154,r_16_105_113,seq76,r_104_78_154,0.92,2,156,154,34
41,r_120_44_35,r_121_0_170,seq45,r_120_44_35,0.86,0,35,35,34
34,r_140_132_93,r_141_36_107,r_118_139_78,r_141_36_107,0.88,0,107,107,34
64,seq31,r_15_35_41,r_12_33_135,r_12_33_135,1,28,163,135,34
9,r_118_139_78,r_117_34_184,seq138,r_118_139_78,0.93,0,78,78,34
22,r_16_105_113,r_22_64_131,r_109_17_13,r_109_17_13,1,0,13,13,34
63,seq28,r_3_20_49,r_96_29_148,r_96_29_148,0.99,4,152,148,34
28,r_117_34_184,seq119,r_15_35_41,r_15_35_41,0.57,143,184,41,34
49,r_89_82_148,seq92,r_21_91_104,r_21_91_104,1,0,104,104,34
56,seq10,r_12_33_135,r_43_13_63,r_43_13_63,1,5,68,63,34
7,r_79_100_84,seq76,seq99,r_79_100_84,0.94,0,84,84,34
23,r_25_130_118,r_22_64_131,r_118_139_78,r_25_130_118,0.77,1,119,118,34
6,r_90_85_41,r_89_82_148,seq83,r_90_85_41,0.62,-18,23,41,34
35,r_96_29_148,seq95,seq28,r_96_29_148,0.92,0,148,148,34
12,r_104_78_154,r_103_37_190,r_16_105_113,r_16_105_113,0.98,0,113,113,34
36,r_109_17_13,seq106,r_16_105_113,r_109_17_13,0.98,0,13,13,34
46,r_80_6_46,r_79_100_84,seq7,r_80_6_46,1,0,46,46,34
44,r_81_4_191,r_129_105_84,r_146_31_1,r_81_4_191,0.65,0,191,191,35
36,r_40_111_61,seq41,r_51_110_12,r_40_111_61,1,0,61,61,35
14,r_114_13_129,seq116,seq11,r_114_13_129,1,0,129,129,35
43,r_149_87_76,seq147,r_68_91_40,r_149_87_76,1,1,77,76,35
83,seq75,r_74_133_68,seq73,r_74_133_68,1,0,68,68,35
80,seq71,r_68_91_40,r_89_65_3,r_68_91_40,0.98,0,40,40,35
86,seq142,r_141_102_168,r_46_140_56,r_46_140_56,1,111,167,56,35
21,r_130_26_60,r_126_69_160,seq27,r_130_26_60,1,0,60,60,35
39,r_100_30_85,seq103,r_146_31_1,r_100_30_85,1,0,85,85,35
1,r_88_25_66,seq95,seq19,r_88_25_66,0.74,0,66,66,35
80,seq71,r_89_65_3,r_84_70_112,r_84_70_112,1,0,112,112,35
5,r_138_124_87,r_137_58_146,r_48_123_32,r_138_124_87,0.99,0,87,87,35
42,r_98_148_72,seq103,seq147,r_98_148_72,1,0,72,72,35
7,r_126_69_160,r_130_26_60,r_48_123_32,r_126_69_160,0.77,-105,55,160,35
7,r_126_69_160,r_48_123_32,r_84_70_112,r_126_69_160,0.88,0,160,160,35
19,r_51_110_12,r_49_128_91,r_145_82_175,r_51_110_12,0.88,0,12,12,35
69,seq38,r_37_43_148,r_119_33_88,r_119_33_88,0.82,41,129,88,35
6,r_6_57_35,r_15_66_185,seq56,r_6_57_35,1,0,35,35,35
9,r_52_60_195,r_49_128_91,r_90_53_17,r_52_60_195,0.62,-178,17,195,35
19,r_51_110_12,r_145_82_175,r_40_111_61,r_40_111_61,1,2,63,61,35
15,r_28_115_72,r_29_101_41,r_44_16_26,r_28_115_72,0.81,-31,41,72,35
38,r_68_91_40,seq71,r_92_85_201,r_68_91_40,0.99,0,40,40,35
66,seq27,seq19,r_130_26_60,r_130_26_60,1,8,68,60,35
38,r_68_91_40,r_92_85_201,seq95,r_92_85_201,0.22,0,201,201,35
2,r_49_128_91,r_48_123_32,r_90_53_17,r_49_128_91,0.99,-59,32,91,35
31,r_62_121_121,seq67,r_106_118_34,r_62_121_121,0.71,0,121,121,35
41,r_54_80_163,seq55,r_122_78_41,r_54_80_163,0.79,0,163,163,35
67,seq32,seq35,r_119_33_88,r_119_33_88,1,26,114,88,35
3,r_84_70_112,seq103,seq71,r_84_70_112,0.97,0,112,112,35
46,r_90_53_17,r_92_85_201,r_52_60_195,r_90_53_17,1,0,17,17,35
10,r_15_66_185,seq14,r_89_65_3,r_89_65_3,0.79,182,185,3,35
35,r_94_76_52,seq95,r_122_78_41,r_122_78_41,0.76,14,55,41,35
2,r_49_128_91,r_90_53_17,seq127,r_49_128_91,1,0,91,91,35
26,r_120_93_147,seq117,r_68_91_40,r_120_93_147,0.98,0,147,147,35
4,r_146_31_1,seq32,r_100_30_85,r_100_30_85,1,1,86,85,35
11,r_129_105_84,seq127,seq104,r_129_105_84,1,0,84,84,35
33,r_29_101_41,r_28_115_72,r_108_99_40,r_29_101_41,1,0,41,41,35
48,r_143_63_124,r_145_82_175,r_89_65_3,r_143_63_124,0.93,0,124,124,35
16,r_92_85_201,r_98_148_72,r_68_91_40,r_92_85_201,1,-161,40,201,35
13,r_48_123_32,r_126_69_160,r_138_124_87,r_48_123_32,0.65,68,100,32,35
15,r_28_115_72,r_44_16_26,seq116,r_28_115_72,1,0,72,72,35
85,seq139,r_137_58_146,r_46_140_56,r_46_140_56,1,90,146,56,35
27,r_74_133_68,seq75,seq132,r_74_133_68,1,0,68,68,35
40,r_44_16_26,r_50_45_1,seq9,r_44_16_26,1,0,26,26,35
74,seq55,r_54_80_163,r_52_60_195,r_54_80_163,0.8,-31,132,163,35
18,r_137_58_146,seq139,r_52_60_195,r_137_58_146,0.8,0,146,146,35
29,r_83_1_122,r_81_4_191,seq2,r_83_1_122,0.93,0,122,122,35
22,r_122_78_41,r_126_69_160,seq79,r_122_78_41,1,0,41,41,35
25,r_119_33_88,r_120_93_147,seq32,r_119_33_88,1,0,88,88,35
20,r_46_140_56,r_50_45_1,seq139,r_46_140_56,1,0,56,56,35
68,seq35,r_34_77_160,r_119_33_88,r_119_33_88,0.97,72,160,88,35
32,r_125_135_114,r_126_69_160,seq132,r_126_69_160,1,-45,115,160,35
52,seq132,r_134_36_189,r_74_133_68,r_74_133_68,1,32,100,68,35
34,r_145_82_175,seq144,seq96,r_145_82_175,0.64,0,175,175,35
60,seq144,r_145_82_175,seq136,r_145_82_175,0.85,0,175,175,35
13,r_48_123_32,r_49_128_91,r_126_69_160,r_48_123_32,0.97,0,32,32,35
91,seq104,seq103,r_129_105_84,r_129_105_84,1,69,153,84,35
49,r_108_99_40,seq109,r_29_101_41,r_29_101_41,1,54,95,41,35
44,r_81_4_191,r_83_1_122,r_129_105_84,r_81_4_191,0.96,-69,122,191,35
23,r_141_102_168,seq139,r_29_101_41,r_141_102_168,0.7,0,168,168,35
87,seq95,r_94_76_52,r_68_91_40,r_68_91_40,0.95,15,55,40,35
12,r_37_43_148,seq38,r_50_45_1,r_37_43_148,0.93,0,148,148,35
98,seq120,r_138_29_147,r_97_122_157,r_138_29_147,0.49,-3,144,147,36
30,r_1_143_86,seq2,seq140,r_1_143_86,1,0,86,86,36
36,r_76_24_110,seq78,seq23,r_76_24_110,1,0,110,110,36
43,r_144_3_81,r_138_29_147,seq2,r_144_3_81,0.96,0,81,81,36
18,r_49_128_34,r_40_88_107,seq126,r_49_128_34,1,0,34,34,36
3,r_64_110_26,r_65_9_134,seq111,r_64_110_26,0.97,0,26,26,36
37,r_52_4_210,seq50,r_144_3_81,r_144_3_81,1,129,210,81,36
19,r_148_115_187,r_105_149_63,seq114,r_148_115_187,0.3,0,187,187,36
86,seq87,seq85,r_40_88_107,r_40_88_107,0.95,7,114,107,36
16,r_59_146_117,r_58_89_147,seq136,r_59_146_117,0.97,0,117,117,36
21,r_65_9_134,seq66,seq11,r_65_9_134,0.98,0,134,134,36
39,r_145_14_108,seq140,seq15,r_145_14_108,1,0,108,108,36
1,r_138_29_147,seq140,r_101_31_90,r_138_29_147,0.67,0,147,147,36
97,seq119,seq117,r_48_118_66,r_48_118_66,1,1,67,66,36
5,r_48_118_66,r_40_88_107,seq119,r_48_118_66,1,0,66,66,36
80,seq66,r_65_9_134,seq67,r_65_9_134,1,0,134,134,36
7,r_141_71_32,r_74_133_110,r_94_72_72,r_141_71_32,0.89,78,110,32,36
45,r_16_91_150,seq17,seq92,r_16_91_150,0.93,0,150,150,36
19,r_148_115_187,seq147,r_105_149_63,r_105_149_63,1,21,84,63,36
95,seq114,r_113_39_127,seq117,r_113_39_127,1,0,127,127,36
66,seq23,seq18,r_76_24_110,r_76_24_110,1,13,123,110,36
14,r_74_133_110,seq50,r_141_71_32,r_141_71_32,1,5,37,32,36
90,seq98,r_97_122_157,r_134_95_59,r_134_95_59,0.95,98,157,59,36
16,r_59_146_117,seq136,r_105_149_63,r_105_149_63,0.46,121,184,63,36
14,r_74_133_110,r_141_71_32,seq132,r_74_133_110,0.95,0,110,110,36
4,r_104_51_61,r_105_149_63,r_52_4_210,r_104_51_61,1,0,61,61,36
0,r_124_19_87,r_125_116_163,seq20,r_124_19_87,1,0,87,87,36
63,seq147,r_148_115_187,r_105_149_63,r_105_149_63,1,124,187,63,36
2,r_101_31_90,r_97_122_157,seq30,r_101_31_90,1,0,90,90,36
11,r_58_89_147,r_57_41_170,r_40_88_107,r_57_41_170,0.98,-23,147,170,36
20,r_42_142_204,r_40_88_107,r_47_43_180,r_40_88_107,1,0,107,107,36
46,r_27_139_192,r_103_26_43,r_1_143_86,r_103_26_43,0.73,149,192,43,36
15,r_107_60_167,seq106,seq61,r_107_60_167,0.76,0,167,167,36
48,r_10_129_88,seq11,seq131,r_10_129_88,0.95,0,88,88,36
57,seq11,r_10_129_88,seq8,r_10_129_88,1,-2,86,88,36
6,r_40_88_107,r_42_142_204,seq87,r_40_88_107,0.98,0,107,107,36
42,r_103_26_43,r_101_31_90,r_27_139_192,r_27_139_192,0.6,-149,43,192,36
35,r_121_73_54,r_123_127_126,r_141_71_32,r_121_73_54,1,0,54,54,36
10,r_28_56_51,r_57_41_170,r_45_55_148,r_28_56_51,0.26,119,170,51,36
27,r_113_39_127,seq114,seq37,r_113_39_127,0.99,0,127,127,36
22,r_102_32_21,seq34,seq35,r_102_32_21,0.74,90,111,21,36
12,r_0_100_22,r_10_129_88,seq99,r_0_100_22,1,0,22,22,36
2,r_101_31_90,r_103_26_43,r_97_122_157,r_103_26_43,1,1,44,43,36
33,r_134_95_59,seq136,seq98,r_134_95_59,1,-1,58,59,36
40,r_108_84_95,r_109_12_134,seq83,r_108_84_95,0.99,0,95,95,36
29,r_68_135_151,r_69_33_166,r_1_143_86,r_69_33_166,0.59,-15,151,166,36
24,r_94_72_72,r_97_122_157,r_141_71_32,r_94_72_72,0.99,0,72,72,36
10,r_28_56_51,seq30,r_57_41_170,r_28_56_51,0.87,-2,49,51,36
25,r_109_12_134,r_108_84_95,seq111,r_108_84_95,1,0,95,95,36
22,r_102_32_21,r_101_31_90,seq34,r_102_32_21,0.94,0,21,21,36
70,seq37,r_38_82_179,r_113_39_127,r_113_39_127,1,52,179,127,36
42,r_103_26_43,r_27_139_192,r_137_25_153,r_137_25_153,0.58,38,191,153,36
61,seq17,r_16_91_150,seq13,r_16_91_150,0.87,0,150,150,36
32,r_57_41_170,r_58_89_147,r_28_56_51,r_57_41_170,0.91,-41,129,170,36
38,r_45_55_148,seq44,r_28_56_51,r_28_56_51,0.92,97,148,51,36
52,seq132,seq131,r_74_133_110,r_74_133_110,1,39,149,110,36
67,seq30,r_36_70_209,r_101_31_90,r_101_31_90,1,4,94,90,36
34,r_77_90_87,r_76_24_110,seq98,r_77_90_87,1,0,87,87,36
46,r_27_139_192,seq23,r_103_26_43,r_103_26_43,1,12,55,43,36
81,seq67,r_69_33_166,seq66,r_69_33_166,0.69,0,166,166,36
9,r_123_127_126,seq120,r_49_128_34,r_49_128_34,0.67,91,125,34,36
28,r_105_149_63,r_148_115_187,seq147,r_148_115_187,0.54,0,187,187,36
28,r_105_149_63,seq106,r_148_115_187,r_105_149_63,1,0,63,63,36
91,seq99,r_94_72_72,r_0_100_22,r_94_72_72,0.96,-3,69,72,36
44,r_97_122_157,seq98,seq120,r_97_122_157,0.69,-1,156,157,36
25,r_109_12_134,seq111,seq13,r_109_12_134,0.99,0,134,134,36
7,r_141_71_32,r_138_29_147,r_74_133_110,r_141_71_32,1,0,32,32,36
49,r_80_22_20,r_77_90_87,seq21,r_77_90_87,0.56,-67,20,87,36
47,r_130_81_38,r_148_115_187,seq83,r_130_81_38,1,0,38,38,36
32,r_57_41_170,r_28_56_51,r_47_43_180,r_47_43_180,0.58,-10,170,180,36
44,r_7_62_149,r_87_8_35,seq61,r_7_62_149,0.61,0,149,149,37
36,r_128_122_96,seq130,r_108_123_95,r_108_123_95,1,23,118,95,37
48,r_101_29_10,r_99_90_58,r_30_94_179,r_101_29_10,0.56,2,12,10,37
24,r_107_117_73,seq106,seq116,r_107_117_73,0.5,-14,59,73,37
16,r_60_118_114,seq61,seq116,r_60_118_114,0.99,0,114,114,37
1,r_81_10_96,r_9_80_10,seq13,r_81_10_96,1,3,99,96,37
5,r_95_133_126,seq98,r_136_134_88,r_95_133_126,0.96,0,126,126,37
46,r_108_123_95,seq109,r_128_122_96,r_108_123_95,1,-1,94,95,37
42,r_18_68_65,r_21_20_92,seq69,r_18_68_65,1,0,65,65,37
45,r_71_114_58,r_67_82_136,seq116,r_71_114_58,1,0,58,58,37
80,seq69,r_67_82_136,r_18_68_65,r_18_68_65,1,12,77,65,37
7,r_105_59_35,r_144_63_35,r_111_39_56,r_111_39_56,1,88,144,56,37
69,seq37,r_45_138_130,r_47_38_129,r_45_138_130,1,-7,123,130,37
0,r_112_85_22,seq113,seq98,r_112_85_22,1,0,22,22,37
19,r_44_125_86,r_45_138_130,r_142_127_58,r_44_125_86,0.97,0,86,86,37
6,r_79_91_49,seq77,r_93_92_53,r_79_91_49,0.96,4,53,49,37
11,r_87_8_35,r_7_62_149,r_81_10_96,r_87_8_35,0.96,116,151,35,37
11,r_87_8_35,seq86,r_7_62_149,r_87_8_35,1,0,35,35,37
37,r_144_63_35,r_141_139_175,seq64,r_144_63_35,0.97,1,36,35,37
35,r_4_49_140,seq0,r_66_52_54,r_4_49_140,0.86,0,140,140,37
97,seq120,r_124_143_167,r_34_119_13,r_34_119_13,0.96,6,19,13,37
31,r_11_36_85,seq12,seq35,r_11_36_85,1,0,85,85,37
41,r_84_129_167,seq83,seq130,r_84_129_167,0.69,0,167,167,37
26,r_74_140_168,seq77,r_141_139_175,r_74_140_168,0.4,0,168,168,37
72,seq46,r_47_38_129,r_66_52_54,r_66_52_54,0.93,75,129,54,37
4,r_45_138_130,seq40,r_141_139_175,r_45_138_130,0.98,1,131,130,37
63,seq24,seq35,r_101_29_10,r_101_29_10,0.74,152,162,10,37
73,seq51,r_48_42_190,r_66_52_54,r_66_52_54,1,95,149,54,37
3,r_135_76_36,r_136_134_88,seq77,r_135_76_36,1,0,36,36,37
15,r_27_131_146,seq28,seq132,r_27_131_146,0.98,0,146,146,37
10,r_111_39_56,seq109,seq40,r_111_39_56,1,0,56,56,37
12,r_9_80_10,r_81_10_96,r_79_91_49,r_81_10_96,0.97,-7,89,96,37
99,seq126,r_124_143_167,r_142_127_58,r_142_127_58,0.62,100,158,58,37
30,r_141_139_175,seq145,r_45_138_130,r_45_138_130,1,8,138,130,37
30,r_141_139_175,r_142_127_58,seq145,r_142_127_58,0.69,0,58,58,37
9,r_93_92_53,seq103,r_79_91_49,r_79_91_49,1,4,53,49,37
47,r_55_75_127,seq56,r_14_78_56,r_55_75_127,0.93,0,127,127,37
43,r_30_94_179,r_32_115_144,r_101_29_10,r_30_94_179,0.75,-160,19,179,37
39,r_142_127_58,r_141_139_175,seq126,r_142_127_58,0.97,0,58,58,37
40,r_97_73_73,seq98,seq70,r_97_73_73,0.88,12,85,73,37
25,r_124_143_167,seq126,r_3_148_123,r_124_143_167,0.49,1,168,167,37
43,r_30_94_179,r_101_29_10,r_112_85_22,r_30_94_179,0.51,0,179,179,37
48,r_101_29_10,r_30_94_179,r_11_36_85,r_11_36_85,1,97,182,85,37
18,r_136_134_88,r_135_76_36,r_141_139_175,r_135_76_36,1,1,37,36,37
2,r_66_52_54,r_79_91_49,seq51,r_66_52_54,0.87,-8,46,54,37
44,r_7_62_149,r_14_78_56,r_87_8_35,r_7_62_149,0.95,-119,30,149,37
12,r_9_80_10,r_79_91_49,r_67_82_136,r_67_82_136,0.69,0,136,136,37
29,r_6_15_6,r_14_78_56,seq13,r_14_78_56,1,0,56,56,37
32,r_67_82_136,seq69,r_9_80_10,r_67_82_136,0.78,1,137,136,37
21,r_14_78_56,r_6_15_6,seq77,r_14_78_56,1,0,56,56,37
34,r_3_148_123,r_4_49_140,seq145,r_3_148_123,0.99,0,123,123,37
8,r_99_90_58,r_100_102_163,r_79_91_49,r_79_91_49,1,9,58,49,37
17,r_48_42_190,seq51,r_7_62_149,r_7_62_149,0.94,40,189,149,37
96,seq116,seq113,r_107_117_73,r_107_117_73,0.8,0,73,73,37
7,r_105_59_35,seq116,r_144_63_35,r_105_59_35,0.85,0,35,35,37
22,r_47_38_129,seq46,seq37,r_47_38_129,0.58,0,129,129,37
14,r_34_119_13,r_32_115_144,seq120,r_34_119_13,0.98,0,13,13,37
49,r_149_137_112,seq147,r_136_134_88,r_149_137_112,0.46,0,112,112,37
18,r_136_134_88,r_141_139_175,r_149_137_112,r_149_137_112,0.58,2,114,112,37
35,r_4_49_140,r_3_148_123,seq0,r_3_148_123,0.99,-18,105,123,37
86,seq85,r_89_30_40,r_140_75_23,r_140_75_23,0.58,17,40,23,38
14,r_34_138_116,seq35,seq135,r_34_138_116,0.99,0,116,116,38
53,seq135,r_136_143_133,r_34_138_116,r_34_138_116,0.98,17,133,116,38
83,seq76,seq80,r_121_78_78,r_121_78_78,1,14,92,78,38
55,seq11,r_9_6_182,r_125_10_140,r_125_10_140,0.78,42,182,140,38
39,r_36_88_150,seq35,r_120_86_78,r_120_86_78,0.95,73,151,78,38
97,seq118,r_116_109_104,r_145_117_29,r_145_117_29,0.99,48,77,29,38
45,r_90_99_23,r_98_82_142,r_61_96_120,r_90_99_23,0.73,119,142,23,38
30,r_21_92_21,r_23_20_66,r_7_93_9,r_21_92_21,0.97,0,21,21,38
19,r_125_10_140,r_126_97_177,seq11,r_125_10_140,0.75,0,140,140,38
66,seq39,r_40_67_182,seq38,r_40_67_182,0.86,0,182,182,38
13,r_133_131_147,seq129,r_62_132_26,r_62_132_26,1,0,26,26,38
37,r_62_132_26,seq63,r_133_131_147,r_62_132_26,1,0,26,26,38
31,r_3_0_9,r_1_19_173,seq8,r_1_19_173,0.66,-95,78,173,38
42,r_146_127_80,seq144,r_139_149_10,r_139_149_10,0.88,15,25,10,38
10,r_98_82_142,r_90_99_23,seq80,r_98_82_142,0.66,0,142,142,38
4,r_53_91_167,seq50,r_7_93_9,r_7_93_9,0.98,158,167,9,38
0,r_9_6_182,seq11,r_142_5_4,r_9_6_182,0.5,0,182,182,38
63,seq31,r_33_148_170,seq35,r_33_148_170,0.76,-25,145,170,38
11,r_23_20_66,seq24,seq35,r_23_20_66,0.52,98,164,66,38
25,r_61_96_120,r_60_106_33,r_59_58_152,r_60_106_33,1,0,33,33,38
16,r_89_30_40,seq85,seq24,r_89_30_40,0.81,0,40,40,38
13,r_133_131_147,r_62_132_26,seq129,r_133_131_147,0.55,1,148,147,38
43,r_139_149_10,seq144,r_33_148_170,r_33_148_170,0.7,5,175,170,38
26,r_17_69_14,seq15,seq64,r_17_69_14,0.76,5,19,14,38
99,seq122,r_125_10_140,r_87_124_37,r_87_124_37,0.59,103,140,37,38
86,seq85,r_140_75_23,r_120_86_78,r_120_86_78,1,4,82,78,38
42,r_146_127_80,r_139_149_10,r_87_124_37,r_146_127_80,1,0,80,80,38
35,r_12_79_49,r_14_51_129,seq80,r_12_79_49,1,0,49,49,38
47,r_130_28_106,seq129,r_89_30_40,r_130_28_106,1,0,106,106,38
40,r_137_111_87,r_134_46_87,seq110,r_134_46_87,1,1,88,87,38
24,r_83_70_116,seq80,r_17_69_14,r_83_70_116,0.86,2,118,116,38
46,r_71_104_31,seq68,seq101,r_71_104_31,0.98,0,31,31,38
43,r_139_149_10,r_146_127_80,seq144,r_146_127_80,0.91,0,80,80,38
64,seq35,r_34_138_116,r_37_32_42,r_34_138_116,1,-17,99,116,38
18,r_87_124_37,r_89_30_40,seq122,r_87_124_37,1,0,37,37,38
58,seq144,r_146_127_80,r_139_149_10,r_146_127_80,0.68,0,80,80,38
68,seq45,r_52_128_157,r_134_46_87,r_134_46_87,0.98,5,92,87,38
38,r_141_29_107,r_136_143_133,r_89_30_40,r_141_29_107,1,0,107,107,38
32,r_7_93_9,r_90_99_23,r_21_92_21,r_21_92_21,1,3,24,21,38
48,r_140_75_23,r_136_143_133,seq76,r_140_75_23,1,0,23,23,38
25,r_61_96_120,r_59_58_152,r_90_99_23,r_61_96_120,0.65,0,120,120,38
9,r_84_105_100,r_83_70_116,r_71_104_31,r_84_105_100,0.55,0,100,100,38
26,r_17_69_14,seq64,r_83_70_116,r_83_70_116,0.71,-6,110,116,38
37,r_62_132_26,r_133_131_147,r_34_138_116,r_34_138_116,0.99,33,149,116,38
28,r_107_66_68,r_116_109_104,seq65,r_107_66_68,0.99,0,68,68,38
5,r_147_100_19,r_145_117_29,seq101,r_147_100_19,1,0,19,19,38
49,r_134_46_87,r_136_143_133,seq45,r_134_46_87,1,0,87,87,38
56,seq13,r_14_51_129,r_18_16_115,r_14_51_129,0.64,0,129,129,38
44,r_33_148_170,r_37_32_42,r_139_149_10,r_33_148_170,0.46,1,171,170,38
43,r_139_149_10,r_136_143_133,r_146_127_80,r_139_149_10,0.74,0,10,10,38
23,r_52_128_157,r_53_91_167,seq129,r_52_128_157,0.53,0,157,157,38
8,r_60_106_33,r_61_96_120,r_71_104_31,r_60_106_33,0.86,0,33,33,38
93,seq105,r_106_29_171,r_89_115_89,r_89_115_89,0.98,82,171,89,39
66,seq27,r_25_118_35,seq36,r_25_118_35,1,0,35,35,39
9,r_111_77_193,r_31_112_10,r_37_80_175,r_37_80_175,0.76,20,195,175,39
66,seq27,seq36,r_42_26_180,r_42_26_180,0.5,-51,129,180,39
14,r_96_17_84,seq97,r_132_18_34,r_96_17_84,1,0,84,84,39
43,r_125_52_150,seq135,r_130_63_173,r_125_52_150,0.35,-55,95,150,39
30,r_43_143_12,r_47_108_43,seq140,r_43_143_12,0.98,0,12,12,39
16,r_56_137_62,seq58,seq138,r_56_137_62,1,0,62,62,39
21,r_66_82_64,r_64_99_188,seq83,r_66_82_64,1,1,65,64,39
39,r_109_16_165,r_110_142_118,r_47_108_43,r_109_16_165,0.99,-47,118,165,39
1,r_7_122_138,seq6,seq119,r_7_122_138,0.93,0,138,138,39
46,r_64_99_188,r_66_82_64,r_28_65_46,r_66_82_64,1,1,65,64,39
42,r_41_87_203,r_37_80_175,r_32_59_92,r_37_80_175,0.48,1,176,175,39
45,r_14_131_72,seq15,r_130_63_173,r_14_131_72,1,0,72,72,39
31,r_30_20_184,r_33_104_109,seq36,r_33_104_109,1,0,109,109,39
57,seq11,r_12_145_43,r_9_78_164,r_12_145_43,1,2,45,43,39
41,r_76_149_72,r_73_39_186,seq148,r_76_149_72,1,0,72,72,39
67,seq36,r_35_46_126,r_30_20_184,r_35_46_126,0.68,0,126,126,39
89,seq97,r_96_17_84,seq98,r_96_17_84,1,0,84,84,39
10,r_130_63_173,seq127,r_14_131_72,r_14_131_72,1,20,92,72,39
72,seq53,r_85_67_32,r_125_52_150,r_125_52_150,0.99,10,160,150,39
28,r_85_67_32,r_73_39_186,r_28_65_46,r_85_67_32,0.97,0,32,32,39
26,r_90_40_191,seq92,r_130_63_173,r_90_40_191,0.13,0,191,191,39
8,r_144_117_152,r_34_146_48,r_7_122_138,r_144_117_152,0.95,0,152,152,39
52,seq4,r_7_122_138,r_86_3_11,r_86_3_11,0.85,1,12,11,39
0,r_89_115_89,seq92,r_31_112_10,r_89_115_89,1,0,89,89,39
63,seq22,seq23,r_86_3_11,r_86_3_11,0.42,163,174,11,39
67,seq36,r_30_20_184,r_106_29_171,r_30_20_184,0.69,0,184,184,39
11,r_110_142_118,r_109_16_165,r_43_143_12,r_110_142_118,0.9,0,118,118,39
17,r_34_146_48,r_32_59_92,r_12_145_43,r_34_146_48,1,0,48,48,39
20,r_73_39_186,seq75,r_130_63_173,r_73_39_186,0.38,0,186,186,39
13,r_9_78_164,seq11,r_51_74_114,r_9_78_164,0.58,0,164,164,39
46,r_64_99_188,r_28_65_46,seq100,r_64_99_188,0.39,0,188,188,39
15,r_68_88_74,r_64_99_188,seq92,r_68_88_74,0.99,0,74,74,39
29,r_47_108_43,seq45,seq105,r_47_108_43,0.95,0,43,43,39
8,r_144_117_152,seq140,r_34_146_48,r_34_146_48,1,9,57,48,39
99,seq127,r_130_63_173,seq129,r_130_63_173,0.99,-42,131,173,39
19,r_113_57_71,r_31_112_10,seq58,r_113_57_71,0.93,0,71,71,39
3,r_116_72_57,r_113_57_71,seq71,r_116_72_57,0.99,0,57,57,39
10,r_130_63_173,r_14_131_72,r_85_67_32,r_130_63_173,0.99,0,173,173,39
27,r_51_74_114,seq53,seq75,r_51_74_114,0.99,0,114,114,39
24,r_107_147_56,r_110_142_118,r_34_146_48,r_34_146_48,0.79,8,56,48,39
57,seq11,r_9_78_164,r_91_10_87,r_91_10_87,0.65,0,87,87,39
2,r_37_80_175,r_41_87_203,r_51_74_114,r_41_87_203,0.65,-28,175,203,39
47,r_101_139_126,seq100,seq138,r_101_139_126,0.89,0,126,126,39
40,r_33_104_109,r_30_20_184,seq105,r_33_104_109,0.93,0,109,109,39
18,r_32_59_92,r_33_104_109,seq58,r_33_104_109,0.98,-16,93,109,39
25,r_79_5_69,r_73_39_186,seq6,r_79_5_69,1,0,69,69,39
23,r_31_112_10,r_37_80_175,r_113_57_71,r_31_112_10,0.84,0,10,10,39
39,r_109_16_165,r_47_108_43,r_132_18_34,r_109_16_165,1,0,165,165,39
68,seq135,seq138,r_38_134_43,r_38_134_43,1,29,72,43,39
61,seq148,seq140,r_76_149_72,r_76_149_72,1,5,77,72,39
38,r_123_114_160,seq124,r_89_115_89,r_123_114_160,0.79,0,160,160,39
35,r_126_48_13,r_144_117_152,seq45,r_126_48_13,1,0,13,13,39
12,r_12_145_43,seq11,r_34_146_48,r_12_145_43,1,1,44,43,39
34,r_94_50_102,seq100,r_85_67_32,r_94_50_102,0.89,0,102,102,39
23,r_31_112_10,r_113_57_71,r_111_77_193,r_113_57_71,1,-4,67,71,39
48,r_28_65_46,r_32_59_92,r_85_67_32,r_85_67_32,0.91,12,44,32,39
45,r_14_131_72,r_130_63_173,seq129,r_130_63_173,0.96,0,173,173,39
81,seq71,seq69,r_116_72_57,r_116_72_57,1,46,103,57,39
9,r_111_77_193,r_107_147_56,r_31_112_10,r_107_147_56,0.88,-27,29,56,39
31,r_30_20_184,seq36,seq21,r_30_20_184,0.98,0,184,184,39
22,r_35_46_126,seq36,r_126_48_13,r_35_46_126,0.74,0,126,126,39
91,seq100,r_101_139_126,seq98,r_101_139_126,0.81,0,126,126,39
36,r_38_134_43,r_37_80_175,seq135,r_38_134_43,1,0,43,43,39
4,r_25_118_35,seq27,seq121,r_25_118_35,1,0,35,35,39
6,r_86_3_11,r_85_67_32,seq4,r_86_3_11,0.89,0,11,11,39
44,r_91_10_87,seq92,seq11,r_91_10_87,1,0,87,87,39
82,seq75,r_73_39_186,r_51_74_114,r_51_74_114,1,22,136,114,39
5,r_132_18_34,r_130_63_173,seq15,r_132_18_34,1,0,34,34,39
19,r_113_57_71,r_116_72_57,r_31_112_10,r_116_72_57,0.86,0,57,57,39
84,seq81,r_73_39_186,r_51_74_114,r_51_74_114,1,32,146,114,39
23,r_31_112_10,r_111_77_193,r_89_115_89,r_89_115_89,0.84,14,103,89,39
30,r_58_84_64,r_62_133_196,r_114_87_5,r_58_84_64,1,0,64,64,40
70,seq44,r_45_25_51,seq43,r_45_25_51,1,0,51,51,40
14,r_130_39_174,r_131_41_206,r_24_37_75,r_130_39_174,0.65,0,174,174,40
8,r_29_93_65,r_27_102_168,r_13_96_4,r_29_93_65,1,0,65,65,40
43,r_36_148_113,r_38_115_129,seq149,r_36_148_113,0.68,0,113,113,40
37,r_38_115_129,r_36_148_113,r_24_37_75,r_38_115_129,0.77,-42,87,129,40
16,r_34_85_133,seq35,r_114_87_5,r_34_85_133,1,0,133,133,40
21,r_113_42_79,seq116,seq43,r_113_42_79,1,0,79,79,40
39,r_62_133_196,seq57,r_100_126_27,r_100_126_27,0.77,178,205,27,40
18,r_77_32_53,r_58_84_64,seq33,r_77_32_53,1,-3,50,53,40
97,seq120,r_121_16_76,seq116,r_121_16_76,1,0,76,76,40
5,r_24_37_75,seq26,r_49_40_85,r_49_40_85,0.65,6,91,85,40
46,r_121_16_76,seq120,r_89_15_29,r_121_16_76,0.83,0,76,76,40
69,seq43,seq48,r_113_42_79,r_113_42_79,1,16,95,79,40
45,r_60_20_63,seq61,seq21,r_60_20_63,1,0,63,63,40
19,r_6_118_154,seq5,seq120,r_6_118_154,0.87,0,154,154,40
40,r_89_15_29,r_90_106_150,seq17,r_89_15_29,1,0,29,29,40
7,r_45_25_51,seq44,seq26,r_45_25_51,1,0,51,51,40
31,r_49_40_85,seq48,r_24_37_75,r_49_40_85,1,0,85,85,40
41,r_131_41_206,r_130_39_174,r_141_132_138,r_131_41_206,0.55,-58,148,206,40
72,seq48,r_49_40_85,seq46,r_49_40_85,1,0,85,85,40
4,r_134_23_135,r_136_92_174,r_45_25_51,r_136_92_174,0.64,-38,136,174,40
0,r_27_102_168,seq28,seq105,r_27_102_168,0.54,0,168,168,40
63,seq21,r_27_102_168,r_60_20_63,r_60_20_63,1,1,64,63,40
20,r_73_123_143,seq72,r_100_126_27,r_73_123_143,0.7,0,143,143,40
13,r_70_142_80,r_68_2_143,r_141_132_138,r_70_142_80,1,0,80,80,40
48,r_125_12_88,seq124,r_22_11_39,r_125_12_88,1,0,88,88,40
57,seq128,r_131_41_206,seq137,r_131_41_206,0.44,-84,122,206,40
6,r_139_10_93,seq140,seq9,r_139_10_93,0.99,0,93,93,40
22,r_135_74_22,r_130_39_174,seq75,r_135_74_22,1,0,22,22,40
15,r_110_144_38,seq108,seq146,r_110_144_38,0.68,5,43,38,40
99,seq127,r_125_12_88,r_100_126_27,r_125_12_88,1,-16,72,88,40
3,r_90_106_150,r_91_55_48,r_13_96_4,r_91_55_48,0.99,2,50,48,40
27,r_79_54_100,seq82,r_119_51_31,r_79_54_100,0.96,0,100,100,40
23,r_141_132_138,r_70_142_80,r_94_129_24,r_141_132_138,0.64,0,138,138,40
24,r_18_47_90,seq21,seq46,r_18_47_90,1,0,90,90,40
36,r_119_51_31,r_121_16_76,seq53,r_119_51_31,1,0,31,31,40
68,seq35,r_34_85_133,r_24_37_75,r_34_85_133,0.67,0,133,133,40
37,r_38_115_129,r_24_37_75,seq105,r_38_115_129,0.81,0,129,129,40
38,r_4_122_126,seq1,r_100_126_27,r_4_122_126,0.97,0,126,126,40
60,seq17,r_27_102_168,r_89_15_29,r_89_15_29,1,5,34,29,40
25,r_50_52_108,r_77_32_53,seq53,r_77_32_53,0.88,-3,50,53,40
34,r_22_11_39,seq21,r_125_12_88,r_125_12_88,1,31,119,88,40
67,seq33,r_34_85_133,r_77_32_53,r_77_32_53,0.74,0,53,53,40
75,seq137,r_136_92_174,r_94_129_24,r_94_129_24,0.82,149,173,24,40
49,r_91_55_48,r_90_106_150,r_63_56_161,r_91_55_48,1,2,50,48,40
23,r_141_132_138,r_134_23_135,r_70_142_80,r_141_132_138,0.78,-54,84,138,40
17,r_68_2_143,seq69,seq0,r_68_2_143,0.89,0,143,143,40
9,r_103_99_102,r_104_71_122,seq98,r_104_71_122,0.61,-20,102,122,40
13,r_70_142_80,r_141_132_138,r_36_148_113,r_70_142_80,0.47,58,138,80,40
28,r_65_14_180,seq57,r_117_30_162,r_65_14_180,0.38,0,180,180,40
12,r_104_71_122,r_117_30_162,seq67,r_104_71_122,0.72,3,125,122,40
44,r_107_95_171,seq105,r_13_96_4,r_13_96_4,0.81,167,171,4,40
23,r_141_132_138,seq143,r_134_23_135,r_141_132_138,0.74,-67,71,138,40
79,seq69,r_68_2_143,seq67,r_68_2_143,1,0,143,143,40
12,r_104_71_122,r_103_99_102,r_117_30_162,r_103_99_102,0.45,-3,99,102,40
93,seq112,r_113_83_129,seq111,r_113_83_129,0.77,0,129,129,41
40,r_86_54_24,r_53_69_132,r_137_55_105,r_137_55_105,0.56,5,110,105,41
36,r_12_61_177,seq16,r_89_60_56,r_12_61_177,0.64,0,177,177,41
4,r_3_76_32,seq75,r_65_79_81,r_65_79_81,0.98,8,89,81,41
92,seq111,r_113_83_129,seq112,r_113_83_129,0.8,0,129,129,41
58,seq143,seq141,r_81_144_144,r_81_144_144,0.99,2,146,144,41
43,r_46_45_35,seq41,r_115_42_67,r_115_42_67,1,4,71,67,41
54,seq136,r_137_55_105,seq131,r_137_55_105,1,0,105,105,41
37,r_70_36_108,seq74,seq35,r_70_36_108,1,0,108,108,41
59,seq16,r_15_64_32,r_2_19_18,r_15_64_32,1,-14,18,32,41
30,r_11_139_198,r_12_61_177,seq0,r_11_139_198,0.41,-159,39,198,41
16,r_142_66_2,seq67,r_4_62_140,r_4_62_140,0.98,31,171,140,41
39,r_120_44_100,r_121_133_112,r_115_42_67,r_120_44_100,0.99,0,100,100,41
1,r_68_114_97,seq74,seq111,r_68_114_97,0.85,0,97,97,41
46,r_115_42_67,r_113_83_129,r_46_45_35,r_115_42_67,0.99,0,67,67,41
42,r_25_96_92,seq24,r_90_91_59,r_25_96_92,0.99,1,93,92,41
32,r_81_144_144,r_140_82_64,seq143,r_81_144_144,0.98,0,144,144,41
21,r_65_79_81,seq48,seq63,r_65_79_81,0.52,-49,32,81,41
85,seq98,r_100_31_156,r_145_97_29,r_145_97_29,0.99,4,33,29,41
66,seq35,seq34,r_70_36_108,r_70_36_108,1,62,170,108,41
45,r_145_97_29,seq143,seq98,r_145_97_29,1,0,29,29,41
78,seq67,r_65_79_81,r_142_66_2,r_65_79_81,0.98,-24,57,81,41
41,r_137_55_105,seq136,r_86_54_24,r_137_55_105,1,0,105,105,41
67,seq39,r_38_1_169,r_129_37_139,r_129_37_139,0.98,30,169,139,41
61,seq148,seq146,r_108_147_10,r_108_147_10,0.45,9,19,10,41
47,r_2_19_18,r_3_76_32,seq16,r_3_76_32,1,-14,18,32,41
26,r_38_1_169,seq39,seq0,r_38_1_169,0.7,0,169,169,41
38,r_103_26_15,seq102,seq24,r_103_26_15,0.97,-1,14,15,41
63,seq24,r_25_96_92,r_103_26_15,r_25_96_92,0.76,1,93,92,41
31,r_15_64_32,seq16,seq63,r_15_64_32,1,0,32,32,41
5,r_108_147_10,r_103_26_15,seq148,r_108_147_10,0.88,1,11,10,41
20,r_121_133_112,seq119,seq131,r_121_133_112,0.78,0,112,112,41
10,r_89_60_56,r_85_21_169,seq63,r_89_60_56,1,0,56,56,41
5,r_108_147_10,seq146,r_77_149_39,r_108_147_10,0.48,95,105,10,41
48,r_14_138_175,r_12_61_177,r_84_13_59,r_84_13_59,1,6,65,59,41
57,seq141,r_140_82_64,seq143,r_140_82_64,1,2,66,64,41
6,r_4_62_140,seq0,seq63,r_4_62_140,0.82,0,140,140,41
88,seq102,r_68_114_97,r_95_105_112,r_95_105_112,0.88,25,137,112,41
10,r_89_60_56,seq63,r_12_61_177,r_12_61_177,0.9,5,182,177,41
27,r_57_71_145,seq56,r_50_72_6,r_57_71_145,0.51,0,145,145,41
22,r_140_82_64,r_81_144_144,r_113_83_129,r_140_82_64,1,80,144,64,41
2,r_95_105_112,seq99,r_6_104_33,r_6_104_33,0.87,79,112,33,41
3,r_30_5_53,r_29_43_143,seq0,r_30_5_53,1,0,53,53,41
60,seq146,seq148,r_108_147_10,r_108_147_10,0.47,18,28,10,41
29,r_23_18_72,r_25_96_92,r_2_19_18,r_23_18_72,1,0,72,72,41
24,r_85_21_169,seq87,seq24,r_85_21_169,0.71,1,170,169,41
25,r_94_58_189,seq93,r_4_62_140,r_94_58_189,0.29,0,189,189,41
33,r_113_83_129,seq111,r_140_82_64,r_140_82_64,0.98,65,129,64,41
48,r_14_138_175,r_84_13_59,seq141,r_84_13_59,0.81,116,175,59,41
64,seq28,r_29_43_143,r_78_32_33,r_78_32_33,1,109,142,33,41
50,seq0,r_4_62_140,r_30_5_53,r_30_5_53,0.84,34,87,53,41
65,seq34,r_33_123_101,seq35,r_33_123_101,1,0,101,101,41
32,r_81_144_144,r_84_13_59,r_140_82_64,r_81_144_144,0.98,-80,64,144,41
61,seq148,r_108_147_10,r_77_149_39,r_77_149_39,0.83,0,39,39,41
57,seq141,seq143,r_14_138_175,r_14_138_175,0.91,0,175,175,41
58,seq143,r_145_97_29,seq141,r_145_97_29,1,0,29,29,41
46,r_115_42_67,r_46_45_35,r_120_44_100,r_120_44_100,1,8,108,100,41
17,r_27_106_138,r_29_43_143,seq107,r_27_106_138,0.77,0,138,138,41
9,r_29_43_143,seq28,r_120_44_100,r_120_44_100,1,43,143,100,41
23,r_84_13_59,r_81_144_144,r_14_138_175,r_84_13_59,1,0,59,59,41
19,r_78_32_33,r_77_149_39,seq28,r_78_32_33,0.97,0,33,33,41
22,r_140_82_64,seq141,r_81_144_144,r_140_82_64,1,0,64,64,41
28,r_92_80_161,r_94_58_189,r_113_83_129,r_92_80_161,0.22,0,161,161,41
49,r_129_37_139,seq127,seq39,r_129_37_139,1,-1,138,139,41
21,r_65_79_81,seq63,r_3_76_32,r_65_79_81,0.99,0,81,81,41
4,r_3_76_32,r_4_62_140,seq75,r_3_76_32,1,1,33,32,41
44,r_33_123_101,seq34,seq124,r_33_123_101,1,0,101,101,41
40,r_86_54_24,r_89_60_56,r_53_69_132,r_53_69_132,0.83,-110,22,132,41
8,r_6_104_33,r_3_76_32,seq109,r_6_104_33,0.67,0,33,33,41
23,r_84_13_59,r_14_138_175,r_30_5_53,r_14_138_175,0.72,0,175,175,41
36,r_27_57_172,seq26,r_113_60_140,r_27_57_172,0.5,0,172,172,42
32,r_91_106_131,r_16_98_31,r_20_110_48,r_91_106_131,0.98,0,131,131,42
14,r_14_5_10,r_7_115_133,r_40_10_17,r_14_5_10,0.86,124,134,10,42
8,r_107_42_117,seq109,seq43,r_107_42_117,0.78,0,117,117,42
53,seq8,seq13,r_40_10_17,r_40_10_17,0.71,80,97,17,42
43,r_129_75_143,r_133_47_150,r_30_76_20,r_129_75_143,0.73,0,143,143,42
10,r_59_86_173,r_113_60_140,seq85,r_59_86_173,0.96,0,173,173,42
3,r_74_127_2,r_129_75_143,r_120_128_143,r_74_127_2,0.56,141,143,2,42
2,r_19_131_59,r_31_49_201,seq132,r_19_131_59,1,0,59,59,42
86,seq141,seq139,r_15_140_95,r_15_140_95,1,8,103,95,42
16,r_119_64_106,seq116,r_93_73_68,r_119_64_106,0.88,2,108,106,42
21,r_9_84_172,seq13,r_40_10_17,r_40_10_17,0.94,73,90,17,42
39,r_44_95_71,seq48,r_16_98_31,r_44_95_71,1,0,71,71,42
97,seq121,r_120_128_143,r_69_124_106,r_69_124_106,0.9,40,146,106,42
41,r_30_76_20,r_19_131_59,seq77,r_30_76_20,1,1,21,20,42
5,r_69_124_106,r_65_114_112,seq122,r_69_124_106,1,0,106,106,42
46,r_71_142_95,r_69_124_106,r_62_145_5,r_71_142_95,0.8,0,95,95,42
42,r_1_94_82,seq2,r_44_95_71,r_1_94_82,1,0,82,82,42
29,r_130_38_33,r_133_47_150,seq36,r_130_38_33,1,0,33,33,42
80,seq56,seq55,r_88_58_23,r_88_58_23,0.99,51,74,23,42
33,r_16_98_31,r_19_131_59,r_101_45_83,r_16_98_31,1,1,32,31,42
25,r_33_112_37,seq32,r_113_60_140,r_33_112_37,0.81,0,37,37,42
15,r_62_145_5,seq147,r_71_142_95,r_71_142_95,1,16,111,95,42
6,r_148_78_34,seq147,seq77,r_148_78_34,1,0,34,34,42
31,r_93_73_68,seq92,r_144_66_17,r_93_73_68,1,0,68,68,42
89,seq83,r_82_104_165,seq81,r_82_104_165,0.97,0,165,165,42
3,r_74_127_2,r_133_47_150,r_129_75_143,r_74_127_2,0.48,38,40,2,42
78,seq53,r_54_96_181,r_126_52_30,r_126_52_30,0.87,100,130,30,42
92,seq87,r_120_128_143,r_100_108_118,r_120_128_143,0.55,-99,44,143,42
85,seq77,seq85,r_148_78_34,r_148_78_34,0.62,16,50,34,42
73,seq43,seq41,r_107_42_117,r_107_42_117,1,11,128,117,42
11,r_133_47_150,seq132,seq48,r_133_47_150,0.93,0,150,150,42
20,r_7_115_133,r_14_5_10,seq116,r_7_115_133,0.67,1,134,133,42
13,r_46_25_166,seq48,seq17,r_46_25_166,0.68,0,166,166,42
48,r_90_143_135,r_89_103_119,r_62_145_5,r_90_143_135,0.86,1,136,135,42
21,r_9_84_172,r_40_10_17,seq85,r_9_84_172,0.87,0,172,172,42
30,r_40_10_17,seq41,seq13,r_40_10_17,0.99,0,17,17,42
23,r_113_60_140,r_59_86_173,r_88_58_23,r_59_86_173,0.99,0,173,173,42
33,r_16_98_31,r_101_45_83,r_44_95_71,r_16_98_31,0.98,50,81,31,42
23,r_113_60_140,r_72_111_71,r_59_86_173,r_113_60_140,1,0,140,140,42
45,r_20_110_48,r_19_131_59,seq109,r_20_110_48,1,0,48,48,42
10,r_59_86_173,r_88_58_23,r_113_60_140,r_113_60_140,0.97,2,142,140,42
87,seq80,r_79_0_122,seq85,r_79_0_122,1,0,122,122,42
70,seq36,seq35,r_130_38_33,r_130_38_33,1,3,36,33,42
4,r_88_58_23,seq87,seq56,r_88_58_23,1,0,23,23,42
18,r_125_70_188,seq122,r_69_124_106,r_69_124_106,1,2,108,106,42
23,r_113_60_140,r_133_47_150,r_107_42_117,r_133_47_150,0.53,-133,17,150,42
23,r_113_60_140,r_107_42_117,r_33_112_37,r_33_112_37,0.98,8,45,37,42
64,seq132,r_133_47_150,r_19_131_59,r_19_131_59,1,91,150,59,42
32,r_91_106_131,r_101_45_83,r_16_98_31,r_91_106_131,0.99,-50,81,131,42
34,r_101_45_83,r_91_106_131,seq48,r_101_45_83,1,0,83,83,42
17,r_100_108_118,r_146_102_2,seq109,r_100_108_118,0.68,0,118,118,42
27,r_99_34_16,r_100_108_118,seq35,r_99_34_16,1,0,16,16,42
25,r_33_112_37,r_113_60_140,r_72_111_71,r_33_112_37,1,70,107,37,42
94,seq109,r_107_42_117,r_20_110_48,r_20_110_48,0.48,14,62,48,42
10,r_59_86_173,r_54_96_181,r_88_58_23,r_88_58_23,1,24,47,23,42
23,r_113_60_140,r_33_112_37,r_72_111_71,r_72_111_71,1,17,88,71,42
0,r_126_52_30,r_74_127_2,seq51,r_126_52_30,1,1,31,30,42
22,r_79_0_122,seq80,seq2,r_79_0_122,0.9,0,122,122,42
28,r_89_103_119,r_90_143_135,r_146_102_2,r_90_143_135,0.59,-13,122,135,42
49,r_82_104_165,seq83,r_89_103_119,r_82_104_165,0.66,0,165,165,42
7,r_15_140_95,seq13,seq141,r_15_140_95,1,0,95,95,42
18,r_125_70_188,r_69_124_106,r_148_78_34,r_125_70_188,0.71,1,189,188,42
44,r_6_12_115,r_7_115_133,seq11,r_7_115_133,0.93,-8,125,133,42
26,r_97_135_32,r_101_45_83,seq138,r_97_135_32,0.99,0,32,32,42
79,seq55,r_54_96_181,r_126_52_30,r_126_52_30,0.74,155,185,30,42
35,r_146_102_2,r_101_45_83,r_89_103_119,r_101_45_83,1,-2,81,83,42
12,r_72_111_71,r_69_124_106,r_33_112_37,r_72_111_71,1,1,72,71,42
92,seq104,r_106_138_109,seq112,r_106_138_109,0.93,1,110,109,43
14,r_85_67_140,r_83_30_135,seq64,r_85_67_140,0.64,-4,136,140,43
30,r_42_140_34,r_45_8_85,seq149,r_42_140_34,0.98,1,35,34,43
43,r_20_118_73,seq18,seq112,r_20_118_73,1,0,73,73,43
71,seq57,r_58_115_111,r_39_59_61,r_39_59_61,1,50,111,61,43
21,r_97_135_96,r_98_7_173,r_144_131_15,r_97_135_96,0.9,0,96,96,43
46,r_58_115_111,seq57,seq112,r_58_115_111,0.94,0,111,111,43
19,r_45_8_85,r_9_54_132,r_5_142_179,r_9_54_132,1,0,132,132,43
69,seq49,r_53_62_183,r_116_50_60,r_116_50_60,1,26,86,60,43
45,r_5_142_179,r_9_54_132,r_45_8_85,r_45_8_85,0.78,27,112,85,43
24,r_39_59_61,r_44_38_7,seq57,r_39_59_61,1,0,61,61,43
19,r_45_8_85,seq46,r_9_54_132,r_45_8_85,0.98,0,85,85,43
76,seq70,r_69_43_165,r_52_82_71,r_52_82_71,0.51,95,166,71,43
41,r_75_84_164,seq74,r_52_82_71,r_52_82_71,0.99,94,165,71,43
67,seq46,r_45_8_85,r_105_48_20,r_45_8_85,1,-1,84,85,43
13,r_0_136_11,seq2,seq133,r_0_136_11,0.91,0,11,11,43
3,r_9_54_132,r_5_142_179,r_45_8_85,r_45_8_85,1,22,107,85,43
10,r_78_73_132,seq80,seq74,r_78_73_132,0.18,1,133,132,43
0,r_19_35_98,seq18,r_91_31_47,r_19_35_98,1,0,98,98,43
20,r_106_138_109,seq104,r_0_136_11,r_106_138_109,0.67,0,109,109,43
15,r_60_17_83,r_58_115_111,r_121_16_17,r_60_17_83,0.97,0,83,83,43
48,r_143_4_88,r_147_125_110,seq2,r_143_4_88,1,0,88,88,43
16,r_91_31_47,r_90_95_130,r_122_33_32,r_91_31_47,0.96,0,47,47,43
6,r_147_125_110,r_146_66_109,seq124,r_147_125_110,0.65,0,110,110,43
33,r_44_38_7,r_39_59_61,seq41,r_39_59_61,1,0,61,61,43
32,r_37_13_15,r_36_1_162,seq18,r_37_13_15,1,0,15,15,43
28,r_121_16_17,r_116_50_60,seq14,r_121_16_17,1,0,17,17,43
27,r_146_66_109,seq149,seq65,r_146_66_109,0.9,0,109,109,43
11,r_111_101_18,r_110_28_172,seq99,r_111_101_18,0.89,0,18,18,43
2,r_110_28_172,seq109,r_19_35_98,r_19_35_98,0.94,74,172,98,43
47,r_103_61_97,r_106_138_109,seq65,r_103_61_97,0.62,0,97,97,43
36,r_87_113_46,seq86,seq112,r_87_113_46,0.96,0,46,46,43
34,r_105_48_20,r_116_50_60,seq47,r_105_48_20,0.92,-1,19,20,43
29,r_52_82_71,seq49,seq81,r_52_82_71,1,0,71,71,43
25,r_10_148_171,seq18,r_139_126_168,r_139_126_168,0.46,3,171,168,43
37,r_122_33_32,r_123_56_198,seq34,r_122_33_32,1,0,32,32,43
19,r_45_8_85,r_5_142_179,r_98_7_173,r_45_8_85,0.96,87,172,85,43
38,r_128_15_95,r_129_29_149,r_121_16_17,r_128_15_95,1,0,95,95,43
45,r_5_142_179,r_45_8_85,r_139_126_168,r_5_142_179,1,0,179,179,43
3,r_9_54_132,r_45_8_85,seq51,r_9_54_132,0.94,0,132,132,43
17,r_129_29_149,r_128_15_95,r_144_131_15,r_128_15_95,1,-17,78,95,43
9,r_116_50_60,r_110_28_172,seq49,r_116_50_60,0.98,0,60,60,43
22,r_119_132_61,r_110_28_172,r_144_131_15,r_119_132_61,0.9,0,61,61,43
66,seq41,seq34,r_44_38_7,r_44_38_7,0.72,38,45,7,43
84,seq86,r_87_113_46,seq88,r_87_113_46,0.73,0,46,46,43
44,r_55_40_163,seq57,r_19_35_98,r_19_35_98,0.75,65,163,98,43
23,r_90_95_130,seq89,seq93,r_90_95_130,0.87,5,135,130,43
17,r_129_29_149,r_144_131_15,r_83_30_135,r_144_131_15,0.93,133,148,15,43
65,seq34,seq41,r_122_33_32,r_122_33_32,1,1,33,32,43
12,r_83_30_135,r_85_67_140,r_91_31_47,r_85_67_140,0.97,-5,135,140,43
22,r_145_56_44,r_147_27_128,seq55,r_145_56_44,0.9,0,44,44,44
30,r_84_64_116,seq75,r_7_65_22,r_7_65_22,0.76,95,117,22,44
16,r_144_25_138,r_134_141_81,r_8_28_127,r_144_25_138,0.97,0,138,138,44
36,r_45_104_101,seq42,seq105,r_45_104_101,0.97,0,101,101,44
44,r_88_86_99,r_92_21_143,r_80_89_96,r_88_86_99,0.89,2,101,99,44
43,r_12_117_104,r_11_94_164,seq118,r_12_117_104,0.98,0,104,104,44
37,r_136_128_155,seq138,r_121_129_113,r_121_129_113,0.68,49,162,113,44
19,r_147_27_128,r_91_137_2,r_8_28_127,r_147_27_128,1,0,128,128,44
55,seq140,r_136_128_155,r_77_143_106,r_77_143_106,0.87,1,107,106,44
16,r_144_25_138,r_136_128_155,r_134_141_81,r_136_128_155,0.57,-72,83,155,44
21,r_41_71_66,seq42,seq67,r_41_71_66,0.99,0,66,66,44
39,r_66_19_165,seq63,r_146_24_57,r_146_24_57,0.65,108,165,57,44
15,r_57_13_182,r_145_56_44,r_6_3_74,r_57_13_182,0.92,1,183,182,44
5,r_31_74_120,r_32_1_122,seq73,r_31_74_120,0.67,0,120,120,44
46,r_58_26_167,r_57_13_182,r_8_28_127,r_58_26_167,0.55,0,167,167,44
42,r_52_102_152,seq53,seq101,r_52_102_152,0.75,0,152,152,44
35,r_98_69_59,r_93_131_93,seq67,r_98_69_59,1,0,59,59,44
45,r_124_109_101,seq118,r_47_112_52,r_124_109_101,0.96,4,105,101,44
31,r_99_76_132,seq95,seq81,r_99_76_132,0.7,0,132,132,44
41,r_87_39_87,r_88_86_99,seq42,r_87_39_87,0.45,0,87,87,44
3,r_11_94_164,seq10,r_70_96_96,r_11_94_164,0.84,0,164,164,44
10,r_93_131_93,r_92_21_143,r_106_130_46,r_93_131_93,0.74,0,93,93,44
54,seq10,r_11_94_164,r_6_3_74,r_11_94_164,0.87,-108,56,164,44
26,r_33_29_121,r_36_79_156,seq30,r_33_29_121,0.99,0,121,121,44
4,r_16_125_185,seq15,r_106_130_46,r_16_125_185,0.19,0,185,185,44
0,r_70_96_96,seq67,seq97,r_70_96_96,0.89,0,96,96,44
15,r_57_13_182,r_58_26_167,r_145_56_44,r_145_56_44,0.82,123,167,44,44
48,r_80_89_96,seq81,r_88_86_99,r_80_89_96,0.89,0,96,96,44
19,r_147_27_128,r_146_24_57,r_91_137_2,r_146_24_57,1,2,59,57,44
87,seq101,seq108,r_52_102_152,r_52_102_152,0.65,0,152,152,44
2,r_8_28_127,seq4,r_147_27_128,r_147_27_128,0.96,0,128,128,44
47,r_32_1_122,r_31_74_120,seq0,r_32_1_122,0.98,0,122,122,44
9,r_134_141_81,seq140,r_51_142_105,r_51_142_105,0.88,16,121,105,44
6,r_106_130_46,seq105,r_91_137_2,r_106_130_46,0.96,1,47,46,44
29,r_77_143_106,seq75,r_51_142_105,r_77_143_106,0.93,0,106,106,44
1,r_7_65_22,r_8_28_127,seq63,r_7_65_22,1,0,22,22,44
24,r_100_44_106,r_111_123_180,seq43,r_111_123_180,0.53,-77,103,180,44
50,seq0,seq4,r_32_1_122,r_32_1_122,0.99,8,130,122,44
32,r_36_79_156,seq42,seq81,r_36_79_156,0.46,0,156,156,44
38,r_18_9_147,seq22,r_6_3_74,r_18_9_147,0.43,1,148,147,44
27,r_146_24_57,r_147_27_128,seq22,r_146_24_57,0.89,0,57,57,44
40,r_38_17_46,r_36_79_156,r_103_14_14,r_38_17_46,1,0,46,46,44
84,seq90,r_88_86_99,r_11_94_164,r_11_94_164,0.82,14,178,164,44
28,r_121_129_113,seq118,seq126,r_121_129_113,0.53,1,114,113,44
91,seq110,r_111_123_180,r_47_112_52,r_47_112_52,0.99,129,181,52,44
56,seq15,r_16_125_185,r_103_14_14,r_16_125_185,0.97,-111,74,185,44
7,r_51_142_105,r_52_102_152,r_134_141_81,r_51_142_105,0.65,0,105,105,44
44,r_88_86_99,r_87_39_87,r_92_21_143,r_87_39_87,0.85,0,87,87,44
11,r_47_112_52,seq49,seq110,r_47_112_52,0.94,0,52,52,44
72,seq55,r_57_13_182,r_145_56_44,r_145_56_44,0.67,0,44,44,44
23,r_135_139_27,r_136_128_155,r_106_130_46,r_106_130_46,0.82,102,148,46,44
34,r_35_116_18,seq34,seq118,r_35_116_18,0.82,0,18,18,44
84,seq90,r_92_21_143,r_88_86_99,r_92_21_143,1,-11,132,143,44
9,r_146_101_55,seq148,r_5_147_12,r_5_147_12,0.82,0,12,12,45
92,seq111,r_108_7_128,seq100,r_108_7_128,1,0,128,128,45
5,r_99_130_46,seq97,seq134,r_99_130_46,0.92,5,51,46,45
14,r_34_39_143,seq33,r_24_38_65,r_24_38_65,1,78,143,65,45
43,r_56_26_140,seq55,seq28,r_56_26_140,0.95,0,140,140,45
37,r_123_84_110,seq122,seq81,r_123_84_110,0.89,0,110,110,45
3,r_6_23_127,r_145_4_25,seq19,r_6_23_127,1,0,127,127,45
86,seq97,seq100,r_45_98_103,r_45_98_103,1,43,146,103,45
16,r_96_88_132,seq100,r_16_87_131,r_16_87_131,1,13,144,131,45
1,r_79_74_90,r_50_63_4,r_124_73_54,r_124_73_54,1,35,89,54,45
19,r_58_1_116,r_145_4_25,r_90_3_146,r_90_3_146,0.95,0,146,146,45
46,r_27_66_86,seq28,seq64,r_27_66_86,1,0,86,86,45
33,r_0_35_76,seq8,seq33,r_0_35_76,0.84,0,76,76,45
42,r_121_60_72,r_123_84_110,seq59,r_121_60_72,0.65,2,74,72,45
33,r_0_35_76,r_2_132_36,seq8,r_0_35_76,0.83,-44,32,76,45
35,r_136_112_50,seq134,r_109_106_108,r_136_112_50,1,0,50,50,45
21,r_2_132_36,r_0_35_76,seq134,r_2_132_36,1,0,36,36,45
45,r_131_125_110,seq134,seq126,r_131_125_110,0.9,1,111,110,45
2,r_70_46_18,r_76_94_134,r_44_40_173,r_70_46_18,0.59,0,18,18,45
19,r_58_1_116,seq59,r_145_4_25,r_58_1_116,0.9,0,116,116,45
38,r_124_73_54,r_121_60_72,r_95_72_13,r_95_72_13,0.6,41,54,13,45
41,r_108_7_128,seq111,seq8,r_108_7_128,0.97,0,128,128,45
4,r_43_14_13,r_45_98_103,seq15,r_43_14_13,0.94,1,14,13,45
11,r_45_98_103,r_44_40_173,seq97,r_45_98_103,1,2,105,103,45
0,r_5_147_12,r_6_23_127,r_146_101_55,r_5_147_12,0.94,0,12,12,45
28,r_42_62_141,r_45_98_103,r_57_41_15,r_57_41_15,0.9,11,26,15,45
20,r_127_83_172,r_128_115_170,r_79_74_90,r_79_74_90,0.93,85,175,90,45
13,r_16_87_131,r_18_31_97,r_96_88_132,r_16_87_131,0.92,0,131,131,45
49,r_129_91_9,r_90_3_146,seq102,r_90_3_146,1,0,146,146,45
44,r_61_113_172,r_42_62_141,r_109_106_108,r_61_113_172,0.37,1,173,172,45
6,r_93_149_62,r_108_7_128,seq148,r_93_149_62,1,0,62,62,45
85,seq92,r_90_3_146,seq102,r_90_3_146,1,0,146,146,45
99,seq126,seq122,r_131_125_110,r_131_125_110,0.94,4,114,110,45
30,r_145_4_25,r_6_23_127,seq8,r_6_23_127,1,0,127,127,45
97,seq148,r_5_147_12,r_93_149_62,r_93_149_62,0.76,0,62,62,45
87,seq100,r_108_7_128,seq102,r_108_7_128,1,-29,99,128,45
97,seq148,r_146_101_55,r_5_147_12,r_5_147_12,0.36,40,52,12,45
26,r_57_41_15,r_58_1_116,r_42_62_141,r_57_41_15,0.78,0,15,15,45
47,r_138_118_172,seq134,seq117,r_138_118_172,0.38,0,172,172,45
3,r_6_23_127,seq8,r_145_4_25,r_145_4_25,1,2,27,25,45
0,r_5_147_12,r_146_101_55,seq148,r_146_101_55,0.99,0,55,55,45
18,r_75_137_124,seq77,seq134,r_75_137_124,0.54,0,124,124,45
29,r_109_106_108,r_108_7_128,seq102,r_108_7_128,1,-29,99,128,45
24,r_21_141_87,seq19,seq144,r_21_141_87,1,0,87,87,45
9,r_146_101_55,r_5_147_12,seq102,r_146_101_55,1,0,55,55,45
35,r_136_112_50,r_109_106_108,seq114,r_136_112_50,0.46,70,120,50,45
32,r_24_38_65,r_21_141_87,r_34_39_143,r_21_141_87,0.44,-22,65,87,45
77,seq65,r_67_37_177,r_27_66_86,r_27_66_86,1,31,117,86,45
34,r_32_82_115,r_34_39_143,r_17_86_18,r_34_39_143,0.52,-28,115,143,45
22,r_17_86_18,r_18_31_97,seq81,r_17_86_18,1,0,18,18,45
81,seq77,r_76_94_134,r_110_78_36,r_76_94_134,0.59,1,135,134,45
7,r_110_78_36,seq111,seq81,r_110_78_36,0.48,-15,21,36,45
17,r_67_37_177,seq64,r_34_39_143,r_67_37_177,0.4,0,177,177,45
30,r_145_4_25,seq142,r_6_23_127,r_145_4_25,0.98,0,25,25,45
26,r_57_41_15,r_42_62_141,r_44_40_173,r_42_62_141,0.99,0,141,141,45
28,r_42_62_141,r_57_41_15,r_61_113_172,r_42_62_141,0.97,0,141,141,45
27,r_54_12_53,r_58_1_116,seq13,r_54_12_53,1,0,53,53,45
28,r_42_62_141,r_61_113_172,r_50_63_4,r_61_113_172,0.39,0,172,172,45
44,r_61_113_172,seq81,r_42_62_141,r_42_62_141,0.9,3,144,141,45
23,r_50_63_4,r_79_74_90,r_85_69_16,r_79_74_90,0.63,45,135,90,45
39,r_105_51_33,seq104,seq49,r_105_51_33,0.9,0,33,33,45
8,r_89_53_29,r_93_149_62,seq59,r_93_149_62,0.68,-29,33,62,45
31,r_44_40_173,r_45_98_103,r_70_46_18,r_70_46_18,0.96,1,19,18,45
12,r_18_31_97,r_16_87_131,seq28,r_16_87_131,1,-34,97,131,45
47,r_35_131_22,r_36_106_104,seq132,r_35_131_22,0.98,0,22,22,46
36,r_51_144_79,seq50,r_107_148_62,r_51_144_79,0.99,0,79,79,46
14,r_81_72_149,seq80,r_102_70_12,r_81_72_149,0.56,0,149,149,46
8,r_111_92_97,r_110_41_141,seq95,r_111_92_97,0.99,5,102,97,46
35,r_110_41_141,seq113,seq40,r_110_41_141,1,0,141,141,46
48,r_103_82_12,seq100,r_84_28_54,r_103_82_12,0.92,0,12,12,46
59,seq141,seq140,r_112_142_37,r_112_142_37,1,73,110,37,46
48,r_103_82_12,r_81_72_149,r_98_83_72,r_98_83_72,0.99,1,73,72,46
5,r_30_10_172,seq29,r_114_8_29,r_114_8_29,1,144,173,29,46
42,r_133_53_79,seq132,seq55,r_133_53_79,1,0,79,79,46
32,r_6_62_113,seq4,r_61_115_193,r_61_115_193,0.98,-80,113,193,46
29,r_114_8_29,r_9_14_122,r_19_13_50,r_114_8_29,0.57,41,70,29,46
37,r_65_125_14,seq55,seq126,r_65_125_14,1,0,14,14,46
19,r_84_28_54,r_78_0_192,r_103_82_12,r_103_82_12,0.99,0,12,12,46
45,r_96_21_68,r_98_83_72,r_63_23_86,r_96_21_68,0.98,-2,66,68,46
39,r_19_13_50,r_18_97_177,r_11_12_114,r_19_13_50,0.7,4,54,50,46
48,r_103_82_12,r_84_28_54,r_81_72_149,r_84_28_54,0.97,0,54,54,46
31,r_61_115_193,r_60_66_140,r_6_62_113,r_6_62_113,0.65,7,120,113,46
41,r_18_97_177,r_19_13_50,seq113,r_19_13_50,0.43,126,176,50,46
3,r_87_105_124,r_86_49_158,r_36_106_104,r_87_105_124,0.77,0,124,124,46
18,r_11_12_114,seq40,r_19_13_50,r_11_12_114,0.7,-90,24,114,46
63,seq29,r_30_10_172,r_59_32_112,r_59_32_112,0.89,60,172,112,46
73,seq55,r_63_23_86,r_133_53_79,r_133_53_79,1,7,86,79,46
11,r_93_38_79,seq94,seq39,r_93_38_79,1,0,79,79,46
20,r_31_99_65,r_30_10_172,seq100,r_31_99_65,1,0,65,65,46
13,r_118_37_101,seq113,seq39,r_118_37_101,0.98,0,101,101,46
98,seq126,seq124,r_65_125_14,r_65_125_14,0.9,56,70,14,46
15,r_86_49_158,seq89,r_17_47_4,r_86_49_158,0.84,0,158,158,46
27,r_91_69_192,r_111_92_97,r_81_72_149,r_111_92_97,0.57,93,190,97,46
62,seq132,r_133_53_79,r_35_131_22,r_133_53_79,0.76,0,79,79,46
16,r_102_70_12,seq100,seq71,r_102_70_12,0.96,0,12,12,46
29,r_114_8_29,r_118_37_101,r_9_14_122,r_114_8_29,1,0,29,29,46
4,r_98_83_72,r_135_27_124,r_103_82_12,r_98_83_72,0.94,0,72,72,46
27,r_91_69_192,seq94,r_112_142_37,r_91_69_192,0.41,-97,95,192,46
2,r_88_129_80,r_86_49_158,r_143_130_6,r_88_129_80,0.98,0,80,80,46
40,r_90_149_67,r_93_38_79,r_107_148_62,r_90_149_67,0.98,0,67,67,46
24,r_25_85_127,seq24,r_98_83_72,r_25_85_127,0.89,0,127,127,46
25,r_107_148_62,r_109_52_180,r_90_149_67,r_107_148_62,0.99,6,68,62,46
64,seq34,r_36_106_104,r_22_33_58,r_36_106_104,0.89,0,104,104,46
46,r_145_73_31,r_146_26_127,seq74,r_145_73_31,1,1,32,31,46
88,seq108,r_109_52_180,r_87_105_124,r_87_105_124,0.88,56,180,124,46
27,r_91_69_192,r_112_142_37,r_111_92_97,r_91_69_192,0.83,-86,106,192,46
32,r_6_62_113,r_5_54_100,seq4,r_5_54_100,0.51,2,102,100,46
4,r_98_83_72,r_96_21_68,r_135_27_124,r_98_83_72,0.39,-18,54,72,46
34,r_63_23_86,r_59_32_112,r_96_21_68,r_96_21_68,1,17,85,68,46
19,r_84_28_54,r_103_82_12,seq24,r_84_28_54,1,0,54,54,46
81,seq79,r_78_0_192,seq80,r_78_0_192,0.73,1,193,192,46
17,r_36_106_104,seq34,seq108,r_36_106_104,1,0,104,104,46
9,r_5_54_100,r_6_62_113,r_133_53_79,r_133_53_79,1,21,100,79,46
96,seq123,seq122,r_88_129_80,r_88_129_80,1,118,198,80,46
31,r_61_115_193,r_6_62_113,seq113,r_61_115_193,0.74,0,193,193,46
22,r_109_52_180,seq108,r_17_47_4,r_109_52_180,0.26,0,180,180,46
49,r_22_33_58,r_25_85_127,seq29,r_25_85_127,0.8,-67,60,127,46
10,r_112_142_37,r_111_92_97,seq141,r_112_142_37,0.98,0,37,37,46
7,r_135_27_124,r_134_20_128,r_84_28_54,r_84_28_54,0.99,71,125,54,46
44,r_146_26_127,seq141,seq24,r_146_26_127,0.88,0,127,127,46
82,seq80,r_81_72_149,r_98_83_72,r_98_83_72,1,75,147,72,46
35,r_110_41_141,r_111_92_97,seq113,r_111_92_97,0.81,0,97,97,46
12,r_76_147_144,seq77,r_107_148_62,r_76_147_144,0.82,0,144,144,46
23,r_143_130_6,seq128,r_88_129_80,r_88_129_80,1,3,83,80,46
40,r_100_120_169,r_64_94_23,seq123,r_100_120_169,0.76,0,169,169,47
84,seq80,seq79,r_95_81_21,r_95_81_21,1,-1,20,21,47
51,seq128,r_127_12_187,r_91_129_28,r_91_129_28,0.64,159,187,28,47
36,r_127_12_187,seq128,r_117_13_69,r_117_13_69,1,118,187,69,47
14,r_124_141_157,seq123,r_121_145_13,r_124_141_157,0.45,1,158,157,47
8,r_82_45_106,seq88,seq41,r_82_45_106,1,0,106,106,47
43,r_69_140_143,seq71,seq138,r_69_140_143,0.97,0,143,143,47
21,r_6_1_85,r_117_13_69,r_67_14_163,r_67_14_163,0.99,26,189,163,47
37,r_5_62_102,r_6_1_85,r_32_8_33,r_32_8_33,0.98,52,85,33,47
16,r_93_136_131,r_97_31_72,r_64_94_23,r_97_31_72,0.65,-14,58,72,47
21,r_6_1_85,r_5_62_102,seq15,r_5_62_102,0.97,-17,85,102,47
1,r_65_37_188,r_67_14_163,r_142_73_48,r_142_73_48,0.9,118,166,48,47
25,r_48_78_155,seq49,r_54_46_17,r_54_46_17,1,-1,16,17,47
46,r_147_134_93,r_143_68_132,seq133,r_143_68_132,0.99,-48,84,132,47
42,r_17_118_68,seq15,seq119,r_17_118_68,1,0,68,68,47
13,r_24_126_56,seq21,seq128,r_24_126_56,1,0,56,56,47
45,r_96_36_103,r_98_102_119,r_43_35_97,r_96_36_103,1,0,103,103,47
20,r_98_102_119,r_64_94_23,seq103,r_98_102_119,0.77,0,119,119,47
39,r_54_46_17,r_48_78_155,r_57_47_107,r_57_47_107,0.53,48,155,107,47
31,r_75_76_98,r_77_7_159,r_48_78_155,r_75_76_98,0.93,60,158,98,47
41,r_77_7_159,r_75_76_98,r_61_4_27,r_77_7_159,0.88,0,159,159,47
89,seq144,r_143_68_132,r_121_145_13,r_143_68_132,0.97,0,132,132,47
3,r_26_83_202,seq23,r_48_78_155,r_48_78_155,0.86,45,200,155,47
28,r_95_81_21,r_97_31_72,seq80,r_95_81_21,0.98,-1,20,21,47
5,r_91_129_28,seq90,seq128,r_91_129_28,1,2,30,28,47
26,r_51_92_74,seq50,seq90,r_51_92_74,1,0,74,74,47
16,r_93_136_131,r_64_94_23,r_147_134_93,r_93_136_131,1,0,131,131,47
4,r_97_31_72,r_98_102_119,r_53_34_1,r_97_31_72,0.92,0,72,72,47
11,r_87_66_131,seq86,seq70,r_87_66_131,0.99,0,131,131,47
18,r_61_4_27,r_57_47_107,seq10,r_61_4_27,1,0,27,27,47
20,r_98_102_119,r_97_31_72,r_64_94_23,r_97_31_72,0.57,1,73,72,47
37,r_5_62_102,r_32_8_33,seq60,r_5_62_102,0.98,0,102,102,47
6,r_143_68_132,seq144,seq70,r_143_68_132,0.91,0,132,132,47
9,r_146_110_52,r_147_134_93,r_107_112_2,r_146_110_52,0.93,7,59,52,47
2,r_89_114_16,r_87_66_131,seq116,r_89_114_16,0.82,1,17,16,47
19,r_32_8_33,seq33,r_61_4_27,r_32_8_33,0.99,1,34,33,47
39,r_54_46_17,seq55,r_48_78_155,r_54_46_17,0.99,-1,16,17,47
47,r_117_13_69,seq116,seq15,r_117_13_69,1,0,69,69,47
40,r_100_120_169,r_99_148_95,r_64_94_23,r_100_120_169,0.98,-76,93,169,47
33,r_99_148_95,r_100_120_169,r_121_145_13,r_99_148_95,0.71,0,95,95,47
48,r_64_94_23,r_93_136_131,r_113_132_90,r_93_136_131,0.46,-4,127,131,47
98,seq123,seq101,r_100_120_169,r_100_120_169,0.57,0,169,169,47
50,seq0,seq15,r_6_1_85,r_6_1_85,0.31,69,154,85,47
32,r_58_3_112,seq59,seq2,r_58_3_112,1,0,112,112,47
38,r_29_25_155,r_43_35_97,seq23,r_29_25_155,0.53,0,155,155,47
52,seq2,seq15,r_58_3_112,r_58_3_112,1,-1,111,112,47
48,r_64_94_23,r_113_132_90,seq101,r_113_132_90,0.44,84,174,90,47
48,r_64_94_23,r_69_140_143,r_93_136_131,r_64_94_23,0.85,0,23,23,47
30,r_142_73_48,r_143_68_132,seq74,r_142_73_48,0.66,0,48,48,47
17,r_131_28_156,seq130,r_44_39_92,r_131_28_156,0.54,1,157,156,47
25,r_48_78_155,r_54_46_17,r_75_76_98,r_48_78_155,0.56,0,155,155,47
1,r_65_37_188,r_142_73_48,r_97_31_72,r_65_37_188,0.67,0,188,188,47
49,r_85_135_154,seq86,r_93_136_131,r_85_135_154,0.85,0,154,154,47
56,seq130,r_131_28_156,r_113_132_90,r_131_28_156,0.53,1,157,156,47
7,r_67_14_163,r_65_37_188,seq15,r_67_14_163,0.6,0,163,163,47
44,r_22_115_129,seq23,r_89_114_16,r_22_115_129,0.98,0,129,129,47
23,r_43_35_97,seq38,r_96_36_103,r_96_36_103,1,23,126,103,47
35,r_122_149_141,seq123,r_99_148_95,r_99_148_95,1,47,142,95,47
12,r_57_47_107,seq56,r_54_46_17,r_57_47_107,0.58,0,107,107,47
40,r_30_60_46,r_61_53_120,r_80_59_112,r_30_60_46,0.55,74,120,46,48
51,seq1,r_8_103_154,r_63_3_86,r_63_3_86,0.76,65,151,86,48
68,seq34,seq35,r_37_33_128,r_37_33_128,0.99,1,129,128,48
36,r_37_33_128,r_38_100_121,seq34,r_37_33_128,0.8,-7,121,128,48
14,r_63_3_86,seq64,seq7,r_63_3_86,0.99,0,86,86,48
8,r_8_103_154,seq7,r_149_104_30,r_8_103_154,0.88,0,154,154,48
43,r_46_18_146,seq47,seq22,r_46_18_146,0.97,0,146,146,48
37,r_9_133_139,r_8_103_154,seq132,r_8_103_154,0.56,-15,139,154,48
16,r_111_0_155,seq113,seq1,r_111_0_155,0.7,0,155,155,48
21,r_89_40_91,seq90,seq41,r_89_40_91,1,0,91,91,48
39,r_88_23_179,r_84_43_182,r_42_19_148,r_88_23_179,0.29,0,179,179,48
1,r_12_115_7,seq119,r_70_117_123,r_70_117_123,0.99,5,128,123,48
46,r_27_146_113,seq25,r_14_144_59,r_27_146_113,1,0,113,113,48
42,r_105_106_122,r_107_16_163,r_83_112_63,r_105_106_122,0.67,1,123,122,48
30,r_96_126_63,seq101,seq123,r_96_126_63,0.98,0,63,63,48
45,r_58_124_130,seq54,seq123,r_58_124_130,0.95,0,130,130,48
19,r_70_117_123,r_73_45_182,r_91_118_34,r_73_45_182,0.99,-59,123,182,48
41,r_93_20_195,r_73_45_182,r_135_92_9,r_135_92_9,1,2,11,9,48
30,r_96_126_63,r_95_145_14,seq101,r_95_145_14,0.86,12,26,14,48
66,seq29,seq31,r_99_28_31,r_99_28_31,0.99,56,87,31,48
31,r_72_129_102,r_73_45_182,seq128,r_72_129_102,0.87,0,102,102,48
10,r_24_2_178,seq22,r_63_3_86,r_24_2_178,0.37,0,178,178,48
72,seq41,r_42_19_148,r_89_40_91,r_89_40_91,1,1,92,91,48
0,r_38_100_121,r_37_33_128,seq98,r_38_100_121,0.98,0,121,121,48
25,r_149_104_30,seq148,seq102,r_149_104_30,0.98,0,30,30,48
97,seq119,r_12_115_7,r_91_118_34,r_91_118_34,0.94,6,40,34,48
11,r_83_112_63,r_84_43_182,seq113,r_83_112_63,0.88,-1,62,63,48
98,seq120,seq123,r_9_133_139,r_9_133_139,0.8,39,178,139,48
18,r_99_28_31,seq98,seq29,r_99_28_31,1,0,31,31,48
23,r_65_15_13,r_62_110_143,seq21,r_65_15_13,0.99,0,13,13,48
13,r_95_145_14,r_96_126_63,seq142,r_95_145_14,0.47,0,14,14,48
85,seq74,r_73_45_182,r_147_71_73,r_147_71_73,1,109,182,73,48
99,seq123,seq120,r_96_126_63,r_96_126_63,1,34,97,63,48
5,r_135_92_9,r_93_20_195,r_32_94_77,r_32_94_77,1,53,130,77,48
22,r_91_118_34,r_73_45_182,seq119,r_91_118_34,1,-1,33,34,48
41,r_93_20_195,r_135_92_9,r_42_19_148,r_93_20_195,0.44,0,195,195,48
38,r_122_26_30,seq123,seq25,r_122_26_30,1,0,30,30,48
24,r_147_71_73,seq141,seq74,r_147_71_73,1,0,73,73,48
33,r_80_59_112,seq81,r_30_60_46,r_30_60_46,1,53,99,46,48
64,seq22,r_24_2_178,r_42_19_148,r_42_19_148,0.97,31,179,148,48
3,r_14_144_59,r_13_10_137,r_95_145_14,r_14_144_59,1,0,59,59,48
20,r_127_109_193,seq128,r_62_110_143,r_62_110_143,0.87,50,193,143,48
68,seq34,r_32_94_77,seq35,r_32_94_77,1,0,77,77,48
32,r_84_43_182,seq86,seq41,r_84_43_182,0.69,0,182,182,48
34,r_130_143_185,seq132,r_14_144_59,r_14_144_59,1,126,185,59,48
9,r_78_17_155,seq81,seq22,r_78_17_155,0.91,0,155,155,48
40,r_30_60_46,r_27_146_113,r_61_53_120,r_30_60_46,1,0,46,46,48
96,seq113,r_111_0_155,r_83_112_63,r_83_112_63,0.72,-1,62,63,48
28,r_125_68_126,seq123,seq69,r_125_68_126,0.96,0,126,126,48
91,seq90,r_93_20_195,r_44_85_149,r_93_20_195,0.63,-3,192,195,48
49,r_55_116_61,seq56,r_91_118_34,r_55_116_61,0.87,1,62,61,48
7,r_137_77_192,seq136,r_44_85_149,r_44_85_149,0.67,44,193,149,48
44,r_32_94_77,seq34,r_135_92_9,r_32_94_77,1,0,77,77,48
35,r_75_114_84,r_73_45_182,r_83_112_63,r_73_45_182,1,-98,84,182,48
12,r_42_19_148,seq41,seq22,r_42_19_148,0.62,0,148,148,48
23,r_65_15_13,seq21,r_107_16_163,r_107_16_163,0.95,1,164,163,48
84,seq69,r_108_67_6,r_125_68_126,r_125_68_126,1,36,162,126,48
30,r_42_138_78,seq41,seq140,r_42_138_78,0.96,0,78,78,49
36,r_63_131_114,seq64,r_28_134_108,r_63_131_114,0.96,0,114,114,49
9,r_8_103_76,r_102_122_91,r_135_104_167,r_135_104_167,0.82,2,169,167,49
8,r_144_0_18,r_145_1_138,r_20_74_34,r_144_0_18,0.47,1,19,18,49
11,r_145_1_138,r_26_147_31,r_75_10_97,r_145_1_138,0.79,0,138,138,49
54,seq11,r_3_45_157,r_75_10_97,r_75_10_97,0.95,44,141,97,49
23,r_83_24_29,seq82,seq25,r_83_24_29,0.98,2,31,29,49
3,r_60_137_8,r_136_73_145,r_34_143_119,r_60_137_8,0.97,137,145,8,49
43,r_9_62_14,r_13_58_175,seq57,r_9_62_14,0.95,0,14,14,49
21,r_135_104_167,r_136_73_145,r_60_137_8,r_135_104_167,0.63,-22,145,167,49
39,r_15_29_162,seq14,seq25,r_15_29_162,0.5,0,162,162,49
1,r_136_73_145,r_135_104_167,r_22_71_102,r_136_73_145,0.96,0,145,145,49
46,r_28_134_108,seq25,seq132,r_28_134_108,0.89,0,108,108,49
42,r_90_4_165,seq81,r_128_5_158,r_90_4_165,0.47,0,165,165,49
80,seq140,r_135_104_167,r_42_138_78,r_42_138_78,0.9,9,87,78,49
69,seq142,seq140,r_34_143_119,r_34_143_119,1,20,139,119,49
45,r_111_39_157,seq108,r_78_38_66,r_111_39_157,0.87,0,157,157,49
63,seq25,r_26_147_31,r_27_35_161,r_26_147_31,1,-8,23,31,49
15,r_54_33_23,r_32_70_102,seq31,r_32_70_102,1,0,102,102,49
11,r_145_1_138,seq148,r_26_147_31,r_26_147_31,0.81,78,109,31,49
76,seq64,r_63_131_114,seq48,r_63_131_114,1,-34,80,114,49
41,r_20_74_34,seq21,r_75_10_97,r_20_74_34,0.93,0,34,34,49
31,r_50_106_127,r_55_53_4,seq105,r_50_106_127,0.86,0,127,127,49
38,r_2_115_127,r_102_122_91,r_66_116_159,r_66_116_159,0.96,16,175,159,49
44,r_61_76_25,r_54_33_23,seq77,r_54_33_23,0.71,1,24,23,49
15,r_54_33_23,r_50_106_127,r_32_70_102,r_54_33_23,0.97,0,23,23,49
49,r_46_93_45,seq94,r_141_139_125,r_46_93_45,0.53,58,103,45,49
0,r_40_101_159,seq36,r_100_98_86,r_40_101_159,0.83,0,159,159,49
19,r_112_124_45,r_110_87_44,seq129,r_110_87_44,1,1,45,44,49
13,r_107_18_85,seq108,seq19,r_107_18_85,1,1,86,85,49
98,seq123,seq121,r_102_122_91,r_102_122_91,0.77,8,99,91,49
48,r_125_6_144,r_120_49_91,r_112_124_45,r_120_49_91,1,-8,83,91,49
12,r_114_79_144,r_102_122_91,seq88,r_114_79_144,0.98,0,144,144,49
18,r_26_147_31,seq25,r_145_1_138,r_26_147_31,0.94,0,31,31,49
6,r_22_71_102,seq23,r_32_70_102,r_22_71_102,0.99,0,102,102,49
10,r_32_70_102,r_54_33_23,r_22_71_102,r_32_70_102,1,0,102,102,49
37,r_30_43_52,seq25,seq41,r_30_43_52,1,0,52,52,49
27,r_91_113_83,seq92,seq108,r_91_113_83,1,0,83,83,49
11,r_145_1_138,r_144_0_18,seq148,r_144_0_18,0.98,0,18,18,49
49,r_46_93_45,r_47_84_96,seq94,r_46_93_45,0.91,0,45,45,49
41,r_20_74_34,r_75_10_97,seq64,r_20_74_34,0.72,63,97,34,49
47,r_120_49_91,seq121,seq48,r_120_49_91,1,0,91,91,49
40,r_66_116_159,seq65,r_2_115_127,r_66_116_159,0.62,0,159,159,49
29,r_47_84_96,seq48,seq85,r_47_84_96,0.7,9,105,96,49
24,r_7_146_174,r_3_45_157,r_125_6_144,r_7_146_174,0.37,-17,157,174,49
25,r_149_69_145,seq148,r_32_70_102,r_149_69_145,0.9,0,145,145,49
48,r_125_6_144,r_112_124_45,seq11,r_125_6_144,1,0,144,144,49
8,r_144_0_18,r_20_74_34,r_66_116_159,r_66_116_159,0.93,-122,37,159,49
70,seq48,r_47_84_96,r_120_49_91,r_120_49_91,1,14,105,91,49
24,r_7_146_174,r_125_6_144,seq148,r_7_146_174,0.76,1,175,174,49
20,r_75_10_97,r_72_109_150,r_20_74_34,r_20_74_34,1,4,38,34,49
38,r_2_115_127,r_3_45_157,r_102_122_91,r_2_115_127,0.9,0,127,127,49
8,r_144_0_18,r_66_116_159,r_47_84_96,r_144_0_18,0.51,92,110,18,49
60,seq148,r_149_69_145,r_26_147_31,r_26_147_31,0.53,114,145,31,49
41,r_20_74_34,seq64,r_22_71_102,r_20_74_34,0.68,85,119,34,49
21,r_135_104_167,r_60_137_8,r_8_103_76,r_135_104_167,0.96,0,167,167,49
10,r_32_70_102,seq31,r_54_33_23,r_54_33_23,0.93,12,35,23,49
17,r_72_109_150,r_75_10_97,r_20_74_34,r_72_109_150,0.9,-69,81,150,49
94,seq105,seq108,r_50_106_127,r_50_106_127,1,0,127,127,49
9,r_8_103_76,r_3_45_157,r_102_122_91,r_8_103_76,1,0,76,76,49
20,r_75_10_97,r_20_74_34,seq11,r_75_10_97,1,0,97,97,49
22,r_3_45_157,r_7_146_174,r_120_49_91,r_3_45_157,0.55,0,157,157,49
28,r_34_143_119,seq31,seq142,r_34_143_119,0.64,0,119,119,49
7,r_78_38_66,seq80,seq36,r_78_38_66,0.93,0,66,66,49
18,r_26_147_31,r_145_1_138,seq148,r_145_1_138,0.9,-19,119,138,49
17,r_72_109_150,r_20_74_34,seq108,r_72_109_150,0.93,0,150,150,49
35,r_27_35_161,seq25,r_78_38_66,r_27_35_161,0.82,1,162,161,49
12,r_114_79_144,r_120_49_91,r_102_122_91,r_120_49_91,0.98,-17,74,91,49
2,r_110_87_44,r_112_124_45,seq82,r_110_87_44,1,1,45,44,49
8,r_80_49_39,r_79_146_160,r_32_51_26,r_80_49_39,0.98,0,39,39,50
30,r_114_142_128,seq112,seq139,r_114_142_128,0.58,0,128,128,50
51,seq131,r_132_74_93,r_90_8_129,r_132_74_93,0.53,-3,90,93,50
43,r_102_147_171,seq100,r_11_145_137,r_11_145_137,0.68,34,171,137,50
37,r_48_120_122,r_32_51_26,seq122,r_48_120_122,1,0,122,122,50
59,seq14,seq16,r_149_15_125,r_149_15_125,1,1,126,125,50
62,seq148,r_66_144_5,r_11_145_137,r_11_145_137,0.81,0,137,137,50
86,seq95,r_90_8_129,r_41_96_67,r_41_96_67,0.71,13,80,67,50
21,r_84_78_126,seq63,r_103_85_71,r_103_85_71,1,8,79,71,50
1,r_33_55_168,seq31,r_60_56_114,r_33_55_168,0.6,0,168,168,50
46,r_107_44_194,r_114_142_128,r_101_106_54,r_107_44_194,0.66,-123,71,194,50
69,seq45,r_43_121_155,seq46,r_43_121_155,0.92,0,155,155,50
45,r_143_19_170,r_66_144_5,r_141_18_57,r_66_144_5,0.73,166,171,5,50
11,r_66_144_5,r_143_19_170,r_102_147_171,r_143_19_170,0.69,2,172,170,50
39,r_58_109_166,seq14,r_135_117_62,r_58_109_166,0.98,0,166,166,50
31,r_59_22_84,r_61_91_93,seq23,r_59_22_84,0.87,0,84,84,50
69,seq45,seq46,r_107_44_194,r_107_44_194,0.68,0,194,194,50
41,r_57_81_171,seq54,r_132_74_93,r_132_74_93,1,78,171,93,50
14,r_101_106_54,r_102_147_171,r_107_44_194,r_101_106_54,0.79,2,56,54,50
3,r_24_42_150,seq23,r_26_83_147,r_24_42_150,0.29,-18,132,150,50
10,r_86_118_57,seq119,r_135_117_62,r_135_117_62,0.71,57,119,62,50
20,r_123_108_59,r_124_126_145,seq110,r_123_108_59,0.77,0,59,59,50
26,r_11_145_137,seq14,seq148,r_11_145_137,0.56,0,137,137,50
16,r_141_18_57,seq23,r_143_19_170,r_143_19_170,0.82,24,194,170,50
4,r_128_116_36,r_127_27_108,r_135_117_62,r_127_27_108,0.62,-47,61,108,50
63,seq23,r_24_42_150,r_59_22_84,r_59_22_84,0.69,0,84,84,50
16,r_141_18_57,seq139,seq23,r_141_18_57,1,0,57,57,50
13,r_60_56_114,r_61_91_93,r_58_109_166,r_61_91_93,0.73,0,93,93,50
46,r_107_44_194,r_101_106_54,seq45,r_107_44_194,0.4,-1,193,194,50
36,r_35_3_20,r_32_51_26,seq4,r_35_3_20,0.89,0,20,20,50
6,r_61_91_93,r_60_56_114,seq93,r_61_91_93,1,0,93,93,50
48,r_20_73_22,seq30,r_24_42_150,r_24_42_150,0.52,-140,10,150,50
3,r_24_42_150,r_26_83_147,r_52_34_1,r_24_42_150,0.58,0,150,150,50
18,r_103_85_71,r_84_78_126,seq68,r_84_78_126,0.69,-1,125,126,50
47,r_75_12_158,seq62,r_132_74_93,r_132_74_93,1,4,97,93,50
9,r_132_74_93,r_75_12_158,seq63,r_132_74_93,0.62,36,129,93,50
40,r_134_50_164,seq137,r_32_51_26,r_134_50_164,0.67,0,164,164,50
18,r_103_85_71,r_114_142_128,r_84_78_126,r_103_85_71,1,0,71,71,50
29,r_1_89_97,seq2,r_21_87_23,r_1_89_97,0.95,0,97,97,50
26,r_11_145_137,seq148,r_79_146_160,r_79_146_160,0.81,5,165,160,50
33,r_135_117_62,r_134_50_164,r_128_116_36,r_135_117_62,0.78,0,62,62,50
42,r_79_146_160,r_80_49_39,r_20_73_22,r_79_146_160,0.92,-122,38,160,50
47,r_75_12_158,r_132_74_93,seq5,r_75_12_158,0.87,0,158,158,50
48,r_20_73_22,r_24_42_150,seq67,r_20_73_22,0.96,0,22,22,50
19,r_82_29_15,r_80_49_39,seq30,r_82_29_15,0.86,-1,14,15,50
49,r_115_133_42,r_114_142_128,seq137,r_115_133_42,0.66,0,42,42,50
14,r_101_106_54,r_107_44_194,r_135_117_62,r_107_44_194,0.8,-100,94,194,50
42,r_79_146_160,r_20_73_22,r_11_145_137,r_20_73_22,0.65,138,160,22,50
32,r_25_76_153,seq23,seq63,r_25_76_153,0.71,0,153,153,50
0,r_32_51_26,r_33_55_168,r_80_49_39,r_32_51_26,0.93,13,39,26,50
34,r_90_8_129,seq88,seq10,r_90_8_129,0.86,0,129,129,50
24,r_65_37_25,r_64_129_129,seq38,r_65_37_25,0.85,0,25,25,50
25,r_21_87_23,r_26_83_147,seq95,r_21_87_23,0.97,0,23,23,50
17,r_127_27_108,seq119,seq28,r_127_27_108,1,-1,107,108,50
25,r_21_87_23,seq95,r_1_89_97,r_1_89_97,1,8,105,97,50
9,r_132_74_93,seq131,r_75_12_158,r_132_74_93,0.97,0,93,93,50
13,r_60_56_114,r_58_109_166,seq54,r_58_109_166,0.75,-49,117,166,50
27,r_92_140_28,seq93,seq139,r_92_140_28,0.59,0,28,28,50
22,r_124_126_145,seq119,r_135_117_62,r_135_117_62,0.96,80,142,62,50
28,r_40_130_99,seq31,seq131,r_40_130_99,1,1,100,99,50
21,r_84_78_126,r_103_85_71,seq63,r_84_78_126,0.86,0,126,126,50
7,r_136_94_136,seq137,seq93,r_136_94_136,0.54,-2,134,136,50
23,r_149_15_125,seq148,seq14,r_149_15_125,1,0,125,125,50
58,seq139,r_141_18_57,r_92_140_28,r_141_18_57,1,0,57,57,50
12,r_64_129_129,seq67,seq137,r_64_129_129,0.71,-1,128,129,50
93,seq99,r_98_33_123,seq97,r_98_33_123,1,0,123,123,51
12,r_70_29_47,seq69,seq30,r_70_29_47,1,0,47,47,51
17,r_113_5_29,r_110_67_42,seq16,r_113_5_29,0.49,0,29,29,51
92,seq97,r_98_33_123,seq92,r_98_33_123,1,-37,86,123,51
14,r_35_101_137,seq37,seq97,r_35_101_137,0.99,0,137,137,51
18,r_121_9_44,r_124_28_153,seq6,r_121_9_44,1,0,44,44,51
43,r_7_105_108,seq6,r_43_104_54,r_7_105_108,1,0,108,108,51
3,r_107_60_54,r_61_149_162,r_108_62_157,r_107_60_54,0.81,107,161,54,51
21,r_115_47_190,r_112_136_103,r_132_117_20,r_115_47_190,0.73,-120,70,190,51
39,r_140_145_169,r_141_111_175,r_91_130_11,r_140_145_169,0.52,2,171,169,51
1,r_98_33_123,seq99,seq32,r_98_33_123,0.98,0,123,123,51
5,r_141_111_175,r_140_145_169,r_23_114_106,r_23_114_106,1,65,171,106,51
46,r_3_64_68,seq2,seq63,r_3_64_68,1,0,68,68,51
42,r_103_122_163,r_106_123_187,r_38_120_21,r_38_120_21,1,143,164,21,51
32,r_82_53_72,r_95_83_7,seq54,r_82_53_72,1,0,72,72,51
7,r_110_67_42,r_66_142_135,seq69,r_66_142_135,0.93,0,135,135,51
45,r_95_83_7,r_82_53_72,seq85,r_82_53_72,1,-5,67,72,51
30,r_132_117_20,r_131_11_60,seq116,r_131_11_60,0.61,-39,21,60,51
19,r_100_87_66,r_98_33_123,seq85,r_100_87_66,1,0,66,66,51
23,r_66_142_135,seq69,r_110_67_42,r_110_67_42,1,9,51,42,51
22,r_38_120_21,r_41_21_162,seq125,r_38_120_21,0.97,-2,19,21,51
66,seq34,r_35_101_137,seq37,r_35_101_137,0.77,-7,130,137,51
94,seq147,r_124_28_153,r_103_122_163,r_103_122_163,0.44,-115,48,163,51
38,r_61_149_162,r_107_60_54,seq147,r_61_149_162,1,0,162,162,51
29,r_108_62_157,r_107_60_54,r_106_123_187,r_107_60_54,1,0,54,54,51
31,r_40_48_89,r_41_21_162,seq45,r_40_48_89,0.99,0,89,89,51
33,r_106_123_187,r_43_104_54,r_38_120_21,r_38_120_21,0.42,164,185,21,51
67,seq37,r_36_8_71,r_35_101_137,r_36_8_71,1,0,71,71,51
90,seq92,r_93_20_90,seq97,r_93_20_90,1,0,90,90,51
36,r_89_50_15,seq85,r_55_51_104,r_89_50_15,0.96,1,16,15,51
67,seq37,r_35_101_137,seq34,r_35_101_137,1,-7,130,137,51
4,r_41_21_162,seq39,seq18,r_41_21_162,0.84,0,162,162,51
0,r_131_11_60,r_126_76_187,r_121_9_44,r_131_11_60,0.99,0,60,60,51
63,seq30,r_27_148_167,r_70_29_47,r_70_29_47,0.9,31,78,47,51
11,r_129_135_97,r_126_76_187,r_112_136_103,r_112_136_103,0.89,0,103,103,51
13,r_44_10_161,seq49,r_131_11_60,r_44_10_161,0.54,0,161,161,51
15,r_23_114_106,seq24,r_132_117_20,r_23_114_106,0.98,0,106,106,51
6,r_126_76_187,seq133,r_81_78_177,r_81_78_177,0.91,10,187,177,51
36,r_89_50_15,r_55_51_104,seq42,r_55_51_104,0.37,9,113,104,51
32,r_82_53_72,r_84_143_125,r_95_83_7,r_95_83_7,0.7,5,12,7,51
24,r_26_80_24,r_23_114_106,r_81_78_177,r_26_80_24,1,0,24,24,51
16,r_59_77_17,seq58,r_81_78_177,r_59_77_17,1,0,17,17,51
2,r_84_143_125,seq88,r_140_145_169,r_84_143_125,0.75,0,125,125,51
41,r_43_104_54,r_103_122_163,r_7_105_108,r_7_105_108,1,29,137,108,51
40,r_102_68_188,seq99,r_110_67_42,r_110_67_42,0.79,146,188,42,51
34,r_144_109_32,r_112_136_103,r_132_117_20,r_112_136_103,0.97,0,103,103,51
25,r_93_20_90,seq92,seq18,r_93_20_90,1,0,90,90,51
33,r_106_123_187,r_103_122_163,r_43_104_54,r_43_104_54,1,83,137,54,51
3,r_107_60_54,r_108_62_157,r_61_149_162,r_107_60_54,1,0,54,54,51
28,r_14_139_34,seq13,seq137,r_14_139_34,0.94,0,34,34,51
38,r_61_149_162,seq65,r_107_60_54,r_107_60_54,1,19,73,54,51
27,r_146_46_55,seq147,seq45,r_146_46_55,1,0,55,55,51
7,r_110_67_42,r_112_136_103,r_66_142_135,r_110_67_42,0.97,1,43,42,51
9,r_112_136_103,r_115_47_190,r_4_138_60,r_4_138_60,0.92,43,103,60,51
34,r_144_109_32,seq137,r_112_136_103,r_144_109_32,0.93,0,32,32,51
29,r_108_62_157,r_106_123_187,r_107_60_54,r_108_62_157,0.47,0,157,157,51
44,r_36_8_71,seq37,r_121_9_44,r_36_8_71,0.99,0,71,71,51
55,seq137,r_144_109_32,r_14_139_34,r_14_139_34,0.51,-2,32,34,51
41,r_43_104_54,r_44_10_161,r_103_122_163,r_43_104_54,0.95,0,54,54,51
23,r_66_142_135,r_110_67_42,r_84_143_125,r_66_142_135,0.52,0,135,135,51
13,r_116_65_18,r_114_148_135,seq59,r_116_65_18,1,0,18,18,52
36,r_11_84_81,r_10_19_178,seq85,r_11_84_81,0.96,0,81,81,52
3,r_25_49_42,seq48,r_82_50_72,r_82_50_72,0.99,3,75,72,52
57,seq144,r_119_112_122,r_71_138_40,r_71_138_40,0.94,13,53,40,52
54,seq135,r_123_83_109,r_71_138_40,r_71_138_40,0.97,15,55,40,52
8,r_82_50_72,seq85,r_25_49_42,r_82_50_72,0.99,0,72,72,52
37,r_95_127_182,seq94,r_52_133_88,r_52_133_88,0.76,92,180,88,52
26,r_71_138_40,r_74_15_199,seq140,r_71_138_40,0.78,0,40,40,52
82,seq88,r_89_29_26,seq87,r_89_29_26,1,0,26,26,52
21,r_70_129_92,r_69_62_92,seq125,r_70_129_92,0.92,0,92,92,52
46,r_123_83_109,seq122,r_11_84_81,r_123_83_109,1,0,109,109,52
42,r_61_111_76,r_60_77_118,seq117,r_61_111_76,1,0,76,76,52
80,seq85,seq80,r_11_84_81,r_11_84_81,1,8,89,81,52
45,r_12_6_55,r_9_108_198,r_8_7_6,r_9_108_198,0.68,-143,55,198,52
95,seq117,r_109_134_178,r_37_110_133,r_37_110_133,0.93,41,174,133,52
31,r_20_68_159,seq18,r_74_15_199,r_74_15_199,0.63,-43,156,199,52
41,r_22_75_175,seq21,seq76,r_22_75_175,0.5,0,175,175,52
26,r_71_138_40,seq140,r_90_139_57,r_90_139_57,0.65,3,60,57,52
44,r_79_17_146,r_60_77_118,seq18,r_79_17_146,0.9,0,146,146,52
30,r_67_91_20,r_69_62_92,seq92,r_67_91_20,0.89,0,20,20,52
43,r_51_131_29,r_60_77_118,r_126_132_109,r_51_131_29,0.7,0,29,29,52
73,seq54,r_53_137_133,r_136_57_8,r_53_137_133,0.58,0,133,133,52
11,r_69_62_92,r_70_129_92,r_73_63_29,r_70_129_92,1,0,92,92,52
28,r_89_29_26,seq88,seq30,r_89_29_26,0.99,0,26,26,52
47,r_32_44_85,seq30,seq43,r_32_44_85,0.99,0,85,85,52
48,r_73_63_29,r_74_15_199,r_116_65_18,r_73_63_29,0.68,0,29,29,52
15,r_78_34_136,r_79_17_146,seq33,r_78_34_136,0.79,0,136,136,52
57,seq144,r_71_138_40,r_70_129_92,r_70_129_92,0.93,15,107,92,52
27,r_146_120_142,seq149,r_70_129_92,r_70_129_92,0.85,50,142,92,52
4,r_36_86_165,seq41,r_16_81_4,r_36_86_165,0.98,0,165,165,52
87,seq98,r_99_38_183,seq97,r_99_38_183,0.87,0,183,183,52
54,seq135,r_71_138_40,seq121,r_71_138_40,0.6,59,99,40,52
2,r_37_110_133,seq41,r_61_111_76,r_37_110_133,0.67,0,133,133,52
24,r_106_147_61,r_114_148_135,seq149,r_106_147_61,0.9,4,65,61,52
25,r_10_19_178,seq14,seq18,r_10_19_178,0.44,0,178,178,52
38,r_60_77_118,seq59,seq80,r_60_77_118,0.91,0,118,118,52
34,r_27_124_80,seq30,seq122,r_27_124_80,1,0,80,80,52
32,r_24_130_36,r_25_49_42,r_51_131_29,r_24_130_36,1,0,36,36,52
5,r_90_139_57,seq92,r_71_138_40,r_90_139_57,0.93,0,57,57,52
9,r_109_134_178,seq117,r_90_139_57,r_90_139_57,0.93,131,188,57,52
33,r_143_145_27,r_142_28_200,seq149,r_142_28_200,0.91,-172,28,200,52
29,r_47_66_112,r_74_15_199,r_69_62_92,r_47_66_112,0.42,64,176,112,52
22,r_118_141_87,r_114_148_135,seq140,r_118_141_87,0.85,0,87,87,52
54,seq135,seq121,r_109_134_178,r_109_134_178,0.69,-3,175,178,52
49,r_119_112_122,seq122,r_61_111_76,r_61_111_76,0.92,46,122,76,52
56,seq14,r_10_19_178,r_3_13_64,r_10_19_178,0.63,-77,101,178,52
7,r_99_38_183,seq98,r_78_34_136,r_99_38_183,0.42,0,183,183,52
44,r_79_17_146,r_78_34_136,r_60_77_118,r_60_77_118,0.5,18,136,118,52
23,r_58_93_78,r_60_77_118,seq92,r_58_93_78,1,0,78,78,52
20,r_136_57_8,seq135,seq55,r_136_57_8,0.41,2,10,8,52
19,r_64_102_40,r_60_77_118,seq100,r_64_102_40,0.99,0,40,40,52
3,r_25_49_42,r_22_75_175,seq48,r_25_49_42,0.95,0,42,42,52
72,seq48,r_82_50_72,r_25_49_42,r_25_49_42,1,-5,37,42,52
43,r_51_131_29,r_126_132_109,r_24_130_36,r_24_130_36,0.84,3,39,36,52
31,r_20_68_159,r_74_15_199,r_16_81_4,r_16_81_4,0.77,178,182,4,52
30,r_52_143_72,r_56_19_177,seq144,r_52_143_72,1,0,72,72,53
44,r_47_17_173,r_21_48_13,r_53_16_21,r_21_48_13,0.53,161,174,13,53
51,seq128,r_115_89_186,r_33_92_74,r_33_92_74,1,13,87,74,53
36,r_97_79_108,r_95_122_131,r_34_80_107,r_97_79_108,0.98,0,108,108,53
44,r_47_17_173,seq46,r_21_48_13,r_21_48_13,1,0,13,13,53
14,r_120_141_110,seq118,r_52_143_72,r_120_141_110,0.9,0,110,110,53
43,r_132_37_71,seq131,seq38,r_132_37_71,0.94,0,71,71,53
17,r_43_111_169,r_47_17_173,r_90_42_22,r_90_42_22,1,0,22,22,53
86,seq94,r_95_122_131,r_33_92_74,r_33_92_74,1,8,82,74,53
16,r_72_100_140,r_70_45_197,r_7_98_52,r_72_100_140,0.94,0,140,140,53
39,r_147_41_109,r_149_102_123,r_90_42_22,r_147_41_109,0.99,0,109,109,53
40,r_36_67_81,r_68_35_48,seq69,r_36_67_81,0.98,0,81,81,53
1,r_70_45_197,r_72_100_140,r_97_79_108,r_70_45_197,0.95,-57,140,197,53
5,r_84_31_127,r_88_32_201,seq26,r_88_32_201,0.49,-74,127,201,53
46,r_34_80_107,r_33_92_74,seq26,r_33_92_74,0.96,-10,64,74,53
42,r_88_32_201,r_87_24_126,seq83,r_87_24_126,0.97,2,128,126,53
69,seq39,r_40_25_156,r_132_37_71,r_132_37_71,0.81,86,157,71,53
10,r_68_35_48,seq69,r_36_67_81,r_68_35_48,0.9,0,48,48,53
34,r_149_102_123,r_148_119_53,r_147_41_109,r_148_119_53,0.89,-24,29,53,53
12,r_90_42_22,r_87_24_126,r_43_111_169,r_90_42_22,0.89,1,23,22,53
19,r_77_93_146,seq76,seq94,r_77_93_146,0.87,0,146,146,53
15,r_108_133_173,r_78_107_69,r_29_134_78,r_108_133_173,0.71,5,178,173,53
40,r_36_67_81,r_34_80_107,r_68_35_48,r_68_35_48,0.81,8,56,48,53
66,seq28,seq30,r_2_27_109,r_2_27_109,1,34,143,109,53
31,r_29_134_78,seq30,seq130,r_29_134_78,1,0,78,78,53
67,seq30,r_29_134_78,seq28,r_29_134_78,1,-8,70,78,53
89,seq103,r_101_4_156,seq104,r_101_4_156,0.94,-50,106,156,53
41,r_21_48_13,r_20_55_20,r_47_17_173,r_47_17_173,0.98,-160,13,173,53
3,r_81_127_149,seq82,seq104,r_81_127_149,0.85,0,149,149,53
49,r_125_73_49,seq126,seq82,r_125_73_49,1,0,49,49,53
26,r_136_44_155,seq137,seq46,r_136_44_155,0.77,0,155,155,53
37,r_64_113_19,r_63_129_85,r_115_89_186,r_64_113_19,0.91,0,19,19,53
4,r_142_1_108,seq144,seq3,r_142_1_108,0.97,0,108,108,53
0,r_50_123_128,seq51,seq124,r_50_123_128,1,0,128,128,53
11,r_91_8_152,r_88_32_201,seq6,r_91_8_152,0.71,0,152,152,53
20,r_63_129_85,seq65,seq130,r_63_129_85,0.97,0,85,85,53
15,r_108_133_173,seq116,r_78_107_69,r_78_107_69,1,-1,68,69,53
48,r_74_140_98,r_77_93_146,seq137,r_74_140_98,0.99,0,98,98,53
53,seq3,r_142_1_108,r_101_4_156,r_101_4_156,1,2,158,156,53
12,r_90_42_22,r_43_111_169,r_147_41_109,r_147_41_109,0.84,45,154,109,53
10,r_68_35_48,r_36_67_81,seq28,r_36_67_81,0.98,0,81,81,53
27,r_139_106_113,r_136_44_155,r_78_107_69,r_139_106_113,0.92,0,113,113,53
51,seq128,seq99,r_81_127_149,r_81_127_149,0.76,19,168,149,53
87,seq96,r_95_122_131,seq104,r_95_122_131,0.76,-1,130,131,53
22,r_78_107_69,r_108_133_173,r_139_106_113,r_139_106_113,0.6,65,178,113,53
2,r_18_62_93,seq13,seq60,r_18_62_93,0.89,0,93,93,53
41,r_21_48_13,r_47_17_173,r_136_44_155,r_21_48_13,0.6,161,174,13,53
47,r_101_4_156,seq99,seq3,r_101_4_156,0.66,0,156,156,53
46,r_34_80_107,seq26,seq75,r_34_80_107,1,0,107,107,53
34,r_149_102_123,r_147_41_109,r_85_145_2,r_147_41_109,0.86,1,110,109,53
25,r_56_19_177,seq54,r_53_16_21,r_53_16_21,0.62,157,178,21,53
33,r_71_146_121,r_72_100_140,r_120_141_110,r_71_146_121,0.97,1,122,121,53
6,r_148_119_53,r_149_102_123,seq118,r_148_119_53,0.96,0,53,53,53
51,seq128,r_33_92_74,seq99,r_33_92_74,0.39,62,136,74,53
68,seq38,r_40_25_156,r_132_37_71,r_132_37_71,0.93,7,78,71,53
38,r_33_92_74,r_34_80_107,seq94,r_33_92_74,1,0,74,74,53
29,r_7_98_52,seq6,seq99,r_7_98_52,1,0,52,52,53
7,r_53_16_21,r_56_19_177,seq13,r_53_16_21,1,0,21,21,53
93,seq116,r_108_133_173,r_64_113_19,r_64_113_19,0.99,3,22,19,53
34,r_149_102_123,r_85_145_2,r_7_98_52,r_149_102_123,0.54,0,123,123,53
9,r_95_122_131,seq96,r_50_123_128,r_50_123_128,0.79,3,131,128,53
37,r_64_113_19,r_115_89_186,seq116,r_115_89_186,0.83,-38,148,186,53
22,r_78_107_69,r_77_93_146,r_108_133_173,r_78_107_69,1,0,69,69,53
28,r_87_24_126,r_88_32_201,r_68_35_48,r_88_32_201,0.63,-74,127,201,53
23,r_2_27_109,seq3,seq28,r_2_27_109,1,1,110,109,53
17,r_43_111_169,r_90_42_22,r_86_110_9,r_43_111_169,0.71,0,169,169,53
88,seq99,r_101_4_156,r_7_98_52,r_7_98_52,1,0,52,52,53
35,r_40_25_156,seq39,seq26,r_40_25_156,0.81,1,157,156,53
36,r_3_77_159,seq2,r_145_78_52,r_3_77_159,0.66,0,159,159,54
8,r_148_99_85,seq149,seq105,r_148_99_85,0.86,-1,84,85,54
53,seq6,r_1_5_127,r_50_7_70,r_50_7_70,1,0,70,70,54
43,r_62_31_174,seq66,r_4_34_41,r_4_34_41,0.87,133,174,41,54
22,r_85_135_59,r_86_83_166,seq138,r_85_135_59,1,0,59,59,54
19,r_55_63_32,r_62_31_174,r_44_64_62,r_44_64_62,0.75,35,97,62,54
71,seq53,r_54_131_168,r_26_52_54,r_26_52_54,0.64,114,168,54,54
16,r_43_13_107,seq37,seq14,r_43_13_107,0.97,0,107,107,54
1,r_71_9_88,r_76_140_131,seq10,r_71_9_88,1,0,88,88,54
97,seq122,r_121_141_117,r_17_123_68,r_17_123_68,1,50,118,68,54
5,r_17_123_68,seq21,seq122,r_17_123_68,1,0,68,68,54
42,r_115_113_196,seq119,r_15_120_116,r_15_120_116,1,0,116,116,54
11,r_28_41_6,r_43_13_107,r_100_42_28,r_100_42_28,0.93,5,33,28,54
32,r_59_29_140,r_35_58_52,r_30_20_169,r_59_29_140,0.88,0,140,140,54
47,r_132_127_119,r_128_61_193,r_139_124_83,r_128_61_193,0.53,-33,160,193,54
31,r_4_34_41,r_1_5_127,seq33,r_4_34_41,1,1,42,41,54
95,seq117,r_118_137_62,seq119,r_118_137_62,1,1,63,62,54
37,r_106_142_24,seq93,seq147,r_106_142_24,0.88,1,25,24,54
29,r_73_95_16,r_71_9_88,seq96,r_73_95_16,1,0,16,16,54
3,r_121_141_117,seq122,r_106_142_24,r_121_141_117,0.54,1,118,117,54
26,r_74_108_161,r_75_116_182,r_130_109_31,r_74_108_161,0.6,0,161,161,54
0,r_118_137_62,seq117,seq138,r_118_137_62,0.98,0,62,62,54
38,r_68_32_54,r_59_29_140,r_4_34_41,r_68_32_54,0.67,1,55,54,54
20,r_11_67_188,r_1_5_127,seq12,r_1_5_127,0.69,-29,98,127,54
98,seq126,r_125_88_183,r_139_124_83,r_139_124_83,0.7,106,189,83,54
46,r_86_83_166,seq84,r_69_87_145,r_69_87_145,0.92,4,149,145,54
10,r_100_42_28,seq102,r_28_41_6,r_100_42_28,0.99,0,28,28,54
15,r_65_49_63,r_59_29_140,seq47,r_65_49_63,0.99,0,63,63,54
48,r_75_116_182,r_74_108_161,r_145_78_52,r_145_78_52,0.72,108,160,52,54
49,r_35_58_52,r_59_29_140,r_55_63_32,r_59_29_140,0.98,0,140,140,54
6,r_128_61_193,r_148_99_85,seq122,r_148_99_85,0.87,-19,66,85,54
4,r_145_78_52,seq147,seq79,r_145_78_52,0.99,0,52,52,54
17,r_16_19_44,r_15_120_116,seq18,r_16_19_44,1,0,44,44,54
27,r_125_88_183,seq126,r_73_95_16,r_73_95_16,0.77,166,182,16,54
87,seq102,seq105,r_23_103_93,r_23_103_93,1,3,96,93,54
9,r_26_52_54,seq21,seq53,r_26_52_54,0.97,-1,53,54,54
21,r_129_25_29,r_128_61_193,seq24,r_129_25_29,0.98,0,29,29,54
2,r_139_124_83,seq149,seq126,r_139_124_83,0.69,-2,81,83,54
47,r_132_127_119,seq133,r_128_61_193,r_132_127_119,0.42,4,123,119,54
18,r_81_39_190,seq82,r_100_42_28,r_100_42_28,0.99,162,190,28,54
24,r_76_140_131,r_75_116_182,r_106_142_24,r_76_140_131,0.79,0,131,131,54
25,r_30_20_169,r_27_92_132,r_4_34_41,r_30_20_169,0.63,-36,133,169,54
33,r_23_103_93,seq24,seq102,r_23_103_93,0.99,0,93,93,54
70,seq51,r_54_131_168,r_81_39_190,r_54_131_168,0.48,-88,80,168,54
6,r_128_61_193,seq122,r_132_127_119,r_128_61_193,0.53,-65,128,193,54
32,r_59_29_140,r_62_31_174,r_35_58_52,r_35_58_52,1,14,66,52,54
34,r_50_7_70,r_48_143_132,seq6,r_50_7_70,1,0,70,70,54
45,r_15_120_116,seq12,seq117,r_15_120_116,1,0,116,116,54
81,seq84,r_86_83_166,r_69_87_145,r_69_87_145,0.9,7,152,145,54
46,r_86_83_166,r_85_135_59,seq84,r_85_135_59,1,0,59,59,54
28,r_44_64_62,seq45,r_55_63_32,r_44_64_62,0.94,1,63,62,54
49,r_35_58_52,seq36,r_59_29_140,r_35_58_52,0.98,0,52,52,54
44,r_60_38_44,r_59_29_140,r_100_42_28,r_60_38_44,0.8,0,44,44,54
25,r_30_20_169,r_4_34_41,r_16_19_44,r_30_20_169,0.66,0,169,169,54
7,r_8_72_134,seq10,r_35_58_52,r_8_72_134,0.79,0,134,134,54
41,r_130_109_31,r_114_136_9,seq110,r_130_109_31,0.93,0,31,31,54
23,r_48_143_132,seq47,r_106_142_24,r_48_143_132,0.94,0,132,132,54
48,r_75_116_182,r_145_78_52,r_15_120_116,r_75_116_182,0.63,0,182,182,54
19,r_55_63_32,seq56,r_62_31_174,r_55_63_32,0.72,0,32,32,54
35,r_27_92_132,r_30_20_169,seq89,r_27_92_132,0.82,0,132,132,54
12,r_54_131_168,seq53,r_121_141_117,r_54_131_168,0.51,0,168,168,54
45,r_15_120_116,r_16_19_44,seq12,r_16_19_44,1,0,44,44,54
30,r_88_112_180,seq92,r_134_110_118,r_88_112_180,0.44,0,180,180,55
6,r_16_129_32,r_17_10_108,seq130,r_16_129_32,1,0,32,32,55
14,r_144_33_158,seq145,r_36_34_116,r_144_33_158,0.84,0,158,158,55
43,r_26_43_186,seq29,r_144_33_158,r_144_33_158,1,27,185,158,55
19,r_132_114_173,r_111_133_38,r_28_113_63,r_132_114_173,0.7,0,173,173,55
10,r_85_143_110,seq84,seq145,r_85_143_110,1,0,110,110,55
55,seq138,r_137_83_193,r_76_139_94,r_76_139_94,1,98,192,94,55
16,r_131_27_135,r_137_83_193,seq29,r_131_27_135,0.99,0,135,135,55
21,r_134_110_118,r_137_83_193,seq109,r_134_110_118,1,0,118,118,55
1,r_44_124_80,seq41,seq125,r_44_124_80,1,0,80,80,55
46,r_76_139_94,seq75,seq138,r_76_139_94,1,0,94,94,55
10,r_85_143_110,r_86_59_46,seq84,r_86_59_46,0.97,11,57,46,55
36,r_111_133_38,seq107,r_132_114_173,r_111_133_38,0.99,0,38,38,55
19,r_132_114_173,r_131_27_135,r_111_133_38,r_111_133_38,0.86,45,83,38,55
15,r_11_60_59,r_12_13_126,seq58,r_11_60_59,1,0,59,59,55
41,r_119_71_146,seq118,r_54_70_78,r_119_71_146,0.76,0,146,146,55
67,seq37,r_36_34_116,r_135_47_68,r_135_47_68,1,49,117,68,55
17,r_122_61_177,r_102_121_131,seq64,r_122_61_177,0.58,1,178,177,55
4,r_28_113_63,seq29,seq118,r_28_113_63,0.97,0,63,63,55
0,r_46_53_69,seq45,r_97_52_3,r_97_52_3,0.83,68,71,3,55
20,r_73_20_98,r_77_90_157,r_120_21_18,r_77_90_157,0.86,-59,98,157,55
13,r_30_55_139,seq32,r_46_53_69,r_30_55_139,0.6,0,139,139,55
48,r_67_72_39,r_69_31_185,r_54_70_78,r_54_70_78,1,107,185,78,55
8,r_86_59_46,r_85_143_110,seq58,r_85_143_110,1,-57,53,110,55
57,seq130,seq126,r_16_129_32,r_16_129_32,1,42,74,32,55
99,seq126,seq130,r_123_127_71,r_123_127_71,0.52,3,74,71,55
36,r_111_133_38,r_132_114_173,r_79_136_34,r_132_114_173,0.91,0,173,173,55
27,r_54_70_78,seq56,r_67_72_39,r_54_70_78,1,0,78,78,55
26,r_1_89_16,seq2,seq92,r_1_89_16,0.97,-1,15,16,55
47,r_17_10_108,seq18,r_38_8_21,r_17_10_108,0.87,2,110,108,55
3,r_105_4_28,r_111_133_38,seq5,r_105_4_28,1,0,28,28,55
34,r_38_8_21,r_39_116_107,r_12_13_126,r_38_8_21,0.83,-2,19,21,55
40,r_135_47_68,r_134_110_118,seq45,r_135_47_68,1,1,69,68,55
45,r_120_21_18,r_123_127_71,seq23,r_120_21_18,0.91,-1,17,18,55
52,seq5,seq7,r_105_4_28,r_105_4_28,1,1,29,28,55
25,r_36_34_116,seq37,r_135_47_68,r_135_47_68,1,55,123,68,55
70,seq45,r_46_53_69,r_135_47_68,r_135_47_68,1,3,71,68,55
38,r_102_121_131,seq100,r_39_116_107,r_39_116_107,0.54,24,131,107,55
28,r_65_48_44,r_66_80_66,seq49,r_65_48_44,1,1,45,44,55
17,r_122_61_177,seq118,r_102_121_131,r_102_121_131,0.97,4,135,131,55
9,r_123_127_71,r_122_61_177,seq126,r_122_61_177,0.62,-105,72,177,55
28,r_65_48_44,seq49,r_144_33_158,r_144_33_158,0.87,17,175,158,55
22,r_63_35_186,r_62_40_191,r_144_33_158,r_144_33_158,0.68,28,186,158,55
34,r_38_8_21,r_12_13_126,r_22_9_46,r_22_9_46,0.94,11,57,46,55
49,r_69_31_185,r_67_72_39,seq32,r_69_31_185,0.27,0,185,185,55
23,r_39_116_107,seq41,seq118,r_39_116_107,0.98,0,107,107,55
7,r_142_146_32,seq141,seq145,r_142_146_32,1,0,32,32,55
82,seq84,r_85_143_110,r_1_89_16,r_85_143_110,1,-2,108,110,55
35,r_93_128_170,seq94,r_16_129_32,r_93_128_170,0.72,0,170,170,55
5,r_79_136_34,r_77_90_157,seq138,r_79_136_34,1,0,34,34,55
93,seq114,r_121_13_152,r_101_115_78,r_101_115_78,0.72,38,116,78,56
64,seq31,r_26_92_46,r_35_29_43,r_26_92_46,0.88,-3,43,46,56
83,seq83,r_84_2_181,r_85_57_196,r_84_2_181,0.86,-20,161,181,56
55,seq139,r_137_37_145,r_94_138_64,r_94_138_64,0.92,14,78,64,56
16,r_54_1_41,seq53,r_10_82_146,r_54_1_41,0.56,0,41,41,56
21,r_60_4_148,r_71_61_20,seq3,r_60_4_148,0.95,0,148,148,56
39,r_16_132_173,r_15_30_103,r_14_25_151,r_16_132_173,0.53,-43,130,173,56
1,r_24_0_108,r_21_129_131,r_54_1_41,r_24_0_108,0.52,0,108,108,56
5,r_94_138_64,seq95,seq139,r_94_138_64,1,0,64,64,56
42,r_20_122_164,seq22,seq133,r_20_122_164,0.79,0,164,164,56
63,seq22,r_24_0_108,r_76_23_20,r_76_23_20,1,3,23,20,56
19,r_67_118_159,r_66_69_20,r_101_115_78,r_101_115_78,0.63,84,162,78,56
40,r_137_37_145,r_140_106_179,r_73_41_131,r_137_37_145,0.97,0,145,145,56
22,r_26_92_46,r_15_30_103,seq95,r_26_92_46,0.95,0,46,46,56
49,r_8_56_53,seq5,seq58,r_8_56_53,1,0,53,53,56
95,seq117,r_120_17_155,seq114,r_120_17_155,0.97,0,155,155,56
76,seq58,r_71_61_20,r_8_56_53,r_8_56_53,1,27,80,53,56
15,r_64_19_74,r_65_81_55,r_62_34_120,r_65_81_55,0.93,4,59,55,56
7,r_65_81_55,r_64_19_74,r_52_80_1,r_64_19_74,1,-15,59,74,56
41,r_109_98_144,seq110,seq99,r_109_98_144,0.88,0,144,144,56
67,seq36,r_39_48_164,r_11_44_55,r_39_48_164,0.48,-45,119,164,56
3,r_9_72_179,seq12,r_66_69_20,r_66_69_20,0.54,159,179,20,56
90,seq99,r_97_116_173,r_109_98_144,r_109_98_144,0.85,29,173,144,56
16,r_54_1_41,r_10_82_146,r_24_0_108,r_54_1_41,0.94,71,112,41,56
4,r_10_82_146,seq12,r_85_57_196,r_10_82_146,0.83,0,146,146,56
0,r_107_70_103,r_108_103_119,r_66_69_20,r_107_70_103,1,0,103,103,56
11,r_52_80_1,r_84_2_181,r_65_81_55,r_52_80_1,0.7,62,63,1,56
46,r_35_29_43,seq36,seq31,r_35_29_43,0.77,0,43,43,56
20,r_73_41_131,seq78,seq38,r_73_41_131,0.99,0,131,131,56
48,r_18_28_65,r_20_122_164,seq31,r_18_28_65,0.87,5,70,65,56
27,r_21_129_131,seq22,r_135_128_41,r_21_129_131,0.99,0,131,131,56
15,r_64_19_74,r_62_34_120,r_76_23_20,r_64_19_74,0.59,0,74,74,56
47,r_108_103_119,r_107_70_103,r_86_105_67,r_86_105_67,0.97,31,98,67,56
47,r_108_103_119,r_86_105_67,seq95,r_108_103_119,0.99,0,119,119,56
18,r_33_59_3,r_71_61_20,r_8_56_53,r_8_56_53,1,54,107,53,56
29,r_119_27_104,r_121_13_152,r_15_30_103,r_119_27_104,0.98,0,104,104,56
24,r_90_100_61,seq89,seq95,r_90_100_61,0.99,0,61,61,56
39,r_16_132_173,r_14_25_151,r_112_130_174,r_16_132_173,1,0,173,173,56
65,seq32,r_39_48_164,r_62_34_120,r_62_34_120,0.94,1,121,120,56
36,r_101_115_78,r_102_104_133,r_121_13_152,r_101_115_78,0.82,1,79,78,56
68,seq38,r_39_48_164,r_11_44_55,r_11_44_55,1,100,155,55,56
29,r_119_27_104,r_15_30_103,r_14_25_151,r_119_27_104,0.56,46,150,104,56
32,r_86_105_67,r_85_57_196,r_108_103_119,r_86_105_67,0.98,0,67,67,56
38,r_97_116_173,seq99,r_101_115_78,r_101_115_78,1,99,177,78,56
77,seq63,r_62_34_120,seq68,r_62_34_120,0.9,2,122,120,56
32,r_86_105_67,r_108_103_119,r_140_106_179,r_108_103_119,0.99,1,120,119,56
34,r_47_123_129,seq46,r_135_128_41,r_47_123_129,0.98,0,129,129,56
64,seq31,r_35_29_43,r_15_30_103,r_15_30_103,0.99,10,113,103,56
17,r_66_69_20,r_67_118_159,seq63,r_66_69_20,0.49,127,147,20,56
9,r_62_34_120,seq63,seq32,r_62_34_120,0.99,0,120,120,56
36,r_101_115_78,r_121_13_152,seq114,r_121_13_152,0.93,-30,122,152,56
36,r_101_115_78,r_97_116_173,r_102_104_133,r_102_104_133,0.47,-103,30,133,56
28,r_14_25_151,r_16_132_173,r_119_27_104,r_119_27_104,1,69,173,104,56
8,r_76_23_20,seq75,seq22,r_76_23_20,1,0,20,20,56
72,seq50,seq53,r_88_49_164,r_88_49_164,0.89,4,168,164,56
65,seq32,r_35_29_43,r_39_48_164,r_35_29_43,0.5,-24,19,43,56
74,seq53,r_54_1_41,seq51,r_54_1_41,1,-22,19,41,56
56,seq12,r_10_82_146,r_9_72_179,r_10_82_146,0.96,-27,119,146,56
44,r_71_61_20,r_60_4_148,r_33_59_3,r_60_4_148,1,0,148,148,56
23,r_15_30_103,r_16_132_173,seq31,r_15_30_103,0.86,12,115,103,56
30,r_135_128_41,r_134_148_106,seq124,r_135_128_41,0.77,0,41,41,56
35,r_134_148_106,seq133,seq149,r_134_148_106,0.66,3,109,106,56
12,r_120_17_155,r_121_13_152,r_76_23_20,r_76_23_20,0.91,134,154,20,56
14,r_11_44_55,r_10_82_146,seq45,r_11_44_55,0.83,0,55,55,56
7,r_115_35_18,r_112_94_34,seq34,r_115_35_18,0.99,0,18,18,57
30,r_12_143_95,seq11,r_128_142_48,r_12_143_95,0.97,0,95,95,57
2,r_85_26_27,r_84_80_190,seq28,r_85_26_27,1,0,27,27,57
17,r_2_81_57,r_1_41_149,r_46_89_9,r_2_81_57,1,0,57,57,57
6,r_68_120_20,r_70_37_110,seq122,r_68_120_20,0.81,0,20,20,57
8,r_84_80_190,seq83,r_110_88_87,r_110_88_87,1,101,188,87,57
37,r_1_41_149,seq0,seq42,r_1_41_149,0.77,0,149,149,57
4,r_51_106_134,r_19_52_69,seq105,r_51_106_134,0.99,0,134,134,57
71,seq137,r_139_91_189,r_59_138_106,r_59_138_106,1,84,190,106,57
16,r_15_48_175,seq16,seq49,r_15_48_175,0.51,0,175,175,57
5,r_4_144_138,seq7,r_92_148_110,r_4_144_138,0.94,0,138,138,57
46,r_73_100_124,seq72,seq101,r_73_100_124,0.51,0,124,124,57
42,r_140_107_141,r_146_50_130,r_99_132_33,r_99_132_33,0.36,46,79,33,57
95,seq118,seq126,r_68_120_20,r_68_120_20,1,1,21,20,57
14,r_58_62_41,r_59_138_106,r_53_63_14,r_53_63_14,0.76,1,15,14,57
0,r_141_130_178,r_146_50_130,r_128_142_48,r_141_130_178,0.84,-129,49,178,57
39,r_112_94_34,seq114,seq101,r_112_94_34,0.73,-5,29,34,57
11,r_53_63_14,r_51_106_134,r_58_62_41,r_53_63_14,0.94,-1,13,14,57
31,r_121_24_74,seq122,seq25,r_121_24_74,1,0,74,74,57
45,r_131_113_89,r_133_13_147,r_36_129_4,r_36_129_4,0.78,17,21,4,57
3,r_104_116_146,seq105,r_131_113_89,r_104_116_146,0.28,0,146,146,57
42,r_140_107_141,r_99_132_33,seq149,r_99_132_33,0.58,77,110,33,57
10,r_110_88_87,seq114,r_46_89_9,r_110_88_87,0.97,2,89,87,57
26,r_146_50_130,seq145,seq49,r_146_50_130,0.62,0,130,130,57
4,r_51_106_134,seq30,r_19_52_69,r_19_52_69,0.99,20,89,69,57
13,r_17_136_166,seq16,r_59_138_106,r_17_136_166,0.49,0,166,166,57
15,r_38_79_134,seq39,r_93_77_14,r_38_79_134,0.79,2,136,134,57
48,r_14_44_109,r_15_48_175,r_8_40_6,r_14_44_109,0.93,0,109,109,57
44,r_55_87_35,seq54,r_46_89_9,r_55_87_35,0.89,0,35,35,57
57,seq145,r_146_50_130,r_3_147_32,r_3_147_32,0.96,98,130,32,57
49,r_3_147_32,r_2_81_57,seq145,r_3_147_32,0.93,0,32,32,57
99,seq149,r_146_50_130,r_92_148_110,r_146_50_130,0.71,-7,123,130,57
0,r_141_130_178,r_128_142_48,r_99_132_33,r_99_132_33,0.61,142,175,33,57
27,r_66_6_160,seq65,seq7,r_66_6_160,0.55,0,160,160,57
18,r_128_142_48,r_141_130_178,r_12_143_95,r_12_143_95,1,12,107,95,57
98,seq126,seq118,r_68_120_20,r_68_120_20,1,1,21,20,57
41,r_67_109_33,r_110_88_87,r_131_113_89,r_67_109_33,0.97,60,93,33,57
47,r_103_5_140,seq101,seq7,r_103_5_140,0.87,0,140,140,57
40,r_33_111_106,seq32,r_131_113_89,r_33_111_106,0.98,1,107,106,57
29,r_29_23_112,seq28,seq25,r_29_23_112,1,1,113,112,57
24,r_31_90_117,seq30,r_68_120_20,r_31_90_117,1,0,117,117,57
25,r_70_37_110,r_71_74_114,seq49,r_70_37_110,0.98,1,111,110,57
43,r_133_13_147,r_36_129_4,seq16,r_133_13_147,0.97,0,147,147,57
33,r_123_127_182,seq122,r_51_106_134,r_51_106_134,1,45,179,134,57
50,seq0,r_1_41_149,seq9,r_1_41_149,0.97,0,149,149,57
19,r_93_77_14,r_99_132_33,seq78,r_93_77_14,0.88,0,14,14,57
21,r_99_132_33,r_103_5_140,r_36_129_4,r_99_132_33,0.47,0,33,33,57
41,r_67_109_33,r_70_37_110,r_110_88_87,r_67_109_33,0.5,0,33,33,57
34,r_92_148_110,r_103_5_140,seq149,r_103_5_140,0.93,-50,90,140,57
60,seq25,r_17_136_166,r_121_24_74,r_121_24_74,0.99,0,74,74,57
45,r_131_113_89,r_36_129_4,seq114,r_131_113_89,0.74,1,90,89,57
18,r_128_142_48,r_131_113_89,r_141_130_178,r_128_142_48,0.93,0,48,48,57
25,r_70_37_110,seq49,r_8_40_6,r_8_40_6,0.4,171,177,6,57
9,r_59_138_106,seq60,seq137,r_59_138_106,1,0,106,106,57
28,r_19_52_69,r_51_106_134,r_146_50_130,r_19_52_69,1,66,135,69,57
22,r_20_125_116,seq22,seq126,r_20_125_116,0.86,0,116,116,57
28,r_19_52_69,r_20_125_116,r_51_106_134,r_19_52_69,0.99,0,69,69,57
36,r_36_129_4,r_131_113_89,r_99_132_33,r_36_129_4,0.64,39,43,4,57
43,r_133_13_147,r_131_113_89,r_36_129_4,r_133_13_147,0.74,-125,22,147,57
23,r_27_119_89,r_29_23_112,r_68_120_20,r_27_119_89,0.99,0,89,89,57
79,seq72,r_73_100_124,seq69,r_73_100_124,0.8,-22,102,124,57
35,r_18_47_134,seq22,seq49,r_18_47_134,0.96,0,134,134,57
42,r_11_107_156,r_148_12_128,r_140_106_20,r_11_107_156,1,0,156,156,58
30,r_33_117_68,r_30_67_80,seq120,r_33_117_68,1,0,68,68,58
41,r_58_48_17,r_57_61_58,r_75_50_10,r_57_61_58,0.94,-41,17,58,58
9,r_20_25_171,r_142_23_110,r_116_37_88,r_142_23_110,0.7,62,172,110,58
8,r_127_111_118,seq129,seq120,r_127_111_118,0.8,3,121,118,58
43,r_36_17_88,seq39,seq18,r_36_17_88,0.81,0,88,88,58
37,r_91_123_128,r_92_60_166,r_68_126_124,r_92_60_166,0.98,-38,128,166,58
18,r_97_35_55,r_92_60_166,r_36_17_88,r_97_35_55,0.99,0,55,55,58
86,seq144,r_143_81_113,seq146,r_143_81_113,1,0,113,113,58
16,r_92_60_166,seq94,r_57_61_58,r_57_61_58,0.55,108,166,58,58
21,r_86_71_115,r_84_51_132,r_65_72_36,r_84_51_132,0.99,-9,123,132,58
9,r_20_25_171,r_116_37_88,r_142_23_110,r_142_23_110,0.55,0,110,110,58
39,r_30_67_80,seq31,seq69,r_30_67_80,1,0,80,80,58
1,r_82_55_64,seq83,seq56,r_82_55_64,0.99,19,83,64,58
5,r_116_37_88,r_118_19_120,seq38,r_116_37_88,0.5,1,89,88,58
32,r_2_47_50,r_1_62_189,r_58_48_17,r_2_47_50,1,0,50,50,58
42,r_11_107_156,seq18,r_148_12_128,r_148_12_128,0.97,0,128,128,58
7,r_65_72_36,seq73,r_86_71_115,r_86_71_115,0.65,13,128,115,58
10,r_121_95_57,seq122,seq94,r_121_95_57,1,0,57,57,58
34,r_75_50_10,r_101_132_134,seq49,r_75_50_10,0.97,0,10,10,58
19,r_28_119_146,seq27,r_105_114_103,r_28_119_146,0.71,0,146,146,58
27,r_142_23_110,r_20_25_171,r_64_22_149,r_64_22_149,0.63,22,171,149,58
95,seq147,r_148_12_128,seq135,r_148_12_128,1,-25,103,128,58
3,r_118_19_120,seq120,seq18,r_118_19_120,0.97,0,120,120,58
56,seq10,r_9_93_24,r_11_107_156,r_9_93_24,0.9,-3,21,24,58
4,r_64_22_149,r_66_133_152,r_142_23_110,r_66_133_152,0.68,-3,149,152,58
26,r_59_34_14,r_64_22_149,seq29,r_59_34_14,0.48,0,14,14,58
63,seq27,r_28_119_146,seq31,r_28_119_146,1,0,146,146,58
11,r_87_26_76,r_86_71_115,seq27,r_87_26_76,1,0,76,76,58
26,r_59_34_14,seq39,seq27,r_59_34_14,0.5,44,58,14,58
20,r_105_114_103,r_104_134_140,seq113,r_105_114_103,0.85,0,103,103,58
13,r_57_61_58,seq52,r_78_7_136,r_57_61_58,0.96,8,66,58,58
56,seq10,r_11_107_156,r_36_17_88,r_11_107_156,0.73,-40,116,156,58
15,r_143_81_113,seq144,seq83,r_143_81_113,0.97,0,113,113,58
36,r_77_44_19,r_78_7_136,seq45,r_77_44_19,1,0,19,19,58
31,r_115_96_13,r_118_19_120,r_86_71_115,r_115_96_13,0.7,0,13,13,58
13,r_57_61_58,r_78_7_136,r_92_60_166,r_78_7_136,1,0,136,136,58
6,r_128_53_114,seq129,seq54,r_128_53_114,0.98,0,114,114,58
85,seq94,r_92_60_166,r_121_95_57,r_121_95_57,1,17,74,57,58
97,seq122,r_121_95_57,seq129,r_121_95_57,1,0,57,57,58
27,r_142_23_110,seq141,r_20_25_171,r_142_23_110,1,0,110,110,58
18,r_97_35_55,r_36_17_88,r_116_37_88,r_116_37_88,0.96,0,88,88,58
2,r_104_134_140,seq109,seq135,r_104_134_140,0.82,0,140,140,58
74,seq54,seq52,r_128_53_114,r_128_53_114,1,15,129,114,58
29,r_68_126_124,seq69,seq124,r_68_126_124,0.93,0,124,124,58
24,r_80_0_68,r_87_26_76,r_24_4_55,r_80_0_68,1,0,68,68,58
25,r_148_12_128,seq147,r_11_107_156,r_148_12_128,0.85,0,128,128,58
33,r_66_133_152,r_64_22_149,r_101_132_134,r_64_22_149,0.97,0,149,149,58
25,r_148_12_128,r_11_107_156,seq14,r_11_107_156,0.99,-3,153,156,58
47,r_9_93_24,seq10,seq94,r_9_93_24,1,0,24,24,58
61,seq18,seq15,r_118_19_120,r_118_19_120,1,2,122,120,58
38,r_40_76_133,seq41,seq98,r_40_76_133,0.95,0,133,133,58
52,seq3,r_1_62_189,r_24_4_55,r_24_4_55,1,54,109,55,58
75,seq56,seq52,r_82_55_64,r_82_55_64,0.67,70,134,64,58
48,r_24_4_55,r_20_25_171,seq3,r_24_4_55,1,1,56,55,58
41,r_58_48_17,r_75_50_10,r_2_47_50,r_2_47_50,0.99,0,50,50,58
17,r_79_46_146,seq83,r_2_47_50,r_79_46_146,0.8,0,146,146,58
9,r_20_25_171,r_21_88_101,r_116_37_88,r_116_37_88,0.94,12,100,88,58
31,r_115_96_13,r_86_71_115,seq90,r_86_71_115,0.81,-13,102,115,58
22,r_84_51_132,seq89,r_75_50_10,r_84_51_132,0.94,1,133,132,58
28,r_101_132_134,seq89,seq130,r_101_132_134,0.73,0,134,134,58
44,r_78_7_136,r_86_71_115,r_8_6_5,r_78_7_136,0.67,0,136,136,58
0,r_139_108_36,seq136,seq109,r_139_108_36,0.93,0,36,36,58
23,r_21_88_101,r_20_25_171,seq89,r_21_88_101,0.99,0,101,101,58
35,r_112_70_185,seq113,r_65_72_36,r_112_70_185,0.46,0,185,185,58
12,r_138_13_158,seq146,seq14,r_138_13_158,0.84,0,158,158,58
7,r_65_72_36,r_66_133_152,seq73,r_65_72_36,0.62,4,40,36,58
30,r_61_108_85,seq62,seq109,r_61_108_85,1,0,85,85,59
14,r_2_20_145,r_5_83_176,r_138_23_121,r_138_23_121,0.98,24,145,121,59
8,r_52_147_175,r_53_102_84,r_134_51_3,r_53_102_84,0.99,0,84,84,59
45,r_36_88_14,r_37_110_198,seq86,r_36_88_14,0.96,0,14,14,59
37,r_73_33_178,r_70_10_137,r_107_69_57,r_107_69_57,0.62,75,132,57,59
16,r_1_12_21,r_0_25_62,seq11,r_1_12_21,0.68,-2,19,21,59
21,r_138_23_121,seq139,seq22,r_138_23_121,0.9,0,121,121,59
1,r_111_29_133,seq115,r_80_28_19,r_111_29_133,0.95,0,133,133,59
97,seq122,seq121,r_40_123_30,r_40_123_30,1,45,75,30,59
23,r_80_28_19,r_77_116_144,seq27,r_80_28_19,0.99,0,19,19,59
5,r_143_54_176,seq144,r_47_59_101,r_143_54_176,0.7,0,176,176,59
46,r_5_83_176,r_4_94_120,r_43_125_199,r_4_94_120,0.83,0,120,120,59
42,r_35_112_171,seq38,seq109,r_35_112_171,0.57,0,171,171,59
95,seq119,seq122,r_95_120_93,r_95_120_93,1,0,93,93,59
11,r_41_14_37,seq42,seq15,r_41_14_37,0.76,0,37,37,59
31,r_142_78_194,seq144,r_31_81_68,r_31_81_68,0.78,126,194,68,59
41,r_132_124_99,seq131,r_85_127_108,r_85_127_108,1,9,117,108,59
3,r_47_59_101,seq48,seq60,r_47_59_101,0.51,43,144,101,59
10,r_103_57_131,r_105_146_150,seq58,r_103_57_131,0.99,0,131,131,59
8,r_52_147_175,r_134_51_3,seq148,r_134_51_3,0.56,173,176,3,59
18,r_24_46_52,r_19_129_176,seq48,r_24_46_52,0.99,0,52,52,59
0,r_44_67_63,r_43_125_199,seq68,r_44_67_63,1,0,63,63,59
40,r_140_34_193,r_138_23_121,r_142_78_194,r_138_23_121,1,-1,120,121,59
20,r_130_66_114,seq131,seq68,r_130_66_114,1,0,114,114,59
46,r_5_83_176,r_43_125_199,seq76,r_5_83_176,0.96,0,176,176,59
15,r_45_26_66,r_47_59_101,r_0_25_62,r_45_26_66,1,0,66,66,59
63,seq27,r_19_129_176,r_80_28_19,r_80_28_19,1,20,39,19,59
48,r_87_136_169,seq86,seq139,r_87_136_169,0.76,0,169,169,59
36,r_0_25_62,r_1_12_21,r_4_94_120,r_0_25_62,0.53,-43,19,62,59
17,r_89_91_35,r_87_136_169,seq92,r_89_91_35,0.92,2,37,35,59
37,r_73_33_178,r_107_69_57,r_75_39_51,r_73_33_178,1,0,178,178,59
6,r_53_102_84,r_52_147_175,seq104,r_53_102_84,1,0,84,84,59
85,seq93,seq96,r_4_94_120,r_4_94_120,0.99,4,124,120,59
22,r_16_72_8,r_73_33_178,r_107_69_57,r_107_69_57,0.99,121,178,57,59
2,r_70_10_137,r_73_33_178,r_1_12_21,r_1_12_21,0.64,117,138,21,59
47,r_4_94_120,r_5_83_176,seq93,r_4_94_120,0.99,0,120,120,59
43,r_74_118_19,r_75_39_51,seq131,r_74_118_19,0.88,0,19,19,59
39,r_141_114_188,r_142_78_194,r_77_116_144,r_141_114_188,0.69,0,188,188,59
40,r_140_34_193,seq144,r_138_23_121,r_140_34_193,0.61,-120,73,193,59
28,r_107_69_57,r_130_66_114,r_16_72_8,r_16_72_8,0.9,49,57,8,59
24,r_19_129_176,seq17,r_40_123_30,r_40_123_30,0.65,146,176,30,59
19,r_75_39_51,r_70_10_137,seq38,r_75_39_51,0.59,0,51,51,59
33,r_31_81_68,seq30,seq82,r_31_81_68,1,0,68,68,59
47,r_4_94_120,seq93,r_135_98_185,r_135_98_185,1,6,191,185,59
65,seq32,r_5_83_176,r_70_10_137,r_70_10_137,0.9,8,145,137,59
32,r_77_116_144,seq76,seq109,r_77_116_144,0.83,0,144,144,59
52,seq8,r_6_101_152,r_128_7_103,r_128_7_103,0.99,48,151,103,59
34,r_85_127_108,r_89_91_35,seq126,r_85_127_108,0.95,0,108,108,59
9,r_40_123_30,r_41_14_37,seq122,r_40_123_30,1,0,30,30,59
91,seq104,r_105_146_150,r_53_102_84,r_53_102_84,1,66,150,84,59
36,r_0_25_62,r_4_94_120,r_45_26_66,r_0_25_62,1,0,62,62,59
49,r_105_146_150,seq104,seq149,r_105_146_150,0.77,0,150,150,59
7,r_113_84_124,seq115,seq86,r_113_84_124,0.91,2,126,124,59
44,r_128_7_103,r_130_66_114,seq8,r_128_7_103,0.93,0,103,103,59
66,seq38,r_37_110_198,r_75_39_51,r_75_39_51,1,3,54,51,59
79,seq68,seq79,r_44_67_63,r_44_67_63,1,11,74,63,59
35,r_95_120_93,seq93,seq119,r_95_120_93,1,0,93,93,59
38,r_106_9_58,r_105_146_150,seq8,r_106_9_58,1,0,58,58,59
39,r_141_114_188,r_138_23_121,r_142_78_194,r_138_23_121,0.99,-7,114,121,59
12,r_3_50_74,r_4_94_120,seq49,r_3_50_74,0.73,0,74,74,59
26,r_71_90_54,r_70_10_137,r_89_91_35,r_71_90_54,0.95,4,58,54,59
30,r_45_93_170,seq48,r_133_46_107,r_133_46_107,0.99,1,108,107,60
36,r_60_53_108,seq62,r_52_50_37,r_60_53_108,0.96,0,108,108,60
54,seq8,r_1_20_62,r_76_4_45,r_76_4_45,0.96,29,74,45,60
37,r_143_36_113,r_112_142_2,seq38,r_143_36_113,0.99,0,113,113,60
16,r_124_69_161,seq122,r_106_67_87,r_124_69_161,0.68,0,161,161,60
39,r_107_126_73,r_106_67_87,seq128,r_107_126_73,1,0,73,73,60
5,r_123_9_79,seq122,r_76_4_45,r_123_9_79,0.95,0,79,79,60
46,r_5_85_91,seq8,seq94,r_5_85_91,1,0,91,91,60
69,seq39,r_40_147_163,r_143_36_113,r_143_36_113,0.79,52,165,113,60
45,r_66_14_84,seq65,seq13,r_66_14_84,1,0,84,84,60
11,r_97_30_22,seq98,r_77_28_7,r_97_30_22,0.72,0,22,22,60
83,seq73,r_74_16_42,r_91_75_16,r_74_16_42,0.67,-29,13,42,60
95,seq109,r_108_27_80,r_81_116_31,r_108_27_80,1,0,80,80,60
19,r_76_4_45,r_74_16_42,r_15_2_4,r_15_2_4,0.96,45,49,4,60
18,r_106_67_87,r_115_31_95,seq70,r_115_31_95,0.96,0,95,95,60
67,seq35,r_34_119_127,seq38,r_34_119_127,0.85,1,128,127,60
8,r_91_75_16,r_89_99_154,seq82,r_91_75_16,0.53,-2,14,16,60
43,r_56_72_13,r_60_53_108,seq71,r_56_72_13,0.61,-1,12,13,60
89,seq94,r_92_87_141,r_7_95_144,r_7_95_144,1,13,157,144,60
3,r_131_139_149,seq128,seq137,r_131_139_149,0.83,0,149,149,60
10,r_7_95_144,seq8,seq94,r_7_95_144,0.8,0,144,144,60
26,r_134_110_168,seq135,r_132_117_28,r_132_117_28,0.57,139,167,28,60
4,r_3_105_101,r_15_2_4,seq109,r_3_105_101,1,0,101,101,60
29,r_81_116_31,r_83_120_137,seq118,r_83_120_137,0.74,-103,34,137,60
13,r_133_46_107,seq128,r_45_93_170,r_133_46_107,0.97,0,107,107,60
15,r_33_78_109,seq32,seq79,r_33_78_109,1,0,109,109,60
25,r_52_50_37,r_49_6_20,r_83_120_137,r_49_6_20,0.78,0,20,20,60
13,r_133_46_107,r_45_93_170,seq43,r_45_93_170,0.91,-1,169,170,60
62,seq19,r_23_61_104,r_1_20_62,r_23_61_104,0.86,-38,66,104,60
49,r_90_64_51,r_89_99_154,seq62,r_90_64_51,1,0,51,51,60
99,seq122,r_124_69_161,r_57_121_114,r_57_121_114,0.89,47,161,114,60
6,r_132_117_28,r_131_139_149,seq118,r_132_117_28,1,0,28,28,60
30,r_45_93_170,r_133_46_107,r_7_95_144,r_45_93_170,0.95,2,172,170,60
93,seq101,r_100_127_183,seq104,r_100_127_183,0.74,-22,161,183,60
18,r_106_67_87,r_107_126_73,r_115_31_95,r_106_67_87,0.64,-14,73,87,60
24,r_24_58_136,r_26_145_120,seq22,r_24_58_136,0.42,-16,120,136,60
33,r_15_2_4,r_3_105_101,seq8,r_3_105_101,1,0,101,101,60
64,seq22,r_23_61_104,r_1_20_62,r_23_61_104,1,0,104,104,60
88,seq88,seq86,r_92_87_141,r_92_87_141,0.94,13,154,141,60
50,seq0,r_1_20_62,r_76_4_45,r_76_4_45,0.88,21,66,45,60
20,r_21_55_6,r_54_111_145,r_23_61_104,r_23_61_104,0.96,42,146,104,60
68,seq38,r_37_25_141,r_143_36_113,r_143_36_113,0.52,0,113,113,60
42,r_54_111_145,r_21_55_6,r_132_117_28,r_21_55_6,0.63,139,145,6,60
32,r_34_119_127,seq35,r_57_121_114,r_34_119_127,0.94,0,127,127,60
38,r_57_121_114,seq62,seq122,r_57_121_114,0.97,0,114,114,60
21,r_102_59_50,seq101,r_90_64_51,r_102_59_50,0.86,1,51,50,60
17,r_1_20_62,seq0,seq22,r_1_20_62,0.7,12,74,62,60
25,r_52_50_37,r_83_120_137,r_60_53_108,r_83_120_137,0.52,-21,116,137,60
24,r_24_58_136,seq22,r_23_61_104,r_24_58_136,0.98,0,136,136,60
9,r_44_11_15,seq43,seq10,r_44_11_15,0.76,0,15,15,60
22,r_100_127_183,seq101,r_57_121_114,r_57_121_114,0.81,71,185,114,60
28,r_26_145_120,r_24_58_136,seq135,r_26_145_120,0.95,0,120,120,60
42,r_54_111_145,r_57_121_114,r_21_55_6,r_54_111_145,0.8,-110,35,145,60
93,seq101,r_102_59_50,r_103_51_180,r_102_59_50,0.76,1,51,50,60
7,r_115_31_95,seq113,r_97_30_22,r_115_31_95,0.98,0,95,95,60
44,r_40_147_163,seq39,r_42_149_160,r_40_147_163,0.78,0,163,163,60
23,r_23_61_104,seq22,r_90_64_51,r_23_61_104,0.93,0,104,104,60
1,r_49_6_20,r_52_50_37,seq8,r_49_6_20,0.9,0,20,20,60
35,r_37_25_141,seq38,r_1_20_62,r_37_25_141,0.9,0,141,141,60
12,r_108_27_80,seq109,r_97_30_22,r_108_27_80,1,0,80,80,60
93,seq99,r_101_3_148,r_22_100_6,r_101_3_148,0.85,1,149,148,61
30,r_35_41_130,seq33,seq42,r_35_41_130,0.62,5,135,130,61
9,r_101_3_148,r_22_100_6,seq4,r_101_3_148,0.91,0,148,148,61
92,seq98,seq93,r_137_96_19,r_137_96_19,1,5,24,19,61
44,r_145_123_88,r_124_120_133,r_45_122_124,r_45_122_124,1,-2,122,124,61
14,r_102_85_96,seq112,seq87,r_102_85_96,0.71,-4,92,96,61
8,r_26_44_115,r_35_41_130,seq46,r_26_44_115,0.85,0,115,115,61
11,r_31_62_104,r_108_29_37,r_30_64_77,r_31_62_104,0.86,5,109,104,61
59,seq16,seq12,r_132_18_62,r_132_18_62,1,69,131,62,61
16,r_36_8_128,r_35_41_130,seq6,r_35_41_130,1,-1,129,130,61
39,r_73_25_127,r_75_142_137,r_77_28_128,r_75_142_137,0.97,-9,128,137,61
1,r_104_61_162,seq105,r_50_57_73,r_104_61_162,0.74,0,162,162,61
46,r_72_27_202,r_73_25_127,seq68,r_73_25_127,0.97,-7,120,127,61
42,r_132_18_62,r_134_21_187,r_54_17_27,r_132_18_62,1,0,62,62,61
45,r_91_15_150,r_89_97_173,seq16,r_91_15_150,0.92,0,150,150,61
29,r_144_94_172,seq149,seq93,r_144_94_172,0.99,0,172,172,61
9,r_101_3_148,r_81_148_120,r_22_100_6,r_101_3_148,0.7,-137,11,148,61
24,r_63_1_175,r_30_64_77,r_101_3_148,r_30_64_77,0.81,98,175,77,61
19,r_50_57_73,seq49,seq59,r_50_57_73,1,0,73,73,61
27,r_24_121_81,r_124_120_133,r_45_122_124,r_45_122_124,1,32,156,124,61
76,seq59,seq56,r_50_57_73,r_50_57_73,1,14,87,73,61
33,r_90_0_33,r_89_97_173,seq4,r_90_0_33,0.86,0,33,33,61
31,r_60_86_111,seq56,r_102_85_96,r_60_86_111,0.95,0,111,111,61
68,seq42,r_10_139_177,r_35_41_130,r_10_139_177,0.78,-33,144,177,61
28,r_74_117_148,r_125_95_106,r_114_116_68,r_74_117_148,0.98,0,148,148,61
6,r_19_110_28,r_13_40_9,seq112,r_19_110_28,0.89,3,31,28,61
90,seq87,r_89_97_173,r_102_85_96,r_102_85_96,0.78,16,112,96,61
26,r_9_140_133,seq6,seq149,r_9_140_133,0.81,1,134,133,61
36,r_92_119_12,seq93,r_124_120_133,r_92_119_12,0.98,0,12,12,61
0,r_81_148_120,seq79,seq149,r_81_148_120,0.94,0,120,120,61
11,r_31_62_104,r_30_64_77,r_108_29_37,r_31_62_104,0.72,-27,77,104,61
20,r_134_21_187,seq133,r_77_28_128,r_134_21_187,0.38,0,187,187,61
13,r_143_107_135,r_144_94_172,r_58_103_37,r_143_107_135,0.74,0,135,135,61
15,r_124_120_133,r_125_95_106,r_92_119_12,r_125_95_106,0.55,0,106,106,61
48,r_30_64_77,r_31_62_104,r_63_1_175,r_63_1_175,0.82,-98,77,175,61
17,r_108_29_37,seq109,seq33,r_108_29_37,0.95,0,37,37,61
40,r_137_96_19,seq138,seq98,r_137_96_19,1,0,19,19,61
27,r_24_121_81,r_26_44_115,r_124_120_133,r_24_121_81,0.99,0,81,81,61
2,r_114_116_68,seq112,seq118,r_114_116_68,0.98,0,68,68,61
41,r_147_135_29,r_136_141_165,seq138,r_136_141_165,0.47,0,165,165,61
47,r_32_131_186,seq33,r_129_130_9,r_32_131_186,0.39,0,186,186,61
18,r_45_122_124,seq46,r_145_123_88,r_45_122_124,0.92,0,124,124,61
29,r_144_94_172,r_143_107_135,seq149,r_143_107_135,1,0,135,135,61
24,r_63_1_175,seq65,r_30_64_77,r_30_64_77,1,4,81,77,61
59,seq16,r_132_18_62,r_91_15_150,r_91_15_150,0.72,-1,149,150,61
25,r_75_142_137,r_74_117_148,seq149,r_75_142_137,0.9,0,137,137,61
48,r_30_64_77,r_63_1_175,seq65,r_63_1_175,0.79,0,175,175,61
22,r_58_103_37,seq59,seq105,r_58_103_37,0.99,3,40,37,61
68,seq42,r_45_122_124,seq49,r_45_122_124,0.36,-44,80,124,61
61,seq149,r_144_94_172,r_81_148_120,r_81_148_120,0.81,26,146,120,61
32,r_106_47_136,r_104_61_162,r_26_44_115,r_106_47_136,0.75,0,136,136,61
38,r_125_95_106,r_124_120_133,r_137_96_19,r_125_95_106,0.98,0,106,106,61
37,r_136_141_165,r_147_135_29,r_75_142_137,r_75_142_137,1,28,165,137,61
28,r_74_117_148,r_75_142_137,r_125_95_106,r_125_95_106,0.92,31,137,106,61
37,r_136_141_165,seq128,r_147_135_29,r_147_135_29,0.81,2,31,29,61
49,r_22_100_6,r_101_3_148,seq99,r_101_3_148,0.85,1,149,148,61
41,r_147_135_29,r_143_107_135,r_136_141_165,r_147_135_29,0.63,0,29,29,61
87,seq82,r_81_148_120,seq83,r_81_148_120,1,-100,20,120,61
35,r_54_17_27,r_36_8_128,r_132_18_62,r_132_18_62,0.99,8,70,62,61
44,r_145_123_88,r_143_107_135,r_124_120_133,r_145_123_88,0.92,0,88,88,61
35,r_54_17_27,seq52,r_36_8_128,r_54_17_27,0.88,4,31,27,61
97,seq118,seq82,r_114_116_68,r_114_116_68,0.86,-2,66,68,61
51,seq1,r_5_51_195,r_45_2_79,r_45_2_79,1,94,173,79,62
9,r_61_127_134,r_39_63_25,seq129,r_61_127_134,0.57,0,134,134,62
33,r_34_130_181,r_31_92_75,r_16_32_32,r_31_92_75,0.41,-40,35,75,62
92,seq109,seq102,r_76_108_96,r_76_108_96,1,77,173,96,62
8,r_22_33_156,seq23,r_16_32_32,r_22_33_156,0.58,3,159,156,62
43,r_38_75_112,seq37,r_9_77_15,r_38_75_112,0.97,0,112,112,62
31,r_9_77_15,r_21_55_60,seq72,r_9_77_15,0.89,0,15,15,62
71,seq49,seq37,r_90_48_22,r_90_48_22,0.99,119,141,22,62
21,r_139_59_111,seq142,seq57,r_139_59_111,1,0,111,111,62
39,r_19_146_190,r_22_33_156,r_30_20_116,r_19_146_190,0.5,-75,115,190,62
1,r_106_122_104,seq102,seq123,r_106_122_104,0.96,0,104,104,62
5,r_31_92_75,r_34_130_181,seq93,r_31_92_75,1,0,75,75,62
42,r_45_2_79,r_38_75_112,seq1,r_45_2_79,1,0,79,79,62
86,seq93,r_87_128_168,r_3_89_24,r_3_89_24,0.57,24,48,24,62
19,r_15_116_78,seq12,seq115,r_15_116_78,1,0,78,78,62
0,r_98_44_50,r_97_91_131,seq37,r_98_44_50,1,0,50,50,62
33,r_34_130_181,r_16_32_32,seq129,r_34_130_181,0.42,0,181,181,62
38,r_87_128_168,seq93,r_3_89_24,r_3_89_24,1,23,47,24,62
76,seq69,r_68_7_179,r_66_67_99,r_66_67_99,0.99,80,179,99,62
38,r_87_128_168,r_3_89_24,seq129,r_87_128_168,0.57,1,169,168,62
14,r_90_48_22,r_87_128_168,seq37,r_90_48_22,0.98,0,22,22,62
28,r_107_54_37,r_106_122_104,seq53,r_107_54_37,1,2,39,37,62
17,r_16_32_32,r_15_116_78,r_34_130_181,r_16_32_32,0.61,0,32,32,62
10,r_81_95_129,seq80,seq100,r_81_95_129,0.68,3,132,129,62
47,r_65_8_58,r_66_67_99,seq10,r_65_8_58,1,0,58,58,62
14,r_90_48_22,seq37,seq49,r_90_48_22,0.36,119,141,22,62
4,r_136_85_127,seq149,r_97_91_131,r_136_85_127,0.77,4,131,127,62
11,r_133_99_165,seq123,seq100,r_133_99_165,0.64,0,165,165,62
25,r_135_101_113,r_4_113_27,seq102,r_135_101_113,0.95,0,113,113,62
20,r_132_47_129,seq125,r_96_46_63,r_132_47_129,0.96,0,129,129,62
13,r_60_110_145,seq57,r_119_111_42,r_60_110_145,0.95,0,145,145,62
46,r_30_20_116,r_19_146_190,seq25,r_30_20_116,0.47,74,190,116,62
48,r_144_17_101,r_143_62_104,seq18,r_144_17_101,1,0,101,101,62
49,r_3_89_24,r_87_128_168,r_97_91_131,r_87_128_168,0.84,-28,140,168,62
16,r_58_79_33,r_60_110_145,seq80,r_58_79_33,1,1,34,33,62
27,r_76_108_96,seq72,seq102,r_76_108_96,0.83,0,96,96,62
6,r_97_91_131,r_98_44_50,seq94,r_98_44_50,1,0,50,50,62
36,r_4_113_27,r_5_51_195,r_119_111_42,r_4_113_27,0.99,0,27,27,62
7,r_66_67_99,r_39_63_25,r_9_77_15,r_66_67_99,0.99,0,99,99,62
9,r_61_127_134,r_66_67_99,r_39_63_25,r_39_63_25,0.53,-15,10,25,62
40,r_64_71_77,r_66_67_99,r_9_77_15,r_9_77_15,1,62,77,15,62
18,r_96_46_63,seq100,seq36,r_96_46_63,1,0,63,63,62
29,r_143_62_104,r_137_141_24,r_39_63_25,r_143_62_104,1,0,104,104,62
41,r_105_121_10,seq104,seq123,r_105_121_10,0.81,0,10,10,62
15,r_131_35_53,r_132_47_129,r_16_32_32,r_131_35_53,1,0,53,53,62
25,r_135_101_113,r_134_28_93,r_4_113_27,r_135_101_113,0.81,-21,92,113,62
6,r_97_91_131,seq94,seq88,r_97_91_131,0.39,0,131,131,62
65,seq29,r_30_20_116,r_134_28_93,r_134_28_93,0.89,11,104,93,62
61,seq23,r_22_33_156,r_52_24_95,r_52_24_95,1,42,137,95,62
34,r_134_28_93,r_135_101_113,seq29,r_134_28_93,1,0,93,93,62
58,seq18,seq13,r_144_17_101,r_144_17_101,0.92,25,126,101,62
2,r_39_63_25,seq41,r_66_67_99,r_66_67_99,0.63,-74,25,99,62
49,r_3_89_24,seq1,r_87_128_168,r_3_89_24,1,-1,23,24,62
12,r_21_55_60,r_90_48_22,r_70_56_76,r_70_56_76,0.92,13,89,76,62
22,r_70_56_76,r_68_7_179,r_21_55_60,r_70_56_76,1,0,76,76,62
7,r_66_67_99,r_64_71_77,r_39_63_25,r_66_67_99,0.7,-23,76,99,62
32,r_6_11_52,seq10,seq13,r_6_11_52,0.8,0,52,52,62
23,r_119_111_42,seq123,r_4_113_27,r_4_113_27,0.84,33,60,27,62
17,r_16_32_32,r_34_130_181,r_22_33_156,r_16_32_32,0.6,149,181,32,62
35,r_52_24_95,seq53,seq23,r_52_24_95,1,0,95,95,62
12,r_21_55_60,r_19_146_190,r_90_48_22,r_21_55_60,1,0,60,60,62
44,r_43_120_28,seq42,seq123,r_43_120_28,0.99,0,28,28,62
3,r_86_148_36,r_87_128_168,seq149,r_86_148_36,0.98,2,38,36,62
93,seq104,r_108_57_185,r_84_107_89,r_84_107_89,0.82,16,105,89,63
30,r_61_20_214,r_63_92_112,seq69,r_63_92_112,1,0,112,112,63
36,r_62_32_106,r_63_92_112,r_74_28_28,r_63_92_112,1,-6,106,112,63
1,r_114_88_11,seq115,seq85,r_114_88_11,0.94,0,11,11,63
14,r_17_6_164,r_18_21_199,r_14_8_65,r_18_21_199,0.47,-35,164,199,63
8,r_59_87_148,r_58_25_178,r_114_88_11,r_59_87_148,0.73,0,148,148,63
38,r_74_28_28,r_66_41_188,seq30,r_74_28_28,0.96,-3,25,28,63
37,r_19_13_103,r_17_6_164,r_68_12_49,r_19_13_103,0.88,0,103,103,63
16,r_99_78_71,seq100,seq79,r_99_78_71,1,0,71,71,63
21,r_58_25_178,seq50,seq23,r_58_25_178,0.49,0,178,178,63
24,r_105_132_30,r_106_83_104,r_129_124_131,r_105_132_30,0.99,0,30,30,63
5,r_11_125_150,r_10_121_106,r_1_127_169,r_10_121_106,0.96,0,106,106,63
46,r_98_118_83,seq100,r_119_0_129,r_98_118_83,0.8,0,83,83,63
32,r_9_128_9,r_129_124_131,r_122_130_111,r_9_128_9,0.31,127,136,9,63
7,r_68_12_49,r_15_91_123,r_19_13_103,r_15_91_123,0.63,1,124,123,63
45,r_22_33_10,r_35_123_198,seq23,r_22_33_10,0.33,163,173,10,63
29,r_34_37_58,seq27,seq38,r_34_37_58,0.79,0,58,58,63
7,r_68_12_49,seq69,r_15_91_123,r_68_12_49,0.92,0,49,49,63
24,r_105_132_30,r_129_124_131,r_146_148_123,r_146_148_123,0.47,-14,109,123,63
19,r_106_83_104,r_108_57_185,seq85,r_106_83_104,0.95,0,104,104,63
11,r_16_42_100,seq38,seq44,r_16_42_100,0.66,74,174,100,63
44,r_134_72_184,seq135,r_133_73_152,r_134_72_184,1,0,184,184,63
31,r_18_21_199,r_17_6_164,seq23,r_17_6_164,0.57,0,164,164,63
67,seq135,r_133_73_152,r_89_136_61,r_89_136_61,0.9,9,70,61,63
90,seq100,seq95,r_2_101_122,r_2_101_122,0.59,0,122,122,63
3,r_84_107_89,seq85,seq104,r_84_107_89,1,0,89,89,63
10,r_133_73_152,r_134_72_184,r_93_67_139,r_133_73_152,0.54,1,153,152,63
90,seq100,r_99_78_71,r_98_118_83,r_99_78_71,0.92,0,71,71,63
49,r_122_130_111,r_9_128_9,r_65_131_166,r_65_131_166,1,3,169,166,63
11,r_16_42_100,r_15_91_123,seq38,r_16_42_100,0.61,0,100,100,63
20,r_2_101_122,seq5,seq100,r_2_101_122,0.87,0,122,122,63
57,seq144,seq149,r_55_145_62,r_55_145_62,1,14,76,62,63
13,r_142_3_49,r_2_101_122,r_4_70_216,r_2_101_122,1,0,122,122,63
33,r_63_92_112,r_93_67_139,r_15_91_123,r_93_67_139,0.73,0,139,139,63
63,seq30,r_29_36_114,r_74_28_28,r_74_28_28,0.96,-3,25,28,63
99,seq120,r_122_130_111,r_10_121_106,r_10_121_106,1,5,111,106,63
40,r_93_67_139,r_63_92_112,seq69,r_93_67_139,0.96,0,139,139,63
0,r_29_36_114,r_35_123_198,r_58_25_178,r_29_36_114,0.88,84,198,114,63
27,r_64_117_106,seq69,r_98_118_83,r_64_117_106,1,0,106,106,63
5,r_11_125_150,r_1_127_169,r_129_124_131,r_129_124_131,0.78,19,150,131,63
25,r_143_46_51,seq138,seq45,r_143_46_51,1,0,51,51,63
13,r_142_3_49,r_4_70_216,r_119_0_129,r_119_0_129,0.88,82,211,129,63
2,r_43_48_156,seq45,seq38,r_43_48_156,0.42,-90,66,156,63
43,r_129_124_131,r_119_0_129,r_9_128_9,r_9_128_9,0.98,2,11,9,63
40,r_93_67_139,seq90,r_63_92_112,r_63_92_112,0.78,9,121,112,63
18,r_89_136_61,r_84_107_89,seq135,r_89_136_61,1,0,61,61,63
15,r_31_51_25,r_29_36_114,seq54,r_31_51_25,0.89,-7,18,25,63
43,r_129_124_131,r_9_128_9,r_11_125_150,r_11_125_150,1,2,152,150,63
33,r_63_92_112,r_61_20_214,r_93_67_139,r_63_92_112,0.81,0,112,112,63
32,r_9_128_9,r_122_130_111,r_1_127_169,r_1_127_169,1,0,169,169,63
70,seq47,r_58_25_178,r_43_48_156,r_58_25_178,0.61,-19,159,178,63
69,seq45,r_43_48_156,r_143_46_51,r_143_46_51,1,5,56,51,63
34,r_108_57_185,seq104,seq56,r_108_57_185,0.91,0,185,185,63
46,r_98_118_83,r_119_0_129,r_64_117_106,r_98_118_83,0.96,24,107,83,63
17,r_15_91_123,r_16_42_100,r_68_12_49,r_68_12_49,0.57,53,102,49,63
9,r_119_0_129,seq120,r_19_13_103,r_119_0_129,0.82,0,129,129,63
13,r_142_3_49,r_143_46_51,r_2_101_122,r_2_101_122,0.97,-73,49,122,63
29,r_34_37_58,seq38,r_16_42_100,r_34_37_58,0.63,90,148,58,63
22,r_55_145_62,r_59_87_148,seq144,r_55_145_62,1,0,62,62,63
17,r_15_91_123,r_68_12_49,r_63_92_112,r_15_91_123,0.98,1,124,123,63
49,r_122_130_111,seq120,r_9_128_9,r_9_128_9,0.72,102,111,9,63
44,r_134_72_184,r_133_73_152,seq135,r_133_73_152,0.72,1,153,152,63
23,r_35_123_198,r_29_36_114,r_64_117_106,r_64_117_106,1,90,196,106,63
24,r_105_132_30,r_146_148_123,seq135,r_146_148_123,0.53,36,159,123,63
39,r_26_112_46,r_29_36_114,seq113,r_26_112_46,1,0,46,46,63
35,r_14_8_65,r_16_42_100,seq7,r_16_42_100,0.99,-35,65,100,63
12,r_65_131_166,r_66_41_188,r_122_130_111,r_65_131_166,0.71,0,166,166,63
38,r_126_9_102,r_127_93_46,r_129_118_80,r_127_93_46,0.92,0,46,46,64
46,r_125_49_17,r_127_93_46,r_66_52_24,r_125_49_17,0.84,1,18,17,64
51,seq8,seq13,r_17_47_15,r_17_47_15,0.67,161,176,15,64
36,r_5_58_118,r_6_86_128,r_144_59_55,r_5_58_118,1,0,118,118,64
38,r_126_9_102,r_129_118_80,r_85_143_40,r_129_118_80,0.76,-6,74,80,64
92,seq103,r_91_56_196,r_61_100_44,r_61_100_44,1,81,125,44,64
9,r_117_75_178,r_73_116_111,seq76,r_117_75_178,0.8,0,178,178,64
14,r_24_71_138,r_21_92_138,r_134_67_13,r_134_67_13,0.99,124,137,13,64
5,r_112_65_68,r_115_149_129,seq63,r_112_65_68,1,0,68,68,64
69,seq141,r_140_36_174,seq135,r_140_36_174,0.63,0,174,174,64
24,r_6_86_128,r_45_4_32,r_50_84_28,r_45_4_32,0.98,96,128,32,64
19,r_113_105_169,r_117_75_178,r_98_101_163,r_98_101_163,0.72,6,169,163,64
47,r_40_25_139,r_78_39_70,seq26,r_40_25_139,0.78,0,139,139,64
15,r_54_132_66,seq135,r_122_131_129,r_122_131_129,0.71,1,130,129,64
1,r_144_59_55,r_146_14_174,seq57,r_144_59_55,1,0,55,55,64
16,r_130_1_30,r_144_59_55,r_2_128_141,r_130_1_30,1,0,30,30,64
39,r_29_83_148,r_107_31_7,r_119_82_84,r_29_83_148,0.97,0,148,148,64
41,r_119_82_84,seq111,seq81,r_119_82_84,1,0,84,84,64
3,r_21_92_138,seq26,r_127_93_46,r_21_92_138,0.86,0,138,138,64
10,r_115_149_129,r_113_105_169,seq148,r_115_149_129,0.81,1,130,129,64
39,r_29_83_148,seq32,r_107_31_7,r_107_31_7,0.98,3,10,7,64
8,r_17_47_15,r_48_62_101,r_66_52_24,r_17_47_15,0.77,89,104,15,64
16,r_130_1_30,r_2_128_141,r_45_4_32,r_2_128_141,0.95,0,141,141,64
4,r_73_116_111,seq72,r_129_118_80,r_73_116_111,0.98,0,111,111,64
21,r_134_67_13,r_144_59_55,seq68,r_134_67_13,0.94,0,13,13,64
20,r_140_36_174,seq141,r_95_33_120,r_140_36_174,0.52,0,174,174,64
15,r_54_132_66,seq57,seq135,r_54_132_66,1,0,66,66,64
49,r_70_37_12,seq34,r_95_33_120,r_95_33_120,1,7,127,120,64
17,r_3_19_51,r_6_86_128,seq26,r_3_19_51,1,0,51,51,64
12,r_45_4_32,r_5_58_118,r_41_7_112,r_45_4_32,1,86,118,32,64
6,r_122_131_129,seq124,r_54_132_66,r_54_132_66,0.99,63,129,66,64
99,seq124,r_122_131_129,r_110_123_30,r_122_131_129,0.95,-1,128,129,64
30,r_114_20_40,r_117_75_178,seq26,r_114_20_40,1,0,40,40,64
0,r_48_62_101,r_17_47_15,seq60,r_48_62_101,0.81,7,108,101,64
49,r_70_37_12,r_73_116_111,seq34,r_70_37_12,0.96,0,12,12,64
27,r_146_14_174,seq147,seq13,r_146_14_174,0.56,0,174,174,64
42,r_138_99_45,r_140_36_174,seq90,r_138_99_45,1,0,45,45,64
47,r_40_25_139,r_41_7_112,r_78_39_70,r_78_39_70,0.77,42,112,70,64
24,r_6_86_128,r_5_58_118,r_45_4_32,r_45_4_32,0.74,86,118,32,64
26,r_69_145_28,r_73_116_111,seq147,r_69_145_28,1,0,28,28,64
25,r_129_118_80,seq137,r_117_75_178,r_129_118_80,0.67,0,80,80,64
12,r_45_4_32,seq46,r_5_58_118,r_45_4_32,0.97,0,32,32,64
65,seq32,r_29_83_148,r_107_31_7,r_29_83_148,1,-42,106,148,64
0,r_48_62_101,r_41_7_112,r_17_47_15,r_48_62_101,0.79,-59,42,101,64
28,r_2_128_141,r_6_86_128,r_130_1_30,r_130_1_30,0.75,15,45,30,64
34,r_95_33_120,r_91_56_196,r_107_31_7,r_95_33_120,0.98,0,120,120,64
75,seq60,seq46,r_48_62_101,r_48_62_101,0.38,7,108,101,64
32,r_61_100_44,seq60,seq103,r_61_100_44,1,0,44,44,64
78,seq68,r_73_116_111,r_134_67_13,r_134_67_13,0.5,1,14,13,64
22,r_50_84_28,r_41_7_112,seq87,r_50_84_28,0.81,0,28,28,64
9,r_117_75_178,r_113_105_169,r_73_116_111,r_73_116_111,1,47,158,111,64
96,seq111,r_113_105_169,seq121,r_113_105_169,0.63,-15,154,169,64
37,r_107_31_7,r_29_83_148,r_95_33_120,r_107_31_7,0.81,141,148,7,64
28,r_2_128_141,r_130_1_30,r_122_131_129,r_2_128_141,1,2,143,141,64
7,r_110_123_30,seq108,seq124,r_110_123_30,0.78,5,35,30,64
64,seq27,r_29_83_148,r_0_28_45,r_0_28_45,0.88,0,45,45,64
48,r_139_35_42,r_140_36_174,seq34,r_139_35_42,1,0,42,42,64
44,r_41_7_112,r_40_25_139,r_45_4_32,r_40_25_139,0.81,-27,112,139,64
11,r_127_93_46,r_126_9_102,seq94,r_127_93_46,0.99,0,46,46,64
35,r_74_42_71,r_73_116_111,r_78_39_70,r_73_116_111,0.52,-40,71,111,64
8,r_17_47_15,seq16,r_48_62_101,r_17_47_15,0.9,-2,13,15,64
45,r_18_44_90,seq22,seq43,r_18_44_90,0.51,-36,54,90,64
36,r_25_45_128,seq26,seq43,r_25_45_128,0.74,0,128,128,65
2,r_7_125_27,r_17_48_33,seq127,r_7_125_27,0.97,0,27,27,65
6,r_70_20_52,seq69,seq21,r_70_20_52,1,0,52,52,65
5,r_22_12_26,r_25_45_128,seq14,r_22_12_26,0.8,0,26,26,65
53,seq10,r_11_123_148,r_116_8_34,r_116_8_34,0.47,112,146,34,65
37,r_15_108_63,seq14,seq107,r_15_108_63,1,0,63,63,65
51,seq3,r_5_13_9,r_31_4_13,r_31_4_13,0.66,-1,12,13,65
19,r_144_103_124,r_85_143_43,r_30_104_30,r_144_103_124,0.99,0,124,124,65
62,seq32,r_30_104_30,r_56_33_22,r_30_104_30,0.6,-6,24,30,65
71,seq54,r_53_131_119,seq51,r_53_131_119,1,0,119,119,65
86,seq96,r_97_79_122,seq99,r_97_79_122,0.95,0,122,122,65
16,r_130_89_163,seq127,r_2_91_48,r_130_89_163,0.7,0,163,163,65
1,r_74_134_135,seq75,seq132,r_74_134_135,0.87,0,135,135,65
46,r_149_27_158,seq148,seq26,r_149_27_158,0.78,0,158,158,65
42,r_86_140_174,r_77_87_16,seq139,r_86_140_174,0.64,0,174,174,65
12,r_116_8_34,r_115_40_117,seq14,r_116_8_34,0.93,0,34,34,65
25,r_1_67_71,r_71_110_131,r_6_81_38,r_71_110_131,0.54,-16,115,131,65
24,r_85_143_43,r_144_103_124,r_68_136_10,r_144_103_124,1,0,124,124,65
27,r_2_91_48,r_109_92_36,r_130_89_163,r_130_89_163,0.86,7,170,163,65
38,r_93_24_35,seq95,r_25_45_128,r_93_24_35,0.89,0,35,35,65
38,r_93_24_35,r_25_45_128,seq18,r_25_45_128,0.49,-25,103,128,65
41,r_84_65_126,r_77_87_16,seq66,r_84_65_126,0.96,0,126,126,65
24,r_85_143_43,r_77_87_16,r_144_103_124,r_85_143_43,1,0,43,43,65
30,r_30_104_30,seq29,seq101,r_30_104_30,1,0,30,30,65
72,seq58,seq59,r_73_57_26,r_73_57_26,1,1,27,26,65
10,r_135_147_178,seq132,r_52_146_87,r_52_146_87,1,91,178,87,65
26,r_41_106_179,seq42,r_71_110_131,r_41_106_179,0.45,0,179,179,65
14,r_47_129_12,r_130_89_163,r_7_125_27,r_47_129_12,0.78,151,163,12,65
60,seq26,r_121_23_24,r_149_27_158,r_149_27_158,0.96,1,159,158,65
0,r_90_117_190,seq95,r_130_89_163,r_130_89_163,0.62,7,170,163,65
28,r_73_57_26,r_70_20_52,seq58,r_73_57_26,0.64,0,26,26,65
20,r_77_87_16,r_86_140_174,seq82,r_86_140_174,0.83,0,174,174,65
13,r_9_88_166,seq10,r_130_89_163,r_9_88_166,0.76,0,166,166,65
44,r_31_4_13,r_30_104_30,seq3,r_31_4_13,0.54,-1,12,13,65
15,r_115_40_117,seq114,seq42,r_115_40_117,1,0,117,117,65
4,r_17_48_33,r_76_49_2,r_113_46_149,r_113_46_149,0.91,0,149,149,65
82,seq80,seq78,r_6_81_38,r_6_81_38,1,6,44,38,65
12,r_116_8_34,seq14,seq10,r_116_8_34,0.52,94,128,34,65
40,r_53_131_119,seq54,seq132,r_53_131_119,1,0,119,119,65
18,r_128_137_135,r_130_89_163,r_53_131_119,r_53_131_119,0.65,15,134,119,65
29,r_71_110_131,seq72,r_15_108_63,r_71_110_131,0.92,5,136,131,65
25,r_1_67_71,seq0,r_71_110_131,r_1_67_71,0.9,0,71,71,65
33,r_145_28_174,seq148,seq29,r_145_28_174,0.65,0,174,174,65
14,r_47_129_12,r_52_146_87,r_130_89_163,r_47_129_12,0.91,-1,11,12,65
50,seq0,r_1_67_71,r_31_4_13,r_1_67_71,1,0,71,71,65
59,seq21,r_25_45_128,r_70_20_52,r_70_20_52,0.99,7,59,52,65
58,seq148,r_149_27_158,r_52_146_87,r_52_146_87,0.97,33,120,87,65
27,r_2_91_48,seq3,r_109_92_36,r_2_91_48,1,1,49,48,65
52,seq132,r_135_147_178,r_74_134_135,r_74_134_135,0.99,41,176,135,65
77,seq66,seq64,r_84_65_126,r_84_65_126,1,7,133,126,65
34,r_142_98_120,seq139,seq99,r_142_98_120,0.94,0,120,120,65
45,r_141_16_41,r_142_98_120,seq14,r_141_16_41,1,0,41,41,65
47,r_56_33_22,seq58,seq32,r_56_33_22,0.92,-1,21,22,65
22,r_97_79_122,seq96,r_6_81_38,r_97_79_122,0.93,0,122,122,65
91,seq107,r_97_79_122,r_15_108_63,r_15_108_63,0.7,3,66,63,65
49,r_133_39_130,r_135_147_178,r_115_40_117,r_135_147_178,0.78,-48,130,178,65
4,r_17_48_33,r_15_108_63,r_76_49_2,r_17_48_33,0.65,0,33,33,65
23,r_113_46_149,seq114,r_17_48_33,r_113_46_149,0.95,0,149,149,65
31,r_109_92_36,seq107,seq95,r_109_92_36,1,0,36,36,65
35,r_124_120_61,r_130_89_163,seq119,r_130_89_163,0.75,-100,63,163,65
19,r_144_103_124,r_135_147_178,r_85_143_43,r_85_143_43,1,14,57,43,65
3,r_6_81_38,seq3,seq80,r_6_81_38,1,0,38,38,65
30,r_75_125_118,r_76_148_129,r_126_92_180,r_75_125_118,1,0,118,118,66
40,r_142_108_20,r_141_8_60,seq112,r_142_108_20,0.83,0,20,20,66
36,r_44_107_176,seq49,r_97_117_36,r_44_107_176,0.26,0,176,176,66
13,r_22_147_93,seq19,seq144,r_22_147_93,1,0,93,93,66
20,r_131_83_151,seq128,r_126_92_180,r_126_92_180,0.32,-136,44,180,66
14,r_141_8_60,r_136_43_167,r_6_47_170,r_141_8_60,1,0,60,60,66
53,seq5,r_6_47_170,r_141_8_60,r_141_8_60,1,86,146,60,66
8,r_130_89_11,r_126_92_180,seq88,r_130_89_11,0.99,0,11,11,66
87,seq88,r_91_110_36,r_130_89_11,r_91_110_36,0.78,-7,29,36,66
59,seq23,r_22_147_93,r_26_24_193,r_22_147_93,1,-7,86,93,66
16,r_38_87_105,seq42,r_130_89_11,r_38_87_105,0.82,0,105,105,66
21,r_126_92_180,r_131_83_151,r_75_125_118,r_75_125_118,0.57,28,146,118,66
39,r_33_145_160,seq34,r_146_149_138,r_33_145_160,0.77,2,162,160,66
80,seq67,r_66_7_136,seq68,r_66_7_136,1,0,136,136,66
45,r_69_45_159,seq68,seq46,r_69_45_159,0.42,0,159,159,66
13,r_22_147_93,r_21_102_46,seq19,r_21_102_46,1,-4,42,46,66
35,r_1_78_36,seq0,seq80,r_1_78_36,1,0,36,36,66
19,r_90_14_111,seq88,r_120_17_46,r_90_14_111,1,0,111,111,66
10,r_120_17_46,r_111_137_149,r_18_51_70,r_120_17_46,0.99,0,46,46,66
66,seq35,r_36_55_140,seq34,r_36_55_140,0.94,-5,135,140,66
31,r_66_7_136,seq67,r_141_8_60,r_66_7_136,0.85,0,136,136,66
41,r_6_47_170,seq5,r_69_45_159,r_6_47_170,0.66,0,170,170,66
67,seq42,r_40_13_102,r_37_134_175,r_40_13_102,0.98,0,102,102,66
3,r_18_51_70,r_15_109_60,r_120_17_46,r_18_51_70,0.84,-12,58,70,66
67,seq42,r_37_134_175,r_58_39_28,r_37_134_175,0.97,-4,171,175,66
95,seq112,r_111_137_149,r_91_110_36,r_91_110_36,1,1,37,36,66
26,r_136_43_167,r_138_140_150,r_18_51_70,r_136_43_167,0.32,0,167,167,66
14,r_141_8_60,r_6_47_170,r_66_7_136,r_66_7_136,0.79,34,170,136,66
25,r_4_20_183,seq5,r_104_2_47,r_104_2_47,1,7,54,47,66
0,r_15_109_60,r_18_51_70,r_91_110_36,r_15_109_60,1,0,60,60,66
11,r_111_137_149,seq112,r_79_135_95,r_111_137_149,0.74,0,149,149,66
47,r_16_12_111,r_120_17_46,r_40_13_102,r_40_13_102,0.98,8,110,102,66
88,seq95,r_93_72_144,r_28_96_11,r_28_96_11,0.44,18,29,11,66
46,r_104_2_47,seq103,r_4_20_183,r_104_2_47,1,0,47,47,66
10,r_120_17_46,r_18_51_70,r_16_12_111,r_18_51_70,0.87,2,72,70,66
6,r_93_72_144,seq95,r_139_70_105,r_139_70_105,0.98,39,144,105,66
9,r_79_135_95,r_66_7_136,r_1_78_36,r_1_78_36,1,1,37,36,66
27,r_25_64_127,r_26_24_193,seq65,r_25_64_127,0.99,0,127,127,66
3,r_18_51_70,r_120_17_46,r_113_53_11,r_18_51_70,0.99,0,70,70,66
47,r_16_12_111,r_18_51_70,r_120_17_46,r_16_12_111,0.95,-39,72,111,66
10,r_120_17_46,r_16_12_111,r_90_14_111,r_90_14_111,0.91,0,111,111,66
5,r_91_110_36,r_90_14_111,seq112,r_91_110_36,1,0,36,36,66
18,r_76_148_129,r_69_45_159,r_22_147_93,r_76_148_129,0.94,0,129,129,66
24,r_40_13_102,seq42,seq9,r_40_13_102,0.99,0,102,102,66
33,r_138_140_150,r_136_43_167,r_79_135_95,r_79_135_95,1,29,124,95,66
37,r_113_53_11,r_111_137_149,seq52,r_113_53_11,1,0,11,11,66
58,seq19,r_22_147_93,r_26_24_193,r_22_147_93,0.98,5,98,93,66
65,seq34,r_33_145_160,seq29,r_33_145_160,0.62,3,163,160,66
20,r_131_83_151,r_126_92_180,r_130_89_11,r_131_83_151,0.95,0,151,151,66
32,r_143_86_128,seq144,r_130_89_11,r_143_86_128,0.95,0,128,128,66
4,r_28_96_11,r_31_94_121,seq95,r_28_96_11,0.78,0,11,11,66
43,r_60_71_25,seq56,seq68,r_60_71_25,0.81,0,25,25,66
28,r_139_70_105,r_136_43_167,seq73,r_139_70_105,0.99,0,105,105,66
7,r_31_94_121,seq30,r_28_96_11,r_31_94_121,0.93,0,121,121,66
23,r_36_55_140,seq35,r_25_64_127,r_36_55_140,0.63,0,140,140,66
42,r_85_99_29,r_91_110_36,seq98,r_91_110_36,0.68,-7,29,36,66
49,r_21_102_46,r_22_147_93,seq103,r_21_102_46,1,0,46,46,66
12,r_146_149_138,seq144,r_22_147_93,r_22_147_93,1,44,137,93,66
9,r_79_135_95,r_1_78_36,r_138_140_150,r_79_135_95,0.99,0,95,95,66
89,seq98,r_97_117_36,r_85_99_29,r_97_117_36,0.8,-6,30,36,66
30,r_81_83_101,r_82_75_180,r_118_87_83,r_118_87_83,1,96,179,83,67
92,seq101,r_100_5_102,r_147_102_19,r_100_5_102,0.91,-2,100,102,67
18,r_134_77_39,r_133_61_163,r_80_16_182,r_134_77_39,0.98,0,39,39,67
53,seq4,r_3_12_101,r_100_5_102,r_100_5_102,1,0,102,102,67
34,r_141_113_148,r_69_144_123,r_91_109_48,r_141_113_148,0.54,1,149,148,67
43,r_88_8_101,r_90_17_161,seq7,r_88_8_101,1,0,101,101,67
37,r_98_97_174,seq99,r_108_95_20,r_108_95_20,0.59,154,174,20,67
7,r_149_115_42,r_148_72_83,seq117,r_149_115_42,0.98,0,42,42,67
78,seq47,r_49_86_35,seq46,r_49_86_35,0.87,0,35,35,67
55,seq7,seq9,r_88_8_101,r_88_8_101,1,0,101,101,67
86,seq71,r_70_10_138,seq62,r_70_10_138,1,0,138,138,67
16,r_143_93_98,r_141_113_148,r_90_17_161,r_143_93_98,0.99,0,98,98,67
21,r_114_73_79,seq111,seq74,r_114_73_79,1,0,79,79,67
39,r_64_28_173,seq62,r_38_29_36,r_38_29_36,0.57,135,171,36,67
1,r_40_76_20,seq85,r_89_78_97,r_40_76_20,0.47,97,117,20,67
5,r_140_39_129,r_141_113_148,seq41,r_140_39_129,0.84,1,130,129,67
46,r_52_79_70,seq51,r_80_16_182,r_52_79_70,0.75,0,70,70,67
9,r_112_122_27,r_114_73_79,seq123,r_114_73_79,0.94,-48,31,79,67
45,r_94_19_149,r_90_17_161,r_48_24_24,r_48_24_24,1,125,149,24,67
45,r_94_19_149,seq92,r_90_17_161,r_94_19_149,0.41,-46,103,149,67
1,r_40_76_20,r_38_29_36,seq85,r_40_76_20,0.71,-1,19,20,67
27,r_49_86_35,seq85,r_118_87_83,r_118_87_83,1,62,145,83,67
27,r_49_86_35,seq47,seq85,r_49_86_35,0.92,0,35,35,67
96,seq117,r_149_115_42,r_22_116_91,r_22_116_91,1,31,122,91,67
3,r_131_60_119,seq130,seq65,r_131_60_119,0.66,0,119,119,67
19,r_48_24_24,r_49_86_35,seq25,r_48_24_24,1,-1,23,24,67
90,seq92,r_94_19_149,r_143_93_98,r_143_93_98,0.99,7,105,98,67
49,r_91_109_48,r_94_19_149,seq111,r_91_109_48,1,1,49,48,67
26,r_90_17_161,r_88_8_101,r_94_19_149,r_88_8_101,1,-3,98,101,67
14,r_66_142_23,r_141_113_148,r_135_146_139,r_141_113_148,0.74,1,149,148,67
48,r_129_132_176,r_118_87_83,r_18_127_20,r_129_132_176,0.9,-136,40,176,67
4,r_118_87_83,r_112_122_27,r_49_86_35,r_118_87_83,1,0,83,83,67
0,r_96_2_161,r_108_95_20,seq0,r_96_2_161,0.8,0,161,161,67
73,seq41,seq37,r_140_39_129,r_140_39_129,1,13,142,129,67
13,r_69_144_123,seq68,seq145,r_69_144_123,0.96,0,123,123,67
41,r_108_95_20,r_149_115_42,r_98_97_174,r_149_115_42,0.84,135,177,42,67
15,r_54_58_146,seq51,r_131_60_119,r_131_60_119,0.93,27,146,119,67
41,r_108_95_20,r_118_87_83,r_96_2_161,r_108_95_20,0.97,0,20,20,67
62,seq21,r_22_116_91,r_15_20_51,r_22_116_91,0.88,-28,63,91,67
85,seq68,r_69_144_123,seq62,r_69_144_123,0.99,0,123,123,67
16,r_143_93_98,r_90_17_161,seq92,r_90_17_161,1,-9,152,161,67
31,r_18_127_20,seq21,r_129_132_176,r_18_127_20,1,0,20,20,67
89,seq85,r_89_78_97,r_49_86_35,r_49_86_35,0.75,23,58,35,67
87,seq74,seq65,r_114_73_79,r_114_73_79,1,0,79,79,67
3,r_131_60_119,seq65,r_54_58_146,r_131_60_119,0.62,31,150,119,67
41,r_108_95_20,r_96_2_161,r_149_115_42,r_149_115_42,0.65,124,166,42,67
61,seq145,r_140_39_129,r_135_146_139,r_140_39_129,0.96,-9,120,129,67
29,r_100_5_102,seq101,seq4,r_100_5_102,0.99,0,102,102,67
46,r_52_79_70,r_80_16_182,r_89_78_97,r_89_78_97,0.51,25,122,97,67
24,r_135_146_139,seq137,seq145,r_135_146_139,0.71,0,139,139,67
48,r_129_132_176,r_18_127_20,seq136,r_129_132_176,0.81,2,178,176,67
64,seq25,r_26_110_160,r_38_29_36,r_38_29_36,0.92,124,160,36,67
81,seq56,seq65,r_53_57_32,r_53_57_32,0.98,7,39,32,67
14,r_66_142_23,r_69_144_123,r_141_113_148,r_66_142_23,1,0,23,23,67
61,seq145,r_148_72_83,r_140_39_129,r_148_72_83,1,1,84,83,67
32,r_26_110_160,seq25,r_141_113_148,r_26_110_160,0.65,0,160,160,67
38,r_70_10_138,seq71,r_3_12_101,r_70_10_138,0.74,0,138,138,67
20,r_84_55_27,r_82_75_180,seq51,r_84_55_27,0.76,0,27,27,67
34,r_141_113_148,r_140_39_129,r_69_144_123,r_141_113_148,0.49,-18,130,148,67
6,r_31_120_15,seq32,seq119,r_31_120_15,1,0,15,15,67
17,r_89_78_97,r_90_17_161,r_134_77_39,r_89_78_97,0.66,0,97,97,67
2,r_38_29_36,seq37,r_48_24_24,r_38_29_36,0.84,1,37,36,67
96,seq117,seq99,r_149_115_42,r_149_115_42,0.99,18,60,42,67
31,r_18_127_20,r_129_132_176,r_26_110_160,r_26_110_160,0.61,17,177,160,67
22,r_148_72_83,seq145,r_114_73_79,r_148_72_83,0.97,1,84,83,67
28,r_80_16_182,seq85,r_52_79_70,r_52_79_70,0.85,17,87,70,67
91,seq99,r_98_97_174,r_18_127_20,r_18_127_20,0.64,129,149,20,67
8,r_121_138_46,seq119,seq137,r_121_138_46,1,0,46,46,67
18,r_134_77_39,r_80_16_182,r_89_78_97,r_134_77_39,0.42,62,101,39,67
44,r_63_50_157,seq62,r_84_55_27,r_84_55_27,0.97,128,155,27,67
11,r_53_57_32,seq51,seq56,r_53_57_32,0.68,0,32,32,67
82,seq62,r_63_50_157,seq56,r_63_50_157,0.91,0,157,157,67
79,seq51,r_52_79_70,r_84_55_27,r_52_79_70,0.86,0,70,70,67
12,r_22_116_91,r_26_110_160,seq117,r_22_116_91,0.66,0,91,91,67
36,r_103_45_48,r_100_5_102,seq46,r_103_45_48,1,0,48,48,67
30,r_99_16_134,seq100,r_19_13_41,r_99_16_134,0.87,0,134,134,68
44,r_89_11_107,r_123_87_18,r_80_12_65,r_123_87_18,0.93,89,107,18,68
36,r_136_45_145,seq137,seq46,r_136_45_145,0.91,0,145,145,68
54,seq4,r_3_139_49,seq6,r_3_139_49,0.77,0,49,49,68
92,seq106,r_105_122_118,seq97,r_105_122_118,1,4,122,118,68
43,r_110_61_141,seq111,r_27_64_106,r_110_61_141,0.88,0,141,141,68
0,r_105_122_118,seq143,r_35_120_161,r_35_120_161,1,0,161,161,68
37,r_78_55_77,r_77_10_142,seq59,r_78_55_77,0.76,0,77,77,68
20,r_148_71_35,seq147,r_86_70_23,r_148_71_35,1,1,36,35,68
24,r_124_28_59,r_132_101_133,seq30,r_124_28_59,1,0,59,59,68
21,r_77_10_142,r_78_55_77,seq76,r_78_55_77,1,0,77,77,68
39,r_115_34_98,seq114,seq36,r_115_34_98,0.97,0,98,98,68
1,r_94_133_169,r_37_92_12,r_113_141_70,r_94_133_169,0.84,0,169,169,68
23,r_121_145_19,r_123_87_18,r_146_81_173,r_121_145_19,0.99,0,19,19,68
5,r_80_12_65,r_79_88_101,r_19_13_41,r_80_12_65,1,0,65,65,68
42,r_52_135_161,seq59,r_113_141_70,r_52_135_161,0.9,0,161,161,68
44,r_89_11_107,r_86_70_23,r_123_87_18,r_89_11_107,0.96,-84,23,107,68
45,r_5_21_120,seq6,seq24,r_5_21_120,0.98,1,121,120,68
95,seq111,r_113_141_70,r_110_61_141,r_113_141_70,1,0,70,70,68
31,r_22_82_74,r_23_138_184,r_123_87_18,r_22_82_74,1,0,74,74,68
41,r_26_93_156,r_18_140_161,r_37_92_12,r_26_93_156,0.61,0,156,156,68
67,seq36,r_35_120_161,r_115_34_98,r_115_34_98,1,63,161,98,68
16,r_123_87_18,r_121_145_19,r_89_11_107,r_123_87_18,1,0,18,18,68
3,r_126_8_116,seq127,seq6,r_126_8_116,1,0,116,116,68
10,r_73_58_173,r_72_7_169,r_90_56_123,r_73_58_173,0.56,-4,169,173,68
26,r_29_144_73,r_27_64_106,r_121_145_19,r_29_144_73,1,0,73,73,68
16,r_123_87_18,r_89_11_107,r_79_88_101,r_89_11_107,0.92,0,107,107,68
14,r_37_92_12,r_94_133_169,r_26_93_156,r_37_92_12,0.67,157,169,12,68
0,r_105_122_118,seq106,seq143,r_105_122_118,0.81,5,123,118,68
11,r_90_56_123,r_94_133_169,seq59,r_90_56_123,0.98,0,123,123,68
13,r_9_57_137,r_19_13_41,r_90_56_123,r_90_56_123,0.75,15,138,123,68
15,r_125_118_73,r_126_8_116,seq119,r_125_118_73,1,0,73,73,68
8,r_44_91_51,seq46,r_37_92_12,r_44_91_51,0.89,0,51,51,68
57,seq137,r_136_45_145,r_113_141_70,r_113_141_70,0.74,61,131,70,68
6,r_35_120_161,seq36,r_105_122_118,r_35_120_161,0.74,0,161,161,68
21,r_77_10_142,seq76,r_99_16_134,r_77_10_142,0.98,0,142,142,68
99,seq127,r_126_8_116,seq131,r_126_8_116,1,0,116,116,68
71,seq46,r_44_91_51,seq50,r_44_91_51,0.94,0,51,51,68
27,r_31_74_155,seq30,r_83_75_26,r_31_74_155,0.72,2,157,155,68
2,r_23_138_184,seq24,r_94_133_169,r_23_138_184,0.51,0,184,184,68
47,r_103_40_121,r_105_122_118,r_54_41_2,r_103_40_121,0.89,0,121,121,68
18,r_113_141_70,seq111,r_3_139_49,r_113_141_70,1,0,70,70,68
29,r_27_64_106,r_31_74_155,seq65,r_27_64_106,0.98,0,106,106,68
25,r_132_101_133,seq131,seq102,r_132_101_133,0.98,0,133,133,68
33,r_142_84_65,seq143,seq85,r_142_84_65,1,0,65,65,68
32,r_19_13_41,r_18_140_161,seq14,r_18_140_161,0.85,-118,43,161,68
64,seq24,r_23_138_184,r_5_21_120,r_5_21_120,0.96,10,130,120,68
38,r_86_70_23,r_72_7_169,r_148_71_35,r_86_70_23,0.73,57,80,23,68
65,seq30,r_31_74_155,r_124_28_59,r_124_28_59,1,74,133,59,68
68,seq134,seq143,r_3_139_49,r_3_139_49,1,39,88,49,68
54,seq4,r_25_0_5,r_126_8_116,r_126_8_116,0.73,39,155,116,68
71,seq46,seq50,r_136_45_145,r_136_45_145,0.98,2,147,145,68
14,r_37_92_12,r_43_69_150,r_94_133_169,r_37_92_12,0.74,0,12,12,68
46,r_3_139_49,seq4,seq137,r_3_139_49,1,0,49,49,68
38,r_86_70_23,r_89_11_107,r_72_7_169,r_86_70_23,0.97,0,23,23,68
9,r_72_7_169,r_73_58_173,r_126_8_116,r_72_7_169,0.46,0,169,169,68
1,r_94_133_169,r_90_56_123,r_37_92_12,r_94_133_169,0.54,-154,15,169,68
96,seq114,r_115_34_98,seq116,r_115_34_98,1,0,98,98,68
22,r_53_60_83,r_52_135_161,seq59,r_52_135_161,1,-77,84,161,68
28,r_130_104_164,seq128,seq106,r_130_104_164,0.79,0,164,164,68
49,r_79_88_101,r_80_12_65,r_123_87_18,r_79_88_101,0.91,-33,68,101,68
7,r_42_32_187,seq39,r_54_41_2,r_54_41_2,0.63,185,187,2,68
35,r_18_140_161,r_19_13_41,r_113_141_70,r_18_140_161,0.85,0,161,161,68
12,r_95_112_170,seq97,seq111,r_95_112_170,0.46,0,170,170,68
95,seq111,r_110_61_141,seq116,r_110_61_141,0.98,-44,97,141,68
23,r_121_145_19,r_146_81_173,r_29_144_73,r_29_144_73,0.89,32,105,73,68
14,r_7_89_60,r_6_1_108,seq91,r_7_89_60,0.99,0,60,60,69
43,r_84_107_127,seq83,seq106,r_84_107_127,0.82,2,129,127,69
37,r_99_9_146,seq100,r_48_11_139,r_99_9_146,0.64,0,146,146,69
59,seq142,r_140_94_183,r_70_141_111,r_70_141_111,0.96,1,112,111,69
71,seq42,r_43_85_170,r_65_44_113,r_65_44_113,0.94,57,170,113,69
72,seq45,seq50,r_101_46_21,r_101_46_21,1,1,22,21,69
86,seq91,r_90_79_63,r_7_89_60,r_7_89_60,1,26,86,60,69
16,r_66_38_62,r_70_141_111,r_37_149_105,r_66_38_62,1,0,62,62,69
39,r_93_113_93,r_90_79_63,r_111_21_196,r_93_113_93,0.78,8,101,93,69
1,r_139_102_83,r_140_94_183,r_80_104_47,r_139_102_83,0.76,0,83,83,69
46,r_52_55_127,seq51,r_20_56_71,r_20_56_71,0.73,55,126,71,69
42,r_65_44_113,seq69,seq42,r_65_44_113,0.91,0,113,113,69
34,r_112_15_15,r_114_0_91,seq10,r_112_15_15,0.99,0,15,15,69
8,r_16_17_114,seq35,r_72_19_2,r_16_17_114,0.42,-60,54,114,69
45,r_111_21_196,seq110,r_93_113_93,r_93_113_93,0.99,1,94,93,69
30,r_101_46_21,r_114_0_91,seq45,r_101_46_21,0.93,0,21,21,69
19,r_114_0_91,r_111_21_196,r_77_4_90,r_114_0_91,0.55,0,91,91,69
27,r_140_94_183,r_70_141_111,seq97,r_140_94_183,0.92,0,183,183,69
76,seq53,r_93_113_93,r_20_56_71,r_20_56_71,1,-7,64,71,69
26,r_37_149_105,r_66_38_62,r_74_144_104,r_37_149_105,0.97,0,105,105,69
31,r_20_56_71,r_23_13_193,seq53,r_20_56_71,1,0,71,71,69
89,seq105,r_114_0_91,r_80_104_47,r_114_0_91,0.84,-30,61,91,69
10,r_39_118_117,seq41,seq117,r_39_118_117,0.99,0,117,117,69
20,r_80_104_47,r_76_63_184,seq105,r_80_104_47,0.97,0,47,47,69
26,r_37_149_105,seq35,r_66_38_62,r_66_38_62,1,3,65,62,69
75,seq51,r_96_98_49,r_93_113_93,r_96_98_49,0.72,123,172,49,69
4,r_70_141_111,seq69,seq142,r_70_141_111,0.98,0,111,111,69
78,seq57,r_76_63_184,r_124_62_121,r_124_62_121,1,21,142,121,69
0,r_78_73_87,r_76_63_184,r_90_79_63,r_90_79_63,1,78,141,63,69
63,seq25,r_26_49_186,seq27,r_26_49_186,0.36,0,186,186,69
11,r_74_144_104,r_75_103_113,r_71_146_47,r_75_103_113,1,-9,104,113,69
13,r_119_22_84,seq117,seq24,r_119_22_84,0.99,0,84,84,69
15,r_115_132_99,seq116,r_58_125_73,r_115_132_99,0.98,-1,98,99,69
48,r_130_147_167,seq129,r_74_144_104,r_74_144_104,0.85,65,169,104,69
6,r_77_4_90,r_76_63_184,seq3,r_77_4_90,1,0,90,90,69
21,r_145_88_184,r_71_146_47,r_124_62_121,r_124_62_121,0.71,61,182,121,69
85,seq86,r_84_107_127,r_5_87_80,r_5_87_80,0.78,0,80,80,69
36,r_71_146_47,r_145_88_184,r_74_144_104,r_74_144_104,1,80,184,104,69
27,r_140_94_183,seq142,r_70_141_111,r_70_141_111,1,2,113,111,69
87,seq97,r_95_81_172,seq100,r_95_81_172,0.43,5,177,172,69
2,r_95_81_172,seq97,r_124_62_121,r_124_62_121,0.97,56,177,121,69
47,r_76_63_184,r_78_73_87,r_145_88_184,r_145_88_184,0.93,0,184,184,69
40,r_124_62_121,seq126,seq59,r_124_62_121,0.97,0,121,121,69
29,r_23_13_193,r_72_19_2,r_48_11_139,r_48_11_139,0.99,54,193,139,69
24,r_82_36_77,r_84_107_127,r_66_38_62,r_84_107_127,0.93,-50,77,127,69
33,r_43_85_170,seq42,r_5_87_80,r_43_85_170,0.43,0,170,170,69
88,seq100,r_99_9_146,r_96_98_49,r_99_9_146,0.9,0,146,146,69
21,r_145_88_184,seq148,r_71_146_47,r_71_146_47,1,0,47,47,69
61,seq148,r_145_88_184,r_71_146_47,r_71_146_47,1,16,63,47,69
32,r_6_1_108,r_5_87_80,r_16_17_114,r_5_87_80,0.76,0,80,80,69
38,r_121_54_176,seq120,r_20_56_71,r_20_56_71,0.47,105,176,71,69
32,r_6_1_108,r_16_17_114,r_77_4_90,r_6_1_108,0.77,0,108,108,69
36,r_71_146_47,r_74_144_104,r_145_88_184,r_145_88_184,0.92,-137,47,184,69
75,seq51,r_52_55_127,r_96_98_49,r_52_55_127,0.5,6,133,127,69
60,seq18,r_72_19_2,r_16_17_114,r_16_17_114,0.67,1,115,114,69
17,r_29_127_89,seq27,r_58_125_73,r_29_127_89,0.99,0,89,89,69
94,seq116,r_115_132_99,seq117,r_115_132_99,1,-12,87,99,69
9,r_58_125_73,seq59,seq126,r_58_125_73,1,0,73,73,69
28,r_90_79_63,seq91,r_78_73_87,r_78_73_87,0.55,-1,86,87,69
7,r_64_31_84,r_76_63_184,seq33,r_64_31_84,0.92,0,84,84,69
44,r_75_103_113,r_74_144_104,r_139_102_83,r_75_103_113,1,-8,105,113,69
16,r_66_38_62,r_37_149_105,r_82_36_77,r_37_149_105,0.99,0,105,105,69
3,r_96_98_49,r_95_81_172,seq100,r_96_98_49,0.66,-24,25,49,69
35,r_5_87_80,r_6_1_108,seq86,r_5_87_80,1,0,80,80,69
12,r_137_14_178,seq136,r_112_15_15,r_137_14_178,0.4,0,178,178,69
84,seq83,r_84_107_127,r_5_87_80,r_5_87_80,0.86,49,129,80,69
36,r_35_86_67,r_37_11_155,r_82_74_170,r_35_86_67,0.95,0,67,67,70
54,seq6,r_7_76_163,r_14_16_160,r_7_76_163,0.55,0,163,163,70
83,seq81,r_82_74_170,r_67_80_92,r_67_80_92,1,76,168,92,70
59,seq23,r_24_92_157,seq27,r_24_92_157,0.93,0,157,157,70
13,r_131_117_40,r_130_47_93,seq116,r_130_47_93,0.72,-48,45,93,70
55,seq8,r_9_18_118,r_138_13_76,r_138_13_76,0.74,42,118,76,70
16,r_82_74_170,seq81,r_149_73_1,r_149_73_1,0.7,169,170,1,70
21,r_10_93_73,r_9_18_118,r_143_94_59,r_10_93_73,0.89,0,73,73,70
1,r_61_103_117,seq60,seq104,r_61_103_117,0.99,0,117,117,70
46,r_46_140_129,seq44,seq141,r_46_140_129,0.9,3,132,129,70
42,r_138_13_76,seq141,seq8,r_138_13_76,1,0,76,76,70
4,r_43_3_25,seq42,seq4,r_43_3_25,0.98,0,25,25,70
14,r_36_68_17,r_37_11_155,seq75,r_36_68_17,0.71,-2,15,17,70
77,seq55,r_59_87_73,r_71_54_31,r_59_87_73,0.9,-32,41,73,70
19,r_67_80_92,seq66,seq81,r_67_80_92,1,0,92,92,70
27,r_17_84_143,seq29,r_9_18_118,r_9_18_118,0.71,0,118,118,70
27,r_17_84_143,r_26_22_12,seq29,r_17_84_143,0.52,-108,35,143,70
89,seq104,r_108_105_71,r_61_103_117,r_61_103_117,1,30,147,117,70
37,r_143_94_59,r_139_147_112,r_91_89_76,r_143_94_59,0.48,0,59,59,70
26,r_25_136_139,r_24_92_157,seq132,r_25_136_139,0.94,0,139,139,70
0,r_95_57_122,seq96,r_71_54_31,r_95_57_122,0.79,0,122,122,70
11,r_14_16_160,r_15_106_169,seq6,r_15_106_169,0.54,-79,90,169,70
15,r_137_58_139,r_135_126_131,r_95_57_122,r_135_126_131,0.58,8,139,131,70
48,r_15_106_169,r_14_16_160,r_61_103_117,r_15_106_169,0.44,0,169,169,70
3,r_9_18_118,r_17_84_143,r_144_19_41,r_17_84_143,1,3,146,143,70
37,r_143_94_59,r_91_89_76,r_10_93_73,r_10_93_73,0.97,3,76,73,70
12,r_144_19_41,r_20_99_147,r_146_28_8,r_20_99_147,0.93,0,147,147,70
27,r_17_84_143,r_9_18_118,seq85,r_17_84_143,0.94,0,143,143,70
10,r_0_21_174,r_43_3_25,r_146_28_8,r_146_28_8,0.51,168,176,8,70
12,r_144_19_41,r_145_56_172,r_20_99_147,r_144_19_41,1,0,41,41,70
47,r_148_97_150,r_145_56_172,r_20_99_147,r_148_97_150,0.56,0,150,150,70
18,r_69_124_73,seq70,seq125,r_69_124_73,1,0,73,73,70
29,r_78_113_76,seq75,seq112,r_78_113_76,1,1,77,76,70
23,r_2_121_55,r_5_65_90,seq120,r_2_121_55,1,0,55,55,70
45,r_20_99_147,seq27,r_144_19_41,r_144_19_41,1,-2,39,41,70
25,r_5_65_90,seq4,seq66,r_5_65_90,0.91,0,90,90,70
32,r_51_101_147,seq50,seq102,r_51_101_147,0.82,0,147,147,70
24,r_90_100_23,r_88_30_32,seq102,r_88_30_32,0.69,-9,23,32,70
45,r_20_99_147,r_144_19_41,r_90_100_23,r_20_99_147,0.87,0,147,147,70
7,r_127_110_30,r_131_117_40,seq111,r_127_110_30,0.67,0,30,30,70
81,seq70,r_69_124_73,r_36_68_17,r_69_124_73,0.99,0,73,73,70
30,r_88_30_32,r_82_74_170,seq31,r_88_30_32,1,0,32,32,70
17,r_130_47_93,seq128,seq45,r_130_47_93,1,0,93,93,70
10,r_0_21_174,r_1_109_151,r_43_3_25,r_0_21_174,0.64,-127,47,174,70
28,r_114_119_70,seq111,seq118,r_114_119_70,0.92,0,70,70,70
36,r_35_86_67,r_82_74_170,r_59_87_73,r_59_87_73,0.68,10,83,73,70
44,r_91_89_76,seq98,r_59_87_73,r_59_87_73,1,3,76,73,70
8,r_71_54_31,r_72_64_143,seq55,r_71_54_31,0.86,2,33,31,70
35,r_37_11_155,seq39,r_138_13_76,r_37_11_155,0.61,0,155,155,70
30,r_94_20_126,seq96,seq19,r_94_20_126,0.82,0,126,126,71
16,r_101_75_15,r_109_6_21,seq76,r_101_75_15,0.73,0,15,15,71
55,seq8,seq7,r_109_6_21,r_109_6_21,0.96,24,45,21,71
14,r_138_91_64,r_136_9_180,seq90,r_138_91_64,1,0,64,64,71
8,r_62_147_158,r_68_10_182,seq144,r_68_10_182,0.81,-24,158,182,71
48,r_39_12_29,r_107_63_119,seq19,r_107_63_119,0.6,45,164,119,71
37,r_118_95_163,seq117,r_16_93_33,r_118_95_163,0.61,0,163,163,71
21,r_73_48_103,seq76,seq51,r_73_48_103,0.46,0,103,103,71
39,r_130_60_99,seq133,r_28_61_61,r_130_60_99,1,0,99,99,71
5,r_107_63_119,r_106_115_146,seq69,r_107_63_119,0.81,0,119,119,71
46,r_68_10_182,seq69,r_136_9_180,r_68_10_182,0.57,0,182,182,71
42,r_106_115_146,seq105,r_142_116_104,r_106_115_146,0.95,0,146,146,71
60,seq144,r_1_135_1,r_62_147_158,r_62_147_158,0.72,8,166,158,71
32,r_5_143_129,r_109_6_21,r_58_140_20,r_5_143_129,1,0,129,129,71
45,r_145_74_109,r_146_100_91,seq144,r_146_100_91,0.94,0,91,91,71
32,r_5_143_129,seq7,r_109_6_21,r_109_6_21,0.99,12,33,21,71
47,r_11_66_54,r_39_12_29,seq65,r_11_66_54,0.75,0,54,54,71
43,r_55_132_49,r_56_30_102,seq133,r_55_132_49,1,0,49,49,71
66,seq31,seq32,r_56_30_102,r_56_30_102,0.88,8,110,102,71
44,r_28_61_61,r_141_29_9,r_11_66_54,r_11_66_54,0.71,10,64,54,71
41,r_104_110_104,r_106_115_146,seq105,r_106_115_146,1,-42,104,146,71
11,r_120_72_27,seq117,r_101_75_15,r_120_72_27,1,0,27,27,71
1,r_16_93_33,seq15,seq90,r_16_93_33,0.82,0,33,33,71
0,r_17_34_66,seq15,seq32,r_17_34_66,0.99,1,67,66,71
13,r_64_43_80,r_62_147_158,seq51,r_62_147_158,0.67,-74,84,158,71
96,seq117,r_120_72_27,r_44_119_4,r_120_72_27,0.86,0,27,27,71
4,r_109_6_21,r_5_143_129,r_148_2_34,r_109_6_21,0.68,75,96,21,71
45,r_145_74_109,seq144,r_101_75_15,r_145_74_109,1,0,109,109,71
6,r_86_41_64,r_87_53_193,seq38,r_86_41_64,1,0,64,64,71
26,r_58_140_20,r_56_30_102,seq139,r_58_140_20,1,0,20,20,71
27,r_108_47_133,r_106_115_146,seq46,r_108_47_133,0.94,0,133,133,71
2,r_111_88_115,r_114_42_116,r_138_91_64,r_111_88_115,1,-2,113,115,71
25,r_59_82_30,r_62_147_158,r_94_20_126,r_59_82_30,0.69,1,31,30,71
76,seq54,r_56_30_102,r_102_57_28,r_102_57_28,0.55,27,55,28,71
40,r_114_42_116,seq113,seq46,r_114_42_116,0.88,0,116,116,71
18,r_149_45_86,r_146_100_91,seq51,r_149_45_86,1,0,86,86,71
29,r_136_9_180,seq137,seq8,r_136_9_180,0.6,0,180,180,71
36,r_148_2_34,r_149_45_86,seq3,r_148_2_34,1,0,34,34,71
48,r_39_12_29,seq13,r_107_63_119,r_107_63_119,0.67,22,141,119,71
70,seq38,r_37_84_181,r_86_41_64,r_86_41_64,1,0,64,64,71
44,r_28_61_61,r_35_71_85,r_141_29_9,r_141_29_9,0.98,1,10,9,71
54,seq7,r_0_89_144,r_109_6_21,r_109_6_21,0.99,2,23,21,71
47,r_11_66_54,seq19,r_39_12_29,r_39_12_29,0.94,4,33,29,71
34,r_131_21_90,seq133,seq22,r_131_21_90,1,0,90,90,71
4,r_109_6_21,r_107_63_119,r_5_143_129,r_109_6_21,0.98,0,21,21,71
49,r_124_112_40,r_126_128_153,seq113,r_124_112_40,1,0,40,40,71
25,r_59_82_30,r_94_20_126,r_26_83_97,r_26_83_97,0.55,0,97,97,71
17,r_37_84_181,seq38,r_26_83_97,r_26_83_97,1,84,181,97,71
94,seq105,r_106_115_146,r_146_100_91,r_146_100_91,0.82,55,146,91,71
9,r_146_100_91,r_145_74_109,seq105,r_146_100_91,1,0,91,91,71
22,r_35_71_85,seq36,r_101_75_15,r_35_71_85,0.91,3,88,85,71
20,r_141_29_9,r_28_61_61,seq31,r_28_61_61,0.84,3,64,61,71
28,r_102_57_28,r_107_63_119,seq54,r_102_57_28,0.7,0,28,28,71
7,r_23_25_62,seq24,seq27,r_23_25_62,0.99,1,63,62,71
23,r_26_83_97,seq27,r_59_82_30,r_26_83_97,0.87,0,97,97,71
20,r_141_29_9,r_142_116_104,r_28_61_61,r_141_29_9,0.97,1,10,9,71
4,r_109_6_21,r_148_2_34,seq8,r_148_2_34,0.69,113,147,34,71
19,r_129_14_40,seq133,seq15,r_129_14_40,0.98,0,40,40,71
12,r_56_30_102,seq54,seq31,r_56_30_102,0.78,0,102,102,71
33,r_18_69_51,seq24,seq72,r_18_69_51,1,0,51,51,72
14,r_92_47_157,seq94,r_6_49_97,r_92_47_157,0.6,0,157,157,72
8,r_87_34_113,seq86,seq35,r_87_34_113,1,0,113,113,72
43,r_128_58_170,r_130_106_126,r_146_129_147,r_130_106_126,0.94,0,126,126,72
5,r_4_95_187,r_6_49_97,r_45_3_10,r_4_95_187,0.61,-175,12,187,72
25,r_52_19_57,seq46,r_22_91_149,r_52_19_57,0.99,0,57,57,72
59,seq35,r_33_32_54,r_87_34_113,r_87_34_113,1,14,127,113,72
55,seq145,r_146_129_147,r_126_147_127,r_126_147_127,0.62,20,147,127,72
21,r_133_144_151,r_134_21_184,r_126_147_127,r_126_147_127,0.73,24,151,127,72
39,r_15_123_189,seq13,seq122,r_15_123_189,0.26,0,189,189,72
1,r_30_16_112,r_33_32_54,r_96_17_92,r_96_17_92,1,20,112,92,72
46,r_6_49_97,r_4_95_187,seq46,r_6_49_97,1,0,97,97,72
7,r_96_17_92,r_15_123_189,r_30_16_112,r_96_17_92,0.62,68,160,92,72
45,r_11_48_73,seq10,seq46,r_11_48_73,0.93,0,73,73,72
19,r_140_83_127,r_141_7_93,r_146_129_147,r_141_7_93,1,2,95,93,72
9,r_26_118_48,r_30_16_112,seq119,r_26_118_48,1,0,48,48,72
17,r_68_142_39,r_64_5_174,seq145,r_68_142_39,1,0,39,39,72
42,r_146_129_147,r_128_58_170,seq137,r_128_58_170,0.95,0,170,170,72
41,r_64_5_174,seq65,r_45_3_10,r_64_5_174,0.47,0,174,174,72
3,r_57_27_145,seq56,seq29,r_57_27_145,0.74,0,145,145,72
10,r_126_147_127,seq127,seq145,r_126_147_127,0.63,0,127,127,72
26,r_114_81_109,r_112_93_155,seq82,r_114_81_109,0.92,0,109,109,72
0,r_112_93_155,seq113,seq94,r_112_93_155,0.42,0,155,155,72
11,r_22_91_149,seq24,r_130_106_126,r_22_91_149,0.76,0,149,149,72
20,r_78_1_104,r_79_12_138,r_4_95_187,r_78_1_104,0.85,0,104,104,72
13,r_141_7_93,r_140_83_127,seq10,r_141_7_93,1,0,93,93,72
15,r_124_23_174,seq125,r_30_16_112,r_30_16_112,0.74,63,175,112,72
48,r_120_71_48,r_133_144_151,seq74,r_133_144_151,0.76,-36,115,151,72
4,r_14_149_55,r_128_58_170,r_146_129_147,r_128_58_170,0.53,-11,159,170,72
6,r_130_106_126,r_128_58_170,seq109,r_130_106_126,0.99,0,126,126,72
30,r_2_38_17,r_4_95_187,seq36,r_2_38_17,0.99,0,17,17,72
5,r_4_95_187,r_45_3_10,r_76_88_170,r_76_88_170,0.9,17,187,170,72
27,r_79_12_138,seq82,seq10,r_79_12_138,0.93,0,138,138,72
22,r_108_131_81,r_134_21_184,r_55_135_116,r_55_135_116,0.81,64,180,116,72
2,r_76_88_170,seq75,r_22_91_149,r_76_88_170,0.55,0,170,170,72
47,r_40_103_193,seq39,r_130_106_126,r_130_106_126,0.84,67,193,126,72
96,seq119,r_112_93_155,r_26_118_48,r_26_118_48,1,0,48,48,72
18,r_100_63_194,seq97,r_28_60_173,r_100_63_194,0.38,0,194,194,72
29,r_55_135_116,r_57_27_145,seq137,r_55_135_116,1,0,116,116,72
24,r_134_21_184,r_133_144_151,r_108_131_81,r_108_131_81,1,0,81,81,72
34,r_117_148_89,r_128_58_170,r_55_135_116,r_117_148_89,0.66,76,165,89,72
48,r_120_71_48,seq74,seq72,r_120_71_48,0.71,0,48,48,72
49,r_45_3_10,r_52_19_57,r_4_95_187,r_45_3_10,1,0,10,10,72
58,seq29,r_28_60_173,r_33_32_54,r_28_60_173,0.91,0,173,173,72
20,r_78_1_104,r_4_95_187,r_37_0_167,r_37_0_167,0.88,12,179,167,72
32,r_70_84_79,seq72,seq86,r_70_84_79,0.97,0,79,79,72
40,r_80_61_43,r_79_12_138,seq62,r_80_61_43,0.67,-2,41,43,72
38,r_28_60_173,seq29,r_80_61_43,r_28_60_173,0.47,0,173,173,72
34,r_117_148_89,r_115_59_102,r_128_58_170,r_117_148_89,0.99,0,89,89,72
19,r_140_83_127,r_146_129_147,r_70_84_79,r_140_83_127,0.94,0,127,127,72
19,r_140_83_127,r_70_84_79,r_76_88_170,r_76_88_170,1,7,177,170,72
25,r_52_19_57,r_22_91_149,r_43_20_92,r_52_19_57,0.46,92,149,57,72
94,seq113,r_112_93_155,seq116,r_112_93_155,0.7,0,155,155,72
28,r_115_59_102,r_80_61_43,r_128_58_170,r_128_58_170,1,4,174,170,72
22,r_108_131_81,seq110,r_134_21_184,r_108_131_81,0.99,0,81,81,72
28,r_115_59_102,seq116,r_80_61_43,r_115_59_102,0.77,0,102,102,72
43,r_128_58_170,r_146_129_147,r_115_59_102,r_128_58_170,0.95,0,170,170,72
7,r_96_17_92,r_92_47_157,r_15_123_189,r_96_17_92,1,0,92,92,72
60,seq36,r_37_0_167,r_2_38_17,r_2_38_17,1,1,18,17,72
44,r_43_20_92,seq44,r_52_19_57,r_43_20_92,0.51,1,93,92,72
23,r_132_99_115,r_133_144_151,seq97,r_132_99_115,0.99,0,115,115,72
35,r_31_41_124,r_33_32_54,seq42,r_31_41_124,0.77,0,124,124,72
12,r_107_9_165,seq110,r_143_8_1,r_107_9_165,0.66,1,166,165,72
84,seq94,r_92_47_157,r_112_93_155,r_92_47_157,0.78,0,157,157,72
4,r_14_149_55,r_15_123_189,r_128_58_170,r_14_149_55,0.99,1,56,55,72
30,r_109_28_153,r_104_110_97,seq29,r_109_28_153,0.6,0,153,153,73
44,r_25_41_21,r_44_73_147,r_60_42_90,r_44_73_147,0.68,0,147,147,73
36,r_60_42_90,r_59_53_102,r_44_73_147,r_60_42_90,0.72,0,90,90,73
9,r_74_51_55,seq57,r_67_55_53,r_74_51_55,0.44,68,123,55,73
32,r_44_73_147,r_60_42_90,seq72,r_44_73_147,0.94,0,147,147,73
14,r_147_76_108,seq149,seq75,r_147_76_108,1,1,109,108,73
8,r_130_45_88,seq126,r_101_47_21,r_130_45_88,0.69,2,90,88,73
16,r_111_3_120,seq113,seq4,r_111_3_120,0.99,0,120,120,73
1,r_15_64_126,r_14_36_83,r_92_19_88,r_15_64_126,0.85,-43,83,126,73
97,seq123,seq120,r_86_122_118,r_86_122_118,1,39,157,118,73
35,r_84_66_19,r_86_122_118,r_65_71_150,r_84_66_19,0.94,-1,18,19,73
80,seq75,seq72,r_34_77_140,r_34_77_140,0.98,59,199,140,73
1,r_15_64_126,r_92_19_88,seq63,r_15_64_126,1,0,126,126,73
32,r_44_73_147,r_25_41_21,r_60_42_90,r_60_42_90,0.57,11,101,90,73
10,r_107_85_43,r_104_110_97,seq87,r_107_85_43,1,0,43,43,73
19,r_135_131_183,seq136,r_86_122_118,r_86_122_118,0.97,68,186,118,73
66,seq29,seq27,r_109_28_153,r_109_28_153,0.92,19,172,153,73
31,r_13_31_73,seq12,seq33,r_13_31_73,0.99,0,73,73,73
41,r_35_103_161,r_34_77_140,r_14_36_83,r_35_103_161,0.87,-63,98,161,73
89,seq144,seq146,r_95_143_62,r_95_143_62,1,14,76,62,73
3,r_139_90_123,r_135_131_183,seq91,r_139_90_123,0.98,0,123,123,73
44,r_25_41_21,r_15_64_126,r_44_73_147,r_25_41_21,1,0,21,21,73
4,r_32_68_62,seq33,seq69,r_32_68_62,1,0,62,62,73
15,r_11_142_88,r_141_81_137,r_22_148_81,r_141_81_137,0.97,1,138,137,73
78,seq69,r_79_8_199,r_32_68_62,r_32_68_62,1,1,63,62,73
0,r_34_77_140,r_35_103_161,seq75,r_34_77_140,0.95,0,140,140,73
5,r_82_108_34,seq80,r_118_100_30,r_82_108_34,1,0,34,34,73
73,seq52,r_59_53_102,r_67_55_53,r_67_55_53,0.91,50,103,53,73
11,r_104_110_97,r_102_99_116,r_109_28_153,r_104_110_97,0.65,-2,95,97,73
55,seq7,r_6_98_131,seq10,r_6_98_131,0.57,-112,19,131,73
26,r_125_88_182,r_95_143_62,seq126,r_95_143_62,0.91,-11,51,62,73
15,r_11_142_88,seq12,r_141_81_137,r_11_142_88,0.68,0,88,88,73
24,r_141_81_137,r_11_142_88,seq80,r_141_81_137,1,0,137,137,73
6,r_95_143_62,seq96,seq144,r_95_143_62,0.98,1,63,62,73
7,r_49_94_24,seq48,seq93,r_49_94_24,1,0,24,24,73
48,r_65_71_150,seq63,r_84_66_19,r_84_66_19,1,-1,18,19,73
45,r_37_121_11,r_34_77_140,seq123,r_37_121_11,0.96,0,11,11,73
39,r_67_55_53,r_65_71_150,seq58,r_67_55_53,0.55,0,53,53,73
17,r_118_100_30,r_112_26_94,r_102_99_116,r_112_26_94,0.96,-63,31,94,73
27,r_92_19_88,seq91,r_54_20_57,r_92_19_88,1,0,88,88,73
2,r_86_122_118,seq87,seq123,r_86_122_118,1,0,118,118,73
41,r_35_103_161,r_14_36_83,r_118_100_30,r_35_103_161,1,0,161,161,73
47,r_133_127_79,r_139_90_123,seq126,r_133_127_79,0.75,0,79,79,73
40,r_39_128_81,r_40_38_175,r_133_127_79,r_39_128_81,1,0,81,81,73
18,r_112_26_94,seq113,r_54_20_57,r_112_26_94,1,0,94,94,73
29,r_40_38_175,seq33,r_14_36_83,r_14_36_83,0.96,6,89,83,73
24,r_141_81_137,seq144,r_11_142_88,r_11_142_88,0.97,0,88,88,73
35,r_84_66_19,r_65_71_150,seq63,r_65_71_150,1,0,150,150,73
46,r_102_99_116,r_104_110_97,r_118_100_30,r_102_99_116,0.62,-85,31,116,73
36,r_60_42_90,r_44_73_147,r_25_41_21,r_44_73_147,0.99,0,147,147,73
33,r_59_53_102,seq57,r_67_55_53,r_67_55_53,0.97,53,106,53,73
48,r_65_71_150,r_84_66_19,r_34_77_140,r_34_77_140,0.54,10,150,140,73
9,r_74_51_55,r_79_8_199,seq57,r_74_51_55,0.85,-11,44,55,73
58,seq12,r_13_31_73,seq10,r_13_31_73,1,-4,69,73,73
42,r_140_105_13,r_141_81_137,r_102_99_116,r_140_105_13,0.65,-2,11,13,73
61,seq18,seq16,r_2_17_18,r_2_17_18,0.98,110,128,18,73
12,r_43_138_36,r_44_73_147,seq136,r_43_138_36,1,1,37,36,73
38,r_78_124_118,r_79_8_199,seq123,r_78_124_118,0.94,0,118,118,73
77,seq63,r_65_71_150,r_15_64_126,r_15_64_126,0.58,9,135,126,73
85,seq91,r_92_19_88,seq93,r_92_19_88,1,-36,52,88,73
11,r_104_110_97,r_109_28_153,r_137_114_31,r_109_28_153,1,0,153,153,73
43,r_101_47_21,r_104_110_97,seq46,r_101_47_21,0.99,0,21,21,73
49,r_137_114_31,r_139_90_123,seq113,r_137_114_31,0.83,-1,30,31,73
22,r_22_148_81,seq23,seq145,r_22_148_81,1,0,81,81,73
28,r_14_36_83,r_15_64_126,r_40_38_175,r_14_36_83,0.77,0,83,83,73
91,seq113,r_112_26_94,r_137_114_31,r_112_26_94,0.98,-34,60,94,73
32,r_44_73_147,r_43_138_36,r_25_41_21,r_44_73_147,1,-124,23,147,73
23,r_6_98_131,seq5,r_82_108_34,r_6_98_131,0.97,0,131,131,73
20,r_24_106_10,r_15_64_126,r_102_99_116,r_24_106_10,0.91,0,10,10,73
79,seq72,r_79_8_199,r_9_70_155,r_9_70_155,1,45,200,155,73
13,r_54_20_57,r_59_53_102,seq23,r_54_20_57,1,0,57,57,73
34,r_2_17_18,seq1,seq18,r_2_17_18,1,0,18,18,73
70,seq46,seq48,r_101_47_21,r_101_47_21,1,14,35,21,73
36,r_83_124_128,seq87,r_142_125_68,r_83_124_128,0.7,2,130,128,74
28,r_78_49_27,seq74,r_50_60_101,r_78_49_27,1,0,27,27,74
14,r_18_38_111,seq19,seq37,r_18_38_111,0.81,0,111,111,74
21,r_98_59_18,r_99_95_92,seq66,r_98_59_18,0.99,-1,17,18,74
8,r_47_111_144,r_46_30_105,r_15_43_44,r_15_43_44,0.79,61,105,44,74
59,seq13,r_12_51_155,r_141_14_93,r_141_14_93,1,15,108,93,74
16,r_25_110_108,r_26_4_173,seq112,r_25_110_108,0.91,0,108,108,74
1,r_26_4_173,seq27,r_22_2_167,r_26_4_173,0.47,0,173,173,74
46,r_39_123_115,seq40,seq122,r_39_123_115,0.99,1,116,115,74
80,seq76,seq74,r_52_77_40,r_52_77_40,1,2,42,40,74
30,r_63_119_45,r_64_24_50,seq122,r_63_119_45,1,0,45,45,74
41,r_70_3_36,seq71,r_0_65_142,r_70_3_36,0.96,1,37,36,74
31,r_35_8_89,seq34,r_139_9_14,r_35_8_89,0.96,0,89,89,74
67,seq34,seq37,r_72_36_107,r_72_36_107,1,3,110,107,74
38,r_129_61_44,seq130,seq66,r_129_61_44,1,1,45,44,74
3,r_103_143_100,seq104,r_75_148_47,r_103_143_100,0.99,0,100,100,74
42,r_31_109_25,r_20_138_56,seq108,r_31_109_25,0.8,0,25,25,74
10,r_72_36_107,seq73,seq34,r_72_36_107,1,0,107,107,74
35,r_139_9_14,seq140,seq13,r_139_9_14,1,0,14,14,74
37,r_0_65_142,seq5,r_70_3_36,r_70_3_36,1,23,59,36,74
26,r_45_44_115,r_47_111_144,r_78_49_27,r_45_44_115,0.99,0,115,115,74
44,r_101_146_163,r_20_138_56,r_28_100_139,r_20_138_56,0.59,95,151,56,74
4,r_46_30_105,r_47_111_144,r_64_24_50,r_47_111_144,1,-39,105,144,74
9,r_134_58_39,seq135,seq57,r_134_58_39,1,0,39,39,74
63,seq23,r_22_2_167,r_64_24_50,r_64_24_50,0.97,77,127,50,74
11,r_11_69_106,seq10,seq71,r_11_69_106,0.95,0,106,106,74
2,r_20_138_56,seq19,seq140,r_20_138_56,1,0,56,56,74
47,r_118_42_54,r_117_62_153,seq33,r_118_42_54,1,0,54,54,74
13,r_55_89_159,seq57,r_145_88_21,r_145_88_21,0.5,138,159,21,74
15,r_128_96_130,seq127,r_99_95_92,r_128_96_130,0.64,0,130,130,74
48,r_94_149_148,r_99_95_92,r_75_148_47,r_99_95_92,0.84,56,148,92,74
40,r_15_43_44,seq17,r_78_49_27,r_78_49_27,0.74,17,44,27,74
6,r_142_125_68,r_141_14_93,seq130,r_141_14_93,0.8,-25,68,93,74
21,r_98_59_18,seq66,r_50_60_101,r_98_59_18,0.62,75,93,18,74
27,r_28_100_139,r_26_4_173,r_101_146_163,r_28_100_139,0.76,2,141,139,74
41,r_70_3_36,r_0_65_142,r_48_7_55,r_70_3_36,0.83,83,119,36,74
44,r_101_146_163,r_28_100_139,r_75_148_47,r_75_148_47,0.96,116,163,47,74
24,r_145_88_21,r_147_97_104,seq87,r_145_88_21,0.94,8,29,21,74
35,r_139_9_14,seq13,r_35_8_89,r_35_8_89,1,32,121,89,74
25,r_105_16_167,seq108,seq17,r_105_16_167,0.28,0,167,167,74
33,r_147_97_104,seq144,r_99_95_92,r_147_97_104,0.78,0,104,104,74
68,seq37,seq34,r_18_38_111,r_18_38_111,0.97,0,111,111,74
32,r_85_133_179,seq84,r_83_124_128,r_83_124_128,0.96,48,176,128,74
53,seq5,r_0_65_142,r_48_7_55,r_48_7_55,1,4,59,55,74
34,r_22_2_167,seq23,r_70_3_36,r_22_2_167,0.55,0,167,167,74
8,r_47_111_144,r_15_43_44,seq112,r_47_111_144,0.97,0,144,144,74
17,r_117_62_153,seq122,r_50_60_101,r_117_62_153,0.71,0,153,153,74
61,seq17,r_15_43_44,r_25_110_108,r_15_43_44,0.75,-13,31,44,74
39,r_91_21_11,seq92,seq27,r_91_21_11,0.99,0,11,11,74
37,r_0_65_142,r_70_3_36,r_50_60_101,r_0_65_142,1,0,142,142,74
28,r_78_49_27,r_50_60_101,r_15_43_44,r_15_43_44,0.79,53,97,44,74
45,r_75_148_47,seq76,seq144,r_75_148_47,1,6,53,47,74
22,r_50_60_101,r_47_111_144,r_129_61_44,r_50_60_101,0.96,6,107,101,74
7,r_141_14_93,r_147_97_104,seq13,r_141_14_93,0.98,0,93,93,74
44,r_101_146_163,seq113,r_20_138_56,r_20_138_56,0.77,75,131,56,74
23,r_116_115_61,r_117_62_153,seq114,r_117_62_153,0.9,-97,56,153,74
43,r_64_24_50,seq66,seq23,r_64_24_50,0.95,1,51,50,74
19,r_52_77_40,r_50_60_101,seq76,r_52_77_40,1,0,40,40,74
5,r_48_7_55,r_47_111_144,seq5,r_48_7_55,1,0,55,55,74
29,r_1_102_15,r_0_65_142,seq104,r_1_102_15,0.98,0,15,15,74
40,r_102_48_36,seq45,r_76_46_87,r_76_46_87,0.99,11,98,87,75
36,r_82_0_120,r_80_12_167,r_140_1_14,r_82_0_120,0.92,0,120,120,75
92,seq104,seq101,r_139_103_60,r_139_103_60,1,56,116,60,75
14,r_127_27_65,r_128_33_133,seq28,r_127_27_65,0.99,0,65,65,75
43,r_25_124_63,r_26_111_78,r_128_33_133,r_128_33_133,0.93,-70,63,133,75
5,r_87_142_108,r_90_40_156,r_75_143_53,r_87_142_108,0.92,0,108,108,75
37,r_90_40_156,r_89_67_187,r_56_38_17,r_90_40_156,0.65,0,156,156,75
21,r_86_110_66,r_87_142_108,seq113,r_86_110_66,0.93,0,66,66,75
39,r_119_64_178,seq123,r_32_69_161,r_32_69_161,1,16,177,161,75
46,r_83_125_74,r_80_12_167,r_25_124_63,r_83_125_74,0.99,0,74,74,75
42,r_63_52_148,r_66_135_165,r_116_51_81,r_116_51_81,0.86,67,148,81,75
6,r_43_78_49,seq41,r_79_81_1,r_43_78_49,0.99,0,49,49,75
11,r_91_137_11,seq92,seq138,r_91_137_11,0.89,0,11,11,75
32,r_60_117_157,seq55,r_136_118_99,r_60_117_157,0.98,0,157,157,75
45,r_128_33_133,r_127_27_65,r_25_124_63,r_128_33_133,0.98,-68,65,133,75
24,r_75_143_53,r_88_147_36,r_87_142_108,r_87_142_108,1,6,114,108,75
73,seq45,seq39,r_102_48_36,r_102_48_36,1,10,46,36,75
95,seq115,r_116_51_81,seq99,r_116_51_81,1,0,81,81,75
31,r_10_3_80,seq9,r_2_112_170,r_10_3_80,0.84,0,80,80,75
41,r_105_14_123,r_114_13_187,r_21_15_18,r_105_14_123,0.98,0,123,123,75
10,r_66_135_165,r_72_107_147,r_47_62_2,r_47_62_2,0.59,11,13,2,75
24,r_75_143_53,seq77,r_88_147_36,r_75_143_53,0.53,0,53,53,75
5,r_87_142_108,seq85,r_90_40_156,r_90_40_156,0.38,-72,84,156,75
4,r_50_35_120,seq53,seq36,r_50_35_120,0.5,2,122,120,75
78,seq68,seq73,r_47_62_2,r_47_62_2,0.62,163,165,2,75
63,seq24,r_26_111_78,seq23,r_26_111_78,1,0,78,78,75
13,r_139_103_60,r_136_118_99,seq104,r_139_103_60,0.57,0,60,60,75
15,r_26_111_78,seq24,r_86_110_66,r_26_111_78,0.75,0,78,78,75
40,r_102_48_36,seq101,seq45,r_102_48_36,1,0,36,36,75
12,r_2_112_170,r_10_3_80,r_72_107_147,r_2_112_170,0.68,0,170,170,75
75,seq55,seq53,r_30_54_49,r_30_54_49,1,-1,48,49,75
48,r_131_84_71,r_130_59_37,r_91_137_11,r_130_59_37,0.66,0,37,37,75
10,r_66_135_165,r_47_62_2,r_91_137_11,r_66_135_165,0.63,1,166,165,75
27,r_121_108_95,seq122,seq109,r_121_108_95,0.65,0,95,95,75
48,r_131_84_71,r_91_137_11,seq85,r_131_84_71,0.95,-1,70,71,75
26,r_140_1_14,r_139_103_60,seq6,r_140_1_14,0.99,1,15,14,75
47,r_116_51_81,seq115,seq53,r_116_51_81,1,0,81,81,75
5,r_87_142_108,r_88_147_36,seq85,r_88_147_36,1,0,36,36,75
74,seq53,r_50_35_120,r_116_51_81,r_116_51_81,1,41,122,81,75
18,r_79_81_1,r_80_12_167,r_43_78_49,r_43_78_49,0.87,118,167,49,75
19,r_30_54_49,r_32_69_161,seq55,r_30_54_49,0.89,2,51,49,75
43,r_25_124_63,r_128_33_133,r_61_126_96,r_25_124_63,0.54,70,133,63,75
2,r_37_74_17,seq39,seq70,r_37_74_17,0.98,7,24,17,75
33,r_98_49_120,seq96,r_76_46_87,r_98_49_120,1,0,120,120,75
82,seq77,r_89_67_187,r_43_78_49,r_89_67_187,0.59,-23,164,187,75
20,r_18_93_18,r_21_15_18,seq94,r_18_93_18,1,1,19,18,75
32,r_60_117_157,r_61_126_96,seq55,r_61_126_96,0.97,0,96,96,75
34,r_61_126_96,r_60_117_157,r_25_124_63,r_61_126_96,0.56,0,96,96,75
60,seq20,r_19_17_88,r_129_22_35,r_129_22_35,1,58,93,35,75
45,r_128_33_133,r_25_124_63,r_50_35_120,r_128_33_133,0.94,0,133,133,75
17,r_80_12_167,r_79_81_1,seq6,r_79_81_1,0.75,166,167,1,75
9,r_89_67_187,r_131_84_71,r_32_69_161,r_89_67_187,0.47,0,187,187,75
94,seq113,r_114_13_187,r_72_107_147,r_72_107_147,0.98,40,187,147,75
9,r_89_67_187,r_90_40_156,r_131_84_71,r_131_84_71,1,84,155,71,75
31,r_10_3_80,r_2_112_170,r_34_4_163,r_10_3_80,0.57,90,170,80,75
22,r_47_62_2,r_66_135_165,r_144_65_164,r_144_65_164,0.82,2,166,164,75
28,r_136_118_99,seq138,seq123,r_136_118_99,0.91,0,99,99,75
35,r_145_106_178,r_88_147_36,r_72_107_147,r_145_106_178,0.97,0,178,178,75
49,r_144_65_164,r_145_106_178,r_47_62_2,r_144_65_164,0.81,0,164,164,75
7,r_130_59_37,r_131_84_71,seq57,r_130_59_37,0.99,0,37,37,75
44,r_132_31_96,seq133,seq36,r_132_31_96,1,0,96,96,75
26,r_140_1_14,r_50_35_120,r_82_0_120,r_82_0_120,0.98,0,120,120,75
23,r_76_46_87,seq77,r_102_48_36,r_76_46_87,0.98,0,87,87,75
82,seq77,r_76_46_87,r_89_67_187,r_76_46_87,0.73,-3,84,87,75
35,r_145_106_178,r_144_65_164,r_88_147_36,r_88_147_36,0.98,127,163,36,75
12,r_2_112_170,seq11,r_10_3_80,r_10_3_80,0.49,0,80,80,75
95,seq115,seq99,r_60_117_157,r_60_117_157,1,0,157,157,75
93,seq99,seq96,r_59_101_97,r_59_101_97,1,25,122,97,76
8,r_132_102_97,r_131_29_126,r_24_103_80,r_132_102_97,1,0,97,97,76
59,seq146,seq149,r_4_145_155,r_4_145_155,0.9,0,155,155,76
5,r_134_100_22,seq133,seq99,r_134_100_22,0.99,0,22,22,76
16,r_82_76_105,seq89,seq73,r_82_76_105,0.99,0,105,105,76
21,r_0_122_140,seq27,seq126,r_0_122_140,0.92,0,140,140,76
39,r_53_143_87,seq54,seq142,r_53_143_87,1,0,87,87,76
45,r_48_7_117,seq54,seq6,r_48_7_117,0.87,0,117,117,76
72,seq46,r_37_60_54,seq49,r_37_60_54,0.63,-3,51,54,76
95,seq111,r_112_45_65,seq109,r_112_45_65,1,0,65,65,76
14,r_47_8_34,r_48_7_117,seq9,r_47_8_34,0.82,3,37,34,76
41,r_24_103_80,seq22,r_107_127_202,r_24_103_80,1,0,80,80,76
3,r_112_45_65,seq111,seq46,r_112_45_65,1,0,65,65,76
10,r_61_105_152,seq62,r_132_102_97,r_61_105_152,0.89,0,152,152,76
90,seq95,seq99,r_59_101_97,r_59_101_97,1,23,120,97,76
28,r_17_18_26,r_24_103_80,r_128_19_26,r_17_18_26,1,7,33,26,76
26,r_64_94_155,seq65,seq95,r_64_94_155,0.8,0,155,155,76
4,r_68_138_160,seq72,r_130_125_144,r_68_138_160,0.76,0,160,160,76
46,r_128_19_26,r_130_125_144,r_17_18_26,r_128_19_26,1,0,26,26,76
78,seq62,r_61_105_152,r_58_63_7,r_61_105_152,0.94,-1,151,152,76
0,r_16_33_111,r_13_11_166,r_40_32_97,r_16_33_111,0.51,0,111,111,76
37,r_67_57_34,r_68_138_160,r_144_56_3,r_68_138_160,0.86,-126,34,160,76
11,r_139_79_167,seq140,r_104_77_164,r_139_79_167,0.69,0,167,167,76
13,r_83_116_181,seq89,r_41_115_143,r_83_116_181,0.72,0,181,181,76
15,r_40_32_97,r_41_115_143,r_16_33_111,r_40_32_97,0.85,19,116,97,76
48,r_104_77_164,r_107_127_202,r_139_79_167,r_104_77_164,0.89,0,164,164,76
30,r_37_60_54,seq36,seq62,r_37_60_54,0.91,-2,52,54,76
6,r_75_15_120,seq74,seq14,r_75_15_120,0.77,0,120,120,76
62,seq22,r_23_120_172,r_97_20_54,r_97_20_54,0.94,118,172,54,76
99,seq126,r_121_90_82,r_130_125_144,r_121_90_82,1,0,82,82,76
5,r_134_100_22,seq99,r_59_101_97,r_59_101_97,1,17,114,97,76
27,r_52_5_79,seq54,seq6,r_52_5_79,1,3,82,79,76
87,seq142,seq147,r_53_143_87,r_53_143_87,0.79,0,87,87,76
90,seq95,r_59_101_97,r_64_94_155,r_64_94_155,0.74,7,162,155,76
2,r_59_101_97,r_61_105_152,r_134_100_22,r_59_101_97,0.97,1,98,97,76
47,r_80_124_170,seq73,r_130_125_144,r_80_124_170,0.87,0,170,170,76
19,r_81_39_17,r_37_60_54,r_135_38_53,r_135_38_53,0.99,1,54,53,76
25,r_41_115_143,seq44,seq117,r_41_115_143,0.95,0,143,143,76
33,r_78_86_101,seq73,r_129_85_61,r_78_86_101,0.87,0,101,101,76
31,r_2_118_46,r_4_145_155,seq119,r_2_118_46,1,0,46,46,76
1,r_97_20_54,seq96,seq22,r_97_20_54,0.99,2,56,54,76
32,r_106_148_143,r_107_127_202,seq149,r_106_148_143,1,0,143,143,76
38,r_131_29_126,seq136,r_34_30_71,r_131_29_126,0.98,0,126,126,76
34,r_23_120_172,seq22,r_130_125_144,r_23_120_172,0.76,0,172,172,76
19,r_81_39_17,r_83_116_181,r_37_60_54,r_81_39_17,0.83,0,17,17,76
17,r_141_25_160,seq140,r_97_20_54,r_141_25_160,0.77,0,160,160,76
9,r_130_125_144,r_129_85_61,seq126,r_129_85_61,1,0,61,61,76
22,r_129_85_61,r_130_125_144,r_21_87_4,r_129_85_61,1,0,61,61,76
49,r_114_88_128,r_123_113_10,r_21_87_4,r_114_88_128,0.99,0,128,128,76
7,r_121_90_82,seq126,r_21_87_4,r_121_90_82,1,0,82,82,76
44,r_107_127_202,r_106_148_143,r_24_103_80,r_24_103_80,0.83,63,143,80,76
23,r_26_108_124,seq28,seq109,r_26_108_124,1,0,124,124,76
35,r_34_30_71,seq36,r_40_32_97,r_34_30_71,0.5,10,81,71,76
12,r_4_145_155,seq3,seq146,r_4_145_155,0.7,0,155,155,76
20,r_135_38_53,r_132_102_97,r_81_39_17,r_135_38_53,1,1,54,53,76
51,seq6,r_8_104_138,seq12,r_8_104_138,1,-71,67,138,77
8,r_75_131_19,r_74_33_158,r_129_105_122,r_75_131_19,0.78,0,19,19,77
92,seq142,r_138_59_172,r_103_141_47,r_103_141_47,1,35,82,47,77
14,r_133_36_117,seq135,seq35,r_133_36_117,0.93,0,117,117,77
53,seq145,r_144_30_173,r_103_141_47,r_103_141_47,1,127,174,47,77
1,r_134_137_50,r_133_36_117,r_138_59_172,r_133_36_117,0.99,-67,50,117,77
37,r_49_147_122,seq50,seq145,r_49_147_122,0.99,0,122,122,77
19,r_99_2_50,r_132_1_48,r_149_3_95,r_149_3_95,1,42,137,95,77
1,r_134_137_50,r_138_59_172,r_24_139_115,r_24_139_115,0.99,57,172,115,77
5,r_81_34_126,seq80,r_133_36_117,r_81_34_126,0.97,0,126,126,77
42,r_115_19_168,seq109,r_148_21_3,r_115_19_168,0.7,0,168,168,77
32,r_117_79_43,r_81_34_126,r_120_82_126,r_81_34_126,0.79,0,126,126,77
45,r_120_82_126,r_115_19_168,r_117_79_43,r_115_19_168,0.99,-42,126,168,77
35,r_138_59_172,r_140_20_163,r_134_137_50,r_138_59_172,0.72,-121,51,172,77
30,r_53_73_14,seq52,seq76,r_53_73_14,0.89,-1,13,14,77
25,r_103_141_47,seq106,seq142,r_103_141_47,1,0,47,47,77
31,r_41_123_64,seq40,seq124,r_41_123_64,1,0,64,64,77
41,r_95_69_151,seq94,seq70,r_95_69_151,0.56,0,151,151,77
63,seq28,r_29_48_29,r_119_31_27,r_119_31_27,0.95,0,27,27,77
24,r_132_1_48,r_134_137_50,r_99_2_50,r_132_1_48,1,0,48,48,77
17,r_4_62_51,r_0_130_39,r_8_104_138,r_0_130_39,0.64,1,40,39,77
26,r_45_23_60,r_41_123_64,seq22,r_45_23_60,0.83,1,61,60,77
17,r_4_62_51,r_8_104_138,seq61,r_4_62_51,0.84,0,51,51,77
0,r_38_102_101,seq39,seq107,r_38_102_101,1,0,101,101,77
20,r_55_56_107,r_67_89_93,r_125_54_20,r_67_89_93,0.65,-32,61,93,77
13,r_24_139_115,seq22,r_134_137_50,r_24_139_115,1,1,116,115,77
57,seq16,seq17,r_57_15_13,r_57_15_13,0.87,78,91,13,77
99,seq124,seq128,r_41_123_64,r_41_123_64,1,2,66,64,77
12,r_125_54_20,r_134_137_50,r_55_56_107,r_125_54_20,0.99,0,20,20,77
40,r_140_20_163,r_138_59_172,r_148_21_3,r_138_59_172,0.63,-9,163,172,77
29,r_18_116_71,seq16,seq109,r_18_116_71,1,0,71,71,77
8,r_75_131_19,r_129_105_122,r_0_130_39,r_0_130_39,0.7,4,43,39,77
19,r_99_2_50,seq100,r_132_1_48,r_99_2_50,1,1,51,50,77
35,r_138_59_172,r_134_137_50,seq58,r_138_59_172,0.53,0,172,172,77
33,r_10_118_83,r_13_11_3,r_18_116_71,r_10_118_83,1,0,83,83,77
48,r_129_105_122,r_75_131_19,seq106,r_129_105_122,0.85,0,122,122,77
50,seq128,seq124,r_78_126_56,r_78_126_56,1,7,63,56,77
65,seq39,r_38_102_101,r_29_48_29,r_38_102_101,0.78,-15,86,101,77
15,r_119_31_27,r_120_82_126,seq26,r_119_31_27,1,0,27,27,77
48,r_129_105_122,r_134_137_50,r_75_131_19,r_75_131_19,0.97,0,19,19,77
38,r_112_51_157,r_115_19_168,r_29_48_29,r_29_48_29,0.62,128,157,29,77
34,r_149_3_95,r_144_30_173,r_99_2_50,r_149_3_95,0.99,0,95,95,77
2,r_32_27_134,r_29_48_29,r_119_31_27,r_119_31_27,1,4,31,27,77
39,r_57_15_13,r_67_89_93,seq16,r_57_15_13,0.97,2,15,13,77
9,r_8_104_138,r_13_11_3,r_38_102_101,r_8_104_138,0.59,0,138,138,77
43,r_78_126_56,r_81_34_126,seq128,r_78_126_56,1,0,56,56,77
28,r_111_66_121,r_112_51_157,seq64,r_111_66_121,0.83,1,122,121,77
36,r_0_130_39,r_4_62_51,r_75_131_19,r_0_130_39,1,1,40,39,77
7,r_67_89_93,seq64,seq90,r_67_89_93,0.98,0,93,93,77
44,r_44_5_156,seq40,r_99_2_50,r_44_5_156,0.81,1,157,156,77
49,r_63_122_58,r_144_30_173,r_75_131_19,r_63_122_58,0.37,69,127,58,77
32,r_117_79_43,r_111_66_121,r_81_34_126,r_117_79_43,0.91,-1,42,43,77
93,seq102,r_104_9_184,r_51_114_128,r_51_114_128,0.75,38,166,128,78
9,r_90_137_13,r_138_30_129,r_146_49_190,r_138_30_129,0.79,-72,57,129,78
36,r_58_65_90,seq57,seq61,r_58_65_90,0.54,0,90,90,78
9,r_90_137_13,r_146_49_190,r_39_140_169,r_90_137_13,0.67,150,163,13,78
71,seq47,r_51_114_128,r_109_48_31,r_109_48_31,0.43,2,33,31,78
55,seq15,seq14,r_1_16_12,r_1_16_12,0.97,136,148,12,78
16,r_136_28_84,r_133_117_208,seq27,r_136_28_84,1,0,84,84,78
21,r_39_140_169,seq38,r_18_143_121,r_39_140_169,0.82,0,169,169,78
39,r_55_66_99,seq57,r_58_65_90,r_58_65_90,0.63,9,99,90,78
1,r_123_22_109,r_133_117_208,seq21,r_123_22_109,0.95,0,109,109,78
5,r_144_53_196,r_145_64_129,r_18_143_121,r_144_53_196,0.94,-67,129,196,78
46,r_131_87_145,r_130_36_189,r_6_88_61,r_131_87_145,0.94,0,145,145,78
45,r_113_118_178,seq112,r_12_119_15,r_12_119_15,0.98,174,189,15,78
15,r_89_106_20,r_105_5_101,r_107_110_87,r_105_5_101,1,0,101,101,78
35,r_67_124_58,r_51_114_128,seq127,r_67_124_58,0.95,0,58,58,78
31,r_130_36_189,r_133_117_208,r_76_35_143,r_130_36_189,0.62,0,189,189,78
41,r_145_64_129,r_146_49_190,r_125_63_27,r_145_64_129,0.7,0,129,129,78
13,r_138_30_129,r_139_135_4,r_144_53_196,r_138_30_129,0.45,-118,11,129,78
10,r_10_46_75,seq14,seq40,r_10_46_75,1,2,77,75,78
9,r_90_137_13,r_89_106_20,r_138_30_129,r_138_30_129,0.52,-113,16,129,78
48,r_12_119_15,r_10_46_75,seq120,r_12_119_15,0.96,0,15,15,78
90,seq92,r_93_56_193,r_6_88_61,r_6_88_61,1,125,186,61,78
15,r_89_106_20,r_85_86_54,r_105_5_101,r_89_106_20,0.98,-1,19,20,78
88,seq142,r_144_53_196,r_80_141_26,r_80_141_26,0.96,23,49,26,78
4,r_96_0_99,seq98,r_1_16_12,r_96_0_99,0.78,1,100,99,78
0,r_93_56_193,r_85_86_54,r_83_54_74,r_93_56_193,0.32,0,193,193,78
7,r_105_5_101,r_89_106_20,seq8,r_105_5_101,1,0,101,101,78
73,seq57,r_58_65_90,r_83_54_74,r_83_54_74,1,16,90,74,78
11,r_100_99_3,r_93_56_193,seq84,r_100_99_3,0.46,37,40,3,78
29,r_80_141_26,seq79,seq142,r_80_141_26,1,0,26,26,78
26,r_109_48_31,r_113_118_178,seq47,r_109_48_31,0.96,0,31,31,78
57,seq148,r_146_49_190,r_43_147_137,r_43_147_137,0.82,53,190,137,78
13,r_138_30_129,r_144_53_196,r_31_11_190,r_138_30_129,0.97,0,129,129,78
6,r_43_147_137,r_44_7_137,seq148,r_43_147_137,0.93,0,137,137,78
5,r_144_53_196,r_18_143_121,r_93_56_193,r_144_53_196,0.7,0,196,196,78
33,r_3_116_98,r_132_101_38,seq120,r_3_116_98,0.45,24,122,98,78
19,r_97_126_53,seq98,seq127,r_97_126_53,1,0,53,53,78
27,r_83_54_74,seq82,seq57,r_83_54_74,0.95,0,74,74,78
97,seq120,r_115_121_100,r_12_119_15,r_12_119_15,1,1,16,15,78
47,r_129_34_123,r_103_128_4,seq37,r_129_34_123,0.79,0,123,123,78
40,r_149_95_80,r_146_49_190,seq98,r_149_95_80,1,0,80,80,78
18,r_44_7_137,r_43_147_137,r_105_5_101,r_44_7_137,0.9,0,137,137,78
25,r_107_110_87,r_105_5_101,seq111,r_105_5_101,1,-14,87,101,78
33,r_3_116_98,seq4,r_132_101_38,r_3_116_98,0.83,1,99,98,78
98,seq122,r_115_121_100,r_12_119_15,r_12_119_15,0.73,33,48,15,78
32,r_24_52_137,seq25,r_83_54_74,r_24_52_137,0.9,0,137,137,78
77,seq68,r_51_114_128,seq60,r_51_114_128,0.97,-44,84,128,78
37,r_125_63_27,r_123_22_109,seq59,r_125_63_27,1,0,27,27,78
34,r_133_117_208,r_130_36_189,r_103_128_4,r_130_36_189,0.9,-24,165,189,78
37,r_125_63_27,seq59,r_58_65_90,r_125_63_27,0.49,76,103,27,78
22,r_18_143_121,seq19,seq142,r_18_143_121,1,0,121,121,78
28,r_146_49_190,seq148,r_109_48_31,r_109_48_31,0.74,159,190,31,78
84,seq79,r_80_141_26,seq82,r_80_141_26,1,-7,19,26,78
7,r_105_5_101,r_107_110_87,r_89_106_20,r_89_106_20,0.92,53,73,20,78
44,r_51_114_128,seq50,seq111,r_51_114_128,0.98,1,129,128,78
23,r_6_88_61,seq8,r_85_86_54,r_6_88_61,1,0,61,61,78
8,r_42_71_33,r_43_147_137,seq70,r_42_71_33,0.99,0,33,33,78
12,r_76_35_143,seq75,r_129_34_123,r_76_35_143,0.99,0,143,143,78
2,r_134_74_36,r_132_101_38,seq75,r_134_74_36,1,0,36,36,78
3,r_132_101_38,r_136_28_84,seq111,r_132_101_38,0.48,0,38,38,78
22,r_88_35_43,seq89,r_36_34_127,r_88_35_43,1,1,44,43,79
46,r_12_64_22,r_17_142_120,r_51_66_4,r_12_64_22,1,0,22,22,79
8,r_120_20_85,seq117,seq19,r_120_20_85,1,1,86,85,79
43,r_72_139_195,r_67_83_178,seq73,r_72_139_195,0.58,-40,155,195,79
15,r_47_98_34,seq44,seq97,r_47_98_34,1,1,35,34,79
3,r_32_43_102,r_116_33_70,seq44,r_32_43_102,0.94,0,102,102,79
37,r_11_112_75,seq10,r_62_109_38,r_11_112_75,0.93,0,75,75,79
3,r_32_43_102,r_36_34_127,r_116_33_70,r_116_33_70,0.66,0,70,70,79
49,r_62_109_38,r_61_148_146,seq110,r_62_109_38,0.99,0,38,38,79
31,r_146_60_14,r_141_124_91,r_61_148_146,r_146_60_14,1,1,15,14,79
10,r_42_5_26,r_47_98_34,seq4,r_42_5_26,1,0,26,26,79
26,r_86_102_43,seq97,seq103,r_86_102_43,0.89,-3,40,43,79
86,seq93,seq97,r_121_92_173,r_121_92_173,0.47,0,173,173,79
16,r_67_83_178,seq65,seq84,r_67_83_178,0.56,0,178,178,79
21,r_77_40_175,r_79_22_115,r_76_49_195,r_79_22_115,1,0,115,115,79
39,r_74_29_90,r_75_114_162,seq23,r_74_29_90,0.99,0,90,90,79
1,r_75_114_162,seq73,r_141_124_91,r_75_114_162,0.35,2,164,162,79
5,r_141_124_91,r_140_113_113,seq123,r_140_113_113,0.9,-22,91,113,79
45,r_26_99_174,seq28,r_47_98_34,r_47_98_34,0.34,140,174,34,79
19,r_116_33_70,r_115_94_152,r_32_43_102,r_116_33_70,1,0,70,70,79
25,r_63_143_45,r_67_83_178,seq137,r_63_143_45,1,0,45,45,79
94,seq110,r_111_144_179,r_62_109_38,r_62_109_38,1,-1,37,38,79
93,seq106,r_125_132_203,r_37_108_11,r_37_108_11,0.99,0,11,11,79
41,r_87_107_184,seq89,r_37_108_11,r_37_108_11,0.96,173,184,11,79
67,seq134,r_115_94_152,r_70_149_67,r_70_149_67,1,19,86,67,79
40,r_96_3_32,seq97,r_42_5_26,r_96_3_32,1,0,32,32,79
0,r_17_142_120,seq15,r_39_145_89,r_17_142_120,0.95,0,120,120,79
11,r_56_90_74,seq57,seq89,r_56_90_74,1,0,74,74,79
13,r_135_58_116,r_136_31_195,seq57,r_135_58_116,0.97,0,116,116,79
98,seq123,r_125_132_203,r_141_124_91,r_141_124_91,0.61,29,120,91,79
48,r_61_148_146,seq54,r_70_149_67,r_70_149_67,0.84,79,146,67,79
21,r_77_40_175,r_76_49_195,seq41,r_77_40_175,0.97,1,176,175,79
85,seq89,r_87_107_184,r_56_90_74,r_56_90_74,1,106,180,74,79
2,r_91_55_174,r_87_107_184,seq54,r_91_55_174,0.71,-1,173,174,79
27,r_70_149_67,r_67_83_178,r_63_143_45,r_67_83_178,1,-111,67,178,79
47,r_140_113_113,seq137,r_11_112_75,r_11_112_75,0.99,38,113,75,79
37,r_11_112_75,r_62_109_38,r_140_113_113,r_140_113_113,1,13,126,113,79
24,r_111_144_179,seq110,r_17_142_120,r_17_142_120,1,59,179,120,79
33,r_0_45_159,seq4,seq44,r_0_45_159,0.77,0,159,159,79
70,seq44,seq46,r_32_43_102,r_32_43_102,1,0,102,102,79
32,r_30_1_165,seq28,r_120_20_85,r_120_20_85,1,81,166,85,79
38,r_101_13_146,seq100,seq14,r_101_13_146,0.97,0,146,146,79
9,r_78_52_49,r_77_40_175,seq53,r_78_52_49,1,1,50,49,79
23,r_2_128_58,seq4,seq129,r_2_128_58,1,0,58,58,79
34,r_80_18_101,seq81,seq15,r_80_18_101,0.85,0,101,101,79
19,r_116_33_70,r_32_43_102,r_88_35_43,r_116_33_70,0.64,32,102,70,79
19,r_116_33_70,r_88_35_43,r_36_34_127,r_36_34_127,0.53,-7,120,127,79
90,seq103,seq104,r_86_102_43,r_86_102_43,1,0,43,43,79
50,seq129,r_127_82_178,r_2_128_58,r_2_128_58,1,1,59,58,79
18,r_36_34_127,r_32_43_102,r_88_35_43,r_88_35_43,1,2,45,43,79
96,seq117,r_125_132_203,seq133,r_125_132_203,0.52,-67,136,203,79
31,r_146_60_14,r_61_148_146,seq57,r_61_148_146,1,0,146,146,79
28,r_115_94_152,r_125_132_203,seq95,r_115_94_152,0.77,0,152,152,79
28,r_115_94_152,r_116_33_70,r_125_132_203,r_116_33_70,1,-15,55,70,79
18,r_36_34_127,r_88_35_43,r_116_33_70,r_116_33_70,0.99,57,127,70,79
44,r_79_22_115,r_77_40_175,seq23,r_79_22_115,0.96,0,115,115,79
82,seq81,r_80_18_101,seq84,r_80_18_101,0.97,0,101,101,79
1,r_75_114_162,r_141_124_91,r_37_108_11,r_37_108_11,0.7,159,170,11,79
2,r_91_55_174,seq93,r_87_107_184,r_91_55_174,0.48,-129,45,174,79
93,seq111,r_123_71_180,r_68_110_177,r_68_110_177,0.61,13,190,177,80
30,r_7_118_119,r_10_41_158,seq124,r_7_118_119,0.98,0,119,119,80
51,seq1,r_0_42_78,seq20,r_0_42_78,0.81,0,78,78,80
36,r_68_110_177,r_69_56_87,r_131_70_32,r_69_56_87,0.72,0,87,87,80
14,r_125_48_70,seq128,r_6_50_53,r_125_48_70,1,0,70,70,80
8,r_108_11_148,r_107_3_160,seq12,r_108_11_148,0.56,0,148,148,80
4,r_6_50_53,r_8_61_54,seq49,r_6_50_53,1,0,53,53,80
83,seq84,r_85_59_87,seq74,r_85_59_87,1,0,87,87,80
12,r_8_61_54,r_7_118_119,seq62,r_8_61_54,0.8,0,54,54,80
16,r_38_149_158,seq36,seq145,r_38_149_158,0.91,0,158,158,80
39,r_83_106_94,seq82,seq121,r_83_106_94,0.9,0,94,94,80
1,r_4_17_27,r_21_117_162,r_64_18_57,r_64_18_57,0.96,8,65,57,80
29,r_131_70_32,seq145,r_68_110_177,r_131_70_32,0.92,0,32,32,80
46,r_89_55_118,r_88_138_118,r_69_56_87,r_88_138_118,0.95,0,118,118,80
42,r_107_3_160,r_108_11_148,seq113,r_108_11_148,0.65,-36,112,148,80
69,seq36,r_34_86_151,r_33_37_80,r_34_86_151,1,-6,145,151,80
83,seq84,seq74,r_34_86_151,r_34_86_151,1,9,160,151,80
21,r_119_102_30,r_120_2_145,seq104,r_120_2_145,0.85,-115,30,145,80
66,seq29,r_26_66_59,r_9_28_34,r_26_66_59,0.63,1,60,59,80
76,seq62,r_60_97_113,r_8_61_54,r_8_61_54,0.89,32,86,54,80
38,r_23_46_31,r_19_91_165,seq45,r_19_91_165,0.99,-134,31,165,80
31,r_65_44_3,seq45,r_69_56_87,r_69_56_87,1,34,121,87,80
41,r_123_71_180,r_120_2_145,seq124,r_120_2_145,0.99,-73,72,145,80
26,r_60_97_113,seq62,seq98,r_60_97_113,0.97,0,113,113,80
15,r_54_87_36,r_53_81_132,seq74,r_54_87_36,0.95,0,36,36,80
0,r_0_42_78,seq1,seq43,r_0_42_78,1,0,78,78,80
73,seq49,r_51_39_118,r_6_50_53,r_6_50_53,1,31,84,53,80
11,r_53_81_132,seq52,seq82,r_53_81_132,0.99,0,132,132,80
20,r_92_73_95,seq93,r_54_87_36,r_54_87_36,0.81,68,104,36,80
13,r_22_27_63,r_21_117_162,r_9_28_34,r_21_117_162,0.85,-99,63,162,80
98,seq124,r_123_71_180,r_21_117_162,r_21_117_162,0.93,28,190,162,80
48,r_10_41_158,seq12,r_0_42_78,r_10_41_158,0.73,0,158,158,80
20,r_92_73_95,r_54_87_36,r_140_72_144,r_140_72_144,0.72,2,146,144,80
6,r_96_35_166,seq98,seq36,r_96_35_166,0.93,1,167,166,80
36,r_68_110_177,r_131_70_32,seq111,r_68_110_177,0.59,0,177,177,80
45,r_115_58_11,r_112_25_65,seq62,r_115_58_11,0.77,0,11,11,80
28,r_116_130_27,seq114,seq129,r_116_130_27,0.79,11,38,27,80
52,seq5,r_4_17_27,r_10_41_158,r_4_17_27,0.59,25,52,27,80
3,r_64_18_57,r_60_97_113,r_4_17_27,r_64_18_57,1,0,57,57,80
27,r_69_56_87,r_68_110_177,seq57,r_69_56_87,1,0,87,87,80
51,seq1,seq20,r_120_2_145,r_120_2_145,0.99,31,176,145,80
87,seq98,r_96_35_166,r_60_97_113,r_60_97_113,0.53,54,167,113,80
2,r_88_138_118,r_89_55_118,seq139,r_89_55_118,0.71,0,118,118,80
41,r_123_71_180,seq124,r_53_81_132,r_53_81_132,0.99,61,193,132,80
47,r_85_59_87,seq84,r_8_61_54,r_85_59_87,0.53,0,87,87,80
24,r_120_2_145,seq121,seq5,r_120_2_145,0.72,0,145,145,80
25,r_75_103_76,seq74,seq104,r_75_103_76,0.92,0,76,76,80
43,r_9_28_34,r_10_41_158,seq29,r_9_28_34,1,0,34,34,80
82,seq82,seq74,r_53_81_132,r_53_81_132,1,40,172,132,80
88,seq99,r_96_35_166,seq121,r_96_35_166,0.53,-82,84,166,80
70,seq43,seq45,r_0_42_78,r_0_42_78,1,0,78,78,80
37,r_100_31_45,seq99,seq32,r_100_31_45,1,0,45,45,80
34,r_76_13_79,seq74,seq12,r_76_13_79,0.89,0,79,79,80
75,seq57,seq49,r_69_56_87,r_69_56_87,1,1,88,87,80
68,seq32,seq30,r_100_31_45,r_100_31_45,1,3,48,45,80
81,seq80,seq74,r_53_81_132,r_53_81_132,1,0,132,132,80
94,seq113,r_112_25_65,seq114,r_112_25_65,1,0,65,65,80
9,r_19_91_165,seq20,r_136_95_8,r_19_91_165,0.64,0,165,165,80
29,r_131_70_32,r_68_110_177,seq67,r_131_70_32,0.59,113,145,32,80
22,r_26_66_59,seq29,seq62,r_26_66_59,1,1,60,59,80
40,r_77_40_21,r_88_138_118,seq32,r_77_40_21,0.99,0,21,21,80
49,r_140_72_144,seq144,r_92_73_95,r_140_72_144,0.74,0,144,144,80
7,r_63_14_123,seq62,seq12,r_63_14_123,0.88,0,123,123,80
44,r_51_39_118,seq52,r_77_40_21,r_77_40_21,0.62,97,118,21,80
82,seq82,r_83_106_94,seq74,r_83_106_94,1,0,94,94,80
35,r_33_37_80,r_38_149_158,seq36,r_38_149_158,1,-23,135,158,80
84,seq93,r_92_73_95,r_136_95_8,r_92_73_95,0.96,0,95,95,80
40,r_33_93_87,r_92_59_173,r_143_103_96,r_33_93_87,0.49,86,173,87,81
30,r_27_16_50,seq26,r_142_21_58,r_142_21_58,1,5,63,58,81
44,r_139_34_180,r_41_138_14,r_15_36_59,r_15_36_59,0.95,121,180,59,81
36,r_9_130_170,seq8,r_149_131_147,r_149_131_147,0.6,23,170,147,81
43,r_0_44_139,seq1,seq50,r_0_44_139,0.95,0,139,139,81
20,r_91_62_1,r_60_69_41,r_30_61_33,r_30_61_33,1,6,39,33,81
44,r_139_34_180,r_142_21_58,r_41_138_14,r_139_34_180,0.76,-166,14,180,81
71,seq43,r_47_122_103,seq40,r_47_122_103,1,0,103,103,81
16,r_56_96_99,seq57,r_112_94_21,r_56_96_99,0.86,0,99,99,81
21,r_4_39_154,seq2,r_128_38_42,r_4_39_154,0.72,0,154,154,81
39,r_55_83_182,seq57,r_79_82_2,r_79_82_2,0.58,180,182,2,81
97,seq117,r_116_74_99,seq113,r_116_74_99,1,0,99,99,81
5,r_51_118_103,seq50,r_90_119_41,r_51_118_103,0.89,0,103,103,81
46,r_101_126_103,seq102,seq129,r_101_126_103,0.79,0,103,103,81
30,r_27_16_50,r_142_21_58,r_98_17_97,r_98_17_97,1,3,100,97,81
37,r_112_94_21,r_116_74_99,seq95,r_112_94_21,0.9,0,21,21,81
24,r_90_119_41,r_120_81_169,r_51_118_103,r_51_118_103,1,2,105,103,81
19,r_46_140_18,r_41_138_14,r_149_131_147,r_149_131_147,0.95,18,165,147,81
17,r_42_12_134,r_133_49_84,seq14,r_42_12_134,0.99,0,134,134,81
28,r_75_64_160,r_116_74_99,seq65,r_75_64_160,0.63,0,160,160,81
24,r_90_119_41,seq95,r_120_81_169,r_90_119_41,0.65,1,42,41,81
38,r_22_71_9,r_70_77_75,r_104_73_66,r_104_73_66,0.79,8,74,66,81
31,r_137_72_135,r_139_34_180,r_116_74_99,r_139_34_180,0.71,-45,135,180,81
67,seq31,seq26,r_97_29_141,r_97_29_141,0.9,2,143,141,81
3,r_66_53_140,r_67_18_148,seq54,r_67_18_148,0.81,-8,140,148,81
47,r_76_134_40,r_75_64_160,seq129,r_76_134_40,0.92,0,40,40,81
26,r_135_7_81,seq136,seq8,r_135_7_81,1,1,82,81,81
4,r_98_17_97,seq99,r_27_16_50,r_98_17_97,0.99,0,97,97,81
23,r_120_81_169,r_116_74_99,r_90_119_41,r_120_81_169,0.92,-128,41,169,81
80,seq78,seq80,r_70_77_75,r_70_77_75,0.82,-49,26,75,81
69,seq37,seq35,r_128_38_42,r_128_38_42,0.92,8,50,42,81
15,r_143_103_96,r_139_34_180,seq102,r_143_103_96,0.93,0,96,96,81
82,seq85,r_84_28_44,r_79_82_2,r_84_28_44,1,0,44,44,81
6,r_116_74_99,seq117,r_104_73_66,r_116_74_99,0.93,0,99,99,81
62,seq20,seq23,r_142_21_58,r_142_21_58,1,14,72,58,81
48,r_63_100_10,r_60_69_41,seq99,r_63_100_10,0.52,0,10,10,81
99,seq124,r_125_19_177,seq123,r_125_19_177,0.98,0,177,177,81
8,r_84_28_44,seq85,seq26,r_84_28_44,1,0,44,44,81
18,r_92_59_173,r_33_93_87,r_30_61_33,r_30_61_33,0.85,140,173,33,81
27,r_70_77_75,r_75_64_160,seq78,r_70_77_75,0.59,13,88,75,81
18,r_92_59_173,r_97_29_141,r_33_93_87,r_92_59_173,0.93,-84,89,173,81
66,seq26,r_27_16_50,r_84_28_44,r_84_28_44,1,12,56,44,81
22,r_133_49_84,seq40,r_111_48_162,r_111_48_162,0.97,2,164,162,81
2,r_13_108_165,seq14,seq106,r_13_108_165,0.91,0,165,165,81
40,r_33_93_87,r_32_145_156,r_92_59_173,r_33_93_87,0.79,0,87,87,81
18,r_92_59_173,seq95,r_97_29_141,r_97_29_141,0.61,-78,63,141,81
35,r_32_145_156,r_128_38_42,seq146,r_32_145_156,0.72,0,156,156,81
33,r_132_52_172,seq129,r_66_53_140,r_66_53_140,0.78,32,172,140,81
42,r_41_138_14,r_42_12_134,r_139_34_180,r_41_138_14,0.64,0,14,14,81
58,seq14,r_9_130_170,r_127_11_61,r_127_11_61,1,14,75,61,81
70,seq40,r_47_122_103,seq43,r_47_122_103,0.99,0,103,103,81
68,seq35,seq37,r_15_36_59,r_15_36_59,1,21,80,59,81
42,r_41_138_14,r_139_34_180,r_46_140_18,r_41_138_14,0.23,166,180,14,81
32,r_47_122_103,r_42_12_134,seq123,r_47_122_103,0.62,0,103,103,81
9,r_30_61_33,seq31,r_91_62_1,r_30_61_33,1,0,33,33,81
34,r_149_131_147,seq147,r_76_134_40,r_149_131_147,0.88,0,147,147,81
75,seq54,seq50,r_66_53_140,r_66_53_140,0.5,16,156,140,81
17,r_42_12_134,r_47_122_103,r_133_49_84,r_42_12_134,0.62,-31,103,134,81
14,r_142_21_58,r_143_103_96,seq20,r_142_21_58,1,0,58,58,81
45,r_128_38_42,r_127_11_61,seq37,r_128_38_42,0.71,0,42,42,81
28,r_75_64_160,r_70_77_75,r_116_74_99,r_116_74_99,0.89,29,128,99,81
49,r_104_73_66,seq102,r_22_71_9,r_104_73_66,0.98,0,66,66,81
87,seq95,r_90_119_41,r_112_94_21,r_90_119_41,0.67,-7,34,41,81
79,seq68,r_66_53_140,r_60_69_41,r_66_53_140,0.85,-71,69,140,81
35,r_32_145_156,r_33_93_87,r_128_38_42,r_33_93_87,0.58,0,87,87,81
13,r_15_36_59,seq26,seq35,r_15_36_59,0.92,0,59,59,81
67,seq31,r_30_61_33,seq26,r_30_61_33,0.99,1,34,33,81
23,r_120_81_169,r_90_119_41,seq80,r_120_81_169,0.56,0,169,169,81
93,seq108,seq104,r_71_109_31,r_71_109_31,1,42,73,31,82
47,r_41_120_19,seq43,seq123,r_41_120_19,0.71,0,19,19,82
36,r_16_91_117,r_13_145_153,seq90,r_16_91_117,0.98,0,117,117,82
9,r_45_22_168,seq51,seq23,r_45_22_168,0.82,0,168,168,82
14,r_114_1_29,r_105_76_30,r_2_50_119,r_114_1_29,0.95,0,29,29,82
53,seq6,r_8_21_200,r_134_5_87,r_134_5_87,1,14,101,87,82
60,seq147,r_148_33_41,r_143_146_85,r_148_33_41,0.91,-8,33,41,82
37,r_13_145_153,seq15,r_143_146_85,r_13_145_153,0.87,0,153,153,82
26,r_142_17_21,r_143_146_85,seq15,r_142_17_21,0.98,0,21,21,82
86,seq90,r_94_121_142,r_16_91_117,r_16_91_117,0.76,13,130,117,82
21,r_137_118_158,r_139_75_145,seq141,r_137_118_158,0.56,-13,145,158,82
39,r_127_78_98,seq125,r_103_77_1,r_127_78_98,0.82,0,98,98,82
5,r_39_42_119,r_40_79_77,seq43,r_40_79_77,1,0,77,77,82
42,r_103_77_1,seq85,r_127_78_98,r_127_78_98,1,12,110,98,82
19,r_59_70_85,r_63_97_89,r_106_72_66,r_59_70_85,0.98,0,85,85,82
21,r_137_118_158,seq141,seq119,r_137_118_158,0.6,0,158,158,82
66,seq32,r_31_92_156,r_148_33_41,r_148_33_41,0.61,115,156,41,82
31,r_80_149_128,seq82,seq147,r_80_149_128,0.81,1,129,128,82
41,r_38_81_109,seq36,seq82,r_38_81_109,0.82,0,109,109,82
6,r_71_109_31,seq68,seq108,r_71_109_31,1,0,31,31,82
10,r_46_57_72,r_45_22_168,seq56,r_46_57_72,0.93,0,72,72,82
3,r_105_76_30,r_106_72_66,seq85,r_105_76_30,1,0,30,30,82
3,r_105_76_30,seq85,r_103_77_1,r_105_76_30,0.44,56,86,30,82
0,r_40_79_77,r_39_42_119,r_80_149_128,r_40_79_77,0.96,0,77,77,82
11,r_100_67_164,seq101,r_106_72_66,r_106_72_66,0.99,97,163,66,82
79,seq64,r_71_109_31,r_89_65_27,r_71_109_31,0.98,-3,28,31,82
20,r_115_132_175,seq119,seq136,r_115_132_175,0.37,0,175,175,82
13,r_60_54_75,r_59_70_85,seq53,r_60_54_75,0.98,0,75,75,82
15,r_106_72_66,seq104,seq69,r_106_72_66,1,0,66,66,82
94,seq112,r_71_109_31,r_138_113_136,r_138_113_136,0.51,1,137,136,82
4,r_116_29_55,seq119,seq27,r_116_29_55,1,0,55,55,82
3,r_105_76_30,r_103_77_1,r_139_75_145,r_139_75_145,0.87,0,145,145,82
27,r_30_83_86,seq27,seq85,r_30_83_86,0.99,0,86,86,82
43,r_34_96_53,r_31_92_156,seq98,r_34_96_53,0.82,0,53,53,82
23,r_93_11_189,r_16_91_117,r_134_5_87,r_93_11_189,0.78,0,189,189,82
2,r_138_113_136,r_139_75_145,seq112,r_139_75_145,0.74,-9,136,145,82
40,r_110_19_85,seq112,seq20,r_110_19_85,1,1,86,85,82
18,r_31_92_156,seq32,r_16_91_117,r_31_92_156,0.81,0,156,156,82
0,r_40_79_77,r_80_149_128,r_30_83_86,r_80_149_128,1,0,128,128,82
24,r_124_87_100,seq123,r_30_83_86,r_124_87_100,0.97,0,100,100,82
34,r_2_50_119,r_114_1_29,seq51,r_2_50_119,0.95,0,119,119,82
25,r_139_75_145,r_137_118_158,r_105_76_30,r_137_118_158,0.71,-13,145,158,82
14,r_114_1_29,r_115_132_175,r_105_76_30,r_115_132_175,0.55,-158,17,175,82
33,r_3_128_158,seq7,r_94_121_142,r_3_128_158,0.69,0,158,158,82
29,r_24_107_55,seq23,seq108,r_24_107_55,1,0,55,55,82
14,r_114_1_29,r_2_50_119,seq4,r_2_50_119,0.99,0,119,119,82
32,r_143_146_85,seq144,r_13_145_153,r_13_145_153,0.98,0,153,153,82
38,r_47_111_148,seq51,seq112,r_47_111_148,0.5,0,148,148,82
52,seq4,seq7,r_134_5_87,r_134_5_87,1,43,130,87,82
45,r_148_33_41,r_122_55_129,seq32,r_148_33_41,0.95,0,41,41,82
75,seq53,seq52,r_60_54_75,r_60_54_75,1,17,92,75,82
17,r_134_5_87,seq136,seq6,r_134_5_87,1,0,87,87,82
94,seq112,r_110_19_85,r_71_109_31,r_110_19_85,0.83,1,86,85,82
9,r_45_22_168,r_46_57_72,seq51,r_46_57_72,1,0,72,72,82
34,r_2_50_119,seq25,r_114_1_29,r_114_1_29,0.74,3,32,29,82
22,r_95_26_78,r_94_121_142,seq23,r_95_26_78,1,0,78,78,82
44,r_18_74_134,r_13_145_153,seq73,r_18_74_134,0.87,0,134,134,82
23,r_93_11_189,r_94_121_142,r_16_91_117,r_16_91_117,0.78,25,142,117,82
43,r_34_96_53,seq98,r_63_97_89,r_63_97_89,1,2,91,89,82
60,seq147,r_143_146_85,r_80_149_128,r_80_149_128,1,9,137,128,82
35,r_94_121_142,r_93_11_189,r_41_120_19,r_94_121_142,0.92,0,142,142,82
30,r_50_82_162,seq49,r_117_76_110,r_50_82_162,0.77,0,162,162,83
16,r_4_37_57,r_36_146_118,r_53_26_32,r_36_146_118,0.98,-6,112,118,83
14,r_100_27_22,r_22_133_145,r_53_26_32,r_100_27_22,0.5,12,34,22,83
92,seq108,r_109_32_94,seq105,r_109_32_94,1,0,94,94,83
8,r_92_14_79,seq93,seq15,r_92_14_79,1,0,79,79,83
43,r_43_119_165,seq45,r_30_131_59,r_43_119_165,0.56,0,165,165,83
54,seq9,r_10_71_192,r_56_8_27,r_56_8_27,1,38,65,27,83
55,seq140,r_141_80_197,r_106_139_63,r_106_139_63,1,14,77,63,83
86,seq97,r_96_103_16,r_35_98_89,r_35_98_89,1,17,106,89,83
21,r_128_52_116,seq134,seq51,r_128_52_116,0.99,0,116,116,83
39,r_101_121_189,r_96_103_16,r_78_122_37,r_101_121_189,0.32,0,189,189,83
75,seq66,seq63,r_48_67_25,r_48_67_25,0.97,-8,17,25,83
5,r_125_40_85,seq124,r_41_91_195,r_125_40_85,1,0,85,85,83
46,r_17_130_187,seq15,r_123_18_101,r_123_18_101,1,28,129,101,83
24,r_56_8_27,r_53_26_32,seq9,r_56_8_27,1,0,27,27,83
26,r_36_146_118,r_4_37_57,seq148,r_36_146_118,1,0,118,118,83
45,r_70_12_176,seq73,r_53_26_32,r_70_12_176,0.48,0,176,176,83
1,r_30_131_59,r_29_95_187,seq134,r_30_131_59,1,0,59,59,83
46,r_17_130_187,r_123_18_101,r_30_131_59,r_17_130_187,0.98,0,187,187,83
19,r_112_19_31,r_114_38_117,seq21,r_112_19_31,1,0,31,31,83
29,r_78_122_37,seq79,seq120,r_78_122_37,0.94,1,38,37,83
95,seq116,r_115_142_161,r_88_113_106,r_88_113_106,0.95,23,129,106,83
31,r_35_98_89,r_36_146_118,seq97,r_35_98_89,0.51,-1,88,89,83
41,r_127_68_172,seq124,seq69,r_127_68_172,0.27,0,172,172,83
14,r_100_27_22,r_101_121_189,r_22_133_145,r_100_27_22,0.53,0,22,22,83
42,r_0_147_48,seq1,seq148,r_0_147_48,0.99,0,48,48,83
26,r_36_146_118,r_35_98_89,r_4_37_57,r_4_37_57,0.93,11,68,57,83
4,r_41_91_195,seq39,r_125_40_85,r_125_40_85,1,27,112,85,83
0,r_135_90_92,seq134,r_87_2_186,r_135_90_92,0.98,0,92,92,83
63,seq39,r_41_91_195,r_125_40_85,r_125_40_85,1,96,181,85,83
16,r_4_37_57,r_10_71_192,r_36_146_118,r_4_37_57,1,0,57,57,83
37,r_118_59_33,r_117_76_110,seq57,r_118_59_33,1,1,34,33,83
11,r_117_76_110,seq120,seq77,r_117_76_110,0.84,0,110,110,83
20,r_136_47_185,seq137,seq49,r_136_47_185,0.45,0,185,185,83
15,r_106_139_63,seq104,seq140,r_106_139_63,0.98,0,63,63,83
34,r_29_95_187,r_30_131_59,r_34_31_71,r_30_131_59,1,0,59,59,83
0,r_135_90_92,r_87_2_186,r_117_76_110,r_135_90_92,0.66,96,188,92,83
27,r_61_20_60,seq60,seq21,r_61_20_60,1,0,60,60,83
12,r_48_67_25,r_50_82_162,seq66,r_48_67_25,0.79,3,28,25,83
50,seq1,r_0_147_48,seq6,r_0_147_48,1,-10,38,48,83
47,r_88_113_106,r_87_2_186,seq116,r_88_113_106,0.79,-1,105,106,83
40,r_22_133_145,seq21,seq134,r_22_133_145,0.99,0,145,145,83
18,r_123_18_101,seq120,r_17_130_187,r_123_18_101,0.97,0,101,101,83
34,r_29_95_187,r_34_31_71,r_35_98_89,r_35_98_89,0.8,98,187,89,83
25,r_87_2_186,r_88_113_106,r_135_90_92,r_87_2_186,0.98,-80,106,186,83
64,seq45,r_43_119_165,r_84_46_118,r_84_46_118,0.86,5,123,118,83
32,r_115_142_161,seq116,r_106_139_63,r_106_139_63,0.91,98,161,63,83
36,r_83_33_41,seq79,r_34_31_71,r_83_33_41,1,1,42,41,83
3,r_53_26_32,r_61_20_60,r_100_27_22,r_100_27_22,0.76,10,32,22,83
96,seq120,r_123_18_101,r_78_122_37,r_123_18_101,0.74,-34,67,101,83
33,r_34_31_71,r_30_131_59,r_83_33_41,r_34_31_71,0.96,-19,52,71,83
10,r_5_145_55,r_10_71_192,seq148,r_5_145_55,1,0,55,55,83
49,r_11_129_163,r_10_71_192,r_78_122_37,r_11_129_163,0.62,0,163,163,83
28,r_28_23_55,r_30_131_59,seq25,r_30_131_59,1,-4,55,59,83
7,r_114_38_117,r_115_142_161,r_125_40_85,r_115_142_161,1,-44,117,161,83
18,r_123_18_101,r_17_130_187,r_53_26_32,r_17_130_187,0.93,0,187,187,83
44,r_85_54_184,seq86,seq55,r_85_54_184,0.53,0,184,184,83
23,r_89_126_61,r_87_2_186,seq124,r_89_126_61,0.97,0,61,61,83
82,seq86,r_85_54_184,r_135_90_92,r_135_90_92,0.63,92,184,92,83
35,r_84_46_118,r_85_54_184,seq45,r_84_46_118,0.97,0,118,118,83
30,r_84_116_78,seq85,r_124_115_68,r_84_116_78,1,0,78,78,84
32,r_80_102_123,r_100_42_166,r_64_101_159,r_80_102_123,0.97,44,167,123,84
37,r_47_91_16,r_53_39_19,seq88,r_47_91_16,0.89,0,16,16,84
43,r_65_54_90,r_64_101_159,r_2_49_49,r_2_49_49,0.86,68,117,49,84
16,r_121_30_101,r_120_107_87,r_123_22_190,r_120_107_87,0.91,-9,78,87,84
21,r_114_13_92,seq113,seq21,r_114_13_92,0.96,0,92,92,84
39,r_120_107_87,r_121_30_101,seq106,r_120_107_87,1,0,87,87,84
1,r_20_141_113,r_24_60_126,seq140,r_20_141_113,0.94,0,113,113,84
28,r_2_49_49,seq6,seq51,r_2_49_49,1,2,51,49,84
42,r_122_61_116,r_123_22_190,r_2_49_49,r_122_61_116,1,0,116,116,84
80,seq63,seq58,r_87_62_113,r_87_62_113,0.99,13,126,113,84
19,r_134_96_77,r_132_48_170,seq94,r_134_96_77,0.98,0,77,77,84
33,r_4_70_26,r_71_98_185,seq73,r_71_98_185,0.96,-5,180,185,84
27,r_132_48_170,r_31_133_73,r_2_49_49,r_132_48_170,0.49,0,170,170,84
66,seq29,seq26,r_68_28_145,r_68_28_145,0.91,6,151,145,84
31,r_129_135_149,r_128_81_139,r_16_130_63,r_16_130_63,1,0,63,63,84
41,r_93_38_67,r_105_12_163,seq36,r_93_38_67,1,0,67,67,84
14,r_23_66_26,r_24_60_126,r_4_70_26,r_4_70_26,0.83,0,26,26,84
44,r_15_126_24,r_24_60_126,seq127,r_15_126_24,1,0,24,24,84
3,r_67_111_40,r_69_146_75,seq110,r_67_111_40,0.69,0,40,40,84
10,r_123_22_190,r_122_61_116,r_74_119_9,r_122_61_116,0.82,0,116,116,84
26,r_128_81_139,r_129_135_149,r_78_77_38,r_128_81_139,0.71,0,139,139,84
20,r_64_101_159,r_65_54_90,r_80_102_123,r_65_54_90,0.6,69,159,90,84
13,r_52_138_86,seq58,seq140,r_52_138_86,1,0,86,86,84
15,r_69_146_75,r_68_28_145,seq149,r_69_146_75,1,0,75,75,84
49,r_75_92_189,r_78_77_38,r_41_97_134,r_78_77_38,0.35,152,190,38,84
4,r_35_136_17,r_132_48_170,r_129_135_149,r_35_136_17,0.51,139,156,17,84
12,r_16_130_63,r_129_135_149,r_123_22_190,r_16_130_63,0.49,86,149,63,84
5,r_144_108_88,r_72_143_9,r_84_116_78,r_72_143_9,0.51,80,89,9,84
0,r_100_42_166,seq94,seq40,r_100_42_166,0.83,0,166,166,84
12,r_16_130_63,r_123_22_190,r_15_126_24,r_123_22_190,0.99,-1,189,190,84
27,r_132_48_170,r_134_96_77,r_31_133_73,r_132_48_170,1,-93,77,170,84
2,r_24_60_126,seq25,r_2_49_49,r_24_60_126,0.62,1,127,126,84
47,r_87_62_113,seq88,seq63,r_87_62_113,0.91,1,114,113,84
40,r_76_19_109,r_75_92_189,seq18,r_76_19_109,0.92,0,109,109,84
50,seq0,r_2_49_49,seq8,r_2_49_49,0.61,-23,26,49,84
18,r_68_28_145,r_71_98_185,seq29,r_68_28_145,0.82,0,145,145,84
29,r_79_148_177,r_78_77_38,r_69_146_75,r_78_77_38,0.53,139,177,38,84
25,r_71_98_185,seq73,r_41_97_134,r_41_97_134,0.93,51,185,134,84
22,r_124_115_68,r_114_13_92,r_84_116_78,r_124_115_68,1,10,78,68,84
5,r_144_108_88,r_84_116_78,r_67_111_40,r_84_116_78,0.47,60,138,78,84
24,r_53_39_19,seq50,seq46,r_53_39_19,0.87,0,19,19,84
32,r_80_102_123,r_78_77_38,r_100_42_166,r_100_42_166,0.82,-43,123,166,84
10,r_123_22_190,r_74_119_9,r_16_130_63,r_74_119_9,0.56,162,171,9,84
10,r_123_22_190,r_16_130_63,r_114_13_92,r_123_22_190,0.92,-1,189,190,84
0,r_100_42_166,r_105_12_163,seq94,r_100_42_166,0.49,-114,52,166,84
34,r_105_12_163,seq106,seq26,r_105_12_163,0.81,0,163,163,84
11,r_43_5_53,r_41_97_134,seq8,r_43_5_53,1,0,53,53,84
45,r_56_145_12,r_53_39_19,seq147,r_56_145_12,1,0,12,12,84
4,r_35_136_17,seq36,r_132_48_170,r_35_136_17,0.87,0,17,17,84
9,r_31_133_73,seq32,r_35_136_17,r_31_133_73,0.66,0,73,73,84
31,r_129_135_149,r_16_130_63,r_35_136_17,r_16_130_63,0.6,86,149,63,84
22,r_124_115_68,r_125_55_192,r_114_13_92,r_114_13_92,0.62,-24,68,92,84
84,seq85,r_83_34_194,r_128_81_139,r_128_81_139,1,32,171,139,84
49,r_75_92_189,r_76_19_109,r_78_77_38,r_76_19_109,1,0,109,109,84
7,r_41_97_134,seq44,r_134_96_77,r_41_97_134,0.98,0,134,134,84
23,r_45_95_103,seq46,r_134_96_77,r_45_95_103,1,0,103,103,84
17,r_72_143_9,r_144_108_88,seq147,r_144_108_88,1,0,88,88,84
82,seq73,r_71_98_185,r_23_66_26,r_23_66_26,0.63,154,180,26,84
33,r_4_70_26,seq3,r_71_98_185,r_4_70_26,1,0,26,26,84
16,r_121_30_101,r_123_22_190,seq36,r_121_30_101,0.94,0,101,101,84
35,r_90_103_176,seq89,r_64_101_159,r_90_103_176,0.2,4,180,176,84
12,r_16_130_63,r_24_60_126,r_129_135_149,r_16_130_63,1,0,63,63,84
84,seq85,r_84_116_78,r_83_34_194,r_84_116_78,1,1,79,78,84
93,seq111,r_110_109_66,seq113,r_110_109_66,0.56,6,72,66,85
30,r_141_99_132,seq142,r_100_95_127,r_141_99_132,0.91,0,132,132,85
51,seq1,r_0_119_180,seq2,r_0_119_180,0.27,1,181,180,85
67,seq45,r_46_79_160,r_101_44_37,r_101_44_37,1,-1,36,37,85
8,r_133_126_8,seq129,r_3_125_100,r_3_125_100,1,0,100,100,85
15,r_28_6_32,r_32_18_109,seq4,r_28_6_32,1,0,32,32,85
53,seq4,r_3_125_100,r_28_6_32,r_28_6_32,0.84,0,32,32,85
71,seq58,seq51,r_106_56_61,r_106_56_61,1,1,62,61,85
16,r_38_112_90,r_41_57_130,r_140_116_46,r_38_112_90,1,0,90,90,85
21,r_8_82_116,r_10_143_114,r_86_81_86,r_8_82_116,0.91,-1,115,116,85
1,r_60_50_138,r_7_62_33,r_97_53_41,r_60_50_138,0.46,0,138,138,85
34,r_97_53_41,r_100_95_127,seq51,r_97_53_41,1,1,42,41,85
5,r_70_80_80,seq71,r_86_81_86,r_70_80_80,0.85,6,86,80,85
46,r_24_65_76,r_25_47_156,seq63,r_24_65_76,1,0,76,76,85
42,r_120_135_156,seq124,r_92_139_98,r_92_139_98,1,58,156,98,85
23,r_26_130_22,r_35_22_133,seq129,r_26_130_22,1,0,22,22,85
73,seq69,r_70_80_80,r_13_68_17,r_13_68_17,1,0,17,17,85
19,r_148_5_129,r_149_104_135,r_28_6_32,r_148_5_129,0.98,0,129,129,85
1,r_60_50_138,r_59_12_70,r_7_62_33,r_60_50_138,0.65,-104,34,138,85
70,seq51,seq58,r_97_53_41,r_97_53_41,1,12,53,41,85
98,seq124,r_120_135_156,r_30_123_32,r_30_123_32,1,-2,30,32,85
27,r_67_147_47,r_149_104_135,seq145,r_149_104_135,1,1,136,135,85
28,r_40_19_41,r_41_57_130,seq17,r_40_19_41,1,0,41,41,85
10,r_33_73_158,seq29,seq74,r_33_73_158,0.62,0,158,158,85
26,r_106_56_61,seq108,seq58,r_106_56_61,1,0,61,61,85
14,r_86_81_86,r_101_44_37,r_52_85_6,r_101_44_37,0.83,-13,24,37,85
14,r_86_81_86,r_52_85_6,r_70_80_80,r_86_81_86,0.81,1,87,86,85
4,r_110_109_66,seq111,seq144,r_110_109_66,0.56,6,72,66,85
6,r_13_68_17,r_10_143_114,seq69,r_13_68_17,1,0,17,17,85
0,r_41_57_130,seq42,seq58,r_41_57_130,0.92,0,130,130,85
13,r_134_36_122,r_138_136_120,r_66_39_122,r_134_36_122,0.94,2,124,122,85
48,r_3_125_100,seq2,r_133_126_8,r_3_125_100,0.94,0,100,100,85
49,r_117_23_90,r_25_47_156,r_35_22_133,r_117_23_90,0.55,66,156,90,85
4,r_110_109_66,seq144,seq142,r_110_109_66,0.55,68,134,66,85
57,seq14,r_16_103_152,r_40_19_41,r_40_19_41,1,111,152,41,85
33,r_140_116_46,r_138_136_120,seq115,r_140_116_46,0.99,0,46,46,85
27,r_67_147_47,r_66_39_122,r_149_104_135,r_67_147_47,1,0,47,47,85
40,r_25_47_156,seq20,r_117_23_90,r_117_23_90,0.78,4,94,90,85
2,r_59_12_70,r_60_50_138,seq11,r_59_12_70,1,0,70,70,85
47,r_149_104_135,r_148_5_129,r_141_99_132,r_148_5_129,1,0,129,129,85
40,r_25_47_156,r_24_65_76,seq20,r_24_65_76,0.66,1,77,76,85
74,seq71,r_70_80_80,seq63,r_70_80_80,0.98,0,80,80,85
54,seq129,seq132,r_26_130_22,r_26_130_22,1,9,31,22,85
36,r_88_54_51,seq89,r_61_55_39,r_88_54_51,0.99,1,52,51,85
25,r_92_139_98,seq93,r_138_136_120,r_92_139_98,1,0,98,98,85
43,r_7_62_33,r_60_50_138,seq71,r_60_50_138,1,-11,127,138,85
58,seq144,r_148_5_129,r_10_143_114,r_10_143_114,0.58,6,120,114,85
39,r_30_123_32,r_28_6_32,seq124,r_30_123_32,1,-2,30,32,85
61,seq132,seq129,r_146_131_58,r_146_131_58,1,79,137,58,85
32,r_35_22_133,seq34,r_117_23_90,r_35_22_133,0.89,0,133,133,85
38,r_16_103_152,seq14,r_100_95_127,r_16_103_152,0.56,0,152,152,85
52,seq2,r_3_125_100,seq4,r_3_125_100,1,-4,96,100,85
4,r_110_109_66,seq142,r_92_139_98,r_92_139_98,0.36,74,172,98,85
41,r_61_55_39,r_60_50_138,seq58,r_61_55_39,0.82,0,39,39,85
60,seq20,r_25_47_156,r_117_23_90,r_117_23_90,1,55,145,90,85
17,r_37_64_81,r_41_57_130,r_24_65_76,r_37_64_81,0.98,0,81,81,85
20,r_21_27_34,r_25_47_156,seq29,r_21_27_34,0.96,0,34,34,85
41,r_61_55_39,seq58,r_88_54_51,r_88_54_51,0.89,4,55,51,85
9,r_10_143_114,seq11,seq144,r_10_143_114,1,0,114,114,85
92,seq108,r_106_56_61,seq107,r_106_56_61,1,-9,52,61,85
29,r_52_85_6,r_86_81_86,seq89,r_86_81_86,0.79,1,87,86,85
22,r_122_84_168,seq124,r_46_79_160,r_46_79_160,0.64,9,169,160,85
7,r_101_44_37,r_100_95_127,seq45,r_101_44_37,1,-1,36,37,85
49,r_117_23_90,r_120_135_156,r_25_47_156,r_117_23_90,0.98,0,90,90,85
24,r_146_131_58,r_148_5_129,r_26_130_22,r_146_131_58,1,0,58,58,85
43,r_7_62_33,r_10_143_114,r_60_50_138,r_7_62_33,1,0,33,33,85
44,r_66_39_122,seq63,seq42,r_66_39_122,0.84,0,122,122,85
35,r_15_83_112,seq14,r_70_80_80,r_15_83_112,0.99,0,112,112,85
30,r_125_63_142,seq136,r_27_75_123,r_125_63_142,0.78,0,142,142,86
46,r_76_36_15,seq74,seq37,r_76_36_15,1,0,15,15,86
8,r_87_46_69,r_79_149_104,seq90,r_87_46_69,0.59,-58,11,69,86
24,r_96_16_103,seq19,r_0_15_150,r_96_16_103,0.73,55,158,103,86
33,r_118_24_16,r_122_42_140,seq23,r_118_24_16,0.72,0,16,16,86
10,r_50_80_30,r_48_88_101,seq84,r_50_80_30,0.99,1,31,30,86
16,r_57_92_86,seq58,r_117_91_31,r_57_92_86,1,0,86,86,86
26,r_110_97_50,seq107,seq98,r_110_97_50,1,0,50,50,86
5,r_122_42_140,seq121,r_87_46_69,r_122_42_140,0.73,0,140,140,86
42,r_103_31_108,seq104,r_13_30_46,r_103_31_108,0.76,0,108,108,86
27,r_114_7_23,r_115_83_44,seq9,r_114_7_23,0.98,0,23,23,86
69,seq49,r_48_88_101,seq53,r_48_88_101,1,-32,69,101,86
45,r_146_108_110,seq143,seq107,r_146_108_110,0.97,0,110,110,86
92,seq107,r_110_97_50,seq102,r_110_97_50,0.94,-3,47,50,86
19,r_65_144_147,seq64,seq143,r_65_144_147,0.94,1,148,147,86
38,r_21_135_148,seq23,r_129_20_40,r_129_20_40,1,0,40,40,86
38,r_21_135_148,r_129_20_40,seq136,r_21_135_148,0.71,0,148,148,86
41,r_130_6_60,r_132_119_191,r_114_7_23,r_130_6_60,1,0,60,60,86
67,seq43,r_106_35_1,r_87_46_69,r_87_46_69,1,1,70,69,86
20,r_41_100_17,r_40_109_184,seq104,r_41_100_17,0.99,0,17,17,86
47,r_128_61_40,r_125_63_142,seq62,r_128_61_40,1,0,40,40,86
14,r_147_32_31,r_106_35_1,r_133_33_105,r_133_33_105,1,10,115,105,86
0,r_45_10_136,seq43,seq11,r_45_10_136,0.83,0,136,136,86
73,seq64,r_65_144_147,seq67,r_65_144_147,0.87,1,148,147,86
32,r_18_124_32,seq19,seq123,r_18_124_32,1,0,32,32,86
15,r_93_126_97,seq90,r_132_119_191,r_93_126_97,0.89,0,97,97,86
48,r_44_34_58,r_106_35_1,r_76_36_15,r_76_36_15,0.86,89,104,15,86
13,r_101_81_37,r_103_31_108,seq84,r_101_81_37,1,0,37,37,86
49,r_129_20_40,r_21_135_148,seq26,r_21_135_148,0.98,-24,124,148,86
6,r_60_3_89,seq62,seq4,r_60_3_89,0.98,3,92,89,86
36,r_13_30_46,r_52_137_153,r_103_31_108,r_103_31_108,0.92,12,120,108,86
12,r_17_66_10,r_18_124_32,seq68,r_17_66_10,0.76,0,10,10,86
22,r_54_99_43,r_106_35_1,seq104,r_54_99_43,0.98,0,43,43,86
36,r_13_30_46,seq14,r_52_137_153,r_13_30_46,1,0,46,46,86
59,seq19,r_55_12_8,r_96_16_103,r_96_16_103,0.71,0,103,103,86
37,r_127_22_10,r_133_33_105,seq23,r_127_22_10,0.82,0,10,10,86
39,r_56_28_55,seq58,r_147_32_31,r_56_28_55,1,3,58,55,86
40,r_138_94_147,seq136,seq95,r_138_94_147,0.58,0,147,147,86
29,r_0_15_150,r_1_25_115,r_130_6_60,r_130_6_60,0.93,24,84,60,86
24,r_96_16_103,seq98,seq19,r_96_16_103,0.89,0,103,103,86
25,r_27_75_123,seq26,seq74,r_27_75_123,0.99,0,123,123,86
92,seq107,seq102,r_146_108_110,r_146_108_110,0.94,2,112,110,86
30,r_125_63_142,r_27_75_123,r_101_81_37,r_101_81_37,0.62,136,173,37,86
70,seq53,r_52_137_153,seq49,r_52_137_153,0.73,0,153,153,86
31,r_117_91_31,r_122_42_140,r_93_126_97,r_117_91_31,1,-1,30,31,86
34,r_79_149_104,seq78,seq148,r_79_149_104,0.99,0,104,104,86
86,seq90,seq95,r_117_91_31,r_117_91_31,0.98,13,44,31,86
59,seq19,r_18_124_32,r_55_12_8,r_18_124_32,1,0,32,32,86
49,r_129_20_40,r_132_119_191,r_21_135_148,r_129_20_40,0.99,0,40,40,86
61,seq23,r_27_75_123,r_118_24_16,r_118_24_16,1,0,16,16,86
17,r_55_12_8,r_1_25_115,seq14,r_1_25_115,0.98,-41,74,115,86
21,r_145_82_46,r_142_2_128,r_115_83_44,r_145_82_46,0.99,0,46,46,86
14,r_147_32_31,seq148,r_106_35_1,r_147_32_31,0.99,0,31,31,86
31,r_117_91_31,r_93_126_97,r_57_92_86,r_117_91_31,0.96,64,95,31,86
29,r_0_15_150,r_130_6_60,r_96_16_103,r_0_15_150,0.8,11,161,150,86
28,r_120_59_78,seq121,seq62,r_120_59_78,1,0,78,78,86
44,r_115_83_44,seq112,seq84,r_115_83_44,1,0,44,44,86
7,r_52_137_153,seq53,r_21_135_148,r_52_137_153,0.63,0,153,153,86
57,seq14,r_13_30_46,r_55_12_8,r_13_30_46,0.98,-7,39,46,86
23,r_1_25_115,r_0_15_150,seq26,r_1_25_115,0.97,0,115,115,86
84,seq84,seq86,r_115_83_44,r_115_83_44,1,1,45,44,86
8,r_87_46_69,seq90,seq43,r_87_46_69,1,0,69,69,86
40,r_24_132_9,r_133_16_180,seq130,r_133_16_180,0.98,0,180,180,87
30,r_102_118_162,r_101_86_171,r_126_119_58,r_102_118_162,0.5,0,162,162,87
51,seq130,r_133_16_180,r_40_129_29,r_40_129_29,1,106,135,29,87
36,r_49_2_147,seq47,r_131_5_54,r_49_2_147,0.87,0,147,147,87
8,r_125_36_74,r_91_127_6,seq33,r_125_36_74,1,0,74,74,87
43,r_79_32_164,seq83,r_122_30_133,r_79_32_164,0.84,0,164,164,87
26,r_42_92_37,r_37_39_24,seq89,r_42_92_37,1,0,37,37,87
59,seq17,r_19_100_172,r_8_10_106,r_8_10_106,0.53,66,172,106,87
16,r_85_21_126,seq87,seq20,r_85_21_126,0.99,-1,125,126,87
39,r_26_64_66,seq28,seq65,r_26_64_66,1,0,66,66,87
25,r_136_78_15,r_126_119_58,seq83,r_136_78_15,0.96,0,15,15,87
5,r_139_13_67,r_138_77_73,seq14,r_139_13_67,1,0,67,67,87
46,r_62_88_151,seq60,seq87,r_62_88_151,0.64,1,152,151,87
7,r_126_119_58,r_120_117_180,r_102_118_162,r_120_117_180,0.51,-6,174,180,87
23,r_40_129_29,r_42_92_37,r_24_132_9,r_40_129_29,0.94,0,29,29,87
12,r_124_75_189,r_126_119_58,r_50_123_28,r_50_123_28,1,3,31,28,87
7,r_126_119_58,r_125_36_74,r_120_117_180,r_125_36_74,1,-16,58,74,87
31,r_34_146_149,seq33,r_54_147_63,r_54_147_63,0.91,85,148,63,87
45,r_76_11_21,r_74_72_179,seq9,r_76_11_21,1,0,21,21,87
10,r_144_128_134,seq143,r_91_127_6,r_144_128_134,0.82,0,134,134,87
4,r_138_77_73,seq140,seq71,r_138_77_73,1,4,77,73,87
0,r_145_80_125,seq149,r_136_78_15,r_145_80_125,0.86,0,125,125,87
11,r_1_109_80,seq0,seq110,r_1_109_80,1,0,80,80,87
20,r_91_127_6,r_125_36_74,r_40_129_29,r_91_127_6,0.5,68,74,6,87
13,r_101_86_171,r_102_118_162,r_62_88_151,r_101_86_171,0.61,0,171,171,87
15,r_8_10_106,seq0,r_76_11_21,r_8_10_106,0.85,0,106,106,87
95,seq106,seq103,r_1_109_80,r_1_109_80,0.57,25,105,80,87
48,r_70_18_146,seq69,seq15,r_70_18_146,0.96,0,146,146,87
57,seq14,seq9,r_139_13_67,r_139_13_67,1,12,79,67,87
12,r_124_75_189,r_50_123_28,r_138_77_73,r_138_77_73,0.82,118,191,73,87
99,seq116,r_126_119_58,r_120_117_180,r_126_119_58,0.31,122,180,58,87
2,r_4_41_108,seq0,r_37_39_24,r_4_41_108,0.99,0,108,108,87
47,r_54_147_63,seq56,seq149,r_54_147_63,1,0,63,63,87
29,r_67_48_147,r_63_68_97,r_46_51_17,r_67_48_147,0.82,0,147,147,87
24,r_122_30_133,r_126_119_58,seq31,r_122_30_133,0.92,0,133,133,87
33,r_114_43_111,r_112_23_166,seq44,r_114_43_111,1,0,111,111,87
65,seq29,seq31,r_4_41_108,r_4_41_108,0.96,7,115,108,87
37,r_131_5_54,r_133_16_180,seq6,r_131_5_54,0.83,0,54,54,87
20,r_91_127_6,r_40_129_29,r_144_128_134,r_144_128_134,0.65,0,134,134,87
38,r_120_117_180,r_126_119_58,seq116,r_126_119_58,0.46,116,174,58,87
70,seq53,r_57_95_178,r_12_52_40,r_12_52_40,1,17,57,40,87
6,r_12_52_40,seq9,seq53,r_12_52_40,1,0,40,40,87
45,r_76_11_21,seq9,r_8_10_106,r_8_10_106,0.99,6,112,106,87
9,r_134_115_80,seq135,r_40_129_29,r_40_129_29,0.91,55,84,29,87
96,seq107,r_112_23_166,r_105_108_3,r_112_23_166,0.52,-99,67,166,87
18,r_50_123_28,r_49_2_147,r_124_75_189,r_50_123_28,1,0,28,28,87
22,r_7_121_160,seq0,r_50_123_28,r_7_121_160,0.5,0,160,160,87
86,seq89,r_98_90_184,r_42_92_37,r_42_92_37,1,1,38,37,87
28,r_112_23_166,seq110,seq25,r_112_23_166,0.85,0,166,166,87
91,seq97,r_98_90_184,r_57_95_178,r_57_95_178,1,8,186,178,87
18,r_50_123_28,r_124_75_189,r_7_121_160,r_7_121_160,0.92,29,189,160,87
30,r_66_83_122,r_62_5_184,r_24_84_34,r_24_84_34,0.94,90,124,34,88
36,r_62_5_184,seq61,r_136_7_78,r_136_7_78,0.59,106,184,78,88
6,r_53_46_52,seq54,r_44_79_169,r_53_46_52,0.88,-6,46,52,88
14,r_39_103_92,r_6_40_1,seq102,r_39_103_92,1,0,92,92,88
8,r_143_71_114,seq141,seq69,r_143_71_114,0.99,1,115,114,88
43,r_76_82_13,seq81,r_24_84_34,r_24_84_34,1,40,74,34,88
9,r_24_84_34,r_25_128_171,r_76_82_13,r_24_84_34,0.98,0,34,34,88
16,r_72_8_158,seq74,r_136_7_78,r_72_8_158,0.64,0,158,158,88
21,r_63_41_75,r_62_5_184,r_42_45_130,r_63_41_75,0.67,0,75,75,88
1,r_136_7_78,seq138,seq4,r_136_7_78,1,0,78,78,88
46,r_51_55_28,r_88_90_191,seq65,r_51_55_28,0.46,57,85,28,88
45,r_92_19_127,seq87,r_146_15_3,r_92_19_127,0.95,0,127,127,88
5,r_78_9_25,r_77_43_127,seq4,r_78_9_25,0.74,0,25,25,88
52,seq134,r_97_135_112,r_129_142_45,r_97_135_112,0.79,75,187,112,88
27,r_95_147_113,r_53_46_52,r_3_94_15,r_95_147_113,0.65,-96,17,113,88
27,r_95_147_113,r_3_94_15,r_129_142_45,r_95_147_113,0.95,0,113,113,88
33,r_137_114_33,r_136_7_78,seq112,r_136_7_78,0.51,-45,33,78,88
3,r_145_18_145,seq141,r_146_15_3,r_145_18_145,0.9,0,145,145,88
4,r_77_43_127,seq81,r_63_41_75,r_77_43_127,0.25,15,142,127,88
0,r_38_75_136,seq37,seq74,r_38_75_136,0.79,0,136,136,88
47,r_96_67_155,r_0_98_106,r_143_71_114,r_96_67_155,0.99,0,155,155,88
13,r_32_123_136,r_30_131_152,r_86_124_6,r_86_124_6,0.95,130,136,6,88
15,r_119_13_129,seq127,r_101_120_28,r_119_13_129,0.66,-45,84,129,88
62,seq132,r_130_125_21,r_108_133_104,r_108_133_104,0.78,2,106,104,88
21,r_63_41_75,r_42_45_130,r_77_43_127,r_77_43_127,0.56,39,166,127,88
66,seq34,r_29_93_36,seq37,r_29_93_36,0.92,-13,23,36,88
52,seq134,seq140,r_97_135_112,r_97_135_112,1,6,118,112,88
7,r_101_120_28,r_105_12_90,r_86_124_6,r_101_120_28,0.7,1,29,28,88
17,r_100_148_31,seq99,seq140,r_100_148_31,0.98,0,31,31,88
39,r_122_36_20,r_119_13_129,seq35,r_122_36_20,0.76,0,20,20,88
47,r_96_67_155,r_97_135_112,r_0_98_106,r_96_67_155,0.9,-41,114,155,88
40,r_105_12_90,seq102,seq14,r_105_12_90,1,0,90,90,88
18,r_126_47_65,r_119_13_129,seq49,r_126_47_65,1,1,66,65,88
29,r_30_131_152,seq31,seq132,r_30_131_152,0.76,0,152,152,88
38,r_56_28_11,seq57,seq27,r_56_28_11,1,-1,10,11,88
24,r_44_79_169,seq49,r_24_84_34,r_24_84_34,0.99,134,168,34,88
15,r_119_13_129,r_101_120_28,r_105_12_90,r_119_13_129,1,0,129,129,88
35,r_3_94_15,r_95_147_113,r_29_93_36,r_3_94_15,0.78,97,112,15,88
25,r_20_106_53,seq4,seq107,r_20_106_53,1,0,53,53,88
6,r_53_46_52,r_44_79_169,r_42_45_130,r_53_46_52,0.35,125,177,52,88
88,seq99,r_100_148_31,r_97_135_112,r_100_148_31,0.79,1,32,31,88
32,r_108_133_104,seq107,seq132,r_108_133_104,0.76,0,104,104,88
34,r_0_98_106,seq1,seq99,r_0_98_106,1,0,106,106,88
67,seq35,r_39_103_92,r_122_36_20,r_39_103_92,0.77,-39,53,92,88
2,r_29_93_36,r_32_123_136,r_3_94_15,r_32_123_136,0.84,-99,37,136,88
53,seq138,r_136_7_78,r_129_142_45,r_136_7_78,1,-23,55,78,88
22,r_2_60_161,seq1,seq59,r_2_60_161,0.52,0,161,161,88
35,r_3_94_15,r_29_93_36,r_95_147_113,r_3_94_15,0.59,0,15,15,88
28,r_97_135_112,r_96_67_155,seq134,r_97_135_112,0.74,0,112,112,88
11,r_129_142_45,r_130_125_21,seq141,r_129_142_45,0.84,0,45,45,88
49,r_80_118_78,seq81,r_129_142_45,r_80_118_78,1,0,78,78,88
60,seq22,r_20_106_53,r_149_21_18,r_20_106_53,0.95,-5,48,53,88
56,seq141,r_143_71_114,r_129_142_45,r_143_71_114,0.97,1,115,114,88
44,r_25_128_171,seq31,seq132,r_25_128_171,0.54,0,171,171,88
23,r_42_45_130,r_63_41_75,r_53_46_52,r_42_45_130,0.56,-2,128,130,88
42,r_149_21_18,r_143_71_114,seq22,r_149_21_18,0.92,0,18,18,88
40,r_110_62_28,seq55,r_125_63_82,r_125_63_82,1,15,97,82,89
30,r_68_33_189,r_67_109_164,r_46_69_82,r_46_69_82,0.85,0,82,82,89
14,r_92_51_147,r_87_35_194,r_122_52_36,r_92_51_147,0.95,0,147,147,89
53,seq133,r_132_70_185,r_5_131_130,r_5_131_130,0.99,43,173,130,89
83,seq71,r_68_33_189,r_92_51_147,r_92_51_147,0.96,31,178,147,89
2,r_105_29_59,seq106,r_27_82_197,r_105_29_59,1,0,59,59,89
16,r_15_100_93,r_148_14_1,r_61_99_84,r_148_14_1,0.49,92,93,1,89
21,r_8_75_170,seq9,r_92_51_147,r_92_51_147,0.86,24,171,147,89
1,r_108_103_185,r_101_107_29,r_2_121_74,r_2_121_74,1,111,185,74,89
46,r_12_25_157,r_17_64_168,r_49_23_21,r_12_25_157,0.45,0,157,157,89
42,r_67_109_164,r_68_33_189,r_101_107_29,r_67_109_164,0.61,0,164,164,89
69,seq32,r_31_102_150,seq34,r_31_102_150,0.92,0,150,150,89
57,seq10,r_11_3_37,r_128_16_5,r_128_16_5,0.7,8,13,5,89
72,seq39,seq36,r_144_38_47,r_144_38_47,1,0,47,47,89
5,r_118_47_25,seq117,seq48,r_118_47_25,1,0,25,25,89
40,r_110_62_28,r_108_103_185,seq55,r_110_62_28,1,1,29,28,89
92,seq106,r_108_103_185,r_43_104_74,r_43_104_74,1,0,74,74,89
31,r_125_63_82,r_124_28_198,r_110_62_28,r_125_63_82,0.64,0,82,82,89
41,r_27_82_197,r_22_78_141,r_105_29_59,r_105_29_59,0.94,9,68,59,89
10,r_76_66_156,r_77_53_144,r_46_69_82,r_46_69_82,0.64,74,156,82,89
90,seq95,r_94_37_165,r_15_100_93,r_15_100_93,1,74,167,93,89
43,r_122_52_36,r_123_58_56,r_50_1_173,r_50_1_173,0.99,-137,36,173,89
37,r_49_23_21,r_73_119_45,seq26,r_49_23_21,0.58,-2,19,21,89
4,r_91_145_62,r_92_51_147,r_115_149_13,r_91_145_62,1,0,62,62,89
0,r_124_28_198,r_125_63_82,seq113,r_125_63_82,1,-8,74,82,89
39,r_73_119_45,seq74,r_135_120_38,r_73_119_45,1,0,45,45,89
73,seq41,r_40_65_160,r_118_47_25,r_118_47_25,0.88,134,159,25,89
11,r_84_6_99,seq85,seq7,r_84_6_99,1,0,99,99,89
20,r_130_98_145,seq129,r_61_99_84,r_61_99_84,0.81,61,145,84,89
13,r_141_56_123,r_147_142_74,r_123_58_56,r_147_142_74,1,49,123,74,89
15,r_2_121_74,r_5_131_130,seq113,r_2_121_74,0.87,0,74,74,89
48,r_46_69_82,seq45,seq71,r_46_69_82,1,0,82,82,89
35,r_50_1_173,seq55,r_122_52_36,r_122_52_36,1,1,37,36,89
6,r_61_99_84,seq55,r_94_37_165,r_61_99_84,0.99,0,84,84,89
27,r_123_58_56,r_108_103_185,seq57,r_123_58_56,1,0,56,56,89
36,r_128_16_5,r_17_64_168,r_148_14_1,r_17_64_168,0.84,0,168,168,89
25,r_101_107_29,r_84_6_99,r_108_103_185,r_101_107_29,0.99,0,29,29,89
74,seq42,r_43_104_74,seq45,r_43_104_74,1,0,74,74,89
18,r_147_142_74,seq146,seq143,r_147_142_74,0.52,-10,64,74,89
35,r_50_1_173,r_122_52_36,seq0,r_50_1_173,0.5,0,173,173,89
43,r_122_52_36,r_50_1_173,r_92_51_147,r_92_51_147,0.82,26,173,147,89
33,r_112_83_155,seq113,r_79_96_10,r_112_83_155,0.61,5,160,155,89
47,r_17_64_168,r_128_16_5,r_76_66_156,r_128_16_5,0.49,163,168,5,89
92,seq106,r_105_29_59,r_108_103_185,r_105_29_59,0.98,-4,55,59,89
6,r_61_99_84,r_94_37_165,seq97,r_94_37_165,0.97,-21,144,165,89
1,r_108_103_185,r_105_29_59,r_101_107_29,r_108_103_185,0.99,-156,29,185,89
19,r_80_111_58,r_79_96_10,seq113,r_80_111_58,0.87,-48,10,58,89
38,r_93_134_191,r_94_37_165,r_61_99_84,r_61_99_84,1,63,147,84,89
26,r_135_120_38,seq136,seq113,r_135_120_38,0.95,0,38,38,89
38,r_93_134_191,r_61_99_84,r_5_131_130,r_93_134_191,0.89,0,191,191,89
34,r_77_53_144,r_76_66_156,r_122_52_36,r_122_52_36,1,108,144,36,89
60,seq13,r_17_64_168,seq10,r_17_64_168,0.65,0,168,168,89
25,r_101_107_29,r_108_103_185,r_67_109_164,r_67_109_164,0.94,21,185,164,89
94,seq113,r_112_83_155,r_80_111_58,r_80_111_58,1,97,155,58,89
17,r_115_149_13,seq116,seq146,r_115_149_13,0.85,0,13,13,89
28,r_5_131_130,seq4,seq133,r_5_131_130,1,0,130,130,89
49,r_43_104_74,seq42,seq106,r_43_104_74,1,0,74,74,89
56,seq9,r_8_75_170,r_148_14_1,r_8_75_170,0.69,0,170,170,89
7,r_132_70_185,seq133,r_76_66_156,r_132_70_185,0.53,0,185,185,89
44,r_94_37_165,seq95,seq36,r_94_37_165,0.78,0,165,165,89
23,r_148_14_1,r_15_100_93,r_128_16_5,r_15_100_93,1,-9,84,93,89
24,r_144_38_47,seq143,seq39,r_144_38_47,1,0,47,47,89
8,r_96_20_69,r_99_28_153,seq17,r_96_20_69,0.99,0,69,69,90
23,r_37_55_6,r_27_78_98,r_139_54_27,r_139_54_27,1,5,32,27,90
16,r_103_93_71,seq107,r_92_75_185,r_103_93_71,1,0,71,71,90
39,r_59_95_110,r_61_135_109,seq98,r_59_95_110,0.82,0,110,110,90
1,r_99_28_153,seq98,r_56_36_20,r_99_28_153,0.5,0,153,153,90
97,seq118,seq114,r_2_116_19,r_2_116_19,0.99,88,107,19,90
4,r_23_74_40,r_24_18_151,r_76_86_151,r_23_74_40,0.94,0,40,40,90
5,r_109_110_122,r_108_119_157,r_22_113_23,r_22_113_23,0.96,99,122,23,90
4,r_23_74_40,r_27_78_98,r_92_75_185,r_23_74_40,0.65,145,185,40,90
30,r_83_40_45,seq82,r_104_42_41,r_104_42_41,0.78,5,46,41,90
34,r_139_54_27,seq138,seq50,r_139_54_27,0.98,0,27,27,90
14,r_127_67_36,seq128,r_19_65_37,r_127_67_36,1,1,37,36,90
19,r_130_62_52,r_131_6_157,r_100_60_42,r_130_62_52,0.8,0,52,52,90
31,r_92_75_185,r_91_12_88,r_103_93_71,r_92_75_185,0.8,-97,88,185,90
94,seq112,r_111_90_167,r_22_113_23,r_22_113_23,0.95,26,49,23,90
90,seq98,r_99_28_153,r_59_95_110,r_59_95_110,0.78,1,111,110,90
26,r_66_0_63,r_64_125_90,r_126_26_37,r_64_125_90,0.55,-7,83,90,90
16,r_103_93_71,r_92_75_185,r_59_95_110,r_59_95_110,0.57,81,191,110,90
40,r_143_53_17,seq144,seq52,r_143_53_17,1,0,17,17,90
73,seq49,r_48_41_74,r_139_54_27,r_139_54_27,0.7,50,77,27,90
11,r_79_102_84,seq77,seq106,r_79_102_84,0.94,0,84,84,90
20,r_39_70_163,r_38_47_14,r_124_71_50,r_124_71_50,1,113,163,50,90
13,r_111_90_167,seq112,r_76_86_151,r_111_90_167,0.62,0,167,167,90
15,r_108_119_157,r_109_110_122,seq121,r_108_119_157,0.6,0,157,157,90
48,r_97_117_144,r_99_28_153,seq118,r_99_28_153,0.61,-8,145,153,90
4,r_23_74_40,r_76_86_151,r_27_78_98,r_23_74_40,0.53,111,151,40,90
12,r_76_86_151,r_23_74_40,seq88,r_76_86_151,0.64,0,151,151,90
62,seq13,r_14_31_170,r_91_12_88,r_91_12_88,1,82,170,88,90
27,r_120_21_174,seq121,r_96_20_69,r_96_20_69,0.59,104,173,69,90
43,r_100_60_42,r_103_93_71,r_59_95_110,r_59_95_110,0.94,-68,42,110,90
12,r_76_86_151,r_79_102_84,r_23_74_40,r_79_102_84,1,-28,56,84,90
47,r_131_6_157,seq134,seq4,r_131_6_157,0.65,0,157,157,90
18,r_16_32_174,seq17,r_147_33_25,r_147_33_25,0.91,149,174,25,90
46,r_2_116_19,r_14_31_170,seq118,r_2_116_19,0.95,0,19,19,90
24,r_61_135_109,r_59_95_110,seq134,r_61_135_109,0.94,0,109,109,90
43,r_100_60_42,r_59_95_110,r_130_62_52,r_59_95_110,0.63,0,110,110,90
33,r_14_31_170,seq13,r_147_33_25,r_147_33_25,0.87,145,170,25,90
65,seq17,r_16_32_174,r_96_20_69,r_96_20_69,1,25,94,69,90
0,r_58_101_29,r_61_135_109,seq107,r_58_101_29,1,0,29,29,90
42,r_22_113_23,r_16_32_174,seq112,r_22_113_23,1,0,23,23,90
32,r_81_3_139,seq77,r_123_7_4,r_81_3_139,0.73,0,139,139,90
38,r_91_12_88,r_92_75_185,seq13,r_91_12_88,0.99,0,88,88,90
81,seq77,r_81_3_139,r_27_78_98,r_81_3_139,0.66,-1,138,139,90
68,seq25,r_23_74_40,r_126_26_37,r_126_26_37,0.99,3,40,37,90
31,r_92_75_185,r_103_93_71,r_23_74_40,r_92_75_185,0.58,0,185,185,90
10,r_124_71_50,r_22_113_23,seq69,r_124_71_50,0.96,0,50,50,90
22,r_64_125_90,r_66_0_63,r_127_67_36,r_64_125_90,0.8,-27,63,90,90
28,r_48_41_74,seq49,r_83_40_45,r_48_41_74,0.8,3,77,74,90
36,r_104_42_41,r_105_30_150,seq43,r_104_42_41,0.83,0,41,41,90
49,r_29_57_96,r_39_70_163,r_124_71_50,r_124_71_50,1,43,93,50,90
10,r_124_71_50,r_126_26_37,r_22_113_23,r_124_71_50,0.79,-13,37,50,90
7,r_80_63_90,r_81_3_139,r_19_65_37,r_80_63_90,0.97,0,90,90,90
44,r_148_34_107,seq149,r_56_36_20,r_148_34_107,0.95,1,108,107,90
41,r_35_10_54,r_39_70_163,seq9,r_35_10_54,0.96,0,54,54,90
17,r_147_33_25,seq146,r_56_36_20,r_147_33_25,0.99,0,25,25,90
6,r_51_142_23,r_48_41_74,seq140,r_51_142_23,0.99,0,23,23,90
29,r_19_65_37,r_16_32_174,r_127_67_36,r_19_65_37,0.69,0,37,37,90
22,r_64_125_90,r_127_67_36,seq121,r_64_125_90,0.88,0,90,90,90
40,r_15_122_90,r_121_34_154,r_132_125_78,r_121_34_154,0.9,0,154,154,91
30,r_140_35_79,r_142_61_166,r_36_92_131,r_140_35_79,0.88,0,79,79,91
51,seq1,seq6,r_126_0_130,r_126_0_130,0.98,1,131,130,91
36,r_73_60_83,r_74_10_90,r_28_67_76,r_73_60_83,1,0,83,83,91
8,r_48_14_60,seq49,seq12,r_48_14_60,1,0,60,60,91
43,r_9_55_133,r_11_86_88,r_74_10_90,r_9_55_133,0.85,-45,88,133,91
37,r_17_4_137,r_18_147_181,seq3,r_17_4_137,0.81,0,137,137,91
59,seq16,r_17_4_137,r_48_14_60,r_48_14_60,0.75,77,137,60,91
55,seq6,r_8_66_179,seq5,r_8_66_179,0.91,-66,113,179,91
69,seq49,r_48_14_60,seq46,r_48_14_60,1,-6,54,60,91
86,seq93,r_94_90_70,seq96,r_94_90_70,0.73,0,70,70,91
16,r_68_53_169,seq69,r_9_55_133,r_9_55_133,0.74,36,169,133,91
21,r_121_34_154,seq120,r_15_122_90,r_15_122_90,0.98,10,100,90,91
5,r_115_44_91,r_131_116_21,r_118_47_55,r_131_116_21,0.83,70,91,21,91
42,r_141_75_178,r_142_61_166,r_124_139_119,r_124_139_119,0.59,47,166,119,91
45,r_95_13_88,seq93,r_48_14_60,r_95_13_88,0.65,0,88,88,91
3,r_81_38_105,r_73_60_83,r_68_53_169,r_68_53_169,0.35,14,183,169,91
4,r_131_116_21,r_135_136_22,seq119,r_135_136_22,0.43,93,115,22,91
19,r_37_88_105,seq25,r_11_86_88,r_37_88_105,0.56,0,105,105,91
66,seq133,r_132_125_78,seq130,r_132_125_78,0.55,6,84,78,91
38,r_74_10_90,r_117_72_8,r_9_55_133,r_74_10_90,0.95,0,90,90,91
31,r_117_72_8,seq102,r_111_71_140,r_111_71_140,0.99,0,140,140,91
30,r_140_35_79,r_36_92_131,seq33,r_36_92_131,0.97,0,131,131,91
3,r_81_38_105,r_82_29_157,r_74_10_90,r_82_29_157,0.28,-22,135,157,91
22,r_98_51_34,seq99,seq52,r_98_51_34,0.99,0,34,34,91
26,r_97_22_94,seq101,seq24,r_97_22_94,0.82,0,94,94,91
0,r_124_139_119,seq127,r_77_143_8,r_124_139_119,0.86,0,119,119,91
2,r_108_80_43,seq107,seq83,r_108_80_43,1,0,43,43,91
20,r_36_92_131,seq33,r_140_35_79,r_140_35_79,0.99,3,82,79,91
13,r_111_71_140,seq114,r_117_72_8,r_111_71_140,0.74,0,140,140,91
98,seq120,r_121_34_154,r_15_122_90,r_15_122_90,0.71,59,149,90,91
15,r_82_29_157,seq83,r_121_34_154,r_82_29_157,0.65,0,157,157,91
6,r_11_86_88,r_9_55_133,r_2_87_48,r_11_86_88,0.98,0,88,88,91
48,r_113_103_53,r_111_71_140,seq104,r_113_103_53,0.62,0,53,53,91
9,r_106_128_36,seq107,seq127,r_106_128_36,1,0,36,36,91
19,r_37_88_105,seq50,r_68_53_169,r_68_53_169,0.42,-87,82,169,91
46,r_2_87_48,r_8_66_179,seq89,r_2_87_48,1,0,48,48,91
27,r_20_148_120,seq12,seq149,r_20_148_120,0.95,-1,119,120,91
71,seq52,r_40_42_173,r_98_51_34,r_98_51_34,0.99,3,37,34,91
3,r_81_38_105,r_74_10_90,r_73_60_83,r_73_60_83,0.55,63,146,83,91
41,r_77_143_8,r_141_75_178,r_45_144_35,r_45_144_35,0.81,135,170,35,91
47,r_39_100_149,r_40_42_173,r_118_47_55,r_118_47_55,1,4,59,55,91
40,r_15_122_90,seq12,r_121_34_154,r_15_122_90,0.69,1,91,90,91
97,seq119,r_118_47_55,seq149,r_118_47_55,0.99,0,55,55,91
18,r_142_61_166,r_141_75_178,r_28_67_76,r_142_61_166,0.57,0,166,166,91
24,r_132_125_78,seq133,r_106_128_36,r_106_128_36,0.88,48,84,36,91
34,r_40_42_173,r_48_14_60,r_118_47_55,r_40_42_173,0.99,-115,58,173,91
34,r_40_42_173,r_118_47_55,r_115_44_91,r_115_44_91,1,86,177,91,91
33,r_126_0_130,seq127,seq1,r_126_0_130,0.95,0,130,130,91
64,seq27,seq30,r_140_35_79,r_140_35_79,1,98,177,79,91
47,r_39_100_149,r_118_47_55,seq99,r_39_100_149,0.75,-22,127,149,91
97,seq119,seq149,r_121_34_154,r_121_34_154,0.46,-56,98,154,91
29,r_45_144_35,seq46,r_77_143_8,r_45_144_35,0.94,0,35,35,91
50,seq149,seq145,r_20_148_120,r_20_148_120,1,11,131,120,91
58,seq12,seq16,r_48_14_60,r_48_14_60,1,3,63,60,91
68,seq46,r_43_54_88,r_118_47_55,r_118_47_55,1,33,88,55,91
32,r_85_70_80,seq89,seq69,r_85_70_80,0.96,0,80,80,91
25,r_19_58_40,r_20_148_120,seq59,r_19_58_40,1,0,40,40,91
11,r_41_134_38,r_40_42_173,seq138,r_41_134_38,1,0,38,38,91
4,r_131_116_21,r_115_44_91,r_135_136_22,r_115_44_91,0.65,0,91,91,91
19,r_37_88_105,r_68_53_169,seq25,r_37_88_105,0.44,-13,92,105,91
39,r_118_47_55,seq119,seq46,r_118_47_55,1,0,55,55,91
38,r_74_10_90,r_9_55_133,r_48_14_60,r_9_55_133,0.97,2,135,133,91
21,r_121_34_154,r_15_122_90,seq33,r_121_34_154,0.99,0,154,154,91
17,r_94_90_70,seq93,r_11_86_88,r_11_86_88,1,39,127,88,91
20,r_36_92_131,r_140_35_79,seq93,r_36_92_131,1,1,132,131,91
14,r_112_76_32,r_113_103_53,seq83,r_112_76_32,1,0,32,32,91
96,seq114,r_111_71_140,seq107,r_111_71_140,0.99,0,140,140,91
42,r_141_75_178,r_124_139_119,r_108_80_43,r_141_75_178,0.89,0,178,178,91
31,r_117_72_8,r_74_10_90,seq102,r_74_10_90,0.82,0,90,90,91
28,r_18_147_181,seq16,r_20_148_120,r_20_148_120,0.97,61,181,120,91
4,r_131_116_21,r_132_125_78,r_115_44_91,r_131_116_21,0.7,12,33,21,91
56,seq129,seq130,r_15_122_90,r_15_122_90,1,64,154,90,91
7,r_23_32_87,seq25,seq33,r_23_32_87,0.66,0,87,87,91
44,r_43_54_88,seq46,r_98_51_34,r_98_51_34,0.99,54,88,34,91
23,r_28_67_76,r_31_7_147,seq69,r_28_67_76,1,0,76,76,91
82,seq83,r_82_29_157,r_108_80_43,r_108_80_43,0.99,55,98,43,91
79,seq69,r_68_53_169,r_85_70_80,r_85_70_80,0.98,89,169,80,91
35,r_31_7_147,seq30,seq5,r_31_7_147,0.95,0,147,147,91
12,r_146_137_91,seq149,seq138,r_146_137_91,0.96,3,94,91,91
43,r_9_55_133,r_74_10_90,r_43_54_88,r_9_55_133,1,0,133,133,91
93,seq108,r_106_53_85,r_20_107_9,r_106_53_85,1,0,85,85,92
51,seq1,r_22_66_113,r_35_2_85,r_22_66_113,1,0,113,113,92
45,r_131_76_43,r_136_36_162,r_135_77_20,r_136_36_162,0.99,-119,43,162,92
9,r_57_105_164,r_97_58_73,r_34_103_125,r_34_103_125,0.77,39,164,125,92
5,r_120_126_85,r_125_138_118,seq149,r_125_138_118,0.87,0,118,118,92
40,r_135_77_20,seq80,r_131_76_43,r_131_76_43,0.82,17,60,43,92
55,seq139,seq137,r_125_138_118,r_125_138_118,0.68,4,122,118,92
86,seq91,r_89_0_165,r_74_90_29,r_74_90_29,0.52,63,92,29,92
16,r_112_129_147,r_113_6_134,r_19_116_85,r_19_116_85,0.99,49,134,85,92
21,r_31_50_65,seq29,r_49_93_186,r_31_50_65,0.56,0,65,65,92
39,r_143_46_187,r_142_132_156,r_33_144_18,r_33_144_18,1,138,156,18,92
1,r_4_18_89,seq10,seq17,r_4_18_89,0.39,0,89,89,92
5,r_120_126_85,r_121_102_164,r_125_138_118,r_120_126_85,0.73,0,85,85,92
46,r_34_103_125,seq38,seq108,r_34_103_125,0.92,0,125,125,92
42,r_19_116_85,seq38,seq115,r_19_116_85,1,0,85,85,92
63,seq27,r_49_93_186,r_122_25_49,r_122_25_49,1,7,56,49,92
80,seq80,seq84,r_39_78_64,r_39_78_64,1,36,100,64,92
32,r_9_62_52,r_61_48_177,r_97_58_73,r_97_58_73,0.75,104,177,73,92
24,r_22_66_113,seq27,r_109_64_105,r_22_66_113,1,0,113,113,92
3,r_125_138_118,r_120_126_85,seq139,r_125_138_118,0.93,0,118,118,92
3,r_125_138_118,r_142_132_156,r_120_126_85,r_120_126_85,0.79,0,85,85,92
38,r_51_99_180,r_81_52_10,r_57_105_164,r_81_52_10,0.49,170,180,10,92
7,r_79_23_59,seq80,r_122_25_49,r_79_23_59,1,0,59,59,92
41,r_65_21_159,seq67,r_79_23_59,r_79_23_59,0.88,100,159,59,92
26,r_122_25_49,seq123,seq27,r_122_25_49,1,0,49,49,92
97,seq119,r_120_126_85,r_13_118_13,r_13_118_13,0.78,1,14,13,92
10,r_13_118_13,r_31_50_65,seq119,r_13_118_13,1,0,13,13,92
3,r_125_138_118,r_127_45_67,r_142_132_156,r_127_45_67,0.54,1,68,67,92
0,r_61_48_177,r_60_75_105,r_9_62_52,r_61_48_177,0.76,-89,88,177,92
11,r_142_132_156,r_143_46_187,r_125_138_118,r_125_138_118,0.99,35,153,118,92
13,r_97_58_73,r_95_100_186,r_57_105_164,r_95_100_186,0.72,-113,73,186,92
13,r_97_58_73,r_57_105_164,seq59,r_97_58_73,0.71,92,165,73,92
85,seq88,r_89_0_165,r_74_90_29,r_74_90_29,0.66,136,165,29,92
0,r_61_48_177,r_9_62_52,r_63_54_105,r_61_48_177,0.59,0,177,177,92
36,r_81_52_10,r_51_99_180,r_4_18_89,r_4_18_89,0.86,82,171,89,92
27,r_141_16_153,r_142_132_156,r_4_18_89,r_142_132_156,0.5,-3,153,156,92
30,r_104_11_15,r_40_87_107,r_15_8_179,r_40_87_107,1,-32,75,107,92
2,r_55_24_107,r_51_99_180,r_122_25_49,r_122_25_49,1,62,111,49,92
47,r_127_45_67,r_125_138_118,seq44,r_127_45_67,1,0,67,67,92
36,r_81_52_10,r_79_23_59,r_51_99_180,r_51_99_180,0.58,-170,10,180,92
18,r_113_6_134,r_112_129_147,seq5,r_113_6_134,0.83,0,134,134,92
29,r_117_26_142,seq115,r_86_28_136,r_117_26_142,0.68,0,142,142,92
38,r_51_99_180,r_55_24_107,r_81_52_10,r_81_52_10,0.99,1,11,10,92
17,r_106_53_85,r_55_24_107,r_63_54_105,r_63_54_105,0.65,13,118,105,92
48,r_40_87_107,r_51_99_180,r_74_90_29,r_40_87_107,1,1,108,107,92
30,r_104_11_15,r_97_58_73,r_40_87_107,r_104_11_15,1,0,15,15,92
17,r_106_53_85,seq108,r_55_24_107,r_106_53_85,0.52,0,85,85,92
94,seq111,r_110_7_178,r_57_105_164,r_57_105_164,0.73,14,178,164,92
9,r_57_105_164,r_61_48_177,r_97_58_73,r_57_105_164,0.54,-89,75,164,92
96,seq115,r_117_26_142,r_19_116_85,r_19_116_85,0.95,50,135,85,92
22,r_134_32_173,seq133,seq29,r_134_32_173,0.29,0,173,173,92
16,r_112_129_147,r_19_116_85,r_140_130_120,r_112_129_147,0.77,0,147,147,92
28,r_49_93_186,seq44,r_74_90_29,r_74_90_29,0.8,157,186,29,92
49,r_121_102_164,seq119,r_34_103_125,r_34_103_125,0.88,39,164,125,92
32,r_9_62_52,r_4_18_89,r_61_48_177,r_9_62_52,1,0,52,52,92
44,r_60_75_105,seq59,r_39_78_64,r_60_75_105,0.98,7,112,105,92
19,r_47_3_31,r_49_93_186,seq10,r_47_3_31,0.84,9,40,31,92
35,r_39_78_64,seq29,r_131_76_43,r_39_78_64,1,1,65,64,92
12,r_86_28_136,seq85,r_122_25_49,r_86_28_136,0.66,0,136,136,92
37,r_33_144_18,r_4_18_89,seq146,r_33_144_18,1,0,18,18,92
30,r_91_20_185,seq88,r_92_18_101,r_92_18_101,1,84,185,101,93
36,r_10_79_72,seq17,seq81,r_10_79_72,1,0,72,72,93
14,r_76_144_97,seq78,seq146,r_76_144_97,0.99,0,97,97,93
8,r_26_94_176,seq27,r_49_95_6,r_49_95_6,0.81,170,176,6,93
43,r_133_6_65,r_114_121_187,r_80_7_15,r_133_6_65,1,0,65,65,93
37,r_33_96_151,seq32,r_115_84_18,r_33_96_151,0.67,-1,150,151,93
59,seq141,r_147_98_159,r_86_140_65,r_86_140_65,0.88,9,74,65,93
86,seq81,seq78,r_10_79_72,r_10_79_72,1,1,73,72,93
1,r_13_113_122,seq14,seq111,r_13_113_122,0.96,0,122,122,93
5,r_21_34_87,seq27,r_120_36_86,r_21_34_87,1,0,87,87,93
42,r_147_98_159,seq146,r_49_95_6,r_147_98_159,0.49,0,159,159,93
7,r_16_42_133,r_61_15_13,r_47_46_5,r_16_42_133,0.82,0,133,133,93
45,r_86_140_65,seq87,seq141,r_86_140_65,0.94,0,65,65,93
10,r_28_139_20,r_26_94_176,seq138,r_28_139_20,0.99,0,20,20,93
16,r_57_97_28,r_56_75_65,seq99,r_57_97_28,1,2,30,28,93
39,r_83_22_29,r_82_127_108,seq23,r_83_22_29,1,0,29,29,93
67,seq31,seq29,r_124_30_93,r_124_30_93,1,19,112,93,93
41,r_117_37_13,r_114_121_187,r_63_43_14,r_117_37_13,0.97,0,13,13,93
3,r_120_36_86,r_122_131_185,seq32,r_120_36_86,1,0,86,86,93
28,r_132_77_42,r_114_121_187,seq78,r_132_77_42,0.99,0,42,42,93
26,r_25_135_72,seq27,r_28_139_20,r_25_135_72,0.65,0,72,72,93
78,seq55,r_56_75_65,r_90_59_57,r_90_59_57,0.9,7,64,57,93
11,r_124_30_93,seq126,seq31,r_124_30_93,1,0,93,93,93
20,r_129_85_114,seq128,seq87,r_129_85_114,0.84,0,114,114,93
13,r_67_64_13,r_65_24_133,r_105_66_78,r_67_64_13,0.85,115,128,13,93
15,r_112_35_144,r_114_121_187,r_120_36_86,r_114_121_187,0.82,-43,144,187,93
48,r_90_59_57,r_92_18_101,seq58,r_90_59_57,0.99,0,57,57,93
6,r_114_121_187,r_112_35_144,r_13_113_122,r_13_113_122,0.76,22,144,122,93
62,seq146,r_147_98_159,r_76_144_97,r_76_144_97,0.99,63,160,97,93
85,seq78,seq81,r_132_77_42,r_132_77_42,0.98,31,73,42,93
22,r_61_15_13,r_16_42_133,seq12,r_16_42_133,1,0,133,133,93
2,r_105_66_78,seq103,r_67_64_13,r_105_66_78,1,0,78,78,93
47,r_93_125_144,r_49_95_6,seq126,r_93_125_144,0.63,0,144,144,93
18,r_51_73_145,seq52,r_53_74_146,r_53_74_146,0.39,0,146,146,93
25,r_92_18_101,r_91_20_185,seq17,r_92_18_101,0.99,0,101,101,93
33,r_68_149_65,r_65_24_133,seq142,r_68_149_65,1,0,65,65,93
65,seq27,r_26_94_176,seq23,r_26_94_176,0.73,0,176,176,93
21,r_80_7_15,seq81,seq8,r_80_7_15,0.97,1,16,15,93
68,seq32,r_33_96_151,r_120_36_86,r_120_36_86,0.86,45,131,86,93
19,r_63_43_14,r_67_64_13,seq44,r_63_43_14,0.77,-1,13,14,93
61,seq17,r_19_11_134,r_92_18_101,r_92_18_101,1,56,157,101,93
38,r_82_127_108,seq55,seq128,r_82_127_108,0.91,0,108,108,93
34,r_65_24_133,r_67_64_13,seq23,r_65_24_133,0.82,0,133,133,93
7,r_16_42_133,r_5_45_105,r_61_15_13,r_61_15_13,0.99,0,13,13,93
17,r_5_45_105,seq8,r_47_46_5,r_5_45_105,0.99,0,105,105,93
22,r_61_15_13,seq62,r_16_42_133,r_61_15_13,1,0,13,13,93
78,seq55,r_90_59_57,seq48,r_90_59_57,0.74,38,95,57,93
49,r_106_116_141,seq107,r_110_118_22,r_110_118_22,0.67,118,140,22,93
23,r_72_123_63,r_71_101_163,r_122_131_185,r_72_123_63,0.98,0,63,63,93
82,seq62,r_65_24_133,seq70,r_65_24_133,0.81,-72,61,133,93
31,r_143_104_36,r_147_98_159,seq103,r_143_104_36,0.91,0,36,36,93
12,r_122_131_185,r_120_36_86,r_72_123_63,r_122_131_185,0.97,-99,86,185,93
30,r_10_75_165,seq9,r_96_72_134,r_10_75_165,0.59,1,166,165,94
6,r_135_54_21,r_48_140_193,r_106_57_30,r_135_54_21,0.71,13,34,21,94
14,r_110_145_107,seq109,seq148,r_110_145_107,0.99,0,107,107,94
8,r_118_25_122,r_121_74_171,r_52_26_92,r_118_25_122,0.86,1,123,122,94
83,seq141,r_143_44_117,r_147_60_194,r_143_44_117,1,-18,99,117,94
37,r_62_65_70,seq61,r_64_15_193,r_62_65_70,0.77,0,70,70,94
1,r_77_19_71,r_21_91_174,r_123_2_143,r_123_2_143,0.76,31,174,143,94
1,r_77_19_71,r_80_98_82,r_21_91_174,r_77_19_71,1,0,71,71,94
97,seq122,r_123_2_143,r_56_124_18,r_123_2_143,0.57,0,143,143,94
5,r_64_15_193,seq61,r_62_65_70,r_62_65_70,0.82,11,81,70,94
46,r_101_103_148,r_102_81_199,r_111_90_55,r_111_90_55,1,144,199,55,94
42,r_143_44_117,seq141,r_45_33_171,r_143_44_117,1,0,117,117,94
48,r_105_93_36,r_107_149_176,seq94,r_105_93_36,1,0,36,36,94
21,r_63_133_18,r_143_44_117,r_79_131_67,r_63_133_18,1,49,67,18,94
29,r_37_58_33,r_34_108_173,seq59,r_37_58_33,1,0,33,33,94
33,r_142_50_32,r_143_44_117,r_48_140_193,r_142_50_32,1,0,32,32,94
32,r_132_35_29,r_34_108_173,r_73_36_136,r_73_36_136,1,12,148,136,94
45,r_18_30_68,r_22_144_124,seq31,r_22_144_124,0.97,-56,68,124,94
43,r_104_69_41,r_102_81_199,seq70,r_104_69_41,0.99,0,41,41,94
33,r_142_50_32,r_48_140_193,r_76_49_121,r_76_49_121,0.98,16,137,121,94
38,r_34_108_173,r_132_35_29,seq109,r_34_108_173,0.61,0,173,173,94
0,r_89_130_35,r_92_82_166,seq129,r_89_130_35,1,0,35,35,94
4,r_106_57_30,r_105_93_36,r_135_54_21,r_106_57_30,0.86,0,30,30,94
6,r_135_54_21,r_147_60_194,r_48_140_193,r_48_140_193,0.67,-172,21,193,94
15,r_51_136_27,r_52_26_92,seq134,r_51_136_27,0.95,3,30,27,94
31,r_146_99_96,r_147_60_194,r_80_98_82,r_146_99_96,1,0,96,96,94
41,r_0_53_93,r_6_84_155,r_48_140_193,r_0_53_93,0.97,0,93,93,94
10,r_85_78_168,seq71,r_92_82_166,r_85_78_168,0.37,0,168,168,94
90,seq97,r_96_72_134,seq100,r_96_72_134,0.65,-35,99,134,94
26,r_123_2_143,seq122,seq1,r_123_2_143,0.74,0,143,143,94
3,r_56_124_18,r_51_136_27,seq125,r_56_124_18,0.81,0,18,18,94
11,r_107_149_176,seq109,seq148,r_107_149_176,0.52,0,176,176,94
20,r_8_47_97,r_10_75_165,r_48_140_193,r_8_47_97,0.86,0,97,97,94
36,r_95_14_20,r_92_82_166,seq13,r_95_14_20,0.78,0,20,20,94
49,r_21_91_174,r_77_19_71,seq94,r_21_91_174,0.93,0,174,174,94
34,r_46_120_56,r_48_140_193,r_121_74_171,r_46_120_56,1,0,56,56,94
2,r_76_49_121,r_85_78_168,r_142_50_32,r_76_49_121,1,0,121,121,94
19,r_111_90_55,r_107_149_176,seq100,r_111_90_55,1,0,55,55,94
27,r_24_113_120,seq23,seq114,r_24_113_120,0.89,1,121,120,94
21,r_63_133_18,r_62_65_70,r_143_44_117,r_63_133_18,0.93,0,18,18,94
40,r_79_131_67,r_80_98_82,r_63_133_18,r_79_131_67,1,0,67,67,94
18,r_6_84_155,seq1,seq83,r_6_84_155,0.92,0,155,155,94
24,r_92_82_166,seq94,r_85_78_168,r_92_82_166,0.46,2,168,166,94
20,r_8_47_97,r_48_140_193,r_142_50_32,r_48_140_193,0.53,-61,132,193,94
34,r_46_120_56,r_121_74_171,r_24_113_120,r_24_113_120,0.99,51,171,120,94
25,r_22_144_124,r_21_91_174,seq141,r_22_144_124,0.98,0,124,124,94
16,r_119_40_48,r_118_25_122,seq43,r_119_40_48,0.79,0,48,48,94
64,seq148,r_147_60_194,r_107_149_176,r_107_149_176,0.91,18,194,176,94
28,r_52_26_92,r_51_136_27,r_135_54_21,r_52_26_92,0.64,-62,30,92,94
47,r_48_140_193,r_142_50_32,r_107_149_176,r_48_140_193,0.73,0,193,193,94
41,r_0_53_93,r_48_140_193,r_135_54_21,r_0_53_93,0.39,55,148,93,94
47,r_48_140_193,r_46_120_56,r_142_50_32,r_48_140_193,0.99,-148,45,193,94
2,r_76_49_121,r_79_131_67,r_85_78_168,r_79_131_67,0.95,-15,52,67,94
81,seq70,seq68,r_104_69_41,r_104_69_41,1,80,121,41,94
17,r_96_72_134,seq97,seq71,r_96_72_134,0.62,0,134,134,94
32,r_132_35_29,seq134,r_34_108_173,r_132_35_29,0.99,0,29,29,94
9,r_73_36_136,seq71,r_132_35_29,r_73_36_136,0.97,0,136,136,94
37,r_62_65_70,r_64_15_193,r_147_60_194,r_147_60_194,0.5,3,197,194,94
28,r_52_26_92,r_135_54_21,r_24_113_120,r_52_26_92,0.85,0,92,92,94
28,r_52_26_92,r_24_113_120,r_118_25_122,r_52_26_92,1,31,123,92,94
23,r_121_74_171,r_118_25_122,r_46_120_56,r_121_74_171,0.66,-115,56,171,94
49,r_21_91_174,r_22_144_124,r_77_19_71,r_77_19_71,0.75,28,99,71,94
89,seq94,r_92_82_166,r_105_93_36,r_105_93_36,1,8,44,36,94
7,r_80_98_82,r_76_49_121,seq100,r_80_98_82,0.46,0,82,82,94
44,r_27_42_144,seq28,r_119_40_48,r_119_40_48,1,103,151,48,94
38,r_34_108_173,r_37_58_33,r_132_35_29,r_34_108_173,1,-140,33,173,94
35,r_20_126_100,r_22_144_124,seq125,r_20_126_100,1,0,100,100,94
23,r_121_74_171,r_46_120_56,r_96_72_134,r_121_74_171,0.52,0,171,171,94
84,seq83,seq71,r_6_84_155,r_6_84_155,1,27,182,155,94
30,r_30_97_133,r_32_44_160,seq96,r_30_97_133,0.54,0,133,133,95
9,r_110_133_179,r_70_111_2,r_113_134_48,r_113_134_48,0.81,131,179,48,95
0,r_50_7_55,r_51_52_93,seq5,r_50_7_55,1,0,55,55,95
87,seq91,seq96,r_130_90_178,r_130_90_178,0.93,0,178,178,95
72,seq48,r_50_7_55,r_55_22_132,r_50_7_55,0.96,-23,32,55,95
20,r_109_14_153,r_108_78_91,r_89_132_47,r_89_132_47,0.52,-1,46,47,95
8,r_100_20_154,seq102,r_139_21_156,r_100_20_154,0.93,2,156,154,95
22,r_141_87_26,r_139_21_156,r_86_23_137,r_141_87_26,1,0,26,26,95
12,r_68_104_51,seq67,seq103,r_68_104_51,1,3,54,51,95
37,r_118_98_171,seq115,r_83_93_175,r_118_98_171,0.77,0,171,171,95
42,r_19_73_164,r_17_64_81,r_34_137_160,r_19_73_164,0.43,-112,52,164,95
26,r_89_132_47,r_86_23_137,seq125,r_89_132_47,1,0,47,47,95
71,seq43,r_42_24_113,r_32_44_160,r_42_24_113,0.83,16,129,113,95
16,r_92_62_171,seq96,r_63_66_108,r_92_62_171,0.29,0,171,171,95
1,r_83_93_175,seq82,r_30_97_133,r_30_97_133,0.8,46,179,133,95
97,seq122,r_123_117_125,r_18_128_104,r_18_128_104,1,32,136,104,95
5,r_34_137_160,seq33,r_54_142_6,r_34_137_160,0.77,0,160,160,95
46,r_32_44_160,r_34_137_160,seq43,r_34_137_160,0.97,-7,153,160,95
42,r_19_73_164,r_42_24_113,r_148_72_16,r_19_73_164,0.98,0,164,164,95
35,r_149_145_204,r_136_45_57,r_144_143_8,r_136_45_57,0.97,-6,51,57,95
19,r_60_46_118,seq59,r_136_45_57,r_136_45_57,1,61,118,57,95
4,r_127_28_48,seq129,seq25,r_127_28_48,1,3,51,48,95
11,r_148_72_16,r_74_121_140,seq81,r_74_121_140,1,0,140,140,95
66,seq33,r_34_137_160,seq31,r_34_137_160,1,0,160,160,95
31,r_53_119_81,r_55_22_132,seq116,r_53_119_81,1,0,81,81,95
74,seq138,r_136_45_57,r_54_142_6,r_136_45_57,0.99,-6,51,57,95
13,r_80_41_180,seq79,r_148_72_16,r_148_72_16,1,86,102,16,95
25,r_86_23_137,seq85,r_141_87_26,r_141_87_26,1,7,33,26,95
15,r_123_117_125,seq122,r_53_119_81,r_53_119_81,1,52,133,81,95
28,r_51_52_93,r_55_22_132,seq57,r_55_22_132,0.98,0,132,132,95
57,seq10,r_9_39_101,seq8,r_9_39_101,1,-34,67,101,95
13,r_80_41_180,r_148_72_16,r_32_44_160,r_80_41_180,0.52,0,180,180,95
6,r_4_36_68,seq3,seq37,r_4_36_68,1,0,68,68,95
21,r_74_121_140,r_148_72_16,seq120,r_74_121_140,0.97,0,140,140,95
27,r_94_107_93,seq96,seq105,r_94_107_93,1,0,93,93,95
22,r_141_87_26,r_86_23_137,r_148_72_16,r_86_23_137,0.93,0,137,137,95
2,r_55_22_132,r_56_147_89,r_51_52_93,r_56_147_89,1,1,90,89,95
47,r_17_64_81,r_18_128_104,seq69,r_17_64_81,0.64,0,81,81,95
88,seq135,r_136_45_57,r_113_134_48,r_136_45_57,1,2,59,57,95
29,r_139_21_156,seq138,r_100_20_154,r_139_21_156,0.75,0,156,156,95
24,r_18_128_104,r_17_64_81,seq15,r_17_64_81,0.87,1,82,81,95
33,r_42_24_113,seq43,r_19_73_164,r_19_73_164,0.58,-44,120,164,95
11,r_148_72_16,r_136_45_57,r_74_121_140,r_148_72_16,0.71,0,16,16,95
70,seq40,r_42_24_113,r_9_39_101,r_9_39_101,0.94,1,102,101,95
21,r_74_121_140,r_80_41_180,r_148_72_16,r_148_72_16,0.97,0,16,16,95
20,r_109_14_153,r_89_132_47,seq12,r_109_14_153,0.7,0,153,153,95
42,r_19_73_164,r_34_137_160,seq57,r_19_73_164,0.56,-59,105,164,95
32,r_58_99_58,seq57,seq102,r_58_99_58,1,1,59,58,95
38,r_84_29_161,seq81,r_127_28_48,r_127_28_48,0.83,113,161,48,95
52,seq3,seq1,r_101_2_69,r_101_2_69,1,12,81,69,95
39,r_113_134_48,seq112,seq135,r_113_134_48,0.58,3,51,48,95
35,r_149_145_204,r_144_143_8,r_56_147_89,r_56_147_89,0.99,3,92,89,95
28,r_51_52_93,seq49,r_55_22_132,r_51_52_93,0.61,3,96,93,95
17,r_101_2_69,r_100_20_154,seq3,r_101_2_69,0.97,1,70,69,95
25,r_86_23_137,r_141_87_26,r_55_22_132,r_86_23_137,0.49,0,137,137,95
9,r_110_133_179,r_114_88_169,r_70_111_2,r_110_133_179,0.49,-112,67,179,95
23,r_136_45_57,seq135,r_13_47_55,r_136_45_57,1,2,59,57,95
96,seq120,seq125,r_74_121_140,r_74_121_140,0.99,31,171,140,95
72,seq48,r_92_62_171,seq49,r_92_62_171,0.63,-52,119,171,95
91,seq103,r_100_20_154,r_68_104_51,r_68_104_51,0.52,20,71,51,95
49,r_108_78_91,seq105,seq77,r_108_78_91,1,0,91,91,95
72,seq48,r_55_22_132,r_92_62_171,r_92_62_171,0.84,-79,92,171,95
24,r_18_128_104,seq15,seq129,r_18_128_104,0.95,0,104,104,95
28,r_51_52_93,r_50_7_55,seq49,r_50_7_55,1,0,55,55,95
33,r_42_24_113,r_19_73_164,r_55_22_132,r_42_24_113,0.82,23,136,113,95
7,r_9_39_101,seq10,seq8,r_9_39_101,0.33,-30,71,101,95
75,seq57,r_58_99_58,r_55_22_132,r_58_99_58,0.97,-21,37,58,95
44,r_56_147_89,r_55_22_132,r_149_145_204,r_56_147_89,0.99,0,89,89,95
2,r_55_22_132,r_51_52_93,r_42_24_113,r_55_22_132,0.99,0,132,132,95
82,seq77,seq79,r_108_78_91,r_108_78_91,1,31,122,91,95
36,r_13_47_55,seq12,r_136_45_57,r_136_45_57,0.72,2,59,57,95
7,r_9_39_101,seq8,seq40,r_9_39_101,0.95,0,101,101,95
48,r_75_126_48,r_74_121_140,seq125,r_75_126_48,0.69,3,51,48,95
36,r_50_65_68,r_51_15_148,seq69,r_51_15_148,0.78,-80,68,148,96
19,r_98_7_36,r_99_20_68,seq10,r_98_7_36,1,0,36,36,96
43,r_43_87_93,seq47,seq86,r_43_87_93,0.92,0,93,93,96
2,r_92_110_164,r_91_42_58,seq90,r_91_42_58,0.99,0,58,58,96
16,r_129_89_154,seq130,r_43_87_93,r_129_89_154,0.72,1,155,154,96
1,r_22_136_147,r_18_5_155,r_17_138_85,r_18_5_155,0.88,-8,147,155,96
42,r_79_135_159,seq78,r_22_136_147,r_79_135_159,0.77,1,160,159,96
35,r_146_38_23,seq137,r_40_34_125,r_146_38_23,0.99,-5,18,23,96
69,seq52,r_51_15_148,seq86,r_51_15_148,0.94,0,148,148,96
45,r_30_96_181,seq32,r_41_31_67,r_41_31_67,1,4,71,67,96
24,r_41_31_67,r_30_96_181,r_40_34_125,r_40_34_125,0.95,57,182,125,96
15,r_16_61_22,seq58,r_73_62_187,r_73_62_187,0.54,-11,176,187,96
88,seq94,r_35_106_54,r_128_112_104,r_35_106_54,0.53,76,130,54,96
95,seq115,seq113,r_141_116_75,r_141_116_75,1,32,107,75,96
0,r_114_63_43,seq115,r_64_145_159,r_114_63_43,0.98,0,43,43,96
39,r_64_145_159,r_114_63_43,r_131_144_149,r_64_145_159,0.95,0,159,159,96
31,r_119_19_123,seq120,seq21,r_119_19_123,0.85,0,123,123,96
41,r_25_139_96,r_24_132_132,r_17_138_85,r_25_139_96,0.83,0,96,96,96
67,seq47,r_44_140_188,seq45,r_44_140_188,0.56,-30,158,188,96
89,seq101,r_100_39_151,r_128_112_104,r_100_39_151,0.65,0,151,151,96
3,r_46_123_79,seq47,seq121,r_46_123_79,0.95,0,79,79,96
10,r_14_75_185,r_17_138_85,r_48_13_39,r_14_75_185,0.6,-97,88,185,96
14,r_48_13_39,seq49,r_14_75_185,r_48_13_39,0.99,1,40,39,96
14,r_48_13_39,r_14_75_185,r_40_34_125,r_40_34_125,0.68,59,184,125,96
4,r_99_20_68,r_100_39_151,seq21,r_99_20_68,1,0,68,68,96
25,r_35_106_54,seq36,seq105,r_35_106_54,1,0,54,54,96
63,seq32,seq33,r_40_34_125,r_40_34_125,1,21,146,125,96
11,r_24_132_132,r_29_37_134,seq130,r_24_132_132,0.56,0,132,132,96
39,r_64_145_159,r_60_84_29,r_114_63_43,r_114_63_43,0.79,6,49,43,96
13,r_29_37_134,seq27,r_146_38_23,r_29_37_134,0.96,0,134,134,96
65,seq36,r_35_106_54,r_83_6_184,r_35_106_54,0.65,0,54,54,96
6,r_104_71_75,seq105,seq78,r_104_71_75,1,0,75,75,96
10,r_14_75_185,r_51_15_148,r_104_71_75,r_14_75_185,0.98,0,185,185,96
20,r_125_28_48,seq126,seq27,r_125_28_48,0.93,0,48,48,96
2,r_92_110_164,seq90,seq108,r_92_110_164,0.81,0,164,164,96
0,r_114_63_43,r_64_145_159,r_104_71_75,r_114_63_43,0.93,116,159,43,96
10,r_14_75_185,r_48_13_39,r_51_15_148,r_51_15_148,1,1,149,148,96
27,r_80_8_127,r_79_135_159,r_95_11_30,r_79_135_159,0.56,-32,127,159,96
30,r_91_42_58,r_92_110_164,r_146_38_23,r_91_42_58,0.84,0,58,58,96
47,r_9_88_97,seq4,r_43_87_93,r_9_88_97,1,0,97,97,96
40,r_131_144_149,r_129_89_154,seq142,r_131_144_149,0.66,0,149,149,96
29,r_23_54_69,r_22_136_147,seq53,r_23_54_69,1,0,69,69,96
15,r_16_61_22,r_14_75_185,seq58,r_16_61_22,0.97,-4,18,22,96
24,r_41_31_67,r_40_34_125,r_30_96_181,r_41_31_67,0.95,2,69,67,96
35,r_146_38_23,r_40_34_125,r_91_42_58,r_146_38_23,0.61,102,125,23,96
33,r_67_55_74,seq68,seq56,r_67_55_74,0.79,0,74,74,96
68,seq49,r_48_13_39,seq47,r_48_13_39,0.95,0,39,39,96
65,seq36,r_83_6_184,r_104_71_75,r_104_71_75,0.83,39,114,75,96
88,seq94,r_134_118_3,r_35_106_54,r_35_106_54,0.78,48,102,54,96
70,seq53,r_60_84_29,r_23_54_69,r_23_54_69,1,4,73,69,96
35,r_146_38_23,r_91_42_58,r_29_37_134,r_29_37_134,0.86,3,137,134,96
61,seq21,r_18_5_155,r_119_19_123,r_119_19_123,0.72,32,155,123,96
38,r_122_148_66,seq121,seq147,r_122_148_66,1,0,66,66,96
52,seq130,r_129_89_154,r_24_132_132,r_24_132_132,0.88,23,155,132,96
77,seq69,r_70_93_144,r_104_71_75,r_104_71_75,0.99,59,134,75,96
34,r_2_124_157,seq3,r_46_123_79,r_2_124_157,0.58,0,157,157,96
28,r_40_34_125,r_91_42_58,seq32,r_40_34_125,1,0,125,125,96
75,seq66,r_80_8_127,seq68,r_80_8_127,0.98,-55,72,127,96
60,seq147,r_149_117_183,r_122_148_66,r_122_148_66,1,117,183,66,96
45,r_30_96_181,r_41_31_67,r_111_102_68,r_30_96_181,0.74,0,181,181,96
18,r_95_11_30,r_99_20_68,seq12,r_95_11_30,0.99,0,30,30,96
17,r_149_117_183,seq147,r_134_118_3,r_134_118_3,0.59,180,183,3,96
9,r_100_39_151,seq101,r_29_37_134,r_100_39_151,0.81,0,151,151,96
23,r_17_138_85,seq137,r_25_139_96,r_25_139_96,0.81,6,102,96,96
22,r_141_116_75,seq142,seq115,r_141_116_75,0.99,0,75,75,96
28,r_40_34_125,r_41_31_67,r_91_42_58,r_41_31_67,0.53,2,69,67,96
49,r_133_26_143,r_129_89_154,r_125_28_48,r_133_26_143,0.83,0,143,143,96
12,r_51_15_148,r_14_75_185,r_40_34_125,r_14_75_185,0.72,1,186,185,96
23,r_17_138_85,r_14_75_185,seq137,r_17_138_85,0.81,1,86,85,96
82,seq78,r_79_135_159,r_104_71_75,r_104_71_75,0.71,84,159,75,96
8,r_92_89_114,r_96_1_183,r_5_94_32,r_5_94_32,1,7,39,32,97
37,r_6_79_155,r_7_45_142,r_10_20_158,r_7_45_142,0.91,0,142,142,97
16,r_44_71_156,seq49,r_8_68_97,r_8_68_97,1,59,156,97,97
21,r_78_110_98,seq77,r_4_111_15,r_78_110_98,1,0,98,98,97
39,r_118_84_143,seq125,r_103_83_35,r_118_84_143,0.71,0,143,143,97
5,r_48_127_111,seq49,r_133_131_25,r_48_127_111,0.99,0,111,111,97
33,r_80_91_170,seq81,r_103_83_35,r_103_83_35,0.38,112,147,35,97
69,seq33,r_34_93_72,r_109_35_23,r_34_93_72,0.64,0,72,72,97
20,r_128_40_101,r_133_131_25,seq37,r_128_40_101,1,0,101,101,97
48,r_97_27_24,r_96_1_183,seq29,r_97_27_24,1,0,24,24,97
41,r_17_116_25,r_34_93_72,seq115,r_17_116_25,1,0,25,25,97
37,r_6_79_155,r_10_20_158,r_90_82_142,r_6_79_155,0.78,0,155,155,97
38,r_76_16_35,r_78_110_98,seq12,r_76_16_35,1,0,35,35,97
45,r_22_9_56,seq18,r_10_20_158,r_22_9_56,0.76,1,57,56,97
31,r_56_21_132,seq55,seq19,r_56_21_132,0.95,0,132,132,97
11,r_109_35_23,r_107_113_169,seq33,r_109_35_23,1,0,23,23,97
67,seq30,r_14_65_128,seq19,r_14_65_128,0.97,-18,110,128,97
23,r_133_131_25,r_142_132_178,seq129,r_133_131_25,0.93,1,26,25,97
10,r_140_121_169,r_142_132_178,r_24_120_15,r_24_120_15,0.57,154,169,15,97
90,seq95,r_96_1_183,r_144_98_31,r_144_98_31,1,152,183,31,97
26,r_72_38_159,seq77,r_128_40_101,r_72_38_159,0.73,0,159,159,97
8,r_92_89_114,r_5_94_32,r_103_83_35,r_92_89_114,0.73,0,114,114,97
32,r_147_60_41,seq146,seq57,r_147_60_41,1,0,41,41,97
73,seq42,seq41,r_124_43_162,r_124_43_162,0.94,0,162,162,97
36,r_117_105_22,seq115,r_107_113_169,r_107_113_169,0.9,-149,20,169,97
15,r_36_112_116,seq42,r_4_111_15,r_36_112_116,0.85,0,116,116,97
44,r_103_83_35,seq102,seq88,r_103_83_35,1,0,35,35,97
4,r_124_43_162,r_24_120_15,seq42,r_124_43_162,0.81,0,162,162,97
6,r_86_139_102,seq88,r_142_132_178,r_86_139_102,0.97,0,102,102,97
20,r_128_40_101,r_124_43_162,r_133_131_25,r_133_131_25,0.59,23,48,25,97
99,seq125,seq129,r_2_126_147,r_2_126_147,1,4,151,147,97
74,seq49,r_44_71_156,r_7_45_142,r_7_45_142,0.85,7,149,142,97
4,r_124_43_162,r_128_40_101,r_24_120_15,r_124_43_162,0.59,-107,55,162,97
49,r_101_119_16,seq100,r_24_120_15,r_101_119_16,0.99,0,16,16,97
2,r_2_126_147,seq0,seq125,r_2_126_147,0.75,0,147,147,97
47,r_85_46_62,r_86_139_102,seq49,r_85_46_62,1,0,62,62,97
43,r_4_111_15,r_2_126_147,r_107_113_169,r_4_111_15,1,0,15,15,97
62,seq149,r_122_145_36,r_108_148_140,r_108_148_140,1,1,141,140,97
40,r_142_132_178,seq141,seq138,r_142_132_178,0.69,-84,94,178,97
74,seq49,r_48_127_111,r_44_71_156,r_48_127_111,0.96,-7,104,111,97
29,r_14_65_128,seq12,seq61,r_14_65_128,0.97,0,128,128,97
24,r_8_68_97,r_7_45_142,seq66,r_8_68_97,0.92,0,97,97,97
34,r_5_94_32,r_92_89_114,r_34_93_72,r_34_93_72,0.66,42,114,72,97
25,r_47_130_72,r_48_127_111,r_133_131_25,r_133_131_25,1,47,72,25,97
33,r_80_91_170,r_92_89_114,seq81,r_92_89_114,0.34,-12,102,114,97
7,r_24_120_15,seq23,r_101_119_16,r_24_120_15,1,1,16,15,97
1,r_122_145_36,r_124_43_162,seq146,r_122_145_36,0.74,1,37,36,97
45,r_22_9_56,r_10_20_158,r_76_16_35,r_10_20_158,0.56,9,167,158,97
81,seq66,r_67_63_112,r_8_68_97,r_8_68_97,1,18,115,97,97
17,r_108_148_140,r_107_113_169,seq149,r_108_148_140,0.87,0,140,140,97
9,r_62_73_149,seq61,seq75,r_62_73_149,0.64,0,149,149,97
14,r_144_98_31,seq146,seq95,r_144_98_31,0.89,1,32,31,97
34,r_5_94_32,r_10_20_158,r_92_89_114,r_5_94_32,1,0,32,32,97
28,r_7_45_142,r_6_79_155,seq49,r_7_45_142,0.93,0,142,142,97
12,r_51_136_56,r_52_50_32,seq137,r_51_136_56,1,0,56,56,97
98,seq115,r_117_105_22,r_17_116_25,r_17_116_25,1,0,25,25,97
35,r_59_31_100,seq55,seq33,r_59_31_100,1,0,100,100,97
27,r_58_70_6,r_48_127_111,r_135_69_9,r_58_70_6,0.98,8,14,6,97
84,seq77,r_78_110_98,seq74,r_78_110_98,1,0,98,98,97
30,r_141_87_106,r_142_119_71,r_145_111_146,r_142_119_71,0.84,7,78,71,98
15,r_103_122_14,r_105_134_122,seq123,r_103_122_14,0.53,0,14,14,98
8,r_130_71_181,seq129,r_30_69_78,r_130_71_181,0.49,0,181,181,98
53,seq133,r_136_65_147,r_59_132_50,r_59_132_50,0.76,26,76,50,98
43,r_78_26_191,seq81,r_74_121_79,r_74_121_79,0.71,46,125,79,98
42,r_51_110_57,seq52,r_2_107_1,r_51_110_57,1,0,57,57,98
63,seq149,r_145_111_146,r_5_146_119,r_5_146_119,0.9,11,130,119,98
22,r_45_61_50,seq46,seq62,r_45_61_50,0.99,2,52,50,98
37,r_139_82_90,r_138_12_113,r_50_85_39,r_139_82_90,0.96,0,90,90,98
59,seq140,r_138_12_113,r_145_111_146,r_138_12_113,1,0,113,113,98
55,seq129,r_130_71_181,r_59_132_50,r_59_132_50,0.99,131,181,50,98
16,r_127_80_158,r_126_36_169,seq81,r_127_80_158,0.58,0,158,158,98
39,r_68_93_112,seq67,r_94_35_169,r_68_93_112,0.99,0,112,112,98
1,r_108_21_138,r_2_107_1,r_144_23_112,r_2_107_1,1,137,138,1,98
14,r_86_91_198,r_84_32_136,r_50_85_39,r_50_85_39,0.91,4,43,39,98
5,r_74_121_79,seq75,seq120,r_74_121_79,1,0,79,79,98
68,seq43,r_51_110_57,seq46,r_51_110_57,1,-13,44,57,98
32,r_25_55_85,r_106_24_11,seq46,r_25_55_85,0.99,0,85,85,98
7,r_106_24_11,r_25_55_85,r_147_28_33,r_25_55_85,0.74,0,85,85,98
19,r_92_7_70,r_95_22_141,seq10,r_92_7_70,0.74,0,70,70,98
9,r_94_35_169,r_40_96_54,r_14_39_42,r_94_35_169,0.89,0,169,169,98
85,seq88,seq90,r_17_89_10,r_17_89_10,0.99,23,33,10,98
30,r_141_87_106,r_145_111_146,r_17_89_10,r_141_87_106,0.56,0,106,106,98
45,r_9_77_28,seq8,seq75,r_9_77_28,1,0,28,28,98
33,r_147_28_33,seq149,r_13_27_24,r_147_28_33,0.98,0,33,33,98
31,r_5_146_119,seq10,seq149,r_5_146_119,0.97,3,122,119,98
41,r_126_36_169,seq125,r_14_39_42,r_126_36_169,0.69,0,169,169,98
24,r_70_104_130,r_30_69_78,seq100,r_70_104_130,0.98,0,130,130,98
44,r_13_27_24,r_9_77_28,r_106_24_11,r_13_27_24,0.98,0,24,24,98
3,r_31_64_123,seq33,seq66,r_31_64_123,1,0,123,123,98
10,r_84_32_136,r_86_91_198,seq33,r_84_32_136,0.88,0,136,136,98
26,r_105_134_122,seq100,r_59_132_50,r_59_132_50,1,72,122,50,98
0,r_99_79_165,seq98,r_127_80_158,r_99_79_165,0.46,3,168,165,98
63,seq149,r_148_37_91,r_145_111_146,r_148_37_91,0.93,-9,82,91,98
43,r_78_26_191,r_74_121_79,seq113,r_78_26_191,0.46,-45,146,191,98
11,r_41_76_134,seq42,r_9_77_28,r_41_76_134,0.95,0,134,134,98
20,r_145_111_146,r_144_23_112,seq140,r_144_23_112,1,-25,87,112,98
13,r_138_12_113,seq140,seq8,r_138_12_113,0.98,0,113,113,98
48,r_136_65_147,r_135_101_158,seq66,r_136_65_147,0.97,0,147,147,98
44,r_13_27_24,r_106_24_11,r_147_28_33,r_13_27_24,0.5,44,68,24,98
36,r_40_96_54,r_41_76_134,seq98,r_40_96_54,1,0,54,54,98
6,r_95_22_141,r_94_35_169,r_144_23_112,r_94_35_169,0.91,-28,141,169,98
62,seq20,seq19,r_108_21_138,r_108_21_138,1,4,142,138,98
84,seq81,r_78_26_191,r_127_80_158,r_78_26_191,0.96,-31,160,191,98
29,r_17_89_10,r_18_0_99,seq88,r_17_89_10,0.99,0,10,10,98
27,r_144_23_112,r_145_111_146,seq20,r_144_23_112,0.84,0,112,112,98
25,r_14_39_42,seq15,seq42,r_14_39_42,0.96,9,51,42,98
87,seq98,r_99_79_165,r_40_96_54,r_40_96_54,1,117,171,54,98
34,r_102_128_44,r_105_134_122,r_126_36_169,r_102_128_44,0.53,0,44,44,98
4,r_50_85_39,seq49,r_86_91_198,r_50_85_39,1,0,39,39,98
2,r_2_107_1,r_109_47_159,r_51_110_57,r_51_110_57,1,102,159,57,98
47,r_54_137_191,seq46,r_59_132_50,r_59_132_50,0.79,141,191,50,98
24,r_70_104_130,r_68_93_112,r_30_69_78,r_30_69_78,0.61,2,80,78,98
34,r_102_128_44,r_126_36_169,r_59_132_50,r_126_36_169,0.97,-8,161,169,98
7,r_106_24_11,r_105_134_122,r_25_55_85,r_106_24_11,1,0,11,11,98
38,r_109_47_159,r_2_107_1,seq46,r_109_47_159,0.7,0,159,159,98
39,r_68_93_112,r_94_35_169,seq98,r_94_35_169,1,0,169,169,98
81,seq73,r_72_143_175,r_41_76_134,r_41_76_134,0.99,38,172,134,98
17,r_142_119_71,r_141_87_106,seq123,r_142_119_71,0.91,-1,70,71,98
21,r_59_132_50,seq58,seq133,r_59_132_50,1,0,50,50,98
9,r_94_35_169,r_95_22_141,r_40_96_54,r_40_96_54,1,91,145,54,98
77,seq58,r_59_132_50,seq57,r_59_132_50,1,0,50,50,98
96,seq120,r_127_80_158,r_74_121_79,r_74_121_79,0.88,1,80,79,98
28,r_148_37_91,seq149,r_14_39_42,r_148_37_91,1,0,91,91,98
49,r_135_101_158,seq133,r_70_104_130,r_70_104_130,0.93,23,153,130,98
23,r_30_69_78,seq29,seq66,r_30_69_78,0.95,0,78,78,98
32,r_25_55_85,r_41_76_134,r_106_24_11,r_106_24_11,0.78,10,21,11,98
35,r_60_16_79,seq62,seq15,r_60_16_79,0.99,0,79,79,98
12,r_18_0_99,seq20,seq1,r_18_0_99,0.98,0,99,99,98
23,r_30_69_78,seq66,r_130_71_181,r_130_71_181,0.99,1,182,181,98
84,seq81,r_78_26_191,r_17_89_10,r_78_26_191,0.51,-75,116,191,98
93,seq112,r_111_83_141,r_143_109_23,r_143_109_23,0.86,118,141,23,99
18,r_2_97_59,seq3,r_93_96_52,r_2_97_59,0.99,0,59,59,99
90,seq92,r_111_83_141,r_45_91_29,r_45_91_29,1,1,30,29,99
14,r_68_98_80,seq69,r_133_95_37,r_68_98_80,0.64,-8,72,80,99
8,r_49_40_153,r_50_101_177,r_116_35_141,r_50_101_177,0.94,-19,158,177,99
43,r_148_74_172,seq149,r_77_87_12,r_77_87_12,0.52,162,174,12,99
83,seq69,r_68_98_80,seq78,r_68_98_80,0.91,-8,72,80,99
37,r_118_0_142,seq125,r_108_119_61,r_108_119_61,0.86,31,92,61,99
10,r_102_146_8,r_116_35_141,seq149,r_102_146_8,0.67,2,10,8,99
16,r_66_19_135,r_65_89_104,seq64,r_65_89_104,0.5,-39,65,104,99
39,r_115_28_89,r_111_83_141,seq25,r_115_28_89,0.91,0,89,89,99
12,r_126_57_49,seq125,r_131_55_4,r_126_57_49,0.99,0,49,49,99
5,r_81_1_67,r_82_117_94,r_122_5_17,r_82_117_94,0.57,-27,67,94,99
46,r_105_76_64,seq92,seq78,r_105_76_64,0.61,1,65,64,99
42,r_99_144_167,seq92,r_68_98_80,r_99_144_167,0.43,-68,99,167,99
21,r_129_107_31,seq128,r_103_36_180,r_129_107_31,0.96,0,31,31,99
19,r_39_73_67,seq38,seq72,r_39_73_67,1,0,67,67,99
31,r_111_83_141,seq112,r_53_80_31,r_53_80_31,0.71,111,142,31,99
30,r_53_80_31,r_52_15_182,seq78,r_53_80_31,0.98,-1,30,31,99
3,r_147_85_61,r_148_74_172,seq86,r_147_85_61,0.9,0,61,61,99
26,r_108_119_61,r_111_83_141,r_118_0_142,r_108_119_61,0.96,9,70,61,99
16,r_66_19_135,seq64,r_115_28_89,r_66_19_135,0.53,0,135,135,99
0,r_116_35_141,r_111_83_141,seq38,r_111_83_141,0.71,0,141,141,99
20,r_56_67_111,r_131_55_4,r_75_70_84,r_131_55_4,0.6,106,110,4,99
13,r_103_36_180,seq104,r_116_35_141,r_116_35_141,0.81,39,180,141,99
15,r_52_15_182,seq51,r_32_33_60,r_32_33_60,0.8,123,183,60,99
48,r_17_110_130,seq16,r_143_109_23,r_17_110_130,0.91,0,130,130,99
53,seq6,r_115_28_89,r_41_7_177,r_41_7_177,0.96,1,178,177,99
49,r_42_113_23,r_111_83_141,r_82_117_94,r_42_113_23,0.65,99,122,23,99
36,r_122_5_17,seq128,seq3,r_122_5_17,0.99,0,17,17,99
6,r_26_8_128,seq27,r_23_10_166,r_26_8_128,0.23,0,128,128,99
21,r_129_107_31,r_103_36_180,r_130_106_48,r_129_107_31,0.85,72,103,31,99
37,r_118_0_142,r_81_1_67,r_66_19_135,r_81_1_67,0.41,102,169,67,99
53,seq6,r_44_30_135,r_122_5_17,r_122_5_17,0.46,65,82,17,99
25,r_45_91_29,r_41_7_177,r_90_4_139,r_45_91_29,0.98,0,29,29,99
35,r_130_106_48,seq125,r_129_107_31,r_130_106_48,0.64,0,48,48,99
37,r_118_0_142,r_108_119_61,r_81_1_67,r_118_0_142,0.94,-2,140,142,99
26,r_108_119_61,r_136_14_194,seq141,r_108_119_61,0.5,116,177,61,99
47,r_21_37_79,seq22,seq38,r_21_37_79,0.88,0,79,79,99
74,seq51,r_52_15_182,r_126_57_49,r_126_57_49,0.92,131,180,49,99
24,r_50_101_177,r_52_15_182,seq100,r_52_15_182,0.58,-5,177,182,99
33,r_134_88_178,r_136_14_194,r_77_87_12,r_134_88_178,0.19,1,179,178,99
64,seq149,r_148_74_172,r_102_146_8,r_148_74_172,0.62,3,175,172,99
42,r_99_144_167,r_68_98_80,seq145,r_99_144_167,0.93,0,167,167,99
32,r_23_10_166,seq27,r_26_8_128,r_26_8_128,0.3,38,166,128,99
34,r_65_89_104,r_66_19_135,r_45_91_29,r_65_89_104,0.99,1,105,104,99
49,r_42_113_23,r_39_73_67,r_111_83_141,r_42_113_23,0.49,0,23,23,99
81,seq64,r_66_19_135,r_105_76_64,r_66_19_135,0.88,-1,134,135,99
17,r_131_55_4,r_56_67_111,r_126_57_49,r_131_55_4,0.77,107,111,4,99
25,r_45_91_29,r_90_4_139,r_65_89_104,r_90_4_139,1,-18,121,139,99
9,r_82_117_94,r_75_70_84,r_42_113_23,r_82_117_94,0.7,8,102,94,99
26,r_108_119_61,r_118_0_142,r_136_14_194,r_118_0_142,0.97,-6,136,142,99
45,r_93_96_52,seq92,r_133_95_37,r_133_95_37,1,5,42,37,99
40,r_114_94_152,r_111_83_141,r_42_113_23,r_42_113_23,0.9,28,51,23,99
23,r_41_7_177,r_43_46_27,seq6,r_41_7_177,0.51,0,177,177,99
4,r_133_95_37,r_136_14_194,r_93_96_52,r_133_95_37,0.98,0,37,37,99