30,r_59_48_67,r_60_39_67,r_140_47_43,r_59_48_67,0.83,0,67,67,0
18,r_148_66_59,seq149,seq65,r_148_66_59,1.0,0,59,59,0
14,r_6_36_178,seq5,r_131_34_112,r_131_34_112,0.79,66,178,112,0
29,r_35_3_171,r_131_34_112,seq1,r_35_3_171,0.62,0,171,171,0
53,seq135,seq123,r_12_139_50,r_12_139_50,0.92,74,124,50,0
71,seq61,r_60_39_67,r_117_58_4,r_60_39_67,1.0,0,67,67,0
39,r_22_78_85,seq21,seq82,r_22_78_85,0.98,1,86,85,0
5,r_14_80_92,r_17_113_143,seq82,r_14_80_92,0.99,0,92,92,0
45,r_2_103_148,seq1,seq100,r_2_103_148,0.8,0,148,148,0
66,seq46,seq45,r_60_39_67,r_60_39_67,0.99,60,127,67,0
43,r_114_106_132,seq112,r_38_115_28,r_38_115_28,1.0,15,43,28,0
54,seq10,r_8_29_98,r_85_11_14,r_85_11_14,1.0,1,15,14,0
8,r_140_47_43,r_51_73_114,r_59_48_67,r_59_48_67,0.51,3,70,67,0
31,r_79_97_103,r_77_64_123,seq96,r_77_64_123,0.98,-20,103,123,0
41,r_142_13_111,seq143,r_27_9_80,r_142_13_111,0.55,0,111,111,0
12,r_31_70_183,seq21,r_148_66_59,r_31_70_183,0.46,1,184,183,0
4,r_27_9_80,seq25,r_85_11_14,r_85_11_14,1.0,66,80,14,0
0,r_8_29_98,seq10,r_16_30_10,r_16_30_10,0.49,88,98,10,0
63,seq133,r_134_121_51,r_93_132_50,r_93_132_50,1.0,18,68,50,0
7,r_77_64_123,r_22_78_85,r_148_66_59,r_77_64_123,0.91,0,123,123,0
15,r_71_26_164,seq72,seq25,r_71_26_164,0.62,0,164,164,0
48,r_134_121_51,seq133,r_50_122_13,r_134_121_51,0.62,17,68,51,0
17,r_129_7_33,r_130_109_57,r_85_11_14,r_129_7_33,0.99,0,33,33,0
12,r_31_70_183,r_37_118_113,seq21,r_37_118_113,0.99,-7,106,113,0
6,r_4_74_82,seq5,seq75,r_4_74_82,1.0,0,82,82,0
12,r_31_70_183,r_24_68_32,r_37_118_113,r_24_68_32,0.96,-6,26,32,0
8,r_140_47_43,r_138_49_195,r_51_73_114,r_140_47_43,0.63,1,44,43,0
28,r_28_40_13,r_8_29_98,seq44,r_28_40_13,0.93,0,13,13,0
27,r_51_73_114,seq55,r_4_74_82,r_51_73_114,1.0,0,114,114,0
36,r_12_139_50,r_14_80_92,r_137_136_174,r_12_139_50,0.99,1,51,50,0
22,r_24_68_32,seq25,seq67,r_24_68_32,0.99,1,33,32,0
2,r_95_94_157,seq96,r_2_103_148,r_2_103_148,0.99,9,157,148,0
3,r_93_132_50,seq92,seq133,r_93_132_50,1.0,3,53,50,0
29,r_35_3_171,r_37_118_113,r_131_34_112,r_37_118_113,0.69,1,114,113,0
46,r_127_23_19,r_130_109_57,seq20,r_127_23_19,0.89,0,19,19,0
24,r_144_62_83,r_142_13_111,seq61,r_144_62_83,0.98,0,83,83,0
25,r_53_41_168,seq55,r_32_43_138,r_53_41_168,0.5,0,168,168,0
43,r_114_106_132,r_38_115_28,r_107_81_177,r_114_106_132,0.69,0,132,132,0
33,r_99_63_97,seq100,r_144_62_83,r_99_63_97,1.0,0,97,97,0
64,seq44,r_42_98_65,r_28_40_13,r_42_98_65,0.99,0,65,65,0
19,r_85_11_14,seq87,seq10,r_85_11_14,0.96,0,14,14,0
34,r_38_115_28,r_42_98_65,seq112,r_38_115_28,1.0,0,28,28,0
37,r_16_30_10,seq25,r_8_29_98,r_8_29_98,0.64,-55,43,98,0
21,r_33_54_24,r_32_43_138,seq55,r_33_54_24,1.0,0,24,24,0
32,r_32_43_138,r_35_3_171,r_60_39_67,r_32_43_138,0.93,0,138,138,0
38,r_131_34_112,seq133,r_35_3_171,r_131_34_112,0.5,0,112,112,0
77,seq82,r_83_86_151,r_14_80_92,r_14_80_92,1.0,38,130,92,0
9,r_37_118_113,r_35_3_171,r_19_120_26,r_35_3_171,0.96,-58,113,171,0
91,seq110,seq102,r_130_109_57,r_130_109_57,1.0,40,97,57,0
42,r_69_84_23,r_71_26_164,seq82,r_69_84_23,0.95,-2,21,23,0
13,r_130_109_57,r_134_121_51,seq110,r_130_109_57,1.0,0,57,57,0
68,seq55,r_53_41_168,r_33_54_24,r_33_54_24,1.0,5,29,24,0
7,r_77_64_123,r_79_97_103,r_22_78_85,r_22_78_85,0.8,18,103,85,0
44,r_42_98_65,seq44,seq100,r_42_98_65,1.0,0,65,65,0
10,r_19_120_26,r_22_78_85,seq119,r_19_120_26,0.99,1,27,26,0
35,r_60_39_67,seq61,seq44,r_60_39_67,1.0,0,67,67,0
94,seq119,seq124,r_19_120_26,r_19_120_26,1.0,4,30,26,0
92,seq96,r_110_128_156,seq83,r_110_128_156,0.74,-144,12,156,1
36,r_122_125_63,seq120,seq127,r_122_125_63,1.0,0,63,63,1
9,r_45_28_192,seq49,r_40_36_116,r_45_28_192,0.64,0,192,192,1
23,r_9_98_28,seq4,r_149_99_2,r_9_98_28,0.98,0,28,28,1
50,seq3,r_0_61_22,seq8,r_0_61_22,1.0,0,22,22,1
76,seq63,r_109_130_77,r_80_81_32,r_109_130_77,0.63,-48,29,77,1
71,seq49,r_48_72_170,r_134_52_111,r_134_52_111,0.87,62,173,111,1
16,r_92_116_159,seq93,r_54_118_108,r_92_116_159,0.73,0,159,159,1
1,r_95_2_184,r_79_94_43,r_108_1_82,r_95_2_184,0.85,0,184,184,1
1,r_95_2_184,seq83,r_79_94_43,r_79_94_43,0.56,35,78,43,1
97,seq114,r_115_30_141,seq111,r_115_30_141,1.0,0,141,141,1
46,r_142_103_119,r_135_124_172,r_149_99_2,r_142_103_119,0.99,0,119,119,1
45,r_115_30_141,seq114,r_40_36_116,r_115_30_141,0.98,0,141,141,1
9,r_45_28_192,r_47_58_64,seq49,r_47_58_64,0.84,-16,48,64,1
19,r_135_124_172,r_141_133_196,r_84_123_22,r_84_123_22,0.8,150,172,22,1
13,r_13_41_23,r_17_137_87,r_40_36_116,r_17_137_87,0.9,-65,22,87,1
31,r_79_94_43,r_80_81_32,r_95_2_184,r_79_94_43,0.62,25,68,43,1
41,r_66_71_162,seq67,seq73,r_66_71_162,0.34,0,162,162,1
3,r_40_36_116,r_39_75_70,r_82_38_12,r_39_75_70,1.0,-1,69,70,1
10,r_18_147_83,seq20,seq146,r_18_147_83,0.99,0,83,83,1
26,r_22_117_89,seq20,seq120,r_22_117_89,0.78,0,89,89,1
72,seq51,r_54_118_108,r_48_72_170,r_54_118_108,1.0,0,108,108,1
14,r_62_7_164,r_0_61_22,r_29_6_151,r_62_7_164,0.65,0,164,164,1
4,r_50_23_72,r_48_72_170,seq20,r_50_23_72,1.0,0,72,72,1
0,r_110_128_156,seq111,r_109_130_77,r_109_130_77,1.0,79,156,77,1
20,r_90_57_179,seq89,r_0_61_22,r_90_57_179,0.52,1,180,179,1
37,r_84_123_22,seq83,seq131,r_84_123_22,1.0,0,22,22,1
8,r_88_136_34,r_90_57_179,r_141_133_196,r_88_136_34,0.98,0,34,34,1
15,r_138_12_81,r_135_124_172,seq16,r_138_12_81,1.0,0,81,81,1
48,r_27_65_62,seq20,seq67,r_27_65_62,1.0,0,62,62,1
12,r_0_61_22,r_62_7_164,r_47_58_64,r_62_7_164,0.63,0,164,164,1
6,r_109_130_77,r_108_1_82,seq131,r_109_130_77,0.96,0,77,77,1
99,seq127,r_129_19_195,r_122_125_63,r_122_125_63,1.0,11,74,63,1
49,r_82_38_12,r_80_81_32,r_40_36_116,r_82_38_12,1.0,0,12,12,1
27,r_148_53_178,seq146,r_134_52_111,r_134_52_111,1.0,67,178,111,1
5,r_140_35_53,r_138_12_81,r_40_36_116,r_40_36_116,0.94,-65,51,116,1
30,r_74_106_58,seq114,r_37_107_131,r_37_107_131,1.0,31,162,131,1
30,r_74_106_58,seq78,seq114,r_74_106_58,0.95,0,58,58,1
26,r_22_117_89,seq120,r_54_118_108,r_54_118_108,0.89,2,110,108,1
12,r_0_61_22,r_22_117_89,r_62_7_164,r_0_61_22,1.0,0,22,22,1
39,r_59_105_56,r_62_7_164,r_149_99_2,r_59_105_56,0.99,0,56,56,1
2,r_39_75_70,r_40_36_116,r_76_33_118,r_39_75_70,0.99,0,70,70,1
40,r_17_137_87,seq15,r_88_136_34,r_17_137_87,1.0,0,87,87,1
28,r_76_33_118,r_39_75_70,r_140_35_53,r_76_33_118,1.0,0,118,118,1
14,r_62_7_164,seq60,r_0_61_22,r_0_61_22,0.99,25,47,22,1
18,r_87_100_82,seq86,r_149_99_2,r_87_100_82,0.97,1,83,82,1
29,r_29_6_151,r_31_119_153,seq4,r_31_119_153,0.62,-2,151,153,1
2,r_39_75_70,r_76_33_118,seq78,r_76_33_118,1.0,0,118,118,1
24,r_129_19_195,seq131,r_40_36_116,r_129_19_195,0.15,0,195,195,1
25,r_144_34_158,seq146,r_140_35_53,r_140_35_53,0.55,105,158,53,1
33,r_37_107_131,r_40_36_116,r_74_106_58,r_37_107_131,0.99,0,131,131,1
76,seq63,r_80_81_32,r_95_2_184,r_80_81_32,0.49,19,51,32,1
88,seq86,r_87_100_82,r_121_85_40,r_121_85_40,0.47,43,83,40,1
32,r_47_58_64,r_45_28_192,r_0_61_22,r_0_61_22,0.55,46,68,22,1
38,r_48_72_170,seq49,seq73,r_48_72_170,0.78,0,170,170,1
34,r_31_119_153,r_29_6_151,r_54_118_108,r_31_119_153,0.88,0,153,153,1
60,seq146,seq145,r_18_147_83,r_18_147_83,1.0,24,107,83,1
17,r_54_118_108,seq51,r_22_117_89,r_54_118_108,1.0,0,108,108,1
50,seq3,seq8,r_108_1_82,r_108_1_82,1.0,15,97,82,1
31,r_79_94_43,r_95_2_184,seq89,r_95_2_184,0.98,-2,182,184,1
37,r_84_123_22,seq131,r_135_124_172,r_135_124_172,0.5,1,173,172,1
28,r_76_33_118,seq77,r_39_75_70,r_39_75_70,1.0,0,70,70,1
91,seq93,r_92_116_159,seq91,r_92_116_159,1.0,0,159,159,1
44,r_101_126_140,r_149_99_2,r_122_125_63,r_101_126_140,0.53,0,140,140,1
72,seq51,r_48_72_170,r_134_52_111,r_48_72_170,0.94,-25,145,170,1
35,r_134_52_111,seq143,seq51,r_134_52_111,1.0,0,111,111,1
11,r_80_81_32,r_79_94_43,seq96,r_80_81_32,0.5,10,42,32,1
7,r_121_85_40,r_122_125_63,seq86,r_121_85_40,1.0,0,40,40,1
84,seq77,r_76_33_118,seq78,r_76_33_118,1.0,-3,115,118,1
97,seq124,r_125_100_135,r_147_43_103,r_125_100_135,0.6,-77,58,135,2
40,r_4_23_145,r_113_3_8,r_67_26_26,r_67_26_26,0.66,131,157,26,2
33,r_133_93_45,r_135_136_174,seq90,r_133_93_45,1.0,0,45,45,2
30,r_33_138_70,r_36_1_142,seq139,r_33_138_70,0.99,3,73,70,2
44,r_121_19_156,r_5_120_14,seq18,r_5_120_14,0.69,142,156,14,2
36,r_125_100_135,seq146,seq126,r_125_100_135,0.38,-77,58,135,2
14,r_149_110_60,seq148,seq112,r_149_110_60,1.0,1,61,60,2
28,r_54_77_32,seq55,r_79_114_162,r_54_77_32,1.0,0,32,32,2
83,seq80,r_89_96_126,r_13_82_101,r_13_82_101,0.75,7,108,101,2
37,r_144_118_91,seq132,r_87_119_79,r_144_118_91,1.0,0,91,91,2
59,seq18,seq21,r_130_14_12,r_130_14_12,0.63,126,138,12,2
21,r_16_103_132,seq17,r_122_108_87,r_16_103_132,0.89,0,132,132,2
39,r_66_128_163,seq68,seq127,r_66_128_163,0.68,0,163,163,2
80,seq72,r_69_39_193,r_47_71_140,r_47_71_140,0.98,5,145,140,2
5,r_9_7_166,seq11,r_25_8_53,r_25_8_53,0.45,113,166,53,2
46,r_47_71_140,r_46_98_180,seq72,r_47_71_140,0.79,0,140,140,2
13,r_2_99_114,r_149_110_60,r_125_100_135,r_125_100_135,0.87,9,144,135,2
31,r_113_3_8,r_4_23_145,r_36_1_142,r_113_3_8,0.76,138,146,8,2
93,seq115,r_121_19_156,r_143_116_25,r_143_116_25,0.62,1,26,25,2
44,r_121_19_156,r_122_108_87,r_5_120_14,r_5_120_14,0.74,1,15,14,2
19,r_89_96_126,seq83,r_24_91_69,r_24_91_69,1.0,14,83,69,2
1,r_73_49_34,r_88_32_48,r_51_50_114,r_73_49_34,0.99,0,34,34,2
27,r_92_60_34,r_45_84_93,r_129_61_99,r_92_60_34,0.89,63,97,34,2
3,r_25_8_53,r_27_107_196,seq6,r_25_8_53,0.87,2,55,53,2
17,r_46_98_180,r_73_49_34,r_122_108_87,r_46_98_180,0.98,0,180,180,2
41,r_87_119_79,seq83,r_143_116_25,r_87_119_79,1.0,0,79,79,2
23,r_67_26_26,r_66_128_163,r_27_107_196,r_67_26_26,1.0,0,26,26,2
13,r_2_99_114,r_5_120_14,r_113_3_8,r_2_99_114,0.77,-103,11,114,2
10,r_10_78_60,r_9_7_166,r_54_77_32,r_10_78_60,0.99,1,61,60,2
35,r_27_107_196,r_25_8_53,r_67_26_26,r_27_107_196,0.98,-141,55,196,2
49,r_45_84_93,r_92_60_34,r_76_85_44,r_45_84_93,0.96,1,94,93,2
72,seq55,seq53,r_102_57_44,r_102_57_44,1.0,41,85,44,2
4,r_97_22_135,seq112,r_130_14_12,r_97_22_135,0.81,0,135,135,2
87,seq101,r_102_57_44,seq112,r_102_57_44,1.0,-11,33,44,2
73,seq59,seq55,r_64_58_169,r_64_58_169,0.86,14,183,169,2
15,r_129_61_99,seq127,r_92_60_34,r_129_61_99,0.99,0,99,99,2
48,r_122_108_87,seq123,seq109,r_122_108_87,1.0,0,87,87,2
13,r_2_99_114,r_113_3_8,r_149_110_60,r_2_99_114,0.98,0,114,114,2
62,seq29,r_36_1_142,r_86_28_134,r_86_28_134,1.0,0,134,134,2
19,r_89_96_126,r_24_91_69,r_35_95_15,r_89_96_126,0.97,0,126,126,2
8,r_102_57_44,seq104,seq55,r_102_57_44,1.0,0,44,44,2
0,r_35_95_15,seq112,r_89_96_126,r_89_96_126,0.75,6,132,126,2
49,r_45_84_93,r_46_98_180,r_92_60_34,r_92_60_34,0.94,22,56,34,2
36,r_125_100_135,seq126,r_2_99_114,r_125_100_135,0.93,0,135,135,2
94,seq148,r_147_43_103,seq146,r_147_43_103,1.0,1,104,103,2
16,r_70_42_28,seq72,seq44,r_70_42_28,0.99,0,28,28,2
40,r_4_23_145,r_5_120_14,r_113_3_8,r_4_23_145,0.81,-132,13,145,2
24,r_111_74_130,seq112,r_10_78_60,r_10_78_60,0.63,70,130,60,2
47,r_5_120_14,r_121_19_156,seq123,r_121_19_156,0.89,0,156,156,2
18,r_0_117_44,r_2_99_114,r_143_116_25,r_0_117_44,1.0,0,44,44,2
58,seq17,r_13_82_101,r_130_14_12,r_13_82_101,0.98,0,101,101,2
2,r_88_32_48,r_87_119_79,seq31,r_88_32_48,1.0,0,48,48,2
27,r_92_60_34,seq90,r_45_84_93,r_92_60_34,0.95,0,34,34,2
0,r_35_95_15,seq29,seq112,r_35_95_15,0.86,4,19,15,2
47,r_5_120_14,r_2_99_114,r_121_19_156,r_5_120_14,0.7,0,14,14,2
38,r_86_28_134,seq83,seq29,r_86_28_134,0.91,0,134,134,2
34,r_13_82_101,seq17,seq81,r_13_82_101,1.0,0,101,101,2
69,seq44,seq41,r_70_42_28,r_70_42_28,1.0,1,29,28,2
80,seq72,r_70_42_28,r_69_39_193,r_70_42_28,0.98,0,28,28,2
45,r_79_114_162,r_54_77_32,r_143_116_25,r_79_114_162,0.84,0,162,162,2
17,r_46_98_180,r_47_71_140,r_73_49_34,r_73_49_34,0.9,105,139,34,2
94,seq148,r_149_110_60,r_147_43_103,r_149_110_60,1.0,1,61,60,2
9,r_147_43_103,seq148,seq44,r_147_43_103,0.99,1,104,103,2
96,seq123,r_122_108_87,r_5_120_14,r_122_108_87,0.95,-1,86,87,2
31,r_113_3_8,r_2_99_114,r_4_23_145,r_2_99_114,1.0,0,114,114,2
28,r_54_77_32,r_79_114_162,r_10_78_60,r_54_77_32,0.93,75,107,32,2
45,r_79_114_162,r_76_85_44,r_54_77_32,r_54_77_32,0.99,21,53,32,2
7,r_24_91_69,r_27_107_196,seq90,r_24_91_69,1.0,0,69,69,2
82,seq75,r_79_114_162,r_10_78_60,r_10_78_60,1.0,42,102,60,2
6,r_130_14_12,r_143_116_25,seq15,r_130_14_12,0.96,0,12,12,2
12,r_36_1_142,seq34,r_113_3_8,r_36_1_142,0.76,0,142,142,2
84,seq81,r_89_96_126,r_13_82_101,r_13_82_101,0.71,18,119,101,2
93,seq101,r_107_57_101,r_14_121_7,r_14_121_7,0.52,55,62,7,3
30,r_144_139_156,r_146_40_160,r_77_126_84,r_144_139_156,0.71,0,156,156,3
36,r_117_130_100,seq116,r_77_126_84,r_117_130_100,0.52,0,100,100,3
9,r_119_91_54,r_92_131_178,r_128_90_138,r_128_90_138,0.62,49,187,138,3
14,r_127_59_190,seq125,r_99_60_57,r_99_60_57,0.94,133,190,57,3
8,r_47_13_117,seq48,seq15,r_47_13_117,0.99,1,118,117,3
37,r_51_53_152,seq49,r_20_54_68,r_20_54_68,1.0,84,152,68,3
44,r_64_70_122,r_58_7_147,r_5_52_1,r_64_70_122,0.37,-108,14,122,3
71,seq38,r_36_106_186,r_146_40_160,r_146_40_160,0.6,27,187,160,3
86,seq84,r_83_22_121,seq81,r_83_22_121,1.0,0,121,121,3
21,r_114_89_68,r_117_130_100,seq93,r_117_130_100,0.84,-32,68,100,3
20,r_123_55_14,r_58_7_147,r_64_70_122,r_123_55_14,0.56,41,55,14,3
28,r_35_61_191,seq33,r_82_34_41,r_82_34_41,1.0,10,51,41,3
5,r_120_94_147,seq118,r_128_90_138,r_120_94_147,0.52,0,147,147,3
46,r_88_18_147,seq87,seq19,r_88_18_147,0.95,1,148,147,3
69,seq32,seq33,r_82_34_41,r_82_34_41,0.99,28,69,41,3
24,r_92_131_178,r_119_91_54,r_77_126_84,r_77_126_84,0.57,95,179,84,3
19,r_9_71_98,seq11,r_76_69_1,r_9_71_98,0.95,0,98,98,3
43,r_16_135_52,r_17_44_78,r_132_108_207,r_16_135_52,0.78,0,52,52,3
95,seq113,r_107_57_101,r_96_112_49,r_107_57_101,1.0,-23,78,101,3
76,seq49,r_51_53_152,r_21_50_40,r_21_50_40,1.0,76,116,40,3
20,r_123_55_14,r_64_70_122,r_143_56_81,r_123_55_14,0.94,67,81,14,3
31,r_23_86_147,seq19,seq85,r_23_86_147,0.77,1,148,147,3
3,r_76_69_1,seq74,r_9_71_98,r_9_71_98,1.0,20,118,98,3
18,r_99_60_57,seq98,r_123_55_14,r_99_60_57,0.94,0,57,57,3
45,r_5_52_1,seq42,r_64_70_122,r_64_70_122,0.36,-108,14,122,3
26,r_143_56_81,r_144_139_156,r_123_55_14,r_143_56_81,0.98,0,81,81,3
32,r_21_50_40,r_23_86_147,seq49,r_21_50_40,0.89,0,40,40,3
4,r_77_126_84,r_83_22_121,seq125,r_83_22_121,0.72,-37,84,121,3
13,r_73_142_148,seq74,r_46_141_64,r_46_141_64,0.83,84,148,64,3
15,r_134_110_99,r_132_108_207,r_72_109_49,r_134_110_99,0.77,0,99,99,3
48,r_83_22_121,seq84,seq19,r_83_22_121,0.97,0,121,121,3
9,r_119_91_54,r_120_94_147,r_92_131_178,r_119_91_54,0.88,1,55,54,3
6,r_146_40_160,seq140,r_3_37_37,r_146_40_160,0.83,3,163,160,3
93,seq101,r_14_121_7,r_0_104_95,r_0_104_95,0.99,11,106,95,3
44,r_64_70_122,r_5_52_1,r_123_55_14,r_123_55_14,0.83,39,53,14,3
49,r_3_37_37,seq2,seq38,r_3_37_37,0.99,0,37,37,3
20,r_123_55_14,r_107_57_101,r_58_7_147,r_123_55_14,0.78,-1,13,14,3
2,r_128_90_138,r_127_59_190,seq93,r_127_59_190,0.67,-52,138,190,3
47,r_78_111_80,seq80,r_96_112_49,r_78_111_80,0.58,3,83,80,3
40,r_58_7_147,r_123_55_14,r_147_10_65,r_147_10_65,0.58,82,147,65,3
29,r_36_106_186,seq38,seq80,r_36_106_186,0.33,0,186,186,3
24,r_92_131_178,seq95,r_119_91_54,r_119_91_54,0.72,61,115,54,3
10,r_96_112_49,r_97_62_110,seq113,r_97_62_110,0.78,-61,49,110,3
25,r_1_148_118,r_0_104_95,seq32,r_1_148_118,0.57,-23,95,118,3
33,r_17_44_78,r_23_86_147,r_45_43_26,r_17_44_78,1.0,0,78,78,3
70,seq33,r_35_61_191,r_82_34_41,r_82_34_41,0.98,78,119,41,3
68,seq31,seq29,r_124_30_58,r_124_30_58,1.0,1,59,58,3
61,seq149,r_144_139_156,r_1_148_118,r_1_148_118,1.0,1,119,118,3
34,r_147_10_65,seq149,seq11,r_147_10_65,1.0,-1,64,65,3
75,seq48,r_47_13_117,seq49,r_47_13_117,1.0,1,118,117,3
45,r_5_52_1,r_64_70_122,r_20_54_68,r_20_54_68,0.71,13,81,68,3
25,r_1_148_118,seq32,seq149,r_1_148_118,0.99,0,118,118,3
94,seq102,r_105_145_186,r_8_103_28,r_8_103_28,1.0,115,143,28,3
96,seq116,r_117_130_100,r_0_104_95,r_0_104_95,1.0,5,100,95,3
38,r_72_109_49,r_73_142_148,r_96_112_49,r_72_109_49,1.0,0,49,49,3
98,seq122,r_14_121_7,r_8_103_28,r_8_103_28,0.5,105,133,28,3
1,r_82_34_41,r_83_22_121,r_35_61_191,r_82_34_41,0.99,0,41,41,3
28,r_35_61_191,r_82_34_41,r_127_59_190,r_35_61_191,0.4,0,191,191,3
84,seq80,seq84,r_115_79_133,r_115_79_133,0.46,-4,129,133,3
41,r_124_30_58,r_107_57_101,seq31,r_124_30_58,1.0,0,58,58,3
7,r_107_57_101,seq113,r_123_55_14,r_107_57_101,0.63,2,103,101,3
18,r_99_60_57,r_123_55_14,r_97_62_110,r_97_62_110,1.0,44,154,110,3
23,r_45_43_26,seq42,r_17_44_78,r_17_44_78,1.0,2,80,78,3
17,r_14_121_7,seq122,r_8_103_28,r_8_103_28,0.92,62,90,28,3
44,r_64_70_122,r_123_55_14,r_76_69_1,r_64_70_122,0.97,0,122,122,3
35,r_20_54_68,seq19,r_5_52_1,r_20_54_68,1.0,0,68,68,3
50,seq2,r_3_37_37,seq4,r_3_37_37,0.65,0,37,37,3
12,r_46_141_64,r_47_13_117,seq140,r_46_141_64,0.98,0,64,64,3
84,seq80,r_78_111_80,seq84,r_78_111_80,0.42,3,83,80,3
30,r_67_56_111,r_65_118_155,r_52_138_189,r_67_56_111,1.0,0,111,111,4
36,r_109_54_93,r_110_134_193,r_52_138_189,r_109_54_93,1.0,0,93,93,4
25,r_72_88_28,r_68_5_61,r_89_133_103,r_72_88_28,1.0,0,28,28,4
53,seq141,seq148,r_25_140_159,r_25_140_159,0.91,22,181,159,4
43,r_98_116_115,r_100_53_135,seq119,r_98_116_115,0.67,0,115,115,4
45,r_10_8_177,r_13_99_185,r_39_9_40,r_39_9_40,0.98,9,49,40,4
59,seq20,r_13_99_185,r_22_27_125,r_22_27_125,0.57,-29,96,125,4
19,r_125_21_152,r_57_124_75,seq24,r_125_21_152,0.99,0,152,152,4
55,seq15,r_13_99_185,r_147_16_91,r_147_16_91,1.0,6,97,91,4
87,seq94,r_92_6_99,seq91,r_92_6_99,1.0,-47,52,99,4
16,r_73_40_110,seq74,seq37,r_73_40_110,0.97,0,110,110,4
21,r_81_83_151,r_80_82_138,seq84,r_80_82_138,0.65,18,156,138,4
1,r_25_140_159,r_23_71_180,seq141,r_23_71_180,0.5,-21,159,180,4
5,r_120_36_111,seq123,r_73_40_110,r_120_36_111,1.0,0,111,111,4
46,r_1_144_171,r_0_85_113,r_33_3_88,r_1_144_171,0.93,-58,113,171,4
42,r_29_104_65,seq28,r_96_42_130,r_29_104_65,0.97,0,65,65,4
47,r_97_149_178,seq103,r_25_140_159,r_97_149_178,0.73,0,178,178,4
46,r_1_144_171,r_33_3_88,seq142,r_1_144_171,1.0,0,171,171,4
19,r_125_21_152,r_126_115_136,r_57_124_75,r_57_124_75,1.0,0,75,75,4
11,r_33_3_88,r_1_144_171,r_78_4_160,r_33_3_88,0.96,72,160,88,4
39,r_89_133_103,r_92_6_99,r_72_88_28,r_72_88_28,1.0,1,29,28,4
39,r_89_133_103,r_72_88_28,r_131_135_99,r_89_133_103,0.99,0,103,103,4
31,r_111_14_77,seq112,seq15,r_111_14_77,1.0,0,77,77,4
41,r_92_6_99,seq94,r_68_5_61,r_92_6_99,1.0,0,99,99,4
42,r_29_104_65,r_96_42_130,r_72_88_28,r_96_42_130,0.83,-6,124,130,4
3,r_100_53_135,r_98_116_115,r_97_149_178,r_100_53_135,0.49,-20,115,135,4
10,r_147_16_91,seq146,seq15,r_147_16_91,1.0,0,91,91,4
33,r_26_108_13,r_34_75_47,seq119,r_26_108_13,0.89,0,13,13,4
26,r_0_85_113,r_1_144_171,seq86,r_0_85_113,0.99,0,113,113,4
14,r_17_137_9,r_136_102_136,seq141,r_136_102_136,0.69,-31,105,136,4
4,r_51_93_133,r_52_138_189,seq94,r_51_93_133,1.0,0,133,133,4
0,r_126_115_136,r_125_21_152,r_98_116_115,r_126_115_136,0.88,0,136,136,4
11,r_33_3_88,seq31,r_1_144_171,r_33_3_88,1.0,0,88,88,4
20,r_101_35_123,seq103,r_120_36_111,r_120_36_111,0.42,12,123,111,4
15,r_95_105_73,r_97_149_178,seq106,r_95_105_73,0.9,0,73,73,4
48,r_127_12_153,seq128,r_69_11_72,r_127_12_153,0.68,0,153,153,4
13,r_136_102_136,r_17_137_9,seq103,r_136_102_136,0.8,0,136,136,4
37,r_39_9_40,seq37,r_10_8_177,r_39_9_40,0.99,0,40,40,4
49,r_2_46_57,r_0_85_113,seq48,r_2_46_57,1.0,0,57,57,4
3,r_100_53_135,r_97_149_178,r_109_54_93,r_100_53_135,0.89,0,135,135,4
32,r_52_138_189,r_67_56_111,r_25_140_159,r_25_140_159,0.6,28,187,159,4
2,r_139_58_144,seq148,r_67_56_111,r_139_58_144,0.56,0,144,144,4
47,r_97_149_178,r_96_42_130,seq103,r_96_42_130,1.0,0,130,130,4
6,r_34_75_47,seq47,seq74,r_34_75_47,1.0,0,47,47,4
40,r_78_4_160,seq79,r_33_3_88,r_78_4_160,0.78,0,160,160,4
18,r_22_27_125,r_25_140_159,r_120_36_111,r_22_27_125,0.75,0,125,125,4
24,r_45_130_118,seq47,seq129,r_45_130_118,0.99,0,118,118,4
89,seq103,r_101_35_123,r_97_149_178,r_101_35_123,0.73,-29,94,123,4
50,seq128,r_127_12_153,r_131_135_99,r_127_12_153,0.99,0,153,153,4
58,seq19,r_18_113_176,r_111_14_77,r_111_14_77,0.99,5,82,77,4
59,seq20,r_22_27_125,r_23_71_180,r_22_27_125,0.94,-4,121,125,4
32,r_52_138_189,r_51_93_133,r_67_56_111,r_52_138_189,0.96,-56,133,189,4
38,r_110_134_193,r_109_54_93,seq112,r_109_54_93,1.0,-16,77,93,4
52,seq7,seq15,r_68_5_61,r_68_5_61,1.0,6,67,61,4
77,seq66,r_65_118_155,seq63,r_65_118_155,1.0,1,156,155,4
34,r_96_42_130,r_97_149_178,seq48,r_96_42_130,0.75,0,130,130,4
45,r_10_8_177,r_39_9_40,r_68_5_61,r_68_5_61,0.87,114,175,61,4
17,r_132_44_136,r_131_135_99,r_2_46_57,r_132_44_136,0.64,0,136,136,4
25,r_72_88_28,r_89_133_103,seq91,r_89_133_103,0.99,0,103,103,4
9,r_65_118_155,seq66,seq119,r_65_118_155,0.62,1,156,155,4
37,r_39_9_40,r_10_8_177,r_111_14_77,r_111_14_77,1.0,100,177,77,4
22,r_69_11_72,seq70,seq15,r_69_11_72,1.0,0,72,72,4
28,r_131_135_99,r_132_44_136,seq128,r_132_44_136,1.0,0,136,136,4
7,r_68_5_61,r_65_118_155,seq7,r_68_5_61,1.0,0,61,61,4
44,r_18_113_176,seq19,seq112,r_18_113_176,0.48,0,176,176,4
42,r_29_104_65,r_72_88_28,r_45_130_118,r_29_104_65,0.5,99,164,65,4
35,r_57_124_75,seq60,seq123,r_57_124_75,1.0,0,75,75,4
89,seq103,r_97_149_178,r_101_35_123,r_101_35_123,0.58,-70,53,123,4
93,seq100,r_101_62_144,r_18_98_89,r_18_98_89,0.74,55,144,89,5
17,r_90_94_45,r_89_68_71,seq95,r_89_68_71,0.88,-26,45,71,5
51,seq2,r_0_131_83,seq8,r_0_131_83,1.0,0,83,83,5
40,r_67_83_9,r_69_122_200,r_57_86_52,r_57_86_52,0.64,2,54,52,5
14,r_138_121_98,seq139,r_118_120_56,r_118_120_56,0.62,58,114,56,5
8,r_118_120_56,r_117_15_156,r_138_121_98,r_138_121_98,0.46,27,125,98,5
43,r_46_125_100,r_44_130_130,r_50_128_65,r_44_130_130,0.97,-30,100,130,5
81,seq147,r_93_113_36,r_64_148_102,r_64_148_102,0.41,39,141,102,5
37,r_72_32_107,r_69_122_200,r_126_34_16,r_72_32_107,0.99,0,107,107,5
71,seq45,r_44_130_130,seq49,r_44_130_130,0.99,0,130,130,5
86,seq85,r_84_109_177,r_57_86_52,r_57_86_52,1.0,123,175,52,5
24,r_126_34_16,seq149,seq31,r_126_34_16,1.0,0,16,16,5
21,r_64_148_102,seq63,seq149,r_64_148_102,1.0,0,102,102,5
39,r_107_144_77,r_106_77_135,seq142,r_106_77_135,0.59,-58,77,135,5
1,r_106_77_135,seq104,r_9_75_89,r_106_77_135,0.84,0,135,135,5
97,seq115,r_117_15_156,r_80_116_109,r_80_116_109,0.62,47,156,109,5
87,seq88,r_87_61_43,r_84_109_177,r_87_61_43,0.63,-1,42,43,5
16,r_42_146_44,r_39_70_150,seq142,r_42_146_44,1.0,0,44,44,5
5,r_143_33_94,seq142,r_126_34_16,r_143_33_94,0.91,0,94,94,5
42,r_103_27_73,r_106_77_135,seq28,r_103_27_73,1.0,0,73,73,5
45,r_135_97_146,r_17_133_8,r_18_98_89,r_135_97_146,1.0,0,146,146,5
32,r_20_78_158,seq19,r_112_82_116,r_20_78_158,0.73,0,158,158,5
45,r_135_97_146,r_134_119_142,r_17_133_8,r_135_97_146,0.31,-26,120,146,5
19,r_4_36_188,seq10,r_35_37_152,r_35_37_152,0.69,36,188,152,5
65,seq29,seq28,r_105_30_10,r_105_30_10,0.59,41,51,10,5
18,r_124_79_12,r_126_34_16,seq81,r_124_79_12,1.0,0,12,12,5
31,r_76_60_154,r_80_116_109,r_9_75_89,r_76_60_154,0.71,-50,104,154,5
35,r_57_86_52,r_55_11_151,seq88,r_57_86_52,1.0,0,52,52,5
3,r_102_74_64,r_101_62_144,seq71,r_102_74_64,0.91,0,64,64,5
26,r_53_73_98,r_54_1_170,seq71,r_53_73_98,0.99,0,98,98,5
13,r_0_131_83,r_118_120_56,r_5_132_105,r_5_132_105,0.83,8,113,105,5
4,r_89_68_71,r_90_94_45,r_69_122_200,r_89_68_71,1.0,0,71,71,5
78,seq63,r_64_148_102,seq65,r_64_148_102,0.97,0,102,102,5
0,r_80_116_109,seq81,seq115,r_80_116_109,1.0,0,109,109,5
2,r_87_61_43,seq88,seq65,r_87_61_43,0.99,0,43,43,5
36,r_93_113_36,seq91,seq114,r_93_113_36,1.0,0,36,36,5
13,r_0_131_83,seq2,r_118_120_56,r_0_131_83,0.55,0,83,83,5
98,seq123,r_134_119_142,r_25_129_30,r_25_129_30,0.99,87,117,30,5
15,r_50_128_65,seq51,seq127,r_50_128_65,1.0,0,65,65,5
48,r_9_75_89,seq10,r_76_60_154,r_9_75_89,0.97,0,89,89,5
12,r_101_62_144,seq100,r_87_61_43,r_101_62_144,0.84,0,144,144,5
6,r_117_15_156,seq115,seq13,r_117_15_156,0.75,0,156,156,5
62,seq22,r_23_47_164,seq19,r_23_47_164,0.69,0,164,164,5
85,seq81,r_80_116_109,r_124_79_12,r_80_116_109,0.91,-1,108,109,5
2,r_87_61_43,seq65,r_101_62_144,r_101_62_144,0.99,0,144,144,5
99,seq127,r_134_119_142,r_50_128_65,r_50_128_65,1.0,3,68,65,5
78,seq63,seq65,r_101_62_144,r_101_62_144,1.0,20,164,144,5
10,r_17_133_8,r_134_119_142,r_50_128_65,r_50_128_65,1.0,75,140,65,5
27,r_44_130_130,seq45,r_17_133_8,r_44_130_130,0.94,0,130,130,5
41,r_3_137_32,r_138_121_98,r_48_136_99,r_48_136_99,1.0,4,103,99,5
47,r_18_98_89,r_20_78_158,seq99,r_18_98_89,1.0,0,89,89,5
29,r_112_82_116,seq114,seq81,r_112_82_116,1.0,0,116,116,5
46,r_25_129_30,seq24,seq127,r_25_129_30,0.99,0,30,30,5
25,r_52_7_142,r_54_1_170,seq8,r_52_7_142,0.43,0,142,142,5
33,r_39_70_150,seq40,r_89_68_71,r_39_70_150,0.91,1,151,150,5
48,r_9_75_89,r_76_60_154,r_106_77_135,r_9_75_89,0.8,64,153,89,5
64,seq28,seq29,r_103_27_73,r_103_27_73,1.0,12,85,73,5
50,seq149,seq139,r_64_148_102,r_64_148_102,1.0,6,108,102,5
44,r_105_30_10,r_106_77_135,seq29,r_105_30_10,0.96,0,10,10,5
52,seq6,r_5_132_105,seq8,r_5_132_105,1.0,0,105,105,5
34,r_55_11_151,seq56,seq12,r_55_11_151,0.52,1,152,151,5
75,seq56,r_55_11_151,seq58,r_55_11_151,0.69,3,154,151,5
9,r_134_119_142,r_135_97_146,r_138_121_98,r_135_97_146,0.9,-3,143,146,5
66,seq31,seq49,r_126_34_16,r_126_34_16,0.98,3,19,16,5
22,r_48_136_99,r_44_130_130,r_3_137_32,r_48_136_99,0.96,0,99,99,5
56,seq12,seq13,r_55_11_151,r_55_11_151,0.68,32,183,151,5
7,r_111_145_163,seq114,r_42_146_44,r_42_146_44,1.0,118,162,44,5
41,r_3_137_32,r_4_36_188,r_138_121_98,r_3_137_32,1.0,-1,31,32,5
23,r_69_122_200,r_72_32_107,r_89_68_71,r_69_122_200,0.97,-128,72,200,5
82,seq71,r_69_122_200,r_102_74_64,r_102_74_64,1.0,34,98,64,5
95,seq110,r_107_144_77,r_26_108_26,r_26_108_26,0.98,3,29,26,5
12,r_101_62_144,r_102_74_64,seq100,r_102_74_64,1.0,-4,60,64,5
40,r_67_83_9,r_64_148_102,r_69_122_200,r_67_83_9,0.5,2,11,9,5
31,r_76_60_154,r_9_75_89,seq56,r_76_60_154,0.96,0,154,154,5
23,r_69_122_200,r_89_68_71,r_118_120_56,r_118_120_56,0.77,146,202,56,5
36,r_94_46_76,r_92_31_160,r_44_47_9,r_94_46_76,0.96,0,76,76,6
92,seq101,r_100_19_151,r_6_102_93,r_6_102_93,0.83,59,152,93,6
14,r_139_64_182,seq137,r_106_70_22,r_106_70_22,0.65,158,180,22,6
8,r_37_24_101,r_36_127_199,seq23,r_37_24_101,1.0,0,101,101,6
53,seq3,seq0,r_27_2_114,r_27_2_114,1.0,39,153,114,6
43,r_56_128_98,seq57,seq129,r_56_128_98,0.99,4,102,98,6
45,r_140_119_10,r_141_87_85,seq121,r_140_119_10,0.94,0,10,10,6
3,r_92_31_160,r_103_114_39,seq26,r_92_31_160,0.85,0,160,160,6
16,r_12_93_154,r_13_110_179,r_6_102_93,r_12_93_154,0.74,0,154,154,6
42,r_72_124_30,seq67,r_125_58_86,r_72_124_30,0.91,0,30,30,6
21,r_52_40_145,r_53_132_174,seq39,r_52_40_145,0.57,0,145,145,6
1,r_66_51_180,seq74,seq50,r_66_51_180,0.36,3,183,180,6
5,r_115_18_129,seq116,seq16,r_115_18_129,0.97,0,129,129,6
46,r_53_132_174,seq54,seq133,r_53_132_174,0.58,0,174,174,6
49,r_125_58_86,r_72_124_30,seq59,r_125_58_86,0.99,0,86,86,6
32,r_5_126_141,seq0,r_56_128_98,r_5_126_141,0.74,0,141,141,6
30,r_106_70_22,r_104_107_62,seq74,r_104_107_62,0.71,-40,22,62,6
19,r_99_62_135,r_100_19_151,seq61,r_100_19_151,0.61,-16,135,151,6
11,r_33_55_112,seq32,r_25_122_97,r_25_122_97,0.54,-77,20,97,6
11,r_33_55_112,r_25_122_97,r_91_34_90,r_91_34_90,0.58,1,91,90,6
76,seq61,r_60_7_188,r_99_62_135,r_99_62_135,0.71,44,179,135,6
67,seq32,r_33_55_112,r_71_29_9,r_71_29_9,1.0,13,22,9,6
31,r_27_2_114,seq26,seq0,r_27_2_114,0.98,0,114,114,6
41,r_6_102_93,seq8,seq101,r_6_102_93,1.0,0,93,93,6
93,seq105,r_104_107_62,r_103_114_39,r_103_114_39,0.89,-9,30,39,6
42,r_72_124_30,r_125_58_86,r_115_18_129,r_125_58_86,1.0,0,86,86,6
67,seq32,r_71_29_9,r_91_34_90,r_91_34_90,1.0,29,119,90,6
3,r_92_31_160,r_94_46_76,r_103_114_39,r_92_31_160,0.62,-81,79,160,6
10,r_9_1_151,r_13_110_179,seq0,r_9_1_151,0.83,0,151,151,6
4,r_25_122_97,r_27_2_114,r_140_119_10,r_25_122_97,1.0,0,97,97,6
35,r_91_34_90,r_33_55_112,seq32,r_33_55_112,0.85,0,112,112,6
0,r_13_110_179,r_12_93_154,r_14_10_147,r_12_93_154,0.9,1,155,154,6
20,r_82_98_105,seq80,r_143_97_72,r_143_97_72,0.98,33,105,72,6
13,r_112_77_110,seq113,seq78,r_112_77_110,0.81,0,110,110,6
99,seq121,r_115_18_129,r_140_119_10,r_140_119_10,0.78,0,10,10,6
49,r_125_58_86,r_115_18_129,r_72_124_30,r_72_124_30,0.98,4,34,30,6
59,seq142,r_143_97_72,seq144,r_143_97_72,0.97,-39,33,72,6
56,seq8,seq0,r_60_7_188,r_60_7_188,0.98,11,199,188,6
15,r_96_79_148,r_100_19_151,r_112_77_110,r_100_19_151,0.94,-3,148,151,6
48,r_28_41_147,seq30,seq39,r_28_41_147,0.59,0,147,147,6
6,r_38_131_72,seq39,seq133,r_38_131_72,1.0,0,72,72,6
27,r_100_19_151,seq101,seq26,r_100_19_151,0.8,1,152,151,6
11,r_33_55_112,r_91_34_90,seq57,r_33_55_112,0.95,0,112,112,6
78,seq67,seq74,r_146_68_54,r_146_68_54,1.0,0,54,54,6
2,r_104_107_62,seq105,seq111,r_104_107_62,0.78,0,62,62,6
25,r_103_114_39,r_99_62_135,seq113,r_103_114_39,0.69,-8,31,39,6
47,r_149_65_148,seq148,seq63,r_149_65_148,0.78,0,148,148,6
74,seq57,r_56_128_98,r_106_70_22,r_56_128_98,1.0,4,102,98,6
29,r_109_69_105,seq108,r_146_68_54,r_146_68_54,0.97,51,105,54,6
24,r_48_117_120,r_44_47_9,seq116,r_48_117_120,0.69,0,120,120,6
33,r_36_127_199,r_37_24_101,seq39,r_37_24_101,1.0,0,101,101,6
50,seq0,seq3,r_9_1_151,r_9_1_151,0.99,2,153,151,6
68,seq39,r_38_131_72,seq42,r_38_131_72,1.0,-7,65,72,6
38,r_134_95_171,seq133,r_6_102_93,r_134_95_171,0.5,1,172,171,6
77,seq63,seq74,r_149_65_148,r_149_65_148,1.0,11,159,148,6
34,r_11_73_81,r_13_110_179,seq74,r_11_73_81,1.0,0,81,81,6
26,r_123_21_22,r_115_18_129,r_120_22_2,r_123_21_22,0.88,0,22,22,6
0,r_13_110_179,r_14_10_147,seq108,r_13_110_179,0.97,0,179,179,6
94,seq108,r_109_69_105,seq111,r_109_69_105,1.0,0,105,105,6
9,r_141_87_85,r_149_65_148,seq84,r_141_87_85,0.76,0,85,85,6
18,r_4_45_10,r_6_102_93,r_44_47_9,r_4_45_10,0.65,0,10,10,6
28,r_143_97_72,r_145_147_128,seq101,r_143_97_72,1.0,0,72,72,6
91,seq148,r_149_65_148,seq142,r_149_65_148,0.86,0,148,148,6
56,seq8,r_6_102_93,seq0,r_6_102_93,1.0,0,93,93,6
96,seq113,r_112_77_110,r_103_114_39,r_103_114_39,0.69,-8,31,39,6
44,r_44_47_9,r_48_117_120,r_94_46_76,r_44_47_9,0.83,67,76,9,6
40,r_120_22_2,seq23,r_123_21_22,r_123_21_22,1.0,0,22,22,6
42,r_72_124_30,r_115_18_129,seq118,r_115_18_129,1.0,0,129,129,6
79,seq74,seq67,r_11_73_81,r_11_73_81,1.0,1,82,81,6
35,r_91_34_90,seq89,r_33_55_112,r_91_34_90,0.96,0,90,90,6
14,r_95_87_63,seq96,r_62_78_24,r_95_87_63,0.99,1,64,63,7
43,r_113_48_66,r_119_0_178,seq52,r_113_48_66,1.0,0,66,66,7
37,r_109_136_139,seq106,r_34_134_110,r_34_134_110,1.0,29,139,110,7
36,r_114_98_11,r_128_25_103,seq97,r_128_25_103,0.73,-92,11,103,7
16,r_6_71_112,seq9,seq69,r_6_71_112,0.99,0,112,112,7
39,r_140_92_128,seq139,r_47_91_10,r_47_91_10,0.89,119,129,10,7
1,r_116_105_161,seq115,r_55_103_141,r_55_103_141,0.79,22,163,141,7
97,seq112,r_121_41_121,r_5_123_76,r_5_123_76,0.6,45,121,76,7
46,r_104_10_158,seq99,seq11,r_104_10_158,0.6,0,158,158,7
42,r_5_123_76,seq11,r_119_0_178,r_5_123_76,0.96,-4,72,76,7
69,seq135,seq138,r_34_134_110,r_34_134_110,1.0,3,113,110,7
15,r_47_91_10,r_49_70_136,seq90,r_47_91_10,0.91,0,10,10,7
19,r_34_134_110,seq35,seq135,r_34_134_110,0.99,0,110,110,7
5,r_43_86_10,r_85_126_93,r_62_78_24,r_43_86_10,0.88,43,53,10,7
95,seq99,r_109_136_139,r_55_103_141,r_55_103_141,0.58,0,141,141,7
31,r_65_7_82,seq68,seq9,r_65_7_82,1.0,0,82,82,7
89,seq147,r_145_124_136,r_120_148_63,r_120_148_63,0.92,16,79,63,7
3,r_125_45_89,r_128_25_103,seq52,r_125_45_89,1.0,0,89,89,7
90,seq88,r_89_137_180,r_62_78_24,r_62_78_24,0.86,159,183,24,7
4,r_121_41_121,r_119_0_178,seq42,r_121_41_121,1.0,0,121,121,7
11,r_141_13_60,r_120_148_63,r_122_12_40,r_141_13_60,1.0,0,60,60,7
13,r_120_148_63,r_121_41_121,seq147,r_120_148_63,0.9,1,64,63,7
8,r_33_127_34,r_34_134_110,seq129,r_33_127_34,0.67,0,34,34,7
48,r_55_103_141,seq57,seq99,r_55_103_141,0.73,0,141,141,7
13,r_120_148_63,seq147,r_37_149_123,r_37_149_123,1.0,2,125,123,7
6,r_72_118_178,seq73,r_85_126_93,r_85_126_93,1.0,84,177,93,7
30,r_122_12_40,r_121_41_121,r_8_14_1,r_122_12_40,0.96,0,40,40,7
52,seq4,seq2,r_51_3_51,r_51_3_51,1.0,2,53,51,7
45,r_64_16_47,seq63,r_8_14_1,r_64_16_47,1.0,0,47,47,7
2,r_119_0_178,r_121_41_121,r_5_123_76,r_5_123_76,0.84,45,121,76,7
47,r_21_83_98,seq18,r_62_78_24,r_21_83_98,0.66,0,98,98,7
30,r_122_12_40,r_8_14_1,r_141_13_60,r_141_13_60,1.0,2,62,60,7
29,r_28_15_138,seq26,r_8_14_1,r_28_15_138,0.64,0,138,138,7
5,r_43_86_10,r_51_3_51,r_85_126_93,r_43_86_10,0.89,0,10,10,7
18,r_84_36_174,seq69,r_62_78_24,r_62_78_24,0.82,33,57,24,7
25,r_108_66_130,r_109_136_139,r_111_61_9,r_108_66_130,0.9,0,130,130,7
32,r_67_39_42,seq68,seq42,r_67_39_42,0.99,1,43,42,7
64,seq26,r_28_15_138,r_128_25_103,r_128_25_103,1.0,35,138,103,7
58,seq144,r_145_124_136,r_102_146_17,r_102_146_17,0.47,119,136,17,7
94,seq97,seq96,r_114_98_11,r_114_98_11,0.51,23,34,11,7
68,seq42,r_40_29_137,r_121_41_121,r_121_41_121,0.51,16,137,121,7
42,r_5_123_76,r_119_0_178,r_145_124_136,r_5_123_76,0.71,102,178,76,7
91,seq90,seq93,r_47_91_10,r_47_91_10,0.92,2,12,10,7
38,r_37_149_123,seq35,r_120_148_63,r_37_149_123,0.83,0,123,123,7
21,r_51_3_51,seq50,seq4,r_51_3_51,1.0,0,51,51,7
34,r_101_143_129,r_104_10_158,r_102_146_17,r_101_143_129,0.73,0,129,129,7
35,r_38_107_44,r_30_80_83,seq106,r_38_107_44,1.0,0,44,44,7
78,seq63,r_64_16_47,r_111_61_9,r_64_16_47,0.77,0,47,47,7
81,seq69,r_89_137_180,r_6_71_112,r_6_71_112,0.89,5,117,112,7
26,r_58_56_91,seq59,seq57,r_58_56_91,0.65,-5,86,91,7
96,seq106,r_109_136_139,r_38_107_44,r_38_107_44,1.0,41,85,44,7
22,r_30_80_83,r_28_15_138,r_62_78_24,r_30_80_83,0.98,0,83,83,7
28,r_40_29_137,seq42,r_128_25_103,r_40_29_137,0.65,0,137,137,7
49,r_94_27_19,seq93,seq26,r_94_27_19,1.0,0,19,19,7
10,r_62_78_24,r_65_7_82,seq82,r_62_78_24,0.78,1,25,24,7
18,r_84_36_174,r_62_78_24,seq35,r_84_36_174,0.46,0,174,174,7
9,r_102_146_17,r_108_66_130,seq144,r_102_146_17,0.9,1,18,17,7
23,r_85_126_93,r_89_137_180,r_33_127_34,r_85_126_93,0.96,1,94,93,7
2,r_119_0_178,r_5_123_76,seq1,r_119_0_178,0.96,0,178,178,7
12,r_145_124_136,seq144,r_5_123_76,r_5_123_76,1.0,60,136,76,7
40,r_120_21_23,r_19_137_172,r_83_22_99,r_83_22_99,1.0,13,112,99,8
30,r_107_12_87,r_112_46_98,seq15,r_107_12_87,1.0,0,87,87,8
51,seq130,seq125,r_115_131_153,r_115_131_153,0.67,0,153,153,8
36,r_88_122_90,r_89_29_151,r_65_123_73,r_89_29_151,1.0,-61,90,151,8
14,r_112_46_98,r_115_131_153,r_84_45_14,r_112_46_98,1.0,0,98,98,8
28,r_109_32_32,r_107_12_87,seq31,r_109_32_32,1.0,0,32,32,8
37,r_49_114_93,seq48,r_42_116_61,r_49_114_93,0.92,0,93,93,8
59,seq17,r_16_35_68,seq11,r_16_35_68,1.0,-2,66,68,8
45,r_84_45_14,r_90_91_89,seq48,r_84_45_14,0.9,5,19,14,8
39,r_81_3_98,seq77,seq1,r_81_3_98,1.0,0,98,98,8
97,seq110,r_111_60_116,r_13_113_71,r_13_113_71,0.7,36,107,71,8
5,r_128_71_116,r_127_118_123,r_4_69_111,r_128_71_116,0.96,0,116,116,8
46,r_65_123_73,seq66,seq121,r_65_123_73,1.0,0,73,73,8
42,r_0_99_165,seq1,r_85_93_8,r_0_99_165,0.59,0,165,165,8
24,r_20_108_174,r_120_21_23,r_100_117_142,r_120_21_23,0.53,151,174,23,8
19,r_57_7_153,seq58,seq6,r_57_7_153,0.95,0,153,153,8
15,r_85_93_8,r_97_104_124,r_124_95_94,r_124_95_94,0.58,20,114,94,8
38,r_126_96_30,r_97_104_124,r_124_95_94,r_126_96_30,0.75,66,96,30,8
31,r_19_137_172,r_20_108_174,seq135,r_19_137_172,0.52,0,172,172,8
41,r_111_60_116,seq110,r_14_61_101,r_111_60_116,0.97,0,116,116,8
10,r_100_117_142,r_97_104_124,r_13_113_71,r_13_113_71,1.0,71,142,71,8
11,r_53_119_147,seq52,seq129,r_53_119_147,0.81,0,147,147,8
20,r_10_59_91,seq8,seq58,r_10_59_91,1.0,0,91,91,8
13,r_13_113_71,r_14_61_101,r_42_116_61,r_13_113_71,1.0,0,71,71,8
48,r_83_22_99,seq82,r_120_21_23,r_83_22_99,1.0,0,99,99,8
21,r_18_80_55,r_20_108_174,seq77,r_18_80_55,0.99,-2,53,55,8
49,r_89_29_151,seq77,seq28,r_89_29_151,0.97,0,151,151,8
33,r_62_56_33,r_84_45_14,r_30_55_77,r_30_55_77,0.5,4,81,77,8
6,r_115_131_153,r_112_46_98,r_42_116_61,r_115_131_153,0.52,-81,72,153,8
44,r_138_36_31,seq135,seq37,r_138_36_31,0.92,0,31,31,8
99,seq125,r_124_95_94,seq129,r_124_95_94,0.96,-29,65,94,8
29,r_98_41_50,r_97_104_124,seq40,r_98_41_50,1.0,0,50,50,8
27,r_127_118_123,seq121,r_13_113_71,r_13_113_71,1.0,52,123,71,8
26,r_97_104_124,r_98_41_50,r_100_117_142,r_98_41_50,1.0,-9,41,50,8
87,seq82,r_83_22_99,seq86,r_83_22_99,1.0,-4,95,99,8
56,seq11,r_20_108_174,seq15,r_20_108_174,0.87,-149,25,174,8
47,r_42_116_61,seq40,r_115_131_153,r_42_116_61,1.0,0,61,61,8
18,r_132_26_188,r_133_105_122,seq125,r_132_26_188,0.44,-83,105,188,8
38,r_126_96_30,r_132_26_188,r_97_104_124,r_126_96_30,0.83,0,30,30,8
25,r_145_78_89,seq146,seq77,r_145_78_89,0.97,0,89,89,8
64,seq28,seq37,r_89_29_151,r_89_29_151,0.87,6,157,151,8
47,r_42_116_61,r_115_131_153,r_100_117_142,r_42_116_61,0.93,92,153,61,8
50,seq1,r_0_99_165,r_23_2_32,r_23_2_32,0.8,134,166,32,8
92,seq92,r_145_78_89,seq106,r_145_78_89,0.97,-36,53,89,8
6,r_115_131_153,r_42_116_61,seq130,r_115_131_153,0.84,0,153,153,8
65,seq31,seq33,r_109_32_32,r_109_32_32,1.0,40,72,32,8
16,r_14_61_101,r_10_59_91,r_111_60_116,r_111_60_116,0.97,2,118,116,8
34,r_30_55_77,seq33,r_62_56_33,r_30_55_77,0.96,4,81,77,8
40,r_120_21_23,r_128_71_116,r_19_137_172,r_120_21_23,0.99,0,23,23,8
45,r_84_45_14,seq48,r_112_46_98,r_112_46_98,1.0,6,104,98,8
7,r_79_54_31,r_81_3_98,seq52,r_79_54_31,0.98,-1,30,31,8
17,r_25_142_61,r_24_70_88,r_141_148_194,r_25_142_61,1.0,0,61,61,8
9,r_16_35_68,seq17,seq37,r_16_35_68,0.96,0,68,68,8
26,r_97_104_124,r_100_117_142,r_133_105_122,r_133_105_122,0.81,2,124,122,8
96,seq106,seq103,r_133_105_122,r_133_105_122,1.0,40,162,122,8
0,r_23_2_32,r_25_142_61,seq1,r_23_2_32,1.0,0,32,32,8
22,r_43_63_112,seq44,r_14_61_101,r_14_61_101,0.58,9,110,101,8
24,r_20_108_174,r_19_137_172,r_120_21_23,r_120_21_23,1.0,17,40,23,8
49,r_89_29_151,r_88_122_90,seq77,r_88_122_90,0.92,-25,65,90,8
18,r_132_26_188,seq125,seq27,r_132_26_188,0.77,0,188,188,8
23,r_133_105_122,r_132_26_188,seq129,r_132_26_188,0.64,-108,80,188,8
78,seq52,r_53_119_147,r_79_54_31,r_79_54_31,0.93,0,31,31,8
35,r_24_70_88,r_25_142_61,r_72_64_15,r_24_70_88,0.95,-26,62,88,8
12,r_4_69_111,r_0_99_165,r_24_70_88,r_4_69_111,1.0,0,111,111,8
93,seq98,r_100_118_139,r_141_99_148,r_141_99_148,0.96,3,151,148,9
40,r_50_51_19,seq48,r_20_46_120,r_20_46_120,1.0,14,134,120,9
30,r_78_96_119,r_74_81_182,seq97,r_78_96_119,0.91,1,120,119,9
51,seq130,r_125_133_120,r_142_129_17,r_125_133_120,0.67,-57,63,120,9
92,seq97,r_117_143_196,r_78_96_119,r_78_96_119,0.82,7,126,119,9
14,r_101_147_137,r_100_118_139,r_149_138_188,r_101_147_137,0.93,2,139,137,9
43,r_5_109_13,r_108_56_191,r_100_118_139,r_100_118_139,0.5,58,197,139,9
37,r_1_126_125,seq0,r_142_129_17,r_1_126_125,0.9,0,125,125,9
40,r_50_51_19,seq68,seq48,r_50_51_19,0.53,28,47,19,9
71,seq48,r_47_128_89,r_50_51_19,r_47_128_89,1.0,-4,85,89,9
16,r_57_40_116,r_58_145_162,seq37,r_58_145_162,0.98,-45,117,162,9
21,r_13_104_174,seq14,r_141_99_148,r_13_104_174,0.7,0,174,174,9
1,r_47_128_89,seq48,seq127,r_47_128_89,0.95,2,91,89,9
5,r_36_144_157,seq37,r_101_147_137,r_36_144_157,0.5,0,157,157,9
46,r_71_63_143,seq72,r_103_61_123,r_103_61_123,0.98,20,143,123,9
42,r_79_6_138,r_49_82_1,r_59_2_121,r_79_6_138,0.71,0,138,138,9
80,seq72,r_71_63_143,r_55_69_70,r_55_69_70,0.53,73,143,70,9
32,r_34_4_10,r_3_7_128,r_59_2_121,r_59_2_121,0.94,11,132,121,9
95,seq111,r_110_12_141,seq98,r_110_12_141,1.0,-43,98,141,9
41,r_18_148_159,seq19,r_101_147_137,r_18_148_159,0.77,0,159,159,9
0,r_59_2_121,r_58_145_162,r_34_4_10,r_59_2_121,0.56,0,121,121,9
31,r_17_80_30,r_18_148_159,r_49_82_1,r_17_80_30,0.99,0,30,30,9
11,r_103_61_123,r_100_118_139,seq52,r_103_61_123,0.86,0,123,123,9
20,r_76_119_62,r_74_81_182,r_106_114_43,r_76_119_62,1.0,0,62,62,9
13,r_85_90_181,seq86,r_141_99_148,r_141_99_148,0.93,38,186,148,9
15,r_33_66_87,r_42_121_136,seq65,r_42_121_136,0.61,-49,87,136,9
48,r_122_115_116,seq130,r_106_114_43,r_122_115_116,0.52,-10,106,116,9
19,r_105_31_54,r_106_114_43,seq32,r_105_31_54,0.99,5,59,54,9
6,r_55_69_70,seq52,seq72,r_55_69_70,0.78,0,70,70,9
99,seq127,seq130,r_47_128_89,r_47_128_89,1.0,9,98,89,9
45,r_110_12_141,r_101_147_137,r_64_8_122,r_101_147_137,0.82,1,138,137,9
27,r_45_112_121,r_44_16_190,r_75_113_135,r_45_112_121,0.66,21,142,121,9
34,r_106_114_43,r_105_31_54,seq116,r_105_31_54,0.99,-7,47,54,9
22,r_141_99_148,r_149_138_188,seq98,r_141_99_148,0.81,1,149,148,9
2,r_100_118_139,r_101_147_137,r_76_119_62,r_100_118_139,0.99,-1,138,139,9
47,r_58_145_162,seq60,seq146,r_58_145_162,0.73,1,163,162,9
74,seq137,seq134,r_24_136_102,r_24_136_102,1.0,28,130,102,9
18,r_64_8_122,seq65,seq9,r_64_8_122,0.93,0,122,122,9
25,r_84_41_141,seq83,r_139_38_10,r_139_38_10,0.65,123,133,10,9
10,r_49_82_1,r_79_6_138,r_17_80_30,r_17_80_30,0.6,6,36,30,9
33,r_125_133_120,seq130,r_35_135_6,r_125_133_120,0.77,0,120,120,9
50,seq0,r_1_126_125,seq19,r_1_126_125,0.67,0,125,125,9
58,seq146,r_149_138_188,r_58_145_162,r_58_145_162,0.77,4,166,162,9
14,r_101_147_137,r_149_138_188,r_18_148_159,r_18_148_159,0.68,30,189,159,9
22,r_141_99_148,r_140_54_36,r_149_138_188,r_140_54_36,0.99,0,36,36,9
26,r_140_54_36,r_141_99_148,seq53,r_140_54_36,0.99,0,36,36,9
9,r_149_138_188,r_141_99_148,r_101_147_137,r_149_138_188,0.72,-37,151,188,9
4,r_142_129_17,r_141_99_148,seq130,r_142_129_17,0.97,0,17,17,9
9,r_149_138_188,seq146,r_141_99_148,r_141_99_148,0.44,-30,118,148,9
68,seq32,r_42_121_136,r_105_31_54,r_105_31_54,0.76,0,54,54,9
28,r_74_81_182,seq73,r_49_82_1,r_74_81_182,0.5,1,183,182,9
49,r_20_46_120,seq19,r_50_51_19,r_20_46_120,0.73,0,120,120,9
44,r_24_136_102,seq23,seq137,r_24_136_102,0.99,0,102,102,9
82,seq83,r_84_41_141,r_78_96_119,r_78_96_119,0.61,31,150,119,9
35,r_43_70_65,r_42_121_136,seq72,r_43_70_65,0.73,0,65,65,9
40,r_3_121_66,r_118_90_171,seq135,r_118_90_171,0.5,-35,136,171,10
36,r_102_75_69,seq103,seq76,r_102_75_69,0.96,0,69,69,10
28,r_67_34_16,seq68,r_33_37_165,r_67_34_16,0.98,0,16,16,10
5,r_124_99_56,r_125_1_108,r_70_100_23,r_124_99_56,0.86,0,56,56,10
14,r_53_112_188,seq51,r_127_111_30,r_127_111_30,0.75,158,188,30,10
30,r_129_7_56,r_130_38_152,seq8,r_129_7_56,1.0,0,56,56,10
37,r_15_19_169,seq14,seq10,r_15_19_169,0.4,-74,95,169,10
3,r_47_92_22,r_96_98_168,seq77,r_47_92_22,0.36,163,185,22,10
3,r_47_92_22,r_46_22_162,r_87_4_202,r_47_92_22,0.57,0,22,22,10
16,r_46_22_162,seq48,r_86_23_49,r_46_22_162,0.61,0,162,162,10
21,r_49_16_1,r_18_27_115,r_61_20_54,r_61_20_54,1.0,90,144,54,10
39,r_117_146_103,r_120_9_180,seq145,r_117_146_103,0.64,0,103,103,10
46,r_118_90_171,r_120_9_180,r_138_91_59,r_120_9_180,0.61,-9,171,180,10
43,r_13_82_41,r_15_19_169,seq81,r_13_82_41,1.0,0,41,41,10
15,r_140_36_96,seq44,r_130_38_152,r_130_38_152,0.94,13,165,152,10
11,r_33_37_165,r_67_34_16,r_130_38_152,r_67_34_16,0.63,149,165,16,10
95,seq110,r_109_54_78,r_108_32_194,r_109_54_78,1.0,-18,60,78,10
41,r_97_2_93,r_96_98_168,r_129_7_56,r_96_98_168,0.91,-73,95,168,10
67,seq31,r_33_37_165,r_86_23_49,r_86_23_49,0.84,74,123,49,10
34,r_61_20_54,r_60_131_39,seq59,r_60_131_39,0.87,0,39,39,10
1,r_125_1_108,r_122_11_141,seq0,r_125_1_108,1.0,-1,107,108,10
47,r_127_111_30,r_130_38_152,r_118_90_171,r_127_111_30,0.89,10,40,30,10
26,r_72_132_91,r_74_24_123,seq134,r_74_24_123,0.7,-32,91,123,10
4,r_71_63_169,seq69,seq64,r_71_63_169,0.35,22,191,169,10
0,r_120_9_180,seq119,r_129_7_56,r_129_7_56,0.97,124,180,56,10
29,r_138_91_59,r_133_58_115,seq89,r_138_91_59,0.99,0,59,59,10
13,r_109_54_78,seq110,r_123_52_72,r_109_54_78,0.91,0,78,78,10
98,seq119,r_120_9_180,r_60_131_39,r_60_131_39,0.84,147,186,39,10
48,r_41_95_192,r_42_73_143,seq44,r_42_73_143,0.99,0,143,143,10
3,r_47_92_22,r_87_4_202,r_96_98_168,r_96_98_168,0.51,-120,48,168,10
93,seq105,r_102_75_69,seq107,r_102_75_69,1.0,-51,18,69,10
6,r_123_52_72,r_125_1_108,seq51,r_123_52_72,0.87,0,72,72,10
2,r_122_11_141,seq145,r_56_12_84,r_122_11_141,1.0,0,141,141,10
78,seq68,r_72_132_91,seq76,r_72_132_91,1.0,-36,55,91,10
7,r_60_131_39,r_61_20_54,seq137,r_60_131_39,1.0,0,39,39,10
27,r_108_32_194,seq110,r_46_22_162,r_46_22_162,0.6,30,192,162,10
17,r_86_23_49,seq85,r_25_126_142,r_86_23_49,1.0,0,49,49,10
2,r_122_11_141,r_123_52_72,seq145,r_123_52_72,1.0,0,72,72,10
40,r_3_121_66,seq6,r_118_90_171,r_3_121_66,1.0,0,66,66,10
18,r_96_98_168,r_97_2_93,r_70_100_23,r_97_2_93,1.0,0,93,93,10
24,r_55_83_184,r_53_112_188,r_13_82_41,r_53_112_188,0.4,-4,184,188,10
45,r_40_143_39,r_42_73_143,seq141,r_40_143_39,1.0,0,39,39,10
25,r_65_142_132,seq64,r_40_143_39,r_65_142_132,0.68,0,132,132,10
33,r_18_27_115,r_17_106_142,seq30,r_17_106_142,0.99,1,143,142,10
47,r_127_111_30,r_118_90_171,r_17_106_142,r_17_106_142,0.55,2,144,142,10
11,r_33_37_165,r_29_139_146,r_67_34_16,r_67_34_16,1.0,0,16,16,10
50,seq0,seq6,r_125_1_108,r_125_1_108,0.98,15,123,108,10
1,r_125_1_108,r_124_99_56,r_122_11_141,r_124_99_56,1.0,0,56,56,10
42,r_50_62_67,seq43,r_123_52_72,r_123_52_72,0.69,70,142,72,10
47,r_127_111_30,seq128,r_53_112_188,r_127_111_30,0.83,159,189,30,10
9,r_42_73_143,r_41_95_192,r_102_75_69,r_42_73_143,0.91,0,143,143,10
28,r_67_34_16,r_33_37_165,r_86_23_49,r_67_34_16,0.84,149,165,16,10
22,r_35_101_64,seq43,r_70_100_23,r_35_101_64,0.99,0,64,64,10
48,r_41_95_192,seq44,seq93,r_41_95_192,0.83,0,192,192,10
49,r_28_113_134,seq26,seq116,r_28_113_134,0.89,0,134,134,10
44,r_25_126_142,seq26,seq135,r_25_126_142,0.54,0,142,142,10
23,r_17_106_142,r_18_27_115,seq107,r_17_106_142,0.96,1,143,142,10
17,r_86_23_49,r_25_126_142,r_74_24_123,r_86_23_49,0.91,93,142,49,10
47,r_127_111_30,r_17_106_142,seq66,r_127_111_30,0.48,133,163,30,10
12,r_136_84_52,r_130_38_152,seq85,r_136_84_52,0.84,0,52,52,10
35,r_56_12_84,r_53_112_188,seq10,r_56_12_84,0.97,0,84,84,10
95,seq110,r_108_32_194,r_71_63_169,r_108_32_194,0.7,0,194,194,10
19,r_70_100_23,r_71_63_169,r_96_98_168,r_70_100_23,0.85,-2,21,23,10
0,r_28_142_28,seq66,r_101_144_21,r_28_142_28,0.84,0,28,28,11
36,r_80_71_63,r_77_39_189,seq72,r_80_71_63,1.0,0,63,63,11
92,seq111,r_114_33_165,r_134_110_93,r_134_110_93,0.66,8,101,93,11
8,r_4_22_83,r_3_45_103,r_141_18_11,r_3_45_103,0.83,-18,85,103,11
43,r_30_135_154,seq40,seq136,r_30_135_154,0.8,0,154,154,11
86,seq148,r_146_93_117,r_143_138_133,r_146_93_117,0.83,-5,112,117,11
26,r_70_113_16,seq69,seq111,r_70_113_16,0.95,0,16,16,11
21,r_57_98_62,r_65_8_99,r_32_100_34,r_65_8_99,0.7,-37,62,99,11
37,r_127_90_24,seq128,seq89,r_127_90_24,0.96,-1,23,24,11
5,r_3_45_103,seq5,seq46,r_3_45_103,1.0,0,103,103,11
46,r_49_79_167,seq47,r_58_78_94,r_58_78_94,0.9,73,167,94,11
12,r_32_100_34,r_38_145_144,seq104,r_32_100_34,1.0,0,34,34,11
32,r_101_144_21,r_143_138_133,r_28_142_28,r_143_138_133,0.39,0,133,133,11
7,r_143_138_133,r_101_144_21,r_105_131_7,r_143_138_133,0.8,0,133,133,11
18,r_73_87_45,seq72,seq86,r_73_87_45,1.0,0,45,45,11
16,r_116_26_42,r_114_33_165,r_27_84_102,r_116_26_42,1.0,0,42,42,11
32,r_101_144_21,r_28_142_28,r_38_145_144,r_38_145_144,1.0,0,144,144,11
19,r_43_112_94,seq44,r_70_113_16,r_43_112_94,0.99,0,94,94,11
76,seq66,seq69,r_9_67_133,r_9_67_133,1.0,0,133,133,11
38,r_19_115_102,r_141_18_11,seq117,r_19_115_102,0.99,0,102,102,11
39,r_141_18_11,r_19_115_102,r_4_22_83,r_19_115_102,1.0,0,102,102,11
67,seq40,r_38_145_144,r_16_41_53,r_16_41_53,0.99,46,99,53,11
30,r_83_147_33,r_85_108_55,r_146_93_117,r_83_147_33,0.94,0,33,33,11
3,r_95_88_80,r_103_59_95,seq86,r_95_88_80,1.0,0,80,80,11
10,r_96_75_62,r_95_88_80,seq72,r_96_75_62,0.95,0,62,62,11
35,r_85_108_55,r_77_39_189,seq123,r_85_108_55,0.98,0,55,55,11
16,r_116_26_42,r_27_84_102,r_64_25_7,r_27_84_102,1.0,0,102,102,11
4,r_21_36_88,r_24_53_102,r_119_34_45,r_119_34_45,1.0,43,88,45,11
11,r_65_8_99,seq60,r_13_23_187,r_65_8_99,0.92,0,99,99,11
48,r_146_93_117,seq106,r_143_138_133,r_143_138_133,0.71,-114,19,133,11
48,r_146_93_117,r_143_138_133,r_83_147_33,r_146_93_117,0.98,-73,44,117,11
20,r_92_74_91,seq91,r_96_75_62,r_92_74_91,1.0,0,91,91,11
13,r_64_25_7,r_27_84_102,r_116_26_42,r_64_25_7,0.72,66,73,7,11
7,r_143_138_133,r_140_52_29,r_101_144_21,r_143_138_133,0.54,-107,26,133,11
15,r_9_67_133,r_13_23_187,seq66,r_9_67_133,0.99,0,133,133,11
31,r_27_84_102,r_116_26_42,r_58_78_94,r_27_84_102,0.99,0,102,102,11
44,r_24_53_102,r_4_22_83,seq66,r_24_53_102,0.96,3,105,102,11
6,r_120_29_82,seq121,r_119_34_45,r_120_29_82,0.55,0,82,82,11
10,r_96_75_62,seq72,r_92_74_91,r_92_74_91,0.88,34,125,91,11
9,r_119_34_45,seq118,r_149_31_28,r_119_34_45,0.92,0,45,45,11
30,r_83_147_33,r_146_93_117,seq139,r_146_93_117,0.76,0,117,117,11
40,r_103_59_95,seq104,seq60,r_103_59_95,1.0,0,95,95,11
29,r_134_110_93,seq139,seq111,r_134_110_93,0.85,0,93,93,11
24,r_38_145_144,seq40,r_101_144_21,r_38_145_144,0.87,0,144,144,11
38,r_19_115_102,r_21_36_88,r_141_18_11,r_141_18_11,1.0,0,11,11,11
25,r_35_17_156,seq40,r_4_22_83,r_35_17_156,0.74,0,156,156,11
48,r_146_93_117,r_83_147_33,seq91,r_146_93_117,0.97,-1,116,117,11
70,seq47,r_49_79_167,r_140_52_29,r_140_52_29,0.85,138,167,29,11
34,r_149_31_28,seq148,seq37,r_149_31_28,1.0,0,28,28,11
1,r_140_52_29,r_143_138_133,seq51,r_140_52_29,1.0,0,29,29,11
65,seq20,r_19_115_102,r_4_22_83,r_19_115_102,1.0,0,102,102,11
32,r_101_144_21,r_103_59_95,r_143_138_133,r_101_144_21,0.74,4,25,21,11
33,r_42_81_44,r_43_112_94,seq82,r_42_81_44,1.0,0,44,44,11
83,seq89,seq86,r_127_90_24,r_127_90_24,1.0,-1,23,24,11
60,seq139,seq137,r_143_138_133,r_143_138_133,0.69,15,148,133,11
81,seq82,r_77_39_189,r_42_81_44,r_42_81_44,1.0,33,77,44,11
17,r_50_0_100,seq51,seq1,r_50_0_100,1.0,1,101,100,11
39,r_141_18_11,r_140_52_29,r_19_115_102,r_141_18_11,0.99,0,11,11,11
31,r_27_84_102,r_64_25_7,r_116_26_42,r_116_26_42,1.0,17,59,42,11
42,r_76_63_39,r_77_39_189,seq62,r_76_63_39,1.0,0,39,39,11
14,r_97_126_32,r_96_75_62,seq130,r_97_126_32,0.99,0,32,32,11
45,r_16_41_53,seq15,seq40,r_16_41_53,1.0,0,53,53,11
22,r_11_133_66,r_9_67_133,seq132,r_11_133_66,1.0,0,66,66,11
49,r_114_33_165,seq117,r_21_36_88,r_21_36_88,0.99,77,165,88,11
44,r_24_53_102,r_21_36_88,r_4_22_83,r_21_36_88,0.9,0,88,88,11
23,r_48_56_96,seq47,r_76_63_39,r_76_63_39,0.93,56,95,39,11
84,seq91,r_92_74_91,seq94,r_92_74_91,1.0,0,91,91,11
30,r_65_87_108,r_78_2_112,r_59_84_74,r_78_2_112,1.0,-3,109,112,12
36,r_3_74_137,seq4,r_56_76_107,r_3_74_137,0.53,0,137,137,12
14,r_5_146_98,seq4,r_111_147_33,r_5_146_98,1.0,0,98,98,12
8,r_20_126_131,seq19,seq129,r_20_126_131,0.91,0,131,131,12
53,seq4,r_5_146_98,r_3_74_137,r_5_146_98,1.0,0,98,98,12
43,r_52_119_140,seq55,r_20_126_131,r_52_119_140,0.79,0,140,140,12
37,r_101_149_108,seq102,r_111_147_33,r_101_149_108,1.0,0,108,108,12
16,r_26_108_60,r_31_83_136,seq106,r_26_108_60,1.0,0,60,60,12
21,r_94_81_115,r_93_134_135,r_56_76_107,r_94_81_115,0.7,20,135,115,12
39,r_107_79_91,seq106,r_78_2_112,r_107_79_91,0.88,0,91,91,12
5,r_39_40_49,seq38,r_143_41_71,r_143_41_71,1.0,2,73,71,12
46,r_78_2_112,r_75_144_92,r_107_79_91,r_78_2_112,0.88,-20,92,112,12
42,r_128_72_107,r_124_122_181,r_107_79_91,r_124_122_181,1.0,-74,107,181,12
45,r_93_134_135,r_94_81_115,r_20_126_131,r_93_134_135,0.96,0,135,135,12
27,r_70_22_164,r_120_69_68,seq24,r_70_22_164,0.88,0,164,164,12
67,seq24,r_30_25_91,r_70_22_164,r_70_22_164,0.86,2,166,164,12
40,r_71_103_28,r_70_22_164,r_109_105_7,r_71_103_28,1.0,0,28,28,12
26,r_88_100_106,seq85,seq99,r_88_100_106,1.0,0,106,106,12
3,r_6_18_57,seq19,r_98_17_87,r_98_17_87,1.0,10,97,87,12
0,r_125_13_119,r_124_122_181,seq14,r_125_13_119,0.99,0,119,119,12
73,seq42,r_78_2_112,r_73_43_101,r_78_2_112,0.93,-10,102,112,12
11,r_12_29_133,seq14,seq28,r_12_29_133,0.81,0,133,133,12
67,seq24,r_23_117_56,r_30_25_91,r_23_117_56,1.0,0,56,56,12
20,r_75_144_92,r_78_2_112,r_111_147_33,r_75_144_92,1.0,0,92,92,12
48,r_15_51_67,seq14,seq61,r_15_51_67,1.0,0,67,67,12
49,r_120_69_68,r_70_22_164,seq67,r_70_22_164,1.0,-16,148,164,12
13,r_35_44_40,r_73_43_101,r_107_79_91,r_107_79_91,1.0,12,103,91,12
6,r_27_37_93,seq28,seq34,r_27_37_93,1.0,0,93,93,12
62,seq14,seq16,r_125_13_119,r_125_13_119,1.0,24,143,119,12
19,r_21_50_29,r_20_126_131,seq46,r_21_50_29,1.0,0,29,29,12
3,r_6_18_57,seq7,seq19,r_6_18_57,1.0,0,57,57,12
27,r_70_22_164,seq67,r_120_69_68,r_120_69_68,1.0,10,78,68,12
2,r_77_60_77,r_75_144_92,seq61,r_75_144_92,1.0,-11,81,92,12
47,r_80_92_173,r_78_2_112,r_94_81_115,r_78_2_112,0.7,-1,111,112,12
18,r_124_122_181,r_128_72_107,seq129,r_128_72_107,1.0,0,107,107,12
29,r_59_84_74,r_56_76_107,seq85,r_59_84_74,0.81,0,74,74,12
24,r_118_66_133,seq121,r_56_76_107,r_118_66_133,0.79,0,133,133,12
25,r_73_43_101,r_78_2_112,seq42,r_78_2_112,0.98,-10,102,112,12
33,r_135_62_120,seq141,seq58,r_135_62_120,0.96,0,120,120,12
13,r_35_44_40,seq34,r_73_43_101,r_35_44_40,0.47,0,40,40,12
88,seq97,r_98_17_87,seq99,r_98_17_87,1.0,0,87,87,12
1,r_23_117_56,seq24,seq121,r_23_117_56,1.0,0,56,56,12
32,r_48_115_125,seq46,seq114,r_48_115_125,0.98,0,125,125,12
38,r_98_17_87,seq97,r_6_18_57,r_98_17_87,1.0,0,87,87,12
9,r_111_147_33,seq112,seq145,r_111_147_33,0.89,0,33,33,12
53,seq4,r_3_74_137,r_148_1_39,r_3_74_137,1.0,1,138,137,12
71,seq34,seq33,r_27_37_93,r_27_37_93,1.0,4,97,93,12
34,r_63_127_170,seq61,r_20_126_131,r_20_126_131,0.77,39,170,131,12
50,seq0,seq4,r_148_1_39,r_148_1_39,0.99,5,44,39,12
55,seq7,r_6_18_57,seq9,r_6_18_57,0.99,0,57,57,12
81,seq64,r_80_92_173,r_128_72_107,r_128_72_107,1.0,1,108,107,12
17,r_95_36_94,r_96_82_97,r_27_37_93,r_27_37_93,0.85,1,94,93,12
46,r_78_2_112,r_107_79_91,r_148_1_39,r_78_2_112,1.0,0,112,112,12
39,r_107_79_91,r_78_2_112,r_56_76_107,r_78_2_112,0.79,0,112,112,12
22,r_31_83_136,seq32,r_59_84_74,r_31_83_136,0.84,0,136,136,12
28,r_56_76_107,seq55,r_107_79_91,r_107_79_91,1.0,20,111,91,12
49,r_120_69_68,seq121,r_70_22_164,r_120_69_68,1.0,0,68,68,12
44,r_143_41_71,seq145,r_39_40_49,r_143_41_71,1.0,0,71,71,12
71,seq34,r_35_44_40,seq33,r_35_44_40,0.59,-21,19,40,12
35,r_57_90_141,seq55,r_31_83_136,r_31_83_136,1.0,5,141,136,12
12,r_11_123_65,seq10,seq121,r_11_123_65,1.0,0,65,65,12
23,r_148_1_39,seq145,seq0,r_148_1_39,1.0,0,39,39,12
65,seq145,r_148_1_39,r_111_147_33,r_148_1_39,1.0,0,39,39,12
43,r_105_13_193,r_109_108_96,r_141_28_6,r_141_28_6,0.83,191,197,6,13
83,seq140,seq147,r_83_143_69,r_83_143_69,1.0,3,72,69,13
39,r_119_92_103,r_120_148_155,seq90,r_119_92_103,0.69,4,107,103,13
1,r_106_87_172,r_105_13_193,r_0_84_135,r_106_87_172,0.54,0,172,172,13
5,r_31_48_107,seq32,seq50,r_31_48_107,0.97,0,107,107,13
46,r_18_117_81,r_17_142_182,r_44_118_45,r_18_117_81,1.0,0,81,81,13
42,r_8_59_124,seq9,r_31_48_107,r_8_59_124,0.91,0,124,124,13
45,r_15_25_149,r_14_66_79,seq12,r_14_66_79,0.81,0,79,79,13
19,r_94_145_128,r_91_146_155,r_89_149_21,r_89_149_21,0.76,107,128,21,13
15,r_120_148_155,r_44_118_45,r_89_149_21,r_120_148_155,0.94,0,155,155,13
33,r_116_67_9,r_74_122_82,r_14_66_79,r_116_67_9,1.0,70,79,9,13
76,seq62,seq64,r_132_61_132,r_132_61_132,0.98,1,133,132,13
97,seq114,r_113_110_99,r_119_92_103,r_113_110_99,0.65,0,99,99,13
31,r_29_39_77,r_34_30_44,r_52_38_1,r_29_39_77,1.0,0,77,77,13
41,r_63_2_85,seq64,seq3,r_63_2_85,0.98,0,85,85,13
3,r_14_66_79,r_15_25_149,r_116_67_9,r_14_66_79,1.0,0,79,79,13
10,r_7_73_141,seq9,r_45_78_115,r_7_73_141,0.95,0,141,141,13
44,r_75_54_20,r_82_138_185,seq56,r_75_54_20,0.45,1,21,20,13
26,r_53_97_148,seq55,seq100,r_53_97_148,0.65,0,148,148,13
0,r_74_122_82,r_82_138_185,r_130_123_29,r_74_122_82,1.0,0,82,82,13
11,r_95_125_157,r_96_57_197,seq126,r_95_125_157,0.81,0,157,157,13
15,r_120_148_155,r_119_92_103,r_44_118_45,r_120_148_155,0.92,-83,72,155,13
48,r_132_61_132,seq135,seq62,r_132_61_132,0.94,0,132,132,13
57,seq9,r_8_59_124,seq4,r_8_59_124,1.0,0,124,124,13
12,r_0_84_135,seq3,seq85,r_0_84_135,1.0,0,135,135,13
6,r_83_143_69,r_86_103_128,seq140,r_83_143_69,1.0,0,69,69,13
85,seq77,seq79,r_45_78_115,r_45_78_115,0.94,6,121,115,13
99,seq126,seq135,r_95_125_157,r_95_125_157,0.83,3,160,157,13
36,r_44_118_45,r_120_148_155,r_18_117_81,r_44_118_45,0.95,97,142,45,13
9,r_89_149_21,r_109_108_96,seq147,r_89_149_21,0.92,-1,20,21,13
29,r_34_30_44,seq35,seq32,r_34_30_44,0.66,5,49,44,13
36,r_44_118_45,r_45_78_115,r_120_148_155,r_44_118_45,0.98,0,45,45,13
2,r_45_78_115,seq41,seq77,r_45_78_115,0.84,0,115,115,13
47,r_128_133_178,r_127_121_192,seq134,r_128_133_178,0.5,0,178,178,13
40,r_47_6_133,seq46,seq9,r_47_6_133,0.97,0,133,133,13
24,r_131_137_161,seq129,seq139,r_131_137_161,0.19,0,161,161,13
61,seq147,r_144_60_139,r_89_149_21,r_89_149_21,0.97,-1,20,21,13
50,seq129,r_131_137_161,seq139,r_131_137_161,0.24,0,161,161,13
34,r_115_111_34,seq114,seq112,r_115_111_34,0.99,-6,28,34,13
65,seq35,r_34_30_44,r_10_33_70,r_10_33_70,1.0,21,91,70,13
32,r_70_1_126,r_71_23_201,r_63_2_85,r_71_23_201,1.0,-75,126,201,13
38,r_107_26_135,r_105_13_193,r_141_28_6,r_107_26_135,0.85,0,135,135,13
75,seq56,r_58_88_158,r_31_48_107,r_31_48_107,1.0,35,142,107,13
60,seq16,r_17_142_182,seq20,r_17_142_182,0.77,-52,130,182,13
45,r_15_25_149,seq12,r_93_27_148,r_93_27_148,0.89,5,153,148,13
17,r_24_49_130,r_34_30_44,r_31_48_107,r_34_30_44,0.95,87,131,44,13
96,seq112,r_109_108_96,r_115_111_34,r_115_111_34,0.99,26,60,34,13
22,r_93_27_148,r_91_146_155,r_107_26_135,r_91_146_155,0.89,-7,148,155,13
28,r_127_121_192,r_128_133_178,r_74_122_82,r_74_122_82,1.0,110,192,82,13
12,r_0_84_135,r_8_59_124,seq3,r_8_59_124,0.53,-66,58,124,13
7,r_91_146_155,r_95_125_157,r_94_145_128,r_95_125_157,0.88,-2,155,157,13
23,r_17_142_182,r_18_117_81,r_21_42_180,r_18_117_81,1.0,2,83,81,13
97,seq114,r_119_92_103,r_44_118_45,r_119_92_103,0.55,35,138,103,13
79,seq139,seq135,r_131_137_161,r_131_137_161,0.37,2,163,161,13
35,r_10_33_70,r_8_59_124,seq35,r_10_33_70,1.0,0,70,70,13
97,seq114,r_115_111_34,r_113_110_99,r_115_111_34,0.92,0,34,34,13
23,r_17_142_182,r_21_42_180,r_83_143_69,r_17_142_182,0.81,0,182,182,13
51,seq6,r_7_5_117,r_129_10_103,r_129_10_103,1.0,10,113,103,14
47,r_13_61_127,r_101_86_98,r_114_74_1,r_101_86_98,0.51,46,144,98,14
92,seq113,seq117,r_122_112_98,r_122_112_98,0.95,38,136,98,14
14,r_64_72_160,seq63,r_114_74_1,r_114_74_1,0.68,159,160,1,14
48,r_127_53_29,r_145_68_29,r_49_135_150,r_127_53_29,0.96,1,30,29,14
83,seq95,r_94_107_183,r_108_89_39,r_108_89_39,0.98,130,169,39,14
37,r_123_83_138,seq125,seq84,r_123_83_138,0.45,0,138,138,14
59,seq16,seq15,r_20_65_186,r_20_65_186,0.52,-80,106,186,14
71,seq47,r_48_58_181,r_18_50_138,r_48_58_181,0.36,0,181,181,14
39,r_129_10_103,r_132_134_154,seq11,r_129_10_103,0.98,0,103,103,14
1,r_132_134_154,r_38_130_81,r_49_135_150,r_49_135_150,0.8,4,154,150,14
1,r_132_134_154,r_129_10_103,r_38_130_81,r_132_134_154,0.81,-60,94,154,14
27,r_142_116_59,seq137,seq117,r_142_116_59,1.0,0,59,59,14
46,r_39_46_126,seq40,r_100_45_95,r_100_45_95,0.98,31,126,95,14
42,r_100_45_95,r_101_86_98,r_48_58_181,r_100_45_95,0.97,0,95,95,14
80,seq85,seq84,r_101_86_98,r_101_86_98,1.0,2,100,98,14
45,r_136_55_37,r_127_53_29,r_56_54_57,r_56_54_57,0.99,26,83,57,14
18,r_77_148_44,r_78_126_148,r_92_149_22,r_77_148_44,0.83,1,45,44,14
10,r_108_89_39,seq109,seq91,r_108_89_39,0.92,4,43,39,14
76,seq69,r_70_34_152,r_120_67_42,r_120_67_42,0.98,110,152,42,14
34,r_92_149_22,r_90_57_152,seq147,r_90_57_152,0.88,-130,22,152,14
67,seq28,r_30_128_166,r_87_25_107,r_87_25_107,0.84,57,164,107,14
89,seq109,r_106_31_66,seq110,r_106_31_66,1.0,1,67,66,14
3,r_18_50_138,seq17,r_127_53_29,r_18_50_138,0.62,2,140,138,14
40,r_4_80_28,r_3_9_47,seq82,r_4_80_28,0.99,0,28,28,14
15,r_76_33_23,r_78_126_148,seq36,r_76_33_23,1.0,0,23,23,14
32,r_96_42_49,r_97_131_83,seq43,r_96_42_49,1.0,0,49,49,14
26,r_122_112_98,r_123_83_138,seq113,r_122_112_98,0.84,0,98,98,14
4,r_101_86_98,r_100_45_95,seq85,r_101_86_98,0.94,0,98,98,14
73,seq63,r_64_72_160,r_120_67_42,r_120_67_42,1.0,118,160,42,14
11,r_87_25_107,seq88,seq23,r_87_25_107,0.98,0,107,107,14
2,r_120_67_42,seq121,seq63,r_120_67_42,0.72,0,42,42,14
20,r_19_41_81,r_20_65_186,r_96_42_49,r_96_42_49,1.0,34,83,49,14
98,seq124,seq125,r_78_126_148,r_78_126_148,1.0,8,156,148,14
13,r_30_128_166,seq26,r_97_131_83,r_30_128_166,0.88,0,166,166,14
5,r_62_1_123,r_78_126_148,r_2_12_191,r_2_12_191,0.68,-68,123,191,14
72,seq60,r_75_71_186,r_32_59_25,r_32_59_25,0.84,0,25,25,14
24,r_49_135_150,r_48_58_181,seq141,r_49_135_150,0.97,0,150,150,14
47,r_13_61_127,r_2_12_191,r_101_86_98,r_101_86_98,0.57,29,127,98,14
38,r_78_126_148,r_77_148_44,seq85,r_77_148_44,0.9,6,50,44,14
29,r_90_57_152,seq91,r_32_59_25,r_90_57_152,0.83,0,152,152,14
24,r_49_135_150,r_51_44_101,r_48_58_181,r_51_44_101,0.94,0,101,101,14
34,r_92_149_22,seq147,r_77_148_44,r_77_148_44,0.98,44,88,44,14
81,seq88,r_94_107_183,r_78_126_148,r_78_126_148,0.5,-24,124,148,14
61,seq147,r_132_134_154,r_92_149_22,r_132_134_154,0.7,-115,39,154,14
44,r_145_68_29,r_127_53_29,seq63,r_145_68_29,1.0,1,30,29,14
42,r_100_45_95,r_48_58_181,r_39_46_126,r_100_45_95,0.68,74,169,95,14
48,r_127_53_29,r_49_135_150,r_136_55_37,r_127_53_29,0.74,20,49,29,14
60,seq17,r_18_50_138,seq21,r_18_50_138,0.68,1,139,138,14
94,seq117,seq110,r_142_116_59,r_142_116_59,1.0,1,60,59,14
30,r_32_59_25,r_22_93_98,seq60,r_32_59_25,1.0,0,25,25,14
22,r_29_81_14,r_30_128_166,seq82,r_29_81_14,0.96,-1,13,14,14
21,r_97_131_83,r_96_42_49,r_98_52_175,r_96_42_49,1.0,0,49,49,14
28,r_140_37_82,seq139,r_76_33_23,r_140_37_82,1.0,0,82,82,14
81,seq88,r_78_126_148,seq109,r_78_126_148,0.59,8,156,148,14
49,r_22_93_98,seq23,seq95,r_22_93_98,1.0,0,98,98,14
7,r_79_143_131,seq82,r_35_146_68,r_35_146_68,0.74,63,131,68,14
23,r_38_130_81,seq36,r_97_131_83,r_38_130_81,1.0,2,83,81,14
82,seq91,r_90_57_152,seq95,r_90_57_152,0.92,0,152,152,14
35,r_51_44_101,r_49_135_150,seq43,r_49_135_150,0.56,-49,101,150,14
12,r_2_12_191,r_3_9_47,r_62_1_123,r_62_1_123,1.0,3,126,123,14
5,r_62_1_123,r_123_83_138,r_78_126_148,r_123_83_138,0.52,-123,15,138,14
45,r_136_55_37,r_142_116_59,r_127_53_29,r_142_116_59,0.99,-22,37,59,14
84,seq144,seq147,r_35_146_68,r_35_146_68,1.0,0,68,68,14
78,seq82,seq84,r_29_81_14,r_29_81_14,1.0,-1,13,14,14
21,r_97_131_83,r_98_52_175,r_38_130_81,r_38_130_81,0.76,3,84,81,14
93,seq110,r_111_116_129,r_61_112_26,r_61_112_26,0.84,82,108,26,15
30,r_80_71_183,r_82_140_157,seq84,r_82_140_157,0.87,0,157,157,15
36,r_32_66_188,r_31_4_145,r_146_36_18,r_32_66_188,0.58,-43,145,188,15
36,r_32_66_188,r_146_36_18,seq67,r_146_36_18,0.58,170,188,18,15
14,r_83_29_129,seq86,r_18_28_95,r_83_29_129,0.78,0,129,129,15
43,r_126_47_182,r_127_121_124,seq46,r_126_47_182,0.5,3,185,182,15
81,seq89,r_88_39_32,seq77,r_88_39_32,0.98,0,32,32,15
54,seq6,r_5_119_109,r_144_7_56,r_144_7_56,0.64,56,112,56,15
81,seq89,seq77,r_14_87_132,r_14_87_132,0.91,1,133,132,15
37,r_101_58_4,r_57_16_179,r_90_63_63,r_101_58_4,0.65,175,179,4,15
16,r_125_78_165,r_126_47_182,r_109_79_76,r_126_47_182,0.81,-17,165,182,15
46,r_52_8_65,r_53_40_114,seq6,r_52_8_65,0.92,0,65,65,15
42,r_109_79_76,seq107,seq77,r_109_79_76,0.95,10,86,76,15
35,r_1_108_45,seq0,seq107,r_1_108_45,0.99,0,45,45,15
45,r_134_15_110,r_136_148_114,seq21,r_134_15_110,0.82,0,110,110,15
19,r_136_148_114,seq135,seq149,r_136_148_114,0.99,1,115,114,15
8,r_144_7_56,r_143_117_86,seq6,r_144_7_56,1.0,3,59,56,15
95,seq115,r_114_25_113,r_111_116_129,r_114_25_113,0.99,0,113,113,15
66,seq42,r_41_35_187,r_53_40_114,r_53_40_114,0.97,75,189,114,15
31,r_129_147_166,r_127_121_124,r_81_145_136,r_127_121_124,0.52,42,166,124,15
67,seq44,r_45_139_83,seq42,r_45_139_83,1.0,0,83,83,15
3,r_57_16_179,r_101_58_4,r_134_15_110,r_101_58_4,0.44,175,179,4,15
48,r_19_65_26,r_20_13_174,r_68_93_170,r_19_65_26,0.98,2,28,26,15
44,r_143_117_86,seq149,seq115,r_143_117_86,0.95,1,87,86,15
4,r_114_25_113,seq115,seq24,r_114_25_113,0.98,0,113,113,15
78,seq77,r_72_34_193,r_109_79_76,r_109_79_76,0.5,8,84,76,15
0,r_10_26_118,seq9,r_18_28_95,r_10_26_118,0.8,0,118,118,15
63,seq24,seq27,r_114_25_113,r_114_25_113,1.0,0,113,113,15
11,r_45_139_83,seq44,seq138,r_45_139_83,1.0,0,83,83,15
99,seq149,r_146_36_18,r_143_117_86,r_146_36_18,0.85,1,19,18,15
20,r_90_63_63,seq91,r_19_65_26,r_90_63_63,0.97,1,64,63,15
13,r_33_118_87,r_31_4_145,seq123,r_33_118_87,0.89,0,87,87,15
46,r_52_8_65,seq6,r_137_12_93,r_137_12_93,0.95,54,147,93,15
15,r_130_54_28,r_127_121_124,seq55,r_130_54_28,0.91,9,37,28,15
6,r_85_98_90,seq86,seq97,r_85_98_90,0.94,1,91,90,15
62,seq23,r_30_43_165,seq46,r_30_43_165,0.53,-69,96,165,15
94,seq113,r_111_116_129,r_61_112_26,r_61_112_26,0.86,29,55,26,15
41,r_61_112_26,r_60_3_67,seq113,r_61_112_26,0.97,0,26,26,15
27,r_111_116_129,seq110,r_143_117_86,r_143_117_86,0.98,61,147,86,15
26,r_49_94_52,r_48_38_199,r_99_95_77,r_49_94_52,0.98,2,54,52,15
2,r_68_93_170,seq67,r_49_94_52,r_68_93_170,0.67,0,170,170,15
47,r_20_13_174,r_22_56_181,r_134_15_110,r_134_15_110,0.88,63,173,110,15
40,r_137_12_93,seq138,seq9,r_137_12_93,0.8,0,93,93,15
18,r_5_119_109,seq6,r_127_121_124,r_5_119_109,0.97,3,112,109,15
29,r_14_87_132,r_20_13_174,seq89,r_14_87_132,0.59,0,132,132,15
24,r_30_43_165,seq24,seq44,r_30_43_165,0.43,-3,162,165,15
25,r_59_64_114,seq62,r_90_63_63,r_90_63_63,0.97,46,109,63,15
33,r_17_132_146,r_20_13_174,r_76_133_124,r_17_132_146,0.75,0,146,146,15
48,r_19_65_26,r_68_93_170,r_90_63_63,r_19_65_26,0.79,91,117,26,15
70,seq51,r_14_87_132,r_72_34_193,r_72_34_193,0.77,-96,97,193,15
61,seq21,r_22_56_181,r_57_16_179,r_22_56_181,0.52,0,181,181,15
32,r_31_4_145,r_32_66_188,r_144_7_56,r_144_7_56,0.74,89,145,56,15
38,r_60_3_67,seq62,seq2,r_60_3_67,0.95,0,67,67,15
52,seq2,seq0,r_60_3_67,r_60_3_67,0.96,67,134,67,15
50,seq0,r_1_108_45,seq2,r_1_108_45,0.99,14,59,45,15
9,r_82_140_157,r_80_71_183,seq141,r_82_140_157,0.7,0,157,157,15
34,r_88_39_32,seq89,seq37,r_88_39_32,0.97,0,32,32,15
22,r_76_133_124,seq77,seq135,r_76_133_124,0.75,0,124,124,15
28,r_99_95_77,seq100,r_49_94_52,r_99_95_77,0.62,10,87,77,15
5,r_146_36_18,seq149,seq24,r_146_36_18,0.96,1,19,18,15
49,r_70_124_115,r_68_93_170,seq123,r_70_124_115,0.77,0,115,115,15
7,r_53_40_114,r_57_16_179,seq42,r_53_40_114,0.87,0,114,114,15
44,r_143_117_86,r_144_7_56,seq149,r_144_7_56,0.83,4,60,56,15
23,r_81_145_136,r_82_140_157,seq149,r_81_145_136,0.8,0,136,136,15
12,r_18_28_95,r_17_132_146,seq24,r_18_28_95,0.95,4,99,95,15
36,r_8_42_144,r_121_7_81,seq39,r_8_42_144,0.98,0,144,144,16
93,seq111,r_112_0_41,seq96,r_112_0_41,0.84,1,42,41,16
36,r_8_42_144,r_9_110_94,r_121_7_81,r_8_42_144,0.96,-50,94,144,16
8,r_137_46_143,r_138_128_149,seq48,r_137_46_143,0.52,0,143,143,16
46,r_112_0_41,seq111,r_8_42_144,r_112_0_41,1.0,1,42,41,16
53,seq134,seq139,r_59_133_65,r_59_133_65,1.0,8,73,65,16
34,r_37_43_141,seq31,r_15_45_160,r_15_45_160,0.62,0,160,160,16
43,r_61_68_160,seq60,seq69,r_61_68_160,0.4,1,161,160,16
54,seq136,r_135_20_112,seq139,r_135_20_112,1.0,0,112,112,16
15,r_19_141_34,seq13,seq139,r_19_141_34,1.0,1,35,34,16
37,r_71_130_181,seq74,r_44_129_134,r_71_130_181,0.29,0,181,181,16
59,seq16,seq14,r_36_17_104,r_36_17_104,1.0,24,128,104,16
71,seq60,r_61_68_160,r_94_62_60,r_94_62_60,1.0,86,146,60,16
16,r_22_27_86,r_24_3_106,r_88_28_21,r_22_27_86,0.61,0,86,86,16
39,r_135_20_112,seq136,r_36_17_104,r_135_20_112,0.96,0,112,112,16
1,r_9_110_94,r_8_42_144,seq111,r_9_110_94,1.0,1,95,94,16
5,r_59_133_65,r_61_68_160,seq134,r_59_133_65,1.0,0,65,65,16
32,r_30_79_174,r_88_28_21,r_73_87_171,r_88_28_21,0.75,153,174,21,16
69,seq55,r_73_87_171,r_6_56_83,r_6_56_83,0.71,1,84,83,16
13,r_44_129_134,r_24_3_106,seq48,r_24_3_106,0.99,-50,56,106,16
45,r_124_52_89,seq123,seq54,r_124_52_89,1.0,0,89,89,16
19,r_49_77_117,r_50_147_108,seq47,r_50_147_108,0.74,0,108,108,16
30,r_18_29_46,seq13,r_88_28_21,r_18_29_46,1.0,0,46,46,16
20,r_88_28_21,r_80_95_73,r_30_79_174,r_88_28_21,1.0,0,21,21,16
31,r_24_3_106,seq31,seq4,r_24_3_106,1.0,0,106,106,16
41,r_121_7_81,seq123,seq2,r_121_7_81,1.0,1,82,81,16
3,r_140_23_61,r_142_114_117,r_24_3_106,r_140_23_61,0.97,0,61,61,16
79,seq83,r_88_28_21,r_78_84_25,r_88_28_21,1.0,-1,20,21,16
26,r_53_58_128,seq54,seq60,r_53_58_128,0.77,0,128,128,16
14,r_108_131_57,r_19_141_34,r_44_129_134,r_44_129_134,1.0,10,144,134,16
4,r_119_89_92,seq117,seq93,r_119_89_92,1.0,1,93,92,16
0,r_142_114_117,seq139,r_86_120_21,r_142_114_117,0.5,0,117,117,16
63,seq31,r_38_21_198,r_70_34_169,r_70_34_169,0.95,4,173,169,16
11,r_15_45_160,seq12,r_37_43_141,r_37_43_141,0.43,19,160,141,16
46,r_112_0_41,r_8_42_144,seq1,r_8_42_144,0.95,-35,109,144,16
3,r_140_23_61,r_24_3_106,r_75_25_79,r_140_23_61,0.45,27,88,61,16
13,r_44_129_134,seq48,r_108_131_57,r_44_129_134,1.0,0,134,134,16
93,seq111,r_76_113_54,r_9_110_94,r_9_110_94,0.9,5,99,94,16
27,r_70_34_169,r_73_87_171,seq31,r_70_34_169,0.81,0,169,169,16
2,r_6_56_83,r_9_110_94,seq55,r_6_56_83,0.99,0,83,83,16
14,r_108_131_57,seq107,r_19_141_34,r_108_131_57,1.0,0,57,57,16
18,r_63_148_119,seq65,r_50_147_108,r_63_148_119,0.96,0,119,119,16
29,r_50_147_108,r_49_77_117,seq146,r_50_147_108,1.0,0,108,108,16
25,r_75_25_79,r_73_87_171,r_140_23_61,r_75_25_79,0.88,0,79,79,16
74,seq67,seq64,r_144_66_8,r_144_66_8,0.95,16,24,8,16
33,r_36_17_104,r_38_21_198,seq16,r_36_17_104,1.0,0,104,104,16
6,r_76_113_54,r_73_87_171,r_86_120_21,r_76_113_54,1.0,0,54,54,16
65,seq39,r_38_21_198,r_8_42_144,r_8_42_144,1.0,39,183,144,16
20,r_88_28_21,r_30_79_174,r_22_27_86,r_30_79_174,0.57,-49,125,174,16
68,seq54,r_53_58_128,r_124_52_89,r_124_52_89,1.0,53,142,89,16
32,r_30_79_174,r_26_10_157,r_88_28_21,r_30_79_174,0.77,-108,66,174,16
52,seq4,seq1,r_24_3_106,r_24_3_106,1.0,20,126,106,16
48,r_91_100_49,seq90,seq99,r_91_100_49,1.0,0,49,49,16
45,r_124_52_89,seq54,r_145_51_168,r_145_51_168,0.98,1,169,168,16
17,r_38_21_198,r_37_43_141,seq35,r_37_43_141,0.98,0,141,141,16
9,r_32_11_73,seq31,seq12,r_32_11_73,1.0,0,73,73,16
22,r_94_62_60,seq103,seq60,r_94_62_60,0.98,0,60,60,16
28,r_80_95_73,seq81,seq107,r_80_95_73,1.0,0,73,73,16
40,r_86_120_21,r_88_28_21,seq117,r_86_120_21,1.0,0,21,21,16
49,r_26_10_157,r_30_79_174,seq12,r_26_10_157,0.67,1,158,157,16
7,r_73_87_171,seq74,r_33_92_150,r_73_87_171,0.73,0,171,171,16
44,r_40_118_130,r_38_21_198,r_142_114_117,r_40_118_130,0.92,0,130,130,16
23,r_104_5_139,seq105,seq4,r_104_5_139,0.95,0,139,139,16
35,r_41_116_141,r_38_21_198,seq115,r_41_116_141,0.57,0,141,141,16
36,r_124_2_179,seq123,r_148_11_31,r_148_11_31,0.87,150,181,31,17
9,r_69_134_29,r_137_117_167,r_103_135_105,r_103_135_105,0.97,62,167,105,17
92,seq104,r_103_135_105,seq108,r_103_135_105,1.0,0,105,105,17
14,r_70_34_151,seq68,r_74_33_17,r_70_34_151,0.54,0,151,151,17
43,r_76_30_184,r_78_143_103,r_61_77_28,r_78_143_103,1.0,-21,82,103,17
37,r_145_107_114,seq149,seq108,r_145_107_114,1.0,0,114,114,17
31,r_74_33_17,seq73,seq35,r_74_33_17,0.87,-2,15,17,17
55,seq9,r_5_47_147,r_31_8_57,r_31_8_57,0.73,18,75,57,17
21,r_25_28_114,seq26,r_74_33_17,r_25_28_114,0.38,3,117,114,17
1,r_112_100_177,r_146_111_44,seq98,r_112_100_177,0.44,0,177,177,17
19,r_130_0_80,r_148_11_31,seq6,r_130_0_80,0.59,30,110,80,17
5,r_83_144_1,r_142_41_150,r_78_143_103,r_78_143_103,0.95,47,150,103,17
46,r_27_49_88,r_25_28_114,r_86_48_45,r_27_49_88,0.98,1,89,88,17
18,r_66_88_19,seq82,seq72,r_66_88_19,0.51,48,67,19,17
7,r_137_117_167,r_69_134_29,r_146_111_44,r_137_117_167,0.47,0,167,167,17
47,r_99_90_98,r_66_88_19,r_97_89_111,r_97_89_111,1.0,5,116,111,17
33,r_67_138_8,r_139_110_93,r_69_134_29,r_67_138_8,0.66,63,71,8,17
66,seq26,r_25_28_114,r_7_24_36,r_25_28_114,0.98,-15,99,114,17
38,r_121_147_182,seq118,r_106_141_59,r_106_141_59,0.82,122,181,59,17
45,r_31_8_57,r_37_32_69,seq9,r_31_8_57,1.0,0,57,57,17
41,r_127_39_64,seq128,seq40,r_127_39_64,1.0,1,65,64,17
89,seq95,r_96_52_147,seq98,r_96_52_147,0.9,17,164,147,17
6,r_148_11_31,seq149,seq10,r_148_11_31,1.0,0,31,31,17
3,r_37_32_69,seq35,r_12_29_123,r_12_29_123,0.87,6,129,123,17
90,seq98,r_97_89_111,seq95,r_97_89_111,1.0,3,114,111,17
26,r_103_135_105,seq104,r_69_134_29,r_103_135_105,1.0,0,105,105,17
4,r_122_56_67,r_121_147_182,seq58,r_122_56_67,1.0,0,67,67,17
0,r_43_113_135,seq42,seq114,r_43_113_135,0.89,0,135,135,17
11,r_51_109_172,seq50,seq108,r_51_109_172,0.35,0,172,172,17
2,r_139_110_93,seq116,r_51_109_172,r_139_110_93,0.53,96,189,93,17
13,r_115_126_150,seq114,seq123,r_115_126_150,0.92,0,150,150,17
15,r_86_48_45,seq82,seq50,r_86_48_45,0.54,10,55,45,17
48,r_78_143_103,seq79,r_83_144_1,r_78_143_103,0.98,0,103,103,17
40,r_7_24_36,r_5_47_147,seq26,r_5_47_147,0.63,-94,53,147,17
18,r_66_88_19,r_69_134_29,seq82,r_69_134_29,0.91,-7,22,29,17
22,r_125_84_99,r_67_138_8,r_18_85_13,r_125_84_99,1.0,0,99,99,17
99,seq123,r_124_2_179,r_115_126_150,r_115_126_150,0.96,32,182,150,17
34,r_106_141_59,seq108,seq140,r_106_141_59,1.0,0,59,59,17
1,r_112_100_177,r_115_126_150,r_146_111_44,r_146_111_44,1.0,2,46,44,17
16,r_61_77_28,r_64_87_73,r_76_30_184,r_64_87_73,0.54,-45,28,73,17
2,r_139_110_93,r_137_117_167,r_115_126_150,r_139_110_93,0.95,0,93,93,17
47,r_99_90_98,r_97_89_111,r_66_88_19,r_99_90_98,0.62,0,98,98,17
24,r_142_41_150,r_83_144_1,seq40,r_142_41_150,0.89,0,150,150,17
35,r_18_85_13,seq82,r_64_87_73,r_18_85_13,0.64,60,73,13,17
25,r_4_1_123,seq3,r_31_8_57,r_31_8_57,1.0,64,121,57,17
88,seq93,r_94_129_172,r_66_88_19,r_94_129_172,0.53,0,172,172,17
58,seq13,seq16,r_120_14_125,r_120_14_125,1.0,3,128,125,17
70,seq42,r_43_113_135,seq40,r_43_113_135,1.0,0,135,135,17
49,r_136_19_17,r_139_110_93,seq20,r_136_19_17,0.97,0,17,17,17
42,r_146_111_44,r_112_100_177,r_43_113_135,r_43_113_135,0.96,28,163,135,17
2,r_139_110_93,seq101,seq116,r_139_110_93,0.35,73,166,93,17
38,r_121_147_182,r_120_14_125,seq118,r_120_14_125,0.93,-21,104,125,17
35,r_18_85_13,r_22_36_120,seq82,r_18_85_13,0.87,0,13,13,17
75,seq58,r_57_102_178,r_122_56_67,r_122_56_67,1.0,10,77,67,17
17,r_22_36_120,seq23,seq38,r_22_36_120,0.67,0,120,120,17
94,seq108,seq105,r_145_107_114,r_145_107_114,1.0,23,137,114,17
9,r_69_134_29,r_70_34_151,r_137_117_167,r_69_134_29,0.99,0,29,29,17
2,r_139_110_93,r_115_126_150,seq101,r_115_126_150,0.74,-7,143,150,17
22,r_125_84_99,r_124_2_179,r_67_138_8,r_67_138_8,0.87,70,78,8,17
18,r_66_88_19,seq72,r_99_90_98,r_99_90_98,0.76,0,98,98,17
28,r_21_44_97,seq20,seq40,r_21_44_97,0.81,1,98,97,17
56,seq10,seq16,r_148_11_31,r_148_11_31,0.8,46,77,31,17
44,r_120_14_125,r_121_147_182,seq13,r_120_14_125,0.93,0,125,125,17
42,r_146_111_44,r_145_107_114,r_112_100_177,r_146_111_44,1.0,0,44,44,17
23,r_94_129_172,seq93,seq133,r_94_129_172,0.63,0,172,172,17
7,r_137_117_167,r_139_110_93,r_69_134_29,r_69_134_29,0.91,3,32,29,17
12,r_64_87_73,seq62,r_18_85_13,r_64_87_73,0.97,0,73,73,17
21,r_25_28_114,r_74_33_17,r_12_29_123,r_12_29_123,0.71,6,129,123,17
61,seq20,r_35_21_73,r_31_19_93,r_31_19_93,0.82,17,110,93,18
30,r_108_98_116,r_100_134_120,r_46_97_70,r_108_98_116,0.56,0,116,116,18
68,seq36,seq50,r_3_37_125,r_3_37_125,1.0,1,126,125,18
14,r_126_29_183,seq125,r_115_33_32,r_115_33_32,0.69,147,179,32,18
53,seq132,seq131,r_40_135_80,r_40_135_80,1.0,53,133,80,18
43,r_105_124_117,seq104,seq125,r_105_124_117,1.0,0,117,117,18
86,seq88,seq78,r_116_89_167,r_116_89_167,1.0,8,175,167,18
54,seq5,r_4_113_132,seq7,r_4_113_132,0.97,0,132,132,18
86,seq88,r_87_41_64,seq78,r_87_41_64,1.0,5,69,64,18
39,r_100_134_120,seq99,r_40_135_80,r_100_134_120,0.99,0,120,120,18
1,r_121_145_101,r_122_102_187,r_71_147_9,r_121_145_101,0.96,0,101,101,18
20,r_53_11_54,r_4_113_132,r_17_12_82,r_53_11_54,0.56,28,82,54,18
5,r_138_61_111,seq132,seq62,r_138_61_111,0.92,0,111,111,18
42,r_73_38_130,r_74_148_198,r_93_47_50,r_73_38_130,1.0,0,130,130,18
80,seq75,r_73_38_130,seq77,r_73_38_130,1.0,0,130,130,18
45,r_144_110_98,r_140_141_62,seq109,r_144_110_98,0.62,0,98,98,18
24,r_117_92_40,r_90_67_157,r_18_91_142,r_117_92_40,0.95,117,157,40,18
19,r_44_136_184,seq42,r_40_135_80,r_40_135_80,1.0,104,184,80,18
34,r_106_66_26,r_108_98_116,r_64_85_167,r_106_66_26,0.85,0,26,26,18
95,seq118,r_116_89_167,r_69_114_89,r_69_114_89,0.92,78,167,89,18
38,r_39_70_7,r_69_114_89,seq68,r_69_114_89,1.0,-12,77,89,18
31,r_31_19_93,r_32_81_170,seq20,r_31_19_93,0.83,0,93,93,18
41,r_137_72_62,r_138_61_111,seq75,r_137_72_62,0.97,0,62,62,18
67,seq34,r_32_81_170,r_115_33_32,r_115_33_32,0.69,26,58,32,18
37,r_128_139_48,r_126_29_183,seq131,r_128_139_48,0.35,0,48,48,18
3,r_17_12_82,r_18_91_142,r_53_11_54,r_17_12_82,0.48,1,83,82,18
26,r_40_135_80,seq43,r_128_139_48,r_40_135_80,1.0,0,80,80,18
44,r_35_21_73,seq20,seq26,r_35_21_73,0.27,27,100,73,18
33,r_65_123_192,r_90_67_157,r_44_136_184,r_90_67_157,0.52,38,195,157,18
0,r_6_83_163,seq7,seq84,r_6_83_163,0.87,0,163,163,18
11,r_4_113_132,seq5,seq112,r_4_113_132,0.89,0,132,132,18
13,r_87_41_64,seq88,seq42,r_87_41_64,0.99,0,64,64,18
46,r_59_130_50,r_129_142_180,r_40_135_80,r_40_135_80,1.0,93,173,80,18
15,r_90_67_157,r_117_92_40,r_106_66_26,r_106_66_26,0.52,128,154,26,18
12,r_18_91_142,seq16,r_117_92_40,r_18_91_142,0.98,0,142,142,18
21,r_69_114_89,r_39_70_7,seq118,r_69_114_89,1.0,0,89,89,18
36,r_71_147_9,r_121_145_101,r_76_146_154,r_121_145_101,0.95,55,156,101,18
4,r_133_80_32,r_144_110_98,seq78,r_133_80_32,1.0,0,32,32,18
6,r_93_47_50,seq95,seq48,r_93_47_50,1.0,0,50,50,18
2,r_3_37_125,r_4_113_132,seq36,r_3_37_125,0.91,0,125,125,18
40,r_129_142_180,seq131,r_59_130_50,r_59_130_50,1.0,19,69,50,18
18,r_32_81_170,r_31_19_93,r_115_33_32,r_32_81_170,0.48,-77,93,170,18
29,r_76_146_154,seq77,r_71_147_9,r_76_146_154,0.71,0,154,154,18
34,r_106_66_26,r_64_85_167,r_90_67_157,r_90_67_157,0.66,13,170,157,18
33,r_65_123_192,r_64_85_167,r_90_67_157,r_90_67_157,0.87,8,165,157,18
64,seq26,r_24_52_189,r_54_25_65,r_54_25_65,1.0,17,82,65,18
10,r_115_33_32,r_117_92_40,seq34,r_115_33_32,1.0,0,32,32,18
68,seq36,r_35_21_73,seq56,r_35_21_73,1.0,0,73,73,18
61,seq20,seq22,r_35_21_73,r_35_21_73,0.94,14,87,73,18
23,r_0_58_53,seq2,r_57_143_136,r_0_58_53,1.0,0,53,53,18
12,r_18_91_142,r_17_12_82,seq16,r_17_12_82,0.79,-45,37,82,18
52,seq131,seq132,r_40_135_80,r_40_135_80,1.0,23,103,80,18
47,r_45_94_13,r_53_11_54,seq95,r_45_94_13,1.0,0,13,13,18
46,r_59_130_50,seq63,r_129_142_180,r_59_130_50,1.0,0,50,50,18
17,r_122_102_187,r_121_145_101,seq120,r_121_145_101,1.0,0,101,101,18
22,r_57_143_136,r_0_58_53,r_140_141_62,r_57_143_136,1.0,0,136,136,18
22,r_57_143_136,seq56,r_0_58_53,r_0_58_53,1.0,26,79,53,18
28,r_46_97_70,seq48,seq99,r_46_97_70,1.0,0,70,70,18
24,r_117_92_40,seq118,r_90_67_157,r_117_92_40,0.99,0,40,40,18
49,r_54_25_65,seq56,seq26,r_54_25_65,1.0,0,65,65,18
7,r_140_141_62,r_144_110_98,r_40_135_80,r_40_135_80,1.0,11,91,80,18
18,r_32_81_170,r_115_33_32,seq78,r_32_81_170,0.84,0,170,170,18
44,r_35_21_73,seq36,seq20,r_35_21_73,0.99,0,73,73,18
32,r_101_60_17,r_108_98_116,seq62,r_101_60_17,0.95,0,17,17,18
35,r_64_85_167,r_65_123_192,r_6_83_163,r_64_85_167,0.64,0,167,167,18
92,seq109,r_121_145_101,r_144_110_98,r_121_145_101,1.0,-2,99,101,18
23,r_0_58_53,r_57_143_136,seq55,r_57_143_136,1.0,0,136,136,18
20,r_53_11_54,r_54_25_65,r_4_113_132,r_53_11_54,0.96,0,54,54,18
8,r_130_75_38,r_128_81_38,seq78,r_130_75_38,0.85,1,39,38,19
30,r_139_149_114,seq141,r_147_12_153,r_147_12_153,0.4,-39,114,153,19
19,r_7_98_15,r_6_10_18,seq96,r_7_98_15,0.78,0,15,15,19
14,r_100_0_84,r_102_148_162,seq2,r_100_0_84,0.99,0,84,84,19
43,r_102_148_162,seq103,r_139_149_114,r_102_148_162,0.61,0,162,162,19
37,r_42_32_133,r_43_40_125,r_94_31_78,r_43_40_125,0.56,8,133,125,19
5,r_6_10_18,seq1,r_11_54_115,r_6_10_18,0.96,-2,16,18,19
16,r_120_50_19,r_123_144_77,r_52_119_148,r_120_50_19,0.98,0,19,19,19
24,r_11_54_115,seq8,r_6_10_18,r_6_10_18,1.0,-2,16,18,19
46,r_94_31_78,r_95_76_154,seq30,r_94_31_78,1.0,0,78,78,19
42,r_58_108_90,r_55_37_90,seq109,r_58_108_90,0.91,0,90,90,19
80,seq78,seq77,r_130_75_38,r_130_75_38,1.0,27,65,38,19
1,r_128_81_38,r_130_75_38,r_51_80_25,r_128_81_38,0.6,-2,36,38,19
45,r_115_53_147,seq113,r_11_54_115,r_115_53_147,0.57,0,147,147,19
27,r_52_119_148,r_51_80_25,r_120_50_19,r_52_119_148,0.96,-123,25,148,19
36,r_56_59_23,r_64_25_41,r_105_62_5,r_64_25_41,0.99,-13,28,41,19
24,r_11_54_115,r_6_10_18,seq66,r_11_54_115,0.97,2,117,115,19
39,r_123_144_77,seq121,seq145,r_123_144_77,0.59,-30,47,77,19
12,r_83_104_18,seq84,seq103,r_83_104_18,0.72,-1,17,18,19
27,r_52_119_148,r_120_50_19,seq121,r_52_119_148,0.85,1,149,148,19
95,seq118,r_117_125_154,r_73_116_129,r_73_116_129,0.75,25,154,129,19
30,r_139_149_114,r_147_12_153,r_21_135_102,r_147_12_153,0.95,0,153,153,19
89,seq107,r_106_101_152,r_58_108_90,r_58_108_90,0.8,53,143,90,19
3,r_39_126_64,seq44,seq127,r_39_126_64,1.0,0,64,64,19
82,seq84,r_79_29_90,r_128_81_38,r_79_29_90,0.53,-35,55,90,19
90,seq109,r_106_101_152,r_58_108_90,r_58_108_90,0.81,8,98,90,19
16,r_120_50_19,r_52_119_148,r_4_49_108,r_4_49_108,0.96,41,149,108,19
83,seq85,r_79_29_90,r_14_87_2,r_79_29_90,1.0,-35,55,90,19
4,r_38_86_172,seq57,r_41_90_15,r_41_90_15,0.47,153,168,15,19
0,r_143_36_88,seq145,seq34,r_143_36_88,1.0,0,88,88,19
63,seq30,seq34,r_94_31_78,r_94_31_78,1.0,20,98,78,19
24,r_11_54_115,seq66,r_115_53_147,r_115_53_147,0.97,19,166,147,19
20,r_106_101_152,seq107,seq103,r_106_101_152,0.69,0,152,152,19
13,r_99_68_146,seq85,r_130_75_38,r_130_75_38,0.92,109,147,38,19
15,r_21_135_102,seq22,r_112_136_74,r_21_135_102,1.0,0,102,102,19
48,r_73_116_129,seq74,seq118,r_73_116_129,0.92,2,131,129,19
26,r_51_80_25,r_52_119_148,seq84,r_51_80_25,0.97,0,25,25,19
62,seq27,r_28_93_169,r_79_29_90,r_79_29_90,1.0,79,169,90,19
33,r_23_33_202,r_24_3_192,r_64_25_41,r_24_3_192,0.97,0,192,192,19
99,seq127,r_115_53_147,r_39_126_64,r_39_126_64,0.96,0,64,64,19
5,r_6_10_18,r_11_54_115,seq13,r_11_54_115,1.0,2,117,115,19
31,r_64_25_41,r_56_59_23,r_24_3_192,r_64_25_41,1.0,0,41,41,19
47,r_17_89_132,r_16_48_159,seq88,r_17_89_132,0.84,0,132,132,19
40,r_112_136_74,seq111,seq138,r_112_136_74,0.98,0,74,74,19
18,r_35_20_134,seq34,seq22,r_35_20_134,0.99,0,134,134,19
29,r_55_37_90,seq57,r_143_36_88,r_55_37_90,0.87,0,90,90,19
35,r_95_76_154,r_14_87_2,r_130_75_38,r_95_76_154,0.63,0,154,154,19
33,r_23_33_202,r_26_137_163,r_24_3_192,r_26_137_163,0.75,1,164,163,19
58,seq13,seq15,r_147_12_153,r_147_12_153,0.99,3,156,153,19
2,r_61_146_20,seq60,seq132,r_61_146_20,0.86,0,20,20,19
65,seq34,r_35_20_134,r_143_36_88,r_143_36_88,0.78,46,134,88,19
61,seq22,r_21_135_102,r_19_18_102,r_21_135_102,1.0,0,102,102,19
32,r_43_40_125,r_42_32_133,seq44,r_42_32_133,1.0,0,133,133,19
38,r_131_82_99,seq132,seq84,r_131_82_99,0.91,0,99,99,19
6,r_79_29_90,r_94_31_78,r_128_81_38,r_128_81_38,0.55,-2,36,38,19
34,r_117_125_154,seq118,r_39_126_64,r_39_126_64,1.0,92,156,64,19
60,seq145,r_143_36_88,r_123_144_77,r_143_36_88,1.0,0,88,88,19
9,r_147_12_153,seq132,r_139_149_114,r_147_12_153,0.35,-33,120,153,19
31,r_64_25_41,r_24_3_192,r_23_33_202,r_24_3_192,0.51,-6,186,192,19
6,r_79_29_90,r_128_81_38,seq27,r_79_29_90,1.0,0,90,90,19
17,r_41_90_15,r_39_126_64,seq88,r_41_90_15,0.61,0,15,15,19
22,r_28_93_169,seq27,r_41_90_15,r_28_93_169,0.55,0,169,169,19
9,r_147_12_153,r_139_149_114,seq13,r_147_12_153,1.0,0,153,153,19
28,r_16_48_159,r_17_89_132,seq15,r_17_89_132,1.0,0,132,132,19
49,r_26_137_163,r_24_3_192,r_21_135_102,r_24_3_192,0.53,-28,164,192,19
56,seq8,seq15,r_6_10_18,r_6_10_18,0.56,45,63,18,19
7,r_9_97_113,seq15,r_7_98_15,r_9_97_113,0.99,0,113,113,19
44,r_24_3_192,r_26_137_163,r_23_33_202,r_26_137_163,0.78,1,164,163,19
23,r_4_49_108,seq5,r_120_50_19,r_4_49_108,0.99,0,108,108,19
28,r_16_48_159,seq15,r_120_50_19,r_16_48_159,0.96,0,159,159,19
79,seq77,seq78,r_130_75_38,r_130_75_38,0.99,49,87,38,19
35,r_95_76_154,r_94_31_78,r_14_87_2,r_94_31_78,1.0,0,78,78,19
87,seq96,r_79_29_90,r_7_98_15,r_79_29_90,0.73,-64,26,90,19
24,r_118_30_111,r_125_40_69,r_47_121_36,r_47_121_36,0.75,0,36,36,20
30,r_69_75_80,seq67,r_55_76_25,r_69_75_80,0.59,0,80,80,20
36,r_26_138_63,r_29_120_126,seq141,r_26_138_63,1.0,0,63,63,20
19,r_47_121_36,r_54_25_50,r_118_30_111,r_47_121_36,1.0,0,36,36,20
14,r_72_77_179,r_74_117_207,r_69_75_80,r_69_75_80,1.0,99,179,80,20
8,r_133_6_125,r_135_70_186,r_7_100_209,r_133_6_125,0.93,0,125,125,20
43,r_50_106_171,seq51,seq105,r_50_106_171,0.63,0,171,171,20
54,seq137,r_140_86_182,r_35_136_143,r_35_136_143,0.99,3,146,143,20
3,r_42_110_195,r_66_41_15,seq108,r_42_110_195,0.33,0,195,195,20
19,r_47_121_36,r_118_30_111,r_145_119_104,r_47_121_36,1.0,76,112,36,20
55,seq10,r_9_0_199,r_34_8_148,r_34_8_148,1.0,44,192,148,20
16,r_113_39_79,r_115_18_173,r_125_40_69,r_115_18_173,0.98,-93,80,173,20
5,r_45_107_134,seq46,seq108,r_45_107_134,0.89,0,134,134,20
46,r_98_84_182,seq99,seq83,r_98_84_182,0.72,0,182,182,20
7,r_135_70_186,r_11_131_59,r_109_60_9,r_135_70_186,0.64,0,186,186,20
45,r_116_94_60,r_125_40_69,seq93,r_125_40_69,1.0,-7,62,69,20
25,r_124_102_40,r_125_40_69,r_127_101_23,r_125_40_69,0.99,-28,41,69,20
41,r_55_76_25,r_54_25_50,seq78,r_55_76_25,0.99,0,25,25,20
24,r_118_30_111,r_47_121_36,seq31,r_118_30_111,0.92,1,112,111,20
27,r_37_22_194,r_125_40_69,r_115_18_173,r_115_18_173,0.78,21,194,173,20
66,seq31,seq32,r_118_30_111,r_118_30_111,1.0,11,122,111,20
37,r_66_41_15,r_69_75_80,r_42_110_195,r_66_41_15,0.94,0,15,15,20
20,r_11_131_59,seq14,r_135_70_186,r_11_131_59,1.0,0,59,59,20
42,r_48_15_106,seq16,r_134_17_116,r_48_15_106,0.3,47,153,106,20
26,r_134_17_116,r_133_6_125,r_49_24_45,r_134_17_116,0.99,0,116,116,20
4,r_128_95_162,seq126,seq92,r_128_95_162,0.34,14,176,162,20
0,r_144_123_74,r_140_86_182,seq126,r_144_123_74,1.0,0,74,74,20
63,seq141,r_140_86_182,r_103_139_89,r_103_139_89,1.0,93,182,89,20
6,r_145_119_104,seq146,r_47_121_36,r_145_119_104,1.0,0,104,104,20
31,r_132_44_20,r_135_70_186,seq46,r_132_44_20,0.93,0,20,20,20
27,r_37_22_194,r_29_120_126,r_125_40_69,r_37_22_194,0.84,-109,85,194,20
39,r_54_25_50,seq27,seq38,r_54_25_50,0.47,38,88,50,20
21,r_148_62_18,r_149_147_7,seq64,r_148_62_18,1.0,0,18,18,20
2,r_125_40_69,seq126,r_66_41_15,r_125_40_69,1.0,0,69,69,20
49,r_49_24_45,r_48_15_106,seq20,r_49_24_45,1.0,0,45,45,20
41,r_55_76_25,seq78,r_69_75_80,r_69_75_80,1.0,34,114,80,20
47,r_89_12_101,seq88,seq13,r_89_12_101,1.0,0,101,101,20
3,r_42_110_195,seq38,r_66_41_15,r_66_41_15,0.96,12,27,15,20
29,r_114_53_142,r_115_18_173,seq52,r_114_53_142,0.95,0,142,142,20
48,r_112_3_25,seq108,seq4,r_112_3_25,0.57,0,25,25,20
88,seq88,r_89_12_101,seq104,r_89_12_101,0.99,-12,89,101,20
40,r_59_143_19,seq61,seq141,r_59_143_19,0.98,-1,18,19,20
20,r_11_131_59,r_135_70_186,r_35_136_143,r_35_136_143,1.0,38,181,143,20
32,r_140_86_182,seq141,seq87,r_140_86_182,0.32,0,182,182,20
12,r_96_33_126,r_116_94_60,seq32,r_96_33_126,1.0,0,126,126,20
17,r_115_18_173,seq108,r_49_24_45,r_115_18_173,0.6,1,174,173,20
94,seq104,r_103_139_89,seq105,r_103_139_89,1.0,1,90,89,20
22,r_103_139_89,seq104,r_26_138_63,r_103_139_89,0.98,1,90,89,20
73,seq56,r_148_62_18,r_114_53_142,r_114_53_142,0.93,25,167,142,20
91,seq93,r_96_33_126,r_116_94_60,r_96_33_126,0.82,-41,85,126,20
10,r_127_101_23,r_128_95_162,seq99,r_127_101_23,0.64,2,25,23,20
7,r_135_70_186,r_133_6_125,r_11_131_59,r_11_131_59,0.71,66,125,59,20
44,r_23_130_196,seq20,r_128_95_162,r_23_130_196,0.3,0,196,196,20
23,r_35_136_143,r_34_8_148,seq137,r_35_136_143,0.98,0,143,143,20
35,r_142_57_61,r_144_123_74,r_109_60_9,r_142_57_61,1.0,0,61,61,20
12,r_96_33_126,seq93,r_116_94_60,r_116_94_60,0.84,24,84,60,20
39,r_54_25_50,r_48_15_106,seq27,r_54_25_50,0.74,0,50,50,20
30,r_13_56_175,seq12,r_146_60_170,r_146_60_170,0.58,3,173,170,21
51,seq4,r_6_33_146,seq2,r_6_33_146,1.0,-35,111,146,21
36,r_10_80_119,seq12,seq77,r_10_80_119,0.94,0,119,119,21
14,r_149_58_164,seq148,r_67_62_108,r_149_58_164,0.77,0,164,164,21
43,r_144_131_106,r_146_60_170,seq132,r_146_60_170,0.53,-64,106,170,21
37,r_135_55_131,seq134,seq54,r_135_55_131,0.97,0,131,131,21
31,r_49_133_108,r_47_121_44,r_11_50_43,r_49_133_108,0.95,-65,43,108,21
21,r_130_29_151,seq132,r_70_32_115,r_130_29_151,0.86,0,151,151,21
39,r_30_119_99,r_31_39_66,r_79_25_5,r_30_119_99,0.39,-32,67,99,21
1,r_6_33_146,r_3_118_135,seq2,r_3_118_135,0.82,-42,93,135,21
97,seq148,r_149_58_164,r_1_143_94,r_1_143_94,0.99,69,163,94,21
12,r_19_68_30,r_21_36_164,seq69,r_19_68_30,0.98,0,30,30,21
34,r_73_122_23,seq126,r_115_123_38,r_115_123_38,1.0,1,39,38,21
8,r_72_120_60,r_81_74_33,r_115_123_38,r_72_120_60,1.0,0,60,60,21
32,r_115_123_38,seq114,r_73_122_23,r_115_123_38,0.99,0,38,38,21
15,r_11_50_43,r_49_133_108,seq48,r_49_133_108,1.0,0,108,108,21
22,r_145_99_31,r_146_60_170,seq105,r_145_99_31,0.99,0,31,31,21
16,r_97_64_18,seq96,seq63,r_97_64_18,0.91,0,18,18,21
10,r_37_0_180,seq38,seq4,r_37_0_180,0.26,0,180,180,21
8,r_72_120_60,r_73_122_23,r_81_74_33,r_72_120_60,0.77,-37,23,60,21
26,r_57_136_133,seq59,r_49_133_108,r_57_136_133,1.0,0,133,133,21
0,r_28_83_62,r_26_24_55,seq82,r_28_83_62,1.0,0,62,62,21
63,seq132,r_130_29_151,r_144_131_106,r_130_29_151,0.51,-42,109,151,21
42,r_16_113_181,r_19_68_30,seq22,r_19_68_30,0.4,16,46,30,21
11,r_86_94_71,r_85_124_104,seq92,r_86_94_71,1.0,0,71,71,21
20,r_67_62_108,r_70_32_115,seq59,r_67_62_108,0.85,1,109,108,21
13,r_3_118_135,r_6_33_146,r_85_124_104,r_3_118_135,0.68,0,135,135,21
48,r_147_128_156,r_149_58_164,r_46_129_99,r_46_129_99,0.82,57,156,99,21
94,seq114,r_115_123_38,seq116,r_115_123_38,1.0,-5,33,38,21
6,r_112_15_123,seq110,seq14,r_112_15_123,0.98,0,123,123,21
62,seq22,seq18,r_79_25_5,r_79_25_5,0.76,106,111,5,21
39,r_30_119_99,r_79_25_5,r_72_120_60,r_30_119_99,1.0,0,99,99,21
15,r_11_50_43,r_10_80_119,r_49_133_108,r_11_50_43,0.99,0,43,43,21
99,seq127,seq126,r_46_129_99,r_46_129_99,1.0,8,107,99,21
24,r_81_74_33,r_72_120_60,seq22,r_72_120_60,0.68,1,61,60,21
59,seq14,r_13_56_175,r_112_15_123,r_112_15_123,0.81,1,124,123,21
23,r_90_34_2,r_21_36_164,seq40,r_90_34_2,0.51,110,112,2,21
4,r_41_142_49,seq40,seq141,r_41_142_49,1.0,0,49,49,21
2,r_125_78_137,seq127,r_10_80_119,r_125_78_137,0.69,0,137,137,21
47,r_5_53_110,r_6_33_146,seq51,r_5_53_110,0.91,0,110,110,21
40,r_89_87_154,seq91,r_10_80_119,r_10_80_119,0.92,15,134,119,21
33,r_17_44_118,seq22,seq45,r_17_44_118,0.57,0,118,118,21
23,r_90_34_2,seq40,r_6_33_146,r_6_33_146,0.47,3,149,146,21
1,r_6_33_146,seq2,r_90_34_2,r_6_33_146,0.91,0,146,146,21
50,seq2,r_1_143_94,seq4,r_1_143_94,1.0,-1,93,94,21
58,seq141,r_146_60_170,r_1_143_94,r_1_143_94,1.0,11,105,94,21
65,seq38,r_37_0_180,r_11_50_43,r_11_50_43,1.0,137,180,43,21
68,seq45,r_43_98_192,r_17_44_118,r_17_44_118,0.59,0,118,118,21
42,r_16_113_181,r_11_50_43,r_88_111_36,r_16_113_181,0.93,0,181,181,21
42,r_16_113_181,seq22,r_11_50_43,r_11_50_43,0.34,84,127,43,21
76,seq63,r_67_62_108,r_97_64_18,r_97_64_18,0.94,1,19,18,21
46,r_138_65_50,r_135_55_131,r_97_64_18,r_138_65_50,0.94,0,50,50,21
24,r_81_74_33,r_138_65_50,r_17_44_118,r_81_74_33,0.57,139,172,33,21
24,r_81_74_33,seq22,r_138_65_50,r_138_65_50,0.42,104,154,50,21
31,r_49_133_108,r_11_50_43,seq134,r_49_133_108,1.0,0,108,108,21
34,r_73_122_23,r_72_120_60,seq126,r_73_122_23,0.74,-2,21,23,21
44,r_70_32_115,r_31_39_66,r_130_29_151,r_130_29_151,0.6,14,165,151,21
24,r_81_74_33,seq82,r_72_120_60,r_81_74_33,0.88,-1,32,33,21
49,r_31_39_66,r_30_119_99,seq42,r_30_119_99,0.83,-32,67,99,21
7,r_1_143_94,seq2,seq148,r_1_143_94,1.0,0,94,94,21
44,r_70_32_115,seq69,r_31_39_66,r_70_32_115,0.76,0,115,115,21
23,r_90_34_2,r_43_98_192,r_21_36_164,r_43_98_192,0.31,-110,82,192,21
19,r_88_111_36,r_85_124_104,seq110,r_88_111_36,1.0,1,37,36,21
35,r_109_104_84,seq108,seq105,r_109_104_84,0.87,0,84,84,21
38,r_101_66_58,seq100,r_97_64_18,r_101_66_58,1.0,0,58,58,21
84,seq92,seq95,r_86_94_71,r_86_94_71,1.0,20,91,71,21
45,r_47_121_44,seq48,r_115_123_38,r_47_121_44,1.0,0,44,44,21
41,r_60_93_45,r_61_48_101,r_84_13_94,r_60_93_45,1.0,0,45,45,22
40,r_55_6_14,seq4,seq2,r_55_6_14,0.35,79,93,14,22
33,r_58_25_45,seq59,r_24_47_91,r_58_25_45,0.93,0,45,45,22
30,r_24_47_91,seq35,seq51,r_24_47_91,0.49,0,91,91,22
41,r_60_93_45,r_84_13_94,r_1_94_56,r_84_13_94,0.81,-19,75,94,22
8,r_49_104_117,seq51,r_3_106_75,r_49_104_117,0.58,0,117,117,22
49,r_114_5_154,seq109,r_55_6_14,r_114_5_154,1.0,0,154,154,22
37,r_66_78_101,seq63,r_134_77_12,r_66_78_101,0.96,1,102,101,22
21,r_102_46_174,r_103_45_111,r_105_101_95,r_102_46_174,0.99,-63,111,174,22
39,r_103_45_111,r_102_46_174,r_24_47_91,r_103_45_111,0.95,0,111,111,22
1,r_92_87_194,r_1_94_56,r_134_77_12,r_1_94_56,0.25,141,197,56,22
5,r_148_67_75,r_149_23_185,seq68,r_148_67_75,1.0,0,75,75,22
42,r_136_37_104,seq137,seq36,r_136_37_104,1.0,0,104,104,22
45,r_42_74_185,r_38_32_187,r_132_70_47,r_42_74_185,0.26,0,185,185,22
2,r_131_11_83,seq14,r_7_9_132,r_131_11_83,0.59,44,127,83,22
11,r_3_106_75,r_126_124_36,r_49_104_117,r_49_104_117,0.99,8,125,117,22
76,seq54,r_61_48_101,seq56,r_61_48_101,0.71,0,101,101,22
18,r_134_77_12,r_132_70_47,seq79,r_134_77_12,0.69,0,12,12,22
84,seq79,r_92_87_194,r_134_77_12,r_134_77_12,0.83,37,49,12,22
3,r_113_53_111,r_114_5_154,seq54,r_113_53_111,0.91,0,111,111,22
10,r_105_101_95,r_113_53_111,seq99,r_105_101_95,1.0,1,96,95,22
35,r_57_122_55,seq56,r_120_115_143,r_57_122_55,1.0,0,55,55,22
50,seq0,r_1_94_56,seq14,r_1_94_56,1.0,0,56,56,22
9,r_139_133_18,r_138_144_160,seq137,r_139_133_18,0.52,21,39,18,22
11,r_3_106_75,seq4,r_105_101_95,r_3_106_75,0.7,0,75,75,22
11,r_3_106_75,r_105_101_95,r_126_124_36,r_105_101_95,0.9,0,95,95,22
47,r_120_115_143,r_121_30_54,r_57_122_55,r_120_115_143,1.0,-89,54,143,22
48,r_43_119_61,r_42_74_185,seq118,r_43_119_61,1.0,0,61,61,22
81,seq68,r_66_78_101,r_107_69_40,r_107_69_40,0.84,8,48,40,22
0,r_116_140_13,r_113_53_111,seq143,r_116_140_13,0.78,0,13,13,22
21,r_102_46_174,r_105_101_95,r_61_48_101,r_102_46_174,0.99,0,174,174,22
15,r_1_94_56,seq0,r_60_93_45,r_1_94_56,0.99,0,56,56,22
23,r_88_142_27,r_92_87_194,seq141,r_88_142_27,1.0,0,27,27,22
24,r_130_62_158,seq137,seq56,r_130_62_158,0.84,0,158,158,22
27,r_61_48_101,seq54,r_24_47_91,r_24_47_91,0.77,10,101,91,22
26,r_121_30_54,r_120_115_143,seq29,r_121_30_54,1.0,0,54,54,22
1,r_92_87_194,r_84_13_94,r_1_94_56,r_92_87_194,1.0,-141,53,194,22
2,r_131_11_83,r_136_37_104,seq14,r_131_11_83,0.87,0,83,83,22
53,seq4,r_7_9_132,r_55_6_14,r_55_6_14,1.0,0,14,14,22
35,r_57_122_55,r_120_115_143,seq123,r_57_122_55,0.43,92,147,55,22
25,r_39_90_159,r_38_32_187,r_60_93_45,r_38_32_187,0.7,-28,159,187,22
36,r_95_40_152,r_100_10_189,seq41,r_95_40_152,1.0,0,152,152,22
64,seq26,r_27_15_182,r_75_44_1,r_75_44_1,0.77,181,182,1,22
46,r_50_64_57,seq51,seq65,r_50_64_57,0.99,0,57,57,22
47,r_120_115_143,r_57_122_55,r_43_119_61,r_120_115_143,0.4,26,169,143,22
58,seq14,seq4,r_84_13_94,r_84_13_94,1.0,0,94,94,22
65,seq29,r_27_15_182,r_121_30_54,r_121_30_54,1.0,25,79,54,22
77,seq56,r_57_122_55,seq59,r_57_122_55,1.0,0,55,55,22
38,r_138_144_160,seq143,r_116_140_13,r_116_140_13,0.85,145,158,13,22
52,seq2,r_3_106_75,r_55_6_14,r_3_106_75,0.99,0,75,75,22
40,r_55_6_14,seq54,seq4,r_55_6_14,0.96,0,14,14,22
14,r_82_20_51,seq83,seq18,r_82_20_51,1.0,0,51,51,22
6,r_107_69_40,r_126_124_36,seq68,r_107_69_40,1.0,0,40,40,22
96,seq117,r_114_5_154,r_43_119_61,r_43_119_61,0.99,55,116,61,22
28,r_7_9_132,seq8,r_131_11_83,r_131_11_83,1.0,52,135,83,22
91,seq99,r_100_10_189,r_28_97_182,r_100_10_189,0.1,-5,184,189,22
49,r_114_5_154,r_113_53_111,seq109,r_113_53_111,1.0,0,111,111,22
19,r_132_70_47,r_136_37_104,seq71,r_132_70_47,1.0,0,47,47,22
32,r_76_108_17,r_92_87_194,seq109,r_76_108_17,1.0,0,17,17,22
12,r_84_13_94,seq85,seq14,r_84_13_94,0.97,1,95,94,22
36,r_138_17_139,seq140,seq15,r_138_17_139,0.66,0,139,139,23
13,r_121_59_23,r_122_47_166,seq60,r_121_59_23,0.85,1,24,23,23
11,r_57_39_98,seq56,r_139_38_19,r_57_39_98,0.53,0,98,98,23
8,r_142_27_115,r_141_116_115,seq28,r_142_27_115,0.97,0,115,115,23
37,r_87_107_86,seq88,seq109,r_87_107_86,0.84,1,87,86,23
59,seq145,r_146_69_133,seq147,r_146_69_133,0.67,0,133,133,23
55,seq9,r_13_98_127,r_24_6_140,r_13_98_127,0.9,-1,126,127,23
86,seq88,r_87_107_86,seq91,r_87_107_86,0.65,6,92,86,23
16,r_128_117_78,r_129_125_162,seq114,r_128_117_78,0.38,0,78,78,23
21,r_146_69_133,seq145,seq68,r_146_69_133,0.6,0,133,133,23
1,r_118_26_66,seq111,seq28,r_118_26_66,0.94,1,67,66,23
5,r_16_124_166,r_24_6_140,r_129_125_162,r_16_124_166,0.63,0,166,166,23
46,r_141_116_115,r_142_27_115,r_128_117_78,r_141_116_115,0.86,0,115,115,23
45,r_58_11_75,r_57_39_98,seq9,r_58_11_75,1.0,0,75,75,23
19,r_131_73_71,seq130,r_70_29_107,r_131_73_71,0.83,0,71,71,23
33,r_122_47_166,seq114,r_79_46_105,r_122_47_166,0.97,0,166,166,23
19,r_131_73_71,r_77_8_181,r_106_72_177,r_77_8_181,0.99,-1,180,181,23
89,seq94,r_97_134_189,r_123_95_89,r_123_95_89,0.95,58,147,89,23
47,r_119_65_28,r_120_67_108,seq63,r_119_65_28,0.76,0,28,28,23
3,r_106_72_177,seq109,r_131_73_71,r_106_72_177,0.39,0,177,177,23
38,r_13_98_127,seq91,r_25_100_157,r_25_100_157,1.0,5,162,157,23
4,r_10_108_113,seq9,seq109,r_10_108_113,0.93,0,113,113,23
78,seq68,seq66,r_146_69_133,r_146_69_133,0.98,0,133,133,23
0,r_120_67_108,r_122_47_166,seq68,r_120_67_108,0.89,0,108,108,23
63,seq28,r_25_100_157,r_142_27_115,r_142_27_115,0.61,16,131,115,23
92,seq103,r_104_34_46,r_85_105_43,r_104_34_46,0.71,0,46,46,23
11,r_57_39_98,r_58_11_75,seq56,r_58_11_75,0.93,0,75,75,23
20,r_70_29_107,r_74_82_102,r_43_30_67,r_70_29_107,0.86,0,107,107,23
15,r_44_64_191,seq45,r_148_62_140,r_148_62_140,0.94,51,191,140,23
6,r_48_99_192,seq49,r_25_100_157,r_25_100_157,0.5,35,192,157,23
19,r_131_73_71,r_70_29_107,r_77_8_181,r_70_29_107,0.58,0,107,107,23
29,r_143_32_31,r_144_41_29,seq31,r_143_32_31,0.93,-2,29,31,23
27,r_79_46_105,r_78_12_155,seq49,r_79_46_105,0.95,0,105,105,23
12,r_112_52_48,seq110,seq53,r_112_52_48,0.72,0,48,48,23
2,r_71_133_75,r_74_82_102,seq130,r_71_133_75,0.96,0,75,75,23
18,r_74_82_102,r_70_29_107,seq83,r_74_82_102,0.95,0,102,102,23
25,r_149_0_199,r_148_62_140,seq147,r_148_62_140,0.7,0,140,140,23
33,r_122_47_166,r_120_67_108,seq114,r_120_67_108,0.94,-3,105,108,23
65,seq35,r_33_37_193,r_104_34_46,r_104_34_46,0.98,86,132,46,23
42,r_139_38_19,seq36,r_57_39_98,r_57_39_98,1.0,42,140,98,23
32,r_20_113_169,seq19,r_128_117_78,r_20_113_169,0.64,0,169,169,23
39,r_85_105_43,seq86,seq103,r_85_105_43,0.76,9,52,43,23
38,r_13_98_127,seq9,seq91,r_13_98_127,0.65,0,127,127,23
64,seq31,r_33_37_193,r_143_32_31,r_143_32_31,0.71,28,59,31,23
44,r_144_41_29,r_143_32_31,r_92_42_4,r_144_41_29,0.78,0,29,29,23
48,r_104_34_46,seq103,seq35,r_104_34_46,0.99,0,46,46,23
24,r_61_55_33,seq60,r_23_89_1,r_61_55_33,0.43,0,33,33,23
17,r_43_30_67,r_92_42_4,r_143_32_31,r_43_30_67,0.96,0,67,67,23
24,r_61_55_33,r_23_89_1,seq56,r_61_55_33,0.75,16,49,33,23
9,r_97_134_189,seq96,r_71_133_75,r_71_133_75,0.9,114,189,75,23
49,r_21_132_67,r_24_6_140,seq130,r_21_132_67,0.99,0,67,67,23
72,seq54,r_120_67_108,r_61_55_33,r_120_67_108,0.66,-59,49,108,23
7,r_78_12_155,r_77_8_181,r_24_6_140,r_24_6_140,0.96,13,153,140,23
24,r_61_55_33,seq54,seq56,r_61_55_33,0.43,136,169,33,23
23,r_148_62_140,r_149_0_199,r_119_65_28,r_148_62_140,0.87,0,140,140,23
82,seq83,seq86,r_74_82_102,r_74_82_102,0.77,10,112,102,23
42,r_139_38_19,r_142_27_115,seq36,r_139_38_19,0.69,-1,18,19,23
35,r_33_37_193,seq35,seq36,r_33_37_193,0.29,1,194,193,23
31,r_51_1_19,seq53,seq3,r_51_1_19,0.86,0,19,19,23
30,r_129_149_154,seq128,r_13_147_111,r_13_147_111,1.0,42,153,111,24
4,r_30_134_43,r_125_7_132,r_55_132_48,r_30_134_43,0.82,21,64,43,24
8,r_99_96_135,r_102_2_167,r_5_95_150,r_99_96_135,0.57,32,167,135,24
43,r_111_20_202,seq106,r_99_96_135,r_99_96_135,0.39,-41,94,135,24
47,r_5_95_150,r_62_6_86,r_99_96_135,r_5_95_150,0.99,0,150,150,24
59,seq16,r_15_51_153,r_67_18_110,r_67_18_110,0.97,0,110,110,24
49,r_17_39_30,seq16,seq37,r_17_39_30,0.99,1,31,30,24
16,r_77_38_143,seq81,r_56_76_29,r_56_76_29,0.98,29,58,29,24
21,r_103_124_61,r_99_96_135,r_125_7_132,r_103_124_61,0.99,0,61,61,24
39,r_19_3_59,r_27_143_191,r_136_4_49,r_19_3_59,1.0,0,59,59,24
1,r_44_75_184,seq35,r_42_86_35,r_42_86_35,0.87,152,187,35,24
5,r_125_7_132,r_120_24_180,r_62_6_86,r_125_7_132,1.0,0,132,132,24
5,r_125_7_132,r_129_149_154,r_120_24_180,r_120_24_180,0.7,-91,89,180,24
46,r_57_66_81,r_54_98_186,seq65,r_57_66_81,0.94,0,81,81,24
42,r_34_108_60,r_40_46_177,seq110,r_34_108_60,1.0,0,60,60,24
33,r_122_85_38,r_125_7_132,seq78,r_122_85_38,0.87,0,38,38,24
32,r_56_76_29,r_77_38_143,r_42_86_35,r_77_38_143,0.98,0,143,143,24
45,r_109_73_127,seq110,seq71,r_109_73_127,0.96,1,128,127,24
21,r_103_124_61,r_125_7_132,r_92_126_102,r_125_7_132,0.48,-14,118,132,24
19,r_74_83_94,seq71,seq82,r_74_83_94,0.99,0,94,94,24
33,r_122_85_38,seq78,r_42_86_35,r_122_85_38,0.47,101,139,38,24
7,r_15_51_153,r_14_8_200,r_84_53_17,r_84_53_17,0.95,136,153,17,24
31,r_13_147_111,seq12,seq145,r_13_147_111,0.97,0,111,111,24
41,r_139_41_160,r_121_140_7,seq43,r_139_41_160,0.51,0,160,160,24
3,r_121_140_7,r_139_41_160,seq138,r_139_41_160,1.0,0,160,160,24
26,r_62_6_86,r_67_18_110,r_136_4_49,r_62_6_86,1.0,0,86,86,24
72,seq60,r_118_58_3,r_0_59_105,r_0_59_105,1.0,13,118,105,24
16,r_77_38_143,r_56_76_29,r_17_39_30,r_77_38_143,1.0,0,143,143,24
0,r_67_18_110,seq65,seq16,r_67_18_110,0.83,0,110,110,24
63,seq25,r_26_100_130,seq23,r_26_100_130,1.0,0,130,130,24
98,seq119,r_120_24_180,r_49_131_78,r_49_131_78,1.0,76,154,78,24
48,r_26_100_130,seq25,r_99_96_135,r_26_100_130,1.0,0,130,130,24
36,r_84_53_17,r_87_50_116,seq52,r_84_53_17,0.71,0,17,17,24
20,r_55_132_48,r_54_98_186,r_30_134_43,r_55_132_48,0.92,0,48,48,24
27,r_146_72_198,seq145,r_109_73_127,r_109_73_127,0.86,71,198,127,24
79,seq71,seq70,r_109_73_127,r_109_73_127,1.0,32,159,127,24
2,r_92_126_102,r_93_112_155,r_103_124_61,r_93_112_155,1.0,-53,102,155,24
47,r_5_95_150,r_0_59_105,r_62_6_86,r_5_95_150,0.72,-45,105,150,24
40,r_130_137_93,r_129_149_154,seq135,r_129_149_154,0.62,-61,93,154,24
18,r_104_91_140,seq105,r_99_96_135,r_104_91_140,0.79,19,159,140,24
29,r_49_131_78,r_57_66_81,seq128,r_49_131_78,1.0,0,78,78,24
4,r_30_134_43,seq32,r_125_7_132,r_30_134_43,0.69,0,43,43,24
24,r_27_143_191,seq25,seq142,r_27_143_191,0.49,0,191,191,24
25,r_0_59_105,r_5_95_150,seq60,r_0_59_105,0.99,0,105,105,24
52,seq135,r_136_4_49,seq138,r_136_4_49,1.0,0,49,49,24
50,seq128,r_129_149_154,r_49_131_78,r_49_131_78,1.0,76,154,78,24
38,r_54_98_186,seq52,r_99_96_135,r_99_96_135,0.91,51,186,135,24
77,seq68,r_69_22_83,seq70,r_69_22_83,1.0,1,84,83,24
34,r_93_112_155,r_92_126_102,r_99_96_135,r_92_126_102,1.0,-1,101,102,24
17,r_69_22_83,seq68,seq25,r_69_22_83,1.0,0,83,83,24
32,r_56_76_29,r_55_132_48,r_77_38_143,r_56_76_29,0.78,0,29,29,24
9,r_114_21_160,seq116,r_69_22_83,r_114_21_160,0.78,0,160,160,24
13,r_136_4_49,seq135,seq1,r_136_4_49,0.93,0,49,49,24
22,r_148_45_138,seq138,r_17_39_30,r_148_45_138,0.8,2,140,138,24
28,r_47_117_158,seq48,seq115,r_47_117_158,0.94,0,158,158,24
91,seq105,r_104_91_140,r_99_96_135,r_104_91_140,0.67,3,143,140,24
14,r_42_86_35,seq43,seq88,r_42_86_35,1.0,0,35,35,24
56,seq12,r_13_147_111,r_14_8_200,r_13_147_111,1.0,0,111,111,24
7,r_15_51_153,seq16,r_14_8_200,r_14_8_200,0.53,-78,122,200,24
44,r_102_2_167,r_99_96_135,r_125_7_132,r_102_2_167,0.84,0,167,167,24
79,seq71,r_74_83_94,seq70,r_74_83_94,1.0,1,95,94,24
12,r_87_50_116,seq88,seq52,r_87_50_116,0.92,0,116,116,24
93,seq107,r_106_118_75,r_1_103_64,r_1_103_64,0.74,11,75,64,25
30,r_41_75_180,seq42,r_61_77_97,r_41_75_180,0.36,0,180,180,25
36,r_38_76_166,r_39_148_130,r_149_89_101,r_38_76_166,0.82,-36,130,166,25
8,r_62_24_147,r_61_77_97,seq58,r_61_77_97,0.68,0,97,97,25
29,r_134_87_44,r_81_90_100,r_114_88_95,r_114_88_95,0.96,6,101,95,25
37,r_48_128_104,seq50,seq132,r_48_128_104,0.86,0,104,104,25
59,seq141,r_143_17_177,seq138,r_143_17_177,0.89,-24,153,177,25
19,r_28_94_3,seq98,seq100,r_28_94_3,0.72,113,116,3,25
55,seq9,r_11_102_146,r_146_10_14,r_11_102_146,0.84,-47,99,146,25
39,r_129_80_105,seq132,r_5_126_8,r_5_126_8,0.8,54,62,8,25
1,r_61_77_97,r_62_24_147,r_121_70_48,r_121_70_48,0.66,49,97,48,25
5,r_135_108_98,r_137_29_136,seq110,r_135_108_98,0.89,3,101,98,25
42,r_104_35_129,seq107,r_36_32_126,r_104_35_129,0.94,0,129,129,25
80,seq64,seq67,r_33_63_75,r_33_63_75,0.98,52,127,75,25
36,r_38_76_166,r_149_89_101,r_61_77_97,r_38_76_166,0.59,0,166,166,25
44,r_20_37_138,r_38_76_166,r_83_57_109,r_38_76_166,0.48,15,181,166,25
45,r_65_122_84,seq64,seq123,r_65_122_84,1.0,0,84,84,25
15,r_127_85_16,r_124_59_99,seq84,r_127_85_16,0.85,0,16,16,25
21,r_45_27_44,seq44,r_26_13_167,r_45_27_44,1.0,1,45,44,25
24,r_1_103_64,seq107,r_11_102_146,r_11_102_146,1.0,1,147,146,25
9,r_121_70_48,seq123,r_49_74_5,r_121_70_48,1.0,0,48,48,25
3,r_81_90_100,seq84,seq91,r_81_90_100,0.35,-22,78,100,25
10,r_33_63_75,r_36_32_126,seq64,r_33_63_75,0.9,0,75,75,25
47,r_124_59_99,r_127_85_16,r_5_126_8,r_124_59_99,0.94,-87,12,99,25
26,r_26_13_167,r_25_56_132,r_45_27_44,r_45_27_44,0.74,86,130,44,25
78,seq58,seq60,r_124_59_99,r_124_59_99,1.0,2,101,99,25
0,r_39_148_130,r_38_76_166,seq145,r_39_148_130,0.42,0,130,130,25
63,seq18,r_20_37_138,r_52_19_87,r_52_19_87,0.95,51,138,87,25
11,r_137_29_136,seq138,r_36_32_126,r_137_29_136,0.66,1,137,136,25
13,r_149_89_101,seq145,r_114_88_95,r_149_89_101,0.94,1,102,101,25
62,seq145,seq144,r_39_148_130,r_39_148_130,1.0,18,148,130,25
21,r_45_27_44,r_26_13_167,r_137_29_136,r_137_29_136,0.98,31,167,136,25
85,seq82,r_83_57_109,seq84,r_83_57_109,1.0,0,109,109,25
34,r_86_2_59,seq84,r_105_4_42,r_86_2_59,0.95,0,59,59,25
46,r_147_16_12,r_135_108_98,seq15,r_147_16_12,0.87,0,12,12,25
26,r_26_13_167,r_45_27_44,r_147_16_12,r_26_13_167,0.91,0,167,167,25
27,r_83_57_109,seq82,seq58,r_83_57_109,0.87,0,109,109,25
38,r_105_4_42,r_104_35_129,seq3,r_105_4_42,0.99,0,42,42,25
99,seq123,r_115_120_21,r_65_122_84,r_65_122_84,1.0,21,105,84,25
40,r_136_66_125,r_137_29_136,r_33_63_75,r_136_66_125,0.91,0,125,125,25
29,r_134_87_44,r_143_17_177,r_81_90_100,r_134_87_44,0.93,3,47,44,25
18,r_25_56_132,r_26_13_167,seq55,r_25_56_132,0.83,0,132,132,25
24,r_1_103_64,seq3,seq107,r_1_103_64,0.9,0,64,64,25
8,r_62_24_147,seq58,seq23,r_62_24_147,1.0,0,147,147,25
25,r_106_118_75,seq107,seq117,r_106_118_75,0.72,0,75,75,25
39,r_129_80_105,r_5_126_8,r_61_77_97,r_129_80_105,1.0,0,105,105,25
23,r_146_10_14,r_149_89_101,seq9,r_146_10_14,0.94,0,14,14,25
47,r_124_59_99,r_5_126_8,seq58,r_124_59_99,1.0,0,99,99,25
20,r_5_126_8,r_124_59_99,seq132,r_124_59_99,1.0,0,99,99,25
32,r_40_47_130,r_41_75_180,seq44,r_40_47_130,0.6,0,130,130,25
48,r_79_131_18,r_49_74_5,seq132,r_79_131_18,0.97,1,19,18,25
49,r_0_68_24,r_1_103_64,seq69,r_0_68_24,0.74,0,24,24,25
75,seq53,r_52_19_87,seq50,r_52_19_87,0.88,0,87,87,25
81,seq67,seq64,r_0_68_24,r_0_68_24,0.96,110,134,24,25
17,r_36_32_126,seq31,r_104_35_129,r_104_35_129,0.98,2,131,129,25
99,seq123,r_121_70_48,r_115_120_21,r_121_70_48,0.76,0,48,48,25
19,r_28_94_3,seq91,seq98,r_28_94_3,0.44,30,33,3,25
22,r_143_17_177,seq141,r_52_19_87,r_143_17_177,0.57,0,177,177,25
60,seq15,seq12,r_147_16_12,r_147_16_12,0.98,0,12,12,25
28,r_114_88_95,seq117,r_134_87_44,r_114_88_95,0.53,0,95,95,25
7,r_52_19_87,seq53,seq18,r_52_19_87,0.99,0,87,87,25
44,r_20_37_138,seq18,r_38_76_166,r_20_37_138,0.79,0,138,138,25
43,r_125_8_55,r_124_59_99,seq6,r_125_8_55,1.0,0,55,55,25
82,seq69,seq64,r_0_68_24,r_0_68_24,0.98,110,134,24,25
35,r_78_14_192,seq73,r_52_19_87,r_52_19_87,0.91,105,192,87,25
36,r_19_20_2,r_23_76_126,r_85_22_63,r_85_22_63,0.99,0,63,63,26
8,r_23_76_126,r_19_20_2,seq77,r_23_76_126,0.9,1,127,126,26
58,seq147,r_146_142_9,r_27_145_26,r_146_142_9,0.74,162,171,9,26
43,r_89_12_186,r_88_0_140,r_101_92_76,r_89_12_186,0.74,-46,140,186,26
62,seq30,r_28_48_162,r_64_31_20,r_64_31_20,0.98,0,20,20,26
20,r_32_115_32,r_34_112_90,r_110_144_193,r_110_144_193,0.98,-161,32,193,26
1,r_101_92_76,seq99,seq93,r_101_92_76,0.97,-2,74,76,26
42,r_62_114_136,seq61,r_32_115_32,r_62_114_136,0.91,0,136,136,26
80,seq143,r_146_142_9,r_27_145_26,r_27_145_26,1.0,66,92,26,26
69,seq52,seq70,r_102_50_80,r_102_50_80,1.0,12,92,80,26
76,seq70,r_66_29_172,r_141_69_19,r_141_69_19,0.99,1,20,19,26
19,r_21_40_128,r_19_20_2,r_43_42_81,r_21_40_128,0.9,0,128,128,26
33,r_17_7_147,r_64_31_20,seq6,r_17_7_147,0.95,0,147,147,26
90,seq99,r_101_92_76,r_126_100_37,r_101_92_76,0.64,-31,45,76,26
95,seq111,r_110_144_193,r_34_112_90,r_34_112_90,1.0,1,91,90,26
46,r_64_31_20,r_59_36_105,seq30,r_64_31_20,0.99,0,20,20,26
31,r_39_116_152,r_43_42_81,r_136_119_152,r_39_116_152,0.45,0,152,152,26
41,r_85_22_63,seq83,r_19_20_2,r_85_22_63,1.0,0,63,63,26
3,r_28_48_162,seq30,seq49,r_28_48_162,0.81,0,162,162,26
26,r_66_29_172,seq70,r_64_31_20,r_64_31_20,0.56,152,172,20,26
4,r_35_78_179,seq37,r_117_79_7,r_35_78_179,0.48,0,179,179,26
0,r_102_50_80,seq104,seq52,r_102_50_80,1.0,0,80,80,26
63,seq33,r_34_112_90,seq37,r_34_112_90,1.0,0,90,90,26
38,r_139_74_109,seq147,seq75,r_139_74_109,0.92,0,109,109,26
13,r_3_105_157,seq1,r_10_4_98,r_10_4_98,1.0,10,108,98,26
7,r_10_4_98,r_3_105_157,r_13_2_145,r_10_4_98,0.96,59,157,98,26
57,seq15,r_13_2_145,seq11,r_13_2_145,1.0,-1,144,145,26
13,r_3_105_157,r_10_4_98,seq106,r_3_105_157,1.0,0,157,157,26
2,r_5_44_5,r_45_84_163,seq46,r_45_84_163,0.76,2,165,163,26
12,r_149_25_18,seq148,r_18_24_9,r_149_25_18,0.99,0,18,18,26
27,r_110_144_193,seq111,r_27_145_26,r_27_145_26,0.87,167,193,26,26
48,r_90_65_22,r_88_0_140,r_141_69_19,r_90_65_22,0.99,0,22,22,26
47,r_58_38_96,seq55,seq37,r_58_38_96,0.97,0,96,96,26
40,r_81_71_132,seq82,r_139_74_109,r_139_74_109,1.0,25,134,109,26
18,r_129_51_164,seq131,seq52,r_129_51_164,0.68,0,164,164,26
29,r_14_130_127,r_13_2_145,r_129_51_164,r_14_130_127,0.5,0,127,127,26
49,r_118_96_26,r_127_67_132,seq95,r_118_96_26,0.66,0,26,26,26
24,r_45_84_163,r_5_44_5,r_117_79_7,r_117_79_7,0.6,156,163,7,26
25,r_132_140_70,seq133,r_146_142_9,r_132_140_70,0.83,0,70,70,26
33,r_17_7_147,r_19_20_2,r_64_31_20,r_64_31_20,0.59,55,75,20,26
64,seq37,r_35_78_179,r_58_38_96,r_58_38_96,1.0,2,98,96,26
20,r_32_115_32,r_110_144_193,r_62_114_136,r_62_114_136,0.82,17,153,136,26
68,seq49,seq46,r_28_48_162,r_28_48_162,0.78,-1,161,162,26
52,seq133,r_132_140_70,seq134,r_132_140_70,1.0,-3,67,70,26
34,r_136_119_152,seq134,r_39_116_152,r_39_116_152,0.56,0,152,152,26
9,r_127_67_132,r_128_113_187,r_141_69_19,r_127_67_132,0.5,0,132,132,26
22,r_146_142_9,seq143,r_132_140_70,r_132_140_70,0.56,29,99,70,26
28,r_128_113_187,seq124,r_32_115_32,r_32_115_32,0.96,155,187,32,26
11,r_109_57_45,seq107,seq56,r_109_57_45,1.0,0,45,45,26
29,r_14_130_127,r_129_51_164,seq131,r_129_51_164,0.99,-5,159,164,26
56,seq11,r_10_4_98,seq15,r_10_4_98,1.0,-11,87,98,26
7,r_10_4_98,seq11,r_3_105_157,r_10_4_98,1.0,0,98,98,26
44,r_34_112_90,seq33,seq111,r_34_112_90,0.98,0,90,90,26
23,r_88_0_140,r_89_12_186,seq1,r_88_0_140,0.9,0,140,140,26
6,r_141_69_19,r_146_142_9,seq70,r_141_69_19,1.0,0,19,19,26
37,r_18_24_9,r_28_48_162,r_149_25_18,r_149_25_18,0.93,0,18,18,26
30,r_27_145_26,r_28_48_162,seq143,r_27_145_26,1.0,2,28,26,26
30,r_91_12_107,r_92_59_85,r_17_90_69,r_91_12_107,0.69,-23,84,107,27
36,r_138_38_143,seq133,r_28_37_82,r_138_38_143,0.98,0,143,143,27
14,r_40_113_60,seq41,r_77_115_31,r_40_113_60,1.0,0,60,60,27
8,r_102_21_60,r_103_39_146,r_84_20_53,r_102_21_60,0.77,0,60,60,27
98,seq123,r_122_70_160,r_44_125_38,r_44_125_38,1.0,5,43,38,27
43,r_101_80_185,seq98,r_141_79_110,r_141_79_110,1.0,72,182,110,27
37,r_145_142_121,seq144,seq139,r_145_142_121,0.5,20,141,121,27
78,seq63,r_86_25_75,r_95_69_125,r_95_69_125,0.68,19,144,125,27
16,r_95_69_125,r_97_33_196,seq68,r_95_69_125,0.84,0,125,125,27
39,r_82_64_191,seq78,r_141_79_110,r_141_79_110,1.0,2,112,110,27
97,seq121,r_120_146_114,seq119,r_120_146_114,1.0,0,114,114,27
46,r_86_25_75,r_85_31_155,seq24,r_86_25_75,0.79,0,75,75,27
42,r_147_27_138,r_149_55_109,seq144,r_149_55_109,0.61,0,109,109,27
69,seq32,seq24,r_15_35_69,r_15_35_69,0.6,24,93,69,27
19,r_103_39_146,r_101_80_185,seq41,r_103_39_146,0.73,0,146,146,27
33,r_85_31_155,r_82_64_191,r_13_34_102,r_85_31_155,0.95,0,155,155,27
66,seq132,seq133,r_135_136_76,r_135_136_76,0.41,82,158,76,27
77,seq62,r_148_22_58,seq8,r_148_22_58,0.55,34,92,58,27
39,r_82_64_191,r_141_79_110,seq65,r_82_64_191,0.59,0,191,191,27
41,r_124_3_77,seq123,r_106_2_30,r_124_3_77,0.81,0,77,77,27
0,r_148_22_58,r_149_55_109,r_84_20_53,r_148_22_58,1.0,0,58,58,27
3,r_81_73_2,seq75,r_122_70_160,r_122_70_160,0.95,0,160,160,27
24,r_84_20_53,r_85_31_155,r_129_19_4,r_84_20_53,0.99,0,53,53,27
90,seq110,r_109_94_137,seq107,r_109_94_137,0.83,0,137,137,27
4,r_143_49_131,seq140,seq47,r_143_49_131,0.62,1,132,131,27
78,seq63,r_66_76_9,r_86_25_75,r_86_25_75,0.92,15,90,75,27
63,seq18,seq14,r_108_16_107,r_108_16_107,1.0,27,134,107,27
13,r_57_89_60,r_53_60_9,r_91_12_107,r_57_89_60,0.88,0,60,60,27
30,r_91_12_107,r_17_90_69,seq9,r_91_12_107,0.98,0,107,107,27
85,seq78,r_82_64_191,r_141_79_110,r_141_79_110,1.0,42,152,110,27
64,seq23,r_28_37_82,r_148_22_58,r_148_22_58,1.0,0,58,58,27
27,r_109_94_137,seq110,r_57_89_60,r_109_94_137,0.61,0,137,137,27
44,r_129_19_4,seq23,r_84_20_53,r_84_20_53,1.0,2,55,53,27
22,r_28_37_82,r_15_35_69,r_138_38_143,r_138_38_143,1.0,2,145,143,27
2,r_83_130_90,r_85_31_155,seq131,r_83_130_90,0.98,0,90,90,27
47,r_92_59_85,r_91_12_107,r_53_60_9,r_53_60_9,1.0,77,86,9,27
40,r_149_55_109,r_147_27_138,r_54_51_90,r_149_55_109,0.61,0,109,109,27
11,r_106_2_30,r_0_126_125,r_124_3_77,r_106_2_30,0.97,48,78,30,27
25,r_74_52_119,seq75,r_54_51_90,r_74_52_119,0.73,0,119,119,27
33,r_85_31_155,r_86_25_75,r_82_64_191,r_86_25_75,1.0,0,75,75,27
70,seq36,seq24,r_15_35_69,r_15_35_69,0.88,3,72,69,27
61,seq14,r_17_90_69,seq11,r_17_90_69,1.0,-6,63,69,27
32,r_15_35_69,seq14,seq36,r_15_35_69,0.82,0,69,69,27
77,seq62,r_66_76_9,r_148_22_58,r_148_22_58,0.61,6,64,58,27
11,r_106_2_30,seq107,r_0_126_125,r_106_2_30,1.0,0,30,30,27
42,r_147_27_138,seq144,r_86_25_75,r_147_27_138,0.96,0,138,138,27
21,r_44_125_38,r_46_88_120,seq123,r_44_125_38,1.0,0,38,38,27
81,seq68,seq67,r_95_69_125,r_95_69_125,1.0,12,137,125,27
17,r_108_16_107,r_109_94_137,seq18,r_108_16_107,0.94,0,107,107,27
9,r_99_6_177,seq98,r_105_5_16,r_99_6_177,0.68,0,177,177,27
6,r_105_5_16,seq104,seq7,r_105_5_16,0.63,0,16,16,27
22,r_28_37_82,seq24,r_15_35_69,r_28_37_82,0.49,0,82,82,27
28,r_141_79_110,seq140,r_82_64_191,r_141_79_110,1.0,0,110,110,27
91,seq111,seq107,r_77_115_31,r_77_115_31,0.97,84,115,31,27
49,r_0_126_125,seq1,r_44_125_38,r_0_126_125,0.72,0,125,125,27
7,r_13_34_102,seq14,seq32,r_13_34_102,0.78,0,102,102,27
5,r_77_115_31,r_74_52_119,seq116,r_77_115_31,1.0,0,31,31,27
13,r_57_89_60,r_91_12_107,r_17_90_69,r_91_12_107,0.63,-19,88,107,27
23,r_120_146_114,seq121,r_145_142_121,r_120_146_114,0.99,1,115,114,27
35,r_122_70_160,seq123,r_81_73_2,r_122_70_160,0.67,0,160,160,27
26,r_87_58_58,r_91_12_107,r_53_60_9,r_53_60_9,0.78,50,59,9,27
89,seq107,r_106_2_30,seq110,r_106_2_30,1.0,0,30,30,27
93,seq87,r_88_14_83,seq85,r_88_14_83,1.0,-1,82,83,28
44,r_100_11_123,r_71_103_53,r_26_12_119,r_100_11_123,1.0,0,123,123,28
51,seq2,r_1_76_152,seq4,r_1_76_152,0.9,0,152,152,28
6,r_71_103_53,r_72_118_22,seq65,r_72_118_22,0.93,0,22,22,28
45,r_26_12_119,r_70_121_106,seq45,r_26_12_119,0.43,-77,42,119,28
36,r_16_50_92,seq4,r_129_51_65,r_129_51_65,0.79,27,92,65,28
43,r_0_59_145,r_1_76_152,r_30_58_32,r_1_76_152,0.86,-7,145,152,28
88,seq75,r_86_83_64,r_23_74_42,r_23_74_42,0.48,0,42,42,28
71,seq31,seq35,r_116_29_89,r_116_29_89,1.0,70,159,89,28
16,r_81_17_114,seq82,r_146_15_87,r_81_17_114,0.64,0,114,114,28
39,r_125_67_164,seq123,r_55_69_139,r_125_67_164,0.8,0,164,164,28
1,r_27_145_81,seq31,seq149,r_27_145_81,1.0,0,81,81,28
97,seq147,r_146_15_87,seq149,r_146_15_87,1.0,0,87,87,28
46,r_10_98_156,seq13,r_71_103_53,r_71_103_53,0.64,103,156,53,28
21,r_72_118_22,r_71_103_53,seq123,r_72_118_22,0.95,0,22,22,28
24,r_105_9_184,r_114_108_52,r_100_11_123,r_105_9_184,0.67,0,184,184,28
19,r_115_3_117,seq111,seq6,r_115_3_117,1.0,0,117,117,28
95,seq94,r_92_60_71,r_143_95_4,r_92_60_71,1.0,-5,66,71,28
0,r_97_93_33,r_101_141_51,seq94,r_101_141_51,1.0,-18,33,51,28
38,r_88_14_83,r_10_98_156,seq19,r_10_98_156,1.0,-13,143,156,28
3,r_32_47_149,seq35,r_48_49_137,r_48_49_137,0.55,12,149,137,28
10,r_129_51_65,seq128,seq53,r_129_51_65,1.0,0,65,65,28
42,r_126_78_48,r_129_51_65,seq77,r_126_78_48,0.99,0,48,48,28
4,r_37_89_136,seq36,seq90,r_37_89_136,0.82,0,136,136,28
5,r_43_104_35,seq42,r_105_9_184,r_43_104_35,1.0,0,35,35,28
28,r_70_121_106,r_63_110_138,seq65,r_63_110_138,0.65,-113,25,138,28
40,r_113_130_36,r_107_140_173,seq131,r_113_130_36,1.0,0,36,36,28
48,r_133_99_171,r_134_80_198,r_38_96_126,r_38_96_126,0.66,45,171,126,28
22,r_146_15_87,r_0_59_145,r_81_17_114,r_146_15_87,0.84,28,115,87,28
99,seq123,r_125_67_164,r_57_124_41,r_57_124_41,0.99,100,141,41,28
5,r_43_104_35,r_105_9_184,r_114_108_52,r_105_9_184,0.77,-54,130,184,28
87,seq68,seq65,r_55_69_139,r_55_69_139,0.99,0,139,139,28
18,r_30_58_32,seq56,r_0_59_145,r_0_59_145,0.99,0,145,145,28
8,r_57_124_41,seq42,seq123,r_57_124_41,1.0,0,41,41,28
26,r_40_102_54,r_38_96_126,r_71_103_53,r_40_102_54,0.9,0,54,54,28
87,seq68,r_70_121_106,seq65,r_70_121_106,1.0,-34,72,106,28
2,r_106_41_123,r_105_9_184,seq44,r_106_41_123,0.98,0,123,123,28
47,r_92_60_71,seq94,seq68,r_92_60_71,0.98,0,71,71,28
74,seq36,r_37_89_136,r_127_39_124,r_127_39_124,0.7,12,136,124,28
24,r_105_9_184,r_106_41_123,r_114_108_52,r_106_41_123,1.0,0,123,123,28
25,r_63_110_138,r_64_91_95,r_148_62_58,r_63_110_138,0.53,-48,90,138,28
33,r_134_80_198,r_133_99_171,seq132,r_133_99_171,0.66,0,171,171,28
18,r_30_58_32,seq31,seq52,r_30_58_32,0.57,5,37,32,28
32,r_116_29_89,seq117,seq31,r_116_29_89,1.0,0,89,89,28
38,r_88_14_83,seq87,r_10_98_156,r_88_14_83,0.8,0,83,83,28
25,r_63_110_138,r_148_62_58,r_114_108_52,r_63_110_138,1.0,0,138,138,28
15,r_122_25_12,r_125_67_164,seq24,r_122_25_12,1.0,0,12,12,28
23,r_148_62_58,seq144,r_63_110_138,r_148_62_58,1.0,0,58,58,28
34,r_64_91_95,r_63_110_138,seq94,r_64_91_95,1.0,0,95,95,28
45,r_26_12_119,seq45,seq13,r_26_12_119,0.67,0,119,119,28
17,r_112_61_86,r_115_3_117,r_148_62_58,r_112_61_86,0.97,0,86,86,28
9,r_107_140_173,r_114_108_52,r_101_141_51,r_101_141_51,1.0,122,173,51,28
28,r_70_121_106,seq65,r_57_124_41,r_70_121_106,0.92,0,106,106,28
22,r_146_15_87,seq147,r_0_59_145,r_146_15_87,0.86,0,87,87,28
49,r_119_109_133,r_125_67_164,r_114_108_52,r_119_109_133,0.92,0,133,133,28
27,r_23_74_42,seq22,seq75,r_23_74_42,0.91,0,42,42,28
7,r_127_39_124,seq128,seq36,r_127_39_124,0.99,0,124,124,28
20,r_101_141_51,r_100_11_123,seq142,r_101_141_51,1.0,0,51,51,28
33,r_134_80_198,seq132,r_86_83_64,r_134_80_198,0.82,-1,197,198,28
35,r_114_108_52,r_107_140_173,r_63_110_138,r_63_110_138,0.99,35,173,138,28
44,r_100_11_123,r_101_141_51,r_71_103_53,r_100_11_123,1.0,-70,53,123,28
23,r_148_62_58,r_63_110_138,r_112_61_86,r_148_62_58,0.98,80,138,58,28
84,seq56,r_55_69_139,r_30_58_32,r_55_69_139,0.49,-1,138,139,28
30,r_91_33_173,seq92,r_20_31_184,r_20_31_184,0.69,2,186,184,29
36,r_53_65_156,r_57_70_134,seq45,r_57_70_134,0.49,1,135,134,29
9,r_34_9_86,r_10_145_171,r_27_12_85,r_10_145_171,0.46,0,171,171,29
14,r_21_121_1,r_122_113_63,seq128,r_122_113_63,1.0,0,63,63,29
8,r_10_145_171,r_13_18_164,r_118_87_26,r_118_87_26,0.97,55,81,26,29
37,r_25_41_108,r_27_12_85,r_59_29_1,r_27_12_85,0.54,0,85,85,29
21,r_50_56_166,seq49,r_2_54_160,r_2_54_160,0.73,6,166,160,29
39,r_2_54_160,r_0_23_80,seq3,r_0_23_80,0.97,0,80,80,29
16,r_118_87_26,seq120,seq92,r_118_87_26,0.99,0,26,26,29
5,r_124_146_141,r_123_103_158,seq147,r_124_146_141,0.55,0,141,141,29
42,r_72_24_73,r_60_71_9,r_0_23_80,r_72_24_73,1.0,4,77,73,29
44,r_95_108_75,r_97_40_187,seq107,r_95_108_75,0.84,0,75,75,29
69,seq61,r_64_138_130,seq58,r_64_138_130,1.0,0,130,130,29
45,r_0_23_80,r_1_17_115,r_72_24_73,r_72_24_73,0.63,7,80,73,29
38,r_123_103_158,r_80_126_92,r_15_102_65,r_123_103_158,0.93,1,159,158,29
19,r_32_148_188,r_35_100_164,seq45,r_32_148_188,0.32,-23,165,188,29
33,r_63_105_51,r_62_119_87,seq104,r_63_105_51,0.66,4,55,51,29
95,seq111,seq107,r_122_113_63,r_122_113_63,1.0,3,66,63,29
66,seq49,r_50_56_166,r_8_47_67,r_8_47_67,1.0,25,92,67,29
39,r_2_54_160,seq3,r_50_56_166,r_2_54_160,0.87,2,162,160,29
31,r_57_70_134,r_53_65_156,r_137_68_98,r_137_68_98,0.99,36,134,98,29
41,r_114_125_93,seq115,r_80_126_92,r_80_126_92,1.0,6,98,92,29
24,r_48_42_48,seq49,seq43,r_48_42_48,0.85,0,48,48,29
46,r_96_39_32,r_95_108_75,seq38,r_96_39_32,0.97,2,34,32,29
3,r_137_68_98,r_134_11_181,seq66,r_137_68_98,1.0,0,98,98,29
10,r_62_119_87,r_64_138_130,seq120,r_62_119_87,1.0,0,87,87,29
90,seq104,seq107,r_63_105_51,r_63_105_51,1.0,55,106,51,29
72,seq147,r_149_51_124,seq141,r_149_51_124,1.0,0,124,124,29
4,r_55_116_105,r_57_70_134,seq115,r_55_116_105,1.0,0,105,105,29
0,r_80_126_92,seq79,r_114_125_93,r_80_126_92,0.95,0,92,92,29
37,r_25_41_108,r_59_29_1,seq43,r_25_41_108,0.92,0,108,108,29
11,r_8_47_67,seq6,seq49,r_8_47_67,0.99,0,67,67,29
20,r_143_142_111,seq147,r_83_144_173,r_83_144_173,0.89,10,183,173,29
13,r_1_17_115,r_2_54_160,seq16,r_1_17_115,0.79,0,115,115,29
15,r_64_138_130,seq61,seq129,r_64_138_130,0.79,0,130,130,29
48,r_83_144_173,seq84,r_143_142_111,r_143_142_111,0.67,62,173,111,29
40,r_139_77_40,r_143_142_111,seq81,r_139_77_40,0.91,0,40,40,29
6,r_27_12_85,r_25_41_108,r_13_18_164,r_27_12_85,0.75,0,85,85,29
7,r_59_29_1,r_25_41_108,r_132_30_20,r_59_29_1,0.96,43,44,1,29
44,r_95_108_75,r_96_39_32,r_97_40_187,r_96_39_32,0.59,0,32,32,29
8,r_10_145_171,r_118_87_26,r_34_9_86,r_10_145_171,0.44,-84,87,171,29
2,r_36_112_65,r_34_9_86,r_122_113_63,r_36_112_65,0.68,1,66,65,29
18,r_97_40_187,seq99,r_48_42_48,r_97_40_187,0.49,0,187,187,29
64,seq43,seq38,r_48_42_48,r_48_42_48,0.95,3,51,48,29
25,r_20_31_184,seq22,r_91_33_173,r_91_33_173,0.76,13,186,173,29
36,r_53_65_156,seq45,r_137_68_98,r_53_65_156,0.58,0,156,156,29
68,seq58,r_64_138_130,seq61,r_64_138_130,1.0,0,130,130,29
61,seq22,r_20_31_184,r_72_24_73,r_72_24_73,1.0,68,141,73,29
32,r_149_51_124,seq147,seq52,r_149_51_124,0.79,0,124,124,29
38,r_123_103_158,r_124_146_141,r_80_126_92,r_80_126_92,1.0,49,141,92,29
8,r_10_145_171,r_34_9_86,r_124_146_141,r_10_145_171,0.32,0,171,171,29
34,r_4_28_61,seq3,r_59_29_1,r_4_28_61,1.0,0,61,61,29
43,r_98_37_13,r_97_40_187,seq38,r_98_37_13,0.72,0,13,13,29
26,r_135_26_55,r_137_68_98,r_59_29_1,r_135_26_55,0.99,2,57,55,29
9,r_34_9_86,r_35_100_164,r_10_145_171,r_34_9_86,0.91,0,86,86,29
96,seq115,r_114_125_93,r_55_116_105,r_55_116_105,1.0,3,108,105,29
29,r_132_30_20,seq133,r_59_29_1,r_132_30_20,0.96,0,20,20,29
22,r_46_130_89,seq45,seq129,r_46_130_89,1.0,0,89,89,29
28,r_35_100_164,r_32_148_188,r_15_102_65,r_15_102_65,0.84,99,164,65,29
49,r_134_11_181,r_137_68_98,seq133,r_137_68_98,0.96,-23,75,98,29
35,r_122_113_63,r_21_121_1,r_36_112_65,r_122_113_63,1.0,0,63,63,29
12,r_15_102_65,r_13_18_164,seq99,r_15_102_65,0.99,0,65,65,29
40,r_9_7_195,r_96_12_76,r_118_1_91,r_96_12_76,0.23,120,196,76,30
57,seq140,seq131,r_34_141_126,r_34_141_126,0.86,7,133,126,30
14,r_103_49_64,r_104_106_74,seq50,r_103_49_64,1.0,1,65,64,30
8,r_39_85_113,r_41_89_121,seq87,r_39_85_113,0.51,2,115,113,30
37,r_115_58_11,r_60_65_79,r_94_61_37,r_94_61_37,0.64,30,67,37,30
16,r_10_125_191,r_9_7_195,seq124,r_10_125_191,0.51,0,191,191,30
21,r_88_26_157,seq87,r_38_30_9,r_88_26_157,0.91,0,157,157,30
39,r_78_8_155,r_79_29_163,r_96_12_76,r_79_29_163,0.81,-8,155,163,30
1,r_77_101_120,r_79_29_163,seq100,r_77_101_120,0.93,0,120,120,30
5,r_114_149_163,r_113_119_92,r_2_112_105,r_2_112_105,0.93,3,108,105,30
46,r_3_42_95,r_2_112_105,seq43,r_3_42_95,1.0,0,95,95,30
42,r_75_68_182,seq74,r_90_69_156,r_75_68_182,0.4,0,182,182,30
56,seq138,r_136_81_163,r_147_137_49,r_147_137_49,0.72,5,54,49,30
35,r_40_82_18,r_39_85_113,r_88_26_157,r_40_82_18,0.6,0,18,18,30
80,seq63,r_66_146_187,r_94_61_37,r_94_61_37,0.96,144,181,37,30
10,r_96_12_76,r_11_17_125,r_9_7_195,r_11_17_125,1.0,0,125,125,30
88,seq148,r_145_45_140,r_114_149_163,r_145_45_140,0.99,2,142,140,30
15,r_142_36_52,seq143,seq31,r_142_36_52,1.0,-2,50,52,30
45,r_59_48_68,r_60_65_79,seq50,r_59_48_68,0.69,0,68,68,30
19,r_113_119_92,r_114_149_163,seq121,r_113_119_92,0.93,7,99,92,30
31,r_118_1_91,seq120,seq6,r_118_1_91,1.0,0,91,91,30
3,r_4_73_76,r_2_112_105,seq74,r_4_73_76,1.0,0,76,76,30
10,r_96_12_76,seq93,r_11_17_125,r_96_12_76,0.99,0,76,76,30
48,r_105_97_18,r_103_49_64,seq98,r_105_97_18,0.59,-3,15,18,30
26,r_86_111_80,r_88_26_157,seq107,r_86_111_80,0.89,0,80,80,30
8,r_39_85_113,seq87,r_130_83_127,r_39_85_113,0.5,59,172,113,30
11,r_147_137_49,seq148,seq138,r_147_137_49,0.9,5,54,49,30
0,r_34_141_126,r_37_44_176,seq140,r_34_141_126,0.94,0,126,126,30
20,r_84_35_179,seq87,r_142_36_52,r_142_36_52,0.86,128,180,52,30
13,r_66_146_187,seq67,r_114_149_163,r_66_146_187,0.38,0,187,187,30
6,r_136_81_163,seq138,r_40_82_18,r_40_82_18,0.95,147,165,18,30
85,seq87,r_88_26_157,r_39_85_113,r_39_85_113,0.79,42,155,113,30
7,r_51_144_25,r_47_46_187,seq143,r_51_144_25,0.97,0,25,25,30
87,seq93,r_96_12_76,r_132_91_46,r_96_12_76,0.97,-1,75,76,30
24,r_60_65_79,r_94_61_37,seq67,r_60_65_79,0.39,0,79,79,30
2,r_145_45_140,seq148,r_3_42_95,r_145_45_140,0.97,0,140,140,30
47,r_130_83_127,seq131,r_39_85_113,r_130_83_127,0.61,0,127,127,30
40,r_9_7_195,r_10_125_191,r_96_12_76,r_96_12_76,1.0,14,90,76,30
29,r_109_80_104,seq108,r_64_76_90,r_109_80_104,0.99,0,104,104,30
23,r_2_112_105,r_114_149_163,seq107,r_114_149_163,0.94,0,163,163,30
24,r_60_65_79,r_59_48_68,r_94_61_37,r_60_65_79,0.41,-11,68,79,30
88,seq148,r_147_137_49,r_145_45_140,r_147_137_49,1.0,5,54,49,30
35,r_40_82_18,r_88_26_157,r_39_85_113,r_39_85_113,0.82,38,151,113,30
25,r_18_92_83,seq20,r_132_91_46,r_18_92_83,1.0,0,83,83,30
33,r_79_29_163,r_75_68_182,r_88_26_157,r_79_29_163,0.21,0,163,163,30
28,r_126_22_76,seq20,r_99_23_127,r_99_23_127,1.0,8,135,127,30
43,r_94_61_37,seq93,seq62,r_94_61_37,0.94,0,37,37,30
32,r_37_44_176,seq31,r_3_42_95,r_3_42_95,1.0,81,176,95,30
81,seq67,r_66_146_187,r_90_69_156,r_90_69_156,0.92,5,161,156,30
9,r_41_89_121,r_39_85_113,r_18_92_83,r_41_89_121,0.53,0,121,121,30
22,r_64_76_90,r_66_146_187,seq74,r_64_76_90,1.0,0,90,90,30
28,r_126_22_76,r_122_116_201,seq20,r_126_22_76,0.98,0,76,76,30
49,r_104_106_74,r_103_49_64,seq107,r_103_49_64,1.0,1,65,64,30
44,r_70_117_179,r_79_29_163,r_113_119_92,r_70_117_179,0.49,-23,156,179,30
23,r_2_112_105,seq5,r_114_149_163,r_2_112_105,0.97,2,107,105,30
12,r_11_17_125,r_10_125_191,seq13,r_11_17_125,0.99,0,125,125,30
5,r_114_149_163,r_2_112_105,seq148,r_114_149_163,0.92,0,163,163,30
30,r_96_122_149,seq99,r_53_123_49,r_53_123_49,1.0,100,149,49,31
63,seq143,seq136,r_118_144_49,r_118_144_49,0.69,1,50,49,31
44,r_59_23_181,r_47_58_20,r_80_26_121,r_47_58_20,0.76,161,181,20,31
46,r_87_19_18,r_95_34_189,seq18,r_87_19_18,1.0,0,18,18,31
51,seq129,seq130,r_20_128_34,r_20_128_34,1.0,27,61,34,31
9,r_126_94_188,r_5_124_11,r_114_93_140,r_126_94_188,0.49,0,188,188,31
1,r_5_124_11,r_32_28_46,r_126_94_188,r_5_124_11,0.99,0,11,11,31
6,r_62_102_46,r_64_33_196,seq101,r_62_102_46,1.0,0,46,46,31
47,r_84_13_172,r_1_73_102,r_78_14_114,r_84_13_172,0.98,0,172,172,31
8,r_21_30_194,seq27,r_83_29_48,r_83_29_48,1.0,146,194,48,31
72,seq36,seq4,r_75_38_17,r_75_38_17,1.0,5,22,17,31
83,seq134,r_149_132_18,r_127_133_40,r_127_133_40,0.59,39,79,40,31
37,r_1_73_102,seq2,seq74,r_1_73_102,1.0,0,102,102,31
86,seq68,r_69_86_181,r_56_67_182,r_56_67_182,0.81,-1,181,182,31
16,r_70_51_62,r_71_15_180,r_52_54_44,r_70_51_62,1.0,0,62,62,31
39,r_112_72_114,seq111,r_1_73_102,r_1_73_102,0.94,17,119,102,31
1,r_5_124_11,r_126_94_188,r_20_128_34,r_20_128_34,0.83,154,188,34,31
5,r_64_33_196,seq63,r_95_34_189,r_64_33_196,0.39,0,196,196,31
32,r_47_58_20,r_59_23_181,seq61,r_47_58_20,0.71,127,147,20,31
45,r_116_90_83,seq117,seq88,r_116_90_83,0.89,2,85,83,31
9,r_126_94_188,r_125_115_72,r_5_124_11,r_5_124_11,0.5,0,11,11,31
73,seq37,r_32_28_46,r_75_38_17,r_75_38_17,1.0,1,18,17,31
44,r_59_23_181,r_64_33_196,r_47_58_20,r_47_58_20,0.99,26,46,20,31
31,r_77_85_164,r_78_14_114,r_1_73_102,r_77_85_164,0.95,-50,114,164,31
17,r_127_133_40,r_149_132_18,seq134,r_127_133_40,0.49,40,80,40,31
41,r_8_103_103,seq7,seq104,r_8_103_103,1.0,0,103,103,31
3,r_95_34_189,r_91_120_132,r_71_15_180,r_71_15_180,0.66,-51,129,180,31
17,r_127_133_40,seq129,r_149_132_18,r_127_133_40,0.94,0,40,40,31
10,r_71_15_180,r_70_51_62,seq68,r_70_51_62,0.99,0,62,62,31
90,seq99,r_96_122_149,r_48_98_47,r_48_98_47,1.0,93,140,47,31
26,r_139_107_77,r_137_45_75,r_105_100_82,r_139_107_77,0.99,-2,75,77,31
23,r_20_128_34,r_21_30_194,seq129,r_20_128_34,1.0,0,34,34,31
38,r_114_93_140,r_95_34_189,r_62_102_46,r_95_34_189,0.92,-14,175,189,31
11,r_69_86_181,seq68,r_77_85_164,r_77_85_164,0.9,17,181,164,31
13,r_137_45_75,r_139_107_77,r_82_43_67,r_137_45_75,1.0,0,75,75,31
48,r_78_14_114,r_76_135_114,seq12,r_78_14_114,0.9,0,114,114,31
14,r_83_29_48,r_80_26_121,seq31,r_83_29_48,0.85,0,48,48,31
31,r_77_85_164,r_116_90_83,r_69_86_181,r_77_85_164,0.48,17,181,164,31
0,r_91_120_132,r_92_57_56,r_95_34_189,r_92_57_56,1.0,0,56,56,31
19,r_53_123_49,r_52_54_44,seq121,r_53_123_49,1.0,0,49,49,31
0,r_91_120_132,r_95_34_189,r_89_119_9,r_91_120_132,0.82,0,132,132,31
83,seq134,r_127_133_40,r_76_135_114,r_76_135_114,0.96,9,123,114,31
4,r_118_144_49,seq117,seq143,r_118_144_49,1.0,0,49,49,31
2,r_16_39_194,seq18,r_137_45_75,r_137_45_75,1.0,119,194,75,31
47,r_84_13_172,r_80_26_121,r_1_73_102,r_84_13_172,0.76,-51,121,172,31
43,r_149_132_18,seq148,seq134,r_149_132_18,0.94,1,19,18,31
24,r_75_38_17,r_76_135_114,seq37,r_75_38_17,0.99,0,17,17,31
40,r_56_67_182,seq55,seq68,r_56_67_182,0.78,1,183,182,31
70,seq31,r_32_28_46,r_83_29_48,r_83_29_48,1.0,2,50,48,31
25,r_125_115_72,r_126_94_188,seq121,r_125_115_72,0.95,0,72,72,31
33,r_40_140_139,seq42,seq142,r_40_140_139,0.94,0,139,139,31
49,r_138_131_15,r_137_45_75,seq130,r_138_131_15,0.88,2,17,15,31
27,r_92_57_56,r_91_120_132,r_47_58_20,r_92_57_56,1.0,2,58,56,31
34,r_110_147_109,r_112_72_114,seq148,r_110_147_109,0.83,0,109,109,31
60,seq12,r_16_39_194,r_78_14_114,r_78_14_114,1.0,2,116,114,31
3,r_95_34_189,r_71_15_180,r_114_93_140,r_95_34_189,0.83,-48,141,189,31
18,r_25_46_48,r_81_24_1,r_52_54_44,r_25_46_48,0.65,0,48,48,31
96,seq111,r_112_72_114,seq113,r_112_72_114,0.96,5,119,114,31
32,r_47_58_20,r_48_98_47,r_59_23_181,r_47_58_20,0.97,0,20,20,31
22,r_82_43_67,r_80_26_121,seq42,r_82_43_67,0.92,0,67,67,31
88,seq79,r_80_26_121,seq74,r_80_26_121,0.57,-95,26,121,31
72,seq36,r_75_38_17,seq35,r_75_38_17,0.45,77,94,17,31
12,r_76_135_114,r_78_14_114,seq134,r_76_135_114,0.83,0,114,114,31
28,r_97_145_14,r_95_34_189,seq146,r_97_145_14,0.68,0,14,14,31
31,r_77_85_164,r_1_73_102,r_116_90_83,r_77_85_164,0.84,0,164,164,31
84,seq63,r_64_33_196,r_92_57_56,r_92_57_56,1.0,142,198,56,31
3,r_95_34_189,r_114_93_140,r_83_29_48,r_95_34_189,0.96,1,190,189,31
48,r_91_82_148,seq109,r_99_75_131,r_91_82_148,0.79,0,148,148,32
16,r_102_126_15,r_103_64_161,seq124,r_102_126_15,0.99,0,15,15,32
36,r_117_135_148,r_119_74_193,seq137,r_117_135_148,0.38,0,148,148,32
53,seq8,r_7_98_72,r_21_10_30,r_7_98_72,0.7,-1,71,72,32
43,r_107_16_144,seq108,r_72_106_72,r_72_106_72,0.96,39,111,72,32
37,r_115_50_136,seq116,seq51,r_115_50_136,0.99,0,136,136,32
39,r_7_98_72,seq8,seq94,r_7_98_72,1.0,0,72,72,32
5,r_114_27_66,r_115_50_136,r_24_46_145,r_114_27_66,0.89,0,66,66,32
22,r_129_56_168,r_115_50_136,r_103_64_161,r_129_56_168,0.58,16,184,168,32
21,r_73_130_30,seq69,seq131,r_73_130_30,0.99,0,30,30,32
34,r_57_14_142,r_52_68_122,r_41_58_26,r_41_58_26,0.7,1,27,26,32
8,r_111_128_43,seq110,r_102_126_15,r_111_128_43,1.0,0,43,43,32
95,seq118,r_119_74_193,r_92_120_20,r_92_120_20,0.83,117,137,20,32
31,r_76_144_108,r_100_80_12,seq143,r_76_144_108,0.96,0,108,108,32
89,seq104,r_103_64_161,r_141_101_41,r_141_101_41,1.0,58,99,41,32
10,r_2_96_104,r_4_0_116,seq97,r_2_96_104,1.0,0,104,104,32
4,r_52_68_122,r_53_133_140,seq69,r_52_68_122,0.72,0,122,122,32
0,r_90_62_109,r_91_82_148,seq63,r_90_62_109,0.92,0,109,109,32
11,r_78_122_71,r_77_67_98,seq121,r_78_122_71,1.0,0,71,71,32
30,r_41_58_26,r_115_50_136,r_90_62_109,r_90_62_109,0.75,62,171,109,32
20,r_100_80_12,r_76_144_108,seq83,r_76_144_108,1.0,0,108,108,32
15,r_30_26_160,seq31,r_114_27_66,r_114_27_66,1.0,94,160,66,32
48,r_91_82_148,r_90_62_109,seq109,r_90_62_109,0.78,-15,94,109,32
23,r_105_88_24,r_103_64_161,r_13_89_16,r_13_89_16,0.81,8,24,16,32
2,r_12_42_41,seq11,seq43,r_12_42_41,0.98,0,41,41,32
57,seq143,r_145_15_88,seq146,r_145_15_88,1.0,-1,87,88,32
6,r_103_64_161,seq104,seq65,r_103_64_161,0.61,0,161,161,32
43,r_107_16_144,r_72_106_72,seq17,r_107_16_144,0.86,0,144,144,32
13,r_13_89_16,r_12_42_41,seq87,r_13_89_16,0.99,0,16,16,32
99,seq125,r_119_74_193,r_111_128_43,r_111_128_43,1.0,116,159,43,32
5,r_114_27_66,r_24_46_145,r_45_25_125,r_114_27_66,0.78,79,145,66,32
19,r_92_120_20,r_90_62_109,seq121,r_92_120_20,0.98,0,20,20,32
30,r_41_58_26,r_45_25_125,r_57_14_142,r_41_58_26,0.98,3,29,26,32
27,r_55_71_117,r_52_68_122,r_77_67_98,r_77_67_98,0.84,19,117,98,32
30,r_41_58_26,r_57_14_142,r_115_50_136,r_41_58_26,0.77,116,142,26,32
79,seq69,seq66,r_52_68_122,r_52_68_122,0.95,16,138,122,32
42,r_9_138_45,seq11,seq137,r_9_138_45,1.0,0,45,45,32
47,r_72_106_72,r_70_44_175,r_107_16_144,r_70_44_175,0.5,-103,72,175,32
18,r_22_47_161,r_23_59_135,r_45_25_125,r_22_47_161,0.59,-26,135,161,32
29,r_45_25_125,seq40,r_114_27_66,r_114_27_66,1.0,59,125,66,32
24,r_53_133_140,r_52_68_122,r_90_62_109,r_53_133_140,0.59,-18,122,140,32
96,seq121,seq118,r_92_120_20,r_92_120_20,1.0,8,28,20,32
34,r_57_14_142,r_41_58_26,r_21_10_30,r_57_14_142,0.71,0,142,142,32
25,r_33_127_151,r_35_18_162,r_111_128_43,r_33_127_151,0.82,0,151,151,32
64,seq31,r_30_26_160,r_12_42_41,r_12_42_41,0.66,122,163,41,32
47,r_72_106_72,r_107_16_144,r_141_101_41,r_107_16_144,0.98,0,144,144,32
50,seq131,r_129_56_168,r_73_130_30,r_73_130_30,0.68,120,150,30,32
58,seq17,seq20,r_107_16_144,r_107_16_144,0.88,3,147,144,32
24,r_53_133_140,r_90_62_109,seq134,r_53_133_140,0.95,0,140,140,32
33,r_79_29_16,r_78_122_71,seq31,r_79_29_16,0.96,-1,15,16,32
38,r_23_59_135,r_22_47_161,seq60,r_23_59_135,0.6,0,135,135,32
52,seq6,r_4_0_116,r_3_1_40,r_4_0_116,0.91,0,116,116,32
94,seq116,r_115_50_136,r_54_113_5,r_115_50_136,0.46,0,136,136,32
9,r_24_46_145,r_22_47_161,r_12_42_41,r_12_42_41,0.98,103,144,41,32
14,r_21_10_30,r_22_47_161,seq11,r_21_10_30,0.89,1,31,30,32
18,r_22_47_161,r_45_25_125,r_12_42_41,r_22_47_161,0.47,0,161,161,32
22,r_129_56_168,seq131,r_115_50_136,r_115_50_136,0.71,33,169,136,32
28,r_145_15_88,seq143,r_21_10_30,r_145_15_88,1.0,0,88,88,32
46,r_141_101_41,seq149,seq104,r_141_101_41,1.0,0,41,41,32
41,r_81_93_36,r_77_67_98,seq94,r_77_67_98,0.56,-50,48,98,32
49,r_5_147_93,seq6,seq146,r_5_147_93,0.98,0,93,93,32
44,r_4_0_116,seq6,r_21_10_30,r_21_10_30,0.77,81,111,30,32
12,r_77_67_98,r_76_144_108,seq66,r_76_144_108,0.83,-10,98,108,32
93,seq114,seq110,r_2_113_80,r_2_113_80,0.98,1,81,80,33
37,r_145_85_93,r_146_63_47,seq148,r_146_63_47,0.97,0,47,47,33
51,seq130,seq131,r_97_129_65,r_97_129_65,1.0,63,128,65,33
66,seq23,r_17_84_156,seq11,r_17_84_156,1.0,-3,153,156,33
14,r_48_52_125,seq49,r_74_56_92,r_74_56_92,1.0,51,143,92,33
8,r_42_4_201,r_43_78_181,r_27_38_63,r_43_78_181,1.0,0,181,181,33
54,seq6,r_7_126_186,r_99_8_80,r_99_8_80,1.0,99,179,80,33
83,seq86,r_88_77_76,r_22_87_70,r_22_87_70,1.0,8,78,70,33
39,r_43_78_181,r_42_4_201,r_88_77_76,r_88_77_76,0.49,105,181,76,33
1,r_124_121_106,r_122_9_123,seq117,r_122_9_123,0.57,-17,106,123,33
97,seq148,r_147_115_133,r_145_85_93,r_147_115_133,0.48,-71,62,133,33
5,r_95_149_115,seq96,seq148,r_95_149_115,0.66,0,115,115,33
80,seq65,r_62_101_175,r_146_63_47,r_146_63_47,1.0,128,175,47,33
19,r_3_57_89,seq5,seq58,r_3_57_89,0.9,-3,86,89,33
21,r_144_66_30,r_143_73_44,r_75_68_16,r_75_68_16,0.63,15,31,16,33
66,seq23,r_22_87_70,r_17_84_156,r_22_87_70,1.0,0,70,70,33
44,r_70_93_34,seq69,r_109_94_3,r_70_93_34,1.0,0,34,34,33
76,seq49,r_48_52_125,seq65,r_48_52_125,0.52,-13,112,125,33
38,r_24_16_185,r_82_26_103,seq18,r_24_16_185,0.86,0,185,185,33
31,r_99_8_80,seq100,r_7_126_186,r_99_8_80,1.0,0,80,80,33
41,r_7_126_186,seq6,r_99_8_80,r_99_8_80,1.0,58,138,80,33
3,r_12_90_106,r_10_51_205,r_22_87_70,r_10_51_205,1.0,-99,106,205,33
10,r_22_87_70,seq23,seq86,r_22_87_70,1.0,0,70,70,33
26,r_97_129_65,seq103,seq128,r_97_129_65,1.0,0,65,65,33
0,r_104_91_119,seq103,r_109_94_3,r_104_91_119,0.57,6,125,119,33
73,seq40,r_41_21_135,seq35,r_41_21_135,0.98,0,135,135,33
20,r_41_21_135,seq40,seq20,r_41_21_135,0.88,0,135,135,33
13,r_92_72_169,r_109_94_3,r_118_71_29,r_92_72_169,0.51,0,169,169,33
46,r_146_63_47,r_145_85_93,seq65,r_146_63_47,1.0,0,47,47,33
15,r_139_120_146,seq141,seq117,r_139_120_146,0.73,0,146,146,33
48,r_0_14_98,r_2_113_80,r_36_1_63,r_0_14_98,0.94,-24,74,98,33
6,r_37_89_149,r_27_38_63,r_12_90_106,r_37_89_149,0.88,0,149,149,33
85,seq100,r_99_8_80,seq103,r_99_8_80,1.0,-8,72,80,33
11,r_143_73_44,seq141,seq79,r_143_73_44,1.0,0,44,44,33
27,r_118_71_29,seq117,seq69,r_118_71_29,0.96,0,29,29,33
87,seq103,r_104_91_119,seq100,r_104_91_119,0.58,0,119,119,33
22,r_36_1_63,r_0_14_98,seq11,r_36_1_63,0.51,104,167,63,33
2,r_81_44_87,r_83_80_1,seq45,r_81_44_87,1.0,1,88,87,33
47,r_67_60_180,r_75_68_16,r_146_63_47,r_75_68_16,0.56,164,180,16,33
40,r_25_54_103,r_24_16_185,seq53,r_25_54_103,0.93,0,103,103,33
24,r_122_9_123,seq123,seq11,r_122_9_123,0.98,1,124,123,33
25,r_61_140_134,r_62_101_175,seq142,r_61_140_134,0.99,0,134,134,33
33,r_62_101_175,seq65,seq102,r_62_101_175,0.2,0,175,175,33
50,seq128,seq131,r_97_129_65,r_97_129_65,1.0,8,73,65,33
32,r_2_113_80,r_0_14_98,seq114,r_2_113_80,1.0,0,80,80,33
38,r_24_16_185,r_25_54_103,r_82_26_103,r_82_26_103,0.92,0,103,103,33
52,seq131,seq130,r_97_129_65,r_97_129_65,1.0,49,114,65,33
34,r_74_56_92,seq79,r_64_55_23,r_74_56_92,1.0,0,92,92,33
3,r_12_90_106,r_22_87_70,r_37_89_149,r_37_89_149,1.0,4,153,149,33
97,seq148,seq135,r_95_149_115,r_95_149_115,0.73,3,118,115,33
41,r_7_126_186,r_99_8_80,r_133_127_41,r_7_126_186,0.76,0,186,186,33
48,r_0_14_98,r_36_1_63,seq18,r_36_1_63,0.52,35,98,63,33
17,r_82_26_103,seq79,r_24_16_185,r_82_26_103,1.0,0,103,103,33
9,r_39_132_67,r_37_89_149,r_97_129_65,r_39_132_67,1.0,0,67,67,33
31,r_99_8_80,r_7_126_186,seq6,r_7_126_186,0.83,0,186,186,33
22,r_36_1_63,seq35,r_0_14_98,r_36_1_63,1.0,0,63,63,33
28,r_75_68_16,r_67_60_180,r_144_66_30,r_144_66_30,0.63,149,179,30,33
36,r_133_127_41,seq135,seq123,r_133_127_41,0.99,0,41,41,33
49,r_15_31_62,r_17_84_156,r_46_33_40,r_15_31_62,1.0,0,62,62,33
17,r_82_26_103,r_24_16_185,r_81_44_87,r_82_26_103,0.49,76,179,103,33
79,seq58,r_64_55_23,r_3_57_89,r_3_57_89,1.0,23,112,89,33
35,r_107_98_92,seq106,seq103,r_107_98_92,0.71,1,93,92,33
51,seq4,seq7,r_70_5_176,r_70_5_176,0.87,5,181,176,34
42,r_76_21_31,r_73_98_73,r_19_148_80,r_76_21_31,0.98,0,31,31,34
14,r_38_35_70,r_54_12_95,seq36,r_38_35_70,0.99,0,70,70,34
29,r_29_94_45,seq27,r_132_87_40,r_29_94_45,1.0,0,45,45,34
43,r_131_140_82,r_122_128_30,r_96_136_25,r_96_136_25,0.84,57,82,25,34
37,r_86_37_86,r_85_41_77,seq84,r_85_41_77,0.99,0,77,77,34
59,seq26,r_24_118_177,r_13_22_106,r_13_22_106,0.9,71,177,106,34
86,seq101,seq102,r_0_100_61,r_0_100_61,1.0,26,87,61,34
21,r_82_47_118,r_81_116_76,r_137_80_3,r_81_116_76,0.99,0,76,76,34
39,r_73_98_73,seq84,r_3_99_18,r_3_99_18,0.99,55,73,18,34
46,r_146_60_192,seq147,seq61,r_146_60_192,0.54,0,192,192,34
42,r_76_21_31,seq14,r_121_20_123,r_121_20_123,1.0,1,124,123,34
4,r_130_6_59,r_122_128_30,seq7,r_130_6_59,1.0,0,59,59,34
21,r_82_47_118,r_137_80_3,r_110_42_61,r_82_47_118,1.0,0,118,118,34
45,r_0_100_61,seq1,seq101,r_0_100_61,1.0,0,61,61,34
19,r_18_88_93,r_19_148_80,r_16_11_187,r_19_148_80,0.99,-11,69,80,34
77,seq72,seq101,r_33_97_120,r_33_97_120,1.0,55,175,120,34
95,seq117,seq115,r_81_116_76,r_81_116_76,1.0,0,76,76,34
31,r_13_22_106,seq14,seq26,r_13_22_106,0.99,0,106,106,34
26,r_124_144_47,r_130_6_59,r_143_57_196,r_130_6_59,0.8,-10,49,59,34
11,r_134_113_92,r_96_136_25,r_122_128_30,r_134_113_92,0.46,62,154,92,34
47,r_89_129_15,r_96_136_25,r_122_128_30,r_122_128_30,0.96,-15,15,30,34
42,r_76_21_31,r_19_148_80,seq14,r_19_148_80,0.91,0,80,80,34
0,r_33_97_120,seq30,r_29_94_45,r_33_97_120,0.6,0,120,120,34
63,seq36,seq30,r_86_37_86,r_86_37_86,1.0,11,97,86,34
11,r_134_113_92,r_122_128_30,r_96_136_25,r_122_128_30,0.6,75,105,30,34
20,r_120_149_162,seq119,r_19_148_80,r_19_148_80,1.0,82,162,80,34
13,r_111_75_106,seq109,r_71_74_52,r_71_74_52,0.67,54,106,52,34
15,r_40_59_174,seq55,seq61,r_40_59_174,0.62,0,174,174,34
48,r_85_41_77,r_86_37_86,r_110_42_61,r_86_37_86,0.99,-9,77,86,34
12,r_3_99_18,r_104_103_24,r_73_98_73,r_73_98_73,0.9,14,87,73,34
6,r_110_42_61,seq109,seq43,r_110_42_61,1.0,1,62,61,34
9,r_19_148_80,r_18_88_93,r_76_21_31,r_76_21_31,1.0,6,37,31,34
12,r_3_99_18,r_2_78_85,r_104_103_24,r_3_99_18,0.99,0,18,18,34
27,r_31_50_19,r_33_97_120,seq55,r_31_50_19,0.98,2,21,19,34
11,r_134_113_92,r_122_128_30,r_19_148_80,r_122_128_30,0.35,143,173,30,34
41,r_132_87_40,seq90,r_18_88_93,r_18_88_93,1.0,14,107,93,34
93,seq114,r_25_123_9,r_143_57_196,r_143_57_196,0.64,-76,120,196,34
18,r_54_12_95,seq52,seq14,r_54_12_95,0.99,0,95,95,34
9,r_19_148_80,r_76_21_31,seq147,r_19_148_80,1.0,0,80,80,34
25,r_145_51_63,r_146_60_192,r_31_50_19,r_145_51_63,1.0,0,63,63,34
3,r_135_28_28,r_130_6_59,seq27,r_135_28_28,1.0,1,29,28,34
64,seq43,r_44_46_99,r_110_42_61,r_110_42_61,1.0,1,62,61,34
88,seq105,r_104_103_24,r_0_100_61,r_0_100_61,1.0,26,87,61,34
50,seq1,r_0_100_61,seq7,r_0_100_61,1.0,0,61,61,34
32,r_133_23_163,r_122_128_30,r_13_22_106,r_133_23_163,0.85,0,163,163,34
38,r_81_116_76,r_82_47_118,seq117,r_81_116_76,1.0,0,76,76,34
52,seq7,r_8_108_132,r_130_6_59,r_130_6_59,0.95,73,132,59,34
34,r_24_118_177,seq26,seq117,r_24_118_177,0.74,0,177,177,34
24,r_67_34_23,seq68,seq30,r_67_34_23,1.0,0,23,23,34
81,seq142,r_141_83_187,r_124_144_47,r_124_144_47,1.0,140,187,47,34
93,seq114,r_143_57_196,r_122_128_30,r_143_57_196,0.97,-18,178,196,34
96,seq119,r_120_149_162,r_81_116_76,r_81_116_76,1.0,88,164,76,34
22,r_2_78_85,seq4,r_137_80_3,r_2_78_85,0.99,0,85,85,34
28,r_8_108_132,seq7,seq106,r_8_108_132,0.83,0,132,132,34
49,r_71_74_52,r_70_5_176,seq112,r_71_74_52,0.89,19,71,52,34
7,r_121_20_123,seq119,r_76_21_31,r_121_20_123,0.99,1,124,123,34
17,r_96_136_25,r_86_37_86,r_131_140_82,r_96_136_25,1.0,0,25,25,34
41,r_132_87_40,r_130_6_59,seq90,r_132_87_40,0.99,0,40,40,34
19,r_18_88_93,r_16_11_187,r_132_87_40,r_18_88_93,0.96,0,93,93,34
45,r_2_29_192,r_103_5_35,r_117_39_17,r_2_29_192,0.33,1,193,192,35
40,r_7_51_107,r_26_57_36,r_6_44_96,r_7_51_107,0.33,61,168,107,35
30,r_83_138_63,seq87,seq140,r_83_138_63,0.97,6,69,63,35
36,r_70_37_68,seq71,r_117_39_17,r_70_37_68,1.0,0,68,68,35
8,r_10_97_182,r_9_80_164,r_34_12_51,r_34_12_51,1.0,113,164,51,35
53,seq140,r_139_82_133,r_83_138_63,r_83_138_63,0.79,0,63,63,35
43,r_100_75_148,seq108,r_62_101_108,r_62_101_108,1.0,2,110,108,35
37,r_139_82_133,seq140,seq85,r_139_82_133,0.8,1,134,133,35
16,r_1_86_72,r_3_60_181,seq87,r_1_86_72,1.0,0,72,72,35
1,r_136_78_118,seq142,seq76,r_136_78_118,0.94,0,118,118,35
5,r_127_47_189,seq125,r_6_44_96,r_6_44_96,0.44,93,189,96,35
46,r_148_128_116,seq149,r_106_131_87,r_106_131_87,0.66,38,125,87,35
42,r_115_141_194,seq124,r_59_137_46,r_59_137_46,1.0,148,194,46,35
11,r_38_54_63,seq40,r_18_56_25,r_18_56_25,0.99,8,33,25,35
51,seq134,seq135,r_122_133_36,r_122_133_36,0.44,15,51,36,35
45,r_2_29_192,r_3_60_181,r_103_5_35,r_103_5_35,0.77,147,182,35,35
21,r_27_25_22,r_28_69_94,seq23,r_27_25_22,1.0,0,22,22,35
19,r_106_131_87,seq108,r_122_133_36,r_106_131_87,0.56,0,87,87,35
8,r_10_97_182,r_34_12_51,r_132_98_78,r_10_97_182,0.86,0,182,182,35
49,r_34_12_51,r_33_119_125,r_10_97_182,r_34_12_51,0.98,2,53,51,35
76,seq71,r_68_102_183,r_28_69_94,r_28_69_94,1.0,89,183,94,35
31,r_31_130_136,r_30_20_154,r_106_131_87,r_31_130_136,0.91,0,136,136,35
17,r_50_45_32,r_49_61_61,seq46,r_50_45_32,0.75,0,32,32,35
10,r_114_81_70,r_115_141_194,seq85,r_114_81_70,0.97,0,70,70,35
71,seq52,r_55_35_109,r_18_56_25,r_18_56_25,1.0,2,27,25,35
43,r_100_75_148,r_62_101_108,seq76,r_100_75_148,0.97,0,148,148,35
4,r_49_61_61,r_50_45_32,r_26_57_36,r_26_57_36,1.0,62,98,36,35
32,r_129_74_185,r_83_138_63,r_106_131_87,r_129_74_185,0.45,-46,139,185,35
26,r_103_5_35,seq104,r_6_44_96,r_103_5_35,1.0,0,35,35,35
63,seq32,r_33_119_125,r_55_35_109,r_33_119_125,1.0,1,126,125,35
3,r_26_57_36,seq19,seq58,r_26_57_36,1.0,0,36,36,35
13,r_33_119_125,seq32,seq120,r_33_119_125,0.97,1,126,125,35
48,r_95_109_116,seq99,seq110,r_95_109_116,0.92,0,116,116,35
49,r_34_12_51,r_10_97_182,r_103_5_35,r_10_97_182,0.94,0,182,182,35
65,seq40,r_38_54_63,r_117_39_17,r_117_39_17,1.0,0,17,17,35
50,seq4,r_3_60_181,r_103_5_35,r_3_60_181,0.44,-17,164,181,35
27,r_62_101_108,seq63,r_100_75_148,r_62_101_108,0.96,1,109,108,35
39,r_122_133_36,r_121_17_128,seq134,r_122_133_36,0.54,-1,35,36,35
87,seq99,r_96_77_179,r_132_98_78,r_132_98_78,1.0,8,86,78,35
47,r_92_123_159,seq91,r_33_119_125,r_33_119_125,0.9,34,159,125,35
20,r_59_137_46,seq48,seq140,r_59_137_46,1.0,0,46,46,35
40,r_7_51_107,r_10_97_182,r_26_57_36,r_7_51_107,0.96,0,107,107,35
18,r_9_80_164,r_10_97_182,r_100_75_148,r_100_75_148,0.97,16,164,148,35
29,r_68_102_183,seq71,r_14_105_178,r_14_105_178,0.71,8,186,178,35
24,r_8_94_60,r_10_97_182,seq99,r_8_94_60,1.0,0,60,60,35
25,r_30_20_154,r_55_35_109,r_121_17_128,r_30_20_154,0.48,0,154,154,35
27,r_62_101_108,r_100_75_148,r_116_107_48,r_100_75_148,0.98,0,148,148,35
25,r_30_20_154,r_31_130_136,r_55_35_109,r_31_130_136,0.78,0,136,136,35
14,r_117_39_17,r_116_107_48,seq40,r_117_39_17,1.0,0,17,17,35
33,r_132_98_78,r_129_74_185,seq99,r_132_98_78,1.0,4,82,78,35
50,seq4,r_7_51_107,r_3_60_181,r_7_51_107,1.0,1,108,107,35
32,r_129_74_185,r_132_98_78,r_83_138_63,r_129_74_185,1.0,-104,81,185,35
38,r_121_17_128,seq120,seq19,r_121_17_128,0.93,0,128,128,35
19,r_106_131_87,r_122_133_36,r_31_130_136,r_31_130_136,1.0,6,142,136,35
34,r_11_66_108,r_10_97_182,seq65,r_11_66_108,0.91,0,108,108,35
9,r_6_44_96,r_7_51_107,r_50_45_32,r_50_45_32,1.0,64,96,32,35
26,r_103_5_35,r_6_44_96,r_34_12_51,r_6_44_96,1.0,0,96,96,35
28,r_28_69_94,r_31_130_136,seq71,r_28_69_94,0.74,0,94,94,35
41,r_116_107_48,r_115_141_194,seq110,r_116_107_48,0.97,0,48,48,35
7,r_143_13_146,seq142,seq15,r_143_13_146,0.79,0,146,146,35
44,r_53_79_63,r_55_35_109,seq76,r_53_79_63,1.0,0,63,63,35
23,r_3_60_181,r_2_29_192,r_49_61_61,r_49_61_61,0.94,120,181,61,35
35,r_111_67_192,seq112,r_114_81_70,r_114_81_70,0.87,119,189,70,35
12,r_96_77_179,seq99,r_136_78_118,r_136_78_118,0.96,61,179,118,35
40,r_121_110_37,seq113,r_51_111_57,r_51_111_57,0.96,61,118,57,36
30,r_101_93_42,r_104_34_160,seq91,r_104_34_160,0.67,0,160,160,36
36,r_16_132_117,seq10,seq133,r_16_132_117,0.96,0,117,117,36
14,r_99_69_64,r_101_93_42,seq68,r_99_69_64,0.99,0,64,64,36
53,seq4,r_2_58_182,r_22_3_33,r_22_3_33,0.54,38,71,33,36
43,r_96_84_88,seq97,seq83,r_96_84_88,1.0,0,88,88,36
45,r_11_85_14,r_14_98_20,seq83,r_11_85_14,0.91,0,14,14,36
17,r_100_26_14,r_104_34_160,seq27,r_100_26_14,0.97,0,14,14,36
16,r_77_17_171,seq76,r_127_18_139,r_127_18_139,0.84,34,173,139,36
39,r_138_35_105,seq137,seq33,r_138_35_105,0.92,0,105,105,36
1,r_5_118_134,seq6,seq119,r_5_118_134,0.77,0,134,134,36
5,r_13_52_68,r_12_116_101,seq50,r_13_52_68,0.99,1,69,68,36
88,seq83,r_11_85_14,r_96_84_88,r_96_84_88,1.0,3,91,88,36
69,seq33,seq37,r_138_35_105,r_138_35_105,1.0,16,121,105,36
3,r_57_82_53,r_60_54_36,r_135_59_12,r_135_59_12,0.52,2,14,12,36
8,r_104_34_160,r_101_93_42,r_105_15_193,r_101_93_42,0.97,12,54,42,36
58,seq10,r_16_132_117,r_9_125_187,r_16_132_117,1.0,0,117,117,36
12,r_60_54_36,seq61,seq53,r_60_54_36,1.0,-1,35,36,36
34,r_124_40_49,seq123,r_55_42_29,r_124_40_49,1.0,0,49,49,36
21,r_103_19_28,r_13_52_68,seq21,r_103_19_28,0.4,153,181,28,36
2,r_14_98_20,r_99_69_64,seq107,r_99_69_64,1.0,0,64,64,36
13,r_41_8_141,r_9_125_187,r_127_18_139,r_9_125_187,1.0,0,187,187,36
33,r_22_3_33,r_24_63_82,seq4,r_24_63_82,0.5,-49,33,82,36
10,r_56_46_5,r_47_143_116,r_44_45_143,r_47_143_116,0.99,0,116,116,36
90,seq91,r_92_38_135,seq95,r_92_38_135,1.0,0,135,135,36
26,r_114_89_114,r_115_112_90,r_120_109_117,r_114_89_114,0.4,-24,90,114,36
8,r_104_34_160,r_105_15_193,seq33,r_105_15_193,0.66,-28,165,193,36
4,r_115_112_90,r_114_89_114,seq113,r_115_112_90,0.6,0,90,90,36
0,r_106_130_79,seq107,seq131,r_106_130_79,0.94,12,91,79,36
63,seq148,r_149_122_97,r_87_146_41,r_87_146_41,0.73,57,98,41,36
11,r_55_42_29,r_41_8_141,r_124_40_49,r_124_40_49,1.0,92,141,49,36
29,r_51_111_57,seq50,r_121_110_37,r_51_111_57,1.0,0,57,57,36
20,r_12_116_101,seq10,seq119,r_12_116_101,1.0,0,101,101,36
15,r_29_1_177,r_31_23_188,seq0,r_29_1_177,0.61,0,177,177,36
48,r_44_45_143,seq48,r_56_46_5,r_56_46_5,0.48,80,85,5,36
95,seq113,r_136_86_187,r_121_110_37,r_121_110_37,0.62,-16,21,37,36
13,r_41_8_141,r_55_42_29,r_9_125_187,r_41_8_141,0.98,0,141,141,36
21,r_103_19_28,r_20_72_121,r_60_54_36,r_103_19_28,0.94,68,96,28,36
21,r_103_19_28,r_60_54_36,r_13_52_68,r_103_19_28,0.56,120,148,28,36
46,r_135_59_12,r_136_86_187,r_57_82_53,r_135_59_12,0.84,0,12,12,36
87,seq81,seq80,r_57_82_53,r_57_82_53,1.0,43,96,53,36
77,seq61,r_135_59_12,r_94_64_78,r_94_64_78,1.0,0,78,78,36
21,r_103_19_28,r_106_130_79,r_20_72_121,r_103_19_28,1.0,1,29,28,36
88,seq83,seq80,r_11_85_14,r_11_85_14,0.83,6,20,14,36
18,r_47_143_116,seq48,r_87_146_41,r_47_143_116,0.98,0,116,116,36
24,r_31_23_188,seq28,seq21,r_31_23_188,0.27,3,191,188,36
13,r_41_8_141,r_47_143_116,r_55_42_29,r_41_8_141,0.84,-110,31,141,36
25,r_136_86_187,seq133,r_11_85_14,r_11_85_14,0.63,174,188,14,36
58,seq10,r_12_116_101,r_16_132_117,r_12_116_101,0.96,0,101,101,36
2,r_14_98_20,r_12_116_101,r_99_69_64,r_14_98_20,0.99,0,20,20,36
65,seq25,r_24_63_82,seq21,r_24_63_82,1.0,0,82,82,36
3,r_57_82_53,r_135_59_12,seq81,r_57_82_53,1.0,0,53,53,36
26,r_114_89_114,r_120_109_117,seq88,r_114_89_114,0.57,0,114,114,36
32,r_105_15_193,r_104_34_160,seq102,r_104_34_160,0.8,0,160,160,36
38,r_94_64_78,r_96_84_88,r_24_63_82,r_94_64_78,0.99,4,82,78,36
46,r_135_59_12,r_57_82_53,seq61,r_57_82_53,0.88,1,54,53,36
27,r_78_39_36,r_77_17_171,seq37,r_78_39_36,1.0,0,36,36,36
9,r_120_109_117,seq119,r_51_111_57,r_51_111_57,1.0,61,118,57,36
49,r_9_125_187,r_41_8_141,r_106_130_79,r_9_125_187,1.0,0,187,187,36
98,seq123,seq128,r_12_116_101,r_12_116_101,1.0,51,152,101,36
29,r_51_111_57,r_121_110_37,r_115_112_90,r_115_112_90,0.89,67,157,90,36
22,r_24_63_82,seq25,r_94_64_78,r_24_63_82,1.0,0,82,82,36
49,r_9_125_187,seq10,r_41_8_141,r_41_8_141,0.73,6,147,141,36
98,seq123,r_124_40_49,seq128,r_124_40_49,1.0,0,49,49,36
7,r_127_18_139,seq128,seq10,r_127_18_139,0.84,0,139,139,36
44,r_20_72_121,seq25,seq75,r_20_72_121,0.91,0,121,121,36
23,r_2_58_182,seq0,r_135_59_12,r_2_58_182,0.55,0,182,182,36
76,seq53,r_55_42_29,r_60_54_36,r_60_54_36,1.0,-1,35,36,36
35,r_74_36_72,r_73_108_133,r_78_39_36,r_73_108_133,0.94,-61,72,133,36
95,seq113,r_121_110_37,r_115_112_90,r_115_112_90,0.58,7,97,90,36
84,seq76,r_77_17_171,r_20_72_121,r_20_72_121,1.0,50,171,121,36
40,r_117_14_169,r_56_114_55,r_82_23_4,r_117_14_169,0.93,0,169,169,37
8,r_26_134_80,r_27_12_88,r_47_131_45,r_26_134_80,0.54,0,80,80,37
53,seq13,seq17,r_31_25_76,r_31_25_76,0.96,23,99,76,37
37,r_77_149_170,seq76,seq148,r_77_149_170,0.62,0,170,170,37
16,r_73_42_169,r_71_57_195,seq76,r_73_42_169,0.41,-92,77,169,37
21,r_19_118_78,r_18_30_159,seq120,r_19_118_78,0.95,0,78,78,37
39,r_132_94_168,seq129,r_147_96_104,r_147_96_104,0.95,64,168,104,37
5,r_107_86_145,r_113_106_93,r_39_88_80,r_107_86_145,0.51,1,146,145,37
42,r_85_116_126,seq83,r_125_119_112,r_85_116_126,0.9,0,126,126,37
38,r_136_2_39,r_133_128_114,r_1_70_58,r_136_2_39,0.74,0,39,39,37
4,r_89_74_25,r_90_139_40,seq76,r_90_139_40,0.52,-15,25,40,37
6,r_75_135_42,r_77_149_170,seq129,r_75_135_42,0.94,0,42,42,37
45,r_35_37_100,seq36,r_126_40_23,r_126_40_23,1.0,93,116,23,37
10,r_137_72_20,r_133_128_114,seq68,r_137_72_20,1.0,0,20,20,37
19,r_125_119_112,seq124,r_19_118_78,r_125_119_112,1.0,0,112,112,37
2,r_84_61_21,r_90_139_40,seq62,r_84_61_21,0.57,0,21,21,37
95,seq120,r_113_106_93,r_19_118_78,r_19_118_78,1.0,2,80,78,37
27,r_47_131_45,seq46,seq129,r_47_131_45,1.0,0,45,45,37
51,seq6,r_4_7_167,r_109_5_14,r_109_5_14,1.0,0,14,14,37
31,r_27_12_88,r_28_130_183,r_115_9_96,r_27_12_88,0.66,13,101,88,37
14,r_109_5_14,r_107_86_145,seq6,r_109_5_14,0.96,0,14,14,37
41,r_31_25_76,seq33,seq24,r_31_25_76,0.78,9,85,76,37
30,r_44_87_34,r_47_131_45,seq83,r_47_131_45,0.61,-11,34,45,37
28,r_8_144_112,r_27_12_88,r_11_143_101,r_8_144_112,0.76,0,112,112,37
96,seq148,r_26_134_80,r_77_149_170,r_77_149_170,0.99,8,178,170,37
26,r_39_88_80,seq36,r_44_87_34,r_39_88_80,0.86,1,81,80,37
16,r_73_42_169,seq76,r_126_40_23,r_73_42_169,0.48,0,169,169,37
0,r_4_7_167,seq6,r_27_12_88,r_4_7_167,0.3,8,175,167,37
99,seq124,r_127_38_175,r_133_128_114,r_127_38_175,1.0,0,175,175,37
13,r_147_96_104,seq148,seq95,r_147_96_104,0.96,0,104,104,37
48,r_111_15_142,seq103,seq16,r_111_15_142,0.77,0,142,142,37
99,seq124,r_125_119_112,r_127_38_175,r_125_119_112,1.0,0,112,112,37
30,r_44_87_34,seq83,r_107_86_145,r_107_86_145,1.0,10,155,145,37
35,r_141_51_137,r_140_58_50,r_90_139_40,r_141_51_137,0.99,-88,49,137,37
47,r_115_9_96,r_117_14_169,r_27_12_88,r_115_9_96,0.9,0,96,96,37
40,r_117_14_169,r_115_9_96,r_56_114_55,r_117_14_169,0.95,-74,95,169,37
18,r_121_67_141,seq122,seq66,r_121_67_141,0.91,0,141,141,37
29,r_98_32_128,seq99,seq33,r_98_32_128,0.89,1,129,128,37
34,r_90_139_40,r_141_51_137,seq129,r_141_51_137,0.93,0,137,137,37
35,r_141_51_137,r_90_139_40,r_101_52_32,r_141_51_137,1.0,0,137,137,37
25,r_127_38_175,seq124,r_73_42_169,r_127_38_175,0.73,0,175,175,37
49,r_1_70_58,r_136_2_39,seq69,r_1_70_58,0.92,0,58,58,37
50,seq129,r_133_128_114,r_47_131_45,r_47_131_45,1.0,32,77,45,37
44,r_56_114_55,seq55,seq110,r_56_114_55,1.0,0,55,55,37
61,seq33,seq36,r_98_32_128,r_98_32_128,1.0,15,143,128,37
32,r_3_146_126,r_4_7_167,seq145,r_3_146_126,0.97,1,127,126,37
52,seq145,seq142,r_147_96_104,r_147_96_104,0.54,-16,88,104,37
15,r_49_105_10,r_73_42_169,r_113_106_93,r_49_105_10,0.84,2,12,10,37
22,r_100_78_48,r_98_32_128,seq79,r_100_78_48,0.99,0,48,48,37
60,seq29,r_28_130_183,r_18_30_159,r_28_130_183,0.66,0,183,183,37
34,r_90_139_40,seq83,r_141_51_137,r_90_139_40,1.0,0,40,40,37
33,r_10_21_52,r_11_143_101,r_82_23_4,r_10_21_52,0.53,0,52,52,37
49,r_1_70_58,r_26_134_80,r_136_2_39,r_136_2_39,0.98,2,41,39,37
38,r_136_2_39,r_1_70_58,seq29,r_1_70_58,0.85,0,58,58,37
28,r_8_144_112,r_11_143_101,r_27_12_88,r_11_143_101,0.51,0,101,101,37
20,r_126_40_23,r_127_38_175,r_35_37_100,r_126_40_23,0.99,0,23,23,37
79,seq69,seq68,r_1_70_58,r_1_70_58,1.0,68,126,58,37
12,r_28_130_183,seq29,r_47_131_45,r_47_131_45,0.9,138,183,45,37
84,seq83,r_90_139_40,r_44_87_34,r_90_139_40,0.83,-2,38,40,37
36,r_0_2_65,r_1_106_170,r_50_7_136,r_50_7_136,0.54,10,146,136,38
14,r_89_134_193,r_95_88_80,r_75_91_121,r_75_91_121,0.92,24,145,121,38
8,r_14_55_91,seq13,seq53,r_14_55_91,0.98,0,91,91,38
53,seq5,seq3,r_33_4_69,r_33_4_69,1.0,60,129,69,38
43,r_52_140_79,r_57_30_115,r_20_141_72,r_52_140_79,0.98,0,79,79,38
11,r_95_88_80,r_92_64_166,r_15_85_33,r_95_88_80,0.86,-3,77,80,38
54,seq10,seq18,r_50_7_136,r_50_7_136,0.95,12,148,136,38
37,r_59_67_63,r_62_78_189,r_68_69_151,r_59_67_63,0.43,52,115,63,38
30,r_145_122_53,r_146_138_135,r_125_123_5,r_145_122_53,0.92,0,53,53,38
16,r_119_98_97,seq121,r_116_100_27,r_119_98_97,0.53,0,97,97,38
39,r_143_107_102,r_146_138_135,r_142_110_97,r_146_138_135,0.99,-33,102,135,38
1,r_25_8_180,seq26,r_114_9_173,r_114_9_173,0.57,5,178,173,38
42,r_49_87_156,seq48,r_80_86_120,r_49_87_156,0.62,0,156,156,38
45,r_144_77_95,r_146_138_135,seq76,r_144_77_95,0.83,0,95,95,38
31,r_50_7_136,r_51_111_42,seq53,r_51_111_42,0.96,0,42,42,38
24,r_92_64_166,r_126_93_74,r_59_67_63,r_92_64_166,0.61,0,166,166,38
19,r_20_141_72,seq18,r_142_110_97,r_20_141_72,0.96,1,73,72,38
2,r_31_117_56,seq26,r_115_128_123,r_31_117_56,0.78,1,57,56,38
9,r_116_100_27,seq102,r_34_99_57,r_34_99_57,0.99,-7,50,57,38
67,seq29,r_32_148_161,r_57_30_115,r_57_30_115,0.91,21,136,115,38
3,r_83_39_65,seq84,seq38,r_83_39_65,0.99,0,65,65,38
26,r_60_124_105,r_62_78_189,seq127,r_60_124_105,0.99,0,105,105,38
9,r_116_100_27,r_115_128_123,seq102,r_116_100_27,0.6,0,27,27,38
0,r_142_110_97,r_146_138_135,r_51_111_42,r_142_110_97,0.68,0,97,97,38
20,r_34_99_57,seq35,r_116_100_27,r_34_99_57,1.0,4,61,57,38
13,r_125_123_5,seq127,r_145_122_53,r_145_122_53,0.78,36,89,53,38
48,r_36_130_30,r_41_139_150,seq127,r_36_130_30,0.64,-1,29,30,38
15,r_137_22_64,r_136_101_70,r_79_19_4,r_137_22_64,1.0,0,64,64,38
27,r_114_9_173,seq132,seq10,r_114_9_173,0.78,1,174,173,38
6,r_115_128_123,r_31_117_56,seq127,r_115_128_123,0.73,1,124,123,38
6,r_115_128_123,r_119_98_97,r_31_117_56,r_31_117_56,0.52,9,65,56,38
22,r_108_37_20,r_94_104_2,seq38,r_108_37_20,1.0,2,22,20,38
99,seq127,seq121,r_115_128_123,r_115_128_123,0.53,23,146,123,38
10,r_32_148_161,seq29,seq149,r_32_148_161,0.96,0,161,161,38
27,r_114_9_173,r_115_128_123,r_95_88_80,r_114_9_173,0.61,-110,63,173,38
35,r_15_85_33,seq16,seq84,r_15_85_33,1.0,1,34,33,38
47,r_97_135_113,seq96,r_146_138_135,r_97_135_113,0.8,0,113,113,38
74,seq48,r_49_87_156,r_129_47_39,r_129_47_39,0.73,117,156,39,38
18,r_75_91_121,seq74,seq90,r_75_91_121,0.96,0,121,121,38
29,r_41_139_150,seq38,r_146_138_135,r_41_139_150,0.68,0,150,150,38
24,r_92_64_166,seq90,r_126_93_74,r_126_93_74,1.0,0,74,74,38
25,r_57_30_115,seq53,seq29,r_57_30_115,1.0,0,115,115,38
33,r_68_69_151,r_65_46_153,seq70,r_65_46_153,0.95,-28,125,153,38
88,seq90,r_92_64_166,r_75_91_121,r_75_91_121,0.94,2,123,121,38
21,r_129_47_39,r_126_93_74,seq48,r_129_47_39,0.99,0,39,39,38
44,r_6_42_26,seq3,seq43,r_6_42_26,0.95,1,27,26,38
32,r_80_86_120,seq76,r_95_88_80,r_80_86_120,0.93,0,120,120,38
38,r_66_61_123,r_65_46_153,seq58,r_65_46_153,0.79,-30,123,153,38
34,r_65_46_153,r_68_69_151,r_129_47_39,r_65_46_153,0.6,0,153,153,38
17,r_33_4_69,r_32_148_161,seq5,r_33_4_69,0.97,0,69,69,38
31,r_50_7_136,seq53,seq3,r_50_7_136,0.9,0,136,136,38
5,r_51_111_42,r_50_7_136,seq109,r_51_111_42,1.0,0,42,42,38
28,r_1_106_170,r_0_2_65,r_142_110_97,r_0_2_65,0.49,105,170,65,38
64,seq26,r_31_117_56,r_25_8_180,r_31_117_56,1.0,-11,45,56,38
11,r_95_88_80,r_97_135_113,r_92_64_166,r_95_88_80,0.53,-35,45,80,38
23,r_126_93_74,seq127,r_92_64_166,r_126_93_74,0.97,0,74,74,38
12,r_146_138_135,r_144_77_95,r_20_141_72,r_146_138_135,0.76,-40,95,135,38
19,r_20_141_72,r_142_110_97,r_52_140_79,r_142_110_97,0.44,0,97,97,38
23,r_126_93_74,r_92_64_166,r_75_91_121,r_75_91_121,0.64,45,166,121,38
8,r_148_135_39,seq147,seq134,r_148_135_39,0.95,0,39,39,39
37,r_117_129_154,r_121_18_50,seq136,r_117_129_154,0.43,-138,16,154,39
92,seq100,r_102_113_174,r_29_101_33,r_29_101_33,1.0,141,174,33,39
14,r_112_31_68,seq115,seq23,r_112_31_68,0.96,0,68,68,39
54,seq136,r_130_119_6,r_6_145_27,r_6_145_27,0.75,13,40,27,39
71,seq52,r_51_122_33,r_12_45_20,r_51_122_33,0.99,0,33,33,39
37,r_117_129_154,seq136,r_131_114_37,r_131_114_37,0.55,2,39,37,39
3,r_12_45_20,r_44_28_76,seq52,r_44_28_76,0.97,3,79,76,39
37,r_117_129_154,r_131_114_37,seq132,r_117_129_154,0.57,-61,93,154,39
21,r_5_91_182,seq3,r_36_89_30,r_36_89_30,0.98,149,179,30,39
39,r_105_13_120,r_106_107_80,seq14,r_105_13_120,0.65,0,120,120,39
42,r_71_37_69,seq73,seq39,r_71_37_69,0.86,1,70,69,39
10,r_15_25_43,r_17_46_122,seq23,r_15_25_43,0.93,2,45,43,39
32,r_131_114_37,seq132,r_7_116_32,r_7_116_32,0.61,6,38,32,39
45,r_87_4_84,seq84,seq3,r_87_4_84,1.0,0,84,84,39
2,r_121_18_50,r_120_127_39,seq21,r_121_18_50,1.0,0,50,50,39
19,r_38_86_118,r_34_74_177,seq84,r_38_86_118,0.74,0,118,118,39
15,r_30_125_11,r_120_127_39,r_51_122_33,r_51_122_33,1.0,103,136,33,39
76,seq60,seq56,r_81_61_127,r_81_61_127,0.99,2,129,127,39
4,r_36_89_30,r_33_133_47,seq90,r_36_89_30,0.99,0,30,30,39
31,r_47_123_22,r_51_122_33,r_121_18_50,r_121_18_50,0.81,-28,22,50,39
67,seq39,r_34_74_177,r_71_37_69,r_71_37_69,1.0,80,149,69,39
41,r_118_68_5,r_59_94_74,r_103_69_25,r_118_68_5,0.51,23,28,5,39
26,r_59_94_74,r_64_79_77,r_96_49_153,r_59_94_74,1.0,0,74,74,39
44,r_19_43_51,seq52,r_11_42_78,r_11_42_78,0.66,0,78,78,39
15,r_30_125_11,r_29_101_33,r_120_127_39,r_30_125_11,0.65,0,11,11,39
11,r_146_76_133,seq142,r_35_75_87,r_146_76_133,0.96,0,133,133,39
44,r_19_43_51,r_20_66_70,seq52,r_19_43_51,0.51,0,51,51,39
48,r_82_67_150,seq84,r_20_66_70,r_82_67_150,0.53,1,151,150,39
36,r_103_69_25,r_102_113_174,r_118_68_5,r_103_69_25,1.0,0,25,25,39
5,r_20_66_70,r_17_46_122,seq63,r_20_66_70,0.93,-2,68,70,39
47,r_128_95_156,seq126,seq93,r_128_95_156,0.62,0,156,156,39
40,r_2_65_114,r_5_91_182,seq63,r_2_65_114,0.74,0,114,114,39
29,r_54_10_80,seq62,r_83_8_25,r_83_8_25,0.63,55,80,25,39
46,r_44_28_76,r_12_45_20,r_112_31_68,r_44_28_76,0.74,0,76,76,39
35,r_35_75_87,r_36_89_30,r_146_76_133,r_146_76_133,1.0,24,157,133,39
25,r_17_46_122,seq16,r_12_45_20,r_17_46_122,0.82,0,122,122,39
88,seq93,r_96_49_153,r_128_95_156,r_96_49_153,0.45,0,153,153,39
12,r_96_49_153,r_59_94_74,seq52,r_96_49_153,1.0,0,153,153,39
70,seq142,seq139,r_50_143_31,r_50_143_31,0.8,56,87,31,39
23,r_29_101_33,r_27_111_35,seq100,r_29_101_33,0.48,0,33,33,39
61,seq147,r_149_48_188,r_6_145_27,r_6_145_27,0.85,129,156,27,39
38,r_102_113_174,seq100,r_131_114_37,r_131_114_37,0.89,137,174,37,39
71,seq52,r_12_45_20,r_96_49_153,r_96_49_153,0.98,15,168,153,39
34,r_106_107_80,r_105_13_120,r_29_101_33,r_106_107_80,0.96,40,120,80,39
60,seq16,r_17_46_122,r_105_13_120,r_105_13_120,1.0,2,122,120,39
24,r_92_138_13,r_96_49_153,seq137,r_92_138_13,0.95,0,13,13,39
30,r_7_116_32,r_5_91_182,seq115,r_7_116_32,1.0,0,32,32,39
17,r_81_61_127,seq80,seq60,r_81_61_127,0.96,0,127,127,39
14,r_112_31_68,seq23,r_44_28_76,r_44_28_76,0.59,41,117,76,39
9,r_11_42_78,r_5_91_182,r_19_43_51,r_5_91_182,1.0,-104,78,182,39
3,r_12_45_20,r_15_25_43,r_44_28_76,r_12_45_20,0.92,-3,17,20,39
26,r_59_94_74,r_96_49_153,seq93,r_96_49_153,1.0,-2,151,153,39
6,r_6_145_27,r_5_91_182,seq142,r_5_91_182,0.9,-155,27,182,39
16,r_27_111_35,r_24_0_177,r_131_114_37,r_27_111_35,1.0,0,35,35,39
31,r_47_123_22,r_121_18_50,r_51_122_33,r_121_18_50,0.97,0,50,50,39
49,r_64_79_77,seq63,seq77,r_64_79_77,1.0,0,77,77,39
3,r_12_45_20,seq52,r_17_46_122,r_17_46_122,0.9,0,122,122,39
5,r_20_66_70,r_19_43_51,r_17_46_122,r_17_46_122,0.61,-97,25,122,39
35,r_35_75_87,r_34_74_177,r_36_89_30,r_34_74_177,0.92,-90,87,177,39
22,r_33_133_47,r_35_75_87,r_148_135_39,r_33_133_47,1.0,0,47,47,39
12,r_96_49_153,seq93,r_59_94_74,r_59_94_74,1.0,27,101,74,39
46,r_44_28_76,r_51_122_33,r_12_45_20,r_44_28_76,0.76,-49,27,76,39
93,seq100,r_101_79_111,r_95_98_80,r_101_79_111,1.0,-1,110,111,40
44,r_14_36_139,r_54_13_43,r_85_34_26,r_14_36_139,0.96,0,139,139,40
51,seq1,seq7,r_102_6_115,r_102_6_115,0.75,60,175,115,40
36,r_137_21_168,seq140,r_51_138_86,r_51_138_86,1.0,3,89,86,40
8,r_41_25_86,r_43_78_105,r_24_19_161,r_41_25_86,0.63,0,86,86,40
53,seq4,r_3_116_106,seq2,r_3_116_106,1.0,0,106,106,40
43,r_76_30_71,seq74,r_23_29_42,r_76_30_71,0.99,0,71,71,40
16,r_37_28_35,r_31_56_189,r_23_29_42,r_31_56_189,0.49,-128,61,189,40
21,r_109_81_76,seq114,seq80,r_109_81_76,1.0,0,76,76,40
1,r_17_48_136,seq16,r_66_42_50,r_66_42_50,1.0,84,134,50,40
97,seq114,r_115_89_66,r_106_113_24,r_115_89_66,1.0,-1,65,66,40
42,r_102_6_115,seq103,seq1,r_102_6_115,0.97,0,115,115,40
7,r_33_40_138,r_85_34_26,r_66_42_50,r_66_42_50,0.57,88,138,50,40
45,r_124_8_165,r_125_135_167,r_145_12_17,r_145_12_17,0.41,147,164,17,40
19,r_96_94_141,seq91,seq93,r_96_94_141,0.37,-44,97,141,40
30,r_66_42_50,r_67_118_144,seq44,r_66_42_50,1.0,0,50,50,40
31,r_3_116_106,seq4,seq114,r_3_116_106,0.58,0,106,106,40
37,r_61_72_34,r_55_15_79,r_111_73_29,r_61_72_34,1.0,-1,33,34,40
41,r_49_50_133,r_47_90_90,r_144_38_88,r_49_50_133,0.7,-43,90,133,40
17,r_23_29_42,r_85_34_26,r_76_30_71,r_76_30_71,1.0,0,71,71,40
10,r_145_12_17,r_144_38_88,seq9,r_145_12_17,0.99,0,17,17,40
89,seq91,seq92,r_47_90_90,r_47_90_90,1.0,12,102,90,40
3,r_43_78_105,seq44,seq80,r_43_78_105,1.0,0,105,105,40
26,r_47_90_90,r_49_50_133,seq91,r_47_90_90,1.0,0,90,90,40
78,seq64,r_67_118_144,r_5_68_10,r_67_118_144,0.99,0,144,144,40
0,r_86_112_161,seq87,r_106_113_24,r_86_112_161,0.53,0,161,161,40
63,seq20,r_24_19_161,r_41_25_86,r_41_25_86,0.98,68,154,86,40
11,r_122_71_88,r_119_139_164,r_111_73_29,r_122_71_88,0.89,0,88,88,40
12,r_111_73_29,r_109_81_76,r_61_72_34,r_61_72_34,1.0,-5,29,34,40
98,seq121,r_119_139_164,r_117_120_109,r_117_120_109,0.99,38,147,109,40
15,r_101_79_111,seq100,seq80,r_101_79_111,0.98,0,111,111,40
48,r_107_22_129,seq114,r_41_25_86,r_107_22_129,1.0,0,129,129,40
2,r_85_34_26,r_86_112_161,r_33_40_138,r_85_34_26,1.0,0,26,26,40
6,r_24_19_161,seq20,r_41_25_86,r_41_25_86,1.0,1,87,86,40
2,r_85_34_26,r_33_40_138,r_18_32_50,r_85_34_26,0.69,112,138,26,40
23,r_54_13_43,r_55_15_79,r_14_36_139,r_54_13_43,1.0,2,45,43,40
1,r_17_48_136,seq27,r_23_29_42,r_17_48_136,0.57,34,170,136,40
99,seq127,r_125_135_167,r_117_120_109,r_117_120_109,0.81,55,164,109,40
41,r_49_50_133,r_144_38_88,seq53,r_49_50_133,0.99,0,133,133,40
36,r_137_21_168,r_51_138_86,r_41_25_86,r_137_21_168,0.97,0,168,168,40
29,r_5_68_10,seq1,seq64,r_5_68_10,0.87,0,10,10,40
47,r_144_38_88,seq146,seq39,r_144_38_88,1.0,0,88,88,40
18,r_55_15_79,seq53,seq16,r_55_15_79,0.98,0,79,79,40
17,r_23_29_42,seq20,r_85_34_26,r_23_29_42,0.75,1,43,42,40
24,r_67_118_144,seq64,r_3_116_106,r_67_118_144,0.99,0,144,144,40
7,r_33_40_138,r_37_28_35,r_85_34_26,r_85_34_26,1.0,2,28,26,40
44,r_14_36_139,r_17_48_136,r_54_13_43,r_14_36_139,0.49,-99,40,139,40
34,r_51_138_86,r_137_21_168,r_119_139_164,r_137_21_168,0.96,0,168,168,40
88,seq87,r_86_112_161,r_65_97_103,r_65_97_103,0.95,58,161,103,40
61,seq16,r_17_48_136,r_55_15_79,r_55_15_79,0.61,24,103,79,40
32,r_115_89_66,seq114,seq91,r_115_89_66,1.0,0,66,66,40
38,r_65_97_103,r_67_118_144,seq92,r_65_97_103,1.0,1,104,103,40
34,r_51_138_86,seq53,r_137_21_168,r_51_138_86,1.0,0,86,86,40
60,seq142,r_143_11_116,seq148,r_143_11_116,1.0,2,118,116,40
25,r_31_56_189,r_37_28_35,r_85_34_26,r_85_34_26,1.0,20,46,26,40
46,r_106_113_24,r_102_6_115,seq114,r_106_113_24,0.47,0,24,24,40
22,r_131_35_164,r_133_129_126,r_85_34_26,r_131_35_164,0.57,0,164,164,40
1,r_17_48_136,r_66_42_50,seq27,r_66_42_50,0.53,96,146,50,40
35,r_108_130_60,r_109_81_76,r_133_129_126,r_109_81_76,1.0,-16,60,76,40
39,r_18_32_50,r_17_48_136,r_85_34_26,r_18_32_50,1.0,0,50,50,40
16,r_37_28_35,r_23_29_42,r_85_34_26,r_85_34_26,0.66,55,81,26,40
23,r_54_13_43,r_14_36_139,r_24_19_161,r_54_13_43,0.42,100,143,43,40
84,seq80,seq74,r_109_81_76,r_109_81_76,1.0,15,91,76,40
93,seq110,r_109_33_153,r_147_108_91,r_147_108_91,0.76,62,153,91,41
36,r_58_38_119,r_59_26_97,r_17_61_12,r_58_38_119,0.56,-55,64,119,41
92,seq106,r_105_0_136,seq104,r_105_0_136,1.0,0,136,136,41
14,r_36_53_128,seq35,r_121_52_9,r_121_52_9,0.59,119,128,9,41
9,r_42_12_86,r_10_118_161,seq9,r_10_118_161,1.0,0,161,161,41
43,r_10_118_161,r_11_74_149,r_42_12_86,r_42_12_86,1.0,63,149,86,41
16,r_149_30_66,r_147_108_91,seq32,r_149_30_66,1.0,0,66,66,41
39,r_116_139_192,seq111,r_47_117_114,r_47_117_114,1.0,3,117,114,41
1,r_105_0_136,seq106,r_107_1_55,r_107_1_55,0.84,81,136,55,41
5,r_96_144_66,seq95,seq145,r_96_144_66,1.0,0,66,66,41
42,r_94_13_133,seq95,seq14,r_94_13_133,0.97,1,134,133,41
80,seq64,r_65_71_77,r_146_66_96,r_146_66_96,0.83,40,136,96,41
2,r_17_61_12,seq14,seq63,r_17_61_12,0.92,-2,10,12,41
19,r_141_97_148,seq143,seq98,r_141_97_148,0.78,0,148,148,41
23,r_57_75_29,r_56_76_190,seq72,r_57_75_29,0.82,0,29,29,41
31,r_146_66_96,seq145,r_65_71_77,r_146_66_96,0.82,0,96,96,41
41,r_47_117_114,seq46,r_134_115_113,r_47_117_114,0.65,1,115,114,41
45,r_90_142_27,r_91_119_42,seq143,r_90_142_27,1.0,-1,26,27,41
17,r_16_49_71,r_48_84_84,r_128_50_82,r_16_49_71,0.87,13,84,71,41
26,r_88_137_98,seq87,r_90_142_27,r_88_137_98,0.93,1,99,98,41
8,r_93_83_109,r_31_92_25,seq82,r_93_83_109,0.92,0,109,109,41
18,r_2_45_49,r_3_62_53,seq46,r_2_45_49,1.0,0,49,49,41
9,r_42_12_86,r_41_40_129,r_10_118_161,r_42_12_86,0.97,0,86,86,41
50,seq129,r_149_30_66,seq145,r_149_30_66,0.98,-27,39,66,41
11,r_11_74_149,r_10_118_161,r_65_71_77,r_65_71_77,0.61,72,149,77,41
20,r_128_50_82,seq125,r_16_49_71,r_128_50_82,1.0,0,82,82,41
44,r_148_112_12,r_149_30_66,seq111,r_148_112_12,0.96,0,12,12,41
15,r_65_71_77,seq64,seq72,r_65_71_77,0.76,2,79,77,41
4,r_51_20_7,seq14,r_99_24_98,r_99_24_98,1.0,11,109,98,41
6,r_99_24_98,seq98,seq21,r_99_24_98,1.0,0,98,98,41
85,seq82,r_81_70_87,r_48_84_84,r_48_84_84,0.84,-1,83,84,41
24,r_5_27_67,r_47_117_114,seq28,r_47_117_114,0.74,-7,107,114,41
8,r_93_83_109,r_105_0_136,r_31_92_25,r_31_92_25,0.8,10,35,25,41
10,r_134_115_113,r_135_55_185,r_60_114_87,r_134_115_113,0.82,0,113,113,41
22,r_60_114_87,r_109_33_153,r_134_115_113,r_60_114_87,0.85,32,119,87,41
27,r_15_132_183,seq18,seq133,r_15_132_183,0.31,0,183,183,41
13,r_107_1_55,seq106,seq4,r_107_1_55,1.0,0,55,55,41
30,r_31_92_25,r_93_83_109,r_47_117_114,r_47_117_114,0.81,4,118,114,41
47,r_3_62_53,seq4,seq63,r_3_62_53,1.0,0,53,53,41
29,r_59_26_97,r_58_38_119,r_120_25_115,r_58_38_119,0.84,-1,118,119,41
85,seq82,r_48_84_84,r_93_83_109,r_93_83_109,0.68,8,117,109,41
24,r_5_27_67,seq6,r_47_117_114,r_5_27_67,0.97,0,67,67,41
35,r_85_78_17,r_73_80_24,r_113_77_51,r_113_77_51,0.83,36,87,51,41
34,r_113_77_51,seq111,r_85_78_17,r_113_77_51,0.76,0,51,51,41
24,r_5_27_67,seq28,r_59_26_97,r_5_27_67,0.43,75,142,67,41
33,r_22_67_119,seq23,r_65_71_77,r_22_67_119,0.95,0,119,119,41
7,r_91_119_42,r_90_142_27,seq122,r_91_119_42,0.7,-19,23,42,41
58,seq9,r_11_74_149,r_42_12_86,r_42_12_86,1.0,13,99,86,41
0,r_56_76_190,r_57_75_29,r_17_61_12,r_56_76_190,0.88,-161,29,190,41
10,r_134_115_113,r_146_66_96,r_135_55_185,r_134_115_113,0.57,-81,32,113,41
32,r_81_70_87,seq82,r_65_71_77,r_81_70_87,0.89,5,92,87,41
31,r_146_66_96,r_65_71_77,r_113_77_51,r_146_66_96,0.49,54,150,96,41
38,r_147_108_91,seq143,seq110,r_147_108_91,0.99,0,91,91,41
3,r_103_127_27,r_102_138_133,seq125,r_103_127_27,0.62,5,32,27,41
17,r_16_49_71,seq18,r_48_84_84,r_16_49_71,0.8,0,71,71,41
30,r_31_92_25,r_36_53_128,r_93_83_109,r_31_92_25,0.9,0,25,25,41
9,r_42_12_86,r_47_117_114,r_41_40_129,r_41_40_129,0.38,-51,78,129,41
36,r_58_38_119,r_17_61_12,seq37,r_58_38_119,1.0,0,119,119,41
79,seq63,r_59_26_97,r_17_61_12,r_59_26_97,0.62,-51,46,97,41
43,r_10_118_161,r_42_12_86,r_47_117_114,r_10_118_161,0.84,0,161,161,41
22,r_60_114_87,r_58_38_119,r_109_33_153,r_58_38_119,0.49,-31,88,119,41
28,r_101_89_185,r_102_138_133,seq100,r_102_138_133,0.97,-2,131,133,41
91,seq104,seq106,r_141_97_148,r_141_97_148,0.88,21,169,148,41
49,r_102_138_133,r_101_89_185,r_88_137_98,r_101_89_185,0.98,-52,133,185,41
30,r_20_106_87,seq21,seq107,r_20_106_87,1.0,1,88,87,42
51,seq130,r_132_105_123,r_91_131_69,r_91_131_69,0.52,54,123,69,42
36,r_3_115_142,r_5_70_80,r_57_4_28,r_5_70_80,0.91,0,80,80,42
92,seq107,seq98,r_20_106_87,r_20_106_87,1.0,0,87,87,42
82,seq82,r_84_17_153,r_19_81_10,r_19_81_10,1.0,0,10,10,42
14,r_92_42_87,r_97_95_50,seq41,r_92_42_87,1.0,0,87,87,42
43,r_91_131_69,r_90_29_141,seq130,r_91_131_69,1.0,1,70,69,42
37,r_36_127_133,seq34,r_128_126_131,r_36_127_133,0.57,0,133,133,42
3,r_57_4_28,r_3_115_142,r_76_6_47,r_57_4_28,0.94,114,142,28,42
71,seq50,r_51_15_140,r_112_52_12,r_51_15_140,0.87,0,140,140,42
39,r_83_77_63,r_84_17_153,seq69,r_83_77_63,1.0,0,63,63,42
5,r_12_125_153,seq11,r_128_126_131,r_12_125_153,0.82,0,153,153,42
46,r_64_60_94,seq66,seq61,r_64_60_94,0.92,0,94,94,42
7,r_71_116_34,r_145_124_22,r_3_115_142,r_3_115_142,1.0,-2,140,142,42
19,r_56_33_175,r_55_65_182,seq34,r_55_65_182,0.55,-7,175,182,42
15,r_90_29_141,r_84_17_153,r_40_27_39,r_90_29_141,0.99,0,141,141,42
45,r_16_10_30,r_18_1_182,seq11,r_16_10_30,0.57,2,32,30,42
7,r_71_116_34,seq72,r_145_124_22,r_71_116_34,0.83,0,34,34,42
26,r_117_67_67,r_118_32_137,seq69,r_117_67_67,1.0,0,67,67,42
38,r_137_7_68,r_93_136_42,r_76_6_47,r_137_7_68,1.0,1,69,68,42
0,r_44_63_107,r_43_9_75,seq41,r_43_9_75,1.0,1,76,75,42
11,r_109_135_87,seq110,r_134_141_123,r_109_135_87,0.94,0,87,87,42
47,r_143_113_54,seq144,seq114,r_143_113_54,0.99,0,54,54,42
20,r_51_15_140,r_53_2_169,r_18_1_182,r_18_1_182,0.7,-42,140,182,42
13,r_5_70_80,r_3_115_142,seq69,r_5_70_80,1.0,0,80,80,42
15,r_90_29_141,r_91_131_69,r_84_17_153,r_91_131_69,1.0,1,70,69,42
6,r_68_23_164,seq73,r_38_25_169,r_68_23_164,0.51,0,164,164,42
36,r_3_115_142,r_57_4_28,r_71_116_34,r_3_115_142,1.0,0,142,142,42
23,r_112_52_12,r_84_17_153,r_53_2_169,r_112_52_12,0.91,0,12,12,42
38,r_137_7_68,r_138_79_18,r_132_105_123,r_137_7_68,0.94,-55,13,68,42
27,r_132_105_123,seq130,r_20_106_87,r_132_105_123,0.92,0,123,123,42
48,r_145_124_22,seq144,seq122,r_145_124_22,0.97,0,22,22,42
8,r_93_136_42,r_137_7_68,seq139,r_137_7_68,0.96,1,69,68,42
16,r_99_119_49,seq98,seq120,r_99_119_49,1.0,1,50,49,42
21,r_138_79_18,r_137_7_68,seq80,r_138_79_18,1.0,0,18,18,42
2,r_84_17_153,seq102,r_18_1_182,r_84_17_153,0.9,0,153,153,42
3,r_57_4_28,r_55_65_182,r_3_115_142,r_57_4_28,0.92,0,28,28,42
40,r_18_1_182,r_16_10_30,r_84_17_153,r_84_17_153,1.0,0,153,153,42
74,seq61,seq58,r_64_60_94,r_64_60_94,0.97,34,128,94,42
18,r_43_9_75,r_44_63_107,seq11,r_43_9_75,1.0,1,76,75,42
29,r_47_88_118,r_54_45_4,r_46_89_107,r_54_45_4,1.0,115,119,4,42
0,r_44_63_107,seq41,seq66,r_44_63_107,0.79,0,107,107,42
24,r_54_45_4,r_47_88_118,r_92_42_87,r_54_45_4,0.92,114,118,4,42
25,r_128_126_131,seq129,r_36_127_133,r_128_126_131,0.52,2,133,131,42
33,r_134_141_123,r_133_87_158,r_109_135_87,r_109_135_87,0.97,2,89,87,42
50,seq129,r_128_126_131,r_91_131_69,r_91_131_69,1.0,62,131,69,42
33,r_134_141_123,r_109_135_87,seq139,r_134_141_123,0.81,0,123,123,42
32,r_133_87_158,r_134_141_123,r_109_135_87,r_109_135_87,0.92,11,98,87,42
81,seq80,seq78,r_138_79_18,r_138_79_18,0.98,15,33,18,42
34,r_37_101_186,seq34,r_140_108_183,r_140_108_183,0.9,4,187,183,42
17,r_118_32_137,r_117_67_67,seq120,r_117_67_67,1.0,0,67,67,42
10,r_76_6_47,seq73,r_57_4_28,r_76_6_47,0.83,0,47,47,42
9,r_123_74_171,seq122,r_44_63_107,r_44_63_107,0.78,63,170,107,42
28,r_53_2_169,r_51_15_140,r_112_52_12,r_112_52_12,0.97,0,12,12,42
28,r_53_2_169,r_112_52_12,r_76_6_47,r_53_2_169,0.53,0,169,169,42
35,r_46_89_107,r_90_29_141,r_47_88_118,r_90_29_141,0.99,0,141,141,42
22,r_140_108_183,seq139,r_47_88_118,r_47_88_118,0.6,64,182,118,42
38,r_137_7_68,r_132_105_123,r_93_136_42,r_137_7_68,0.82,-17,51,68,42
17,r_118_32_137,seq120,r_40_27_39,r_118_32_137,0.97,1,138,137,42
11,r_109_135_87,r_134_141_123,r_133_87_158,r_134_141_123,0.82,0,123,123,42
11,r_109_135_87,r_133_87_158,r_134_141_123,r_109_135_87,0.77,73,160,87,42
35,r_46_89_107,r_47_88_118,r_90_29_141,r_46_89_107,0.54,0,107,107,42
12,r_55_65_182,r_56_33_175,r_112_52_12,r_56_33_175,0.42,-8,167,175,42
8,r_93_136_42,r_92_42_87,r_137_7_68,r_93_136_42,0.98,0,42,42,42
23,r_112_52_12,r_53_2_169,r_64_60_94,r_112_52_12,0.53,137,149,12,42
30,r_134_62_102,r_133_121_149,r_61_68_205,r_134_62_102,1.0,0,102,102,43
44,r_81_83_175,seq95,seq84,r_81_83_175,0.59,0,175,175,43
38,r_82_77_44,r_81_83_175,seq79,r_81_83_175,0.55,-129,46,175,43
42,r_138_44_83,seq46,r_2_45_102,r_2_45_102,0.94,0,102,102,43
36,r_16_25_83,seq17,seq29,r_16_25_83,0.99,0,83,83,43
9,r_143_43_8,r_42_141_160,seq46,r_42_141_160,0.5,1,161,160,43
14,r_27_147_182,r_26_69_65,seq29,r_26_69_65,1.0,0,65,65,43
8,r_70_41_94,seq71,seq40,r_70_41_94,1.0,5,99,94,43
10,r_60_11_30,r_61_68_205,seq12,r_60_11_30,1.0,0,30,30,43
59,seq14,r_13_88_169,r_124_15_45,r_124_15_45,1.0,115,160,45,43
71,seq40,seq39,r_70_41_94,r_70_41_94,1.0,28,122,94,43
39,r_61_68_205,seq63,r_134_62_102,r_134_62_102,1.0,24,126,102,43
23,r_38_80_157,r_30_72_155,r_51_37_20,r_51_37_20,1.0,-1,19,20,43
5,r_142_32_143,r_148_10_164,seq34,r_142_32_143,0.62,0,143,143,43
42,r_138_44_83,r_139_136_198,seq46,r_138_44_83,0.87,0,83,83,43
69,seq35,r_36_130_163,seq34,r_36_130_163,1.0,0,163,163,43
45,r_36_130_163,seq35,seq128,r_36_130_163,0.77,0,163,163,43
32,r_55_100_34,seq63,r_73_101_14,r_55_100_34,0.59,0,34,34,43
31,r_5_28_105,seq6,seq29,r_5_28_105,0.99,1,106,105,43
41,r_139_136_198,r_138_44_83,r_18_140_79,r_139_136_198,1.0,-115,83,198,43
3,r_3_48_104,r_2_45_102,seq49,r_3_48_104,0.94,-2,102,104,43
88,seq99,r_92_7_160,r_73_101_14,r_73_101_14,0.96,0,14,14,43
26,r_26_69_65,r_27_147_182,seq71,r_26_69_65,0.99,0,65,65,43
14,r_27_147_182,seq29,seq146,r_27_147_182,0.43,0,182,182,43
4,r_2_45_102,r_3_48_104,r_138_44_83,r_2_45_102,0.78,0,102,102,43
25,r_137_144_54,r_139_136_198,seq149,r_137_144_54,0.99,0,54,54,43
0,r_123_86_157,seq117,r_31_87_46,r_123_86_157,0.97,0,157,157,43
20,r_76_64_66,r_82_77_44,seq67,r_76_64_66,0.8,0,66,66,43
46,r_42_141_160,r_143_43_8,r_18_140_79,r_143_43_8,0.84,153,161,8,43
48,r_30_72_155,seq29,seq71,r_30_72_155,0.62,0,155,155,43
11,r_21_108_51,seq20,seq114,r_21_108_51,1.0,0,51,51,43
49,r_51_37_20,r_38_80_157,r_70_41_94,r_51_37_20,0.77,137,157,20,43
6,r_92_7_160,seq91,seq8,r_92_7_160,0.63,0,160,160,43
15,r_124_15_45,r_123_86_157,seq17,r_124_15_45,1.0,0,45,45,43
21,r_103_52_12,r_104_106_63,seq54,r_103_52_12,1.0,0,12,12,43
27,r_133_121_149,r_134_62_102,r_139_136_198,r_134_62_102,1.0,0,102,102,43
2,r_97_23_82,seq96,seq20,r_97_23_82,0.97,0,82,82,43
47,r_65_115_77,seq66,seq114,r_65_115_77,1.0,0,77,77,43
40,r_135_126_130,r_139_136_198,seq128,r_135_126_130,0.89,0,130,130,43
29,r_148_10_164,seq149,r_60_11_30,r_148_10_164,0.77,0,164,164,43
24,r_118_33_96,seq119,seq34,r_118_33_96,1.0,0,96,96,43
33,r_56_59_150,r_98_57_4,r_134_62_102,r_134_62_102,1.0,49,151,102,43
13,r_31_87_46,r_30_72_155,seq84,r_31_87_46,0.98,4,50,46,43
19,r_73_101_14,r_70_41_94,seq99,r_73_101_14,0.74,0,14,14,43
34,r_24_47_128,seq22,seq46,r_24_47_128,0.83,0,128,128,43
94,seq114,seq117,r_65_115_77,r_65_115_77,1.0,17,94,77,43
27,r_133_121_149,r_139_136_198,seq117,r_133_121_149,1.0,0,149,149,43
28,r_122_145_139,seq117,seq149,r_122_145_139,0.88,0,139,139,43
49,r_51_37_20,r_53_107_158,r_38_80_157,r_51_37_20,0.93,-1,19,20,43
44,r_81_83_175,r_82_77_44,seq95,r_82_77_44,0.73,63,107,44,43
12,r_18_140_79,r_16_25_83,r_139_136_198,r_18_140_79,1.0,0,79,79,43
23,r_38_80_157,r_51_37_20,r_90_94_113,r_51_37_20,0.73,137,157,20,43
84,seq91,r_92_7_160,r_90_94_113,r_92_7_160,0.85,0,160,160,43
1,r_56_92_42,seq59,r_91_93_72,r_56_92_42,0.98,0,42,42,44
37,r_149_31_148,seq147,seq32,r_149_31_148,0.87,0,148,148,44
16,r_28_13_84,seq27,r_118_12_60,r_28_13_84,1.0,0,84,84,44
5,r_112_144_197,seq111,r_128_143_50,r_128_143_50,0.85,147,197,50,44
42,r_11_20_119,seq4,seq19,r_11_20_119,0.51,-13,106,119,44
32,r_45_105_199,r_133_44_10,r_72_104_18,r_133_44_10,0.4,189,199,10,44
30,r_103_52_126,seq107,r_72_104_18,r_72_104_18,1.0,3,21,18,44
29,r_109_113_121,seq100,r_76_114_16,r_76_114_16,0.49,105,121,16,44
40,r_39_65_50,r_37_121_164,seq64,r_39_65_50,0.99,0,50,50,44
93,seq100,r_102_24_58,r_140_106_37,r_102_24_58,1.0,-11,47,58,44
95,seq111,r_112_144_197,r_76_114_16,r_76_114_16,0.99,181,197,16,44
31,r_82_117_30,r_81_148_25,r_76_114_16,r_82_117_30,0.74,-4,26,30,44
41,r_110_17_73,r_109_113_121,seq18,r_110_17_73,1.0,0,73,73,44
89,seq94,r_99_145_176,r_56_92_42,r_56_92_42,0.81,122,164,42,44
45,r_141_1_16,r_149_31_148,r_2_43_106,r_141_1_16,0.99,0,16,16,44
8,r_2_43_106,r_141_1_16,r_131_46_102,r_2_43_106,1.0,0,106,106,44
2,r_66_138_13,r_56_92_42,seq137,r_66_138_13,1.0,0,13,13,44
14,r_72_104_18,r_103_52_126,r_140_106_37,r_103_52_126,0.95,0,126,126,44
48,r_80_25_40,seq84,r_26_55_150,r_80_25_40,0.71,0,40,40,44
0,r_135_16_110,seq134,r_10_15_14,r_135_16_110,1.0,0,110,110,44
94,seq107,r_103_52_126,r_140_106_37,r_103_52_126,0.62,-67,59,126,44
21,r_102_24_58,seq100,r_80_25_40,r_102_24_58,1.0,0,58,58,44
13,r_131_46_102,seq132,r_133_44_10,r_131_46_102,0.98,0,102,102,44
14,r_72_104_18,r_56_92_42,r_103_52_126,r_72_104_18,0.78,0,18,18,44
48,r_80_25_40,r_26_55_150,r_102_24_58,r_80_25_40,0.65,44,84,40,44
4,r_76_114_16,seq111,r_82_117_30,r_82_117_30,0.8,63,93,30,44
56,seq139,r_140_106_37,r_76_114_16,r_76_114_16,0.72,23,39,16,44
8,r_2_43_106,seq14,r_141_1_16,r_141_1_16,0.83,6,22,16,44
15,r_91_93_72,seq94,r_56_92_42,r_56_92_42,0.99,1,43,42,44
56,seq139,r_76_114_16,r_66_138_13,r_76_114_16,0.63,60,76,16,44
43,r_118_12_60,seq3,r_28_13_84,r_28_13_84,1.0,22,106,84,44
30,r_103_52_126,r_72_104_18,seq53,r_103_52_126,1.0,0,126,126,44
32,r_45_105_199,r_33_146_181,r_133_44_10,r_133_44_10,1.0,2,12,10,44
47,r_89_122_84,seq90,seq119,r_89_122_84,1.0,0,84,84,44
18,r_38_67_61,r_37_121_164,r_39_65_50,r_37_121_164,1.0,-103,61,164,44
29,r_109_113_121,r_110_17_73,seq100,r_110_17_73,1.0,1,74,73,44
33,r_68_58_159,seq64,r_26_55_150,r_26_55_150,1.0,9,159,150,44
58,seq18,seq21,r_110_17_73,r_110_17_73,1.0,35,108,73,44
70,seq49,r_48_41_177,r_86_63_17,r_48_41_177,0.5,0,177,177,44
27,r_115_98_49,seq111,seq97,r_115_98_49,1.0,0,49,49,44
65,seq32,r_30_124_197,r_149_31_148,r_149_31_148,0.99,11,159,148,44
39,r_50_130_57,seq53,seq132,r_50_130_57,1.0,0,57,57,44
38,r_48_41_177,seq49,seq42,r_48_41_177,0.67,0,177,177,44
77,seq64,seq62,r_39_65_50,r_39_65_50,1.0,22,72,50,44
19,r_86_63_17,r_89_122_84,seq62,r_86_63_17,0.97,0,17,17,44
43,r_118_12_60,r_112_144_197,seq3,r_118_12_60,0.96,-1,59,60,44
45,r_141_1_16,r_2_43_106,r_125_7_72,r_141_1_16,1.0,90,106,16,44
11,r_128_143_50,r_135_16_110,seq142,r_135_16_110,0.79,-57,53,110,44
26,r_133_44_10,r_135_16_110,r_45_105_199,r_135_16_110,0.78,-100,10,110,44
9,r_33_146_181,r_34_6_210,r_81_148_25,r_33_146_181,0.54,0,181,181,44
26,r_133_44_10,r_45_105_199,r_131_46_102,r_131_46_102,1.0,25,127,102,44
22,r_47_120_100,r_48_41_177,seq119,r_47_120_100,0.95,0,100,100,44
34,r_140_106_37,seq139,seq107,r_140_106_37,0.95,0,37,37,44
49,r_74_60_128,seq77,r_86_63_17,r_74_60_128,0.8,0,128,128,44
4,r_76_114_16,seq75,seq111,r_76_114_16,0.98,0,16,16,44
7,r_37_121_164,r_34_6_210,r_47_120_100,r_34_6_210,0.77,-46,164,210,44
17,r_26_55_150,r_80_25_40,r_40_57_9,r_26_55_150,0.9,0,150,150,44
74,seq137,r_135_16_110,r_66_138_13,r_66_138_13,0.82,3,16,13,44
12,r_30_124_197,seq32,r_37_121_164,r_30_124_197,0.38,0,197,197,44
17,r_26_55_150,seq32,r_80_25_40,r_80_25_40,1.0,0,40,40,44
36,r_35_106_96,seq29,r_105_2_155,r_35_106_96,0.96,0,96,96,45
6,r_80_134_32,seq79,seq132,r_80_134_32,1.0,0,32,32,45
14,r_1_58_106,seq4,seq55,r_1_58_106,1.0,0,106,106,45
8,r_82_92_182,r_44_81_5,r_116_94_101,r_116_94_101,1.0,81,182,101,45
17,r_31_83_56,seq29,seq89,r_31_83_56,0.94,0,56,56,45
35,r_98_111_83,r_37_108_17,seq122,r_37_108_17,0.59,150,167,17,45
36,r_35_106_96,r_105_2_155,seq95,r_105_2_155,0.86,0,155,155,45
3,r_146_125_22,seq148,seq124,r_146_125_22,1.0,0,22,22,45
55,seq142,r_137_84_130,r_114_143_59,r_114_143_59,0.55,46,105,59,45
16,r_38_73_23,r_39_102_164,seq75,r_38_73_23,0.9,2,25,23,45
21,r_131_61_149,seq132,seq60,r_131_61_149,0.83,0,149,149,45
1,r_130_49_172,seq132,r_87_48_24,r_130_49_172,0.92,0,172,172,45
5,r_69_10_79,r_78_50_115,seq11,r_69_10_79,1.0,0,79,79,45
46,r_39_102_164,seq40,r_109_104_31,r_39_102_164,0.68,0,164,164,45
35,r_98_111_83,r_97_120_30,r_109_104_31,r_98_111_83,0.97,-53,30,83,45
39,r_16_112_27,r_7_47_87,seq113,r_16_112_27,1.0,0,27,27,45
89,seq95,r_109_104_31,r_37_108_17,r_109_104_31,0.38,131,162,31,45
19,r_15_70_137,r_14_33_169,r_38_73_23,r_15_70_137,0.63,0,137,137,45
10,r_23_27_136,seq65,r_25_71_126,r_23_27_136,0.55,-90,46,136,45
10,r_23_27_136,r_25_71_126,seq29,r_23_27_136,0.64,-75,61,136,45
30,r_96_57_30,seq95,seq55,r_96_57_30,1.0,0,30,30,45
72,seq55,r_53_51_184,r_96_57_30,r_96_57_30,1.0,27,57,30,45
56,seq144,seq142,r_140_145_140,r_140_145_140,0.52,-117,23,140,45
26,r_116_94_101,seq118,r_56_93_4,r_116_94_101,0.99,0,101,101,45
2,r_105_2_155,r_35_106_96,r_3_5_117,r_105_2_155,1.0,0,155,155,45
0,r_123_19_66,seq124,r_32_22_5,r_123_19_66,1.0,0,66,66,45
96,seq148,r_149_128_44,r_138_147_24,r_149_128_44,0.66,0,44,44,45
33,r_87_48_24,seq89,r_62_46_15,r_87_48_24,0.6,1,25,24,45
20,r_41_91_69,seq42,r_56_93_4,r_41_91_69,0.94,0,69,69,45
13,r_7_47_87,r_8_21_156,r_62_46_15,r_7_47_87,1.0,0,87,87,45
98,seq124,r_123_19_66,r_146_125_22,r_123_19_66,0.6,0,66,66,45
15,r_0_88_89,seq4,seq89,r_0_88_89,1.0,0,89,89,45
23,r_138_147_24,r_140_145_140,seq148,r_138_147_24,0.99,0,24,24,45
35,r_98_111_83,r_109_104_31,r_110_76_143,r_98_111_83,0.98,3,86,83,45
62,seq26,r_25_71_126,seq36,r_25_71_126,0.75,1,127,126,45
35,r_98_111_83,r_110_76_143,r_37_108_17,r_98_111_83,0.61,62,145,83,45
10,r_23_27_136,seq29,r_135_28_127,r_135_28_127,1.0,9,136,127,45
2,r_105_2_155,seq107,seq95,r_105_2_155,0.58,-107,48,155,45
41,r_12_9_150,r_14_33_169,r_69_10_79,r_14_33_169,1.0,-19,150,169,45
47,r_121_115_130,seq122,seq113,r_121_115_130,0.78,0,130,130,45
40,r_44_81_5,r_82_92_182,seq79,r_44_81_5,0.32,177,182,5,45
18,r_8_21_156,seq11,r_123_19_66,r_123_19_66,1.0,85,151,66,45
29,r_37_108_17,r_38_73_23,seq107,r_37_108_17,1.0,0,17,17,45
44,r_110_76_143,r_98_111_83,r_38_73_23,r_110_76_143,0.95,0,143,143,45
25,r_135_28_127,r_131_61_149,seq29,r_135_28_127,0.69,0,127,127,45
37,r_109_104_31,r_110_76_143,seq103,r_109_104_31,0.92,1,32,31,45
49,r_90_99_43,r_56_93_4,seq100,r_90_99_43,0.97,-1,42,43,45
31,r_97_120_30,r_98_111_83,r_117_119_24,r_97_120_30,0.98,0,30,30,45
32,r_141_52_68,r_137_84_130,r_62_46_15,r_141_52_68,0.88,1,69,68,45
38,r_114_143_59,seq113,seq142,r_114_143_59,1.0,2,61,59,45
52,seq136,r_137_84_130,r_114_143_59,r_114_143_59,0.54,69,128,59,45
48,r_149_128_44,seq148,r_127_129_102,r_149_128_44,1.0,0,44,44,45
44,r_110_76_143,r_109_104_31,r_16_112_27,r_110_76_143,0.57,-106,37,143,45
34,r_56_93_4,seq65,r_41_91_69,r_56_93_4,0.42,67,71,4,45
2,r_105_2_155,seq95,r_35_106_96,r_35_106_96,0.99,1,97,96,45
34,r_56_93_4,r_41_91_69,r_116_94_101,r_116_94_101,1.0,2,103,101,45
84,seq79,r_80_134_32,r_56_93_4,r_80_134_32,0.99,0,32,32,45
94,seq113,r_114_143_59,r_16_112_27,r_114_143_59,0.47,2,61,59,45
7,r_14_33_169,r_123_19_66,seq30,r_14_33_169,0.91,0,169,169,45
9,r_140_145_140,seq136,seq144,r_140_145_140,0.85,0,140,140,45
22,r_137_84_130,seq136,seq85,r_137_84_130,0.74,0,130,130,45
28,r_72_6_188,seq77,r_123_19_66,r_123_19_66,0.86,122,188,66,45
44,r_110_76_143,r_16_112_27,r_98_111_83,r_110_76_143,0.57,-59,84,143,45
7,r_14_33_169,r_15_70_137,r_123_19_66,r_123_19_66,0.96,63,129,66,45
25,r_135_28_127,seq29,r_23_27_136,r_135_28_127,0.48,39,166,127,45
40,r_110_132_190,r_136_109_85,seq129,r_110_132_190,0.76,0,190,190,46
30,r_11_137_176,r_10_3_188,r_27_140_97,r_10_3_188,0.64,-12,176,188,46
18,r_57_28_126,r_88_56_92,seq29,r_57_28_126,0.94,5,131,126,46
36,r_31_75_136,r_30_112_92,seq34,r_30_112_92,1.0,-2,90,92,46
9,r_66_59_18,r_55_70_50,r_88_56_92,r_55_70_50,0.4,45,95,50,46
20,r_71_118_44,r_87_51_191,r_41_114_36,r_87_51_191,0.85,-146,45,191,46
36,r_31_75_136,seq34,seq77,r_31_75_136,0.91,0,136,136,46
14,r_87_51_191,seq91,r_88_56_92,r_88_56_92,1.0,99,191,92,46
55,seq8,r_7_82_182,r_135_13_52,r_135_13_52,1.0,128,180,52,46
16,r_96_133_25,seq93,seq134,r_96_133_25,1.0,0,25,25,46
21,r_10_3_188,seq16,r_117_5_171,r_117_5_171,0.65,17,188,171,46
39,r_20_49_10,r_42_89_155,r_88_56_92,r_88_56_92,0.55,7,99,92,46
1,r_72_147_63,r_73_123_197,seq145,r_72_147_63,1.0,0,63,63,46
98,seq124,seq129,r_96_133_25,r_96_133_25,0.43,164,189,25,46
5,r_146_37_94,seq145,seq39,r_146_37_94,1.0,0,94,94,46
52,seq4,r_2_60_26,seq18,r_2_60_26,0.72,1,27,26,46
69,seq26,r_27_140_97,seq25,r_27_140_97,1.0,0,97,97,46
45,r_7_82_182,seq8,r_50_81_174,r_50_81_174,0.58,8,182,174,46
27,r_88_56_92,r_57_28_126,r_17_53_7,r_57_28_126,0.89,3,129,126,46
47,r_64_76_163,seq61,r_125_65_23,r_125_65_23,1.0,29,52,23,46
3,r_55_70_50,r_57_28_126,r_48_69_20,r_55_70_50,0.75,5,55,50,46
41,r_27_140_97,seq26,seq139,r_27_140_97,1.0,0,97,97,46
28,r_135_13_52,seq139,seq14,r_135_13_52,1.0,0,52,52,46
66,seq23,seq21,r_130_22_25,r_130_22_25,1.0,0,25,25,46
26,r_47_108_95,seq46,r_136_109_85,r_47_108_95,0.99,0,95,95,46
11,r_67_58_142,r_64_76_163,r_88_56_92,r_64_76_163,0.46,-20,143,163,46
13,r_62_33_86,seq61,r_131_32_45,r_131_32_45,0.97,41,86,45,46
46,r_106_138_108,r_9_103_31,r_27_140_97,r_106_138_108,1.0,0,108,108,46
4,r_50_81_174,r_45_52_68,r_6_86_169,r_6_86_169,0.93,5,174,169,46
6,r_84_44_88,r_78_35_170,seq43,r_78_35_170,0.49,-82,88,170,46
62,seq145,r_146_37_94,r_144_148_157,r_146_37_94,1.0,0,94,94,46
52,seq4,seq18,r_117_5_171,r_117_5_171,0.93,21,192,171,46
8,r_41_114_36,r_42_89_155,seq116,r_41_114_36,1.0,0,36,36,46
10,r_45_52_68,r_50_81_174,r_88_56_92,r_88_56_92,0.82,80,172,92,46
27,r_88_56_92,r_87_51_191,r_57_28_126,r_88_56_92,0.72,0,92,92,46
12,r_100_36_28,seq99,seq38,r_100_36_28,0.55,0,28,28,46
48,r_131_32_45,seq129,seq34,r_131_32_45,0.99,0,45,45,46
40,r_110_132_190,r_106_138_108,r_136_109_85,r_110_132_190,0.98,-99,91,190,46
74,seq40,r_42_89_155,seq43,r_42_89_155,0.75,-9,146,155,46
18,r_57_28_126,r_55_70_50,r_88_56_92,r_57_28_126,0.51,-34,92,126,46
29,r_117_5_171,seq116,seq4,r_117_5_171,0.68,0,171,171,46
46,r_106_138_108,r_110_132_190,r_9_103_31,r_9_103_31,1.0,0,31,31,46
33,r_42_89_155,seq40,r_127_85_37,r_127_85_37,1.0,118,155,37,46
47,r_64_76_163,r_125_65_23,r_127_85_37,r_127_85_37,0.54,127,164,37,46
70,seq29,r_55_70_50,r_57_28_126,r_57_28_126,0.86,5,131,126,46
22,r_127_85_37,seq129,seq79,r_127_85_37,1.0,1,38,37,46
42,r_125_65_23,seq126,seq61,r_125_65_23,0.99,0,23,23,46
48,r_131_32_45,seq34,r_62_33_86,r_62_33_86,0.97,-4,82,86,46
77,seq54,r_55_70_50,r_17_53_7,r_55_70_50,0.65,-40,10,50,46
34,r_30_112_92,r_31_75_136,r_41_114_36,r_30_112_92,0.45,1,93,92,46
19,r_2_60_26,seq4,seq61,r_2_60_26,0.66,0,26,26,46
15,r_74_63_47,r_87_51_191,r_2_60_26,r_87_51_191,0.54,-140,51,191,46
17,r_6_86_169,seq8,r_127_85_37,r_127_85_37,0.74,133,170,37,46
94,seq116,r_117_5_171,r_41_114_36,r_41_114_36,0.63,28,64,36,46
0,r_9_103_31,r_7_82_182,r_107_105_28,r_9_103_31,0.95,1,32,31,46
32,r_48_69_20,r_47_108_95,r_64_76_163,r_48_69_20,0.59,0,20,20,46
49,r_90_12_82,r_87_51_191,seq14,r_90_12_82,0.9,0,82,82,46
44,r_136_109_85,seq139,r_9_103_31,r_136_109_85,1.0,0,85,85,46
9,r_66_59_18,r_67_58_142,r_55_70_50,r_67_58_142,0.38,-124,18,142,46
32,r_48_69_20,r_64_76_163,r_55_70_50,r_48_69_20,0.54,51,71,20,46
43,r_107_105_28,r_110_132_190,r_9_103_31,r_9_103_31,1.0,-2,29,31,46
30,r_133_45_167,seq134,seq44,r_133_45_167,0.77,0,167,167,47
36,r_113_76_177,seq112,r_30_71_144,r_113_76_177,0.76,0,177,177,47
3,r_114_87_11,r_38_92_101,r_78_89_169,r_114_87_11,0.89,160,171,11,47
14,r_136_12_190,seq138,r_21_13_2,r_21_13_2,0.51,188,190,2,47
8,r_121_111_159,seq122,seq112,r_121_111_159,0.89,0,159,159,47
53,seq134,r_133_45_167,seq132,r_133_45_167,0.76,0,167,167,47
54,seq135,r_136_12_190,r_149_148_32,r_136_12_190,0.58,-84,106,190,47
83,seq82,r_93_70_9,r_42_83_109,r_42_83_109,1.0,11,120,109,47
3,r_114_87_11,r_86_37_113,r_38_92_101,r_114_87_11,0.84,103,114,11,47
22,r_75_62_158,seq94,r_116_63_176,r_75_62_158,0.74,21,179,158,47
3,r_114_87_11,seq115,r_86_37_113,r_114_87_11,0.92,0,11,11,47
19,r_97_74_8,r_75_62_158,r_30_71_144,r_97_74_8,0.67,150,158,8,47
39,r_35_117_84,r_30_71_144,r_5_119_64,r_35_117_84,1.0,0,84,84,47
46,r_0_49_163,r_4_41_134,r_3_11_53,r_4_41_134,0.99,-47,87,134,47
29,r_33_9_32,r_30_71_144,seq8,r_33_9_32,1.0,1,33,32,47
42,r_48_15_55,seq46,seq22,r_48_15_55,1.0,0,55,55,47
1,r_131_6_113,r_136_12_190,r_147_55_101,r_147_55_101,0.34,-65,36,101,47
45,r_124_102_100,seq126,seq104,r_124_102_100,1.0,0,100,100,47
27,r_106_66_125,r_91_105_42,seq67,r_106_66_125,1.0,0,125,125,47
95,seq120,r_116_63_176,r_35_117_84,r_35_117_84,1.0,7,91,84,47
76,seq60,seq56,r_38_92_101,r_38_92_101,0.84,84,185,101,47
41,r_59_139_82,r_57_118_153,r_50_137_66,r_57_118_153,1.0,-71,82,153,47
28,r_16_18_24,r_30_71_144,r_85_20_19,r_16_18_24,0.76,9,33,24,47
26,r_4_41_134,r_5_119_64,r_1_68_200,r_5_119_64,1.0,0,64,64,47
4,r_58_84_184,seq56,r_30_71_144,r_30_71_144,0.54,39,183,144,47
0,r_54_96_129,seq53,seq95,r_54_96_129,0.99,0,129,129,47
63,seq25,r_24_65_148,seq22,r_24_65_148,1.0,0,148,148,47
73,seq52,r_51_144_80,seq47,r_51_144_80,1.0,0,80,80,47
6,r_19_110_14,seq17,seq109,r_19_110_14,0.87,0,14,14,47
20,r_23_108_171,seq25,r_143_107_76,r_23_108_171,0.63,0,171,171,47
46,r_0_49_163,r_3_11_53,seq46,r_0_49_163,0.91,0,163,163,47
47,r_103_28_48,seq104,seq27,r_103_28_48,1.0,0,48,48,47
27,r_106_66_125,r_103_28_48,r_91_105_42,r_106_66_125,0.98,-77,48,125,47
21,r_91_105_42,r_106_66_125,r_19_110_14,r_106_66_125,1.0,-10,115,125,47
85,seq90,seq94,r_38_92_101,r_38_92_101,1.0,-1,100,101,47
55,seq8,r_3_11_53,r_33_9_32,r_33_9_32,1.0,20,52,32,47
87,seq95,seq101,r_54_96_129,r_54_96_129,1.0,1,130,129,47
15,r_72_146_160,seq67,r_51_144_80,r_72_146_160,1.0,0,160,160,47
2,r_143_107_76,r_145_7_162,r_19_110_14,r_143_107_76,1.0,0,76,76,47
40,r_43_128_172,seq44,seq129,r_43_128_172,0.56,0,172,172,47
74,seq53,r_54_96_129,seq52,r_54_96_129,1.0,0,129,129,47
24,r_5_119_64,r_4_41_134,seq120,r_5_119_64,1.0,0,64,64,47
25,r_78_89_169,seq79,r_114_87_11,r_114_87_11,0.93,158,169,11,47
23,r_86_37_113,r_64_100_8,r_114_87_11,r_86_37_113,0.8,-103,10,113,47
70,seq44,r_43_128_172,r_133_45_167,r_133_45_167,0.38,5,172,167,47
32,r_38_92_101,seq39,seq90,r_38_92_101,0.98,0,101,101,47
75,seq56,r_57_118_153,r_147_55_101,r_147_55_101,0.71,52,153,101,47
81,seq79,r_78_89_169,seq77,r_78_89_169,0.53,0,169,169,47
17,r_42_83_109,seq40,seq82,r_42_83_109,0.99,0,109,109,47
9,r_24_65_148,seq25,r_106_66_125,r_24_65_148,0.62,0,148,148,47
26,r_4_41_134,r_1_68_200,seq40,r_4_41_134,0.98,0,134,134,47
96,seq122,r_121_111_159,seq125,r_121_111_159,0.8,0,159,159,47
18,r_3_11_53,r_5_119_64,seq14,r_5_119_64,1.0,-11,53,64,47
10,r_85_20_19,seq77,r_16_18_24,r_85_20_19,0.85,0,19,19,47
49,r_51_144_80,seq52,seq141,r_51_144_80,1.0,0,80,80,47
56,seq138,r_136_12_190,r_50_137_66,r_50_137_66,1.0,124,190,66,47
7,r_30_71_144,seq31,r_93_70_9,r_30_71_144,0.82,0,144,144,47
44,r_36_29_197,seq40,r_103_28_48,r_103_28_48,1.0,149,197,48,47
21,r_91_105_42,seq90,r_106_66_125,r_91_105_42,1.0,0,42,42,47
27,r_106_66_125,seq67,r_24_65_148,r_24_65_148,0.57,22,170,148,47
79,seq73,seq77,r_93_70_9,r_93_70_9,0.44,101,110,9,47
35,r_147_55_101,r_149_148_32,seq56,r_147_55_101,1.0,0,101,101,47
43,r_10_81_27,r_3_11_53,seq80,r_10_81_27,1.0,1,28,27,47
12,r_116_63_176,seq120,r_75_62_158,r_116_63_176,0.54,0,176,176,47
82,seq80,seq77,r_10_81_27,r_10_81_27,1.0,3,30,27,47
23,r_86_37_113,r_114_87_11,seq40,r_86_37_113,0.82,0,113,113,47
40,r_28_106_180,r_113_25_27,r_78_29_77,r_78_29_77,1.0,37,114,77,48
30,r_8_26_169,seq9,r_113_25_27,r_8_26_169,0.71,1,170,169,48
44,r_32_43_45,r_42_49_115,seq53,r_32_43_45,0.55,70,115,45,48
36,r_24_118_95,seq15,seq119,r_24_118_95,0.99,0,95,95,48
43,r_12_115_135,r_13_100_193,seq116,r_12_115_135,0.92,0,135,135,48
83,seq80,r_78_29_77,r_93_87_60,r_78_29_77,0.45,-1,76,77,48
37,r_38_44_168,seq39,r_75_47_94,r_75_47_94,1.0,74,168,94,48
2,r_41_146_59,r_60_40_8,r_145_99_153,r_41_146_59,0.99,0,59,59,48
32,r_42_49_115,r_45_27_178,r_32_43_45,r_42_49_115,0.55,-70,45,115,48
16,r_127_94_155,r_129_51_163,seq104,r_127_94_155,0.79,0,155,155,48
39,r_71_130_145,seq72,seq132,r_71_130_145,0.62,0,145,145,48
5,r_67_0_172,seq69,r_148_1_37,r_148_1_37,0.5,135,172,37,48
42,r_23_79_91,r_24_118_95,seq80,r_23_79_91,1.0,0,91,91,48
35,r_108_123_31,r_109_91_72,seq124,r_108_123_31,0.97,-1,30,31,48
31,r_54_52_17,seq55,r_11_33_57,r_11_33_57,0.78,0,57,57,48
32,r_42_49_115,r_32_43_45,seq48,r_42_49_115,0.75,0,115,115,48
45,r_101_76_165,r_96_68_187,seq74,r_101_76_165,0.57,0,165,165,48
19,r_111_70_116,r_112_131_141,seq72,r_111_70_116,0.95,0,116,116,48
87,seq86,seq84,r_93_87_60,r_93_87_60,0.97,-1,59,60,48
44,r_32_43_45,r_31_36_160,r_42_49_115,r_32_43_45,0.82,1,46,45,48
98,seq124,seq126,r_108_123_31,r_108_123_31,0.91,3,34,31,48
89,seq92,seq86,r_109_91_72,r_109_91_72,0.99,2,74,72,48
0,r_129_51_163,r_133_128_111,r_54_52_17,r_129_51_163,0.96,0,163,163,48
90,seq95,r_96_68_187,r_57_98_97,r_57_98_97,0.99,90,187,97,48
26,r_30_97_182,seq34,r_78_29_77,r_78_29_77,0.96,45,122,77,48
18,r_16_73_49,r_13_100_193,seq72,r_16_73_49,1.0,0,49,49,48
0,r_129_51_163,r_127_94_155,r_133_128_111,r_133_128_111,1.0,19,130,111,48
11,r_45_27_178,seq48,r_8_26_169,r_45_27_178,0.42,0,178,178,48
13,r_93_87_60,r_96_68_187,seq86,r_96_68_187,0.63,-122,65,187,48
57,seq141,r_145_99_153,r_121_142_24,r_121_142_24,0.83,1,25,24,48
20,r_121_142_24,r_122_37_27,seq141,r_121_142_24,0.69,0,24,24,48
31,r_54_52_17,seq59,r_129_51_163,r_129_51_163,0.88,2,165,163,48
97,seq120,r_122_37_27,seq117,r_122_37_27,0.79,-6,21,27,48
40,r_28_106_180,r_78_29_77,r_107_103_68,r_28_106_180,0.96,-2,178,180,48
2,r_41_146_59,r_145_99_153,r_83_147_78,r_145_99_153,0.88,-30,123,153,48
23,r_113_25_27,r_112_131_141,r_28_106_180,r_113_25_27,0.93,0,27,27,48
99,seq126,r_129_51_163,r_133_128_111,r_133_128_111,1.0,57,168,111,48
3,r_58_89_8,r_41_146_59,seq90,r_58_89_8,0.88,2,10,8,48
27,r_78_29_77,seq80,r_113_25_27,r_78_29_77,0.99,0,77,77,48
41,r_77_144_52,r_75_47_94,r_145_99_153,r_77_144_52,1.0,0,52,52,48
24,r_60_40_8,r_113_25_27,seq59,r_60_40_8,0.57,63,71,8,48
41,r_77_144_52,r_145_99_153,r_41_146_59,r_145_99_153,1.0,0,153,153,48
40,r_28_106_180,seq34,r_113_25_27,r_113_25_27,0.88,-1,26,27,48
74,seq53,r_57_98_97,seq59,r_57_98_97,1.0,-19,78,97,48
29,r_83_147_78,seq82,r_41_146_59,r_83_147_78,0.97,6,84,78,48
28,r_11_33_57,r_8_26_169,seq34,r_11_33_57,0.97,0,57,57,48
24,r_60_40_8,r_41_146_59,r_113_25_27,r_41_146_59,0.57,1,60,59,48
17,r_112_131_141,seq110,seq132,r_112_131_141,0.74,0,141,141,48
33,r_75_47_94,r_71_130_145,seq48,r_75_47_94,1.0,0,94,94,48
44,r_32_43_45,seq53,r_11_33_57,r_32_43_45,0.58,126,171,45,48
58,seq14,r_13_100_193,seq15,r_13_100_193,0.59,0,193,193,48
47,r_114_62_13,seq110,seq64,r_114_62_13,0.7,0,13,13,48
22,r_109_91_72,r_96_68_187,seq92,r_109_91_72,0.93,0,72,72,48
49,r_85_10_24,seq84,seq9,r_85_10_24,1.0,0,24,24,48
34,r_133_128_111,seq134,r_129_51_163,r_129_51_163,0.71,-52,111,163,48
25,r_143_2_22,r_145_99_153,seq4,r_143_2_22,1.0,0,22,22,48
75,seq55,r_57_98_97,seq59,r_57_98_97,1.0,-18,79,97,48
17,r_112_131_141,r_111_70_116,seq110,r_111_70_116,0.94,0,116,116,48
34,r_133_128_111,r_129_51_163,seq126,r_129_51_163,1.0,0,163,163,48
22,r_109_91_72,r_108_123_31,r_96_68_187,r_109_91_72,0.68,-44,28,72,48
9,r_149_135_137,r_145_99_153,seq134,r_145_99_153,0.65,-9,144,153,48
24,r_60_40_8,seq59,r_75_47_94,r_60_40_8,0.5,126,134,8,48
26,r_30_97_182,r_78_29_77,r_57_98_97,r_30_97_182,0.87,2,184,182,48
31,r_54_52_17,r_11_33_57,seq59,r_54_52_17,0.43,67,84,17,48
71,seq39,r_38_44_168,r_122_37_27,r_122_37_27,1.0,2,29,27,48
82,seq74,r_75_47_94,seq72,r_75_47_94,1.0,0,94,94,48
10,r_122_37_27,r_121_142_24,seq39,r_122_37_27,1.0,0,27,27,48
12,r_57_98_97,seq55,seq95,r_57_98_97,0.99,0,97,97,48
23,r_113_25_27,r_28_106_180,r_78_29_77,r_78_29_77,0.71,38,115,77,48
4,r_148_1_37,r_145_99_153,r_143_2_22,r_145_99_153,0.86,-117,36,153,48
51,seq7,r_6_13_192,r_84_8_69,r_84_8_69,1.0,123,192,69,49
14,r_25_55_133,seq24,seq56,r_25_55_133,0.51,0,133,133,49
8,r_148_65_154,r_149_113_106,r_147_93_183,r_149_113_106,1.0,0,106,106,49
58,seq19,seq30,r_119_20_139,r_119_20_139,0.99,8,147,139,49
43,r_34_137_80,seq32,seq138,r_34_137_80,1.0,0,80,80,49
22,r_122_15_52,r_119_20_139,seq12,r_122_15_52,1.0,0,52,52,49
37,r_101_124_196,seq104,r_2_123_86,r_2_123_86,0.84,110,196,86,49
59,seq24,r_25_55_133,seq30,r_25_55_133,0.67,-30,103,133,49
86,seq81,r_82_140_156,seq78,r_82_140_156,0.97,1,157,156,49
21,r_2_123_86,r_6_13_192,r_64_121_28,r_2_123_86,1.0,0,86,86,49
97,seq116,r_115_136_175,seq117,r_115_136_175,0.68,0,175,175,49
42,r_114_40_92,r_115_136_175,seq36,r_114_40_92,1.0,0,92,92,49
5,r_94_131_43,r_95_110_75,seq128,r_94_131_43,1.0,0,43,43,49
15,r_133_63_120,r_108_135_49,seq62,r_133_63_120,1.0,0,120,120,49
91,seq92,r_94_131_43,r_98_3_120,r_94_131_43,0.99,-6,37,43,49
17,r_39_89_20,r_35_132_157,seq90,r_39_89_20,0.9,0,20,20,49
31,r_141_129_172,seq145,r_125_127_106,r_125_127_106,0.77,66,172,106,49
41,r_5_102_179,r_6_13_192,r_57_105_160,r_57_105_160,0.59,19,179,160,49
15,r_133_63_120,r_134_59_64,r_108_135_49,r_133_63_120,1.0,-69,51,120,49
3,r_119_20_139,seq118,seq19,r_119_20_139,0.95,0,139,139,49
26,r_98_3_120,r_99_21_180,r_120_1_81,r_98_3_120,0.89,0,120,120,49
72,seq47,r_46_126_192,r_10_49_38,r_10_49_38,0.98,154,192,38,49
9,r_147_93_183,seq143,seq92,r_147_93_183,0.97,-10,173,183,49
4,r_149_113_106,r_148_65_154,r_64_121_28,r_149_113_106,0.99,0,106,106,49
29,r_58_112_53,r_57_105_160,r_111_53_166,r_58_112_53,0.98,0,53,53,49
0,r_23_130_103,r_25_55_133,r_94_131_43,r_23_130_103,1.0,0,103,103,49
11,r_99_21_180,seq100,r_142_28_22,r_99_21_180,0.54,0,180,180,49
20,r_106_61_63,seq109,seq62,r_106_61_63,1.0,0,63,63,49
13,r_120_1_81,r_119_20_139,r_14_0_77,r_120_1_81,1.0,1,82,81,49
46,r_111_53_166,r_58_112_53,seq51,r_111_53_166,0.7,0,166,166,49
8,r_148_65_154,r_147_93_183,seq62,r_148_65_154,0.94,0,154,154,49
48,r_57_105_160,seq56,seq103,r_57_105_160,0.5,0,160,160,49
57,seq145,r_141_129_172,seq143,r_141_129_172,0.78,-57,115,172,49
6,r_22_60_65,r_23_130_103,r_134_59_64,r_22_60_65,1.0,0,65,65,49
87,seq85,seq92,r_133_63_120,r_133_63_120,1.0,59,179,120,49
27,r_17_146_196,seq16,r_82_140_156,r_82_140_156,0.54,38,194,156,49
35,r_108_135_49,seq109,r_133_63_120,r_108_135_49,1.0,0,49,49,49
87,seq85,r_84_8_69,seq92,r_84_8_69,1.0,1,70,69,49
75,seq62,r_64_121_28,r_82_140_156,r_64_121_28,0.79,0,28,28,49
47,r_14_0_77,r_11_52_193,r_120_1_81,r_14_0_77,1.0,1,78,77,49
40,r_4_96_161,r_5_102_179,r_86_91_92,r_86_91_92,0.86,68,160,92,49
18,r_86_91_92,seq88,seq92,r_86_91_92,0.63,0,92,92,49
24,r_50_48_114,seq47,r_10_49_38,r_10_49_38,1.0,12,50,38,49
35,r_108_135_49,r_133_63_120,r_147_93_183,r_133_63_120,0.66,1,121,120,49
25,r_84_8_69,seq85,r_5_102_179,r_84_8_69,0.84,1,70,69,49
33,r_33_74_63,r_34_137_80,seq73,r_33_74_63,1.0,2,65,63,49
64,seq32,r_34_137_80,seq36,r_34_137_80,0.99,-4,76,80,49
50,seq128,r_149_113_106,r_94_131_43,r_94_131_43,0.74,5,48,43,49
2,r_142_28_22,r_141_129_172,seq26,r_142_28_22,0.9,0,22,22,49
52,seq138,seq139,r_34_137_80,r_34_137_80,1.0,1,81,80,49
46,r_111_53_166,seq51,r_11_52_193,r_111_53_166,0.45,27,193,166,49
10,r_10_49_38,r_11_52_193,r_50_48_114,r_10_49_38,0.97,0,38,38,49
45,r_54_18_185,seq38,seq19,r_54_18_185,0.74,-1,184,185,49
81,seq73,r_72_97_88,r_33_74_63,r_33_74_63,0.98,48,111,63,49
9,r_147_93_183,r_148_65_154,seq143,r_148_65_154,0.66,-3,151,154,49
50,seq128,r_94_131_43,r_125_127_106,r_125_127_106,1.0,17,123,106,49
91,seq92,r_98_3_120,r_86_91_92,r_98_3_120,1.0,-24,96,120,49
29,r_58_112_53,r_111_53_166,r_95_110_75,r_58_112_53,0.66,109,162,53,49
96,seq109,r_58_112_53,r_27_107_110,r_27_107_110,0.84,0,110,110,49
28,r_134_59_64,r_133_63_120,r_22_60_65,r_134_59_64,0.98,1,65,64,49
49,r_27_107_110,seq26,seq109,r_27_107_110,0.95,0,110,110,49
35,r_108_135_49,r_147_93_183,r_35_132_157,r_108_135_49,0.87,109,158,49,49
7,r_95_110_75,seq78,r_58_112_53,r_95_110_75,1.0,0,75,75,49
44,r_11_52_193,seq12,r_111_53_166,r_11_52_193,0.43,0,193,193,49
25,r_84_8_69,r_5_102_179,r_14_0_77,r_84_8_69,0.76,40,109,69,49
83,seq78,r_94_131_43,seq79,r_94_131_43,1.0,-8,35,43,49
46,r_111_53_166,r_115_136_175,r_58_112_53,r_58_112_53,1.0,3,56,53,49
12,r_6_13_192,seq7,r_122_15_52,r_6_13_192,0.45,1,193,192,49
30,r_64_121_28,seq62,seq118,r_64_121_28,1.0,0,28,28,49
23,r_121_65_28,seq122,r_61_26_126,r_121_65_28,0.99,0,28,28,50
32,r_118_85_55,seq117,seq86,r_118_85_55,0.99,0,55,55,50
14,r_75_50_62,seq77,seq51,r_75_50_62,0.96,0,62,62,50
43,r_66_129_68,r_61_26_126,seq131,r_66_129_68,0.94,0,68,68,50
37,r_37_9_156,seq38,seq11,r_37_9_156,0.66,0,156,156,50
59,seq143,r_142_128_83,seq147,r_142_128_83,0.99,0,83,83,50
11,r_72_144_81,r_70_120_111,seq67,r_72_144_81,0.87,-71,10,81,50
86,seq87,r_90_29_143,seq92,r_90_29_143,1.0,-14,129,143,50
21,r_90_29_143,seq89,r_35_30_137,r_90_29_143,0.84,0,143,143,50
39,r_16_20_111,r_19_91_134,r_64_18_46,r_16_20_111,0.97,23,134,111,50
1,r_142_128_83,seq143,r_13_127_76,r_13_127_76,1.0,7,83,76,50
5,r_13_127_76,r_15_46_155,r_66_129_68,r_13_127_76,1.0,0,76,76,50
46,r_19_91_134,r_15_46_155,seq89,r_15_46_155,0.84,-21,134,155,50
42,r_32_71_103,seq33,seq69,r_32_71_103,1.0,0,103,103,50
80,seq62,r_63_138_104,seq59,r_63_138_104,0.97,-5,99,104,50
8,r_42_3_21,r_47_34_142,seq5,r_42_3_21,0.57,0,21,21,50
18,r_107_84_18,seq106,r_14_83_3,r_107_84_18,0.91,0,18,18,50
27,r_139_116_188,r_63_138_104,r_96_119_159,r_96_119_159,1.0,29,188,159,50
95,seq110,seq122,r_96_119_159,r_96_119_159,0.78,1,160,159,50
31,r_114_80_96,r_113_8_186,seq77,r_114_80_96,0.92,0,96,96,50
41,r_53_31_65,seq51,seq33,r_53_31_65,1.0,0,65,65,50
38,r_14_83_3,seq86,r_107_84_18,r_107_84_18,0.76,8,26,18,50
3,r_61_26_126,seq59,seq25,r_61_26_126,0.98,0,126,126,50
10,r_41_76_154,r_39_108_202,r_19_91_134,r_39_108_202,0.73,-48,154,202,50
47,r_64_18_46,r_61_26_126,r_16_20_111,r_64_18_46,0.97,1,47,46,50
4,r_24_68_132,seq25,seq67,r_24_68_132,0.98,0,132,132,50
63,seq27,r_22_115_173,r_61_26_126,r_61_26_126,0.95,48,174,126,50
20,r_63_138_104,seq62,r_139_116_188,r_63_138_104,0.94,0,104,104,50
19,r_125_145_27,r_124_102_59,r_142_128_83,r_142_128_83,0.46,-56,27,83,50
13,r_111_133_104,seq131,r_52_137_60,r_52_137_60,0.72,43,103,60,50
49,r_103_93_181,r_124_102_59,r_0_94_175,r_0_94_175,0.98,10,185,175,50
57,seq11,r_12_81_201,r_37_9_156,r_37_9_156,0.91,45,201,156,50
13,r_111_133_104,r_52_137_60,r_17_126_168,r_17_126_168,0.91,1,169,168,50
85,seq86,seq98,r_118_85_55,r_118_85_55,1.0,41,96,55,50
43,r_66_129_68,seq131,r_142_128_83,r_66_129_68,0.54,47,115,68,50
27,r_139_116_188,r_140_149_120,r_63_138_104,r_63_138_104,1.0,0,104,104,50
87,seq89,r_90_29_143,r_19_91_134,r_90_29_143,0.64,0,143,143,50
11,r_72_144_81,seq67,r_104_73_57,r_104_73_57,0.65,4,61,57,50
29,r_140_149_120,seq141,seq148,r_140_149_120,0.47,-22,98,120,50
25,r_104_73_57,r_72_144_81,seq69,r_72_144_81,0.88,0,81,81,50
24,r_88_82_99,r_90_29_143,r_107_84_18,r_90_29_143,0.9,-44,99,143,50
33,r_17_126_168,r_16_20_111,r_142_128_83,r_17_126_168,0.8,0,168,168,50
28,r_130_21_177,seq132,r_16_20_111,r_130_21_177,1.0,0,177,177,50
58,seq141,r_140_149_120,r_52_137_60,r_52_137_60,1.0,81,141,60,50
25,r_104_73_57,r_103_93_181,r_72_144_81,r_104_73_57,0.99,1,58,57,50
20,r_63_138_104,r_139_116_188,r_52_137_60,r_63_138_104,0.3,83,187,104,50
68,seq38,r_37_9_156,seq36,r_37_9_156,0.81,0,156,156,50
36,r_4_135_42,seq5,seq136,r_4_135_42,1.0,0,42,42,50
19,r_125_145_27,r_142_128_83,r_72_144_81,r_72_144_81,0.82,2,83,81,50
16,r_124_102_59,seq122,r_103_93_181,r_124_102_59,0.98,0,59,59,50
81,seq67,seq69,r_24_68_132,r_24_68_132,1.0,1,133,132,50
17,r_0_94_175,r_101_1_3,r_19_91_134,r_19_91_134,0.74,39,173,134,50
11,r_72_144_81,r_104_73_57,r_125_145_27,r_72_144_81,0.88,0,81,81,50
9,r_47_34_142,seq48,r_35_30_137,r_47_34_142,0.58,7,149,142,50
22,r_99_45_65,r_100_60_191,seq44,r_99_45_65,1.0,0,65,65,50
49,r_103_93_181,r_104_73_57,r_124_102_59,r_103_93_181,1.0,-122,59,181,50
7,r_146_23_67,seq147,seq25,r_146_23_67,1.0,0,67,67,50
44,r_70_120_111,seq69,seq122,r_70_120_111,0.71,0,111,111,50
82,seq69,r_70_120_111,r_32_71_103,r_32_71_103,0.73,8,111,103,50
35,r_52_137_60,r_53_31_65,r_4_135_42,r_52_137_60,1.0,0,60,60,50
12,r_15_46_155,r_17_126_168,seq48,r_15_46_155,0.78,0,155,155,50
23,r_121_65_28,r_61_26_126,seq62,r_61_26_126,1.0,-28,98,126,50
30,r_26_136_62,seq24,seq134,r_26_136_62,1.0,0,62,62,51
51,seq2,r_0_27_96,r_97_1_75,r_97_1_75,0.99,3,78,75,51
36,r_119_83_162,seq118,seq84,r_119_83_162,0.52,0,162,162,51
20,r_85_39_41,seq84,r_138_37_3,r_85_39_41,1.0,0,41,41,51
66,seq24,seq22,r_140_25_134,r_140_25_134,1.0,1,135,134,51
14,r_51_61_134,r_52_62_79,r_50_53_81,r_52_62_79,0.57,2,81,79,51
8,r_55_77_85,r_51_61_134,r_131_78_23,r_55_77_85,0.99,0,85,85,51
43,r_102_54_107,r_103_66_86,r_55_77_85,r_102_54_107,0.75,-20,87,107,51
83,seq80,seq81,r_48_79_61,r_48_79_61,1.0,14,75,61,51
19,r_18_117_134,r_67_19_16,seq116,r_18_117_134,0.99,0,134,134,51
71,seq42,r_43_88_163,r_105_38_58,r_105_38_58,1.0,105,163,58,51
5,r_20_57_22,r_18_117_134,seq56,r_20_57_22,1.0,0,22,22,51
16,r_108_130_114,seq107,seq129,r_108_130_114,0.91,0,114,114,51
39,r_64_106_126,seq65,seq107,r_64_106_126,0.9,0,126,126,51
1,r_48_79_61,r_49_60_166,seq80,r_48_79_61,0.99,0,61,61,51
46,r_50_53_81,seq33,r_51_61_134,r_51_61_134,0.53,-53,81,134,51
42,r_97_1_75,r_100_6_155,seq2,r_97_1_75,0.57,0,75,75,51
46,r_50_53_81,r_102_54_107,r_105_38_58,r_50_53_81,0.48,81,162,81,51
14,r_51_61_134,r_50_53_81,r_52_62_79,r_51_61_134,1.0,0,134,134,51
25,r_104_112_37,r_103_66_86,seq114,r_104_112_37,0.79,0,37,37,51
45,r_147_139_123,seq146,r_16_137_21,r_16_137_21,0.98,100,121,21,51
2,r_16_137_21,r_15_29_112,seq142,r_16_137_21,0.99,0,21,21,51
66,seq24,r_26_136_62,seq22,r_26_136_62,1.0,0,62,62,51
67,seq28,seq34,r_15_29_112,r_15_29_112,1.0,1,113,112,51
0,r_105_38_58,seq107,r_138_37_3,r_105_38_58,1.0,0,58,58,51
37,r_67_19_16,seq68,r_18_117_134,r_67_19_16,1.0,-1,15,16,51
10,r_111_4_117,seq114,r_21_13_86,r_111_4_117,0.94,0,117,117,51
61,seq144,seq143,r_132_145_39,r_132_145_39,0.62,5,44,39,51
90,seq101,r_100_6_155,r_48_79_61,r_48_79_61,0.99,93,154,61,51
26,r_52_62_79,r_51_61_134,seq63,r_52_62_79,0.67,0,79,79,51
72,seq44,r_45_93_154,seq46,r_45_93_154,0.62,0,154,154,51
11,r_138_37_3,r_40_92_55,r_85_39_41,r_138_37_3,0.98,52,55,3,51
4,r_115_9_148,seq107,seq7,r_115_9_148,0.74,0,148,148,51
9,r_132_145_39,r_135_149_98,seq144,r_132_145_39,0.83,0,39,39,51
78,seq65,r_64_106_126,r_103_66_86,r_103_66_86,0.7,40,126,86,51
63,seq148,r_147_139_123,r_135_149_98,r_135_149_98,0.37,4,102,98,51
13,r_95_113_64,r_97_1_75,r_104_112_37,r_95_113_64,0.97,0,64,64,51
15,r_45_93_154,seq44,r_48_79_61,r_48_79_61,0.99,92,153,61,51
62,seq146,r_147_139_123,r_135_149_98,r_147_139_123,0.56,1,124,123,51
21,r_8_94_12,r_97_1_75,r_40_92_55,r_8_94_12,1.0,63,75,12,51
21,r_8_94_12,r_0_27_96,r_97_1_75,r_8_94_12,0.98,0,12,12,51
47,r_128_17_10,r_125_72_95,r_15_29_112,r_128_17_10,0.98,0,10,10,51
27,r_140_25_134,seq141,seq24,r_140_25_134,0.61,0,134,134,51
48,r_110_3_22,r_105_38_58,seq11,r_110_3_22,1.0,0,22,22,51
79,seq68,seq73,r_125_72_95,r_125_72_95,0.96,14,109,95,51
79,seq68,r_67_19_16,seq73,r_67_19_16,0.78,-3,13,16,51
40,r_75_98_171,r_96_76_2,r_131_78_23,r_131_78_23,0.99,56,79,23,51
74,seq47,r_49_60_166,seq44,r_49_60_166,0.66,0,166,166,51
18,r_15_29_112,r_18_117_134,seq28,r_15_29_112,0.96,0,112,112,51
33,r_99_14_66,r_100_6_155,r_15_29_112,r_99_14_66,1.0,0,66,66,51
29,r_40_92_55,seq34,r_8_94_12,r_40_92_55,1.0,0,55,55,51
47,r_128_17_10,r_15_29_112,r_21_13_86,r_15_29_112,0.78,0,112,112,51
88,seq87,seq80,r_8_94_12,r_8_94_12,0.98,132,144,12,51
50,seq129,seq133,r_108_130_114,r_108_130_114,0.58,0,114,114,51
32,r_21_13_86,seq22,r_99_14_66,r_99_14_66,1.0,20,86,66,51
46,r_50_53_81,r_51_61_134,r_102_54_107,r_51_61_134,0.93,2,136,134,51
41,r_89_36_33,seq87,r_138_37_3,r_89_36_33,0.99,0,33,33,51
34,r_135_149_98,seq133,seq148,r_135_149_98,0.8,0,98,98,51
19,r_18_117_134,r_16_137_21,r_67_19_16,r_18_117_134,1.0,-117,17,134,51
38,r_131_78_23,seq141,r_75_98_171,r_131_78_23,0.82,0,23,23,51
33,r_99_14_66,r_15_29_112,r_21_13_86,r_15_29_112,1.0,-17,95,112,51
43,r_102_54_107,r_55_77_85,r_50_53_81,r_102_54_107,0.84,0,107,107,51
94,seq116,r_115_9_148,r_18_117_134,r_18_117_134,0.71,14,148,134,51
37,r_67_19_16,r_18_117_134,seq7,r_18_117_134,0.88,0,134,134,51
22,r_43_88_163,seq42,r_48_79_61,r_48_79_61,1.0,101,162,61,51
28,r_5_58_117,r_18_117_134,seq56,r_5_58_117,0.93,0,117,117,51
49,r_74_31_76,seq80,seq30,r_74_31_76,1.0,0,76,76,51
7,r_103_66_86,r_102_54_107,seq65,r_103_66_86,1.0,1,87,86,51
44,r_0_27_96,seq2,seq24,r_0_27_96,0.69,0,96,96,51
23,r_49_60_166,seq47,r_103_66_86,r_49_60_166,0.52,0,166,166,51
82,seq73,seq70,r_125_72_95,r_125_72_95,1.0,7,102,95,51
35,r_96_76_2,r_75_98_171,r_55_77_85,r_55_77_85,1.0,56,141,85,51
12,r_125_72_95,seq126,seq73,r_125_72_95,0.92,2,97,95,51
30,r_124_8_122,r_146_128_39,seq13,r_124_8_122,1.0,0,122,122,52
40,r_146_128_39,r_124_8_122,r_11_129_114,r_146_128_39,0.92,83,122,39,52
30,r_124_8_122,r_125_71_77,r_146_128_39,r_124_8_122,1.0,-57,65,122,52
27,r_99_109_44,seq98,seq112,r_99_109_44,1.0,0,44,44,52
8,r_43_143_149,r_41_45_28,r_148_144_36,r_43_143_149,0.82,0,149,149,52
53,seq4,seq2,r_53_5_72,r_53_5_72,1.0,18,90,72,52
43,r_69_81_78,seq67,r_130_80_16,r_130_80_16,0.87,64,80,16,52
36,r_138_113_157,r_134_123_155,r_34_137_37,r_34_137_37,1.0,2,39,37,52
23,r_10_49_23,r_12_89_147,r_41_45_28,r_10_49_23,0.94,0,23,23,52
54,seq133,r_134_123_155,r_103_135_42,r_103_135_42,0.94,34,76,42,52
37,r_53_5_72,seq55,seq4,r_53_5_72,1.0,0,72,72,52
59,seq22,r_23_77_152,r_39_40_56,r_39_40_56,0.56,96,152,56,52
86,seq94,r_92_29_168,seq101,r_92_29_168,0.41,-3,165,168,52
16,r_132_136_118,r_131_127_86,r_34_137_37,r_132_136_118,0.88,-28,90,118,52
21,r_104_84_167,seq106,r_66_85_140,r_104_84_167,0.51,0,167,167,52
13,r_54_1_15,r_56_20_140,seq0,r_54_1_15,0.84,0,15,15,52
46,r_37_62_26,r_39_40_56,seq61,r_37_62_26,0.86,-10,16,26,52
7,r_18_57_64,r_56_20_140,r_10_49_23,r_56_20_140,0.94,0,140,140,52
1,r_42_28_24,r_43_143_149,r_96_27_2,r_42_28_24,0.77,1,25,24,52
45,r_15_58_25,r_12_89_147,seq79,r_15_58_25,0.88,1,26,25,52
3,r_95_6_145,r_100_68_165,r_53_5_72,r_53_5_72,0.97,73,145,72,52
10,r_16_64_118,seq13,seq65,r_16_64_118,0.99,0,118,118,52
0,r_12_89_147,r_11_129_114,seq13,r_11_129_114,1.0,0,114,114,52
11,r_11_129_114,r_12_89_147,r_146_128_39,r_11_129_114,0.99,0,114,114,52
87,seq98,r_99_109_44,seq101,r_99_109_44,1.0,0,44,44,52
15,r_131_127_86,r_132_136_118,r_146_128_39,r_132_136_118,0.83,-30,88,118,52
48,r_141_73_74,seq142,seq72,r_141_73_74,1.0,2,76,74,52
6,r_56_20_140,r_53_5_72,r_18_57_64,r_56_20_140,0.99,-71,69,140,52
99,seq122,r_124_8_122,r_131_127_86,r_131_127_86,0.95,23,109,86,52
36,r_138_113_157,r_34_137_37,r_99_109_44,r_138_113_157,0.7,0,157,157,52
31,r_34_137_37,seq30,r_138_113_157,r_34_137_37,1.0,0,37,37,52
9,r_103_135_42,r_104_84_167,r_34_137_37,r_103_135_42,1.0,0,42,42,52
2,r_93_21_96,seq94,r_97_19_7,r_93_21_96,0.94,0,96,96,52
47,r_115_126_138,seq118,r_131_127_86,r_115_126_138,0.64,1,139,138,52
74,seq65,r_66_85_140,r_16_64_118,r_16_64_118,1.0,22,140,118,52
18,r_23_77_152,seq22,r_130_80_16,r_130_80_16,0.99,136,152,16,52
29,r_7_46_96,r_11_129_114,r_41_45_28,r_7_46_96,1.0,0,96,96,52
24,r_75_121_100,seq76,seq120,r_75_121_100,0.98,0,100,100,52
40,r_146_128_39,seq145,r_124_8_122,r_146_128_39,1.0,1,40,39,52
25,r_44_105_105,seq47,seq106,r_44_105_105,1.0,0,105,105,52
70,seq55,r_53_5_72,r_41_45_28,r_53_5_72,1.0,0,72,72,52
6,r_56_20_140,r_18_57_64,r_93_21_96,r_56_20_140,0.9,0,140,140,52
32,r_125_71_77,r_124_8_122,r_141_73_74,r_125_71_77,1.0,0,77,77,52
38,r_91_78_163,r_92_29_168,r_130_80_16,r_130_80_16,0.64,147,163,16,52
0,r_12_89_147,seq13,seq87,r_12_89_147,0.77,2,149,147,52
33,r_70_149_18,seq72,seq145,r_70_149_18,0.99,0,18,18,52
26,r_97_19_7,seq14,r_93_21_96,r_93_21_96,1.0,22,118,96,52
31,r_34_137_37,r_138_113_157,r_132_136_118,r_34_137_37,0.85,93,130,37,52
34,r_17_60_35,r_12_89_147,seq61,r_17_60_35,0.95,0,35,35,52
7,r_18_57_64,r_12_89_147,r_56_20_140,r_18_57_64,0.95,0,64,64,52
44,r_9_32_64,r_11_129_114,seq31,r_9_32_64,1.0,0,64,64,52
99,seq122,r_131_127_86,r_134_123_155,r_134_123_155,1.0,1,156,155,52
41,r_50_38_38,r_44_105_105,r_39_40_56,r_44_105_105,0.78,-65,40,105,52
35,r_102_111_141,seq118,seq110,r_102_111_141,0.71,0,141,141,52
22,r_90_36_61,seq87,r_39_40_56,r_90_36_61,0.77,-14,47,61,52
30,r_38_22_178,seq36,r_5_25_15,r_5_25_15,0.63,163,178,15,53
36,r_135_96_82,seq134,r_85_97_57,r_135_96_82,1.0,0,82,82,53
9,r_109_0_13,r_1_110_148,r_71_27_127,r_109_0_13,0.64,135,148,13,53
14,r_33_101_122,seq34,seq104,r_33_101_122,0.92,1,123,122,53
8,r_19_81_66,r_23_30_187,seq77,r_19_81_66,1.0,0,66,66,53
43,r_18_43_105,seq15,seq45,r_18_43_105,0.96,0,105,105,53
37,r_106_21_114,seq107,r_5_25_15,r_106_21_114,0.84,0,114,114,53
20,r_20_58_26,r_19_81_66,seq57,r_19_81_66,0.83,-40,26,66,53
21,r_68_56_73,r_69_140_122,r_55_117_131,r_68_56_73,0.73,0,73,73,53
1,r_74_62_16,seq64,r_70_65_90,r_70_65_90,0.99,68,158,90,53
38,r_125_26_27,r_5_25_15,r_71_27_127,r_71_27_127,0.6,12,139,127,53
15,r_108_141_17,r_118_133_32,seq144,r_108_141_17,0.98,0,17,17,53
46,r_49_82_80,seq50,seq95,r_49_82_80,0.81,1,81,80,53
42,r_70_65_90,r_71_27_127,r_74_62_16,r_70_65_90,0.52,0,90,90,53
35,r_143_24_44,r_142_86_91,r_5_25_15,r_143_24_44,1.0,1,45,44,53
45,r_53_78_152,r_52_47_176,r_19_81_66,r_52_47_176,0.79,-23,153,176,53
19,r_94_44_108,seq95,seq45,r_94_44_108,0.94,0,108,108,53
34,r_118_133_32,r_135_96_82,r_72_132_45,r_135_96_82,0.71,0,82,82,53
95,seq107,r_106_21_114,seq103,r_106_21_114,0.82,0,114,114,53
31,r_55_117_131,seq60,r_102_113_53,r_55_117_131,0.88,0,131,131,53
10,r_1_110_148,r_109_0_13,r_137_111_127,r_1_110_148,0.83,0,148,148,53
44,r_91_51_19,r_90_99_39,r_52_47_176,r_91_51_19,0.81,0,19,19,53
38,r_125_26_27,r_115_28_34,r_5_25_15,r_5_25_15,0.43,70,85,15,53
26,r_145_48_152,seq144,r_52_47_176,r_145_48_152,0.79,0,152,152,53
88,seq84,seq95,r_142_86_91,r_142_86_91,0.92,18,109,91,53
25,r_29_40_67,r_115_28_34,r_126_41_8,r_29_40_67,0.98,2,69,67,53
4,r_137_111_127,seq136,r_102_113_53,r_137_111_127,0.88,0,127,127,53
11,r_139_75_95,r_145_48_152,r_37_76_72,r_139_75_95,0.92,1,96,95,53
1,r_74_62_16,r_80_100_50,seq64,r_74_62_16,0.89,0,16,16,53
13,r_142_86_91,r_139_75_95,seq84,r_142_86_91,1.0,0,91,91,53
6,r_37_76_72,r_33_101_122,seq77,r_37_76_72,1.0,0,72,72,53
3,r_80_100_50,seq77,r_90_99_39,r_80_100_50,0.98,0,50,50,53
47,r_115_28_34,r_29_40_67,r_125_26_27,r_29_40_67,0.73,2,69,67,53
9,r_109_0_13,r_108_141_17,r_1_110_148,r_109_0_13,0.94,0,13,13,53
25,r_29_40_67,r_5_25_15,r_115_28_34,r_29_40_67,0.46,-29,38,67,53
2,r_5_25_15,seq6,r_143_24_44,r_143_24_44,0.92,17,61,44,53
40,r_127_138_133,seq130,seq136,r_127_138_133,0.93,0,133,133,53
75,seq45,r_42_92_155,r_83_46_27,r_83_46_27,0.84,-2,25,27,53
29,r_13_120_193,seq12,r_72_132_45,r_72_132_45,0.91,155,200,45,53
47,r_115_28_34,r_125_26_27,r_106_21_114,r_106_21_114,0.85,63,177,114,53
49,r_90_99_39,r_85_97_57,r_80_100_50,r_80_100_50,1.0,2,52,50,53
33,r_52_47_176,r_53_78_152,r_91_51_19,r_52_47_176,0.85,-83,93,176,53
32,r_85_97_57,seq84,r_8_98_60,r_8_98_60,0.66,-2,58,60,53
63,seq14,r_18_43_105,r_35_17_8,r_18_43_105,0.91,-63,42,105,53
49,r_90_99_39,seq87,r_85_97_57,r_90_99_39,0.45,1,40,39,53
81,seq61,seq64,r_70_65_90,r_70_65_90,1.0,68,158,90,53
17,r_119_16_169,seq121,r_35_17_8,r_119_16_169,0.33,0,169,169,53
27,r_123_147_57,r_124_79_179,seq146,r_123_147_57,1.0,0,57,57,53
16,r_114_32_14,r_109_0_13,seq31,r_114_32_14,0.92,-3,11,14,53
34,r_118_133_32,r_115_28_34,r_135_96_82,r_118_133_32,0.95,0,32,32,53
12,r_72_132_45,r_71_27_127,r_118_133_32,r_72_132_45,1.0,0,45,45,53
22,r_71_27_127,seq67,r_125_26_27,r_125_26_27,0.56,100,127,27,53
28,r_69_140_122,r_71_27_127,r_108_141_17,r_69_140_122,0.62,0,122,122,53
91,seq95,r_94_44_108,seq88,r_94_44_108,0.99,0,108,108,53
21,r_68_56_73,r_55_117_131,r_20_58_26,r_55_117_131,1.0,0,131,131,53
7,r_83_46_27,seq84,seq45,r_83_46_27,0.99,0,27,27,53
23,r_8_98_60,seq6,r_80_100_50,r_8_98_60,1.0,0,60,60,53
82,seq63,seq64,r_74_62_16,r_74_62_16,0.9,71,87,16,53
47,r_115_28_34,seq112,r_29_40_67,r_115_28_34,0.96,4,38,34,53
38,r_125_26_27,seq50,r_115_28_34,r_125_26_27,0.61,17,44,27,53
38,r_125_26_27,r_123_147_57,seq50,r_125_26_27,0.93,0,27,27,53
30,r_96_131_106,r_94_11_163,r_14_130_22,r_96_131_106,0.93,0,106,106,54
4,r_62_40_95,r_63_25_70,seq66,r_62_40_95,0.59,-66,29,95,54
8,r_143_76_180,r_142_126_167,r_106_144_58,r_106_144_58,1.0,80,138,58,54
58,seq16,seq20,r_48_17_88,r_48_17_88,0.98,54,142,88,54
43,r_134_105_68,seq136,r_47_103_3,r_134_105_68,1.0,0,68,68,54
37,r_104_119_73,seq98,r_111_120_30,r_104_119_73,0.96,0,73,73,54
55,seq136,r_134_105_68,seq147,r_134_105_68,1.0,0,68,68,54
1,r_48_17_88,r_50_64_135,seq16,r_48_17_88,0.89,-3,85,88,54
5,r_122_91_165,r_121_36_92,r_104_119_73,r_122_91_165,0.99,-91,74,165,54
42,r_146_123_169,r_44_145_1,r_111_120_30,r_146_123_169,0.73,0,169,169,54
45,r_14_130_22,r_15_93_73,seq129,r_14_130_22,1.0,0,22,22,54
7,r_71_140_52,r_143_76_180,r_59_138_90,r_59_138_90,0.73,6,96,90,54
49,r_13_65_112,seq67,r_50_64_135,r_13_65_112,0.49,57,169,112,54
66,seq37,r_35_135_181,r_121_36_92,r_121_36_92,1.0,5,97,92,54
67,seq41,seq45,r_12_42_113,r_12_42_113,0.94,6,119,113,54
14,r_82_6_26,r_81_26_130,seq1,r_82_6_26,1.0,0,26,26,54
3,r_9_28_110,seq10,seq29,r_9_28_110,0.93,0,110,110,54
16,r_54_118_90,r_59_138_90,r_104_119_73,r_59_138_90,0.53,21,111,90,54
0,r_63_25_70,r_62_40_95,seq20,r_63_25_70,0.86,0,70,70,54
73,seq67,r_68_43_73,seq66,r_68_43_73,0.96,-1,72,73,54
11,r_127_22_155,seq133,r_63_25_70,r_63_25_70,0.63,85,155,70,54
7,r_71_140_52,seq73,r_143_76_180,r_71_140_52,0.98,0,52,52,54
20,r_142_126_167,r_143_76_180,r_111_120_30,r_142_126_167,0.61,1,168,167,54
13,r_50_64_135,r_48_17_88,r_4_51_44,r_4_51_44,0.97,42,86,44,54
98,seq125,r_121_36_92,r_111_120_30,r_121_36_92,0.93,-27,65,92,54
56,seq10,r_82_6_26,r_94_11_163,r_94_11_163,1.0,7,170,163,54
15,r_94_11_163,seq95,seq10,r_94_11_163,0.92,0,163,163,54
4,r_62_40_95,seq66,seq41,r_62_40_95,0.76,0,95,95,54
6,r_12_42_113,r_13_65_112,seq41,r_12_42_113,0.9,0,113,113,54
62,seq29,r_27_114_180,r_12_42_113,r_27_114_180,0.53,-114,66,180,54
13,r_50_64_135,r_4_51_44,r_13_65_112,r_50_64_135,0.87,0,135,135,54
85,seq95,r_94_11_163,r_15_93_73,r_15_93_73,0.62,90,163,73,54
21,r_7_61_12,r_9_28_110,seq56,r_7_61_12,0.59,0,12,12,54
5,r_122_91_165,r_104_119_73,r_8_92_145,r_122_91_165,0.81,0,165,165,54
36,r_111_120_30,r_122_91_165,r_87_124_149,r_111_120_30,0.61,135,165,30,54
2,r_81_26_130,seq79,r_63_25_70,r_81_26_130,0.78,0,130,130,54
40,r_15_93_73,seq16,seq95,r_15_93_73,0.99,0,73,73,54
29,r_68_43_73,seq67,seq45,r_68_43_73,0.91,0,73,73,54
24,r_0_132_129,seq1,seq133,r_0_132_129,0.78,0,129,129,54
58,seq16,r_15_93_73,seq20,r_15_93_73,0.94,-12,61,73,54
65,seq34,r_33_78_59,seq45,r_33_78_59,0.8,5,64,59,54
18,r_33_78_59,seq34,seq86,r_33_78_59,0.98,-4,55,59,54
25,r_60_97_58,r_59_138_90,seq100,r_60_97_58,0.63,0,58,58,54
32,r_121_36_92,r_122_91_165,seq37,r_121_36_92,1.0,-3,89,92,54
54,seq129,seq128,r_14_130_22,r_14_130_22,1.0,1,23,22,54
38,r_23_85_170,seq20,r_33_78_59,r_33_78_59,0.81,111,170,59,54
33,r_4_51_44,seq1,seq56,r_4_51_44,1.0,0,44,44,54
34,r_18_58_80,r_23_85_170,seq56,r_18_58_80,0.74,0,80,80,54
8,r_143_76_180,r_106_144_58,seq75,r_143_76_180,0.96,0,180,180,54
19,r_49_109_26,r_50_64_135,seq108,r_49_109_26,0.53,0,26,26,54
17,r_44_145_1,r_146_123_169,r_106_144_58,r_106_144_58,1.0,111,169,58,54
9,r_27_114_180,seq29,seq113,r_27_114_180,0.49,-1,179,180,54
36,r_111_120_30,seq112,r_122_91_165,r_111_120_30,0.96,0,30,30,54
46,r_106_144_58,seq112,r_44_145_1,r_106_144_58,1.0,1,59,58,54
22,r_137_46_85,r_44_145_1,r_7_61_12,r_137_46_85,0.99,0,85,85,54
28,r_8_92_145,seq10,r_15_93_73,r_8_92_145,0.72,0,145,145,54
49,r_13_65_112,r_12_42_113,seq67,r_13_65_112,0.52,0,112,112,54
44,r_38_139_179,seq45,r_71_140_52,r_71_140_52,0.94,127,179,52,54
72,seq66,r_68_43_73,seq67,r_68_43_73,0.83,-29,44,73,54
62,seq29,r_12_42_113,r_9_28_110,r_9_28_110,0.63,3,113,110,54
35,r_55_80_31,r_59_138_90,seq79,r_59_138_90,0.69,-59,31,90,54
12,r_117_24_128,seq116,r_63_25_70,r_117_24_128,0.65,0,128,128,54
44,r_34_7_25,r_6_119_154,r_118_9_53,r_34_7_25,0.76,131,156,25,55
9,r_134_98_43,r_132_32_98,seq99,r_134_98_43,0.92,0,43,43,55
36,r_92_71_127,seq89,r_42_58_8,r_92_71_127,0.49,0,127,127,55
8,r_115_44_61,seq116,r_46_103_131,r_115_44_61,1.0,0,61,61,55
53,seq3,seq0,r_118_9_53,r_118_9_53,1.0,134,187,53,55
43,r_25_35_113,r_23_10_183,r_80_36_70,r_80_36_70,1.0,63,133,70,55
26,r_28_8_42,r_26_138_63,r_6_119_154,r_28_8_42,0.88,1,43,42,55
54,seq133,r_132_32_98,seq146,r_132_32_98,0.84,0,98,98,55
37,r_24_122_76,r_25_35_113,seq123,r_24_122_76,1.0,0,76,76,55
16,r_64_86_103,seq63,seq112,r_64_86_103,0.54,0,103,103,55
35,r_104_143_175,r_1_107_54,r_141_145_73,r_104_143_175,0.84,0,175,175,55
32,r_27_29_191,r_68_30_43,r_80_36_70,r_80_36_70,0.71,119,189,70,55
45,r_33_87_167,r_27_29_191,seq88,r_33_87_167,0.49,0,167,167,55
39,r_68_30_43,r_69_61_130,r_27_29_191,r_68_30_43,1.0,0,43,43,55
15,r_132_32_98,r_33_87_167,r_80_36_70,r_33_87_167,0.99,0,167,167,55
31,r_1_107_54,seq0,r_104_143_175,r_1_107_54,1.0,0,54,54,55
11,r_80_36_70,r_33_87_167,r_132_32_98,r_80_36_70,0.85,97,167,70,55
39,r_68_30_43,r_27_29_191,r_80_36_70,r_80_36_70,0.94,68,138,70,55
41,r_12_131_183,seq13,r_111_139_130,r_12_131_183,0.53,3,186,183,55
89,seq102,r_108_110_185,r_46_103_131,r_46_103_131,1.0,16,147,131,55
10,r_148_95_116,seq146,r_18_149_25,r_18_149_25,0.96,35,60,25,55
8,r_115_44_61,r_46_103_131,r_5_39_9,r_46_103_131,1.0,0,131,131,55
72,seq53,seq52,r_85_54_79,r_85_54_79,1.0,48,127,79,55
4,r_108_110_185,seq102,r_1_107_54,r_1_107_54,1.0,29,83,54,55
0,r_111_139_130,seq112,r_26_138_63,r_26_138_63,0.52,67,130,63,55
11,r_80_36_70,seq83,r_33_87_167,r_80_36_70,0.97,0,70,70,55
20,r_100_78_75,r_94_17_172,seq84,r_94_17_172,0.93,-42,130,172,55
13,r_94_17_172,seq96,r_70_14_7,r_94_17_172,0.73,0,172,172,55
15,r_132_32_98,seq133,r_33_87_167,r_132_32_98,0.77,1,99,98,55
1,r_118_9_53,seq116,r_28_8_42,r_118_9_53,1.0,1,54,53,55
6,r_59_48_125,seq62,seq50,r_59_48_125,0.96,0,125,125,55
85,seq89,r_92_71_127,r_121_90_47,r_92_71_127,0.74,0,127,127,55
26,r_28_8_42,r_6_119_154,r_118_9_53,r_28_8_42,0.86,45,87,42,55
29,r_55_38_39,r_118_9_53,r_5_39_9,r_118_9_53,0.49,115,168,53,55
27,r_56_93_121,r_57_11_132,seq89,r_57_11_132,1.0,-11,121,132,55
19,r_37_60_53,r_55_38_39,seq62,r_37_60_53,1.0,0,53,53,55
2,r_6_119_154,seq0,seq114,r_6_119_154,0.85,1,155,154,55
40,r_18_149_25,seq19,seq146,r_18_149_25,0.97,1,26,25,55
63,seq19,r_18_149_25,r_70_14_7,r_18_149_25,0.85,1,26,25,55
25,r_47_137_186,seq50,r_111_139_130,r_111_139_130,0.97,56,186,130,55
19,r_37_60_53,seq43,r_55_38_39,r_55_38_39,0.66,2,41,39,55
33,r_109_79_92,seq102,seq84,r_109_79_92,0.54,6,98,92,55
42,r_121_90_47,seq123,seq89,r_121_90_47,0.34,0,47,47,55
18,r_5_39_9,r_6_119_154,seq41,r_5_39_9,0.6,5,14,9,55
88,seq99,r_100_78_75,r_134_98_43,r_134_98_43,0.93,55,98,43,55
44,r_34_7_25,r_33_87_167,r_6_119_154,r_34_7_25,0.53,0,25,25,55
65,seq21,seq20,r_73_22_98,r_73_22_98,1.0,0,98,98,55
14,r_46_103_131,r_115_44_61,seq102,r_46_103_131,1.0,0,131,131,55
32,r_27_29_191,r_26_138_63,r_68_30_43,r_27_29_191,0.99,-128,63,191,55
38,r_73_22_98,r_72_127_177,seq21,r_73_22_98,1.0,3,101,98,55
14,r_46_103_131,seq40,r_115_44_61,r_115_44_61,1.0,3,64,61,55
10,r_148_95_116,r_18_149_25,seq96,r_148_95_116,1.0,0,116,116,55
17,r_26_138_63,r_27_29_191,seq136,r_26_138_63,1.0,0,63,63,55
96,seq123,r_111_139_130,r_24_122_76,r_24_122_76,0.85,21,97,76,55
8,r_115_44_61,r_5_39_9,r_4_45_155,r_115_44_61,0.4,105,166,61,55
29,r_55_38_39,r_56_93_121,r_37_60_53,r_55_38_39,0.58,0,39,39,55
31,r_1_107_54,r_104_143_175,r_46_103_131,r_46_103_131,0.86,40,171,131,55
22,r_31_101_16,seq20,seq102,r_31_101_16,0.95,-3,13,16,55
28,r_4_45_155,seq3,r_115_44_61,r_115_44_61,0.98,94,155,61,55
49,r_106_135_143,r_104_143_175,r_26_138_63,r_26_138_63,0.7,81,144,63,55
29,r_55_38_39,r_37_60_53,r_5_39_9,r_37_60_53,0.89,0,53,53,55
7,r_85_54_79,seq83,seq53,r_85_54_79,0.91,0,79,79,55
23,r_23_10_183,r_25_35_113,r_118_9_53,r_118_9_53,0.96,132,185,53,55
29,r_55_38_39,r_5_39_9,r_118_9_53,r_118_9_53,0.45,73,126,53,55
35,r_104_143_175,r_106_135_143,r_1_107_54,r_1_107_54,1.0,90,144,54,55
12,r_49_130_135,seq50,seq129,r_49_130_135,0.95,0,135,135,55
30,r_135_65_137,seq133,r_1_64_89,r_135_65_137,0.92,0,137,137,56
36,r_99_33_174,seq98,r_145_37_121,r_145_37_121,0.84,53,174,121,56
14,r_8_105_180,seq7,r_139_109_22,r_8_105_180,0.6,0,180,180,56
8,r_18_45_71,r_20_83_78,seq47,r_18_45_71,0.55,0,71,71,56
43,r_50_148_72,seq51,seq149,r_50_148_72,1.0,0,72,72,56
54,seq7,r_8_105_180,seq4,r_8_105_180,1.0,-23,157,180,56
37,r_100_27_85,seq108,seq26,r_100_27_85,1.0,0,85,85,56
26,r_81_118_159,r_20_83_78,seq117,r_81_118_159,0.45,0,159,159,56
55,seq11,r_10_136_113,r_9_23_59,r_10_136_113,1.0,0,113,113,56
21,r_24_30_3,r_29_97_129,seq31,r_29_97_129,1.0,-5,124,129,56
1,r_5_82_177,seq4,seq88,r_5_82_177,0.62,0,177,177,56
97,seq119,r_121_13_91,r_19_123_11,r_121_13_91,1.0,-15,76,91,56
5,r_1_64_89,seq0,seq63,r_1_64_89,0.91,0,89,89,56
46,r_6_21_70,r_5_82_177,r_129_14_42,r_129_14_42,0.92,27,69,42,56
7,r_125_134_136,r_19_123_11,r_16_130_116,r_125_134_136,0.82,0,136,136,56
11,r_139_109_22,r_144_17_189,seq108,r_139_109_22,1.0,0,22,22,56
59,seq149,r_144_17_189,r_50_148_72,r_50_148_72,1.0,2,74,72,56
95,seq113,r_114_58_145,seq117,r_114_58_145,0.92,1,146,145,56
31,r_95_49_164,r_96_89_100,r_99_33_174,r_96_89_100,0.71,-1,99,100,56
41,r_87_115_154,seq88,r_101_116_80,r_87_115_154,0.74,0,154,154,56
67,seq40,r_39_94_187,seq41,r_39_94_187,0.3,0,187,187,56
3,r_52_85_112,seq51,seq88,r_52_85_112,0.85,0,112,112,56
10,r_114_58_145,seq113,seq53,r_114_58_145,0.96,0,145,145,56
26,r_81_118_159,r_79_86_180,r_20_83_78,r_20_83_78,0.97,67,145,78,56
78,seq63,seq61,r_1_64_89,r_1_64_89,0.93,-1,88,89,56
0,r_16_130_116,r_20_83_78,r_6_21_70,r_20_83_78,1.0,1,79,78,56
13,r_122_137_97,r_125_134_136,r_135_65_137,r_122_137_97,0.68,0,97,97,56
98,seq120,r_121_13_91,seq126,r_121_13_91,1.0,0,91,91,56
48,r_144_17_189,seq143,r_6_21_70,r_6_21_70,1.0,119,189,70,56
6,r_76_56_149,seq73,r_114_58_145,r_76_56_149,0.82,0,149,149,56
27,r_103_62_97,r_104_124_99,seq63,r_103_62_97,1.0,0,97,97,56
80,seq70,r_69_75_30,r_72_67_10,r_69_75_30,0.64,-3,27,30,56
2,r_129_14_42,seq126,seq15,r_129_14_42,1.0,2,44,42,56
28,r_19_123_11,r_16_130_116,r_122_137_97,r_19_123_11,0.92,0,11,11,56
18,r_138_28_113,r_135_65_137,r_100_27_85,r_138_28_113,0.54,0,113,113,56
25,r_36_146_79,seq35,seq140,r_36_146_79,1.0,0,79,79,56
33,r_57_111_161,seq53,r_106_110_2,r_106_110_2,0.68,159,161,2,56
50,seq0,r_1_64_89,r_9_23_59,r_1_64_89,0.99,0,89,89,56
42,r_72_67_10,r_76_56_149,seq68,r_72_67_10,0.93,1,11,10,56
59,seq149,r_147_128_32,r_144_17_189,r_147_128_32,0.78,1,33,32,56
38,r_101_116_80,r_100_27_85,seq117,r_101_116_80,0.95,0,80,80,56
52,seq4,r_5_82_177,seq7,r_5_82_177,0.97,0,177,177,56
34,r_29_97_129,r_24_30_3,seq98,r_29_97_129,0.81,0,129,129,56
47,r_147_128_32,seq149,seq126,r_147_128_32,0.97,0,32,32,56
35,r_79_86_180,r_20_83_78,r_5_82_177,r_5_82_177,0.95,3,180,177,56
7,r_125_134_136,r_122_137_97,r_19_123_11,r_19_123_11,0.87,1,12,11,56
9,r_96_89_100,r_95_49_164,seq91,r_96_89_100,0.7,0,100,100,56
13,r_122_137_97,r_135_65_137,r_10_136_113,r_122_137_97,0.9,21,118,97,56
96,seq117,seq119,r_101_116_80,r_101_116_80,1.0,9,89,80,56
12,r_9_23_59,r_8_105_180,r_127_25_1,r_8_105_180,0.88,-121,59,180,56
28,r_19_123_11,r_122_137_97,r_104_124_99,r_19_123_11,0.99,88,99,11,56
22,r_80_142_138,r_79_86_180,r_36_146_79,r_79_86_180,0.65,-42,138,180,56
91,seq98,r_99_33_174,r_29_97_129,r_29_97_129,0.69,45,174,129,56
4,r_59_131_35,r_55_93_58,r_3_132_8,r_59_131_35,0.94,0,35,35,56
0,r_16_130_116,r_6_21_70,seq133,r_16_130_116,1.0,2,118,116,56
49,r_145_37_121,r_144_17_189,seq35,r_145_37_121,0.89,1,122,121,56
44,r_46_102_148,seq47,r_139_109_22,r_46_102_148,0.94,0,148,148,56
23,r_10_136_113,seq11,r_122_137_97,r_10_136_113,0.61,0,113,113,56
20,r_55_93_58,seq53,seq92,r_55_93_58,1.0,0,58,58,56
82,seq73,r_76_56_149,seq77,r_76_56_149,0.89,-19,130,149,56
19,r_69_75_30,seq70,seq73,r_69_75_30,0.96,2,32,30,56
35,r_79_86_180,r_80_142_138,r_20_83_78,r_79_86_180,0.85,-42,138,180,56
55,seq11,r_9_23_59,r_43_12_189,r_43_12_189,0.56,4,193,189,56
36,r_64_42_68,r_60_123_150,r_58_47_25,r_64_42_68,0.55,0,68,68,57
8,r_22_109_86,r_20_103_115,seq121,r_22_109_86,0.96,0,86,86,57
43,r_87_8_174,seq86,r_80_11_1,r_87_8_174,0.48,0,174,174,57
34,r_107_9_45,seq105,r_80_11_1,r_107_9_45,1.0,0,45,45,57
59,seq143,seq148,r_120_144_143,r_120_144_143,0.59,5,148,143,57
30,r_63_39_53,r_60_123_150,seq34,r_63_39_53,1.0,0,53,53,57
86,seq141,seq138,r_0_142_59,r_0_142_59,1.0,1,60,59,57
21,r_19_37_82,r_20_103_115,seq36,r_20_103_115,0.59,-33,82,115,57
39,r_51_135_163,seq50,r_113_137_11,r_113_137_11,0.96,152,163,11,57
22,r_93_81_175,seq97,r_43_82_167,r_93_81_175,0.64,-1,174,175,57
1,r_38_146_66,seq34,seq148,r_38_146_66,1.0,0,66,66,57
25,r_77_31_16,r_75_49_105,seq32,r_77_31_16,1.0,0,16,16,57
46,r_120_144_143,seq121,r_132_119_59,r_132_119_59,1.0,10,69,59,57
42,r_3_118_61,seq1,r_132_119_59,r_3_118_61,1.0,0,61,61,57
45,r_102_61_99,seq104,seq62,r_102_61_99,0.99,0,99,99,57
19,r_16_98_185,seq13,r_100_99_118,r_100_99_118,0.89,64,182,118,57
30,r_63_39_53,seq34,r_94_40_90,r_94_40_90,1.0,14,104,90,57
15,r_18_91_105,r_90_106_179,r_29_89_139,r_18_91_105,0.6,74,179,105,57
5,r_7_68_29,r_16_98_185,r_124_69_3,r_7_68_29,0.99,0,29,29,57
7,r_0_142_59,seq1,seq141,r_0_142_59,0.99,0,59,59,57
26,r_113_137_11,r_112_12_75,seq136,r_113_137_11,0.55,0,11,11,57
67,seq30,r_29_89_139,r_54_5_13,r_54_5_13,0.52,63,76,13,57
10,r_56_145_167,seq57,r_120_144_143,r_56_145_167,0.6,0,167,167,57
90,seq101,r_102_61_99,seq104,r_102_61_99,0.88,-23,76,99,57
4,r_94_40_90,r_93_81_175,r_63_39_53,r_93_81_175,0.66,-85,90,175,57
29,r_90_106_179,r_92_53_53,r_93_81_175,r_92_53_53,0.94,0,53,53,57
54,seq6,seq4,r_54_5_13,r_54_5_13,1.0,0,13,13,57
78,seq57,r_55_88_98,r_14_72_13,r_14_72_13,0.56,86,99,13,57
73,seq36,seq34,r_19_37_82,r_19_37_82,0.87,34,116,82,57
11,r_43_82_167,seq48,r_139_85_139,r_139_85_139,0.99,29,168,139,57
20,r_133_117_99,seq134,r_65_116_22,r_65_116_22,0.61,76,98,22,57
13,r_20_103_115,seq21,seq104,r_20_103_115,0.98,0,115,115,57
46,r_120_144_143,r_132_119_59,seq143,r_120_144_143,0.9,1,144,143,57
15,r_18_91_105,seq17,r_90_106_179,r_18_91_105,1.0,0,105,105,57
2,r_41_15_48,seq34,seq13,r_41_15_48,0.89,-8,40,48,57
91,seq104,seq101,r_20_103_115,r_20_103_115,0.84,1,116,115,57
6,r_132_119_59,r_133_117_99,r_3_118_61,r_3_118_61,1.0,2,63,61,57
3,r_125_52_11,seq121,r_56_145_167,r_56_145_167,0.55,-155,12,167,57
27,r_55_88_98,r_56_145_167,seq86,r_55_88_98,0.88,1,99,98,57
44,r_29_89_139,r_54_5_13,r_18_91_105,r_29_89_139,0.82,-2,137,139,57
87,seq86,r_87_8_174,r_139_85_139,r_139_85_139,0.97,24,163,139,57
37,r_92_53_53,r_90_106_179,r_125_52_11,r_92_53_53,0.94,0,53,53,57
40,r_44_74_25,r_43_82_167,seq73,r_44_74_25,0.8,1,26,25,57
71,seq34,r_41_15_48,seq35,r_41_15_48,0.54,-28,20,48,57
74,seq134,r_133_117_99,r_25_131_63,r_25_131_63,1.0,36,99,63,57
18,r_110_79_177,seq121,r_125_52_11,r_125_52_11,0.73,163,174,11,57
47,r_129_26_10,r_54_5_13,seq24,r_54_5_13,0.51,136,149,13,57
47,r_129_26_10,seq128,r_25_131_63,r_129_26_10,0.93,1,11,10,57
33,r_114_67_101,seq115,seq66,r_114_67_101,0.92,0,101,101,57
92,seq105,r_65_116_22,r_90_106_179,r_65_116_22,0.34,160,182,22,57
24,r_58_47_25,r_60_123_150,seq48,r_58_47_25,0.94,1,26,25,57
35,r_14_72_13,r_41_15_48,seq73,r_14_72_13,1.0,0,13,13,57
0,r_83_147_52,r_87_8_174,seq148,r_83_147_52,1.0,0,52,52,57
3,r_125_52_11,r_56_145_167,r_92_53_53,r_125_52_11,0.94,48,59,11,57
17,r_112_12_75,r_114_67_101,seq13,r_112_12_75,1.0,0,75,75,57
9,r_25_131_63,r_16_98_185,seq134,r_25_131_63,1.0,0,63,63,57
29,r_90_106_179,r_93_81_175,r_18_91_105,r_18_91_105,0.98,18,123,105,57
22,r_93_81_175,r_94_40_90,r_90_106_179,r_94_40_90,0.99,0,90,90,57
47,r_129_26_10,r_25_131_63,r_54_5_13,r_25_131_63,0.92,0,63,63,57
44,r_29_89_139,seq30,r_54_5_13,r_54_5_13,0.63,72,85,13,57
29,r_90_106_179,r_18_91_105,seq105,r_90_106_179,0.62,0,179,179,57
23,r_139_85_139,seq140,seq86,r_139_85_139,0.77,0,139,139,57
12,r_60_123_150,r_59_46_192,seq121,r_60_123_150,0.78,0,150,150,57
22,r_93_81_175,r_90_106_179,seq97,r_93_81_175,0.43,-52,123,175,57
14,r_22_100_115,seq21,seq101,r_22_100_115,0.99,0,115,115,58
8,r_62_11_164,seq64,seq10,r_62_11_164,0.49,2,166,164,58
43,r_38_27_96,seq37,r_136_31_23,r_136_31_23,0.61,73,96,23,58
0,r_119_35_90,r_117_43_39,r_12_118_24,r_119_35_90,0.93,-63,27,90,58
37,r_76_92_132,seq81,seq93,r_76_92_132,0.51,-2,130,132,58
59,seq14,r_13_106_89,r_84_16_6,r_13_106_89,1.0,0,89,89,58
30,r_72_112_53,seq74,seq111,r_72_112_53,0.97,0,53,53,58
86,seq99,r_98_121_164,r_1_90_130,r_1_90_130,0.99,33,163,130,58
21,r_129_39_154,seq130,r_119_35_90,r_129_39_154,0.66,0,154,154,58
39,r_23_26_188,seq21,r_119_35_90,r_119_35_90,1.0,93,183,90,58
1,r_4_70_135,seq2,seq68,r_4_70_135,0.92,0,135,135,58
97,seq123,r_122_50_156,seq120,r_122_50_156,0.89,0,156,156,58
5,r_133_126_84,r_132_96_189,seq124,r_133_126_84,1.0,0,84,84,58
46,r_9_73_82,seq10,seq74,r_9_73_82,1.0,0,82,82,58
44,r_136_31_23,r_140_78_109,seq32,r_136_31_23,1.0,0,23,23,58
80,seq80,r_76_92_132,r_140_78_109,r_140_78_109,1.0,4,113,109,58
45,r_97_36_140,r_98_121_164,seq37,r_97_36_140,0.84,0,140,140,58
19,r_29_145_166,seq30,seq144,r_29_145_166,0.62,0,166,166,58
7,r_125_146_54,seq124,seq144,r_125_146_54,0.99,0,54,54,58
76,seq68,r_67_127_169,r_4_70_135,r_4_70_135,0.6,34,169,135,58
31,r_45_143_180,seq40,r_29_145_166,r_45_143_180,0.5,1,181,180,58
20,r_71_138_33,r_67_127_169,r_53_139_6,r_71_138_33,0.98,0,33,33,58
41,r_66_63_127,r_67_127_169,seq64,r_66_63_127,1.0,0,127,127,58
26,r_55_5_49,r_54_86_85,seq2,r_55_5_49,1.0,0,49,49,58
3,r_140_78_109,seq141,seq80,r_140_78_109,1.0,0,109,109,58
10,r_79_85_65,seq81,r_54_86_85,r_54_86_85,1.0,45,130,85,58
90,seq107,seq105,r_13_106_89,r_13_106_89,1.0,13,102,89,58
40,r_28_51_28,r_29_145_166,seq52,r_29_145_166,0.84,-138,28,166,58
4,r_1_90_130,r_4_70_135,seq89,r_1_90_130,0.63,0,130,130,58
11,r_132_96_189,seq137,r_1_90_130,r_132_96_189,0.29,1,190,189,58
13,r_44_3_78,r_45_143_180,r_55_5_49,r_45_143_180,1.0,-101,79,180,58
15,r_67_127_169,r_66_63_127,seq65,r_66_63_127,0.96,0,127,127,58
48,r_25_33_140,r_23_26_188,r_136_31_23,r_136_31_23,0.99,97,120,23,58
49,r_34_102_13,seq101,r_77_104_75,r_34_102_13,0.45,93,106,13,58
57,seq10,r_9_73_82,r_57_8_80,r_9_73_82,0.91,0,82,82,58
6,r_69_91_146,r_67_127_169,r_76_92_132,r_69_91_146,0.79,0,146,146,58
62,seq21,r_23_26_188,r_24_56_69,r_24_56_69,0.62,90,159,69,58
2,r_12_118_24,r_119_35_90,seq123,r_119_35_90,0.99,0,90,90,58
99,seq149,r_148_94_150,seq144,r_148_94_150,0.95,0,150,150,58
0,r_119_35_90,r_12_118_24,r_136_31_23,r_119_35_90,1.0,0,90,90,58
27,r_113_87_110,seq111,r_17_88_14,r_17_88_14,0.76,95,109,14,58
87,seq101,seq93,r_22_100_115,r_22_100_115,1.0,0,115,115,58
49,r_34_102_13,r_38_27_96,seq101,r_34_102_13,1.0,0,13,13,58
47,r_148_94_150,seq149,r_76_92_132,r_148_94_150,0.81,0,150,150,58
16,r_20_47_31,r_22_100_115,seq46,r_22_100_115,0.99,-70,45,115,58
74,seq64,r_62_11_164,r_66_63_127,r_66_63_127,0.98,39,166,127,58
29,r_57_8_80,r_54_86_85,seq10,r_54_86_85,0.77,-4,81,85,58
24,r_98_121_164,seq99,seq120,r_98_121_164,0.33,0,164,164,58
25,r_77_104_75,seq80,seq103,r_77_104_75,0.76,0,75,75,58
2,r_12_118_24,r_13_106_89,r_119_35_90,r_12_118_24,1.0,0,24,24,58
33,r_122_50_156,seq123,r_24_56_69,r_122_50_156,0.84,0,156,156,58
70,seq52,r_54_86_85,r_28_51_28,r_54_86_85,1.0,0,85,85,58
65,seq37,r_38_27_96,r_97_36_140,r_97_36_140,0.87,12,152,140,58
32,r_13_106_89,seq14,seq107,r_13_106_89,1.0,0,89,89,58
38,r_18_116_96,seq14,seq115,r_18_116_96,1.0,0,96,96,58
68,seq48,r_24_56_69,seq49,r_24_56_69,0.95,-45,24,69,58
17,r_7_41_138,seq10,seq40,r_7_41_138,0.55,0,138,138,58
9,r_60_134_189,seq59,seq135,r_60_134_189,0.25,0,189,189,58
22,r_54_86_85,seq52,r_79_85_65,r_54_86_85,1.0,0,85,85,58
28,r_142_15_104,r_148_94_150,r_84_16_6,r_142_15_104,0.95,0,104,104,58
35,r_108_42_106,seq110,r_117_43_39,r_108_42_106,0.71,0,106,106,58
12,r_24_56_69,r_22_100_115,r_28_51_28,r_22_100_115,0.94,-47,68,115,58
15,r_67_127_169,seq65,r_133_126_84,r_67_127_169,0.8,0,169,169,58
93,seq112,r_113_15_131,r_85_110_107,r_85_110_107,0.68,24,131,107,59
30,r_90_98_97,r_92_0_127,seq99,r_90_98_97,0.96,0,97,97,59
9,r_87_141_22,r_140_11_168,r_55_134_149,r_55_134_149,0.86,20,169,149,59
26,r_136_29_144,r_133_6_132,r_87_141_22,r_87_141_22,0.99,23,45,22,59
92,seq105,r_106_72_181,r_16_104_65,r_16_104_65,1.0,116,181,65,59
14,r_27_30_82,r_28_79_108,r_36_35_158,r_28_79_108,0.99,1,109,108,59
8,r_89_135_159,seq94,r_87_141_22,r_89_135_159,0.71,0,159,159,59
43,r_120_66_103,seq119,seq67,r_120_66_103,0.93,0,103,103,59
23,r_1_33_44,r_3_78_71,seq34,r_3_78_71,0.89,-48,23,71,59
54,seq139,r_140_11_168,r_87_141_22,r_87_141_22,0.82,147,169,22,59
44,r_10_91_47,r_3_78_71,seq94,r_10_91_47,1.0,0,47,47,59
15,r_20_125_44,r_19_59_136,seq122,r_20_125_44,1.0,0,44,44,59
19,r_132_86_20,r_85_110_107,seq83,r_85_110_107,1.0,0,107,107,59
16,r_26_4_74,r_27_30_82,seq7,r_26_4_74,0.91,-7,67,74,59
21,r_55_134_149,r_57_88_187,r_87_141_22,r_55_134_149,0.87,0,149,149,59
39,r_3_78_71,seq2,seq80,r_3_78_71,0.99,0,71,71,59
1,r_19_59_136,seq24,seq61,r_19_59_136,0.79,3,139,136,59
97,seq119,r_120_66_103,seq122,r_120_66_103,1.0,0,103,103,59
80,seq67,r_68_146_165,r_120_66_103,r_120_66_103,0.77,-3,100,103,59
46,r_93_53_92,r_92_0_127,seq54,r_93_53_92,0.53,0,92,92,59
99,seq126,seq129,r_64_127_71,r_64_127_71,0.54,9,80,71,59
3,r_18_75_34,seq17,seq76,r_18_75_34,1.0,0,34,34,59
45,r_68_146_165,r_81_74_146,r_117_82_129,r_117_82_129,0.78,8,137,129,59
19,r_132_86_20,r_140_11_168,r_85_110_107,r_132_86_20,0.82,-1,19,20,59
76,seq54,seq46,r_93_53_92,r_93_53_92,1.0,0,92,92,59
35,r_140_11_168,seq147,r_87_141_22,r_87_141_22,0.98,0,22,22,59
1,r_19_59_136,r_3_78_71,seq24,r_3_78_71,1.0,-24,47,71,59
45,r_68_146_165,r_117_82_129,seq147,r_68_146_165,0.98,0,165,165,59
41,r_128_97_42,seq129,r_103_8_179,r_128_97_42,0.99,0,42,42,59
31,r_37_138_188,seq40,seq137,r_37_138_188,0.27,0,188,188,59
89,seq99,r_106_72_181,r_90_98_97,r_90_98_97,0.99,4,101,97,59
10,r_123_108_123,seq122,r_60_109_50,r_123_108_123,0.83,0,123,123,59
4,r_56_23_100,r_57_88_187,seq24,r_56_23_100,0.91,0,100,100,59
78,seq61,r_57_88_187,r_19_59_136,r_19_59_136,0.65,1,137,136,59
0,r_103_8_179,r_106_72_181,r_56_23_100,r_56_23_100,0.78,78,178,100,59
11,r_58_131_102,r_57_88_187,r_87_141_22,r_58_131_102,0.97,0,102,102,59
12,r_60_109_50,seq61,r_106_72_181,r_60_109_50,1.0,0,50,50,59
12,r_60_109_50,r_106_72_181,r_123_108_123,r_123_108_123,1.0,26,149,123,59
85,seq80,r_68_146_165,r_3_78_71,r_3_78_71,0.95,18,89,71,59
63,seq21,r_3_78_71,seq24,r_3_78_71,1.0,-24,47,71,59
6,r_65_41_30,r_64_127_71,seq40,r_65_41_30,0.99,0,30,30,59
27,r_22_44_79,seq24,seq46,r_22_44_79,0.67,0,79,79,59
2,r_133_6_132,r_136_29_144,r_62_5_13,r_62_5_13,0.78,119,132,13,59
47,r_28_79_108,r_27_30_82,r_3_78_71,r_27_30_82,0.99,27,109,82,59
40,r_145_25_138,seq147,seq24,r_145_25_138,0.74,0,138,138,59
79,seq63,r_81_74_146,r_93_53_92,r_81_74_146,0.46,0,146,146,59
18,r_117_82_129,seq116,r_3_78_71,r_117_82_129,0.96,1,130,129,59
29,r_100_51_126,r_106_72_181,seq52,r_100_51_126,0.93,0,126,126,59
64,seq24,r_22_44_79,r_19_59_136,r_22_44_79,0.71,-28,51,79,59
25,r_16_104_65,seq17,seq105,r_16_104_65,1.0,0,65,65,59
34,r_71_96_51,seq73,r_89_135_159,r_71_96_51,0.98,0,51,51,59
33,r_81_74_146,r_68_146_165,r_18_75_34,r_81_74_146,0.87,1,147,146,59
20,r_85_110_107,r_87_141_22,r_132_86_20,r_85_110_107,0.79,-88,19,107,59
50,seq129,r_136_29_144,seq143,r_136_29_144,0.86,-57,87,144,59
34,r_71_96_51,r_89_135_159,r_128_97_42,r_71_96_51,0.43,33,84,51,59
80,seq67,r_65_41_30,r_68_146_165,r_65_41_30,0.62,-13,17,30,59
20,r_85_110_107,r_132_86_20,seq112,r_85_110_107,1.0,0,107,107,59
32,r_107_48_129,r_106_72_181,seq52,r_107_48_129,0.79,2,131,129,59
64,seq24,r_19_59_136,r_145_25_138,r_145_25_138,0.6,0,138,138,59
24,r_64_127_71,r_65_41_30,r_68_146_165,r_65_41_30,0.85,3,33,30,59
17,r_113_15_131,seq112,seq17,r_113_15_131,0.94,1,132,131,59
26,r_136_29_144,r_87_141_22,r_27_30_82,r_136_29_144,0.99,0,144,144,59
50,seq129,seq143,r_45_130_130,r_45_130_130,0.64,33,163,130,59
9,r_87_141_22,r_85_110_107,r_140_11_168,r_87_141_22,0.97,0,22,22,59
41,r_128_97_42,r_103_8_179,seq99,r_128_97_42,0.71,48,90,42,59
28,r_57_88_187,seq61,r_10_91_47,r_57_88_187,0.59,0,187,187,59
22,r_92_0_127,seq94,r_26_4_74,r_92_0_127,0.91,0,127,127,59
88,seq94,r_92_0_127,r_10_91_47,r_10_91_47,1.0,-1,46,47,59
28,r_57_88_187,r_56_23_100,seq61,r_56_23_100,0.71,-32,68,100,59
49,r_95_142_109,r_92_0_127,seq143,r_95_142_109,0.99,1,110,109,59
7,r_77_31_125,seq76,r_27_30_82,r_77_31_125,0.93,0,125,125,59
60,seq17,r_18_75_34,seq14,r_18_75_34,1.0,-2,32,34,59
24,r_64_127_71,r_68_146_165,seq126,r_64_127_71,0.97,1,72,71,59
60,seq17,seq14,r_113_15_131,r_113_15_131,0.99,29,160,131,59
36,r_62_5_13,seq63,seq7,r_62_5_13,0.98,0,13,13,59
44,r_14_77_178,r_143_13_13,r_114_74_175,r_143_13_13,0.48,165,178,13,60
42,r_133_140_42,r_98_141_59,r_109_139_87,r_109_139_87,1.0,0,87,87,60
9,r_114_74_175,seq112,r_129_75_45,r_114_74_175,0.51,0,175,175,60
92,seq99,seq106,r_82_100_79,r_82_100_79,1.0,0,79,79,60
44,r_14_77_178,r_19_51_139,r_143_13_13,r_143_13_13,1.0,0,13,13,60
14,r_120_125_132,r_121_48_68,r_81_124_39,r_120_125_132,0.87,-64,68,132,60
37,r_130_2_79,seq131,seq1,r_130_2_79,1.0,0,79,79,60
26,r_116_123_55,r_115_119_64,r_81_124_39,r_81_124_39,1.0,19,58,39,60
16,r_138_24_139,seq137,seq25,r_138_24_139,0.92,1,140,139,60
21,r_108_64_167,seq106,r_105_62_48,r_105_62_48,1.0,119,167,48,60
42,r_133_140_42,seq135,r_98_141_59,r_98_141_59,0.98,5,64,59,60
8,r_103_15_24,r_104_52_165,r_143_13_13,r_103_15_24,0.78,0,24,24,60
45,r_26_0_136,r_27_16_165,r_130_2_79,r_130_2_79,1.0,54,133,79,60
19,r_57_111_120,seq56,r_40_113_76,r_57_111_120,0.98,0,120,120,60
66,seq25,r_27_16_165,r_138_24_139,r_138_24_139,0.85,12,151,139,60
1,r_65_83_35,r_63_127_165,r_46_86_24,r_65_83_35,1.0,0,35,35,60
94,seq106,r_105_62_48,r_108_64_167,r_105_62_48,1.0,1,49,48,60
67,seq29,r_27_16_165,r_118_28_52,r_118_28_52,1.0,113,165,52,60
10,r_143_13_13,r_146_35_100,r_14_77_178,r_14_77_178,0.85,-165,13,178,60
3,r_27_16_165,seq29,r_73_18_30,r_73_18_30,1.0,135,165,30,60
73,seq43,r_42_22_50,r_72_41_26,r_72_41_26,1.0,0,26,26,60
24,r_118_28_52,seq117,seq29,r_118_28_52,1.0,0,52,52,60
90,seq95,r_96_79_87,r_87_70_167,r_96_79_87,0.68,0,87,87,60
4,r_33_23_164,seq32,r_42_22_50,r_33_23_164,0.43,0,164,164,60
0,r_19_51_139,seq20,seq50,r_19_51_139,1.0,3,142,139,60
11,r_128_102_61,seq131,seq106,r_128_102_61,0.99,1,62,61,60
20,r_121_48_68,r_120_125_132,r_63_127_165,r_121_48_68,0.53,0,68,68,60
30,r_72_41_26,r_71_47_102,seq43,r_72_41_26,0.77,0,26,26,60
15,r_40_113_76,seq43,seq112,r_40_113_76,1.0,0,76,76,60
48,r_88_36_164,r_87_70_167,seq37,r_88_36_164,0.66,0,164,164,60
6,r_44_49_199,seq43,r_71_47_102,r_71_47_102,1.0,47,149,102,60
62,seq131,r_130_2_79,r_115_119_64,r_130_2_79,0.93,0,79,79,60
10,r_143_13_13,r_14_77_178,r_103_15_24,r_143_13_13,0.81,165,178,13,60
27,r_67_59_63,seq66,seq56,r_67_59_63,0.89,0,63,63,60
61,seq17,r_19_51_139,r_73_18_30,r_73_18_30,0.85,5,35,30,60
2,r_8_122_66,seq10,r_115_119_64,r_8_122_66,0.99,0,66,66,60
18,r_109_139_87,r_110_58_127,r_133_140_42,r_109_139_87,0.98,0,87,87,60
29,r_4_31_144,seq5,r_146_35_100,r_146_35_100,1.0,51,151,100,60
13,r_42_22_50,r_40_113_76,seq21,r_40_113_76,0.99,-26,50,76,60
47,r_90_61_43,r_63_127_165,r_105_62_48,r_63_127_165,0.88,-35,130,165,60
5,r_82_100_79,r_65_83_35,seq99,r_82_100_79,1.0,-1,78,79,60
39,r_73_18_30,r_71_47_102,seq17,r_73_18_30,0.96,0,30,30,60
38,r_96_79_87,seq95,seq80,r_96_79_87,0.6,0,87,87,60
34,r_132_107_149,seq135,r_128_102_61,r_132_107_149,0.59,0,149,149,60
64,seq21,r_19_51_139,r_42_22_50,r_19_51_139,0.63,-87,52,139,60
85,seq85,r_87_70_167,r_46_86_24,r_46_86_24,1.0,0,24,24,60
32,r_60_12_48,r_76_7_191,r_103_15_24,r_60_12_48,0.99,0,48,48,60
17,r_63_127_165,seq66,r_105_62_48,r_105_62_48,0.99,45,93,48,60
41,r_46_86_24,r_44_49_199,seq85,r_46_86_24,0.99,0,24,24,60
9,r_114_74_175,r_115_119_64,seq112,r_115_119_64,1.0,1,65,64,60
59,seq142,r_138_24_139,r_133_140_42,r_138_24_139,0.86,-104,35,139,60
12,r_129_75_45,r_128_102_61,seq78,r_129_75_45,0.91,0,45,45,60
22,r_146_35_100,r_148_39_162,seq30,r_146_35_100,0.94,0,100,100,60
84,seq80,r_65_83_35,r_96_79_87,r_96_79_87,0.65,0,87,87,60
28,r_104_52_165,seq106,seq53,r_104_52_165,0.54,0,165,165,60
40,r_98_141_59,seq97,r_133_140_42,r_98_141_59,0.99,0,59,59,60
84,seq80,seq92,r_65_83_35,r_65_83_35,1.0,8,43,35,60
49,r_115_119_64,r_114_74_175,r_8_122_66,r_115_119_64,0.68,1,65,64,60
33,r_105_62_48,seq106,r_90_61_43,r_105_62_48,1.0,1,49,48,60
43,r_81_124_39,r_82_100_79,r_120_125_132,r_81_124_39,0.98,0,39,39,60
23,r_110_58_127,seq112,seq56,r_110_58_127,0.69,0,127,127,60
94,seq106,r_108_64_167,r_128_102_61,r_108_64_167,0.74,0,167,167,60
17,r_63_127_165,r_105_62_48,seq126,r_63_127_165,0.47,0,165,165,60
47,r_90_61_43,seq91,r_63_127_165,r_90_61_43,0.99,0,43,43,60
5,r_82_100_79,r_81_124_39,r_65_83_35,r_82_100_79,0.95,-40,39,79,60
93,seq114,r_113_89_158,r_149_115_70,r_149_115_70,0.66,30,100,70,61
36,r_149_115_70,r_146_44_149,seq114,r_149_115_70,0.99,0,70,70,61
14,r_48_71_103,r_49_112_113,seq70,r_49_112_113,0.87,-10,103,113,61
8,r_27_69_144,seq30,r_32_61_19,r_27_69_144,0.61,0,144,144,61
43,r_76_142_60,seq75,seq141,r_76_142_60,1.0,1,61,60,61
37,r_66_97_108,r_63_134_198,seq98,r_66_97_108,0.99,0,108,108,61
59,seq141,r_149_115_70,r_76_142_60,r_76_142_60,0.98,4,64,60,61
86,seq98,seq100,r_66_97_108,r_66_97_108,1.0,12,120,108,61
16,r_56_51_81,seq72,r_60_52_12,r_56_51_81,0.78,0,81,81,61
21,r_20_2_78,seq23,r_85_1_158,r_20_2_78,0.98,0,78,78,61
5,r_10_12_41,seq11,seq4,r_10_12_41,0.52,85,126,41,61
46,r_126_26_125,seq125,r_34_28_13,r_126_26_125,1.0,0,125,125,61
80,seq84,r_85_1_158,r_118_83_6,r_85_1_158,0.81,1,159,158,61
60,seq14,r_81_19_8,r_104_16_55,r_104_16_55,1.0,6,61,55,61
31,r_74_57_150,r_95_73_104,r_27_69_144,r_74_57_150,0.6,2,152,150,61
39,r_138_47_41,r_49_112_113,r_60_52_12,r_49_112_113,1.0,0,113,113,61
31,r_74_57_150,seq72,r_95_73_104,r_95_73_104,0.97,15,119,104,61
41,r_33_67_118,r_35_37_174,seq68,r_33_67_118,0.89,0,118,118,61
10,r_41_144_149,r_40_133_186,r_25_148_125,r_41_144_149,0.61,0,149,149,61
30,r_32_61_19,r_35_37_174,seq65,r_32_61_19,0.66,0,19,19,61
15,r_95_73_104,r_63_134_198,seq72,r_63_134_198,0.59,-55,143,198,61
26,r_59_18_124,r_63_134_198,r_135_17_118,r_59_18_124,0.76,0,124,124,61
38,r_146_44_149,r_76_142_60,seq46,r_146_44_149,1.0,0,149,149,61
11,r_143_62_114,r_146_44_149,r_32_61_19,r_143_62_114,0.72,0,114,114,61
20,r_135_17_118,seq136,r_81_19_8,r_135_17_118,1.0,0,118,118,61
15,r_95_73_104,seq96,r_63_134_198,r_95_73_104,0.76,0,104,104,61
48,r_64_0_183,r_63_134_198,r_20_2_78,r_63_134_198,0.59,-15,183,198,61
45,r_7_131_56,seq9,seq132,r_7_131_56,1.0,0,56,56,61
6,r_113_89_158,seq114,r_90_91_82,r_113_89_158,0.69,0,158,158,61
3,r_60_52_12,r_58_45_37,seq50,r_60_52_12,0.48,0,12,12,61
27,r_79_13_194,seq78,r_10_12_41,r_10_12_41,1.0,153,194,41,61
7,r_49_112_113,r_138_47_41,seq109,r_49_112_113,0.99,0,113,113,61
39,r_138_47_41,r_135_17_118,r_49_112_113,r_138_47_41,1.0,0,41,41,61
24,r_40_133_186,r_145_39_14,r_76_142_60,r_40_133_186,0.99,0,186,186,61
2,r_25_148_125,seq23,r_76_142_60,r_25_148_125,0.9,0,125,125,61
74,seq70,r_63_134_198,r_48_71_103,r_48_71_103,0.98,49,152,103,61
18,r_24_108_145,seq23,seq106,r_24_108_145,0.6,0,145,145,61
29,r_93_42_123,seq96,seq46,r_93_42_123,0.83,0,123,123,61
24,r_40_133_186,r_41_144_149,r_145_39_14,r_40_133_186,0.69,-49,137,186,61
25,r_94_130_105,r_93_42_123,r_7_131_56,r_93_42_123,0.59,-18,105,123,61
58,seq140,seq132,r_76_142_60,r_76_142_60,1.0,106,166,60,61
19,r_145_39_14,r_143_62_114,seq38,r_145_39_14,0.58,0,14,14,61
65,seq36,seq38,r_35_37_174,r_35_37_174,0.67,-8,166,174,61
68,seq46,seq43,r_58_45_37,r_58_45_37,0.9,55,92,37,61
38,r_146_44_149,r_143_62_114,r_76_142_60,r_76_142_60,0.97,54,114,60,61
9,r_107_54_67,seq72,r_120_55_105,r_120_55_105,0.98,1,106,105,61
33,r_22_101_24,r_25_148_125,seq103,r_22_101_24,1.0,0,24,24,61
75,seq72,r_74_57_150,r_95_73_104,r_95_73_104,0.99,23,127,104,61
9,r_107_54_67,seq106,seq72,r_107_54_67,0.99,0,67,67,61
22,r_85_1_158,seq84,r_20_2_78,r_85_1_158,0.64,1,159,158,61
28,r_139_15_98,r_135_17_118,r_104_16_55,r_139_15_98,0.52,0,98,98,61
49,r_137_124_60,r_135_17_118,seq125,r_137_124_60,0.57,0,60,60,61
7,r_49_112_113,r_48_71_103,r_138_47_41,r_138_47_41,1.0,35,76,41,61
44,r_82_29_127,seq84,r_34_28_13,r_34_28_13,0.66,115,128,13,61
23,r_111_21_114,seq109,seq23,r_111_21_114,1.0,0,114,114,61
35,r_110_122_83,seq109,seq125,r_110_122_83,0.97,0,83,83,61
66,seq38,seq36,r_145_39_14,r_145_39_14,1.0,6,20,14,61
12,r_123_102_81,r_126_26_125,seq103,r_123_102_81,0.97,0,81,81,61
4,r_58_45_37,r_59_18_124,seq46,r_58_45_37,0.77,0,37,37,61
30,r_116_71_99,seq117,seq77,r_116_71_99,1.0,1,100,99,62
51,seq1,r_0_19_174,r_40_5_70,r_40_5_70,1.0,108,178,70,62
36,r_10_20_153,r_8_93_189,r_132_18_9,r_10_20_153,0.67,0,153,153,62
8,r_149_39_100,r_147_97_185,r_124_41_9,r_149_39_100,1.0,0,100,100,62
53,seq6,r_14_33_151,r_8_93_189,r_14_33_151,0.45,0,151,151,62
43,r_95_3_108,seq94,r_40_5_70,r_95_3_108,0.99,0,108,108,62
37,r_134_36_89,r_109_133_1,r_124_41_9,r_134_36_89,1.0,-1,88,89,62
55,seq12,r_14_33_151,seq6,r_14_33_151,0.37,0,151,151,62
71,seq57,seq59,r_84_56_81,r_84_56_81,1.0,19,100,81,62
86,seq94,r_95_3_108,r_92_96_97,r_95_3_108,0.99,-13,95,108,62
16,r_135_118_104,r_109_133_1,seq117,r_135_118_104,0.98,0,104,104,62
21,r_24_74_102,seq25,r_70_73_115,r_24_74_102,0.99,0,102,102,62
39,r_13_146_139,r_14_33_151,r_99_142_126,r_13_146_139,0.45,0,139,139,62
28,r_144_106_51,r_149_39_100,r_115_105_15,r_144_106_51,1.0,0,51,51,62
5,r_42_22_63,r_40_5_70,r_4_21_49,r_42_22_63,1.0,0,63,63,62
42,r_15_138_126,r_14_33_151,r_99_142_126,r_15_138_126,0.78,0,126,126,62
23,r_122_130_147,seq119,seq128,r_122_130_147,0.98,0,147,147,62
19,r_8_93_189,r_10_20_153,seq6,r_10_20_153,0.62,1,154,153,62
10,r_127_58_46,r_136_7_182,seq59,r_127_58_46,1.0,0,46,46,62
76,seq64,seq63,r_38_65_123,r_38_65_123,0.99,11,134,123,62
31,r_123_85_103,r_122_130_147,seq83,r_123_85_103,1.0,1,104,103,62
41,r_14_33_151,r_15_138_126,seq12,r_15_138_126,0.82,0,126,126,62
38,r_40_5_70,seq2,r_95_3_108,r_95_3_108,1.0,2,110,108,62
26,r_76_108_182,r_75_87_80,seq81,r_75_87_80,0.59,-19,61,80,62
14,r_124_41_9,r_38_65_123,r_149_39_100,r_124_41_9,0.79,102,111,9,62
11,r_0_19_174,seq1,r_132_18_9,r_0_19_174,0.5,0,174,174,62
20,r_75_87_80,r_76_108_182,seq90,r_75_87_80,0.92,0,80,80,62
91,seq107,seq102,r_115_105_15,r_115_105_15,1.0,0,15,15,62
15,r_32_145_112,seq35,seq143,r_32_145_112,0.81,0,112,112,62
49,r_38_65_123,r_124_41_9,seq64,r_38_65_123,1.0,0,123,123,62
38,r_40_5_70,r_124_41_9,seq2,r_40_5_70,1.0,0,70,70,62
6,r_99_142_126,seq100,r_32_145_112,r_99_142_126,0.97,0,126,126,62
45,r_78_62_48,r_79_139_155,seq67,r_78_62_48,0.86,0,48,48,62
38,r_40_5_70,r_37_26_68,r_124_41_9,r_124_41_9,0.84,10,19,9,62
2,r_37_26_68,r_38_65_123,seq25,r_37_26_68,0.75,0,68,68,62
47,r_49_9_177,seq48,r_8_93_189,r_49_9_177,0.5,0,177,177,62
19,r_8_93_189,r_49_9_177,r_92_96_97,r_8_93_189,0.76,0,189,189,62
40,r_30_89_102,r_31_11_178,r_75_87_80,r_30_89_102,1.0,0,102,102,62
29,r_137_68_160,r_147_97_185,seq63,r_137_68_160,0.73,0,160,160,62
25,r_147_97_185,seq143,r_104_101_5,r_147_97_185,0.35,0,185,185,62
33,r_84_56_81,seq83,seq57,r_84_56_81,1.0,0,81,81,62
19,r_8_93_189,seq6,r_49_9_177,r_8_93_189,0.67,-13,176,189,62
58,seq23,r_17_112_187,r_42_22_63,r_42_22_63,1.0,13,76,63,62
0,r_114_16_20,seq111,r_17_112_187,r_114_16_20,1.0,-1,19,20,62
61,seq35,r_32_145_112,r_31_11_178,r_32_145_112,1.0,-32,80,112,62
32,r_69_51_172,seq67,r_29_50_162,r_69_51_172,0.72,0,172,172,62
52,seq2,r_0_19_174,r_95_3_108,r_95_3_108,0.89,51,159,108,62
34,r_79_139_155,seq77,r_99_142_126,r_79_139_155,0.69,0,155,155,62
48,r_4_21_49,seq2,seq23,r_4_21_49,1.0,0,49,49,62
60,seq27,r_29_50_162,r_140_28_145,r_140_28_145,1.0,17,162,145,62
41,r_14_33_151,seq12,seq35,r_14_33_151,0.86,0,151,151,62
13,r_34_131_44,r_32_145_112,r_109_133_1,r_34_131_44,0.87,0,44,44,62
49,r_38_65_123,r_37_26_68,r_124_41_9,r_38_65_123,0.78,-83,40,123,62
81,seq83,r_84_56_81,seq86,r_84_56_81,0.95,-2,79,81,62
17,r_148_113_117,r_147_97_185,seq110,r_148_113_117,0.91,0,117,117,62
94,seq117,r_116_71_99,r_122_130_147,r_116_71_99,0.97,-16,83,99,62
9,r_52_82_148,seq53,r_123_85_103,r_52_82_148,0.85,0,148,148,62
1,r_115_105_15,r_114_16_20,seq107,r_115_105_15,1.0,0,15,15,62
22,r_31_11_178,seq35,seq12,r_31_11_178,0.49,0,178,178,62
47,r_49_9_177,r_8_93_189,r_31_11_178,r_8_93_189,0.85,0,189,189,62
7,r_17_112_187,seq23,r_132_18_9,r_132_18_9,0.9,60,69,9,62
23,r_122_130_147,r_123_85_103,seq119,r_123_85_103,0.99,1,104,103,62
35,r_140_28_145,seq141,seq27,r_140_28_145,0.94,0,145,145,62
12,r_70_73_115,r_69_51_172,r_24_74_102,r_24_74_102,0.61,13,115,102,62
81,seq83,seq86,r_123_85_103,r_123_85_103,1.0,2,105,103,62
99,seq127,r_128_18_131,seq129,r_128_18_131,0.9,-89,42,131,63
40,r_34_147_16,r_145_102_78,r_45_146_51,r_145_102_78,0.6,0,78,78,63
30,r_8_103_135,r_9_5_103,r_52_97_107,r_8_103_135,0.75,0,135,135,63
18,r_32_118_20,seq33,r_117_90_189,r_32_118_20,1.0,0,20,20,63
8,r_57_47_70,r_53_111_194,r_59_49_13,r_57_47_70,0.66,0,70,70,63
43,r_44_142_97,seq41,seq143,r_44_142_97,0.99,0,97,97,63
58,seq12,seq10,r_20_15_153,r_20_15_153,0.81,4,157,153,63
83,seq93,r_94_21_156,r_24_91_20,r_94_21_156,0.5,0,156,156,63
71,seq41,r_44_142_97,seq40,r_44_142_97,1.0,0,97,97,63
86,seq105,seq101,r_8_103_135,r_8_103_135,0.95,18,153,135,63
16,r_2_122_63,seq0,seq121,r_2_122_63,1.0,0,63,63,63
1,r_128_18_131,seq127,seq28,r_128_18_131,0.94,0,131,131,63
46,r_131_115_185,seq129,r_71_114_184,r_71_114_184,0.66,1,185,184,63
42,r_14_51_98,seq12,seq55,r_14_51_98,1.0,0,98,98,63
21,r_145_102_78,r_34_147_16,seq105,r_145_102_78,1.0,0,78,78,63
6,r_25_98_15,seq101,r_79_99_50,r_79_99_50,0.97,9,59,50,63
31,r_16_92_29,r_14_51_98,r_24_91_20,r_16_92_29,0.97,0,29,29,63
19,r_22_38_143,r_20_15_153,r_149_36_17,r_22_38_143,0.96,0,143,143,63
14,r_11_66_33,seq12,seq68,r_11_66_33,1.0,0,33,33,63
41,r_86_112_83,r_88_87_130,seq110,r_86_112_83,0.98,1,84,83,63
26,r_96_56_11,seq95,seq55,r_96_56_11,0.93,0,11,11,63
67,seq33,r_22_38_143,seq31,r_22_38_143,0.86,-2,141,143,63
69,seq39,r_57_47_70,r_149_36_17,r_149_36_17,0.9,-5,12,17,63
10,r_59_49_13,r_48_148_153,r_57_47_70,r_48_148_153,0.52,0,153,153,63
48,r_132_30_55,seq134,seq29,r_132_30_55,1.0,0,55,55,63
40,r_34_147_16,seq33,r_145_102_78,r_34_147_16,0.98,1,17,16,63
28,r_117_90_189,r_116_37_41,r_32_118_20,r_117_90_189,0.84,-164,25,189,63
20,r_46_58_194,seq40,r_96_56_11,r_96_56_11,0.81,183,194,11,63
13,r_88_87_130,r_89_81_123,seq85,r_89_81_123,0.46,8,131,123,63
15,r_71_114_184,seq72,r_86_112_83,r_86_112_83,0.96,101,184,83,63
11,r_45_146_51,r_44_142_97,r_34_147_16,r_45_146_51,0.75,0,51,51,63
0,r_26_80_5,r_79_99_50,r_76_77_50,r_79_99_50,0.65,-25,25,50,63
62,seq19,r_20_15_153,r_104_23_61,r_104_23_61,1.0,92,153,61,63
85,seq101,seq105,r_84_100_107,r_84_100_107,1.0,57,164,107,63
37,r_54_137_40,r_53_111_194,seq138,r_54_137_40,1.0,0,40,40,63
27,r_104_23_61,seq105,seq19,r_104_23_61,1.0,0,61,61,63
60,seq143,r_34_147_16,r_44_142_97,r_44_142_97,0.76,2,99,97,63
74,seq138,seq141,r_54_137_40,r_54_137_40,1.0,33,73,40,63
24,r_13_3_111,seq12,seq0,r_13_3_111,0.56,14,125,111,63
21,r_145_102_78,seq141,r_34_147_16,r_34_147_16,0.91,10,26,16,63
33,r_106_1_174,seq110,r_13_3_111,r_106_1_174,0.66,0,174,174,63
34,r_42_139_14,r_57_47_70,seq141,r_42_139_14,0.99,0,14,14,63
65,seq29,seq28,r_132_30_55,r_132_30_55,1.0,29,84,55,63
32,r_84_100_107,seq85,seq101,r_84_100_107,0.99,0,107,107,63
25,r_79_99_50,seq78,r_25_98_15,r_79_99_50,1.0,0,50,50,63
6,r_25_98_15,r_24_91_20,seq101,r_25_98_15,0.94,0,15,15,63
83,seq93,r_24_91_20,r_53_111_194,r_53_111_194,0.35,-16,178,194,63
17,r_9_5_103,r_8_103_135,seq7,r_8_103_135,0.75,-32,103,135,63
4,r_149_36_17,r_145_102_78,seq39,r_149_36_17,0.92,0,17,17,63
23,r_50_133_59,r_52_97_107,seq135,r_50_133_59,0.97,0,59,59,63
36,r_116_37_41,r_117_90_189,r_149_36_17,r_116_37_41,0.99,0,41,41,63
49,r_52_97_107,r_53_111_194,r_25_98_15,r_52_97_107,0.86,0,107,107,63
7,r_63_75_64,r_67_61_191,r_76_77_50,r_63_75_64,0.68,75,139,64,63
79,seq73,r_64_70_87,r_35_74_17,r_35_74_17,0.56,28,45,17,63
12,r_48_148_153,r_59_49_13,r_45_146_51,r_45_146_51,0.59,102,153,51,63
40,r_45_113_11,r_111_95_143,r_140_109_107,r_140_109_107,0.99,33,140,107,64
43,r_64_56_108,seq67,seq57,r_64_56_108,0.92,4,112,108,64
22,r_83_132_26,seq84,seq133,r_83_132_26,1.0,0,26,26,64
37,r_55_75_111,r_58_110_158,r_53_74_88,r_55_75_111,0.86,-32,79,111,64
3,r_141_102_162,seq139,seq100,r_141_102_162,0.57,0,162,162,64
19,r_101_148_6,r_146_18_118,r_127_149_131,r_101_148_6,0.61,112,118,6,64
71,seq44,seq47,r_82_43_99,r_82_43_99,0.99,13,112,99,64
16,r_107_129_118,seq106,r_83_132_26,r_107_129_118,1.0,0,118,118,64
39,r_38_0_186,r_39_98_159,r_121_37_114,r_121_37_114,0.94,42,156,114,64
1,r_19_54_152,seq22,r_64_56_108,r_19_54_152,0.78,-2,150,152,64
97,seq117,r_116_137_134,r_143_118_109,r_143_118_109,0.63,-1,108,109,64
4,r_144_20_48,r_141_102_162,r_19_54_152,r_19_54_152,0.85,-104,48,152,64
46,r_146_18_118,r_147_123_106,r_101_148_6,r_146_18_118,0.55,-12,106,118,64
32,r_111_95_143,r_45_113_11,r_70_96_97,r_70_96_97,0.99,46,143,97,64
45,r_142_16_82,r_141_102_162,r_144_20_48,r_142_16_82,0.57,0,82,82,64
35,r_3_81_34,seq1,seq77,r_3_81_34,1.0,-1,33,34,64
23,r_131_12_29,seq134,seq13,r_131_12_29,1.0,0,29,29,64
41,r_70_96_97,seq67,seq93,r_70_96_97,0.99,0,97,97,64
96,seq108,r_45_113_11,r_140_109_107,r_140_109_107,0.98,8,115,107,64
3,r_141_102_162,r_143_118_109,seq139,r_143_118_109,0.93,-16,93,109,64
10,r_79_85_81,r_82_43_99,seq84,r_79_85_81,0.99,0,81,81,64
26,r_121_37_114,seq120,seq36,r_121_37_114,0.99,0,114,114,64
0,r_65_115_65,r_70_96_97,seq117,r_65_115_65,1.0,0,65,65,64
11,r_116_137_134,seq117,r_107_129_118,r_107_129_118,0.96,16,134,118,64
85,seq87,seq84,r_79_85_81,r_79_85_81,0.95,25,106,81,64
20,r_66_50_130,seq67,seq49,r_66_50_130,0.84,1,131,130,64
13,r_143_118_109,r_141_102_162,seq117,r_143_118_109,0.95,2,111,109,64
48,r_76_40_64,seq77,seq41,r_76_40_64,0.98,-1,63,64,64
4,r_144_20_48,r_19_54_152,r_146_18_118,r_146_18_118,0.99,5,123,118,64
6,r_58_110_158,seq57,r_140_109_107,r_140_109_107,0.62,52,159,107,64
85,seq87,r_86_34_59,seq84,r_86_34_59,1.0,2,61,59,64
27,r_32_130_79,seq33,r_83_132_26,r_32_130_79,1.0,0,79,79,64
87,seq90,r_92_91_201,r_97_89_47,r_92_91_201,0.36,-126,75,201,64
31,r_60_7_22,seq59,seq4,r_60_7_22,1.0,1,23,22,64
2,r_51_15_119,seq49,seq22,r_51_15_119,0.82,3,122,119,64
47,r_126_128_146,seq124,r_107_129_118,r_107_129_118,0.54,28,146,118,64
18,r_140_109_107,r_141_102_162,seq108,r_140_109_107,0.83,0,107,107,64
29,r_82_43_99,seq77,seq44,r_82_43_99,0.69,0,99,99,64
24,r_23_48_75,seq24,seq49,r_23_48_75,0.9,-4,71,75,64
96,seq108,r_107_129_118,r_45_113_11,r_45_113_11,0.95,15,26,11,64
25,r_127_149_131,r_136_21_155,r_101_148_6,r_127_149_131,0.72,-57,74,131,64
33,r_29_122_170,r_30_27_42,seq120,r_29_122_170,0.51,2,172,170,64
68,seq139,r_141_102_162,r_107_129_118,r_107_129_118,0.92,23,141,118,64
34,r_138_114_9,seq117,r_65_115_65,r_65_115_65,1.0,84,149,65,64
46,r_146_18_118,r_101_148_6,r_144_20_48,r_101_148_6,0.78,112,118,6,64
81,seq73,r_145_72_6,r_55_75_111,r_55_75_111,0.96,16,127,111,64
17,r_112_52_69,r_111_95_143,seq57,r_112_52_69,0.99,0,69,69,64
32,r_111_95_143,r_112_52_69,r_45_113_11,r_111_95_143,0.88,-114,29,143,64
9,r_26_68_144,seq24,seq67,r_26_68_144,0.66,0,144,144,64
99,seq124,r_126_128_146,r_17_125_8,r_17_125_8,0.81,21,29,8,64
98,seq120,r_65_115_65,r_29_122_170,r_29_122_170,0.74,5,175,170,64
28,r_6_80_123,seq4,seq77,r_6_80_123,0.96,2,125,123,64
49,r_147_123_106,r_146_18_118,r_17_125_8,r_147_123_106,0.55,0,106,106,64
56,seq10,seq9,r_119_8_78,r_119_8_78,1.0,6,84,78,64
7,r_39_98_159,r_38_0_186,r_97_89_47,r_39_98_159,0.65,0,159,159,64
44,r_53_74_88,seq59,r_55_75_111,r_53_74_88,0.62,-7,81,88,64
42,r_86_34_59,seq87,seq33,r_86_34_59,1.0,0,59,59,64
12,r_119_8_78,r_121_37_114,seq10,r_119_8_78,0.98,0,78,78,64
40,r_45_113_11,seq44,r_111_95_143,r_45_113_11,0.99,0,11,11,64
84,seq84,seq87,r_79_85_81,r_79_85_81,1.0,46,127,81,64
40,r_7_44_75,r_43_118_159,r_68_46_130,r_7_44_75,0.54,84,159,75,65
30,r_14_63_107,seq16,r_105_67_35,r_14_63_107,1.0,0,107,107,65
36,r_8_70_68,r_9_1_97,r_126_77_24,r_8_70_68,1.0,0,68,68,65
14,r_74_135_143,r_75_106_70,r_80_71_76,r_75_106_70,0.89,0,70,70,65
8,r_143_27_136,r_144_32_193,r_15_28_55,r_143_27_136,0.96,0,136,136,65
43,r_72_53_142,r_76_140_164,seq54,r_72_53_142,0.8,1,143,142,65
16,r_75_106_70,r_74_135_143,seq107,r_75_106_70,1.0,0,70,70,65
21,r_115_101_141,r_114_13_157,r_47_100_119,r_115_101_141,0.92,1,142,141,65
39,r_18_24_131,seq11,r_40_17_96,r_40_17_96,1.0,7,103,96,65
1,r_78_121_139,seq79,seq122,r_78_121_139,0.65,0,139,139,65
97,seq122,r_146_120_13,r_78_121_139,r_78_121_139,1.0,10,149,139,65
5,r_112_102_116,seq109,seq104,r_112_102_116,1.0,2,118,116,65
46,r_36_119_162,seq38,r_43_118_159,r_36_119_162,0.68,0,162,162,65
42,r_124_99_55,seq125,r_50_93_49,r_124_99_55,1.0,0,55,55,65
69,seq42,r_41_131_129,r_7_44_75,r_7_44_75,0.94,54,129,75,65
19,r_144_32_193,r_147_88_174,r_55_142_175,r_55_142_175,0.71,-1,174,175,65
59,seq16,r_40_17_96,r_114_13_157,r_114_13_157,1.0,5,162,157,65
38,r_91_21_33,seq23,r_18_24_131,r_18_24_131,1.0,3,134,131,65
31,r_43_118_159,r_45_57_105,r_7_44_75,r_7_44_75,1.0,5,80,75,65
41,r_22_59_80,seq23,r_105_67_35,r_22_59_80,1.0,0,80,80,65
62,seq26,seq29,r_15_28_55,r_15_28_55,1.0,1,56,55,65
10,r_128_34_104,r_137_141_188,r_25_35_46,r_128_34_104,0.99,1,105,104,65
90,seq107,seq104,r_75_106_70,r_75_106_70,1.0,7,77,70,65
26,r_68_46_130,r_80_71_76,r_7_44_75,r_7_44_75,1.0,55,130,75,65
14,r_74_135_143,r_80_71_76,r_137_141_188,r_74_135_143,0.91,0,143,143,65
4,r_45_57_105,r_47_100_119,r_22_59_80,r_22_59_80,0.99,25,105,80,65
11,r_40_17_96,r_41_131_129,r_9_1_97,r_40_17_96,0.99,0,96,96,65
20,r_64_84_113,seq66,r_56_83_37,r_56_83_37,0.46,76,113,37,65
13,r_98_65_141,seq94,r_105_67_35,r_105_67_35,0.69,107,142,35,65
89,seq104,r_105_67_35,seq107,r_105_67_35,0.92,0,35,35,65
15,r_61_123_193,r_55_142_175,r_105_67_35,r_105_67_35,0.51,43,78,35,65
48,r_0_58_103,r_2_37_118,r_22_59_80,r_22_59_80,0.97,24,104,80,65
23,r_146_120_13,r_145_103_42,seq122,r_145_103_42,0.7,-29,13,42,65
66,seq33,seq38,r_25_35_46,r_25_35_46,1.0,12,58,46,65
2,r_55_142_175,r_105_67_35,r_19_148_27,r_55_142_175,0.73,0,175,175,65
76,seq66,r_64_84_113,r_105_67_35,r_105_67_35,0.86,16,51,35,65
2,r_55_142_175,seq54,r_105_67_35,r_105_67_35,1.0,54,89,35,65
41,r_22_59_80,r_105_67_35,r_0_58_103,r_0_58_103,0.95,78,181,103,65
47,r_73_4_107,r_76_140_164,seq6,r_73_4_107,1.0,0,107,107,65
40,r_7_44_75,seq6,r_43_118_159,r_7_44_75,1.0,0,75,75,65
37,r_56_83_37,r_55_142_175,seq81,r_56_83_37,0.8,2,39,37,65
25,r_2_37_118,seq3,seq38,r_2_37_118,1.0,0,118,118,65
33,r_76_140_164,seq69,r_137_141_188,r_137_141_188,0.56,-24,164,188,65
68,seq38,r_36_119_162,r_2_37_118,r_2_37_118,0.8,44,162,118,65
35,r_19_148_27,r_9_1_97,seq149,r_19_148_27,0.97,2,29,27,65
32,r_108_12_134,seq117,seq10,r_108_12_134,0.72,-5,129,134,65
52,seq3,r_2_37_118,r_9_1_97,r_2_37_118,1.0,0,118,118,65
0,r_145_103_42,r_144_32_193,seq107,r_145_103_42,1.0,0,42,42,65
18,r_25_35_46,seq23,seq33,r_25_35_46,1.0,0,46,46,65
34,r_47_100_119,r_45_57_105,r_105_67_35,r_105_67_35,0.98,68,103,35,65
44,r_85_138_29,seq86,r_137_141_188,r_85_138_29,1.0,0,29,29,65
17,r_105_67_35,seq104,seq66,r_105_67_35,0.98,0,35,35,65
22,r_50_93_49,seq48,r_20_96_40,r_20_96_40,0.71,10,50,40,65
98,seq125,r_124_99_55,r_137_141_188,r_124_99_55,1.0,0,55,55,65
9,r_41_131_129,seq42,r_137_141_188,r_41_131_129,0.88,0,129,129,65
61,seq23,r_91_21_33,r_15_28_55,r_15_28_55,0.94,54,109,55,65
31,r_43_118_159,r_7_44_75,r_36_119_162,r_7_44_75,1.0,84,159,75,65
37,r_56_83_37,seq81,r_64_84_113,r_64_84_113,0.99,28,141,113,65
49,r_114_13_157,seq110,seq16,r_114_13_157,0.73,0,157,157,65
28,r_15_28_55,seq16,seq26,r_15_28_55,1.0,0,55,55,65
7,r_80_71_76,r_78_121_139,r_126_77_24,r_80_71_76,0.97,0,76,76,65
38,r_91_21_33,seq92,seq23,r_91_21_33,1.0,0,33,33,65
29,r_20_96_40,seq10,seq94,r_20_96_40,1.0,0,40,40,65
39,r_18_24_131,r_40_17_96,seq23,r_18_24_131,1.0,0,131,131,65
34,r_47_100_119,r_105_67_35,r_115_101_141,r_47_100_119,0.69,24,143,119,65
4,r_120_126_36,r_143_63_188,seq141,r_143_63_188,0.32,-42,146,188,66
9,r_56_136_123,r_85_59_14,r_105_134_20,r_56_136_123,0.99,0,123,123,66
37,r_31_114_195,seq32,r_121_112_77,r_121_112_77,0.71,116,193,77,66
59,seq17,r_16_4_115,seq22,r_16_4_115,0.89,-3,112,115,66
55,seq8,r_7_82_150,seq6,r_7_82_150,0.97,0,150,150,66
86,seq97,r_96_68_134,seq95,r_96_68_134,0.99,0,134,134,66
39,r_39_45_70,seq38,r_122_44_38,r_39_45_70,0.81,0,70,70,66
1,r_15_148_80,r_16_4_115,r_71_147_61,r_15_148_80,0.87,0,80,80,66
28,r_100_53_36,r_101_64_64,r_54_144_168,r_100_53_36,0.97,0,36,36,66
46,r_71_147_61,r_65_43_93,r_143_63_188,r_71_147_61,0.98,0,61,61,66
42,r_96_68_134,seq97,seq69,r_96_68_134,0.81,0,134,134,66
80,seq88,r_33_89_3,r_116_87_20,r_116_87_20,0.85,97,117,20,66
7,r_85_59_14,r_56_136_123,r_66_60_44,r_56_136_123,0.58,-41,82,123,66
45,r_143_63_188,seq145,r_101_64_64,r_143_63_188,0.32,1,189,188,66
16,r_48_123_24,r_54_144_168,seq124,r_48_123_24,0.99,0,24,24,66
30,r_2_26_176,seq0,r_130_1_20,r_130_1_20,0.77,17,37,20,66
19,r_79_52_138,r_80_47_174,r_10_50_116,r_10_50_116,0.78,20,136,116,66
26,r_65_43_93,seq95,seq41,r_65_43_93,1.0,0,93,93,66
5,r_121_112_77,r_120_126_36,r_48_123_24,r_121_112_77,0.81,-40,37,77,66
31,r_16_4_115,seq17,r_125_5_44,r_16_4_115,0.92,0,115,115,66
41,r_83_135_191,seq91,r_56_136_123,r_56_136_123,0.74,68,191,123,66
67,seq41,seq46,r_65_43_93,r_65_43_93,1.0,41,134,93,66
89,seq145,r_143_63_188,r_15_148_80,r_15_148_80,1.0,30,110,80,66
4,r_120_126_36,r_80_47_174,r_143_63_188,r_120_126_36,0.46,34,70,36,66
0,r_24_34_136,r_29_25_83,r_133_37_23,r_133_37_23,0.73,113,136,23,66
52,seq3,seq0,r_16_4_115,r_16_4_115,0.52,5,120,115,66
25,r_28_75_30,r_29_25_83,seq78,r_28_75_30,1.0,0,30,30,66
68,seq46,r_54_144_168,seq49,r_54_144_168,1.0,-121,47,168,66
34,r_130_1_20,seq129,r_2_26_176,r_130_1_20,0.67,0,20,20,66
15,r_12_137_177,seq13,r_56_136_123,r_12_137_177,0.75,0,177,177,66
49,r_105_134_20,r_138_70_124,r_56_136_123,r_105_134_20,1.0,104,124,20,66
13,r_18_139_157,r_72_19_6,r_105_134_20,r_18_139_157,0.93,2,159,157,66
6,r_80_47_174,seq81,r_10_50_116,r_80_47_174,0.82,1,175,174,66
62,seq22,r_24_34_136,r_77_30_100,r_77_30_100,0.8,2,102,100,66
36,r_54_144_168,r_100_53_36,r_98_142_132,r_54_144_168,0.94,0,168,168,66
13,r_18_139_157,seq21,r_72_19_6,r_72_19_6,0.38,27,33,6,66
27,r_77_30_100,r_76_14_141,r_117_27_73,r_76_14_141,0.69,-40,101,141,66
30,r_2_26_176,r_130_1_20,r_77_30_100,r_2_26_176,0.89,0,176,176,66
43,r_146_62_16,r_149_20_30,seq61,r_146_62_16,0.76,3,19,16,66
40,r_98_142_132,seq99,seq145,r_98_142_132,0.79,0,132,132,66
10,r_101_64_64,r_98_142_132,seq69,r_101_64_64,0.79,0,64,64,66
24,r_58_103_60,r_57_23_62,seq102,r_57_23_62,0.98,-2,60,62,66
34,r_130_1_20,r_2_26_176,seq0,r_2_26_176,1.0,0,176,176,66
2,r_116_87_20,seq115,seq88,r_116_87_20,0.88,4,24,20,66
10,r_101_64_64,r_100_53_36,r_98_142_132,r_100_53_36,0.99,0,36,36,66
33,r_76_14_141,seq78,seq17,r_76_14_141,0.79,0,141,141,66
48,r_72_19_6,r_18_139_157,seq21,r_18_139_157,0.84,-6,151,157,66
47,r_125_5_44,seq3,r_16_4_115,r_16_4_115,1.0,0,115,115,66
88,seq102,seq124,r_58_103_60,r_58_103_60,0.96,3,63,60,66
58,seq13,r_12_137_177,seq9,r_12_137_177,0.67,-6,171,177,66
20,r_66_60_44,r_67_113_198,r_85_59_14,r_66_60_44,0.42,0,44,44,66
46,r_71_147_61,r_143_63_188,r_15_148_80,r_15_148_80,0.64,25,105,80,66
22,r_149_20_30,seq145,r_72_19_6,r_149_20_30,0.98,0,30,30,66
38,r_57_23_62,r_56_136_123,r_29_25_83,r_57_23_62,1.0,0,62,62,66
52,seq3,seq0,r_125_5_44,r_125_5_44,0.75,27,71,44,66
77,seq81,r_80_47_174,r_7_82_150,r_7_82_150,0.92,25,175,150,66
59,seq17,seq22,r_149_20_30,r_149_20_30,0.59,136,166,30,66
18,r_122_44_38,r_108_40_119,seq41,r_122_44_38,0.95,0,38,38,66
23,r_138_70_124,r_133_37_23,r_105_134_20,r_138_70_124,0.95,-99,25,124,66
7,r_85_59_14,seq84,r_56_136_123,r_85_59_14,0.4,0,14,14,66
49,r_105_134_20,r_117_27_73,r_138_70_124,r_105_134_20,0.96,1,21,20,66
36,r_54_144_168,seq46,r_100_53_36,r_100_53_36,1.0,11,47,36,66
17,r_10_50_116,seq9,seq49,r_10_50_116,0.98,0,116,116,66
9,r_56_136_123,r_57_23_62,r_85_59_14,r_57_23_62,1.0,0,62,62,66
21,r_133_37_23,r_138_70_124,seq35,r_133_37_23,1.0,2,25,23,66
28,r_100_53_36,r_54_144_168,r_10_50_116,r_10_50_116,0.98,50,166,116,66
47,r_125_5_44,r_120_126_36,seq3,r_125_5_44,0.9,0,44,44,66
56,seq9,r_10_50_116,seq13,r_10_50_116,1.0,0,116,116,66
44,r_29_25_83,r_24_34_136,r_57_23_62,r_57_23_62,1.0,74,136,62,66
35,r_11_92_144,r_12_137_177,seq93,r_11_92_144,0.92,0,144,144,66
18,r_122_44_38,seq41,r_39_45_70,r_39_45_70,0.99,19,89,70,66
23,r_138_70_124,r_105_134_20,seq69,r_138_70_124,0.96,0,124,124,66
21,r_96_88_47,seq95,seq89,r_96_88_47,0.9,1,48,47,67
14,r_129_142_123,seq128,seq141,r_129_142_123,0.85,0,123,123,67
8,r_76_97_96,r_82_64_152,seq101,r_76_97_96,1.0,0,96,96,67
53,seq6,r_7_145_186,r_8_11_193,r_8_11_193,0.52,-2,191,193,67
43,r_58_133_61,r_57_67_90,seq134,r_58_133_61,1.0,0,61,61,67
50,seq0,r_2_68_22,r_35_1_7,r_2_68_22,0.9,0,22,22,67
92,seq109,r_110_33_150,r_5_111_50,r_5_111_50,0.96,10,60,50,67
37,r_50_93_160,r_52_73_181,r_98_99_10,r_50_93_160,0.62,0,160,160,67
41,r_79_49_18,r_75_77_15,r_50_93_160,r_79_49_18,1.0,0,18,18,67
52,seq3,seq0,r_124_4_36,r_124_4_36,1.0,0,36,36,67
16,r_92_78_114,r_94_25_58,r_98_99_10,r_94_25_58,1.0,0,58,58,67
39,r_65_66_65,r_50_93_160,r_57_67_90,r_50_93_160,0.81,-58,102,160,67
1,r_117_140_135,r_118_19_146,r_129_142_123,r_117_140_135,0.99,0,135,135,67
97,seq122,seq120,r_39_121_47,r_39_121_47,1.0,17,64,47,67
5,r_147_107_96,r_149_100_190,seq108,r_147_107_96,1.0,0,96,96,67
46,r_24_83_85,seq23,seq84,r_24_83_85,1.0,0,85,85,67
3,r_47_30_24,r_46_137_37,seq29,r_46_137_37,0.97,-13,24,37,67
45,r_72_123_166,seq74,seq125,r_72_123_166,0.71,0,166,166,67
10,r_132_80_55,r_131_70_143,r_75_77_15,r_132_80_55,1.0,2,57,55,67
24,r_12_54_151,r_7_145_186,r_14_51_56,r_12_54_151,0.74,0,151,151,67
15,r_16_53_187,r_130_17_3,r_110_33_150,r_110_33_150,1.0,43,193,150,67
28,r_94_25_58,r_92_78_114,seq23,r_94_25_58,1.0,0,58,58,67
30,r_5_111_50,r_7_145_186,seq109,r_5_111_50,1.0,0,50,50,67
35,r_39_121_47,seq38,seq122,r_39_121_47,1.0,0,47,47,67
31,r_149_100_190,r_147_107_96,r_103_148_63,r_149_100_190,0.82,-112,78,190,67
67,seq31,seq36,r_110_33_150,r_110_33_150,1.0,1,151,150,67
11,r_52_73_181,r_50_93_160,r_14_51_56,r_52_73_181,0.83,-117,64,181,67
25,r_112_87_157,seq106,seq113,r_112_87_157,0.46,-124,33,157,67
48,r_135_15_130,seq134,r_130_17_3,r_135_15_130,0.98,0,130,130,67
12,r_110_33_150,r_5_111_50,seq31,r_110_33_150,1.0,1,151,150,67
15,r_16_53_187,r_14_51_56,r_130_17_3,r_14_51_56,0.85,0,56,56,67
47,r_35_1_7,r_46_137_37,seq0,r_35_1_7,0.93,3,10,7,67
4,r_60_86_50,r_57_67_90,r_96_88_47,r_60_86_50,1.0,0,50,50,67
41,r_79_49_18,r_50_93_160,r_14_51_56,r_79_49_18,0.8,142,160,18,67
93,seq113,r_112_87_157,r_39_121_47,r_112_87_157,0.56,-31,126,157,67
40,r_131_70_143,seq134,seq69,r_131_70_143,0.95,0,143,143,67
18,r_130_17_3,r_16_53_187,r_13_18_62,r_13_18_62,1.0,28,90,62,67
29,r_21_32_193,seq20,r_110_33_150,r_110_33_150,1.0,43,193,150,67
24,r_12_54_151,r_13_18_62,r_7_145_186,r_13_18_62,1.0,0,62,62,67
88,seq104,r_103_148_63,seq101,r_103_148_63,0.54,-41,22,63,67
33,r_10_59_113,r_8_11_193,seq61,r_10_59_113,0.91,0,113,113,67
36,r_2_68_22,seq0,seq69,r_2_68_22,1.0,0,22,22,67
64,seq26,seq28,r_118_19_146,r_118_19_146,1.0,48,194,146,67
20,r_14_51_56,r_16_53_187,r_79_49_18,r_14_51_56,0.66,0,56,56,67
19,r_85_114_12,r_92_78_114,seq115,r_85_114_12,0.91,1,13,12,67
61,seq20,r_21_32_193,r_118_19_146,r_118_19_146,1.0,49,195,146,67
32,r_103_148_63,seq104,r_149_100_190,r_103_148_63,1.0,0,63,63,67
34,r_82_64_152,seq84,seq61,r_82_64_152,0.93,0,152,152,67
16,r_92_78_114,r_98_99_10,r_132_80_55,r_92_78_114,1.0,0,114,114,67
17,r_57_67_90,seq61,r_65_66_65,r_57_67_90,0.65,0,90,90,67
25,r_112_87_157,seq113,r_96_88_47,r_96_88_47,0.51,110,157,47,67
2,r_46_137_37,r_45_48_63,seq138,r_46_137_37,0.99,0,37,37,67
22,r_75_77_15,r_76_97_96,r_132_80_55,r_75_77_15,1.0,65,80,15,67
93,seq113,r_110_33_150,r_112_87_157,r_112_87_157,0.56,-115,42,157,67
49,r_27_119_195,seq28,r_47_30_24,r_47_30_24,0.97,137,161,24,67
56,seq138,seq141,r_46_137_37,r_46_137_37,1.0,8,45,37,67
44,r_127_62_153,seq128,r_82_64_152,r_127_62_153,0.82,0,153,153,67
23,r_13_18_62,r_12_54_151,r_130_17_3,r_13_18_62,0.98,0,62,62,67
26,r_124_4_36,seq126,seq3,r_124_4_36,1.0,0,36,36,67
82,seq84,r_82_64_152,r_24_83_85,r_24_83_85,0.92,67,152,85,67
12,r_110_33_150,seq106,r_5_111_50,r_5_111_50,1.0,9,59,50,67
30,r_131_124_128,r_133_141_143,r_84_120_97,r_131_124_128,0.46,0,128,128,68
36,r_67_8_74,seq69,r_61_10_22,r_67_8_74,0.95,-1,73,74,68
54,seq6,r_7_90_183,r_61_10_22,r_61_10_22,0.95,66,88,22,68
37,r_77_104_142,seq78,seq108,r_77_104_142,0.75,0,142,142,68
25,r_143_37_54,r_146_99_132,seq35,r_143_37_54,0.91,1,55,54,68
55,seq135,r_138_101_151,r_106_144_48,r_106_144_48,0.62,103,151,48,68
71,seq56,r_49_13_149,r_58_48_96,r_49_13_149,0.9,1,150,149,68
21,r_22_123_157,r_21_86_161,r_84_120_97,r_22_123_157,0.48,0,157,157,68
1,r_84_120_97,seq92,seq122,r_84_120_97,0.57,0,97,97,68
20,r_110_137_146,seq132,r_106_144_48,r_110_137_146,0.87,0,146,146,68
5,r_21_86_161,seq23,r_138_101_151,r_21_86_161,0.76,0,161,161,68
46,r_18_1_119,seq17,r_82_4_5,r_18_1_119,0.75,0,119,119,68
42,r_59_93_94,r_58_48_96,r_96_88_78,r_59_93_94,1.0,0,94,94,68
45,r_7_90_183,r_9_126_105,r_61_10_22,r_7_90_183,0.66,-161,22,183,68
23,r_61_10_22,seq60,r_7_90_183,r_61_10_22,0.97,0,22,22,68
80,seq78,r_77_104_142,seq81,r_77_104_142,1.0,0,142,142,68
18,r_49_13_149,r_58_48_96,r_71_12_95,r_49_13_149,0.97,1,150,149,68
27,r_71_12_95,r_11_0_43,r_49_13_149,r_71_12_95,0.57,57,152,95,68
19,r_53_119_184,seq56,r_32_116_23,r_32_116_23,0.72,163,186,23,68
32,r_70_34_188,r_136_47_81,r_42_63_24,r_70_34_188,0.53,-68,120,188,68
94,seq115,r_113_134_191,r_105_114_51,r_105_114_51,1.0,0,51,51,68
2,r_105_114_51,seq103,seq115,r_105_114_51,1.0,0,51,51,68
31,r_50_33_115,r_49_13_149,seq31,r_50_33_115,0.94,0,115,115,68
8,r_3_15_54,seq2,seq19,r_3_15_54,1.0,1,55,54,68
0,r_32_116_23,seq31,seq118,r_32_116_23,1.0,0,23,23,68
17,r_36_14_24,seq35,r_24_16_138,r_36_14_24,0.97,0,24,24,68
4,r_9_126_105,r_7_90_183,seq125,r_9_126_105,1.0,0,105,105,68
20,r_110_137_146,seq115,seq132,r_110_137_146,0.46,-28,118,146,68
13,r_91_100_138,r_87_52_177,r_96_88_78,r_91_100_138,0.43,0,138,138,68
15,r_129_38_96,seq128,seq41,r_129_38_96,0.95,0,96,96,68
95,seq118,seq121,r_32_116_23,r_32_116_23,1.0,0,23,23,68
6,r_130_51_161,seq132,r_58_48_96,r_130_51_161,0.5,0,161,161,68
48,r_39_27_18,r_43_64_149,seq28,r_39_27_18,1.0,0,18,18,68
67,seq35,r_55_30_14,r_143_37_54,r_143_37_54,0.94,2,56,54,68
27,r_71_12_95,seq72,r_36_14_24,r_71_12_95,0.97,-1,94,95,68
41,r_54_66_31,r_42_63_24,r_26_65_154,r_26_65_154,1.0,13,167,154,68
47,r_58_48_96,r_59_93_94,seq56,r_59_93_94,1.0,3,97,94,68
18,r_49_13_149,r_50_33_115,r_58_48_96,r_50_33_115,1.0,0,115,115,68
29,r_26_65_154,seq28,r_43_64_149,r_26_65_154,0.52,0,154,154,68
67,seq35,r_36_14_24,r_55_30_14,r_55_30_14,0.73,2,16,14,68
44,r_42_63_24,r_43_64_149,r_54_66_31,r_42_63_24,0.52,1,25,24,68
91,seq107,r_106_144_48,seq103,r_106_144_48,1.0,1,49,48,68
22,r_46_74_40,r_43_64_149,seq73,r_46_74_40,0.93,0,40,40,68
32,r_70_34_188,seq75,r_136_47_81,r_70_34_188,0.55,-85,103,188,68
52,seq132,r_133_141_143,r_106_144_48,r_106_144_48,1.0,90,138,48,68
45,r_7_90_183,r_61_10_22,r_21_86_161,r_61_10_22,0.45,161,183,22,68
27,r_71_12_95,r_36_14_24,r_11_0_43,r_11_0_43,0.68,98,141,43,68
49,r_98_140_114,seq102,seq139,r_98_140_114,0.47,0,114,114,68
7,r_136_47_81,r_138_101_151,seq44,r_136_47_81,0.96,0,81,81,68
41,r_54_66_31,r_53_119_184,r_42_63_24,r_54_66_31,0.88,0,31,31,68
12,r_57_79_122,r_58_48_96,seq81,r_57_79_122,0.96,-1,121,122,68
28,r_55_30_14,r_53_119_184,seq31,r_55_30_14,0.91,0,14,14,68
24,r_106_144_48,seq107,seq135,r_106_144_48,1.0,-3,45,48,68
84,seq89,r_87_52_177,r_21_86_161,r_21_86_161,0.51,14,175,161,68
30,r_18_81_68,seq19,r_82_117_186,r_18_81_68,0.99,0,68,68,69
36,r_75_22_191,r_73_15_166,r_20_74_63,r_20_74_63,1.0,103,166,63,69
8,r_48_114_91,seq47,seq111,r_48_114_91,0.96,-1,90,91,69
54,seq10,r_9_56_131,r_17_77_156,r_9_56_131,0.76,-3,128,131,69
12,r_3_72_54,r_1_104_177,r_73_15_166,r_3_72_54,1.0,0,54,54,69
37,r_71_141_199,seq70,r_95_144_84,r_95_144_84,0.98,115,199,84,69
39,r_101_148_130,seq109,r_95_144_84,r_95_144_84,0.72,45,129,84,69
97,seq122,r_123_90_145,r_63_120_114,r_63_120_114,0.58,28,142,114,69
54,seq10,r_17_77_156,r_45_12_145,r_17_77_156,0.56,-9,147,156,69
46,r_126_52_154,r_127_133_182,r_98_55_72,r_126_52_154,0.7,0,154,154,69
19,r_139_27_102,r_138_50_153,seq25,r_139_27_102,1.0,0,102,102,69
15,r_1_104_177,r_129_2_11,seq105,r_1_104_177,0.54,0,177,177,69
66,seq31,r_33_128_113,seq41,r_33_128_113,0.99,-5,108,113,69
31,r_46_44_148,r_45_12_145,seq34,r_45_12_145,0.35,0,145,145,69
10,r_73_15_166,r_75_22_191,r_113_28_112,r_75_22_191,0.4,-25,166,191,69
47,r_16_96_47,r_17_77_156,seq97,r_16_96_47,0.98,0,47,47,69
26,r_43_118_158,r_46_44_148,r_59_115_14,r_43_118_158,0.6,0,158,158,69
4,r_20_74_63,r_18_81_68,r_3_72_54,r_20_74_63,0.94,0,63,63,69
2,r_17_77_156,r_16_96_47,r_23_88_164,r_16_96_47,1.0,-5,42,47,69
48,r_107_6_26,seq106,r_9_56_131,r_107_6_26,0.57,0,26,26,69
3,r_8_76_13,r_7_99_131,seq89,r_8_76_13,0.83,0,13,13,69
13,r_113_28_112,r_112_131_182,r_139_27_102,r_113_28_112,1.0,0,112,112,69
20,r_129_2_11,r_139_27_102,r_3_72_54,r_129_2_11,0.86,0,11,11,69
0,r_7_99_131,r_8_76_13,r_1_104_177,r_7_99_131,0.48,-118,13,131,69
12,r_3_72_54,r_73_15_166,r_20_74_63,r_3_72_54,0.66,112,166,54,69
2,r_17_77_156,r_23_88_164,r_134_79_25,r_134_79_25,0.98,131,156,25,69
28,r_59_115_14,r_63_120_114,seq111,r_59_115_14,0.88,-1,13,14,69
27,r_61_11_150,r_36_62_4,r_45_12_145,r_61_11_150,0.68,0,150,150,69
30,r_18_81_68,r_82_117_186,r_83_54_200,r_18_81_68,0.52,108,176,68,69
22,r_82_117_186,r_18_81_68,r_43_118_158,r_43_118_158,0.85,29,187,158,69
41,r_33_128_113,r_32_102_48,seq31,r_32_102_48,1.0,-1,47,48,69
41,r_33_128_113,seq31,seq130,r_33_128_113,1.0,0,113,113,69
0,r_7_99_131,r_107_6_26,seq100,r_7_99_131,1.0,0,131,131,69
25,r_134_79_25,r_139_27_102,seq78,r_134_79_25,1.0,0,25,25,69
20,r_129_2_11,r_3_72_54,r_1_104_177,r_3_72_54,1.0,-5,49,54,69
40,r_138_50_153,seq136,seq51,r_138_50_153,0.57,0,153,153,69
45,r_116_0_17,r_33_128_113,r_107_6_26,r_107_6_26,0.67,21,47,26,69
45,r_116_0_17,r_113_28_112,r_33_128_113,r_113_28_112,0.45,-95,17,112,69
18,r_9_56_131,seq10,seq57,r_9_56_131,0.56,0,131,131,69
29,r_63_120_114,seq64,seq122,r_63_120_114,0.91,0,114,114,69
43,r_32_102_48,r_103_80_179,seq105,r_32_102_48,0.71,127,175,48,69
0,r_7_99_131,r_1_104_177,r_107_6_26,r_107_6_26,0.69,39,65,26,69
50,seq130,r_138_50_153,r_33_128_113,r_33_128_113,0.74,16,129,113,69
6,r_103_80_179,r_32_102_48,r_134_79_25,r_103_80_179,0.52,0,179,179,69
45,r_116_0_17,r_107_6_26,seq26,r_116_0_17,0.62,47,64,17,69
32,r_112_131_182,seq111,r_127_133_182,r_112_131_182,0.53,0,182,182,69
38,r_40_49_103,r_42_86_183,r_98_55_72,r_40_49_103,0.97,0,103,103,69
34,r_123_90_145,seq122,seq89,r_123_90_145,0.87,0,145,145,69
20,r_129_2_11,r_1_104_177,r_121_5_97,r_121_5_97,0.98,24,121,97,69
42,r_39_93_15,r_40_49_103,seq94,r_39_93_15,0.91,0,15,15,69
48,r_107_6_26,r_9_56_131,r_129_2_11,r_107_6_26,0.68,24,50,26,69
15,r_1_104_177,r_3_72_54,r_129_2_11,r_3_72_54,0.89,-2,52,54,69
17,r_95_144_84,seq94,seq143,r_95_144_84,1.0,1,85,84,69
25,r_134_79_25,seq78,r_17_77_156,r_17_77_156,0.78,0,156,156,69
9,r_121_5_97,seq122,r_129_2_11,r_121_5_97,1.0,0,97,97,69
79,seq66,r_67_119_185,r_36_62_4,r_36_62_4,0.58,41,45,4,69
22,r_82_117_186,seq89,r_18_81_68,r_18_81_68,1.0,14,82,68,69
88,seq94,seq92,r_39_93_15,r_39_93_15,1.0,2,17,15,69
7,r_127_133_182,seq125,r_149_132_180,r_127_133_182,0.44,0,182,182,69
44,r_23_88_164,seq24,r_83_54_200,r_23_88_164,0.57,0,164,164,69
23,r_98_55_72,seq92,seq47,r_98_55_72,0.97,2,74,72,69
82,seq78,seq89,r_17_77_156,r_17_77_156,0.89,5,161,156,69
35,r_13_4_176,seq19,r_121_5_97,r_121_5_97,1.0,79,176,97,69
43,r_32_102_48,r_33_128_113,r_103_80_179,r_32_102_48,1.0,0,48,48,69
6,r_103_80_179,seq105,r_32_102_48,r_32_102_48,1.0,0,48,48,69
30,r_120_84_70,seq119,seq82,r_120_84_70,1.0,1,71,70,70
16,r_114_36_85,seq112,r_29_113_13,r_29_113_13,0.88,0,13,13,70
92,seq107,r_106_66_145,r_127_105_15,r_106_66_145,0.6,-82,63,145,70
25,r_133_121_43,r_141_14_94,seq122,r_133_121_43,0.95,0,43,43,70
14,r_60_125_68,r_61_115_199,seq126,r_60_125_68,0.99,0,68,68,70
8,r_147_63_153,seq146,seq64,r_147_63_153,0.95,0,153,153,70
43,r_78_47_70,seq80,seq49,r_78_47_70,0.99,0,70,70,70
37,r_41_104_85,seq39,r_127_105_15,r_41_104_85,1.0,0,85,85,70
86,seq82,r_83_55_184,r_120_84_70,r_120_84_70,1.0,115,185,70,70
1,r_35_145_76,r_34_31_57,seq144,r_35_145_76,1.0,0,76,76,70
5,r_98_140_151,seq99,r_0_139_24,r_98_140_151,0.56,0,151,151,70
42,r_124_85_67,seq126,r_137_86_54,r_124_85_67,0.95,0,67,67,70
45,r_3_130_121,r_6_88_182,seq131,r_3_130_121,0.98,0,121,121,70
39,r_0_139_24,seq1,r_134_15_185,r_0_139_24,1.0,0,24,24,70
10,r_127_105_15,r_128_91_128,seq107,r_127_105_15,0.93,0,15,15,70
24,r_89_79_103,r_13_90_19,seq76,r_89_79_103,1.0,0,103,103,70
33,r_92_116_24,r_117_19_105,seq119,r_117_19_105,1.0,0,105,105,70
73,seq54,r_48_4_186,r_135_53_25,r_135_53_25,1.0,6,31,25,70
39,r_0_139_24,r_134_15_185,r_101_138_94,r_101_138_94,1.0,36,130,94,70
31,r_45_73_109,seq50,r_132_74_52,r_132_74_52,1.0,57,109,52,70
34,r_136_94_48,r_141_14_94,r_95_57_162,r_136_94_48,1.0,0,48,48,70
26,r_83_55_184,seq82,r_141_14_94,r_141_14_94,1.0,91,185,94,70
16,r_114_36_85,r_29_113_13,r_34_31_57,r_114_36_85,1.0,0,85,85,70
11,r_137_86_54,r_141_14_94,seq81,r_137_86_54,0.95,0,54,54,70
4,r_106_66_145,seq107,seq70,r_106_66_145,0.83,0,145,145,70
21,r_29_113_13,r_35_145_76,r_114_36_85,r_29_113_13,0.9,0,13,13,70
46,r_135_53_25,r_141_14_94,seq54,r_135_53_25,0.82,1,26,25,70
2,r_13_90_19,r_11_103_131,r_89_79_103,r_13_90_19,1.0,0,19,19,70
0,r_11_103_131,r_6_88_182,r_127_105_15,r_11_103_131,0.85,0,131,131,70
13,r_123_69_119,seq122,seq67,r_123_69_119,1.0,1,120,119,70
98,seq126,r_128_91_128,r_60_125_68,r_60_125_68,0.79,19,87,68,70
15,r_65_109_74,seq64,r_75_111_36,r_65_109_74,0.71,0,74,74,70
48,r_8_25_168,r_11_103_131,r_18_9_59,r_8_25_168,0.83,-87,81,168,70
6,r_48_4_186,seq49,r_97_5_106,r_97_5_106,1.0,80,186,106,70
21,r_29_113_13,r_114_36_85,r_65_109_74,r_29_113_13,1.0,72,85,13,70
20,r_95_57_162,r_98_140_151,r_136_94_48,r_136_94_48,0.99,0,48,48,70
9,r_75_111_36,r_72_10_48,seq110,r_75_111_36,1.0,0,36,36,70
2,r_13_90_19,r_89_79_103,seq93,r_89_79_103,1.0,0,103,103,70
35,r_117_19_105,r_120_84_70,r_92_116_24,r_117_19_105,0.87,-71,34,105,70
19,r_118_143_30,r_120_84_70,seq144,r_120_84_70,0.63,-36,34,70,70
41,r_72_10_48,r_11_103_131,r_18_9_59,r_11_103_131,1.0,-1,130,131,70
47,r_134_15_185,r_141_14_94,r_101_138_94,r_134_15_185,0.95,-90,95,185,70
40,r_128_91_128,seq131,seq93,r_128_91_128,0.98,0,128,128,70
50,seq1,r_0_139_24,seq2,r_0_139_24,0.99,2,26,24,70
29,r_6_88_182,r_8_25_168,r_72_10_48,r_72_10_48,1.0,67,115,48,70
34,r_136_94_48,r_95_57_162,r_13_90_19,r_95_57_162,0.69,0,162,162,70
35,r_117_19_105,r_92_116_24,seq17,r_117_19_105,0.97,0,105,105,70
48,r_8_25_168,r_18_9_59,seq24,r_8_25_168,0.82,0,168,168,70
47,r_134_15_185,r_101_138_94,r_117_19_105,r_134_15_185,0.83,0,185,185,70
54,seq142,r_147_63_153,r_118_143_30,r_118_143_30,0.51,-5,25,30,70
20,r_95_57_162,r_136_94_48,r_147_63_153,r_95_57_162,0.69,0,162,162,70
42,r_124_85_67,r_137_86_54,seq82,r_124_85_67,0.47,79,146,67,70
33,r_92_116_24,seq119,r_44_129_137,r_92_116_24,0.52,139,163,24,70
24,r_89_79_103,r_92_116_24,r_13_90_19,r_89_79_103,0.99,-78,25,103,70
33,r_92_116_24,seq93,r_117_19_105,r_92_116_24,1.0,0,24,24,70
21,r_29_113_13,r_65_109_74,seq112,r_29_113_13,0.41,138,151,13,70
49,r_16_87_40,seq17,seq93,r_16_87_40,1.0,0,40,40,70
27,r_56_22_34,seq54,seq21,r_56_22_34,0.97,2,36,34,70
17,r_7_108_160,r_6_88_182,seq107,r_7_108_160,0.66,0,160,160,70
41,r_72_10_48,seq70,r_11_103_131,r_72_10_48,0.86,3,51,48,70
11,r_137_86_54,seq81,r_124_85_67,r_124_85_67,0.56,37,104,67,70
22,r_97_5_106,r_98_140_151,r_72_10_48,r_97_5_106,1.0,0,106,106,70
28,r_101_138_94,seq102,r_0_139_24,r_101_138_94,1.0,0,94,94,70
56,seq17,seq21,r_117_19_105,r_117_19_105,1.0,23,128,105,70
7,r_37_40_101,r_34_31_57,seq38,r_37_40_101,0.97,0,101,101,70
23,r_18_9_59,seq17,r_8_25_168,r_18_9_59,0.98,2,61,59,70
93,seq110,r_106_66_145,r_75_111_36,r_75_111_36,1.0,3,39,36,70
12,r_132_74_52,r_141_14_94,seq71,r_132_74_52,0.58,0,52,52,70
59,seq21,seq20,r_56_22_34,r_56_22_34,1.0,5,39,34,70
23,r_18_9_59,r_8_25_168,r_72_10_48,r_8_25_168,0.93,0,168,168,70
92,seq104,r_106_40_137,r_134_105_15,r_106_40_137,0.53,0,137,137,71
14,r_84_38_76,r_85_111_78,seq39,r_84_38_76,1.0,0,76,76,71
8,r_140_69_141,seq139,r_1_72_63,r_1_72_63,0.99,78,141,63,71
43,r_14_28_92,seq13,seq21,r_14_28_92,0.75,0,92,92,71
53,seq6,r_5_99_32,seq2,r_5_99_32,1.0,0,32,32,71
26,r_138_25_45,seq139,r_22_27_51,r_138_25_45,1.0,2,47,45,71
37,r_126_88_105,seq121,r_80_124_48,r_80_124_48,1.0,2,50,48,71
16,r_9_146_105,seq10,seq149,r_9_146_105,0.98,0,105,105,71
21,r_112_103_189,r_109_75_189,r_5_99_32,r_5_99_32,1.0,93,125,32,71
1,r_109_75_189,r_110_26_139,r_134_105_15,r_110_26_139,0.87,2,141,139,71
97,seq120,r_119_142_79,r_80_124_48,r_80_124_48,0.83,33,81,48,71
37,r_126_88_105,r_80_124_48,seq86,r_126_88_105,0.91,1,106,105,71
5,r_144_125_178,seq149,r_80_124_48,r_80_124_48,0.89,130,178,48,71
46,r_102_137_155,seq100,r_119_142_79,r_102_137_155,0.68,0,155,155,71
80,seq68,r_70_54_129,r_1_72_63,r_1_72_63,1.0,66,129,63,71
3,r_122_7_24,r_119_142_79,seq13,r_122_7_24,0.91,0,24,24,71
45,r_110_26_139,r_109_75_189,r_22_27_51,r_110_26_139,0.82,2,141,139,71
19,r_0_37_81,seq2,r_84_38_76,r_0_37_81,1.0,0,81,81,71
33,r_35_90_39,r_109_75_189,r_112_103_189,r_109_75_189,0.45,-23,166,189,71
33,r_35_90_39,seq36,r_109_75_189,r_35_90_39,0.87,-5,34,39,71
4,r_128_57_18,r_122_7_24,seq56,r_122_7_24,0.62,-12,12,24,71
42,r_65_141_52,r_108_64_6,seq139,r_65_141_52,0.86,1,53,52,71
36,r_5_99_32,seq6,r_63_101_25,r_5_99_32,1.0,0,32,32,71
47,r_92_127_46,r_91_48_159,r_135_20_187,r_92_127_46,0.92,1,47,46,71
49,r_130_118_96,r_136_33_104,seq116,r_136_33_104,1.0,-7,97,104,71
0,r_85_111_78,seq86,r_63_101_25,r_63_101_25,0.6,56,81,25,71
11,r_76_4_65,seq77,seq6,r_76_4_65,1.0,0,65,65,71
39,r_80_124_48,r_126_88_105,seq120,r_126_88_105,0.99,0,105,105,71
20,r_136_33_104,r_135_20_187,seq29,r_136_33_104,0.96,2,106,104,71
98,seq121,seq120,r_80_124_48,r_80_124_48,1.0,32,80,48,71
15,r_93_66_173,seq95,r_108_64_6,r_108_64_6,0.88,168,174,6,71
48,r_70_54_129,seq68,seq53,r_70_54_129,0.56,0,129,129,71
79,seq67,r_65_141_52,r_108_64_6,r_65_141_52,0.84,-18,34,52,71
13,r_44_71_49,r_70_54_129,r_1_72_63,r_44_71_49,0.62,61,110,49,71
6,r_19_129_63,r_18_143_145,r_130_118_96,r_19_129_63,0.91,0,63,63,71
27,r_18_143_145,r_24_89_188,r_9_146_105,r_18_143_145,0.88,0,145,145,71
49,r_130_118_96,seq116,r_136_33_104,r_136_33_104,0.73,-65,39,104,71
43,r_14_28_92,seq21,seq29,r_14_28_92,0.46,37,129,92,71
40,r_16_123_117,r_18_143_145,r_80_124_48,r_80_124_48,0.57,69,117,48,71
18,r_147_8_72,seq148,seq10,r_147_8_72,1.0,0,72,72,71
29,r_119_142_79,seq120,r_65_141_52,r_65_141_52,0.68,8,60,52,71
24,r_106_40_137,seq104,seq41,r_106_40_137,0.61,2,139,137,71
47,r_92_127_46,r_135_20_187,r_19_129_63,r_92_127_46,0.63,67,113,46,71
65,seq39,seq36,r_84_38_76,r_84_38_76,1.0,-1,75,76,71
61,seq23,r_24_89_188,r_136_33_104,r_136_33_104,0.97,82,186,104,71
10,r_134_105_15,r_136_33_104,seq104,r_134_105_15,0.77,-1,14,15,71
38,r_17_107_105,r_18_143_145,r_134_105_15,r_17_107_105,0.9,1,106,105,71
34,r_31_73_131,seq29,r_1_72_63,r_1_72_63,0.97,70,133,63,71
39,r_80_124_48,seq79,r_126_88_105,r_80_124_48,0.99,3,51,48,71
81,seq77,r_76_4_65,seq82,r_76_4_65,1.0,0,65,65,71
6,r_19_129_63,r_130_118_96,r_92_127_46,r_130_118_96,0.54,1,97,96,71
9,r_59_145_156,seq61,r_18_143_145,r_59_145_156,0.7,0,156,156,71
13,r_44_71_49,seq43,r_70_54_129,r_44_71_49,0.77,0,49,49,71
28,r_24_89_188,seq23,r_35_90_39,r_35_90_39,0.91,146,185,39,71
91,seq100,r_102_137_155,r_112_103_189,r_102_137_155,0.6,0,155,155,71
75,seq56,r_52_32_196,r_128_57_18,r_128_57_18,0.97,-2,16,18,71
23,r_135_20_187,seq132,r_136_33_104,r_136_33_104,1.0,83,187,104,71
12,r_1_72_63,seq2,r_44_71_49,r_1_72_63,1.0,0,63,63,71
93,seq108,r_106_91_119,r_76_107_134,r_76_107_134,0.73,2,136,134,72
8,r_80_135_95,r_79_112_170,seq136,r_80_135_95,0.99,1,96,95,72
43,r_0_111_131,seq2,seq110,r_0_111_131,0.91,0,131,131,72
87,seq98,r_93_96_204,r_83_97_34,r_83_97_34,0.81,-5,29,34,72
92,seq104,r_103_48_51,seq102,r_103_48_51,1.0,0,51,51,72
37,r_66_55_154,seq64,r_4_57_24,r_66_55_154,0.75,0,154,154,72
3,r_24_30_94,r_32_146_164,seq35,r_32_146_164,1.0,0,164,164,72
39,r_26_81_121,r_25_23_81,seq78,r_26_81_121,0.99,0,121,121,72
6,r_8_49_113,r_103_48_51,r_115_50_167,r_115_50_167,0.99,-6,161,167,72
1,r_7_114_127,r_12_18_211,r_82_118_98,r_7_114_127,0.92,0,127,127,72
97,seq120,seq119,r_113_122_31,r_113_122_31,0.84,88,119,31,72
42,r_31_67_127,r_32_146_164,seq69,r_31_67_127,0.58,0,127,127,72
80,seq72,r_76_107_134,seq69,r_76_107_134,0.63,0,134,134,72
14,r_115_50_167,r_113_122_31,r_29_116_45,r_29_116_45,0.94,1,46,45,72
45,r_22_1_75,r_25_23_81,seq2,r_22_1_75,1.0,0,75,75,72
21,r_127_74_22,seq128,r_77_44_138,r_127_74_22,1.0,0,22,22,72
32,r_83_97_34,r_82_118_98,seq98,r_82_118_98,0.88,-64,34,98,72
19,r_85_36_217,seq84,r_24_30_94,r_24_30_94,0.98,122,216,94,72
15,r_56_89_40,seq54,seq90,r_56_89_40,0.99,1,41,40,72
33,r_4_57_24,seq54,r_66_55_154,r_66_55_154,0.99,6,160,154,72
11,r_82_118_98,r_85_36_217,r_29_116_45,r_82_118_98,0.99,0,98,98,72
76,seq64,r_66_55_154,r_53_65_83,r_53_65_83,0.61,18,101,83,72
11,r_82_118_98,r_83_97_34,r_85_36_217,r_83_97_34,0.51,3,37,34,72
31,r_46_126_105,seq47,seq129,r_46_126_105,1.0,0,105,105,72
3,r_24_30_94,r_25_23_81,r_32_146_164,r_24_30_94,0.99,1,95,94,72
10,r_75_144_70,r_76_107_134,seq141,r_75_144_70,1.0,0,70,70,72
26,r_77_44_138,r_76_107_134,seq42,r_77_44_138,0.76,-1,137,138,72
0,r_103_48_51,seq104,r_8_49_113,r_8_49_113,0.63,0,113,113,72
14,r_115_50_167,r_29_116_45,r_8_49_113,r_115_50_167,0.65,0,167,167,72
35,r_134_37_53,r_137_125_121,seq38,r_134_37_53,1.0,0,53,53,72
4,r_53_65_83,r_51_105_108,seq64,r_53_65_83,0.76,1,84,83,72
73,seq54,seq58,r_4_57_24,r_4_57_24,0.99,26,50,24,72
20,r_32_146_164,r_31_67_127,r_24_30_94,r_24_30_94,0.86,33,127,94,72
13,r_76_107_134,r_77_44_138,seq108,r_76_107_134,0.76,0,134,134,72
46,r_29_116_45,r_115_50_167,r_82_118_98,r_29_116_45,0.98,88,133,45,72
48,r_40_73_217,r_39_123_213,r_127_74_22,r_127_74_22,0.59,194,216,22,72
46,r_29_116_45,seq38,r_115_50_167,r_29_116_45,1.0,0,45,45,72
6,r_8_49_113,r_12_18_211,r_103_48_51,r_8_49_113,0.92,0,113,113,72
21,r_127_74_22,r_77_44_138,r_31_67_127,r_127_74_22,0.93,116,138,22,72
85,seq90,r_85_36_217,r_56_89_40,r_56_89_40,0.98,32,72,40,72
99,seq149,seq148,r_75_144_70,r_75_144_70,1.0,-1,69,70,72
27,r_94_34_90,r_93_96_204,seq35,r_94_34_90,0.98,0,90,90,72
2,r_137_125_121,seq136,r_75_144_70,r_75_144_70,1.0,54,124,70,72
40,r_14_52_104,r_12_18_211,r_3_59_67,r_14_52_104,1.0,0,104,104,72
74,seq58,seq54,r_3_59_67,r_3_59_67,1.0,21,88,67,72
18,r_79_112_170,seq78,seq110,r_79_112_170,0.84,0,170,170,72
29,r_51_105_108,r_53_65_83,r_3_59_67,r_51_105_108,0.44,-23,85,108,72
24,r_10_117_121,r_12_18_211,r_82_118_98,r_10_117_121,1.0,1,122,121,72
47,r_88_28_49,r_76_107_134,seq41,r_88_28_49,0.67,144,193,49,72
25,r_109_92_108,seq110,r_93_96_204,r_109_92_108,0.43,0,108,108,72
20,r_32_146_164,r_24_30_94,r_75_144_70,r_32_146_164,1.0,0,164,164,72
92,seq104,seq102,r_76_107_134,r_76_107_134,0.89,24,158,134,72
47,r_88_28_49,r_32_146_164,r_76_107_134,r_88_28_49,0.42,99,148,49,72
49,r_27_62_110,seq54,r_79_112_170,r_27_62_110,0.54,-68,42,110,72
68,seq38,r_33_121_214,r_134_37_53,r_134_37_53,1.0,47,100,53,72
38,r_71_138_90,r_66_55_154,r_75_144_70,r_66_55_154,1.0,-64,90,154,72
52,seq2,r_0_111_131,r_22_1_75,r_22_1_75,0.53,7,82,75,72
33,r_4_57_24,seq5,seq54,r_4_57_24,1.0,0,24,24,72
17,r_95_43_222,r_93_96_204,r_77_44_138,r_77_44_138,0.74,84,222,138,72
9,r_93_96_204,r_95_43_222,r_106_91_119,r_106_91_119,0.91,84,203,119,72
47,r_88_28_49,r_85_36_217,r_32_146_164,r_88_28_49,0.84,0,49,49,72
22,r_63_140_154,seq61,r_75_144_70,r_75_144_70,0.72,84,154,70,72
28,r_60_101_89,r_63_140_154,seq100,r_60_101_89,0.65,0,89,89,72
56,seq136,r_137_125_121,r_80_135_95,r_80_135_95,1.0,26,121,95,72
23,r_3_59_67,seq2,r_4_57_24,r_3_59_67,1.0,0,67,67,72
49,r_27_62_110,r_79_112_170,r_63_140_154,r_27_62_110,0.59,-38,72,110,72
12,r_106_91_119,seq108,r_109_92_108,r_109_92_108,1.0,12,120,108,72
25,r_109_92_108,r_93_96_204,r_106_91_119,r_106_91_119,0.97,0,119,119,72
43,r_136_118_60,r_138_100_121,r_20_117_38,r_20_117_38,0.57,24,62,38,73
40,r_31_112_12,r_29_9_33,seq109,r_31_112_12,0.96,0,12,12,73
72,seq49,r_53_80_111,r_54_50_31,r_54_50_31,0.6,2,33,31,73
1,r_137_1_149,r_120_139_4,r_147_4_27,r_147_4_27,0.48,120,147,27,73
46,r_105_38_145,seq106,r_78_32_46,r_105_38_145,0.65,0,145,145,73
42,r_63_122_182,seq64,r_73_113_76,r_73_113_76,0.99,106,182,76,73
3,r_138_100_121,seq104,r_98_131_1,r_138_100_121,0.41,59,180,121,73
48,r_128_13_38,r_127_12_136,r_11_14_2,r_128_13_38,0.58,0,38,38,73
45,r_144_140_171,seq142,r_120_139_4,r_120_139_4,0.88,167,171,4,73
39,r_147_4_27,r_143_42_78,seq2,r_147_4_27,0.96,0,27,27,73
19,r_99_116_164,seq97,r_73_113_76,r_73_113_76,0.99,88,164,76,73
36,r_74_134_44,r_73_113_76,r_120_139_4,r_120_139_4,0.89,43,47,4,73
31,r_111_124_90,seq109,seq123,r_111_124_90,0.88,0,90,90,73
41,r_102_65_98,r_101_141_135,r_81_68_31,r_102_65_98,0.52,0,98,98,73
5,r_17_10_25,r_11_14_2,r_29_9_33,r_29_9_33,0.66,6,39,33,73
3,r_138_100_121,r_137_1_149,r_101_141_135,r_137_1_149,0.22,-28,121,149,73
90,seq94,r_95_47_95,seq91,r_95_47_95,1.0,0,95,95,73
15,r_101_141_135,r_108_67_118,r_138_100_121,r_101_141_135,0.69,-13,122,135,73
14,r_18_56_92,r_107_26_5,seq57,r_18_56_92,1.0,-2,90,92,73
35,r_71_48_53,r_69_40_66,r_54_50_31,r_69_40_66,0.62,-13,53,66,73
4,r_95_47_95,seq94,r_45_46_31,r_95_47_95,0.96,0,95,95,73
78,seq64,r_63_122_182,r_55_61_7,r_63_122_182,0.46,-8,174,182,73
0,r_84_3_149,seq86,r_147_4_27,r_84_3_149,0.57,0,149,149,73
98,seq123,seq125,r_111_124_90,r_111_124_90,0.91,30,120,90,73
15,r_101_141_135,r_102_65_98,r_108_67_118,r_101_141_135,0.76,-45,90,135,73
30,r_54_50_31,r_53_80_111,seq49,r_54_50_31,0.7,0,31,31,73
6,r_143_42_78,r_144_140_171,seq41,r_143_42_78,1.0,1,79,78,73
34,r_135_129_57,r_138_100_121,seq130,r_135_129_57,0.7,2,59,57,73
8,r_85_21_28,r_84_3_149,seq24,r_85_21_28,0.99,0,28,28,73
25,r_11_14_2,seq6,r_128_13_38,r_128_13_38,0.98,0,38,38,73
26,r_81_68_31,seq79,seq59,r_81_68_31,0.71,10,41,31,73
2,r_108_67_118,r_105_38_145,r_101_141_135,r_101_141_135,0.77,-38,97,135,73
47,r_5_30_68,seq2,seq37,r_5_30_68,1.0,0,68,68,73
18,r_73_113_76,seq70,seq114,r_73_113_76,0.55,0,76,76,73
29,r_76_23_185,seq77,r_85_21_28,r_85_21_28,0.76,157,185,28,73
24,r_69_40_66,seq70,seq37,r_69_40_66,0.99,1,67,66,73
58,seq142,r_144_140_171,r_98_131_1,r_98_131_1,0.94,170,171,1,73
70,seq41,seq58,r_143_42_78,r_143_42_78,1.0,-1,77,78,73
20,r_53_80_111,seq58,seq79,r_53_80_111,0.43,0,111,111,73
32,r_120_139_4,r_137_1_149,r_148_146_43,r_137_1_149,0.94,-1,148,149,73
10,r_20_117_38,r_19_60_39,seq114,r_20_117_38,0.78,0,38,38,73
14,r_18_56_92,r_17_10_25,r_107_26_5,r_18_56_92,0.83,-80,12,92,73
75,seq57,seq59,r_18_56_92,r_18_56_92,1.0,1,93,92,73
81,seq79,seq86,r_53_80_111,r_53_80_111,0.55,47,158,111,73
9,r_36_66_91,seq37,r_81_68_31,r_36_66_91,0.94,0,91,91,73
27,r_78_32_46,seq79,seq35,r_78_32_46,0.93,11,57,46,73
26,r_81_68_31,seq59,r_108_67_118,r_108_67_118,1.0,0,118,118,73
2,r_108_67_118,r_101_141_135,r_36_66_91,r_108_67_118,0.94,0,118,118,73
3,r_138_100_121,r_101_141_135,seq104,r_138_100_121,0.55,14,135,121,73
22,r_127_12_136,seq125,r_11_14_2,r_127_12_136,0.91,0,136,136,73
28,r_28_62_30,r_29_9_33,seq64,r_28_62_30,0.94,1,31,30,73
91,seq97,r_99_116_164,seq88,r_99_116_164,0.75,-18,146,164,73
5,r_17_10_25,r_18_56_92,r_11_14_2,r_17_10_25,0.88,2,27,25,73
20,r_53_80_111,r_54_50_31,seq58,r_54_50_31,0.56,0,31,31,73
15,r_101_141_135,r_138_100_121,r_148_146_43,r_101_141_135,0.78,0,135,135,73
44,r_121_27_147,r_119_34_166,r_107_26_5,r_107_26_5,0.65,142,147,5,73
23,r_119_34_166,seq125,r_20_117_38,r_20_117_38,1.0,12,50,38,73
57,seq130,seq132,r_135_129_57,r_135_129_57,0.79,2,59,57,73
38,r_19_60_39,seq24,r_55_61_7,r_19_60_39,1.0,2,41,39,73
7,r_29_9_33,r_36_66_91,r_17_10_25,r_29_9_33,1.0,0,33,33,73
23,r_119_34_166,r_20_117_38,r_69_40_66,r_69_40_66,0.48,100,166,66,73
30,r_11_55_135,r_10_77_159,r_66_54_27,r_11_55_135,0.91,0,135,135,74
48,r_80_31_13,r_34_53_91,r_56_30_61,r_80_31_13,0.98,54,67,13,74
8,r_29_25_74,r_34_53_91,r_19_27_69,r_34_53_91,1.0,-17,74,91,74
86,seq81,r_79_117_118,r_33_82_5,r_79_117_118,0.87,0,118,118,74
16,r_76_67_80,seq78,seq68,r_76_67_80,0.98,0,80,80,74
39,r_106_3_119,seq107,seq5,r_106_3_119,0.97,0,119,119,74
1,r_20_75_86,r_21_58_151,seq78,r_20_75_86,0.93,0,86,86,74
5,r_90_121_105,r_91_50_73,seq89,r_91_50_73,1.0,0,73,73,74
46,r_46_43_181,r_47_88_103,seq48,r_47_88_103,0.99,1,104,103,74
42,r_34_53_91,r_32_102_19,r_80_31_13,r_34_53_91,0.78,-72,19,91,74
3,r_111_87_181,r_79_117_118,r_47_88_103,r_111_87_181,0.94,0,181,181,74
45,r_143_118_98,r_146_83_187,r_101_110_201,r_146_83_187,0.39,-113,74,187,74
19,r_119_40_134,r_115_45_194,seq39,r_119_40_134,0.89,0,134,134,74
21,r_32_102_19,r_34_53_91,r_101_110_201,r_32_102_19,0.97,0,19,19,74
38,r_28_104_57,r_101_110_201,r_44_103_165,r_44_103_165,0.95,0,165,165,74
41,r_56_30_61,r_52_37_159,r_80_31_13,r_56_30_61,1.0,0,61,61,74
12,r_145_62_27,r_146_83_187,r_52_37_159,r_145_62_27,1.0,0,27,27,74
3,r_111_87_181,r_112_86_147,r_79_117_118,r_79_117_118,0.83,29,147,118,74
45,r_143_118_98,r_101_110_201,r_115_45_194,r_143_118_98,0.88,0,98,98,74
78,seq137,r_138_63_68,r_70_136_4,r_138_63_68,1.0,0,68,68,74
0,r_65_60_74,seq68,r_122_59_18,r_65_60_74,0.97,0,74,74,74
63,seq18,r_4_24_139,r_13_17_84,r_4_24_139,0.68,-47,92,139,74
73,seq129,r_127_144_162,r_84_126_30,r_84_126_30,0.76,130,160,30,74
11,r_133_15_73,seq134,seq18,r_133_15_73,1.0,0,73,73,74
9,r_128_93_32,r_127_144_162,seq94,r_128_93_32,1.0,0,32,32,74
48,r_80_31_13,r_84_126_30,r_34_53_91,r_80_31_13,0.99,0,13,13,74
79,seq57,r_52_37_159,r_122_59_18,r_122_59_18,0.88,6,24,18,74
20,r_72_61_76,seq71,r_145_62_27,r_72_61_76,0.97,0,76,76,74
98,seq120,seq123,r_90_121_105,r_90_121_105,1.0,5,110,105,74
46,r_46_43_181,seq48,r_147_42_5,r_46_43_181,0.89,0,181,181,74
15,r_47_88_103,r_46_43_181,seq85,r_47_88_103,0.9,0,103,103,74
12,r_145_62_27,r_52_37_159,r_72_61_76,r_145_62_27,0.78,63,90,27,74
99,seq123,seq120,r_84_126_30,r_84_126_30,1.0,107,137,30,74
26,r_116_105_39,r_119_40_134,seq107,r_119_40_134,0.52,-93,41,134,74
2,r_52_37_159,seq51,r_147_42_5,r_52_37_159,0.75,0,159,159,74
37,r_109_73_53,seq107,seq71,r_109_73_53,1.0,0,53,53,74
40,r_138_63_68,seq137,r_145_62_27,r_138_63_68,0.78,0,68,68,74
74,seq41,r_44_103_165,r_147_42_5,r_44_103_165,0.8,0,165,165,74
29,r_13_17_84,seq14,seq18,r_13_17_84,0.43,30,114,84,74
22,r_84_126_30,r_116_105_39,r_16_125_49,r_16_125_49,0.91,1,50,49,74
33,r_127_144_162,seq129,r_124_149_6,r_127_144_162,0.56,0,162,162,74
27,r_122_59_18,seq123,seq57,r_122_59_18,1.0,0,18,18,74
88,seq89,r_90_121_105,r_74_92_7,r_90_121_105,0.92,0,105,105,74
85,seq78,r_20_75_86,r_10_77_159,r_10_77_159,0.98,0,159,159,74
42,r_34_53_91,r_80_31_13,seq51,r_34_53_91,1.0,1,92,91,74
32,r_146_83_187,seq148,r_33_82_5,r_33_82_5,0.59,182,187,5,74
22,r_84_126_30,seq85,r_116_105_39,r_84_126_30,0.97,0,30,30,74
77,seq51,r_52_37_159,r_91_50_73,r_91_50_73,0.83,75,148,73,74
34,r_91_50_73,r_90_121_105,seq48,r_91_50_73,0.99,0,73,73,74
81,seq68,seq64,r_76_67_80,r_76_67_80,1.0,17,97,80,74
17,r_10_77_159,r_11_55_135,seq12,r_11_55_135,0.79,0,135,135,74
7,r_124_149_6,r_122_59_18,seq148,r_124_149_6,0.75,4,10,6,74
47,r_16_125_49,seq18,r_84_126_30,r_16_125_49,1.0,0,49,49,74
10,r_49_142_50,seq48,seq140,r_49_142_50,1.0,0,50,50,74
6,r_66_54_27,seq64,r_145_62_27,r_66_54_27,0.9,0,27,27,74
17,r_10_77_159,seq12,seq78,r_10_77_159,0.89,0,159,159,74
49,r_8_99_113,r_10_77_159,r_32_102_19,r_8_99_113,0.44,0,113,113,74
87,seq85,r_84_126_30,r_33_82_5,r_84_126_30,0.99,0,30,30,74
44,r_44_103_165,seq41,r_28_104_57,r_28_104_57,0.59,108,165,57,74
23,r_112_86_147,r_111_87_181,r_47_88_103,r_112_86_147,0.75,0,147,147,74
35,r_79_117_118,seq81,r_143_118_98,r_79_117_118,0.96,0,118,118,74
38,r_28_104_57,seq26,r_101_110_201,r_28_104_57,0.99,0,57,57,74
36,r_4_116_127,seq3,r_118_117_191,r_4_116_127,0.98,2,129,127,75
8,r_86_124_108,seq85,seq126,r_86_124_108,0.75,0,108,108,75
43,r_69_46_119,seq68,r_45_28_170,r_69_46_119,0.83,0,119,119,75
0,r_11_108_27,r_8_110_145,r_106_73_154,r_11_108_27,1.0,0,27,27,75
50,seq1,r_4_116_127,r_78_0_17,r_78_0_17,0.64,3,20,17,75
59,seq15,seq9,r_82_14_100,r_82_14_100,1.0,22,122,100,75
19,r_80_17_69,r_16_18_159,r_48_66_111,r_16_18_159,0.41,0,159,159,75
86,seq85,r_86_124_108,seq88,r_86_124_108,1.0,-10,98,108,75
16,r_51_107_82,r_54_38_147,r_11_108_27,r_51_107_82,0.89,0,82,82,75
21,r_118_117_191,r_115_100_172,r_4_116_127,r_4_116_127,0.98,45,172,127,75
1,r_16_18_159,r_80_17_69,seq19,r_16_18_159,0.54,0,159,159,75
1,r_16_18_159,r_43_27_56,r_80_17_69,r_16_18_159,0.53,-88,71,159,75
5,r_131_136_6,r_135_40_128,r_84_134_67,r_84_134_67,0.73,61,128,67,75
80,seq71,seq74,r_6_72_85,r_6_72_85,1.0,3,88,85,75
92,seq96,seq104,r_50_98_20,r_50_98_20,1.0,0,20,20,75
20,r_50_98_20,r_51_107_82,seq96,r_50_98_20,1.0,0,20,20,75
45,r_82_14_100,seq83,seq15,r_82_14_100,0.98,0,100,100,75
19,r_80_17_69,seq79,r_16_18_159,r_80_17_69,0.99,0,69,69,75
15,r_55_109_158,r_128_56_29,r_143_112_55,r_55_109_158,0.79,1,159,158,75
33,r_127_64_15,r_55_109_158,seq52,r_55_109_158,0.98,-47,111,158,75
76,seq62,r_59_76_175,r_20_61_140,r_59_76_175,0.6,0,175,175,75
31,r_8_110_145,seq9,seq111,r_8_110_145,0.87,0,145,145,75
43,r_69_46_119,r_45_28_170,seq47,r_45_28_170,0.95,0,170,170,75
19,r_80_17_69,r_48_66_111,r_43_27_56,r_43_27_56,0.71,118,174,56,75
28,r_128_56_29,seq129,r_55_109_158,r_128_56_29,1.0,0,29,29,75
30,r_42_144_20,seq41,r_149_145_204,r_42_144_20,0.89,0,20,20,75
10,r_93_75_177,seq92,r_59_76_175,r_93_75_177,0.27,0,177,177,75
26,r_78_0_17,r_80_17_69,seq1,r_78_0_17,0.8,0,17,17,75
72,seq41,r_55_109_158,seq22,r_55_109_158,0.43,-59,99,158,75
11,r_143_112_55,seq146,seq111,r_143_112_55,1.0,0,55,55,75
72,seq41,seq22,r_135_40_128,r_135_40_128,0.87,7,135,128,75
27,r_114_7_181,r_143_112_55,r_102_12_133,r_114_7_181,0.82,0,181,181,75
37,r_106_73_154,r_114_7_181,r_11_108_27,r_11_108_27,0.99,19,46,27,75
98,seq121,r_122_89_103,r_118_117_191,r_122_89_103,1.0,-27,76,103,75
4,r_60_25_11,r_24_29_181,r_43_27_56,r_60_25_11,0.41,153,164,11,75
62,seq19,r_20_61_140,seq22,r_20_61_140,0.95,3,143,140,75
40,r_26_97_53,seq31,r_50_98_20,r_26_97_53,0.87,0,53,53,75
99,seq126,seq121,r_86_124_108,r_86_124_108,0.95,41,149,108,75
0,r_11_108_27,r_106_73_154,r_51_107_82,r_51_107_82,0.94,66,148,82,75
27,r_114_7_181,r_113_139_156,r_143_112_55,r_143_112_55,1.0,100,155,55,75
69,seq35,seq37,r_43_27_56,r_43_27_56,0.49,94,150,56,75
2,r_24_29_181,r_60_25_11,r_44_30_163,r_60_25_11,0.33,172,183,11,75
47,r_63_39_87,seq62,seq37,r_63_39_87,0.86,0,87,87,75
74,seq52,r_53_142_174,seq47,r_53_142_174,0.47,0,174,174,75
29,r_45_28_170,r_44_30_163,r_69_46_119,r_69_46_119,0.71,22,141,119,75
24,r_6_72_85,seq9,seq71,r_6_72_85,0.92,1,86,85,75
33,r_127_64_15,seq126,r_55_109_158,r_127_64_15,0.4,0,15,15,75
32,r_23_10_82,seq22,seq9,r_23_10_82,0.95,0,82,82,75
38,r_102_12_133,seq101,r_13_21_191,r_102_12_133,0.53,0,133,133,75
77,seq65,r_55_109_158,r_48_66_111,r_55_109_158,0.96,-23,135,158,75
15,r_55_109_158,seq58,r_128_56_29,r_128_56_29,0.99,17,46,29,75
29,r_45_28_170,r_69_46_119,r_44_30_163,r_45_28_170,0.59,0,170,170,75
4,r_60_25_11,r_20_61_140,r_24_29_181,r_24_29_181,0.78,-170,11,181,75
34,r_120_140_11,r_118_117_191,seq141,r_120_140_11,0.97,0,11,11,75
60,seq141,seq138,r_120_140_11,r_120_140_11,0.69,67,78,11,75
17,r_54_38_147,r_53_142_174,r_63_39_87,r_53_142_174,0.99,-27,147,174,75
9,r_133_57_125,seq132,seq58,r_133_57_125,0.97,0,125,125,75
37,r_106_73_154,r_11_108_27,seq71,r_106_73_154,0.91,0,154,154,75
28,r_128_56_29,r_55_109_158,seq58,r_55_109_158,0.96,2,160,158,75
22,r_44_30_163,r_45_28_170,seq32,r_45_28_170,0.3,-7,163,170,75
91,seq94,r_95_105_159,seq85,r_95_105_159,0.67,0,159,159,75
49,r_84_134_67,r_86_124_108,r_131_136_6,r_84_134_67,0.99,0,67,67,75
55,seq129,r_128_56_29,seq130,r_128_56_29,0.57,0,29,29,75
7,r_115_100_172,r_118_117_191,r_50_98_20,r_118_117_191,0.57,-19,172,191,75
44,r_122_89_103,seq121,seq90,r_122_89_103,0.99,0,103,103,75
23,r_95_105_159,seq94,r_50_98_20,r_50_98_20,0.54,139,159,20,75
35,r_113_139_156,r_114_7_181,seq138,r_113_139_156,0.88,0,156,156,75
12,r_135_40_128,r_131_136_6,seq41,r_135_40_128,0.68,0,128,128,75
39,r_123_67_42,r_122_89_103,seq68,r_123_67_42,0.83,0,42,42,75
30,r_111_21_182,seq110,seq20,r_111_21_182,0.28,0,182,182,76
14,r_133_131_105,r_134_92_76,r_114_129_59,r_133_131_105,0.91,-29,76,105,76
43,r_25_1_92,seq27,r_65_2_59,r_25_1_92,0.96,0,92,92,76
55,seq141,r_142_26_34,r_144_146_140,r_142_26_34,1.0,-11,23,34,76
25,r_40_0_11,seq8,r_65_2_59,r_65_2_59,0.96,-2,57,59,76
37,r_148_139_92,r_144_146_140,r_105_140_62,r_105_140_62,0.98,30,92,62,76
26,r_71_3_99,r_73_76_73,seq8,r_71_3_99,0.76,-2,97,99,76
27,r_114_129_59,r_112_7_121,r_17_130_38,r_114_129_59,0.98,0,59,59,76
5,r_143_69_153,r_144_146_140,r_54_67_3,r_143_69_153,0.87,0,153,153,76
46,r_44_68_172,r_41_4_183,r_54_67_3,r_41_4_183,0.39,-10,173,183,76
32,r_90_43_118,seq89,r_75_42_33,r_90_43_118,0.99,0,118,118,76
45,r_80_128_112,r_84_87_135,r_133_131_105,r_80_128_112,1.0,0,112,112,76
69,seq136,r_138_109_160,r_10_137_117,r_10_137_117,0.96,5,122,117,76
10,r_127_19_66,r_133_131_105,r_17_130_38,r_17_130_38,0.77,10,48,38,76
19,r_134_92_76,r_133_131_105,seq93,r_134_92_76,0.99,0,76,76,76
31,r_17_130_38,seq27,r_127_19_66,r_17_130_38,0.92,0,38,38,76
16,r_48_36_36,r_49_103_142,seq34,r_48_36_36,0.83,2,38,36,76
66,seq39,r_38_61_102,seq47,r_38_61_102,0.72,0,102,102,76
76,seq82,seq83,r_104_81_67,r_104_81_67,1.0,3,70,67,76
41,r_79_50_181,seq83,seq47,r_79_50_181,0.73,1,182,181,76
26,r_71_3_99,r_72_37_83,r_73_76_73,r_72_37_83,0.82,0,83,83,76
16,r_48_36_36,seq34,r_72_37_83,r_72_37_83,1.0,20,103,83,76
40,r_123_78_37,seq120,seq77,r_123_78_37,1.0,0,37,37,76
4,r_57_149_163,seq59,r_144_146_140,r_57_149_163,0.58,0,163,163,76
18,r_41_4_183,r_44_68_172,r_75_42_33,r_75_42_33,1.0,19,52,33,76
0,r_138_109_160,seq136,r_60_116_74,r_60_116_74,0.99,86,160,74,76
11,r_66_147_91,r_54_67_3,r_144_146_140,r_66_147_91,1.0,0,91,91,76
20,r_104_81_67,r_112_7_121,seq82,r_104_81_67,1.0,0,67,67,76
8,r_142_26_34,seq141,r_62_28_21,r_142_26_34,1.0,0,34,34,76
36,r_13_135_15,r_15_5_89,seq132,r_13_135_15,0.97,2,17,15,76
6,r_56_18_69,seq53,r_127_19_66,r_127_19_66,0.78,3,69,66,76
99,seq126,r_125_106_131,seq124,r_125_106_131,0.75,0,131,131,76
22,r_75_42_33,r_41_4_183,r_91_55_91,r_91_55_91,1.0,97,188,91,76
22,r_75_42_33,r_73_76_73,r_41_4_183,r_75_42_33,1.0,0,33,33,76
2,r_119_117_178,seq120,r_138_109_160,r_138_109_160,0.99,16,176,160,76
47,r_10_137_117,seq11,seq136,r_10_137_117,1.0,0,117,117,76
29,r_15_5_89,seq14,seq8,r_15_5_89,1.0,0,89,89,76
24,r_98_6_134,seq102,r_15_5_89,r_98_6_134,0.94,0,134,134,76
33,r_112_7_121,seq113,r_71_3_99,r_112_7_121,0.91,0,121,121,76
50,seq132,r_133_131_105,r_13_135_15,r_13_135_15,0.76,97,112,15,76
70,seq53,r_52_16_155,r_91_55_91,r_91_55_91,1.0,36,127,91,76
32,r_90_43_118,r_91_55_91,seq89,r_91_55_91,0.99,0,91,91,76
38,r_72_37_83,r_71_3_99,r_48_36_36,r_72_37_83,1.0,0,83,83,76
34,r_45_35_139,r_49_103_142,r_72_37_83,r_45_35_139,0.82,0,139,139,76
39,r_62_28_21,seq63,r_142_26_34,r_142_26_34,0.59,0,34,34,76
81,seq89,r_90_43_118,seq88,r_90_43_118,1.0,-10,108,118,76
17,r_60_116_74,seq59,seq115,r_60_116_74,1.0,0,74,74,76
9,r_73_76_73,r_72_37_83,r_123_78_37,r_73_76_73,0.95,0,73,73,76
28,r_38_61_102,seq39,seq59,r_38_61_102,0.62,0,102,102,76
31,r_17_130_38,r_127_19_66,r_114_129_59,r_17_130_38,0.59,24,62,38,76
49,r_105_140_62,seq107,r_148_139_92,r_105_140_62,0.99,1,63,62,76
75,seq77,r_73_76_73,r_123_78_37,r_123_78_37,1.0,0,37,37,76
44,r_49_103_142,seq47,seq99,r_49_103_142,0.64,0,142,142,76
23,r_94_74_182,seq93,r_123_78_37,r_123_78_37,0.99,145,182,37,76
82,seq93,r_94_74_182,r_134_92_76,r_134_92_76,1.0,106,182,76,76
42,r_65_2_59,seq70,r_40_0_11,r_65_2_59,0.8,0,59,59,76
35,r_29_24_172,seq34,r_142_26_34,r_142_26_34,0.86,138,172,34,76
12,r_52_16_155,seq53,r_56_18_69,r_56_18_69,0.55,86,155,69,76
30,r_23_94_190,seq27,r_57_103_75,r_57_103_75,0.57,112,187,75,77
36,r_100_112_184,r_101_120_107,r_57_103_75,r_57_103_75,1.0,18,93,75,77
8,r_71_113_63,r_72_96_141,r_114_121_134,r_71_113_63,0.59,3,66,63,77
53,seq133,r_132_99_160,seq146,r_132_99_160,0.55,0,160,160,77
37,r_109_39_120,seq107,r_38_9_180,r_109_39_120,0.95,0,120,120,77
5,r_57_103_75,r_56_13_45,seq54,r_56_13_45,0.78,1,46,45,77
71,seq44,r_46_52_133,seq47,r_46_52_133,1.0,0,133,133,77
16,r_46_52_133,seq44,seq51,r_46_52_133,0.94,1,134,133,77
39,r_68_131_184,seq69,r_140_123_145,r_68_131_184,0.86,0,184,184,77
1,r_127_92_106,seq128,seq88,r_127_92_106,0.71,0,106,106,77
46,r_61_55_199,r_59_12_98,r_40_60_28,r_61_55_199,0.98,-101,98,199,77
43,r_126_4_40,seq122,seq6,r_126_4_40,1.0,0,40,40,77
80,seq65,seq62,r_144_66_148,r_144_66_148,1.0,7,155,148,77
19,r_140_123_145,r_144_66_148,seq122,r_144_66_148,0.65,-3,145,148,77
31,r_132_99_160,seq133,r_35_97_81,r_35_97_81,1.0,79,160,81,77
67,seq31,r_34_117_157,r_77_33_53,r_77_33_53,0.81,83,136,53,77
89,seq93,r_101_120_107,r_57_103_75,r_57_103_75,1.0,36,111,75,77
10,r_53_105_63,seq51,r_136_106_30,r_53_105_63,1.0,0,63,63,77
90,seq98,r_101_120_107,r_35_97_81,r_35_97_81,0.98,8,89,81,77
26,r_41_149_116,r_38_9_180,r_8_42_74,r_8_42_74,1.0,5,79,74,77
8,r_71_113_63,r_114_121_134,r_100_112_184,r_71_113_63,0.83,72,135,63,77
5,r_57_103_75,seq54,seq102,r_57_103_75,1.0,-1,74,75,77
20,r_8_42_74,r_41_149_116,seq36,r_41_149_116,1.0,-2,114,116,77
0,r_74_22_168,seq73,r_10_25_144,r_74_22_168,0.78,0,168,168,77
11,r_104_85_170,r_101_120_107,r_57_103_75,r_57_103_75,1.0,26,101,75,77
29,r_45_110_57,r_43_18_68,seq111,r_45_110_57,1.0,0,57,57,77
20,r_8_42_74,seq11,r_41_149_116,r_8_42_74,0.63,1,75,74,77
13,r_43_18_68,seq44,seq15,r_43_18_68,0.98,0,68,68,77
44,r_138_78_215,r_144_66_148,r_17_137_50,r_17_137_50,0.56,1,51,50,77
15,r_101_120_107,r_104_85_170,seq119,r_101_120_107,0.89,0,107,107,77
25,r_38_9_180,r_8_42_74,r_109_39_120,r_109_39_120,1.0,0,120,120,77
4,r_70_142_54,r_141_67_156,seq146,r_141_67_156,1.0,0,156,156,77
48,r_77_33_53,r_83_148_122,seq31,r_77_33_53,1.0,0,53,53,77
85,seq86,seq88,r_81_87_155,r_81_87_155,0.54,-39,116,155,77
9,r_14_135_36,seq15,seq134,r_14_135_36,1.0,0,36,36,77
26,r_41_149_116,r_8_42_74,seq146,r_41_149_116,1.0,0,116,116,77
25,r_38_9_180,r_109_39_120,r_59_12_98,r_38_9_180,0.82,0,180,180,77
45,r_64_28_48,seq62,seq30,r_64_28_48,1.0,0,48,48,77
27,r_34_117_157,seq31,r_101_120_107,r_34_117_157,0.93,0,157,157,77
6,r_17_137_50,r_16_89_95,r_138_78_215,r_138_78_215,0.76,-165,50,215,77
79,seq62,seq65,r_144_66_148,r_144_66_148,1.0,19,167,148,77
79,seq62,r_64_28_48,seq65,r_64_28_48,1.0,0,48,48,77
47,r_16_89_95,seq15,seq88,r_16_89_95,0.99,0,95,95,77
40,r_5_3_98,seq6,r_21_0_15,r_5_3_98,0.75,0,98,98,77
18,r_72_96_141,seq73,r_80_95_86,r_72_96_141,0.43,2,143,141,77
3,r_136_106_30,seq107,r_53_105_63,r_53_105_63,1.0,15,78,63,77
32,r_125_116_16,r_126_4_40,seq115,r_126_4_40,0.82,-27,13,40,77
25,r_38_9_180,r_41_149_116,r_8_42_74,r_8_42_74,1.0,5,79,74,77
33,r_32_139_117,r_34_117_157,seq146,r_32_139_117,0.82,0,117,117,77
2,r_56_13_45,r_57_103_75,seq15,r_56_13_45,1.0,1,46,45,77
6,r_17_137_50,r_138_78_215,r_14_135_36,r_17_137_50,0.42,138,188,50,77
24,r_144_66_148,seq65,r_141_67_156,r_141_67_156,0.56,11,167,156,77
38,r_80_95_86,r_83_148_122,r_57_103_75,r_57_103_75,1.0,25,100,75,77
4,r_70_142_54,r_68_131_184,r_141_67_156,r_70_142_54,1.0,0,54,54,77
41,r_40_60_28,r_41_149_116,r_61_55_199,r_40_60_28,1.0,0,28,28,77
34,r_81_87_155,r_83_148_122,seq86,r_83_148_122,0.85,0,122,122,77
75,seq51,r_53_105_63,seq58,r_53_105_63,0.57,0,63,63,77
3,r_136_106_30,seq134,seq107,r_136_106_30,0.8,3,33,30,77
17,r_83_148_122,r_81_87_155,r_41_149_116,r_41_149_116,0.98,6,122,116,77
94,seq111,seq107,r_45_110_57,r_45_110_57,1.0,46,103,57,77
37,r_109_39_120,r_38_9_180,r_8_42_74,r_38_9_180,0.99,0,180,180,77
22,r_35_97_81,seq36,seq98,r_35_97_81,1.0,0,81,81,77
91,seq102,r_101_120_107,r_57_103_75,r_57_103_75,1.0,25,100,75,77
77,seq134,r_136_106_30,r_14_135_36,r_14_135_36,0.87,0,36,36,77
12,r_21_0_15,r_17_137_50,seq1,r_17_137_50,0.47,-38,12,50,77
7,r_59_12_98,r_61_55_199,seq11,r_59_12_98,0.98,0,98,98,77
23,r_19_84_94,seq20,seq75,r_19_84_94,1.0,0,94,94,77
75,seq51,seq58,r_46_52_133,r_46_52_133,1.0,-53,80,133,77
35,r_10_25_144,seq11,seq26,r_10_25_144,0.86,0,144,144,77
92,seq105,r_107_33_165,r_52_131_127,r_52_131_127,0.78,36,163,127,78
26,r_94_134_43,seq96,r_135_37_125,r_94_134_43,0.8,0,43,43,78
83,seq76,r_75_123_130,seq78,r_75_123_130,0.99,0,130,130,78
3,r_135_37_125,r_94_134_43,r_38_119_189,r_135_37_125,0.99,0,125,125,78
31,r_25_140_152,r_26_19_35,r_31_15_183,r_25_140_152,0.61,-112,40,152,78
3,r_135_37_125,r_38_119_189,seq39,r_38_119_189,0.97,0,189,189,78
55,seq5,r_6_87_177,seq9,r_6_87_177,0.76,-43,134,177,78
21,r_34_79_75,r_26_19_35,seq78,r_34_79_75,1.0,0,75,75,78
5,r_149_99_174,seq148,r_117_101_95,r_117_101_95,0.52,79,174,95,78
46,r_14_127_135,seq18,r_52_131_127,r_14_127_135,0.78,0,135,135,78
42,r_80_1_99,r_75_123_130,seq2,r_80_1_99,1.0,0,99,99,78
39,r_145_132_53,r_146_71_191,seq130,r_145_132_53,0.97,1,54,53,78
83,seq76,seq78,r_7_77_169,r_7_77_169,1.0,0,169,169,78
11,r_66_35_10,r_34_79_75,seq29,r_34_79_75,1.0,1,76,75,78
23,r_88_48_51,r_91_85_148,r_44_50_19,r_88_48_51,1.0,0,51,51,78
27,r_38_119_189,r_135_37_125,r_110_111_6,r_38_119_189,0.91,0,189,189,78
74,seq58,r_43_32_176,r_54_57_171,r_54_57_171,0.59,0,171,171,78
3,r_135_37_125,seq105,r_94_134_43,r_135_37_125,0.89,-67,58,125,78
6,r_83_72_31,r_91_85_148,seq74,r_83_72_31,1.0,0,31,31,78
10,r_136_17_139,r_137_10_168,r_116_13_102,r_137_10_168,0.91,-29,139,168,78
4,r_61_20_107,seq60,r_26_19_35,r_61_20_107,0.88,0,107,107,78
0,r_106_30_150,r_107_33_165,r_81_27_95,r_81_27_95,0.73,55,150,95,78
73,seq53,r_54_57_171,r_86_47_32,r_86_47_32,1.0,138,170,32,78
20,r_146_71_191,seq148,r_83_72_31,r_83_72_31,0.96,160,191,31,78
13,r_125_142_146,seq126,r_108_144_53,r_108_144_53,0.66,100,153,53,78
22,r_86_47_32,r_91_85_148,r_44_50_19,r_86_47_32,1.0,0,32,32,78
40,r_139_21_124,r_98_65_195,r_61_20_107,r_139_21_124,0.96,1,125,124,78
48,r_81_27_95,r_80_1_99,seq29,r_81_27_95,0.95,0,95,95,78
44,r_12_55_184,seq9,r_86_47_32,r_12_55_184,0.84,0,184,184,78
27,r_38_119_189,seq39,r_135_37_125,r_135_37_125,1.0,4,129,125,78
35,r_16_95_56,r_14_127_135,r_109_93_51,r_16_95_56,1.0,0,56,56,78
2,r_31_15_183,seq29,r_116_13_102,r_116_13_102,1.0,81,183,102,78
47,r_75_123_130,seq76,seq124,r_75_123_130,0.99,0,130,130,78
40,r_139_21_124,r_149_99_174,r_98_65_195,r_139_21_124,0.51,-29,95,124,78
18,r_100_70_126,r_98_65_195,r_83_72_31,r_98_65_195,0.92,-69,126,195,78
29,r_117_101_95,r_116_13_102,r_98_65_195,r_116_13_102,0.76,1,103,102,78
24,r_11_41_142,seq8,seq39,r_11_41_142,0.96,0,142,142,78
25,r_133_36_143,seq118,r_94_134_43,r_94_134_43,0.62,21,64,43,78
33,r_52_131_127,r_54_57_171,r_145_132_53,r_52_131_127,0.95,0,127,127,78
58,seq138,r_137_10_168,r_52_131_127,r_52_131_127,0.97,42,169,127,78
32,r_115_0_159,seq113,r_80_1_99,r_115_0_159,0.87,0,159,159,78
38,r_107_33_165,seq105,r_81_27_95,r_107_33_165,0.75,0,165,165,78
52,seq2,seq58,r_88_48_51,r_88_48_51,0.58,7,58,51,78
34,r_98_65_195,r_100_70_126,r_117_101_95,r_100_70_126,0.75,0,126,126,78
52,seq2,r_88_48_51,r_80_1_99,r_80_1_99,0.9,2,101,99,78
17,r_137_10_168,seq138,seq9,r_137_10_168,0.59,0,168,168,78
25,r_133_36_143,r_94_134_43,r_135_37_125,r_94_134_43,1.0,97,140,43,78
9,r_143_73_67,r_149_99_174,r_83_72_31,r_143_73_67,0.44,0,67,67,78
26,r_94_134_43,r_135_37_125,r_145_132_53,r_135_37_125,1.0,0,125,125,78
31,r_25_140_152,r_31_15_183,r_117_101_95,r_25_140_152,0.73,0,152,152,78
28,r_26_19_35,r_25_140_152,r_61_20_107,r_26_19_35,0.96,73,108,35,78
91,seq103,r_102_49_129,r_117_101_95,r_102_49_129,0.58,0,129,129,78
49,r_43_32_176,seq45,r_107_33_165,r_107_33_165,0.76,11,176,165,78
7,r_116_13_102,r_117_101_95,seq18,r_116_13_102,1.0,1,103,102,78
44,r_12_55_184,r_11_41_142,seq9,r_11_41_142,0.83,0,142,142,78
43,r_109_93_51,seq105,r_16_95_56,r_109_93_51,0.57,4,55,51,78
1,r_44_50_19,r_43_32_176,seq51,r_44_50_19,0.77,1,20,19,78
84,seq78,seq76,r_34_79_75,r_34_79_75,1.0,73,148,75,78
40,r_28_134_28,seq146,r_18_144_70,r_18_144_70,1.0,44,114,70,79
30,r_78_12_71,seq79,seq13,r_78_12_71,0.99,0,71,71,79
8,r_39_132_74,r_40_136_115,seq129,r_39_132_74,0.72,1,75,74,79
4,r_130_148_56,r_131_99_55,seq146,r_131_99_55,0.74,-2,53,55,79
35,r_109_83_20,seq110,seq84,r_109_83_20,0.91,0,20,20,79
37,r_29_113_176,r_30_89_123,r_1_31_104,r_30_89_123,0.78,-1,122,123,79
3,r_100_147_148,seq102,seq146,r_100_147_148,0.93,0,148,148,79
26,r_86_105_84,r_104_142_168,seq102,r_86_105_84,0.47,26,110,84,79
16,r_55_76_142,seq54,r_59_77_33,r_55_76_142,0.75,0,142,142,79
39,r_4_22_151,seq6,seq23,r_4_22_151,0.55,0,151,151,79
5,r_0_73_79,r_1_31_104,seq72,r_0_73_79,0.9,0,79,79,79
25,r_51_25_83,r_30_89_123,r_56_24_102,r_30_89_123,0.99,1,124,123,79
80,seq81,seq84,r_36_82_106,r_36_82_106,0.99,5,111,106,79
19,r_137_16_12,r_149_47_96,seq15,r_137_16_12,0.89,0,12,12,79
86,seq97,r_98_52_49,r_104_142_168,r_98_52_49,1.0,-2,47,49,79
38,r_1_31_104,seq3,r_125_2_40,r_125_2_40,1.0,0,40,40,79
38,r_1_31_104,r_125_2_40,seq26,r_1_31_104,0.89,0,104,104,79
31,r_50_128_87,r_56_24_102,r_39_132_74,r_56_24_102,1.0,-13,89,102,79
41,r_104_142_168,r_101_120_86,r_86_105_84,r_104_142_168,0.8,-82,86,168,79
28,r_21_92_30,seq20,r_94_71_93,r_21_92_30,0.99,-1,29,30,79
3,r_100_147_148,r_101_120_86,seq102,r_101_120_86,0.91,0,86,86,79
40,r_28_134_28,r_30_89_123,seq146,r_28_134_28,0.95,0,28,28,79
11,r_131_99_55,r_130_148_56,seq97,r_131_99_55,0.98,0,55,55,79
0,r_141_95_4,r_96_64_176,seq93,r_96_64_176,0.73,0,176,176,79
63,seq38,r_36_82_106,seq42,r_36_82_106,0.96,-32,74,106,79
20,r_94_71_93,r_96_64_176,seq70,r_94_71_93,0.86,0,93,93,79
15,r_53_139_71,r_55_76_142,seq138,r_53_139_71,0.99,0,71,71,79
48,r_14_44_99,seq15,r_127_43_22,r_14_44_99,0.82,11,110,99,79
21,r_19_123_136,r_18_144_70,seq20,r_18_144_70,1.0,-17,53,70,79
33,r_18_144_70,r_130_148_56,r_35_145_121,r_35_145_121,1.0,0,121,121,79
13,r_125_2_40,r_1_31_104,seq6,r_1_31_104,0.69,1,105,104,79
62,seq34,r_35_145_121,r_1_31_104,r_35_145_121,0.99,1,122,121,79
21,r_19_123_136,seq20,seq124,r_19_123_136,1.0,0,136,136,79
6,r_33_91_45,seq34,seq90,r_33_91_45,0.98,0,45,45,79
27,r_87_74_16,seq80,seq79,r_87_74_16,0.34,54,70,16,79
17,r_9_46_53,r_7_143_171,seq48,r_9_46_53,1.0,0,53,53,79
37,r_29_113_176,r_1_31_104,r_101_120_86,r_29_113_176,0.86,1,177,176,79
41,r_104_142_168,r_86_105_84,r_18_144_70,r_104_142_168,0.7,1,169,168,79
77,seq72,seq65,r_0_73_79,r_0_73_79,0.76,0,79,79,79
46,r_10_61_37,seq11,seq60,r_10_61_37,1.0,0,37,37,79
74,seq68,seq70,r_37_67_113,r_37_67_113,0.95,16,129,113,79
18,r_149_47_96,seq146,r_9_46_53,r_149_47_96,1.0,0,96,96,79
29,r_118_41_120,seq119,seq42,r_118_41_120,0.97,1,121,120,79
78,seq79,r_78_12_71,r_59_77_33,r_78_12_71,0.52,-19,52,71,79
24,r_133_135_153,seq146,r_18_144_70,r_18_144_70,1.0,44,114,70,79
25,r_51_25_83,r_50_128_87,r_30_89_123,r_50_128_87,0.97,-1,86,87,79
43,r_59_77_33,seq57,seq79,r_59_77_33,0.73,1,34,33,79
33,r_18_144_70,r_19_123_136,r_130_148_56,r_18_144_70,0.94,0,70,70,79
13,r_125_2_40,r_126_75_171,r_1_31_104,r_125_2_40,0.99,0,40,40,79
64,seq42,r_40_136_115,r_14_44_99,r_40_136_115,0.88,0,115,115,79
50,seq129,r_130_148_56,r_39_132_74,r_39_132_74,0.99,4,78,74,79
58,seq20,r_19_123_136,seq15,r_19_123_136,1.0,1,137,136,79
52,seq6,r_4_22_151,seq3,r_4_22_151,0.88,0,151,151,79
34,r_30_89_123,r_29_113_176,seq88,r_30_89_123,0.97,0,123,123,79
44,r_98_52_49,seq97,seq54,r_98_52_49,1.0,0,49,49,79
1,r_5_111_15,r_1_31_104,r_8_112_10,r_5_111_15,0.5,-1,14,15,79
27,r_87_74_16,seq88,seq80,r_87_74_16,0.97,0,16,16,79
9,r_101_120_86,r_104_142_168,seq119,r_101_120_86,0.98,0,86,86,79
40,r_28_134_28,r_18_144_70,r_133_135_153,r_28_134_28,0.58,129,157,28,79
28,r_21_92_30,r_94_71_93,seq102,r_94_71_93,1.0,0,93,93,79
57,seq146,r_149_47_96,r_130_148_56,r_149_47_96,0.91,-43,53,96,79
49,r_37_67_113,r_36_82_106,r_40_136_115,r_36_82_106,0.72,-8,98,106,79
56,seq15,r_17_32_155,r_137_16_12,r_137_16_12,0.75,143,155,12,79
7,r_126_75_171,seq119,r_55_76_142,r_55_76_142,0.57,31,173,142,79
24,r_133_135_153,r_18_144_70,r_28_134_28,r_28_134_28,0.68,125,153,28,79
49,r_37_67_113,r_40_136_115,seq68,r_37_67_113,0.85,0,113,113,79
32,r_7_143_171,r_9_46_53,seq11,r_7_143_171,0.46,-129,42,171,79
30,r_133_31_60,r_134_94_67,r_29_12_115,r_133_31_60,0.99,0,60,60,80
51,seq131,r_132_91_179,r_110_146_41,r_110_146_41,0.92,124,165,41,80
36,r_82_40_146,r_81_42_107,r_16_75_103,r_82_40_146,0.83,-39,107,146,80
2,r_44_135_27,seq43,seq139,r_44_135_27,1.0,0,27,27,80
20,r_110_146_41,r_111_69_69,seq144,r_110_146_41,0.98,0,41,41,80
14,r_16_75_103,r_24_38_123,r_73_76_36,r_16_75_103,0.89,0,103,103,80
8,r_35_124_11,r_33_68_165,seq125,r_35_124_11,0.69,0,11,11,80
43,r_137_0_63,r_136_48_126,r_1_45_183,r_137_0_63,1.0,0,63,63,80
17,r_4_87_22,seq5,seq89,r_4_87_22,1.0,0,22,22,80
37,r_84_59_92,seq85,seq60,r_84_59_92,0.94,0,92,92,80
3,r_1_45_183,r_137_0_63,r_32_46_110,r_1_45_183,0.49,0,183,183,80
18,r_90_100_192,r_80_30_106,seq101,r_80_30_106,1.0,-9,97,106,80
16,r_115_118_162,r_112_65_170,r_55_117_14,r_115_118_162,0.56,4,166,162,80
21,r_58_8_184,seq63,seq10,r_58_8_184,0.33,0,184,184,80
1,r_32_46_110,r_28_142_146,seq51,r_28_142_146,0.84,-36,110,146,80
28,r_22_113_36,r_17_21_16,seq114,r_22_113_36,1.0,0,36,36,80
46,r_121_36_149,seq122,r_24_38_123,r_24_38_123,0.74,26,149,123,80
42,r_23_27_116,r_24_38_123,seq26,r_24_38_123,0.61,-4,119,123,80
45,r_24_38_123,r_23_27_116,r_81_42_107,r_81_42_107,0.66,12,119,107,80
11,r_134_94_67,r_93_2_158,r_34_95_148,r_134_94_67,0.98,91,158,67,80
24,r_93_2_158,r_134_94_67,r_137_0_63,r_93_2_158,0.97,0,158,158,80
19,r_34_95_148,r_33_68_165,r_134_94_67,r_34_95_148,0.9,0,148,148,80
36,r_82_40_146,r_16_75_103,r_24_38_123,r_82_40_146,1.0,0,146,146,80
40,r_128_62_38,seq129,seq63,r_128_62_38,0.99,0,38,38,80
41,r_136_48_126,r_137_0_63,r_149_49_160,r_137_0_63,1.0,0,63,63,80
77,seq74,r_73_76_36,seq71,r_73_76_36,0.83,2,38,36,80
11,r_134_94_67,r_133_31_60,r_44_135_27,r_44_135_27,0.99,0,27,27,80
10,r_14_92_171,seq15,r_134_94_67,r_14_92_171,0.74,0,171,171,80
0,r_28_142_146,r_29_12_115,r_80_30_106,r_80_30_106,0.98,9,115,106,80
13,r_9_61_166,seq10,r_84_59_92,r_9_61_166,0.84,0,166,166,80
6,r_111_69_69,r_115_118_162,seq70,r_111_69_69,1.0,0,69,69,80
62,seq26,r_28_142_146,r_23_27_116,r_28_142_146,0.93,-27,119,146,80
33,r_67_88_54,seq63,seq89,r_67_88_54,1.0,0,54,54,80
32,r_39_54_49,seq37,seq56,r_39_54_49,0.98,2,51,49,80
18,r_90_100_192,seq101,r_34_95_148,r_34_95_148,1.0,14,162,148,80
27,r_29_12_115,r_28_142_146,r_104_13_5,r_29_12_115,0.9,0,115,115,80
5,r_7_108_32,seq5,seq105,r_7_108_32,1.0,0,32,32,80
29,r_73_76_36,seq74,seq77,r_73_76_36,0.79,0,36,36,80
12,r_55_117_14,r_58_8_184,seq122,r_55_117_14,0.95,-1,13,14,80
18,r_90_100_192,r_93_2_158,r_80_30_106,r_80_30_106,0.44,-26,80,106,80
0,r_28_142_146,r_80_30_106,seq140,r_28_142_146,0.97,0,146,146,80
24,r_93_2_158,seq101,r_134_94_67,r_134_94_67,1.0,9,76,67,80
25,r_109_96_163,seq105,seq97,r_109_96_163,0.43,0,163,163,80
43,r_137_0_63,r_1_45_183,r_93_2_158,r_93_2_158,0.91,25,183,158,80
3,r_1_45_183,r_3_86_59,seq5,r_3_86_59,0.99,0,59,59,80
70,seq60,r_58_8_184,r_84_59_92,r_84_59_92,1.0,37,129,92,80
61,seq25,r_24_38_123,r_17_21_16,r_24_38_123,0.86,2,125,123,80
38,r_83_53_84,r_84_59_92,r_39_54_49,r_39_54_49,0.95,35,84,49,80
52,seq5,r_1_45_183,r_137_0_63,r_137_0_63,1.0,25,88,63,80
34,r_132_91_179,seq131,r_14_92_171,r_14_92_171,0.48,8,179,171,80
15,r_66_119_31,r_67_88_54,seq122,r_66_119_31,1.0,0,31,31,80
9,r_33_68_165,r_34_95_148,r_133_31_60,r_133_31_60,1.0,86,146,60,80
9,r_33_68_165,r_133_31_60,r_111_69_69,r_33_68_165,0.89,0,165,165,80
23,r_3_86_59,r_1_45_183,seq85,r_3_86_59,1.0,0,59,59,80
3,r_1_45_183,seq5,r_137_0_63,r_1_45_183,0.55,-110,73,183,80
11,r_134_94_67,r_44_135_27,r_93_2_158,r_134_94_67,1.0,1,68,67,80
91,seq114,r_112_65_170,r_22_113_36,r_22_113_36,1.0,130,166,36,80
49,r_11_106_127,seq15,r_7_108_32,r_11_106_127,0.74,0,127,127,80
39,r_141_102_26,seq140,seq103,r_141_102_26,0.94,0,26,26,80
44,r_112_65_170,seq114,r_9_61_166,r_112_65_170,0.52,0,170,170,80
26,r_145_123_36,r_149_49_160,r_35_124_11,r_145_123_36,0.97,0,36,36,80
32,r_39_54_49,seq56,r_83_53_84,r_83_53_84,0.95,4,88,84,80
35,r_80_30_106,r_82_40_146,r_133_31_60,r_80_30_106,0.86,0,106,106,80
30,r_133_31_60,r_29_12_115,r_80_30_106,r_80_30_106,0.83,9,115,106,80
36,r_90_6_104,r_91_63_183,seq7,r_90_6_104,1.0,0,104,104,81
39,r_71_10_140,r_97_66_86,seq9,r_97_66_86,0.83,53,139,86,81
14,r_72_38_120,r_71_10_140,r_88_39_86,r_71_10_140,0.99,-20,120,140,81
8,r_97_66_86,seq101,seq65,r_97_66_86,1.0,0,86,86,81
43,r_43_119_139,r_40_62_165,r_107_120_76,r_43_119_139,0.71,0,139,139,81
62,seq26,seq29,r_106_27_7,r_106_27_7,0.5,13,20,7,81
83,seq141,r_142_135_111,r_11_143_51,r_11_143_51,1.0,61,112,51,81
13,r_70_47_191,seq54,r_22_68_31,r_22_68_31,0.97,12,43,31,81
54,seq9,seq7,r_71_10_140,r_71_10_140,1.0,0,140,140,81
55,seq139,r_142_135_111,r_118_140_49,r_118_140_49,0.61,31,80,49,81
71,seq51,r_50_59_107,seq49,r_50_59_107,0.99,1,108,107,81
86,seq85,seq81,r_56_84_146,r_56_84_146,0.52,3,149,146,81
39,r_71_10_140,r_72_38_120,r_97_66_86,r_97_66_86,0.88,33,119,86,81
1,r_23_96_79,r_20_41_170,seq98,r_23_96_79,0.97,0,79,79,81
28,r_11_143_51,seq9,seq141,r_11_143_51,1.0,0,51,51,81
46,r_107_120_76,seq110,r_12_128_72,r_12_128_72,0.78,4,76,72,81
7,r_17_121_110,r_16_21_43,r_58_15_5,r_16_21_43,0.62,12,55,43,81
80,seq73,seq64,r_33_74_75,r_33_74_75,0.99,64,139,75,81
45,r_113_133_176,r_115_103_198,r_117_131_72,r_117_131_72,0.53,97,169,72,81
24,r_91_63_183,r_134_86_111,r_22_68_31,r_22_68_31,0.34,152,183,31,81
19,r_50_59_107,seq51,seq54,r_50_59_107,0.89,1,108,107,81
11,r_134_86_111,r_87_36_172,r_56_84_146,r_87_36_172,0.79,0,172,172,81
94,seq110,r_108_149_68,r_109_0_179,r_108_149_68,0.84,-18,50,68,81
20,r_16_21_43,r_17_121_110,seq25,r_17_121_110,0.97,-67,43,110,81
76,seq61,r_60_89_114,seq54,r_60_89_114,0.9,6,120,114,81
31,r_108_149_68,seq110,seq148,r_108_149_68,0.88,3,71,68,81
41,r_24_111_175,seq25,seq112,r_24_111_175,0.81,0,175,175,81
67,seq35,r_33_74_75,seq32,r_33_74_75,1.0,0,75,75,81
38,r_132_18_46,seq136,r_92_19_8,r_132_18_46,1.0,-1,45,46,81
3,r_34_93_64,r_33_74_75,seq95,r_34_93_64,1.0,0,64,64,81
95,seq112,seq136,r_115_103_198,r_115_103_198,0.5,-150,48,198,81
27,r_22_68_31,r_23_96_79,seq64,r_22_68_31,0.71,0,31,31,81
40,r_12_128_72,r_50_59_107,seq122,r_12_128_72,0.71,-27,45,72,81
26,r_125_2_141,seq124,seq3,r_125_2_141,0.75,0,141,141,81
4,r_87_36_172,seq81,r_72_38_120,r_72_38_120,0.55,52,172,120,81
11,r_134_86_111,seq136,r_87_36_172,r_134_86_111,0.93,0,111,111,81
15,r_116_57_80,r_117_131_72,seq54,r_116_57_80,0.99,0,80,80,81
48,r_1_77_94,r_5_80_181,seq78,r_1_77_94,0.98,0,94,94,81
54,seq9,r_11_143_51,seq7,r_11_143_51,1.0,0,51,51,81
13,r_70_47_191,r_22_68_31,r_76_46_144,r_22_68_31,0.44,160,191,31,81
99,seq127,r_126_44_130,seq124,r_126_44_130,1.0,0,130,130,81
5,r_58_15_5,r_17_121_110,seq13,r_17_121_110,1.0,6,116,110,81
21,r_92_19_8,r_23_96_79,r_132_18_46,r_92_19_8,0.99,39,47,8,81
21,r_92_19_8,r_106_27_7,r_23_96_79,r_92_19_8,0.32,10,18,8,81
18,r_56_84_146,seq54,seq85,r_56_84_146,0.4,3,149,146,81
29,r_76_46_144,seq75,r_130_45_66,r_76_46_144,0.49,0,144,144,81
24,r_91_63_183,r_90_6_104,r_134_86_111,r_91_63_183,0.48,-77,106,183,81
66,seq32,r_33_74_75,seq35,r_33_74_75,1.0,-18,57,75,81
25,r_40_62_165,seq37,seq61,r_40_62_165,0.51,0,165,165,81
33,r_33_74_75,seq35,seq73,r_33_74_75,0.94,0,75,75,81
65,seq31,seq51,r_126_44_130,r_126_44_130,0.96,4,134,130,81
42,r_106_27_7,r_92_19_8,seq26,r_106_27_7,0.57,4,11,7,81
68,seq37,r_40_62_165,r_72_38_120,r_72_38_120,0.65,44,164,120,81
61,seq25,r_24_111_175,r_16_21_43,r_24_111_175,0.75,0,175,175,81
32,r_130_45_66,seq136,seq48,r_130_45_66,1.0,1,67,66,81
22,r_118_140_49,r_123_42_136,seq139,r_123_42_136,0.76,-87,49,136,81
34,r_20_41_170,seq25,r_126_44_130,r_20_41_170,0.63,0,170,170,81
81,seq75,r_76_46_144,r_1_77_94,r_1_77_94,0.99,48,142,94,81
9,r_60_89_114,seq61,r_134_86_111,r_134_86_111,0.74,15,126,111,81
7,r_17_121_110,r_58_15_5,r_107_120_76,r_17_121_110,1.0,0,110,110,81
49,r_88_39_86,r_90_6_104,seq37,r_90_6_104,0.81,-17,87,104,81
44,r_142_135_111,seq141,seq136,r_142_135_111,0.39,1,112,111,81
94,seq110,r_109_0_179,r_17_121_110,r_17_121_110,0.7,65,175,110,81
37,r_138_99_11,r_142_135_111,seq98,r_138_99_11,0.92,2,13,11,81
82,seq78,seq75,r_1_77_94,r_1_77_94,1.0,4,98,94,81
35,r_126_44_130,seq127,r_72_38_120,r_126_44_130,0.62,0,130,130,81
12,r_117_131_72,r_116_57_80,seq136,r_116_57_80,0.86,-4,76,80,81
95,seq112,r_115_103_198,r_24_111_175,r_24_111_175,0.52,1,176,175,81
30,r_6_15_123,r_2_110_190,r_29_14_73,r_29_14_73,0.82,54,127,73,82
36,r_27_23_148,seq26,r_1_24_24,r_1_24_24,0.68,124,148,24,82
14,r_21_40_67,seq16,r_41_118_125,r_21_40_67,0.93,0,67,67,82
81,seq69,r_66_85_38,r_57_142_74,r_66_85_38,0.9,-9,29,38,82
15,r_132_35_35,seq133,r_34_79_184,r_132_35_35,0.98,0,35,35,82
37,r_37_64_164,seq36,r_93_63_19,r_93_63_19,0.81,147,166,19,82
55,seq9,r_10_31_179,r_129_3_101,r_129_3_101,1.0,77,178,101,82
71,seq36,r_37_64_164,r_8_39_39,r_8_39_39,0.96,127,166,39,82
39,r_10_31_179,seq9,r_135_28_116,r_135_28_116,0.99,63,179,116,82
1,r_48_119_118,seq45,seq116,r_48_119_118,0.76,0,118,118,82
24,r_58_104_27,r_57_142_74,seq105,r_57_142_74,0.49,-46,28,74,82
5,r_130_144_153,seq131,r_57_142_74,r_57_142_74,0.99,79,153,74,82
69,seq30,seq32,r_135_28_116,r_135_28_116,1.0,4,120,116,82
40,r_107_73_24,r_97_81_182,seq74,r_107_73_24,0.79,0,24,24,82
19,r_33_106_67,seq32,r_58_104_27,r_33_106_67,0.91,1,68,67,82
12,r_83_115_123,r_80_49_14,r_13_82_29,r_13_82_29,0.77,2,31,29,82
76,seq55,r_56_111_131,seq51,r_56_111_131,0.6,0,131,131,82
38,r_100_78_5,seq74,r_12_77_72,r_12_77_72,1.0,32,104,72,82
97,seq123,r_84_122_21,r_141_124_159,r_141_124_159,0.9,9,168,159,82
41,r_95_109_125,r_97_81_182,seq114,r_95_109_125,0.58,0,125,125,82
21,r_93_63_19,r_84_122_21,seq62,r_93_63_19,0.71,1,20,19,82
3,r_128_65_138,r_130_144_153,r_42_68_82,r_128_65_138,0.61,0,138,138,82
67,seq25,seq22,r_1_24_24,r_1_24_24,1.0,4,28,24,82
26,r_29_14_73,seq30,seq16,r_29_14_73,0.88,0,73,73,82
23,r_8_39_39,seq7,seq36,r_8_39_39,0.91,-5,34,39,82
4,r_56_111_131,seq55,seq114,r_56_111_131,0.63,0,131,131,82
81,seq69,r_57_142_74,r_47_70_64,r_57_142_74,0.98,-7,67,74,82
31,r_4_61_53,r_6_15_123,r_93_63_19,r_4_61_53,0.97,0,53,53,82
73,seq44,r_43_54_137,seq45,r_43_54_137,1.0,0,137,137,82
13,r_72_18_76,seq69,seq17,r_72_18_76,0.75,0,76,76,82
48,r_112_5_168,seq114,r_129_3_101,r_129_3_101,0.83,66,167,101,82
12,r_83_115_123,r_13_82_29,seq116,r_83_115_123,0.89,0,123,123,82
8,r_108_102_185,r_95_109_125,r_34_79_184,r_34_79_184,0.76,-33,151,184,82
85,seq90,seq91,r_86_87_52,r_86_87_52,0.83,73,125,52,82
8,r_108_102_185,r_97_81_182,r_19_75_47,r_108_102_185,0.63,-131,54,185,82
14,r_21_40_67,r_41_118_125,seq45,r_41_118_125,1.0,0,125,125,82
49,r_143_71_57,r_141_124_159,seq69,r_143_71_57,1.0,0,57,57,82
6,r_13_82_29,r_19_75_47,r_83_115_123,r_83_115_123,0.69,-94,29,123,82
33,r_41_118_125,r_43_54_137,r_21_40_67,r_41_118_125,0.64,-21,104,125,82
27,r_42_68_82,r_43_54_137,r_47_70_64,r_43_54_137,1.0,-56,81,137,82
8,r_108_102_185,r_19_75_47,seq99,r_108_102_185,0.62,-118,67,185,82
2,r_129_3_101,r_130_144_153,r_2_110_190,r_129_3_101,0.98,0,101,101,82
74,seq45,r_48_119_118,seq44,r_48_119_118,1.0,3,121,118,82
25,r_2_110_190,r_6_15_123,r_129_3_101,r_129_3_101,1.0,26,127,101,82
7,r_52_94_14,r_53_38_43,seq99,r_52_94_14,0.62,2,16,14,82
43,r_66_85_38,seq69,r_86_87_52,r_66_85_38,0.99,-1,37,38,82
50,seq131,r_130_144_153,seq127,r_130_144_153,1.0,0,153,153,82
58,seq140,r_141_124_159,r_57_142_74,r_57_142_74,1.0,28,102,74,82
6,r_13_82_29,r_83_115_123,r_12_77_72,r_13_82_29,0.83,94,123,29,82
32,r_50_67_179,seq55,r_128_65_138,r_128_65_138,1.0,41,179,138,82
18,r_19_75_47,r_21_40_67,seq74,r_19_75_47,0.91,-1,46,47,82
34,r_12_77_72,seq11,r_100_78_5,r_12_77_72,0.96,0,72,72,82
75,seq51,r_57_142_74,seq55,r_57_142_74,1.0,-7,67,74,82
97,seq123,seq120,r_84_122_21,r_84_122_21,1.0,1,22,21,82
91,seq105,r_97_81_182,r_58_104_27,r_58_104_27,0.99,1,28,27,82
9,r_57_142_74,seq59,seq140,r_57_142_74,1.0,0,74,74,82
33,r_41_118_125,r_48_119_118,r_43_54_137,r_48_119_118,0.45,-66,52,118,82
22,r_135_28_116,seq134,seq30,r_135_28_116,1.0,0,116,116,82
33,r_41_118_125,r_21_40_67,r_48_119_118,r_21_40_67,0.79,58,125,67,82
28,r_47_70_64,r_48_119_118,seq69,r_48_119_118,0.8,-55,63,118,82
47,r_53_38_43,seq51,r_8_39_39,r_53_38_43,0.83,1,44,43,82
44,r_89_125_111,seq90,seq126,r_89_125_111,1.0,0,111,111,82
17,r_84_122_21,r_97_81_182,seq123,r_84_122_21,0.94,0,21,21,82
11,r_34_79_184,r_37_64_164,r_132_35_35,r_132_35_35,0.99,11,46,35,82
10,r_1_24_24,r_2_110_190,seq25,r_1_24_24,0.53,0,24,24,82
8,r_30_74_84,r_29_5_129,r_3_73_28,r_29_5_129,0.99,-45,84,129,83
43,r_75_118_147,seq72,seq119,r_75_118_147,0.99,0,147,147,83
37,r_58_117_158,r_57_68_188,r_113_116_183,r_57_68_188,0.47,-29,159,188,83
55,seq136,seq135,r_41_139_13,r_41_139_13,0.94,134,147,13,83
16,r_144_32_169,r_149_84_147,seq141,r_149_84_147,0.51,-5,142,147,83
21,r_1_8_5,r_11_97_149,r_71_10_86,r_1_8_5,0.56,142,147,5,83
27,r_96_16_10,seq94,seq17,r_96_16_10,0.99,0,10,10,83
46,r_34_109_168,r_35_9_168,r_99_110_92,r_34_109_168,0.68,0,168,168,83
42,r_83_28_172,seq91,r_48_21_153,r_48_21_153,0.8,19,172,153,83
80,seq70,r_67_140_128,r_87_69_99,r_67_140_128,0.64,-9,119,128,83
45,r_11_97_149,r_1_8_5,seq101,r_11_97_149,0.83,0,149,149,83
61,seq17,r_30_74_84,r_96_16_10,r_96_16_10,0.71,0,10,10,83
35,r_61_93_36,r_62_56_149,seq94,r_61_93_36,1.0,0,36,36,83
19,r_33_125_126,r_35_9_168,r_128_127_192,r_33_125_126,1.0,0,126,126,83
15,r_71_10_86,r_11_97_149,seq12,r_11_97_149,1.0,0,149,149,83
15,r_71_10_86,seq12,r_35_9_168,r_71_10_86,0.52,87,173,86,83
95,seq111,seq112,r_99_110_92,r_99_110_92,0.92,23,115,92,83
76,seq53,r_54_79_92,r_23_55_70,r_23_55_70,1.0,21,91,70,83
31,r_2_122_77,r_4_7_111,r_123_121_106,r_2_122_77,1.0,0,77,77,83
41,r_35_9_168,seq36,r_71_10_86,r_71_10_86,0.99,82,168,86,83
12,r_64_38_174,r_45_49_11,seq42,r_45_49_11,0.48,186,197,11,83
26,r_134_132_69,seq135,seq133,r_134_132_69,0.72,12,81,69,83
48,r_3_73_28,r_2_122_77,seq72,r_3_73_28,1.0,0,28,28,83
71,seq42,r_40_124_35,r_88_44_11,r_40_124_35,0.91,-1,34,35,83
72,seq43,r_45_49_11,r_88_44_11,r_88_44_11,1.0,0,11,11,83
4,r_57_68_188,r_58_117_158,r_129_59_40,r_129_59_40,0.71,119,159,40,83
78,seq63,r_64_38_174,r_129_59_40,r_129_59_40,1.0,133,173,40,83
0,r_76_89_55,seq77,seq91,r_76_89_55,0.72,7,62,55,83
5,r_40_124_35,seq42,seq119,r_40_124_35,1.0,0,35,35,83
63,seq19,r_29_5_129,r_148_31_58,r_148_31_58,0.96,23,81,58,83
11,r_99_110_92,r_98_90_126,seq111,r_98_90_126,0.68,-34,92,126,83
30,r_88_44_11,seq85,seq43,r_88_44_11,1.0,0,11,11,83
63,seq19,r_148_31_58,r_100_18_114,r_100_18_114,1.0,0,114,114,83
15,r_71_10_86,seq70,r_11_97_149,r_71_10_86,1.0,0,86,86,83
17,r_4_7_111,seq0,seq6,r_4_7_111,0.44,0,111,111,83
99,seq119,r_120_106_165,r_2_122_77,r_2_122_77,1.0,85,162,77,83
13,r_128_127_192,seq112,r_104_126_22,r_104_126_22,0.96,7,29,22,83
9,r_41_139_13,seq42,seq137,r_41_139_13,0.99,0,13,13,83
53,seq6,seq0,r_4_7_111,r_4_7_111,0.5,7,118,111,83
16,r_144_32_169,seq141,r_148_31_58,r_144_32_169,1.0,0,169,169,83
10,r_39_92_64,r_45_49_11,r_107_95_49,r_39_92_64,0.96,-6,58,64,83
2,r_103_51_72,r_98_90_126,seq50,r_103_51_72,0.99,0,72,72,83
3,r_66_81_52,seq65,seq80,r_66_81_52,0.88,0,52,52,83
39,r_148_31_58,r_149_84_147,seq36,r_148_31_58,1.0,0,58,58,83
40,r_87_69_99,seq91,seq70,r_87_69_99,0.64,0,99,99,83
18,r_149_84_147,seq146,seq86,r_149_84_147,0.94,0,147,147,83
29,r_100_18_114,seq101,seq19,r_100_18_114,0.97,0,114,114,83
24,r_54_79_92,seq53,seq78,r_54_79_92,0.9,0,92,92,83
34,r_129_59_40,r_58_117_158,r_62_56_149,r_58_117_158,0.87,1,159,158,83
33,r_48_21_153,r_45_49_11,seq20,r_45_49_11,0.56,142,153,11,83
47,r_107_95_49,seq108,r_61_93_36,r_107_95_49,1.0,2,51,49,83
88,seq91,seq85,r_76_89_55,r_76_89_55,0.95,23,78,55,83
32,r_23_55_70,r_24_47_174,seq53,r_23_55_70,1.0,0,70,70,83
77,seq60,r_62_56_149,r_129_59_40,r_129_59_40,1.0,105,145,40,83
71,seq42,r_88_44_11,r_45_49_11,r_45_49_11,0.32,120,131,11,83
25,r_104_126_22,r_103_51_72,r_128_127_192,r_104_126_22,0.97,-1,21,22,83
17,r_4_7_111,r_2_122_77,seq0,r_2_122_77,0.89,0,77,77,83
34,r_129_59_40,seq131,r_58_117_158,r_129_59_40,0.99,0,40,40,83
22,r_123_121_106,seq119,r_2_122_77,r_2_122_77,1.0,0,77,77,83
28,r_67_140_128,seq70,r_143_138_125,r_67_140_128,0.99,0,128,128,83
49,r_62_56_149,seq60,r_129_59_40,r_129_59_40,1.0,109,149,40,83
7,r_82_115_144,seq80,r_113_116_183,r_82_115_144,0.94,0,144,144,83
44,r_29_5_129,r_24_47_174,r_4_7_111,r_24_47_174,0.9,-45,129,174,83
23,r_98_90_126,seq101,r_76_89_55,r_98_90_126,0.96,0,126,126,83
79,seq65,r_62_56_149,r_129_59_40,r_62_56_149,0.42,-48,101,149,83
12,r_64_38_174,seq63,r_45_49_11,r_64_38_174,0.42,0,174,174,83
18,r_110_67_58,r_121_107_124,seq66,r_110_67_58,1.0,1,59,58,84
17,r_58_64_41,r_56_32_91,seq65,r_58_64_41,1.0,0,41,41,84
38,r_96_79_34,r_97_93_85,seq78,r_96_79_34,0.83,0,34,34,84
14,r_99_75_74,seq102,seq82,r_99_75_74,0.69,0,74,74,84
16,r_23_91_109,r_25_70_165,r_97_93_85,r_23_91_109,1.0,0,109,109,84
39,r_149_57_70,seq147,seq55,r_149_57_70,0.93,0,70,70,84
1,r_68_17_104,seq66,r_4_18_15,r_68_17_104,0.99,0,104,104,84
5,r_80_101_74,r_83_14_181,r_126_103_37,r_80_101_74,1.0,0,74,74,84
42,r_134_73_133,r_135_36_138,r_33_72_109,r_134_73_133,0.65,0,133,133,84
56,seq6,seq9,r_86_5_46,r_86_5_46,0.98,8,54,46,84
19,r_123_139_144,seq124,r_7_141_28,r_123_139_144,0.74,0,144,144,84
15,r_54_77_174,r_149_57_70,seq78,r_54_77_174,0.94,0,174,174,84
22,r_4_18_15,seq3,r_19_120_185,r_4_18_15,0.97,0,15,15,84
46,r_43_24_21,seq42,seq28,r_43_24_21,0.88,-1,20,21,84
31,r_47_129_146,seq44,seq128,r_47_129_146,0.74,0,146,146,84
49,r_21_27_32,r_19_120_185,seq28,r_21_27_32,0.58,1,33,32,84
3,r_51_8_126,seq50,seq9,r_51_8_126,0.76,0,126,126,84
10,r_121_107_124,seq124,r_80_101_74,r_80_101_74,0.94,50,124,74,84
91,seq85,r_86_5_46,seq84,r_86_5_46,0.98,0,46,46,84
26,r_89_35_114,seq92,r_56_32_91,r_89_35_114,0.99,0,114,114,84
48,r_7_141_28,seq6,seq142,r_7_141_28,0.97,0,28,28,84
14,r_99_75_74,seq82,seq84,r_99_75_74,0.31,131,205,74,84
4,r_125_49_148,r_137_39_77,r_140_138_52,r_137_39_77,0.81,2,79,77,84
13,r_118_52_182,r_114_117_11,r_125_49_148,r_114_117_11,0.42,171,182,11,84
15,r_54_77_174,seq50,r_149_57_70,r_149_57_70,1.0,23,93,70,84
27,r_56_32_91,r_34_69_148,r_29_30_155,r_34_69_148,0.88,-21,127,148,84
4,r_125_49_148,r_140_138_52,seq50,r_125_49_148,0.99,0,148,148,84
57,seq136,r_135_36_138,seq128,r_135_36_138,0.95,0,138,138,84
27,r_56_32_91,seq55,r_34_69_148,r_56_32_91,0.5,0,91,91,84
28,r_33_72_109,r_71_11_159,r_134_73_133,r_33_72_109,0.68,50,159,109,84
87,seq78,seq82,r_54_77_174,r_54_77_174,0.72,9,183,174,84
22,r_4_18_15,r_19_120_185,r_68_17_104,r_68_17_104,0.98,21,125,104,84
40,r_97_93_85,seq95,seq92,r_97_93_85,0.99,0,85,85,84
29,r_100_16_190,seq102,r_83_14_181,r_83_14_181,0.63,7,188,181,84
24,r_34_69_148,r_33_72_109,r_56_32_91,r_33_72_109,0.86,0,109,109,84
25,r_140_138_52,seq142,r_127_98_191,r_140_138_52,0.8,38,90,52,84
33,r_135_36_138,seq136,r_56_32_91,r_135_36_138,0.96,0,138,138,84
50,seq0,r_1_90_102,seq3,r_1_90_102,1.0,0,102,102,84
70,seq28,r_23_91_109,r_43_24_21,r_23_91_109,1.0,-10,99,109,84
47,r_86_5_46,seq85,seq6,r_86_5_46,1.0,0,46,46,84
68,seq20,r_19_120_185,r_68_17_104,r_68_17_104,0.95,81,185,104,84
32,r_119_53_126,seq124,r_149_57_70,r_119_53_126,0.84,0,126,126,84
12,r_126_103_37,r_135_36_138,seq102,r_126_103_37,1.0,0,37,37,84
95,seq102,r_106_113_106,r_126_103_37,r_126_103_37,1.0,13,50,37,84
77,seq48,r_56_32_91,r_149_57_70,r_149_57_70,1.0,31,101,70,84
34,r_15_104_113,r_13_131_117,r_80_101_74,r_15_104_113,0.89,0,113,113,84
85,seq74,seq109,r_125_49_148,r_125_49_148,0.55,-60,88,148,84
60,seq12,seq9,r_71_11_159,r_71_11_159,0.7,12,171,159,84
81,seq61,seq50,r_149_57_70,r_149_57_70,1.0,9,79,70,84
25,r_140_138_52,r_127_98_191,r_7_141_28,r_127_98_191,0.57,-35,156,191,84
94,seq95,r_97_93_85,seq124,r_97_93_85,0.98,0,85,85,84
9,r_105_94_180,seq102,r_23_91_109,r_23_91_109,0.95,71,180,109,84
37,r_112_63_11,r_114_117_11,seq65,r_112_63_11,0.79,1,12,11,84
28,r_33_72_109,r_34_69_148,r_71_11_159,r_33_72_109,0.64,0,109,109,84
7,r_13_131_117,r_15_104_113,seq132,r_13_131_117,0.99,-3,114,117,84
23,r_1_90_102,seq0,r_97_93_85,r_1_90_102,1.0,0,102,102,84
79,seq55,r_56_32_91,r_149_57_70,r_149_57_70,0.98,21,91,70,84
24,r_34_69_148,r_56_32_91,r_33_72_109,r_34_69_148,0.98,0,148,148,84
35,r_137_39_77,seq142,seq40,r_137_39_77,0.96,0,77,77,84
44,r_28_121_174,r_70_27_36,r_71_122_62,r_28_121_174,0.84,0,174,174,85
51,seq4,r_6_47_137,r_109_3_5,r_6_47_137,0.74,0,137,137,85
52,seq135,r_134_24_59,r_79_128_15,r_134_24_59,1.0,0,59,59,85
92,seq144,r_143_107_174,r_52_146_84,r_52_146_84,1.0,90,174,84,85
14,r_76_66_174,seq73,seq68,r_76_66_174,0.74,0,174,174,85
96,seq108,r_45_110_48,r_87_112_106,r_87_112_106,0.65,26,132,106,85
8,r_1_43_125,seq0,seq44,r_1_43_125,0.95,0,125,125,85
30,r_148_13_188,r_149_103_34,r_79_128_15,r_148_13_188,0.44,-153,35,188,85
23,r_9_59_24,r_5_102_179,seq60,r_9_59_24,0.51,-1,23,24,85
83,seq80,seq84,r_49_81_150,r_49_81_150,1.0,7,157,150,85
74,seq60,seq64,r_9_59_24,r_9_59_24,0.96,2,26,24,85
21,r_119_65_159,seq118,seq63,r_119_65_159,0.48,0,159,159,85
1,r_18_26_2,r_28_121_174,r_70_27_36,r_70_27_36,0.97,138,174,36,85
97,seq113,r_114_82_179,r_71_122_62,r_71_122_62,1.0,120,182,62,85
5,r_123_142_127,r_119_65_159,r_20_141_66,r_20_141_66,0.72,61,127,66,85
46,r_83_35_92,seq84,seq41,r_83_35_92,1.0,0,92,92,85
42,r_6_47_137,r_5_102_179,seq51,r_6_47_137,0.99,0,137,137,85
66,seq44,r_45_110_48,seq54,r_45_110_48,0.97,1,49,48,85
19,r_52_146_84,seq54,seq144,r_52_146_84,0.98,0,84,84,85
33,r_70_27_36,r_28_121_174,r_18_26_2,r_28_121_174,1.0,0,174,174,85
33,r_70_27_36,r_71_122_62,r_28_121_174,r_70_27_36,0.99,0,36,36,85
18,r_147_100_46,seq136,seq104,r_147_100_46,0.92,-3,43,46,85
10,r_5_102_179,seq4,r_149_103_34,r_5_102_179,0.41,0,179,179,85
24,r_36_129_21,r_39_67_169,seq132,r_36_129_21,0.87,0,21,21,85
72,seq55,seq68,r_9_59_24,r_9_59_24,0.76,148,172,24,85
4,r_124_8_194,r_71_122_62,r_148_13_188,r_71_122_62,0.74,135,197,62,85
4,r_124_8_194,seq118,r_71_122_62,r_71_122_62,1.0,83,145,62,85
0,r_49_81_150,seq51,seq80,r_49_81_150,0.85,0,150,150,85
20,r_57_139_103,seq68,seq136,r_57_139_103,1.0,0,103,103,85
3,r_45_110_48,seq44,r_123_142_127,r_45_110_48,0.83,1,49,48,85
13,r_92_40_66,seq90,seq41,r_92_40_66,1.0,0,66,66,85
15,r_111_42_98,seq118,seq41,r_111_42_98,0.97,1,99,98,85
48,r_77_99_131,seq84,r_30_98_103,r_77_99_131,0.62,0,131,131,85
36,r_109_3_5,r_1_43_125,seq4,r_1_43_125,0.88,-71,54,125,85
6,r_39_67_169,r_38_130_126,r_111_42_98,r_39_67_169,0.88,-42,127,169,85
62,seq132,r_131_48_176,r_38_130_126,r_38_130_126,0.96,50,176,126,85
29,r_137_120_29,seq138,r_119_65_159,r_137_120_29,0.52,0,29,29,85
27,r_88_89_77,r_87_112_106,seq90,r_87_112_106,1.0,-19,87,106,85
30,r_148_13_188,r_79_128_15,r_12_23_199,r_148_13_188,0.27,0,188,188,85
49,r_2_86_23,seq17,seq93,r_2_86_23,1.0,2,25,23,85
2,r_20_141_66,seq16,seq136,r_20_141_66,1.0,0,66,66,85
47,r_116_19_107,r_115_126_110,seq21,r_116_19_107,0.98,0,107,107,85
40,r_134_24_59,seq135,seq21,r_134_24_59,1.0,1,60,59,85
3,r_45_110_48,seq108,r_79_128_15,r_45_110_48,0.45,81,129,48,85
37,r_72_33_32,r_71_122_62,r_133_34_20,r_72_33_32,0.99,0,32,32,85
6,r_39_67_169,r_111_42_98,r_9_59_24,r_39_67_169,0.62,1,170,169,85
50,seq0,r_1_43_125,seq4,r_1_43_125,0.91,0,125,125,85
29,r_137_120_29,r_119_65_159,r_71_122_62,r_137_120_29,0.9,34,63,29,85
65,seq41,r_28_121_174,r_111_42_98,r_111_42_98,0.97,30,128,98,85
32,r_38_130_126,r_39_67_169,seq132,r_38_130_126,1.0,1,127,126,85
34,r_30_98_103,seq31,r_62_97_3,r_30_98_103,0.99,0,103,103,85
99,seq127,r_131_48_176,r_79_128_15,r_79_128_15,1.0,6,21,15,85
9,r_131_48_176,seq132,r_6_47_137,r_131_48_176,0.71,0,176,176,85
96,seq108,seq144,r_45_110_48,r_45_110_48,0.87,32,80,48,85
38,r_79_128_15,seq80,seq127,r_79_128_15,0.99,0,15,15,85
16,r_149_103_34,r_148_13_188,seq105,r_149_103_34,0.99,1,35,34,85
22,r_7_117_98,r_6_47_137,seq113,r_7_117_98,0.99,0,98,98,85
28,r_115_126_110,r_119_65_159,r_79_128_15,r_115_126_110,0.72,0,110,110,85
91,seq96,seq95,r_62_97_3,r_62_97_3,0.46,131,134,3,85
7,r_25_145_194,r_28_121_174,r_133_34_20,r_133_34_20,0.68,52,72,20,85
44,r_28_121_174,r_39_67_169,r_70_27_36,r_70_27_36,1.0,33,69,36,85
25,r_133_34_20,r_131_48_176,seq31,r_133_34_20,0.86,-1,19,20,85
35,r_87_112_106,r_88_89_77,r_7_117_98,r_87_112_106,0.94,0,106,106,85
12,r_71_122_62,r_76_66_174,r_137_120_29,r_71_122_62,0.98,0,62,62,85
93,seq119,seq140,r_113_118_123,r_113_118_123,0.88,0,123,123,86
30,r_24_149_106,seq22,r_95_142_96,r_24_149_106,0.98,0,106,106,86
14,r_139_21_83,seq135,seq26,r_139_21_83,1.0,0,83,83,86
57,seq141,r_143_123_59,seq140,r_143_123_59,0.73,-16,43,59,86
8,r_58_65_123,seq61,r_37_67_56,r_37_67_56,0.98,68,124,56,86
27,r_97_16_63,seq20,r_105_17_97,r_105_17_97,1.0,23,120,97,86
31,r_69_6_35,r_68_18_90,seq8,r_69_6_35,0.84,0,35,35,86
26,r_38_27_20,r_42_144_135,seq28,r_38_27_20,1.0,1,21,20,86
16,r_34_90_105,r_36_35_15,seq89,r_34_90_105,0.96,0,105,105,86
21,r_138_111_61,r_139_21_83,r_64_112_13,r_138_111_61,1.0,0,61,61,86
39,r_86_79_127,seq88,seq78,r_86_79_127,0.47,0,127,127,86
5,r_120_40_117,seq121,seq39,r_120_40_117,1.0,0,117,117,86
42,r_98_32_187,seq74,r_81_31_151,r_81_31_151,0.7,36,187,151,86
32,r_92_147_127,seq91,r_24_149_106,r_92_147_127,0.99,0,127,127,86
76,seq72,r_70_14_193,r_80_73_37,r_80_73_37,0.97,-4,33,37,86
24,r_29_107_148,seq30,seq108,r_29_107_148,0.71,0,148,148,86
19,r_7_71_153,seq8,r_80_73_37,r_7_71_153,0.86,0,153,153,86
10,r_68_18_90,r_63_60_84,r_97_16_63,r_63_60_84,1.0,5,89,84,86
43,r_19_51_31,seq26,r_52_131_186,r_19_51_31,1.0,-2,29,31,86
36,r_80_73_37,r_82_4_178,seq72,r_80_73_37,0.73,-8,29,37,86
4,r_81_31_151,r_82_4_178,r_120_40_117,r_81_31_151,0.55,0,151,151,86
13,r_95_142_96,r_1_94_2,seq141,r_95_142_96,1.0,0,96,96,86
15,r_2_50_77,r_3_62_78,seq48,r_2_50_77,0.96,0,77,77,86
48,r_1_94_2,r_95_142_96,seq91,r_95_142_96,0.99,0,96,96,86
75,seq66,r_63_60_84,r_37_67_56,r_37_67_56,1.0,1,57,56,86
12,r_113_118_123,r_44_116_19,seq119,r_113_118_123,0.96,0,123,123,86
6,r_143_123_59,r_139_21_83,seq122,r_139_21_83,1.0,-24,59,83,86
9,r_96_134_42,r_97_16_63,seq135,r_96_134_42,1.0,0,42,42,86
27,r_97_16_63,r_95_142_96,seq20,r_97_16_63,1.0,0,63,63,86
34,r_54_128_47,seq55,r_129_75_193,r_54_128_47,1.0,0,47,47,86
12,r_113_118_123,r_139_21_83,r_44_116_19,r_44_116_19,0.65,1,20,19,86
2,r_82_4_178,r_81_31_151,seq88,r_81_31_151,0.89,0,151,151,86
47,r_3_62_78,r_2_50_77,r_80_73_37,r_3_62_78,0.92,0,78,78,86
29,r_63_60_84,seq74,seq61,r_63_60_84,0.67,-1,83,84,86
40,r_64_112_13,r_96_134_42,r_138_111_61,r_64_112_13,0.93,0,13,13,86
0,r_15_47_15,r_19_51_31,seq48,r_15_47_15,0.69,0,15,15,86
46,r_146_56_13,r_139_21_83,seq55,r_146_56_13,0.99,0,13,13,86
34,r_54_128_47,r_129_75_193,r_95_142_96,r_95_142_96,0.98,23,119,96,86
35,r_52_131_186,r_19_51_31,seq130,r_52_131_186,0.6,0,186,186,86
43,r_19_51_31,r_52_131_186,r_146_56_13,r_52_131_186,0.96,0,186,186,86
33,r_148_115_81,r_139_21_83,r_44_116_19,r_148_115_81,0.99,1,82,81,86
17,r_45_46_166,r_44_116_19,seq43,r_44_116_19,1.0,-1,18,19,86
28,r_44_116_19,r_45_46_166,r_113_118_123,r_44_116_19,1.0,0,19,19,86
58,seq20,seq26,r_97_16_63,r_97_16_63,1.0,5,68,63,86
77,seq140,r_148_115_81,seq141,r_148_115_81,0.99,-44,37,81,86
68,seq43,r_45_46_166,seq30,r_45_46_166,0.37,-37,129,166,86
35,r_52_131_186,r_53_114_36,r_19_51_31,r_52_131_186,1.0,-157,29,186,86
38,r_70_14_193,seq72,r_68_18_90,r_68_18_90,1.0,103,193,90,86
41,r_133_0_2,r_7_71_153,r_2_50_77,r_2_50_77,0.59,-49,28,77,86
57,seq141,seq140,r_95_142_96,r_95_142_96,1.0,41,137,96,86
41,r_133_0_2,r_2_50_77,seq20,r_2_50_77,0.94,-1,76,77,86
32,r_92_147_127,r_93_110_26,seq91,r_92_147_127,0.59,-101,26,127,86
28,r_44_116_19,r_113_118_123,r_53_114_36,r_44_116_19,0.82,78,97,19,86
11,r_53_114_36,r_52_131_186,r_44_116_19,r_53_114_36,1.0,0,36,36,86
63,seq28,seq26,r_38_27_20,r_38_27_20,1.0,9,29,20,86
49,r_13_77_95,r_24_149_106,r_80_73_37,r_13_77_95,0.99,0,95,95,86
2,r_82_4_178,seq88,r_69_6_35,r_82_4_178,0.96,0,178,178,86
7,r_85_23_88,seq84,seq25,r_85_23_88,1.0,0,88,88,86
23,r_132_145_95,r_129_75_193,r_24_149_106,r_24_149_106,1.0,13,119,106,86
84,seq89,seq91,r_34_90_105,r_34_90_105,1.0,8,113,105,86
30,r_74_58_178,seq73,r_66_56_119,r_66_56_119,0.88,59,178,119,87
36,r_75_123_58,r_74_58_178,r_122_117_96,r_75_123_58,0.99,0,58,58,87
14,r_77_144_76,r_78_31_143,r_119_142_20,r_77_144_76,1.0,0,76,76,87
43,r_101_145_151,seq100,r_77_144_76,r_101_145_151,0.97,0,151,151,87
4,r_91_51_53,seq95,seq50,r_91_51_53,1.0,0,53,53,87
37,r_33_88_150,seq32,r_85_87_131,r_33_88_150,0.77,0,150,150,87
26,r_14_133_47,r_13_114_44,r_124_136_6,r_14_133_47,1.0,0,47,47,87
71,seq32,r_33_88_150,seq36,r_33_88_150,0.95,0,150,150,87
86,seq73,r_74_58_178,r_104_76_113,r_104_76_113,1.0,66,179,113,87
16,r_129_90_128,seq128,seq92,r_129_90_128,0.97,2,130,128,87
21,r_125_137_130,r_122_117_96,r_84_138_73,r_125_137_130,0.63,0,130,130,87
1,r_98_132_87,seq108,r_84_138_73,r_98_132_87,0.98,0,87,87,87
5,r_104_76_113,r_101_145_151,seq73,r_104_76_113,0.94,0,113,113,87
42,r_85_87_131,r_84_138_73,r_53_83_40,r_85_87_131,0.72,-58,73,131,87
87,seq86,r_66_56_119,r_85_87_131,r_66_56_119,0.84,-104,15,119,87
80,seq55,r_57_34_152,r_66_56_119,r_66_56_119,0.56,33,152,119,87
32,r_111_126_127,r_110_94_123,r_103_120_72,r_110_94_123,0.8,-6,117,123,87
41,r_112_43_30,r_111_126_127,seq44,r_112_43_30,1.0,0,30,30,87
19,r_149_107_182,r_143_106_158,r_82_99_27,r_82_99_27,0.82,155,182,27,87
45,r_110_94_123,r_125_137_130,seq108,r_110_94_123,0.73,-100,23,123,87
31,r_13_114_44,r_14_133_47,seq113,r_13_114_44,0.99,0,44,44,87
76,seq44,r_45_26_167,seq40,r_45_26_167,0.97,0,167,167,87
38,r_72_38_35,r_66_56_119,r_39_140_187,r_72_38_35,1.0,0,35,35,87
38,r_72_38_35,r_39_140_187,r_66_56_119,r_72_38_35,0.56,152,187,35,87
10,r_66_56_119,seq63,seq55,r_66_56_119,0.68,0,119,119,87
72,seq36,r_37_79_86,seq32,r_37_79_86,1.0,-1,85,86,87
8,r_148_2_30,r_149_107_182,seq1,r_148_2_30,1.0,0,30,30,87
63,seq146,r_147_18_179,r_77_144_76,r_77_144_76,1.0,104,180,76,87
11,r_64_81_88,seq63,r_53_83_40,r_53_83_40,0.8,58,98,40,87
29,r_143_106_158,r_77_144_76,seq108,r_143_106_158,1.0,0,158,158,87
48,r_119_142_20,r_118_60_137,r_143_106_158,r_119_142_20,0.97,1,21,20,87
6,r_115_89_175,r_122_117_96,r_129_90_128,r_129_90_128,0.98,47,175,128,87
62,seq15,r_16_21_36,r_28_17_111,r_28_17_111,0.92,0,111,111,87
0,r_53_83_40,r_54_19_150,r_85_87_131,r_53_83_40,0.98,0,40,40,87
2,r_39_140_187,r_72_38_35,r_98_132_87,r_72_38_35,0.52,152,187,35,87
0,r_53_83_40,r_85_87_131,seq86,r_53_83_40,0.5,91,131,40,87
87,seq86,r_85_87_131,r_53_83_40,r_53_83_40,0.91,56,96,40,87
9,r_54_19_150,r_35_52_105,r_16_21_36,r_54_19_150,0.83,1,151,150,87
91,seq97,seq105,r_13_114_44,r_13_114_44,0.27,88,132,44,87
47,r_131_67_156,seq134,seq63,r_131_67_156,0.83,0,156,156,87
3,r_82_99_27,r_85_87_131,seq100,r_82_99_27,0.99,0,27,27,87
40,r_28_17_111,seq29,seq15,r_28_17_111,0.73,0,111,111,87
74,seq40,r_41_68_189,seq44,r_41_68_189,0.96,-48,141,189,87
18,r_37_79_86,seq36,r_46_80_77,r_37_79_86,0.65,0,86,86,87
29,r_143_106_158,r_147_18_179,r_77_144_76,r_77_144_76,1.0,34,110,76,87
19,r_149_107_182,r_139_49_137,r_143_106_158,r_139_49_137,0.53,-82,55,137,87
24,r_0_24_168,seq1,seq23,r_0_24_168,0.54,0,168,168,87
25,r_118_60_137,r_122_117_96,seq59,r_118_60_137,0.95,0,137,137,87
33,r_147_18_179,seq146,r_54_19_150,r_54_19_150,0.42,29,179,150,87
48,r_119_142_20,r_143_106_158,r_77_144_76,r_77_144_76,0.81,82,158,76,87
50,seq128,r_129_90_128,seq141,r_129_90_128,0.96,1,129,128,87
52,seq130,r_131_67_156,r_14_133_47,r_14_133_47,0.9,109,156,47,87
34,r_84_138_73,r_85_87_131,r_14_133_47,r_84_138_73,1.0,0,73,73,87
45,r_110_94_123,seq108,r_9_93_18,r_110_94_123,0.91,0,123,123,87
81,seq59,seq62,r_118_60_137,r_118_60_137,1.0,2,139,137,87
17,r_103_120_72,r_104_76_113,r_122_117_96,r_103_120_72,0.98,13,85,72,87
32,r_111_126_127,r_112_43_30,r_110_94_123,r_112_43_30,1.0,0,30,30,87
22,r_122_117_96,r_115_89_175,r_103_120_72,r_103_120_72,0.97,1,73,72,87
49,r_9_93_18,seq6,seq95,r_9_93_18,0.98,1,19,18,87
7,r_139_49_137,r_131_67_156,r_91_51_53,r_139_49_137,0.86,0,137,137,87
19,r_149_107_182,r_148_2_30,r_139_49_137,r_148_2_30,0.88,0,30,30,87
44,r_61_127_164,seq62,seq128,r_61_127_164,0.82,0,164,164,87
23,r_35_52_105,r_33_88_150,seq59,r_33_88_150,0.88,-44,106,150,87
12,r_3_69_38,seq1,seq70,r_3_69_38,1.0,0,38,38,87
2,r_39_140_187,r_41_68_189,r_72_38_35,r_72_38_35,1.0,1,36,35,87
36,r_68_3_77,seq73,r_12_6_28,r_68_3_77,1.0,1,78,77,88
8,r_17_38_67,r_16_94_143,r_39_46_157,r_17_38_67,1.0,0,67,67,88
4,r_104_83_53,r_108_103_99,seq84,r_104_83_53,0.93,0,53,53,88
22,r_39_46_157,r_17_38_67,seq44,r_39_46_157,0.73,0,157,157,88
37,r_116_34_192,r_134_114_48,r_65_117_97,r_65_117_97,1.0,35,132,97,88
59,seq21,seq24,r_48_20_55,r_48_20_55,1.0,44,99,55,88
21,r_98_139_145,r_99_144_112,r_85_97_72,r_99_144_112,0.57,0,112,112,88
39,r_67_43_99,r_65_117_97,seq44,r_67_43_99,1.0,-2,97,99,88
97,seq121,r_123_140_83,seq118,r_123_140_83,0.89,0,83,83,88
5,r_65_117_97,r_67_43_99,r_134_114_48,r_65_117_97,0.92,0,97,97,88
46,r_112_80_184,seq111,r_42_79_81,r_42_79_81,1.0,101,182,81,88
42,r_14_71_118,r_11_107_164,r_32_70_14,r_14_71_118,0.99,0,118,118,88
60,seq24,seq21,r_77_26_8,r_77_26_8,0.95,32,40,8,88
32,r_85_97_72,r_98_139_145,r_2_90_112,r_85_97_72,0.97,73,145,72,88
69,seq40,r_41_136_111,seq49,r_41_136_111,1.0,0,111,111,88
19,r_89_115_107,seq101,r_134_114_48,r_89_115_107,0.81,0,107,107,88
11,r_47_63_4,r_62_56_81,seq59,r_62_56_81,1.0,0,81,81,88
37,r_116_34_192,r_65_117_97,seq33,r_116_34_192,0.99,0,192,192,88
95,seq111,r_112_80_184,r_122_110_8,r_122_110_8,0.79,176,184,8,88
38,r_148_22_48,seq21,r_106_23_95,r_106_23_95,1.0,14,109,95,88
97,seq121,seq118,r_31_120_164,r_31_120_164,0.6,0,164,164,88
31,r_149_109_74,seq142,r_122_110_8,r_149_109_74,1.0,0,74,74,88
41,r_119_64_66,r_123_140_83,r_67_43_99,r_119_64_66,1.0,0,66,66,88
30,r_12_6_28,r_8_93_129,seq5,r_12_6_28,0.81,6,34,28,88
10,r_74_124_75,seq73,seq126,r_74_124_75,1.0,-3,72,75,88
43,r_125_9_24,r_132_0_89,r_8_93_129,r_125_9_24,0.99,0,24,24,88
73,seq54,r_55_52_106,r_27_53_118,r_27_53_118,0.98,8,126,118,88
26,r_132_0_89,seq133,seq1,r_132_0_89,1.0,0,89,89,88
8,r_17_38_67,r_39_46_157,seq37,r_39_46_157,0.92,0,157,157,88
0,r_41_136_111,seq40,r_135_138_116,r_41_136_111,0.99,0,111,111,88
13,r_55_52_106,r_50_57_1,seq54,r_55_52_106,0.69,1,107,106,88
15,r_7_69_125,seq5,r_32_70_14,r_7_69_125,0.99,0,125,125,88
37,r_116_34_192,r_123_140_83,r_134_114_48,r_116_34_192,0.7,-137,55,192,88
27,r_42_79_81,r_41_136_111,seq81,r_42_79_81,1.0,0,81,81,88
2,r_16_94_143,seq15,r_2_90_112,r_16_94_143,0.45,0,143,143,88
47,r_31_120_164,seq28,seq121,r_31_120_164,0.84,0,164,164,88
40,r_11_107_164,seq15,seq105,r_11_107_164,0.91,0,164,164,88
24,r_123_140_83,seq121,seq145,r_123_140_83,0.86,0,83,83,88
21,r_98_139_145,r_85_97_72,r_123_140_83,r_98_139_145,0.99,0,145,145,88
35,r_8_93_129,r_125_9_24,r_2_90_112,r_125_9_24,0.95,105,129,24,88
43,r_125_9_24,r_8_93_129,seq15,r_8_93_129,1.0,0,129,129,88
33,r_106_23_95,seq105,r_148_22_48,r_106_23_95,0.64,0,95,95,88
13,r_55_52_106,seq54,r_27_53_118,r_27_53_118,0.98,16,134,118,88
50,seq1,r_4_91_170,r_132_0_89,r_132_0_89,0.98,8,97,89,88
61,seq25,r_27_53_118,r_77_26_8,r_27_53_118,0.74,-58,60,118,88
32,r_85_97_72,seq84,r_98_139_145,r_85_97_72,0.74,0,72,72,88
52,seq5,r_7_69_125,r_12_6_28,r_7_69_125,0.63,-53,72,125,88
34,r_113_10_158,r_116_34_192,seq15,r_113_10_158,0.43,0,158,158,88
41,r_119_64_66,r_67_43_99,r_36_66_93,r_119_64_66,0.59,33,99,66,88
17,r_36_66_93,seq37,r_119_64_66,r_36_66_93,1.0,0,93,93,88
35,r_8_93_129,r_12_6_28,r_125_9_24,r_8_93_129,0.8,-94,35,129,88
38,r_148_22_48,r_149_109_74,seq21,r_148_22_48,0.99,1,49,48,88
22,r_39_46_157,seq37,r_17_38_67,r_17_38_67,1.0,36,103,67,88
49,r_27_53_118,seq25,seq54,r_27_53_118,0.75,0,118,118,88
23,r_134_114_48,r_135_138_116,r_116_34_192,r_134_114_48,0.98,0,48,48,88
56,seq15,r_16_94_143,r_11_107_164,r_16_94_143,0.99,-1,142,143,88
7,r_62_56_81,r_47_63_4,r_50_57_1,r_62_56_81,1.0,0,81,81,88
44,r_45_19_60,seq49,seq24,r_45_19_60,1.0,0,60,60,88
12,r_4_91_170,seq5,r_2_90_112,r_2_90_112,0.92,58,170,112,88
28,r_32_70_14,r_27_53_118,seq73,r_32_70_14,1.0,0,14,14,88
23,r_134_114_48,r_116_34_192,r_89_115_107,r_89_115_107,0.98,71,178,107,88
30,r_11_55_171,r_20_129_139,r_84_8_132,r_20_129_139,0.64,-4,135,139,89
36,r_25_64_80,r_24_2_50,seq62,r_25_64_80,1.0,0,80,80,89
8,r_71_91_169,r_73_114_146,seq78,r_73_114_146,0.87,-50,96,146,89
32,r_88_50_10,seq87,seq49,r_88_50_10,0.86,0,10,10,89
37,r_75_19_70,seq76,seq18,r_75_19_70,0.97,0,70,70,89
71,seq49,r_47_89_88,r_88_50_10,r_47_89_88,0.99,-7,81,88,89
21,r_68_41_122,r_67_70_152,r_82_39_67,r_68_41_122,0.99,0,122,122,89
39,r_33_102_148,r_32_9_173,seq103,r_33_102_148,0.64,0,148,148,89
1,r_143_27_17,r_32_9_173,r_135_28_26,r_135_28_26,0.63,94,120,26,89
42,r_4_42_69,r_3_128_162,seq43,r_3_128_162,0.84,-92,70,162,89
18,r_135_28_26,r_134_130_108,r_143_27_17,r_135_28_26,0.91,0,26,26,89
80,seq85,r_84_8_132,seq81,r_84_8_132,1.0,3,135,132,89
45,r_67_70_152,r_68_41_122,r_97_65_112,r_67_70_152,0.82,-30,122,152,89
19,r_20_129_139,seq15,r_134_130_108,r_20_129_139,0.89,0,139,139,89
30,r_11_55_171,r_84_8_132,r_51_59_143,r_11_55_171,0.87,0,171,171,89
31,r_3_128_162,r_4_42_69,r_24_2_50,r_4_42_69,0.95,1,70,69,89
9,r_24_2_50,r_25_64_80,seq1,r_25_64_80,1.0,-22,58,80,89
11,r_96_86_23,r_100_125_49,seq87,r_96_86_23,0.84,0,23,23,89
10,r_80_109_126,seq79,seq108,r_80_109_126,0.98,0,126,126,89
8,r_71_91_169,seq78,seq95,r_71_91_169,0.65,0,169,169,89
17,r_140_46_24,r_145_90_198,r_88_50_10,r_140_46_24,1.0,0,24,24,89
14,r_51_59_143,seq54,r_124_60_84,r_51_59_143,0.91,0,143,143,89
4,r_63_40_181,r_58_77_168,r_25_64_80,r_25_64_80,1.0,4,84,80,89
78,seq79,r_80_109_126,seq85,r_80_109_126,1.0,0,126,126,89
0,r_32_9_173,seq29,r_84_8_132,r_84_8_132,0.77,41,173,132,89
25,r_72_123_30,r_71_91_169,seq122,r_72_123_30,1.0,0,30,30,89
73,seq56,r_57_139_163,r_124_60_84,r_124_60_84,0.97,79,163,84,89
50,seq1,r_3_128_162,r_24_2_50,r_3_128_162,0.69,-109,53,162,89
20,r_10_115_134,r_3_128_162,r_5_116_24,r_3_128_162,0.88,-28,134,162,89
15,r_47_89_88,seq49,r_96_86_23,r_47_89_88,0.79,0,88,88,89
48,r_144_74_137,r_145_90_198,seq81,r_144_74_137,0.82,0,137,137,89
4,r_63_40_181,r_25_64_80,r_140_46_24,r_63_40_181,0.52,0,181,181,89
57,seq17,r_20_129_139,seq22,r_20_129_139,0.99,-3,136,139,89
6,r_53_98_138,seq54,r_149_99_12,r_53_98_138,0.95,0,138,138,89
62,seq22,r_23_111_135,seq18,r_23_111_135,1.0,0,135,135,89
16,r_149_99_12,seq148,seq95,r_149_99_12,1.0,0,12,12,89
5,r_100_125_49,r_121_146_84,seq126,r_121_146_84,0.52,28,112,84,89
34,r_97_65_112,r_67_70_152,r_0_66_144,r_97_65_112,0.94,36,148,112,89
43,r_69_12_42,r_68_41_122,seq13,r_69_12_42,0.97,0,42,42,89
27,r_124_60_84,seq122,seq62,r_124_60_84,1.0,0,84,84,89
47,r_121_146_84,r_124_60_84,seq142,r_124_60_84,0.82,0,84,84,89
40,r_0_66_144,r_20_129_139,r_51_59_143,r_20_129_139,0.36,-33,106,139,89
24,r_127_38_121,r_134_130_108,r_26_37_9,r_127_38_121,0.98,0,121,121,89
35,r_82_39_67,r_88_50_10,r_68_41_122,r_68_41_122,1.0,19,141,122,89
33,r_57_139_163,seq56,seq142,r_57_139_163,0.65,0,163,163,89
38,r_23_111_135,seq22,seq112,r_23_111_135,0.98,0,135,135,89
52,seq137,r_134_130_108,r_83_136_157,r_83_136_157,0.9,18,175,157,89
34,r_97_65_112,seq95,r_67_70_152,r_97_65_112,0.9,0,112,112,89
40,r_0_66_144,r_51_59_143,r_97_65_112,r_97_65_112,0.98,29,141,112,89
45,r_67_70_152,r_97_65_112,seq76,r_67_70_152,0.97,0,152,152,89
41,r_5_116_24,r_7_6_86,seq117,r_5_116_24,1.0,0,24,24,89
31,r_3_128_162,r_24_2_50,r_20_129_139,r_24_2_50,1.0,112,162,50,89
22,r_138_131_163,seq147,r_20_129_139,r_20_129_139,0.96,8,147,139,89
28,r_113_48_99,seq110,r_88_50_10,r_113_48_99,0.93,0,99,99,89
7,r_145_90_198,r_144_74_137,r_121_146_84,r_145_90_198,0.94,-61,137,198,89
44,r_58_77_168,r_63_40_181,seq78,r_58_77_168,0.62,0,168,168,89
1,r_143_27_17,r_145_90_198,r_32_9_173,r_143_27_17,1.0,0,17,17,89
23,r_83_136_157,seq85,seq137,r_83_136_157,0.54,0,157,157,89
5,r_100_125_49,r_97_65_112,r_121_146_84,r_100_125_49,0.97,0,49,49,89
35,r_82_39_67,seq81,r_88_50_10,r_82_39_67,0.77,0,67,67,89
84,seq95,r_97_65_112,r_149_99_12,r_97_65_112,0.89,0,112,112,89
44,r_116_143_184,seq120,r_77_117_116,r_77_117_116,0.98,0,116,116,90
71,seq42,r_65_39_76,r_82_44_111,r_82_44_111,0.89,1,112,111,90
51,seq2,r_0_69_82,seq16,r_0_69_82,0.98,0,82,82,90
36,r_53_20_117,seq52,seq14,r_53_20_117,1.0,0,117,117,90
14,r_33_85_180,seq34,r_12_84_142,r_12_84_142,0.84,38,180,142,90
8,r_0_69_82,seq2,seq67,r_0_69_82,1.0,0,82,82,90
43,r_38_149_175,r_37_123_76,seq9,r_37_123_76,0.69,0,76,76,90
20,r_92_72_39,seq93,r_71_45_158,r_92_72_39,1.0,0,39,39,90
45,r_37_123_76,seq120,r_103_124_102,r_103_124_102,0.79,7,109,102,90
71,seq42,r_41_97_79,r_65_39_76,r_41_97_79,0.59,-3,76,79,90
39,r_65_39_76,seq68,seq42,r_65_39_76,0.92,1,77,76,90
1,r_86_1_164,r_88_73_174,seq2,r_86_1_164,0.66,0,164,164,90
5,r_82_44_111,seq81,seq42,r_82_44_111,0.99,0,111,111,90
42,r_105_30_111,seq98,r_19_35_61,r_105_30_111,0.97,0,111,111,90
80,seq60,seq68,r_112_61_126,r_112_61_126,1.0,28,154,126,90
45,r_37_123_76,r_38_149_175,seq120,r_37_123_76,0.96,0,76,76,90
16,r_91_111_26,seq94,seq109,r_91_111_26,0.88,-2,24,26,90
19,r_112_61_126,r_113_107_84,seq60,r_112_61_126,0.93,1,127,126,90
30,r_62_90_46,r_71_45_158,r_74_89_8,r_62_90_46,0.78,0,46,46,90
95,seq115,seq114,r_56_99_110,r_56_99_110,1.0,50,160,110,90
31,r_87_27_80,r_88_73_174,seq29,r_87_27_80,1.0,0,80,80,90
41,r_126_66_197,r_127_59_203,r_0_69_82,r_0_69_82,0.97,115,197,82,90
67,seq23,r_22_145_176,r_55_25_142,r_55_25_142,0.96,34,176,142,90
3,r_106_133_102,r_105_30_111,r_17_132_30,r_106_133_102,0.96,3,105,102,90
10,r_103_124_102,r_105_30_111,r_37_123_76,r_103_124_102,0.66,0,102,102,90
90,seq96,seq114,r_41_97_79,r_41_97_79,1.0,0,79,79,90
26,r_22_145_176,seq23,r_141_146_37,r_141_146_37,0.79,139,176,37,90
21,r_130_15_144,r_17_132_30,r_53_20_117,r_130_15_144,1.0,0,144,144,90
0,r_55_25_142,r_54_40_191,seq23,r_55_25_142,0.98,0,142,142,90
43,r_38_149_175,seq9,r_57_6_87,r_57_6_87,0.55,10,97,87,90
11,r_28_135_86,seq29,seq134,r_28_135_86,1.0,0,86,86,90
13,r_41_97_79,seq42,seq96,r_41_97_79,1.0,0,79,79,90
81,seq63,r_71_45_158,r_43_64_51,r_43_64_51,0.62,-3,48,51,90
4,r_17_132_30,seq134,r_106_133_102,r_106_133_102,0.99,-1,101,102,90
6,r_88_73_174,r_86_1_164,r_0_69_82,r_0_69_82,1.0,83,165,82,90
43,r_38_149_175,r_57_6_87,seq148,r_38_149_175,1.0,0,175,175,90
49,r_74_89_8,r_82_44_111,seq93,r_74_89_8,0.82,7,15,8,90
12,r_36_110_42,r_38_149_175,seq109,r_36_110_42,1.0,0,42,42,90
2,r_56_99_110,seq58,r_131_102_5,r_56_99_110,0.96,0,110,110,90
47,r_77_117_116,seq81,r_116_143_184,r_77_117_116,0.69,0,116,116,90
29,r_129_18_119,r_127_59_203,seq16,r_129_18_119,0.92,2,121,119,90
28,r_75_95_57,seq76,seq94,r_75_95_57,1.0,0,57,57,90
24,r_113_107_84,seq109,r_122_108_114,r_122_108_114,0.7,11,125,114,90
48,r_43_64_51,r_41_97_79,seq63,r_43_64_51,0.51,-4,47,51,90
34,r_12_84_142,seq13,seq48,r_12_84_142,0.96,0,142,142,90
35,r_71_45_158,r_92_72_39,r_82_44_111,r_92_72_39,0.9,119,158,39,90
4,r_17_132_30,seq14,seq134,r_17_132_30,1.0,1,31,30,90
47,r_77_117_116,r_116_143_184,r_103_124_102,r_77_117_116,0.49,68,184,116,90
58,seq9,r_11_51_169,seq8,r_11_51_169,0.66,0,169,169,90
70,seq34,r_33_85_180,r_19_35_61,r_19_35_61,1.0,22,83,61,90
20,r_92_72_39,r_71_45_158,r_112_61_126,r_112_61_126,0.68,34,160,126,90
61,seq13,r_12_84_142,seq9,r_12_84_142,1.0,-9,133,142,90
32,r_32_121_168,r_33_85_180,r_103_124_102,r_32_121_168,0.62,0,168,168,90
38,r_19_35_61,r_22_145_176,seq34,r_19_35_61,0.98,0,61,61,90
21,r_130_15_144,seq120,r_17_132_30,r_130_15_144,0.83,-55,89,144,90
77,seq52,r_53_20_117,r_54_40_191,r_53_20_117,1.0,0,117,117,90
34,r_12_84_142,r_22_145_176,seq13,r_22_145_176,0.74,-109,67,176,90
93,seq109,r_113_107_84,r_36_110_42,r_36_110_42,1.0,1,43,42,90
17,r_57_6_87,r_56_99_110,seq7,r_57_6_87,1.0,0,87,87,90
49,r_74_89_8,seq93,r_62_90_46,r_62_90_46,1.0,5,51,46,90
9,r_54_40_191,r_55_25_142,seq52,r_55_25_142,1.0,-1,141,142,90
96,seq119,r_118_31_137,r_103_124_102,r_118_31_137,0.7,1,138,137,90
22,r_122_108_114,r_118_31_137,r_113_107_84,r_118_31_137,0.64,-23,114,137,90
35,r_71_45_158,r_62_90_46,r_92_72_39,r_71_45_158,1.0,-118,40,158,90
56,seq7,seq3,r_57_6_87,r_57_6_87,1.0,24,111,87,90
7,r_118_31_137,seq119,r_19_35_61,r_118_31_137,0.93,1,138,137,90
94,seq114,seq115,r_56_99_110,r_56_99_110,1.0,31,141,110,90
9,r_54_40_191,seq52,r_65_39_76,r_65_39_76,0.75,115,191,76,90
34,r_12_84_142,seq48,r_33_85_180,r_12_84_142,0.48,39,181,142,90
44,r_116_143_184,r_77_117_116,seq142,r_116_143_184,0.64,0,184,184,90
25,r_95_55_43,r_96_127_179,seq54,r_95_55_43,1.0,0,43,43,91
14,r_6_77_163,seq5,seq78,r_6_77_163,0.83,0,163,163,91
18,r_84_47_39,r_85_148_55,r_49_149_174,r_84_47_39,0.99,0,39,39,91
8,r_73_74_79,seq71,seq68,r_73_74_79,0.43,4,83,79,91
95,seq122,r_120_50_66,r_44_121_14,r_120_50_66,0.79,-31,35,66,91
37,r_58_90_91,r_60_1_133,r_82_91_75,r_58_90_91,0.98,0,91,91,91
42,r_61_72_38,r_62_145_189,r_114_70_9,r_61_72_38,0.69,14,52,38,91
21,r_57_53_161,r_60_1_133,r_95_55_43,r_57_53_161,0.99,-28,133,161,91
39,r_46_40_105,seq45,r_57_53_161,r_46_40_105,0.97,0,105,105,91
1,r_117_25_61,seq115,seq29,r_117_25_61,1.0,0,61,61,91
5,r_18_8_76,r_21_86_108,seq9,r_18_8_76,1.0,0,76,76,91
46,r_65_142_149,seq66,seq141,r_65_142_149,0.69,0,149,149,91
45,r_96_127_179,seq98,r_140_128_17,r_140_128_17,0.52,164,181,17,91
0,r_69_144_46,seq68,seq146,r_69_144_46,0.95,3,49,46,91
79,seq68,r_73_74_79,r_42_67_100,r_42_67_100,0.9,-6,94,100,91
69,seq30,r_31_92_40,seq29,r_31_92_40,1.0,-9,31,40,91
31,r_21_86_108,r_16_20_26,r_75_87_39,r_21_86_108,0.98,1,109,108,91
38,r_75_87_39,r_65_142_149,seq88,r_75_87_39,0.79,0,39,39,91
3,r_103_35_147,r_14_104_3,seq36,r_103_35_147,0.74,0,147,147,91
10,r_42_67_100,r_41_3_79,seq68,r_41_3_79,0.72,1,80,79,91
90,seq107,r_105_80_180,r_59_106_70,r_59_106_70,1.0,66,136,70,91
26,r_59_106_70,r_60_1_133,seq107,r_59_106_70,0.97,0,70,70,91
8,r_73_74_79,seq68,r_61_72_38,r_61_72_38,0.53,145,183,38,91
38,r_75_87_39,r_73_74_79,r_65_142_149,r_73_74_79,0.59,-50,29,79,91
11,r_60_1_133,r_57_53_161,r_41_3_79,r_57_53_161,1.0,-28,133,161,91
0,r_69_144_46,seq146,r_113_143_59,r_69_144_46,0.5,21,67,46,91
20,r_41_3_79,r_42_67_100,r_2_102_178,r_41_3_79,0.98,0,79,79,91
48,r_10_76_94,r_11_13_192,r_108_81_84,r_10_76_94,0.98,0,94,94,91
7,r_79_101_48,r_82_91_75,r_14_104_3,r_14_104_3,1.0,45,48,3,91
57,seq9,r_11_13_192,r_119_12_49,r_119_12_49,1.0,143,192,49,91
6,r_105_80_180,seq107,r_108_81_84,r_108_81_84,1.0,96,180,84,91
62,seq147,seq146,r_85_148_55,r_85_148_55,1.0,13,68,55,91
13,r_39_19_17,r_38_63_182,r_16_20_26,r_39_19_17,0.81,-1,16,17,91
43,r_49_149_174,r_46_40_105,r_84_47_39,r_84_47_39,0.87,3,42,39,91
27,r_82_91_75,seq83,r_31_92_40,r_82_91_75,1.0,0,75,75,91
19,r_37_100_42,r_38_63_182,r_14_104_3,r_37_100_42,1.0,0,42,42,91
17,r_119_12_49,r_113_143_59,seq9,r_119_12_49,1.0,0,49,49,91
2,r_110_133_183,seq109,r_131_134_45,r_131_134_45,0.89,138,183,45,91
40,r_137_112_83,r_138_26_142,seq115,r_138_26_142,0.91,-59,83,142,91
74,seq45,r_46_40_105,seq51,r_46_40_105,0.99,0,105,105,91
24,r_62_145_189,r_61_72_38,seq68,r_61_72_38,0.46,46,84,38,91
43,r_49_149_174,r_84_47_39,r_85_148_55,r_49_149_174,0.74,0,174,174,91
86,seq94,r_96_127_179,r_31_92_40,r_31_92_40,1.0,14,54,40,91
50,seq0,r_2_102_178,r_41_3_79,r_41_3_79,1.0,99,178,79,91
20,r_41_3_79,r_2_102_178,r_60_1_133,r_60_1_133,0.93,45,178,133,91
33,r_44_121_14,r_52_32_39,seq122,r_44_121_14,0.95,1,15,14,91
34,r_28_48_115,seq29,r_84_47_39,r_28_48_115,0.98,0,115,115,91
16,r_113_143_59,seq115,r_69_144_46,r_69_144_46,0.65,13,59,46,91
28,r_131_134_45,seq132,seq135,r_131_134_45,0.68,8,53,45,91
60,seq15,r_16_20_26,r_39_19_17,r_39_19_17,0.85,106,123,17,91
81,seq78,seq83,r_6_77_163,r_6_77_163,0.87,0,163,163,91
79,seq68,r_69_144_46,r_73_74_79,r_69_144_46,0.79,0,46,46,91
22,r_118_93_80,r_117_25_61,r_31_92_40,r_118_93_80,0.94,-21,59,80,91
76,seq54,r_49_149_174,r_95_55_43,r_95_55_43,0.94,0,43,43,91
91,seq109,r_110_133_183,r_59_106_70,r_59_106_70,1.0,111,181,70,91
49,r_2_102_178,seq0,r_79_101_48,r_79_101_48,0.54,130,178,48,91
32,r_120_50_66,seq124,seq43,r_120_50_66,0.85,0,66,66,91
18,r_84_47_39,r_49_149_174,r_120_50_66,r_84_47_39,0.75,135,174,39,91
23,r_138_26_142,seq136,seq27,r_138_26_142,0.87,0,142,142,91
30,r_31_92_40,seq30,seq94,r_31_92_40,1.0,1,41,40,91
35,r_16_20_26,r_21_86_108,r_39_19_17,r_21_86_108,0.78,1,109,108,91
12,r_108_81_84,r_110_133_183,seq83,r_108_81_84,0.99,0,84,84,91
30,r_13_137_99,r_11_4_91,r_126_9_12,r_13_137_99,0.84,-31,68,99,92
51,seq3,seq1,r_105_2_11,r_105_2_11,0.71,100,111,11,92
23,r_50_42_18,seq52,r_39_51_121,r_50_42_18,1.0,0,18,18,92
25,r_48_16_46,seq46,seq18,r_48_16_46,1.0,0,46,46,92
8,r_113_68_90,seq114,seq65,r_113_68_90,0.96,0,90,90,92
43,r_108_84_151,r_103_104_126,seq85,r_108_84_151,0.68,0,151,151,92
36,r_53_142_24,r_54_133_96,seq136,r_53_142_24,0.99,0,24,24,92
29,r_83_55_192,r_139_89_33,r_80_64_182,r_83_55_192,0.47,-101,91,192,92
54,seq15,r_6_19_37,r_63_14_96,r_63_14_96,1.0,1,97,96,92
37,r_54_133_96,seq52,seq135,r_54_133_96,0.99,0,96,96,92
59,seq24,r_27_116_104,seq25,r_27_116_104,1.0,-1,103,104,92
21,r_81_143_187,r_80_64_182,r_5_149_12,r_81_143_187,0.41,-3,184,187,92
39,r_145_60_133,r_144_107_158,seq59,r_145_60_133,0.89,0,133,133,92
1,r_62_71_9,r_69_138_178,r_113_68_90,r_62_71_9,0.65,169,178,9,92
29,r_83_55_192,r_80_64_182,seq85,r_83_55_192,0.61,-49,143,192,92
5,r_94_121_180,seq93,seq122,r_94_121_180,0.6,0,180,180,92
70,seq52,seq49,r_39_51_121,r_39_51_121,1.0,3,124,121,92
45,r_45_37_102,seq49,seq38,r_45_37_102,0.95,-2,100,102,92
7,r_35_91_49,seq36,r_101_90_14,r_35_91_49,1.0,0,49,49,92
19,r_47_33_93,seq46,seq36,r_47_33_93,1.0,-1,92,93,92
31,r_27_116_104,seq24,seq118,r_27_116_104,1.0,0,104,104,92
41,r_101_90_14,seq92,r_35_91_49,r_35_91_49,1.0,17,66,49,92
26,r_10_100_11,r_11_4_91,r_102_99_180,r_10_100_11,0.67,0,11,11,92
3,r_98_78_88,r_102_99_180,r_123_79_2,r_98_78_88,0.99,0,88,88,92
30,r_13_137_99,r_126_9_12,r_23_141_61,r_13_137_99,0.96,0,99,99,92
48,r_147_148_60,r_145_60_133,r_5_149_12,r_147_148_60,0.7,-8,52,60,92
4,r_34_56_149,seq36,seq59,r_34_56_149,0.95,0,149,149,92
0,r_17_40_62,seq18,r_50_42_18,r_17_40_62,0.8,0,62,62,92
73,seq59,seq57,r_145_60_133,r_145_60_133,0.88,30,163,133,92
11,r_76_134_108,r_123_79_2,r_54_133_96,r_76_134_108,0.94,0,108,108,92
20,r_82_43_72,r_83_55_192,seq38,r_82_43_72,0.97,0,72,72,92
13,r_39_51_121,seq38,seq52,r_39_51_121,0.78,0,121,121,92
98,seq122,r_98_78_88,seq111,r_98_78_88,0.84,-13,75,88,92
10,r_96_22_56,r_102_99_180,r_6_19_37,r_96_22_56,0.92,0,56,56,92
6,r_132_30_122,seq135,seq31,r_132_30_122,0.99,0,122,122,92
50,seq1,seq3,r_105_2_11,r_105_2_11,0.99,0,11,11,92
40,r_74_70_177,r_123_79_2,r_62_71_9,r_62_71_9,0.7,168,177,9,92
18,r_41_124_114,r_39_51_121,seq127,r_41_124_114,1.0,0,114,114,92
29,r_83_55_192,r_82_43_72,r_139_89_33,r_83_55_192,0.95,-120,72,192,92
29,r_83_55_192,seq85,r_39_51_121,r_39_51_121,0.66,71,192,121,92
33,r_80_64_182,r_81_143_187,r_62_71_9,r_80_64_182,0.4,0,182,182,92
64,seq36,r_34_56_149,r_47_33_93,r_47_33_93,0.89,56,149,93,92
70,seq52,r_54_133_96,seq49,r_54_133_96,0.98,0,96,96,92
65,seq38,r_44_0_189,r_45_37_102,r_45_37_102,1.0,45,147,102,92
68,seq46,r_47_33_93,seq49,r_47_33_93,1.0,0,93,93,92
84,seq88,r_86_12_177,r_139_89_33,r_139_89_33,1.0,1,34,33,92
32,r_63_14_96,seq67,seq15,r_63_14_96,0.99,0,96,96,92
24,r_139_89_33,r_125_140_4,seq88,r_139_89_33,0.99,1,34,33,92
34,r_126_9_12,r_132_30_122,seq15,r_126_9_12,0.81,0,12,12,92
28,r_11_4_91,r_6_19_37,seq3,r_11_4_91,0.62,0,91,91,92
49,r_117_130_94,seq118,seq131,r_117_130_94,1.0,0,94,94,92
44,r_23_141_61,seq20,seq136,r_23_141_61,1.0,0,61,61,92
35,r_69_138_178,r_62_71_9,r_125_140_4,r_69_138_178,0.34,0,178,178,92
42,r_5_149_12,r_11_4_91,r_147_148_60,r_5_149_12,1.0,0,12,12,92
2,r_105_2_11,r_98_78_88,seq1,r_105_2_11,0.95,0,11,11,92
23,r_50_42_18,r_39_51_121,r_17_40_62,r_50_42_18,0.81,103,121,18,92
40,r_125_79_11,r_78_115_137,seq76,r_78_115_137,0.99,0,137,137,93
30,r_70_56_70,seq69,seq55,r_70_56_70,1.0,0,70,70,93
36,r_104_89_163,r_103_0_128,r_50_102_14,r_104_89_163,0.92,-35,128,163,93
17,r_17_121_57,seq3,seq123,r_17_121_57,1.0,0,57,57,93
14,r_64_16_158,seq61,r_82_15_41,r_82_15_41,0.97,118,159,41,93
57,seq14,r_8_7_50,r_82_15_41,r_82_15_41,1.0,7,48,41,93
8,r_63_36_84,r_64_16_158,seq35,r_63_36_84,1.0,1,85,84,93
21,r_144_57_36,r_58_30_54,r_5_59_51,r_144_57_36,0.93,18,54,36,93
9,r_95_83_16,r_125_79_11,r_45_81_67,r_45_81_67,0.96,-2,65,67,93
83,seq76,r_78_115_137,r_125_79_11,r_78_115_137,0.56,-64,73,137,93
37,r_130_21_67,seq134,seq18,r_130_21_67,1.0,0,67,67,93
59,seq18,seq3,r_130_21_67,r_130_21_67,1.0,5,72,67,93
24,r_24_54_59,r_25_84_122,seq55,r_24_54_59,0.98,0,59,59,93
26,r_51_38_55,seq49,seq35,r_51_38_55,0.92,0,55,55,93
16,r_87_132_104,seq86,seq134,r_87_132_104,0.7,0,104,104,93
1,r_58_30_54,seq35,r_145_31_91,r_58_30_54,0.64,61,115,54,93
97,seq116,r_114_43_165,r_12_117_109,r_12_117_109,0.98,38,147,109,93
42,r_19_26_94,seq18,r_77_27_23,r_19_26_94,0.99,0,94,94,93
9,r_95_83_16,r_82_15_41,r_125_79_11,r_82_15_41,0.91,4,45,41,93
35,r_45_81_67,r_44_122_50,seq49,r_44_122_50,0.98,0,50,50,93
69,seq42,r_41_99_144,r_70_56_70,r_70_56_70,0.99,74,144,70,93
45,r_25_84_122,r_28_29_173,r_100_85_95,r_25_84_122,0.98,0,122,122,93
19,r_92_60_190,seq91,r_129_93_42,r_129_93_42,0.76,91,133,42,93
33,r_12_117_109,r_74_11_27,seq116,r_12_117_109,1.0,0,109,109,93
33,r_12_117_109,r_13_23_34,r_74_11_27,r_12_117_109,0.98,-75,34,109,93
11,r_74_11_27,r_12_117_109,r_82_15_41,r_12_117_109,0.84,0,109,109,93
66,seq146,seq142,r_87_132_104,r_87_132_104,0.87,19,123,104,93
35,r_45_81_67,seq49,r_95_83_16,r_45_81_67,0.92,0,67,67,93
31,r_41_99_144,seq42,seq98,r_41_99_144,0.61,0,144,144,93
11,r_74_11_27,seq75,r_12_117_109,r_74_11_27,0.99,0,27,27,93
9,r_95_83_16,seq94,r_82_15_41,r_95_83_16,0.67,0,16,16,93
47,r_78_115_137,r_77_27_23,r_125_79_11,r_78_115_137,0.95,-125,12,137,93
23,r_13_23_34,r_12_117_109,seq22,r_13_23_34,0.98,0,34,34,93
15,r_10_96_11,seq14,seq112,r_10_96_11,0.99,0,11,11,93
2,r_82_15_41,r_77_27_23,r_95_83_16,r_82_15_41,0.65,-25,16,41,93
4,r_100_85_95,seq98,r_45_81_67,r_100_85_95,1.0,0,95,95,93
0,r_28_29_173,r_25_84_122,r_77_27_23,r_25_84_122,0.85,-10,112,122,93
64,seq34,r_145_31_91,r_63_36_84,r_145_31_91,0.48,68,159,91,93
20,r_47_127_126,seq46,seq126,r_47_127_126,0.61,0,126,126,93
13,r_6_9_137,seq3,r_74_11_27,r_74_11_27,1.0,114,141,27,93
98,seq123,r_119_147_171,r_17_121_57,r_17_121_57,1.0,114,171,57,93
46,r_77_27_23,r_28_29_173,r_19_26_94,r_19_26_94,1.0,37,131,94,93
1,r_58_30_54,r_64_16_158,seq35,r_58_30_54,0.97,0,54,54,93
6,r_33_37_126,seq34,r_51_38_55,r_51_38_55,0.84,74,129,55,93
48,r_72_118_10,r_74_11_27,seq123,r_72_118_10,0.96,0,10,10,93
99,seq126,r_128_73_170,r_47_127_126,r_47_127_126,0.76,45,171,126,93
41,r_97_90_51,r_106_124_178,seq91,r_97_90_51,0.89,-5,46,51,93
40,r_125_79_11,r_141_88_122,r_78_115_137,r_125_79_11,0.97,-1,10,11,93
74,seq55,seq53,r_70_56_70,r_70_56_70,1.0,12,82,70,93
36,r_104_89_163,r_50_102_14,r_141_88_122,r_104_89_163,0.73,0,163,163,93
18,r_32_140_81,seq39,r_20_138_50,r_32_140_81,1.0,0,81,81,93
27,r_44_122_50,r_45_81_67,seq123,r_44_122_50,1.0,0,50,50,93
25,r_103_0_128,r_104_89_163,seq1,r_103_0_128,0.94,0,128,128,93
64,seq34,r_33_37_126,r_145_31_91,r_145_31_91,1.0,31,122,91,93
82,seq75,r_125_79_11,r_139_71_106,r_139_71_106,1.0,26,132,106,93
47,r_78_115_137,r_125_79_11,r_12_117_109,r_78_115_137,0.99,0,137,137,93
50,seq1,seq3,r_103_0_128,r_103_0_128,0.99,2,130,128,93
34,r_106_124_178,seq107,r_87_132_104,r_87_132_104,0.33,69,173,104,93
32,r_145_31_91,seq146,r_58_30_54,r_145_31_91,0.94,0,91,91,93
38,r_105_120_130,r_106_124_178,r_44_122_50,r_44_122_50,1.0,80,130,50,93
34,r_106_124_178,r_105_120_130,seq107,r_106_124_178,0.4,-48,130,178,93
21,r_144_57_36,r_141_88_122,r_58_30_54,r_144_57_36,0.88,2,38,36,93
81,seq69,r_70_56_70,seq61,r_70_56_70,1.0,-1,69,70,93
46,r_77_27_23,r_78_115_137,r_28_29_173,r_77_27_23,0.8,0,23,23,93
39,r_50_102_14,r_51_38_55,seq107,r_50_102_14,0.93,1,15,14,93
29,r_129_93_42,r_130_21_67,seq94,r_130_21_67,0.79,-25,42,67,93
22,r_128_73_170,seq126,r_139_71_106,r_139_71_106,1.0,64,170,106,93
10,r_5_59_51,r_6_9_137,r_144_57_36,r_5_59_51,1.0,0,51,51,93
2,r_82_15_41,r_95_83_16,seq14,r_82_15_41,0.99,2,43,41,93
44,r_139_71_106,seq137,seq75,r_139_71_106,0.59,0,106,106,93
35,r_45_81_67,r_95_83_16,r_100_85_95,r_100_85_95,1.0,18,113,95,93
93,seq99,r_98_131_190,r_31_103_146,r_31_103_146,1.0,44,190,146,94
41,r_19_9_45,seq16,r_8_2_187,r_19_9_45,0.87,0,45,45,94
40,r_141_104_158,r_4_143_10,r_142_107_122,r_4_143_10,0.86,145,155,10,94
30,r_124_129_95,r_123_121_177,r_96_128_81,r_96_128_81,0.84,28,109,81,94
44,r_4_143_10,r_142_107_122,r_141_104_158,r_142_107_122,0.83,-13,109,122,94
51,seq7,r_8_2_187,r_13_0_50,r_13_0_50,0.92,129,179,50,94
15,r_126_10_14,r_123_121_177,seq12,r_126_10_14,0.98,0,14,14,94
43,r_45_110_61,seq41,seq113,r_45_110_61,1.0,0,61,61,94
46,r_61_46_8,r_48_97_169,r_100_47_69,r_100_47_69,0.93,9,78,69,94
80,seq69,r_68_91_174,r_127_70_129,r_127_70_129,0.77,45,174,129,94
9,r_25_133_38,r_27_146_130,r_87_134_25,r_25_133_38,1.0,2,40,38,94
12,r_89_119_124,r_123_121_177,r_102_120_142,r_102_120_142,0.97,13,155,142,94
3,r_123_121_177,r_124_129_95,r_89_119_124,r_123_121_177,0.64,-60,117,177,94
90,seq90,r_89_119_124,seq93,r_89_119_124,0.97,-33,91,124,94
26,r_31_103_146,seq36,seq99,r_31_103_146,0.73,0,146,146,94
4,r_105_80_143,seq108,r_72_78_15,r_105_80_143,0.52,0,143,143,94
11,r_96_128_81,r_94_79_144,r_124_129_95,r_94_79_144,0.49,-63,81,144,94
20,r_50_60_107,r_48_97_169,r_125_65_5,r_48_97_169,0.85,-62,107,169,94
19,r_92_135_6,seq140,r_87_134_25,r_87_134_25,1.0,2,27,25,94
13,r_68_91_174,seq69,seq90,r_68_91_174,0.53,0,174,174,94
98,seq118,r_117_73_169,r_112_116_19,r_117_73_169,0.49,0,169,169,94
48,r_57_138_93,seq58,r_130_136_41,r_57_138_93,0.99,0,93,93,94
18,r_23_149_31,seq20,seq147,r_23_149_31,0.93,0,31,31,94
6,r_100_47_69,seq108,r_61_46_8,r_100_47_69,1.0,0,69,69,94
63,seq33,r_38_28_44,r_49_35_42,r_49_35_42,0.86,12,54,42,94
8,r_87_134_25,r_86_24_137,r_92_135_6,r_87_134_25,0.98,0,25,25,94
10,r_130_136_41,r_87_134_25,r_57_138_93,r_57_138_93,1.0,20,113,93,94
2,r_127_70_129,r_124_129_95,seq69,r_127_70_129,0.91,0,129,129,94
10,r_130_136_41,r_127_70_129,r_87_134_25,r_130_136_41,0.61,0,41,41,94
37,r_142_107_122,r_141_104_158,r_4_143_10,r_4_143_10,0.98,0,10,10,94
40,r_141_104_158,r_142_107_122,r_4_143_10,r_141_104_158,0.47,-74,84,158,94
53,seq12,r_13_0_50,r_126_10_14,r_13_0_50,1.0,-3,47,50,94
29,r_48_97_169,seq52,r_31_103_146,r_48_97_169,0.56,0,169,169,94
45,r_49_35_42,r_48_97_169,seq33,r_49_35_42,0.97,4,46,42,94
25,r_83_71_129,seq84,r_72_78_15,r_83_71_129,0.81,0,129,129,94
33,r_63_26_86,seq64,seq22,r_63_26_86,0.89,11,97,86,94
47,r_122_1_14,r_3_40_82,r_13_0_50,r_3_40_82,0.69,0,82,82,94
44,r_4_143_10,r_141_104_158,seq144,r_141_104_158,0.99,0,158,158,94
44,r_4_143_10,seq5,r_142_107_122,r_4_143_10,0.96,0,10,10,94
36,r_13_0_50,seq12,r_122_1_14,r_13_0_50,1.0,0,50,50,94
32,r_8_2_187,seq7,r_19_9_45,r_19_9_45,1.0,71,116,45,94
38,r_102_120_142,r_101_44_180,r_89_119_124,r_101_44_180,0.5,-38,142,180,94
47,r_122_1_14,r_123_121_177,r_3_40_82,r_122_1_14,1.0,-1,13,14,94
34,r_86_24_137,seq88,seq16,r_86_24_137,0.75,0,137,137,94
42,r_6_81_27,seq7,seq84,r_6_81_27,1.0,0,27,27,94
81,seq140,seq137,r_130_136_41,r_130_136_41,0.57,29,70,41,94
17,r_101_44_180,r_98_131_190,r_109_43_180,r_98_131_190,0.35,-10,180,190,94
37,r_142_107_122,r_4_143_10,seq108,r_142_107_122,0.94,0,122,122,94
91,seq93,r_94_79_144,seq90,r_94_79_144,0.81,0,144,144,94
24,r_32_132_15,r_31_103_146,r_92_135_6,r_32_132_15,0.81,0,15,15,94
49,r_106_14_134,seq108,seq16,r_106_14_134,0.92,0,134,134,94
7,r_112_116_19,r_111_11_57,seq118,r_111_11_57,0.93,-30,27,57,94
0,r_111_11_57,r_114_139_131,seq12,r_111_11_57,0.99,0,57,57,94
22,r_15_95_23,r_23_149_31,seq93,r_15_95_23,0.87,0,23,23,94
35,r_3_40_82,seq5,seq41,r_3_40_82,0.92,0,82,82,94
8,r_90_141_77,r_88_51_173,seq145,r_90_141_77,0.89,0,77,77,95
3,r_148_21_198,r_114_147_61,r_34_136_11,r_34_136_11,0.63,142,153,11,95
55,seq7,r_8_22_117,r_122_9_68,r_122_9_68,1.0,1,69,68,95
71,seq50,r_49_23_161,seq45,r_49_23_161,0.63,-26,135,161,95
21,r_91_119_168,r_88_51_173,seq120,r_88_51_173,0.6,-5,168,173,95
39,r_122_9_68,seq120,seq7,r_122_9_68,1.0,0,68,68,95
30,r_46_144_24,seq45,seq145,r_46_144_24,0.99,-1,23,24,95
41,r_52_84_198,r_57_89_57,r_95_53_21,r_52_84_198,0.99,-177,21,198,95
5,r_6_132_94,seq5,r_19_131_6,r_6_132_94,0.97,0,94,94,95
45,r_71_32_80,r_70_28_118,r_146_33_24,r_71_32_80,0.99,0,80,80,95
27,r_61_18_172,r_95_53_21,r_24_20_119,r_61_18_172,0.69,1,173,172,95
97,seq120,r_122_9_68,seq135,r_122_9_68,1.0,-15,53,68,95
11,r_133_27_34,r_130_129_48,seq14,r_133_27_34,0.99,0,34,34,95
26,r_134_111_118,r_130_129_48,seq110,r_134_111_118,0.55,0,118,118,95
48,r_12_142_40,r_25_83_197,seq145,r_12_142_40,1.0,0,40,40,95
0,r_125_117_131,seq126,r_37_115_83,r_37_115_83,0.8,48,131,83,95
20,r_107_121_194,seq110,r_6_132_94,r_6_132_94,1.0,100,194,94,95
4,r_25_83_197,r_44_26_34,r_57_89_57,r_57_89_57,0.9,140,197,57,95
57,seq138,r_140_118_172,r_116_139_51,r_116_139_51,0.99,122,173,51,95
12,r_114_147_61,r_148_21_198,r_34_136_11,r_34_136_11,0.48,141,152,11,95
4,r_25_83_197,r_24_20_119,r_44_26_34,r_44_26_34,1.0,0,34,34,95
42,r_29_100_36,r_25_83_197,seq102,r_29_100_36,1.0,0,36,36,95
27,r_61_18_172,r_62_108_156,r_95_53_21,r_95_53_21,0.72,133,154,21,95
6,r_99_15_49,seq102,seq14,r_99_15_49,1.0,1,50,49,95
2,r_37_115_83,seq38,r_19_131_6,r_37_115_83,0.97,0,83,83,95
41,r_52_84_198,r_95_53_21,r_25_83_197,r_25_83_197,0.7,1,198,197,95
15,r_149_106_33,r_148_21_198,seq110,r_149_106_33,0.65,0,33,33,95
40,r_79_0_167,seq78,r_101_10_4,r_79_0_167,0.66,1,168,167,95
74,seq60,r_61_18_172,seq50,r_61_18_172,0.97,0,172,172,95
36,r_44_26_34,seq45,r_25_83_197,r_44_26_34,1.0,0,34,34,95
24,r_8_22_117,seq7,r_70_28_118,r_70_28_118,0.99,8,126,118,95
35,r_95_53_21,r_52_84_198,r_88_51_173,r_88_51_173,0.99,14,187,173,95
25,r_59_63_189,seq56,seq64,r_59_63_189,0.44,1,190,189,95
33,r_55_98_59,seq56,r_29_100_36,r_55_98_59,1.0,1,60,59,95
37,r_66_41_54,seq67,seq38,r_66_41_54,1.0,0,54,54,95
44,r_70_28_118,seq73,r_8_22_117,r_70_28_118,1.0,0,118,118,95
68,seq135,r_134_111_118,r_6_132_94,r_6_132_94,1.0,24,118,94,95
16,r_116_139_51,r_97_105_26,r_19_131_6,r_19_131_6,0.71,16,22,6,95
38,r_49_23_161,seq50,r_24_20_119,r_24_20_119,0.69,42,161,119,95
49,r_146_33_24,seq145,seq31,r_146_33_24,0.98,0,24,24,95
34,r_43_123_113,r_39_42_176,seq126,r_43_123_113,0.96,0,113,113,95
3,r_148_21_198,r_149_106_33,r_19_131_6,r_148_21_198,0.75,-167,31,198,95
2,r_37_115_83,r_19_131_6,r_125_117_131,r_125_117_131,0.95,1,132,131,95
17,r_74_104_103,r_70_28_118,r_55_98_59,r_74_104_103,0.7,0,103,103,95
3,r_148_21_198,r_19_131_6,r_114_147_61,r_148_21_198,0.37,-135,63,198,95
32,r_54_77_30,r_55_98_59,r_79_0_167,r_54_77_30,0.95,0,30,30,95
22,r_62_108_156,r_61_18_172,r_30_113_9,r_62_108_156,0.76,0,156,156,95
13,r_57_89_57,seq58,seq81,r_57_89_57,1.0,0,57,57,95
7,r_24_20_119,r_25_83_197,r_8_22_117,r_24_20_119,0.46,30,149,119,95
44,r_70_28_118,r_71_32_80,seq73,r_71_32_80,1.0,-2,78,80,95
82,seq78,r_79_0_167,r_57_89_57,r_57_89_57,0.98,109,166,57,95
79,seq73,r_72_124_176,seq75,r_72_124_176,0.61,0,176,176,95
12,r_114_147_61,seq109,r_148_21_198,r_114_147_61,0.63,0,61,61,95
29,r_34_136_11,seq35,seq138,r_34_136_11,0.99,0,11,11,95
35,r_95_53_21,r_90_141_77,r_52_84_198,r_95_53_21,0.96,0,21,21,95
32,r_54_77_30,r_79_0_167,seq76,r_79_0_167,0.53,-96,71,167,95
30,r_73_67_121,seq72,r_68_92_172,r_73_67_121,0.7,0,121,121,96
51,seq3,r_4_74_169,r_12_26_65,r_4_74_169,0.69,-1,168,169,96
77,seq130,r_129_125_71,r_31_132_18,r_31_132_18,1.0,0,18,18,96
18,r_95_70_121,r_71_85_179,r_4_74_169,r_95_70_121,0.93,58,179,121,96
43,r_15_0_95,seq18,seq2,r_15_0_95,0.9,1,96,95,96
36,r_107_24_39,r_106_146_147,seq27,r_107_24_39,1.0,0,39,39,96
16,r_148_136_59,r_141_79_148,r_6_143_4,r_141_79_148,0.69,-88,60,148,96
21,r_40_91_166,seq39,seq93,r_40_91_166,0.55,0,166,166,96
1,r_31_132_18,r_33_102_110,seq130,r_31_132_18,0.99,0,18,18,96
5,r_129_125_71,r_128_48_91,seq123,r_128_48_91,1.0,0,91,91,96
46,r_57_120_64,seq56,r_31_132_18,r_57_120_64,0.46,0,64,64,96
49,r_68_92_172,r_78_38_139,r_35_105_91,r_68_92_172,0.29,-116,56,172,96
45,r_147_109_182,r_149_7_192,seq110,r_149_7_192,0.4,-10,182,192,96
19,r_126_51_71,seq124,seq56,r_126_51_71,1.0,0,71,71,96
31,r_23_10_158,seq27,r_53_5_11,r_53_5_11,0.81,147,158,11,96
41,r_97_16_64,r_95_70_121,seq18,r_97_16_64,1.0,0,64,64,96
30,r_73_67_121,r_68_92_172,r_4_74_169,r_73_67_121,0.49,52,173,121,96
3,r_127_82_151,seq130,r_142_83_60,r_142_83_60,0.94,88,148,60,96
10,r_90_20_4,r_21_118_192,r_12_26_65,r_12_26_65,0.62,127,192,65,96
26,r_128_48_91,r_129_125_71,r_122_50_40,r_129_125_71,1.0,20,91,71,96
44,r_71_85_179,r_95_70_121,seq86,r_71_85_179,0.94,0,179,179,96
48,r_122_50_40,seq123,seq49,r_122_50_40,1.0,0,40,40,96
4,r_52_119_145,r_54_46_200,r_57_120_64,r_57_120_64,0.78,81,145,64,96
78,seq72,r_73_67_121,r_71_85_179,r_73_67_121,0.75,-27,94,121,96
47,r_138_81_13,r_80_37_53,r_64_77_1,r_80_37_53,0.94,0,53,53,96
0,r_78_38_139,r_64_77_1,seq42,r_78_38_139,0.6,1,140,139,96
63,seq36,r_35_105_91,seq42,r_35_105_91,0.99,0,91,91,96
32,r_47_17_38,seq58,seq18,r_47_17_38,1.0,1,39,38,96
13,r_33_102_110,seq30,seq103,r_33_102_110,1.0,0,110,110,96
46,r_57_120_64,r_31_132_18,r_52_119_145,r_52_119_145,1.0,2,147,145,96
39,r_41_14_23,r_40_91_166,r_90_20_4,r_41_14_23,0.91,0,23,23,96
12,r_140_34_10,r_141_79_148,seq30,r_140_34_10,0.99,0,10,10,96
2,r_141_79_148,seq144,r_138_81_13,r_141_79_148,0.57,0,148,148,96
18,r_95_70_121,r_99_69_152,r_71_85_179,r_95_70_121,0.96,0,121,121,96
29,r_99_69_152,seq96,seq72,r_99_69_152,0.57,0,152,152,96
24,r_12_26_65,seq13,r_107_24_39,r_107_24_39,1.0,27,66,39,96
53,seq9,r_90_20_4,r_53_5_11,r_53_5_11,0.72,3,14,11,96
33,r_35_105_91,seq36,seq108,r_35_105_91,0.95,0,91,91,96
64,seq39,r_40_91_166,seq42,r_40_91_166,0.99,-9,157,166,96
70,seq56,r_54_46_200,r_100_55_173,r_100_55_173,0.66,15,188,173,96
52,seq135,r_133_29_105,seq121,r_133_29_105,1.0,-3,102,105,96
47,r_138_81_13,r_141_79_148,r_80_37_53,r_138_81_13,0.98,0,13,13,96
11,r_133_29_105,r_78_38_139,seq2,r_133_29_105,0.58,29,134,105,96
17,r_64_77_1,r_78_38_139,r_138_81_13,r_64_77_1,0.79,139,140,1,96
9,r_1_11_107,seq2,seq13,r_1_11_107,0.73,1,108,107,96
28,r_134_115_63,seq135,seq113,r_134_115_63,0.95,0,63,63,96
91,seq108,r_106_146_147,r_35_105_91,r_35_105_91,1.0,30,121,91,96
37,r_80_37_53,r_138_81_13,seq36,r_80_37_53,0.95,0,53,53,96
68,seq49,seq58,r_122_50_40,r_122_50_40,1.0,5,45,40,96
6,r_53_5_11,r_54_46_200,seq9,r_53_5_11,0.94,0,11,11,96
7,r_4_74_169,seq3,r_99_69_152,r_4_74_169,0.72,0,169,169,96
44,r_71_85_179,seq72,r_95_70_121,r_95_70_121,1.0,35,156,121,96
23,r_142_83_60,r_141_79_148,seq86,r_142_83_60,1.0,0,60,60,96
49,r_68_92_172,r_35_105_91,r_73_67_121,r_35_105_91,0.64,-4,87,91,96
37,r_80_37_53,r_78_38_139,r_138_81_13,r_138_81_13,0.98,0,13,13,96
49,r_68_92_172,r_73_67_121,seq93,r_68_92_172,0.68,0,172,172,96
40,r_145_100_56,seq107,r_56_102_127,r_56_102_127,1.0,46,173,127,97
51,seq1,r_2_62_69,seq0,r_2_62_69,1.0,0,69,69,97
36,r_126_42_78,r_125_23_83,seq46,r_126_42_78,1.0,0,78,78,97
92,seq107,seq110,r_25_103_24,r_25_103_24,1.0,90,114,24,97
61,seq18,r_16_116_32,seq27,r_16_116_32,1.0,-7,25,32,97
14,r_4_41_143,seq3,seq46,r_4_41_143,0.85,0,143,143,97
8,r_146_49_63,seq143,r_136_47_55,r_146_49_63,0.52,0,63,63,97
53,seq3,r_4_41_143,seq6,r_4_41_143,0.98,-74,69,143,97
43,r_52_135_61,seq51,r_45_133_5,r_52_135_61,1.0,0,61,61,97
45,r_83_105_9,r_84_73_160,r_101_114_177,r_83_105_9,0.98,1,10,9,97
3,r_106_53_24,r_101_114_177,seq54,r_106_53_24,1.0,2,26,24,97
37,r_66_98_186,seq68,r_25_103_24,r_66_98_186,0.25,0,186,186,97
55,seq6,r_5_29_128,seq3,r_5_29_128,0.9,0,128,128,97
38,r_87_90_17,r_86_14_137,seq91,r_87_90_17,1.0,-1,16,17,97
21,r_117_48_154,r_118_115_84,r_146_49_63,r_118_115_84,0.71,70,154,84,97
39,r_125_23_83,seq128,r_147_22_33,r_125_23_83,0.98,0,83,83,97
5,r_33_104_113,seq35,r_25_103_24,r_33_104_113,1.0,0,113,113,97
42,r_140_77_89,seq141,seq75,r_140_77_89,1.0,0,89,89,97
35,r_137_10_173,r_136_47_55,r_45_133_5,r_137_10_173,0.67,-143,30,173,97
41,r_11_15_121,r_58_7_99,r_37_13_112,r_11_15_121,0.5,0,121,121,97
71,seq46,r_106_53_24,r_126_42_78,r_126_42_78,0.99,3,81,78,97
19,r_37_13_112,seq35,r_11_15_121,r_37_13_112,1.0,0,112,112,97
40,r_145_100_56,r_146_49_63,seq107,r_145_100_56,0.56,0,56,56,97
71,seq46,r_40_127_152,r_106_53_24,r_106_53_24,0.55,27,51,24,97
31,r_129_55_98,seq128,r_44_57_2,r_129_55_98,0.99,0,98,98,97
68,seq35,r_17_31_2,r_93_36_156,r_93_36_156,1.0,2,158,156,97
41,r_11_15_121,r_28_21_50,r_58_7_99,r_58_7_99,0.84,3,102,99,97
1,r_147_22_33,r_146_49_63,seq24,r_147_22_33,1.0,0,33,33,97
10,r_93_36_156,seq94,seq35,r_93_36_156,0.67,0,156,156,97
0,r_111_20_188,r_112_50_136,r_96_121_34,r_111_20_188,0.88,-51,137,188,97
13,r_148_12_196,seq149,r_86_14_137,r_86_14_137,0.93,55,192,137,97
98,seq122,seq119,r_96_121_34,r_96_121_34,0.94,35,69,34,97
15,r_5_29_128,r_4_41_143,seq27,r_5_29_128,0.94,0,128,128,97
48,r_2_62_69,seq1,seq64,r_2_62_69,1.0,0,69,69,97
49,r_101_114_177,r_25_103_24,r_96_121_34,r_101_114_177,0.48,0,177,177,97
6,r_70_88_63,seq71,r_89_138_192,r_70_88_63,0.99,1,64,63,97
26,r_97_30_57,r_99_123_64,seq32,r_97_30_57,1.0,2,59,57,97
27,r_99_123_64,r_97_30_57,r_96_121_34,r_97_30_57,0.78,7,64,57,97
30,r_9_113_9,seq122,r_16_116_32,r_16_116_32,1.0,40,72,32,97
87,seq85,r_84_73_160,seq81,r_84_73_160,0.68,0,160,160,97
2,r_44_57_2,r_56_102_127,r_129_55_98,r_44_57_2,0.62,125,127,2,97
4,r_25_103_24,seq26,r_83_105_9,r_25_103_24,0.93,0,24,24,97
18,r_39_34_171,seq38,r_93_36_156,r_39_34_171,0.46,1,172,171,97
29,r_112_50_136,r_111_20_188,r_106_53_24,r_112_50_136,0.77,1,137,136,97
49,r_101_114_177,r_106_53_24,r_25_103_24,r_101_114_177,0.93,-151,26,177,97
0,r_111_20_188,r_96_121_34,seq19,r_111_20_188,0.47,0,188,188,97
24,r_76_8_140,seq75,r_58_7_99,r_76_8_140,0.92,0,140,140,97
35,r_137_10_173,r_45_133_5,r_58_7_99,r_137_10_173,0.54,0,173,173,97
25,r_118_115_84,r_117_48_154,r_96_121_34,r_118_115_84,0.65,70,154,84,97
33,r_72_61_152,seq74,seq59,r_72_61_152,0.87,0,152,152,97
44,r_16_116_32,seq18,r_118_115_84,r_16_116_32,1.0,1,33,32,97
9,r_86_14_137,seq81,r_37_13_112,r_86_14_137,1.0,0,137,137,97
70,seq38,r_39_34_171,seq46,r_39_34_171,0.63,2,173,171,97
6,r_70_88_63,r_89_138_192,r_87_90_17,r_89_138_192,0.85,-24,168,192,97
68,seq35,r_37_13_112,r_17_31_2,r_37_13_112,0.9,-1,111,112,97
32,r_67_80_143,r_66_98_186,seq79,r_67_80_143,0.67,0,143,143,97
20,r_92_139_11,r_129_55_98,seq149,r_129_55_98,0.96,-69,29,98,97
34,r_89_138_192,r_93_36_156,r_87_90_17,r_89_138_192,0.83,-89,103,192,97
45,r_83_105_9,r_101_114_177,r_25_103_24,r_25_103_24,0.87,102,126,24,97
22,r_58_7_99,r_11_15_121,seq26,r_58_7_99,0.41,22,121,99,97
46,r_136_47_55,seq130,r_106_53_24,r_136_47_55,1.0,0,55,55,97
81,seq71,r_70_88_63,seq63,r_70_88_63,1.0,1,64,63,97
17,r_56_102_127,r_44_57_2,r_25_103_24,r_56_102_127,0.97,0,127,127,97
22,r_58_7_99,seq26,r_76_8_140,r_76_8_140,0.98,1,141,140,97
22,r_58_7_99,seq59,r_11_15_121,r_58_7_99,0.83,0,99,99,97
28,r_78_43_130,r_76_8_140,r_126_42_78,r_78_43_130,0.99,0,130,130,97
11,r_96_121_34,r_93_36_156,seq122,r_96_121_34,0.85,2,36,34,97
7,r_40_127_152,r_39_34_171,seq128,r_40_127_152,0.78,0,152,152,97
20,r_92_139_11,r_93_36_156,r_129_55_98,r_129_55_98,0.81,-90,8,98,97
82,seq74,seq75,r_84_73_160,r_84_73_160,0.9,3,163,160,97
40,r_1_119_20,seq7,seq120,r_1_119_20,0.99,0,20,20,98
36,r_34_134_69,r_35_54_155,r_133_5_157,r_34_134_69,1.0,0,69,69,98
8,r_116_52_198,seq115,r_126_51_35,r_126_51_35,1.0,163,198,35,98
53,seq7,r_4_149_194,r_127_6_114,r_127_6_114,1.0,10,124,114,98
43,r_110_3_100,r_108_83_142,r_143_2_63,r_110_3_100,0.95,0,100,100,98
90,seq97,seq99,r_142_96_166,r_142_96_166,0.69,3,169,166,98
37,r_50_68_100,seq49,seq67,r_50_68_100,0.65,0,100,100,98
16,r_121_15_124,seq120,r_26_13_82,r_121_15_124,1.0,0,124,124,98
21,r_123_32_171,seq130,r_102_124_31,r_102_124_31,0.62,38,69,31,98
97,seq115,r_116_52_198,r_98_135_129,r_98_135_129,1.0,51,180,129,98
5,r_143_2_63,r_142_96_166,r_21_10_9,r_143_2_63,1.0,0,63,63,98
42,r_128_8_197,r_127_6_114,r_118_46_209,r_127_6_114,1.0,0,114,114,98
31,r_100_59_56,r_98_135_129,seq60,r_100_59_56,1.0,0,56,56,98
46,r_102_124_31,r_107_0_191,r_123_32_171,r_102_124_31,0.58,4,35,31,98
45,r_29_84_72,seq31,seq80,r_29_84_72,1.0,0,72,72,98
19,r_74_61_204,seq75,r_35_54_155,r_35_54_155,0.99,49,204,155,98
41,r_132_136_11,r_133_5_157,seq137,r_132_136_11,1.0,0,11,11,98
11,r_95_19_3,r_148_22_9,r_73_17_52,r_73_17_52,0.64,33,85,52,98
65,seq43,r_42_12_59,seq44,r_42_12_59,1.0,0,59,59,98
89,seq94,r_93_39_104,r_147_92_58,r_147_92_58,0.76,46,104,58,98
3,r_77_109_193,seq82,seq105,r_77_109_193,0.57,0,193,193,98
4,r_147_92_58,seq145,seq94,r_147_92_58,1.0,0,58,58,98
10,r_4_149_194,seq7,r_133_5_157,r_133_5_157,1.0,0,157,157,98
24,r_70_139_21,r_71_55_55,r_56_140_15,r_70_139_21,1.0,0,21,21,98
39,r_86_138_40,seq85,r_56_140_15,r_86_138_40,0.95,0,40,40,98
27,r_73_17_52,seq75,r_95_19_3,r_73_17_52,1.0,0,52,52,98
14,r_71_55_55,r_53_30_185,r_35_54_155,r_71_55_55,0.61,108,163,55,98
20,r_53_30_185,seq49,r_71_55_55,r_71_55_55,1.0,47,102,55,98
13,r_23_11_178,seq24,r_21_10_9,r_21_10_9,0.95,169,178,9,98
46,r_102_124_31,r_123_32_171,seq125,r_123_32_171,1.0,-1,170,171,98
15,r_64_146_67,seq63,seq145,r_64_146_67,1.0,0,67,67,98
48,r_69_20_102,seq67,r_148_22_9,r_69_20_102,1.0,0,102,102,98
57,seq24,r_25_16_145,r_69_20_102,r_69_20_102,1.0,40,142,102,98
21,r_123_32_171,r_102_124_31,seq31,r_123_32_171,0.88,0,171,171,98
0,r_33_36_66,r_35_54_155,seq38,r_33_36_66,0.55,-10,56,66,98
26,r_42_12_59,seq43,r_21_10_9,r_42_12_59,1.0,0,59,59,98
5,r_143_2_63,r_21_10_9,r_110_3_100,r_110_3_100,1.0,54,154,100,98
92,seq101,r_100_59_56,seq99,r_100_59_56,0.94,1,57,56,98
36,r_34_134_69,r_133_5_157,r_98_135_129,r_98_135_129,0.7,28,157,129,98
78,seq72,r_71_55_55,seq75,r_71_55_55,0.98,0,55,55,98
22,r_148_22_9,r_25_16_145,r_69_20_102,r_69_20_102,1.0,0,102,102,98
18,r_127_6_114,r_128_8_197,seq7,r_127_6_114,0.99,0,114,114,98
29,r_118_46_209,seq120,r_93_39_104,r_93_39_104,0.99,105,209,104,98
25,r_113_103_194,seq112,r_122_114_141,r_122_114_141,0.56,-6,135,141,98
33,r_133_5_157,seq130,r_4_149_194,r_133_5_157,0.69,0,157,157,98
47,r_18_104_23,r_95_19_3,seq106,r_18_104_23,1.0,1,24,23,98
20,r_53_30_185,r_71_55_55,seq31,r_53_30_185,0.88,3,188,185,98
32,r_93_39_104,seq94,seq40,r_93_39_104,1.0,0,104,104,98
38,r_107_0_191,r_110_3_100,seq111,r_110_3_100,0.99,0,100,100,98
77,seq67,r_69_20_102,r_50_68_100,r_69_20_102,0.99,0,102,102,98
34,r_21_10_9,r_9_14_88,r_143_2_63,r_143_2_63,1.0,25,88,63,98
30,r_56_140_15,seq58,seq141,r_56_140_15,1.0,0,15,15,98
25,r_113_103_194,r_122_114_141,r_18_104_23,r_122_114_141,0.91,53,194,141,98
60,seq31,r_29_84_72,r_33_36_66,r_29_84_72,1.0,0,72,72,98
17,r_25_16_145,seq24,r_26_13_82,r_26_13_82,1.0,64,146,82,98
9,r_98_135_129,seq99,r_34_134_69,r_98_135_129,0.95,2,131,129,98
11,r_95_19_3,r_18_104_23,r_148_22_9,r_95_19_3,0.67,21,24,3,98
26,r_42_12_59,r_21_10_9,r_26_13_82,r_26_13_82,0.93,49,131,82,98
96,seq112,r_113_103_194,seq111,r_113_103_194,0.52,-1,193,194,98
28,r_108_83_142,r_107_0_191,r_29_84_72,r_108_83_142,0.75,0,142,142,98
91,seq99,r_98_135_129,seq101,r_98_135_129,0.92,3,132,129,98
49,r_126_51_35,r_121_15_124,seq58,r_126_51_35,1.0,0,35,35,98
56,seq145,seq141,r_64_146_67,r_64_146_67,1.0,3,70,67,98
7,r_142_96_166,r_144_81_168,seq97,r_142_96_166,0.88,0,166,166,98
44,r_144_81_168,r_142_96_166,seq80,r_144_81_168,0.86,0,168,168,98
35,r_122_114_141,seq120,seq112,r_122_114_141,0.67,2,143,141,98
12,r_35_54_155,r_33_36_66,r_71_55_55,r_71_55_55,1.0,100,155,55,98
23,r_9_14_88,r_21_10_9,r_26_13_82,r_26_13_82,1.0,7,89,82,98
14,r_71_55_55,seq72,r_53_30_185,r_71_55_55,1.0,0,55,55,98
30,r_145_132_86,seq148,seq131,r_145_132_86,0.97,0,86,86,99
12,r_84_45_154,seq96,r_126_83_47,r_126_83_47,1.0,0,47,47,99
36,r_15_111_121,seq14,seq113,r_15_111_121,0.96,0,121,121,99
26,r_19_61_91,r_71_18_50,r_149_60_77,r_19_61_91,0.99,0,91,91,99
37,r_10_99_153,seq11,seq102,r_10_99_153,0.98,0,153,153,99
26,r_19_61_91,r_10_99_153,r_71_18_50,r_71_18_50,1.0,0,50,50,99
16,r_110_49_96,seq109,seq46,r_110_49_96,1.0,0,96,96,99
1,r_123_69_76,seq122,seq67,r_123_69_76,0.98,-1,75,76,99
5,r_78_37_179,seq80,r_25_42_129,r_78_37_179,0.36,0,179,179,99
46,r_75_33_88,r_73_1_146,seq34,r_75_33_88,0.79,0,88,88,99
42,r_29_138_111,r_28_40_121,seq139,r_29_138_111,1.0,0,111,111,99
80,seq80,r_79_95_139,seq77,r_79_95_139,0.83,0,139,139,99
41,r_53_88_25,seq52,r_86_107_150,r_53_88_25,0.96,0,25,25,99
25,r_126_83_47,r_141_97_156,r_84_45_154,r_126_83_47,1.0,0,47,47,99
95,seq118,r_117_27_173,r_135_124_166,r_117_27_173,0.8,2,175,173,99
31,r_22_12_81,r_146_24_1,seq14,r_22_12_81,1.0,0,81,81,99
44,r_28_40_121,r_25_42_129,r_100_41_97,r_100_41_97,0.57,25,122,97,99
3,r_100_41_97,r_101_143_170,seq39,r_100_41_97,0.89,0,97,97,99
72,seq57,r_63_85_135,r_54_56_123,r_63_85_135,0.47,1,136,135,99
4,r_35_47_186,seq46,r_28_40_121,r_28_40_121,0.66,24,145,121,99
0,r_25_42_129,r_26_16_138,r_28_40_121,r_26_16_138,0.91,-9,129,138,99
11,r_73_1_146,seq76,r_144_0_104,r_73_1_146,0.95,0,146,146,99
20,r_89_94_2,seq91,r_128_93_127,r_128_93_127,1.0,3,130,127,99
13,r_13_20_103,r_15_111_121,seq21,r_13_20_103,1.0,0,103,103,99
47,r_149_60_77,r_63_85_135,r_19_61_91,r_149_60_77,0.87,39,116,77,99
15,r_119_30_153,seq120,r_75_33_88,r_119_30_153,0.81,0,153,153,99
48,r_86_107_150,r_87_130_177,r_127_108_24,r_86_107_150,0.67,0,150,150,99
12,r_84_45_154,r_126_83_47,seq46,r_84_45_154,0.69,0,154,154,99
10,r_144_0_104,seq14,r_73_1_146,r_73_1_146,1.0,0,146,146,99
85,seq96,r_89_94_2,r_79_95_139,r_79_95_139,0.6,22,161,139,99
27,r_98_90_129,r_101_143_170,r_89_94_2,r_101_143_170,0.71,-41,129,170,99
2,r_92_5_115,r_89_94_2,seq7,r_92_5_115,0.99,0,115,115,99
41,r_53_88_25,r_86_107_150,r_63_85_135,r_86_107_150,0.52,0,150,150,99
47,r_149_60_77,seq148,r_63_85_135,r_149_60_77,0.94,0,77,77,99
40,r_8_51_177,seq11,r_23_50_72,r_8_51_177,0.68,0,177,177,99
18,r_54_56_123,seq55,seq57,r_54_56_123,0.63,0,123,123,99
29,r_87_130_177,r_86_107_150,r_63_85_135,r_87_130_177,0.85,-27,150,177,99
24,r_59_62_181,r_63_85_135,r_17_58_88,r_17_58_88,1.0,6,94,88,99
34,r_17_58_88,seq55,r_19_61_91,r_17_58_88,0.5,68,156,88,99
33,r_128_93_127,seq129,r_89_94_2,r_128_93_127,1.0,0,127,127,99
29,r_87_130_177,r_63_85_135,r_135_124_166,r_87_130_177,0.98,0,177,177,99
50,seq129,r_128_93_127,r_145_132_86,r_145_132_86,0.53,41,127,86,99
32,r_70_64_107,seq66,r_17_58_88,r_17_58_88,0.83,19,107,88,99
9,r_134_9_33,r_135_124_166,seq11,r_134_9_33,1.0,0,33,33,99
34,r_17_58_88,r_15_111_121,seq55,r_17_58_88,1.0,0,88,88,99
17,r_23_50_72,r_146_24_1,seq52,r_23_50_72,1.0,0,72,72,99
25,r_126_83_47,r_84_45_154,r_63_85_135,r_126_83_47,0.53,104,151,47,99
94,seq116,r_117_27_173,r_135_124_166,r_117_27_173,0.46,2,175,173,99
22,r_71_18_50,r_70_64_107,seq14,r_71_18_50,1.0,0,50,50,99
96,seq120,r_119_30_153,seq116,r_119_30_153,0.57,-13,140,153,99
7,r_141_97_156,seq140,r_10_99_153,r_141_97_156,0.8,0,156,156,99
44,r_28_40_121,r_29_138_111,r_25_42_129,r_28_40_121,0.42,-10,111,121,99
