54,seq7,r_41_14_146,seq93,r_41_14_146,0.9,0,146,146,0
30,r_44_94_135,r_26_138_85,r_20_85_39,r_44_94_135,0.64,-9,126,135,0
37,r_131_92_186,r_62_113_179,r_123_89_15,r_123_89_15,0.96,166,181,15,0
55,seq8,r_75_37_150,r_118_36_49,r_118_36_49,0.73,101,150,49,0
39,r_80_104_115,seq34,seq67,r_80_104_115,0.98,1,116,115,0
46,r_109_133_101,seq34,r_118_36_49,r_109_133_101,0.97,0,101,101,0
19,r_75_37_150,seq8,r_28_9_26,r_75_37_150,0.7,0,150,150,0
31,r_2_78_110,seq145,r_118_36_49,r_118_36_49,0.81,64,113,49,0
41,r_41_14_146,seq7,seq67,r_41_14_146,0.65,0,146,146,0
3,r_100_33_108,r_64_120_113,seq17,r_100_33_108,0.98,0,108,108,0
10,r_15_10_95,r_16_143_197,seq147,r_15_10_95,1.0,1,96,95,0
26,r_64_120_113,r_100_33_108,r_126_86_57,r_64_120_113,1.0,-5,108,113,0
4,r_43_81_159,r_40_112_172,r_44_94_135,r_40_112_172,0.49,-12,160,172,0
32,r_49_129_40,r_97_107_64,seq136,r_49_129_40,0.89,1,41,40,0
0,r_4_117_66,r_44_94_135,r_59_83_60,r_4_117_66,0.98,0,66,66,0
63,seq27,r_26_138_85,seq125,r_26_138_85,1.0,0,85,85,0
11,r_139_35_162,seq42,r_87_48_36,r_87_48_36,0.98,126,162,36,0
13,r_127_18_145,seq39,r_123_89_15,r_127_18_145,0.91,0,145,145,0
6,r_28_9_26,r_43_81_159,r_131_92_186,r_28_9_26,0.99,0,26,26,0
48,r_26_138_85,seq27,r_44_94_135,r_26_138_85,0.97,0,85,85,0
33,r_87_48_36,r_115_23_80,seq46,r_87_48_36,0.85,1,37,36,0
5,r_123_89_15,r_100_33_108,r_54_70_34,r_100_33_108,1.0,-12,96,108,0
27,r_116_119_117,seq98,seq63,r_116_119_117,0.99,2,119,117,0
70,seq46,seq147,r_87_48_36,r_87_48_36,0.98,22,58,36,0
1,r_31_12_14,r_65_69_128,seq82,r_31_12_14,0.88,-2,12,14,0
2,r_115_23_80,r_15_10_95,r_126_86_57,r_126_86_57,0.86,23,80,57,0
40,r_68_24_24,r_4_117_66,r_0_135_22,r_68_24_24,0.66,2,26,24,0
15,r_118_36_49,r_99_25_180,seq1,r_118_36_49,1.0,4,53,49,0
25,r_97_107_64,seq51,r_0_135_22,r_97_107_64,0.9,1,65,64,0
21,r_54_70_34,r_131_92_186,seq42,r_54_70_34,0.59,3,37,34,0
38,r_95_52_144,seq67,r_44_94_135,r_95_52_144,0.48,6,150,144,0
36,r_130_149_32,r_20_85_39,seq134,r_130_149_32,0.9,1,33,32,0
34,r_45_61_84,seq82,r_20_85_39,r_45_61_84,1.0,0,84,84,0
60,seq147,seq46,r_15_10_95,r_15_10_95,1.0,39,134,95,0
81,seq67,r_95_52_144,r_80_104_115,r_80_104_115,0.68,35,150,115,0
17,r_101_141_126,r_99_25_180,r_54_70_34,r_101_141_126,0.74,3,129,126,0
14,r_126_86_57,r_108_122_89,r_130_149_32,r_130_149_32,0.89,26,58,32,0
9,r_50_32_143,seq132,r_28_9_26,r_28_9_26,0.92,120,146,26,0
42,r_20_85_39,r_26_138_85,seq145,r_20_85_39,0.97,0,39,39,0
18,r_38_148_53,r_100_33_108,r_31_12_14,r_38_148_53,0.54,0,53,53,0
22,r_11_79_190,r_16_143_197,r_26_138_85,r_26_138_85,1.0,105,190,85,0
28,r_108_122_89,r_40_112_172,r_49_129_40,r_108_122_89,1.0,0,89,89,0
7,r_99_25_180,seq57,seq21,r_99_25_180,0.57,1,181,180,0
44,r_144_128_109,r_50_32_143,seq17,r_144_128_109,1.0,1,110,109,0
23,r_59_83_60,seq102,r_4_117_66,r_59_83_60,0.63,7,67,60,0
20,r_124_91_58,seq134,seq98,r_124_91_58,1.0,0,58,58,0
5,r_123_89_15,seq47,r_100_33_108,r_123_89_15,0.92,0,15,15,0
40,r_88_96_39,r_5_129_138,seq134,r_5_129_138,0.47,12,150,138,1
8,r_95_26_172,r_83_4_178,seq58,r_95_26_172,0.78,0,172,172,1
11,r_11_72_29,r_138_67_144,r_83_4_178,r_11_72_29,1.0,0,29,29,1
27,r_111_15_31,r_28_44_134,r_110_78_52,r_110_78_52,0.63,12,64,52,1
37,r_24_14_74,r_5_129_138,seq106,r_24_14_74,1.0,0,74,74,1
40,r_88_96_39,r_97_87_171,r_5_129_138,r_88_96_39,1.0,0,39,39,1
16,r_104_71_105,seq141,r_143_33_51,r_143_33_51,0.99,57,108,51,1
21,r_70_130_90,r_95_26_172,seq101,r_95_26_172,1.0,-83,89,172,1
39,r_1_86_82,r_95_26_172,r_143_33_51,r_1_86_82,1.0,1,83,82,1
1,r_138_67_144,r_135_116_133,r_107_6_13,r_107_6_13,0.55,132,145,13,1
31,r_68_117_141,seq89,seq30,r_68_117_141,0.62,8,149,141,1
29,r_143_33_51,r_107_6_13,r_1_86_82,r_1_86_82,1.0,20,102,82,1
41,r_125_149_149,seq27,r_143_33_51,r_143_33_51,0.98,103,154,51,1
27,r_111_15_31,r_138_67_144,r_28_44_134,r_111_15_31,1.0,0,31,31,1
10,r_39_103_151,r_121_128_4,r_25_45_145,r_121_128_4,0.82,147,151,4,1
22,r_28_44_134,r_0_147_93,r_111_15_31,r_111_15_31,0.96,3,34,31,1
15,r_34_98_19,r_82_18_25,seq7,r_34_98_19,1.0,0,19,19,1
0,r_48_81_185,seq84,r_46_92_20,r_46_92_20,0.75,167,187,20,1
2,r_10_32_56,r_138_67_144,seq84,r_10_32_56,1.0,0,56,56,1
18,r_109_77_35,r_68_117_141,seq19,r_109_77_35,0.98,1,36,35,1
94,seq115,r_8_99_24,r_82_18_25,r_8_99_24,0.58,0,24,24,1
4,r_110_78_52,r_9_52_17,r_111_15_31,r_110_78_52,1.0,0,52,52,1
22,r_28_44_134,r_111_15_31,seq64,r_28_44_134,0.81,-5,129,134,1
47,r_136_51_179,seq38,r_95_26_172,r_95_26_172,0.87,9,181,172,1
24,r_127_119_132,r_65_140_150,r_107_6_13,r_127_119_132,0.76,1,133,132,1
82,seq84,r_65_140_150,r_10_32_56,r_10_32_56,1.0,0,56,56,1
46,r_107_6_13,r_48_81_185,seq49,r_107_6_13,1.0,0,13,13,1
34,r_5_129_138,r_88_96_39,r_91_13_119,r_91_13_119,0.62,21,140,119,1
26,r_12_59_26,r_5_129_138,seq141,r_12_59_26,1.0,2,28,26,1
33,r_29_146_80,r_61_80_104,seq38,r_29_146_80,0.78,8,88,80,1
54,seq7,r_61_80_104,r_34_98_19,r_34_98_19,1.0,1,20,19,1
65,seq30,r_97_87_171,r_68_117_141,r_68_117_141,0.66,-2,139,141,1
32,r_60_79_167,seq118,r_9_52_17,r_60_79_167,0.86,0,167,167,1
38,r_91_13_119,r_123_112_197,r_10_32_56,r_123_112_197,0.98,-76,121,197,1
29,r_143_33_51,r_55_105_101,r_107_6_13,r_143_33_51,0.72,1,52,51,1
25,r_82_18_25,r_60_79_167,seq115,r_82_18_25,0.86,-2,23,25,1
17,r_41_20_113,r_123_112_197,r_24_14_74,r_24_14_74,1.0,45,119,74,1
34,r_5_129_138,r_24_14_74,r_88_96_39,r_5_129_138,0.99,-98,40,138,1
13,r_40_17_34,seq16,seq27,r_40_17_34,1.0,-2,32,34,1
37,r_24_14_74,seq106,r_41_20_113,r_24_14_74,0.53,66,140,74,1
28,r_121_128_4,r_39_103_151,seq42,r_39_103_151,0.58,0,151,151,1
91,seq106,r_55_105_101,r_24_14_74,r_24_14_74,0.92,27,101,74,1
49,r_76_66_128,seq35,r_143_33_51,r_76_66_128,1.0,0,128,128,1
44,r_0_147_93,seq122,seq101,r_0_147_93,0.68,0,93,93,1
23,r_55_105_101,seq106,seq114,r_55_105_101,0.93,0,101,101,1
5,r_8_99_24,seq134,seq23,r_8_99_24,1.0,0,24,24,1
79,seq64,seq122,r_28_44_134,r_28_44_134,0.58,13,147,134,1
35,r_31_56_142,seq114,r_135_116_133,r_31_56_142,0.87,3,145,142,1
14,r_131_138_187,seq4,r_45_3_4,r_45_3_4,0.59,183,187,4,2
8,r_61_116_136,r_99_89_195,r_72_106_65,r_72_106_65,1.0,94,159,65,2
16,r_46_48_100,seq94,r_73_135_71,r_46_48_100,1.0,0,100,100,2
21,r_142_53_113,seq70,seq54,r_142_53_113,1.0,0,113,113,2
1,r_27_25_145,seq94,r_141_66_45,r_27_25_145,0.68,0,145,145,2
46,r_128_60_73,seq81,seq2,r_128_60_73,1.0,1,74,73,2
83,seq85,r_45_3_4,seq98,r_45_3_4,0.63,135,139,4,2
45,r_56_41_194,r_111_71_49,r_31_80_52,r_31_80_52,1.0,30,82,52,2
43,r_100_40_41,seq5,r_43_42_174,r_100_40_41,0.99,2,43,41,2
37,r_91_113_26,r_20_10_163,r_57_13_154,r_91_113_26,0.99,0,26,26,2
10,r_20_10_163,r_110_97_43,r_148_90_36,r_148_90_36,1.0,129,165,36,2
83,seq85,r_31_80_52,r_45_3_4,r_31_80_52,0.97,3,55,52,2
11,r_114_28_62,r_20_10_163,seq119,r_114_28_62,1.0,1,63,62,2
15,r_120_1_88,seq136,r_31_80_52,r_31_80_52,1.0,38,90,52,2
48,r_57_13_154,r_145_59_140,r_72_106_65,r_72_106_65,0.98,89,154,65,2
20,r_16_17_50,seq137,seq63,r_16_17_50,0.99,2,52,50,2
6,r_72_106_65,r_33_55_83,r_61_116_136,r_72_106_65,1.0,0,65,65,2
31,r_147_139_46,r_20_10_163,seq124,r_147_139_46,0.87,2,48,46,2
27,r_77_103_153,seq94,r_46_48_100,r_46_48_100,0.65,54,154,100,2
35,r_24_126_47,seq19,seq83,r_24_126_47,1.0,1,48,47,2
41,r_104_32_33,seq70,seq36,r_104_32_33,1.0,3,36,33,2
18,r_15_39_181,seq119,seq54,r_15_39_181,0.61,0,181,181,2
29,r_145_59_140,r_57_13_154,r_31_80_52,r_31_80_52,0.79,93,145,52,2
28,r_141_66_45,r_20_10_163,r_91_113_26,r_141_66_45,0.75,3,48,45,2
33,r_30_149_152,r_61_116_136,r_45_3_4,r_45_3_4,0.87,151,155,4,2
9,r_92_65_57,r_46_48_100,seq0,r_92_65_57,0.94,0,57,57,2
38,r_146_62_114,r_144_105_125,r_73_135_71,r_146_62_114,0.99,2,116,114,2
77,seq70,r_77_103_153,r_143_38_59,r_143_38_59,0.89,21,80,59,2
17,r_11_51_34,r_20_10_163,r_45_3_4,r_11_51_34,1.0,0,34,34,2
34,r_108_112_156,seq64,r_147_139_46,r_147_139_46,0.86,111,157,46,2
2,r_31_80_52,seq85,r_120_1_88,r_31_80_52,1.0,0,52,52,2
75,seq64,r_108_112_156,r_46_48_100,r_46_48_100,1.0,57,157,100,2
94,seq115,r_145_59_140,r_120_1_88,r_120_1_88,0.37,-3,85,88,2
0,r_148_90_36,seq124,seq87,r_148_90_36,0.77,1,37,36,2
96,seq119,r_15_39_181,r_114_28_62,r_114_28_62,1.0,36,98,62,2
37,r_91_113_26,r_57_13_154,r_27_25_145,r_91_113_26,0.87,121,147,26,2
49,r_8_78_123,seq96,seq95,r_8_78_123,0.87,1,124,123,2
3,r_111_71_49,r_56_41_194,r_43_42_174,r_111_71_49,0.92,7,56,49,2
7,r_18_52_64,seq19,seq129,r_18_52_64,1.0,0,64,64,2
36,r_143_38_59,r_86_37_84,seq70,r_143_38_59,1.0,0,59,59,2
14,r_23_100_111,seq4,seq70,r_23_100_111,1.0,1,112,111,3
43,r_92_115_132,seq10,r_57_55_16,r_92_115_132,0.8,3,135,132,3
44,r_57_55_16,r_97_103_35,seq119,r_57_55_16,0.68,-2,14,16,3
55,seq133,r_33_7_118,seq68,r_33_7_118,1.0,0,118,118,3
16,r_24_63_162,seq20,r_51_25_69,r_51_25_69,1.0,96,165,69,3
39,r_5_9_130,seq48,seq133,r_5_9_130,0.73,1,131,130,3
46,r_112_129_138,seq116,r_117_84_44,r_112_129_138,0.98,6,144,138,3
45,r_88_3_125,seq10,r_57_55_16,r_88_3_125,0.84,1,126,125,3
9,r_121_73_12,r_61_81_29,seq14,r_121_73_12,0.99,-1,11,12,3
0,r_0_145_49,r_8_75_62,r_58_35_175,r_0_145_49,1.0,0,49,49,3
99,seq125,seq68,r_17_67_18,r_17_67_18,0.92,15,33,18,3
25,r_97_103_35,seq101,r_108_135_190,r_97_103_35,0.74,1,36,35,3
5,r_111_46_27,seq1,r_6_60_5,r_111_46_27,0.98,2,29,27,3
3,r_40_52_84,r_112_129_138,seq15,r_40_52_84,0.65,2,86,84,3
10,r_83_28_134,seq131,seq14,r_83_28_134,0.97,1,135,134,3
4,r_132_89_91,r_24_63_162,r_8_75_62,r_24_63_162,1.0,-68,94,162,3
13,r_90_45_65,r_33_7_118,r_49_106_34,r_49_106_34,0.67,31,65,34,3
15,r_51_25_69,seq80,r_24_63_162,r_51_25_69,0.99,2,71,69,3
6,r_59_142_164,seq32,r_61_81_29,r_59_142_164,0.73,0,164,164,3
20,r_17_67_18,r_114_120_148,seq125,r_17_67_18,0.97,-4,14,18,3
26,r_62_86_41,r_51_25_69,seq125,r_62_86_41,0.99,0,41,41,3
31,r_110_30_19,r_61_81_29,seq102,r_110_30_19,0.99,-5,14,19,3
40,r_147_65_153,seq4,r_51_25_69,r_51_25_69,0.86,84,153,69,3
18,r_34_127_182,r_104_124_186,r_111_46_27,r_104_124_186,0.51,-4,182,186,3
29,r_136_146_169,seq130,r_132_89_91,r_136_146_169,0.72,0,169,169,3
24,r_138_16_152,seq32,r_0_145_49,r_138_16_152,0.71,0,152,152,3
38,r_95_69_11,seq68,r_104_124_186,r_95_69_11,0.95,0,11,11,3
26,r_62_86_41,seq125,r_8_75_62,r_8_75_62,1.0,9,71,62,3
34,r_113_96_156,seq41,r_132_89_91,r_113_96_156,0.8,2,158,156,3
36,r_77_78_47,r_83_28_134,seq91,r_77_78_47,1.0,0,47,47,3
17,r_33_7_118,seq133,r_2_107_100,r_33_7_118,1.0,0,118,118,3
96,seq116,r_112_129_138,seq20,r_112_129_138,0.91,6,144,138,3
22,r_38_122_107,r_74_141_109,seq70,r_38_122_107,0.78,1,108,107,3
92,seq101,r_97_103_35,seq43,r_97_103_35,1.0,1,36,35,3
23,r_74_141_109,r_88_3_125,seq4,r_74_141_109,0.98,0,109,109,3
35,r_118_21_172,seq149,r_111_46_27,r_111_46_27,0.86,158,185,27,3
12,r_8_75_62,r_74_141_109,r_62_86_41,r_8_75_62,1.0,1,63,62,3
15,r_119_116_49,r_65_18_152,seq142,r_119_116_49,0.63,0,49,49,4
30,r_134_101_148,seq48,r_100_91_1,r_134_101_148,0.6,1,149,148,4
44,r_27_3_20,r_146_103_195,seq148,r_27_3_20,0.59,127,147,20,4
36,r_95_25_123,seq26,r_20_60_56,r_95_25_123,0.77,4,127,123,4
14,r_140_81_173,r_86_75_58,seq8,r_86_75_58,0.77,3,61,58,4
8,r_16_92_89,r_65_18_152,r_110_69_54,r_110_69_54,0.85,36,90,54,4
43,r_7_129_170,r_23_117_167,r_110_69_54,r_110_69_54,0.99,115,169,54,4
37,r_90_82_122,seq35,r_16_92_89,r_90_82_122,0.48,0,122,122,4
26,r_146_103_195,seq148,r_27_3_20,r_27_3_20,0.95,1,21,20,4
16,r_127_123_163,seq128,seq79,r_127_123_163,0.32,0,163,163,4
1,r_14_104_183,r_109_58_121,r_17_107_107,r_14_104_183,0.77,-77,106,183,4
42,r_37_135_99,seq141,seq111,r_37_135_99,0.83,1,100,99,4
13,r_144_43_47,seq128,r_52_132_6,r_144_43_47,0.92,1,48,47,4
45,r_89_45_82,r_99_71_161,r_88_57_19,r_89_45_82,0.67,-1,81,82,4
19,r_121_114_84,r_134_101_148,seq54,r_121_114_84,0.86,1,85,84,4
41,r_109_58_121,r_14_104_183,r_110_69_54,r_109_58_121,0.85,1,122,121,4
4,r_20_60_56,r_110_69_54,seq2,r_20_60_56,0.94,5,61,56,4
63,seq35,r_90_82_122,seq13,r_90_82_122,0.55,0,122,122,4
20,r_86_75_58,r_140_81_173,r_118_21_141,r_86_75_58,0.93,3,61,58,4
49,r_118_21_141,r_86_75_58,seq128,r_118_21_141,0.73,1,142,141,4
6,r_65_18_152,seq47,r_52_132_6,r_65_18_152,0.54,3,155,152,4
49,r_118_21_141,seq42,r_86_75_58,r_86_75_58,1.0,-1,57,58,4
27,r_137_12_177,seq55,r_110_69_54,r_110_69_54,0.82,126,180,54,4
2,r_28_10_100,seq54,seq8,r_28_10_100,0.76,0,100,100,4
47,r_125_139_85,seq70,r_110_69_54,r_125_139_85,0.73,10,95,85,4
18,r_11_41_57,r_121_114_84,r_46_94_4,r_11_41_57,0.9,3,60,57,4
58,seq141,r_37_135_99,r_88_57_19,r_37_135_99,0.61,1,100,99,4
20,r_86_75_58,r_118_21_141,r_76_149_10,r_118_21_141,0.88,6,147,141,4
44,r_27_3_20,r_15_84_193,r_146_103_195,r_27_3_20,0.67,6,26,20,4
38,r_6_80_157,seq47,r_20_60_56,r_20_60_56,0.65,104,160,56,4
34,r_77_63_136,r_134_101_148,seq130,r_77_63_136,0.54,2,138,136,4
25,r_147_22_21,r_6_80_157,r_66_98_196,r_147_22_21,0.92,2,23,21,4
60,seq26,r_95_25_123,seq130,r_95_25_123,0.93,4,127,123,4
17,r_1_33_66,seq68,r_99_71_161,r_1_33_66,0.91,0,66,66,4
9,r_64_78_119,seq83,seq47,r_64_78_119,0.89,4,123,119,4
22,r_126_24_97,r_17_107_107,seq13,r_126_24_97,0.52,3,100,97,4
23,r_4_5_77,seq53,seq49,r_4_5_77,0.92,4,81,77,4
35,r_29_62_65,seq120,r_119_116_49,r_119_116_49,1.0,24,73,49,4
12,r_19_51_108,r_66_98_196,seq53,r_19_51_108,0.77,14,122,108,4
30,r_28_61_85,seq146,r_123_42_38,r_28_61_85,1.0,1,86,85,5
36,r_43_30_105,seq5,seq135,r_43_30_105,0.93,1,106,105,5
92,seq101,r_93_86_60,r_6_73_133,r_93_86_60,0.72,2,62,60,5
14,r_85_57_165,r_62_15_177,r_34_148_40,r_34_148_40,0.88,127,167,40,5
43,r_56_16_55,r_8_96_146,seq128,r_56_16_55,0.96,8,63,55,5
54,seq5,r_43_30_105,r_113_19_15,r_43_30_105,0.88,1,106,105,5
37,r_145_99_166,r_54_105_141,r_64_75_181,r_54_105_141,0.83,1,142,141,5
59,seq13,r_64_75_181,r_123_42_38,r_123_42_38,0.66,22,60,38,5
55,seq134,r_40_80_120,r_58_44_12,r_40_80_120,0.84,0,120,120,5
16,r_2_90_90,r_8_96_146,r_108_89_47,r_2_90_90,0.6,0,90,90,5
21,r_114_110_122,seq115,r_40_80_120,r_114_110_122,0.88,2,124,122,5
1,r_8_96_146,seq143,r_113_19_15,r_8_96_146,0.83,0,146,146,5
42,r_59_12_71,seq132,r_123_42_38,r_59_12_71,0.99,0,71,71,5
7,r_69_70_188,r_58_44_12,r_48_7_58,r_48_7_58,0.61,130,188,58,5
19,r_64_75_181,seq13,r_10_142_111,r_10_142_111,0.83,70,181,111,5
6,r_82_109_21,r_10_142_111,seq71,r_82_109_21,0.97,0,21,21,5
31,r_53_100_68,r_138_65_89,r_108_89_47,r_53_100_68,1.0,0,68,68,5
41,r_74_120_75,r_8_96_146,r_104_140_57,r_74_120_75,0.98,0,75,75,5
3,r_121_21_82,r_8_96_146,r_108_89_47,r_121_21_82,0.7,1,83,82,5
4,r_38_106_195,seq137,r_0_103_99,r_0_103_99,0.88,0,99,99,5
0,r_34_148_40,r_43_30_105,r_130_144_8,r_43_30_105,1.0,-19,86,105,5
11,r_147_18_14,r_93_86_60,seq60,r_147_18_14,0.63,0,14,14,5
15,r_127_81_186,seq68,seq101,r_127_81_186,0.29,0,186,186,5
48,r_138_65_89,seq101,r_82_109_21,r_138_65_89,0.91,7,96,89,5
22,r_141_139_22,r_28_61_85,seq125,r_141_139_22,0.85,0,22,22,5
27,r_91_37_147,seq84,r_130_144_8,r_91_37_147,0.58,3,150,147,5
2,r_48_7_58,seq4,r_82_109_21,r_48_7_58,0.91,4,62,58,5
40,r_92_35_151,r_85_57_165,seq68,r_92_35_151,0.77,5,156,151,5
18,r_111_94_182,seq135,r_34_148_40,r_111_94_182,0.44,0,182,182,5
29,r_0_103_99,r_8_96_146,r_38_106_195,r_0_103_99,0.6,0,99,99,5
25,r_9_31_103,seq39,seq78,r_9_31_103,1.0,1,104,103,5
99,seq125,r_69_70_188,r_141_139_22,r_141_139_22,0.74,12,34,22,5
32,r_93_86_60,seq101,r_116_55_46,r_93_86_60,0.98,2,62,60,5
38,r_62_15_177,seq60,r_34_148_40,r_34_148_40,0.62,139,179,40,5
34,r_129_149_76,r_26_122_191,r_113_19_15,r_129_149_76,0.99,2,78,76,5
47,r_104_140_57,seq29,seq117,r_104_140_57,1.0,2,59,57,5
81,seq68,r_127_81_186,r_48_7_58,r_48_7_58,0.71,128,186,58,5
39,r_58_44_12,r_59_12_71,seq134,r_58_44_12,0.72,3,15,12,5
7,r_69_70_188,seq125,r_58_44_12,r_69_70_188,0.51,-150,38,188,5
17,r_113_19_15,r_26_122_191,r_43_30_105,r_113_19_15,0.95,0,15,15,5
28,r_24_126_31,r_38_106_195,seq41,r_24_126_31,0.87,39,70,31,5
8,r_123_42_38,r_40_80_120,r_147_18_14,r_123_42_38,0.8,0,38,38,5
17,r_113_19_15,r_43_30_105,r_129_149_76,r_113_19_15,0.98,91,106,15,5
35,r_17_136_118,r_8_96_146,r_82_109_21,r_17_136_118,0.97,2,120,118,5
12,r_40_80_120,seq134,seq131,r_40_80_120,0.86,0,120,120,5
36,r_127_27_183,seq104,r_129_50_129,r_127_27_183,0.23,0,183,183,6
14,r_120_10_85,r_98_24_165,seq74,r_120_10_85,0.97,4,89,85,6
8,r_8_144_74,r_14_30_119,r_2_131_17,r_8_144_74,0.93,1,75,74,6
37,r_54_60_160,seq123,r_120_10_85,r_54_60_160,0.54,0,160,160,6
83,seq92,r_6_7_52,r_2_131_17,r_2_131_17,0.45,-5,12,17,6
39,r_47_95_65,r_107_91_180,seq103,r_47_95_65,0.78,18,83,65,6
42,r_96_70_136,seq87,r_52_28_96,r_52_28_96,0.98,40,136,96,6
45,r_67_143_133,seq99,seq22,r_67_143_133,0.62,2,135,133,6
33,r_2_131_17,seq92,r_112_136_69,r_112_136_69,0.96,15,84,69,6
31,r_86_9_148,seq32,r_89_36_112,r_86_9_148,0.58,0,148,148,6
41,r_73_53_176,r_33_149_121,r_52_28_96,r_73_53_176,0.73,-47,129,176,6
3,r_147_82_145,seq75,r_67_143_133,r_147_82_145,0.69,1,146,145,6
90,seq104,r_127_27_183,r_147_82_145,r_147_82_145,0.82,38,183,145,6
33,r_2_131_17,r_72_4_188,seq92,r_2_131_17,0.62,-4,13,17,6
26,r_124_5_44,seq132,seq45,r_124_5_44,0.49,65,109,44,6
4,r_66_130_123,seq75,r_142_69_28,r_66_130_123,0.78,-2,121,123,6
11,r_125_48_144,seq135,r_14_30_119,r_125_48_144,0.77,1,145,144,6
13,r_63_25_131,seq22,seq64,r_63_25_131,0.61,1,132,131,6
15,r_107_91_180,seq100,r_147_82_145,r_147_82_145,0.61,36,181,145,6
48,r_77_106_91,r_14_30_119,seq100,r_77_106_91,0.97,7,98,91,6
6,r_34_148_106,r_71_85_191,r_118_138_6,r_34_148_106,0.8,1,107,106,6
62,seq18,r_98_24_165,r_124_5_44,r_98_24_165,0.52,4,169,165,6
0,r_35_17_23,r_57_110_48,seq135,r_35_17_23,0.95,-5,18,23,6
1,r_140_20_53,r_26_51_157,seq12,r_140_20_53,0.83,0,53,53,6
47,r_33_149_121,r_73_53_176,r_140_20_53,r_33_149_121,0.9,8,129,121,6
40,r_23_115_61,r_98_24_165,seq41,r_23_115_61,0.88,3,64,61,6
29,r_93_78_168,seq12,seq76,r_93_78_168,0.57,1,169,168,6
24,r_89_36_112,seq68,r_31_3_40,r_89_36_112,0.84,1,113,112,6
25,r_56_62_104,seq133,seq0,r_56_62_104,0.79,5,109,104,6
21,r_57_110_48,seq29,seq133,r_57_110_48,0.85,7,55,48,6
20,r_142_69_28,seq59,seq46,r_142_69_28,0.63,4,32,28,6
34,r_129_50_129,seq75,seq84,r_129_50_129,0.91,1,130,129,6
81,seq87,r_96_70_136,r_146_121_36,r_146_121_36,0.99,100,136,36,6
9,r_6_7_52,r_107_91_180,r_23_115_61,r_6_7_52,0.98,10,62,52,6
96,seq119,r_102_13_139,r_56_62_104,r_56_62_104,0.73,48,152,104,6
22,r_83_44_138,seq1,r_120_10_85,r_83_44_138,0.74,2,140,138,6
49,r_139_61_64,seq39,seq68,r_139_61_64,0.97,0,64,64,6
44,r_112_136_69,r_71_85_191,r_2_131_17,r_112_136_69,0.77,3,72,69,6
41,r_73_53_176,r_52_28_96,r_66_130_123,r_73_53_176,0.64,7,183,176,6
23,r_117_19_140,seq29,r_47_95_65,r_117_19_140,0.53,4,144,140,6
32,r_146_121_36,r_58_49_192,seq87,r_146_121_36,0.97,6,42,36,6
51,seq132,r_49_21_61,r_112_46_29,r_49_21_61,1.0,1,62,61,7
43,r_49_21_61,seq132,seq103,r_49_21_61,0.99,1,62,61,7
7,r_7_106_15,r_27_123_112,seq101,r_7_106_15,0.89,0,15,15,7
71,seq56,r_54_138_97,r_100_90_77,r_54_138_97,0.65,4,101,97,7
16,r_66_108_103,seq42,r_115_34_40,r_115_34_40,0.71,75,115,40,7
39,r_54_138_97,seq56,seq101,r_54_138_97,0.97,4,101,97,7
1,r_2_6_143,r_52_102_106,r_104_68_8,r_52_102_106,0.64,2,108,106,7
45,r_30_120_107,r_51_76_161,r_93_80_33,r_30_120_107,0.96,0,107,107,7
31,r_13_38_150,r_122_87_186,r_4_28_167,r_13_38_150,0.66,1,151,150,7
41,r_52_102_106,r_2_6_143,seq101,r_52_102_106,0.97,2,108,106,7
12,r_4_28_167,r_12_77_37,r_13_38_150,r_4_28_167,0.49,-21,146,167,7
22,r_93_80_33,r_14_130_75,seq140,r_93_80_33,0.99,1,34,33,7
63,seq23,r_51_76_161,r_92_63_72,r_92_63_72,1.0,7,79,72,7
20,r_92_63_72,r_79_105_173,seq23,r_92_63_72,0.94,5,77,72,7
15,r_100_90_77,seq118,r_113_22_16,r_100_90_77,0.74,3,80,77,7
6,r_44_50_117,r_94_73_198,r_19_137_52,r_44_50_117,0.55,2,119,117,7
47,r_104_68_8,seq53,seq98,r_104_68_8,0.85,2,10,8,7
35,r_127_45_47,r_121_86_43,r_93_80_33,r_127_45_47,0.99,2,49,47,7
40,r_126_29_90,seq129,seq61,r_126_29_90,0.96,1,91,90,7
14,r_25_72_44,r_4_28_167,seq57,r_25_72_44,0.78,3,47,44,7
36,r_124_141_50,r_122_87_186,seq9,r_124_141_50,0.88,2,52,50,7
12,r_4_28_167,r_19_137_52,r_0_149_23,r_4_28_167,0.63,-128,39,167,7
32,r_35_125_102,r_41_16_12,r_93_80_33,r_35_125_102,0.82,1,103,102,7
75,seq61,seq53,r_126_29_90,r_126_29_90,1.0,30,120,90,7
0,r_12_77_37,r_51_76_161,seq75,r_12_77_37,1.0,1,38,37,7
17,r_33_107_175,seq98,r_51_76_161,r_51_76_161,0.53,14,175,161,7
9,r_117_58_133,r_94_73_198,r_70_136_123,r_94_73_198,0.64,-57,141,198,7
24,r_19_137_52,r_4_28_167,r_112_46_29,r_19_137_52,0.89,2,54,52,7
28,r_79_105_173,seq101,r_126_29_90,r_79_105_173,0.59,1,174,173,7
91,seq101,r_79_105_173,r_54_138_97,r_54_138_97,0.76,68,165,97,7
49,r_10_26_93,r_67_3_157,r_100_90_77,r_67_3_157,0.56,-57,100,157,7
34,r_0_149_23,r_14_130_75,seq129,r_0_149_23,1.0,0,23,23,7
44,r_85_131_115,seq97,seq103,r_85_131_115,1.0,0,115,115,7
19,r_115_34_40,r_55_81_189,seq129,r_115_34_40,1.0,0,40,40,7
12,r_4_28_167,r_0_149_23,r_12_77_37,r_4_28_167,0.42,-104,63,167,7
36,r_143_59_80,r_17_87_154,r_93_114_15,r_143_59_80,0.81,2,82,80,8
43,r_130_133_101,r_97_148_110,r_137_11_64,r_130_133_101,0.95,0,101,101,8
28,r_149_1_24,r_17_87_154,r_102_71_4,r_149_1_24,0.84,-3,21,24,8
37,r_74_61_44,r_20_89_182,seq8,r_74_61_44,0.94,6,50,44,8
25,r_60_144_14,r_17_87_154,seq46,r_60_144_14,0.82,2,16,14,8
5,r_91_27_106,r_16_118_69,r_149_1_24,r_91_27_106,0.43,-31,75,106,8
46,r_62_43_178,r_28_49_189,seq142,r_62_43_178,0.29,5,183,178,8
69,seq38,r_101_128_13,r_40_70_102,r_40_70_102,1.0,6,108,102,8
45,r_16_118_69,r_91_27_106,r_53_33_41,r_16_118_69,0.99,11,80,69,8
19,r_141_126_142,seq7,r_18_32_131,r_141_126_142,0.83,4,146,142,8
35,r_82_3_55,r_23_31_183,seq8,r_82_3_55,0.96,3,58,55,8
31,r_85_66_59,seq142,seq26,r_85_66_59,0.99,1,60,59,8
41,r_77_36_138,r_23_31_183,seq9,r_77_36_138,0.6,2,140,138,8
3,r_79_78_124,r_68_22_45,r_137_11_64,r_79_78_124,0.87,6,130,124,8
26,r_40_70_102,seq2,seq38,r_40_70_102,0.96,4,106,102,8
4,r_96_94_125,r_103_84_187,r_53_33_41,r_96_94_125,0.82,0,125,125,8
0,r_116_80_174,seq147,seq21,r_116_80_174,0.46,2,176,174,8
11,r_112_55_147,r_93_114_15,r_136_6_71,r_112_55_147,0.89,0,147,147,8
20,r_69_122_111,seq29,seq19,r_69_122_111,0.87,1,112,111,8
12,r_109_119_49,seq26,r_146_39_62,r_109_119_49,0.98,1,50,49,8
13,r_58_115_93,r_141_126_142,seq29,r_58_115_93,0.97,2,95,93,8
48,r_110_131_99,seq147,seq7,r_110_131_99,0.99,1,100,99,8
42,r_34_64_17,r_23_31_183,seq54,r_34_64_17,0.92,0,17,17,8
2,r_136_6_71,r_58_115_93,seq139,r_136_6_71,0.98,0,71,71,8
47,r_35_42_87,r_50_129_175,seq26,r_35_42_87,0.92,0,87,87,8
59,seq142,r_106_67_173,r_62_43_178,r_106_67_173,0.62,0,173,173,8
18,r_92_104_73,seq142,r_149_1_24,r_92_104_73,0.95,9,82,73,8
29,r_97_148_110,r_112_55_147,r_82_3_55,r_97_148_110,0.91,8,118,110,8
24,r_146_39_62,r_96_94_125,r_53_33_41,r_53_33_41,0.98,28,69,41,8
33,r_28_49_189,r_62_43_178,r_97_148_110,r_97_148_110,0.88,76,186,110,8
32,r_137_11_64,seq25,seq107,r_137_11_64,1.0,0,64,64,8
38,r_93_114_15,r_97_148_110,r_143_59_80,r_93_114_15,0.77,100,115,15,8
52,seq4,r_106_67_173,seq30,r_106_67_173,0.99,0,173,173,8
34,r_95_88_190,seq108,r_53_33_41,r_53_33_41,0.67,149,190,41,8
12,r_109_119_49,r_146_39_62,r_97_148_110,r_146_39_62,0.53,18,80,62,8
9,r_103_84_187,r_132_44_199,r_79_78_124,r_79_78_124,0.9,64,188,124,8
10,r_20_89_182,r_74_61_44,seq37,r_74_61_44,0.75,6,50,44,8
1,r_53_33_41,r_141_126_142,r_34_64_17,r_34_64_17,0.76,24,41,17,8
22,r_5_113_82,seq81,seq73,r_5_113_82,0.99,0,82,82,8
59,seq142,r_92_104_73,r_106_67_173,r_92_104_73,0.54,-19,54,73,8
49,r_18_32_131,seq25,r_53_33_41,r_18_32_131,0.69,0,131,131,8
44,r_125_13_143,r_132_44_199,r_143_59_80,r_132_44_199,0.6,-48,151,199,8
23,r_106_67_173,seq4,r_136_6_71,r_106_67_173,0.55,0,173,173,8
5,r_91_27_106,r_149_1_24,r_110_131_99,r_91_27_106,0.56,1,107,106,8
41,r_41_81_44,r_52_24_194,seq11,r_41_81_44,0.9,1,45,44,9
30,r_36_120_113,r_76_64_182,seq18,r_36_120_113,0.8,1,114,113,9
36,r_8_139_190,seq11,r_121_124_100,r_121_124_100,1.0,32,132,100,9
14,r_39_40_135,r_142_34_172,seq83,r_39_40_135,0.76,1,136,135,9
53,seq138,r_0_146_82,r_115_37_49,r_115_37_49,0.97,39,88,49,9
43,r_76_64_182,seq25,r_63_33_128,r_76_64_182,0.47,0,182,182,9
16,r_96_105_75,r_66_112_156,seq38,r_96_105_75,1.0,0,75,75,9
21,r_142_34_172,seq99,r_132_140_59,r_142_34_172,0.65,0,172,172,9
39,r_121_124_100,r_101_28_124,r_8_139_190,r_121_124_100,0.97,0,100,100,9
5,r_43_1_139,seq85,seq31,r_43_1_139,0.76,1,140,139,9
46,r_103_135_159,r_142_34_172,r_0_146_82,r_103_135_159,0.64,2,161,159,9
1,r_132_140_59,r_80_27_162,seq97,r_132_140_59,1.0,0,59,59,9
39,r_121_124_100,r_8_139_190,seq122,r_8_139_190,0.74,0,190,190,9
31,r_141_75_99,seq18,seq91,r_141_75_99,0.69,0,99,99,9
24,r_62_2_54,seq116,seq53,r_62_2_54,1.0,1,55,54,9
37,r_45_74_48,seq31,seq16,r_45_74_48,1.0,0,48,48,9
27,r_5_26_31,r_92_71_166,seq102,r_5_26_31,0.99,0,31,31,9
10,r_49_54_168,seq55,r_36_120_113,r_49_54_168,0.64,0,168,168,9
18,r_115_37_49,seq109,seq138,r_115_37_49,0.99,0,49,49,9
32,r_78_9_22,r_39_40_135,seq129,r_78_9_22,1.0,2,24,22,9
78,seq83,r_17_133_132,r_39_40_135,r_39_40_135,0.88,5,140,135,9
11,r_0_146_82,seq138,r_96_105_75,r_96_105_75,0.98,13,88,75,9
20,r_88_60_90,r_39_40_135,r_123_131_41,r_88_60_90,0.99,0,90,90,9
98,seq125,r_63_33_128,seq50,r_63_33_128,1.0,0,128,128,9
48,r_58_107_13,seq51,r_149_10_89,r_58_107_13,0.7,63,76,13,9
49,r_126_98_36,r_87_106_145,seq50,r_87_106_145,1.0,0,145,145,9
36,r_8_139_190,r_121_124_100,r_7_145_184,r_8_139_190,0.92,0,190,190,9
85,seq99,r_142_34_172,r_63_33_128,r_63_33_128,0.67,44,172,128,9
49,r_126_98_36,r_84_95_122,r_87_106_145,r_126_98_36,1.0,1,37,36,9
40,r_104_119_146,seq29,r_58_107_13,r_104_119_146,0.81,2,148,146,9
23,r_77_147_16,r_63_33_128,r_46_56_19,r_77_147_16,1.0,1,17,16,9
91,seq111,r_72_128_120,r_126_98_36,r_72_128_120,0.82,6,126,120,9
13,r_46_56_19,seq53,r_77_147_16,r_46_56_19,0.98,1,20,19,9
38,r_100_4_106,r_142_34_172,r_132_140_59,r_100_4_106,0.69,0,106,106,9
17,r_72_128_120,seq11,seq79,r_72_128_120,0.94,1,121,120,9
28,r_87_106_145,r_126_98_36,r_63_33_128,r_126_98_36,0.57,109,145,36,9
22,r_61_32_110,r_57_70_149,seq99,r_61_32_110,0.97,0,110,110,9
28,r_87_106_145,seq125,r_126_98_36,r_126_98_36,1.0,42,78,36,9
7,r_149_10_89,seq110,r_58_107_13,r_58_107_13,0.73,77,90,13,9
35,r_12_19_148,seq117,seq148,r_12_19_148,0.56,0,148,148,9
12,r_93_134_189,seq11,r_143_6_20,r_143_6_20,0.87,168,188,20,9
93,seq106,r_56_108_165,r_77_65_70,r_77_65_70,0.88,54,124,70,10
36,r_19_148_105,seq79,r_34_88_98,r_19_148_105,0.97,16,121,105,10
9,r_77_65_70,r_56_108_165,r_90_58_172,r_77_65_70,0.56,100,170,70,10
14,r_78_29_115,r_35_70_138,seq50,r_78_29_115,0.86,15,130,115,10
8,r_146_126_178,seq147,r_83_103_116,r_146_126_178,0.4,-1,177,178,10
53,seq133,r_110_52_148,r_31_3_88,r_31_3_88,0.78,66,154,88,10
43,r_72_101_135,r_93_61_186,r_81_8_75,r_81_8_75,0.57,61,136,75,10
16,r_87_118_162,r_18_27_5,r_110_52_148,r_87_118_162,0.69,0,162,162,10
21,r_117_102_126,r_49_124_14,r_115_14_16,r_115_14_16,0.8,114,130,16,10
39,r_51_132_185,seq131,r_78_29_115,r_78_29_115,0.73,71,186,115,10
1,r_31_3_88,r_100_76_11,seq133,r_31_3_88,0.8,4,92,88,10
46,r_6_30_65,seq141,r_54_66_30,r_6_30_65,0.86,1,66,65,10
42,r_139_116_99,r_99_12_24,seq33,r_139_116_99,0.82,0,99,99,10
45,r_2_96_69,seq23,r_115_14_16,r_2_96_69,0.53,0,69,69,10
95,seq111,r_7_89_114,seq107,r_7_89_114,0.99,0,114,114,10
31,r_93_61_186,seq20,r_31_3_88,r_93_61_186,0.31,0,186,186,10
41,r_4_94_136,seq129,r_17_119_196,r_4_94_136,0.92,-5,131,136,10
10,r_10_68_79,seq107,r_115_14_16,r_10_68_79,0.98,1,80,79,10
62,seq145,seq67,r_84_15_34,r_84_15_34,1.0,16,50,34,10
26,r_34_88_98,r_56_108_165,seq138,r_34_88_98,0.92,21,119,98,10
4,r_46_40_106,seq20,seq129,r_46_40_106,0.27,34,140,106,10
63,seq147,r_146_126_178,r_110_52_148,r_110_52_148,0.84,11,159,148,10
11,r_59_135_63,r_83_103_116,seq45,r_59_135_63,0.94,3,66,63,10
5,r_115_14_16,r_54_66_30,r_71_16_191,r_71_16_191,0.97,-180,11,191,10
13,r_75_37_60,seq128,seq38,r_75_37_60,0.99,0,60,60,10
15,r_86_55_142,r_110_52_148,seq129,r_86_55_142,0.82,1,143,142,10
48,r_113_112_119,r_9_32_89,seq80,r_113_112_119,0.89,2,121,119,10
57,seq140,seq129,r_18_27_5,r_18_27_5,0.48,107,112,5,10
18,r_137_22_56,r_117_102_126,seq23,r_137_22_56,0.77,2,58,56,10
6,r_35_70_138,r_86_55_142,r_115_14_16,r_115_14_16,0.99,122,138,16,10
85,seq74,seq67,r_5_48_122,r_5_48_122,0.82,7,129,122,10
99,seq127,r_90_58_172,r_83_103_116,r_83_103_116,0.96,59,175,116,10
2,r_41_64_29,r_137_22_56,seq20,r_41_64_29,0.96,-6,23,29,10
27,r_90_58_172,seq127,r_77_65_70,r_77_65_70,0.85,105,175,70,10
34,r_56_108_165,r_77_65_70,seq43,r_77_65_70,0.78,100,170,70,10
3,r_130_91_82,r_10_68_79,seq13,r_130_91_82,0.68,-2,80,82,10
3,r_130_91_82,seq120,r_10_68_79,r_130_91_82,0.41,-37,45,82,10
47,r_122_44_130,r_87_118_162,r_7_89_114,r_122_44_130,0.63,2,132,130,10
29,r_47_121_68,r_99_12_24,r_137_22_56,r_47_121_68,0.92,1,69,68,10
24,r_9_32_89,seq13,r_49_124_14,r_9_32_89,0.51,32,121,89,10
33,r_110_52_148,seq133,seq147,r_110_52_148,0.63,6,154,148,10
20,r_84_15_34,seq134,seq145,r_84_15_34,0.95,4,38,34,10
32,r_5_48_122,r_87_118_162,seq74,r_5_48_122,0.8,2,124,122,10
38,r_21_114_85,r_17_119_196,r_18_27_5,r_21_114_85,0.84,0,85,85,10
52,seq131,r_51_132_185,seq69,r_51_132_185,0.61,-28,157,185,10
34,r_56_108_165,r_34_88_98,r_77_65_70,r_77_65_70,0.65,49,119,70,10
17,r_81_8_75,r_34_88_98,r_137_22_56,r_81_8_75,0.58,7,82,75,10
94,seq107,r_10_68_79,seq111,r_10_68_79,1.0,1,80,79,10
9,r_77_65_70,r_90_58_172,r_56_108_165,r_77_65_70,0.54,12,82,70,10
28,r_7_89_114,seq111,r_105_144_108,r_7_89_114,0.9,0,114,114,10
49,r_24_136_93,r_46_40_106,r_49_124_14,r_24_136_93,0.9,2,95,93,10
7,r_83_103_116,seq33,seq127,r_83_103_116,0.92,5,121,116,10
44,r_105_144_108,r_71_16_191,seq13,r_105_144_108,0.84,3,111,108,10
30,r_57_59_171,r_84_97_188,r_60_22_146,r_57_59_171,0.31,-30,141,171,11
36,r_114_91_113,seq21,seq18,r_114_91_113,0.67,0,113,113,11
14,r_134_7_101,seq88,seq2,r_134_7_101,0.71,4,105,101,11
37,r_44_1_117,r_65_104_151,r_62_119_182,r_44_1_117,0.57,2,119,117,11
59,seq10,r_74_110_145,r_67_112_77,r_67_112_77,1.0,71,148,77,11
16,r_80_93_132,r_26_102_3,r_45_101_48,r_26_102_3,0.53,136,139,3,11
21,r_49_144_115,r_29_75_170,seq12,r_29_75_170,0.55,-54,116,170,11
46,r_123_47_150,seq21,r_73_122_167,r_123_47_150,0.58,0,150,150,11
42,r_95_76_148,r_17_83_164,seq98,r_17_83_164,0.9,-14,150,164,11
45,r_23_14_95,r_134_7_101,seq30,r_23_14_95,0.71,2,97,95,11
34,r_136_70_47,r_134_7_101,seq85,r_136_70_47,0.81,2,49,47,11
43,r_139_79_50,r_134_7_101,r_37_121_20,r_139_79_50,0.62,2,52,50,11
1,r_53_64_19,r_43_147_38,r_26_102_3,r_26_102_3,0.66,16,19,3,11
9,r_42_78_40,r_123_47_150,r_43_147_38,r_123_47_150,0.75,-110,40,150,11
31,r_73_122_167,seq126,r_123_47_150,r_123_47_150,0.83,3,153,150,11
20,r_25_118_42,r_55_146_192,seq71,r_25_118_42,1.0,0,42,42,11
4,r_142_92_118,seq89,r_28_66_109,r_142_92_118,0.64,1,119,118,11
0,r_74_110_145,seq10,r_43_147_38,r_43_147_38,0.69,110,148,38,11
11,r_48_132_105,r_84_97_188,r_73_122_167,r_48_132_105,0.78,1,106,105,11
13,r_52_72_60,seq133,r_26_102_3,r_52_72_60,0.87,5,65,60,11
40,r_81_27_44,r_80_93_132,seq50,r_81_27_44,1.0,0,44,44,11
6,r_145_129_81,r_49_144_115,r_34_116_13,r_145_129_81,0.99,3,84,81,11
7,r_43_147_38,r_107_13_172,r_42_78_40,r_107_13_172,0.77,-131,41,172,11
2,r_37_121_20,seq89,r_131_105_97,r_131_105_97,0.87,41,138,97,11
47,r_82_46_187,seq33,r_38_69_155,r_38_69_155,0.65,33,188,155,11
29,r_36_87_135,seq3,seq141,r_36_87_135,0.6,1,136,135,11
44,r_16_63_34,r_9_54_102,seq24,r_9_54_102,0.69,-62,40,102,11
25,r_68_31_129,seq85,r_34_116_13,r_68_31_129,0.81,0,129,129,11
68,seq33,r_82_46_187,r_37_121_20,r_37_121_20,0.78,169,189,20,11
32,r_67_112_77,seq2,seq10,r_67_112_77,0.93,1,78,77,11
24,r_15_125_17,r_45_101_48,seq113,r_15_125_17,0.85,-5,12,17,11
17,r_60_22_146,seq133,r_57_59_171,r_60_22_146,0.5,0,146,146,11
22,r_38_69_155,r_120_39_161,r_62_119_182,r_120_39_161,0.47,-2,159,161,11
35,r_120_39_161,seq30,r_55_146_192,r_120_39_161,0.4,1,162,161,11
12,r_28_66_109,seq40,r_81_27_44,r_28_66_109,0.78,2,111,109,11
30,r_82_46_167,r_67_109_177,seq135,r_82_46_167,0.67,1,168,167,12
51,seq3,seq63,r_107_48_191,r_107_48_191,0.44,-30,161,191,12
19,r_80_39_44,r_112_132_103,r_127_5_16,r_80_39_44,0.65,0,44,44,12
8,r_124_53_152,seq86,seq34,r_124_53_152,0.91,0,152,152,12
18,r_31_61_54,r_33_47_52,seq34,r_31_61_54,1.0,2,56,54,12
16,r_87_76_129,r_57_38_109,r_59_65_90,r_87_76_129,0.53,-17,112,129,12
39,r_8_75_119,r_107_48_191,r_14_139_68,r_14_139_68,0.61,55,123,68,12
1,r_144_126_100,r_124_53_152,seq125,r_124_53_152,0.65,-41,111,152,12
38,r_127_5_16,r_59_65_90,r_80_39_44,r_80_39_44,0.77,4,48,44,12
46,r_116_30_164,r_40_94_30,seq101,r_116_30_164,0.71,0,164,164,12
43,r_21_13_40,r_114_54_132,r_127_5_16,r_21_13_40,0.67,1,41,40,12
47,r_114_54_132,r_21_13_40,r_110_64_162,r_21_13_40,0.62,1,41,40,12
76,seq63,r_133_130_98,r_81_58_163,r_133_130_98,1.0,0,98,98,12
31,r_28_95_183,seq45,r_77_6_10,r_28_95_183,0.52,0,183,183,12
41,r_112_132_103,seq34,r_136_15_3,r_112_132_103,1.0,2,105,103,12
89,seq148,r_104_123_184,r_32_92_106,r_32_92_106,1.0,73,179,106,12
15,r_43_141_20,r_57_38_109,seq74,r_43_141_20,0.87,0,20,20,12
3,r_120_24_181,seq74,r_59_65_90,r_59_65_90,0.71,94,184,90,12
85,seq88,r_138_97_174,r_77_6_10,r_77_6_10,0.98,2,12,10,12
36,r_19_78_15,seq7,r_129_35_87,r_19_78_15,0.8,-3,12,15,12
4,r_129_35_87,r_19_78_15,r_21_13_40,r_129_35_87,0.79,1,88,87,12
9,r_16_0_39,seq4,seq108,r_16_0_39,1.0,0,39,39,12
11,r_133_130_98,seq63,r_26_23_28,r_133_130_98,0.54,2,100,98,12
20,r_104_123_184,seq63,r_1_85_5,r_104_123_184,0.55,-6,178,184,12
13,r_57_38_109,r_87_76_129,r_122_140_51,r_57_38_109,0.8,3,112,109,12
10,r_33_47_52,r_31_61_54,r_43_141_20,r_31_61_54,0.97,2,56,54,12
6,r_110_64_162,seq71,seq134,r_110_64_162,0.74,0,162,162,12
24,r_106_51_33,seq4,seq91,r_106_51_33,0.97,2,35,33,12
16,r_87_76_129,r_59_65_90,seq45,r_87_76_129,0.8,1,130,129,12
36,r_19_78_15,r_129_35_87,r_59_65_90,r_19_78_15,0.56,73,88,15,12
42,r_72_147_21,r_81_58_163,r_2_93_4,r_72_147_21,0.85,-1,20,21,12
2,r_32_92_106,seq11,r_81_58_163,r_32_92_106,1.0,0,106,106,12
40,r_67_109_177,seq100,r_110_64_162,r_110_64_162,0.88,18,180,162,12
25,r_137_98_80,r_110_64_162,r_31_61_54,r_110_64_162,0.93,-82,80,162,12
33,r_14_139_68,seq20,seq4,r_14_139_68,0.94,1,69,68,12
47,r_114_54_132,r_110_64_162,r_26_23_28,r_114_54_132,0.85,0,132,132,12
14,r_119_111_24,r_136_15_3,seq25,r_119_111_24,0.97,1,25,24,12
50,seq128,r_149_62_150,seq146,r_149_62_150,1.0,4,154,150,12
61,seq22,r_117_10_53,r_19_78_15,r_117_10_53,0.99,3,56,53,12
58,seq146,r_149_62_150,seq25,r_149_62_150,1.0,-50,100,150,12
28,r_52_66_140,r_33_47_52,r_2_93_4,r_33_47_52,0.65,-2,50,52,12
26,r_122_140_51,r_120_24_181,r_27_143_151,r_122_140_51,0.91,6,57,51,12
34,r_77_6_10,r_32_92_106,seq88,r_77_6_10,0.99,1,11,10,12
17,r_84_142_188,r_57_38_109,r_59_65_90,r_84_142_188,0.77,-84,104,188,12
5,r_26_23_28,r_120_24_181,seq60,r_26_23_28,1.0,-4,24,28,12
79,seq71,r_110_64_162,seq3,r_110_64_162,0.91,0,162,162,12
44,r_117_10_53,seq22,seq25,r_117_10_53,1.0,0,53,53,12
12,r_59_65_90,r_110_64_162,r_19_78_15,r_59_65_90,0.64,0,90,90,12
84,seq86,r_124_53_152,r_32_92_106,r_32_92_106,0.7,46,152,106,12
36,r_53_149_198,r_50_97_65,r_22_109_40,r_50_97_65,1.0,3,68,65,13
92,seq110,r_80_41_30,r_79_63_184,r_79_63_184,0.43,-49,135,184,13
14,r_48_126_64,seq120,seq93,r_48_126_64,1.0,3,67,64,13
16,r_67_1_44,seq57,r_123_72_34,r_67_1_44,0.5,16,60,44,13
21,r_70_94_46,seq73,seq125,r_70_94_46,0.78,26,72,46,13
1,r_86_55_141,r_79_63_184,seq119,r_86_55_141,0.93,5,146,141,13
5,r_102_11_163,seq121,r_61_10_6,r_61_10_6,0.49,159,165,6,13
19,r_59_16_70,seq33,seq4,r_59_16_70,0.5,2,72,70,13
95,seq120,r_48_126_64,seq119,r_48_126_64,1.0,3,67,64,13
10,r_28_21_101,seq3,seq104,r_28_21_101,0.68,3,104,101,13
0,r_62_27_89,seq0,r_22_109_40,r_62_27_89,0.72,-9,80,89,13
11,r_135_142_142,r_82_99_5,seq7,r_135_142_142,0.68,0,142,142,13
13,r_20_145_109,seq4,r_84_75_115,r_84_75_115,0.65,-4,111,115,13
23,r_19_47_26,r_82_99_5,r_18_130_20,r_19_47_26,0.92,-2,24,26,13
2,r_106_46_38,r_50_97_65,seq7,r_50_97_65,0.74,-21,44,65,13
40,r_64_49_155,r_61_10_6,seq128,r_64_49_155,0.62,0,155,155,13
29,r_140_76_160,r_53_149_198,r_135_142_142,r_140_76_160,0.32,5,165,160,13
24,r_115_71_102,r_102_11_163,seq3,r_115_71_102,0.58,8,110,102,13
65,seq33,r_59_16_70,r_79_63_184,r_59_16_70,0.73,51,121,70,13
47,r_139_148_33,seq17,r_124_100_73,r_139_148_33,0.91,0,33,33,13
34,r_84_75_115,r_82_99_5,r_31_77_98,r_84_75_115,0.61,2,117,115,13
17,r_118_42_156,seq54,r_60_29_139,r_118_42_156,0.45,0,156,156,13
98,seq125,r_23_68_164,r_70_94_46,r_70_94_46,0.75,9,55,46,13
9,r_60_29_139,seq44,r_118_42_156,r_118_42_156,0.66,17,173,156,13
43,r_143_88_55,r_28_21_101,r_79_63_184,r_143_88_55,0.56,1,56,55,13
22,r_117_101_58,r_118_42_156,r_18_130_20,r_117_101_58,0.81,3,61,58,13
28,r_105_34_67,r_135_142_142,seq17,r_105_34_67,1.0,1,68,67,13
49,r_31_77_98,r_141_147_199,r_84_75_115,r_31_77_98,0.72,15,113,98,13
12,r_50_97_65,r_53_149_198,seq113,r_50_97_65,0.97,3,68,65,13
39,r_24_43_35,r_28_21_101,seq17,r_24_43_35,0.99,1,36,35,13
30,r_61_131_78,seq68,seq8,r_61_131_78,0.95,0,78,78,14
36,r_136_114_150,seq134,r_119_102_67,r_136_114_150,0.69,4,154,150,14
14,r_43_105_156,r_118_98_186,r_100_116_65,r_43_105_156,0.6,2,158,156,14
8,r_62_4_64,seq56,seq8,r_62_4_64,0.99,5,69,64,14
43,r_117_79_164,seq96,seq66,r_117_79_164,0.5,3,167,164,14
44,r_118_98_186,r_117_79_164,r_22_17_185,r_118_98_186,0.85,0,186,186,14
86,seq93,r_43_105_156,r_44_37_73,r_44_37_73,0.45,2,75,73,14
16,r_97_133_152,r_119_102_67,r_65_18_57,r_97_133_152,1.0,-82,70,152,14
21,r_38_95_183,seq74,r_44_37_73,r_38_95_183,0.46,3,186,183,14
5,r_44_37_73,seq123,seq93,r_44_37_73,0.96,-2,71,73,14
46,r_23_94_148,seq88,r_76_19_111,r_23_94_148,0.65,1,149,148,14
41,r_3_36_44,seq47,r_20_112_11,r_3_36_44,0.85,0,44,44,14
45,r_65_18_57,r_76_19_111,r_103_25_119,r_65_18_57,0.95,0,57,57,14
10,r_111_78_92,r_148_63_132,r_140_58_33,r_111_78_92,0.9,1,93,92,14
26,r_48_139_108,r_11_7_106,r_62_4_64,r_48_139_108,0.84,7,115,108,14
3,r_50_26_18,r_76_19_111,seq68,r_50_26_18,0.65,0,18,18,14
72,seq57,r_30_24_86,seq88,r_30_24_86,1.0,-15,71,86,14
16,r_97_133_152,r_65_18_57,r_100_116_65,r_97_133_152,0.91,0,152,152,14
32,r_49_71_24,seq107,seq134,r_49_71_24,0.98,0,24,24,14
4,r_30_24_86,r_59_113_126,r_13_75_82,r_30_24_86,0.71,-1,85,86,14
17,r_10_130_191,r_43_105_156,r_46_132_43,r_46_132_43,0.82,-2,41,43,14
62,seq33,r_148_63_132,r_76_19_111,r_148_63_132,0.99,-14,118,132,14
49,r_20_112_11,r_117_79_164,seq56,r_20_112_11,0.63,3,14,11,14
27,r_137_141_165,seq106,r_119_102_67,r_119_102_67,0.89,98,165,67,14
2,r_13_75_82,seq0,seq120,r_13_75_82,1.0,0,82,82,14
38,r_46_132_43,r_76_19_111,r_10_130_191,r_46_132_43,0.95,0,43,43,14
0,r_100_116_65,r_11_7_106,r_111_78_92,r_11_7_106,1.0,1,107,106,14
18,r_103_25_119,seq93,r_65_18_57,r_65_18_57,0.91,4,61,57,14
29,r_119_102_67,r_97_133_152,seq144,r_119_102_67,0.72,-2,65,67,14
24,r_28_52_85,seq96,r_70_146_53,r_28_52_85,0.95,0,85,85,14
48,r_16_83_47,r_31_64_120,seq8,r_16_83_47,1.0,0,47,47,14
35,r_31_64_120,r_34_147_26,seq2,r_31_64_120,0.98,10,130,120,14
25,r_148_63_132,seq33,seq0,r_148_63_132,0.84,-1,131,132,14
33,r_11_7_106,r_48_139_108,seq123,r_11_7_106,0.93,1,107,106,14
31,r_81_27_48,seq39,seq2,r_81_27_48,1.0,1,49,48,14
13,r_109_40_19,r_69_84_196,seq14,r_109_40_19,0.82,0,19,19,14
47,r_140_58_33,r_48_139_108,r_111_78_92,r_140_58_33,0.52,66,99,33,14
37,r_53_72_50,r_76_19_111,seq96,r_53_72_50,0.85,4,54,50,14
20,r_34_147_26,r_31_64_120,seq45,r_31_64_120,0.99,10,130,120,14
35,r_31_64_120,r_16_83_47,r_34_147_26,r_31_64_120,0.97,-91,29,120,14
47,r_140_58_33,seq121,r_48_139_108,r_140_58_33,0.95,0,33,33,14
34,r_12_9_109,r_76_19_111,seq80,r_12_9_109,0.95,3,112,109,14
45,r_65_18_57,r_103_25_119,r_44_37_73,r_65_18_57,0.89,69,126,57,14
94,seq120,r_22_17_185,r_13_75_82,r_13_75_82,1.0,25,107,82,14
22,r_149_89_103,seq96,r_3_36_44,r_149_89_103,0.97,2,105,103,14
28,r_42_77_117,seq96,r_70_146_53,r_42_77_117,0.91,0,117,117,14
0,r_100_116_65,r_142_108_180,r_11_7_106,r_100_116_65,0.71,-12,53,65,14
18,r_103_25_119,r_65_18_57,r_149_89_103,r_103_25_119,0.69,9,128,119,14
44,r_118_98_186,r_43_105_156,r_117_79_164,r_118_98_186,0.47,-28,158,186,14
20,r_34_147_26,r_28_52_85,r_31_64_120,r_34_147_26,0.88,3,29,26,14
23,r_138_29_80,seq55,r_62_4_64,r_62_4_64,0.77,11,75,64,14
12,r_73_128_77,seq129,seq123,r_73_128_77,0.65,4,81,77,14
93,seq107,seq144,r_63_112_160,r_63_112_160,1.0,5,165,160,15
36,r_76_58_130,seq146,r_44_97_104,r_76_58_130,0.6,1,131,130,15
14,r_47_132_109,r_125_85_196,r_70_148_19,r_70_148_19,0.59,90,109,19,15
37,r_35_96_28,seq74,seq133,r_35_96_28,1.0,0,28,28,15
21,r_42_0_78,r_129_149_123,r_114_69_135,r_42_0_78,0.78,4,82,78,15
39,r_128_64_117,seq8,r_6_17_5,r_128_64_117,0.55,4,121,117,15
5,r_79_115_143,seq34,seq106,r_79_115_143,0.78,0,143,143,15
19,r_68_131_87,seq144,seq52,r_68_131_87,1.0,0,87,87,15
15,r_32_55_41,r_48_2_70,seq74,r_32_55_41,1.0,0,41,41,15
31,r_5_10_80,seq84,seq135,r_5_10_80,1.0,1,81,80,15
9,r_123_15_49,r_28_81_150,r_61_120_195,r_123_15_49,1.0,0,49,49,15
42,r_38_12_54,r_134_77_159,seq144,r_38_12_54,1.0,2,56,54,15
26,r_130_117_154,r_119_45_194,seq107,r_130_117_154,0.68,0,154,154,15
4,r_11_18_27,r_79_115_143,r_142_98_14,r_79_115_143,0.74,-116,27,143,15
6,r_105_90_16,r_13_126_36,r_100_102_63,r_105_90_16,0.94,1,17,16,15
0,r_100_102_63,seq144,r_11_18_27,r_100_102_63,1.0,1,64,63,15
11,r_44_97_104,r_63_112_160,r_61_120_195,r_44_97_104,0.76,-2,102,104,15
46,r_62_57_50,r_79_115_143,seq50,r_62_57_50,1.0,2,52,50,15
20,r_93_91_77,r_82_139_126,r_24_7_9,r_24_7_9,0.66,68,77,9,15
27,r_54_20_86,seq135,seq3,r_54_20_86,0.97,0,86,86,15
17,r_70_148_19,seq144,seq103,r_70_148_19,1.0,0,19,19,15
2,r_119_45_194,r_130_117_154,r_93_91_77,r_119_45_194,0.8,-40,154,194,15
6,r_105_90_16,r_100_102_63,seq3,r_100_102_63,1.0,1,64,63,15
18,r_129_149_123,r_42_0_78,r_35_96_28,r_129_149_123,0.99,-47,76,123,15
29,r_28_81_150,seq140,r_47_132_109,r_28_81_150,0.84,1,151,150,15
8,r_16_40_29,seq39,seq94,r_16_40_29,1.0,0,29,29,15
43,r_134_77_159,r_62_57_50,r_19_80_119,r_19_80_119,0.94,44,163,119,15
33,r_67_124_189,seq4,r_16_40_29,r_16_40_29,0.93,160,189,29,15
70,seq50,r_134_77_159,r_62_57_50,r_62_57_50,0.99,82,132,50,15
90,seq103,r_63_112_160,r_70_148_19,r_70_148_19,1.0,0,19,19,15
38,r_48_2_70,r_63_112_160,r_100_102_63,r_100_102_63,0.97,7,70,63,15
1,r_13_126_36,r_93_91_77,seq73,r_13_126_36,0.98,2,38,36,15
60,seq146,r_76_58_130,r_93_91_77,r_93_91_77,0.97,54,131,77,15
43,r_134_77_159,r_38_12_54,r_62_57_50,r_134_77_159,0.92,-103,56,159,15
10,r_71_116_21,r_32_55_41,seq31,r_71_116_21,1.0,0,21,21,15
49,r_65_1_155,r_23_41_171,r_100_102_63,r_100_102_63,1.0,95,158,63,15
12,r_19_80_119,r_79_115_143,seq26,r_19_80_119,0.83,0,119,119,15
32,r_49_30_42,r_93_91_77,seq144,r_49_30_42,1.0,0,42,42,15
36,r_57_82_160,seq109,seq66,r_57_82_160,0.67,1,161,160,16
92,seq109,r_57_82_160,r_19_28_85,r_19_28_85,0.99,-1,84,85,16
14,r_107_13_101,r_88_38_159,r_44_52_140,r_44_52_140,0.91,21,161,140,16
8,r_24_47_177,seq65,r_67_92_103,r_67_92_103,0.96,74,177,103,16
43,r_8_70_146,r_50_126_105,r_120_86_166,r_8_70_146,0.71,2,148,146,16
37,r_88_38_159,r_107_13_101,r_67_92_103,r_67_92_103,0.78,58,161,103,16
20,r_68_132_37,seq39,seq129,r_68_132_37,1.0,-1,36,37,16
16,r_19_28_85,seq49,seq109,r_19_28_85,1.0,-1,84,85,16
39,r_140_4_148,seq103,r_21_25_43,r_21_25_43,1.0,106,149,43,16
18,r_77_48_50,r_73_112_156,seq29,r_77_48_50,1.0,0,50,50,16
97,seq117,r_44_52_140,seq27,r_44_52_140,0.98,0,140,140,16
5,r_99_137_182,seq109,r_119_32_115,r_119_32_115,0.85,67,182,115,16
46,r_122_41_68,seq27,seq124,r_122_41_68,0.87,0,68,68,16
42,r_34_148_180,seq20,r_53_123_97,r_53_123_97,0.5,85,182,97,16
21,r_45_33_35,r_99_137_182,seq39,r_45_33_35,1.0,1,36,35,16
45,r_110_59_87,r_46_138_116,seq78,r_110_59_87,0.75,-3,84,87,16
19,r_83_26_183,r_107_13_101,r_105_106_133,r_105_106_133,0.7,50,183,133,16
13,r_7_17_21,r_58_40_32,r_107_13_101,r_7_17_21,0.99,0,21,21,16
31,r_15_93_28,r_50_126_105,r_21_25_43,r_21_25_43,1.0,1,44,43,16
41,r_60_22_92,r_34_148_180,seq51,r_60_22_92,0.92,0,92,92,16
3,r_44_52_140,seq117,r_107_13_101,r_44_52_140,0.55,0,140,140,16
26,r_6_80_13,r_12_115_162,r_100_56_69,r_100_56_69,1.0,94,163,69,16
60,seq27,r_122_41_68,seq117,r_122_41_68,0.8,-38,30,68,16
11,r_101_94_153,r_72_64_158,r_143_81_150,r_143_81_150,0.89,11,161,150,16
15,r_10_23_134,seq146,r_77_48_50,r_77_48_50,1.0,81,131,50,16
48,r_125_42_168,seq118,r_21_25_43,r_21_25_43,0.99,126,169,43,16
2,r_3_2_27,r_53_123_97,seq109,r_3_2_27,1.0,-1,26,27,16
6,r_61_127_79,seq146,r_0_102_14,r_61_127_79,0.91,-7,72,79,16
34,r_144_121_16,r_50_126_105,seq146,r_144_121_16,0.88,0,16,16,16
27,r_72_64_158,r_101_94_153,r_45_33_35,r_45_33_35,0.98,126,161,35,16
47,r_9_130_118,seq66,r_7_17_21,r_7_17_21,0.98,119,140,21,16
40,r_143_81_150,seq129,seq35,r_143_81_150,0.82,2,152,150,16
29,r_136_133_188,seq118,r_67_92_103,r_67_92_103,0.97,86,189,103,16
24,r_53_123_97,seq30,seq146,r_53_123_97,0.83,-5,92,97,16
25,r_100_56_69,seq95,r_144_121_16,r_100_56_69,0.95,-3,66,69,16
33,r_120_86_166,r_145_89_194,r_8_70_146,r_8_70_146,0.96,41,187,146,16
88,seq97,seq30,r_54_5_83,r_54_5_83,1.0,26,109,83,16
38,r_84_71_113,seq103,seq43,r_84_71_113,0.6,2,115,113,16
7,r_21_25_43,r_136_133_188,r_15_93_28,r_21_25_43,1.0,0,43,43,16
22,r_141_69_108,r_50_126_105,seq30,r_141_69_108,0.98,1,109,108,16
44,r_54_5_83,seq66,seq97,r_54_5_83,1.0,1,84,83,16
17,r_73_112_156,seq117,r_7_17_21,r_73_112_156,0.8,-1,155,156,16
12,r_12_115_162,r_6_80_13,r_98_18_1,r_98_18_1,0.72,162,163,1,16
17,r_73_112_156,r_77_48_50,seq117,r_77_48_50,0.9,-8,42,50,16
30,r_16_17_148,r_44_133_180,seq99,r_16_17_148,0.88,2,150,148,17
43,r_4_45_108,r_11_120_56,seq126,r_11_120_56,0.57,55,111,56,17
37,r_71_57_177,r_44_133_180,r_94_72_31,r_71_57_177,0.45,0,177,177,17
19,r_104_1_21,r_0_80_168,r_146_130_29,r_0_80_168,0.97,0,168,168,17
16,r_91_100_101,seq87,seq86,r_91_100_101,0.78,6,107,101,17
39,r_89_53_109,seq141,r_118_33_91,r_118_33_91,0.51,26,117,91,17
1,r_129_30_149,seq103,seq48,r_129_30_149,0.43,2,151,149,17
46,r_145_125_185,seq87,r_143_95_75,r_143_95_75,0.97,-6,69,75,17
45,r_37_28_121,r_148_135_113,r_2_27_70,r_148_135_113,0.99,16,129,113,17
40,r_105_84_24,seq65,seq63,r_105_84_24,0.84,0,24,24,17
33,r_116_13_61,r_71_57_177,r_54_142_78,r_71_57_177,0.89,0,177,177,17
31,r_149_21_120,seq109,r_23_5_60,r_23_5_60,0.78,70,130,60,17
33,r_116_13_61,r_106_36_72,r_71_57_177,r_116_13_61,0.91,-4,57,61,17
10,r_83_24_184,seq40,r_138_22_95,r_83_24_184,0.54,0,184,184,17
2,r_146_130_29,r_43_111_124,r_138_22_95,r_146_130_29,0.74,0,29,29,17
26,r_11_120_56,r_4_45_108,r_56_79_114,r_4_45_108,0.55,3,111,108,17
12,r_9_82_22,r_83_24_184,r_25_119_33,r_9_82_22,1.0,2,24,22,17
11,r_42_32_80,r_4_45_108,r_9_82_22,r_9_82_22,0.95,48,70,22,17
29,r_23_5_60,r_136_39_153,seq38,r_136_39_153,0.65,-96,57,153,17
13,r_61_137_74,r_69_107_26,r_143_95_75,r_61_137_74,0.77,64,138,74,17
15,r_56_79_114,r_54_142_78,r_118_33_91,r_54_142_78,0.86,-11,67,78,17
8,r_68_121_53,r_94_72_31,seq75,r_68_121_53,0.82,0,53,53,17
2,r_146_130_29,r_138_22_95,r_88_76_110,r_146_130_29,0.84,73,102,29,17
76,seq65,r_105_84_24,r_104_1_21,r_105_84_24,0.88,3,27,24,17
3,r_113_49_46,seq7,seq6,r_113_49_46,0.8,-1,45,46,17
47,r_106_36_72,seq131,seq75,r_106_36_72,0.66,-1,71,72,17
18,r_136_39_153,r_55_102_28,seq65,r_136_39_153,0.33,4,157,153,17
25,r_43_111_124,r_149_21_120,seq86,r_43_111_124,0.75,2,126,124,17
48,r_0_80_168,r_104_1_21,r_16_17_148,r_104_1_21,0.95,147,168,21,17
48,r_0_80_168,r_3_114_155,r_104_1_21,r_0_80_168,0.65,-143,25,168,17
32,r_138_22_95,r_3_114_155,seq73,r_138_22_95,0.6,-13,82,95,17
76,seq65,r_104_1_21,r_136_39_153,r_136_39_153,0.75,-29,124,153,17
34,r_3_114_155,seq112,r_113_49_46,r_3_114_155,0.45,3,158,155,17
36,r_29_124_51,r_129_30_149,seq35,r_29_124_51,0.85,-4,47,51,17
94,seq112,r_3_114_155,r_146_130_29,r_3_114_155,0.55,3,158,155,17
9,r_44_133_180,r_71_57_177,r_146_130_29,r_44_133_180,0.31,-3,177,180,17
22,r_88_76_110,seq8,r_146_130_29,r_88_76_110,0.54,4,114,110,17
28,r_143_95_75,r_129_30_149,r_145_125_185,r_143_95_75,0.9,-6,69,75,17
49,r_148_135_113,r_37_28_121,seq41,r_37_28_121,0.71,8,129,121,17
7,r_60_92_82,seq134,r_113_49_46,r_60_92_82,1.0,0,82,82,17
44,r_97_144_126,r_129_30_149,seq58,r_97_144_126,0.69,2,128,126,17
23,r_55_102_28,r_136_39_153,seq147,r_136_39_153,0.46,4,157,153,17
82,seq75,seq87,r_106_36_72,r_106_36_72,0.79,1,73,72,17
17,r_25_119_33,r_94_72_31,r_9_82_22,r_9_82_22,1.0,-1,21,22,17
35,r_54_142_78,r_56_79_114,r_116_13_61,r_56_79_114,0.52,-38,76,114,17
19,r_104_1_21,r_145_125_185,r_0_80_168,r_0_80_168,0.96,-147,21,168,17
36,r_89_36_182,seq125,r_143_144_68,r_143_144_68,0.79,116,184,68,18
92,seq109,r_86_127_71,seq120,r_86_127_71,0.91,0,71,71,18
14,r_140_25_86,r_89_36_182,seq24,r_140_25_86,0.73,3,89,86,18
8,r_76_64_125,r_42_79_133,seq27,r_42_79_133,0.99,-8,125,133,18
37,r_94_74_199,r_87_123_198,r_42_79_133,r_42_79_133,1.0,1,134,133,18
16,r_28_9_172,seq136,r_71_5_105,r_71_5_105,0.66,67,172,105,18
5,r_71_5_105,r_32_116_189,seq97,r_71_5_105,1.0,0,105,105,18
46,r_69_128_167,r_89_36_182,r_8_121_47,r_8_121_47,0.9,120,167,47,18
42,r_65_75_175,seq51,seq61,r_65_75_175,0.48,4,179,175,18
27,r_34_48_25,r_87_123_198,seq38,r_34_48_25,1.0,0,25,25,18
86,seq82,r_94_74_199,r_8_121_47,r_8_121_47,1.0,0,47,47,18
19,r_22_111_184,r_132_18_185,r_143_144_68,r_143_144_68,1.0,118,186,68,18
32,r_110_142_43,seq61,seq43,r_110_142_43,0.89,4,47,43,18
41,r_23_37_159,r_143_144_68,seq124,r_143_144_68,0.66,92,160,68,18
10,r_129_21_168,seq135,r_91_44_30,r_91_44_30,0.74,143,173,30,18
90,seq97,r_112_52_188,r_71_5_105,r_71_5_105,0.99,25,130,105,18
63,seq24,r_39_99_166,r_140_25_86,r_140_25_86,0.96,81,167,86,18
11,r_112_52_188,seq97,r_110_142_43,r_110_142_43,0.82,145,188,43,18
98,seq125,r_89_36_182,r_107_102_170,r_89_36_182,0.39,2,184,182,18
15,r_86_127_71,seq109,seq24,r_86_127_71,0.91,0,71,71,18
48,r_118_35_137,r_143_144_68,r_91_44_30,r_143_144_68,0.99,69,137,68,18
20,r_81_131_41,r_22_111_184,r_91_44_30,r_91_44_30,0.66,-6,24,30,18
6,r_42_79_133,r_129_21_168,r_94_74_199,r_42_79_133,0.98,0,133,133,18
31,r_87_123_198,r_34_48_25,r_104_88_18,r_87_123_198,0.95,-178,20,198,18
39,r_101_1_36,r_22_111_184,seq67,r_101_1_36,0.85,2,38,36,18
30,r_145_139_46,r_100_16_156,seq68,r_145_139_46,0.48,12,58,46,18
47,r_78_83_142,seq126,seq31,r_78_83_142,0.52,5,147,142,18
74,seq138,r_137_96_107,seq136,r_137_96_107,1.0,2,109,107,18
18,r_66_95_135,r_103_46_152,r_91_44_30,r_103_46_152,0.93,-17,135,152,18
29,r_149_33_94,r_87_123_198,r_145_139_46,r_149_33_94,1.0,0,94,94,18
25,r_57_119_186,seq45,r_42_79_133,r_42_79_133,0.98,53,186,133,18
33,r_100_16_156,seq130,r_140_25_86,r_100_16_156,0.26,4,160,156,18
40,r_104_88_18,r_143_144_68,r_87_123_198,r_104_88_18,0.74,0,18,18,18
21,r_8_121_47,seq29,seq82,r_8_121_47,1.0,0,47,47,18
34,r_98_59_79,seq53,seq130,r_98_59_79,0.71,0,79,79,18
67,seq38,r_22_111_184,r_34_48_25,r_34_48_25,1.0,28,53,25,18
45,r_15_4_183,r_145_139_46,r_42_79_133,r_145_139_46,0.89,137,183,46,18
17,r_141_58_89,seq27,r_103_46_152,r_141_58_89,0.48,1,90,89,18
9,r_47_12_80,r_103_46_152,seq135,r_103_46_152,0.61,-69,83,152,18
28,r_19_113_56,r_71_5_105,seq133,r_71_5_105,1.0,-41,64,105,18
45,r_15_4_183,r_71_5_105,r_145_139_46,r_71_5_105,0.97,-46,59,105,18
7,r_32_116_189,seq24,r_47_12_80,r_47_12_80,1.0,109,189,80,18
44,r_39_99_166,seq24,r_19_113_56,r_19_113_56,0.93,111,167,56,18
43,r_41_70_48,r_47_12_80,seq55,r_47_12_80,0.85,-29,51,80,18
35,r_132_18_185,r_81_131_41,r_141_58_89,r_141_58_89,0.98,96,185,89,18
13,r_7_73_59,seq63,r_91_44_30,r_7_73_59,0.52,0,59,59,18
12,r_2_20_110,seq56,r_108_105_101,r_2_20_110,0.83,9,119,110,18
30,r_111_57_156,r_79_91_188,seq146,r_111_57_156,0.56,4,160,156,19
36,r_55_114_153,seq144,r_139_49_14,r_55_114_153,0.73,1,154,153,19
43,r_65_132_190,seq24,r_93_123_120,r_93_123_120,1.0,70,190,120,19
4,r_11_148_10,r_143_44_97,seq126,r_11_148_10,0.72,0,10,10,19
37,r_109_85_152,seq120,r_104_37_37,r_109_85_152,0.83,0,152,152,19
21,r_147_62_73,seq144,r_139_49_14,r_147_62_73,1.0,1,74,73,19
5,r_93_123_120,seq126,seq102,r_93_123_120,1.0,0,120,120,19
99,seq126,seq25,r_11_148_10,r_11_148_10,0.52,37,47,10,19
14,r_138_145_41,r_58_42_84,r_3_40_22,r_3_40_22,0.87,19,41,22,19
19,r_16_119_140,r_79_91_188,r_3_40_22,r_79_91_188,0.81,-48,140,188,19
31,r_131_18_161,r_66_13_31,r_111_57_156,r_66_13_31,0.63,131,162,31,19
10,r_31_86_180,r_143_44_97,r_3_40_22,r_143_44_97,0.46,83,180,97,19
11,r_50_115_158,seq83,seq39,r_50_115_158,0.56,-65,93,158,19
13,r_23_52_154,r_96_106_173,seq81,r_23_52_154,0.81,0,154,154,19
48,r_149_64_91,seq98,seq24,r_149_64_91,0.99,0,91,91,19
6,r_59_15_72,r_0_94_137,seq5,r_59_15_72,0.81,0,72,72,19
62,seq24,r_65_132_190,r_149_64_91,r_149_64_91,1.0,66,157,91,19
45,r_69_95_44,r_76_9_83,r_138_145_41,r_69_95_44,1.0,3,47,44,19
65,seq30,r_107_54_54,seq19,r_107_54_54,0.98,-1,53,54,19
18,r_8_10_69,r_89_22_79,seq53,r_89_22_79,0.96,-9,70,79,19
1,r_3_40_22,r_76_9_83,seq144,r_3_40_22,0.92,0,22,22,19
24,r_135_45_108,r_21_43_74,seq19,r_135_45_108,0.79,4,112,108,19
25,r_124_20_141,seq34,r_75_137_172,r_124_20_141,0.96,0,141,141,19
33,r_14_88_151,r_96_106_173,seq100,r_14_88_151,0.93,0,151,151,19
70,seq47,seq108,r_27_113_33,r_27_113_33,0.92,67,100,33,19
38,r_129_56_171,r_71_136_185,r_50_115_158,r_129_56_171,0.71,1,172,171,19
34,r_0_94_137,seq102,r_8_10_69,r_0_94_137,0.95,0,137,137,19
27,r_27_113_33,r_89_22_79,seq47,r_89_22_79,0.77,-43,36,79,19
17,r_134_92_128,r_71_136_185,r_147_62_73,r_134_92_128,0.98,1,129,128,19
0,r_104_37_37,r_130_133_51,r_21_43_74,r_104_37_37,1.0,0,37,37,19
40,r_107_54_54,seq47,seq125,r_107_54_54,1.0,0,54,54,19
49,r_32_63_86,seq2,r_8_10_69,r_32_63_86,1.0,0,86,86,19
7,r_46_127_35,seq90,seq6,r_46_127_35,1.0,2,37,35,19
44,r_82_38_146,r_71_136_185,r_23_52_154,r_23_52_154,0.77,4,158,154,19
35,r_58_42_84,r_124_20_141,r_3_40_22,r_58_42_84,1.0,0,84,84,19
12,r_89_22_79,r_79_91_188,r_46_127_35,r_89_22_79,0.76,0,79,79,19
23,r_142_12_11,r_104_37_37,seq120,r_142_12_11,0.9,0,11,11,19
30,r_18_39_81,r_22_56_194,seq148,r_18_39_81,0.93,0,81,81,20
50,seq128,seq102,r_41_13_158,r_41_13_158,0.81,-1,157,158,20
83,seq78,r_25_101_86,seq40,r_25_101_86,1.0,0,86,86,20
37,r_72_116_58,r_94_121_144,r_91_51_55,r_94_121_144,0.53,-84,60,144,20
36,r_9_149_11,seq23,r_114_44_128,r_9_149_11,0.96,0,11,11,20
16,r_126_135_95,seq45,r_137_43_139,r_126_135_95,1.0,2,97,95,20
21,r_80_132_70,r_86_62_138,r_79_109_36,r_86_62_138,0.52,-68,70,138,20
5,r_61_19_136,seq144,r_123_15_181,r_61_19_136,0.91,0,136,136,20
69,seq35,r_33_113_166,r_21_55_96,r_21_55_96,1.0,75,171,96,20
45,r_25_101_86,seq78,seq34,r_25_101_86,1.0,0,86,86,20
19,r_69_14_107,r_1_63_168,r_25_101_86,r_69_14_107,0.51,2,109,107,20
8,r_127_42_27,r_123_15_181,seq140,r_127_42_27,0.95,0,27,27,20
44,r_24_82_37,r_91_51_55,r_146_98_22,r_24_82_37,0.98,2,39,37,20
20,r_71_122_16,r_46_83_57,seq5,r_71_122_16,0.93,1,17,16,20
22,r_36_65_34,seq124,r_1_63_168,r_36_65_34,0.89,0,34,34,20
26,r_111_103_135,r_137_43_139,r_80_132_70,r_80_132_70,0.98,72,142,70,20
4,r_33_113_166,seq35,r_66_145_171,r_33_113_166,0.48,5,171,166,20
11,r_130_4_169,r_114_44_128,seq131,r_130_4_169,0.49,2,171,169,20
15,r_91_51_55,r_20_28_161,seq45,r_91_51_55,1.0,0,55,55,20
48,r_10_58_120,r_114_44_128,seq50,r_10_58_120,0.98,1,121,120,20
27,r_67_70_127,r_114_44_128,r_126_135_95,r_67_70_127,0.8,2,129,127,20
14,r_108_129_40,r_126_135_95,seq148,r_108_129_40,0.79,2,42,40,20
22,r_36_65_34,r_1_63_168,r_91_51_55,r_36_65_34,0.35,71,105,34,20
74,seq136,r_94_121_144,r_80_132_70,r_80_132_70,0.78,52,122,70,20
29,r_30_38_113,seq92,seq2,r_30_38_113,0.99,1,114,113,20
24,r_21_55_96,seq92,seq35,r_21_55_96,1.0,0,96,96,20
32,r_93_47_89,seq128,seq81,r_93_47_89,0.83,12,101,89,20
3,r_3_120_31,r_90_74_151,seq105,r_3_120_31,0.99,0,31,31,20
2,r_147_96_24,r_3_120_31,r_71_122_16,r_3_120_31,0.83,-6,25,31,20
75,seq50,seq133,r_10_58_120,r_10_58_120,0.48,2,122,120,20
42,r_79_109_36,r_90_74_151,seq136,r_79_109_36,0.86,3,39,36,20
91,seq102,r_64_99_116,seq128,r_64_99_116,0.93,1,117,116,20
7,r_1_63_168,seq81,r_127_42_27,r_1_63_168,0.46,-1,167,168,20
23,r_107_77_174,seq5,r_130_4_169,r_107_77_174,0.66,2,176,174,20
35,r_90_74_151,seq52,r_91_51_55,r_91_51_55,0.75,99,154,55,20
12,r_41_13_158,seq92,seq128,r_41_13_158,0.91,0,158,158,20
84,seq81,r_1_63_168,r_91_51_55,r_91_51_55,0.84,115,170,55,20
38,r_46_83_57,r_106_6_195,r_146_98_22,r_46_83_57,0.93,0,57,57,20
30,r_8_145_111,r_107_142_9,seq18,r_8_145_111,0.53,7,118,111,21
20,r_60_68_34,r_106_26_186,seq138,r_60_68_34,0.92,1,35,34,21
36,r_93_98_123,seq121,seq63,r_93_98_123,0.39,26,149,123,21
5,r_114_29_55,seq137,seq146,r_114_29_55,0.98,1,56,55,21
9,r_99_44_175,r_80_0_106,r_55_37_196,r_55_37_196,0.78,-53,143,196,21
8,r_25_75_138,seq73,r_8_145_111,r_25_75_138,0.75,0,138,138,21
21,r_80_0_106,r_60_68_34,r_106_26_186,r_106_26_186,0.74,0,186,186,21
43,r_4_92_82,r_62_100_12,seq120,r_4_92_82,0.77,2,84,82,21
16,r_43_52_179,seq129,r_70_45_162,r_43_52_179,0.41,2,181,179,21
21,r_80_0_106,seq3,r_40_14_122,r_80_0_106,0.51,10,116,106,21
39,r_141_38_52,r_25_75_138,seq16,r_141_38_52,0.78,11,63,52,21
1,r_2_104_172,seq133,seq113,r_2_104_172,0.32,0,172,172,21
80,seq83,r_58_132_183,r_62_100_12,r_58_132_183,0.54,1,184,183,21
45,r_40_14_122,seq137,r_48_6_28,r_40_14_122,0.87,1,123,122,21
19,r_82_149_70,r_50_17_108,seq49,r_82_149_70,0.57,2,72,70,21
11,r_85_78_29,seq10,seq111,r_85_78_29,0.71,-7,22,29,21
73,seq56,r_116_34_73,r_141_38_52,r_141_38_52,0.82,-15,37,52,21
44,r_79_20_32,r_114_29_55,r_28_51_25,r_28_51_25,0.99,9,34,25,21
31,r_50_17_108,seq111,seq144,r_50_17_108,0.92,1,109,108,21
10,r_106_26_186,seq74,r_80_0_106,r_80_0_106,0.85,81,187,106,21
13,r_116_34_73,r_32_90_166,r_28_51_25,r_116_34_73,0.97,2,75,73,21
15,r_72_53_87,r_43_52_179,r_123_5_11,r_72_53_87,0.92,5,92,87,21
48,r_76_105_90,seq36,r_70_45_162,r_76_105_90,0.49,12,102,90,21
6,r_58_132_183,seq83,r_91_46_113,r_58_132_183,0.5,1,184,183,21
29,r_127_64_49,r_118_143_182,seq135,r_127_64_49,0.95,1,50,49,21
2,r_57_117_149,r_119_148_151,r_140_128_63,r_119_148_151,0.65,-2,149,151,21
40,r_31_33_177,seq30,r_2_104_172,r_31_33_177,0.38,4,181,177,21
24,r_27_12_99,r_66_22_168,seq113,r_66_22_168,0.86,-69,99,168,21
25,r_41_71_89,seq97,r_24_86_35,r_41_71_89,0.76,10,99,89,21
33,r_112_139_92,r_106_26_186,r_140_128_63,r_106_26_186,0.59,-94,92,186,21
88,seq144,r_93_98_123,r_50_17_108,r_50_17_108,0.97,1,109,108,21
65,seq146,r_42_21_158,r_114_29_55,r_114_29_55,1.0,109,164,55,21
68,seq135,r_32_90_166,r_127_64_49,r_127_64_49,0.51,49,98,49,21
9,r_99_44_175,r_55_37_196,r_70_45_162,r_55_37_196,0.6,-15,181,196,21
32,r_147_59_81,seq16,r_62_100_12,r_147_59_81,0.88,3,84,81,21
52,seq133,r_2_104_172,r_127_64_49,r_127_64_49,0.93,123,172,49,21
41,r_24_86_35,r_27_12_99,seq10,r_24_86_35,0.99,0,35,35,21
34,r_131_88_132,seq9,r_140_128_63,r_140_128_63,0.7,72,135,63,21
60,seq18,seq1,r_8_145_111,r_8_145_111,0.56,7,118,111,21
17,r_69_89_116,r_62_100_12,r_140_128_63,r_69_89_116,0.61,0,116,116,21
94,seq120,seq137,r_54_87_60,r_54_87_60,1.0,38,98,60,21
18,r_13_77_53,r_28_51_25,seq36,r_13_77_53,0.69,0,53,53,21
28,r_81_110_75,r_41_71_89,seq15,r_81_110_75,0.91,4,79,75,21
91,seq111,r_50_17_108,r_85_78_29,r_50_17_108,0.72,1,109,108,21
23,r_54_87_60,r_57_117_149,seq120,r_54_87_60,0.98,1,61,60,21
12,r_140_128_63,seq1,seq115,r_140_128_63,0.96,0,63,63,21
21,r_80_0_106,r_40_14_122,r_60_68_34,r_80_0_106,0.32,44,150,106,21
30,r_73_127_148,r_18_7_149,seq145,r_73_127_148,0.6,1,149,148,22
36,r_79_117_4,r_114_70_181,r_108_51_75,r_108_51_75,1.0,91,166,75,22
66,seq34,r_136_82_6,r_144_81_121,r_144_81_121,1.0,7,128,121,22
14,r_114_70_181,r_16_3_138,r_79_117_4,r_16_3_138,0.55,-73,65,138,22
8,r_16_3_138,r_114_70_181,seq13,r_16_3_138,0.75,0,138,138,22
43,r_144_81_121,r_54_85_124,seq34,r_144_81_121,0.89,2,123,121,22
39,r_50_149_88,r_1_74_92,r_110_137_89,r_1_74_92,0.94,-3,89,92,22
29,r_33_28_14,r_54_85_124,seq4,r_33_28_14,0.88,-1,13,14,22
97,seq122,r_120_97_129,seq40,r_120_97_129,1.0,0,129,129,22
5,r_54_85_124,r_144_81_121,seq90,r_144_81_121,1.0,-28,93,121,22
42,r_111_92_134,r_56_26_150,r_116_96_44,r_116_96_44,1.0,91,135,44,22
45,r_59_8_185,r_20_103_2,r_27_107_37,r_27_107_37,1.0,148,185,37,22
38,r_128_22_80,r_126_57_5,r_87_139_139,r_87_139_139,1.0,35,174,139,22
31,r_1_74_92,seq19,seq60,r_1_74_92,0.98,0,92,92,22
3,r_56_26_150,r_111_92_134,seq9,r_56_26_150,0.86,3,153,150,22
24,r_101_12_19,seq60,seq98,r_101_12_19,1.0,2,21,19,22
14,r_114_70_181,r_79_117_4,r_64_125_23,r_114_70_181,0.69,0,181,181,22
0,r_67_109_144,seq6,r_88_44_7,r_67_109_144,0.74,0,144,144,22
11,r_87_139_139,r_18_7_149,r_128_22_80,r_18_7_149,0.75,-10,139,149,22
20,r_108_51_75,r_75_2_81,seq143,r_108_51_75,0.97,0,75,75,22
13,r_99_123_103,seq45,seq94,r_99_123_103,1.0,0,103,103,22
15,r_49_23_66,seq34,seq36,r_49_23_66,0.86,1,67,66,22
17,r_66_132_38,r_30_68_93,seq91,r_66_132_38,0.67,-1,37,38,22
6,r_61_93_104,seq84,seq78,r_61_93_104,0.56,12,116,104,22
23,r_43_42_28,r_14_25_70,seq13,r_43_42_28,1.0,-1,27,28,22
99,seq143,seq115,r_108_51_75,r_108_51_75,1.0,16,91,75,22
2,r_11_5_152,r_102_105_180,r_16_3_138,r_11_5_152,0.85,1,153,152,22
10,r_116_96_44,r_87_139_139,r_66_132_38,r_116_96_44,0.95,-3,41,44,22
25,r_35_69_173,r_102_105_180,r_73_127_148,r_35_69_173,0.8,1,174,173,22
33,r_75_2_81,r_54_85_124,r_47_21_197,r_75_2_81,1.0,0,81,81,22
38,r_128_22_80,r_18_7_149,r_126_57_5,r_128_22_80,1.0,0,80,80,22
34,r_142_53_105,seq84,seq90,r_142_53_105,1.0,0,105,105,22
59,seq13,r_38_31_20,r_43_42_28,r_43_42_28,0.81,-1,27,28,22
46,r_64_125_23,r_14_25_70,seq77,r_64_125_23,1.0,0,23,23,22
18,r_71_146_53,r_17_58_154,seq29,r_71_146_53,1.0,0,53,53,22
22,r_27_107_37,r_54_85_124,seq46,r_27_107_37,1.0,0,37,37,22
49,r_89_130_142,seq10,seq122,r_89_130_142,0.95,0,142,142,22
82,seq78,r_17_58_154,r_61_93_104,r_17_58_154,0.55,-42,112,154,22
84,seq84,r_142_53_105,r_30_68_93,r_142_53_105,0.98,-22,83,105,22
14,r_81_76_84,seq36,seq130,r_81_76_84,0.92,0,84,84,23
5,r_61_96_81,r_8_23_26,seq20,r_8_23_26,0.72,0,26,26,23
8,r_72_46_60,r_78_64_139,r_30_60_12,r_72_46_60,0.84,1,61,60,23
20,r_75_149_98,r_13_59_171,r_11_18_121,r_75_149_98,0.63,26,124,98,23
37,r_144_109_151,r_126_55_75,r_32_70_94,r_126_55_75,0.89,76,151,75,23
13,r_30_60_12,r_45_54_134,r_126_55_75,r_126_55_75,0.63,-63,12,75,23
16,r_91_47_187,seq86,r_99_100_112,r_91_47_187,0.23,0,187,187,23
21,r_123_128_119,r_14_2_160,seq103,r_123_128_119,0.99,1,120,119,23
30,r_51_97_23,r_41_143_105,seq4,r_51_97_23,0.99,0,23,23,23
42,r_85_131_118,seq73,r_125_101_17,r_85_131_118,0.69,0,118,118,23
45,r_44_43_93,r_69_118_120,seq115,r_44_43_93,0.99,0,93,93,23
40,r_58_38_51,r_126_55_75,seq7,r_58_38_51,1.0,0,51,51,23
19,r_42_15_133,seq48,r_57_105_56,r_57_105_56,1.0,79,135,56,23
24,r_113_132_40,r_75_149_98,seq36,r_113_132_40,0.94,2,42,40,23
31,r_116_142_140,seq24,r_41_143_105,r_116_142_140,0.99,0,140,140,23
3,r_99_100_112,r_144_109_151,seq24,r_99_100_112,0.62,10,122,112,23
46,r_125_101_17,r_99_100_112,seq103,r_125_101_17,1.0,0,17,17,23
10,r_45_54_134,seq4,r_61_96_81,r_45_54_134,0.66,1,135,134,23
26,r_108_39_148,seq37,r_85_131_118,r_108_39_148,0.52,0,148,148,23
0,r_49_33_73,seq25,seq16,r_49_33_73,1.0,0,73,73,23
11,r_32_70_94,seq106,seq87,r_32_70_94,0.97,0,94,94,23
20,r_75_149_98,r_123_128_119,r_13_59_171,r_75_149_98,0.71,1,99,98,23
48,r_117_6_129,seq84,seq74,r_117_6_129,0.97,0,129,129,23
6,r_10_56_152,seq119,seq93,r_10_56_152,0.86,0,152,152,23
15,r_57_105_56,seq7,r_51_97_23,r_57_105_56,1.0,0,56,56,23
85,seq93,seq89,r_10_56_152,r_10_56_152,0.98,1,153,152,23
49,r_62_12_13,r_49_33_73,seq7,r_62_12_13,0.82,0,13,13,23
47,r_141_121_157,seq82,r_11_18_121,r_141_121_157,0.52,0,157,157,23
18,r_140_136_63,seq37,r_58_38_51,r_140_136_63,0.98,0,63,63,23
88,seq102,r_134_1_169,r_83_90_53,r_83_90_53,0.94,3,56,53,23
33,r_14_2_160,r_123_128_119,r_40_127_19,r_123_128_119,0.61,2,121,119,23
70,seq53,r_134_1_169,r_83_90_53,r_83_90_53,0.93,117,170,53,23
32,r_79_5_125,r_45_54_134,r_40_127_19,r_79_5_125,0.86,0,125,125,23
34,r_133_35_142,seq74,r_11_18_121,r_133_35_142,0.77,0,142,142,23
2,r_83_90_53,r_138_137_86,seq102,r_83_90_53,0.99,0,53,53,23
9,r_41_143_105,r_91_47_187,r_62_12_13,r_41_143_105,0.95,0,105,105,23
22,r_13_59_171,seq89,r_113_132_40,r_13_59_171,0.65,0,171,171,23
28,r_78_64_139,r_28_80_197,r_58_38_51,r_28_80_197,0.88,-58,139,197,23
25,r_8_23_26,r_61_96_81,r_30_60_12,r_30_60_12,1.0,14,26,12,23
7,r_112_26_101,seq130,r_21_67_41,r_112_26_101,0.99,0,101,101,23
44,r_9_104_144,seq124,seq122,r_9_104_144,0.88,0,144,144,23
23,r_138_137_86,seq139,seq86,r_138_137_86,0.78,2,88,86,23
38,r_88_135_33,seq92,seq139,r_88_135_33,0.99,0,33,33,23
79,seq84,r_117_6_129,seq16,r_117_6_129,1.0,0,129,129,23
35,r_0_34_137,r_116_142_140,r_11_18_121,r_0_34_137,0.51,1,138,137,23
5,r_61_96_81,seq20,r_126_55_75,r_61_96_81,1.0,0,81,81,23
43,r_93_25_186,seq68,r_44_72_98,r_44_72_98,1.0,91,189,98,24
22,r_112_147_51,seq32,seq144,r_112_147_51,0.99,3,54,51,24
0,r_101_99_24,r_114_58_135,seq27,r_101_99_24,0.85,3,27,24,24
54,seq11,r_114_58_135,r_5_30_52,r_5_30_52,0.98,43,95,52,24
37,r_111_49_158,seq27,seq60,r_111_49_158,0.87,1,159,158,24
59,seq145,r_66_62_145,r_63_54_143,r_63_54_143,0.98,5,148,143,24
21,r_102_136_167,seq144,r_101_99_24,r_101_99_24,0.53,141,165,24,24
5,r_40_143_183,r_14_74_66,r_88_29_19,r_14_74_66,1.0,2,68,66,24
42,r_129_87_142,r_91_69_169,seq109,r_129_87_142,0.96,3,145,142,24
80,seq71,r_52_139_151,r_44_72_98,r_44_72_98,0.63,53,151,98,24
45,r_75_7_82,r_36_126_107,r_88_29_19,r_75_7_82,0.97,1,83,82,24
39,r_130_39_26,r_85_84_131,r_141_51_88,r_130_39_26,0.48,1,27,26,24
6,r_64_90_21,r_127_48_160,seq38,r_64_90_21,0.79,0,21,21,24
39,r_130_39_26,r_141_51_88,r_16_135_45,r_130_39_26,0.93,62,88,26,24
31,r_85_84_131,r_142_86_173,r_133_106_105,r_142_86_173,0.53,-37,136,173,24
41,r_141_51_88,seq137,r_88_29_19,r_88_29_19,0.73,69,88,19,24
10,r_77_61_17,r_101_99_24,seq103,r_77_61_17,1.0,0,17,17,24
30,r_88_29_19,r_146_26_134,r_40_143_183,r_88_29_19,0.81,1,20,19,24
3,r_44_72_98,r_19_43_44,seq92,r_44_72_98,1.0,3,101,98,24
4,r_9_22_33,seq120,r_149_110_133,r_149_110_133,0.68,0,133,133,24
63,seq27,r_111_49_158,r_101_99_24,r_111_49_158,0.56,1,159,158,24
11,r_81_82_170,r_114_58_135,r_19_43_44,r_19_43_44,0.73,130,174,44,24
20,r_122_105_161,r_127_48_160,r_133_106_105,r_133_106_105,0.65,58,163,105,24
13,r_127_48_160,seq100,r_12_56_197,r_12_56_197,0.62,-33,164,197,24
15,r_52_139_151,seq71,seq15,r_52_139_151,0.91,0,151,151,24
48,r_128_24_111,r_114_58_135,r_36_126_107,r_114_58_135,0.9,-16,119,135,24
8,r_16_135_45,r_40_143_183,r_130_39_26,r_130_39_26,0.57,23,49,26,24
40,r_14_74_66,r_40_143_183,r_80_108_3,r_14_74_66,1.0,2,68,66,24
18,r_133_106_105,r_47_124_5,r_16_135_45,r_16_135_45,0.64,60,105,45,24
29,r_149_110_133,r_19_43_44,r_9_22_33,r_149_110_133,0.41,22,155,133,24
24,r_2_83_190,seq104,r_17_96_125,r_17_96_125,0.87,65,190,125,24
36,r_5_30_52,seq35,seq11,r_5_30_52,0.95,5,57,52,24
25,r_36_126_107,r_93_25_186,seq45,r_36_126_107,0.82,1,108,107,24
33,r_91_69_169,seq148,r_57_59_20,r_57_59_20,0.72,152,172,20,24
32,r_138_116_138,seq117,r_101_99_24,r_138_116_138,0.61,1,139,138,24
34,r_66_62_145,seq145,r_19_43_44,r_66_62_145,0.51,3,148,145,24
17,r_10_97_163,r_81_82_170,r_111_49_158,r_10_97_163,0.76,0,163,163,24
9,r_19_43_44,r_149_110_133,r_98_73_62,r_19_43_44,0.55,111,155,44,24
12,r_63_54_143,seq20,seq145,r_63_54_143,0.91,0,143,143,24
30,r_118_146_114,seq14,r_68_52_47,r_118_146_114,0.98,0,114,114,25
36,r_78_63_156,r_80_32_74,r_125_120_173,r_80_32_74,1.0,-1,73,74,25
6,r_107_79_32,r_81_34_97,seq7,r_107_79_32,1.0,0,32,32,25
16,r_123_139_14,r_42_100_158,seq96,r_123_139_14,0.99,0,14,14,25
14,r_21_2_85,seq55,seq6,r_21_2_85,1.0,1,86,85,25
43,r_44_129_116,r_66_93_154,r_104_36_51,r_66_93_154,1.0,-38,116,154,25
21,r_25_30_186,seq7,r_62_92_89,r_62_92_89,0.77,97,186,89,25
97,seq122,r_134_9_157,r_4_31_37,r_4_31_37,0.98,127,164,37,25
5,r_50_116_91,r_16_124_88,seq14,r_50_116_91,0.83,0,91,91,25
46,r_26_142_103,r_125_120_173,r_119_91_198,r_26_142_103,0.75,1,104,103,25
42,r_111_145_133,r_136_37_9,seq33,r_136_37_9,0.56,128,137,9,25
31,r_11_38_75,r_106_95_87,r_4_31_37,r_11_38_75,0.78,0,75,75,25
3,r_134_9_157,seq122,r_24_22_107,r_24_22_107,0.76,57,164,107,25
10,r_29_71_63,seq45,seq14,r_29_71_63,0.8,3,66,63,25
45,r_110_76_16,r_118_146_114,seq122,r_110_76_16,1.0,0,16,16,25
26,r_80_32_74,r_78_63_156,r_105_86_27,r_80_32_74,1.0,-1,73,74,25
27,r_137_53_38,r_94_133_139,seq3,r_137_53_38,0.83,14,52,38,25
33,r_68_52_47,r_42_100_158,r_104_36_51,r_68_52_47,1.0,1,48,47,25
0,r_5_128_77,seq6,seq55,r_5_128_77,0.99,0,77,77,25
73,seq56,seq23,r_24_22_107,r_24_22_107,0.98,1,108,107,25
20,r_27_57_96,r_66_93_154,seq96,r_27_57_96,0.68,6,102,96,25
48,r_41_103_119,r_42_100_158,r_4_31_37,r_41_103_119,0.72,10,129,119,25
57,seq14,r_118_146_114,seq15,r_118_146_114,1.0,0,114,114,25
19,r_104_36_51,r_5_128_77,r_68_52_47,r_104_36_51,1.0,3,54,51,25
36,r_78_63_156,r_125_120_173,r_119_91_198,r_78_63_156,0.99,0,156,156,25
29,r_115_149_19,r_1_132_105,seq17,r_115_149_19,1.0,-1,18,19,25
47,r_83_144_66,seq64,seq39,r_83_144_66,1.0,1,67,66,25
60,seq18,r_140_82_35,r_137_53_38,r_140_82_35,1.0,0,35,35,25
40,r_24_22_107,seq35,seq56,r_24_22_107,0.98,1,108,107,25
18,r_62_92_89,seq23,seq20,r_62_92_89,1.0,0,89,89,25
1,r_40_8_23,r_5_128_77,seq77,r_40_8_23,0.96,-1,22,23,25
25,r_106_95_87,seq70,seq131,r_106_95_87,1.0,0,87,87,25
13,r_51_54_50,seq15,seq48,r_51_54_50,1.0,0,50,50,25
50,seq0,r_72_59_101,seq64,r_72_59_101,1.0,-1,100,101,25
70,seq48,r_125_120_173,r_51_54_50,r_51_54_50,1.0,14,64,50,25
38,r_43_47_121,seq33,r_62_92_89,r_62_92_89,0.98,40,129,89,25
41,r_130_75_34,seq109,seq70,r_130_75_34,0.98,1,35,34,25
17,r_42_100_158,r_112_13_159,r_29_71_63,r_29_71_63,0.9,95,158,63,25
9,r_16_124_88,r_50_116_91,r_107_79_32,r_16_124_88,0.5,3,91,88,25
22,r_148_60_113,seq97,r_21_2_85,r_21_2_85,1.0,32,117,85,25
28,r_90_88_147,r_42_100_158,r_21_2_85,r_42_100_158,0.47,-11,147,158,25
49,r_94_133_139,seq7,r_27_57_96,r_94_133_139,0.54,2,141,139,25
7,r_1_132_105,r_125_120_173,seq28,r_1_132_105,0.9,5,110,105,25
23,r_125_120_173,seq48,r_134_9_157,r_125_120_173,0.56,2,175,173,25
12,r_72_59_101,seq0,r_102_10_15,r_72_59_101,0.98,0,101,101,25
4,r_4_31_37,r_137_53_38,r_110_76_16,r_4_31_37,0.89,0,37,37,25
36,r_110_67_127,r_105_14_199,r_35_149_103,r_110_67_127,0.87,6,133,127,26
13,r_138_74_131,r_17_120_65,seq111,r_138_74_131,0.88,0,131,131,26
14,r_20_85_70,seq77,r_53_81_156,r_20_85_70,0.88,5,75,70,26
37,r_38_61_146,seq93,r_130_79_118,r_38_61_146,0.79,0,146,146,26
49,r_31_98_144,r_97_12_149,r_29_60_39,r_29_60_39,1.0,-1,38,39,26
1,r_139_71_93,r_72_127_88,r_10_11_13,r_139_71_93,0.84,4,97,93,26
97,seq123,seq45,r_70_142_98,r_70_142_98,0.98,1,99,98,26
46,r_53_81_156,r_8_101_159,r_20_85_70,r_20_85_70,0.96,10,80,70,26
42,r_23_25_169,seq57,r_138_74_131,r_23_25_169,0.39,1,170,169,26
7,r_17_120_65,r_138_74_131,seq122,r_138_74_131,0.94,8,139,131,26
31,r_34_44_115,seq137,r_20_85_70,r_34_44_115,0.88,0,115,115,26
41,r_88_108_79,seq15,seq48,r_88_108_79,0.85,1,80,79,26
3,r_63_2_168,seq45,r_126_37_133,r_63_2_168,0.61,0,168,168,26
17,r_131_107_196,seq42,r_116_133_40,r_116_133_40,0.65,0,40,40,26
26,r_36_148_90,r_16_92_1,seq91,r_36_148_90,0.82,3,93,90,26
14,r_20_85_70,r_53_81_156,r_138_74_131,r_53_81_156,0.66,1,157,156,26
4,r_126_37_133,r_53_81_156,r_80_144_15,r_53_81_156,0.79,-23,133,156,26
0,r_102_39_83,seq106,seq104,r_102_39_83,0.82,1,84,83,26
11,r_145_140_113,r_114_24_173,seq46,r_145_140_113,0.73,26,139,113,26
7,r_17_120_65,seq122,r_32_96_166,r_32_96_166,0.89,0,166,166,26
20,r_97_12_149,seq30,seq76,r_97_12_149,0.96,0,149,149,26
13,r_138_74_131,r_72_127_88,r_17_120_65,r_17_120_65,0.88,26,91,65,26
46,r_53_81_156,r_20_85_70,r_29_60_39,r_53_81_156,0.95,1,157,156,26
6,r_114_24_173,r_10_11_13,r_63_2_168,r_114_24_173,0.41,4,177,173,26
45,r_29_60_39,r_114_24_173,seq30,r_29_60_39,1.0,1,40,39,26
99,seq125,r_131_107_196,seq146,r_131_107_196,0.72,-116,80,196,26
8,r_119_66_44,r_128_59_175,r_27_55_198,r_119_66_44,0.9,5,49,44,26
18,r_115_6_158,r_16_92_1,seq146,r_16_92_1,0.59,158,159,1,26
29,r_95_141_97,seq91,seq41,r_95_141_97,0.66,0,97,97,26
5,r_80_144_15,r_102_39_83,seq75,r_80_144_15,0.88,-5,10,15,26
33,r_28_134_95,r_53_81_156,seq78,r_28_134_95,0.57,2,97,95,26
64,seq135,r_35_149_103,r_18_143_64,r_18_143_64,0.96,12,76,64,26
39,r_82_86_54,r_28_134_95,r_16_92_1,r_16_92_1,0.89,56,57,1,26
61,seq30,r_97_12_149,r_68_109_87,r_68_109_87,0.85,21,108,87,26
32,r_84_147_142,r_16_92_1,r_88_108_79,r_16_92_1,0.62,141,142,1,26
38,r_10_11_13,r_114_24_173,r_139_71_93,r_139_71_93,0.69,84,177,93,26
34,r_32_96_166,r_26_19_172,r_17_120_65,r_26_19_172,0.44,-4,168,172,26
9,r_72_127_88,r_139_71_93,r_27_55_198,r_72_127_88,0.76,-2,86,88,26
48,r_116_133_40,r_27_55_198,r_131_107_196,r_116_133_40,0.71,3,43,40,26
22,r_35_149_103,seq135,r_28_134_95,r_28_134_95,0.96,45,140,95,26
28,r_58_21_61,r_51_117_192,r_119_66_44,r_58_21_61,0.99,0,61,61,26
7,r_17_120_65,r_35_149_103,r_138_74_131,r_17_120_65,0.9,4,69,65,26
44,r_113_62_81,r_16_92_1,seq136,r_113_62_81,0.85,3,84,81,26
35,r_68_109_87,r_16_92_1,seq30,r_68_109_87,1.0,1,88,87,26
84,seq91,r_95_141_97,r_36_148_90,r_36_148_90,0.77,7,97,90,26
14,r_0_5_123,r_82_96_145,r_9_80_120,r_0_5_123,0.8,3,126,123,27
16,r_78_33_186,seq54,r_65_37_50,r_65_37_50,1.0,136,186,50,27
21,r_114_132_83,r_142_146_181,seq25,r_114_132_83,0.99,0,83,83,27
28,r_13_29_124,r_78_33_186,r_104_36_150,r_104_36_150,0.75,3,153,150,27
42,r_82_96_145,seq59,seq88,r_82_96_145,0.9,0,145,145,27
45,r_31_111_79,r_99_120_151,r_139_109_26,r_31_111_79,0.99,1,80,79,27
27,r_81_21_27,r_104_36_150,seq69,r_81_21_27,0.96,0,27,27,27
95,seq112,r_117_3_153,r_108_72_62,r_108_72_62,0.97,91,153,62,27
13,r_139_109_26,seq10,r_104_36_150,r_139_109_26,0.99,0,26,26,27
41,r_116_34_78,r_117_3_153,r_60_147_66,r_116_34_78,1.0,0,78,78,27
48,r_91_124_17,r_148_87_51,seq47,r_91_124_17,0.98,0,17,17,27
4,r_66_137_127,seq98,seq75,r_66_137_127,0.69,0,127,127,27
78,seq59,r_82_96_145,r_119_95_34,r_82_96_145,1.0,0,145,145,27
0,r_30_8_98,seq25,seq133,r_30_8_98,0.91,0,98,98,27
20,r_108_72_62,seq129,seq35,r_108_72_62,1.0,1,63,62,27
67,seq145,r_62_143_5,r_32_131_37,r_32_131_37,1.0,7,44,37,27
98,seq121,r_19_127_77,r_144_77_177,r_19_127_77,0.95,3,80,77,27
13,r_139_109_26,r_104_36_150,r_31_111_79,r_31_111_79,0.86,72,151,79,27
6,r_11_15_129,r_78_33_186,r_62_143_5,r_11_15_129,0.7,3,132,129,27
11,r_43_125_46,seq2,r_134_102_196,r_43_125_46,1.0,3,49,46,27
1,r_65_37_50,r_60_147_66,seq101,r_65_37_50,1.0,3,53,50,27
87,seq88,r_14_84_184,r_82_96_145,r_82_96_145,0.88,40,185,145,27
26,r_40_52_10,r_90_58_188,seq45,r_40_52_10,0.77,5,15,10,27
47,r_60_147_66,r_78_33_186,seq45,r_60_147_66,0.94,1,67,66,27
40,r_104_36_150,r_46_63_175,r_13_29_124,r_104_36_150,0.74,0,150,150,27
18,r_142_146_181,seq67,r_66_137_127,r_142_146_181,0.55,-3,178,181,27
29,r_39_138_147,r_62_143_5,r_81_21_27,r_39_138_147,0.68,2,149,147,27
24,r_9_80_120,r_148_87_51,r_0_5_123,r_9_80_120,0.73,1,121,120,27
8,r_49_130_12,r_14_84_184,seq98,r_49_130_12,0.9,-2,10,12,27
25,r_94_123_117,r_66_137_127,seq54,r_94_123_117,0.73,0,117,117,27
64,seq35,r_117_3_153,r_108_72_62,r_108_72_62,0.84,21,83,62,27
2,r_64_149_22,r_78_33_186,r_140_73_191,r_64_149_22,0.99,0,22,22,27
61,seq26,r_41_106_143,seq17,r_41_106_143,0.97,-19,124,143,27
32,r_51_141_101,r_14_84_184,r_91_124_17,r_51_141_101,1.0,0,101,101,27
38,r_12_70_170,seq57,seq121,r_12_70_170,0.29,1,171,170,27
34,r_19_127_77,r_16_18_113,seq50,r_19_127_77,0.96,0,77,77,27
75,seq54,r_78_33_186,r_94_123_117,r_94_123_117,0.76,69,186,117,27
5,r_32_131_37,seq71,seq145,r_32_131_37,0.95,1,38,37,27
9,r_42_23_80,seq27,seq44,r_42_23_80,0.98,0,80,80,27
7,r_107_85_11,r_62_143_5,seq53,r_107_85_11,0.94,-1,10,11,27
22,r_14_84_184,seq88,r_62_143_5,r_14_84_184,0.34,1,185,184,27
28,r_13_29_124,seq4,r_78_33_186,r_13_29_124,0.53,3,127,124,27
49,r_16_18_113,r_19_127_77,seq145,r_19_127_77,0.81,3,80,77,27
44,r_46_63_175,r_104_36_150,r_30_8_98,r_30_8_98,0.54,52,150,98,27
23,r_61_110_164,seq7,seq112,r_61_110_164,0.74,2,166,164,27
35,r_56_105_106,seq50,r_32_131_37,r_56_105_106,0.92,1,107,106,27
8,r_118_8_156,seq67,r_26_138_132,r_26_138_132,0.72,27,159,132,28
43,r_139_126_72,seq2,seq93,r_139_126_72,0.49,0,72,72,28
37,r_38_65_110,r_132_92_149,seq49,r_132_92_149,0.81,-44,105,149,28
48,r_112_51_19,r_23_114_62,seq16,r_112_51_19,1.0,1,20,19,28
86,seq88,r_54_0_106,r_24_97_102,r_54_0_106,0.64,-5,101,106,28
16,r_59_96_101,r_21_133_197,r_112_51_19,r_59_96_101,0.59,-4,97,101,28
7,r_80_144_17,r_6_46_153,r_63_64_67,r_80_144_17,0.83,52,69,17,28
5,r_60_81_86,seq108,r_45_149_129,r_60_81_86,0.98,0,86,86,28
46,r_44_17_138,seq83,r_62_127_21,r_44_17_138,0.85,4,142,138,28
21,r_13_75_23,seq131,r_98_105_22,r_13_75_23,0.7,8,31,23,28
39,r_116_130_50,seq16,r_147_82_94,r_147_82_94,1.0,15,109,94,28
45,r_122_111_142,seq16,r_72_4_108,r_72_4_108,0.91,-1,107,108,28
19,r_55_141_150,seq103,r_42_107_81,r_42_107_81,0.78,69,150,81,28
90,seq94,seq101,r_36_18_104,r_36_18_104,0.57,-59,45,104,28
41,r_124_30_135,r_76_79_134,r_62_127_21,r_124_30_135,0.51,0,135,135,28
3,r_26_138_132,seq15,seq3,r_26_138_132,0.51,0,132,132,28
10,r_86_142_154,r_71_66_160,seq49,r_71_66_160,0.77,-2,158,160,28
26,r_23_114_62,seq137,seq47,r_23_114_62,0.99,0,62,62,28
14,r_12_90_26,r_45_149_129,seq137,r_12_90_26,1.0,-2,24,26,28
0,r_115_50_93,r_54_0_106,seq83,r_115_50_93,0.56,1,94,93,28
11,r_106_109_117,r_6_46_153,r_38_65_110,r_6_46_153,1.0,-28,125,153,28
20,r_36_18_104,r_72_4_108,r_59_96_101,r_59_96_101,0.78,4,105,101,28
15,r_7_19_121,seq35,r_54_0_106,r_54_0_106,0.66,26,132,106,28
6,r_20_31_100,seq47,seq67,r_20_31_100,0.99,0,100,100,28
17,r_89_68_47,r_13_75_23,seq128,r_89_68_47,0.99,0,47,47,28
18,r_132_92_149,seq1,r_62_127_21,r_132_92_149,0.63,1,150,149,28
24,r_63_64_67,r_115_50_93,r_80_144_17,r_80_144_17,0.71,48,65,17,28
33,r_100_125_97,seq135,seq128,r_100_125_97,0.98,0,97,97,28
48,r_112_51_19,seq16,r_59_96_101,r_112_51_19,0.47,93,112,19,28
17,r_89_68_47,r_12_90_26,r_13_75_23,r_89_68_47,0.64,-29,18,47,28
88,seq135,r_100_125_97,r_13_75_23,r_100_125_97,0.9,0,97,97,28
2,r_62_127_21,r_115_50_93,r_45_149_129,r_62_127_21,0.98,-1,20,21,28
7,r_80_144_17,seq78,r_6_46_153,r_80_144_17,0.91,0,17,17,28
32,r_117_99_162,r_76_79_134,seq94,r_76_79_134,0.66,31,165,134,28
38,r_147_82_94,seq58,r_116_130_50,r_147_82_94,0.69,0,94,94,28
39,r_116_130_50,r_36_18_104,seq16,r_116_130_50,1.0,1,51,50,28
4,r_48_136_56,seq56,seq35,r_48_136_56,0.9,1,57,56,28
60,seq16,r_122_111_142,r_36_18_104,r_36_18_104,0.95,3,107,104,28
94,seq103,r_55_141_150,r_23_114_62,r_23_114_62,0.85,88,150,62,28
9,r_148_34_69,r_134_10_145,seq3,r_148_34_69,0.79,0,69,69,28
23,r_113_25_60,seq108,seq14,r_113_25_60,1.0,-1,59,60,28
22,r_41_39_175,seq47,seq43,r_41_39_175,0.46,1,176,175,28
49,r_146_145_140,r_55_141_150,r_98_105_22,r_146_145_140,0.76,0,140,140,28
90,seq94,r_36_18_104,seq101,r_36_18_104,1.0,-3,101,104,28
36,r_70_38_99,r_131_108_179,seq138,r_70_38_99,1.0,0,99,99,29
8,r_18_2_87,r_114_91_196,r_97_76_72,r_114_91_196,1.0,-109,87,196,29
16,r_19_120_182,seq104,r_59_9_143,r_59_9_143,0.89,37,180,143,29
21,r_89_126_97,seq24,r_90_42_60,r_89_126_97,0.67,4,101,97,29
42,r_107_22_153,r_86_15_145,r_39_101_62,r_107_22_153,0.82,-7,146,153,29
9,r_147_129_56,r_106_36_88,r_81_85_52,r_106_36_88,1.0,-32,56,88,29
19,r_115_48_129,r_114_91_196,r_6_41_104,r_114_91_196,1.0,-67,129,196,29
31,r_59_9_143,seq0,seq61,r_59_9_143,0.95,0,143,143,29
41,r_7_146_123,seq63,r_18_2_87,r_18_2_87,1.0,54,141,87,29
3,r_57_123_115,r_86_15_145,r_114_91_196,r_86_15_145,1.0,-29,116,145,29
30,r_77_130_21,r_57_123_115,seq113,r_77_130_21,0.81,-2,19,21,29
0,r_118_95_138,r_46_124_184,seq67,r_118_95_138,0.99,0,138,138,29
20,r_86_15_145,r_107_22_153,r_18_2_87,r_107_22_153,0.6,-7,146,153,29
13,r_50_88_172,r_82_68_194,r_34_109_132,r_34_109_132,1.0,40,172,132,29
15,r_111_49_84,r_114_91_196,r_29_55_22,r_111_49_84,0.95,0,84,84,29
57,seq138,r_21_79_180,r_70_38_99,r_70_38_99,1.0,1,100,99,29
6,r_52_14_100,seq11,seq61,r_52_14_100,1.0,0,100,100,29
99,seq122,seq16,r_89_126_97,r_89_126_97,1.0,30,127,97,29
27,r_21_79_180,seq135,r_131_108_179,r_21_79_180,0.47,0,180,180,29
2,r_34_109_132,r_50_88_172,r_111_49_84,r_50_88_172,0.98,-39,133,172,29
47,r_125_142_98,seq113,seq16,r_125_142_98,0.96,0,98,98,29
14,r_105_94_46,r_60_74_156,seq24,r_105_94_46,1.0,1,47,46,29
18,r_106_36_88,r_29_55_22,seq5,r_106_36_88,1.0,1,89,88,29
35,r_39_101_62,r_19_120_182,r_107_22_153,r_39_101_62,0.58,99,161,62,29
25,r_127_47_160,seq13,r_147_129_56,r_147_129_56,1.0,104,160,56,29
4,r_30_58_30,r_125_142_98,r_141_136_8,r_141_136_8,0.99,23,31,8,29
70,seq31,r_131_108_179,r_34_109_132,r_34_109_132,0.63,47,179,132,29
32,r_10_65_170,seq132,r_137_128_41,r_137_128_41,1.0,136,177,41,29
34,r_60_74_156,seq71,r_52_14_100,r_52_14_100,1.0,58,158,100,29
43,r_102_54_59,r_43_37_126,seq135,r_102_54_59,0.98,0,59,59,29
75,seq61,r_50_88_172,r_52_14_100,r_52_14_100,0.99,60,160,100,29
17,r_137_128_41,r_114_91_196,seq138,r_137_128_41,0.72,37,78,41,29
1,r_141_136_8,r_147_129_56,r_93_4_23,r_141_136_8,1.0,15,23,8,29
28,r_90_42_60,seq98,seq122,r_90_42_60,1.0,0,60,60,29
49,r_133_56_166,seq16,r_106_36_88,r_106_36_88,1.0,78,166,88,29
7,r_64_20_95,seq1,r_3_35_148,r_64_20_95,1.0,0,95,95,29
11,r_81_85_52,seq122,seq75,r_81_85_52,0.98,0,52,52,29
23,r_97_76_72,r_57_123_115,r_93_4_23,r_57_123_115,0.71,-43,72,115,29
22,r_93_4_23,r_114_91_196,r_141_136_8,r_93_4_23,0.99,0,23,23,29
35,r_39_101_62,seq32,r_19_120_182,r_39_101_62,1.0,0,62,62,29
12,r_6_41_104,seq145,seq100,r_6_41_104,0.99,0,104,104,29
30,r_79_134_161,seq145,r_86_148_156,r_86_148_156,0.7,7,163,156,30
8,r_66_70_129,seq137,r_83_30_80,r_66_70_129,0.58,3,132,129,30
43,r_35_17_171,seq26,r_59_107_139,r_59_107_139,0.98,36,175,139,30
1,r_10_14_42,r_144_18_116,seq137,r_10_14_42,0.84,0,42,42,30
16,r_91_27_141,seq133,r_144_18_116,r_144_18_116,1.0,37,153,116,30
21,r_88_96_101,r_34_84_117,r_128_73_18,r_88_96_101,0.65,4,105,101,30
39,r_32_60_140,r_141_130_146,seq40,r_141_130_146,1.0,0,146,146,30
5,r_82_8_62,seq51,seq137,r_82_8_62,0.81,2,64,62,30
46,r_105_52_110,seq3,r_0_65_33,r_105_52_110,0.8,1,111,110,30
11,r_0_65_33,r_141_130_146,seq129,r_0_65_33,0.89,0,33,33,30
80,seq75,r_34_84_117,r_121_119_174,r_34_84_117,0.83,23,140,117,30
45,r_115_101_85,r_86_148_156,r_138_20_185,r_115_101_85,1.0,1,86,85,30
19,r_67_139_147,seq72,r_80_106_197,r_67_139_147,0.67,0,147,147,30
15,r_5_23_51,r_86_148_156,r_2_39_145,r_5_23_51,1.0,0,51,51,30
26,r_33_12_73,seq3,seq54,r_33_12_73,1.0,0,73,73,30
0,r_141_130_146,r_108_149_162,r_43_62_44,r_108_149_162,0.74,-16,146,162,30
37,r_146_31_30,r_141_130_146,seq36,r_146_31_30,0.6,4,34,30,30
20,r_24_126_112,r_143_42_136,r_44_78_72,r_24_126_112,0.7,26,138,112,30
13,r_93_76_63,r_59_107_139,seq110,r_93_76_63,0.71,0,63,63,30
27,r_108_149_162,r_2_39_145,r_97_103_131,r_2_39_145,0.79,20,165,145,30
2,r_143_42_136,r_24_126_112,r_5_23_51,r_5_23_51,1.0,87,138,51,30
47,r_6_122_104,seq102,r_93_76_63,r_6_122_104,0.9,2,106,104,30
40,r_144_18_116,seq110,r_7_53_77,r_144_18_116,0.94,0,116,116,30
18,r_128_73_18,r_97_103_131,r_88_96_101,r_97_103_131,0.75,-38,93,131,30
29,r_45_48_155,seq54,r_80_106_197,r_45_48_155,0.69,1,156,155,30
24,r_7_53_77,r_79_134_161,seq15,r_7_53_77,0.72,5,82,77,30
34,r_86_148_156,seq116,seq16,r_86_148_156,0.98,0,156,156,30
25,r_13_142_53,r_91_27_141,seq38,r_13_142_53,0.66,15,68,53,30
34,r_86_148_156,r_5_23_51,seq116,r_5_23_51,0.99,0,51,51,30
33,r_61_81_66,r_33_12_73,seq133,r_61_81_66,0.57,4,70,66,30
3,r_136_117_15,r_59_107_139,seq71,r_136_117_15,0.98,0,15,15,30
38,r_34_84_117,seq75,r_83_30_80,r_34_84_117,0.75,11,128,117,30
28,r_43_62_44,r_97_103_131,seq116,r_43_62_44,0.97,1,45,44,30
31,r_41_125_47,r_115_101_85,r_121_119_174,r_41_125_47,1.0,0,47,47,30
17,r_140_69_181,seq75,r_97_103_131,r_97_103_131,0.77,50,181,131,30
9,r_59_107_139,seq129,r_128_73_18,r_59_107_139,0.9,0,139,139,30
96,seq116,r_86_148_156,r_141_130_146,r_86_148_156,0.41,-3,153,156,30
28,r_43_62_44,seq116,r_141_130_146,r_141_130_146,0.98,1,147,146,30
22,r_83_30_80,seq15,seq133,r_83_30_80,0.71,2,82,80,30
44,r_132_87_65,seq19,seq63,r_132_87_65,1.0,2,67,65,30
23,r_49_46_97,r_97_103_131,r_121_119_174,r_97_103_131,0.93,-24,107,131,30
35,r_112_25_163,seq110,r_143_42_136,r_112_25_163,0.57,2,165,163,30
36,r_65_31_170,seq5,r_73_27_26,r_65_31_170,0.52,4,174,170,31
92,seq104,r_12_67_119,r_135_16_55,r_135_16_55,0.87,15,70,55,31
14,r_46_115_68,seq148,r_29_130_58,r_46_115_68,0.52,1,69,68,31
8,r_50_32_178,seq60,r_108_55_156,r_108_55_156,0.8,24,180,156,31
54,seq4,r_12_67_119,r_135_16_55,r_135_16_55,0.91,66,121,55,31
21,r_149_38_65,r_99_126_70,seq0,r_99_126_70,0.93,-5,65,70,31
1,r_91_6_140,r_61_72_149,r_98_36_107,r_98_36_107,0.8,33,140,107,31
5,r_10_123_120,seq3,seq43,r_10_123_120,0.81,0,120,120,31
46,r_69_114_150,r_37_145_175,seq139,r_69_114_150,0.49,2,152,150,31
73,seq43,r_22_81_113,r_10_123_120,r_10_123_120,0.87,-2,118,120,31
45,r_23_62_146,seq141,r_135_16_55,r_135_16_55,1.0,93,148,55,31
31,r_29_130_58,seq44,r_131_103_103,r_131_103_103,0.58,4,107,103,31
26,r_53_20_89,r_108_55_156,seq19,r_53_20_89,0.81,3,92,89,31
0,r_98_36_107,seq35,r_113_94_37,r_98_36_107,1.0,0,107,107,31
73,seq43,r_51_24_83,r_22_81_113,r_51_24_83,0.95,1,84,83,31
11,r_133_107_86,r_76_127_168,r_33_45_8,r_133_107_86,1.0,0,86,86,31
6,r_58_140_67,r_51_24_83,r_116_77_138,r_116_77_138,0.88,-69,69,138,31
62,seq143,r_102_142_101,r_58_140_67,r_58_140_67,0.97,52,119,67,31
48,r_73_27_26,r_137_86_139,seq56,r_73_27_26,0.71,11,37,26,31
27,r_138_26_63,seq44,seq146,r_138_26_63,0.97,0,63,63,31
2,r_129_59_184,seq18,r_10_123_120,r_129_59_184,0.59,0,184,184,31
40,r_108_55_156,seq56,seq19,r_108_55_156,0.61,2,158,156,31
18,r_37_145_175,seq13,r_51_24_83,r_51_24_83,0.75,94,177,83,31
29,r_25_1_128,seq141,seq8,r_25_1_128,0.89,0,128,128,31
24,r_131_103_103,r_105_79_180,r_29_130_58,r_131_103_103,0.95,2,105,103,31
25,r_51_24_83,seq43,seq96,r_51_24_83,0.92,1,84,83,31
16,r_21_57_47,seq74,r_22_81_113,r_21_57_47,0.98,1,48,47,31
6,r_58_140_67,r_116_77_138,r_28_85_135,r_58_140_67,0.98,72,139,67,31
34,r_95_54_174,r_50_32_178,r_68_78_114,r_50_32_178,0.68,-4,174,178,31
60,seq13,r_37_145_175,seq80,r_37_145_175,0.92,2,177,175,31
17,r_102_142_101,seq143,r_135_16_55,r_135_16_55,0.97,52,107,55,31
9,r_101_124_88,r_22_81_113,seq89,r_101_124_88,0.84,4,92,88,31
47,r_15_121_21,r_58_140_67,seq18,r_15_121_21,1.0,0,21,21,31
13,r_22_81_113,r_101_124_88,r_21_57_47,r_22_81_113,0.96,-64,49,113,31
49,r_137_86_139,r_76_127_168,seq34,r_137_86_139,0.75,0,139,139,31
7,r_47_52_151,r_50_32_178,r_92_90_45,r_47_52_151,0.79,1,152,151,31
44,r_12_67_119,seq4,seq134,r_12_67_119,0.63,2,121,119,31
23,r_122_100_161,seq109,r_61_72_149,r_122_100_161,0.67,2,163,161,31
35,r_99_126_70,seq19,seq35,r_99_126_70,1.0,0,70,70,31
12,r_68_78_114,r_122_100_161,seq74,r_68_78_114,0.8,5,119,114,31
24,r_13_122_35,r_52_105_136,r_85_46_75,r_13_122_35,0.48,1,36,35,32
40,r_52_105_136,seq83,r_10_38_134,r_52_105_136,0.45,1,137,136,32
51,seq2,r_65_132_139,r_10_38_134,r_10_38_134,0.49,15,149,134,32
36,r_115_9_105,r_129_11_58,seq102,r_115_9_105,0.98,1,106,105,32
8,r_31_40_61,r_48_47_77,r_71_32_41,r_31_40_61,0.99,1,62,61,32
43,r_48_47_77,seq5,seq56,r_48_47_77,0.97,1,78,77,32
16,r_71_32_41,r_15_140_40,seq123,r_71_32_41,1.0,0,41,41,32
21,r_29_19_169,seq21,r_116_127_33,r_116_127_33,1.0,62,95,33,32
42,r_98_95_185,r_134_8_172,r_82_33_53,r_82_33_53,1.0,49,102,53,32
1,r_10_38_134,r_116_127_33,r_13_122_35,r_10_38_134,1.0,-98,36,134,32
48,r_15_140_40,r_71_32_41,r_134_8_172,r_15_140_40,1.0,1,41,40,32
19,r_58_17_80,r_134_8_172,seq107,r_58_17_80,1.0,2,82,80,32
3,r_68_70_177,seq100,r_6_14_154,r_6_14_154,0.83,23,177,154,32
5,r_116_127_33,r_10_38_134,seq21,r_116_127_33,1.0,0,33,33,32
26,r_59_39_111,r_131_146_193,r_115_9_105,r_131_146_193,0.86,-82,111,193,32
4,r_90_148_120,r_131_146_193,r_57_141_11,r_90_148_120,0.95,0,120,120,32
0,r_6_14_154,seq108,r_90_148_120,r_6_14_154,0.87,0,154,154,32
11,r_12_126_97,r_92_139_22,r_142_35_10,r_12_126_97,0.83,0,97,97,32
20,r_28_136_87,seq112,seq18,r_28_136_87,1.0,0,87,87,32
40,r_52_105_136,r_13_122_35,seq83,r_13_122_35,0.87,1,36,35,32
6,r_64_93_133,seq113,r_135_69_34,r_64_93_133,0.87,1,134,133,32
14,r_57_141_11,r_0_91_187,seq43,r_57_141_11,0.97,0,11,11,32
21,r_29_19_169,r_116_127_33,r_145_74_114,r_145_74_114,0.88,56,170,114,32
10,r_82_33_53,r_98_95_185,r_145_74_114,r_145_74_114,1.0,73,187,114,32
10,r_82_33_53,r_94_81_62,r_98_95_185,r_82_33_53,1.0,1,54,53,32
7,r_135_69_34,r_3_62_194,seq7,r_135_69_34,0.91,7,41,34,32
2,r_133_120_60,seq26,seq41,r_133_120_60,1.0,2,62,60,32
47,r_110_137_100,seq43,seq4,r_110_137_100,0.96,-1,99,100,32
29,r_30_22_163,seq54,r_84_25_161,r_30_22_163,0.42,6,169,163,32
33,r_65_132_139,seq2,r_31_40_61,r_31_40_61,0.99,88,149,61,32
48,r_15_140_40,r_134_8_172,r_145_74_114,r_145_74_114,0.97,12,126,114,32
39,r_60_99_59,r_31_40_61,seq55,r_60_99_59,0.97,0,59,59,32
42,r_98_95_185,r_82_33_53,r_6_14_154,r_82_33_53,0.65,134,187,53,32
32,r_134_8_172,r_98_95_185,r_6_14_154,r_6_14_154,0.63,19,173,154,32
38,r_73_79_190,r_3_62_194,seq5,r_73_79_190,0.36,0,190,190,32
27,r_44_97_55,r_31_40_61,r_85_46_75,r_85_46_75,0.62,-17,58,75,32
17,r_45_88_102,r_101_77_160,seq107,r_101_77_160,0.98,-45,115,160,32
9,r_144_106_135,r_129_11_58,seq36,r_144_106_135,0.83,0,135,135,32
22,r_147_96_146,seq34,r_90_148_120,r_147_96_146,0.68,1,147,146,32
28,r_84_25_161,r_129_11_58,r_101_77_160,r_84_25_161,0.49,1,162,161,32
46,r_94_81_62,r_82_33_53,r_71_32_41,r_94_81_62,1.0,-8,54,62,32
23,r_3_62_194,r_73_79_190,r_37_72_31,r_3_62_194,0.37,-4,190,194,32
31,r_37_72_31,r_129_11_58,seq26,r_37_72_31,0.94,5,36,31,32
35,r_101_77_160,seq18,r_84_25_161,r_101_77_160,0.68,2,162,160,32
93,seq114,r_118_91_111,r_17_8_63,r_118_91_111,1.0,4,115,111,33
30,r_12_22_78,r_140_81_194,r_63_53_29,r_12_22_78,1.0,0,78,78,33
36,r_80_73_83,r_76_131_124,seq115,r_80_73_83,0.88,0,83,83,33
32,r_102_85_12,r_26_43_71,seq143,r_26_43_71,1.0,0,71,71,33
14,r_100_107_190,seq9,r_98_28_102,r_98_28_102,0.75,88,190,102,33
43,r_5_120_176,seq16,r_102_85_12,r_5_120_176,0.4,0,176,176,33
3,r_31_44_41,r_124_48_148,seq45,r_124_48_148,0.92,-23,125,148,33
16,r_35_34_131,seq108,r_135_64_80,r_135_64_80,1.0,60,140,80,33
21,r_98_28_102,r_33_90_170,r_26_43_71,r_98_28_102,0.99,2,104,102,33
39,r_124_48_148,seq40,seq133,r_124_48_148,0.78,0,148,148,33
1,r_110_113_59,r_59_96_161,seq16,r_110_113_59,0.69,5,64,59,33
46,r_66_38_88,r_54_101_141,seq0,r_66_38_88,0.89,0,88,88,33
42,r_123_46_125,r_140_81_194,r_135_64_80,r_140_81_194,1.0,-68,126,194,33
45,r_136_137_69,r_25_84_179,seq16,r_136_137_69,0.97,0,69,69,33
15,r_68_104_14,r_140_81_194,seq27,r_68_104_14,0.93,2,16,14,33
19,r_59_96_161,seq116,seq23,r_59_96_161,0.66,1,162,161,33
3,r_31_44_41,r_129_37_159,r_124_48_148,r_31_44_41,1.0,2,43,41,33
41,r_51_61_79,seq132,seq116,r_51_61_79,1.0,0,79,79,33
10,r_135_64_80,r_148_1_15,seq141,r_135_64_80,1.0,0,80,80,33
90,seq108,r_35_34_131,r_54_101_141,r_54_101_141,0.97,-1,140,141,33
2,r_63_53_29,r_110_113_59,seq94,r_63_53_29,0.84,0,29,29,33
72,seq55,r_25_84_179,r_26_43_71,r_26_43_71,1.0,2,73,71,33
37,r_26_43_71,r_102_85_12,seq55,r_26_43_71,1.0,0,71,71,33
4,r_76_131_124,seq147,r_63_53_29,r_76_131_124,0.95,0,124,124,33
0,r_105_6_160,seq147,r_77_134_90,r_105_6_160,0.53,0,160,160,33
73,seq56,r_109_103_169,r_124_48_148,r_124_48_148,0.58,22,170,148,33
37,r_26_43_71,r_76_131_124,r_102_85_12,r_102_85_12,0.89,10,22,12,33
13,r_18_121_188,seq16,r_135_64_80,r_18_121_188,0.35,2,190,188,33
48,r_49_86_114,r_92_78_135,seq9,r_49_86_114,1.0,0,114,114,33
6,r_54_101_141,seq133,r_88_146_48,r_54_101_141,0.54,0,141,141,33
62,seq147,r_76_131_124,seq32,r_76_131_124,0.94,0,124,124,33
40,r_88_146_48,r_87_79_112,seq108,r_88_146_48,0.92,1,49,48,33
32,r_102_85_12,r_31_44_41,r_26_43_71,r_102_85_12,0.91,0,12,12,33
25,r_30_128_155,r_77_134_90,seq147,r_30_128_155,0.35,-6,149,155,33
47,r_57_29_58,r_76_131_124,seq75,r_57_29_58,0.98,1,59,58,33
17,r_77_134_90,r_140_81_194,r_30_128_155,r_140_81_194,0.55,-103,91,194,33
9,r_82_97_104,r_140_81_194,r_17_8_63,r_82_97_104,0.99,0,104,104,33
22,r_129_37_159,seq7,seq40,r_129_37_159,0.71,0,159,159,33
28,r_67_60_180,seq55,r_80_73_83,r_67_60_180,0.63,0,180,180,33
49,r_118_91_111,seq114,seq36,r_118_91_111,0.99,4,115,111,33
34,r_42_20_33,r_5_120_176,seq72,r_42_20_33,1.0,2,35,33,33
7,r_87_79_112,seq144,seq24,r_87_79_112,0.93,0,112,112,33
23,r_109_103_169,seq56,r_135_64_80,r_135_64_80,0.6,90,170,80,33
17,r_77_134_90,r_30_128_155,r_105_6_160,r_77_134_90,0.84,70,160,90,33
35,r_33_90_170,seq23,r_69_4_11,r_69_4_11,0.94,161,172,11,33
79,seq72,seq36,r_42_20_33,r_42_20_33,0.99,9,42,33,33
12,r_17_8_63,r_87_79_112,seq27,r_87_79_112,1.0,-49,63,112,33
30,r_139_80_170,seq88,seq72,r_139_80_170,0.54,0,170,170,34
36,r_101_105_157,seq13,seq29,r_101_105_157,0.5,0,157,157,34
14,r_57_99_171,seq3,seq70,r_57_99_171,0.58,0,171,171,34
37,r_78_146_35,seq83,r_58_81_27,r_78_146_35,0.74,0,35,35,34
10,r_140_31_28,r_141_65_34,r_51_75_4,r_140_31_28,0.99,2,30,28,34
16,r_28_132_133,r_53_128_181,r_24_124_186,r_28_132_133,0.79,2,135,133,34
1,r_126_48_60,r_15_107_96,seq112,r_126_48_60,0.76,19,79,60,34
5,r_6_117_179,seq113,r_61_119_66,r_61_119_66,0.66,114,180,66,34
80,seq83,r_59_11_128,seq93,r_59_11_128,1.0,0,128,128,34
35,r_77_134_57,r_64_98_182,seq111,r_77_134_57,0.69,2,59,57,34
45,r_18_4_136,r_89_63_76,seq30,r_89_63_76,0.83,2,78,76,34
19,r_94_67_70,seq111,seq149,r_94_67_70,0.59,6,76,70,34
45,r_18_4_136,seq30,seq143,r_18_4_136,1.0,0,136,136,34
0,r_141_65_34,r_76_71_184,r_145_66_29,r_145_66_29,0.63,14,43,29,34
41,r_121_20_45,r_53_128_181,r_141_65_34,r_121_20_45,0.46,60,105,45,34
3,r_61_119_66,r_76_71_184,seq88,r_61_119_66,0.71,3,69,66,34
20,r_131_142_172,seq8,r_28_132_133,r_131_142_172,0.56,0,172,172,34
13,r_100_37_102,r_94_67_70,seq8,r_100_37_102,0.78,4,106,102,34
98,seq123,r_52_91_148,seq113,r_52_91_148,0.98,1,149,148,34
15,r_56_5_123,seq13,seq29,r_56_5_123,0.8,1,124,123,34
48,r_39_23_69,seq68,seq93,r_39_23_69,1.0,2,71,69,34
57,seq143,r_137_60_104,seq93,r_137_60_104,1.0,2,106,104,34
4,r_108_40_55,seq129,r_10_115_73,r_108_40_55,0.97,0,55,55,34
2,r_19_46_65,seq7,seq148,r_19_46_65,0.96,3,68,65,34
47,r_138_47_169,seq110,r_74_45_88,r_74_45_88,0.84,81,169,88,34
40,r_10_115_73,seq135,r_108_40_55,r_108_40_55,1.0,19,74,55,34
18,r_74_45_88,r_137_60_104,r_50_0_32,r_50_0_32,0.62,59,91,32,34
29,r_103_27_114,r_9_133_135,seq25,r_103_27_114,0.85,1,115,114,34
24,r_62_36_132,seq72,r_100_37_102,r_100_37_102,0.93,41,143,102,34
25,r_15_107_96,r_126_48_60,seq129,r_15_107_96,0.6,-17,79,96,34
34,r_9_133_135,seq16,r_41_136_2,r_9_133_135,0.58,0,135,135,34
11,r_145_66_29,r_59_11_128,seq90,r_145_66_29,1.0,1,30,29,34
60,seq147,r_53_128_181,r_141_65_34,r_53_128_181,0.54,-76,105,181,34
9,r_104_22_82,seq30,seq69,r_104_22_82,0.76,13,95,82,34
22,r_89_63_76,r_18_4_136,seq7,r_89_63_76,0.95,2,78,76,34
28,r_12_106_122,seq148,seq13,r_12_106_122,0.76,2,124,122,34
86,seq90,r_53_128_181,r_145_66_29,r_145_66_29,0.65,26,55,29,34
7,r_59_11_128,seq83,seq149,r_59_11_128,0.55,0,128,128,34
23,r_1_2_124,seq88,r_19_46_65,r_1_2_124,0.77,0,124,124,34
26,r_50_0_32,r_95_118_79,seq16,r_50_0_32,0.97,0,32,32,34
43,r_58_81_27,r_100_37_102,seq109,r_58_81_27,0.54,1,28,27,34
30,r_7_75_71,r_90_144_93,seq49,r_90_144_93,0.99,-8,85,93,35
14,r_32_110_94,r_54_77_164,seq5,r_54_77_164,0.98,-60,104,164,35
8,r_111_104_100,r_37_38_187,seq140,r_111_104_100,0.54,-38,62,100,35
53,seq5,r_27_84_136,r_32_110_94,r_27_84_136,1.0,2,138,136,35
43,r_87_8_133,r_74_80_2,r_7_75_71,r_87_8_133,0.79,0,133,133,35
83,seq79,r_13_70_179,seq66,r_13_70_179,0.64,-110,69,179,35
37,r_2_148_86,seq48,seq11,r_2_148_86,0.76,18,104,86,35
16,r_89_46_72,r_95_143_83,seq43,r_89_46_72,1.0,0,72,72,35
21,r_145_98_114,r_44_106_183,r_21_9_46,r_145_98_114,0.99,0,114,114,35
1,r_142_86_111,r_27_84_136,r_28_1_33,r_142_86_111,0.99,0,111,111,35
46,r_28_1_33,r_90_144_93,seq136,r_90_144_93,0.99,-58,35,93,35
12,r_29_91_31,r_118_126_177,r_12_128_32,r_29_91_31,0.99,3,34,31,35
31,r_125_68_167,seq22,r_90_144_93,r_90_144_93,0.89,74,167,93,35
89,seq100,r_13_70_179,r_0_19_1,r_13_70_179,0.78,2,181,179,35
20,r_50_64_142,seq14,seq15,r_50_64_142,0.96,0,142,142,35
13,r_6_52_120,r_34_73_180,r_61_45_53,r_6_52_120,0.95,0,120,120,35
48,r_13_70_179,seq100,r_120_35_36,r_13_70_179,0.72,0,179,179,35
6,r_71_135_147,r_83_57_172,r_16_99_141,r_71_135_147,0.76,1,148,147,35
39,r_62_55_38,r_124_76_127,seq39,r_62_55_38,1.0,0,38,38,35
2,r_54_77_164,seq43,seq47,r_54_77_164,0.66,0,164,164,35
47,r_23_60_61,seq47,seq131,r_23_60_61,0.97,1,62,61,35
40,r_44_106_183,seq134,r_0_19_1,r_0_19_1,0.61,184,185,1,35
74,seq48,r_2_148_86,r_30_149_97,r_30_149_97,1.0,7,104,97,35
29,r_27_84_136,seq5,seq67,r_27_84_136,0.92,2,138,136,35
25,r_132_122_122,r_54_77_164,r_50_64_142,r_132_122_122,0.71,0,122,122,35
33,r_83_57_172,seq72,r_120_35_36,r_120_35_36,0.48,140,176,36,35
42,r_117_3_10,r_95_143_83,seq72,r_95_143_83,0.66,-72,11,83,35
32,r_92_139_80,seq131,r_29_91_31,r_92_139_80,1.0,0,80,80,35
38,r_37_38_187,seq94,r_54_77_164,r_54_77_164,0.89,23,187,164,35
81,seq72,r_83_57_172,r_124_76_127,r_124_76_127,0.95,49,176,127,35
17,r_90_144_93,r_7_75_71,r_92_139_80,r_90_144_93,1.0,0,93,93,35
9,r_95_143_83,r_44_106_183,r_23_60_61,r_95_143_83,0.94,7,90,83,35
22,r_30_149_97,seq10,seq48,r_30_149_97,1.0,0,97,97,35
28,r_53_24_157,r_96_56_194,r_124_76_127,r_124_76_127,0.78,31,158,127,35
23,r_42_97_56,r_138_141_59,r_120_35_36,r_42_97_56,1.0,0,56,56,35
25,r_132_122_122,r_50_64_142,seq137,r_50_64_142,0.82,0,142,142,35
7,r_124_76_127,r_102_31_195,r_117_3_10,r_124_76_127,0.86,0,127,127,35
10,r_61_45_53,r_23_60_61,seq114,r_61_45_53,0.66,0,53,53,35
36,r_19_66_117,r_91_10_125,r_96_111_33,r_96_111_33,1.0,84,117,33,36
9,r_5_147_185,r_96_111_33,r_102_63_183,r_5_147_185,0.44,2,187,185,36
14,r_79_27_176,seq120,seq40,r_79_27_176,0.53,0,176,176,36
43,r_62_136_73,r_110_80_164,seq24,r_62_136_73,0.81,-1,72,73,36
48,r_96_111_33,r_119_18_41,r_5_147_185,r_96_111_33,1.0,0,33,33,36
54,seq137,r_47_26_173,r_124_112_27,r_124_112_27,1.0,149,176,27,36
37,r_6_114_101,r_46_35_80,r_42_77_81,r_42_77_81,0.77,19,100,81,36
1,r_91_10_125,r_79_27_176,r_42_77_81,r_91_10_125,0.63,-1,124,125,36
46,r_89_131_126,seq44,r_0_121_29,r_89_131_126,0.99,1,127,126,36
16,r_104_55_24,r_59_30_12,seq50,r_104_55_24,1.0,0,24,24,36
30,r_72_70_16,r_74_7_187,r_54_69_199,r_72_70_16,1.0,0,16,16,36
0,r_20_108_110,r_115_58_62,r_0_121_29,r_115_58_62,0.88,-29,33,62,36
41,r_115_58_62,r_20_108_110,seq145,r_115_58_62,1.0,0,62,62,36
3,r_32_51_140,seq8,r_21_33_39,r_32_51_140,0.98,0,140,140,36
10,r_42_77_81,r_17_146_162,seq29,r_42_77_81,0.93,0,81,81,36
8,r_0_121_29,r_20_108_110,r_149_135_72,r_149_135_72,1.0,33,105,72,36
4,r_113_144_137,seq106,r_132_37_120,r_113_144_137,0.96,0,137,137,36
11,r_47_26_173,seq137,r_130_99_58,r_130_99_58,1.0,118,176,58,36
32,r_21_33_39,r_91_10_125,r_59_30_12,r_21_33_39,0.64,0,39,39,36
31,r_54_69_199,r_102_63_183,r_72_70_16,r_72_70_16,0.97,11,27,16,36
20,r_100_82_181,seq93,r_32_51_140,r_32_51_140,1.0,43,183,140,36
19,r_124_112_27,r_100_82_181,seq41,r_124_112_27,1.0,0,27,27,36
15,r_105_11_179,seq40,r_9_1_9,r_105_11_179,0.58,3,182,179,36
18,r_130_99_58,r_110_80_164,seq129,r_130_99_58,1.0,0,58,58,36
53,seq8,r_32_51_140,r_119_18_41,r_32_51_140,0.82,-89,51,140,36
12,r_84_128_19,r_92_12_138,seq49,r_84_128_19,0.98,-1,18,19,36
0,r_20_108_110,r_0_121_29,r_116_88_68,r_116_88_68,0.46,42,110,68,36
27,r_17_146_162,seq83,r_84_128_19,r_17_146_162,0.61,0,162,162,36
87,seq83,r_17_146_162,r_74_7_187,r_17_146_162,0.43,0,162,162,36
2,r_92_12_138,seq103,r_62_136_73,r_92_12_138,0.98,1,139,138,36
47,r_64_118_189,r_20_108_110,r_0_121_29,r_64_118_189,0.42,-72,117,189,36
40,r_3_61_170,seq129,r_0_121_29,r_0_121_29,0.55,148,177,29,36
29,r_45_98_119,seq57,seq106,r_45_98_119,1.0,-4,115,119,36
96,seq106,r_113_144_137,seq31,r_113_144_137,0.98,-86,51,137,36
24,r_110_80_164,seq49,r_119_18_41,r_110_80_164,0.76,1,165,164,36
8,r_0_121_29,r_122_140_64,r_20_108_110,r_122_140_64,0.92,-35,29,64,36
25,r_46_35_80,r_6_114_101,r_72_70_16,r_46_35_80,0.91,-2,78,80,36
33,r_132_37_120,seq57,seq50,r_132_37_120,0.8,-5,115,120,36
48,r_96_111_33,r_5_147_185,r_84_128_19,r_5_147_185,0.6,0,185,185,36
47,r_64_118_189,r_0_121_29,r_105_11_179,r_0_121_29,0.73,160,189,29,36
68,seq36,r_102_63_183,r_9_1_9,r_9_1_9,0.85,18,27,9,36
17,r_9_1_9,r_52_90_196,seq36,r_9_1_9,0.61,1,10,9,36
21,r_78_109_47,seq134,r_84_128_19,r_78_109_47,1.0,0,47,47,36
38,r_149_135_72,seq14,r_0_121_29,r_149_135_72,1.0,0,72,72,36
9,r_5_147_185,r_139_67_161,r_96_111_33,r_96_111_33,1.0,0,33,33,36
34,r_123_16_166,seq86,seq65,r_123_16_166,0.54,1,167,166,36
7,r_119_18_41,r_47_26_173,seq8,r_119_18_41,0.7,-6,35,41,36
22,r_142_97_152,r_64_118_189,r_119_18_41,r_64_118_189,0.63,-36,153,189,36
49,r_117_13_115,seq65,seq86,r_117_13_115,1.0,7,122,115,36
44,r_81_48_165,seq93,r_119_18_41,r_81_48_165,0.75,0,165,165,36
23,r_122_140_64,seq129,r_84_128_19,r_122_140_64,0.99,1,65,64,36
35,r_139_67_161,r_5_147_185,r_45_98_119,r_45_98_119,0.89,46,165,119,36
36,r_121_52_64,seq91,r_23_11_196,r_121_52_64,1.0,1,65,64,37
43,r_10_59_157,seq92,seq53,r_10_59_157,0.48,1,158,157,37
71,seq43,r_39_132_134,r_131_126_73,r_39_132_134,0.88,0,134,134,37
21,r_103_67_85,r_69_114_165,r_76_30_126,r_76_30_126,0.41,20,146,126,37
5,r_76_30_126,r_77_47_13,r_103_67_85,r_76_30_126,0.17,8,134,126,37
42,r_32_90_116,seq73,r_0_117_50,r_0_117_50,0.82,65,115,50,37
32,r_26_119_66,r_108_120_49,r_74_89_100,r_26_119_66,0.46,66,132,66,37
76,seq63,r_127_80_147,r_100_54_5,r_127_80_147,0.78,0,147,147,37
31,r_69_114_165,r_103_67_85,r_12_13_197,r_12_13_197,0.61,-30,167,197,37
41,r_21_82_91,r_56_85_143,r_0_117_50,r_56_85_143,1.0,-51,92,143,37
3,r_128_50_112,r_70_49_16,r_16_147_79,r_128_50_112,0.92,0,112,112,37
90,seq93,r_41_106_192,r_56_85_143,r_56_85_143,0.91,21,164,143,37
0,r_110_5_76,r_136_29_185,seq20,r_110_5_76,0.99,1,77,76,37
26,r_0_117_50,r_56_85_143,seq92,r_0_117_50,0.94,1,51,50,37
15,r_130_95_83,r_74_89_100,r_131_126_73,r_130_95_83,0.96,2,85,83,37
62,seq25,r_107_46_102,seq141,r_107_46_102,0.95,5,107,102,37
11,r_108_120_49,r_110_5_76,seq88,r_108_120_49,0.91,0,49,49,37
85,seq83,r_72_57_180,r_121_52_64,r_121_52_64,1.0,116,180,64,37
48,r_64_135_58,r_48_140_151,r_139_44_44,r_64_135_58,1.0,0,58,58,37
2,r_74_89_100,seq27,r_26_119_66,r_74_89_100,0.87,7,107,100,37
18,r_56_85_143,r_137_116_111,seq93,r_56_85_143,0.81,0,143,143,37
29,r_60_99_129,r_97_66_117,r_0_117_50,r_97_66_117,0.92,12,129,117,37
24,r_24_84_98,r_72_57_180,r_100_54_5,r_24_84_98,0.99,1,99,98,37
25,r_102_138_56,r_55_133_80,r_108_120_49,r_102_138_56,0.94,9,65,56,37
37,r_134_45_38,r_56_85_143,seq101,r_134_45_38,0.97,0,38,38,37
32,r_26_119_66,r_12_13_197,r_108_120_49,r_12_13_197,0.98,-131,66,197,37
38,r_55_133_80,seq62,seq6,r_55_133_80,0.98,0,80,80,37
19,r_75_4_26,r_64_135_58,r_12_13_197,r_75_4_26,0.99,0,26,26,37
17,r_109_37_150,r_10_59_157,seq73,r_109_37_150,0.67,3,153,150,37
35,r_124_31_34,r_32_90_116,seq93,r_124_31_34,0.97,1,35,34,37
28,r_142_118_188,seq125,r_146_105_17,r_146_105_17,1.0,172,189,17,37
23,r_100_54_5,r_127_80_147,r_24_84_98,r_100_54_5,0.83,102,107,5,37
40,r_139_83_88,r_36_43_50,r_7_84_32,r_139_83_88,0.82,20,108,88,38
30,r_30_126_67,seq101,seq108,r_30_126_67,1.0,0,67,67,38
14,r_125_145_155,r_39_48_195,r_115_92_109,r_39_48_195,0.9,-40,155,195,38
43,r_103_116_62,seq71,r_54_86_28,r_103_116_62,0.95,0,62,62,38
37,r_143_129_115,seq8,r_24_2_26,r_143_129_115,0.9,2,117,115,38
2,r_7_84_32,r_59_106_96,seq35,r_7_84_32,0.91,1,33,32,38
16,r_72_67_177,seq21,seq13,r_72_67_177,0.33,9,186,177,38
5,r_115_92_109,r_33_146_134,r_40_14_25,r_115_92_109,0.93,1,110,109,38
5,r_115_92_109,r_23_107_64,r_33_146_134,r_23_107_64,0.99,0,64,64,38
4,r_94_87_57,r_73_70_170,r_41_98_56,r_94_87_57,0.96,2,59,57,38
40,r_139_83_88,seq134,r_36_43_50,r_36_43_50,0.84,-16,34,50,38
31,r_12_4_97,r_52_133_23,r_103_116_62,r_52_133_23,0.89,74,97,23,38
89,seq105,r_28_37_159,r_91_132_143,r_91_132_143,0.43,18,161,143,38
3,r_80_111_153,r_33_146_134,r_94_87_57,r_94_87_57,1.0,43,100,57,38
10,r_33_146_134,r_80_111_153,r_58_44_182,r_33_146_134,0.79,4,138,134,38
0,r_91_132_143,r_72_67_177,r_123_9_44,r_91_132_143,0.68,3,146,143,38
63,seq25,seq13,r_64_137_78,r_64_137_78,1.0,9,87,78,38
20,r_42_119_151,seq11,r_33_146_134,r_42_119_151,0.65,4,155,151,38
13,r_60_31_65,r_91_132_143,seq148,r_60_31_65,0.98,4,69,65,38
48,r_66_110_185,seq141,r_33_146_134,r_33_146_134,0.94,51,185,134,38
46,r_15_144_36,r_103_116_62,seq138,r_15_144_36,0.83,0,36,36,38
21,r_123_9_44,r_33_146_134,r_112_17_108,r_33_146_134,0.6,4,138,134,38
8,r_93_1_41,r_58_44_182,seq134,r_93_1_41,1.0,0,41,41,38
27,r_147_99_128,seq136,r_24_2_26,r_147_99_128,0.93,0,128,128,38
36,r_36_43_50,r_94_87_57,r_139_83_88,r_36_43_50,0.91,1,51,50,38
87,seq148,seq34,r_60_31_65,r_60_31_65,1.0,10,75,65,38
22,r_68_100_43,r_42_119_151,seq65,r_68_100_43,0.99,0,43,43,38
47,r_113_47_116,r_42_119_151,r_30_126_67,r_113_47_116,0.87,1,117,116,38
74,seq65,r_39_48_195,r_68_100_43,r_68_100_43,0.95,40,83,43,38
29,r_112_17_108,r_95_46_160,r_41_98_56,r_112_17_108,0.9,0,108,108,38
25,r_16_19_148,r_53_61_150,r_89_5_35,r_16_19_148,0.8,0,148,148,38
33,r_18_38_93,r_58_44_182,seq82,r_18_38_93,1.0,4,97,93,38
42,r_73_70_170,r_54_86_28,r_33_146_134,r_54_86_28,0.78,143,171,28,38
32,r_28_37_159,seq105,r_53_61_150,r_28_37_159,0.62,1,160,159,38
38,r_53_61_150,seq138,r_64_137_78,r_64_137_78,1.0,72,150,78,38
3,r_80_111_153,r_94_87_57,seq25,r_80_111_153,1.0,2,155,153,38
34,r_41_98_56,seq20,r_94_87_57,r_94_87_57,1.0,7,64,57,38
17,r_131_122_131,r_140_32_173,seq11,r_131_122_131,0.64,5,136,131,38
28,r_3_63_110,seq114,r_59_106_96,r_3_63_110,0.96,0,110,110,38
49,r_64_137_78,seq105,seq25,r_64_137_78,0.93,7,85,78,38
68,seq35,r_131_122_131,r_7_84_32,r_7_84_32,0.65,1,33,32,38
42,r_73_70_170,r_94_87_57,r_54_86_28,r_94_87_57,0.65,2,59,57,38
36,r_36_43_50,r_139_83_88,r_23_107_64,r_36_43_50,0.78,52,102,50,38
35,r_23_107_64,r_115_92_109,r_36_43_50,r_36_43_50,0.58,14,64,50,38
12,r_59_106_96,r_91_132_143,r_3_63_110,r_59_106_96,0.43,10,106,96,38
21,r_123_9_44,r_131_122_131,r_33_146_134,r_123_9_44,0.98,0,44,44,38
92,seq107,r_84_55_4,r_112_91_85,r_112_91_85,1.0,28,113,85,39
37,r_32_8_72,seq2,r_28_59_18,r_32_8_72,0.95,0,72,72,39
1,r_92_106_102,r_12_132_171,r_141_66_34,r_92_106_102,0.88,-2,100,102,39
25,r_41_103_15,seq14,r_86_13_2,r_41_103_15,0.95,0,15,15,39
5,r_12_132_171,r_79_74_172,r_97_46_96,r_12_132_171,0.59,0,171,171,39
15,r_78_119_16,r_86_13_2,seq129,r_78_119_16,0.63,0,16,16,39
19,r_104_6_55,r_50_124_1,r_114_36_87,r_104_6_55,0.97,-3,52,55,39
31,r_57_111_49,seq22,seq147,r_57_111_49,0.99,1,50,49,39
41,r_89_145_178,r_43_48_3,seq127,r_89_145_178,0.38,2,180,178,39
10,r_47_3_63,seq24,seq116,r_47_3_63,1.0,1,64,63,39
26,r_112_91_85,r_92_106_102,seq107,r_112_91_85,0.97,-1,84,85,39
16,r_120_110_139,r_82_70_48,r_86_13_2,r_82_70_48,0.95,91,139,48,39
0,r_15_85_111,seq108,r_68_98_109,r_15_85_111,0.79,0,111,111,39
66,seq22,r_57_111_49,r_15_85_111,r_57_111_49,1.0,1,50,49,39
48,r_42_7_69,seq128,seq149,r_42_7_69,0.87,-5,64,69,39
12,r_82_70_48,r_120_110_139,r_78_119_16,r_120_110_139,0.83,32,171,139,39
16,r_120_110_139,r_96_67_52,r_82_70_48,r_120_110_139,0.48,-93,46,139,39
99,seq127,r_134_31_188,r_89_145_178,r_89_145_178,0.54,10,188,178,39
29,r_96_67_52,seq1,seq102,r_96_67_52,1.0,-2,50,52,39
36,r_61_81_43,r_86_13_2,r_97_46_96,r_97_46_96,0.86,44,140,96,39
27,r_23_80_189,seq58,r_97_46_96,r_97_46_96,0.72,94,190,96,39
33,r_141_66_34,seq147,seq35,r_141_66_34,0.88,-4,30,34,39
40,r_115_56_65,seq131,seq22,r_115_56_65,0.99,-1,64,65,39
18,r_84_55_4,r_21_76_187,r_112_91_85,r_112_91_85,1.0,77,162,85,39
24,r_79_74_172,r_12_132_171,r_96_67_52,r_12_132_171,0.79,0,171,171,39
3,r_25_130_62,r_139_143_75,seq142,r_139_143_75,1.0,-16,59,75,39
11,r_101_16_17,r_96_67_52,r_75_44_177,r_101_16_17,0.86,-1,16,17,39
58,seq128,r_42_7_69,seq24,r_42_7_69,0.96,-5,64,69,39
32,r_125_65_68,seq30,r_114_36_87,r_125_65_68,0.86,-8,60,68,39
38,r_139_143_75,seq53,seq60,r_139_143_75,1.0,-2,73,75,39
34,r_94_34_12,r_25_130_62,seq1,r_94_34_12,0.75,-1,11,12,39
17,r_123_99_160,r_68_98_109,r_122_83_118,r_122_83_118,0.54,25,143,118,39
22,r_21_76_187,r_84_55_4,r_15_85_111,r_15_85_111,0.99,76,187,111,39
49,r_95_72_41,r_26_71_175,seq53,r_95_72_41,0.69,-22,19,41,39
36,r_61_81_43,r_89_145_178,r_86_13_2,r_61_81_43,0.87,0,43,43,39
12,r_82_70_48,r_49_90_174,r_120_110_139,r_82_70_48,0.97,4,52,48,39
30,r_98_17_153,seq82,seq93,r_98_17_153,0.62,0,153,153,40
36,r_133_38_138,seq62,r_36_11_45,r_133_38_138,0.96,2,140,138,40
8,r_63_47_89,seq22,seq4,r_63_47_89,0.98,1,90,89,40
7,r_60_15_15,r_133_38_138,seq112,r_60_15_15,0.99,0,15,15,40
3,r_1_2_24,seq132,r_40_117_198,r_40_117_198,0.63,-172,26,198,40
55,seq132,seq112,r_78_99_105,r_78_99_105,1.0,0,105,105,40
16,r_57_107_106,r_42_84_157,r_97_129_61,r_97_129_61,0.88,51,112,61,40
39,r_144_68_121,seq13,seq16,r_144_68_121,1.0,-1,120,121,40
1,r_123_131_185,seq28,r_87_126_161,r_87_126_161,0.8,24,185,161,40
46,r_121_92_171,seq52,r_18_114_146,r_18_114_146,0.77,26,172,146,40
33,r_139_27_23,seq9,r_81_6_12,r_139_27_23,0.85,15,38,23,40
20,r_23_33_53,r_138_12_159,r_36_11_45,r_138_12_159,0.78,-106,53,159,40
19,r_32_21_71,r_57_107_106,seq102,r_32_21_71,1.0,0,71,71,40
11,r_87_126_161,r_1_2_24,r_125_37_55,r_87_126_161,0.55,0,161,161,40
31,r_136_118_170,seq112,r_86_90_80,r_86_90_80,0.61,91,171,80,40
26,r_79_105_127,seq130,r_53_128_8,r_79_105_127,0.98,-1,126,127,40
72,seq48,r_138_12_159,r_125_37_55,r_125_37_55,1.0,8,63,55,40
0,r_24_142_108,r_98_17_153,seq113,r_24_142_108,0.88,2,110,108,40
73,seq51,seq93,r_86_90_80,r_86_90_80,0.92,2,82,80,40
11,r_87_126_161,r_0_85_98,r_1_2_24,r_87_126_161,0.64,-60,101,161,40
13,r_45_124_116,seq67,seq145,r_45_124_116,0.99,0,116,116,40
15,r_5_20_128,seq96,r_1_2_24,r_5_20_128,0.99,2,130,128,40
54,seq10,r_121_92_171,r_135_109_14,r_135_109_14,0.55,13,27,14,40
6,r_3_116_102,r_108_95_111,r_60_15_15,r_60_15_15,0.97,87,102,15,40
2,r_0_85_98,r_87_126_161,seq89,r_0_85_98,0.59,3,101,98,40
29,r_14_137_87,r_0_85_98,seq75,r_0_85_98,0.7,-11,87,98,40
25,r_138_12_159,seq147,r_1_2_24,r_1_2_24,0.78,143,167,24,40
88,seq93,r_54_104_109,r_86_90_80,r_86_90_80,0.84,47,127,80,40
58,seq143,r_123_131_185,r_110_149_178,r_110_149_178,0.85,0,178,178,40
18,r_125_37_55,r_123_131_185,r_50_100_26,r_125_37_55,0.99,0,55,55,40
38,r_146_59_148,r_73_119_195,r_55_72_59,r_146_59_148,0.84,0,148,148,40
77,seq62,r_133_38_138,r_53_128_8,r_133_38_138,0.97,2,140,138,40
22,r_77_26_193,r_97_129_61,r_80_71_36,r_77_26_193,0.88,-132,61,193,40
49,r_55_72_59,seq88,seq9,r_55_72_59,0.83,6,65,59,40
4,r_36_11_45,seq9,seq103,r_36_11_45,1.0,0,45,45,40
44,r_19_69_114,r_45_124_116,r_81_6_12,r_19_69_114,0.95,0,114,114,40
23,r_42_84_157,seq106,seq64,r_42_84_157,0.7,0,157,157,40
47,r_80_71_36,r_123_131_185,seq113,r_80_71_36,1.0,2,38,36,40
32,r_50_100_26,seq76,seq48,r_50_100_26,0.71,11,37,26,40
35,r_97_129_61,r_77_26_193,seq61,r_97_129_61,1.0,0,61,61,40
12,r_108_95_111,r_45_124_116,seq16,r_108_95_111,0.91,0,111,111,40
84,seq82,r_98_17_153,r_3_116_102,r_3_116_102,1.0,51,153,102,40
8,r_148_133_47,r_51_124_111,r_6_74_13,r_148_133_47,1.0,0,47,47,41
30,r_131_88_60,r_149_117_74,seq5,r_131_88_60,1.0,-4,56,60,41
37,r_123_129_31,r_25_70_64,seq24,r_25_70_64,0.98,-36,28,64,41
57,seq15,r_134_107_118,r_7_84_24,r_7_84_24,0.65,4,28,24,41
21,r_136_81_65,seq121,r_68_62_197,r_136_81_65,0.98,1,66,65,41
46,r_20_90_135,r_85_138_166,seq144,r_20_90_135,0.99,0,135,135,41
42,r_128_126_189,seq12,r_146_110_109,r_146_110_109,0.92,80,189,109,41
19,r_4_66_67,seq38,r_131_88_60,r_4_66_67,1.0,0,67,67,41
96,seq119,r_113_13_127,r_98_0_55,r_98_0_55,0.96,1,56,55,41
31,r_50_28_182,r_130_14_137,seq144,r_130_14_137,0.75,1,138,137,41
41,r_134_107_118,seq15,r_35_76_103,r_134_107_118,0.78,0,118,118,41
86,seq99,r_86_63_125,r_94_31_44,r_94_31_44,1.0,0,44,44,41
10,r_112_137_93,r_44_80_120,seq77,r_112_137_93,0.78,1,94,93,41
26,r_145_87_186,seq104,r_139_2_22,r_139_2_22,0.91,167,189,22,41
3,r_106_93_18,r_145_87_186,r_10_109_69,r_106_93_18,1.0,0,18,18,41
11,r_98_0_55,r_4_66_67,seq119,r_98_0_55,1.0,0,55,55,41
4,r_61_105_61,r_112_137_93,seq30,r_61_105_61,0.99,0,61,61,41
0,r_51_124_111,r_68_62_197,seq119,r_51_124_111,0.96,0,111,111,41
13,r_146_110_109,r_51_124_111,seq60,r_146_110_109,0.88,0,109,109,41
15,r_44_80_120,r_41_135_163,r_106_93_18,r_44_80_120,0.71,0,120,120,41
48,r_25_70_64,seq97,seq96,r_25_70_64,1.0,0,64,64,41
20,r_7_84_24,seq111,seq15,r_7_84_24,1.0,0,24,24,41
34,r_143_43_16,r_39_27_102,seq114,r_143_43_16,1.0,0,16,16,41
27,r_32_47_71,seq144,seq22,r_32_47_71,1.0,-1,70,71,41
2,r_83_56_119,seq101,seq144,r_83_56_119,0.93,0,119,119,41
47,r_39_27_102,seq60,r_68_62_197,r_39_27_102,0.97,4,106,102,41
24,r_86_63_125,seq97,r_23_18_94,r_86_63_125,0.33,8,133,125,41
33,r_40_36_146,seq119,r_68_62_197,r_40_36_146,0.81,1,147,146,41
32,r_35_76_103,seq19,seq30,r_35_76_103,0.79,5,108,103,41
98,seq121,r_136_81_65,seq104,r_136_81_65,0.98,-25,40,65,41
35,r_94_31_44,r_113_13_127,seq99,r_94_31_44,1.0,0,44,44,41
45,r_6_74_13,seq30,seq99,r_6_74_13,1.0,-1,12,13,41
9,r_48_53_123,seq60,seq19,r_48_53_123,0.91,1,124,123,41
22,r_140_16_183,r_68_62_197,r_75_3_6,r_68_62_197,0.4,-14,183,197,41
49,r_130_14_137,r_50_28_182,r_75_3_6,r_130_14_137,0.92,1,138,137,41
7,r_55_82_116,seq115,seq30,r_55_82_116,0.86,1,117,116,41
44,r_23_18_94,seq24,seq42,r_23_18_94,0.46,3,97,94,41
23,r_113_13_127,seq119,seq5,r_113_13_127,0.89,0,127,127,41
12,r_100_59_85,seq49,r_68_62_197,r_100_59_85,1.0,0,85,85,41
30,r_83_146_102,r_103_85_198,seq19,r_83_146_102,1.0,0,102,102,42
14,r_140_71_122,seq116,seq62,r_140_71_122,0.97,0,122,122,42
8,r_13_139_65,r_115_29_167,r_87_119_66,r_115_29_167,1.0,-101,66,167,42
37,r_0_5_63,seq18,seq25,r_0_5_63,0.97,0,63,63,42
46,r_7_54_178,r_50_131_134,r_100_61_52,r_100_61_52,0.67,123,175,52,42
81,seq77,r_72_110_40,seq32,r_72_110_40,1.0,1,41,40,42
91,seq96,r_100_61_52,r_95_27_38,r_95_27_38,0.94,-1,37,38,42
76,seq62,seq138,r_140_71_122,r_140_71_122,1.0,13,135,122,42
38,r_135_3_31,r_95_27_38,seq16,r_135_3_31,1.0,0,31,31,42
41,r_45_106_98,r_24_141_121,r_122_40_62,r_45_106_98,0.92,-2,96,98,42
13,r_24_141_121,r_147_128_14,seq25,r_147_128_14,0.8,120,134,14,42
10,r_98_20_150,seq125,r_45_106_98,r_98_20_150,0.45,3,153,150,42
26,r_120_26_116,seq137,r_10_79_183,r_120_26_116,0.63,2,118,116,42
4,r_10_79_183,r_103_85_198,r_120_26_116,r_120_26_116,0.94,4,120,116,42
16,r_100_61_52,seq96,seq80,r_100_61_52,0.82,-1,51,52,42
0,r_64_105_114,seq57,seq30,r_64_105_114,0.8,0,114,114,42
20,r_145_126_149,seq124,r_134_43_28,r_145_126_149,0.97,0,149,149,42
13,r_24_141_121,r_45_106_98,r_147_128_14,r_24_141_121,0.62,-30,91,121,42
98,seq125,r_98_20_150,r_47_2_136,r_47_2_136,0.95,13,149,136,42
15,r_74_142_158,seq124,r_98_20_150,r_74_142_158,0.96,0,158,158,42
48,r_47_2_136,seq16,r_100_61_52,r_47_2_136,0.96,1,137,136,42
4,r_10_79_183,r_120_26_116,r_117_14_36,r_10_79_183,0.71,0,183,183,42
49,r_68_8_47,r_112_111_166,seq116,r_68_8_47,0.99,0,47,47,42
40,r_23_132_125,r_112_111_166,seq137,r_23_132_125,0.95,0,125,125,42
18,r_4_6_78,seq16,r_100_61_52,r_4_6_78,1.0,0,78,78,42
7,r_134_43_28,r_98_20_150,seq1,r_134_43_28,0.82,0,28,28,42
42,r_147_128_14,r_140_71_122,r_24_141_121,r_147_128_14,1.0,0,14,14,42
70,seq46,r_87_119_66,r_122_40_62,r_87_119_66,1.0,0,66,66,42
42,r_147_128_14,r_24_141_121,r_134_43_28,r_147_128_14,0.79,126,140,14,42
34,r_60_21_112,r_33_70_129,r_95_27_38,r_95_27_38,0.58,74,112,38,42
6,r_117_14_36,r_87_119_66,seq67,r_87_119_66,0.98,-33,33,66,42
17,r_33_70_129,r_48_86_159,seq137,r_33_70_129,0.88,1,130,129,42
26,r_120_26_116,r_10_79_183,r_51_89_53,r_10_79_183,0.55,1,184,183,42
19,r_113_81_33,r_112_111_166,r_34_97_20,r_112_111_166,0.62,-133,33,166,42
1,r_72_110_40,seq77,seq36,r_72_110_40,1.0,1,41,40,42
32,r_34_97_20,r_112_111_166,seq116,r_34_97_20,0.77,0,20,20,42
22,r_50_131_134,r_7_54_178,r_51_89_53,r_51_89_53,1.0,81,134,53,42
5,r_31_94_27,seq84,r_102_73_9,r_31_94_27,1.0,0,27,27,42
47,r_109_104_44,r_112_111_166,r_122_40_62,r_109_104_44,1.0,0,44,44,42
44,r_115_29_167,seq67,r_13_139_65,r_13_139_65,1.0,102,167,65,42
35,r_65_42_43,r_24_141_121,r_121_52_193,r_121_52_193,0.91,-150,43,193,42
24,r_95_27_38,r_24_141_121,seq96,r_95_27_38,0.66,1,39,38,42
30,r_49_58_92,r_97_112_105,seq4,r_49_58_92,0.91,2,94,92,43
12,r_35_80_38,r_21_36_98,r_73_137_110,r_35_80_38,0.8,-5,33,38,43
0,r_84_111_55,r_45_14_7,seq13,r_84_111_55,1.0,0,55,55,43
14,r_43_106_78,seq8,seq61,r_43_106_78,1.0,0,78,78,43
18,r_71_88_51,r_48_90_175,r_125_44_46,r_71_88_51,1.0,0,51,51,43
54,seq9,r_77_100_28,r_0_65_82,r_0_65_82,1.0,11,93,82,43
37,r_75_118_67,r_15_94_173,seq4,r_75_118_67,1.0,0,67,67,43
16,r_1_123_68,r_45_14_7,seq147,r_1_123_68,0.75,1,69,68,43
21,r_97_112_105,r_130_62_158,seq55,r_97_112_105,1.0,0,105,105,43
39,r_67_63_148,seq13,r_45_14_7,r_67_63_148,0.9,0,148,148,43
1,r_145_25_57,r_15_94_173,seq20,r_145_25_57,0.77,4,61,57,43
5,r_15_94_173,r_120_92_94,r_86_103_2,r_120_92_94,0.61,79,173,94,43
42,r_138_81_74,r_48_90_175,seq27,r_138_81_74,0.92,0,74,74,43
15,r_79_59_42,r_133_5_52,r_51_24_194,r_79_59_42,0.92,0,42,42,43
31,r_52_116_184,seq95,r_130_62_158,r_130_62_158,0.82,26,184,158,43
41,r_113_34_152,seq72,r_29_31_142,r_113_34_152,0.89,0,152,152,43
10,r_48_90_175,seq108,r_84_111_55,r_84_111_55,1.0,128,183,55,43
24,r_133_5_52,seq12,seq23,r_133_5_52,0.97,1,53,52,43
26,r_73_137_110,r_0_65_82,seq108,r_0_65_82,1.0,13,95,82,43
83,seq147,r_143_89_56,r_1_123_68,r_143_89_56,1.0,0,56,56,43
11,r_60_99_58,r_132_69_127,r_18_102_44,r_60_99_58,1.0,11,69,58,43
20,r_50_105_64,seq20,r_78_124_96,r_50_105_64,0.99,16,80,64,43
13,r_30_119_79,r_0_65_82,r_120_92_94,r_30_119_79,0.59,1,80,79,43
25,r_143_89_56,seq147,seq11,r_143_89_56,1.0,0,56,56,43
12,r_35_80_38,r_73_137_110,r_143_89_56,r_143_89_56,1.0,59,115,56,43
2,r_29_31_142,seq32,r_113_34_152,r_113_34_152,1.0,12,164,152,43
47,r_132_69_127,seq23,seq26,r_132_69_127,0.59,0,127,127,43
29,r_3_37_100,r_29_31_142,seq61,r_3_37_100,0.51,16,116,100,43
32,r_107_122_128,r_15_94_173,r_18_102_44,r_107_122_128,0.59,6,134,128,43
4,r_18_102_44,seq26,seq128,r_18_102_44,1.0,0,44,44,43
22,r_144_101_77,r_52_116_184,seq16,r_144_101_77,1.0,0,77,77,43
28,r_140_114_145,seq128,r_50_105_64,r_50_105_64,0.8,86,150,64,43
49,r_51_24_194,r_29_31_142,r_79_59_42,r_51_24_194,0.71,-123,71,194,43
7,r_87_7_103,seq10,seq108,r_87_7_103,0.89,10,113,103,43
44,r_104_126_73,seq47,r_45_14_7,r_104_126_73,0.98,0,73,73,43
23,r_64_74_157,seq66,r_144_101_77,r_144_101_77,1.0,83,160,77,43
6,r_131_6_21,r_79_59_42,seq20,r_131_6_21,0.67,-9,12,21,43
35,r_38_110_160,seq32,r_18_102_44,r_18_102_44,1.0,120,164,44,43
14,r_65_76_132,seq1,r_19_112_130,r_19_112_130,0.64,13,143,130,44
8,r_12_71_129,r_66_59_128,r_140_52_34,r_140_52_34,0.97,28,62,34,44
37,r_92_10_64,seq62,r_15_68_7,r_15_68_7,1.0,82,89,7,44
43,r_50_147_27,r_139_87_147,seq134,r_50_147_27,1.0,3,30,27,44
21,r_4_124_179,r_2_38_186,r_0_142_136,r_4_124_179,0.49,2,181,179,44
39,r_109_128_102,r_21_137_28,seq77,r_109_128_102,0.45,14,116,102,44
80,seq77,r_86_18_182,r_89_106_65,r_89_106_65,1.0,117,182,65,44
69,seq43,r_64_54_80,r_0_142_136,r_64_54_80,0.55,30,110,80,44
45,r_94_104_167,seq67,r_127_28_172,r_94_104_167,0.23,10,177,167,44
29,r_149_23_58,r_49_45_99,seq95,r_149_23_58,1.0,0,58,58,44
31,r_72_145_29,r_74_98_142,r_44_34_171,r_74_98_142,0.45,0,142,142,44
44,r_122_7_49,r_141_80_190,seq103,r_122_7_49,0.79,8,57,49,44
15,r_37_85_21,r_138_33_42,r_21_137_28,r_21_137_28,1.0,-8,20,28,44
10,r_29_8_74,r_130_51_185,seq1,r_29_8_74,0.83,7,81,74,44
30,r_75_70_18,r_138_33_42,seq32,r_75_70_18,0.95,1,19,18,44
26,r_74_98_142,r_72_145_29,seq129,r_74_98_142,0.54,0,142,142,44
8,r_12_71_129,r_140_52_34,r_15_68_7,r_12_71_129,0.87,4,133,129,44
4,r_116_36_123,seq77,r_127_28_172,r_116_36_123,0.47,2,125,123,44
0,r_19_112_130,r_74_98_142,r_122_7_49,r_19_112_130,0.88,0,130,130,44
20,r_108_144_62,seq77,r_119_102_51,r_108_144_62,0.9,25,87,62,44
13,r_119_102_51,r_91_93_68,seq99,r_119_102_51,0.66,39,90,51,44
85,seq95,r_91_93_68,r_149_23_58,r_149_23_58,1.0,20,78,58,44
36,r_140_52_34,r_12_71_129,seq24,r_12_71_129,0.95,4,133,129,44
2,r_0_142_136,r_58_14_75,r_111_113_52,r_0_142_136,1.0,-61,75,136,44
40,r_9_97_85,r_92_10_64,seq57,r_9_97_85,0.78,0,85,85,44
18,r_89_106_65,r_19_112_130,seq77,r_89_106_65,0.85,2,67,65,44
36,r_140_52_34,r_138_33_42,r_12_71_129,r_12_71_129,1.0,-95,34,129,44
25,r_58_14_75,r_0_142_136,r_15_68_7,r_58_14_75,1.0,0,75,75,44
32,r_49_45_99,seq136,seq40,r_49_45_99,0.57,20,119,99,44
38,r_64_54_80,seq43,r_88_63_19,r_88_63_19,0.57,64,83,19,44
75,seq57,seq83,r_9_97_85,r_9_97_85,0.99,37,122,85,44
4,r_116_36_123,r_127_28_172,r_139_87_147,r_127_28_172,1.0,0,172,172,44
17,r_11_73_112,r_141_80_190,r_21_137_28,r_11_73_112,0.58,0,112,112,44
9,r_5_61_73,r_92_10_64,seq3,r_5_61_73,0.96,0,73,73,44
41,r_88_63_19,seq129,seq31,r_88_63_19,0.97,0,19,19,44
5,r_138_33_42,seq3,seq24,r_138_33_42,1.0,0,42,42,44
16,r_111_113_52,r_21_137_28,r_0_142_136,r_111_113_52,1.0,1,53,52,44
22,r_44_34_171,seq83,r_72_145_29,r_72_145_29,0.49,147,176,29,44
28,r_42_6_176,seq83,r_9_97_85,r_9_97_85,1.0,91,176,85,44
49,r_127_28_172,r_92_10_64,r_116_36_123,r_116_36_123,0.81,19,142,123,44
23,r_82_22_60,seq57,seq25,r_82_22_60,1.0,1,61,60,44
49,r_127_28_172,r_116_36_123,r_94_104_167,r_127_28_172,1.0,0,172,172,44
35,r_2_38_186,r_141_80_190,r_91_93_68,r_91_93_68,0.89,118,186,68,44
12,r_66_59_128,seq25,r_0_142_136,r_66_59_128,0.94,1,129,128,44
30,r_128_7_105,r_139_21_107,r_12_81_60,r_12_81_60,1.0,45,105,60,45
36,r_2_35_168,seq65,r_14_119_129,r_2_35_168,0.59,0,168,168,45
9,r_43_118_30,r_144_120_164,r_14_119_129,r_14_119_129,0.65,-1,128,129,45
16,r_47_44_27,r_14_119_129,seq134,r_47_44_27,1.0,0,27,27,45
14,r_114_39_156,r_13_74_22,seq63,r_114_39_156,0.97,0,156,156,45
8,r_0_69_71,seq105,seq80,r_0_69_71,0.99,-3,68,71,45
10,r_88_5_40,r_141_94_175,r_82_40_16,r_88_5_40,0.91,0,40,40,45
43,r_1_3_181,r_141_94_175,r_60_93_87,r_60_93_87,0.98,88,175,87,45
26,r_55_46_55,r_24_79_172,seq105,r_55_46_55,1.0,0,55,55,45
39,r_103_37_66,seq23,seq148,r_103_37_66,1.0,-1,65,66,45
5,r_96_68_65,r_86_130_123,seq127,r_96_68_65,0.97,0,65,65,45
46,r_145_136_103,r_2_35_168,r_43_118_30,r_43_118_30,1.0,80,110,30,45
42,r_51_73_70,r_14_119_129,r_30_15_10,r_51_73_70,0.95,1,71,70,45
27,r_144_120_164,r_43_118_30,r_55_46_55,r_144_120_164,0.43,4,168,164,45
11,r_8_59_51,r_107_87_20,r_61_117_196,r_8_59_51,0.99,1,52,51,45
31,r_48_131_157,seq66,r_55_46_55,r_55_46_55,1.0,113,168,55,45
41,r_137_57_161,seq22,seq78,r_137_57_161,0.52,0,161,161,45
90,seq106,r_64_95_83,seq9,r_64_95_83,1.0,-1,82,83,45
4,r_14_119_129,seq78,r_43_118_30,r_43_118_30,1.0,101,131,30,45
20,r_111_53_117,r_28_71_18,r_31_32_37,r_31_32_37,1.0,84,121,37,45
15,r_64_95_83,seq106,seq140,r_64_95_83,1.0,0,83,83,45
74,seq63,r_36_133_50,r_114_39_156,r_114_39_156,1.0,7,163,156,45
99,seq127,seq6,r_96_68_65,r_96_68_65,1.0,18,83,65,45
34,r_12_81_60,r_67_77_99,seq54,r_12_81_60,0.65,-1,59,60,45
11,r_8_59_51,r_104_42_78,r_107_87_20,r_8_59_51,0.56,-33,18,51,45
40,r_146_108_26,r_60_93_87,seq109,r_60_93_87,0.63,-61,26,87,45
74,seq63,r_58_62_167,r_36_133_50,r_36_133_50,1.0,14,64,50,45
1,r_107_87_20,r_103_37_66,seq105,r_103_37_66,0.94,-44,22,66,45
24,r_135_142_111,seq80,seq98,r_135_142_111,0.99,0,111,111,45
7,r_82_40_16,r_139_21_107,seq22,r_82_40_16,0.68,0,16,16,45
68,seq134,seq9,r_47_44_27,r_47_44_27,1.0,0,27,27,45
21,r_110_4_24,seq123,seq18,r_110_4_24,1.0,0,24,24,45
23,r_31_32_37,seq113,seq26,r_31_32_37,1.0,-4,33,37,45
32,r_141_94_175,r_1_3_181,r_55_46_55,r_141_94_175,0.76,0,175,175,45
38,r_67_77_99,r_12_81_60,r_96_68_65,r_12_81_60,0.88,40,100,60,45
11,r_8_59_51,r_61_117_196,r_104_42_78,r_104_42_78,1.0,5,83,78,45
81,seq80,r_135_142_111,seq72,r_135_142_111,1.0,-30,81,111,45
9,r_43_118_30,r_61_117_196,r_144_120_164,r_43_118_30,1.0,-1,29,30,45
44,r_36_133_50,seq6,seq63,r_36_133_50,1.0,0,50,50,45
28,r_58_62_167,seq17,r_24_79_172,r_58_62_167,0.61,1,168,167,45
49,r_20_16_134,seq140,seq17,r_20_16_134,0.84,0,134,134,45
3,r_100_147_56,seq17,seq140,r_100_147_56,1.0,0,56,56,45
27,r_144_120_164,r_19_102_52,r_43_118_30,r_43_118_30,1.0,9,39,30,45
35,r_112_138_112,seq54,seq72,r_112_138_112,0.87,0,112,112,45
12,r_52_45_131,r_10_116_150,r_82_40_16,r_52_45_131,0.95,0,131,131,45
30,r_71_22_181,seq98,r_14_30_45,r_14_30_45,1.0,137,182,45,46
36,r_74_145_69,r_48_20_197,seq81,r_74_145_69,1.0,1,70,69,46
14,r_75_139_138,seq140,r_103_114_185,r_75_139_138,0.99,0,138,138,46
8,r_117_134_188,r_3_28_5,r_72_127_58,r_117_134_188,0.2,0,188,188,46
37,r_8_119_109,seq129,r_7_65_6,r_8_119_109,0.98,1,110,109,46
16,r_76_70_68,r_90_32_192,r_68_149_178,r_76_70_68,0.64,11,79,68,46
21,r_6_0_102,r_55_5_13,r_74_145_69,r_55_5_13,1.0,89,102,13,46
5,r_29_26_100,seq138,seq39,r_29_26_100,0.84,6,106,100,46
42,r_58_37_95,r_48_20_197,seq64,r_58_37_95,1.0,2,97,95,46
69,seq54,r_110_52_153,r_23_133_42,r_23_133_42,0.69,111,153,42,46
13,r_141_93_41,r_41_92_60,r_13_9_107,r_141_93_41,0.99,1,42,41,46
19,r_31_47_93,seq12,seq140,r_31_47_93,1.0,0,93,93,46
66,seq39,r_108_24_49,r_29_26_100,r_29_26_100,0.65,-1,99,100,46
7,r_103_114_185,r_34_143_123,r_50_100_46,r_50_100_46,0.99,5,51,46,46
31,r_38_4_65,r_29_26_100,seq98,r_38_4_65,1.0,1,66,65,46
90,seq106,r_90_32_192,r_76_70_68,r_76_70_68,0.77,111,179,68,46
28,r_35_94_33,r_75_139_138,seq121,r_35_94_33,1.0,0,33,33,46
26,r_34_143_123,r_103_114_185,seq106,r_34_143_123,0.9,3,126,123,46
16,r_76_70_68,r_68_149_178,seq106,r_68_149_178,0.58,0,178,178,46
4,r_41_92_60,r_48_20_197,seq130,r_41_92_60,0.98,0,60,60,46
20,r_25_142_144,seq1,r_66_59_124,r_25_142_144,0.98,3,147,144,46
48,r_79_115_162,r_71_22_181,r_72_127_58,r_79_115_162,0.87,0,162,162,46
6,r_44_67_140,seq126,seq57,r_44_67_140,0.98,0,140,140,46
33,r_95_136_23,r_108_24_49,seq81,r_95_136_23,0.72,-2,21,23,46
49,r_84_120_15,r_31_47_93,seq18,r_84_120_15,0.99,-3,12,15,46
47,r_27_135_94,seq43,seq63,r_27_135_94,0.56,4,98,94,46
40,r_146_53_172,seq63,seq140,r_146_53_172,0.48,3,175,172,46
18,r_66_59_124,seq61,r_38_4_65,r_38_4_65,0.93,59,124,65,46
29,r_107_104_116,seq131,r_137_132_10,r_107_104_116,0.95,1,117,116,46
25,r_144_80_167,seq126,r_66_59_124,r_144_80_167,0.83,1,168,167,46
24,r_10_109_19,seq128,seq17,r_10_109_19,0.54,0,19,19,46
41,r_45_42_50,seq15,seq89,r_45_42_50,1.0,0,50,50,46
17,r_148_56_129,r_144_80_167,r_10_109_19,r_148_56_129,0.8,3,132,129,46
12,r_14_30_45,r_72_127_58,seq91,r_14_30_45,1.0,0,45,45,46
27,r_105_51_53,r_41_92_60,seq63,r_105_51_53,1.0,0,53,53,46
22,r_68_149_178,r_76_70_68,r_72_127_58,r_72_127_58,0.53,120,178,58,46
44,r_83_124_165,r_117_134_188,r_105_51_53,r_105_51_53,1.0,112,165,53,46
23,r_97_19_63,r_44_67_140,r_137_132_10,r_97_19_63,0.83,3,66,63,46
35,r_110_52_153,seq54,r_72_127_58,r_110_52_153,0.9,0,153,153,46
43,r_50_100_46,r_29_26_100,r_103_114_185,r_50_100_46,1.0,2,48,46,46
32,r_23_133_42,r_113_60_195,seq15,r_23_133_42,1.0,0,42,42,46
30,r_142_115_82,seq94,seq82,r_142_115_82,1.0,0,82,82,47
36,r_137_63_81,r_140_71_130,r_65_14_65,r_65_14_65,0.99,14,79,65,47
43,r_59_141_170,r_57_81_190,r_84_21_3,r_84_21_3,0.76,170,173,3,47
45,r_90_52_13,r_38_24_35,r_69_143_176,r_69_143_176,0.94,-162,14,176,47
16,r_83_60_172,seq2,seq109,r_83_60_172,0.53,0,172,172,47
46,r_135_126_143,seq53,r_9_22_127,r_9_22_127,0.73,18,145,127,47
42,r_76_20_124,seq92,r_90_52_13,r_76_20_124,0.86,1,125,124,47
19,r_32_12_72,seq82,r_89_55_63,r_32_12_72,0.98,1,73,72,47
1,r_132_0_18,r_73_148_84,r_131_17_17,r_132_0_18,0.4,7,25,18,47
38,r_78_101_11,r_93_144_179,r_57_81_190,r_78_101_11,0.99,1,12,11,47
41,r_89_55_63,r_129_79_163,r_32_12_72,r_89_55_63,0.99,13,76,63,47
3,r_140_71_130,r_83_60_172,r_26_66_60,r_83_60_172,0.93,-42,130,172,47
26,r_44_97_91,seq147,seq18,r_44_97_91,0.99,1,92,91,47
99,seq127,r_140_71_130,r_131_17_17,r_131_17_17,1.0,-6,11,17,47
4,r_9_22_127,r_93_144_179,r_73_148_84,r_9_22_127,0.8,0,127,127,47
0,r_119_6_90,r_33_51_145,seq92,r_33_51_145,0.55,-55,90,145,47
5,r_38_24_35,r_87_41_93,seq100,r_38_24_35,1.0,0,35,35,47
11,r_87_41_93,seq149,seq54,r_87_41_93,0.77,1,94,93,47
20,r_80_98_146,seq117,r_65_14_65,r_80_98_146,0.89,4,150,146,47
48,r_34_123_85,r_129_79_163,seq117,r_34_123_85,0.96,0,85,85,47
6,r_99_37_121,seq112,r_38_24_35,r_99_37_121,0.97,1,122,121,47
27,r_50_95_160,seq54,r_11_47_167,r_50_95_160,0.42,11,171,160,47
87,seq100,seq147,r_10_104_105,r_10_104_105,1.0,5,110,105,47
40,r_145_75_195,r_13_88_100,r_30_118_58,r_145_75_195,0.99,-138,57,195,47
2,r_121_61_109,r_80_98_146,seq107,r_121_61_109,0.82,4,113,109,47
18,r_10_104_105,seq35,seq100,r_10_104_105,0.98,0,105,105,47
29,r_129_79_163,r_50_95_160,r_38_24_35,r_50_95_160,0.75,3,163,160,47
15,r_131_17_17,r_57_81_190,seq127,r_131_17_17,0.91,1,18,17,47
24,r_120_67_68,r_87_41_93,seq46,r_120_67_68,0.73,-3,65,68,47
21,r_134_133_54,r_80_98_146,seq1,r_134_133_54,0.94,1,55,54,47
32,r_39_3_110,r_15_23_150,r_57_81_190,r_15_23_150,0.95,-40,110,150,47
34,r_7_114_178,seq1,r_65_14_65,r_7_114_178,0.5,0,178,178,47
45,r_90_52_13,r_69_143_176,r_76_20_124,r_76_20_124,0.87,53,177,124,47
17,r_130_108_171,r_5_45_147,seq18,r_5_45_147,0.8,24,171,147,47
9,r_65_14_65,r_142_115_82,seq136,r_65_14_65,1.0,0,65,65,47
31,r_26_66_60,seq136,r_140_71_130,r_140_71_130,0.9,5,135,130,47
22,r_15_23_150,r_130_108_171,r_74_116_25,r_130_108_171,0.67,-21,150,171,47
49,r_13_88_100,r_145_75_195,r_32_12_72,r_145_75_195,1.0,-96,99,195,47
13,r_30_118_58,seq106,r_145_75_195,r_30_118_58,1.0,-1,57,58,47
33,r_74_116_25,r_57_81_190,seq106,r_74_116_25,0.85,1,26,25,47
31,r_26_66_60,r_119_6_90,seq136,r_26_66_60,0.92,-3,57,60,47
85,seq94,r_65_14_65,r_90_52_13,r_65_14_65,0.83,-7,58,65,47
30,r_94_7_137,seq54,seq66,r_94_7_137,0.81,2,139,137,48
44,r_51_34_174,seq54,seq79,r_51_34_174,0.32,3,177,174,48
14,r_63_6_184,r_97_146_181,r_21_106_48,r_97_146_181,0.62,3,184,181,48
59,seq27,seq71,r_4_81_133,r_4_81_133,0.89,40,173,133,48
16,r_57_9_98,r_53_36_148,seq132,r_57_9_98,0.95,-1,97,98,48
21,r_17_46_69,r_0_65_177,seq26,r_17_46_69,1.0,1,70,69,48
39,r_68_136_160,r_8_105_161,r_59_35_79,r_8_105_161,0.68,-1,160,161,48
5,r_121_31_80,r_111_133_180,r_127_15_68,r_121_31_80,0.91,0,80,80,48
42,r_53_36_148,r_41_104_172,seq80,r_41_104_172,0.66,-22,150,172,48
45,r_111_133_180,seq101,r_18_144_66,r_111_133_180,0.5,0,180,180,48
10,r_1_129_55,r_47_56_195,seq42,r_1_129_55,0.91,-7,48,55,48
36,r_134_118_39,seq117,seq10,r_134_118_39,1.0,-1,38,39,48
40,r_60_55_38,seq73,r_92_83_81,r_60_55_38,1.0,0,38,38,48
31,r_14_108_138,r_0_65_177,r_61_30_87,r_61_30_87,0.55,52,139,87,48
89,seq100,r_41_104_172,seq32,r_41_104_172,1.0,0,172,172,48
3,r_22_40_112,r_39_124_115,seq115,r_22_40_112,0.69,8,120,112,48
26,r_24_123_153,seq26,r_64_20_17,r_24_123_153,0.6,2,155,153,48
2,r_64_20_17,r_60_55_38,r_3_131_194,r_64_20_17,0.74,-1,16,17,48
4,r_128_148_85,seq58,seq119,r_128_148_85,0.99,0,85,85,48
63,seq37,r_39_124_115,r_61_30_87,r_61_30_87,0.78,33,120,87,48
13,r_72_126_86,r_3_131_194,seq54,r_72_126_86,0.96,2,88,86,48
44,r_51_34_174,r_59_35_79,seq54,r_51_34_174,0.57,-116,58,174,48
15,r_92_83_81,seq103,r_60_55_38,r_60_55_38,0.99,68,106,38,48
48,r_28_70_78,seq42,seq140,r_28_70_78,0.78,-1,77,78,48
20,r_114_23_52,r_57_9_98,r_45_145_30,r_114_23_52,0.91,0,52,52,48
6,r_69_11_65,r_127_15_68,seq103,r_69_11_65,0.94,0,65,65,48
2,r_64_20_17,r_3_131_194,r_24_123_153,r_24_123_153,0.83,-1,152,153,48
9,r_25_112_53,r_69_11_65,seq95,r_25_112_53,0.89,0,53,53,48
47,r_127_15_68,seq19,r_121_31_80,r_127_15_68,0.66,20,88,68,48
18,r_8_105_161,seq103,r_21_106_48,r_21_106_48,0.53,124,172,48,48
29,r_59_35_79,r_51_34_174,seq73,r_59_35_79,0.77,-9,70,79,48
24,r_98_142_125,seq93,seq99,r_98_142_125,0.84,2,127,125,48
58,seq26,r_24_123_153,r_17_46_69,r_17_46_69,0.63,1,70,69,48
32,r_38_16_75,r_8_105_161,seq54,r_38_16_75,0.99,0,75,75,48
38,r_107_82_119,r_41_104_172,seq71,r_107_82_119,0.97,0,119,119,48
94,seq115,r_97_146_181,r_22_40_112,r_22_40_112,0.74,70,182,112,48
96,seq117,r_92_83_81,r_67_77_42,r_67_77_42,1.0,85,127,42,48
22,r_143_141_76,seq10,seq54,r_143_141_76,0.83,10,86,76,48
28,r_18_144_66,r_39_124_115,seq80,r_39_124_115,0.59,8,123,115,48
91,seq103,r_8_105_161,r_69_11_65,r_69_11_65,1.0,107,172,65,48
46,r_45_145_30,r_102_147_176,seq78,r_45_145_30,0.98,-2,28,30,48
49,r_61_30_87,seq99,seq37,r_61_30_87,0.98,1,88,87,48
8,r_21_106_48,seq13,r_125_88_21,r_21_106_48,0.99,-2,46,48,48
85,seq93,r_47_56_195,r_125_88_21,r_125_88_21,1.0,0,21,21,48
23,r_41_104_172,seq100,seq138,r_41_104_172,0.47,0,172,172,48
35,r_4_81_133,r_97_146_181,r_69_11_65,r_97_146_181,0.5,-48,133,181,48
11,r_67_77_42,r_102_147_176,seq117,r_67_77_42,0.99,0,42,42,48
19,r_125_88_21,r_85_50_23,seq93,r_125_88_21,0.74,0,21,21,48
30,r_117_22_61,seq111,seq82,r_117_22_61,0.92,1,62,61,49
36,r_124_29_149,seq53,r_16_27_83,r_16_27_83,0.75,66,149,83,49
14,r_112_119_86,r_135_76_87,seq30,r_112_119_86,0.95,5,91,86,49
37,r_113_13_124,r_69_3_119,seq2,r_69_3_119,0.59,6,125,119,49
34,r_20_10_36,r_134_45_37,r_137_62_199,r_20_10_36,0.96,6,42,36,49
80,seq70,r_97_49_190,r_146_148_123,r_146_148_123,0.99,3,126,123,49
5,r_132_99_22,r_69_3_119,r_73_17_47,r_132_99_22,0.9,3,25,22,49
19,r_80_89_60,seq142,seq127,r_80_89_60,0.95,0,60,60,49
31,r_7_54_120,r_91_50_140,r_83_106_98,r_7_54_120,0.66,0,120,120,49
41,r_9_93_117,seq64,r_86_87_56,r_9_93_117,0.52,3,120,117,49
45,r_68_5_20,seq90,seq67,r_68_5_20,0.78,1,21,20,49
26,r_34_18_100,r_69_3_119,r_19_58_49,r_34_18_100,1.0,1,101,100,49
4,r_41_63_26,r_146_148_123,seq78,r_41_63_26,1.0,1,27,26,49
0,r_16_27_83,seq70,r_55_37_23,r_16_27_83,0.64,8,91,83,49
11,r_86_87_56,seq24,r_97_49_190,r_86_87_56,0.66,4,60,56,49
99,seq127,r_59_11_63,r_80_89_60,r_80_89_60,0.97,46,106,60,49
8,r_55_37_23,r_75_14_174,seq121,r_55_37_23,0.89,2,25,23,49
27,r_6_95_66,r_102_141_197,r_55_37_23,r_6_95_66,1.0,0,66,66,49
42,r_140_23_39,r_77_122_85,r_137_62_199,r_140_23_39,0.63,2,41,39,49
18,r_77_122_85,seq92,seq40,r_77_122_85,0.94,4,89,85,49
24,r_48_100_160,seq130,r_77_122_85,r_77_122_85,1.0,76,161,85,49
10,r_81_125_19,r_55_37_23,seq138,r_81_125_19,0.72,3,22,19,49
25,r_75_14_174,seq142,r_81_125_19,r_81_125_19,0.78,158,177,19,49
33,r_44_103_183,seq40,r_146_148_123,r_146_148_123,0.53,60,183,123,49
68,seq40,r_91_50_140,r_134_45_37,r_134_45_37,0.54,104,141,37,49
61,seq21,r_25_52_198,r_19_58_49,r_19_58_49,0.63,14,63,49,49
32,r_25_52_198,seq21,r_31_33_7,r_31_33_7,0.87,160,167,7,49
38,r_120_145_76,seq51,r_55_37_23,r_120_145_76,1.0,0,76,76,49
44,r_134_45_37,r_20_10_36,seq40,r_20_10_36,0.73,6,42,36,49
11,r_86_87_56,r_97_49_190,r_9_93_117,r_86_87_56,0.72,62,118,56,49
17,r_4_101_176,seq127,seq98,r_4_101_176,0.5,0,176,176,49
43,r_73_17_47,seq36,r_132_99_22,r_132_99_22,0.99,3,25,22,49
49,r_118_39_30,r_55_37_23,seq78,r_118_39_30,1.0,0,30,30,49
28,r_114_85_175,seq74,r_31_33_7,r_31_33_7,0.52,169,176,7,49
7,r_32_43_159,seq121,seq139,r_32_43_159,0.48,1,160,159,49
23,r_19_58_49,r_120_145_76,seq21,r_120_145_76,1.0,-13,63,76,49
35,r_83_106_98,r_137_62_199,r_128_12_1,r_128_12_1,0.83,107,108,1,49
12,r_135_76_87,r_112_119_86,r_59_11_63,r_135_76_87,0.94,4,91,87,49
30,r_13_130_74,r_136_145_131,r_99_143_17,r_13_130_74,1.0,0,74,74,50
14,r_22_89_101,r_48_80_102,r_99_143_17,r_22_89_101,1.0,0,101,101,50
43,r_108_124_153,r_39_79_191,r_122_81_152,r_108_124_153,0.92,1,154,153,50
86,seq86,r_51_16_166,r_94_82_40,r_94_82_40,0.71,54,94,40,50
16,r_107_44_70,seq95,seq18,r_107_44_70,1.0,0,70,70,50
21,r_28_76_112,seq142,seq73,r_28_76_112,0.55,14,126,112,50
1,r_149_36_85,seq35,seq131,r_149_36_85,0.58,4,89,85,50
45,r_114_117_169,seq41,r_107_44_70,r_107_44_70,1.0,104,174,70,50
55,seq137,r_53_14_167,r_105_29_80,r_105_29_80,1.0,0,80,80,50
10,r_43_127_43,r_22_89_101,seq70,r_43_127_43,0.99,0,43,43,50
3,r_148_26_127,seq98,r_149_36_85,r_148_26_127,0.78,-2,125,127,50
26,r_0_3_176,seq31,r_33_103_15,r_0_3_176,0.7,0,176,176,50
35,r_120_128_42,seq137,seq135,r_120_128_42,1.0,0,42,42,50
18,r_118_62_52,seq137,r_10_27_6,r_118_62_52,1.0,0,52,52,50
20,r_102_144_106,seq131,r_72_134_79,r_102_144_106,0.98,0,106,106,50
13,r_105_29_80,r_122_81_152,seq137,r_105_29_80,1.0,0,80,80,50
98,seq123,r_112_106_172,r_125_56_123,r_125_56_123,1.0,18,141,123,50
11,r_94_82_40,r_107_44_70,seq86,r_94_82_40,1.0,0,40,40,50
15,r_91_49_68,r_39_79_191,seq142,r_91_49_68,1.0,0,68,68,50
6,r_46_37_185,seq74,r_0_3_176,r_0_3_176,0.73,12,188,176,50
55,seq137,r_118_62_52,r_53_14_167,r_118_62_52,0.96,0,52,52,50
2,r_53_14_167,seq21,r_107_44_70,r_107_44_70,0.77,102,172,70,50
29,r_75_147_94,seq32,r_122_81_152,r_75_147_94,1.0,0,94,94,50
25,r_78_87_98,seq123,seq131,r_78_87_98,1.0,0,98,98,50
33,r_48_80_102,r_22_89_101,seq54,r_22_89_101,1.0,0,101,101,50
88,seq90,r_136_145_131,r_1_140_146,r_136_145_131,1.0,0,131,131,50
32,r_1_140_146,r_17_63_197,r_118_62_52,r_118_62_52,1.0,111,163,52,50
38,r_68_9_88,r_46_37_185,r_60_93_7,r_68_9_88,0.89,0,88,88,50
4,r_19_77_21,seq92,seq7,r_19_77_21,0.97,0,21,21,50
17,r_85_30_69,r_99_143_17,r_28_76_112,r_85_30_69,1.0,0,69,69,50
9,r_116_2_63,seq97,seq74,r_116_2_63,1.0,0,63,63,50
28,r_132_50_92,seq54,seq67,r_132_50_92,1.0,0,92,92,50
49,r_72_134_79,r_99_143_17,seq41,r_72_134_79,0.84,3,82,79,50
23,r_121_119_82,r_114_117_169,seq38,r_121_119_82,0.82,0,82,82,50
31,r_45_42_19,r_116_2_63,seq95,r_45_42_19,0.99,0,19,19,50
12,r_125_56_123,r_39_79_191,seq123,r_125_56_123,0.99,0,123,123,50
8,r_11_83_13,r_46_37_185,seq73,r_11_83_13,1.0,0,13,13,50
30,r_17_47_150,r_39_19_189,r_136_120_56,r_17_47_150,0.52,30,180,150,51
36,r_96_59_97,r_134_109_152,r_144_100_31,r_134_109_152,0.91,-55,97,152,51
14,r_5_20_171,r_77_108_167,seq23,r_77_108_167,0.48,4,171,167,51
8,r_103_32_116,seq3,seq133,r_103_32_116,0.92,4,120,116,51
37,r_39_19_189,r_17_47_150,r_140_70_72,r_17_47_150,0.46,39,189,150,51
59,seq23,r_54_72_115,seq3,r_54_72_115,1.0,0,115,115,51
16,r_101_60_133,seq3,r_140_70_72,r_140_70_72,0.6,69,141,72,51
5,r_140_70_72,seq94,r_34_33_182,r_34_33_182,0.73,-91,91,182,51
46,r_0_83_160,r_148_42_191,r_123_110_122,r_123_110_122,1.0,50,172,122,51
42,r_145_128_100,r_101_60_133,r_76_12_46,r_145_128_100,0.99,0,100,100,51
22,r_129_126_59,r_0_83_160,seq24,r_0_83_160,0.62,-102,58,160,51
7,r_123_110_122,r_39_19_189,r_34_33_182,r_123_110_122,0.79,67,189,122,51
45,r_69_117_176,seq31,r_136_120_56,r_69_117_176,0.74,0,176,176,51
19,r_102_53_108,seq24,r_1_57_89,r_102_53_108,1.0,0,108,108,51
32,r_122_124_47,r_135_149_60,seq139,r_122_124_47,1.0,0,47,47,51
1,r_143_85_8,r_9_125_96,r_144_100_31,r_143_85_8,0.61,17,25,8,51
39,r_37_18_29,r_76_12_46,seq44,r_37_18_29,1.0,0,29,29,51
31,r_132_118_135,r_89_26_68,r_28_105_49,r_132_118_135,0.78,-75,60,135,51
3,r_77_108_167,r_5_20_171,r_135_149_60,r_5_20_171,0.49,0,171,171,51
4,r_138_91_99,r_39_19_189,seq64,r_138_91_99,0.54,4,103,99,51
0,r_148_42_191,r_0_83_160,r_77_108_167,r_148_42_191,0.32,-19,172,191,51
63,seq31,r_69_117_176,r_140_70_72,r_69_117_176,0.78,0,176,176,51
11,r_8_98_130,r_34_33_182,r_144_100_31,r_144_100_31,1.0,100,131,31,51
1,r_143_85_8,r_144_100_31,r_65_29_79,r_143_85_8,0.57,39,47,8,51
15,r_36_56_94,r_121_107_121,seq93,r_36_56_94,1.0,1,95,94,51
48,r_89_26_68,r_132_118_135,r_136_120_56,r_89_26_68,0.49,0,68,68,51
6,r_9_125_96,r_54_72_115,seq127,r_9_125_96,0.87,0,96,96,51
5,r_140_70_72,r_34_33_182,r_11_35_20,r_34_33_182,0.75,0,182,182,51
33,r_28_105_49,r_17_47_150,seq25,r_28_105_49,0.93,-3,46,49,51
27,r_43_115_137,seq141,r_113_15_123,r_43_115_137,0.84,0,137,137,51
2,r_30_40_142,seq90,r_28_105_49,r_30_40_142,0.4,0,142,142,51
47,r_54_72_115,seq23,r_76_12_46,r_54_72_115,0.92,0,115,115,51
29,r_21_86_90,seq58,seq25,r_21_86_90,0.9,-7,83,90,51
24,r_135_149_60,r_132_118_135,seq74,r_135_149_60,0.58,-10,50,60,51
25,r_121_107_121,r_67_50_37,seq3,r_121_107_121,0.43,11,132,121,51
13,r_136_120_56,seq133,seq61,r_136_120_56,0.72,-6,50,56,51
88,seq93,r_142_119_180,r_36_56_94,r_36_56_94,1.0,22,116,94,51
10,r_144_100_31,r_129_126_59,seq80,r_144_100_31,1.0,1,32,31,51
61,seq25,seq6,r_21_86_90,r_21_86_90,0.87,6,96,90,51
52,seq133,seq74,r_103_32_116,r_103_32_116,1.0,27,143,116,51
40,r_45_63_48,seq48,r_67_50_37,r_45_63_48,0.82,0,48,48,51
17,r_142_119_180,seq93,r_51_146_117,r_142_119_180,0.45,0,180,180,51
31,r_132_118_135,r_28_105_49,r_4_10_23,r_132_118_135,0.97,0,135,135,51
7,r_123_110_122,r_101_60_133,r_39_19_189,r_123_110_122,0.74,0,122,122,51
44,r_34_33_182,r_8_98_130,r_123_110_122,r_123_110_122,0.76,60,182,122,51
35,r_65_29_79,seq6,r_143_85_8,r_65_29_79,1.0,7,86,79,51
30,r_125_114_161,seq51,r_68_41_143,r_68_41_143,0.99,19,162,143,52
43,r_127_63_96,seq135,r_130_137_67,r_130_137_67,0.85,33,100,67,52
71,seq49,seq17,r_87_108_28,r_87_108_28,1.0,82,110,28,52
16,r_39_20_155,r_120_104_95,r_107_86_25,r_107_86_25,0.63,88,113,25,52
21,r_144_79_113,seq53,r_46_61_13,r_144_79_113,0.94,0,113,113,52
39,r_1_57_127,r_31_24_134,r_50_6_7,r_50_6_7,0.92,120,127,7,52
24,r_87_108_28,seq129,seq49,r_87_108_28,0.91,0,28,28,52
5,r_31_24_134,seq36,r_112_34_184,r_112_34_184,0.42,-46,138,184,52
46,r_48_28_64,seq11,seq135,r_48_28_64,1.0,3,67,64,52
45,r_140_82_186,seq15,r_32_116_17,r_32_116_17,0.61,169,186,17,52
19,r_19_103_128,r_31_24_134,r_130_137_67,r_19_103_128,0.57,4,132,128,52
49,r_54_96_26,r_68_41_143,seq109,r_54_96_26,1.0,1,27,26,52
31,r_73_56_115,r_91_90_137,r_67_84_27,r_67_84_27,0.91,88,115,27,52
41,r_91_90_137,seq4,seq71,r_91_90_137,0.85,5,142,137,52
10,r_16_29_65,r_18_141_199,seq59,r_16_29_65,1.0,2,67,65,52
74,seq53,r_33_12_192,r_72_149_11,r_72_149_11,0.99,0,11,11,52
0,r_100_44_102,seq59,seq36,r_100_44_102,0.88,0,102,102,52
11,r_3_147_81,r_31_24_134,r_48_28_64,r_48_28_64,0.84,21,85,64,52
99,seq121,r_46_61_13,r_120_104_95,r_120_104_95,0.63,5,100,95,52
1,r_46_61_13,seq148,seq58,r_46_61_13,0.62,3,16,13,52
20,r_123_128_107,seq136,r_8_99_98,r_8_99_98,0.95,11,109,98,52
13,r_37_143_157,seq136,r_134_122_51,r_37_143_157,0.41,4,161,157,52
48,r_93_13_86,seq131,r_87_108_28,r_93_13_86,0.56,2,88,86,52
57,seq136,r_123_128_107,r_107_86_25,r_107_86_25,0.88,84,109,25,52
6,r_69_62_131,seq88,r_8_99_98,r_69_62_131,0.84,1,132,131,52
2,r_105_126_116,seq22,r_102_95_60,r_105_126_116,0.75,1,117,116,52
18,r_120_104_95,r_39_20_155,seq121,r_39_20_155,0.52,-57,98,155,52
29,r_130_137_67,seq25,seq119,r_130_137_67,0.66,2,69,67,52
99,seq121,seq0,r_46_61_13,r_46_61_13,0.87,7,20,13,52
14,r_111_66_23,r_112_34_184,seq14,r_111_66_23,0.93,0,23,23,52
50,seq0,r_100_44_102,r_35_138_16,r_35_138_16,0.54,0,16,16,52
25,r_72_149_11,seq17,seq53,r_72_149_11,0.92,0,11,11,52
34,r_8_99_98,seq148,seq22,r_8_99_98,0.82,3,101,98,52
26,r_107_86_25,r_45_27_182,r_39_20_155,r_107_86_25,0.98,-1,24,25,52
47,r_124_115_58,r_120_104_95,r_102_95_60,r_124_115_58,0.98,1,59,58,52
26,r_107_86_25,r_39_20_155,seq59,r_39_20_155,0.76,0,155,155,52
95,seq109,r_30_146_178,r_54_96_26,r_54_96_26,0.94,29,55,26,52
28,r_60_78_163,r_118_75_177,seq53,r_118_75_177,0.63,2,179,177,52
16,r_39_20_155,r_107_86_25,r_67_84_27,r_39_20_155,0.55,0,155,155,52
23,r_70_26_118,seq132,r_113_2_9,r_70_26_118,0.94,0,118,118,52
12,r_118_75_177,r_60_78_163,r_39_20_155,r_118_75_177,0.35,2,179,177,52
2,r_86_24_27,r_30_111_32,seq149,r_86_24_27,0.78,-12,15,27,53
14,r_60_88_165,seq79,r_61_51_39,r_61_51_39,1.0,131,170,39,53
8,r_57_18_117,r_125_114_122,r_30_111_32,r_125_114_122,0.73,-4,118,122,53
43,r_3_89_184,seq15,r_59_38_112,r_3_89_184,0.58,0,184,184,53
37,r_0_109_155,seq124,r_76_43_94,r_76_43_94,1.0,61,155,94,53
21,r_25_5_113,seq132,r_61_51_39,r_61_51_39,1.0,89,128,39,53
39,r_62_148_139,seq8,r_65_96_103,r_62_148_139,0.87,0,139,139,53
66,seq33,r_72_126_126,r_65_96_103,r_65_96_103,0.91,30,133,103,53
31,r_82_142_146,r_36_77_149,r_72_126_126,r_82_142_146,0.93,2,148,146,53
10,r_128_108_123,seq145,seq41,r_128_108_123,0.98,0,123,123,53
26,r_55_50_83,seq6,seq123,r_55_50_83,1.0,0,83,83,53
72,seq136,r_92_117_101,r_47_94_69,r_47_94_69,1.0,2,71,69,53
9,r_61_51_39,r_91_35_185,seq102,r_61_51_39,1.0,0,39,39,53
0,r_91_35_185,seq145,r_86_24_27,r_86_24_27,0.53,160,187,27,53
11,r_47_94_69,seq27,seq136,r_47_94_69,1.0,0,69,69,53
13,r_28_7_81,seq32,seq13,r_28_7_81,1.0,0,81,81,53
15,r_76_43_94,r_128_108_123,r_92_117_101,r_92_117_101,0.61,-6,95,101,53
47,r_63_103_14,r_143_134_99,seq145,r_63_103_14,0.88,2,16,14,53
6,r_59_38_112,r_0_109_155,r_30_111_32,r_59_38_112,0.68,2,114,112,53
62,seq23,r_125_114_122,seq8,r_125_114_122,0.75,6,128,122,53
7,r_9_4_46,r_91_35_185,r_97_19_34,r_91_35_185,0.95,-138,47,185,53
40,r_125_114_122,seq23,seq132,r_125_114_122,0.71,5,127,122,53
5,r_56_146_10,seq101,seq78,r_56_146_10,0.68,0,10,10,53
24,r_14_147_136,seq13,seq2,r_14_147_136,0.93,1,137,136,53
25,r_58_131_143,r_91_35_185,seq13,r_58_131_143,0.83,1,144,143,53
88,seq102,r_92_117_101,r_61_51_39,r_61_51_39,1.0,3,42,39,53
27,r_10_34_47,r_54_81_45,r_105_22_6,r_10_34_47,0.99,2,49,47,53
17,r_1_21_29,r_65_96_103,r_115_120_118,r_1_21_29,0.96,1,30,29,53
61,seq149,r_49_45_93,r_86_24_27,r_49_45_93,0.96,0,93,93,53
28,r_54_81_45,seq132,r_61_51_39,r_61_51_39,0.96,15,54,39,53
34,r_49_45_93,seq149,r_30_111_32,r_49_45_93,0.74,0,93,93,53
1,r_84_80_28,r_3_89_184,seq100,r_84_80_28,0.99,-5,23,28,53
22,r_144_139_179,r_17_39_173,seq118,r_144_139_179,0.35,2,181,179,53
49,r_112_11_64,seq149,seq78,r_112_11_64,1.0,8,72,64,53
33,r_64_31_49,r_72_126_126,seq141,r_64_31_49,1.0,0,49,49,53
4,r_115_120_118,r_10_34_47,r_1_21_29,r_115_120_118,0.47,-85,33,118,53
23,r_138_20_107,r_36_77_149,r_30_111_32,r_36_77_149,0.71,-42,107,149,53
3,r_70_12_37,r_92_117_101,seq2,r_70_12_37,1.0,0,37,37,53
19,r_30_111_32,r_10_34_47,seq145,r_30_111_32,1.0,0,32,32,53
35,r_72_126_126,seq33,r_82_142_146,r_82_142_146,0.69,2,148,146,53
12,r_65_96_103,r_26_66_199,seq33,r_65_96_103,0.94,0,103,103,53
30,r_141_55_95,seq5,seq20,r_141_55_95,0.92,1,96,95,54
43,r_140_64_152,seq54,seq62,r_140_64_152,0.52,0,152,152,54
37,r_40_44_181,r_125_95_121,r_144_74_39,r_125_95_121,0.98,0,121,121,54
55,seq12,r_32_27_65,r_111_65_159,r_32_27_65,1.0,0,65,65,54
16,r_102_18_67,seq58,seq133,r_102_18_67,1.0,-6,61,67,54
39,r_125_95_121,r_40_44_181,seq19,r_125_95_121,0.84,0,121,121,54
42,r_67_93_151,r_132_137_2,seq12,r_67_93_151,0.93,0,151,151,54
80,seq72,r_60_99_143,r_50_130_29,r_60_99_143,0.85,0,143,143,54
9,r_106_81_153,r_57_10_31,seq54,r_106_81_153,0.48,-101,52,153,54
33,r_135_51_57,r_141_55_95,r_105_48_40,r_141_55_95,0.43,-38,57,95,54
44,r_131_116_59,r_97_59_76,seq22,r_131_116_59,0.57,-2,57,59,54
7,r_122_13_19,r_149_17_34,seq128,r_122_13_19,0.84,3,22,19,54
26,r_4_92_173,seq47,r_134_123_144,r_4_92_173,0.5,5,178,173,54
21,r_61_79_58,r_141_55_95,seq9,r_61_79_58,0.77,0,58,58,54
11,r_29_41_169,seq76,r_140_64_152,r_29_41_169,0.71,0,169,169,54
20,r_25_100_156,seq104,seq35,r_25_100_156,0.61,-1,155,156,54
13,r_111_65_159,r_87_15_100,r_88_89_84,r_111_65_159,1.0,-64,95,159,54
15,r_32_27_65,seq12,seq38,r_32_27_65,1.0,0,65,65,54
35,r_69_21_16,r_124_113_36,seq108,r_69_21_16,0.65,0,16,16,54
13,r_111_65_159,r_88_89_84,seq76,r_111_65_159,0.88,0,159,159,54
6,r_88_89_84,seq103,r_111_65_159,r_88_89_84,1.0,0,84,84,54
23,r_37_139_15,r_111_65_159,seq120,r_37_139_15,1.0,0,15,15,54
70,seq38,r_132_137_2,r_32_27_65,r_32_27_65,1.0,1,66,65,54
85,seq83,seq31,r_105_48_40,r_105_48_40,1.0,114,154,40,54
8,r_124_113_36,r_29_41_169,r_37_139_15,r_124_113_36,0.98,0,36,36,54
27,r_126_0_160,seq36,r_32_27_65,r_32_27_65,1.0,98,163,65,54
2,r_134_123_144,seq9,r_144_74_39,r_134_123_144,0.39,21,165,144,54
40,r_143_16_99,seq54,r_149_17_34,r_143_16_99,0.45,23,122,99,54
29,r_80_46_90,r_111_65_159,r_61_79_58,r_80_46_90,1.0,0,90,90,54
24,r_68_117_83,r_132_137_2,r_124_113_36,r_68_117_83,0.5,1,84,83,54
45,r_112_75_187,r_134_123_144,r_105_48_40,r_105_48_40,0.99,-1,39,40,54
6,r_88_89_84,r_111_65_159,r_67_93_151,r_67_93_151,0.98,8,159,151,54
1,r_14_145_23,r_126_0_160,seq148,r_14_145_23,0.99,1,24,23,54
38,r_129_85_142,seq108,r_119_71_30,r_119_71_30,0.99,113,143,30,54
53,seq9,r_134_123_144,r_61_79_58,r_61_79_58,1.0,1,59,58,54
34,r_8_66_118,r_60_99_143,r_122_13_19,r_8_66_118,0.47,0,118,118,54
45,r_112_75_187,r_105_48_40,r_14_145_23,r_105_48_40,0.41,149,189,40,54
22,r_6_33_174,seq20,r_111_65_159,r_6_33_174,0.71,0,174,174,54
10,r_86_42_56,seq35,seq58,r_86_42_56,0.94,-1,55,56,54
28,r_87_15_100,r_111_65_159,r_86_42_56,r_87_15_100,1.0,-1,99,100,54
49,r_7_63_104,seq146,r_105_48_40,r_105_48_40,0.94,59,99,40,54
14,r_45_138_38,seq38,seq54,r_45_138_38,0.76,-3,35,38,54
82,seq76,r_29_41_169,r_111_65_159,r_29_41_169,0.71,0,169,169,54
70,seq38,r_45_138_38,r_132_137_2,r_45_138_38,0.31,-3,35,38,54
55,seq12,r_111_65_159,r_67_93_151,r_67_93_151,0.84,0,151,151,54
30,r_146_107_164,r_65_87_14,r_31_113_42,r_65_87_14,0.77,148,162,14,55
51,seq1,r_10_66_179,r_31_113_42,r_31_113_42,0.75,127,169,42,55
36,r_95_25_153,r_133_129_183,r_51_97_35,r_95_25_153,0.46,1,154,153,55
14,r_10_66_179,seq1,r_95_25_153,r_95_25_153,0.61,25,178,153,55
18,r_58_29_39,r_67_84_69,r_56_78_195,r_56_78_195,1.0,-156,39,195,55
37,r_114_39_192,r_140_72_74,r_44_115_71,r_114_39_192,0.49,-117,75,192,55
19,r_2_63_186,r_76_130_7,r_94_104_56,r_94_104_56,0.78,131,187,56,55
16,r_38_33_185,r_142_91_189,r_114_39_192,r_114_39_192,0.69,-4,188,192,55
21,r_133_129_183,r_95_25_153,r_108_77_91,r_108_77_91,0.93,63,154,91,55
39,r_147_126_81,r_125_121_5,r_106_85_100,r_147_126_81,0.71,20,101,81,55
1,r_100_117_90,seq128,r_92_127_18,r_100_117_90,0.73,5,95,90,55
5,r_62_134_114,seq20,r_53_14_11,r_62_134_114,0.89,2,116,114,55
10,r_31_113_42,r_90_111_168,seq22,r_31_113_42,0.93,1,43,42,55
21,r_133_129_183,r_108_77_91,seq1,r_133_129_183,0.89,1,184,183,55
41,r_32_11_88,seq26,r_53_14_11,r_32_11_88,0.65,0,88,88,55
3,r_108_77_91,r_116_3_176,seq15,r_108_77_91,1.0,3,94,91,55
17,r_53_14_11,r_110_9_126,seq35,r_53_14_11,0.66,1,12,11,55
4,r_65_87_14,r_146_107_164,r_147_126_81,r_65_87_14,0.69,116,130,14,55
2,r_92_127_18,r_31_113_42,seq101,r_92_127_18,0.95,1,19,18,55
0,r_80_105_147,seq99,r_62_134_114,r_62_134_114,0.87,36,150,114,55
73,seq45,r_30_61_151,r_141_54_87,r_141_54_87,0.73,67,154,87,55
15,r_98_102_154,seq37,r_94_104_56,r_94_104_56,0.68,103,159,56,55
12,r_116_3_176,r_53_14_11,r_110_9_126,r_110_9_126,0.79,48,174,126,55
48,r_145_137_54,seq35,r_58_29_39,r_58_29_39,0.89,20,59,39,55
29,r_52_149_21,seq101,seq37,r_52_149_21,0.9,2,23,21,55
47,r_106_85_100,r_89_16_197,r_147_126_81,r_106_85_100,0.58,1,101,100,55
40,r_74_120_106,r_119_48_146,r_83_144_12,r_74_120_106,0.84,3,109,106,55
24,r_82_21_161,seq36,r_27_71_166,r_82_21_161,0.5,-32,129,161,55
25,r_44_115_71,r_119_48_146,r_114_39_192,r_44_115_71,1.0,4,75,71,55
38,r_132_17_36,seq136,seq23,r_132_17_36,0.99,0,36,36,55
33,r_141_54_87,r_10_66_179,seq20,r_141_54_87,1.0,9,96,87,55
34,r_27_71_166,seq23,r_58_29_39,r_58_29_39,1.0,131,170,39,55
9,r_119_48_146,r_95_25_153,r_80_105_147,r_80_105_147,0.62,1,148,147,55
31,r_76_130_7,r_2_63_186,r_100_117_90,r_100_117_90,0.9,97,187,90,55
22,r_30_61_151,seq45,r_31_113_42,r_30_61_151,0.76,3,154,151,55
28,r_67_84_69,seq15,r_83_144_12,r_67_84_69,1.0,6,75,69,55
49,r_140_72_74,seq6,seq128,r_140_72_74,0.98,1,75,74,55
44,r_135_43_122,seq70,r_147_126_81,r_147_126_81,0.87,47,128,81,55
23,r_4_86_70,r_10_66_179,r_106_85_100,r_4_86_70,0.74,3,73,70,55
12,r_116_3_176,r_108_77_91,r_53_14_11,r_116_3_176,0.72,-82,94,176,55
36,r_134_39_135,seq147,r_55_28_121,r_134_39_135,0.78,1,136,135,56
12,r_89_99_39,r_43_51_81,r_36_64_156,r_89_99_39,0.84,7,46,39,56
14,r_132_148_104,seq149,seq20,r_132_148_104,0.58,1,105,104,56
4,r_14_17_44,r_103_63_69,r_46_137_25,r_14_17_44,0.83,9,53,44,56
37,r_85_76_172,seq110,r_24_4_149,r_85_76_172,0.31,8,180,172,56
24,r_3_8_42,r_82_96_98,seq145,r_3_8_42,0.57,17,59,42,56
21,r_22_111_130,seq117,r_36_64_156,r_22_111_130,0.56,14,144,130,56
39,r_6_120_68,r_70_105_106,seq10,r_6_120_68,0.92,1,69,68,56
1,r_135_18_70,r_85_76_172,r_52_133_148,r_135_18_70,1.0,0,70,70,56
5,r_36_64_156,r_15_32_83,r_89_99_39,r_36_64_156,0.62,-84,72,156,56
45,r_45_92_158,seq130,seq83,r_45_92_158,0.63,0,158,158,56
3,r_93_35_180,seq44,r_15_32_83,r_15_32_83,0.87,100,183,83,56
10,r_102_127_150,r_129_12_163,r_103_63_69,r_102_127_150,0.55,0,150,150,56
16,r_104_78_51,r_70_105_106,r_140_58_46,r_70_105_106,0.86,-55,51,106,56
11,r_131_141_134,r_23_108_5,r_103_63_69,r_103_63_69,0.52,89,158,69,56
20,r_60_50_102,r_36_64_156,seq147,r_60_50_102,0.96,6,108,102,56
12,r_89_99_39,r_36_64_156,r_43_51_81,r_43_51_81,0.59,71,152,81,56
6,r_43_51_81,r_102_127_150,r_3_8_42,r_43_51_81,0.93,0,81,81,56
5,r_36_64_156,r_89_99_39,seq98,r_36_64_156,0.63,-4,152,156,56
33,r_140_58_46,r_45_92_158,r_94_49_33,r_140_58_46,1.0,0,46,46,56
2,r_103_63_69,r_118_53_100,seq37,r_103_63_69,0.79,3,72,69,56
47,r_128_124_169,r_122_16_147,r_84_42_183,r_122_16_147,0.78,11,158,147,56
40,r_129_12_163,seq7,seq80,r_129_12_163,0.55,0,163,163,56
18,r_73_25_140,r_85_76_172,r_71_121_27,r_73_25_140,0.25,18,158,140,56
25,r_70_105_106,r_52_133_148,seq7,r_70_105_106,0.99,0,106,106,56
38,r_9_40_84,r_60_50_102,seq0,r_60_50_102,0.83,-30,72,102,56
34,r_15_32_83,r_36_64_156,seq117,r_15_32_83,0.76,3,86,83,56
42,r_144_86_35,r_82_96_98,seq125,r_144_86_35,1.0,0,35,35,56
49,r_77_30_86,r_132_148_104,r_71_121_27,r_132_148_104,0.89,-17,87,104,56
7,r_118_53_100,seq142,seq79,r_118_53_100,0.8,4,104,100,56
44,r_109_68_82,seq81,r_9_40_84,r_109_68_82,0.68,-21,61,82,56
35,r_74_31_93,seq145,r_71_121_27,r_74_31_93,0.56,10,103,93,56
30,r_149_110_132,r_142_57_162,r_90_29_73,r_142_57_162,0.73,14,176,162,57
18,r_33_91_60,r_142_57_162,r_97_111_20,r_33_91_60,0.9,-1,59,60,57
36,r_22_48_83,r_21_40_74,seq123,r_21_40_74,0.59,-5,69,74,57
14,r_113_3_140,seq55,seq19,r_113_3_140,0.9,0,140,140,57
8,r_74_114_143,seq122,seq93,r_74_114_143,0.79,0,143,143,57
39,r_146_59_70,r_142_57_162,seq39,r_146_59_70,0.63,1,71,70,57
1,r_100_58_142,r_88_95_110,r_74_114_143,r_88_95_110,0.82,-1,109,110,57
5,r_90_29_73,r_80_8_105,seq69,r_80_8_105,1.0,-34,71,105,57
46,r_140_72_72,r_142_57_162,r_102_148_121,r_140_72_72,0.95,1,73,72,57
42,r_43_106_151,seq96,r_44_47_87,r_44_47_87,0.99,64,151,87,57
45,r_102_148_121,seq73,r_140_72_72,r_140_72_72,0.58,2,74,72,57
19,r_142_57_162,r_149_110_132,r_28_60_53,r_28_60_53,0.98,123,176,53,57
37,r_27_121_50,r_0_62_199,seq18,r_27_121_50,0.99,-9,41,50,57
46,r_140_72_72,r_102_148_121,r_34_133_91,r_140_72_72,0.67,49,121,72,57
16,r_61_136_30,r_85_117_81,seq135,r_61_136_30,0.72,-1,29,30,57
41,r_46_26_94,seq51,seq56,r_46_26_94,0.97,-1,93,94,57
21,r_76_99_18,r_49_105_136,seq39,r_76_99_18,0.76,2,20,18,57
10,r_2_65_182,r_126_10_80,r_14_82_66,r_2_65_182,0.85,-117,65,182,57
26,r_128_52_102,seq144,seq16,r_128_52_102,1.0,-1,101,102,57
9,r_127_138_39,r_113_3_140,r_17_143_183,r_127_138_39,0.89,0,39,39,57
78,seq78,seq83,r_89_77_86,r_89_77_86,0.95,-1,85,86,57
0,r_14_82_66,seq56,r_2_65_182,r_14_82_66,0.89,-1,65,66,57
11,r_34_133_91,r_88_95_110,seq55,r_34_133_91,0.96,-2,89,91,57
20,r_145_75_178,seq93,r_28_60_53,r_28_60_53,0.98,129,182,53,57
13,r_12_63_152,seq51,r_139_108_67,r_139_108_67,1.0,52,119,67,57
15,r_107_125_165,seq36,r_113_3_140,r_113_3_140,0.98,25,165,140,57
48,r_126_10_80,r_2_65_182,seq18,r_126_10_80,0.92,-1,79,80,57
6,r_89_77_86,r_17_143_183,seq78,r_89_77_86,0.77,-1,85,86,57
0,r_14_82_66,r_2_65_182,r_89_77_86,r_14_82_66,0.55,118,184,66,57
49,r_4_25_58,r_49_105_136,seq20,r_4_25_58,0.94,-1,57,58,57
10,r_2_65_182,r_14_82_66,r_90_29_73,r_2_65_182,0.48,2,184,182,57
28,r_41_134_19,r_7_98_49,seq56,r_41_134_19,0.57,-2,17,19,57
87,seq144,r_128_52_102,r_84_70_130,r_128_52_102,1.0,-16,86,102,57
2,r_85_117_81,seq86,r_41_134_19,r_85_117_81,1.0,0,81,81,57
7,r_28_60_53,r_12_63_152,seq135,r_28_60_53,0.99,-6,47,53,57
40,r_139_108_67,seq78,seq16,r_139_108_67,1.0,-3,64,67,57
29,r_5_1_71,r_85_117_81,r_127_138_39,r_127_138_39,0.78,30,69,39,57
45,r_102_148_121,r_140_72_72,seq13,r_102_148_121,0.99,0,121,121,57
24,r_137_35_141,r_142_57_162,seq79,r_142_57_162,0.98,-22,140,162,57
35,r_21_40_74,r_17_143_183,r_90_29_73,r_17_143_183,0.85,1,184,183,57
27,r_7_98_49,r_146_59_70,seq103,r_7_98_49,1.0,0,49,49,57
44,r_31_129_16,seq112,seq36,r_31_129_16,0.81,0,16,16,57
32,r_67_64_144,seq73,r_88_95_110,r_67_64_144,0.92,0,144,144,57
4,r_97_111_20,r_89_77_86,seq24,r_97_111_20,0.76,0,20,20,57
75,seq69,r_142_57_162,r_90_29_73,r_142_57_162,0.46,-93,69,162,57
9,r_127_138_39,r_17_143_183,r_5_1_71,r_127_138_39,0.86,46,85,39,57
31,r_49_105_136,r_4_25_58,r_12_63_152,r_4_25_58,0.9,-7,51,58,57
28,r_41_134_19,seq56,r_85_117_81,r_85_117_81,0.99,0,81,81,57
23,r_17_143_183,r_142_57_162,r_14_82_66,r_14_82_66,0.85,118,184,66,57
35,r_21_40_74,r_22_48_83,r_17_143_183,r_21_40_74,0.91,-1,73,74,57
12,r_88_95_110,r_100_58_142,r_27_121_50,r_88_95_110,0.86,0,110,110,57
84,seq93,r_145_75_178,r_74_114_143,r_74_114_143,0.9,39,182,143,57
5,r_32_102_48,seq0,r_31_134_189,r_32_102_48,0.93,3,51,48,58
14,r_80_53_56,r_1_121_164,seq48,r_80_53_56,0.59,85,141,56,58
8,r_56_66_177,seq50,r_19_116_2,r_19_116_2,0.64,177,179,2,58
53,seq133,r_145_8_165,r_32_102_48,r_32_102_48,0.52,105,153,48,58
45,r_11_70_19,r_142_105_37,r_113_67_132,r_11_70_19,0.79,0,19,19,58
16,r_98_141_98,r_87_128_198,r_19_116_2,r_98_141_98,0.39,22,120,98,58
69,seq41,r_36_104_124,r_69_5_41,r_69_5_41,0.57,62,103,41,58
30,r_30_10_44,seq27,r_16_14_38,r_30_10_44,0.98,0,44,44,58
18,r_69_5_41,r_32_102_48,seq41,r_69_5_41,0.71,2,43,41,58
36,r_113_67_132,r_30_10_44,r_11_70_19,r_113_67_132,0.91,-100,32,132,58
26,r_88_120_199,r_19_116_2,r_65_123_68,r_65_123_68,0.52,56,124,68,58
11,r_42_13_128,r_56_66_177,r_32_102_48,r_42_13_128,0.48,0,128,128,58
20,r_94_143_108,r_1_121_164,r_36_104_124,r_1_121_164,0.81,9,173,164,58
13,r_31_134_189,r_19_116_2,r_32_102_48,r_32_102_48,0.98,14,62,48,58
48,r_86_114_100,seq20,seq57,r_86_114_100,0.43,1,101,100,58
6,r_1_121_164,r_94_143_108,r_90_46_63,r_94_143_108,0.77,65,173,108,58
36,r_113_67_132,r_11_70_19,r_24_135_20,r_113_67_132,0.83,6,138,132,58
25,r_84_71_118,r_64_76_3,r_65_123_68,r_84_71_118,0.45,6,124,118,58
34,r_58_72_42,seq9,r_25_82_24,r_58_72_42,0.61,1,43,42,58
70,seq48,r_111_60_103,r_80_53_56,r_80_53_56,0.44,20,76,56,58
32,r_49_54_86,r_7_40_156,r_65_123_68,r_7_40_156,0.5,-64,92,156,58
44,r_142_105_37,seq52,seq137,r_142_105_37,0.98,0,37,37,58
55,seq9,r_58_72_42,seq144,r_58_72_42,0.52,15,57,42,58
45,r_11_70_19,r_113_67_132,seq27,r_11_70_19,0.58,119,138,19,58
9,r_65_123_68,r_36_104_124,r_88_120_199,r_36_104_124,0.61,-53,71,124,58
22,r_111_60_103,r_80_53_56,r_30_10_44,r_111_60_103,0.45,1,104,103,58
28,r_147_83_174,r_19_116_2,r_90_46_63,r_90_46_63,0.89,113,176,63,58
35,r_148_23_113,r_37_45_149,seq55,r_37_45_149,0.92,-32,117,149,58
12,r_146_140_112,r_87_128_198,r_86_114_100,r_146_140_112,0.53,8,120,112,58
30,r_63_47_192,r_145_51_148,r_131_65_17,r_131_65_17,0.79,43,60,17,59
33,r_144_146_154,r_95_94_104,seq85,r_144_146_154,0.95,1,155,154,59
36,r_108_83_152,r_36_128_112,seq56,r_108_83_152,0.59,10,162,152,59
8,r_75_59_78,r_10_53_86,seq121,r_75_59_78,1.0,1,79,78,59
43,r_145_51_148,r_63_47_192,r_110_61_19,r_110_61_19,0.74,131,150,19,59
49,r_70_68_53,r_140_5_162,r_62_17_25,r_70_68_53,0.71,2,55,53,59
39,r_49_99_58,r_114_58_159,seq20,r_49_99_58,0.93,2,60,58,59
16,r_119_19_26,r_15_4_180,r_33_35_22,r_15_4_180,0.68,-154,26,180,59
42,r_137_66_151,r_134_30_143,r_73_115_129,r_134_30_143,0.56,8,151,143,59
95,seq116,r_26_57_105,r_100_96_13,r_100_96_13,0.81,-2,11,13,59
35,r_120_0_51,r_125_143_184,r_62_17_25,r_120_0_51,0.85,0,51,51,59
19,r_134_30_143,seq133,seq54,r_134_30_143,0.7,8,151,143,59
31,r_106_147_178,seq56,r_73_115_129,r_106_147_178,0.32,2,180,178,59
17,r_62_17_25,r_15_4_180,r_70_68_53,r_70_68_53,0.72,2,55,53,59
41,r_138_13_43,seq142,seq44,r_138_13_43,0.86,42,85,43,59
3,r_73_115_129,seq121,r_39_91_99,r_39_91_99,0.51,30,129,99,59
10,r_125_143_184,seq25,r_140_5_162,r_125_143_184,0.26,0,184,184,59
1,r_34_3_12,r_73_115_129,seq142,r_34_3_12,0.68,1,13,12,59
0,r_140_5_162,r_14_18_38,r_48_88_197,r_140_5_162,0.4,2,164,162,59
11,r_42_21_140,r_105_60_193,r_92_2_199,r_92_2_199,0.52,-59,140,199,59
13,r_38_122_188,seq31,r_87_45_121,r_87_45_121,1.0,69,190,121,59
98,seq124,r_149_102_122,r_87_45_121,r_87_45_121,0.94,14,135,121,59
15,r_87_45_121,r_140_5_162,r_12_22_142,r_87_45_121,0.9,2,123,121,59
48,r_50_41_102,r_140_5_162,r_39_91_99,r_50_41_102,0.89,2,104,102,59
4,r_126_118_32,r_140_5_162,seq67,r_126_118_32,0.97,7,39,32,59
2,r_95_94_104,seq112,r_144_146_154,r_95_94_104,0.71,0,104,104,59
47,r_10_53_86,seq24,r_34_3_12,r_10_53_86,0.89,3,89,86,59
40,r_130_84_98,r_114_58_159,r_36_128_112,r_130_84_98,0.64,0,98,98,59
24,r_26_57_105,seq54,r_110_61_19,r_26_57_105,0.9,2,107,105,59
33,r_144_146_154,seq11,r_95_94_104,r_95_94_104,0.99,-4,100,104,59
21,r_74_129_34,r_75_59_78,r_110_61_19,r_74_129_34,0.79,3,37,34,59
52,seq133,r_134_30_143,r_36_128_112,r_134_30_143,0.65,8,151,143,59
34,r_12_22_142,seq46,r_87_45_121,r_87_45_121,0.89,25,146,121,59
75,seq56,r_106_147_178,r_108_83_152,r_108_83_152,0.62,28,180,152,59
32,r_141_71_30,r_75_59_78,r_36_128_112,r_141_71_30,0.95,6,36,30,59
18,r_100_96_13,r_140_5_162,seq116,r_100_96_13,0.65,-2,11,13,59
9,r_15_4_180,seq43,seq133,r_15_4_180,0.59,0,180,180,59
2,r_95_94_104,r_144_146_154,r_6_139_125,r_144_146_154,0.54,1,155,154,59
22,r_114_58_159,r_92_2_199,r_87_45_121,r_92_2_199,0.38,-37,162,199,59
28,r_149_102_122,seq124,r_105_60_193,r_105_60_193,0.76,-58,135,193,59
44,r_6_139_125,seq54,r_95_94_104,r_6_139_125,0.83,0,125,125,59
23,r_148_77_95,seq1,r_131_65_17,r_148_77_95,0.96,0,95,95,59
17,r_62_17_25,r_95_94_104,r_15_4_180,r_62_17_25,0.78,0,25,25,59
29,r_131_65_17,r_26_57_105,r_63_47_192,r_131_65_17,0.57,-2,15,17,59
36,r_50_26_157,seq69,r_86_120_8,r_50_26_157,0.77,6,163,157,60
14,r_34_40_161,r_112_19_147,r_119_54_17,r_34_40_161,0.83,-18,143,161,60
8,r_24_144_131,r_81_114_144,seq22,r_81_114_144,0.76,-3,141,144,60
46,r_2_49_12,r_70_51_75,r_146_7_171,r_2_49_12,0.95,-1,11,12,60
37,r_149_0_137,r_77_16_172,seq145,r_77_16_172,0.67,-35,137,172,60
39,r_117_90_82,r_132_46_170,seq25,r_117_90_82,1.0,-1,81,82,60
1,r_77_16_172,r_100_45_24,seq85,r_77_16_172,0.74,0,172,172,60
45,r_108_72_136,r_137_87_149,r_61_140_99,r_108_72_136,0.95,0,136,136,60
19,r_99_53_185,seq1,r_10_21_166,r_10_21_166,0.71,20,186,166,60
31,r_146_7_171,r_9_28_88,r_37_76_87,r_146_7_171,0.92,-84,87,171,60
41,r_4_66_175,r_134_128_196,r_104_111_130,r_4_66_175,0.57,3,178,175,60
25,r_119_54_17,r_80_138_116,r_34_40_161,r_119_54_17,0.93,0,17,17,60
10,r_103_118_187,r_134_128_196,r_10_21_166,r_10_21_166,0.91,21,187,166,60
26,r_81_114_144,r_134_128_196,r_112_19_147,r_134_128_196,0.84,-49,147,196,60
1,r_77_16_172,r_139_126_53,r_100_45_24,r_77_16_172,1.0,-145,27,172,60
4,r_35_18_178,r_134_128_196,r_62_36_190,r_134_128_196,0.56,-18,178,196,60
0,r_38_73_121,r_4_66_175,seq1,r_4_66_175,0.72,-47,128,175,60
16,r_110_11_56,r_146_7_171,seq52,r_110_11_56,0.97,1,57,56,60
11,r_10_21_166,seq8,seq95,r_10_21_166,0.54,0,166,166,60
20,r_148_84_127,r_42_17_159,r_37_76_87,r_148_84_127,0.8,3,130,127,60
46,r_2_49_12,r_146_7_171,r_148_84_127,r_2_49_12,0.55,159,171,12,60
15,r_61_140_99,r_99_53_185,seq25,r_61_140_99,1.0,0,99,99,60
48,r_137_87_149,r_70_51_75,seq69,r_137_87_149,0.77,2,151,149,60
49,r_100_45_24,r_77_16_172,r_132_46_170,r_100_45_24,0.62,148,172,24,60
6,r_75_141_74,r_148_84_127,r_119_54_17,r_75_141_74,0.91,0,74,74,60
62,seq30,r_146_7_171,seq85,r_146_7_171,1.0,-52,119,171,60
27,r_83_6_67,seq60,seq8,r_83_6_67,1.0,1,68,67,60
5,r_139_126_53,r_77_16_172,seq3,r_139_126_53,1.0,0,53,53,60
49,r_100_45_24,seq97,r_77_16_172,r_100_45_24,1.0,1,25,24,60
2,r_112_19_147,r_34_40_161,r_139_126_53,r_34_40_161,0.55,-14,147,161,60
47,r_9_28_88,r_146_7_171,seq25,r_9_28_88,1.0,-1,87,88,60
40,r_127_29_186,r_48_131_195,r_75_141_74,r_48_131_195,0.38,-9,186,195,60
74,seq60,r_83_6_67,seq30,r_83_6_67,0.82,1,68,67,60
24,r_27_13_59,seq52,seq39,r_27_13_59,0.58,6,65,59,60
32,r_86_120_8,r_70_51_75,seq101,r_86_120_8,0.72,5,13,8,60
33,r_132_46_170,seq55,r_100_45_24,r_100_45_24,0.97,149,173,24,60
13,r_82_92_35,r_80_138_116,r_48_131_195,r_82_92_35,0.99,0,35,35,60
14,r_34_40_161,r_119_54_17,seq5,r_34_40_161,1.0,0,161,161,60
38,r_37_76_87,r_61_140_99,r_2_49_12,r_37_76_87,1.0,1,88,87,60
25,r_119_54_17,r_34_40_161,r_56_91_109,r_119_54_17,0.86,144,161,17,60
67,seq39,seq20,r_27_13_59,r_27_13_59,0.99,-2,57,59,60
31,r_146_7_171,r_37_76_87,r_34_40_161,r_146_7_171,0.71,0,171,171,60
7,r_48_131_195,r_56_91_109,r_82_92_35,r_48_131_195,0.85,-160,35,195,60
22,r_136_67_94,r_80_138_116,r_14_142_146,r_136_67_94,0.76,-3,91,94,60
44,r_15_94_89,seq3,seq133,r_15_94_89,0.98,0,89,89,60
23,r_89_124_84,seq39,seq123,r_89_124_84,0.99,1,85,84,60
12,r_56_91_109,seq101,r_119_54_17,r_56_91_109,0.9,1,110,109,60
41,r_26_66_42,r_125_15_118,r_82_8_20,r_26_66_42,0.62,3,45,42,61
12,r_46_71_66,r_29_12_171,r_53_141_121,r_53_141_121,0.72,6,127,121,61
30,r_129_7_109,r_54_137_106,r_6_37_9,r_129_7_109,0.97,6,115,109,61
36,r_16_49_82,r_2_146_180,r_82_8_20,r_16_49_82,0.93,0,82,82,61
14,r_47_44_74,seq102,seq50,r_47_44_74,1.0,0,74,74,61
83,seq142,seq65,r_127_73_90,r_127_73_90,0.88,54,144,90,61
37,r_135_43_178,r_85_77_163,r_46_71_66,r_46_71_66,1.0,88,154,66,61
16,r_67_27_159,seq50,seq33,r_67_27_159,0.64,1,160,159,61
39,r_59_11_115,r_5_114_153,r_91_119_107,r_59_11_115,0.9,1,116,115,61
1,r_127_73_90,r_81_112_139,seq142,r_127_73_90,0.65,3,93,90,61
27,r_6_37_9,r_147_120_134,seq40,r_6_37_9,0.68,1,10,9,61
5,r_91_119_107,r_117_83_110,r_107_57_81,r_117_83_110,1.0,-2,108,110,61
33,r_103_97_35,r_3_138_166,seq14,r_103_97_35,0.96,3,38,35,61
46,r_4_60_34,r_148_61_187,seq87,r_4_60_34,1.0,1,35,34,61
45,r_81_112_139,r_127_73_90,r_91_119_107,r_127_73_90,0.72,52,142,90,61
19,r_32_128_148,seq50,r_88_93_22,r_32_128_148,0.64,0,148,148,61
66,seq30,r_53_141_121,r_127_73_90,r_53_141_121,0.78,4,125,121,61
31,r_104_21_190,seq48,r_91_119_107,r_91_119_107,1.0,83,190,107,61
3,r_88_93_22,r_69_126_108,r_82_8_20,r_88_93_22,0.84,1,23,22,61
10,r_64_115_91,r_118_22_10,seq133,r_64_115_91,1.0,0,91,91,61
26,r_5_114_153,r_63_17_189,r_127_73_90,r_5_114_153,0.78,1,154,153,61
0,r_69_126_108,seq65,seq140,r_69_126_108,0.92,0,108,108,61
20,r_99_139_168,seq58,seq74,r_99_139_168,0.44,0,168,168,61
13,r_34_23_125,r_148_61_187,r_6_37_9,r_34_23_125,0.89,5,130,125,61
15,r_105_31_62,r_79_52_193,r_82_8_20,r_105_31_62,1.0,0,62,62,61
48,r_28_41_127,seq33,seq65,r_28_41_127,0.81,3,130,127,61
49,r_29_12_171,r_46_71_66,r_136_9_53,r_46_71_66,0.72,106,172,66,61
6,r_39_10_124,r_99_139_168,r_64_115_91,r_99_139_168,1.0,-44,124,168,61
9,r_136_9_53,r_36_55_89,r_6_37_9,r_6_37_9,0.97,44,53,9,61
2,r_117_83_110,seq40,r_68_134_198,r_117_83_110,0.97,6,116,110,61
18,r_45_89_83,r_69_126_108,seq38,r_45_89_83,0.77,2,85,83,61
29,r_85_77_163,r_135_43_178,seq58,r_85_77_163,0.33,1,164,163,61
24,r_36_55_89,r_2_146_180,r_6_37_9,r_36_55_89,0.93,2,91,89,61
50,seq0,r_42_122_111,seq130,r_42_122_111,0.94,-10,101,111,61
28,r_82_8_20,r_117_83_110,seq24,r_82_8_20,0.9,2,22,20,61
34,r_42_122_111,seq0,seq25,r_42_122_111,0.97,0,111,111,61
11,r_147_120_134,r_105_31_62,seq142,r_147_120_134,0.38,-104,30,134,61
32,r_86_78_27,r_136_9_53,r_6_37_9,r_6_37_9,1.0,19,28,9,61
22,r_84_106_175,seq40,r_69_126_108,r_69_126_108,0.64,75,183,108,61
49,r_29_12_171,r_28_41_127,r_46_71_66,r_46_71_66,0.89,9,75,66,61
44,r_125_15_118,seq25,r_51_90_199,r_125_15_118,0.98,1,119,118,61
23,r_132_145_84,r_2_146_180,seq70,r_132_145_84,1.0,1,85,84,61
12,r_46_71_66,seq65,r_29_12_171,r_46_71_66,0.98,2,68,66,61
30,r_48_62_87,seq121,r_91_47_73,r_48_62_87,1.0,0,87,87,62
9,r_65_131_152,seq20,r_149_132_138,r_65_131_152,1.0,0,152,152,62
14,r_105_120_131,r_8_37_135,seq93,r_105_120_131,0.54,17,148,131,62
8,r_69_21_65,r_45_2_90,r_44_33_48,r_45_2_90,0.96,-20,70,90,62
53,seq135,r_31_143_171,r_38_142_75,r_31_143_171,0.55,-101,70,171,62
37,r_79_106_81,r_82_77_134,r_38_142_75,r_79_106_81,0.94,-1,80,81,62
16,r_138_90_62,seq86,seq34,r_138_90_62,1.0,0,62,62,62
21,r_91_47_73,r_83_123_167,seq40,r_91_47_73,1.0,-1,72,73,62
1,r_18_74_121,r_27_80_197,r_58_51_20,r_18_74_121,0.99,0,121,121,62
5,r_38_142_75,r_49_88_5,seq135,r_49_88_5,0.6,65,70,5,62
42,r_64_103_115,r_60_134_141,r_67_22_80,r_60_134_141,0.85,-26,115,141,62
19,r_112_26_179,r_96_107_195,r_63_12_175,r_112_26_179,0.49,1,180,179,62
26,r_92_110_64,r_38_142_75,seq75,r_92_110_64,0.88,-8,56,64,62
36,r_44_33_48,r_73_129_91,seq9,r_44_33_48,0.81,-4,44,48,62
31,r_73_129_91,r_83_123_167,r_8_37_135,r_8_37_135,0.73,-40,95,135,62
89,seq97,r_102_5_187,r_108_57_93,r_108_57_93,1.0,94,187,93,62
3,r_127_95_105,seq75,seq24,r_127_95_105,0.92,0,105,105,62
10,r_82_77_134,r_102_5_187,seq61,r_82_77_134,0.95,1,135,134,62
6,r_108_57_93,r_65_131_152,seq97,r_108_57_93,0.97,1,94,93,62
27,r_67_22_80,seq128,seq19,r_67_22_80,1.0,1,81,80,62
2,r_140_94_160,seq16,r_73_129_91,r_73_129_91,0.62,70,161,91,62
47,r_43_78_148,seq121,r_70_54_129,r_43_78_148,0.8,0,148,148,62
18,r_136_144_112,r_105_120_131,r_49_88_5,r_105_120_131,0.65,-6,125,131,62
24,r_60_134_141,r_4_115_191,r_49_88_5,r_60_134_141,0.87,0,141,141,62
25,r_11_10_123,seq76,r_84_39_199,r_11_10_123,0.99,2,125,123,62
33,r_133_71_165,seq24,seq85,r_133_71_165,0.77,0,165,165,62
38,r_81_32_120,r_70_54_129,r_48_62_87,r_48_62_87,1.0,33,120,87,62
60,seq19,seq24,r_67_22_80,r_67_22_80,1.0,2,82,80,62
81,seq68,r_100_117_98,seq53,r_100_117_98,1.0,0,98,98,62
17,r_149_132_138,seq40,seq122,r_149_132_138,0.88,1,139,138,62
41,r_104_125_24,r_100_117_98,r_8_37_135,r_100_117_98,0.83,-74,24,98,62
9,r_65_131_152,r_108_57_93,seq20,r_108_57_93,1.0,-23,70,93,62
22,r_147_17_132,seq122,r_45_2_90,r_45_2_90,1.0,54,144,90,62
28,r_83_123_167,seq61,r_38_142_75,r_83_123_167,0.6,3,170,167,62
29,r_145_15_23,seq29,seq98,r_145_15_23,1.0,1,24,23,62
49,r_100_117_98,seq68,seq34,r_100_117_98,0.99,0,98,98,62
7,r_70_54_129,r_82_77_134,r_91_47_73,r_70_54_129,1.0,1,130,129,62
44,r_45_2_90,seq0,seq128,r_45_2_90,1.0,1,91,90,62
12,r_4_115_191,r_60_134_141,r_45_2_90,r_45_2_90,0.87,51,141,90,62
30,r_108_11_67,seq52,r_77_70_145,r_108_11_67,1.0,1,68,67,63
51,seq129,r_95_136_83,seq36,r_95_136_83,0.54,0,83,83,63
31,r_96_144_39,r_40_28_192,seq130,r_96_144_39,1.0,0,39,39,63
8,r_77_70_145,r_109_2_132,r_69_98_77,r_69_98_77,0.9,55,132,77,63
41,r_37_82_43,r_59_14_87,seq145,r_59_14_87,0.73,-38,49,87,63
43,r_31_146_140,r_124_71_176,r_59_14_87,r_59_14_87,0.68,54,141,87,63
2,r_106_99_56,r_102_39_171,seq47,r_106_99_56,1.0,3,59,56,63
26,r_32_116_54,r_83_149_188,r_1_140_53,r_83_149_188,0.51,-133,55,188,63
16,r_75_90_68,seq145,seq15,r_75_90_68,1.0,0,68,68,63
21,r_16_10_85,seq22,seq128,r_16_10_85,0.9,0,85,85,63
39,r_63_73_103,seq132,seq128,r_63_73_103,0.99,2,105,103,63
1,r_69_98_77,seq53,r_106_99_56,r_69_98_77,0.7,0,77,77,63
46,r_55_13_118,r_43_38_193,r_131_141_88,r_43_38_193,0.82,-73,120,193,63
42,r_24_117_71,seq130,seq30,r_24_117_71,0.99,0,71,71,63
18,r_50_147_33,r_106_99_56,r_124_71_176,r_106_99_56,0.71,-21,35,56,63
45,r_119_120_75,r_18_27_144,r_75_90_68,r_119_120_75,0.83,11,86,75,63
24,r_0_72_169,r_4_100_60,seq17,r_0_72_169,0.99,2,171,169,63
14,r_67_97_44,r_74_34_194,seq44,r_67_97_44,1.0,5,49,44,63
3,r_59_14_87,r_31_146_140,r_75_90_68,r_59_14_87,0.73,1,88,87,63
10,r_68_126_96,r_77_70_145,r_6_25_57,r_68_126_96,0.89,1,97,96,63
0,r_115_105_139,seq145,seq137,r_115_105_139,0.85,0,139,139,63
11,r_6_25_57,r_40_28_192,seq86,r_6_25_57,1.0,7,64,57,63
13,r_46_60_97,r_0_72_169,seq22,r_0_72_169,0.95,-60,109,169,63
48,r_18_27_144,r_74_34_194,r_46_60_97,r_18_27_144,0.61,0,144,144,63
6,r_43_38_193,r_55_13_118,r_66_62_79,r_43_38_193,0.95,-73,120,193,63
27,r_66_62_79,r_46_60_97,seq52,r_66_62_79,0.88,0,79,79,63
30,r_108_11_67,r_77_70_145,r_80_21_128,r_108_11_67,1.0,78,145,67,63
8,r_77_70_145,r_69_98_77,r_4_100_60,r_77_70_145,0.98,0,145,145,63
47,r_4_100_60,seq36,r_0_72_169,r_4_100_60,1.0,1,61,60,63
40,r_124_71_176,r_31_146_140,r_50_147_33,r_124_71_176,0.78,-36,140,176,63
74,seq52,r_43_38_193,r_66_62_79,r_66_62_79,1.0,25,104,79,63
29,r_83_149_188,seq36,r_108_11_67,r_108_11_67,0.94,121,188,67,63
24,r_0_72_169,r_46_60_97,r_4_100_60,r_4_100_60,0.99,49,109,60,63
15,r_1_140_53,seq130,seq44,r_1_140_53,0.99,0,53,53,63
33,r_109_2_132,r_77_70_145,seq128,r_109_2_132,0.85,0,132,132,63
47,r_4_100_60,r_0_72_169,r_77_70_145,r_4_100_60,0.85,111,171,60,63
32,r_131_141_88,seq76,r_102_39_171,r_131_141_88,0.54,0,88,88,63
38,r_94_41_183,seq15,r_7_65_36,r_7_65_36,1.0,150,186,36,63
25,r_107_134_21,r_115_105_139,seq143,r_107_134_21,0.84,0,21,21,63
4,r_7_65_36,r_112_127_72,seq89,r_7_65_36,1.0,0,36,36,63
40,r_124_71_176,r_50_147_33,r_59_14_87,r_124_71_176,0.76,1,177,176,63
60,seq20,seq49,r_95_136_83,r_95_136_83,0.99,3,86,83,63
17,r_84_9_157,seq87,r_135_12_170,r_84_9_157,0.49,2,159,157,63
25,r_107_134_21,seq143,r_112_127_72,r_112_127_72,0.81,17,89,72,63
86,seq89,r_5_45_182,r_7_65_36,r_7_65_36,0.92,0,36,36,63
28,r_19_93_69,r_40_28_192,seq143,r_19_93_69,0.99,0,69,69,63
49,r_57_81_120,r_135_12_170,r_68_126_96,r_68_126_96,0.94,26,122,96,63
7,r_112_127_72,seq64,r_107_134_21,r_112_127_72,0.88,1,73,72,63
18,r_50_147_33,r_124_71_176,seq129,r_124_71_176,0.81,1,177,176,63
44,r_8_118_112,r_31_146_140,r_67_97_44,r_8_118_112,0.98,0,112,112,63
23,r_80_21_128,r_135_12_170,seq79,r_80_21_128,0.85,1,129,128,63
35,r_95_136_83,seq129,seq20,r_95_136_83,0.95,0,83,83,63
30,r_142_126_80,seq87,r_138_4_160,r_142_126_80,0.99,0,80,80,64
36,r_75_19_164,seq70,r_149_86_54,r_75_19_164,0.59,0,164,164,64
48,r_118_43_45,r_58_59_82,seq27,r_118_43_45,0.99,3,48,45,64
14,r_64_129_67,seq123,seq83,r_64_129_67,1.0,0,67,67,64
8,r_134_2_100,seq15,r_56_31_49,r_134_2_100,0.73,1,101,100,64
43,r_92_24_120,r_1_3_142,seq7,r_1_3_142,0.6,-22,120,142,64
54,seq12,r_58_59_82,r_32_67_62,r_32_67_62,0.72,20,82,62,64
16,r_138_4_160,r_35_98_147,r_61_148_105,r_138_4_160,0.9,-47,113,160,64
1,r_127_125_128,seq144,seq143,r_127_125_128,0.78,1,129,128,64
5,r_117_106_88,r_36_146_1,seq38,r_117_106_88,0.97,1,89,88,64
46,r_32_67_62,r_117_106_88,seq12,r_32_67_62,0.53,1,63,62,64
42,r_5_105_76,seq128,r_1_3_142,r_5_105_76,1.0,0,76,76,64
19,r_136_82_90,r_1_3_142,seq14,r_136_82_90,0.87,0,90,90,64
31,r_80_115_185,seq45,r_18_41_138,r_80_115_185,0.2,1,186,185,64
41,r_109_68_77,r_108_23_158,r_57_113_51,r_108_23_158,0.99,-81,77,158,64
89,seq95,r_94_133_10,r_56_31_49,r_56_31_49,0.69,16,65,49,64
10,r_72_0_79,r_134_2_100,r_149_86_54,r_72_0_79,0.68,1,80,79,64
72,seq45,r_80_115_185,r_119_89_123,r_119_89_123,0.89,63,186,123,64
26,r_145_60_42,r_61_148_105,r_149_86_54,r_149_86_54,0.59,-12,42,54,64
4,r_61_148_105,r_111_39_162,r_138_4_160,r_61_148_105,0.94,0,105,105,64
0,r_35_98_147,r_138_4_160,r_118_43_45,r_35_98_147,0.68,0,147,147,64
23,r_120_74_24,r_6_130_183,seq15,r_120_74_24,0.98,0,24,24,64
20,r_57_113_51,r_132_46_60,r_65_69_14,r_57_113_51,0.78,1,52,51,64
6,r_132_46_60,seq139,r_149_86_54,r_132_46_60,1.0,1,61,60,64
35,r_100_11_48,r_61_148_105,r_149_86_54,r_149_86_54,0.67,-5,49,54,64
2,r_119_89_123,seq147,seq21,r_119_89_123,0.74,0,123,123,64
41,r_109_68_77,r_57_113_51,r_108_23_158,r_108_23_158,0.95,-1,157,158,64
47,r_108_23_158,seq17,r_109_68_77,r_109_68_77,1.0,81,158,77,64
33,r_78_42_149,r_1_3_142,seq141,r_78_42_149,0.87,0,149,149,64
32,r_8_131_125,r_91_140_153,r_57_113_51,r_91_140_153,0.68,-28,125,153,64
12,r_13_40_20,r_96_33_134,seq66,r_13_40_20,0.92,-1,19,20,64
34,r_91_140_153,r_55_9_22,r_57_113_51,r_55_9_22,0.85,131,153,22,64
7,r_47_54_13,r_63_52_124,seq29,r_47_54_13,0.94,0,13,13,64
21,r_56_31_49,r_1_3_142,seq95,r_56_31_49,0.64,3,52,49,64
9,r_20_44_169,seq87,r_149_86_54,r_20_44_169,0.36,0,169,169,64
22,r_96_33_134,r_75_19_164,r_57_113_51,r_75_19_164,0.94,-30,134,164,64
49,r_137_16_110,r_63_52_124,r_47_54_13,r_47_54_13,0.79,97,110,13,64
56,seq14,seq83,r_136_82_90,r_136_82_90,0.98,10,100,90,64
44,r_76_90_114,seq143,seq10,r_76_90_114,0.85,3,117,114,64
29,r_65_69_14,r_119_89_123,seq15,r_65_69_14,0.9,1,15,14,64
84,seq83,seq14,r_64_129_67,r_64_129_67,1.0,2,69,67,64
30,r_84_50_143,seq45,r_72_34_13,r_84_50_143,0.52,2,145,143,65
36,r_14_15_167,seq10,r_121_113_11,r_121_113_11,0.58,163,174,11,65
14,r_115_143_65,r_99_130_116,seq117,r_115_143_65,0.4,0,65,65,65
37,r_36_6_145,seq138,r_87_5_129,r_36_6_145,0.67,1,146,145,65
21,r_65_126_77,seq51,seq27,r_65_126_77,0.87,0,77,77,65
39,r_136_129_122,seq60,r_28_122_8,r_28_122_8,0.83,125,133,8,65
5,r_140_56_173,seq12,r_18_31_172,r_18_31_172,0.34,-52,120,172,65
46,r_99_130_116,seq27,r_148_3_171,r_99_130_116,0.9,1,117,116,65
48,r_93_71_43,r_136_129_122,seq4,r_93_71_43,0.46,-2,41,43,65
45,r_106_134_138,r_14_15_167,r_148_3_171,r_106_134_138,0.91,1,139,138,65
27,r_11_141_27,r_78_48_41,seq91,r_11_141_27,0.58,0,27,27,65
73,seq60,r_136_129_122,r_110_144_36,r_110_144_36,1.0,1,37,36,65
31,r_25_73_130,r_96_75_157,seq19,r_25_73_130,0.49,2,132,130,65
41,r_18_31_172,r_49_40_196,r_20_43_131,r_18_31_172,0.63,0,172,172,65
10,r_2_85_90,seq91,seq66,r_2_85_90,0.79,1,91,90,65
26,r_87_5_129,seq33,seq10,r_87_5_129,1.0,0,129,129,65
7,r_88_103_62,r_13_35_194,seq46,r_88_103_62,0.92,-5,57,62,65
15,r_146_119_94,r_95_8_99,seq70,r_146_119_94,1.0,0,94,94,65
6,r_102_147_165,seq1,r_110_144_36,r_110_144_36,0.94,129,165,36,65
8,r_9_133_22,r_49_40_196,seq12,r_9_133_22,0.86,0,22,22,65
13,r_32_7_32,r_65_126_77,seq42,r_32_7_32,0.97,1,33,32,65
40,r_16_0_121,r_14_15_167,r_148_3_171,r_16_0_121,0.95,2,123,121,65
29,r_74_26_66,r_106_134_138,seq137,r_74_26_66,1.0,0,66,66,65
24,r_77_127_79,seq81,r_94_30_123,r_77_127_79,0.96,3,82,79,65
28,r_108_135_46,seq81,r_92_23_6,r_108_135_46,1.0,0,46,46,65
58,seq19,r_101_128_178,r_25_73_130,r_25_73_130,0.74,-14,116,130,65
32,r_109_29_113,seq70,seq123,r_109_29_113,0.43,21,134,113,65
38,r_95_8_99,r_146_119_94,seq17,r_146_119_94,0.61,0,94,94,65
1,r_78_48_41,seq89,seq45,r_78_48_41,1.0,0,41,41,65
44,r_37_111_88,r_102_147_165,r_92_23_6,r_37_111_88,1.0,0,88,88,65
23,r_39_24_158,r_94_30_123,r_97_142_2,r_39_24_158,0.68,1,159,158,65
35,r_58_52_89,r_87_5_129,seq89,r_58_52_89,1.0,0,89,89,65
17,r_110_144_36,r_13_35_194,seq60,r_110_144_36,1.0,0,36,36,65
30,r_4_8_161,seq64,r_115_99_60,r_115_99_60,0.88,111,171,60,66
36,r_148_16_6,seq135,r_42_72_44,r_42_72_44,0.8,33,77,44,66
32,r_122_118_39,r_140_73_169,seq137,r_122_118_39,0.97,7,46,39,66
92,seq107,r_117_27_151,seq103,r_117_27_151,1.0,0,151,151,66
14,r_96_32_163,r_87_13_175,r_40_124_121,r_87_13_175,0.72,-12,163,175,66
49,r_85_10_58,r_96_32_163,seq135,r_85_10_58,0.83,0,58,58,66
83,seq79,seq135,r_50_3_65,r_50_3_65,0.85,1,66,65,66
37,r_11_145_66,r_96_32_163,seq138,r_11_145_66,0.81,0,66,66,66
2,r_71_84_33,r_60_61_150,seq58,r_71_84_33,0.67,0,33,33,66
16,r_12_66_95,seq137,seq74,r_12_66_95,1.0,0,95,95,66
21,r_120_109_81,r_35_18_131,r_122_118_39,r_120_109_81,0.87,1,82,81,66
1,r_117_27_151,seq107,r_36_15_9,r_117_27_151,0.96,0,151,151,66
46,r_88_95_168,seq103,r_80_69_97,r_88_95_168,0.86,1,169,168,66
45,r_1_104_96,seq101,r_115_99_60,r_1_104_96,0.67,4,100,96,66
19,r_94_53_156,seq45,r_55_33_102,r_94_53_156,0.95,1,157,156,66
95,seq113,seq102,r_42_72_44,r_42_72_44,0.61,31,75,44,66
66,seq29,r_110_114_172,r_52_141_85,r_52_141_85,0.97,53,138,85,66
31,r_87_13_175,seq77,r_31_62_37,r_87_13_175,0.82,0,175,175,66
41,r_119_25_123,seq68,r_31_62_37,r_119_25_123,1.0,0,123,123,66
20,r_47_123_42,r_52_141_85,seq68,r_47_123_42,1.0,0,42,42,66
4,r_76_78_158,seq106,r_40_124_121,r_40_124_121,1.0,45,166,121,66
0,r_40_124_121,seq121,r_41_136_186,r_40_124_121,1.0,0,121,121,66
42,r_42_72_44,r_50_3_65,r_148_16_6,r_42_72_44,0.78,2,46,44,66
11,r_52_141_85,seq24,seq29,r_52_141_85,0.91,1,86,85,66
15,r_127_65_72,seq134,seq77,r_127_65_72,1.0,0,72,72,66
48,r_26_59_187,seq98,r_12_66_95,r_12_66_95,0.99,92,187,95,66
27,r_34_48_104,r_4_8_161,r_55_33_102,r_34_48_104,0.68,0,104,104,66
47,r_50_3_65,seq134,seq79,r_50_3_65,0.94,3,68,65,66
40,r_7_39_185,r_129_146_106,r_120_109_81,r_7_39_185,0.73,-77,108,185,66
18,r_60_61_150,r_80_69_97,r_36_15_9,r_36_15_9,0.61,146,155,9,66
25,r_5_89_140,r_80_69_97,r_149_86_118,r_149_86_118,1.0,24,142,118,66
33,r_129_146_106,r_7_39_185,seq98,r_129_146_106,0.9,2,108,106,66
38,r_54_92_78,r_9_126_196,seq0,r_54_92_78,0.95,3,81,78,66
34,r_49_111_133,r_26_59_187,r_31_62_37,r_26_59_187,0.98,-40,147,187,66
13,r_31_62_37,r_49_111_133,seq134,r_31_62_37,0.75,9,46,37,66
22,r_81_133_143,r_37_93_191,r_40_124_121,r_40_124_121,1.0,29,150,121,66
44,r_115_99_60,r_76_78_158,seq70,r_115_99_60,0.97,8,68,60,66
79,seq70,seq38,r_115_99_60,r_115_99_60,0.93,7,67,60,66
35,r_110_114_172,seq29,r_17_21_198,r_17_21_198,0.73,-26,172,198,66
12,r_149_86_118,r_87_13_175,r_105_100_181,r_149_86_118,0.63,1,119,118,66
40,r_93_76_177,r_136_26_30,seq66,r_136_26_30,0.7,147,177,30,67
30,r_68_149_109,seq88,seq31,r_68_149_109,1.0,0,109,109,67
83,seq66,r_60_131_169,r_8_73_129,r_60_131_169,1.0,2,171,169,67
37,r_120_39_158,r_93_76_177,r_97_35_88,r_120_39_158,0.59,0,158,158,67
49,r_136_26_30,seq3,r_89_80_36,r_136_26_30,0.99,1,31,30,67
21,r_134_142_81,r_113_57_102,r_116_67_58,r_116_67_58,0.98,23,81,58,67
1,r_127_74_18,seq18,seq122,r_127_74_18,1.0,0,18,18,67
46,r_86_51_183,seq108,r_147_140_61,r_147_140_61,1.0,123,184,61,67
69,seq146,r_50_92_104,r_12_143_196,r_50_92_104,1.0,0,104,104,67
45,r_12_143_196,r_82_78_145,seq146,r_82_78_145,0.98,11,156,145,67
73,seq45,r_19_107_48,r_115_99_12,r_115_99_12,1.0,6,18,12,67
19,r_82_78_145,r_12_143_196,r_105_71_114,r_82_78_145,0.59,1,146,145,67
42,r_116_67_58,r_106_70_4,seq33,r_116_67_58,1.0,0,58,58,67
15,r_139_100_80,seq10,r_111_141_144,r_111_141_144,1.0,5,149,144,67
31,r_49_135_99,r_86_51_183,r_21_0_8,r_49_135_99,1.0,0,99,99,67
41,r_27_103_82,seq48,seq122,r_27_103_82,1.0,0,82,82,67
40,r_93_76_177,r_118_58_92,r_136_26_30,r_136_26_30,0.62,2,32,30,67
39,r_89_80_36,r_97_35_88,r_136_26_30,r_136_26_30,0.99,10,40,30,67
4,r_1_63_60,r_97_35_88,seq7,r_1_63_60,0.97,2,62,60,67
0,r_118_58_92,r_120_39_158,r_19_107_48,r_118_58_92,1.0,1,93,92,67
20,r_105_71_114,seq125,r_112_126_98,r_112_126_98,1.0,19,117,98,67
15,r_139_100_80,seq90,seq10,r_139_100_80,0.97,0,80,80,67
13,r_94_55_13,r_53_85_26,r_8_73_129,r_94_55_13,0.88,3,16,13,67
8,r_101_14_52,r_44_46_127,r_6_77_15,r_101_14_52,0.79,5,57,52,67
2,r_147_140_61,r_60_131_169,r_101_14_52,r_147_140_61,1.0,2,63,61,67
47,r_15_11_139,seq45,r_97_35_88,r_15_11_139,0.97,0,139,139,67
29,r_60_131_169,seq66,r_118_58_92,r_60_131_169,0.75,2,171,169,67
23,r_128_2_16,r_136_26_30,r_19_107_48,r_128_2_16,1.0,1,17,16,67
25,r_54_123_184,r_53_85_26,r_50_92_104,r_50_92_104,1.0,80,184,104,67
33,r_50_92_104,seq146,seq43,r_50_92_104,1.0,0,104,104,67
64,seq28,r_15_11_139,r_91_104_11,r_15_11_139,0.79,-53,86,139,67
32,r_112_126_98,seq40,r_89_80_36,r_112_126_98,1.0,0,98,98,67
17,r_97_35_88,seq98,seq132,r_97_35_88,0.84,9,97,88,67
18,r_91_104_11,seq88,seq28,r_91_104_11,0.99,0,11,11,67
27,r_6_77_15,r_128_2_16,seq98,r_6_77_15,0.98,1,16,15,67
9,r_72_129_90,seq95,r_101_14_52,r_72_129_90,0.51,3,93,90,67
22,r_44_46_127,seq4,seq10,r_44_46_127,0.99,0,127,127,67
28,r_62_23_141,seq5,r_116_67_58,r_116_67_58,1.0,83,141,58,67
56,seq10,r_133_61_194,r_44_46_127,r_44_46_127,0.98,1,128,127,67
7,r_16_130_62,r_54_123_184,r_128_2_16,r_16_130_62,1.0,3,65,62,67
44,r_113_57_102,seq65,r_101_14_52,r_113_57_102,0.6,2,104,102,67
6,r_115_99_12,r_72_129_90,seq45,r_115_99_12,0.86,0,12,12,67
35,r_111_141_144,seq45,r_139_100_80,r_111_141_144,0.68,0,144,144,67
12,r_37_29_168,r_75_96_143,r_119_34_43,r_37_29_168,0.63,0,168,168,67
48,r_38_81_51,r_101_14_52,seq43,r_38_81_51,1.0,0,51,51,67
36,r_75_0_183,seq131,seq28,r_75_0_183,0.35,0,183,183,68
14,r_100_38_114,seq118,r_35_14_126,r_100_38_114,0.99,2,116,114,68
53,seq6,r_104_87_188,r_129_116_198,r_104_87_188,0.81,0,188,188,68
43,r_128_65_174,seq139,seq9,r_128_65_174,0.73,0,174,174,68
20,r_31_141_40,r_110_64_107,seq3,r_31_141_40,1.0,0,40,40,68
1,r_70_122_141,seq107,r_126_109_6,r_126_109_6,0.69,135,141,6,68
42,r_1_17_179,seq53,r_35_14_126,r_1_17_179,0.52,0,179,179,68
45,r_77_78_22,r_47_149_18,seq43,r_77_78_22,0.99,0,22,22,68
95,seq118,r_100_38_114,r_74_23_14,r_100_38_114,0.83,2,116,114,68
41,r_115_7_110,seq60,r_35_14_126,r_115_7_110,1.0,6,116,110,68
10,r_16_73_96,seq50,r_83_68_180,r_16_73_96,1.0,1,97,96,68
26,r_13_98_88,seq9,r_126_109_6,r_13_98_88,0.91,0,88,88,68
3,r_22_21_19,r_35_14_126,r_20_144_12,r_22_21_19,1.0,-1,18,19,68
4,r_46_91_120,seq4,r_63_32_7,r_46_91_120,0.71,0,120,120,68
39,r_95_25_30,r_47_149_18,seq34,r_95_25_30,1.0,1,31,30,68
13,r_15_120_153,seq117,r_26_19_133,r_26_19_133,0.96,23,156,133,68
46,r_147_82_58,r_8_84_97,seq76,r_147_82_58,1.0,0,58,58,68
12,r_26_19_133,r_72_55_49,r_77_78_22,r_26_19_133,1.0,1,134,133,68
28,r_56_132_36,r_147_82_58,r_63_32_7,r_56_132_36,1.0,1,37,36,68
11,r_97_48_48,r_24_18_103,seq4,r_97_48_48,1.0,1,49,48,68
27,r_106_62_64,r_110_64_107,r_22_21_19,r_106_62_64,1.0,0,64,64,68
34,r_146_148_37,r_89_49_74,seq96,r_89_49_74,1.0,3,77,74,68
37,r_72_55_49,r_47_149_18,r_26_19_133,r_72_55_49,0.6,0,49,49,68
49,r_123_105_44,r_51_145_169,seq125,r_123_105_44,0.95,1,45,44,68
47,r_135_36_87,seq27,r_147_82_58,r_147_82_58,0.92,31,89,58,68
40,r_24_18_103,seq125,r_83_68_180,r_24_18_103,1.0,0,103,103,68
18,r_90_101_106,seq107,r_97_48_48,r_90_101_106,0.98,2,108,106,68
5,r_20_144_12,r_97_48_48,r_47_149_18,r_47_149_18,0.71,-8,10,18,68
19,r_89_49_74,r_146_148_37,r_138_58_15,r_89_49_74,1.0,0,74,74,68
12,r_26_19_133,r_41_133_99,r_72_55_49,r_26_19_133,0.62,-78,55,133,68
24,r_61_45_136,seq39,r_126_109_6,r_126_109_6,0.79,130,136,6,68
32,r_41_133_99,r_138_58_15,r_123_105_44,r_41_133_99,1.0,1,100,99,68
81,seq76,r_40_92_122,r_147_82_58,r_147_82_58,1.0,71,129,58,68
17,r_102_10_172,r_8_84_97,r_110_64_107,r_8_84_97,0.51,75,172,97,68
37,r_72_55_49,r_26_19_133,seq50,r_26_19_133,1.0,1,134,133,68
22,r_108_111_157,seq39,r_52_88_144,r_108_111_157,0.63,0,157,157,68
34,r_146_148_37,r_47_149_18,r_89_49_74,r_146_148_37,0.92,0,37,37,68
51,seq3,seq131,r_31_141_40,r_31_141_40,1.0,12,52,40,68
7,r_52_88_144,seq121,seq113,r_52_88_144,0.96,1,145,144,68
44,r_119_67_61,r_5_80_134,seq142,r_119_67_61,0.69,7,68,61,68
23,r_138_58_15,r_41_133_99,r_89_49_74,r_138_58_15,0.88,85,100,15,68
16,r_112_66_29,r_108_111_157,r_63_32_7,r_112_66_29,1.0,2,31,29,68
79,seq139,r_128_65_174,r_147_82_58,r_147_82_58,1.0,96,154,58,68
19,r_89_49_74,r_5_80_134,r_146_148_37,r_146_148_37,0.99,0,37,37,68
35,r_30_140_80,r_24_18_103,r_74_23_14,r_30_140_80,1.0,0,80,80,68
38,r_71_42_56,r_110_64_107,seq107,r_71_42_56,0.8,2,58,56,68
93,seq108,seq58,r_37_64_94,r_37_64_94,0.71,-8,86,94,69
30,r_59_112_82,r_23_30_125,seq35,r_59_112_82,0.91,2,84,82,69
23,r_133_39_38,seq20,seq16,r_133_39_38,1.0,0,38,38,69
36,r_148_51_137,seq149,r_83_102_14,r_148_51_137,1.0,0,137,137,69
8,r_135_33_86,r_32_138_144,seq96,r_32_138_144,0.67,-51,93,144,69
43,r_48_117_123,r_56_75_188,r_105_44_68,r_56_75_188,0.96,-65,123,188,69
37,r_37_64_94,r_106_6_184,seq108,r_37_64_94,0.79,8,102,94,69
21,r_125_74_88,seq16,seq143,r_125_74_88,0.44,8,96,88,69
1,r_114_29_97,seq149,r_45_146_177,r_114_29_97,1.0,1,98,97,69
5,r_95_111_138,r_88_80_168,r_125_74_88,r_95_111_138,0.97,1,139,138,69
42,r_69_92_135,r_124_86_176,r_133_39_38,r_124_86_176,0.67,-41,135,176,69
24,r_10_25_27,seq19,seq43,r_10_25_27,1.0,0,27,27,69
45,r_9_22_145,seq96,seq26,r_9_22_145,0.36,6,151,145,69
3,r_4_130_166,seq143,r_139_84_7,r_4_130_166,0.84,1,167,166,69
34,r_82_67_48,seq5,seq16,r_82_67_48,1.0,0,48,48,69
11,r_38_87_180,seq149,r_4_130_166,r_38_87_180,0.64,1,181,180,69
20,r_62_98_149,seq96,r_24_132_64,r_62_98_149,0.32,2,151,149,69
13,r_105_44_68,r_107_128_1,seq149,r_105_44_68,1.0,0,68,68,69
15,r_66_110_175,r_78_2_178,r_4_130_166,r_4_130_166,0.74,10,176,166,69
27,r_17_57_164,seq127,r_105_44_68,r_105_44_68,1.0,96,164,68,69
47,r_124_86_176,seq27,r_114_29_97,r_114_29_97,1.0,81,178,97,69
39,r_90_36_55,seq31,r_93_97_197,r_90_36_55,0.7,3,58,55,69
29,r_120_7_122,seq43,seq101,r_120_7_122,0.49,1,123,122,69
25,r_122_99_161,r_88_80_168,seq109,r_88_80_168,0.59,-11,157,168,69
33,r_88_80_168,r_95_111_138,r_83_102_14,r_95_111_138,1.0,1,139,138,69
17,r_42_21_110,r_32_138_144,r_105_44_68,r_32_138_144,1.0,-34,110,144,69
94,seq109,seq31,r_122_99_161,r_122_99_161,0.39,-2,159,161,69
49,r_40_47_62,r_56_75_188,seq19,r_40_47_62,1.0,1,63,62,69
56,seq143,r_78_2_178,r_95_111_138,r_95_111_138,0.98,40,178,138,69
44,r_28_116_146,r_17_57_164,r_135_33_86,r_28_116_146,0.63,5,151,146,69
35,r_14_118_96,seq54,seq141,r_14_118_96,0.79,1,97,96,69
8,r_111_135_83,r_68_112_154,r_8_64_188,r_111_135_83,1.0,2,85,83,70
43,r_2_98_192,r_102_72_130,r_18_95_3,r_102_72_130,0.88,1,131,130,70
37,r_56_144_127,seq47,r_15_46_86,r_56_144_127,0.96,1,128,127,70
16,r_79_69_61,r_67_145_94,r_18_95_3,r_79_69_61,0.95,4,65,61,70
46,r_81_118_80,seq113,r_15_46_86,r_81_118_80,0.62,10,90,80,70
45,r_70_12_84,r_31_27_138,seq47,r_31_27_138,0.86,-45,93,138,70
30,r_54_104_42,r_13_53_190,seq40,r_54_104_42,1.0,2,44,42,70
14,r_11_125_22,r_86_65_121,r_67_145_94,r_11_125_22,1.0,0,22,22,70
85,seq92,r_101_97_197,r_62_131_56,r_62_131_56,1.0,1,57,56,70
3,r_10_9_132,seq39,seq25,r_10_9_132,0.99,0,132,132,70
10,r_16_147_179,seq1,r_111_135_83,r_111_135_83,0.51,102,185,83,70
26,r_114_83_182,seq63,r_111_135_83,r_114_83_182,0.39,0,182,182,70
48,r_146_49_17,seq61,seq6,r_146_49_17,1.0,0,17,17,70
78,seq75,r_68_112_154,r_139_58_63,r_68_112_154,0.83,-9,145,154,70
11,r_139_58_63,seq1,seq59,r_139_58_63,0.86,4,67,63,70
2,r_62_131_56,r_52_17_50,seq92,r_62_131_56,1.0,0,56,56,70
20,r_73_140_147,seq0,r_32_48_89,r_73_140_147,0.86,0,147,147,70
15,r_19_136_171,r_71_134_131,r_79_69_61,r_79_69_61,0.92,111,172,61,70
12,r_13_53_190,r_24_93_7,r_11_125_22,r_13_53_190,0.18,0,190,190,70
19,r_51_23_34,r_114_83_182,seq1,r_51_23_34,1.0,0,34,34,70
18,r_32_48_89,seq84,seq20,r_32_48_89,0.92,4,93,89,70
42,r_124_108_10,r_110_89_85,seq0,r_124_108_10,1.0,0,10,10,70
32,r_102_72_130,r_2_98_192,r_81_118_80,r_102_72_130,0.75,1,131,130,70
38,r_31_27_138,seq35,r_85_115_183,r_31_27_138,0.96,1,139,138,70
77,seq63,r_114_83_182,r_3_88_113,r_3_88_113,1.0,62,175,113,70
36,r_26_28_33,r_74_45_194,r_15_46_86,r_26_28_33,1.0,0,33,33,70
17,r_71_134_131,seq6,seq96,r_71_134_131,0.42,26,157,131,70
9,r_3_88_113,r_71_134_131,r_54_104_42,r_71_134_131,0.98,-18,113,131,70
22,r_15_46_86,r_16_147_179,r_26_28_33,r_26_28_33,1.0,67,100,33,70
5,r_143_91_23,r_74_45_194,seq39,r_143_91_23,0.61,4,27,23,70
40,r_129_149_59,r_43_138_169,seq37,r_129_149_59,1.0,0,59,59,70
7,r_90_57_99,seq22,r_110_89_85,r_90_57_99,0.41,3,102,99,70
44,r_66_99_119,seq40,r_111_135_83,r_66_99_119,0.98,0,119,119,70
31,r_33_148_19,r_16_147_179,seq6,r_33_148_19,0.56,0,19,19,70
30,r_79_76_152,seq60,r_57_51_80,r_79_76_152,0.57,0,152,152,71
46,r_3_47_17,r_61_67_31,r_49_122_174,r_3_47_17,0.96,1,18,17,71
14,r_117_107_104,seq42,r_132_50_60,r_132_50_60,1.0,45,105,60,71
8,r_116_96_173,seq29,r_52_111_86,r_52_111_86,1.0,56,142,86,71
98,seq125,r_27_91_199,r_8_112_26,r_8_112_26,0.96,17,43,26,71
53,seq134,seq136,r_132_50_60,r_132_50_60,1.0,5,65,60,71
22,r_123_63_54,r_113_120_94,seq147,r_123_63_54,1.0,0,54,54,71
86,seq85,r_34_130_111,r_61_67_31,r_34_130_111,0.66,1,112,111,71
21,r_87_68_106,r_84_59_135,r_83_140_47,r_83_140_47,0.89,59,106,47,71
39,r_1_44_127,r_61_67_31,seq12,r_1_44_127,0.95,0,127,127,71
32,r_5_114_59,r_94_143_118,r_7_56_116,r_5_114_59,0.35,73,132,59,71
45,r_138_41_93,r_57_51_80,r_61_67_31,r_57_51_80,0.91,17,97,80,71
31,r_146_26_149,seq147,r_90_72_105,r_90_72_105,0.92,44,149,105,71
67,seq29,r_116_96_173,r_84_59_135,r_84_59_135,0.97,7,142,135,71
26,r_70_31_83,seq60,seq78,r_70_31_83,1.0,0,83,83,71
36,r_101_69_12,r_61_67_31,r_62_24_190,r_101_69_12,0.99,0,12,12,71
78,seq60,r_70_31_83,r_101_69_12,r_70_31_83,1.0,0,83,83,71
8,r_116_96_173,r_52_111_86,r_14_39_76,r_116_96_173,0.97,0,173,173,71
20,r_34_130_111,seq85,r_4_20_58,r_4_20_58,1.0,54,112,58,71
13,r_52_111_86,r_34_130_111,r_116_96_173,r_52_111_86,1.0,0,86,86,71
46,r_3_47_17,r_49_122_174,r_19_48_11,r_49_122_174,0.62,0,174,174,71
16,r_83_140_47,r_94_143_118,seq105,r_83_140_47,1.0,0,47,47,71
13,r_52_111_86,r_116_96_173,r_144_6_30,r_116_96_173,0.99,0,173,173,71
0,r_18_99_40,r_129_148_197,seq53,r_18_99_40,1.0,0,40,40,71
6,r_4_20_58,seq103,seq58,r_4_20_58,1.0,1,59,58,71
36,r_101_69_12,r_62_24_190,seq60,r_62_24_190,0.59,-21,169,190,71
10,r_62_24_190,r_101_69_12,r_19_48_11,r_62_24_190,0.46,0,190,190,71
47,r_110_75_126,r_146_26_149,r_37_43_81,r_37_43_81,0.7,45,126,81,71
40,r_37_43_81,r_70_31_83,seq135,r_37_43_81,1.0,2,83,81,71
18,r_132_50_60,r_94_143_118,seq134,r_132_50_60,1.0,2,62,60,71
29,r_90_72_105,r_145_30_153,seq128,r_90_72_105,1.0,0,105,105,71
24,r_149_104_79,r_1_44_127,r_8_112_26,r_149_104_79,1.0,1,80,79,71
25,r_94_143_118,r_132_50_60,r_5_114_59,r_94_143_118,1.0,-56,62,118,71
43,r_49_122_174,r_3_47_17,r_18_99_40,r_3_47_17,0.59,157,174,17,71
64,seq22,r_116_96_173,r_84_59_135,r_84_59_135,1.0,0,135,135,71
32,r_5_114_59,seq12,r_94_143_118,r_5_114_59,0.99,0,59,59,71
38,r_77_88_64,r_145_30_153,seq142,r_77_88_64,1.0,1,65,64,71
92,seq103,r_4_20_58,r_116_96_173,r_4_20_58,0.85,1,59,58,71
25,r_94_143_118,r_5_114_59,r_35_9_19,r_94_143_118,0.71,7,125,118,71
28,r_0_23_166,seq53,r_83_140_47,r_83_140_47,0.65,119,166,47,71
10,r_62_24_190,r_70_31_83,r_101_69_12,r_62_24_190,0.52,-153,37,190,71
7,r_131_64_95,r_34_130_111,r_113_120_94,r_131_64_95,0.38,2,97,95,71
44,r_84_59_135,seq38,seq22,r_84_59_135,0.89,0,135,135,71
43,r_49_122_174,r_117_107_104,r_3_47_17,r_3_47_17,0.69,5,22,17,71
82,seq78,r_145_30_153,r_70_31_83,r_70_31_83,1.0,76,159,83,71
43,r_2_117_134,r_110_138_149,r_29_106_4,r_29_106_4,0.96,130,134,4,72
37,r_61_91_157,r_18_24_192,r_87_37_27,r_87_37_27,0.84,132,159,27,72
16,r_76_105_147,r_61_91_157,r_29_106_4,r_76_105_147,0.79,1,148,147,72
21,r_129_101_100,seq43,r_23_74_16,r_129_101_100,0.99,0,100,100,72
1,r_96_107_115,seq50,seq12,r_96_107_115,1.0,0,115,115,72
42,r_110_138_149,seq149,r_109_10_95,r_110_138_149,0.77,1,150,149,72
45,r_92_72_103,seq108,seq34,r_92_72_103,1.0,0,103,103,72
19,r_83_85_122,seq9,r_69_3_130,r_83_85_122,0.99,0,122,122,72
31,r_147_130_113,r_11_56_145,r_29_106_4,r_147_130_113,0.85,0,113,113,72
9,r_87_37_27,r_102_81_52,seq31,r_87_37_27,1.0,0,27,27,72
14,r_134_104_12,seq145,r_13_35_93,r_13_35_93,1.0,28,121,93,72
78,seq50,r_96_107_115,r_113_131_53,r_96_107_115,1.0,0,115,115,72
0,r_109_10_95,seq143,seq139,r_109_10_95,0.93,0,95,95,72
12,r_28_114_51,seq145,r_113_131_53,r_28_114_51,0.96,-1,50,51,72
13,r_142_46_173,seq30,r_102_81_52,r_102_81_52,0.6,121,173,52,72
32,r_103_5_19,r_67_60_68,r_125_123_26,r_103_5_19,1.0,-1,18,19,72
15,r_13_35_93,r_23_74_16,r_134_104_12,r_13_35_93,0.89,0,93,93,72
48,r_39_115_66,r_76_105_147,r_28_114_51,r_28_114_51,0.88,18,69,51,72
6,r_69_3_130,seq64,r_83_85_122,r_83_85_122,1.0,27,149,122,72
20,r_127_90_46,r_25_42_151,seq48,r_127_90_46,0.72,2,48,46,72
87,seq75,r_62_116_141,seq36,r_62_116_141,0.98,0,141,141,72
2,r_126_99_186,r_120_53_172,r_23_74_16,r_126_99_186,0.54,0,186,186,72
3,r_113_131_53,r_140_22_182,r_28_114_51,r_28_114_51,0.62,2,53,51,72
40,r_17_88_41,r_51_119_71,r_28_114_51,r_17_88_41,0.5,28,69,41,72
18,r_7_49_131,seq95,r_29_106_4,r_7_49_131,0.98,0,131,131,72
33,r_100_16_69,r_23_74_16,seq78,r_100_16_69,0.73,14,83,69,72
38,r_118_93_78,r_23_74_16,r_87_37_27,r_23_74_16,0.54,62,78,16,72
17,r_148_15_128,seq136,seq43,r_148_15_128,0.32,6,134,128,72
94,seq108,r_92_72_103,seq143,r_92_72_103,1.0,0,103,103,72
91,seq89,seq48,r_1_41_32,r_1_41_32,1.0,51,83,32,72
49,r_62_116_141,seq75,r_29_106_4,r_62_116_141,0.91,0,141,141,72
34,r_71_135_34,r_126_99_186,seq137,r_71_135_34,1.0,1,35,34,72
44,r_67_60_68,r_23_74_16,seq143,r_67_60_68,0.83,2,70,68,72
11,r_102_81_52,r_62_116_141,seq143,r_102_81_52,1.0,0,52,52,72
23,r_51_119_71,r_61_91_157,seq64,r_51_119_71,1.0,0,71,71,72
7,r_1_41_32,r_109_10_95,seq89,r_1_41_32,1.0,1,33,32,72
22,r_0_54_29,r_144_59_199,r_84_94_148,r_0_54_29,1.0,0,29,29,72
35,r_128_58_87,r_109_10_95,r_127_90_46,r_128_58_87,0.99,0,87,87,72
51,seq6,r_32_67_178,r_24_5_182,r_32_67_178,0.62,5,183,178,73
36,r_83_25_91,r_23_62_129,seq89,r_83_25_91,0.99,2,93,91,73
18,r_85_146_32,seq12,seq139,r_85_146_32,0.59,7,39,32,73
8,r_130_87_156,seq147,r_118_50_84,r_130_87_156,0.45,4,160,156,73
43,r_112_134_89,seq99,r_11_14_25,r_112_134_89,0.85,2,91,89,73
32,r_10_54_31,r_122_18_197,r_59_69_9,r_10_54_31,0.95,0,31,31,73
54,seq139,r_83_25_91,r_85_146_32,r_83_25_91,0.6,2,93,91,73
30,r_36_38_55,seq141,seq39,r_36_38_55,1.0,0,55,55,73
40,r_90_81_16,r_11_14_25,r_32_67_178,r_90_81_16,0.9,-1,15,16,73
21,r_74_76_72,r_43_68_95,seq107,r_74_76_72,0.98,0,72,72,73
5,r_120_34_151,seq45,r_137_124_63,r_120_34_151,0.69,1,152,151,73
46,r_23_62_129,seq139,r_84_143_73,r_23_62_129,0.72,3,132,129,73
19,r_117_108_155,seq106,r_80_70_17,r_117_108_155,0.87,1,156,155,73
29,r_57_4_30,r_117_108_155,seq78,r_57_4_30,0.97,0,30,30,73
9,r_132_94_37,r_112_134_89,r_109_79_69,r_132_94_37,0.62,3,40,37,73
1,r_11_14_25,r_129_72_134,seq86,r_11_14_25,0.99,0,25,25,73
95,seq107,r_56_9_82,r_74_76_72,r_74_76_72,1.0,23,95,72,73
10,r_32_67_178,seq6,r_30_127_19,r_32_67_178,0.48,5,183,178,73
40,r_90_81_16,r_32_67_178,r_132_94_37,r_90_81_16,0.7,47,63,16,73
11,r_126_144_132,r_109_79_69,seq113,r_126_144_132,0.8,2,134,132,73
15,r_3_60_174,seq93,r_59_69_9,r_59_69_9,0.75,166,175,9,73
48,r_125_77_160,seq47,r_11_14_25,r_125_77_160,0.68,2,162,160,73
6,r_121_133_105,seq78,seq37,r_121_133_105,0.99,0,105,105,73
17,r_138_95_59,seq147,seq88,r_138_95_59,1.0,0,59,59,73
27,r_24_5_182,r_61_136_185,seq6,r_61_136_185,0.43,-1,184,185,73
13,r_59_69_9,r_130_87_156,r_10_54_31,r_10_54_31,0.54,0,31,31,73
31,r_46_97_40,r_36_38_55,r_105_116_20,r_105_116_20,0.57,21,41,20,73
2,r_43_68_95,seq88,seq89,r_43_68_95,1.0,0,95,95,73
47,r_84_143_73,r_126_144_132,seq73,r_84_143_73,0.93,0,73,73,73
33,r_27_48_130,seq26,seq40,r_27_48_130,0.86,0,130,130,73
84,seq86,r_149_1_58,r_11_14_25,r_149_1_58,0.67,0,58,58,73
38,r_41_111_78,seq148,r_74_76_72,r_41_111_78,0.78,2,80,78,73
83,seq141,r_36_38_55,r_80_70_17,r_36_38_55,0.85,-4,51,55,73
3,r_80_70_17,r_0_91_199,r_51_82_11,r_80_70_17,0.45,0,17,17,73
22,r_109_79_69,r_126_144_132,r_118_50_84,r_109_79_69,0.63,65,134,69,73
28,r_128_66_124,r_126_144_132,seq89,r_128_66_124,0.97,1,125,124,73
49,r_30_127_19,r_24_5_182,r_59_69_9,r_30_127_19,0.98,0,19,19,73
12,r_149_1_58,seq86,r_105_116_20,r_149_1_58,1.0,0,58,58,73
7,r_118_50_84,r_56_9_82,r_132_94_37,r_118_50_84,0.89,1,85,84,73
44,r_142_104_98,r_126_144_132,seq22,r_142_104_98,0.99,1,99,98,73
16,r_44_119_56,r_43_68_95,r_132_94_37,r_44_119_56,0.99,0,56,56,73
30,r_42_68_79,seq38,r_73_102_19,r_42_68_79,1.0,0,79,79,74
53,seq5,seq27,r_52_43_59,r_52_43_59,1.0,97,156,59,74
2,r_52_43_59,seq108,r_100_84_16,r_52_43_59,1.0,0,59,59,74
15,r_40_26_26,r_111_61_120,seq2,r_40_26_26,0.98,-4,22,26,74
16,r_24_105_147,r_4_3_122,r_1_46_134,r_4_3_122,0.98,0,122,122,74
21,r_1_46_134,r_85_148_175,r_40_26_26,r_40_26_26,1.0,124,150,26,74
39,r_116_10_144,r_23_80_13,r_106_89_108,r_23_80_13,0.8,134,147,13,74
1,r_106_89_108,seq7,r_109_0_45,r_106_89_108,0.99,1,109,108,74
5,r_64_18_88,seq44,r_109_0_45,r_64_18_88,1.0,1,89,88,74
46,r_122_65_81,seq58,r_40_26_26,r_122_65_81,0.6,0,81,81,74
42,r_45_81_84,r_64_18_88,r_52_43_59,r_45_81_84,0.98,0,84,84,74
23,r_16_136_22,r_1_46_134,seq131,r_16_136_22,1.0,0,22,22,74
33,r_111_61_120,r_22_48_32,seq58,r_22_48_32,0.95,0,32,32,74
7,r_53_76_17,r_6_8_135,r_79_37_110,r_53_76_17,0.86,118,135,17,74
19,r_86_119_159,seq87,r_73_102_19,r_86_119_159,0.69,1,160,159,74
33,r_111_61_120,seq58,r_53_76_17,r_111_61_120,0.4,2,122,120,74
45,r_92_30_55,r_55_132_104,seq19,r_92_30_55,0.87,0,55,55,74
95,seq120,r_23_80_13,r_63_127_76,r_63_127_76,1.0,23,99,76,74
41,r_144_78_127,seq7,r_35_20_166,r_144_78_127,0.98,1,128,127,74
10,r_63_127_76,r_86_119_159,seq120,r_63_127_76,0.94,1,77,76,74
25,r_109_0_45,r_63_127_76,r_72_134_42,r_109_0_45,1.0,0,45,45,74
4,r_14_29_153,r_60_93_101,r_112_110_65,r_14_29_153,0.87,1,154,153,74
8,r_34_128_30,r_106_89_108,r_130_11_20,r_106_89_108,0.7,-78,30,108,74
0,r_35_20_166,seq19,r_14_29_153,r_14_29_153,0.96,13,166,153,74
11,r_79_37_110,r_74_32_190,r_53_76_17,r_79_37_110,0.98,0,110,110,74
26,r_56_28_51,r_122_65_81,r_73_102_19,r_73_102_19,0.82,32,51,19,74
13,r_55_132_104,seq131,seq21,r_55_132_104,0.91,1,105,104,74
98,seq125,r_117_104_140,r_143_95_111,r_117_104_140,0.69,0,140,140,74
6,r_143_95_111,seq129,seq66,r_143_95_111,0.62,20,131,111,74
43,r_72_134_42,r_135_36_6,r_79_37_110,r_72_134_42,1.0,0,42,42,74
47,r_74_32_190,r_79_37_110,r_64_18_88,r_74_32_190,0.97,-80,110,190,74
18,r_118_107_60,r_143_95_111,r_130_11_20,r_118_107_60,0.99,1,61,60,74
43,r_72_134_42,r_79_37_110,r_106_89_108,r_72_134_42,1.0,68,110,42,74
47,r_74_32_190,r_64_18_88,r_55_132_104,r_74_32_190,0.72,0,190,190,74
7,r_53_76_17,r_106_89_108,r_6_8_135,r_53_76_17,0.98,0,17,17,74
32,r_4_3_122,r_24_105_147,seq51,r_4_3_122,0.96,0,122,122,74
38,r_60_93_101,r_14_29_153,seq47,r_14_29_153,0.91,-51,102,153,74
75,seq58,r_122_65_81,seq108,r_122_65_81,1.0,0,81,81,74
92,seq108,r_52_43_59,seq58,r_52_43_59,1.0,0,59,59,74
49,r_141_146_35,r_1_46_134,seq147,r_141_146_35,1.0,5,40,35,74
17,r_114_123_151,r_23_80_13,seq47,r_23_80_13,0.5,91,104,13,74
22,r_90_71_68,r_23_80_13,r_100_84_16,r_90_71_68,0.52,3,71,68,74
91,seq145,r_112_110_65,r_99_59_87,r_99_59_87,1.0,17,104,87,74
37,r_25_139_31,r_143_95_111,r_126_70_10,r_25_139_31,1.0,0,31,31,74
48,r_22_48_32,r_111_61_120,r_73_102_19,r_22_48_32,0.98,0,32,32,74
44,r_99_59_87,seq142,seq145,r_99_59_87,1.0,5,92,87,74
9,r_73_102_19,seq21,r_85_148_175,r_73_102_19,1.0,-1,18,19,74
35,r_112_110_65,r_35_20_166,seq131,r_112_110_65,0.6,1,66,65,74
12,r_39_67_96,r_24_105_147,r_99_59_87,r_24_105_147,1.0,-47,100,147,74
43,r_2_9_100,r_91_67_44,r_14_19_22,r_91_67_44,0.81,57,101,44,75
71,seq43,r_109_47_153,seq82,r_109_47_153,0.97,1,154,153,75
39,r_123_50_106,seq111,seq127,r_123_50_106,0.81,0,106,106,75
1,r_62_18_14,r_36_116_139,r_91_67_44,r_62_18_14,0.52,4,18,14,75
5,r_51_49_157,seq25,r_123_50_106,r_123_50_106,0.71,51,157,106,75
45,r_136_1_120,r_51_49_157,seq61,r_51_49_157,0.99,-36,121,157,75
19,r_109_47_153,seq43,r_85_148_119,r_109_47_153,0.81,1,154,153,75
33,r_64_143_151,r_11_29_78,r_131_10_99,r_64_143_151,1.0,1,152,151,75
24,r_11_29_78,r_64_143_151,r_73_83_136,r_11_29_78,0.98,59,137,78,75
41,r_128_63_176,seq72,r_142_58_147,r_142_58_147,0.47,31,178,147,75
27,r_140_124_17,r_37_146_167,seq100,r_140_124_17,0.75,0,17,17,75
26,r_138_33_143,seq31,r_3_105_57,r_3_105_57,0.69,86,143,57,75
4,r_48_69_126,seq32,r_139_122_30,r_48_69_126,0.81,1,127,126,75
13,r_113_17_60,r_11_29_78,seq135,r_11_29_78,1.0,-9,69,78,75
15,r_118_55_129,seq130,r_60_20_56,r_60_20_56,0.96,79,135,56,75
2,r_91_67_44,r_64_143_151,seq31,r_64_143_151,0.82,-87,64,151,75
47,r_13_28_133,r_85_148_119,r_14_19_22,r_14_19_22,0.84,120,142,22,75
40,r_131_10_99,r_97_56_1,seq76,r_131_10_99,0.76,0,99,99,75
24,r_11_29_78,r_97_56_1,r_64_143_151,r_11_29_78,0.91,0,78,78,75
25,r_81_22_90,seq12,r_108_92_28,r_108_92_28,0.99,93,121,28,75
33,r_64_143_151,r_87_88_85,r_11_29_78,r_64_143_151,0.98,-66,85,151,75
38,r_80_54_182,seq82,r_112_26_171,r_80_54_182,0.61,0,182,182,75
34,r_41_65_109,r_97_56_1,r_27_53_197,r_41_65_109,0.69,1,110,109,75
17,r_147_59_55,seq89,r_14_19_22,r_147_59_55,0.81,6,61,55,75
22,r_7_95_149,r_94_133_194,r_91_67_44,r_94_133_194,0.59,-44,150,194,75
28,r_35_44_94,seq132,seq30,r_35_44_94,0.89,2,96,94,75
49,r_87_88_85,r_64_143_151,r_110_149_16,r_87_88_85,0.95,0,85,85,75
20,r_14_19_22,r_2_9_100,r_97_56_1,r_14_19_22,0.9,1,23,22,75
44,r_144_141_70,r_91_67_44,seq16,r_144_141_70,1.0,1,71,70,75
6,r_3_105_57,r_138_33_143,r_140_124_17,r_3_105_57,0.99,0,57,57,75
31,r_60_20_56,r_91_67_44,seq8,r_60_20_56,1.0,1,57,56,75
12,r_45_34_166,seq100,r_11_29_78,r_11_29_78,0.71,90,168,78,75
36,r_97_56_1,r_4_5_188,r_14_19_22,r_14_19_22,0.93,1,23,22,75
93,seq104,r_84_116_157,r_91_106_17,r_84_116_157,0.83,0,157,157,76
8,r_124_115_126,r_60_3_176,seq62,r_124_115_126,0.43,-4,122,126,76
43,r_76_105_101,seq30,seq144,r_76_105_101,0.79,1,102,101,76
59,seq144,r_111_61_114,r_17_74_120,r_17_74_120,1.0,5,125,120,76
86,seq79,seq9,r_102_5_110,r_102_5_110,1.0,17,127,110,76
39,r_146_81_121,r_17_74_120,seq132,r_146_81_121,0.86,0,121,121,76
1,r_14_42_34,seq132,r_93_118_21,r_93_118_21,0.51,15,36,21,76
45,r_54_48_102,r_77_15_131,r_10_45_37,r_54_48_102,0.95,0,102,102,76
12,r_96_131_28,r_47_86_164,r_51_1_184,r_96_131_28,0.83,-5,23,28,76
19,r_126_52_161,seq144,r_82_26_155,r_126_52_161,0.26,-3,158,161,76
33,r_32_66_153,r_107_35_22,r_76_105_101,r_32_66_153,0.8,1,154,153,76
3,r_67_109_150,seq117,seq50,r_67_109_150,0.82,0,150,150,76
72,seq50,seq46,r_67_109_150,r_67_109_150,0.93,-4,146,150,76
14,r_107_35_22,r_32_66_153,r_43_145_136,r_107_35_22,0.47,135,157,22,76
20,r_120_69_182,seq25,r_67_109_150,r_67_109_150,0.7,35,185,150,76
17,r_101_113_33,r_32_66_153,seq75,r_101_113_33,0.9,0,33,33,76
27,r_77_15_131,seq139,r_56_65_61,r_56_65_61,1.0,72,133,61,76
2,r_34_13_99,seq63,r_37_55_35,r_34_13_99,0.36,12,111,99,76
47,r_140_114_92,seq4,seq25,r_140_114_92,0.85,-4,88,92,76
24,r_56_65_61,r_128_136_59,seq4,r_56_65_61,0.98,6,67,61,76
25,r_72_2_124,seq139,r_34_13_99,r_34_13_99,0.55,29,128,99,76
38,r_93_118_21,r_102_5_110,r_14_42_34,r_93_118_21,0.8,15,36,21,76
14,r_107_35_22,r_126_52_161,r_32_66_153,r_107_35_22,0.81,1,23,22,76
65,seq25,r_120_69_182,r_140_114_92,r_140_114_92,1.0,52,144,92,76
61,seq19,r_134_29_169,seq148,r_134_29_169,0.7,4,173,169,76
34,r_40_28_82,r_128_136_59,seq139,r_40_28_82,0.99,-5,77,82,76
9,r_43_145_136,seq62,seq46,r_43_145_136,0.63,4,140,136,76
33,r_32_66_153,r_101_113_33,r_107_35_22,r_32_66_153,0.78,-130,23,153,76
22,r_71_31_186,seq59,r_124_115_126,r_124_115_126,0.78,60,186,126,76
44,r_102_5_110,seq46,seq79,r_102_5_110,0.9,1,111,110,76
23,r_49_0_143,r_94_95_173,r_80_98_41,r_94_95_173,0.84,-29,144,173,76
82,seq139,r_17_74_120,r_40_28_82,r_40_28_82,0.83,-3,79,82,76
75,seq132,seq4,r_146_81_121,r_146_81_121,0.67,50,171,121,76
79,seq62,r_43_145_136,r_124_115_126,r_43_145_136,0.66,-2,134,136,76
35,r_41_121_89,r_32_66_153,seq63,r_41_121_89,0.47,0,89,89,76
36,r_138_70_70,seq61,seq27,r_138_70_70,1.0,-4,66,70,77
22,r_124_66_61,seq77,r_127_76_2,r_124_66_61,0.77,-19,42,61,77
71,seq136,r_45_7_145,r_26_140_91,r_26_140_91,0.67,62,153,91,77
16,r_38_125_114,seq119,seq100,r_38_125_114,0.99,0,114,114,77
21,r_128_32_186,seq122,r_117_17_22,r_117_17_22,0.99,164,186,22,77
1,r_13_74_130,r_87_144_162,r_29_53_50,r_87_144_162,1.0,-32,130,162,77
46,r_118_44_64,r_143_25_132,seq136,r_118_44_64,0.97,0,64,64,77
42,r_24_50_177,seq92,r_13_74_130,r_13_74_130,0.62,47,177,130,77
34,r_115_78_21,seq135,seq122,r_115_78_21,0.84,-6,15,21,77
31,r_43_21_119,seq83,r_139_62_105,r_43_21_119,1.0,0,119,119,77
3,r_89_120_128,seq116,seq40,r_89_120_128,0.46,0,128,128,77
4,r_130_69_135,r_2_10_138,seq135,r_130_69_135,0.69,1,136,135,77
20,r_12_39_113,seq141,seq95,r_12_39_113,0.91,0,113,113,77
13,r_81_65_81,seq95,r_86_58_12,r_81_65_81,0.79,-13,68,81,77
98,seq122,r_128_32_186,r_2_10_138,r_2_10_138,0.76,48,186,138,77
15,r_2_10_138,seq47,seq122,r_2_10_138,0.51,0,138,138,77
48,r_93_91_115,r_45_7_145,r_143_25_132,r_93_91_115,0.47,0,115,115,77
6,r_101_72_127,seq131,r_142_15_197,r_101_72_127,0.51,0,127,127,77
0,r_149_30_39,r_28_114_180,seq61,r_149_30_39,1.0,1,40,39,77
27,r_110_73_84,r_24_50_177,seq47,r_110_73_84,0.84,0,84,84,77
39,r_117_17_22,seq90,seq5,r_117_17_22,1.0,1,23,22,77
87,seq92,r_24_50_177,r_36_1_45,r_36_1_45,0.62,132,177,45,77
2,r_22_71_69,seq99,seq34,r_22_71_69,1.0,-3,66,69,77
47,r_20_107_121,r_2_10_138,seq52,r_20_107_121,0.65,1,122,121,77
40,r_0_145_155,seq8,r_20_107_121,r_20_107_121,0.75,38,159,121,77
29,r_26_140_91,r_41_49_181,r_118_44_64,r_26_140_91,0.86,0,91,91,77
33,r_45_7_145,seq136,r_143_25_132,r_45_7_145,0.42,8,153,145,77
64,seq34,r_86_58_12,r_22_71_69,r_22_71_69,0.8,-6,63,69,77
25,r_29_53_50,seq97,seq75,r_29_53_50,1.0,0,50,50,77
41,r_108_23_28,r_130_69_135,r_28_114_180,r_108_23_28,1.0,0,28,28,77
17,r_41_49_181,seq64,r_106_67_99,r_41_49_181,0.53,0,181,181,77
49,r_133_147_172,r_128_32_186,seq57,r_133_147_172,0.68,0,172,172,77
44,r_139_62_105,seq27,r_43_21_119,r_43_21_119,1.0,5,124,119,77
18,r_36_1_45,r_130_69_135,seq92,r_36_1_45,0.94,-5,40,45,77
79,seq61,r_45_7_145,r_149_30_39,r_149_30_39,1.0,1,40,39,77
10,r_121_63_53,r_128_32_186,seq131,r_121_63_53,0.97,0,53,53,77
35,r_98_129_142,r_87_144_162,seq132,r_98_129_142,0.32,2,144,142,77
11,r_127_76_2,r_104_31_171,r_124_66_61,r_124_66_61,0.9,-19,42,61,77
36,r_29_87_101,r_130_123_112,r_95_125_5,r_29_87_101,0.9,3,104,101,78
14,r_113_102_69,r_56_85_82,seq129,r_113_102_69,0.96,-1,68,69,78
8,r_97_73_150,seq143,seq41,r_97_73_150,0.44,5,155,150,78
37,r_22_24_126,seq32,r_45_137_71,r_22_24_126,1.0,0,126,126,78
40,r_120_75_15,r_130_123_112,seq64,r_120_75_15,0.78,0,15,15,78
21,r_104_117_161,seq141,r_45_137_71,r_104_117_161,0.8,0,161,161,78
39,r_148_132_91,seq88,seq141,r_148_132_91,0.68,0,91,91,78
46,r_37_59_85,seq131,r_45_137_71,r_37_59_85,1.0,0,85,85,78
42,r_84_96_106,r_105_124_172,seq38,r_84_96_106,0.99,1,107,106,78
69,seq31,r_33_39_179,r_53_13_157,r_53_13_157,1.0,27,184,157,78
45,r_81_110_61,r_106_90_68,r_80_145_28,r_80_145_28,1.0,33,61,28,78
43,r_149_15_43,seq43,seq129,r_149_15_43,1.0,0,43,43,78
31,r_94_65_173,seq9,r_105_124_172,r_94_65_173,0.57,0,173,173,78
3,r_10_48_119,seq129,r_122_71_191,r_10_48_119,0.68,3,122,119,78
90,seq92,r_105_124_172,r_63_42_56,r_63_42_56,0.99,118,174,56,78
4,r_7_54_78,r_148_132_91,r_40_36_54,r_7_54_78,0.83,-1,77,78,78
0,r_23_111_147,seq43,r_113_102_69,r_23_111_147,0.95,0,147,147,78
63,seq18,r_23_111_147,r_6_114_70,r_6_114_70,0.95,68,138,70,78
13,r_33_39_179,seq31,r_58_135_21,r_33_39_179,0.35,5,184,179,78
48,r_106_90_68,r_77_69_99,seq9,r_106_90_68,1.0,0,68,68,78
57,seq9,r_126_89_196,r_106_90_68,r_106_90_68,1.0,10,78,68,78
16,r_40_36_54,r_22_24_126,seq131,r_22_24_126,0.93,-79,47,126,78
62,seq143,r_97_73_150,seq136,r_97_73_150,0.66,18,168,150,78
27,r_30_26_110,r_134_66_14,r_58_135_21,r_30_26_110,1.0,0,110,110,78
55,seq5,r_80_145_28,r_60_118_164,r_80_145_28,1.0,-2,26,28,78
25,r_80_145_28,seq5,seq99,r_80_145_28,1.0,1,29,28,78
2,r_68_79_159,seq14,r_97_73_150,r_68_79_159,0.87,0,159,159,78
47,r_56_85_82,r_113_102_69,seq5,r_56_85_82,0.78,-10,72,82,78
18,r_60_118_164,seq41,seq20,r_60_118_164,0.75,0,164,164,78
29,r_112_119_137,seq64,r_95_125_5,r_112_119_137,0.89,0,137,137,78
52,seq2,r_134_66_14,r_3_0_24,r_3_0_24,0.89,5,29,24,78
33,r_77_69_99,seq136,r_3_0_24,r_3_0_24,0.8,76,100,24,78
1,r_3_0_24,r_1_51_136,seq2,r_3_0_24,1.0,0,24,24,78
32,r_27_82_153,seq38,r_7_54_78,r_27_82_153,0.98,0,153,153,78
38,r_1_51_136,seq14,seq140,r_1_51_136,0.99,0,136,136,78
60,seq141,r_67_98_155,seq21,r_67_98_155,0.95,0,155,155,78
11,r_91_115_20,r_122_71_191,seq43,r_91_115_20,1.0,0,20,20,78
17,r_105_124_172,seq92,seq86,r_105_124_172,0.4,0,172,172,78
28,r_8_16_89,r_122_71_191,r_95_125_5,r_8_16_89,1.0,0,89,89,78
23,r_63_42_56,r_68_79_159,r_134_66_14,r_63_42_56,1.0,0,56,56,78
56,seq136,r_77_69_99,seq143,r_77_69_99,0.83,-34,65,99,78
7,r_130_123_112,r_27_82_153,seq14,r_27_82_153,0.99,-14,139,153,78
44,r_142_74_184,r_113_102_69,r_40_36_54,r_142_74_184,0.6,-115,69,184,78
9,r_138_12_17,r_94_65_173,r_107_34_4,r_138_12_17,1.0,1,18,17,78
82,seq64,r_112_119_137,seq41,r_112_119_137,0.97,0,137,137,78
35,r_6_114_70,seq21,seq18,r_6_114_70,1.0,1,71,70,78
45,r_110_145_42,seq105,seq28,r_110_145_42,1.0,1,43,42,79
36,r_91_81_86,seq30,seq71,r_91_81_86,0.74,14,100,86,79
14,r_31_33_83,r_138_23_174,seq85,r_138_23_174,0.49,-62,112,174,79
8,r_138_23_174,seq100,r_50_41_74,r_50_41_74,1.0,100,174,74,79
53,seq133,r_123_101_101,r_88_119_94,r_123_101_101,1.0,0,101,101,79
43,r_0_57_89,r_24_107_184,seq37,r_0_57_89,0.96,0,89,89,79
42,r_18_14_24,r_91_81_86,r_79_96_28,r_18_14_24,0.99,2,26,24,79
54,seq6,seq75,r_123_101_101,r_123_101_101,0.99,-1,100,101,79
37,r_114_43_128,seq84,r_66_111_63,r_66_111_63,0.75,73,136,63,79
71,seq56,r_35_51_116,r_141_1_5,r_35_51_116,0.95,0,116,116,79
86,seq92,r_91_81_86,r_99_120_110,r_99_120_110,0.99,0,110,110,79
16,r_99_120_110,seq98,seq92,r_99_120_110,1.0,0,110,110,79
39,r_139_93_70,r_29_77_170,r_144_125_65,r_139_93_70,0.74,10,80,70,79
5,r_7_140_175,seq49,seq68,r_7_140_175,0.62,0,175,175,79
32,r_130_2_33,r_47_115_178,seq65,r_130_2_33,1.0,0,33,33,79
24,r_149_122_31,r_91_81_86,r_130_2_33,r_130_2_33,0.53,124,157,33,79
31,r_123_101_101,seq133,seq75,r_123_101_101,0.97,0,101,101,79
41,r_39_63_93,seq64,r_32_121_27,r_32_121_27,0.5,66,93,27,79
26,r_3_13_162,seq19,r_72_86_140,r_3_13_162,0.6,0,162,162,79
4,r_126_55_154,r_69_4_8,r_124_74_151,r_126_55_154,0.8,0,154,154,79
0,r_76_73_7,seq128,r_40_44_112,r_40_44_112,1.0,1,113,112,79
11,r_50_41_74,seq142,seq59,r_50_41_74,1.0,0,74,74,79
7,r_16_11_52,r_25_27_153,r_32_121_27,r_32_121_27,0.99,25,52,27,79
20,r_118_95_132,seq37,seq17,r_118_95_132,0.99,0,132,132,79
48,r_124_74_151,seq147,r_126_55_154,r_126_55_154,0.91,9,163,154,79
38,r_32_121_27,r_45_94_192,seq38,r_32_121_27,1.0,1,28,27,79
19,r_82_9_54,r_3_13_162,seq128,r_82_9_54,1.0,1,55,54,79
27,r_15_143_139,r_146_54_188,r_91_81_86,r_15_143_139,0.99,1,140,139,79
2,r_66_111_63,r_24_107_184,r_79_96_28,r_66_111_63,0.98,1,64,63,79
40,r_24_107_184,seq85,r_15_143_139,r_24_107_184,0.44,1,185,184,79
29,r_88_119_94,r_42_10_189,r_131_97_11,r_88_119_94,0.51,7,101,94,79
25,r_67_61_177,r_47_115_178,r_72_86_140,r_47_115_178,0.81,0,178,178,79
33,r_42_10_189,seq59,seq8,r_42_10_189,0.24,0,189,189,79
12,r_12_46_50,r_149_122_31,seq90,r_149_122_31,0.67,1,32,31,79
34,r_40_44_112,r_45_94_192,r_76_73_7,r_40_44_112,0.98,0,112,112,79
15,r_79_96_28,r_47_115_178,seq132,r_79_96_28,0.99,0,28,28,79
24,r_149_122_31,r_12_46_50,r_91_81_86,r_149_122_31,1.0,2,33,31,79
9,r_47_115_178,r_67_61_177,r_7_140_175,r_67_61_177,0.83,1,178,177,79
22,r_146_54_188,seq62,r_80_112_49,r_80_112_49,0.63,140,189,49,79
44,r_144_125_65,r_114_43_128,seq37,r_144_125_65,0.87,2,67,65,79
23,r_25_27_153,seq64,r_72_86_140,r_72_86_140,0.57,15,155,140,79
82,seq85,r_24_107_184,r_76_73_7,r_24_107_184,0.61,0,184,184,79
36,r_123_40_195,r_93_145_61,r_75_50_4,r_93_145_61,1.0,0,61,61,80
14,r_84_144_138,r_96_101_141,r_99_15_79,r_84_144_138,0.8,0,138,138,80
8,r_117_12_137,seq43,r_25_82_115,r_117_12_137,0.57,0,137,137,80
38,r_134_105_30,r_46_142_52,r_62_11_196,r_46_142_52,0.92,-27,25,52,80
37,r_71_10_140,r_62_11_196,seq112,r_71_10_140,0.45,1,141,140,80
16,r_25_82_115,seq0,seq24,r_25_82_115,0.6,7,122,115,80
21,r_44_19_168,r_118_52_5,r_88_147_154,r_118_52_5,0.65,163,168,5,80
39,r_42_129_93,seq36,seq51,r_42_129_93,0.69,2,95,93,80
2,r_59_61_90,r_64_37_46,seq127,r_59_61_90,1.0,1,91,90,80
5,r_48_121_98,seq128,seq14,r_48_121_98,0.68,4,102,98,80
42,r_67_139_99,r_86_27_194,seq128,r_67_139_99,0.82,3,102,99,80
45,r_78_4_156,r_6_119_136,seq16,r_78_4_156,0.57,-18,138,156,80
19,r_83_23_185,r_96_101_141,r_71_10_140,r_83_23_185,0.48,-38,147,185,80
31,r_90_131_82,r_44_19_168,r_77_141_33,r_90_131_82,1.0,0,82,82,80
3,r_2_53_80,seq80,r_118_52_5,r_2_53_80,0.99,0,80,80,80
10,r_97_95_170,r_84_144_138,r_83_23_185,r_97_95_170,0.51,-32,138,170,80
15,r_45_116_12,seq63,seq43,r_45_116_12,0.88,-1,11,12,80
4,r_94_89_83,r_42_129_93,r_75_50_4,r_94_89_83,1.0,0,83,83,80
0,r_6_119_136,r_78_4_156,seq38,r_78_4_156,0.87,-18,138,156,80
11,r_96_101_141,r_84_144_138,r_8_70_59,r_84_144_138,0.46,2,140,138,80
33,r_77_141_33,seq5,seq63,r_77_141_33,0.98,6,39,33,80
48,r_64_37_46,r_59_61_90,seq43,r_59_61_90,1.0,1,91,90,80
45,r_78_4_156,seq16,seq130,r_78_4_156,0.82,0,156,156,80
99,seq127,seq130,r_59_61_90,r_59_61_90,0.99,9,99,90,80
27,r_29_1_151,r_86_27_194,r_94_89_83,r_86_27_194,0.86,-43,151,194,80
1,r_46_142_52,r_117_12_137,r_123_40_195,r_46_142_52,1.0,1,53,52,80
47,r_22_3_91,r_26_58_132,r_93_145_61,r_22_3_91,0.88,3,94,91,80
10,r_97_95_170,r_83_23_185,seq9,r_97_95_170,0.81,2,172,170,80
18,r_47_18_89,r_44_19_168,r_62_11_196,r_47_18_89,0.97,0,89,89,80
29,r_93_145_61,r_123_40_195,seq32,r_93_145_61,1.0,0,61,61,80
48,r_64_37_46,r_93_145_61,r_59_61_90,r_59_61_90,0.68,-43,47,90,80
25,r_135_125_68,r_108_120_113,seq41,r_135_125_68,0.99,0,68,68,80
32,r_104_148_81,r_86_27_194,r_75_50_4,r_104_148_81,1.0,0,81,81,80
24,r_62_11_196,r_2_53_80,r_134_105_30,r_2_53_80,0.7,-55,25,80,80
22,r_140_102_26,r_44_19_168,seq7,r_140_102_26,1.0,2,28,26,80
12,r_79_56_45,r_48_121_98,seq124,r_79_56_45,0.92,0,45,45,80
49,r_92_114_41,r_107_132_40,r_118_52_5,r_92_114_41,1.0,0,41,41,80
28,r_108_120_113,seq20,r_2_53_80,r_2_53_80,0.99,37,117,80,80
2,r_59_61_90,r_117_12_137,r_64_37_46,r_64_37_46,1.0,9,55,46,80
23,r_143_13_135,r_84_144_138,r_2_53_80,r_84_144_138,0.99,-3,135,138,80
30,r_119_18_141,seq62,r_58_113_107,r_119_18_141,0.75,1,142,141,81
36,r_13_68_158,seq12,r_44_120_50,r_44_120_50,0.86,112,162,50,81
8,r_17_24_118,seq138,seq146,r_17_24_118,0.57,0,118,118,81
3,r_149_101_116,r_38_127_57,r_110_114_104,r_110_114_104,0.98,14,118,104,81
86,seq62,r_119_18_141,r_100_39_192,r_119_18_141,0.9,-20,121,141,81
16,r_142_79_199,r_106_0_177,r_149_101_116,r_106_0_177,0.29,5,182,177,81
21,r_133_19_128,r_85_67_190,r_1_66_16,r_133_19_128,0.89,3,131,128,81
1,r_76_115_132,seq84,r_22_64_119,r_76_115_132,0.93,0,132,132,81
42,r_30_140_138,seq128,r_149_101_116,r_30_140_138,0.77,1,139,138,81
19,r_106_0_177,r_142_79_199,seq48,r_106_0_177,0.3,5,182,177,81
27,r_111_96_152,r_102_6_71,seq128,r_111_96_152,1.0,0,152,152,81
41,r_102_6_71,r_36_71_12,r_111_96_152,r_102_6_71,1.0,1,72,71,81
89,seq138,r_17_24_118,r_73_16_117,r_17_24_118,0.68,-1,117,118,81
37,r_103_108_48,r_121_148_79,seq15,r_103_108_48,0.93,0,48,48,81
43,r_1_66_16,seq147,r_111_96_152,r_1_66_16,0.98,0,16,16,81
10,r_27_95_120,r_85_67_190,r_125_109_86,r_27_95_120,0.71,12,132,120,81
4,r_145_80_147,seq62,r_76_115_132,r_145_80_147,0.84,0,147,147,81
0,r_91_92_148,seq122,r_5_118_51,r_91_92_148,0.67,0,148,148,81
5,r_55_90_54,seq15,r_1_66_16,r_55_90_54,0.97,0,54,54,81
20,r_36_71_12,r_102_6_71,r_85_67_190,r_102_6_71,0.96,-3,68,71,81
15,r_75_72_180,seq28,r_55_90_54,r_55_90_54,1.0,126,180,54,81
20,r_36_71_12,r_85_67_190,r_110_114_104,r_110_114_104,0.73,4,108,104,81
6,r_110_114_104,r_31_86_2,r_36_71_12,r_110_114_104,0.99,0,104,104,81
17,r_41_2_47,r_110_114_104,r_20_130_9,r_41_2_47,1.0,-3,44,47,81
33,r_63_129_63,r_149_101_116,r_142_79_199,r_63_129_63,0.85,-17,46,63,81
27,r_111_96_152,seq37,r_102_6_71,r_102_6_71,1.0,16,87,71,81
41,r_102_6_71,r_111_96_152,r_55_90_54,r_111_96_152,1.0,0,152,152,81
40,r_58_113_107,seq146,r_142_79_199,r_58_113_107,0.82,2,109,107,81
18,r_121_148_79,r_143_112_84,r_132_124_65,r_132_124_65,0.63,14,79,65,81
46,r_87_97_30,r_55_90_54,seq147,r_87_97_30,0.86,0,30,30,81
43,r_1_66_16,r_111_96_152,r_133_19_128,r_1_66_16,0.92,120,136,16,81
12,r_100_39_192,r_132_124_65,r_74_134_33,r_100_39_192,1.0,-160,32,192,81
50,seq128,seq34,r_111_96_152,r_111_96_152,0.91,7,159,152,81
25,r_98_32_62,r_81_11_142,seq45,r_81_11_142,0.65,-84,58,142,81
38,r_22_64_119,r_85_67_190,seq21,r_22_64_119,0.77,2,121,119,81
48,r_38_127_57,seq116,seq4,r_38_127_57,1.0,-1,56,57,81
9,r_117_50_195,r_9_77_14,r_81_11_142,r_81_11_142,0.93,1,143,142,81
14,r_74_134_33,r_30_140_138,r_100_39_192,r_74_134_33,1.0,-1,32,33,81
22,r_123_99_105,r_31_86_2,r_44_120_50,r_123_99_105,1.0,0,105,105,81
28,r_81_11_142,seq135,r_117_50_195,r_81_11_142,0.88,0,142,142,81
3,r_149_101_116,r_63_129_63,r_38_127_57,r_149_101_116,0.53,-60,56,116,81
44,r_73_16_117,r_33_107_196,seq138,r_73_16_117,0.76,1,118,117,81
23,r_132_124_65,r_100_39_192,seq14,r_132_124_65,1.0,0,65,65,81
39,r_44_120_50,seq144,seq8,r_44_120_50,0.81,-4,46,50,81
35,r_83_42_162,seq51,r_55_90_54,r_83_42_162,0.51,0,162,162,81
36,r_129_139_86,seq3,r_26_99_59,r_26_99_59,0.99,27,86,59,82
66,seq22,r_14_31_13,r_57_68_122,r_57_68_122,0.99,-2,120,122,82
53,seq3,r_129_139_86,r_60_40_170,r_129_139_86,0.81,84,170,86,82
30,r_38_114_54,r_57_68_122,r_82_85_39,r_38_114_54,0.6,1,55,54,82
20,r_98_8_40,r_29_146_101,r_64_111_3,r_98_8_40,1.0,0,40,40,82
59,seq10,seq1,r_144_81_17,r_144_81_17,0.9,116,133,17,82
55,seq5,seq2,r_123_86_131,r_123_86_131,1.0,0,131,131,82
16,r_60_40_170,r_35_122_169,seq3,r_35_122_169,0.6,2,171,169,82
21,r_136_91_121,r_62_66_1,seq48,r_136_91_121,1.0,5,126,121,82
1,r_29_146_101,r_34_140_168,r_82_85_39,r_34_140_168,1.0,-64,104,168,82
41,r_44_103_28,r_47_75_147,seq115,r_44_103_28,1.0,2,30,28,82
46,r_14_31_13,r_54_28_133,seq106,r_14_31_13,0.78,1,14,13,82
95,seq106,r_47_75_147,r_29_146_101,r_29_146_101,0.87,46,147,101,82
76,seq49,r_16_13_127,seq30,r_16_13_127,1.0,0,127,127,82
6,r_97_72_34,r_60_40_170,seq63,r_97_72_34,1.0,0,34,34,82
26,r_35_122_169,r_60_40_170,r_98_8_40,r_98_8_40,0.74,129,169,40,82
4,r_127_59_71,r_143_74_145,r_83_23_157,r_143_74_145,0.71,-73,72,145,82
9,r_82_85_39,r_83_23_157,seq106,r_82_85_39,1.0,0,39,39,82
0,r_57_68_122,seq53,seq22,r_57_68_122,1.0,0,122,122,82
13,r_142_148_129,seq1,seq30,r_142_148_129,0.99,1,130,129,82
15,r_20_76_171,seq32,r_123_86_131,r_123_86_131,0.81,40,171,131,82
48,r_107_46_155,seq95,seq149,r_107_46_155,0.91,0,155,155,82
62,seq17,r_112_73_185,r_47_75_147,r_47_75_147,0.95,28,175,147,82
33,r_144_81_17,r_21_70_83,seq10,r_144_81_17,0.61,0,17,17,82
27,r_92_117_110,r_123_86_131,seq130,r_92_117_110,0.96,0,110,110,82
8,r_79_105_49,r_142_148_129,seq87,r_79_105_49,1.0,0,49,49,82
47,r_143_74_145,seq63,r_88_116_107,r_143_74_145,0.97,0,145,145,82
40,r_62_66_1,r_136_91_121,r_51_69_12,r_136_91_121,0.96,5,126,121,82
18,r_50_121_73,r_54_28_133,r_42_78_2,r_42_78_2,0.69,71,73,2,82
29,r_123_86_131,r_92_117_110,r_44_103_28,r_123_86_131,0.47,-21,110,131,82
24,r_47_75_147,seq106,r_65_120_141,r_47_75_147,0.74,0,147,147,82
19,r_55_41_51,seq22,r_62_66_1,r_55_41_51,1.0,0,51,51,82
81,seq138,r_89_0_52,r_14_31_13,r_89_0_52,0.98,4,56,52,82
25,r_88_116_107,seq48,r_21_70_83,r_88_116_107,0.77,0,107,107,82
39,r_51_69_12,r_57_68_122,r_62_66_1,r_51_69_12,0.87,0,12,12,82
32,r_141_24_96,seq37,seq17,r_141_24_96,1.0,0,96,96,82
38,r_45_126_146,seq149,seq67,r_45_126_146,0.97,1,147,146,82
66,seq22,r_55_41_51,r_14_31_13,r_55_41_51,0.9,0,51,51,82
34,r_65_120_141,seq132,r_129_139_86,r_65_120_141,0.95,0,141,141,82
17,r_26_99_59,r_29_146_101,seq149,r_26_99_59,1.0,1,60,59,82
96,seq109,r_33_96_125,r_54_28_133,r_54_28_133,1.0,0,133,133,82
29,r_123_86_131,r_44_103_28,seq5,r_123_86_131,0.99,0,131,131,82
22,r_4_61_87,r_57_68_122,seq25,r_4_61_87,0.96,0,87,87,82
44,r_16_13_127,seq49,r_79_105_49,r_16_13_127,0.92,0,127,127,82
35,r_124_102_82,r_83_23_157,r_38_114_54,r_124_102_82,1.0,2,84,82,82
12,r_36_100_97,r_57_68_122,seq12,r_36_100_97,0.98,0,97,97,82
14,r_89_0_52,seq22,seq2,r_89_0_52,1.0,3,55,52,82
30,r_36_61_127,seq133,r_112_22_84,r_112_22_84,1.0,49,133,84,83
8,r_38_30_145,seq8,r_148_0_165,r_38_30_145,0.49,1,146,145,83
39,r_31_47_44,seq40,r_118_141_82,r_118_141_82,0.97,-2,80,82,83
43,r_18_85_129,seq129,r_2_82_96,r_18_85_129,0.93,0,129,129,83
3,r_87_100_43,r_35_4_142,seq149,r_87_100_43,0.87,5,48,43,83
54,seq129,r_123_130_116,r_48_122_85,r_123_130_116,0.85,-7,109,116,83
28,r_148_0_165,r_32_51_47,r_38_30_145,r_148_0_165,0.76,-21,144,165,83
19,r_19_65_27,r_11_120_139,r_84_24_103,r_19_65_27,1.0,1,28,27,83
21,r_138_64_76,r_139_96_175,r_68_28_59,r_139_96_175,1.0,-99,76,175,83
12,r_57_73_49,r_98_91_180,seq59,r_57_73_49,1.0,0,49,49,83
1,r_17_140_138,seq117,seq129,r_17_140_138,0.68,12,150,138,83
5,r_11_120_139,r_72_46_9,r_127_128_18,r_11_120_139,0.96,0,139,139,83
46,r_16_134_150,seq143,r_11_120_139,r_16_134_150,0.72,0,150,150,83
42,r_25_106_77,seq103,r_116_147_35,r_25_106_77,1.0,0,77,77,83
45,r_48_122_85,seq23,seq129,r_48_122_85,0.6,10,95,85,83
66,seq37,r_92_79_182,r_12_132_37,r_12_132_37,0.67,145,182,37,83
31,r_34_77_140,r_98_91_180,r_36_61_127,r_34_77_140,1.0,0,140,140,83
41,r_112_22_84,r_74_107_99,r_36_61_127,r_112_22_84,1.0,0,84,84,83
10,r_44_81_134,seq143,r_36_61_127,r_44_81_134,1.0,0,134,134,83
20,r_2_82_96,r_38_30_145,seq3,r_2_82_96,0.96,0,96,96,83
15,r_45_80_186,seq55,r_38_30_145,r_45_80_186,0.5,1,187,186,83
48,r_14_93_81,seq144,seq8,r_14_93_81,1.0,0,81,81,83
4,r_127_128_18,r_95_131_124,r_12_132_37,r_95_131_124,1.0,0,124,124,83
6,r_116_147_35,r_98_91_180,r_101_102_187,r_116_147_35,1.0,2,37,35,83
27,r_105_104_171,seq21,r_12_132_37,r_105_104_171,0.68,0,171,171,83
8,r_38_30_145,r_148_0_165,r_139_96_175,r_148_0_165,0.79,8,173,165,83
40,r_124_20_92,r_148_0_165,seq70,r_124_20_92,0.98,1,93,92,83
4,r_127_128_18,seq43,r_95_131_124,r_127_128_18,0.73,0,18,18,83
18,r_74_107_99,seq144,r_84_24_103,r_74_107_99,0.97,0,99,99,83
29,r_95_131_124,seq1,r_13_33_13,r_95_131_124,1.0,0,124,124,83
24,r_56_71_121,seq121,seq21,r_56_71_121,0.95,0,121,121,83
50,seq1,r_95_131_124,r_12_132_37,r_95_131_124,0.61,-22,102,124,83
58,seq143,r_44_81_134,seq99,r_44_81_134,1.0,0,134,134,83
14,r_78_135_23,r_11_120_139,seq136,r_78_135_23,0.99,0,23,23,83
32,r_118_141_82,seq5,r_31_47_44,r_31_47_44,0.84,40,84,44,83
38,r_83_89_74,r_10_49_191,r_12_132_37,r_83_89_74,1.0,0,74,74,83
25,r_9_54_22,seq23,seq8,r_9_54_22,1.0,0,22,22,83
47,r_68_28_59,r_74_107_99,seq133,r_68_28_59,1.0,0,59,59,83
17,r_92_79_182,seq37,r_84_24_103,r_92_79_182,0.46,0,182,182,83
2,r_101_102_187,r_72_46_9,r_116_147_35,r_116_147_35,1.0,2,37,35,83
96,seq121,r_56_71_121,r_58_67_72,r_58_67_72,0.94,43,115,72,83
28,r_148_0_165,r_38_30_145,seq29,r_148_0_165,0.51,1,166,165,83
28,r_148_0_165,r_124_20_92,r_32_51_47,r_148_0_165,1.0,-72,93,165,83
49,r_139_96_175,seq137,r_38_30_145,r_139_96_175,0.31,2,177,175,83
39,r_31_47_44,r_38_30_145,seq40,r_31_47_44,0.95,0,44,44,83
44,r_15_27_98,r_35_4_142,r_13_33_13,r_15_27_98,0.6,2,100,98,83
26,r_12_132_37,r_25_106_77,seq1,r_25_106_77,0.88,-45,32,77,83
35,r_58_67_72,seq37,seq121,r_58_67_72,1.0,1,73,72,83
93,seq144,seq55,r_39_81_70,r_39_81_70,1.0,39,109,70,84
30,r_138_148_137,seq3,seq72,r_138_148_137,0.93,1,138,137,84
51,seq1,r_64_136_72,r_122_134_62,r_122_134_62,1.0,13,75,62,84
14,r_142_57_108,r_26_12_156,r_27_8_52,r_142_57_108,0.74,0,108,108,84
8,r_43_140_68,seq20,seq47,r_43_140_68,1.0,5,73,68,84
37,r_54_2_195,r_10_93_84,r_45_110_76,r_10_93_84,0.52,0,84,84,84
21,r_122_134_62,seq29,seq1,r_122_134_62,1.0,1,63,62,84
1,r_45_110_76,r_89_107_150,r_108_87_56,r_45_110_76,0.99,3,79,76,84
42,r_49_130_129,seq97,r_102_90_199,r_49_130_129,0.95,0,129,129,84
45,r_96_129_101,r_9_31_191,seq145,r_96_129_101,0.92,0,101,101,84
47,r_26_12_156,r_105_41_110,seq48,r_26_12_156,0.98,0,156,156,84
5,r_115_65_25,r_60_126_192,seq97,r_115_65_25,0.99,0,25,25,84
19,r_121_112_179,r_9_31_191,r_45_110_76,r_45_110_76,0.7,103,179,76,84
36,r_108_87_56,seq20,seq58,r_108_87_56,0.78,0,56,56,84
41,r_33_73_99,r_60_126_192,seq77,r_33_73_99,0.65,2,101,99,84
10,r_147_99_117,r_9_31_191,r_54_2_195,r_147_99_117,0.94,0,117,117,84
26,r_76_111_90,r_49_130_129,seq48,r_76_111_90,0.87,0,90,90,84
37,r_54_2_195,r_45_110_76,r_147_99_117,r_54_2_195,0.71,-62,133,195,84
78,seq72,r_7_37_65,r_138_148_137,r_138_148_137,0.82,1,138,137,84
20,r_143_74_171,r_9_31_191,r_27_8_52,r_143_74_171,0.37,4,175,171,84
15,r_116_23_67,r_146_6_104,r_62_128_30,r_146_6_104,0.75,-33,71,104,84
48,r_149_120_146,r_30_68_184,seq35,r_149_120_146,0.58,0,146,146,84
6,r_39_81_70,seq52,seq144,r_39_81_70,1.0,0,70,70,84
27,r_14_71_69,seq16,seq3,r_14_71_69,0.8,9,78,69,84
32,r_63_139_12,r_115_65_25,seq145,r_63_139_12,0.68,0,12,12,84
2,r_89_107_150,r_17_113_163,seq19,r_89_107_150,0.48,1,151,150,84
39,r_137_85_20,r_70_15_197,seq20,r_137_85_20,1.0,0,20,20,84
47,r_26_12_156,r_142_57_108,r_105_41_110,r_142_57_108,0.99,0,108,108,84
34,r_79_13_19,r_116_23_67,seq78,r_79_13_19,0.67,0,19,19,84
18,r_27_8_52,r_22_69_57,seq48,r_27_8_52,0.83,27,79,52,84
11,r_94_83_42,r_89_107_150,r_105_41_110,r_94_83_42,1.0,1,43,42,84
33,r_17_113_163,seq118,r_62_128_30,r_62_128_30,0.79,133,163,30,84
13,r_103_135_33,r_64_136_72,seq44,r_103_135_33,0.9,17,50,33,84
38,r_42_56_58,seq77,seq3,r_42_56_58,0.55,2,60,58,84
0,r_62_128_30,seq86,r_5_11_167,r_62_128_30,0.99,1,31,30,84
22,r_106_66_64,r_138_148_137,r_62_128_30,r_106_66_64,0.94,0,64,64,84
7,r_10_93_84,r_54_2_195,r_62_128_30,r_10_93_84,0.67,0,84,84,84
12,r_22_69_57,r_27_8_52,seq118,r_22_69_57,0.54,22,79,57,84
30,r_80_39_168,seq9,r_19_60_163,r_80_39_168,0.4,1,169,168,85
92,seq106,r_25_27_111,r_97_79_145,r_25_27_111,1.0,3,114,111,85
14,r_75_35_29,r_42_21_179,seq103,r_42_21_179,0.85,-98,81,179,85
15,r_37_2_32,seq67,r_97_79_145,r_37_2_32,1.0,0,32,32,85
37,r_23_1_143,r_130_76_147,seq20,r_23_1_143,0.96,0,143,143,85
16,r_111_136_86,seq32,seq64,r_111_136_86,0.94,0,86,86,85
39,r_14_40_123,r_80_39_168,seq119,r_14_40_123,0.97,0,123,123,85
5,r_55_143_167,seq17,r_15_36_134,r_15_36_134,0.76,36,170,134,85
42,r_0_47_152,seq106,seq139,r_0_47_152,0.85,0,152,152,85
24,r_38_56_24,r_137_118_127,seq16,r_38_56_24,0.77,3,27,24,85
24,r_38_56_24,seq16,r_25_27_111,r_38_56_24,0.67,81,105,24,85
35,r_85_114_58,seq43,r_90_73_49,r_85_114_58,0.59,0,58,58,85
31,r_44_95_172,seq78,r_130_76_147,r_44_95_172,0.48,0,172,172,85
3,r_130_76_147,r_23_1_143,r_26_8_198,r_23_1_143,0.92,0,143,143,85
18,r_116_117_56,r_51_11_55,seq17,r_116_117_56,1.0,1,57,56,85
0,r_42_21_179,seq78,r_6_124_20,r_42_21_179,0.37,3,182,179,85
11,r_50_30_149,seq122,seq32,r_50_30_149,0.87,0,149,149,85
44,r_123_61_57,seq103,seq16,r_123_61_57,1.0,1,58,57,85
48,r_45_49_169,seq34,r_130_76_147,r_130_76_147,0.59,21,168,147,85
13,r_59_115_35,seq67,r_130_76_147,r_59_115_35,1.0,2,37,35,85
13,r_59_115_35,r_130_76_147,seq71,r_59_115_35,0.42,112,147,35,85
2,r_52_58_96,seq78,r_6_124_20,r_52_58_96,0.99,5,101,96,85
47,r_69_94_138,seq31,seq41,r_69_94_138,0.53,8,146,138,85
40,r_121_149_15,r_96_5_194,seq106,r_121_149_15,0.98,1,16,15,85
29,r_4_28_48,r_14_40_123,r_88_131_67,r_14_40_123,1.0,-68,55,123,85
38,r_65_104_113,r_130_76_147,seq103,r_65_104_113,1.0,0,113,113,85
26,r_51_11_55,r_116_117_56,r_6_124_20,r_116_117_56,0.9,1,57,56,85
17,r_132_74_177,seq78,seq64,r_132_74_177,0.53,0,177,177,85
28,r_92_145_135,seq34,seq122,r_92_145_135,0.97,0,135,135,85
49,r_82_66_156,r_55_143_167,r_77_87_1,r_82_66_156,0.61,0,156,156,85
23,r_137_118_127,seq98,r_123_61_57,r_123_61_57,0.98,70,127,57,85
1,r_6_124_20,r_26_8_198,seq142,r_6_124_20,0.65,0,20,20,85
12,r_135_113_87,r_25_27_111,seq20,r_135_113_87,1.0,0,87,87,85
7,r_86_46_44,r_77_87_1,r_75_35_29,r_86_46_44,1.0,1,45,44,85
30,r_109_9_187,seq33,r_28_37_13,r_109_9_187,0.15,0,187,187,86
4,r_85_20_29,r_19_54_118,seq33,r_85_20_29,0.85,0,29,29,86
36,r_115_110_87,r_14_53_126,r_139_97_3,r_139_97_3,0.93,84,87,3,86
14,r_98_57_128,seq3,r_102_39_42,r_102_39_42,0.59,89,131,42,86
53,seq5,r_56_136_181,r_14_53_126,r_14_53_126,1.0,52,178,126,86
43,r_68_91_88,seq12,r_102_39_42,r_102_39_42,0.6,50,92,42,86
54,seq135,r_107_8_148,r_59_112_8,r_107_8_148,0.84,0,148,148,86
37,r_134_100_111,seq55,r_7_94_101,r_7_94_101,0.98,20,121,101,86
16,r_7_94_101,r_139_97_3,seq143,r_7_94_101,0.95,0,101,101,86
21,r_15_92_168,r_142_36_176,r_98_57_128,r_98_57_128,0.93,42,170,128,86
39,r_45_93_138,r_25_76_191,r_28_37_13,r_28_37_13,0.65,126,139,13,86
1,r_107_8_148,seq135,r_41_140_30,r_107_8_148,0.73,4,152,148,86
42,r_50_114_133,r_15_92_168,r_60_106_95,r_50_114_133,0.79,0,133,133,86
19,r_96_103_183,r_30_0_140,r_44_49_58,r_44_49_58,1.0,126,184,58,86
9,r_44_49_58,r_60_106_95,seq79,r_44_49_58,1.0,0,58,58,86
8,r_28_37_13,r_61_16_197,seq127,r_28_37_13,0.99,1,14,13,86
47,r_80_131_17,seq141,seq89,r_80_131_17,0.53,11,28,17,86
26,r_4_121_193,r_148_6_175,r_98_57_128,r_4_121_193,0.5,-15,178,193,86
72,seq55,r_34_117_189,r_2_123_37,r_2_123_37,1.0,152,189,37,86
88,seq89,seq79,r_80_131_17,r_80_131_17,0.85,32,49,17,86
48,r_64_138_40,seq128,seq143,r_64_138_40,0.98,0,40,40,86
0,r_56_136_181,seq5,r_107_8_148,r_56_136_181,0.33,-3,178,181,86
73,seq58,r_41_140_30,r_119_129_99,r_119_129_99,1.0,3,102,99,86
11,r_81_46_172,r_30_0_140,r_28_37_13,r_28_37_13,0.81,160,173,13,86
13,r_111_124_119,r_59_112_8,seq146,r_111_124_119,0.72,2,121,119,86
15,r_60_106_95,seq132,seq116,r_60_106_95,0.98,0,95,95,86
34,r_71_133_55,r_68_91_88,r_144_125_9,r_71_133_55,0.84,0,55,55,86
24,r_147_67_35,r_44_49_58,seq143,r_147_67_35,1.0,0,35,35,86
40,r_59_112_8,r_130_86_49,r_149_82_38,r_149_82_38,0.75,11,49,38,86
17,r_102_39_42,r_90_40_94,seq21,r_102_39_42,1.0,2,44,42,86
31,r_105_42_20,r_30_0_140,seq146,r_105_42_20,0.97,0,20,20,86
79,seq72,r_61_16_197,r_2_123_37,r_2_123_37,1.0,4,41,37,86
18,r_137_48_18,r_19_54_118,seq79,r_137_48_18,0.95,1,19,18,86
25,r_22_31_70,r_109_9_187,seq12,r_22_31_70,0.93,1,71,70,86
23,r_26_47_11,seq17,seq127,r_26_47_11,0.94,3,14,11,86
32,r_69_1_154,r_32_88_161,r_98_57_128,r_32_88_161,0.93,-6,155,161,86
46,r_149_82_38,r_15_92_168,r_59_112_8,r_149_82_38,0.79,0,38,38,86
22,r_119_129_99,seq5,seq58,r_119_129_99,0.84,1,100,99,86
49,r_11_18_82,seq23,seq58,r_11_18_82,0.98,0,82,82,86
7,r_2_123_37,seq79,seq72,r_2_123_37,0.99,0,37,37,86
33,r_130_86_49,r_59_112_8,seq65,r_130_86_49,0.61,0,49,49,86
56,seq12,r_68_91_88,r_22_31_70,r_22_31_70,0.97,22,92,70,86
44,r_14_53_126,seq143,seq5,r_14_53_126,0.59,0,126,126,86
35,r_19_54_118,seq116,r_41_140_30,r_19_54_118,0.64,1,119,118,86
12,r_90_40_94,seq127,seq132,r_90_40_94,0.55,3,97,94,86
84,seq79,seq89,r_44_49_58,r_44_49_58,1.0,25,83,58,86
93,seq104,r_61_122_114,r_134_121_12,r_61_122_114,1.0,1,115,114,87
14,r_89_90_118,seq135,r_94_65_50,r_89_90_118,0.93,1,119,118,87
8,r_134_121_12,seq8,seq42,r_134_121_12,0.89,-1,11,12,87
43,r_22_77_83,r_4_47_109,seq55,r_22_77_83,0.79,0,83,83,87
86,seq135,r_89_90_118,seq104,r_89_90_118,0.99,1,119,118,87
21,r_141_109_130,r_50_126_24,r_6_114_198,r_141_109_130,0.86,0,130,130,87
1,r_26_20_187,r_12_115_168,r_29_67_57,r_29_67_57,1.0,131,188,57,87
5,r_93_16_67,r_38_91_71,r_131_108_54,r_38_91_71,1.0,0,71,71,87
42,r_119_10_192,seq82,r_93_16_67,r_93_16_67,0.98,13,80,67,87
6,r_145_139_44,seq54,seq79,r_145_139_44,1.0,0,44,44,87
66,seq42,r_61_122_114,r_134_121_12,r_61_122_114,1.0,-49,65,114,87
26,r_124_14_28,r_3_58_119,seq82,r_124_14_28,0.84,-5,23,28,87
41,r_4_47_109,r_60_39_161,seq43,r_4_47_109,0.88,11,120,109,87
89,seq98,r_19_144_140,r_17_118_111,r_19_144_140,0.48,-1,139,140,87
3,r_132_92_94,seq127,seq32,r_132_92_94,0.92,3,97,94,87
34,r_56_80_36,r_119_10_192,r_6_114_198,r_56_80_36,0.84,2,38,36,87
4,r_17_118_111,r_48_13_142,r_24_52_34,r_17_118_111,0.96,0,111,111,87
0,r_33_59_103,r_19_144_140,r_18_66_25,r_33_59_103,1.0,0,103,103,87
20,r_48_13_142,r_28_40_174,r_124_14_28,r_48_13_142,0.69,0,142,142,87
13,r_61_122_114,seq104,r_132_92_94,r_61_122_114,1.0,1,115,114,87
48,r_37_149_150,r_99_68_181,seq138,r_99_68_181,0.56,-30,151,181,87
27,r_85_113_86,r_4_47_109,seq128,r_85_113_86,0.98,0,86,86,87
2,r_140_35_62,r_117_9_112,seq1,r_140_35_62,1.0,0,62,62,87
40,r_41_110_186,seq142,r_23_143_137,r_23_143_137,0.67,49,186,137,87
18,r_34_84_184,seq146,r_145_139_44,r_145_139_44,1.0,140,184,44,87
24,r_23_143_137,seq104,r_85_113_86,r_23_143_137,0.93,0,137,137,87
33,r_73_105_120,seq133,seq44,r_73_105_120,0.86,0,120,120,87
19,r_29_67_57,r_33_59_103,r_62_69_73,r_33_59_103,0.98,0,103,103,87
36,r_94_65_50,r_62_69_73,seq133,r_62_69_73,0.93,-23,50,73,87
45,r_24_52_34,r_27_137_81,seq98,r_24_52_34,1.0,0,34,34,87
60,seq147,r_28_40_174,r_19_144_140,r_28_40_174,0.91,0,174,174,87
45,r_24_52_34,seq98,r_17_118_111,r_17_118_111,0.79,24,135,111,87
17,r_38_91_71,r_93_16_67,r_134_121_12,r_38_91_71,0.99,0,71,71,87
28,r_36_100_159,seq102,r_134_121_12,r_36_100_159,0.68,0,159,159,87
49,r_148_78_104,r_93_16_67,r_117_9_112,r_148_78_104,1.0,0,104,104,87
44,r_11_83_173,r_117_9_112,r_4_47_109,r_11_83_173,0.73,0,173,173,87
23,r_3_58_119,seq5,r_6_114_198,r_3_58_119,0.95,1,120,119,87
35,r_27_137_81,seq81,r_50_126_24,r_27_137_81,0.51,14,95,81,87
19,r_29_67_57,r_26_20_187,r_33_59_103,r_29_67_57,1.0,0,57,57,87
37,r_84_1_53,r_133_38_65,seq28,r_84_1_53,0.77,-6,47,53,88
36,r_66_144_194,r_63_98_99,seq29,r_63_98_99,0.98,2,101,99,88
92,seq108,r_70_126_116,r_84_1_53,r_70_126_116,0.94,14,130,116,88
14,r_50_136_128,r_2_90_195,r_21_106_85,r_2_90_195,0.73,-64,131,195,88
43,r_123_48_183,r_2_90_195,r_141_51_27,r_141_51_27,0.63,156,183,27,88
42,r_35_115_147,seq104,r_88_118_72,r_88_118_72,0.99,-15,57,72,88
55,seq12,r_65_0_171,r_79_140_172,r_65_0_171,0.45,0,171,171,88
16,r_75_7_76,seq14,seq134,r_75_7_76,0.99,1,77,76,88
21,r_138_109_78,seq137,seq16,r_138_109_78,0.59,-1,77,78,88
46,r_127_25_89,r_59_23_138,r_75_7_76,r_127_25_89,0.85,-4,85,89,88
45,r_31_9_106,r_78_86_117,r_75_7_76,r_31_9_106,0.85,1,107,106,88
10,r_88_118_72,r_46_40_174,r_35_115_147,r_88_118_72,0.94,-29,43,72,88
19,r_22_19_74,r_93_45_197,seq124,r_22_19_74,0.8,-9,65,74,88
17,r_145_87_39,r_59_23_138,r_56_135_173,r_145_87_39,0.91,0,39,39,88
1,r_61_122_32,r_70_126_116,r_93_45_197,r_61_122_32,0.9,-2,30,32,88
31,r_63_98_99,r_66_144_194,seq114,r_66_144_194,0.61,-93,101,194,88
41,r_55_105_100,r_149_76_98,r_145_87_39,r_55_105_100,0.49,-11,89,100,88
26,r_125_54_159,r_93_45_197,r_138_109_78,r_93_45_197,0.48,-30,167,197,88
0,r_44_148_23,r_146_13_118,seq12,r_44_148_23,0.85,0,23,23,88
13,r_78_86_117,seq64,r_149_76_98,r_78_86_117,0.82,3,120,117,88
15,r_120_132_127,r_149_76_98,r_145_87_39,r_149_76_98,0.73,34,132,98,88
48,r_10_110_90,r_143_101_153,seq17,r_10_110_90,0.7,-2,88,90,88
10,r_88_118_72,r_35_115_147,seq116,r_35_115_147,0.63,2,149,147,88
27,r_146_13_118,seq28,r_119_128_59,r_146_13_118,0.72,1,119,118,88
49,r_119_128_59,r_5_42_119,r_141_51_27,r_119_128_59,0.92,-22,37,59,88
2,r_139_97_185,seq73,r_60_74_5,r_139_97_185,0.34,1,186,185,88
47,r_102_80_67,seq32,seq4,r_102_80_67,0.96,-2,65,67,88
40,r_89_27_122,seq28,seq113,r_89_27_122,0.59,9,131,122,88
29,r_143_101_153,seq43,seq47,r_143_101_153,0.43,3,156,153,88
25,r_21_106_85,seq117,seq137,r_21_106_85,0.92,0,85,85,88
33,r_46_40_174,seq134,seq108,r_46_40_174,0.25,3,177,174,88
11,r_133_38_65,r_56_135_173,seq64,r_133_38_65,0.84,-6,59,65,88
32,r_65_0_171,r_91_72_156,r_133_38_65,r_91_72_156,0.54,15,171,156,88
34,r_91_72_156,r_65_0_171,r_66_144_194,r_65_0_171,0.64,-7,164,171,88
69,seq41,r_83_8_29,seq92,r_83_8_29,1.0,0,29,29,88
22,r_5_42_119,seq92,seq108,r_5_42_119,0.69,11,130,119,88
56,seq14,r_75_7_76,r_56_135_173,r_75_7_76,0.53,-1,75,76,88
7,r_79_140_172,r_37_34_167,seq12,r_37_34_167,0.47,2,169,167,88
44,r_129_121_80,r_146_13_118,seq33,r_129_121_80,0.93,-9,71,80,88
20,r_83_8_29,seq41,seq137,r_83_8_29,1.0,0,29,29,88
23,r_37_34_167,r_79_140_172,r_84_1_53,r_37_34_167,0.35,2,169,167,88
17,r_145_87_39,r_56_135_173,r_55_105_100,r_55_105_100,0.87,14,114,100,88
35,r_93_45_197,r_22_19_74,r_61_122_32,r_93_45_197,0.79,-132,65,197,88
92,seq100,seq12,r_68_113_97,r_68_113_97,1.0,20,117,97,89
8,r_123_36_71,seq147,seq86,r_123_36_71,0.98,1,72,71,89
43,r_73_67_84,r_144_19_144,r_25_104_50,r_25_104_50,0.54,35,85,50,89
3,r_138_110_35,r_130_142_142,r_48_115_31,r_130_142_142,0.9,1,143,142,89
14,r_22_3_28,r_136_111_25,r_41_7_70,r_22_3_28,0.49,48,76,28,89
16,r_45_9_133,r_16_108_171,r_95_80_118,r_45_9_133,0.41,1,134,133,89
21,r_144_19_144,seq86,r_25_104_50,r_144_19_144,0.59,0,144,144,89
39,r_76_31_60,r_63_15_173,seq133,r_76_31_60,1.0,0,60,60,89
32,r_79_57_51,r_140_4_57,seq53,r_79_57_51,1.0,-1,50,51,89
46,r_74_32_102,seq134,seq61,r_74_32_102,0.84,12,114,102,89
42,r_68_113_97,r_54_49_152,seq100,r_68_113_97,0.98,0,97,97,89
40,r_51_91_72,r_5_43_131,r_95_80_118,r_51_91_72,1.0,59,131,72,89
3,r_138_110_35,seq12,r_130_142_142,r_138_110_35,1.0,-1,34,35,89
24,r_33_149_22,r_21_148_111,r_79_57_51,r_21_148_111,1.0,2,113,111,89
57,seq12,r_138_110_35,seq100,r_138_110_35,0.81,-11,24,35,89
19,r_78_71_182,seq135,r_138_110_35,r_138_110_35,1.0,147,182,35,89
27,r_21_148_111,r_33_149_22,r_24_101_19,r_21_148_111,0.98,2,113,111,89
31,r_121_46_85,seq85,r_76_31_60,r_76_31_60,1.0,33,93,60,89
41,r_41_7_70,r_5_43_131,r_22_3_28,r_41_7_70,0.98,0,70,70,89
30,r_130_142_142,r_51_91_72,r_138_110_35,r_130_142_142,0.91,-108,34,142,89
67,seq35,r_95_80_118,seq61,r_95_80_118,1.0,-46,72,118,89
26,r_23_82_127,r_52_66_120,seq6,r_23_82_127,0.34,0,127,127,89
15,r_24_101_19,r_27_87_177,seq118,r_24_101_19,0.88,0,19,19,89
0,r_54_49_152,seq11,r_38_50_37,r_38_50_37,0.96,117,154,37,89
20,r_16_108_171,seq53,r_114_120_123,r_114_120_123,0.98,58,181,123,89
48,r_141_132_189,seq137,r_90_109_114,r_90_109_114,1.0,76,190,114,89
6,r_38_50_37,r_144_19_144,seq135,r_38_50_37,0.59,0,37,37,89
45,r_112_62_49,r_27_87_177,seq34,r_112_62_49,1.0,1,50,49,89
30,r_130_142_142,r_138_110_35,r_90_109_114,r_138_110_35,0.68,108,143,35,89
4,r_126_102_94,r_116_0_68,r_112_62_49,r_126_102_94,1.0,-44,50,94,89
47,r_2_128_164,seq117,seq89,r_2_128_164,0.59,1,165,164,89
40,r_51_91_72,r_130_142_142,r_5_43_131,r_51_91_72,1.0,0,72,72,89
74,seq53,r_16_108_171,r_5_43_131,r_5_43_131,1.0,50,181,131,89
18,r_8_83_175,seq47,r_5_43_131,r_5_43_131,0.87,44,175,131,89
17,r_107_58_16,r_63_15_173,r_27_87_177,r_107_58_16,0.85,1,17,16,89
29,r_122_145_59,r_140_4_57,seq11,r_140_4_57,0.97,-5,52,57,89
57,seq12,seq100,r_90_109_114,r_90_109_114,1.0,3,117,114,89
34,r_65_93_167,r_88_1_40,r_138_110_35,r_138_110_35,0.42,135,170,35,89
2,r_136_111_25,r_140_4_57,seq13,r_136_111_25,0.93,0,25,25,89
24,r_33_149_22,r_136_111_25,r_21_148_111,r_33_149_22,0.57,3,25,22,89
1,r_27_87_177,seq64,r_107_58_16,r_107_58_16,0.96,12,28,16,89
14,r_22_3_28,r_48_115_31,r_136_111_25,r_48_115_31,0.99,-3,28,31,89
9,r_90_109_114,seq14,seq12,r_90_109_114,0.99,0,114,114,89
27,r_21_148_111,r_45_9_133,r_33_149_22,r_33_149_22,1.0,0,22,22,89
22,r_5_43_131,r_41_7_70,seq53,r_5_43_131,0.99,0,131,131,89
5,r_140_4_57,r_78_71_182,r_88_1_40,r_140_4_57,1.0,1,58,57,89
49,r_116_0_68,seq133,seq98,r_116_0_68,1.0,0,68,68,89
44,r_129_94_104,r_90_109_114,r_123_36_71,r_90_109_114,1.0,-9,105,114,89
23,r_114_120_123,r_5_43_131,r_122_145_59,r_122_145_59,0.49,64,123,59,89
17,r_107_58_16,r_27_87_177,r_140_4_57,r_140_4_57,1.0,121,178,57,89
12,r_88_1_40,r_65_93_167,r_140_4_57,r_140_4_57,1.0,113,170,57,89
36,r_120_130_135,r_20_133_190,r_119_1_63,r_20_133_190,0.59,-52,138,190,90
14,r_109_105_140,r_71_98_195,r_102_145_143,r_109_105_140,1.0,0,140,140,90
8,r_119_1_63,r_102_145_143,seq32,r_119_1_63,0.55,0,63,63,90
43,r_28_124_98,r_94_78_111,seq21,r_28_124_98,1.0,0,98,98,90
59,seq143,r_20_133_190,r_112_22_104,r_112_22_104,0.64,86,190,104,90
16,r_11_88_66,seq114,r_119_1_63,r_11_88_66,0.52,-1,65,66,90
21,r_100_9_115,seq104,seq56,r_100_9_115,0.55,30,145,115,90
39,r_92_15_70,r_94_78_111,r_119_1_63,r_92_15_70,1.0,-1,69,70,90
1,r_44_47_94,r_140_118_178,r_149_95_46,r_44_47_94,0.82,0,94,94,90
5,r_102_145_143,r_79_80_179,r_109_105_140,r_109_105_140,0.98,5,145,140,90
42,r_20_133_190,r_120_130_135,r_112_22_104,r_20_133_190,0.54,-91,99,190,90
24,r_87_27_43,seq43,seq81,r_87_27_43,0.89,-2,41,43,90
38,r_37_23_136,r_147_77_40,r_41_57_102,r_147_77_40,1.0,-1,39,40,90
38,r_37_23_136,r_41_57_102,r_18_85_12,r_37_23_136,0.73,-5,131,136,90
31,r_136_13_103,r_33_69_161,r_41_57_102,r_33_69_161,0.86,-60,101,161,90
3,r_70_108_84,seq39,r_82_132_20,r_70_108_84,1.0,0,84,84,90
18,r_75_148_32,r_102_145_143,seq6,r_75_148_32,0.86,1,33,32,90
33,r_135_42_48,seq6,seq81,r_135_42_48,1.0,0,48,48,90
0,r_94_78_111,r_86_110_100,r_70_108_84,r_94_78_111,1.0,-12,99,111,90
15,r_117_35_153,r_146_50_142,seq30,r_117_35_153,0.89,0,153,153,90
48,r_65_54_110,r_100_9_115,seq63,r_65_54_110,0.56,-9,101,110,90
37,r_147_77_40,r_37_23_136,seq93,r_147_77_40,1.0,0,40,40,90
45,r_149_95_46,r_100_9_115,seq39,r_149_95_46,0.98,1,47,46,90
20,r_18_85_12,r_94_78_111,seq5,r_18_85_12,0.93,1,13,12,90
47,r_86_110_100,r_94_78_111,r_119_1_63,r_86_110_100,1.0,-1,99,100,90
40,r_26_128_61,r_117_35_153,r_41_57_102,r_26_128_61,0.95,0,61,61,90
29,r_8_96_155,seq122,r_102_145_143,r_8_96_155,0.98,0,155,155,90
25,r_112_22_104,seq89,seq143,r_112_22_104,0.66,8,112,104,90
65,seq30,r_140_118_178,r_117_35_153,r_117_35_153,0.8,24,177,153,90
42,r_20_133_190,r_112_22_104,r_75_148_32,r_112_22_104,0.62,86,190,104,90
32,r_41_57_102,r_2_72_162,r_26_128_61,r_26_128_61,1.0,0,61,61,90
89,seq91,seq121,r_82_132_20,r_82_132_20,0.98,1,21,20,90
34,r_83_125_36,seq4,seq30,r_83_125_36,1.0,-5,31,36,90
22,r_36_101_62,r_136_13_103,seq73,r_36_101_62,1.0,1,63,62,90
28,r_84_90_171,seq63,r_146_50_142,r_84_90_171,0.72,0,171,171,90
7,r_67_29_117,seq74,r_147_77_40,r_67_29_117,0.58,1,118,117,90
23,r_146_50_142,r_117_35_153,seq34,r_117_35_153,0.94,0,153,153,90
6,r_141_40_57,r_113_138_5,r_3_24_35,r_141_40_57,1.0,0,57,57,90
35,r_33_69_161,seq48,r_62_134_157,r_33_69_161,0.87,1,162,161,90
12,r_140_118_178,seq30,seq43,r_140_118_178,0.69,0,178,178,90
30,r_146_106_187,seq134,r_115_53_137,r_115_53_137,0.7,52,189,137,91
8,r_44_92_169,seq68,r_113_93_117,r_113_93_117,0.67,53,170,117,91
9,r_65_7_34,r_40_18_67,seq21,r_65_7_34,0.96,0,34,34,91
28,r_58_60_24,r_39_107_68,r_55_140_2,r_58_60_24,0.84,-3,21,24,91
37,r_141_43_103,r_78_63_118,r_30_47_1,r_141_43_103,0.97,4,107,103,91
49,r_34_24_23,seq127,r_132_1_196,r_34_24_23,0.41,15,38,23,91
71,seq51,r_19_98_123,r_33_144_22,r_19_98_123,0.53,-29,94,123,91
16,r_9_31_138,seq123,seq13,r_9_31_138,0.67,1,139,138,91
21,r_50_16_69,seq6,r_137_3_122,r_50_16_69,0.79,2,71,69,91
46,r_120_102_146,seq99,r_137_3_122,r_120_102_146,0.27,0,146,146,91
31,r_133_59_188,seq20,r_124_61_94,r_133_59_188,0.27,1,189,188,91
3,r_72_2_149,seq52,seq104,r_72_2_149,0.65,2,151,149,91
10,r_78_63_118,r_22_26_127,r_64_149_59,r_22_26_127,0.99,-9,118,127,91
20,r_54_45_46,r_55_140_2,seq116,r_54_45_46,0.97,1,47,46,91
35,r_130_84_51,r_44_92_169,seq94,r_130_84_51,0.97,2,53,51,91
4,r_37_145_64,r_23_147_79,r_130_84_51,r_130_84_51,0.7,13,64,51,91
26,r_114_126_18,r_72_2_149,seq51,r_114_126_18,0.92,-4,14,18,91
0,r_19_98_123,seq51,r_78_63_118,r_19_98_123,0.57,3,126,123,91
11,r_36_67_75,r_103_100_165,r_137_3_122,r_36_67_75,0.95,4,79,75,91
13,r_124_61_94,r_87_70_150,r_28_136_114,r_87_70_150,0.61,-55,95,150,91
15,r_22_26_127,seq15,r_124_61_94,r_22_26_127,0.89,4,131,127,91
48,r_74_86_141,r_137_3_122,r_37_145_64,r_74_86_141,0.73,0,141,141,91
38,r_33_144_22,r_39_107_68,seq51,r_33_144_22,0.77,6,28,22,91
27,r_12_29_83,r_115_53_137,r_65_7_34,r_12_29_83,0.51,8,91,83,91
47,r_109_83_88,r_133_59_188,seq35,r_109_83_88,0.98,1,89,88,91
18,r_23_147_79,seq138,seq134,r_23_147_79,0.99,2,81,79,91
24,r_113_93_117,seq104,r_33_144_22,r_113_93_117,0.88,0,117,117,91
33,r_64_149_59,r_55_140_2,seq138,r_64_149_59,1.0,2,61,59,91
88,seq99,r_120_102_146,r_40_18_67,r_40_18_67,1.0,79,146,67,91
65,seq134,r_146_106_187,r_23_147_79,r_23_147_79,1.0,110,189,79,91
14,r_77_105_30,r_78_63_118,seq85,r_77_105_30,0.92,0,30,30,91
34,r_40_18_67,r_115_53_137,seq99,r_40_18_67,0.96,1,68,67,91
7,r_39_107_68,seq6,seq88,r_39_107_68,0.59,0,68,68,91
44,r_97_95_140,seq21,r_141_43_103,r_141_43_103,0.46,42,145,103,91
41,r_5_81_40,seq13,seq110,r_5_81_40,0.88,0,40,40,91
86,seq94,seq122,r_130_84_51,r_130_84_51,0.73,8,59,51,91
12,r_115_53_137,seq110,r_54_45_46,r_115_53_137,0.88,3,140,137,91
30,r_4_34_132,r_99_112_190,r_46_111_32,r_4_34_132,0.92,0,132,132,92
2,r_102_5_27,r_21_42_31,seq8,r_21_42_31,1.0,-4,27,31,92
14,r_106_146_180,seq36,r_119_80_46,r_106_146_180,0.59,0,180,180,92
37,r_55_58_148,seq89,r_21_42_31,r_21_42_31,1.0,119,150,31,92
39,r_86_66_134,seq134,r_88_124_8,r_86_66_134,0.87,0,134,134,92
1,r_43_7_126,r_72_108_128,seq148,r_43_7_126,0.56,0,126,126,92
46,r_27_81_133,seq144,seq133,r_27_81_133,0.88,1,134,133,92
25,r_85_31_82,r_118_22_53,seq149,r_118_22_53,1.0,-16,37,53,92
19,r_17_25_141,seq89,r_119_80_46,r_17_25_141,0.94,0,141,141,92
31,r_72_108_128,r_43_7_126,seq56,r_72_108_128,0.91,0,128,128,92
41,r_93_35_74,seq144,r_102_5_27,r_93_35_74,1.0,-2,72,74,92
3,r_20_33_91,seq149,r_137_74_83,r_20_33_91,0.93,0,91,91,92
10,r_141_38_86,r_131_13_168,r_88_124_8,r_141_38_86,0.97,-1,85,86,92
26,r_113_82_78,r_14_1_123,seq48,r_113_82_78,1.0,-1,77,78,92
16,r_117_10_179,r_46_111_32,r_43_7_126,r_117_10_179,0.62,0,179,179,92
0,r_137_74_83,seq16,r_102_5_27,r_137_74_83,1.0,0,83,83,92
11,r_61_0_125,seq148,r_136_98_101,r_136_98_101,1.0,25,126,101,92
20,r_131_13_168,seq8,seq57,r_131_13_168,0.67,0,168,168,92
15,r_95_114_155,r_99_112_190,r_21_42_31,r_99_112_190,0.53,-35,155,190,92
54,seq133,r_43_7_126,r_105_32_11,r_105_32_11,0.98,16,27,11,92
21,r_118_22_53,r_85_31_82,r_53_121_20,r_118_22_53,0.99,0,53,53,92
36,r_53_121_20,r_99_112_190,seq71,r_53_121_20,0.99,-1,19,20,92
6,r_14_1_123,seq6,r_88_124_8,r_14_1_123,0.85,0,123,123,92
23,r_78_39_15,r_102_5_27,r_117_10_179,r_78_39_15,0.99,0,15,15,92
85,seq89,r_55_58_148,r_30_52_35,r_30_52_35,1.0,0,35,35,92
27,r_142_24_184,seq90,r_43_7_126,r_142_24_184,0.48,3,187,184,92
22,r_37_83_18,r_84_135_162,r_103_107_146,r_37_83_18,0.62,146,164,18,92
48,r_30_52_35,r_142_24_184,seq89,r_30_52_35,1.0,0,35,35,92
82,seq71,r_103_107_146,r_53_121_20,r_53_121_20,0.72,7,27,20,92
40,r_68_147_115,r_43_7_126,seq149,r_68_147_115,0.69,10,125,115,92
17,r_45_140_51,seq11,seq116,r_45_140_51,1.0,4,55,51,92
18,r_136_98_101,seq110,r_85_31_82,r_136_98_101,1.0,0,101,101,92
43,r_46_111_32,r_137_74_83,r_117_10_179,r_46_111_32,0.98,-1,31,32,92
47,r_105_32_11,r_137_74_83,seq133,r_105_32_11,0.78,0,11,11,92
43,r_46_111_32,r_117_10_179,r_4_34_132,r_4_34_132,0.94,47,179,132,92
4,r_21_42_31,r_102_5_27,r_54_51_7,r_21_42_31,1.0,0,31,31,92
32,r_75_87_98,seq77,r_85_31_82,r_75_87_98,1.0,0,98,98,92
12,r_119_80_46,r_141_38_86,seq48,r_141_38_86,0.67,-49,37,86,92
34,r_49_130_186,r_97_94_197,r_103_107_146,r_103_107_146,0.68,42,188,146,92
22,r_37_83_18,r_141_38_86,r_84_135_162,r_37_83_18,0.87,0,18,18,92
9,r_139_18_151,seq148,seq134,r_139_18_151,0.85,0,151,151,92
28,r_9_96_166,r_99_112_190,r_21_42_31,r_99_112_190,0.6,-24,166,190,92
24,r_54_51_7,r_137_74_83,r_21_42_31,r_54_51_7,0.96,25,32,7,92
49,r_128_26_140,seq90,r_4_34_132,r_128_26_140,0.52,0,140,140,92
7,r_103_107_146,r_106_146_180,seq132,r_103_107_146,0.78,0,146,146,92
44,r_84_135_162,r_37_83_18,r_45_140_51,r_45_140_51,0.99,113,164,51,92
16,r_117_10_179,r_93_35_74,r_46_111_32,r_117_10_179,1.0,-148,31,179,92
23,r_78_39_15,r_117_10_179,r_45_140_51,r_45_140_51,0.94,128,179,51,92
45,r_29_115_36,seq62,seq116,r_29_115_36,1.0,1,37,36,92
14,r_51_93_126,seq52,r_41_15_44,r_51_93_126,0.97,0,126,126,93
43,r_38_131_131,r_111_118_178,r_45_117_67,r_38_131_131,0.94,1,132,131,93
3,r_23_1_11,r_47_124_119,seq37,r_23_1_11,0.75,0,11,11,93
16,r_62_16_124,r_51_93_126,r_139_11_3,r_139_11_3,0.52,121,124,3,93
21,r_103_34_96,seq134,r_139_11_3,r_103_34_96,1.0,0,96,96,93
97,seq125,r_111_118_178,r_41_15_44,r_41_15_44,1.0,59,103,44,93
42,r_143_88_61,r_40_136_94,seq99,r_143_88_61,1.0,1,62,61,93
19,r_22_107_81,r_54_69_144,r_135_113_29,r_22_107_81,1.0,0,81,81,93
29,r_135_113_29,r_40_136_94,seq26,r_135_113_29,0.97,1,30,29,93
30,r_108_73_15,r_18_96_28,seq52,r_108_73_15,0.99,1,16,15,93
31,r_123_110_86,seq26,seq141,r_123_110_86,1.0,0,86,86,93
10,r_47_124_119,seq61,r_81_60_34,r_47_124_119,1.0,1,120,119,93
26,r_49_105_129,seq97,seq52,r_49_105_129,0.87,1,130,129,93
4,r_85_142_115,r_87_55_45,seq30,r_85_142_115,0.98,0,115,115,93
9,r_87_55_45,r_20_70_143,seq97,r_87_55_45,0.88,-6,39,45,93
11,r_145_119_85,seq99,seq121,r_145_119_85,0.73,1,86,85,93
46,r_29_95_132,r_18_96_28,seq44,r_29_95_132,0.99,0,132,132,93
48,r_128_114_181,seq115,r_145_119_85,r_128_114_181,0.49,1,182,181,93
6,r_18_96_28,r_133_2_117,r_29_95_132,r_18_96_28,0.9,0,28,28,93
27,r_130_98_141,seq71,r_23_1_11,r_23_1_11,0.93,136,147,11,93
37,r_76_106_49,r_146_75_197,seq3,r_76_106_49,0.96,0,49,49,93
2,r_64_100_105,r_129_144_1,r_41_15_44,r_41_15_44,1.0,71,115,44,93
46,r_29_95_132,r_86_77_190,r_18_96_28,r_18_96_28,0.9,5,33,28,93
24,r_8_35_71,seq48,seq127,r_8_35_71,1.0,0,71,71,93
25,r_45_117_67,seq25,seq30,r_45_117_67,0.56,3,70,67,93
70,seq44,seq52,r_29_95_132,r_29_95_132,0.95,1,133,132,93
6,r_18_96_28,r_29_95_132,r_79_72_23,r_29_95_132,1.0,0,132,132,93
20,r_81_60_34,r_87_55_45,seq126,r_81_60_34,0.94,4,38,34,93
32,r_92_13_142,seq83,r_82_148_13,r_92_13_142,0.57,0,142,142,93
38,r_5_74_110,seq27,seq17,r_5_74_110,0.72,6,116,110,93
34,r_33_138_89,seq14,r_23_1_11,r_33_138_89,0.82,0,89,89,93
5,r_116_94_21,r_91_0_133,seq78,r_116_94_21,1.0,0,21,21,93
49,r_79_72_23,r_111_118_178,seq25,r_79_72_23,1.0,0,23,23,93
60,seq25,r_45_117_67,r_79_72_23,r_79_72_23,0.93,47,70,23,93
17,r_10_24_188,seq27,r_85_142_115,r_85_142_115,1.0,74,189,115,93
22,r_68_109_147,seq19,r_145_119_85,r_68_109_147,0.9,0,147,147,93
7,r_91_0_133,seq46,seq80,r_91_0_133,0.48,0,133,133,93
44,r_20_70_143,r_58_12_199,r_103_34_96,r_103_34_96,1.0,50,146,96,93
30,r_94_71_95,seq21,r_1_134_2,r_94_71_95,1.0,1,96,95,94
0,r_141_104_28,r_130_25_149,seq107,r_141_104_28,1.0,0,28,28,94
36,r_57_133_76,seq74,r_18_97_159,r_57_133_76,0.78,-2,74,76,94
21,r_69_52_145,r_62_30_186,r_146_100_100,r_69_52_145,0.66,0,145,145,94
1,r_147_76_10,r_70_125_88,r_141_104_28,r_70_125_88,0.88,0,88,88,94
46,r_126_37_121,r_41_79_160,r_117_51_118,r_117_51_118,0.93,26,144,118,94
24,r_89_120_19,r_116_43_102,seq137,r_89_120_19,0.98,-1,18,19,94
34,r_123_55_29,r_84_49_3,seq80,r_123_55_29,1.0,0,29,29,94
19,r_2_3_195,r_130_25_149,r_123_55_29,r_123_55_29,0.99,56,85,29,94
41,r_117_51_118,r_15_13_140,r_126_37_121,r_117_51_118,0.99,1,119,118,94
43,r_96_112_12,r_73_128_103,seq122,r_96_112_12,1.0,0,12,12,94
90,seq103,seq38,r_36_111_37,r_36_111_37,0.99,-2,35,37,94
38,r_82_86_59,r_84_49_3,r_77_59_13,r_82_86_59,1.0,0,59,59,94
4,r_62_30_186,seq12,r_29_148_101,r_29_148_101,1.0,85,186,101,94
11,r_8_34_109,seq107,seq95,r_8_34_109,1.0,0,109,109,94
39,r_142_5_48,r_63_140_82,seq40,r_142_5_48,0.97,1,49,48,94
49,r_9_7_84,r_84_49_3,r_146_100_100,r_146_100_100,0.78,26,126,100,94
15,r_50_48_63,r_136_109_187,seq65,r_50_48_63,0.99,0,63,63,94
48,r_136_109_187,r_126_37_121,r_50_48_63,r_50_48_63,1.0,125,188,63,94
45,r_121_131_47,r_50_48_63,r_96_112_12,r_121_131_47,0.98,0,47,47,94
27,r_41_79_160,seq113,r_77_59_13,r_41_79_160,0.75,1,161,160,94
1,r_147_76_10,r_141_104_28,r_70_125_88,r_70_125_88,1.0,-78,10,88,94
2,r_116_43_102,r_42_115_114,seq78,r_116_43_102,0.43,-8,94,102,94
18,r_15_13_140,seq80,r_70_125_88,r_70_125_88,0.98,52,140,88,94
29,r_70_125_88,r_23_102_193,seq87,r_70_125_88,1.0,0,88,88,94
13,r_36_111_37,seq118,seq103,r_36_111_37,0.96,-2,35,37,94
17,r_63_140_82,seq106,seq6,r_63_140_82,1.0,0,82,82,94
28,r_28_114_61,seq6,seq4,r_28_114_61,1.0,0,61,61,94
49,r_9_7_84,seq21,r_84_49_3,r_9_7_84,0.94,0,84,84,94
7,r_68_93_178,seq72,r_89_120_19,r_68_93_178,0.41,6,184,178,94
12,r_29_148_101,seq17,r_108_27_21,r_29_148_101,0.93,-1,100,101,94
35,r_108_27_21,r_141_104_28,r_1_134_2,r_1_134_2,0.91,19,21,2,94
36,r_94_73_144,seq32,r_14_137_6,r_94_73_144,0.92,1,145,144,95
29,r_50_31_77,r_130_92_22,r_74_62_24,r_74_62_24,0.99,3,27,24,95
8,r_27_63_160,seq125,r_68_143_79,r_68_143_79,1.0,83,162,79,95
37,r_65_18_187,seq9,r_15_145_169,r_65_18_187,0.45,-28,159,187,95
3,r_33_72_45,r_148_7_115,r_98_120_70,r_33_72_45,0.65,72,117,45,95
25,r_88_49_55,r_44_119_152,seq12,r_88_49_55,0.99,0,55,55,95
21,r_13_0_164,seq55,r_128_79_17,r_13_0_164,0.67,0,164,164,95
39,r_80_23_146,r_148_7_115,r_74_62_24,r_74_62_24,0.94,110,134,24,95
1,r_136_140_185,r_43_85_197,r_5_39_123,r_5_39_123,0.99,62,185,123,95
97,seq125,r_3_106_137,seq149,r_3_106_137,1.0,0,137,137,95
5,r_54_135_65,r_136_140_185,r_42_103_26,r_54_135_65,1.0,0,65,65,95
27,r_74_62_24,seq109,r_50_31_77,r_74_62_24,0.98,1,25,24,95
19,r_89_97_105,r_105_47_198,seq32,r_89_97_105,0.74,0,105,105,95
31,r_139_4_61,seq22,seq71,r_139_4_61,1.0,1,62,61,95
41,r_87_25_88,r_44_119_152,r_102_59_7,r_44_119_152,0.81,-64,88,152,95
26,r_90_132_66,r_26_82_195,r_107_129_37,r_90_132_66,1.0,0,66,66,95
0,r_44_119_152,seq32,seq109,r_44_119_152,0.88,1,153,152,95
11,r_142_112_177,r_64_104_110,seq38,r_64_104_110,0.55,7,117,110,95
27,r_74_62_24,r_50_31_77,r_20_34_194,r_50_31_77,0.65,1,78,77,95
33,r_107_129_37,r_33_72_45,seq141,r_107_129_37,0.64,4,41,37,95
29,r_50_31_77,r_74_62_24,r_33_72_45,r_50_31_77,0.67,1,78,77,95
2,r_122_28_153,r_102_59_7,r_66_115_143,r_102_59_7,0.27,152,159,7,95
47,r_3_106_137,seq125,r_102_59_7,r_3_106_137,1.0,0,137,137,95
74,seq71,r_136_140_185,r_96_56_89,r_96_56_89,1.0,85,174,89,95
24,r_83_53_151,r_26_82_195,r_64_104_110,r_83_53_151,0.92,0,151,151,95
3,r_33_72_45,seq10,r_148_7_115,r_33_72_45,0.65,6,51,45,95
70,seq55,r_136_140_185,r_5_39_123,r_5_39_123,1.0,34,157,123,95
32,r_60_131_165,r_58_100_193,r_15_145_169,r_15_145_169,0.72,-8,161,169,95
34,r_98_120_70,r_70_37_138,r_33_72_45,r_70_37_138,0.74,-67,71,138,95
17,r_70_37_138,r_98_120_70,seq10,r_98_120_70,0.92,1,71,70,95
9,r_52_51_134,r_13_0_164,seq101,r_52_51_134,0.79,0,134,134,95
11,r_142_112_177,seq38,r_102_59_7,r_102_59_7,0.57,161,168,7,95
22,r_134_46_86,seq55,r_45_41_76,r_45_41_76,0.59,13,89,76,95
28,r_148_7_115,r_80_23_146,r_42_103_26,r_148_7_115,0.64,-2,113,115,95
49,r_5_39_123,r_20_34_194,seq55,r_5_39_123,0.99,1,124,123,95
44,r_64_104_110,r_142_112_177,seq146,r_64_104_110,0.66,3,113,110,95
17,r_70_37_138,seq10,seq118,r_70_37_138,0.86,0,138,138,95
35,r_116_8_23,r_96_56_89,r_76_40_4,r_96_56_89,1.0,-25,64,89,95
12,r_45_41_76,seq77,r_134_46_86,r_45_41_76,1.0,3,79,76,95
84,seq101,seq35,r_52_51_134,r_52_51_134,0.99,0,134,134,95
30,r_39_144_190,seq90,r_71_148_67,r_39_144_190,0.37,0,190,190,96
21,r_139_55_52,seq75,r_15_93_162,r_139_55_52,0.67,2,54,52,96
36,r_3_36_60,r_40_31_54,r_89_57_75,r_3_36_60,1.0,0,60,60,96
18,r_52_70_81,r_74_136_142,r_91_14_42,r_91_14_42,0.5,-3,39,42,96
8,r_60_43_138,r_12_50_159,r_33_38_71,r_33_38_71,0.86,67,138,71,96
3,r_117_82_25,r_12_50_159,r_40_31_54,r_12_50_159,0.77,-20,139,159,96
19,r_91_14_42,r_52_70_81,r_145_126_143,r_145_126_143,0.54,1,144,143,96
71,seq63,r_33_38_71,r_71_148_67,r_71_148_67,1.0,9,76,67,96
39,r_2_69_141,r_133_73_55,r_129_103_12,r_2_69_141,0.9,1,142,141,96
1,r_41_23_120,seq147,seq86,r_41_23_120,0.8,8,128,120,96
5,r_88_54_98,r_66_123_137,seq124,r_88_54_98,1.0,1,99,98,96
46,r_46_80_112,r_39_144_190,r_120_132_61,r_39_144_190,0.9,-77,113,190,96
42,r_28_99_97,r_74_136_142,r_116_77_13,r_116_77_13,0.65,84,97,13,96
16,r_20_112_21,r_121_125_57,r_143_106_46,r_143_106_46,0.99,14,60,46,96
3,r_117_82_25,r_130_59_22,r_12_50_159,r_117_82_25,1.0,-1,24,25,96
45,r_13_142_51,r_35_67_160,seq110,r_13_142_51,1.0,0,51,51,96
26,r_15_93_162,r_6_10_189,r_139_55_52,r_139_55_52,0.67,4,56,52,96
76,seq76,r_53_85_154,r_121_125_57,r_53_85_154,1.0,-53,101,154,96
31,r_130_59_22,r_117_82_25,seq22,r_130_59_22,0.97,0,22,22,96
41,r_33_38_71,r_4_27_167,seq19,r_33_38_71,0.54,-10,61,71,96
10,r_95_48_3,r_66_123_137,seq72,r_66_123_137,0.83,2,139,137,96
43,r_0_118_24,r_21_49_166,seq76,r_0_118_24,1.0,0,24,24,96
2,r_32_102_16,r_6_10_189,seq68,r_32_102_16,0.99,0,16,16,96
4,r_45_65_165,seq5,seq24,r_45_65_165,0.55,0,165,165,96
0,r_120_132_61,r_35_67_160,r_84_58_38,r_120_132_61,1.0,0,61,61,96
16,r_20_112_21,r_6_10_189,r_121_125_57,r_20_112_21,0.99,1,22,21,96
11,r_6_10_189,seq17,r_60_43_138,r_60_43_138,0.68,51,189,138,96
15,r_66_123_137,r_88_54_98,r_95_48_3,r_88_54_98,1.0,1,99,98,96
48,r_79_47_179,r_39_144_190,r_12_50_159,r_39_144_190,0.45,-11,179,190,96
21,r_139_55_52,r_15_93_162,r_40_31_54,r_15_93_162,0.59,2,164,162,96
18,r_52_70_81,r_91_14_42,r_13_142_51,r_13_142_51,0.95,24,75,51,96
37,r_84_58_38,r_137_114_37,seq17,r_84_58_38,0.94,2,40,38,96
22,r_12_50_159,r_117_82_25,r_52_70_81,r_12_50_159,0.68,0,159,159,96
19,r_91_14_42,r_35_67_160,r_52_70_81,r_91_14_42,1.0,0,42,42,96
33,r_25_128_40,seq68,seq147,r_25_128_40,1.0,0,40,40,96
35,r_42_138_30,r_6_10_189,seq29,r_42_138_30,0.78,-6,24,30,96
47,r_4_27_167,seq63,r_52_70_81,r_52_70_81,0.69,98,179,81,96
40,r_21_49_166,seq113,r_28_99_97,r_28_99_97,1.0,69,166,97,96
14,r_131_92_44,r_53_85_154,seq24,r_131_92_44,0.77,3,47,44,96
29,r_140_8_125,seq127,r_61_98_136,r_140_8_125,0.86,0,125,125,96
25,r_62_134_10,r_139_55_52,seq101,r_62_134_10,1.0,0,10,10,96
32,r_145_126_143,seq24,r_91_14_42,r_91_14_42,0.9,101,143,42,96
34,r_53_85_154,seq76,seq94,r_53_85_154,0.87,4,158,154,96
6,r_137_114_37,r_84_58_38,r_32_102_16,r_137_114_37,0.85,3,40,37,96
81,seq90,r_79_47_179,r_21_49_166,r_79_47_179,0.64,0,179,179,96
17,r_35_67_160,seq37,seq141,r_35_67_160,0.79,1,161,160,96
26,r_15_93_162,r_139_55_52,r_62_134_10,r_15_93_162,0.83,1,163,162,96
22,r_12_50_159,r_60_43_138,r_117_82_25,r_117_82_25,0.97,113,138,25,96
13,r_143_106_46,seq149,r_20_112_21,r_143_106_46,0.84,1,47,46,96
15,r_66_123_137,r_95_48_3,seq113,r_66_123_137,0.87,2,139,137,96
49,r_74_136_142,seq147,r_21_49_166,r_74_136_142,0.9,0,142,142,96
7,r_71_148_67,seq22,seq63,r_71_148_67,0.93,3,70,67,96
79,seq147,r_41_23_120,r_25_128_40,r_25_128_40,1.0,61,101,40,96
12,r_9_87_177,r_129_103_12,r_66_123_137,r_9_87_177,0.64,0,177,177,96
84,seq97,r_88_54_98,seq72,r_88_54_98,1.0,-15,83,98,96
36,r_104_136_153,seq86,r_42_0_135,r_104_136_153,0.6,6,159,153,97
8,r_1_80_154,seq22,seq6,r_1_80_154,0.79,0,154,154,97
43,r_121_128_159,r_77_94_194,r_42_0_135,r_42_0_135,0.58,24,159,135,97
37,r_71_33_95,r_129_133_108,r_99_34_86,r_71_33_95,0.92,9,104,95,97
16,r_28_62_139,r_42_0_135,r_56_73_3,r_28_62_139,0.73,-1,138,139,97
21,r_3_53_94,r_111_124_75,r_77_94_194,r_3_53_94,0.86,3,97,94,97
39,r_16_117_177,seq11,r_32_57_69,r_32_57_69,0.63,110,179,69,97
42,r_77_94_194,r_121_128_159,r_3_53_94,r_77_94_194,0.68,-35,159,194,97
27,r_113_91_23,r_7_76_77,seq122,r_113_91_23,0.99,0,23,23,97
24,r_12_69_10,r_67_9_120,r_32_57_69,r_12_69_10,0.87,1,11,10,97
24,r_12_69_10,r_32_57_69,seq114,r_32_57_69,0.85,3,72,69,97
40,r_42_0_135,r_18_87_16,r_121_128_159,r_42_0_135,0.34,24,159,135,97
3,r_59_139_137,r_95_81_128,seq50,r_59_139_137,0.69,1,138,137,97
35,r_140_20_45,seq13,r_103_30_67,r_140_20_45,0.97,8,53,45,97
4,r_37_83_181,seq35,r_137_109_147,r_37_83_181,0.38,0,181,181,97
0,r_111_124_75,r_59_139_137,r_146_27_73,r_146_27_73,1.0,24,97,73,97
63,seq25,r_104_136_153,r_129_133_108,r_129_133_108,0.53,14,122,108,97
11,r_92_85_117,seq6,r_134_51_70,r_92_85_117,0.96,1,118,117,97
15,r_149_97_74,r_1_80_154,r_101_10_39,r_149_97_74,0.85,0,74,74,97
48,r_23_64_111,seq46,seq68,r_23_64_111,1.0,3,114,111,97
6,r_96_89_146,r_2_106_199,r_29_142_33,r_2_106_199,0.89,-51,148,199,97
19,r_116_61_20,r_7_76_77,r_120_107_13,r_116_61_20,0.72,2,22,20,97
10,r_29_142_33,r_126_55_36,seq49,r_29_142_33,1.0,0,33,33,97
2,r_32_57_69,r_12_69_10,seq6,r_32_57_69,0.96,3,72,69,97
30,r_18_87_16,r_104_136_153,r_129_133_108,r_129_133_108,0.62,18,126,108,97
56,seq13,r_140_20_45,seq6,r_140_20_45,0.91,8,53,45,97
47,r_17_44_79,seq35,r_74_138_4,r_17_44_79,1.0,0,79,79,97
40,r_42_0_135,r_28_62_139,r_18_87_16,r_42_0_135,0.58,-3,132,135,97
18,r_134_51_70,r_137_109_147,seq14,r_137_109_147,0.77,-63,84,147,97
29,r_99_34_86,seq135,r_71_33_95,r_99_34_86,1.0,1,87,86,97
25,r_112_79_82,seq6,r_74_138_4,r_112_79_82,0.98,1,83,82,97
33,r_146_27_73,seq11,seq147,r_146_27_73,1.0,1,74,73,97
68,seq38,r_54_4_189,r_96_89_146,r_96_89_146,0.91,43,189,146,97
34,r_129_133_108,r_23_64_111,r_18_87_16,r_18_87_16,0.58,92,108,16,97
30,r_18_87_16,r_29_142_33,r_104_136_153,r_18_87_16,0.62,-1,15,16,97
17,r_145_70_183,seq36,r_96_89_146,r_96_89_146,0.94,41,187,146,97
9,r_54_4_189,seq38,r_37_83_181,r_54_4_189,0.31,0,189,189,97
23,r_21_24_59,seq58,seq110,r_21_24_59,1.0,0,59,59,97
28,r_132_141_71,r_1_80_154,seq41,r_132_141_71,1.0,0,71,71,97
7,r_7_76_77,r_143_125_126,seq68,r_7_76_77,1.0,0,77,77,97
44,r_78_39_193,r_120_107_13,r_32_57_69,r_32_57_69,0.99,2,71,69,97
38,r_126_55_36,r_29_142_33,r_103_30_67,r_29_142_33,0.71,0,33,33,97
12,r_67_9_120,r_121_128_159,r_116_61_20,r_67_9_120,0.91,0,120,120,97
2,r_32_57_69,r_29_142_33,r_12_69_10,r_32_57_69,0.77,-58,11,69,97
14,r_30_122_119,r_29_134_112,seq79,r_30_122_119,0.68,9,128,119,98
43,r_43_6_105,seq76,r_61_115_98,r_61_115_98,0.99,35,133,98,98
37,r_26_12_43,r_128_98_179,r_88_67_28,r_26_12_43,1.0,0,43,43,98
16,r_75_106_93,seq129,r_87_103_79,r_75_106_93,0.97,0,93,93,98
21,r_9_32_114,r_83_5_173,seq102,r_9_32_114,0.89,2,116,114,98
39,r_52_92_68,seq46,r_93_105_30,r_52_92_68,0.98,1,69,68,98
1,r_140_82_152,seq144,seq102,r_140_82_152,0.97,0,152,152,98
32,r_53_120_26,r_110_24_193,seq50,r_53_120_26,0.65,-10,16,26,98
46,r_70_107_121,seq132,r_93_105_30,r_70_107_121,0.77,7,128,121,98
6,r_110_24_193,r_55_138_117,r_33_35_133,r_110_24_193,0.59,-144,49,193,98
45,r_117_0_132,r_149_146_134,seq139,r_117_0_132,0.89,0,132,132,98
19,r_91_60_66,seq7,seq143,r_91_60_66,1.0,0,66,66,98
10,r_128_98_179,seq132,r_93_105_30,r_93_105_30,0.49,149,179,30,98
30,r_74_45_19,r_145_101_159,seq76,r_74_45_19,0.76,0,19,19,98
11,r_39_11_70,seq79,seq42,r_39_11_70,0.84,-2,68,70,98
20,r_61_115_98,r_128_98_179,r_56_14_87,r_61_115_98,1.0,1,99,98,98
5,r_137_64_137,r_141_22_61,r_39_11_70,r_137_64_137,0.79,11,148,137,98
23,r_58_108_35,r_119_44_44,r_93_105_30,r_58_108_35,0.84,0,35,35,98
2,r_96_84_141,seq118,seq20,r_96_84_141,0.96,3,144,141,98
47,r_136_78_131,seq124,seq130,r_136_78_131,0.67,0,131,131,98
38,r_119_44_44,seq130,seq94,r_119_44_44,0.97,-1,43,44,98
40,r_87_103_79,seq79,r_61_115_98,r_87_103_79,0.78,0,79,79,98
18,r_62_27_167,seq121,r_49_54_110,r_62_27_167,0.55,0,167,167,98
29,r_69_111_84,r_136_78_131,r_91_60_66,r_136_78_131,1.0,-47,84,131,98
24,r_28_37_104,r_55_138_117,r_73_41_16,r_73_41_16,0.9,89,105,16,98
25,r_56_14_87,r_55_138_117,seq121,r_56_14_87,0.95,0,87,87,98
58,seq132,r_128_98_179,r_1_63_33,r_1_63_33,0.75,52,85,33,98
6,r_110_24_193,r_33_35_133,r_9_32_114,r_110_24_193,0.95,-71,122,193,98
40,r_87_103_79,r_61_115_98,r_75_106_93,r_87_103_79,0.88,20,99,79,98
41,r_16_47_34,r_33_35_133,r_85_13_10,r_16_47_34,0.54,1,35,34,98
34,r_149_146_134,r_117_0_132,seq104,r_149_146_134,0.76,1,135,134,98
26,r_85_13_10,r_58_108_35,seq132,r_85_13_10,0.87,0,10,10,98
81,seq79,r_39_11_70,r_149_146_134,r_39_11_70,0.85,3,73,70,98
17,r_55_138_117,seq102,seq66,r_55_138_117,1.0,2,119,117,98
9,r_77_114_125,r_29_134_112,r_65_147_12,r_29_134_112,0.75,18,130,112,98
96,seq121,r_62_27_167,r_61_115_98,r_61_115_98,0.92,69,167,98,98
13,r_65_147_12,r_86_126_50,seq57,r_65_147_12,0.56,37,49,12,98
28,r_141_22_61,r_137_64_137,r_55_138_117,r_55_138_117,1.0,31,148,117,98
49,r_109_17_160,seq129,seq10,r_109_17_160,0.72,0,160,160,98
33,r_86_126_50,r_65_147_12,seq42,r_86_126_50,0.7,-1,49,50,98
4,r_1_63_33,r_93_105_30,r_85_13_10,r_1_63_33,0.9,0,33,33,98
44,r_38_142_171,seq10,r_93_105_30,r_93_105_30,0.79,144,174,30,98
5,r_137_64_137,r_30_122_119,r_141_22_61,r_137_64_137,0.42,-88,49,137,98
35,r_72_113_67,seq148,seq143,r_72_113_67,1.0,0,67,67,98
12,r_49_54_110,seq144,seq3,r_49_54_110,0.77,0,110,110,98
30,r_40_42_98,seq111,r_133_58_89,r_40_42_98,0.99,0,98,98,99
36,r_146_13_113,r_124_106_154,r_120_79_187,r_146_13_113,0.85,6,119,113,99
8,r_92_15_160,seq110,seq20,r_92_15_160,0.65,0,160,160,99
37,r_9_8_91,r_51_44_181,r_116_22_67,r_9_8_91,0.97,0,91,91,99
21,r_116_22_67,seq23,seq105,r_116_22_67,0.99,1,68,67,99
39,r_127_45_69,seq57,r_91_74_21,r_127_45_69,1.0,5,74,69,99
5,r_85_137_78,seq105,r_143_1_32,r_85_137_78,0.79,0,78,78,99
58,seq147,r_93_104_134,r_30_4_131,r_93_104_134,0.65,-79,55,134,99
45,r_16_102_168,seq100,r_39_119_129,r_39_119_129,0.97,41,170,129,99
38,r_143_1_32,r_99_126_107,r_140_81_94,r_143_1_32,0.79,3,35,32,99
41,r_94_95_63,r_40_42_98,seq97,r_94_95_63,0.97,0,63,63,99
3,r_51_44_181,seq54,r_138_123_24,r_51_44_181,0.33,0,181,181,99
6,r_98_19_53,seq121,seq57,r_98_19_53,0.97,5,58,53,99
4,r_39_119_129,seq68,seq6,r_39_119_129,0.99,0,129,129,99
0,r_133_58_89,seq53,r_91_74_21,r_133_58_89,0.71,5,94,89,99
11,r_108_12_79,r_131_112_124,r_149_3_1,r_108_12_79,0.98,1,80,79,99
47,r_14_5_54,seq76,seq139,r_14_5_54,1.0,0,54,54,99
19,r_138_123_24,r_120_79_187,seq33,r_138_123_24,1.0,3,27,24,99
13,r_55_148_133,seq135,seq111,r_55_148_133,0.99,1,134,133,99
98,seq118,r_89_10_166,r_17_21_92,r_17_21_92,0.37,1,93,92,99
48,r_122_32_184,seq145,r_108_12_79,r_108_12_79,0.94,105,184,79,99
20,r_80_41_30,r_35_34_145,r_61_130_150,r_80_41_30,1.0,0,30,30,99
27,r_24_60_109,r_92_15_160,r_91_74_21,r_24_60_109,0.85,0,109,109,99
54,seq11,r_92_15_160,r_83_31_36,r_83_31_36,1.0,0,36,36,99
2,r_87_26_176,seq63,r_85_137_78,r_85_137_78,0.84,98,176,78,99
40,r_78_117_116,seq25,seq69,r_78_117_116,0.69,0,116,116,99
74,seq63,r_87_26_176,r_80_41_30,r_80_41_30,0.98,146,176,30,99
18,r_7_38_101,r_149_3_1,r_17_21_92,r_7_38_101,0.93,0,101,101,99
24,r_99_126_107,seq66,r_65_62_6,r_99_126_107,1.0,0,107,107,99
43,r_113_125_31,r_108_12_79,seq23,r_113_125_31,0.91,0,31,31,99
10,r_91_74_21,r_28_107_10,r_131_112_124,r_91_74_21,0.95,1,22,21,99
34,r_61_130_150,r_80_41_30,seq52,r_61_130_150,0.96,-7,143,150,99
12,r_140_81_94,seq25,r_143_1_32,r_143_1_32,0.8,7,39,32,99
20,r_80_41_30,r_61_130_150,r_30_4_131,r_80_41_30,0.69,113,143,30,99
42,r_120_79_187,r_146_13_113,r_98_19_53,r_120_79_187,0.48,0,187,187,99
42,r_120_79_187,r_89_10_166,r_146_13_113,r_146_13_113,0.88,-3,110,113,99
32,r_124_106_154,seq6,r_46_59_20,r_124_106_154,0.66,2,156,154,99
77,seq68,r_39_119_129,seq111,r_39_119_129,0.92,0,129,129,99
38,r_143_1_32,r_140_81_94,r_85_137_78,r_143_1_32,0.95,49,81,32,99
34,r_61_130_150,r_136_144_80,r_80_41_30,r_61_130_150,0.95,-69,81,150,99
42,r_120_79_187,r_138_123_24,r_89_10_166,r_120_79_187,0.59,-160,27,187,99
17,r_35_34_145,seq88,r_91_74_21,r_35_34_145,0.87,0,145,145,99
9,r_71_2_82,r_70_90_83,r_116_22_67,r_71_2_82,0.96,0,82,82,99
22,r_136_144_80,r_61_130_150,seq53,r_136_144_80,0.96,1,81,80,99
28,r_70_90_83,r_71_2_82,r_28_107_10,r_70_90_83,0.92,1,84,83,99
12,r_140_81_94,r_143_1_32,seq111,r_140_81_94,1.0,1,95,94,99
44,r_17_21_92,seq53,r_7_38_101,r_7_38_101,1.0,18,119,101,99
26,r_36_77_28,r_67_141_90,seq135,r_36_77_28,0.93,4,32,28,99
1,r_46_59_20,seq29,seq129,r_46_59_20,0.75,0,20,20,99
31,r_83_31_36,r_40_42_98,seq11,r_83_31_36,0.56,0,36,36,99
35,r_30_4_131,seq147,r_94_95_63,r_94_95_63,1.0,81,144,63,99
