33,r_59_17_44,r_92_47_133,r_69_106_125,r_59_17_44,0.97,1,45,44,0
16,r_37_126_15,r_65_146_134,seq66,r_37_126_15,0.97,0,15,15,0
31,r_124_3_38,r_143_51_132,r_10_73_11,r_124_3_38,0.98,1,39,38,0
36,r_90_68_161,seq27,r_128_60_65,r_128_60_65,0.89,97,162,65,0
14,r_11_25_158,r_15_57_81,seq129,r_15_57_81,1.0,-13,68,81,0
55,seq137,r_44_111_61,seq54,r_44_111_61,1.0,0,61,61,0
39,r_6_120_88,seq23,r_0_132_93,r_6_120_88,0.82,5,93,88,0
5,r_30_53_96,r_18_85_197,r_144_121_34,r_18_85_197,0.62,-101,96,197,0
42,r_49_58_107,seq1,r_10_73_11,r_49_58_107,0.62,2,109,107,0
35,r_130_118_43,r_7_141_33,seq27,r_130_118_43,0.68,7,50,43,0
45,r_99_45_69,r_49_58_107,r_37_126_15,r_49_58_107,0.86,-37,70,107,0
3,r_84_127_115,r_56_134_155,r_82_33_123,r_84_127_115,0.57,3,118,115,0
10,r_64_5_101,seq129,seq72,r_64_5_101,0.55,0,101,101,0
14,r_11_25_158,seq129,r_92_47_133,r_92_47_133,0.84,25,158,133,0
11,r_117_79_98,r_24_16_175,r_20_115_23,r_24_16_175,0.98,-75,100,175,0
15,r_119_50_127,r_24_16_175,r_40_71_46,r_24_16_175,0.6,-47,128,175,0
6,r_114_83_137,r_69_106_125,r_11_25_158,r_69_106_125,0.6,11,136,125,0
18,r_20_115_23,r_69_106_125,seq94,r_20_115_23,0.97,0,23,23,0
41,r_12_140_30,r_34_123_154,seq62,r_12_140_30,1.0,6,36,30,0
47,r_0_132_93,r_2_63_8,r_6_120_88,r_0_132_93,0.59,1,94,93,0
40,r_128_60_65,r_64_5_101,seq138,r_64_5_101,0.89,-36,65,101,0
25,r_75_21_103,r_56_134_155,r_4_103_193,r_75_21_103,0.51,17,120,103,0
38,r_44_111_61,seq137,r_87_142_9,r_44_111_61,0.91,0,61,61,0
34,r_116_39_116,r_98_43_14,r_37_126_15,r_98_43_14,1.0,103,117,14,0
2,r_36_46_39,r_82_33_123,r_7_141_33,r_36_46_39,1.0,0,39,39,0
17,r_18_85_197,r_30_53_96,r_130_118_43,r_30_53_96,0.89,-25,71,96,0
28,r_15_57_81,r_11_25_158,r_9_104_5,r_15_57_81,0.78,1,82,81,0
0,r_105_14_35,r_64_5_101,r_87_142_9,r_105_14_35,0.95,1,36,35,0
30,r_9_147_137,r_102_117_168,r_89_120_61,r_9_147_137,0.77,0,137,137,1
8,r_0_130_79,r_30_111_66,r_94_103_24,r_0_130_79,0.68,-2,77,79,1
43,r_110_129_140,r_31_122_146,r_17_25_53,r_110_129_140,0.79,-1,139,140,1
16,r_96_82_125,seq92,r_36_90_25,r_96_82_125,0.42,3,128,125,1
39,r_78_133_75,r_108_8_90,r_94_103_24,r_78_133_75,0.99,0,75,75,1
11,r_18_113_31,r_79_6_27,seq141,r_18_113_31,0.96,0,31,31,1
41,r_68_19_158,seq93,r_38_73_16,r_68_19_158,0.75,0,158,158,1
9,r_94_103_24,r_43_99_170,seq75,r_94_103_24,1.0,0,24,24,1
26,r_70_42_106,r_52_20_54,seq34,r_70_42_106,0.91,2,108,106,1
15,r_86_139_71,r_43_99_170,r_40_107_111,r_86_139_71,0.6,8,79,71,1
47,r_148_125_109,seq14,r_53_71_62,r_148_125_109,1.0,0,109,109,1
24,r_30_111_66,r_0_130_79,r_53_71_62,r_0_130_79,1.0,-16,63,79,1
25,r_31_122_146,r_123_62_192,r_89_120_61,r_31_122_146,0.69,4,150,146,1
38,r_119_45_127,r_52_20_54,seq63,r_119_45_127,0.8,3,130,127,1
36,r_38_73_16,r_17_25_53,seq14,r_38_73_16,0.83,-2,14,16,1
21,r_56_101_35,r_36_90_25,seq63,r_56_101_35,1.0,0,35,35,1
17,r_53_71_62,r_144_57_86,r_30_111_66,r_53_71_62,0.75,1,63,62,1
28,r_3_137_87,seq81,r_43_99_170,r_3_137_87,0.86,-1,86,87,1
49,r_144_57_86,r_53_71_62,r_126_48_83,r_144_57_86,0.88,-5,81,86,1
7,r_132_23_68,seq98,seq26,r_132_23_68,0.99,-1,67,68,1
23,r_65_24_166,r_121_59_197,r_18_113_31,r_121_59_197,0.68,-28,169,197,1
12,r_108_8_90,r_40_107_111,r_38_73_16,r_108_8_90,0.99,-1,89,90,1
25,r_134_141_41,seq9,r_116_87_6,r_134_141_41,0.97,2,43,41,2
3,r_111_5_26,r_71_42_171,r_34_40_3,r_111_5_26,0.97,0,26,26,2
37,r_77_128_170,r_78_117_194,r_37_112_68,r_37_112_68,0.96,106,174,68,2
1,r_105_103_45,r_12_17_92,seq83,r_105_103_45,1.0,1,46,45,2
16,r_49_69_15,r_140_129_178,r_18_88_27,r_18_88_27,0.83,153,180,27,2
21,r_3_137_65,r_74_114_109,seq130,r_3_137_65,0.87,4,69,65,2
91,seq104,r_10_46_52,r_127_20_54,r_10_46_52,0.93,0,52,52,2
5,r_48_139_82,seq148,seq85,r_48_139_82,0.74,2,84,82,2
45,r_66_4_138,seq85,r_18_88_27,r_18_88_27,0.94,114,141,27,2
4,r_14_79_40,seq101,r_135_136_13,r_14_79_40,0.94,6,46,40,2
19,r_10_46_52,seq104,r_61_67_199,r_10_46_52,1.0,0,52,52,2
31,r_73_38_70,r_68_82_181,seq58,r_73_38_70,0.91,-4,66,70,2
10,r_51_8_145,seq31,r_111_5_26,r_51_8_145,0.58,11,156,145,2
26,r_76_95_60,r_27_22_14,seq72,r_76_95_60,1.0,0,60,60,2
11,r_127_20_54,r_50_59_113,seq104,r_127_20_54,0.87,0,54,54,2
0,r_25_123_173,seq143,r_54_36_58,r_54_36_58,0.49,116,174,58,2
15,r_93_90_163,seq119,r_111_5_26,r_93_90_163,0.48,2,165,163,2
48,r_52_44_96,seq98,r_111_5_26,r_52_44_96,0.85,10,106,96,2
6,r_126_109_87,seq107,seq53,r_126_109_87,0.72,0,87,87,2
47,r_140_129_178,r_49_69_15,r_14_79_40,r_14_79_40,0.78,140,180,40,2
33,r_71_42_171,seq85,r_89_91_115,r_89_91_115,0.52,59,174,115,2
38,r_50_59_113,r_86_75_160,r_29_26_17,r_50_59_113,0.8,5,118,113,2
32,r_18_88_27,r_96_124_154,seq47,r_18_88_27,0.91,1,28,27,2
41,r_120_64_42,r_52_44_96,seq81,r_120_64_42,0.78,1,43,42,2
9,r_37_112_68,r_138_149_188,seq142,r_37_112_68,0.96,9,77,68,2
22,r_92_144_100,r_78_117_194,r_54_36_58,r_92_144_100,0.66,10,110,100,2
49,r_108_97_103,seq106,seq7,r_108_97_103,0.55,3,106,103,2
44,r_86_75_160,seq81,r_48_139_82,r_86_75_160,0.58,1,161,160,2
35,r_62_15_134,seq85,r_1_30_195,r_1_30_195,0.96,-51,144,195,2
12,r_12_17_92,seq58,r_48_139_82,r_12_17_92,0.9,14,106,92,2
36,r_137_73_174,r_134_70_168,r_94_0_80,r_94_0_80,1.0,95,175,80,3
8,r_19_58_127,seq54,seq126,r_19_58_127,0.81,6,133,127,3
43,r_53_48_146,seq25,r_50_36_112,r_50_36_112,0.89,43,155,112,3
37,r_24_60_176,seq41,r_52_79_157,r_52_79_157,0.63,27,184,157,3
16,r_10_102_114,r_20_34_123,r_89_59_9,r_10_102_114,0.67,3,117,114,3
39,r_75_39_177,seq126,r_131_130_182,r_131_130_182,0.59,-5,177,182,3
1,r_94_0_80,r_115_37_105,r_96_33_138,r_94_0_80,0.6,73,153,80,3
1,r_94_0_80,r_10_102_114,r_115_37_105,r_94_0_80,0.91,0,80,80,3
46,r_138_72_66,seq16,r_115_37_105,r_115_37_105,0.51,13,118,105,3
42,r_96_33_138,r_149_7_137,r_94_0_80,r_94_0_80,0.63,63,143,80,3
19,r_76_135_117,seq46,seq44,r_76_135_117,0.79,0,117,117,3
41,r_11_95_89,r_149_7_137,seq9,r_11_95_89,0.98,1,90,89,3
0,r_52_79_157,seq90,r_134_70_168,r_52_79_157,0.8,0,157,157,3
20,r_50_36_112,r_131_130_182,r_53_48_146,r_50_36_112,0.83,0,112,112,3
34,r_12_49_50,r_120_136_55,seq117,r_12_49_50,0.92,5,55,50,3
6,r_42_8_143,r_128_57_175,seq83,r_42_8_143,0.82,0,143,143,3
33,r_13_88_46,r_149_7_137,r_20_34_123,r_13_88_46,0.96,0,46,46,3
27,r_64_55_103,seq117,seq46,r_64_55_103,0.86,3,106,103,3
2,r_56_66_83,seq44,r_12_49_50,r_12_49_50,1.0,44,94,50,3
40,r_91_129_185,r_147_32_139,r_94_0_80,r_94_0_80,1.0,105,185,80,3
18,r_140_127_173,r_131_130_182,seq25,r_131_130_182,0.5,-9,173,182,3
29,r_51_104_98,r_76_135_117,r_13_88_46,r_51_104_98,0.94,5,103,98,3
25,r_2_82_77,r_144_108_14,r_27_61_93,r_2_82_77,0.99,1,78,77,3
31,r_43_45_31,r_134_70_168,r_27_61_93,r_43_45_31,0.79,3,34,31,3
61,seq25,r_87_17_128,seq122,r_87_17_128,1.0,0,128,128,3
32,r_20_34_123,r_10_102_114,seq40,r_20_34_123,0.87,-6,117,123,3
24,r_77_92_13,r_134_70_168,seq62,r_77_92_13,0.75,1,14,13,3
17,r_21_113_91,seq54,r_149_7_137,r_21_113_91,0.99,3,94,91,3
28,r_86_99_132,seq145,r_11_95_89,r_11_95_89,1.0,30,119,89,3
49,r_133_4_104,seq62,r_21_113_91,r_133_4_104,0.66,12,116,104,3
7,r_68_67_133,seq41,r_50_36_112,r_50_36_112,0.73,26,138,112,3
23,r_78_132_118,seq122,r_27_61_93,r_78_132_118,0.71,1,119,118,3
30,r_17_94_107,seq12,seq134,r_17_94_107,0.92,2,109,107,4
36,r_53_70_73,r_22_5_97,r_138_50_4,r_53_70_73,0.98,0,73,73,4
8,r_63_77_129,r_21_68_193,r_27_89_187,r_63_77_129,0.67,0,129,129,4
21,r_44_147_126,seq30,r_25_71_29,r_44_147_126,0.85,0,126,126,4
5,r_22_5_97,seq57,seq134,r_22_5_97,0.61,4,101,97,4
46,r_47_20_132,r_90_32_111,r_149_33_44,r_47_20_132,0.48,12,144,132,4
42,r_100_29_60,r_72_58_68,r_25_71_29,r_100_29_60,0.57,1,61,60,4
28,r_133_73_54,seq2,seq99,r_133_73_54,0.86,4,58,54,4
40,r_52_109_49,r_43_51_190,r_90_32_111,r_52_109_49,0.73,-11,38,49,4
31,r_43_51_190,r_52_109_49,r_72_58_68,r_72_58_68,0.69,-1,67,68,4
41,r_148_140_174,seq30,r_15_69_123,r_148_140_174,0.56,0,174,174,4
3,r_146_65_93,r_15_69_123,r_90_32_111,r_146_65_93,0.63,2,95,93,4
14,r_149_33_44,r_146_65_93,seq9,r_149_33_44,0.74,-4,40,44,4
35,r_137_18_52,r_90_32_111,seq98,r_137_18_52,1.0,1,53,52,4
4,r_15_69_123,r_146_65_93,r_110_128_106,r_15_69_123,0.88,3,126,123,4
11,r_72_58_68,r_31_95_103,r_43_51_190,r_72_58_68,1.0,2,70,68,4
15,r_80_26_91,r_90_32_111,seq60,r_80_26_91,0.64,4,95,91,4
38,r_25_71_29,r_90_32_111,seq56,r_25_71_29,0.85,1,30,29,4
25,r_48_136_186,r_90_32_111,r_35_112_170,r_90_32_111,0.56,76,187,111,4
33,r_54_116_74,r_45_39_178,seq66,r_54_116_74,1.0,8,82,74,4
70,seq142,r_43_51_190,r_79_120_116,r_79_120_116,0.83,65,181,116,4
17,r_110_128_106,r_17_94_107,seq88,r_110_128_106,0.86,0,106,106,4
2,r_23_16_34,r_86_13_42,r_138_50_4,r_23_16_34,0.94,3,37,34,4
49,r_36_59_153,seq41,r_81_75_142,r_36_59_153,0.62,1,154,153,4
44,r_79_120_116,seq37,seq10,r_79_120_116,0.86,0,116,116,4
59,seq10,seq142,r_79_120_116,r_79_120_116,0.92,0,116,116,4
36,r_119_90_70,r_109_125_21,seq22,r_119_90_70,0.93,1,71,70,5
14,r_145_58_143,seq25,r_65_46_123,r_65_46_123,0.92,20,143,123,5
8,r_114_71_109,r_18_59_119,r_111_101_46,r_114_71_109,0.97,2,111,109,5
37,r_37_141_94,r_97_79_151,r_40_146_199,r_37_141_94,0.81,-5,89,94,5
16,r_129_60_74,r_42_70_114,r_128_104_5,r_129_60_74,0.74,-3,71,74,5
21,r_99_3_66,seq7,r_128_104_5,r_99_3_66,0.88,1,67,66,5
5,r_136_106_137,r_73_38_72,seq6,r_136_106_137,0.8,3,140,137,5
46,r_132_140_134,r_49_31_139,r_114_71_109,r_49_31_139,0.99,-3,136,139,5
30,r_2_50_14,r_86_124_161,r_105_21_15,r_105_21_15,0.8,-2,13,15,5
31,r_95_110_69,r_145_58_143,r_36_9_60,r_95_110_69,1.0,-2,67,69,5
41,r_97_79_151,seq12,r_86_124_161,r_86_124_161,0.88,4,165,161,5
3,r_19_137_125,seq115,seq44,r_19_137_125,0.9,0,125,125,5
26,r_26_75_152,r_45_41_147,r_128_104_5,r_26_75_152,0.47,2,154,152,5
4,r_42_70_114,r_29_108_146,r_109_125_21,r_29_108_146,0.97,-9,137,146,5
0,r_139_56_108,r_136_106_137,r_111_101_46,r_111_101_46,0.78,66,112,46,5
11,r_65_46_123,seq131,r_40_146_199,r_65_46_123,0.85,3,126,123,5
6,r_109_125_21,r_119_90_70,seq5,r_119_90_70,0.77,-1,69,70,5
42,r_138_143_36,r_40_146_199,seq131,r_138_143_36,0.91,0,36,36,5
30,r_2_50_14,r_105_21_15,r_36_9_60,r_2_50_14,0.7,105,119,14,5
55,seq7,r_26_75_152,r_28_34_12,r_28_34_12,0.98,1,13,12,5
20,r_105_21_15,r_65_46_123,r_30_122_42,r_105_21_15,0.76,-2,13,15,5
2,r_86_124_161,seq13,r_119_90_70,r_86_124_161,0.45,0,161,161,5
43,r_83_133_45,r_99_3_66,seq102,r_99_3_66,0.61,25,91,66,5
18,r_93_142_149,r_42_70_114,r_138_143_36,r_138_143_36,0.74,113,149,36,5
33,r_55_62_158,seq25,r_73_38_72,r_55_62_158,0.61,3,161,158,5
34,r_84_43_128,seq13,r_52_74_73,r_84_43_128,0.8,3,131,128,5
9,r_29_108_146,r_42_70_114,r_65_46_123,r_42_70_114,0.65,32,146,114,5
22,r_36_9_60,seq131,r_2_50_14,r_36_9_60,0.96,1,61,60,5
28,r_18_59_119,seq8,r_98_11_155,r_18_59_119,0.43,3,122,119,5
49,r_45_41_147,r_26_75_152,r_28_34_12,r_28_34_12,0.49,142,154,12,5
44,r_134_39_100,r_145_58_143,r_51_78_31,r_134_39_100,0.92,1,101,100,5
43,r_83_133_45,r_40_146_199,r_99_3_66,r_83_133_45,0.83,0,45,45,5
12,r_52_74_73,r_114_71_109,r_88_103_167,r_52_74_73,0.38,3,76,73,5
26,r_148_43_25,r_32_34_113,seq14,r_148_43_25,0.96,1,26,25,6
36,r_73_20_174,r_10_105_3,r_118_21_38,r_118_21_38,0.89,136,174,38,6
38,r_118_21_38,r_94_142_186,seq8,r_118_21_38,1.0,0,38,38,6
14,r_136_16_129,seq26,r_39_71_130,r_136_16_129,0.92,0,129,129,6
43,r_115_137_6,r_67_3_92,seq97,r_67_3_92,1.0,0,92,92,6
83,seq72,r_98_122_5,r_32_34_113,r_32_34_113,1.0,12,125,113,6
3,r_51_64_185,r_50_103_93,r_66_63_190,r_51_64_185,0.74,0,185,185,6
16,r_32_34_113,seq54,seq72,r_32_34_113,0.98,0,113,113,6
21,r_141_86_79,r_87_83_82,seq47,r_141_86_79,1.0,0,79,79,6
39,r_131_92_66,r_51_64_185,r_126_37_19,r_131_92_66,0.93,0,66,66,6
46,r_31_27_108,seq7,r_115_137_6,r_31_27_108,1.0,0,108,108,6
42,r_39_71_130,seq138,r_126_37_19,r_126_37_19,0.72,113,132,19,6
45,r_23_46_148,r_78_90_188,r_53_75_109,r_23_46_148,0.9,0,148,148,6
19,r_80_55_100,r_98_122_5,seq146,r_80_55_100,0.98,1,101,100,6
33,r_50_103_93,r_51_64_185,r_15_102_134,r_50_103_93,0.68,92,185,93,6
44,r_38_69_39,r_12_13_64,r_66_63_190,r_38_69_39,0.99,0,39,39,6
3,r_51_64_185,r_32_34_113,r_50_103_93,r_51_64_185,1.0,-89,96,185,6
41,r_132_58_199,r_15_102_134,r_85_41_74,r_85_41_74,0.99,61,135,74,6
3,r_51_64_185,r_131_92_66,r_32_34_113,r_51_64_185,0.64,-119,66,185,6
10,r_53_75_109,seq5,r_80_55_100,r_80_55_100,1.0,21,121,100,6
4,r_10_105_3,r_73_20_174,r_106_145_47,r_10_105_3,0.6,98,101,3,6
20,r_130_133_103,r_53_75_109,r_124_135_87,r_53_75_109,0.93,-6,103,109,6
15,r_12_13_64,r_67_3_92,r_107_9_179,r_67_3_92,0.78,-27,65,92,6
28,r_108_100_37,r_56_40_88,seq110,r_108_100_37,1.0,0,37,37,6
6,r_128_81_146,r_18_111_184,r_108_100_37,r_18_111_184,0.8,-37,147,184,6
49,r_93_109_44,r_77_149_128,seq44,r_93_109_44,0.98,7,51,44,6
27,r_144_104_143,seq146,seq116,r_144_104_143,0.79,0,143,143,6
2,r_78_90_188,seq8,r_126_37_19,r_78_90_188,0.49,0,188,188,6
47,r_77_149_128,r_147_19_183,seq52,r_77_149_128,0.77,1,129,128,6
40,r_11_61_170,seq91,r_87_83_82,r_11_61_170,0.6,4,174,170,6
18,r_15_102_134,r_132_58_199,r_50_103_93,r_50_103_93,1.0,42,135,93,6
29,r_4_60_140,seq57,r_124_135_87,r_124_135_87,1.0,64,151,87,6
33,r_50_103_93,r_96_89_117,r_51_64_185,r_51_64_185,0.95,-92,93,185,6
32,r_98_122_5,r_80_55_100,r_4_60_140,r_80_55_100,1.0,1,101,100,6
52,seq2,r_124_135_87,seq97,r_124_135_87,1.0,0,87,87,6
22,r_106_145_47,r_113_25_172,r_10_105_3,r_113_25_172,0.68,-124,48,172,6
34,r_67_3_92,r_115_137_6,seq68,r_67_3_92,1.0,0,92,92,6
9,r_96_89_117,seq44,r_87_83_82,r_96_89_117,0.99,0,117,117,6
23,r_56_40_88,r_11_61_170,r_124_135_87,r_56_40_88,0.59,6,94,88,6
35,r_125_112_151,r_10_105_3,r_126_37_19,r_125_112_151,0.89,0,151,151,6
12,r_124_135_87,seq2,r_56_40_88,r_124_135_87,1.0,0,87,87,6
30,r_83_2_99,seq25,r_122_65_166,r_83_2_99,0.79,2,101,99,7
4,r_89_85_13,r_98_62_65,r_132_26_1,r_132_26_1,0.9,12,13,1,7
8,r_101_16_62,seq107,r_23_36_36,r_101_16_62,0.68,3,65,62,7
43,r_15_57_74,r_103_106_84,r_43_24_14,r_43_24_14,0.99,69,83,14,7
16,r_33_141_121,r_70_115_171,r_88_19_48,r_33_141_121,0.97,0,121,121,7
21,r_49_145_66,r_70_115_171,r_98_62_65,r_98_62_65,1.0,9,74,65,7
39,r_82_9_97,r_122_65_166,r_43_24_14,r_82_9_97,0.99,-4,93,97,7
46,r_11_22_63,r_39_104_122,r_23_36_36,r_11_22_63,0.98,0,63,63,7
41,r_45_71_132,r_70_115_171,seq76,r_45_71_132,0.8,1,133,132,7
3,r_143_73_163,seq27,r_89_85_13,r_143_73_163,0.6,2,165,163,7
10,r_39_104_122,r_143_73_163,r_78_84_103,r_39_104_122,0.77,1,123,122,7
78,seq69,r_0_59_158,r_98_62_65,r_98_62_65,1.0,9,74,65,7
0,r_81_114_181,seq107,r_23_36_36,r_23_36_36,0.96,145,181,36,7
48,r_130_4_134,seq86,r_23_36_36,r_23_36_36,0.91,99,135,36,7
6,r_75_117_129,r_61_64_61,r_43_24_14,r_75_117_129,0.9,0,129,129,7
27,r_142_30_88,seq99,r_50_120_156,r_142_30_88,0.99,2,90,88,7
30,r_83_2_99,r_122_65_166,r_0_59_158,r_83_2_99,0.75,73,172,99,7
2,r_113_97_190,seq123,r_75_117_129,r_75_117_129,0.98,61,190,129,7
40,r_148_95_179,seq100,r_0_59_158,r_148_95_179,0.54,0,179,179,7
5,r_23_36_36,r_143_73_163,seq136,r_23_36_36,1.0,0,36,36,7
18,r_41_138_47,r_98_62_65,r_105_13_18,r_98_62_65,0.74,0,65,65,7
25,r_63_56_155,r_143_73_163,r_89_85_13,r_89_85_13,0.87,142,155,13,7
33,r_80_135_115,r_109_1_193,seq67,r_80_135_115,1.0,1,116,115,7
32,r_38_8_95,r_61_64_61,r_23_36_36,r_23_36_36,0.63,59,95,36,7
9,r_31_28_49,seq136,seq35,r_31_28_49,0.99,1,50,49,7
34,r_137_74_116,r_103_106_84,r_78_84_103,r_137_74_116,1.0,0,116,116,7
36,r_43_24_14,r_20_10_28,r_29_108_3,r_43_24_14,0.81,0,14,14,7
15,r_124_12_51,r_66_52_114,r_78_84_103,r_124_12_51,0.98,1,52,51,7
17,r_60_93_197,seq107,r_131_129_119,r_131_129_119,0.32,4,123,119,7
96,seq123,r_113_97_190,r_0_59_158,r_0_59_158,0.77,18,176,158,7
35,r_122_65_166,r_83_2_99,r_20_10_28,r_122_65_166,0.95,-6,160,166,7
49,r_131_129_119,seq99,r_60_93_197,r_131_129_119,0.49,10,129,119,7
44,r_66_52_114,seq139,seq27,r_66_52_114,0.99,0,114,114,7
35,r_122_65_166,r_109_1_193,r_83_2_99,r_83_2_99,0.82,3,102,99,7
38,r_105_13_18,r_75_117_129,r_41_138_47,r_105_13_18,0.9,0,18,18,7
12,r_98_62_65,r_41_138_47,r_49_145_66,r_98_62_65,1.0,0,65,65,7
65,seq35,seq140,r_31_28_49,r_31_28_49,1.0,8,57,49,7
23,r_61_55_36,r_133_2_17,seq17,r_133_2_17,0.64,21,38,17,8
36,r_30_47_76,r_148_87_106,r_73_48_149,r_30_47_76,0.76,2,78,76,8
14,r_43_118_55,r_56_18_119,seq32,r_43_118_55,0.77,23,78,55,8
37,r_15_63_117,r_73_48_149,seq149,r_73_48_149,0.7,-24,125,149,8
86,seq97,r_60_104_177,r_137_90_102,r_137_90_102,0.7,5,107,102,8
21,r_148_87_106,r_60_104_177,seq29,r_60_104_177,0.45,-70,107,177,8
39,r_101_78_174,seq122,r_13_144_95,r_13_144_95,0.96,81,176,95,8
46,r_14_123_90,r_65_117_74,seq31,r_65_117_74,0.53,21,95,74,8
44,r_111_33_39,r_12_106_101,r_65_117_74,r_111_33_39,0.6,0,39,39,8
3,r_46_23_79,seq126,seq128,r_46_23_79,0.75,0,79,79,8
26,r_86_71_100,r_67_62_153,seq147,r_86_71_100,0.79,0,100,100,8
13,r_140_120_25,r_146_6_171,seq126,r_140_120_25,0.51,0,25,25,8
11,r_66_75_73,r_9_57_137,seq100,r_66_75_73,0.66,0,73,73,8
98,seq126,r_46_23_79,r_140_120_25,r_46_23_79,0.99,-16,63,79,8
48,r_116_35_83,r_13_144_95,seq3,r_13_144_95,1.0,-6,89,95,8
9,r_38_102_43,r_67_62_153,r_65_117_74,r_38_102_43,0.84,2,45,43,8
40,r_1_138_115,r_121_113_170,r_130_19_60,r_121_113_170,0.87,-55,115,170,8
29,r_37_114_70,r_9_57_137,seq74,r_37_114_70,0.56,0,70,70,8
25,r_53_27_172,r_22_5_176,r_130_19_60,r_22_5_176,0.38,-3,173,176,8
33,r_121_113_170,seq127,r_137_90_102,r_137_90_102,0.96,74,176,102,8
32,r_130_19_60,r_9_57_137,seq51,r_130_19_60,0.88,6,66,60,8
17,r_70_135_78,r_65_117_74,seq11,r_70_135_78,0.78,6,84,78,8
28,r_76_4_135,seq32,seq20,r_76_4_135,0.49,6,141,135,8
7,r_13_144_95,r_121_113_170,r_84_145_124,r_121_113_170,0.68,-75,95,170,8
35,r_143_25_160,seq3,r_15_63_117,r_15_63_117,0.86,43,160,117,8
12,r_132_93_129,r_76_4_135,r_65_117_74,r_65_117_74,0.6,74,148,74,8
36,r_136_119_158,r_80_145_186,r_61_74_102,r_136_119_158,0.58,2,160,158,9
47,r_146_72_16,r_60_29_37,seq147,r_146_72_16,1.0,1,17,16,9
43,r_124_11_126,r_58_109_88,r_115_125_38,r_124_11_126,0.59,-52,74,126,9
1,r_43_33_142,r_107_103_148,r_135_122_162,r_135_122_162,0.79,-13,149,162,9
46,r_42_130_85,r_128_52_106,r_144_17_78,r_144_17_78,0.88,18,96,78,9
42,r_22_114_145,seq147,r_60_29_37,r_22_114_145,0.96,0,145,145,9
5,r_123_96_43,r_135_122_162,r_93_140_9,r_123_96_43,0.73,0,43,43,9
22,r_113_75_54,seq63,r_80_145_186,r_80_145_186,0.67,-130,56,186,9
15,r_40_48_30,seq127,seq148,r_40_48_30,0.73,0,30,30,9
31,r_31_126_117,r_35_55_183,r_19_116_101,r_35_55_183,0.82,-66,117,183,9
28,r_24_32_32,r_135_122_162,r_66_118_29,r_24_32_32,0.75,7,39,32,9
63,seq148,r_77_20_157,r_40_48_30,r_40_48_30,0.93,3,33,30,9
11,r_77_20_157,seq6,r_133_73_127,r_133_73_127,0.85,28,155,127,9
13,r_138_45_93,r_107_103_148,r_14_134_99,r_138_45_93,0.74,4,97,93,9
6,r_61_74_102,r_83_46_188,r_58_109_88,r_61_74_102,0.74,3,105,102,9
40,r_19_116_101,r_135_122_162,seq132,r_19_116_101,1.0,0,101,101,9
25,r_142_18_69,seq106,seq6,r_142_18_69,0.63,6,75,69,9
43,r_124_11_126,r_115_125_38,r_123_96_43,r_124_11_126,0.72,16,142,126,9
32,r_88_50_109,r_35_55_183,r_66_118_29,r_66_118_29,0.72,83,112,29,9
34,r_0_12_111,r_80_145_186,r_61_74_102,r_0_12_111,0.7,1,112,111,9
9,r_79_10_120,r_51_111_144,r_31_126_117,r_51_111_144,1.0,-24,120,144,9
62,seq147,r_22_114_145,r_146_72_16,r_146_72_16,0.91,2,18,16,9
49,r_67_65_147,r_83_46_188,r_149_76_167,r_67_65_147,0.61,2,149,147,9
7,r_51_111_144,r_79_10_120,r_66_118_29,r_51_111_144,0.68,-24,120,144,9
23,r_128_52_106,seq28,r_123_96_43,r_128_52_106,0.6,6,112,106,9
35,r_112_9_58,r_83_46_188,seq108,r_112_9_58,0.63,26,84,58,9
12,r_144_17_78,r_124_11_126,r_47_3_74,r_47_3_74,0.81,4,78,74,9
14,r_123_103_64,r_126_79_2,r_104_24_6,r_123_103_64,0.92,0,64,64,10
43,r_130_102_115,r_78_106_178,r_104_24_6,r_78_106_178,0.49,-60,118,178,10
37,r_37_41_79,r_48_86_71,seq96,r_48_86_71,0.72,10,81,71,10
16,r_109_54_87,r_83_66_191,r_136_93_163,r_109_54_87,0.7,8,95,87,10
5,r_51_40_129,seq113,r_109_54_87,r_51_40_129,0.66,6,135,129,10
45,r_76_100_100,r_101_9_176,seq3,r_101_9_176,0.68,-76,100,176,10
4,r_58_118_51,r_51_40_129,seq134,r_58_118_51,0.99,0,51,51,10
13,r_72_108_26,r_139_49_171,seq19,r_72_108_26,0.77,0,26,26,10
3,r_74_20_108,r_138_143_118,r_78_106_178,r_74_20_108,0.76,1,109,108,10
90,seq96,r_34_69_136,r_37_41_79,r_34_69_136,0.61,6,142,136,10
11,r_91_73_180,seq142,r_104_24_6,r_104_24_6,0.71,176,182,6,10
24,r_27_117_157,r_99_23_179,r_137_82_25,r_99_23_179,0.44,-22,157,179,10
25,r_99_23_179,r_15_90_45,r_74_20_108,r_15_90_45,0.31,134,179,45,10
33,r_133_4_128,r_121_120_198,r_48_86_71,r_121_120_198,0.75,-67,131,198,10
38,r_62_89_121,r_126_79_2,r_121_120_198,r_126_79_2,0.65,122,124,2,10
34,r_146_39_151,seq55,r_74_20_108,r_74_20_108,0.77,43,151,108,10
8,r_52_77_37,r_126_79_2,seq56,r_52_77_37,0.76,3,40,37,10
22,r_147_68_133,seq13,r_104_24_6,r_147_68_133,0.5,0,133,133,10
28,r_138_143_118,r_141_11_167,seq25,r_138_143_118,0.66,0,118,118,10
23,r_120_15_18,r_123_105_164,seq90,r_120_15_18,0.99,0,18,18,11
14,r_93_149_92,r_146_121_150,r_57_109_76,r_93_149_92,0.91,0,92,92,11
16,r_1_48_116,seq18,r_86_113_57,r_1_48_116,0.93,0,116,116,11
1,r_8_56_84,r_55_40_91,seq74,r_8_56_84,1.0,1,85,84,11
85,seq90,r_107_76_194,r_120_15_18,r_120_15_18,0.87,9,27,18,11
10,r_65_124_20,r_49_77_32,r_50_60_10,r_65_124_20,0.96,-2,18,20,11
15,r_103_94_39,r_145_20_146,seq38,r_103_94_39,0.92,9,48,39,11
45,r_5_67_188,seq0,r_103_94_39,r_103_94_39,1.0,149,188,39,11
19,r_63_95_115,r_1_48_116,r_8_56_84,r_1_48_116,1.0,-1,115,116,11
39,r_13_135_25,seq11,seq140,r_13_135_25,0.9,0,25,25,11
31,r_114_4_104,r_55_40_91,r_13_135_25,r_114_4_104,0.89,0,104,104,11
41,r_85_84_159,r_79_6_166,r_97_7_105,r_97_7_105,0.86,58,163,105,11
11,r_128_96_47,r_86_113_57,seq132,r_128_96_47,0.99,1,48,47,11
0,r_123_105_164,seq132,seq91,r_123_105_164,0.72,0,164,164,11
20,r_79_6_166,r_110_59_171,r_57_109_76,r_57_109_76,0.72,90,166,76,11
13,r_51_64_127,r_23_83_72,r_70_102_124,r_51_64_127,0.52,4,131,127,11
48,r_70_102_124,r_24_19_160,r_51_64_127,r_70_102_124,0.55,1,125,124,11
6,r_125_133_132,r_145_20_146,r_72_44_52,r_145_20_146,0.92,-12,134,146,11
30,r_126_143_29,r_107_76_194,seq104,r_126_143_29,0.95,0,29,29,11
47,r_146_121_150,seq99,seq118,r_146_121_150,0.54,1,151,150,11
33,r_129_27_65,r_93_149_92,r_110_59_171,r_129_27_65,1.0,0,65,65,11
32,r_57_109_76,seq39,seq131,r_57_109_76,1.0,2,78,76,11
38,r_97_7_105,r_123_105_164,r_142_62_54,r_97_7_105,0.97,3,108,105,11
34,r_116_54_163,r_86_113_57,r_123_105_164,r_116_54_163,0.45,0,163,163,11
27,r_142_62_54,seq131,r_97_7_105,r_142_62_54,0.83,50,104,54,11
28,r_147_88_170,seq118,r_125_133_132,r_147_88_170,0.63,0,170,170,11
14,r_135_24_124,seq25,r_111_142_74,r_135_24_124,0.8,1,125,124,12
8,r_50_18_106,r_49_33_169,seq2,r_50_18_106,0.79,0,106,106,12
30,r_98_88_35,r_112_69_92,seq46,r_112_69_92,0.74,-45,47,92,12
43,r_80_86_84,r_135_24_124,seq73,r_135_24_124,1.0,-29,95,124,12
39,r_48_16_119,r_74_6_195,r_26_71_69,r_48_16_119,0.82,1,120,119,12
1,r_70_3_93,seq145,seq72,r_70_3_93,0.92,2,95,93,12
5,r_76_87_78,seq13,r_121_15_101,r_76_87_78,0.84,0,78,78,12
46,r_11_14_116,r_101_105_166,r_63_30_81,r_63_30_81,0.96,42,123,81,12
42,r_148_54_110,seq46,r_76_87_78,r_76_87_78,0.95,33,111,78,12
45,r_67_91_83,r_104_137_142,r_147_84_2,r_104_137_142,0.69,-56,86,142,12
19,r_21_96_180,seq52,r_70_3_93,r_70_3_93,0.88,90,183,93,12
20,r_39_108_174,r_76_87_78,seq149,r_39_108_174,0.98,0,174,174,12
31,r_107_19_113,r_120_45_128,r_119_113_90,r_107_19_113,0.45,0,113,113,12
41,r_63_30_81,r_120_45_128,seq89,r_63_30_81,0.42,2,83,81,12
3,r_112_69_92,seq51,seq13,r_112_69_92,0.78,0,92,92,12
10,r_119_113_90,r_17_110_122,seq46,r_119_113_90,0.6,13,103,90,12
4,r_120_45_128,r_62_130_173,r_63_30_81,r_62_130_173,0.94,-42,131,173,12
78,seq72,r_111_142_74,seq66,r_111_142_74,0.88,0,74,74,12
0,r_143_20_159,r_21_96_180,r_124_129_103,r_21_96_180,0.56,-21,159,180,12
11,r_134_146_135,seq13,r_26_71_69,r_134_146_135,0.56,3,138,135,12
20,r_39_108_174,r_17_110_122,r_76_87_78,r_76_87_78,1.0,61,139,78,12
13,r_55_118_82,r_120_45_128,r_44_79_73,r_55_118_82,0.98,7,89,82,12
15,r_17_110_122,r_119_113_90,r_77_5_18,r_77_5_18,0.81,85,103,18,12
49,r_77_5_18,seq25,r_17_110_122,r_17_110_122,0.66,28,150,122,12
6,r_101_105_166,seq8,r_50_18_106,r_101_105_166,0.41,2,168,166,12
27,r_62_130_173,seq90,r_23_85_21,r_23_85_21,0.72,165,186,21,12
2,r_124_129_103,r_74_6_195,seq25,r_124_129_103,0.87,0,103,103,12
47,r_29_127_132,r_104_137_142,seq103,r_29_127_132,0.54,0,132,132,12
38,r_140_53_144,r_101_105_166,r_135_24_124,r_140_53_144,0.51,2,146,144,12
81,seq141,r_83_75_115,r_55_118_82,r_55_118_82,0.83,56,138,82,12
17,r_0_58_67,r_67_91_83,r_132_144_33,r_67_91_83,0.74,-15,68,83,12
21,r_132_144_33,r_36_22_196,seq51,r_132_144_33,0.9,1,34,33,12
28,r_26_71_69,seq117,seq90,r_26_71_69,0.87,4,73,69,12
7,r_47_138_76,seq139,seq136,r_47_138_76,0.72,19,95,76,12
44,r_44_79_73,r_143_20_159,seq141,r_44_79_73,0.99,0,73,73,12
23,r_10_92_134,r_131_114_191,r_107_19_113,r_10_92_134,0.83,1,135,134,12
84,seq90,r_62_130_173,r_134_146_135,r_134_146_135,0.82,51,186,135,12
31,r_107_19_113,r_119_113_90,r_10_92_134,r_10_92_134,0.98,2,136,134,12
21,r_127_2_48,r_68_135_57,r_77_122_12,r_127_2_48,0.78,0,48,48,13
12,r_89_29_190,r_131_63_178,r_103_104_52,r_103_104_52,0.92,-6,46,52,13
29,r_103_104_52,seq88,r_89_29_190,r_103_104_52,0.86,-6,46,52,13
46,r_129_33_128,r_49_140_198,r_77_122_12,r_129_33_128,0.55,2,130,128,13
42,r_134_26_90,r_10_40_32,r_18_3_35,r_134_26_90,0.57,10,100,90,13
5,r_52_145_61,r_76_116_98,seq50,r_52_145_61,0.94,-9,52,61,13
47,r_90_64_30,r_68_135_57,r_75_1_18,r_90_64_30,0.62,-2,28,30,13
3,r_39_117_95,seq13,r_91_21_199,r_39_117_95,0.82,5,100,95,13
20,r_20_70_80,r_45_125_135,seq13,r_20_70_80,0.77,-1,79,80,13
30,r_98_4_43,r_87_54_163,r_91_21_199,r_98_4_43,0.84,-3,40,43,13
27,r_149_136_112,seq84,seq130,r_149_136_112,0.44,12,124,112,13
2,r_133_25_161,seq60,r_45_125_135,r_133_25_161,0.18,3,164,161,13
25,r_31_72_139,r_49_140_198,r_82_121_51,r_49_140_198,0.53,-58,140,198,13
33,r_93_53_75,r_12_141_162,r_75_1_18,r_93_53_75,0.73,-9,66,75,13
32,r_76_116_98,seq60,r_62_71_24,r_76_116_98,0.55,-11,87,98,13
38,r_146_115_118,r_45_125_135,r_10_40_32,r_146_115_118,0.66,5,123,118,13
40,r_44_67_56,r_68_135_57,r_82_121_51,r_44_67_56,0.7,-8,48,56,13
17,r_37_6_17,r_123_55_138,r_39_117_95,r_39_117_95,0.95,45,140,95,13
9,r_138_132_74,r_75_1_18,r_68_135_57,r_75_1_18,0.62,53,71,18,13
95,seq112,r_83_30_59,r_97_113_50,r_83_30_59,0.87,-13,46,59,13
23,r_82_121_51,r_87_54_163,r_86_118_8,r_82_121_51,0.91,-3,48,51,13
11,r_124_107_42,r_134_26_90,seq59,r_124_107_42,0.69,-10,32,42,13
35,r_83_30_59,r_78_56_103,r_85_100_44,r_78_56_103,0.94,-43,60,103,13
6,r_102_11_45,r_52_145_61,r_69_24_41,r_102_11_45,0.83,-26,19,45,13
30,r_89_32_99,r_95_119_151,seq76,r_89_32_99,0.47,0,99,99,14
14,r_31_143_64,r_87_91_179,r_3_128_22,r_87_91_179,0.84,-109,70,179,14
8,r_102_104_139,r_16_147_163,r_62_4_45,r_62_4_45,0.65,94,139,45,14
43,r_22_96_164,seq88,r_54_6_85,r_54_6_85,0.64,88,173,85,14
22,r_71_113_55,r_111_2_90,seq97,r_111_2_90,1.0,-33,57,90,14
1,r_54_6_85,r_69_141_119,r_71_113_55,r_54_6_85,0.82,15,100,85,14
42,r_136_138_66,r_111_2_90,seq63,r_111_2_90,1.0,-20,70,90,14
16,r_80_47_35,seq67,seq132,r_80_47_35,0.5,7,42,35,14
19,r_100_56_117,seq42,seq1,r_100_56_117,0.94,0,117,117,14
34,r_3_128_22,seq7,seq88,r_3_128_22,0.77,0,22,22,14
31,r_0_122_155,seq86,r_102_104_139,r_102_104_139,0.55,23,162,139,14
41,r_60_79_98,seq106,r_77_105_53,r_60_79_98,1.0,0,98,98,14
3,r_23_49_82,r_135_74_170,seq98,r_23_49_82,0.75,4,86,82,14
10,r_16_147_163,r_102_104_139,r_101_30_79,r_16_147_163,0.98,-24,139,163,14
0,r_135_74_170,seq132,r_23_49_82,r_23_49_82,0.99,95,177,82,14
11,r_95_119_151,r_17_72_174,seq59,r_17_72_174,0.77,-18,156,174,14
26,r_124_68_47,r_33_83_140,r_145_93_88,r_33_83_140,0.75,-89,51,140,14
20,r_29_66_127,r_87_91_179,r_13_110_74,r_29_66_127,0.74,2,129,127,14
15,r_146_55_109,seq82,r_129_28_57,r_146_55_109,0.94,0,109,109,14
48,r_8_41_143,r_116_43_153,r_131_112_42,r_131_112_42,0.77,104,146,42,14
27,r_85_37_112,r_53_45_188,seq15,r_85_37_112,0.7,0,112,112,14
5,r_131_112_42,r_111_2_90,seq7,r_111_2_90,1.0,-37,53,90,14
47,r_24_123_168,seq63,r_102_104_139,r_102_104_139,0.66,29,168,139,14
29,r_33_83_140,seq149,r_77_105_53,r_33_83_140,0.22,6,146,140,14
25,r_5_75_166,seq10,r_117_25_13,r_5_75_166,0.41,2,168,166,14
60,seq19,r_13_110_74,r_17_72_174,r_13_110_74,0.61,26,100,74,14
17,r_101_30_79,r_145_93_88,r_16_147_163,r_101_30_79,1.0,0,79,79,14
7,r_111_2_90,r_116_43_153,seq1,r_111_2_90,1.0,0,90,90,14
44,r_94_84_73,r_0_122_155,r_129_28_57,r_94_84_73,0.7,7,80,73,14
23,r_53_45_188,r_85_37_112,r_129_28_57,r_85_37_112,1.0,0,112,112,14
49,r_62_4_45,r_102_104_139,seq99,r_62_4_45,0.99,1,46,45,14
35,r_48_26_105,r_5_75_166,r_23_49_82,r_5_75_166,0.8,-59,107,166,14
30,r_22_147_103,r_61_24_173,r_86_68_64,r_22_147_103,0.86,2,105,103,15
37,r_141_80_88,r_85_39_169,r_89_130_11,r_141_80_88,0.58,37,125,88,15
16,r_3_109_164,r_88_115_198,r_67_99_140,r_88_115_198,0.34,-30,168,198,15
21,r_45_134_71,seq1,r_69_29_24,r_45_134_71,0.95,2,73,71,15
5,r_61_24_173,seq6,r_89_130_11,r_89_130_11,0.85,162,173,11,15
19,r_76_148_77,r_65_25_127,r_53_93_50,r_65_25_127,1.0,-43,84,127,15
3,r_132_106_86,seq120,seq56,r_132_106_86,0.92,1,87,86,15
26,r_113_95_78,r_94_82_87,r_23_118_52,r_113_95_78,0.64,6,84,78,15
0,r_67_99_140,seq9,r_105_32_146,r_67_99_140,0.58,4,144,140,15
11,r_94_82_87,r_60_79_185,r_26_21_61,r_94_82_87,0.6,17,104,87,15
20,r_40_57_76,r_140_137_108,r_53_93_50,r_40_57_76,0.9,0,76,76,15
47,r_4_77_21,r_100_63_29,seq104,r_4_77_21,0.74,-1,20,21,15
15,r_12_110_124,seq104,seq112,r_12_110_124,0.94,1,125,124,15
48,r_75_131_120,r_142_41_194,r_100_63_29,r_142_41_194,0.62,-71,123,194,15
1,r_53_93_50,seq19,r_145_5_12,r_53_93_50,0.8,4,54,50,15
9,r_23_118_52,seq46,r_55_37_35,r_55_37_35,0.99,24,59,35,15
6,r_28_123_180,r_53_93_50,r_100_63_29,r_28_123_180,0.83,-151,29,180,15
18,r_105_32_146,seq18,r_67_99_140,r_105_32_146,0.38,9,155,146,15
29,r_66_122_130,seq112,r_141_80_88,r_66_122_130,0.62,0,130,130,15
25,r_140_137_108,r_116_74_129,r_89_130_11,r_116_74_129,0.87,-11,118,129,15
33,r_116_74_129,seq149,r_53_93_50,r_116_74_129,0.72,7,136,129,15
32,r_30_111_57,r_86_68_64,r_17_43_7,r_30_111_57,0.76,2,59,57,15
38,r_65_25_127,seq13,seq7,r_65_25_127,0.98,0,127,127,15
41,r_55_37_35,r_66_122_130,seq19,r_55_37_35,0.87,0,35,35,15
44,r_42_87_49,r_94_82_87,r_64_129_16,r_94_82_87,0.94,-38,49,87,15
13,r_100_63_29,seq1,r_28_123_180,r_100_63_29,0.84,-6,23,29,15
22,r_15_33_73,seq96,seq120,r_15_33_73,0.96,3,76,73,15
28,r_103_107_83,r_105_32_146,seq112,r_103_107_83,1.0,0,83,83,15
7,r_135_16_158,r_142_41_194,r_100_63_29,r_142_41_194,0.37,-36,158,194,15
35,r_136_8_167,seq38,r_53_93_50,r_136_8_167,0.44,-10,157,167,15
12,r_86_68_64,r_83_117_85,r_64_129_16,r_86_68_64,0.88,0,64,64,15
30,r_32_70_157,r_88_58_173,r_1_50_35,r_88_58_173,0.71,-16,157,173,16
36,r_115_112_74,seq129,r_60_142_39,r_60_142_39,0.85,91,130,39,16
14,r_141_24_154,r_32_70_157,r_8_69_120,r_32_70_157,0.93,-1,156,157,16
31,r_1_50_35,r_92_87_160,seq59,r_1_50_35,1.0,0,35,35,16
1,r_132_118_76,r_96_3_54,r_120_127_25,r_132_118_76,1.0,1,77,76,16
16,r_60_142_39,r_132_118_76,r_121_45_7,r_132_118_76,0.79,-32,44,76,16
42,r_56_100_58,r_117_10_187,seq109,r_56_100_58,0.64,9,67,58,16
45,r_96_3_54,r_86_73_141,r_1_50_35,r_96_3_54,0.6,88,142,54,16
40,r_74_27_50,seq11,r_90_93_193,r_74_27_50,1.0,1,51,50,16
19,r_16_139_156,seq59,r_108_136_131,r_16_139_156,0.76,0,156,156,16
39,r_124_84_16,r_8_69_120,seq0,r_124_84_16,0.74,3,19,16,16
27,r_77_145_51,r_83_67_161,r_124_84_16,r_77_145_51,0.81,0,51,51,16
46,r_149_81_22,r_121_45_7,seq20,r_149_81_22,0.99,-1,21,22,16
26,r_6_75_60,r_35_119_115,seq12,r_6_75_60,0.96,5,65,60,16
74,seq59,r_16_139_156,r_1_50_35,r_1_50_35,0.69,16,51,35,16
4,r_68_52_181,seq46,r_60_142_39,r_68_52_181,0.56,0,181,181,16
13,r_86_73_141,r_96_3_54,r_43_55_42,r_86_73_141,0.82,1,142,141,16
37,r_140_23_44,r_8_69_120,seq128,r_140_23_44,0.92,0,44,44,16
2,r_116_79_132,seq82,r_43_55_42,r_116_79_132,0.74,2,134,132,16
47,r_2_28_145,seq0,seq22,r_2_28_145,0.54,1,146,145,16
24,r_35_119_115,r_31_147_179,seq113,r_35_119_115,0.69,19,134,115,16
0,r_41_33_15,r_83_67_161,seq62,r_41_33_15,0.98,0,15,15,16
32,r_106_42_70,r_110_36_103,seq63,r_110_36_103,0.73,-33,70,103,16
9,r_61_105_95,r_108_136_131,seq82,r_61_105_95,0.75,0,95,95,16
22,r_5_144_170,seq109,r_6_75_60,r_6_75_60,0.99,118,178,60,16
41,r_44_17_18,r_41_33_15,seq122,r_44_17_18,0.71,-2,16,18,16
7,r_126_123_104,seq109,r_146_134_69,r_126_123_104,0.75,9,113,104,16
23,r_108_136_131,seq0,seq97,r_108_136_131,0.5,3,134,131,16
43,r_43_55_42,r_61_105_95,seq109,r_43_55_42,0.93,3,45,42,16
12,r_117_10_187,r_34_53_195,r_1_50_35,r_1_50_35,0.99,152,187,35,16
14,r_20_118_156,r_94_14_150,r_105_26_105,r_94_14_150,0.96,6,156,150,17
8,r_42_28_90,r_76_81_168,r_133_86_172,r_42_28_90,1.0,0,90,90,17
43,r_142_38_80,seq116,r_148_56_58,r_142_38_80,0.57,9,89,80,17
17,r_143_93_55,r_47_5_130,r_136_141_7,r_143_93_55,0.99,1,56,55,17
37,r_117_92_121,r_113_34_185,r_15_90_122,r_15_90_122,0.87,3,125,122,17
16,r_135_101_187,seq70,r_42_28_90,r_42_28_90,1.0,100,190,90,17
21,r_113_34_185,r_135_101_187,r_148_56_58,r_148_56_58,1.0,129,187,58,17
1,r_31_78_12,r_66_30_138,r_47_5_130,r_31_78_12,0.84,126,138,12,17
45,r_15_90_122,seq8,r_117_92_121,r_15_90_122,0.96,0,122,122,17
19,r_148_56_58,seq130,r_99_122_59,r_148_56_58,1.0,2,60,58,17
15,r_66_30_138,r_31_78_12,seq139,r_66_30_138,0.82,0,138,138,17
31,r_64_59_134,r_0_61_174,r_123_83_32,r_0_61_174,0.77,-38,136,174,17
3,r_137_120_88,seq85,seq70,r_137_120_88,0.92,2,90,88,17
10,r_9_89_140,r_88_52_165,r_72_77_95,r_9_89_140,0.77,0,140,140,17
4,r_0_61_174,r_96_48_191,r_105_26_105,r_105_26_105,0.67,75,180,105,17
0,r_46_6_83,seq51,r_148_56_58,r_148_56_58,0.72,32,90,58,17
11,r_105_26_105,seq70,seq18,r_105_26_105,0.84,0,105,105,17
2,r_25_2_53,r_42_28_90,seq102,r_25_2_53,0.57,3,56,53,17
13,r_19_3_66,r_42_28_90,r_25_2_53,r_42_28_90,0.97,-23,67,90,17
48,r_21_132_111,r_76_81_168,seq130,r_21_132_111,0.99,0,111,111,17
49,r_136_141_7,r_0_61_174,r_60_126_92,r_136_141_7,0.51,89,96,7,17
41,r_144_95_20,seq32,seq57,r_144_95_20,0.92,0,20,20,17
6,r_33_147_76,r_137_120_88,seq109,r_33_147_76,0.65,3,79,76,17
27,r_24_1_152,seq67,r_148_56_58,r_148_56_58,0.89,103,161,58,17
1,r_31_78_12,r_9_89_140,r_66_30_138,r_31_78_12,0.77,0,12,12,17
29,r_63_17_176,seq55,r_148_56_58,r_148_56_58,0.96,122,180,58,17
24,r_99_122_59,r_137_120_88,r_148_56_58,r_99_122_59,0.99,4,63,59,17
25,r_131_111_65,r_7_112_108,seq130,r_131_111_65,0.97,0,65,65,17
32,r_72_77_95,seq55,seq129,r_72_77_95,0.8,6,101,95,17
38,r_125_91_118,r_7_112_108,r_143_93_55,r_143_93_55,1.0,64,119,55,17
15,r_66_30_138,r_137_120_88,r_31_78_12,r_66_30_138,0.7,-126,12,138,17
34,r_106_75_102,r_22_149_143,seq50,r_106_75_102,0.73,5,107,102,17
22,r_76_81_168,seq128,r_31_78_12,r_76_81_168,0.59,2,170,168,17
46,r_114_87_18,r_53_140_125,seq138,r_114_87_18,0.72,10,28,18,17
7,r_98_104_153,seq10,seq116,r_98_104_153,0.41,5,158,153,17
79,seq62,r_0_61_174,r_143_93_55,r_143_93_55,1.0,83,138,55,17
35,r_60_126_92,r_108_79_198,r_136_141_7,r_60_126_92,0.7,4,96,92,17
36,r_113_103_67,r_35_19_199,seq130,r_113_103_67,0.96,1,68,67,18
14,r_44_96_96,seq117,seq92,r_44_96_96,0.79,11,107,96,18
9,r_41_45_33,seq62,seq0,r_41_45_33,0.92,1,34,33,18
37,r_127_139_179,r_81_136_138,r_63_65_166,r_63_65_166,0.57,19,185,166,18
1,r_3_116_90,seq76,r_100_24_79,r_3_116_90,0.82,4,94,90,18
46,r_121_50_66,r_38_10_184,seq4,r_121_50_66,0.89,2,68,66,18
42,r_100_24_79,r_102_80_99,r_41_45_33,r_102_80_99,0.44,-20,79,99,18
43,r_12_114_30,seq23,r_38_10_184,r_12_114_30,0.95,2,32,30,18
49,r_25_5_51,seq82,r_106_42_27,r_25_5_51,0.83,5,56,51,18
45,r_124_89_65,r_134_27_188,seq76,r_124_89_65,0.89,0,65,65,18
21,r_106_42_27,r_38_10_184,seq62,r_106_42_27,0.95,5,32,27,18
3,r_95_18_162,r_39_71_187,r_107_66_68,r_95_18_162,0.22,5,167,162,18
26,r_51_13_120,seq0,r_81_136_138,r_51_13_120,0.81,0,120,120,18
0,r_119_99_173,r_87_15_141,r_115_91_129,r_119_99_173,0.42,2,175,173,18
20,r_85_143_111,seq122,seq72,r_85_143_111,0.72,3,114,111,18
6,r_46_20_83,r_51_13_120,seq8,r_46_20_83,0.93,4,87,83,18
41,r_110_108_44,r_35_19_199,seq57,r_110_108_44,0.9,2,46,44,18
2,r_63_65_166,r_56_26_75,r_106_42_27,r_106_42_27,0.67,141,168,27,18
47,r_49_147_80,r_35_19_199,r_38_10_184,r_49_147_80,0.9,0,80,80,18
40,r_87_15_141,r_119_99_173,r_41_45_33,r_41_45_33,0.8,109,142,33,18
25,r_58_101_176,seq11,r_102_80_99,r_102_80_99,0.98,81,180,99,18
58,seq11,r_58_101_176,r_43_132_63,r_58_101_176,0.74,4,180,176,18
32,r_78_32_48,r_35_19_199,r_31_83_16,r_78_32_48,0.8,15,63,48,18
38,r_129_52_84,r_35_19_199,r_81_136_138,r_129_52_84,0.94,3,87,84,18
28,r_60_131_170,seq92,r_81_136_138,r_60_131_170,0.29,1,171,170,18
7,r_115_91_129,seq128,seq47,r_115_91_129,0.77,7,136,129,18
23,r_73_98_22,r_25_5_51,r_93_37_2,r_93_37_2,0.97,19,21,2,18
36,r_116_80_112,seq112,r_87_83_134,r_87_83_134,0.76,-22,112,134,19
37,r_86_38_90,seq84,r_125_141_199,r_86_38_90,0.86,2,92,90,19
1,r_96_33_96,r_92_3_174,r_106_66_71,r_96_33_96,0.95,1,97,96,19
35,r_108_126_27,r_106_66_71,r_9_97_77,r_108_126_27,0.88,3,30,27,19
89,seq100,r_9_97_77,r_143_127_57,r_143_127_57,0.98,0,57,57,19
4,r_4_37_59,r_96_33_96,r_65_49_125,r_65_49_125,0.95,-66,59,125,19
45,r_55_70_169,seq39,r_15_120_37,r_15_120_37,0.92,132,169,37,19
19,r_106_66_71,r_42_146_97,seq8,r_106_66_71,0.96,0,71,71,19
32,r_132_128_41,r_129_73_171,r_15_120_37,r_132_128_41,0.88,6,47,41,19
92,seq112,r_107_27_158,r_71_29_23,r_71_29_23,0.99,-2,21,23,19
3,r_15_120_37,r_116_80_112,r_132_128_41,r_15_120_37,0.94,18,55,37,19
41,r_129_73_171,seq145,seq131,r_129_73_171,0.3,7,178,171,19
26,r_107_27_158,seq112,r_35_14_53,r_35_14_53,1.0,113,166,53,19
20,r_42_146_97,seq11,seq7,r_42_146_97,0.58,-14,83,97,19
13,r_92_3_174,seq130,r_41_110_38,r_41_110_38,0.95,136,174,38,19
15,r_90_105_178,r_9_97_77,r_79_34_107,r_79_34_107,0.54,72,179,107,19
6,r_98_102_117,r_90_105_178,r_57_40_46,r_98_102_117,0.68,30,147,117,19
67,seq39,r_57_40_46,r_133_0_28,r_57_40_46,0.82,1,47,46,19
30,r_143_127_57,r_109_61_196,seq100,r_143_127_57,0.94,0,57,57,19
40,r_88_64_81,seq124,seq32,r_88_64_81,0.6,9,90,81,19
29,r_44_36_99,seq117,r_96_33_96,r_96_33_96,1.0,3,99,96,19
0,r_41_110_38,r_96_33_96,r_71_29_23,r_71_29_23,0.95,16,39,23,19
34,r_18_24_88,seq8,r_9_97_77,r_9_97_77,0.73,14,91,77,19
39,r_47_118_50,r_18_24_88,seq46,r_47_118_50,0.92,5,55,50,19
43,r_133_0_28,r_132_128_41,seq39,r_133_0_28,0.49,-3,25,28,19
16,r_138_137_45,r_18_24_88,seq84,r_138_137_45,0.98,8,53,45,19
28,r_79_34_107,seq30,seq62,r_79_34_107,1.0,0,107,107,19
49,r_17_75_33,seq112,seq124,r_17_75_33,0.58,2,35,33,19
7,r_21_53_113,r_26_144_172,r_41_110_38,r_41_110_38,1.0,77,115,38,19
44,r_1_104_149,seq112,r_18_24_88,r_18_24_88,0.56,68,156,88,19
23,r_13_74_153,seq31,r_9_97_77,r_9_97_77,0.97,79,156,77,19
12,r_26_144_172,seq81,r_41_110_38,r_41_110_38,1.0,139,177,38,19
14,r_35_14_53,seq85,r_91_67_17,r_35_14_53,1.0,2,55,53,19
40,r_125_80_149,r_78_11_51,r_49_84_11,r_125_80_149,0.7,-18,131,149,20
36,r_16_50_68,r_72_40_194,seq52,r_16_50_68,1.0,0,68,68,20
1,r_49_84_11,r_148_4_142,r_140_103_93,r_49_84_11,0.86,0,11,11,20
14,r_70_138_162,r_93_133_161,r_49_84_11,r_93_133_161,0.62,1,162,161,20
16,r_107_7_171,r_113_31_193,r_66_81_55,r_113_31_193,0.44,-20,173,193,20
42,r_10_128_159,r_140_103_93,seq30,r_10_128_159,0.65,0,159,159,20
19,r_93_133_161,r_70_138_162,r_101_36_158,r_93_133_161,0.65,0,161,161,20
35,r_23_117_22,r_140_103_93,r_148_4_142,r_23_117_22,0.97,0,22,22,20
41,r_120_43_98,seq74,r_49_84_11,r_120_43_98,0.75,2,100,98,20
40,r_125_80_149,r_34_83_31,r_78_11_51,r_125_80_149,0.79,-117,32,149,20
4,r_20_100_178,r_140_103_93,r_60_94_9,r_140_103_93,0.5,86,179,93,20
11,r_98_12_129,r_140_103_93,seq3,r_98_12_129,0.83,2,131,129,20
15,r_60_94_9,r_93_133_161,r_54_99_75,r_93_133_161,0.85,-36,125,161,20
48,r_141_142_179,r_131_35_174,r_144_24_63,r_144_24_63,1.0,118,181,63,20
6,r_57_92_156,r_20_100_178,r_56_108_39,r_57_92_156,0.71,0,156,156,20
26,r_34_83_31,r_125_80_149,seq136,r_34_83_31,0.89,-1,30,31,20
27,r_39_25_96,r_72_40_194,r_66_81_55,r_72_40_194,1.0,-98,96,194,20
34,r_78_11_51,seq124,seq26,r_78_11_51,0.85,-7,44,51,20
47,r_82_114_92,r_143_96_127,r_16_50_68,r_143_96_127,0.47,-35,92,127,20
33,r_86_129_122,r_148_4_142,r_16_50_68,r_16_50_68,1.0,61,129,68,20
43,r_62_53_52,r_41_44_89,r_148_4_142,r_148_4_142,0.82,-98,44,142,20
20,r_66_81_55,seq26,r_88_126_30,r_66_81_55,1.0,1,56,55,20
32,r_28_73_137,r_77_63_140,r_86_129_122,r_28_73_137,0.77,4,141,137,20
38,r_134_38_115,r_140_103_93,seq130,r_134_38_115,0.75,1,116,115,20
9,r_8_21_53,r_87_42_67,seq1,r_8_21_53,0.7,1,54,53,20
22,r_77_63_140,r_28_73_137,r_49_84_11,r_77_63_140,0.76,1,141,140,20
28,r_64_102_126,r_5_46_119,r_122_2_77,r_64_102_126,0.66,1,127,126,20
7,r_61_112_180,seq52,r_87_42_67,r_87_42_67,1.0,114,181,67,20
44,r_144_24_63,r_27_121_192,seq124,r_144_24_63,1.0,0,63,63,20
23,r_87_42_67,seq74,seq26,r_87_42_67,1.0,1,68,67,20
39,r_54_99_75,r_120_43_98,r_60_94_9,r_120_43_98,1.0,-52,46,98,20
12,r_122_2_77,r_140_103_93,r_60_94_9,r_122_2_77,0.99,-1,76,77,20
15,r_55_114_48,r_62_56_132,seq22,r_55_114_48,0.84,1,49,48,21
36,r_41_104_88,r_62_56_132,seq110,r_41_104_88,0.9,1,89,88,21
14,r_34_37_78,r_62_56_132,r_98_146_80,r_34_37_78,0.97,-6,72,78,21
37,r_82_97_115,r_30_71_176,seq136,r_82_97_115,0.9,5,120,115,21
16,r_39_83_81,seq32,seq68,r_39_83_81,1.0,0,81,81,21
21,r_95_42_90,r_26_13_186,r_50_51_189,r_95_42_90,0.6,2,92,90,21
39,r_84_4_143,seq31,r_95_42_90,r_84_4_143,0.92,1,144,143,21
46,r_52_75_119,r_84_4_143,r_57_45_28,r_52_75_119,0.6,0,119,119,21
42,r_30_71_176,seq110,r_101_139_106,r_101_139_106,1.0,79,185,106,21
41,r_138_86_134,seq72,r_128_27_163,r_138_86_134,0.45,1,135,134,21
3,r_57_45_28,r_49_29_70,r_145_111_5,r_145_111_5,0.77,25,30,5,21
5,r_49_29_70,r_62_56_132,r_55_114_48,r_49_29_70,0.87,4,74,70,21
26,r_100_113_148,seq92,r_128_27_163,r_100_113_148,0.95,1,149,148,21
11,r_62_56_132,r_129_144_161,r_124_60_62,r_62_56_132,0.42,4,136,132,21
48,r_94_127_102,r_141_6_151,r_39_83_81,r_141_6_151,1.0,-49,102,151,21
6,r_131_12_162,r_26_13_186,seq130,r_131_12_162,0.32,3,165,162,21
27,r_9_66_150,seq7,r_123_122_41,r_9_66_150,0.94,0,150,150,21
47,r_124_60_62,r_11_96_71,seq77,r_124_60_62,0.95,2,64,62,21
40,r_25_16_64,r_26_13_186,seq31,r_25_16_64,1.0,0,64,64,21
18,r_11_96_71,r_98_146_80,r_108_33_29,r_11_96_71,0.67,1,72,71,21
29,r_143_132_57,r_103_36_198,seq137,r_143_132_57,0.99,4,61,57,21
24,r_135_81_172,r_21_17_98,r_34_37_78,r_21_17_98,0.35,75,173,98,21
25,r_141_6_151,seq72,r_103_36_198,r_141_6_151,0.56,1,152,151,21
33,r_149_15_130,r_103_36_198,seq1,r_149_15_130,0.88,0,130,130,21
17,r_89_134_89,seq137,seq31,r_89_134_89,1.0,0,89,89,21
9,r_101_139_106,seq68,seq2,r_101_139_106,1.0,0,106,106,21
22,r_98_146_80,r_11_96_71,r_34_37_78,r_98_146_80,0.98,-8,72,80,21
28,r_129_144_161,seq130,r_128_27_163,r_129_144_161,0.39,4,165,161,21
35,r_35_105_32,r_38_93_109,seq115,r_35_105_32,0.93,0,32,32,21
19,r_108_33_29,r_9_66_150,seq54,r_108_33_29,1.0,1,30,29,21
44,r_18_125_166,seq7,seq5,r_18_125_166,0.76,0,166,166,21
23,r_38_93_109,r_90_53_156,seq46,r_38_93_109,0.59,7,116,109,21
5,r_49_29_70,r_57_45_28,r_62_56_132,r_49_29_70,0.59,-36,34,70,21
12,r_121_14_94,r_116_10_193,r_82_97_115,r_121_14_94,0.77,24,118,94,21
30,r_95_36_122,r_139_46_171,seq63,r_95_36_122,0.88,0,122,122,22
36,r_72_137_53,seq71,seq144,r_72_137_53,0.62,36,89,53,22
14,r_42_106_78,r_35_0_76,seq27,r_42_106_78,0.83,3,81,78,22
8,r_55_90_120,r_114_89_142,r_25_69_38,r_25_69_38,0.95,82,120,38,22
39,r_125_68_184,r_11_4_182,r_111_77_24,r_125_68_184,0.44,0,184,184,22
45,r_82_44_163,seq21,r_25_69_38,r_82_44_163,0.74,1,164,163,22
19,r_112_105_150,r_87_81_169,r_96_49_66,r_96_49_66,0.55,86,152,66,22
41,r_35_0_76,r_42_106_78,seq6,r_35_0_76,0.9,5,81,76,22
26,r_136_16_166,seq1,seq97,r_136_16_166,0.7,4,170,166,22
4,r_110_138_71,r_87_81_169,seq133,r_110_138_71,0.95,2,73,71,22
11,r_96_49_66,seq131,r_102_18_3,r_96_49_66,0.97,1,67,66,22
15,r_129_76_109,r_139_46_171,r_25_69_38,r_25_69_38,0.92,76,114,38,22
48,r_80_31_178,r_126_2_123,seq130,r_80_31_178,0.63,-55,123,178,22
6,r_32_100_160,r_3_117_83,r_72_137_53,r_32_100_160,0.69,0,160,160,22
27,r_104_140_168,r_20_141_149,r_25_69_38,r_104_140_168,0.67,2,170,168,22
1,r_124_86_51,r_3_117_83,seq40,r_124_86_51,0.96,0,51,51,22
2,r_147_75_81,seq93,seq70,r_147_75_81,0.97,2,83,81,22
40,r_134_41_132,r_139_46_171,r_5_149_27,r_134_41_132,0.88,4,136,132,22
29,r_51_84_139,seq142,r_54_98_79,r_54_98_79,0.52,61,140,79,22
25,r_132_135_91,r_139_46_171,r_147_75_81,r_132_135_91,0.85,3,94,91,22
57,seq10,seq6,r_23_14_23,r_23_14_23,0.99,0,23,23,22
33,r_5_149_27,seq63,seq7,r_5_149_27,0.76,-9,18,27,22
5,r_25_69_38,r_42_106_78,r_3_117_83,r_42_106_78,0.9,-37,41,78,22
43,r_23_14_23,r_83_74_88,seq10,r_23_14_23,0.91,2,25,23,22
22,r_114_89_142,r_136_16_166,r_25_69_38,r_25_69_38,0.88,104,142,38,22
49,r_61_118_144,r_28_56_177,r_110_138_71,r_61_118_144,0.49,0,144,144,22
44,r_85_43_176,seq130,r_95_36_122,r_85_43_176,0.5,1,177,176,22
35,r_108_122_77,r_87_81_169,seq93,r_108_122_77,0.98,1,78,77,22
12,r_126_2_123,r_80_31_178,r_57_109_69,r_126_2_123,0.92,0,123,123,22
30,r_108_50_126,seq42,seq4,r_108_50_126,0.96,1,127,126,23
92,seq106,r_100_24_179,r_57_7_76,r_57_7_76,1.0,103,179,76,23
43,r_135_70_125,r_51_78_114,r_85_114_55,r_135_70_125,0.83,0,125,125,23
44,r_34_99_15,r_36_101_142,r_59_55_7,r_59_55_7,0.79,7,14,7,23
39,r_94_76_132,r_52_119_177,r_68_126_17,r_94_76_132,1.0,0,132,132,23
1,r_100_24_179,seq106,r_102_39_112,r_100_24_179,0.76,0,179,179,23
97,seq121,r_5_138_143,r_57_7_76,r_57_7_76,0.6,28,104,76,23
46,r_13_60_77,seq74,r_133_90_92,r_133_90_92,1.0,2,94,92,23
27,r_66_44_23,r_52_119_177,seq58,r_66_44_23,1.0,0,23,23,23
5,r_107_147_39,r_133_90_92,seq77,r_107_147_39,0.59,4,43,39,23
21,r_115_32_30,r_139_43_139,r_51_78_114,r_115_32_30,1.0,2,32,30,23
19,r_36_101_142,seq148,r_59_55_7,r_36_101_142,0.52,8,150,142,23
47,r_141_124_41,r_107_147_39,seq123,r_141_124_41,1.0,0,41,41,23
3,r_57_7_76,r_69_146_176,seq121,r_57_7_76,1.0,1,77,76,23
28,r_25_18_38,r_85_114_55,r_134_45_3,r_25_18_38,1.0,1,39,38,23
10,r_125_47_90,r_5_138_143,r_73_61_60,r_5_138_143,1.0,-52,91,143,23
42,r_80_131_48,r_5_138_143,r_93_128_10,r_80_131_48,1.0,0,48,48,23
26,r_1_2_187,seq123,r_52_119_177,r_52_119_177,0.9,13,190,177,23
0,r_5_138_143,r_100_24_179,r_8_0_192,r_5_138_143,0.68,2,145,143,23
11,r_19_48_95,seq31,r_57_7_76,r_57_7_76,1.0,11,87,76,23
20,r_65_89_170,seq123,r_115_32_30,r_115_32_30,0.56,140,170,30,23
13,r_98_129_140,r_75_117_121,r_38_104_194,r_98_129_140,0.97,0,140,140,23
6,r_102_39_112,r_71_46_183,seq137,r_102_39_112,0.5,3,115,112,23
31,r_93_128_10,r_5_138_143,r_68_126_17,r_93_128_10,0.96,0,10,10,23
40,r_112_95_84,r_37_20_119,r_141_124_41,r_112_95_84,0.66,0,84,84,23
36,r_9_63_52,r_52_119_177,r_81_17_35,r_52_119_177,0.9,-125,52,177,23
33,r_116_130_145,r_67_22_144,r_133_90_92,r_133_90_92,1.0,65,157,92,23
48,r_28_111_25,r_64_83_182,seq53,r_28_111_25,1.0,0,25,25,23
38,r_69_146_176,seq27,r_65_89_170,r_69_146_176,0.62,0,176,176,23
41,r_81_17_35,r_52_119_177,r_59_55_7,r_81_17_35,0.99,0,35,35,23
17,r_133_90_92,r_51_78_114,r_13_60_77,r_133_90_92,1.0,1,93,92,23
22,r_37_20_119,r_71_46_183,r_59_55_7,r_37_20_119,0.76,5,124,119,23
49,r_23_105_171,seq84,r_57_7_76,r_57_7_76,0.93,95,171,76,23
23,r_139_43_139,seq4,seq132,r_139_43_139,0.95,1,140,139,23
35,r_71_46_183,seq96,r_93_128_10,r_93_128_10,0.92,173,183,10,23
12,r_52_119_177,seq143,r_66_44_23,r_66_44_23,0.89,154,177,23,23
30,r_113_23_115,seq11,r_61_69_57,r_113_23_115,1.0,2,117,115,24
43,r_137_130_121,r_73_114_142,r_107_5_51,r_73_114_142,0.98,-21,121,142,24
98,seq125,r_90_84_62,r_40_145_58,r_40_145_58,1.0,-1,57,58,24
37,r_146_76_72,seq37,seq32,r_146_76_72,1.0,-1,71,72,24
16,r_43_126_68,r_29_147_149,r_90_84_62,r_90_84_62,0.76,3,65,62,24
5,r_119_121_162,seq118,r_90_84_62,r_90_84_62,0.8,107,169,62,24
45,r_49_96_191,r_117_131_66,r_43_126_68,r_43_126_68,0.99,-3,65,68,24
10,r_40_145_58,r_58_35_126,seq125,r_40_145_58,0.79,-1,57,58,24
19,r_89_48_113,seq144,r_68_104_17,r_89_48_113,0.69,1,114,113,24
41,r_73_114_142,r_137_130_121,r_1_122_63,r_73_114_142,0.79,-17,125,142,24
67,seq37,r_146_76_72,seq46,r_146_76_72,1.0,1,73,72,24
36,r_95_87_12,r_43_126_68,seq116,r_95_87_12,0.99,0,12,12,24
4,r_108_18_78,r_90_84_62,seq67,r_108_18_78,0.83,-1,77,78,24
0,r_90_84_62,r_108_18_78,r_43_126_68,r_90_84_62,0.77,3,65,62,24
11,r_4_149_150,r_133_106_168,r_25_92_18,r_25_92_18,0.99,132,150,18,24
6,r_65_129_111,r_49_96_191,seq138,r_65_129_111,0.97,1,112,111,24
42,r_91_140_46,r_146_76_72,seq28,r_146_76_72,0.62,-29,43,72,24
1,r_107_5_51,seq59,seq45,r_107_5_51,1.0,0,51,51,24
39,r_44_15_55,r_89_48_113,r_62_42_2,r_89_48_113,0.53,-72,41,113,24
2,r_1_122_63,r_3_52_159,seq37,r_1_122_63,0.95,0,63,63,24
47,r_30_105_141,r_4_149_150,r_39_72_26,r_39_72_26,0.87,115,141,26,24
33,r_141_70_94,seq45,r_22_47_90,r_141_70_94,1.0,0,94,94,24
9,r_97_63_70,r_73_114_142,r_62_42_2,r_97_63_70,0.74,-13,57,70,24
21,r_16_14_52,r_141_70_94,seq32,r_141_70_94,0.94,-57,37,94,24
32,r_56_100_64,r_25_92_18,r_4_149_150,r_25_92_18,0.72,122,140,18,24
38,r_50_24_125,seq34,r_90_84_62,r_50_24_125,0.67,4,129,125,24
23,r_39_72_26,r_10_60_102,r_73_114_142,r_39_72_26,1.0,-1,25,26,24
25,r_12_98_22,r_123_120_36,seq34,r_123_120_36,0.49,-13,23,36,24
7,r_123_120_36,r_117_131_66,r_22_47_90,r_123_120_36,1.0,0,36,36,24
13,r_117_131_66,r_8_27_88,seq125,r_8_27_88,0.96,-41,47,88,24
49,r_142_128_109,r_25_92_18,r_16_14_52,r_142_128_109,1.0,0,109,109,24
44,r_8_27_88,r_117_131_66,r_95_87_12,r_8_27_88,1.0,1,89,88,24
12,r_58_35_126,r_25_92_18,r_10_60_102,r_58_35_126,0.96,0,126,126,24
23,r_39_72_26,r_73_114_142,r_30_105_141,r_30_105_141,0.99,5,146,141,24
36,r_109_25_107,seq63,seq73,r_109_25_107,0.66,3,110,107,25
14,r_34_11_77,seq7,r_51_32_10,r_34_11_77,0.9,3,80,77,25
49,r_87_101_57,seq67,r_76_18_9,r_87_101_57,0.9,1,58,57,25
12,r_65_43_16,r_123_49_128,seq94,r_65_43_16,0.7,-2,14,16,25
37,r_85_60_59,r_2_58_72,seq91,r_85_60_59,0.82,2,61,59,25
21,r_4_112_125,r_116_124_139,seq147,r_4_112_125,0.82,1,126,125,25
39,r_39_74_135,r_132_12_158,seq88,r_132_12_158,0.65,-23,135,158,25
42,r_69_95_126,r_111_22_199,r_65_43_16,r_69_95_126,0.85,8,134,126,25
45,r_123_49_128,seq141,seq108,r_123_49_128,0.92,7,135,128,25
34,r_75_135_49,r_134_14_153,seq31,r_75_135_49,0.91,0,49,49,25
31,r_72_0_67,r_109_25_107,r_84_133_11,r_72_0_67,1.0,0,67,67,25
10,r_82_118_60,r_48_140_122,r_77_54_13,r_82_118_60,0.93,0,60,60,25
4,r_29_57_143,seq90,seq27,r_29_57_143,0.72,1,144,143,25
0,r_134_14_153,r_117_136_159,r_38_64_15,r_134_14_153,0.76,3,156,153,25
5,r_38_64_15,r_13_130_90,seq141,r_38_64_15,0.89,-1,14,15,25
6,r_117_136_159,r_66_61_197,seq125,r_66_61_197,0.53,-30,167,197,25
27,r_48_140_122,seq94,r_72_0_67,r_48_140_122,0.87,2,124,122,25
8,r_56_46_37,r_29_57_143,seq28,r_56_46_37,0.82,12,49,37,25
2,r_128_44_151,r_117_136_159,r_75_135_49,r_117_136_159,0.98,-8,151,159,25
47,r_111_22_199,r_50_107_73,r_16_24_47,r_111_22_199,0.71,-126,73,199,25
18,r_98_142_187,seq105,r_134_14_153,r_98_142_187,0.2,3,190,187,25
29,r_86_103_132,r_111_22_199,r_71_81_6,r_86_103_132,0.83,0,132,132,25
25,r_3_70_138,r_39_74_135,seq30,r_39_74_135,0.87,-3,132,135,25
32,r_50_107_73,r_111_22_199,seq63,r_50_107_73,0.96,0,73,73,25
38,r_9_21_155,r_117_136_159,seq7,r_117_136_159,0.3,-2,157,159,25
33,r_120_146_43,r_29_57_143,r_16_24_47,r_29_57_143,0.59,-99,44,143,25
9,r_2_58_72,r_98_142_187,seq67,r_2_58_72,0.77,1,73,72,25
7,r_13_130_90,seq45,r_84_133_11,r_13_130_90,0.97,1,91,90,25
44,r_106_15_181,r_71_81_6,r_83_137_148,r_83_137_148,0.66,35,183,148,25
52,seq7,r_34_11_77,seq91,r_34_11_77,0.97,-36,41,77,25
35,r_68_145_45,r_16_24_47,r_78_53_179,r_78_53_179,0.96,-119,60,179,25
30,r_22_94_77,r_108_128_95,seq110,r_22_94_77,0.71,1,78,77,26
36,r_140_27_151,seq65,r_134_112_52,r_134_112_52,1.0,121,173,52,26
43,r_61_97_173,seq4,r_57_54_140,r_61_97_173,0.45,2,175,173,26
37,r_148_49_49,r_83_131_53,seq48,r_148_49_49,0.82,1,50,49,26
46,r_1_122_114,r_33_58_136,seq64,r_33_58_136,0.62,-22,114,136,26
45,r_117_77_149,seq47,r_134_112_52,r_134_112_52,0.99,96,148,52,26
24,r_91_103_42,r_82_3_105,r_102_76_37,r_91_103_42,0.92,0,42,42,26
31,r_29_6_87,r_83_131_53,r_125_127_189,r_29_6_87,0.77,6,93,87,26
26,r_108_128_95,seq4,r_134_112_52,r_108_128_95,0.93,1,96,95,26
4,r_34_28_82,r_108_128_95,seq99,r_34_28_82,1.0,0,82,82,26
0,r_82_3_105,seq133,r_102_76_37,r_82_3_105,0.54,3,108,105,26
11,r_7_90_178,seq9,r_134_112_52,r_134_112_52,0.93,125,177,52,26
41,r_129_139_59,r_82_3_105,r_148_49_49,r_129_139_59,0.95,0,59,59,26
2,r_42_86_116,seq133,r_148_49_49,r_42_86_116,0.76,0,116,116,26
47,r_0_136_90,r_115_14_169,r_132_109_14,r_0_136_90,0.69,3,93,90,26
40,r_33_58_136,r_117_77_149,seq9,r_117_77_149,0.78,-12,137,149,26
29,r_51_26_79,r_23_74_199,r_39_40_34,r_51_26_79,0.96,0,79,79,26
25,r_79_81_164,seq47,r_51_26_79,r_51_26_79,0.82,87,166,79,26
42,r_36_31_19,r_124_5_22,seq4,r_36_31_19,0.84,3,22,19,26
32,r_125_127_189,r_117_77_149,r_29_6_87,r_29_6_87,0.97,57,144,87,26
28,r_52_146_35,seq9,seq2,r_52_146_35,0.76,0,35,35,26
9,r_24_11_67,r_115_14_169,r_83_131_53,r_24_11_67,0.77,1,68,67,26
22,r_53_96_126,r_83_131_53,r_19_130_38,r_19_130_38,1.0,90,128,38,26
34,r_39_40_34,r_137_73_68,seq133,r_39_40_34,0.9,3,37,34,26
8,r_134_112_52,r_141_30_180,r_52_146_35,r_134_112_52,0.58,4,56,52,26
49,r_87_145_145,r_115_14_169,r_34_28_82,r_87_145_145,0.72,0,145,145,26
7,r_102_76_37,seq17,r_36_31_19,r_102_76_37,0.63,0,37,37,26
23,r_137_73_68,seq48,seq21,r_137_73_68,0.93,1,69,68,26
44,r_56_68_27,r_142_72_190,r_132_109_14,r_56_68_27,0.46,1,28,27,26
43,r_63_26_177,seq31,r_29_36_95,r_63_26_177,0.48,0,177,177,27
37,r_95_28_63,r_27_35_155,r_60_25_137,r_95_28_63,0.63,1,64,63,27
86,seq93,r_85_89_115,seq56,r_85_89_115,0.95,1,116,115,27
21,r_22_147_106,seq18,seq128,r_22_147_106,1.0,0,106,106,27
1,r_33_122_140,seq56,r_96_20_52,r_96_20_52,0.96,88,140,52,27
5,r_126_138_146,seq115,seq56,r_126_138_146,0.89,1,147,146,27
46,r_140_9_96,r_87_74_4,r_117_37_80,r_140_9_96,0.63,0,96,96,27
42,r_77_112_159,r_63_26_177,r_67_90_14,r_77_112_159,0.64,1,160,159,27
13,r_134_111_50,r_126_138_146,seq141,r_134_111_50,0.66,1,51,50,27
19,r_98_123_88,seq2,seq131,r_98_123_88,1.0,0,88,88,27
31,r_132_104_112,r_97_144_196,r_6_10_148,r_132_104_112,0.99,1,113,112,27
41,r_85_89_115,seq93,r_97_144_196,r_85_89_115,0.93,1,116,115,27
3,r_27_35_155,seq141,r_143_64_138,r_27_35_155,0.82,1,156,155,27
10,r_53_107_150,seq128,r_44_1_102,r_44_1_102,0.59,51,153,102,27
32,r_73_145_23,r_29_36_95,r_87_74_4,r_73_145_23,0.97,1,24,23,27
0,r_29_36_95,r_53_107_150,r_19_5_17,r_19_5_17,0.82,80,97,17,27
11,r_38_100_94,r_68_40_166,r_21_45_79,r_68_40_166,1.0,-72,94,166,27
48,r_75_88_157,r_97_144_196,r_6_10_148,r_75_88_157,0.7,1,158,157,27
47,r_24_137_60,r_65_69_197,r_97_144_196,r_24_137_60,1.0,0,60,60,27
40,r_117_37_80,r_97_144_196,r_136_84_43,r_97_144_196,1.0,-111,85,196,27
24,r_43_50_20,r_126_138_146,seq130,r_43_50_20,0.96,0,20,20,27
33,r_44_1_102,seq148,r_3_41_67,r_3_41_67,1.0,45,112,67,27
38,r_129_42_135,r_139_124_193,seq32,r_129_42_135,0.88,0,135,135,27
22,r_67_90_14,r_29_36_95,seq49,r_67_90_14,0.99,0,14,14,27
34,r_3_41_67,r_97_144_196,seq125,r_3_41_67,1.0,0,67,67,27
45,r_46_23_53,r_27_35_155,seq79,r_46_23_53,0.92,0,53,53,27
14,r_96_20_52,r_6_10_148,seq2,r_96_20_52,1.0,1,53,52,27
28,r_109_11_97,r_53_107_150,r_38_100_94,r_53_107_150,1.0,-52,98,150,27
49,r_113_106_110,seq131,seq146,r_113_106_110,0.98,0,110,110,27
7,r_54_47_171,seq131,r_38_100_94,r_38_100_94,0.97,77,171,94,27
44,r_21_45_79,r_126_138_146,seq16,r_21_45_79,0.98,0,79,79,27
8,r_10_146_122,r_136_75_55,seq48,r_10_146_122,0.76,5,127,122,28
37,r_47_65_80,r_69_33_147,seq87,r_47_65_80,0.87,10,90,80,28
39,r_121_138_138,seq72,r_76_31_78,r_121_138_138,0.55,0,138,138,28
5,r_69_33_147,seq48,r_4_6_32,r_69_33_147,0.73,0,147,147,28
46,r_12_42_77,r_114_95_129,seq139,r_12_42_77,0.54,0,77,77,28
42,r_32_98_83,r_9_56_133,seq102,r_32_98_83,0.57,-2,81,83,28
45,r_110_15_156,r_62_11_66,r_145_17_121,r_62_11_66,0.49,103,169,66,28
41,r_141_29_145,seq25,r_78_74_17,r_141_29_145,0.87,1,146,145,28
89,seq88,r_104_127_172,r_41_122_63,r_41_122_63,0.99,0,63,63,28
3,r_80_1_99,r_101_83_152,r_28_57_136,r_80_1_99,0.5,-2,97,99,28
26,r_123_27_158,seq30,seq35,r_123_27_158,0.72,-2,156,158,28
4,r_145_17_121,r_94_148_169,r_137_115_39,r_94_148_169,0.69,-46,123,169,28
13,r_114_95_129,r_12_42_77,seq5,r_114_95_129,0.8,1,130,129,28
48,r_61_128_95,seq73,r_137_115_39,r_61_128_95,0.97,-2,93,95,28
15,r_43_58_44,r_149_116_73,seq20,r_43_58_44,0.9,-1,43,44,28
40,r_60_100_48,seq0,r_66_55_143,r_60_100_48,0.91,1,49,48,28
47,r_82_63_150,seq36,r_80_1_99,r_82_63_150,0.78,0,150,150,28
74,seq36,r_82_63_150,r_10_146_122,r_10_146_122,0.6,28,150,122,28
29,r_104_127_172,seq88,r_141_29_145,r_104_127_172,0.37,3,175,172,28
25,r_67_91_130,r_99_13_41,r_10_146_122,r_67_91_130,0.89,1,131,130,28
33,r_109_126_91,seq134,r_32_98_83,r_109_126_91,0.67,1,92,91,28
88,seq87,r_9_56_133,r_47_65_80,r_47_65_80,0.96,-3,77,80,28
21,r_137_115_39,r_59_93_181,seq134,r_137_115_39,0.5,-2,37,39,28
32,r_90_108_103,r_9_56_133,seq34,r_9_56_133,0.92,-20,113,133,28
16,r_45_64_53,r_67_91_130,seq24,r_45_64_53,0.95,0,53,53,28
28,r_14_120_123,seq24,r_80_1_99,r_14_120_123,0.8,5,128,123,28
49,r_78_74_17,r_92_119_171,r_141_29_145,r_141_29_145,0.77,1,146,145,28
44,r_77_81_164,seq16,seq142,r_77_81_164,0.77,0,164,164,28
35,r_9_56_133,seq87,r_60_100_48,r_60_100_48,0.99,87,135,48,28
22,r_19_144_49,r_50_3_36,r_4_6_32,r_19_144_49,0.74,-2,47,49,28
12,r_41_122_63,r_123_27_158,seq88,r_41_122_63,0.79,0,63,63,28
36,r_87_121_178,seq66,r_103_109_172,r_103_109_172,0.55,12,184,172,29
37,r_50_144_62,r_40_122_149,r_79_42_5,r_50_144_62,0.74,2,64,62,29
1,r_62_34_105,r_103_109_172,r_85_60_76,r_103_109_172,0.7,-63,109,172,29
5,r_97_115_103,r_40_122_149,r_118_75_185,r_40_122_149,0.91,-45,104,149,29
46,r_113_70_175,r_79_42_5,r_134_10_61,r_134_10_61,1.0,116,177,61,29
42,r_54_84_117,seq98,r_147_135_116,r_54_84_117,0.7,1,118,117,29
31,r_19_141_69,r_79_42_5,seq3,r_19_141_69,0.58,0,69,69,29
41,r_48_101_131,r_103_109_172,r_32_123_20,r_103_109_172,0.56,-38,134,172,29
10,r_137_88_110,r_147_135_116,seq8,r_137_88_110,0.85,1,111,110,29
7,r_127_2_24,r_40_122_149,seq63,r_127_2_24,0.75,-2,22,24,29
26,r_112_49_108,r_147_135_116,r_4_100_4,r_112_49_108,0.54,5,113,108,29
0,r_134_10_61,r_79_42_5,r_57_59_199,r_134_10_61,0.77,3,64,61,29
11,r_5_76_132,seq94,r_137_88_110,r_5_76_132,0.52,3,135,132,29
20,r_57_59_199,r_58_91_47,r_134_10_61,r_134_10_61,0.99,20,81,61,29
40,r_52_128_34,r_134_10_61,r_58_91_47,r_58_91_47,0.63,-11,36,47,29
43,r_108_7_36,r_0_143_161,r_127_2_24,r_0_143_161,0.8,-119,42,161,29
47,r_22_129_52,r_131_145_6,r_110_61_73,r_22_129_52,0.77,23,75,52,29
24,r_28_71_114,seq47,r_32_123_20,r_28_71_114,0.55,4,118,114,29
38,r_103_109_172,seq63,r_147_135_116,r_147_135_116,0.69,58,174,116,29
35,r_85_60_76,r_79_42_5,r_62_34_105,r_62_34_105,0.91,6,111,105,29
44,r_41_114_145,r_118_75_185,seq90,r_118_75_185,0.45,-40,145,185,29
35,r_85_60_76,r_102_117_124,r_79_42_5,r_102_117_124,0.55,-47,77,124,29
40,r_50_122_36,r_53_43_191,r_139_27_50,r_139_27_50,0.5,126,176,50,30
36,r_45_42_148,seq83,r_19_72_101,r_45_42_148,0.57,0,148,148,30
14,r_59_140_107,r_103_100_142,seq65,r_59_140_107,0.53,0,107,107,30
43,r_21_52_152,seq0,r_94_2_110,r_21_52_152,0.56,0,152,152,30
34,r_79_37_23,r_139_27_50,r_63_71_9,r_79_37_23,0.86,2,25,23,30
16,r_1_124_115,r_45_42_148,r_77_137_8,r_1_124_115,0.71,2,117,115,30
21,r_107_132_72,r_112_55_17,r_102_49_2,r_107_132_72,0.99,-5,67,72,30
97,seq121,seq5,r_139_27_50,r_139_27_50,1.0,23,73,50,30
5,r_60_93_89,seq5,seq44,r_60_93_89,0.75,3,92,89,30
46,r_80_69_157,seq38,r_20_29_93,r_80_69_157,0.51,5,162,157,30
42,r_96_82_111,r_62_54_1,r_20_29_93,r_96_82_111,0.88,3,114,111,30
45,r_126_119_178,r_84_131_105,r_77_137_8,r_84_131_105,0.98,-34,71,105,30
15,r_88_99_12,r_84_131_105,r_48_104_4,r_84_131_105,0.88,-21,84,105,30
31,r_28_6_122,r_75_120_136,seq135,r_75_120_136,0.59,-9,127,136,30
41,r_86_46_116,r_73_141_177,r_14_127_76,r_73_141_177,0.94,-61,116,177,30
26,r_9_34_129,seq31,seq148,r_9_34_129,0.81,0,129,129,30
4,r_20_29_93,r_9_34_129,seq40,r_9_34_129,0.57,-46,83,129,30
0,r_98_58_179,r_7_35_97,r_9_34_129,r_9_34_129,0.65,50,179,129,30
20,r_14_127_76,r_73_141_177,seq134,r_14_127_76,0.99,-1,75,76,30
38,r_142_66_58,seq40,seq145,r_142_66_58,1.0,-7,51,58,30
40,r_50_122_36,r_96_82_111,r_53_43_191,r_50_122_36,0.99,-3,33,36,30
47,r_11_41_160,r_77_137_8,r_112_55_17,r_77_137_8,0.7,152,160,8,30
18,r_73_141_177,seq5,r_60_93_89,r_60_93_89,1.0,91,180,89,30
29,r_12_51_153,seq3,r_62_54_1,r_12_51_153,0.54,5,158,153,30
25,r_84_131_105,r_11_41_160,seq149,r_84_131_105,0.71,0,105,105,30
33,r_118_30_79,r_84_131_105,seq85,r_118_30_79,0.85,0,79,79,30
44,r_70_39_16,r_60_93_89,seq138,r_70_39_16,0.58,0,16,16,30
2,r_36_25_25,r_59_140_107,seq65,r_36_25_25,0.6,0,25,25,30
3,r_110_115_33,r_61_76_171,seq31,r_110_115_33,1.0,0,33,33,30
45,r_126_119_178,r_77_137_8,r_112_55_17,r_126_119_178,0.61,0,178,178,30
9,r_94_2_110,r_112_55_17,seq3,r_94_2_110,0.76,4,114,110,30
22,r_108_15_128,r_112_55_17,r_110_115_33,r_112_55_17,0.89,112,129,17,30
73,seq44,r_90_26_5,r_60_93_89,r_60_93_89,0.95,8,97,89,30
49,r_33_17_149,seq134,r_9_34_129,r_33_17_149,0.49,0,149,149,30
48,r_53_43_191,r_60_93_89,r_50_122_36,r_50_122_36,0.9,-4,32,36,30
7,r_19_72_101,r_24_128_192,r_63_71_9,r_19_72_101,0.96,4,105,101,30
23,r_77_137_8,r_11_41_160,r_1_124_115,r_77_137_8,0.67,152,160,8,30
12,r_64_78_138,r_112_55_17,r_129_143_7,r_112_55_17,0.58,122,139,17,30
12,r_107_96_45,r_59_112_42,r_21_76_176,r_107_96_45,0.67,12,57,45,31
14,r_56_99_119,r_0_110_175,r_145_111_80,r_56_99_119,0.81,0,119,119,31
37,r_104_108_83,r_61_10_172,r_106_40_15,r_104_108_83,0.82,2,85,83,31
21,r_51_85_186,seq15,r_37_27_2,r_51_85_186,0.25,-3,183,186,31
46,r_106_40_15,r_143_93_168,r_104_108_83,r_104_108_83,0.84,2,85,83,31
42,r_13_30_6,r_35_34_138,r_69_7_111,r_13_30_6,0.61,138,144,6,31
45,r_128_136_135,r_45_90_66,seq31,r_45_90_66,0.97,2,68,66,31
19,r_35_34_138,r_13_30_6,r_2_71_1,r_35_34_138,0.49,6,144,138,31
30,r_49_127_27,r_145_111_80,r_2_71_1,r_145_111_80,0.64,-53,27,80,31
95,seq117,r_17_55_178,r_118_142_152,r_118_142_152,0.83,28,180,152,31
10,r_138_75_79,seq20,r_139_41_41,r_138_75_79,0.86,0,79,79,31
4,r_3_57_98,r_103_73_133,r_138_75_79,r_3_57_98,0.93,6,104,98,31
0,r_24_14_144,r_53_42_146,r_104_108_83,r_24_14_144,0.29,8,152,144,31
29,r_5_133_55,r_132_43_37,seq102,r_5_133_55,0.7,2,57,55,31
20,r_145_111_80,r_36_95_92,r_58_74_4,r_145_111_80,0.93,0,80,80,31
13,r_16_115_191,r_11_120_115,r_45_90_66,r_16_115_191,0.8,-123,68,191,31
15,r_61_10_172,r_58_74_4,r_5_133_55,r_58_74_4,0.48,168,172,4,31
48,r_69_7_111,r_47_64_183,r_13_30_6,r_69_7_111,0.48,2,113,111,31
6,r_143_93_168,r_106_40_15,r_45_90_66,r_106_40_15,0.53,154,169,15,31
27,r_68_83_99,r_139_41_41,r_26_94_93,r_68_83_99,0.7,1,100,99,31
2,r_0_110_175,seq15,r_59_112_42,r_59_112_42,0.97,134,176,42,31
47,r_109_65_136,seq12,r_138_75_79,r_109_65_136,0.48,4,140,136,31
25,r_45_90_66,r_66_135_193,r_16_115_191,r_66_135_193,0.64,-126,67,193,31
38,r_17_55_178,seq117,r_124_98_29,r_17_55_178,0.21,2,180,178,31
34,r_47_64_183,seq117,r_59_112_42,r_59_112_42,1.0,146,188,42,31
23,r_126_70_43,r_0_110_175,seq39,r_126_70_43,0.96,0,43,43,31
26,r_124_98_29,r_37_27_2,seq18,r_124_98_29,0.76,5,34,29,31
45,r_128_136_135,seq31,seq117,r_128_136_135,0.89,5,140,135,31
17,r_53_42_146,r_118_142_152,r_13_30_6,r_53_42_146,0.52,0,146,146,31
28,r_87_67_110,seq22,r_92_121_101,r_87_67_110,0.53,0,110,110,31
1,r_59_112_42,r_107_96_45,r_144_38_33,r_59_112_42,0.82,15,57,42,31
35,r_88_29_85,seq101,r_107_96_45,r_107_96_45,0.96,61,106,45,31
39,r_33_105_49,r_3_57_98,seq12,r_33_105_49,0.93,1,50,49,31
37,r_2_77_104,r_3_72_197,r_78_59_13,r_2_77_104,0.84,1,105,104,32
24,r_86_8_62,r_27_17_94,r_75_133_38,r_86_8_62,0.6,-3,59,62,32
16,r_105_132_66,r_149_73_198,seq25,r_105_132_66,0.61,1,67,66,32
1,r_35_122_147,r_87_10_122,r_143_99_123,r_35_122_147,0.77,0,147,147,32
5,r_14_48_125,r_147_115_156,seq145,r_147_115_156,0.58,-30,126,156,32
46,r_108_32_109,seq19,r_87_10_122,r_108_32_109,0.92,0,109,109,32
42,r_103_94_142,seq116,r_4_85_92,r_4_85_92,0.47,50,142,92,32
35,r_50_69_47,r_35_122_147,seq38,r_50_69_47,0.94,-2,45,47,32
45,r_22_125_171,r_61_20_172,r_75_133_38,r_61_20_172,0.84,-16,156,172,32
10,r_79_95_48,r_9_135_167,seq81,r_79_95_48,1.0,0,48,48,32
0,r_47_34_54,r_3_72_197,seq13,r_47_34_54,0.75,-5,49,54,32
76,seq139,r_143_99_123,r_131_92_93,r_143_99_123,0.75,-32,91,123,32
4,r_127_126_12,r_142_0_27,seq31,r_127_126_12,0.79,0,12,12,32
31,r_36_23_150,seq88,r_40_43_177,r_36_23_150,0.76,2,152,150,32
20,r_7_60_180,seq19,r_87_10_122,r_7_60_180,0.43,1,181,180,32
15,r_71_70_61,r_106_67_183,r_65_74_14,r_65_74_14,0.39,53,67,14,32
8,r_16_24_46,r_35_122_147,r_142_0_27,r_16_24_46,0.98,-1,45,46,32
27,r_28_104_148,r_87_10_122,r_55_110_5,r_28_104_148,0.83,0,148,148,32
40,r_41_112_69,r_103_94_142,r_134_144_9,r_41_112_69,0.76,-4,65,69,32
33,r_9_135_167,r_87_10_122,seq96,r_9_135_167,0.61,1,168,167,32
34,r_120_5_95,seq96,seq11,r_120_5_95,0.97,0,95,95,32
12,r_136_58_17,seq97,r_3_72_197,r_136_58_17,0.91,-1,16,17,32
28,r_143_99_123,seq139,r_35_122_147,r_143_99_123,0.5,27,150,123,32
38,r_114_91_43,seq25,seq13,r_114_91_43,0.78,-2,41,43,32
36,r_135_134_126,r_16_11_65,r_149_119_71,r_16_11_65,0.66,65,130,65,33
26,r_0_128_109,r_14_5_141,r_144_122_122,r_0_128_109,0.93,33,142,109,33
8,r_144_122_122,seq142,seq46,r_144_122_122,0.96,1,123,122,33
43,r_6_130_178,seq7,r_55_65_86,r_55_65_86,1.0,93,179,86,33
44,r_104_26_46,r_16_11_65,seq143,r_16_11_65,0.77,-18,47,65,33
16,r_89_78_118,r_70_29_124,r_126_113_13,r_126_113_13,0.94,105,118,13,33
39,r_57_68_189,seq49,r_19_24_193,r_19_24_193,0.74,-3,190,193,33
5,r_9_40_177,r_16_11_65,r_121_22_70,r_121_22_70,1.0,110,180,70,33
46,r_59_101_153,r_27_83_186,r_58_34_3,r_59_101_153,0.58,0,153,153,33
45,r_3_1_114,r_30_15_104,r_21_37_45,r_21_37_45,0.99,74,119,45,33
30,r_118_140_21,r_20_102_97,r_126_113_13,r_118_140_21,0.71,1,22,21,33
19,r_2_81_140,r_146_33_197,seq143,r_2_81_140,0.55,15,155,140,33
26,r_0_128_109,r_6_130_178,r_14_5_141,r_0_128_109,0.81,1,110,109,33
9,r_100_88_39,seq36,seq39,r_100_88_39,1.0,0,39,39,33
42,r_21_37_45,seq50,seq142,r_21_37_45,1.0,1,46,45,33
11,r_121_22_70,r_74_56_59,r_90_8_29,r_121_22_70,0.96,0,70,70,33
20,r_20_102_97,r_30_15_104,r_149_119_71,r_20_102_97,1.0,1,98,97,33
6,r_85_99_131,r_103_86_144,seq77,r_85_99_131,0.67,1,132,131,33
13,r_90_8_29,r_47_31_42,seq43,r_90_8_29,1.0,0,29,29,33
2,r_74_56_59,r_19_24_193,r_148_112_98,r_148_112_98,0.54,3,101,98,33
47,r_52_110_63,r_89_78_118,seq127,r_52_110_63,0.71,1,64,63,33
40,r_55_65_86,r_62_25_115,r_21_37_45,r_62_25_115,1.0,-27,88,115,33
25,r_91_66_52,r_27_83_186,r_19_24_193,r_91_66_52,0.7,49,101,52,33
33,r_67_4_150,seq53,r_19_24_193,r_67_4_150,0.75,0,150,150,33
38,r_38_72_181,seq53,r_96_97_40,r_96_97_40,0.73,141,181,40,33
52,seq133,r_27_83_186,r_96_97_40,r_96_97_40,1.0,146,186,40,33
34,r_70_29_124,seq64,r_149_119_71,r_70_29_124,0.98,0,124,124,33
3,r_48_69_31,r_0_128_109,seq117,r_48_69_31,0.95,0,31,31,33
41,r_107_80_48,seq17,r_96_97_40,r_96_97_40,1.0,8,48,40,33
95,seq117,r_149_119_71,r_48_69_31,r_48_69_31,1.0,20,51,31,33
12,r_114_28_162,r_16_11_65,r_13_136_148,r_16_11_65,0.42,106,171,65,33
1,r_96_97_40,r_57_68_189,r_107_80_48,r_96_97_40,1.0,0,40,40,33
30,r_83_113_109,r_16_52_100,r_67_61_40,r_16_52_100,1.0,9,109,100,34
8,r_7_110_120,r_96_116_124,r_114_27_135,r_7_110_120,0.84,3,123,120,34
16,r_72_74_102,seq71,r_79_90_199,r_72_74_102,1.0,0,102,102,34
21,r_119_111_167,r_69_118_63,r_97_1_134,r_69_118_63,0.57,104,167,63,34
5,r_133_102_88,r_141_58_189,seq0,r_133_102_88,1.0,0,88,88,34
42,r_57_104_73,seq37,seq70,r_57_104_73,0.62,1,74,73,34
69,seq40,r_25_29_119,r_57_104_73,r_25_29_119,1.0,-18,101,119,34
19,r_16_52_100,r_23_4_139,seq109,r_23_4_139,1.0,-38,101,139,34
37,r_31_81_41,r_91_98_16,r_141_58_189,r_31_81_41,1.0,0,41,41,34
41,r_139_41_95,seq70,r_142_56_156,r_139_41_95,1.0,0,95,95,34
10,r_108_45_136,r_47_122_23,seq84,r_108_45_136,0.52,1,137,136,34
26,r_8_26_76,r_91_98_16,seq49,r_8_26_76,0.89,0,76,76,34
1,r_138_127_51,r_8_26_76,r_11_100_11,r_11_100_11,0.99,41,52,11,34
4,r_50_51_114,r_44_128_172,r_25_29_119,r_25_29_119,1.0,12,131,119,34
0,r_69_118_63,r_112_15_131,r_115_66_54,r_112_15_131,0.81,-30,101,131,34
20,r_25_29_119,seq40,r_50_51_114,r_25_29_119,1.0,0,119,119,34
15,r_47_122_23,r_108_45_136,seq49,r_47_122_23,0.55,114,137,23,34
6,r_117_92_82,r_50_51_114,r_33_85_197,r_33_85_197,0.52,-114,83,197,34
47,r_114_27_135,seq131,r_7_110_120,r_114_27_135,0.83,2,137,135,34
40,r_9_126_147,seq48,r_117_92_82,r_9_126_147,0.97,0,147,147,34
29,r_82_10_104,r_53_42_177,seq105,r_82_10_104,0.81,0,104,104,34
33,r_78_144_115,seq130,r_135_32_106,r_78_144_115,1.0,0,115,115,34
13,r_11_100_11,r_69_118_63,seq70,r_11_100_11,0.99,-1,10,11,34
32,r_96_116_124,r_7_110_120,seq40,r_96_116_124,0.88,8,132,124,34
38,r_146_2_137,seq147,r_21_124_25,r_21_124_25,0.95,112,137,25,34
77,seq64,r_97_1_134,r_16_52_100,r_97_1_134,0.96,2,136,134,34
34,r_87_149_77,r_69_118_63,seq38,r_87_149_77,0.72,0,77,77,34
24,r_21_124_25,r_108_45_136,r_142_56_156,r_21_124_25,1.0,0,25,25,34
3,r_67_61_40,r_69_118_63,r_91_98_16,r_67_61_40,1.0,1,41,40,34
17,r_135_32_106,r_69_118_63,r_148_68_86,r_148_68_86,1.0,26,112,86,34
9,r_112_15_131,r_69_118_63,r_87_149_77,r_69_118_63,0.76,68,131,63,34
7,r_88_54_165,seq84,seq63,r_88_54_165,0.71,0,165,165,34
44,r_43_137_151,seq5,r_117_92_82,r_43_137_151,0.89,0,151,151,34
23,r_65_19_111,r_50_51_114,seq48,r_65_19_111,0.98,0,111,111,34
25,r_36_143_19,r_47_122_23,r_18_75_26,r_36_143_19,1.0,0,19,19,34
84,seq84,r_88_54_165,r_7_110_120,r_88_54_165,0.86,0,165,165,34
36,r_94_103_118,r_130_99_159,r_63_35_31,r_130_99_159,0.92,-41,118,159,35
66,seq37,r_130_99_159,r_85_110_142,r_130_99_159,0.68,-23,136,159,35
43,r_42_0_147,seq106,r_7_135_43,r_7_135_43,0.98,105,148,43,35
37,r_46_57_95,r_5_69_158,seq112,r_46_57_95,0.96,0,95,95,35
14,r_17_105_59,r_70_104_93,seq43,r_17_105_59,1.0,0,59,59,35
16,r_18_62_134,r_101_49_106,seq74,r_101_49_106,1.0,-11,95,106,35
21,r_5_69_158,seq113,r_83_77_124,r_5_69_158,0.63,1,159,158,35
22,r_2_73_34,r_54_79_102,r_6_44_26,r_2_73_34,0.57,1,35,34,35
5,r_83_77_124,seq141,seq107,r_83_77_124,0.81,2,126,124,35
46,r_26_29_67,r_5_69_158,seq1,r_26_29_67,1.0,-2,65,67,35
42,r_80_21_141,seq1,r_7_135_43,r_80_21_141,0.44,0,141,141,35
45,r_108_92_169,seq102,r_30_22_184,r_30_22_184,0.75,-7,177,184,35
65,seq33,r_48_115_120,r_148_23_47,r_148_23_47,1.0,0,47,47,35
32,r_148_23_47,seq59,seq33,r_148_23_47,1.0,0,47,47,35
31,r_147_144_139,r_85_110_142,r_68_28_3,r_147_144_139,0.77,0,139,139,35
89,seq102,r_108_92_169,r_86_88_185,r_108_92_169,0.65,-19,150,169,35
26,r_34_47_108,r_68_28_3,r_70_104_93,r_68_28_3,0.94,106,109,3,35
4,r_100_56_71,r_36_61_193,r_145_9_62,r_36_61_193,0.92,-128,65,193,35
78,seq71,r_13_19_172,r_24_129_78,r_24_129_78,0.89,-11,67,78,35
0,r_93_126_174,seq43,r_127_16_74,r_127_16_74,0.9,100,174,74,35
11,r_114_87_113,seq132,seq96,r_114_87_113,0.99,0,113,113,35
20,r_48_115_120,seq33,r_86_88_185,r_48_115_120,0.58,2,122,120,35
13,r_101_49_106,r_18_62_134,seq52,r_101_49_106,0.93,0,106,106,35
15,r_89_10_122,seq96,seq106,r_89_10_122,0.85,0,122,122,35
66,seq37,r_127_16_74,r_130_99_159,r_127_16_74,1.0,-15,59,74,35
27,r_98_131_75,seq43,r_50_143_10,r_98_131_75,1.0,0,75,75,35
7,r_7_135_43,r_137_76_98,seq43,r_7_135_43,1.0,-2,41,43,35
47,r_130_99_159,r_31_97_103,r_114_87_113,r_31_97_103,0.67,56,159,103,35
40,r_146_14_186,seq96,r_30_22_184,r_146_14_186,0.37,0,186,186,35
18,r_13_19_172,seq71,seq11,r_13_19_172,0.3,3,175,172,35
29,r_137_76_98,seq8,r_68_28_3,r_137_76_98,0.93,-3,95,98,35
25,r_72_116_76,r_93_126_174,seq25,r_72_116_76,1.0,-1,75,76,35
48,r_6_44_26,r_30_22_184,seq113,r_6_44_26,0.97,-1,25,26,35
34,r_145_9_62,r_17_105_59,r_100_56_71,r_100_56_71,0.38,3,74,71,35
17,r_31_97_103,r_130_99_159,r_64_3_52,r_64_3_52,0.88,84,136,52,35
10,r_64_3_52,r_101_49_106,r_31_97_103,r_64_3_52,0.99,-1,51,52,35
30,r_136_125_41,r_127_16_74,seq55,r_136_125_41,0.51,0,41,41,35
36,r_102_55_91,seq63,seq135,r_102_55_91,0.97,0,91,91,36
44,r_134_10_59,seq139,r_73_22_1,r_134_10_59,1.0,0,59,59,36
14,r_73_22_1,r_27_119_199,r_134_10_59,r_134_10_59,1.0,1,60,59,36
42,r_61_45_24,r_79_113_190,seq103,r_61_45_24,0.99,2,26,24,36
34,r_84_82_35,r_34_108_108,seq50,r_84_82_35,0.59,10,45,35,36
37,r_3_56_112,r_122_149_128,r_124_88_94,r_122_149_128,0.99,-16,112,128,36
1,r_87_30_25,r_39_58_186,r_71_95_28,r_71_95_28,0.83,-10,18,28,36
46,r_109_106_106,r_23_36_96,r_87_30_25,r_109_106_106,0.55,-5,101,106,36
45,r_147_37_138,r_100_15_193,r_61_45_24,r_100_15_193,0.97,-52,141,193,36
19,r_132_26_73,r_120_25_107,seq31,r_132_26_73,0.91,16,89,73,36
33,r_138_9_55,seq0,r_89_59_23,r_138_9_55,0.71,0,55,55,36
67,seq41,r_12_81_172,r_86_51_84,r_86_51_84,1.0,17,101,84,36
10,r_131_4_72,seq104,seq63,r_131_4_72,1.0,0,72,72,36
4,r_124_88_94,r_60_115_103,r_131_4_72,r_60_115_103,1.0,-9,94,103,36
16,r_98_137_51,r_122_149_128,seq35,r_98_137_51,0.84,0,51,51,36
0,r_122_149_128,r_3_56_112,r_86_51_84,r_122_149_128,0.96,-16,112,128,36
29,r_28_110_58,r_105_145_176,seq123,r_28_110_58,1.0,1,59,58,36
20,r_29_107_113,r_77_18_137,seq44,r_29_107_113,0.83,0,113,113,36
13,r_60_115_103,r_124_88_94,r_141_49_93,r_124_88_94,0.97,3,97,94,36
8,r_96_20_31,r_34_108_108,seq133,r_96_20_31,0.52,3,34,31,36
98,seq123,r_120_25_107,r_28_110_58,r_28_110_58,1.0,46,104,58,36
15,r_85_33_119,r_112_80_160,r_29_107_113,r_112_80_160,1.0,-40,120,160,36
40,r_86_51_84,r_102_55_91,seq41,r_86_51_84,0.75,0,84,84,36
24,r_32_38_87,seq11,seq13,r_32_38_87,0.95,2,89,87,36
25,r_23_36_96,r_109_106_106,seq31,r_23_36_96,0.43,5,101,96,36
26,r_89_59_23,r_71_95_28,seq40,r_89_59_23,0.93,-1,22,23,36
7,r_121_65_130,seq93,r_120_25_107,r_121_65_130,0.3,12,142,130,36
23,r_34_108_108,r_144_6_122,r_102_55_91,r_102_55_91,0.77,26,117,91,36
12,r_125_2_111,r_77_18_137,seq17,r_77_18_137,0.99,5,142,137,36
36,r_127_144_155,seq141,r_35_11_127,r_35_11_127,0.86,29,156,127,37
92,seq115,r_7_149_157,r_136_135_114,r_7_149_157,0.61,6,163,157,37
40,r_53_147_16,r_7_149_157,seq125,r_53_147_16,0.8,-1,15,16,37
16,r_5_106_107,r_90_59_150,r_103_12_136,r_5_106_107,0.52,2,109,107,37
5,r_136_135_114,r_137_65_177,seq115,r_137_65_177,0.93,-85,92,177,37
42,r_83_28_17,r_51_29_29,r_13_87_66,r_13_87_66,0.8,8,74,66,37
45,r_54_25_101,seq10,r_123_8_77,r_54_25_101,0.57,1,102,101,37
19,r_117_101_126,r_127_144_155,r_94_130_194,r_127_144_155,0.63,-22,133,155,37
31,r_21_27_153,seq3,r_1_68_48,r_1_68_48,0.73,108,156,48,37
41,r_42_43_87,r_99_111_162,r_51_29_29,r_42_43_87,0.57,15,102,87,37
3,r_113_20_115,r_80_100_82,r_114_126_61,r_114_126_61,0.53,27,88,61,37
13,r_103_12_136,seq33,r_5_106_107,r_103_12_136,0.5,-10,126,136,37
15,r_131_66_70,r_73_107_178,r_77_72_198,r_131_66_70,0.6,4,74,70,37
53,seq133,r_134_93_199,r_146_140_160,r_134_93_199,0.45,-31,168,199,37
47,r_108_31_138,r_70_62_1,r_139_61_22,r_108_31_138,0.5,4,142,138,37
4,r_139_61_22,r_136_135_114,seq132,r_139_61_22,0.65,-4,18,22,37
18,r_44_104_100,seq129,r_131_66_70,r_44_104_100,0.8,-6,94,100,37
29,r_30_84_103,r_77_72_198,r_123_8_77,r_77_72_198,0.73,-90,108,198,37
33,r_96_92_112,r_94_130_194,r_4_18_37,r_94_130_194,0.46,-73,121,194,37
34,r_123_8_77,r_94_130_194,seq148,r_94_130_194,0.88,-112,82,194,37
2,r_2_85_38,r_30_84_103,seq125,r_2_85_38,0.86,1,39,38,37
9,r_13_87_66,seq133,r_83_28_17,r_13_87_66,0.83,14,80,66,37
49,r_38_109_152,r_94_130_194,r_13_87_66,r_94_130_194,0.39,-38,156,194,37
35,r_99_111_162,seq45,r_136_135_114,r_136_135_114,0.54,51,165,114,37
8,r_98_95_33,r_21_27_153,seq79,r_21_27_153,0.94,-111,42,153,37
30,r_48_136_90,seq49,r_102_80_100,r_48_136_90,1.0,1,91,90,38
14,r_141_19_85,seq140,seq85,r_141_19_85,0.92,9,94,85,38
43,r_55_129_80,seq42,r_102_80_100,r_55_129_80,0.47,14,94,80,38
16,r_112_147_152,r_134_32_132,r_102_80_100,r_112_147_152,0.75,0,152,152,38
39,r_27_113_60,r_26_31_15,r_21_118_42,r_27_113_60,1.0,1,61,60,38
1,r_50_6_110,seq85,seq2,r_50_6_110,0.99,3,113,110,38
45,r_89_84_25,r_74_121_159,r_62_59_39,r_89_84_25,0.92,137,162,25,38
95,seq109,r_38_106_77,seq108,r_38_106_77,0.82,0,77,77,38
31,r_38_106_77,seq109,r_148_37_44,r_38_106_77,0.98,0,77,77,38
41,r_81_83_66,r_134_32_132,seq61,r_81_83_66,1.0,0,66,66,38
24,r_18_33_52,r_131_137_168,r_29_52_68,r_18_33_52,1.0,3,55,52,38
34,r_62_59_39,seq90,r_89_84_25,r_62_59_39,1.0,0,39,39,38
10,r_100_105_76,seq119,r_21_118_42,r_100_105_76,0.97,0,76,76,38
26,r_94_30_145,seq7,r_102_80_100,r_94_30_145,0.93,1,146,145,38
0,r_63_43_129,r_102_80_100,r_29_52_68,r_63_43_129,0.96,2,131,129,38
20,r_51_92_70,r_126_124_189,seq42,r_51_92_70,1.0,1,71,70,38
13,r_28_72_71,r_116_0_180,r_102_80_100,r_28_72_71,0.8,4,75,71,38
27,r_74_121_159,r_89_84_25,r_26_31_15,r_74_121_159,0.79,3,162,159,38
2,r_131_137_168,seq61,r_62_59_39,r_131_137_168,0.8,1,169,168,38
47,r_128_96_166,seq46,seq109,r_128_96_166,0.83,0,166,166,38
38,r_111_70_35,r_126_124_189,r_133_13_45,r_111_70_35,0.96,1,36,35,38
50,seq1,r_120_3_177,r_54_35_5,r_120_3_177,0.87,-2,175,177,38
42,r_139_114_16,r_131_137_168,seq140,r_139_114_16,0.92,0,16,16,38
37,r_21_118_42,r_50_6_110,r_111_70_35,r_21_118_42,0.73,0,42,42,38
32,r_117_23_138,seq60,r_54_35_5,r_117_23_138,0.56,-3,135,138,38
33,r_57_24_22,r_100_105_76,seq86,r_57_24_22,1.0,2,24,22,38
48,r_133_13_45,r_75_135_122,r_21_118_42,r_133_13_45,0.79,4,49,45,38
22,r_107_88_147,seq143,r_39_73_48,r_107_88_147,0.72,3,150,147,38
5,r_91_17_19,r_131_137_168,seq110,r_91_17_19,0.99,0,19,19,38
49,r_75_135_122,seq149,r_62_59_39,r_75_135_122,0.88,0,122,122,38
23,r_39_73_48,seq140,seq119,r_39_73_48,0.78,0,48,48,38
7,r_77_64_105,r_102_80_100,r_54_35_5,r_77_64_105,1.0,0,105,105,38
35,r_16_145_95,r_74_121_159,r_10_20_171,r_16_145_95,0.8,0,95,95,38
86,seq86,r_131_137_168,r_57_24_22,r_57_24_22,0.93,4,26,22,38
95,seq109,seq108,r_128_96_166,r_128_96_166,1.0,0,166,166,38
37,r_22_116_55,seq8,r_111_107_14,r_22_116_55,0.85,1,56,55,39
25,r_0_78_40,r_35_29_148,seq117,r_0_78_40,0.55,3,43,40,39
43,r_2_70_89,r_91_144_192,r_43_100_39,r_43_100_39,0.75,55,94,39,39
55,seq8,r_22_116_55,r_32_143_118,r_32_143_118,0.69,8,126,118,39
16,r_65_68_171,seq50,r_108_101_180,r_65_68_171,0.48,2,173,171,39
21,r_14_138_84,r_10_93_165,r_102_89_101,r_102_89_101,0.72,2,103,101,39
1,r_32_143_118,seq31,r_9_103_79,r_32_143_118,0.84,6,124,118,39
42,r_48_72_133,r_10_93_165,r_53_142_38,r_10_93_165,0.62,-32,133,165,39
19,r_59_84_146,seq129,r_32_143_118,r_32_143_118,0.79,30,148,118,39
41,r_131_123_183,seq33,r_76_141_160,r_131_123_183,0.18,1,184,183,39
10,r_9_103_79,seq80,seq104,r_9_103_79,0.92,2,81,79,39
63,seq31,r_32_143_118,seq64,r_32_143_118,1.0,-10,108,118,39
20,r_76_141_160,seq82,seq31,r_76_141_160,0.45,2,162,160,39
15,r_69_28_115,seq117,r_118_16_72,r_69_28_115,0.39,3,118,115,39
74,seq50,r_65_68_171,r_66_124_70,r_66_124_70,0.84,103,173,70,39
29,r_66_124_70,seq34,seq50,r_66_124_70,0.95,12,82,70,39
24,r_102_89_101,r_74_23_170,r_14_138_84,r_14_138_84,0.74,19,103,84,39
38,r_94_119_87,r_91_144_192,r_0_78_40,r_0_78_40,0.8,47,87,40,39
47,r_43_100_39,seq64,r_2_70_89,r_43_100_39,0.98,0,39,39,39
9,r_24_83_126,r_65_68_171,r_56_88_66,r_24_83_126,0.61,1,127,126,39
32,r_111_107_14,r_108_101_180,seq134,r_111_107_14,0.67,-3,11,14,39
22,r_10_93_165,r_98_21_136,r_32_143_118,r_32_143_118,0.98,47,165,118,39
33,r_17_77_41,r_91_144_192,seq137,r_17_77_41,0.92,8,49,41,39
7,r_35_29_148,r_13_15_186,r_53_142_38,r_35_29_148,0.48,0,148,148,39
23,r_30_109_82,r_52_133_174,r_111_107_14,r_30_109_82,0.94,5,87,82,39
17,r_87_36_25,r_79_18_187,seq104,r_87_36_25,0.74,0,25,25,39
35,r_98_21_136,r_10_93_165,r_118_16_72,r_10_93_165,0.59,-14,151,165,39
12,r_74_23_170,seq137,r_108_101_180,r_108_101_180,0.81,-7,173,180,39
30,r_146_139_155,seq85,r_19_145_91,r_146_139_155,0.49,7,162,155,40
43,r_7_42_123,r_111_27_182,seq147,r_7_42_123,0.64,20,143,123,40
16,r_108_95_150,r_34_116_20,r_66_8_44,r_34_116_20,0.5,142,162,20,40
1,r_19_145_91,r_71_148_163,r_34_116_20,r_19_145_91,0.82,-2,89,91,40
48,r_41_92_34,seq128,seq134,r_41_92_34,0.82,0,34,34,40
45,r_86_143_109,r_64_144_196,r_55_70_54,r_64_144_196,0.69,-83,113,196,40
39,r_30_105_56,seq46,seq23,r_30_105_56,0.96,-2,54,56,40
31,r_22_50_62,r_103_1_1,r_2_109_79,r_22_50_62,0.66,0,62,62,40
20,r_66_8_44,r_33_73_105,seq149,r_66_8_44,0.62,-2,42,44,40
35,r_55_70_54,r_63_96_108,seq90,r_55_70_54,0.79,-12,42,54,40
4,r_65_122_80,r_111_27_182,r_136_54_199,r_65_122_80,0.61,-3,77,80,40
0,r_40_32_87,r_34_116_20,r_41_92_34,r_40_32_87,0.66,0,87,87,40
11,r_35_51_99,r_68_26_149,seq134,r_35_51_99,0.6,-8,91,99,40
14,r_91_14_36,seq17,r_89_137_13,r_91_14_36,0.85,0,36,36,40
13,r_33_73_105,seq56,seq47,r_33_73_105,0.64,6,111,105,40
27,r_15_0_153,seq138,r_19_145_91,r_15_0_153,0.53,9,162,153,40
42,r_44_97_47,seq132,r_34_116_20,r_44_97_47,0.84,-5,42,47,40
29,r_121_21_164,r_136_54_199,r_55_70_54,r_55_70_54,0.63,111,165,54,40
34,r_126_28_77,seq132,r_34_116_20,r_126_28_77,0.58,2,79,77,40
32,r_20_99_64,seq56,r_44_97_47,r_20_99_64,0.88,-28,36,64,40
17,r_110_123_119,r_34_116_20,r_35_51_99,r_110_123_119,0.67,24,143,119,40
9,r_140_25_144,seq57,r_103_1_1,r_140_25_144,0.48,8,152,144,40
33,r_125_135_32,r_19_145_91,r_38_100_38,r_38_100_38,0.62,-10,28,38,40
28,r_52_83_14,r_63_96_108,r_71_148_163,r_52_83_14,0.52,97,111,14,40
49,r_48_130_111,seq12,r_39_75_37,r_48_130_111,0.63,-10,101,111,40
23,r_18_31_93,r_136_54_199,r_38_100_38,r_136_54_199,0.67,-103,96,199,40
3,r_115_36_24,r_34_116_20,seq82,r_115_36_24,0.79,1,25,24,40
12,r_63_96_108,r_52_83_14,r_22_50_62,r_52_83_14,0.86,97,111,14,40
36,r_45_48_68,seq78,r_59_37_52,r_45_48_68,0.95,-10,58,68,41
14,r_88_8_143,seq71,r_139_22_40,r_139_22_40,0.99,103,143,40,41
8,r_87_142_109,r_27_81_85,r_59_37_52,r_87_142_109,0.4,2,111,109,41
83,seq92,r_28_125_167,r_29_111_78,r_29_111_78,1.0,17,95,78,41
37,r_89_148_111,seq15,r_147_26_61,r_89_148_111,0.36,5,116,111,41
21,r_144_123_84,seq106,seq78,r_144_123_84,0.96,0,84,84,41
1,r_115_12_148,r_102_109_136,r_129_76_4,r_115_12_148,0.53,-12,136,148,41
5,r_75_35_119,r_73_60_174,seq130,r_73_60_174,0.94,-54,120,174,41
45,r_64_17_113,r_105_146_190,r_87_142_109,r_105_146_190,0.71,-56,134,190,41
76,seq71,r_88_8_143,r_73_60_174,r_73_60_174,0.94,3,177,174,41
31,r_42_122_97,seq71,seq55,r_42_122_97,0.87,3,100,97,41
3,r_86_143_117,seq106,seq50,r_86_143_117,0.81,0,117,117,41
26,r_113_65_17,r_51_62_33,r_116_67_64,r_113_65_17,1.0,0,17,17,41
49,r_138_90_44,r_129_76_4,r_49_107_98,r_49_107_98,0.76,0,98,98,41
78,seq78,seq96,r_144_123_84,r_144_123_84,1.0,2,86,84,41
0,r_51_62_33,r_86_143_117,r_29_111_78,r_29_111_78,0.51,8,86,78,41
20,r_11_7_71,r_144_123_84,r_59_37_52,r_59_37_52,1.0,18,70,52,41
27,r_68_84_116,seq0,seq15,r_68_84_116,0.51,0,116,116,41
2,r_49_107_98,r_75_35_119,r_138_90_44,r_75_35_119,0.82,-21,98,119,41
24,r_38_6_178,seq66,r_86_143_117,r_86_143_117,1.0,61,178,117,41
33,r_135_56_95,r_116_67_64,seq97,r_135_56_95,0.62,-18,77,95,41
32,r_29_111_78,r_116_67_64,seq92,r_29_111_78,0.99,-1,77,78,41
38,r_72_5_93,seq136,r_135_56_95,r_72_5_93,1.0,0,93,93,41
52,seq130,r_25_44_135,r_75_35_119,r_25_44_135,0.6,-15,120,135,41
16,r_147_26_61,seq85,r_58_128_12,r_147_26_61,0.68,-7,54,61,41
6,r_139_22_40,r_116_67_64,seq94,r_139_22_40,1.0,0,40,40,41
49,r_138_90_44,r_49_107_98,r_129_76_4,r_138_90_44,0.72,-4,40,44,41
25,r_16_19_47,r_86_143_117,r_59_37_52,r_59_37_52,0.65,-6,46,52,41
9,r_21_23_170,r_46_91_151,r_115_12_148,r_21_23_170,0.54,0,170,170,41
22,r_101_118_115,seq71,r_87_142_109,r_101_118_115,0.75,1,116,115,41
28,r_28_125_167,seq92,r_145_99_51,r_145_99_51,0.47,119,170,51,41
7,r_102_109_136,r_115_12_148,r_2_18_10,r_2_18_10,0.96,126,136,10,41
1,r_115_12_148,r_129_76_4,r_102_109_136,r_115_12_148,0.91,0,148,148,41
12,r_41_131_81,r_25_44_135,r_29_111_78,r_25_44_135,1.0,-54,81,135,41
30,r_10_3_14,r_51_62_33,seq96,r_10_3_14,0.98,0,14,14,41
36,r_88_102_81,r_132_139_173,r_51_115_69,r_88_102_81,0.9,0,81,81,42
14,r_110_11_101,r_45_107_111,r_134_86_97,r_134_86_97,0.88,4,101,97,42
11,r_47_35_29,r_132_139_173,seq128,r_47_35_29,0.99,0,29,29,42
43,r_87_118_156,seq7,r_5_1_6,r_87_118_156,0.52,2,158,156,42
30,r_136_69_53,seq12,seq96,r_136_69_53,1.0,2,55,53,42
21,r_75_80_116,r_132_139_173,r_55_109_198,r_75_80_116,0.52,13,129,116,42
1,r_59_49_84,seq66,seq7,r_59_49_84,1.0,1,85,84,42
45,r_99_28_112,seq129,r_144_52_31,r_99_28_112,0.97,0,112,112,42
19,r_57_40_96,seq96,seq21,r_57_40_96,0.96,0,96,96,42
16,r_144_52_31,r_33_17_157,seq34,r_144_52_31,0.83,7,38,31,42
27,r_140_9_44,r_13_31_82,r_72_63_191,r_140_9_44,0.96,1,45,44,42
31,r_145_64_147,seq89,r_123_60_114,r_145_64_147,0.82,0,147,147,42
3,r_26_142_184,r_51_115_69,r_74_0_166,r_74_0_166,0.8,18,184,166,42
10,r_20_23_61,r_117_120_196,seq12,r_20_23_61,0.75,14,75,61,42
8,r_6_50_26,r_57_40_96,seq7,r_6_50_26,0.93,-3,23,26,42
4,r_79_30_95,r_123_60_114,seq48,r_79_30_95,0.83,1,96,95,42
0,r_132_139_173,seq48,r_136_69_53,r_132_139_173,0.61,3,176,173,42
20,r_33_17_157,r_72_63_191,r_79_30_95,r_79_30_95,0.55,73,168,95,42
13,r_113_43_87,r_132_139_173,r_20_23_61,r_113_43_87,0.96,1,88,87,42
15,r_104_18_86,seq27,seq41,r_104_18_86,0.83,0,86,86,42
26,r_46_116_19,r_59_49_84,seq130,r_46_116_19,0.97,0,19,19,42
47,r_76_137_117,seq108,seq89,r_76_137_117,0.99,0,117,117,42
40,r_13_31_82,seq96,seq27,r_13_31_82,0.99,3,85,82,42
32,r_54_61_27,r_3_53_187,seq129,r_54_61_27,0.97,0,27,27,42
18,r_111_62_186,r_71_38_183,r_75_80_116,r_75_80_116,0.72,70,186,116,42
24,r_147_148_142,r_132_139_173,r_13_31_82,r_147_148_142,0.45,0,142,142,42
25,r_95_91_68,seq138,seq124,r_95_91_68,0.99,2,70,68,42
33,r_143_141_62,seq130,seq108,r_143_141_62,0.9,9,71,62,42
37,r_58_67_39,r_132_139_173,seq25,r_58_67_39,0.88,15,54,39,42
23,r_127_24_33,r_140_9_44,r_74_0_166,r_127_24_33,0.96,0,33,33,42
38,r_3_53_187,seq12,r_111_62_186,r_111_62_186,0.75,3,189,186,42
7,r_36_10_47,r_117_120_196,r_123_60_114,r_36_10_47,0.99,6,53,47,42
22,r_112_65_107,r_74_0_166,r_140_9_44,r_112_65_107,0.82,0,107,107,42
28,r_131_16_64,r_26_142_184,r_71_38_183,r_131_16_64,0.95,0,64,64,42
49,r_45_107_111,r_51_115_69,r_58_67_39,r_45_107_111,1.0,0,111,111,42
12,r_42_15_161,r_123_60_114,r_47_35_29,r_123_60_114,0.8,47,161,114,42
36,r_59_37_74,r_23_117_105,r_88_61_69,r_88_61_69,1.0,5,74,69,43
14,r_89_75_102,seq20,r_134_71_101,r_89_75_102,0.96,0,102,102,43
43,r_36_100_183,seq149,r_24_131_54,r_36_100_183,0.38,1,184,183,43
16,r_97_13_94,r_64_3_186,r_0_4_32,r_64_3_186,0.7,-92,94,186,43
21,r_146_122_163,r_45_58_155,r_86_12_89,r_146_122_163,0.63,0,163,163,43
1,r_133_30_72,r_86_12_89,seq35,r_133_30_72,1.0,0,72,72,43
46,r_23_117_105,seq143,r_88_61_69,r_23_117_105,0.88,2,107,105,43
42,r_86_12_89,seq8,seq9,r_86_12_89,0.93,0,89,89,43
7,r_15_142_52,r_133_30_72,r_123_10_24,r_15_142_52,1.0,3,55,52,43
19,r_141_80_129,seq9,r_53_73_162,r_141_80_129,0.51,0,129,129,43
31,r_64_3_186,r_53_73_162,r_24_131_54,r_64_3_186,0.27,1,187,186,43
10,r_112_94_78,r_69_21_87,r_28_103_64,r_69_21_87,1.0,-9,78,87,43
38,r_123_10_24,r_134_71_101,seq149,r_123_10_24,1.0,0,24,24,43
0,r_88_61_69,seq41,r_91_67_1,r_88_61_69,0.97,2,71,69,43
20,r_84_42_66,seq83,r_88_61_69,r_84_42_66,1.0,3,69,66,43
13,r_132_105_133,r_5_56_169,r_90_139_106,r_132_105_133,0.86,0,133,133,43
6,r_134_71_101,r_45_58_155,r_28_103_64,r_134_71_101,0.91,0,101,101,43
62,seq149,r_36_100_183,r_123_10_24,r_123_10_24,0.87,99,123,24,43
22,r_98_60_26,r_99_38_97,r_2_65_65,r_98_60_26,0.81,71,97,26,43
2,r_2_65_65,r_76_26_142,r_98_60_26,r_76_26_142,0.54,-73,69,142,43
47,r_125_138_146,seq43,r_51_95_44,r_51_95_44,0.81,103,147,44,43
18,r_28_103_64,r_127_85_139,seq18,r_28_103_64,0.99,5,69,64,43
29,r_113_57_119,seq128,seq31,r_113_57_119,0.98,2,121,119,43
24,r_137_129_59,r_125_138_146,seq128,r_137_129_59,1.0,3,62,59,43
25,r_116_66_123,seq9,r_24_131_54,r_116_66_123,0.78,3,126,123,43
33,r_114_96_147,r_64_3_186,seq81,r_64_3_186,0.77,-39,147,186,43
9,r_51_95_44,r_134_71_101,seq41,r_51_95_44,0.91,0,44,44,43
50,seq128,r_113_57_119,seq126,r_113_57_119,1.0,2,121,119,43
32,r_99_38_97,r_52_16_122,r_133_30_72,r_52_16_122,1.0,-25,97,122,43
34,r_148_39_88,seq120,r_25_118_199,r_148_39_88,0.85,1,89,88,43
26,r_0_4_32,r_137_129_59,seq83,r_0_4_32,0.98,2,34,32,43
35,r_46_108_38,seq43,seq8,r_46_108_38,1.0,3,41,38,43
60,seq19,r_5_56_169,r_110_92_58,r_110_92_58,1.0,83,141,58,43
22,r_98_60_26,seq144,r_99_38_97,r_98_60_26,0.99,2,28,26,43
96,seq120,r_148_39_88,r_54_1_9,r_148_39_88,0.51,1,89,88,43
28,r_90_139_106,r_52_16_122,r_34_62_20,r_90_139_106,0.98,2,108,106,43
23,r_127_85_139,r_28_103_64,seq14,r_28_103_64,1.0,5,69,64,43
12,r_110_92_58,r_84_42_66,seq19,r_110_92_58,0.94,4,62,58,43
14,r_95_97_97,seq38,seq49,r_95_97_97,0.49,8,105,97,44
4,r_24_52_53,r_50_116_148,seq11,r_24_52_53,1.0,0,53,53,44
37,r_75_118_182,seq93,r_120_14_49,r_120_14_49,0.87,33,82,49,44
1,r_37_81_77,r_2_84_163,seq135,r_37_81_77,1.0,0,77,77,44
5,r_89_65_59,r_60_44_128,r_26_102_34,r_89_65_59,0.72,3,62,59,44
46,r_85_79_89,r_129_126_143,r_124_73_37,r_124_73_37,1.0,78,115,37,44
19,r_34_71_105,seq87,seq36,r_34_71_105,0.83,0,105,105,44
66,seq38,r_95_97_97,r_144_139_114,r_144_139_114,0.87,20,134,114,44
0,r_108_119_110,r_10_67_187,seq93,r_10_67_187,0.59,-75,112,187,44
2,r_120_14_49,r_148_101_193,r_8_18_10,r_120_14_49,0.99,7,56,49,44
15,r_91_72_118,r_21_121_146,r_34_71_105,r_91_72_118,0.85,0,118,118,44
49,r_69_117_176,r_33_54_25,seq55,r_33_54_25,0.64,155,180,25,44
47,r_140_59_19,r_24_52_53,r_145_43_50,r_24_52_53,0.81,-5,48,53,44
45,r_32_6_44,seq49,r_129_126_143,r_32_6_44,0.76,3,47,44,44
35,r_4_136_43,r_89_65_59,r_13_149_18,r_89_65_59,1.0,-3,56,59,44
39,r_26_102_34,r_24_52_53,seq25,r_26_102_34,0.83,5,39,34,44
40,r_128_23_119,r_50_116_148,r_13_149_18,r_128_23_119,0.85,3,122,119,44
18,r_60_44_128,seq11,r_99_46_9,r_60_44_128,0.75,0,128,128,44
29,r_111_48_104,r_138_70_171,r_26_102_34,r_111_48_104,0.6,4,108,104,44
25,r_141_147_70,r_107_53_158,r_83_3_32,r_141_147_70,0.56,13,83,70,44
33,r_57_127_160,r_129_126_143,seq47,r_57_127_160,0.72,0,160,160,44
20,r_8_18_10,r_75_118_182,r_108_119_110,r_8_18_10,0.57,136,146,10,44
21,r_83_3_32,r_138_70_171,seq87,r_83_3_32,0.5,5,37,32,44
32,r_61_20_129,r_145_43_50,r_89_65_59,r_89_65_59,1.0,91,150,59,44
28,r_39_35_54,seq123,r_124_73_37,r_124_73_37,0.98,17,54,37,44
38,r_100_45_170,r_50_116_148,r_89_65_59,r_89_65_59,0.99,114,173,59,44
34,r_21_121_146,seq40,r_83_3_32,r_21_121_146,0.83,4,150,146,44
22,r_13_149_18,r_108_119_110,seq40,r_13_149_18,0.49,0,18,18,44
9,r_142_7_26,r_2_84_163,seq114,r_142_7_26,0.96,4,30,26,44
17,r_16_90_108,seq96,r_33_54_25,r_33_54_25,0.75,83,108,25,44
37,r_75_118_182,r_120_14_49,r_137_12_169,r_75_118_182,0.49,1,183,182,44
49,r_69_117_176,r_1_80_135,r_33_54_25,r_1_80_135,0.5,-26,109,135,44
7,r_138_70_171,r_132_82_194,r_124_73_37,r_124_73_37,1.0,136,173,37,44
23,r_1_80_135,r_69_117_176,r_107_53_158,r_1_80_135,0.75,15,150,135,44
12,r_10_67_187,seq62,r_89_65_59,r_89_65_59,1.0,128,187,59,44
8,r_124_73_37,r_75_118_182,seq63,r_124_73_37,0.97,5,42,37,44
30,r_127_112_37,r_80_120_100,seq10,r_127_112_37,0.8,1,38,37,45
22,r_64_30_33,seq4,seq74,r_64_30_33,0.56,19,52,33,45
21,r_27_7_51,seq4,seq98,r_27_7_51,0.71,11,62,51,45
4,r_122_84_39,r_141_143_43,seq52,r_122_84_39,0.59,9,48,39,45
5,r_119_83_130,seq136,r_141_143_43,r_119_83_130,0.68,0,130,130,45
49,r_141_143_43,r_122_84_39,seq37,r_122_84_39,0.95,9,48,39,45
41,r_88_103_58,r_35_45_127,r_32_113_2,r_88_103_58,0.62,4,62,58,45
13,r_13_107_94,r_58_130_148,r_36_46_4,r_58_130_148,0.53,-32,116,148,45
48,r_125_11_78,r_17_38_14,seq146,r_125_11_78,0.82,0,78,78,45
49,r_141_143_43,seq37,r_119_83_130,r_119_83_130,0.81,4,134,130,45
6,r_91_18_120,r_149_29_170,r_8_14_48,r_91_18_120,0.74,2,122,120,45
37,r_48_76_42,r_68_56_159,seq96,r_48_76_42,0.68,-2,40,42,45
27,r_49_73_9,r_86_134_152,r_117_123_156,r_86_134_152,0.53,5,157,152,45
2,r_68_56_159,seq16,r_122_84_39,r_122_84_39,0.51,121,160,39,45
47,r_86_134_152,r_49_73_9,r_15_89_133,r_15_89_133,0.58,24,157,133,45
40,r_80_120_100,seq61,seq96,r_80_120_100,0.55,0,100,100,45
18,r_67_54_129,r_119_83_130,r_33_24_113,r_67_54_129,0.54,0,129,129,45
25,r_35_45_127,r_60_69_61,r_33_24_113,r_35_45_127,0.69,0,127,127,45
32,r_132_0_172,seq136,r_68_56_159,r_68_56_159,0.74,15,174,159,45
38,r_53_105_101,seq26,r_33_24_113,r_53_105_101,0.71,0,101,101,45
9,r_8_14_48,r_68_56_159,r_77_110_196,r_8_14_48,0.56,3,51,48,45
28,r_57_79_115,r_15_89_133,seq114,r_57_79_115,0.33,8,123,115,45
7,r_39_70_153,r_139_20_23,r_33_24_113,r_139_20_23,0.38,137,160,23,45
44,r_97_25_139,r_149_29_170,r_122_84_39,r_97_25_139,0.51,2,141,139,45
23,r_66_34_77,r_117_123_156,r_8_14_48,r_66_34_77,0.53,1,78,77,45
35,r_140_92_57,r_68_56_159,r_122_84_39,r_140_92_57,0.62,3,60,57,45
12,r_147_31_131,r_126_106_53,seq114,r_126_106_53,0.65,79,132,53,45
43,r_73_88_120,r_148_48_132,r_39_47_100,r_39_47_100,0.61,22,122,100,46
37,r_66_57_35,r_74_132_88,r_107_44_180,r_107_44_180,0.89,-145,35,180,46
22,r_54_0_57,r_142_106_196,seq65,r_54_0_57,1.0,0,57,57,46
16,r_40_145_58,r_67_141_186,r_43_62_48,r_43_62_48,0.94,18,66,48,46
39,r_74_132_88,seq86,r_131_129_1,r_74_132_88,1.0,10,98,88,46
1,r_87_81_184,r_140_72_54,r_14_126_71,r_14_126_71,0.99,114,185,71,46
45,r_78_30_157,seq115,r_107_44_180,r_107_44_180,0.79,-13,167,180,46
36,r_147_96_38,r_1_35_83,r_82_61_23,r_1_35_83,0.89,-45,38,83,46
19,r_37_13_69,r_74_132_88,r_28_10_61,r_74_132_88,0.79,-18,70,88,46
31,r_85_21_190,seq77,r_107_44_180,r_107_44_180,0.62,7,187,180,46
41,r_14_126_71,r_1_35_83,seq18,r_14_126_71,1.0,0,71,71,46
8,r_43_62_48,r_85_21_190,r_40_145_58,r_43_62_48,0.99,2,50,48,46
10,r_28_10_61,r_12_100_66,seq115,r_28_10_61,1.0,5,66,61,46
4,r_11_31_152,seq59,r_54_0_57,r_54_0_57,0.82,101,158,57,46
13,r_7_146_121,r_1_35_83,seq25,r_7_146_121,0.88,1,122,121,46
98,seq122,r_104_46_176,r_12_100_66,r_12_100_66,0.99,115,181,66,46
48,r_9_97_135,seq16,r_125_135_175,r_9_97_135,0.48,0,135,135,46
6,r_123_113_124,seq93,r_52_130_113,r_123_113_124,0.46,6,130,124,46
27,r_116_22_103,seq51,r_39_47_100,r_116_22_103,0.4,34,137,103,46
40,r_114_103_173,seq149,r_107_44_180,r_107_44_180,0.66,-2,178,180,46
18,r_41_94_107,seq133,seq64,r_41_94_107,0.52,30,137,107,46
29,r_148_48_132,seq136,seq93,r_148_48_132,0.93,0,132,132,46
25,r_80_23_96,seq26,r_28_10_61,r_28_10_61,1.0,40,101,61,46
33,r_112_68_108,r_138_20_163,r_107_44_180,r_112_68_108,0.95,0,108,108,46
58,seq18,r_138_20_163,r_14_126_71,r_14_126_71,1.0,12,83,71,46
32,r_98_24_134,seq32,seq51,r_98_24_134,0.64,3,137,134,46
38,r_12_100_66,r_28_10_61,seq122,r_12_100_66,0.87,0,66,66,46
17,r_139_38_94,r_131_129_1,r_39_47_100,r_139_38_94,0.57,7,101,94,46
9,r_67_141_186,r_40_145_58,r_124_4_81,r_124_4_81,0.87,32,113,81,46
49,r_104_46_176,seq122,r_87_81_184,r_87_81_184,0.66,-3,181,184,46
20,r_82_61_23,r_107_44_180,seq149,r_82_61_23,0.93,0,23,23,46
7,r_52_130_113,r_107_44_180,r_70_117_42,r_52_130_113,0.48,17,130,113,46
44,r_124_4_81,r_1_35_83,r_67_141_186,r_124_4_81,0.58,9,90,81,46
23,r_138_20_163,seq18,r_54_0_57,r_54_0_57,1.0,106,163,57,46
35,r_83_27_101,r_41_94_107,seq33,r_83_27_101,0.86,0,101,101,46
36,r_87_146_59,seq82,seq134,r_87_146_59,0.89,4,63,59,47
8,r_49_105_79,r_21_50_90,r_148_37_6,r_49_105_79,1.0,0,79,79,47
53,seq134,r_77_79_168,r_87_146_59,r_87_146_59,0.5,12,71,59,47
41,r_81_23_65,r_104_58_112,r_4_13_42,r_4_13_42,1.0,7,49,42,47
70,seq137,r_19_133_80,r_15_139_20,r_15_139_20,0.96,1,21,20,47
16,r_127_17_159,r_81_23_65,r_15_139_20,r_81_23_65,0.43,97,162,65,47
1,r_25_53_60,r_131_142_2,seq90,r_25_53_60,0.98,11,71,60,47
46,r_32_62_122,seq137,r_81_23_65,r_32_62_122,0.97,4,126,122,47
42,r_106_84_106,seq38,r_39_8_46,r_39_8_46,0.98,68,114,46,47
45,r_44_107_176,r_143_12_54,r_27_52_184,r_143_12_54,0.99,122,176,54,47
0,r_48_96_49,r_87_146_59,r_131_142_2,r_48_96_49,0.93,1,50,49,47
31,r_41_14_172,seq122,r_141_91_22,r_41_14_172,0.35,0,172,172,47
10,r_21_50_90,r_123_69_100,seq149,r_21_50_90,0.77,1,91,90,47
26,r_16_136_147,r_94_35_185,r_76_99_26,r_94_35_185,0.83,-38,147,185,47
48,r_42_28_75,r_145_89_82,r_141_91_22,r_42_28_75,0.98,0,75,75,47
43,r_4_13_42,r_119_24_187,r_81_23_65,r_4_13_42,0.99,5,47,42,47
99,seq126,r_125_43_132,r_46_3_48,r_125_43_132,0.75,-61,71,132,47
47,r_141_91_22,seq1,r_42_28_75,r_42_28_75,0.65,11,86,75,47
18,r_40_71_181,seq61,r_18_98_15,r_40_71_181,0.4,1,182,181,47
24,r_129_2_87,seq78,seq5,r_129_2_87,0.92,3,90,87,47
3,r_51_70_58,r_103_113_189,r_66_147_13,r_51_70_58,0.93,1,59,58,47
37,r_143_12_54,r_16_136_147,r_44_107_176,r_143_12_54,1.0,0,54,54,47
32,r_72_74_88,r_30_101_74,seq61,r_72_74_88,0.97,6,94,88,47
25,r_76_99_26,r_129_2_87,r_104_58_112,r_76_99_26,0.89,-3,23,26,47
21,r_15_139_20,r_130_120_156,seq137,r_15_139_20,0.71,1,21,20,47
37,r_143_12_54,r_44_107_176,r_77_79_168,r_44_107_176,0.7,0,176,176,47
22,r_130_120_156,r_80_92_161,r_18_98_15,r_130_120_156,0.63,2,158,156,47
7,r_19_133_80,r_32_62_122,seq128,r_19_133_80,0.95,11,91,80,47
44,r_45_55_119,r_141_91_22,seq9,r_45_55_119,0.91,0,119,119,47
35,r_125_43_132,seq126,seq38,r_125_43_132,0.69,3,135,132,47
36,r_100_1_151,r_130_70_153,r_20_141_141,r_20_141_141,0.73,14,155,141,48
14,r_110_10_119,seq146,r_18_147_91,r_110_10_119,0.75,0,119,119,48
8,r_129_79_71,r_86_99_24,r_139_43_44,r_86_99_24,0.51,50,74,24,48
83,seq74,r_123_40_170,r_0_88_78,r_0_88_78,0.63,83,161,78,48
16,r_124_47_83,r_20_141_141,seq5,r_124_47_83,0.82,12,95,83,48
21,r_94_75_93,r_100_1_151,r_139_43_44,r_94_75_93,0.57,1,94,93,48
39,r_32_133_77,r_57_6_199,r_77_23_178,r_77_23_178,0.66,-101,77,178,48
5,r_82_136_62,r_64_143_129,seq3,r_82_136_62,0.98,1,63,62,48
46,r_39_24_118,r_57_6_199,r_139_43_44,r_139_43_44,0.54,79,123,44,48
42,r_83_105_188,seq16,r_139_43_44,r_139_43_44,0.92,145,189,44,48
19,r_33_109_172,r_85_61_191,r_64_143_129,r_33_109_172,0.44,0,172,172,48
18,r_104_92_14,r_77_23_178,seq142,r_104_92_14,0.61,-2,12,14,48
41,r_130_70_153,r_100_1_151,r_102_81_65,r_130_70_153,0.44,2,155,153,48
26,r_63_78_92,r_57_6_199,r_18_147_91,r_63_78_92,0.52,2,94,92,48
4,r_103_116_177,r_83_105_188,r_64_143_129,r_83_105_188,0.65,-11,177,188,48
11,r_20_141_141,r_89_135_149,r_64_143_129,r_20_141_141,0.78,1,142,141,48
13,r_59_56_166,r_26_107_194,r_19_14_162,r_19_14_162,0.98,4,166,162,48
48,r_123_40_170,seq74,r_139_43_44,r_123_40_170,0.42,1,171,170,48
6,r_0_88_78,r_103_116_177,seq74,r_0_88_78,0.75,0,78,78,48
62,seq146,r_110_10_119,seq16,r_110_10_119,0.99,0,119,119,48
45,r_87_50_39,r_18_147_91,seq34,r_87_50_39,0.85,9,48,39,48
27,r_44_38_164,r_8_91_158,r_64_143_129,r_44_38_164,0.58,0,164,164,48
47,r_114_53_107,r_144_134_102,seq98,r_114_53_107,0.83,3,110,107,48
40,r_89_135_149,seq112,r_0_88_78,r_89_135_149,0.75,0,149,149,48
29,r_18_147_91,r_144_134_102,seq42,r_18_147_91,0.91,1,92,91,48
24,r_62_106_156,seq12,r_121_54_57,r_121_54_57,0.82,100,157,57,48
25,r_132_128_85,r_110_10_119,seq15,r_110_10_119,0.95,-34,85,119,48
38,r_68_120_34,r_64_143_129,seq101,r_68_120_34,0.99,2,36,34,48
9,r_121_54_57,r_64_143_129,r_137_58_37,r_121_54_57,0.78,0,57,57,48
37,r_27_9_22,r_59_56_166,seq15,r_27_9_22,0.81,-2,20,22,48
30,r_28_45_31,r_77_23_178,r_104_92_14,r_28_45_31,0.9,1,32,31,48
49,r_84_52_143,seq145,r_102_81_65,r_84_52_143,0.42,8,151,143,48
7,r_111_96_132,r_51_140_134,r_77_23_178,r_77_23_178,0.64,-44,134,178,48
44,r_144_134_102,r_114_53_107,seq36,r_144_134_102,0.73,8,110,102,48
36,r_123_23_84,seq146,r_68_110_96,r_68_110_96,0.96,8,104,96,49
48,r_41_16_30,r_114_118_147,seq73,r_41_16_30,0.72,1,31,30,49
14,r_55_20_82,seq45,seq139,r_55_20_82,0.9,1,83,82,49
43,r_128_83_172,r_141_140_100,r_55_20_82,r_141_140_100,0.74,72,172,100,49
21,r_52_87_125,r_57_104_154,r_6_97_79,r_52_87_125,0.74,3,128,125,49
5,r_27_106_83,r_55_20_82,r_10_51_28,r_27_106_83,0.85,1,84,83,49
42,r_91_43_85,r_117_119_195,seq80,r_91_43_85,0.95,0,85,85,49
45,r_122_15_93,r_141_140_100,r_109_50_59,r_141_140_100,0.89,-2,98,100,49
19,r_82_13_187,r_124_38_24,r_89_95_124,r_89_95_124,0.75,63,187,124,49
6,r_103_8_53,r_114_118_147,seq4,r_103_8_53,0.97,0,53,53,49
31,r_88_111_62,r_114_118_147,seq146,r_88_111_62,0.97,1,63,62,49
10,r_22_29_128,r_60_81_132,r_64_142_67,r_22_29_128,0.57,0,128,128,49
72,seq40,r_114_118_147,r_63_37_78,r_63_37_78,0.97,3,81,78,49
4,r_114_118_147,r_124_38_24,r_65_12_158,r_114_118_147,0.36,12,159,147,49
0,r_89_95_124,r_136_76_127,seq144,r_89_95_124,0.46,4,128,124,49
11,r_68_110_96,r_101_1_182,r_123_23_84,r_68_110_96,0.95,2,98,96,49
1,r_132_47_10,r_18_130_40,r_62_147_141,r_132_47_10,0.89,0,10,10,49
2,r_65_12_158,seq5,r_114_118_147,r_65_12_158,0.35,1,159,158,49
47,r_60_81_132,r_22_29_128,seq112,r_60_81_132,0.66,8,140,132,49
74,seq45,r_82_13_187,r_66_46_144,r_66_46_144,0.53,15,159,144,49
18,r_124_38_24,r_82_13_187,r_65_12_158,r_124_38_24,0.23,163,187,24,49
29,r_98_125_98,r_86_58_183,r_27_106_83,r_98_125_98,0.5,0,98,98,49
25,r_39_149_69,r_66_46_144,seq69,r_39_149_69,0.95,0,69,69,49
33,r_136_76_127,r_89_95_124,seq138,r_136_76_127,0.61,1,128,127,49
64,seq28,seq25,r_68_110_96,r_68_110_96,0.95,28,124,96,49
39,r_109_50_59,r_114_118_147,seq26,r_109_50_59,0.99,0,59,59,49
32,r_56_107_26,r_114_118_147,r_10_51_28,r_114_118_147,0.84,-119,28,147,49
60,seq146,r_123_23_84,r_88_111_62,r_88_111_62,1.0,10,72,62,49
94,seq112,seq144,r_60_81_132,r_60_81_132,0.82,1,133,132,49
3,r_18_130_40,r_52_87_125,seq25,r_18_130_40,0.94,6,46,40,49
22,r_121_90_176,r_82_13_187,r_88_111_62,r_88_111_62,1.0,119,181,62,49
28,r_6_97_79,r_117_119_195,seq127,r_6_97_79,0.56,-7,72,79,49
49,r_92_0_115,r_86_58_183,r_14_42_75,r_92_0_115,0.74,1,116,115,49
7,r_105_11_88,r_82_13_187,seq129,r_105_11_88,0.95,2,90,88,49
44,r_63_37_78,seq5,seq40,r_63_37_78,0.94,2,80,78,49
13,r_10_51_28,r_79_71_80,r_56_107_26,r_79_71_80,0.85,-52,28,80,49
35,r_86_58_183,seq26,r_105_11_88,r_105_11_88,0.72,94,182,88,49
46,r_74_78_42,r_117_119_195,r_57_104_154,r_74_78_42,0.98,4,46,42,49
91,seq113,r_37_101_184,r_118_62_40,r_118_62_40,0.72,19,59,40,50
14,r_141_76_164,seq128,r_145_108_79,r_145_108_79,0.86,91,170,79,50
8,r_88_4_123,r_46_135_177,r_112_0_20,r_88_4_123,0.61,2,125,123,50
43,r_17_63_65,seq28,seq126,r_17_63_65,0.56,2,67,65,50
39,r_19_83_111,seq119,seq25,r_19_83_111,0.74,0,111,111,50
1,r_9_54_67,r_136_7_125,r_70_38_137,r_9_54_67,0.73,20,87,67,50
4,r_59_21_38,r_124_139_68,r_148_107_66,r_59_21_38,0.46,2,40,38,50
15,r_30_42_10,r_9_54_67,seq3,r_30_42_10,0.89,0,10,10,50
41,r_37_101_184,seq132,r_145_108_79,r_145_108_79,0.65,105,184,79,50
3,r_145_108_79,r_88_4_123,seq79,r_145_108_79,0.91,2,81,79,50
10,r_89_82_73,r_148_107_66,r_124_139_68,r_89_82_73,0.71,29,102,73,50
26,r_49_97_149,seq36,r_88_4_123,r_88_4_123,0.7,38,161,123,50
0,r_61_27_97,seq34,seq16,r_61_27_97,0.66,0,97,97,50
29,r_100_39_53,r_141_76_164,seq56,r_100_39_53,0.89,4,57,53,50
4,r_59_21_38,r_148_107_66,r_102_143_176,r_148_107_66,0.68,63,129,66,50
6,r_136_7_125,r_93_142_190,r_74_131_77,r_74_131_77,0.6,48,125,77,50
33,r_69_20_36,seq56,seq87,r_69_20_36,0.78,1,37,36,50
49,r_96_147_57,r_9_54_67,r_124_139_68,r_96_147_57,0.86,0,57,57,50
24,r_23_2_35,r_124_139_68,seq103,r_23_2_35,0.83,11,46,35,50
2,r_13_77_104,seq41,r_61_27_97,r_13_77_104,0.65,7,111,104,50
32,r_65_5_27,r_61_27_97,r_33_55_25,r_65_5_27,0.9,0,27,27,50
25,r_120_6_88,r_124_139_68,seq29,r_120_6_88,0.53,1,89,88,50
38,r_44_138_107,seq3,seq34,r_44_138_107,0.89,1,108,107,50
34,r_148_107_66,r_89_82_73,r_22_146_14,r_148_107_66,0.85,-2,64,66,50
46,r_127_134_23,r_48_78_195,seq25,r_127_134_23,0.64,0,23,23,50
28,r_11_51_48,r_13_77_104,r_23_2_35,r_11_51_48,0.58,1,49,48,50
7,r_32_8_162,r_15_149_194,r_61_27_97,r_61_27_97,0.74,69,166,97,50
44,r_133_50_114,seq121,r_109_137_9,r_133_50_114,0.41,1,115,114,50
35,r_104_1_153,seq68,r_9_54_67,r_104_1_153,0.26,31,184,153,50
30,r_70_37_172,r_41_46_179,r_137_12_155,r_41_46_179,0.32,6,185,179,51
36,r_60_33_84,r_59_133_190,r_91_15_20,r_60_33_84,1.0,-1,83,84,51
8,r_124_113_140,seq65,r_101_43_62,r_124_113_140,0.63,0,140,140,51
43,r_44_134_153,seq90,r_141_103_69,r_44_134_153,0.64,1,154,153,51
37,r_0_77_45,seq76,seq35,r_0_77_45,0.57,70,115,45,51
16,r_96_111_114,r_0_77_45,r_34_94_21,r_96_111_114,0.69,1,115,114,51
21,r_85_68_85,seq57,seq65,r_85_68_85,0.75,0,85,85,51
39,r_10_114_106,seq63,r_148_52_44,r_148_52_44,0.66,55,99,44,51
1,r_137_12_155,r_17_2_159,r_91_15_20,r_137_12_155,0.58,1,156,155,51
5,r_141_103_69,seq18,seq67,r_141_103_69,0.98,-2,67,69,51
32,r_138_5_52,r_139_88_4,r_9_140_51,r_138_5_52,0.99,-2,50,52,51
42,r_86_45_147,r_139_88_4,r_23_13_168,r_86_45_147,0.78,0,147,147,51
13,r_26_42_56,r_102_21_156,seq24,r_26_42_56,0.88,0,56,56,51
19,r_48_142_93,seq62,r_17_2_159,r_48_142_93,0.63,0,93,93,51
41,r_91_15_20,r_81_87_32,seq90,r_91_15_20,0.77,2,22,20,51
2,r_34_94_21,r_141_103_69,seq58,r_34_94_21,0.72,0,21,21,51
44,r_9_140_51,r_128_66_177,seq63,r_9_140_51,0.77,-3,48,51,51
40,r_73_92_39,r_141_103_69,r_139_88_4,r_73_92_39,0.83,-5,34,39,51
26,r_101_43_62,r_16_75_195,r_124_113_140,r_124_113_140,0.77,1,141,140,51
15,r_128_66_177,r_16_75_195,r_34_94_21,r_34_94_21,0.76,157,178,21,51
48,r_110_27_61,r_124_113_140,r_139_88_4,r_110_27_61,0.93,0,61,61,51
38,r_130_54_41,r_139_88_4,seq147,r_130_54_41,0.66,1,42,41,51
47,r_132_149_67,r_96_111_114,seq135,r_132_149_67,0.99,0,67,67,51
18,r_105_83_117,seq35,r_141_103_69,r_141_103_69,0.96,58,127,69,51
29,r_49_31_124,r_124_113_140,r_141_103_69,r_124_113_140,0.97,-22,118,140,51
24,r_102_21_156,r_128_66_177,r_34_94_21,r_34_94_21,0.92,135,156,21,51
33,r_41_46_179,r_70_37_172,r_144_74_7,r_70_37_172,0.36,13,185,172,51
34,r_98_19_108,r_139_88_4,r_36_107_47,r_139_88_4,0.99,105,109,4,51
17,r_64_109_141,seq117,r_0_77_45,r_64_109_141,0.5,10,151,141,51
0,r_81_87_32,r_128_66_177,r_89_119_22,r_81_87_32,0.86,0,32,32,51
28,r_97_11_170,seq100,r_148_52_44,r_97_11_170,0.53,0,170,170,51
49,r_146_51_96,r_128_66_177,r_144_74_7,r_146_51_96,0.71,-5,91,96,51
22,r_89_119_22,r_141_103_69,r_17_2_159,r_89_119_22,0.69,1,23,22,51
35,r_20_14_71,r_10_114_106,r_36_107_47,r_36_107_47,0.99,25,72,47,51
40,r_45_46_128,r_127_72_8,r_66_120_89,r_45_46_128,0.58,0,128,128,52
36,r_83_44_101,r_73_25_183,seq53,r_83_44_101,0.96,-2,99,101,52
39,r_2_126_109,r_22_60_79,r_111_87_69,r_2_126_109,0.98,1,110,109,52
8,r_36_121_131,r_41_138_141,r_133_0_114,r_36_121_131,0.58,0,131,131,52
42,r_56_29_63,seq94,seq105,r_56_29_63,0.96,-6,57,63,52
39,r_2_126_109,r_35_23_90,r_22_60_79,r_2_126_109,0.79,-19,90,109,52
48,r_33_71_53,r_22_60_79,seq47,r_22_60_79,1.0,-38,41,79,52
19,r_11_6_138,r_34_149_87,r_22_60_79,r_11_6_138,1.0,-59,79,138,52
41,r_17_139_61,r_33_71_53,seq43,r_17_139_61,1.0,0,61,61,52
30,r_122_145_33,seq61,seq26,r_122_145_33,1.0,0,33,33,52
0,r_127_72_8,r_45_46_128,r_91_31_142,r_91_31_142,0.45,-14,128,142,52
13,r_91_31_142,r_96_132_177,r_127_72_8,r_91_31_142,0.82,20,162,142,52
7,r_22_60_79,r_11_6_138,r_42_7_108,r_11_6_138,0.56,0,138,138,52
6,r_34_149_87,seq26,r_63_20_27,r_34_149_87,1.0,0,87,87,52
2,r_38_58_17,r_35_23_90,seq143,r_38_58_17,1.0,0,17,17,52
14,r_63_20_27,r_122_145_33,seq89,r_122_145_33,1.0,-6,27,33,52
18,r_133_0_114,r_96_132_177,seq130,r_133_0_114,0.77,2,116,114,52
24,r_88_18_144,seq81,r_34_149_87,r_34_149_87,0.99,57,144,87,52
33,r_79_48_92,seq84,r_34_149_87,r_34_149_87,1.0,9,96,87,52
81,seq85,r_3_92_184,seq142,r_3_92_184,0.78,0,184,184,52
17,r_114_86_132,r_107_32_161,r_51_74_11,r_114_86_132,0.41,11,143,132,52
9,r_129_118_173,r_24_67_187,r_35_23_90,r_35_23_90,1.0,83,173,90,52
40,r_45_46_128,r_22_60_79,r_127_72_8,r_22_60_79,0.99,-20,59,79,52
49,r_19_101_136,r_73_25_183,seq97,r_19_101_136,0.61,0,136,136,52
7,r_22_60_79,r_45_46_128,r_11_6_138,r_22_60_79,1.0,0,79,79,52
44,r_109_62_74,r_24_67_187,r_39_69_23,r_39_69_23,0.53,50,73,23,52
23,r_119_136_67,r_35_23_90,r_33_71_53,r_33_71_53,0.97,12,65,53,52
19,r_11_6_138,r_22_60_79,r_133_0_114,r_11_6_138,1.0,0,138,138,52
12,r_111_87_69,r_42_7_108,seq4,r_42_7_108,1.0,-41,67,108,52
30,r_57_100_146,r_39_77_106,r_136_20_23,r_57_100_146,0.59,4,150,146,53
36,r_27_132_117,seq76,seq147,r_27_132_117,0.51,9,126,117,53
29,r_54_148_51,r_78_138_118,r_15_94_28,r_54_148_51,0.86,-6,45,51,53
8,r_43_140_88,r_126_124_59,r_130_73_86,r_43_140_88,0.76,4,92,88,53
3,r_136_20_23,r_36_55_183,seq146,r_136_20_23,0.76,-1,22,23,53
16,r_80_58_167,seq60,r_50_127_80,r_50_127_80,0.81,18,98,80,53
39,r_50_127_80,seq71,r_80_58_167,r_50_127_80,0.81,-3,77,80,53
42,r_32_33_114,r_75_25_160,seq38,r_32_33_114,0.59,4,118,114,53
13,r_106_22_42,r_87_141_61,seq81,r_106_22_42,0.99,-1,41,42,53
45,r_56_48_128,r_75_25_160,r_39_77_106,r_56_48_128,0.77,3,131,128,53
39,r_50_127_80,r_80_58_167,r_32_33_114,r_50_127_80,0.54,90,170,80,53
31,r_74_103_129,r_59_96_179,r_43_140_88,r_59_96_179,0.57,-46,133,179,53
26,r_87_141_61,r_61_105_78,r_39_77_106,r_87_141_61,0.93,0,61,61,53
16,r_80_58_167,r_50_127_80,r_75_25_160,r_80_58_167,0.61,3,170,167,53
11,r_46_14_85,r_41_128_161,r_4_45_193,r_46_14_85,0.86,1,86,85,53
46,r_123_52_52,r_109_12_108,seq62,r_123_52_52,0.79,0,52,52,53
15,r_130_73_86,r_78_138_118,r_18_17_31,r_18_17_31,0.86,44,75,31,53
6,r_41_128_161,seq11,r_78_138_118,r_41_128_161,0.53,1,162,161,53
22,r_42_70_184,r_15_94_28,r_19_110_36,r_42_70_184,0.81,-162,22,184,53
83,seq81,r_26_101_136,r_106_22_42,r_106_22_42,0.89,-2,40,42,53
27,r_26_101_136,seq81,r_104_83_64,r_26_101_136,0.67,1,137,136,53
49,r_15_94_28,seq147,seq139,r_15_94_28,0.95,-3,25,28,53
2,r_104_83_64,r_119_143_84,seq1,r_104_83_64,0.97,1,65,64,53
47,r_89_118_133,r_4_45_193,seq62,r_89_118_133,0.67,0,133,133,53
35,r_145_116_47,r_74_103_129,r_89_118_133,r_145_116_47,0.83,86,133,47,53
25,r_69_113_100,r_135_90_83,seq108,r_135_90_83,0.67,-4,79,83,53
33,r_61_105_78,r_75_25_160,seq6,r_61_105_78,0.86,-5,73,78,53
12,r_31_121_44,seq60,r_5_129_4,r_31_121_44,0.63,-5,39,44,53
18,r_19_110_36,seq88,seq29,r_19_110_36,0.9,1,37,36,53
68,seq38,r_47_49_174,r_32_33_114,r_32_33_114,0.99,-15,99,114,53
34,r_34_23_182,r_28_120_127,r_19_110_36,r_34_23_182,0.86,-107,75,182,53
17,r_115_134_102,seq139,r_126_124_59,r_115_134_102,0.81,-1,101,102,53
9,r_64_131_158,r_5_129_4,r_136_20_23,r_5_129_4,0.39,158,162,4,53
28,r_28_120_127,r_34_23_182,r_82_65_109,r_28_120_127,0.68,4,131,127,53
20,r_18_17_31,r_107_79_199,seq122,r_18_17_31,0.73,0,31,31,53
56,seq11,r_41_128_161,seq35,r_41_128_161,0.64,-70,91,161,53
7,r_135_90_83,r_69_113_100,seq147,r_135_90_83,0.97,-2,81,83,53
44,r_4_45_193,r_89_118_133,r_46_14_85,r_4_45_193,0.56,-60,133,193,53
35,r_145_116_47,r_28_120_127,r_74_103_129,r_145_116_47,0.97,-4,43,47,53
32,r_36_121_32,r_118_11_122,r_109_19_78,r_36_121_32,0.72,51,83,32,54
14,r_102_88_68,r_118_11_122,r_71_41_4,r_102_88_68,0.99,0,68,68,54
43,r_85_104_152,seq76,r_48_68_75,r_85_104_152,0.75,2,154,152,54
21,r_53_139_145,r_135_72_21,r_107_17_46,r_135_72_21,0.76,124,145,21,54
97,seq119,r_96_126_171,r_117_27_60,r_117_27_60,0.92,123,183,60,54
5,r_129_149_77,seq2,r_24_1_88,r_24_1_88,1.0,5,93,88,54
46,r_64_147_136,seq145,r_140_29_10,r_64_147_136,0.96,0,136,136,54
42,r_51_78_130,r_96_126_171,r_107_17_46,r_96_126_171,0.53,-41,130,171,54
37,r_18_116_30,r_45_81_124,r_131_38_178,r_45_81_124,0.49,-94,30,124,54
48,r_98_3_38,r_15_142_121,seq30,r_98_3_38,0.63,0,38,38,54
45,r_7_82_117,r_0_58_158,seq66,r_0_58_158,0.73,-41,117,158,54
32,r_36_121_32,r_94_73_34,r_118_11_122,r_36_121_32,0.85,1,33,32,54
19,r_45_81_124,seq133,seq137,r_45_81_124,0.97,0,124,124,54
27,r_50_75_45,r_107_17_46,r_71_41_4,r_71_41_4,1.0,41,45,4,54
31,r_118_11_122,r_141_69_150,seq6,r_118_11_122,0.75,3,125,122,54
3,r_0_58_158,seq132,r_49_122_104,r_49_122_104,1.0,54,158,104,54
10,r_117_27_60,seq148,seq119,r_117_27_60,0.86,8,68,60,54
26,r_109_19_78,r_43_108_193,r_36_121_32,r_43_108_193,0.98,-115,78,193,54
13,r_101_32_163,seq52,r_0_58_158,r_101_32_163,0.63,0,163,163,54
15,r_15_142_121,seq137,r_48_68_75,r_15_142_121,0.96,2,123,121,54
6,r_48_68_75,seq57,r_98_3_38,r_98_3_38,1.0,66,104,38,54
16,r_107_17_46,r_141_69_150,seq22,r_107_17_46,1.0,0,46,46,54
4,r_21_100_55,r_96_126_171,r_135_72_21,r_96_126_171,0.62,-116,55,171,54
2,r_125_23_93,seq4,seq57,r_125_23_93,1.0,0,93,93,54
47,r_10_14_116,seq133,r_140_29_10,r_10_14_116,0.96,2,118,116,54
33,r_130_8_24,seq145,seq4,r_130_8_24,0.97,0,24,24,54
17,r_49_122_104,r_43_108_193,seq114,r_49_122_104,1.0,1,105,104,54
44,r_24_1_88,seq144,r_129_149_77,r_24_1_88,0.99,1,89,88,54
23,r_115_55_64,seq133,seq128,r_115_55_64,0.48,59,123,64,54
49,r_146_5_20,r_48_68_75,seq99,r_146_5_20,1.0,0,20,20,54
35,r_92_39_85,seq26,r_71_41_4,r_92_39_85,1.0,0,85,85,54
36,r_132_0_180,seq73,r_124_24_143,r_124_24_143,0.81,37,180,143,55
14,r_148_12_121,seq16,r_116_61_89,r_148_12_121,0.65,2,123,121,55
8,r_93_101_93,seq73,r_115_144_106,r_93_101_93,1.0,-3,90,93,55
37,r_41_53_141,r_76_100_140,r_28_135_87,r_76_100_140,0.74,2,142,140,55
39,r_36_26_92,r_65_22_166,seq125,r_65_22_166,0.66,-84,82,166,55
5,r_124_24_143,seq19,r_23_77_27,r_124_24_143,0.73,12,155,143,55
46,r_89_113_131,seq39,seq142,r_89_113_131,0.81,0,131,131,55
42,r_30_17_109,seq78,r_137_94_84,r_30_17_109,0.91,1,110,109,55
13,r_129_51_48,r_132_0_180,seq88,r_129_51_48,1.0,0,48,48,55
19,r_108_52_189,seq4,r_9_62_195,r_108_52_189,0.4,1,190,189,55
33,r_58_71_22,r_8_105_175,seq16,r_8_105_175,0.56,9,184,175,55
15,r_139_121_30,r_23_77_27,seq73,r_139_121_30,0.95,0,30,30,55
41,r_40_75_96,r_23_77_27,r_47_20_70,r_47_20_70,1.0,20,90,70,55
10,r_76_100_140,r_41_53_141,r_139_121_30,r_41_53_141,0.69,1,142,141,55
26,r_116_61_89,r_99_14_142,seq64,r_116_61_89,0.95,1,90,89,55
4,r_47_20_70,r_72_134_145,seq149,r_47_20_70,0.5,0,70,70,55
11,r_112_6_188,seq73,r_8_105_175,r_8_105_175,0.77,13,188,175,55
20,r_137_94_84,r_141_102_135,seq120,r_141_102_135,0.99,-49,86,135,55
48,r_67_107_110,seq1,r_122_3_5,r_122_3_5,0.92,107,112,5,55
6,r_69_123_165,r_60_84_193,r_129_51_48,r_129_51_48,0.65,119,167,48,55
0,r_8_105_175,r_124_24_143,r_58_71_22,r_58_71_22,0.94,4,26,22,55
0,r_8_105_175,r_58_71_22,r_69_123_165,r_69_123_165,0.7,19,184,165,55
27,r_109_106_160,r_108_52_189,r_131_146_85,r_131_146_85,0.7,78,163,85,55
2,r_141_102_135,seq88,seq126,r_141_102_135,0.73,1,136,135,55
47,r_25_18_118,seq128,r_35_87_20,r_35_87_20,0.55,102,122,20,55
40,r_131_146_85,r_141_102_135,seq125,r_141_102_135,0.84,-29,106,135,55
18,r_57_15_101,r_72_134_145,r_23_77_27,r_23_77_27,0.76,79,106,27,55
29,r_133_143_149,r_108_52_189,r_93_101_93,r_93_101_93,0.84,59,152,93,55
32,r_70_44_186,seq142,r_65_22_166,r_70_44_186,0.26,0,186,186,55
22,r_117_118_31,r_76_100_140,r_49_95_59,r_117_118_31,0.72,-1,30,31,55
34,r_49_95_59,r_70_44_186,r_117_118_31,r_49_95_59,0.76,9,68,59,55
17,r_115_144_106,seq31,seq130,r_115_144_106,0.51,-32,74,106,55
49,r_72_134_145,r_117_118_31,r_35_87_20,r_72_134_145,0.78,1,146,145,55
96,seq120,r_140_27_97,r_137_94_84,r_140_27_97,0.73,11,108,97,55
49,r_72_134_145,r_57_15_101,r_117_118_31,r_72_134_145,0.62,-39,106,145,55
3,r_96_74_57,seq5,seq4,r_96_74_57,0.82,-1,56,57,55
44,r_59_83_139,seq125,seq142,r_59_83_139,0.81,-5,134,139,55
79,seq73,r_112_6_188,r_76_100_140,r_76_100_140,0.99,48,188,140,55
33,r_58_71_22,r_57_15_101,r_8_105_175,r_58_71_22,0.81,0,22,22,55
36,r_119_98_120,r_116_47_148,r_50_137_73,r_50_137_73,0.66,47,120,73,56
41,r_91_46_16,r_116_47_148,seq96,r_91_46_16,0.96,1,17,16,56
43,r_52_74_182,seq128,r_111_136_65,r_111_136_65,1.0,118,183,65,56
7,r_18_126_14,r_108_67_161,seq132,r_18_126_14,1.0,1,15,14,56
0,r_130_28_26,r_35_86_49,seq26,r_35_86_49,0.92,-22,27,49,56
16,r_131_106_103,r_63_90_132,seq19,r_131_106_103,0.67,0,103,103,56
21,r_54_101_140,seq76,r_6_14_124,r_54_101_140,0.61,0,140,140,56
2,r_127_34_28,r_116_47_148,seq117,r_127_34_28,0.97,0,28,28,56
34,r_123_16_41,r_116_47_148,seq8,r_123_16_41,1.0,1,42,41,56
1,r_116_47_148,seq84,r_12_99_119,r_12_99_119,0.8,30,149,119,56
5,r_63_90_132,seq23,r_146_51_47,r_63_90_132,1.0,0,132,132,56
46,r_9_94_136,r_71_89_142,seq0,r_71_89_142,0.63,-5,137,142,56
19,r_25_120_93,r_49_58_188,seq135,r_25_120_93,1.0,0,93,93,56
31,r_12_99_119,seq96,r_50_137_73,r_12_99_119,1.0,0,119,119,56
3,r_49_58_188,r_25_120_93,r_6_14_124,r_25_120_93,1.0,0,93,93,56
10,r_115_27_98,r_133_3_180,r_127_34_28,r_133_3_180,0.66,-82,98,180,56
4,r_111_136_65,seq73,r_18_126_14,r_111_136_65,0.98,3,68,65,56
11,r_141_56_159,r_22_149_176,r_72_11_6,r_141_56_159,0.93,0,159,159,56
20,r_39_83_104,seq76,seq84,r_39_83_104,0.88,4,108,104,56
23,r_112_118_54,r_63_90_132,seq76,r_112_118_54,0.53,3,57,54,56
8,r_147_145_51,r_6_14_124,seq73,r_147_145_51,0.99,1,52,51,56
15,r_82_60_115,r_88_81_138,r_127_34_28,r_88_81_138,0.6,-21,117,138,56
48,r_38_103_169,r_139_40_128,r_130_28_26,r_130_28_26,0.83,161,187,26,56
17,r_125_24_37,r_116_47_148,seq21,r_125_24_37,1.0,0,37,37,56
2,r_127_34_28,seq117,r_53_45_63,r_53_45_63,1.0,31,94,63,56
27,r_71_89_142,r_7_68_192,r_61_114_121,r_71_89_142,0.96,1,143,142,56
47,r_22_149_176,seq107,seq20,r_22_149_176,0.42,2,178,176,56
29,r_5_64_91,r_144_69_147,r_4_62_12,r_5_64_91,0.91,0,91,91,56
24,r_113_36_90,r_54_101_140,r_4_62_12,r_4_62_12,0.65,79,91,12,56
33,r_43_48_137,seq135,r_4_62_12,r_43_48_137,0.67,0,137,137,56
88,seq96,r_66_30_163,r_63_90_132,r_63_90_132,1.0,37,169,132,56
32,r_143_57_96,r_61_114_121,r_111_136_65,r_143_57_96,1.0,0,96,96,56
38,r_53_45_63,r_63_90_132,r_127_34_28,r_53_45_63,1.0,0,63,63,56
9,r_61_114_121,seq75,r_125_24_37,r_125_24_37,0.75,86,123,37,56
22,r_4_62_12,r_144_69_147,seq124,r_4_62_12,0.93,1,13,12,56
49,r_33_102_157,seq135,seq2,r_33_102_157,0.92,0,157,157,56
96,seq117,r_108_67_161,r_127_34_28,r_127_34_28,1.0,3,31,28,56
12,r_108_67_161,seq77,r_63_90_132,r_63_90_132,0.99,27,159,132,56
42,r_35_86_49,seq77,seq44,r_35_86_49,1.0,2,51,49,56
30,r_91_18_150,r_37_68_171,r_0_48_8,r_91_18_150,0.62,1,151,150,57
0,r_51_114_30,r_44_96_36,seq69,r_51_114_30,0.78,-2,28,30,57
8,r_120_50_47,r_72_122_111,r_44_96_36,r_120_50_47,0.79,1,48,47,57
36,r_128_7_125,seq12,seq61,r_128_7_125,0.52,5,130,125,57
37,r_25_119_81,seq69,seq24,r_25_119_81,0.67,2,83,81,57
16,r_2_123_83,seq85,seq149,r_2_123_83,0.74,1,84,83,57
4,r_44_96_36,seq10,r_120_50_47,r_44_96_36,0.73,12,48,36,57
39,r_79_73_43,r_75_99_182,seq17,r_79_73_43,0.51,6,49,43,57
38,r_95_131_48,seq135,seq9,r_95_131_48,0.74,4,52,48,57
15,r_8_11_134,r_15_133_4,r_29_74_7,r_15_133_4,0.69,131,135,4,57
48,r_142_126_127,r_0_48_8,seq127,r_142_126_127,0.64,0,127,127,57
46,r_30_148_57,r_8_11_134,seq83,r_30_148_57,0.73,1,58,57,57
29,r_32_82_108,seq84,seq90,r_32_82_108,0.64,-3,105,108,57
25,r_49_104_75,r_37_68_171,r_59_47_19,r_49_104_75,0.77,2,77,75,57
34,r_129_6_132,r_26_34_11,r_110_71_49,r_26_34_11,0.64,140,151,11,57
22,r_63_78_152,r_57_118_188,r_110_71_49,r_57_118_188,0.64,-35,153,188,57
7,r_55_5_98,r_8_11_134,seq12,r_55_5_98,0.52,-27,71,98,57
23,r_1_77_167,r_147_58_15,r_142_126_127,r_1_77_167,0.27,3,170,167,57
51,seq6,r_2_124_85,r_29_50_91,r_29_50_91,0.53,-8,83,91,58
14,r_110_1_138,seq55,r_143_94_159,r_110_1_138,0.88,4,142,138,58
16,r_102_58_132,seq141,r_53_129_97,r_53_129_97,1.0,46,143,97,58
11,r_108_114_27,r_2_124_85,seq73,r_108_114_27,0.96,-2,25,27,58
1,r_19_13_45,r_29_50_91,seq89,r_19_13_45,0.76,14,59,45,58
31,r_10_116_102,seq68,seq7,r_10_116_102,0.98,0,102,102,58
3,r_115_72_69,r_56_81_129,seq11,r_115_72_69,0.97,2,71,69,58
26,r_144_44_54,r_14_60_188,seq119,r_144_44_54,0.78,28,82,54,58
0,r_2_124_85,seq140,seq141,r_2_124_85,0.6,15,100,85,58
20,r_62_80_123,r_20_34_183,r_108_114_27,r_62_80_123,0.47,7,130,123,58
27,r_99_105_126,r_59_31_143,seq93,r_99_105_126,0.57,4,130,126,58
41,r_70_48_47,r_59_31_143,r_88_0_180,r_70_48_47,0.82,0,47,47,58
47,r_63_132_81,seq128,r_64_96_197,r_63_132_81,0.8,2,83,81,58
40,r_26_130_148,seq16,r_42_33_3,r_26_130_148,0.54,9,157,148,58
29,r_56_81_129,seq128,r_120_51_11,r_56_81_129,0.22,2,131,129,58
4,r_109_137_43,r_102_58_132,r_14_60_188,r_109_137_43,0.67,0,43,43,58
25,r_39_133_141,r_3_17_184,r_108_114_27,r_39_133_141,0.77,4,145,141,58
32,r_67_84_78,r_123_91_149,seq146,r_67_84_78,0.98,0,78,78,58
22,r_98_5_44,r_82_83_114,seq7,r_98_5_44,0.71,4,48,44,58
34,r_4_54_145,r_3_17_184,seq128,r_4_54_145,0.46,-14,131,145,58
48,r_24_145_33,r_118_85_20,seq136,r_118_85_20,0.67,30,50,20,58
17,r_15_111_160,r_26_130_148,r_118_85_20,r_26_130_148,0.44,9,157,148,58
9,r_59_31_143,seq40,r_14_60_188,r_59_31_143,0.76,2,145,143,58
43,r_121_131_30,r_59_31_143,seq36,r_121_131_30,0.83,-5,25,30,58
28,r_82_83_114,seq12,r_53_129_97,r_53_129_97,1.0,29,126,97,58
7,r_143_94_159,seq136,r_110_1_138,r_110_1_138,0.96,23,161,138,58
23,r_123_91_149,seq25,r_4_54_145,r_4_54_145,0.45,7,152,145,58
35,r_104_125_170,r_46_57_181,r_19_13_45,r_104_125_170,0.47,5,175,170,58
5,r_22_8_34,r_104_125_170,seq16,r_22_8_34,0.77,0,34,34,58
12,r_20_34_183,seq146,r_22_8_34,r_22_8_34,0.66,149,183,34,58
51,seq132,r_85_38_177,r_148_45_54,r_148_45_54,1.0,124,178,54,59
36,r_110_103_131,seq14,r_91_10_25,r_110_103_131,0.62,1,132,131,59
32,r_27_121_13,r_36_64_76,seq39,r_27_121_13,0.89,1,14,13,59
43,r_130_108_148,r_94_74_176,r_1_133_97,r_130_108_148,0.53,6,154,148,59
25,r_125_138_24,r_107_19_100,seq101,r_125_138_24,0.82,0,24,24,59
59,seq16,r_85_38_177,r_33_40_114,r_33_40_114,1.0,8,122,114,59
16,r_99_106_91,r_143_22_99,r_11_141_116,r_143_22_99,0.66,-9,90,99,59
21,r_88_32_103,r_1_133_97,r_52_23_35,r_88_32_103,0.54,-7,96,103,59
39,r_71_5_121,seq79,r_73_61_62,r_71_5_121,1.0,0,121,121,59
5,r_107_19_100,r_94_74_176,seq56,r_107_19_100,0.98,-2,98,100,59
46,r_59_81_107,r_35_123_162,r_90_55_18,r_90_55_18,0.67,89,107,18,59
45,r_60_127_68,seq17,seq80,r_60_127_68,0.96,0,68,68,59
41,r_145_140_141,seq139,r_52_23_35,r_52_23_35,0.85,107,142,35,59
3,r_33_40_114,r_147_20_198,seq16,r_33_40_114,0.97,1,115,114,59
4,r_34_8_58,r_67_102_93,seq139,r_34_8_58,1.0,0,58,58,59
11,r_52_23_35,r_85_38_177,seq12,r_52_23_35,1.0,-1,34,35,59
10,r_50_104_130,r_145_140_141,r_124_114_106,r_124_114_106,1.0,30,136,106,59
42,r_116_51_195,r_66_120_140,r_87_115_64,r_116_51_195,0.93,-139,56,195,59
20,r_131_6_85,r_88_32_103,r_77_126_32,r_131_6_85,0.64,-9,76,85,59
13,r_143_22_99,seq72,seq62,r_143_22_99,0.97,-1,98,99,59
15,r_35_123_162,seq79,r_90_55_18,r_35_123_162,0.55,0,162,162,59
48,r_49_109_104,r_92_84_112,r_147_20_198,r_49_109_104,0.93,7,111,104,59
1,r_148_45_54,r_25_7_2,seq132,r_148_45_54,1.0,0,54,54,59
6,r_85_38_177,seq132,r_48_2_28,r_48_2_28,0.78,150,178,28,59
27,r_58_4_136,seq80,r_52_23_35,r_52_23_35,0.94,102,137,35,59
47,r_1_133_97,r_88_32_103,seq17,r_1_133_97,0.83,-1,96,97,59
74,seq56,r_67_102_93,r_107_19_100,r_107_19_100,1.0,-2,98,100,59
24,r_92_84_112,seq12,r_53_93_12,r_53_93_12,0.89,104,116,12,59
33,r_124_114_106,r_110_103_131,seq97,r_124_114_106,0.69,1,107,106,59
64,seq29,r_59_81_107,r_57_28_57,r_57_28_57,0.98,36,93,57,59
84,seq80,r_58_4_136,r_60_127_68,r_60_127_68,0.88,-10,58,68,59
29,r_57_28_57,r_36_64_76,r_135_149_71,r_57_28_57,0.7,-1,56,57,59
34,r_66_120_140,r_116_51_195,seq65,r_66_120_140,0.56,2,142,140,59
2,r_91_10_25,r_85_38_177,r_27_121_13,r_91_10_25,0.51,0,25,25,59
75,seq62,r_85_38_177,r_143_22_99,r_143_22_99,1.0,6,105,99,59
16,r_99_106_91,r_11_141_116,r_90_55_18,r_99_106_91,0.5,51,142,91,59
28,r_87_115_64,r_58_4_136,r_116_51_195,r_87_115_64,0.55,-8,56,64,59
17,r_128_43_61,seq47,r_52_23_35,r_128_43_61,0.78,0,61,61,59
9,r_67_102_93,seq56,r_148_45_54,r_148_45_54,1.0,22,76,54,59
49,r_135_149_71,seq42,r_57_28_57,r_57_28_57,1.0,13,70,57,59
7,r_36_64_76,seq9,r_60_127_68,r_36_64_76,1.0,0,76,76,59
44,r_129_111_73,seq26,seq9,r_129_111_73,1.0,0,73,73,59
23,r_15_95_147,r_85_38_177,r_52_23_35,r_85_38_177,0.76,-30,147,177,59
26,r_77_126_32,r_143_22_99,r_25_7_2,r_77_126_32,0.56,0,32,32,59
35,r_44_96_75,r_107_19_100,r_91_10_25,r_44_96_75,1.0,1,76,75,59
12,r_11_141_116,seq76,r_36_64_76,r_36_64_76,1.0,31,107,76,59
36,r_9_12_69,r_108_50_155,r_33_104_82,r_9_12_69,0.88,-3,66,69,60
43,r_92_6_153,r_81_62_20,r_22_106_112,r_22_106_112,0.82,43,155,112,60
37,r_13_42_134,r_126_111_196,seq20,r_13_42_134,0.66,0,134,134,60
16,r_112_94_120,seq38,seq105,r_112_94_120,0.68,2,122,120,60
39,r_85_35_164,r_143_109_176,r_69_82_111,r_85_35_164,0.49,1,165,164,60
1,r_132_136_178,seq40,r_129_44_26,r_132_136_178,0.35,0,178,178,60
46,r_103_102_113,r_18_83_192,r_74_15_81,r_103_102_113,0.7,7,120,113,60
42,r_75_147_160,seq55,r_13_42_134,r_75_147_160,0.55,1,161,160,60
11,r_81_62_20,r_18_83_192,r_92_6_153,r_81_62_20,0.82,-1,19,20,60
8,r_127_98_56,r_149_134_168,r_121_14_188,r_127_98_56,0.97,-2,54,56,60
45,r_108_50_155,seq138,r_13_42_134,r_108_50_155,0.6,1,156,155,60
19,r_21_131_135,seq119,r_74_15_81,r_21_131_135,0.89,0,135,135,60
11,r_81_62_20,r_92_6_153,r_69_82_111,r_81_62_20,0.74,135,155,20,60
10,r_69_82_111,r_45_144_130,r_81_62_20,r_69_82_111,0.53,2,113,111,60
26,r_49_137_17,r_92_6_153,r_64_59_104,r_49_137_17,0.89,0,17,17,60
4,r_149_134_168,seq8,seq10,r_149_134_168,0.37,0,168,168,60
98,seq119,r_21_131_135,seq34,r_21_131_135,1.0,-47,88,135,60
27,r_2_25_132,seq41,r_129_44_26,r_2_25_132,0.54,2,134,132,60
40,r_128_80_93,seq32,r_125_135_129,r_128_80_93,0.55,-5,88,93,60
25,r_22_106_112,seq60,seq8,r_22_106_112,0.69,1,113,112,60
33,r_88_148_67,seq10,seq84,r_88_148_67,0.89,-1,66,67,60
50,seq1,r_30_19_181,r_45_144_130,r_45_144_130,0.62,57,187,130,60
32,r_97_27_103,r_63_53_136,r_33_104_82,r_97_27_103,0.7,6,109,103,60
34,r_23_67_90,r_45_144_130,seq96,r_23_67_90,0.89,-6,84,90,60
60,seq31,r_95_36_131,seq1,r_95_36_131,1.0,1,132,131,60
9,r_45_144_130,r_122_76_84,r_69_82_111,r_122_76_84,0.99,46,130,84,60
22,r_74_15_81,r_120_51_171,r_121_14_188,r_74_15_81,0.78,-3,78,81,60
28,r_115_4_150,seq46,seq86,r_115_4_150,0.54,0,150,150,60
49,r_95_36_131,seq31,seq86,r_95_36_131,0.69,1,132,131,60
47,r_118_99_45,r_11_29_18,r_114_7_6,r_118_99_45,1.0,-1,44,45,60
7,r_18_83_192,r_103_102_113,r_61_140_121,r_18_83_192,0.64,-70,122,192,60
44,r_54_79_143,r_126_111_196,r_129_44_26,r_54_79_143,0.67,1,144,143,60
23,r_33_104_82,seq87,r_9_12_69,r_9_12_69,0.64,7,76,69,60
35,r_130_24_88,r_18_83_192,seq55,r_130_24_88,0.44,-12,76,88,60
8,r_43_54_147,seq45,r_25_49_75,r_43_54_147,0.62,3,150,147,61
43,r_135_69_134,r_27_65_110,r_129_22_109,r_27_65_110,0.76,25,135,110,61
37,r_108_39_90,r_73_72_126,seq100,r_73_72_126,0.51,-34,92,126,61
1,r_67_148_140,seq75,r_73_72_126,r_67_148_140,0.47,8,148,140,61
5,r_129_22_109,r_67_148_140,r_122_59_111,r_129_22_109,0.86,0,109,109,61
46,r_105_74_136,seq128,r_32_30_4,r_105_74_136,0.56,0,136,136,61
42,r_50_121_78,r_118_20_84,r_83_66_189,r_50_121_78,0.64,0,78,78,61
9,r_112_44_26,r_60_113_175,seq34,r_112_44_26,0.73,5,31,26,61
69,seq35,seq15,r_25_49_75,r_25_49_75,0.87,64,139,75,61
45,r_6_141_178,seq97,r_89_146_45,r_89_146_45,0.8,133,178,45,61
19,r_42_37_117,seq45,seq9,r_42_37_117,0.6,4,121,117,61
0,r_89_146_45,r_80_106_98,r_82_99_37,r_80_106_98,0.7,-48,50,98,61
26,r_13_52_102,seq78,seq45,r_13_52_102,0.82,7,109,102,61
13,r_98_137_130,seq15,r_129_22_109,r_98_137_130,0.75,1,131,130,61
15,r_25_49_75,r_67_148_140,seq35,r_25_49_75,0.88,1,76,75,61
48,r_83_66_189,r_93_120_86,r_50_121_78,r_93_120_86,0.78,-15,71,86,61
6,r_73_72_126,r_95_123_149,r_103_8_18,r_73_72_126,0.5,5,131,126,61
24,r_33_136_181,r_73_72_126,r_80_106_98,r_33_136_181,0.67,1,182,181,61
27,r_81_145_152,r_60_113_175,r_129_22_109,r_60_113_175,0.57,-14,161,175,61
34,r_21_29_47,r_31_48_198,seq5,r_21_29_47,0.7,3,50,47,61
2,r_94_0_95,r_27_65_110,r_101_11_36,r_94_0_95,0.58,2,97,95,61
10,r_82_99_37,r_122_59_111,r_89_146_45,r_82_99_37,0.51,4,41,37,61
24,r_33_136_181,r_92_102_128,r_73_72_126,r_92_102_128,0.66,11,139,128,61
25,r_115_24_56,seq34,seq5,r_115_24_56,0.77,15,71,56,61
17,r_80_106_98,r_33_136_181,r_140_77_194,r_80_106_98,0.66,12,110,98,61
22,r_60_113_175,r_81_145_152,r_67_148_140,r_60_113_175,0.41,3,178,175,61
14,r_4_2_54,seq46,r_112_44_26,r_4_2_54,0.71,0,54,54,61
35,r_92_102_128,r_33_136_181,seq15,r_92_102_128,0.63,11,139,128,61
8,r_30_73_159,r_123_28_68,r_104_119_96,r_123_28_68,0.46,94,162,68,62
21,r_117_90_93,r_144_143_163,seq43,r_117_90_93,0.73,0,93,93,62
46,r_97_137_77,seq79,r_111_121_30,r_97_137_77,0.77,1,78,77,62
42,r_46_48_66,r_82_31_35,r_27_78_3,r_46_48_66,0.91,6,72,66,62
45,r_83_70_63,r_24_49_166,r_123_28_68,r_83_70_63,0.77,1,64,63,62
14,r_113_54_20,seq51,seq0,r_113_54_20,1.0,4,24,20,62
11,r_115_145_119,seq12,r_123_28_68,r_115_145_119,0.53,2,121,119,62
15,r_140_129_54,r_115_145_119,seq1,r_140_129_54,0.93,1,55,54,62
27,r_42_65_132,seq72,r_27_78_3,r_42_65_132,0.69,0,132,132,62
2,r_91_19_73,r_135_52_184,r_76_148_74,r_91_19_73,0.94,6,79,73,62
40,r_132_92_183,seq1,r_24_49_166,r_132_92_183,0.27,7,190,183,62
29,r_146_22_160,r_123_28_68,r_57_9_151,r_123_28_68,0.68,94,162,68,62
33,r_6_118_137,r_131_58_142,r_115_145_119,r_6_118_137,0.69,7,144,137,62
44,r_23_95_42,r_69_110_141,r_57_9_151,r_23_95_42,0.88,3,45,42,62
38,r_98_3_116,r_6_118_137,r_117_90_93,r_6_118_137,0.89,-20,117,137,62
18,r_66_116_41,r_24_49_166,seq15,r_66_116_41,0.94,5,46,41,62
30,r_111_121_30,r_59_81_189,r_133_25_199,r_111_121_30,0.93,2,32,30,62
17,r_21_139_91,r_6_118_137,r_5_63_195,r_21_139_91,0.94,2,93,91,62
22,r_108_134_71,r_59_81_189,seq0,r_108_134_71,0.63,3,74,71,62
49,r_149_93_70,r_21_139_91,r_56_126_197,r_149_93_70,0.59,2,72,70,62
7,r_74_96_128,r_24_49_166,r_66_116_41,r_66_116_41,0.61,91,132,41,62
39,r_40_86_26,r_91_19_73,seq7,r_91_19_73,0.94,-25,48,73,62
36,r_137_17_76,r_134_110_167,r_14_68_14,r_137_17_76,0.99,0,76,76,63
92,seq108,seq124,r_98_79_17,r_98_79_17,0.59,12,29,17,63
46,r_92_12_15,r_84_139_88,r_145_13_6,r_92_12_15,0.77,0,15,15,63
30,r_129_54_34,r_132_32_156,seq138,r_129_54_34,1.0,1,35,34,63
43,r_0_148_107,r_37_113_163,r_23_28_99,r_37_113_163,0.46,-50,113,163,63
16,r_100_57_172,r_122_88_126,r_129_54_34,r_100_57_172,0.64,0,172,172,63
16,r_100_57_172,r_90_10_77,r_122_88_126,r_100_57_172,0.4,-37,135,172,63
21,r_112_3_136,seq5,r_98_79_17,r_98_79_17,0.99,133,150,17,63
39,r_34_94_63,seq136,seq133,r_34_94_63,1.0,0,63,63,63
1,r_115_20_82,r_37_113_163,r_35_63_11,r_35_63_11,0.43,75,86,11,63
5,r_71_64_105,r_11_49_190,seq130,r_71_64_105,1.0,2,107,105,63
42,r_89_123_176,seq128,r_95_1_46,r_95_1_46,1.0,132,178,46,63
3,r_102_140_79,r_90_10_77,seq117,r_102_140_79,1.0,3,82,79,63
37,r_25_47_55,r_132_32_156,seq103,r_25_47_55,0.65,4,59,55,63
26,r_147_77_102,seq41,r_39_144_28,r_147_77_102,0.47,0,102,102,63
11,r_146_58_145,r_23_28_99,r_99_105_44,r_23_28_99,0.42,53,152,99,63
20,r_4_52_129,seq107,seq78,r_4_52_129,0.65,3,132,129,63
13,r_122_88_126,r_21_81_166,r_100_57_172,r_100_57_172,0.8,-26,146,172,63
98,seq124,r_69_2_171,r_14_68_14,r_14_68_14,0.83,162,176,14,63
15,r_48_101_132,seq103,r_84_139_88,r_84_139_88,1.0,48,136,88,63
57,seq138,r_134_110_167,r_129_54_34,r_129_54_34,0.88,26,60,34,63
13,r_122_88_126,r_100_57_172,seq18,r_122_88_126,0.76,46,172,126,63
6,r_45_118_117,seq78,seq31,r_45_118_117,0.96,0,117,117,63
27,r_143_111_61,r_84_139_88,r_22_65_29,r_143_111_61,0.99,0,61,61,63
2,r_114_61_59,r_115_20_82,seq44,r_114_61_59,1.0,2,61,59,63
47,r_53_85_149,seq104,r_146_58_145,r_53_85_149,0.42,3,152,149,63
28,r_72_16_39,r_45_118_117,seq55,r_45_118_117,0.85,-76,41,117,63
18,r_83_135_67,seq44,seq107,r_83_135_67,1.0,2,69,67,63
64,seq31,r_21_81_166,r_45_118_117,r_45_118_117,0.62,50,167,117,63
44,r_22_65_29,r_84_139_88,seq5,r_22_65_29,0.74,1,30,29,63
38,r_11_49_190,r_93_141_191,r_21_81_166,r_21_81_166,0.8,24,190,166,63
34,r_90_10_77,r_102_140_79,r_51_67_33,r_90_10_77,1.0,5,82,77,63
91,seq107,r_4_52_129,r_84_139_88,r_84_139_88,1.0,44,132,88,63
14,r_39_144_28,r_48_101_132,r_37_113_163,r_39_144_28,0.91,7,35,28,63
4,r_51_67_33,r_112_3_136,seq7,r_51_67_33,1.0,0,33,33,63
7,r_84_139_88,r_134_110_167,r_83_135_67,r_134_110_167,1.0,-79,88,167,63
82,seq78,r_45_118_117,r_115_20_82,r_45_118_117,0.97,0,117,117,63
35,r_33_121_128,seq30,r_39_144_28,r_39_144_28,0.92,125,153,28,63
14,r_71_79_77,r_114_132_139,seq106,r_71_79_77,1.0,2,79,77,64
1,r_19_53_42,seq140,seq87,r_19_53_42,0.96,8,50,42,64
37,r_10_81_131,r_96_20_89,r_17_133_23,r_96_20_89,0.62,42,131,89,64
16,r_122_14_103,seq4,r_41_42_104,r_122_14_103,0.77,4,107,103,64
21,r_137_104_87,r_143_130_171,seq9,r_137_104_87,1.0,0,87,87,64
5,r_40_78_169,r_116_31_21,r_114_132_139,r_40_78_169,0.58,0,169,169,64
46,r_55_64_178,seq135,r_41_42_104,r_41_42_104,0.99,74,178,104,64
42,r_28_124_116,r_134_149_182,seq12,r_28_124_116,0.95,0,116,116,64
80,seq140,r_19_53_42,r_143_130_171,r_19_53_42,0.51,74,116,42,64
19,r_21_94_140,r_108_62_196,r_35_91_64,r_21_94_140,0.97,1,141,140,64
43,r_97_18_20,r_36_39_162,seq4,r_97_18_20,0.81,0,20,20,64
31,r_131_93_29,r_119_0_187,r_116_31_21,r_131_93_29,0.61,-3,26,29,64
41,r_37_144_82,seq121,seq12,r_37_144_82,0.89,6,88,82,64
49,r_66_6_33,r_16_127_160,seq49,r_66_6_33,1.0,0,33,33,64
3,r_143_130_171,seq52,r_119_0_187,r_143_130_171,0.41,4,175,171,64
4,r_85_46_65,r_10_81_131,seq1,r_85_46_65,0.89,0,65,65,64
20,r_35_91_64,seq111,r_58_126_149,r_35_91_64,1.0,1,65,64,64
13,r_99_50_132,r_114_132_139,seq59,r_99_50_132,0.88,2,134,132,64
98,seq121,r_37_144_82,r_19_53_42,r_37_144_82,0.44,15,97,82,64
15,r_16_127_160,seq123,r_61_112_173,r_16_127_160,0.78,1,161,160,64
6,r_41_42_104,r_114_132_139,r_122_14_103,r_41_42_104,0.8,2,106,104,64
40,r_67_129_49,r_114_132_139,r_17_133_23,r_67_129_49,1.0,0,49,49,64
27,r_134_149_182,seq106,r_41_42_104,r_134_149_182,0.57,0,182,182,64
9,r_117_48_19,r_19_53_42,seq11,r_117_48_19,0.88,0,19,19,64
35,r_17_133_23,seq12,seq65,r_17_133_23,0.76,1,24,23,64
2,r_36_39_162,r_58_126_149,r_105_26_43,r_105_26_43,0.97,121,164,43,64
47,r_83_5_133,r_16_127_160,seq141,r_83_5_133,0.84,1,134,133,64
24,r_68_125_128,r_16_127_160,r_25_110_2,r_16_127_160,0.95,-32,128,160,64
25,r_74_113_181,seq123,r_36_39_162,r_74_113_181,0.43,1,182,181,64
10,r_47_43_31,seq1,seq95,r_47_43_31,0.96,5,36,31,64
94,seq106,r_134_149_182,r_71_79_77,r_71_79_77,1.0,24,101,77,64
22,r_109_2_144,r_74_113_181,seq13,r_109_2_144,0.87,5,149,144,64
28,r_29_115_174,seq106,r_41_42_104,r_29_115_174,0.58,0,174,174,64
12,r_88_145_73,r_96_20_89,r_54_103_17,r_88_145_73,0.76,7,80,73,64
30,r_50_52_172,seq15,r_54_149_110,r_54_149_110,1.0,62,172,110,65
14,r_93_146_151,r_53_81_150,r_5_64_97,r_53_81_150,0.27,1,151,150,65
59,seq14,r_23_39_198,r_99_13_16,r_99_13_16,0.86,52,68,16,65
21,r_54_149_110,r_66_116_121,seq35,r_54_149_110,0.58,1,111,110,65
1,r_8_94_164,r_20_91_12,r_44_70_134,r_20_91_12,0.52,152,164,12,65
27,r_100_55_58,r_19_119_153,r_47_143_14,r_100_55_58,1.0,1,59,58,65
42,r_112_134_101,r_90_12_113,r_20_91_12,r_112_134_101,0.91,0,101,101,65
45,r_16_85_140,seq30,r_9_98_3,r_16_85_140,0.93,2,142,140,65
19,r_44_70_134,r_46_137_149,seq133,r_46_137_149,0.62,-12,137,149,65
37,r_107_25_34,r_8_94_164,seq21,r_107_25_34,0.98,2,36,34,65
39,r_140_82_29,r_68_24_192,seq67,r_140_82_29,1.0,0,29,29,65
36,r_147_74_43,r_8_94_164,r_105_45_100,r_147_74_43,1.0,1,44,43,65
9,r_99_13_16,r_46_137_149,seq14,r_99_13_16,0.98,0,16,16,65
0,r_46_137_149,r_105_45_100,r_9_98_3,r_46_137_149,0.55,0,149,149,65
20,r_49_1_173,seq84,r_108_88_50,r_108_88_50,0.88,134,184,50,65
15,r_123_109_92,r_5_64_97,r_117_71_65,r_123_109_92,1.0,0,92,92,65
48,r_3_27_104,r_46_137_149,r_123_109_92,r_3_27_104,0.72,0,104,104,65
2,r_5_64_97,seq57,r_37_36_15,r_5_64_97,0.83,0,97,97,65
47,r_79_4_116,r_26_136_159,r_117_71_65,r_117_71_65,0.96,51,116,65,65
23,r_108_88_50,r_19_119_153,r_77_87_49,r_108_88_50,0.93,5,55,50,65
24,r_102_73_148,seq0,r_44_70_134,r_102_73_148,0.84,1,149,148,65
33,r_66_116_121,seq133,seq83,r_66_116_121,0.9,0,121,121,65
50,seq0,r_102_73_148,r_111_60_47,r_102_73_148,0.89,1,149,148,65
43,r_111_60_47,r_8_94_164,seq0,r_8_94_164,0.81,-110,54,164,65
17,r_78_62_102,r_26_136_159,r_123_109_92,r_26_136_159,0.95,-57,102,159,65
40,r_77_87_49,seq97,r_108_88_50,r_108_88_50,0.62,4,54,50,65
22,r_117_71_65,r_54_149_110,seq67,r_117_71_65,0.86,2,67,65,65
49,r_40_124_160,r_61_121_163,r_90_12_113,r_40_124_160,0.36,1,161,160,65
7,r_148_31_156,r_8_94_164,r_105_45_100,r_148_31_156,0.43,0,156,156,65
44,r_53_81_150,seq59,r_44_70_134,r_53_81_150,0.75,3,153,150,65
12,r_138_120_57,r_102_73_148,seq32,r_138_120_57,0.97,9,66,57,65
30,r_53_106_50,r_128_75_170,r_62_52_160,r_128_75_170,0.51,1,171,170,66
36,r_145_50_112,r_128_75_170,r_13_124_44,r_145_50_112,0.58,6,118,112,66
8,r_43_93_113,r_62_52_160,r_139_61_17,r_43_93_113,0.48,3,116,113,66
71,seq35,r_69_41_121,seq0,r_69_41_121,0.58,-20,101,121,66
21,r_87_127_93,r_102_113_126,r_117_136_71,r_102_113_126,0.79,-27,99,126,66
45,r_46_68_76,r_56_92_193,r_13_124_44,r_56_92_193,0.6,-116,77,193,66
43,r_126_78_20,r_132_147_80,r_111_5_7,r_126_78_20,0.59,0,20,20,66
27,r_25_121_35,r_62_52_160,seq31,r_25_121_35,0.98,0,35,35,66
37,r_135_89_48,seq131,r_111_5_7,r_135_89_48,0.54,0,48,48,66
3,r_132_147_80,seq16,r_21_86_40,r_132_147_80,0.88,2,82,80,66
20,r_14_112_135,r_144_29_188,r_12_33_152,r_12_33_152,0.53,1,153,152,66
13,r_139_61_17,r_143_133_108,seq10,r_139_61_17,0.83,-1,16,17,66
9,r_13_124_44,r_28_30_131,seq99,r_13_124_44,0.8,1,45,44,66
24,r_149_138_37,r_46_68_76,seq31,r_149_138_37,0.88,9,46,37,66
2,r_104_120_128,r_73_130_10,r_143_133_108,r_73_130_10,0.44,125,135,10,66
29,r_128_75_170,r_53_106_50,r_91_76_120,r_91_76_120,0.96,51,171,120,66
22,r_21_86_40,r_66_125_162,seq146,r_66_125_162,0.52,-117,45,162,66
38,r_44_109_130,r_56_92_193,r_57_114_198,r_44_109_130,0.73,2,132,130,66
34,r_117_136_71,r_28_30_131,seq32,r_117_136_71,0.59,1,72,71,66
49,r_3_38_158,r_40_26_197,r_60_118_86,r_3_38_158,0.69,1,159,158,66
44,r_12_33_152,r_62_52_160,seq140,r_62_52_160,0.46,6,166,160,66
23,r_63_96_119,seq48,r_57_114_198,r_63_96_119,0.94,0,119,119,66
12,r_143_133_108,seq101,seq90,r_143_133_108,0.45,0,108,108,66
38,r_132_110_31,r_149_16_185,seq63,r_149_16_185,0.52,-147,38,185,67
16,r_50_101_124,r_86_55_127,r_9_8_29,r_50_101_124,0.43,0,124,124,67
21,r_141_113_157,seq78,r_9_8_29,r_9_8_29,0.96,129,158,29,67
39,r_129_7_126,seq136,r_9_8_29,r_129_7_126,0.69,0,126,126,67
1,r_121_140_86,seq93,seq28,r_121_140_86,0.73,1,87,86,67
5,r_15_138_77,r_86_55_127,r_117_19_69,r_15_138_77,0.6,0,77,77,67
46,r_36_73_85,seq80,r_107_57_166,r_36_73_85,0.73,2,87,85,67
42,r_69_116_147,seq28,r_104_40_112,r_69_116_147,0.6,0,147,147,67
20,r_52_133_23,r_109_37_183,r_130_112_119,r_52_133_23,0.95,-3,20,23,67
19,r_82_51_122,seq2,r_45_43_199,r_82_51_122,0.57,2,124,122,67
31,r_122_38_102,r_86_55_127,r_41_126_75,r_122_38_102,0.73,0,102,102,67
28,r_130_112_119,r_129_7_126,r_52_133_23,r_52_133_23,0.94,6,29,23,67
3,r_34_94_128,seq3,r_107_57_166,r_34_94_128,0.54,0,128,128,67
10,r_32_20_95,r_21_124_167,seq136,r_32_20_95,0.9,1,96,95,67
9,r_10_79_46,r_21_124_167,r_135_0_8,r_10_79_46,0.96,3,49,46,67
26,r_108_87_93,seq144,r_121_140_86,r_108_87_93,0.8,5,98,93,67
0,r_25_14_194,r_44_102_141,r_121_140_86,r_25_14_194,0.45,-47,147,194,67
13,r_104_40_112,seq92,seq17,r_104_40_112,0.83,2,114,112,67
40,r_35_26_30,r_108_87_93,seq148,r_35_26_30,0.56,6,36,30,67
48,r_6_91_10,r_12_98_146,seq28,r_6_91_10,0.74,0,10,10,67
27,r_90_23_144,r_149_16_185,r_104_40_112,r_104_40_112,0.65,49,161,112,67
2,r_30_5_179,seq146,r_104_40_112,r_104_40_112,0.56,67,179,112,67
47,r_42_58_184,r_45_43_199,r_30_5_179,r_30_5_179,0.74,8,187,179,67
29,r_120_1_70,r_34_94_128,r_27_33_2,r_120_1_70,0.82,7,77,70,67
25,r_44_102_141,r_25_14_194,seq70,r_44_102_141,0.6,-9,132,141,67
33,r_12_98_146,r_45_43_199,seq114,r_12_98_146,0.72,0,146,146,67
20,r_52_133_23,r_130_112_119,seq128,r_130_112_119,0.99,1,120,119,67
41,r_89_145_39,r_30_5_179,seq53,r_89_145_39,0.74,0,39,39,67
17,r_86_55_127,seq28,r_27_33_2,r_27_33_2,0.65,139,141,2,67
96,seq115,r_117_19_69,r_109_37_183,r_117_19_69,0.91,1,70,69,67
28,r_130_112_119,r_52_133_23,r_120_1_70,r_130_112_119,0.55,1,120,119,67
44,r_117_19_69,seq115,r_27_33_2,r_117_19_69,0.98,1,70,69,67
23,r_95_59_106,r_109_37_183,r_9_8_29,r_95_59_106,0.8,8,114,106,67
14,r_9_8_29,r_15_138_77,seq92,r_9_8_29,0.76,9,38,29,67
36,r_79_131_112,seq108,r_36_57_118,r_79_131_112,0.76,0,112,112,68
14,r_16_53_77,seq68,seq14,r_16_53_77,0.97,-1,76,77,68
8,r_52_99_73,seq108,seq37,r_52_99_73,0.93,0,73,73,68
46,r_40_49_40,r_127_33_41,r_113_12_34,r_40_49_40,1.0,2,42,40,68
25,r_119_26_44,r_20_96_110,r_102_0_144,r_119_26_44,0.52,13,57,44,68
37,r_36_57_118,r_137_81_122,r_79_131_112,r_36_57_118,0.79,0,118,118,68
21,r_47_48_135,r_60_72_199,r_22_45_32,r_47_48_135,0.43,4,139,135,68
39,r_59_106_63,seq2,r_102_0_144,r_59_106_63,0.83,4,67,63,68
1,r_137_81_122,r_141_84_153,seq13,r_137_81_122,0.93,1,123,122,68
42,r_18_71_89,seq144,seq11,r_18_71_89,0.99,0,89,89,68
41,r_30_109_103,r_140_101_115,r_135_8_23,r_135_8_23,0.95,77,100,23,68
28,r_107_56_39,r_127_33_41,seq90,r_107_56_39,0.98,0,39,39,68
26,r_116_5_190,r_15_9_7,r_141_84_153,r_141_84_153,0.99,37,190,153,68
4,r_21_98_85,r_113_12_34,seq76,r_21_98_85,0.99,0,85,85,68
13,r_140_101_115,r_86_80_11,r_110_43_47,r_110_43_47,0.64,53,100,47,68
15,r_141_84_153,r_55_67_138,seq138,r_55_67_138,0.63,15,153,138,68
48,r_134_105_60,r_102_0_144,r_135_8_23,r_134_105_60,0.76,9,69,60,68
2,r_127_33_41,seq13,seq27,r_127_33_41,1.0,0,41,41,68
38,r_146_91_20,r_52_99_73,r_86_80_11,r_86_80_11,0.71,8,19,11,68
47,r_142_23_52,seq34,seq144,r_142_23_52,0.99,1,53,52,68
18,r_65_46_154,r_60_72_199,seq95,r_65_46_154,0.54,0,154,154,68
29,r_70_97_90,seq44,r_50_100_95,r_70_97_90,0.98,0,90,90,68
33,r_64_38_159,seq68,r_21_98_85,r_21_98_85,0.97,74,159,85,68
58,seq11,seq68,r_18_71_89,r_18_71_89,1.0,72,161,89,68
34,r_35_143_145,seq76,r_129_145_101,r_35_143_145,0.69,0,145,145,68
7,r_77_66_126,r_15_9_7,r_110_43_47,r_77_66_126,0.58,0,126,126,68
31,r_28_87_18,r_137_81_122,seq88,r_28_87_18,0.79,-1,17,18,68
12,r_103_128_134,r_35_143_145,r_110_43_47,r_110_43_47,0.81,87,134,47,68
14,r_31_57_113,r_4_11_179,r_63_51_118,r_31_57_113,0.52,0,113,113,69
1,r_5_138_48,seq10,r_15_12_47,r_5_138_48,0.92,2,50,48,69
43,r_129_128_95,r_60_45_183,r_15_12_47,r_15_12_47,0.58,48,95,47,69
37,r_60_45_183,seq23,r_70_149_181,r_70_149_181,0.99,6,187,181,69
16,r_44_134_124,r_70_149_181,r_66_40_119,r_66_40_119,0.82,15,134,119,69
21,r_74_14_173,seq83,r_46_95_104,r_46_95_104,0.6,70,174,104,69
5,r_66_40_119,seq113,r_15_12_47,r_66_40_119,0.67,0,119,119,69
80,seq75,r_118_59_160,r_114_111_37,r_114_111_37,0.88,66,103,37,69
25,r_122_105_41,r_88_32_91,r_69_106_171,r_69_106_171,0.69,-130,41,171,69
39,r_146_58_30,r_19_35_63,seq54,r_146_58_30,0.75,2,32,30,69
19,r_94_109_123,seq84,r_62_132_42,r_94_109_123,0.59,0,123,123,69
31,r_1_41_145,seq147,r_122_105_41,r_122_105_41,0.94,104,145,41,69
10,r_70_149_181,seq6,r_60_45_183,r_60_45_183,0.94,-2,181,183,69
8,r_125_112_54,r_19_35_63,seq2,r_125_112_54,1.0,1,55,54,69
0,r_64_21_137,r_30_9_153,r_107_38_154,r_107_38_154,0.69,-10,144,154,69
20,r_131_55_126,seq119,r_116_27_90,r_116_27_90,0.94,36,126,90,69
36,r_8_39_35,seq36,r_30_9_153,r_8_39_35,0.66,1,36,35,69
15,r_63_51_118,r_69_106_171,r_31_57_113,r_31_57_113,0.88,22,135,113,69
17,r_114_111_37,r_139_96_142,seq75,r_114_111_37,0.79,0,37,37,69
6,r_30_9_153,r_64_21_137,r_5_138_48,r_5_138_48,0.82,97,145,48,69
23,r_62_132_42,r_63_51_118,r_117_26_108,r_62_132_42,0.98,3,45,42,69
36,r_8_39_35,r_30_9_153,r_141_140_16,r_8_39_35,0.37,111,146,35,69
2,r_46_95_104,r_117_26_108,r_100_0_89,r_117_26_108,0.99,3,111,108,69
47,r_123_85_56,seq67,r_141_140_16,r_123_85_56,0.54,0,56,56,69
18,r_142_77_99,r_19_35_63,seq13,r_142_77_99,0.88,4,103,99,69
29,r_118_59_160,seq75,r_46_95_104,r_46_95_104,0.87,58,162,104,69
22,r_88_32_91,r_122_105_41,r_116_27_90,r_122_105_41,0.55,0,41,41,69
24,r_103_87_105,r_80_48_139,r_88_32_91,r_88_32_91,1.0,22,113,91,69
33,r_100_0_89,r_116_27_90,r_89_16_84,r_89_16_84,0.99,19,103,84,69
38,r_93_102_65,r_139_96_142,r_8_39_35,r_93_102_65,0.9,38,103,65,69
34,r_80_48_139,seq67,r_141_140_16,r_141_140_16,0.9,128,144,16,69
30,r_15_12_47,r_44_134_124,seq82,r_15_12_47,0.73,1,48,47,69
9,r_117_26_108,r_46_95_104,r_125_112_54,r_117_26_108,0.9,3,111,108,69
28,r_141_140_16,seq10,r_123_85_56,r_123_85_56,1.0,32,88,56,69
49,r_69_106_171,r_63_51_118,r_122_105_41,r_122_105_41,1.0,94,135,41,69
7,r_139_96_142,seq13,r_94_109_123,r_139_96_142,0.57,0,142,142,69
35,r_7_99_79,r_19_35_63,r_100_0_89,r_7_99_79,0.84,4,83,79,69
30,r_133_9_165,seq53,r_97_147_88,r_97_147_88,0.63,82,170,88,70
36,r_24_99_97,seq76,r_84_136_65,r_24_99_97,0.86,0,97,97,70
14,r_78_6_73,r_11_113_183,seq37,r_78_6_73,0.7,3,76,73,70
8,r_85_1_70,seq44,r_3_139_13,r_85_1_70,0.87,3,73,70,70
43,r_34_27_162,seq137,r_84_136_65,r_84_136_65,0.99,103,168,65,70
5,r_125_114_143,r_19_73_184,r_36_77_136,r_19_73_184,0.46,-39,145,184,70
46,r_74_15_76,seq101,seq72,r_74_15_76,0.91,3,79,76,70
19,r_52_83_99,r_125_114_143,r_85_1_70,r_125_114_143,0.9,-38,105,143,70
10,r_56_146_181,r_82_149_198,r_51_120_112,r_51_120_112,0.92,69,181,112,70
7,r_28_106_16,r_92_54_151,seq18,r_28_106_16,0.89,6,22,16,70
26,r_97_147_88,r_60_121_21,seq129,r_97_147_88,0.51,2,90,88,70
23,r_95_81_34,r_60_121_21,seq0,r_95_81_34,0.72,0,34,34,70
37,r_3_139_13,r_92_54_151,seq79,r_3_139_13,0.66,6,19,13,70
13,r_64_29_160,r_65_50_189,seq8,r_64_29_160,0.23,3,163,160,70
48,r_135_118_110,seq25,r_84_136_65,r_135_118_110,0.74,7,117,110,70
6,r_84_136_65,r_32_103_145,seq145,r_84_136_65,0.84,8,73,65,70
85,seq76,r_24_99_97,r_28_106_16,r_24_99_97,0.82,0,97,97,70
45,r_91_33_43,r_92_54_151,seq88,r_91_33_43,0.78,7,50,43,70
2,r_67_143_138,r_56_146_181,r_51_120_112,r_56_146_181,0.88,-41,140,181,70
47,r_142_108_126,r_60_121_21,seq148,r_142_108_126,0.69,5,131,126,70
24,r_26_87_137,r_105_58_182,seq10,r_105_58_182,0.79,-39,143,182,70
65,seq25,r_135_118_110,seq117,r_135_118_110,1.0,7,117,110,70
28,r_110_128_52,r_92_54_151,seq117,r_110_128_52,0.47,1,53,52,70
17,r_36_77_136,seq88,r_142_108_126,r_36_77_136,0.54,2,138,136,70
49,r_140_131_166,seq72,r_84_136_65,r_84_136_65,0.83,103,168,65,70
44,r_21_49_178,seq98,r_102_90_106,r_21_49_178,0.41,-69,109,178,70
8,r_104_53_71,r_76_18_199,seq109,r_104_53_71,0.54,-1,70,71,71
43,r_130_115_90,r_111_38_128,r_25_4_40,r_130_115_90,0.58,0,90,90,71
30,r_16_7_38,r_93_57_78,seq63,r_16_7_38,0.55,1,39,38,71
21,r_86_117_147,r_96_46_12,r_8_47_53,r_86_117_147,0.38,1,148,147,71
39,r_95_42_99,seq28,r_94_89_81,r_95_42_99,0.99,0,99,99,71
1,r_48_142_143,r_76_18_199,r_101_120_36,r_101_120_36,0.63,113,149,36,71
19,r_132_21_131,seq63,r_62_102_28,r_62_102_28,0.56,116,144,28,71
0,r_93_57_78,r_26_70_126,seq12,r_93_57_78,0.71,0,78,78,71
73,seq138,r_35_136_60,r_80_110_5,r_35_136_60,0.76,20,80,60,71
11,r_106_90_98,seq51,seq72,r_106_90_98,0.74,15,113,98,71
20,r_97_64_175,seq139,r_62_102_28,r_62_102_28,0.75,152,180,28,71
13,r_79_123_184,r_103_39_192,r_130_115_90,r_130_115_90,0.99,94,184,90,71
48,r_111_38_128,r_118_54_80,r_94_89_81,r_118_54_80,0.55,50,130,80,71
6,r_67_105_134,r_140_98_135,r_144_78_197,r_140_98_135,0.66,2,137,135,71
27,r_44_65_73,seq81,r_144_78_197,r_44_65_73,0.74,5,78,73,71
2,r_124_43_92,r_144_78_197,r_94_89_81,r_124_43_92,0.69,-13,79,92,71
40,r_35_136_60,r_85_55_186,seq10,r_35_136_60,0.75,10,70,60,71
32,r_107_52_158,seq10,r_144_78_197,r_107_52_158,0.5,5,163,158,71
38,r_140_98_135,r_67_105_134,seq28,r_140_98_135,0.97,2,137,135,71
9,r_1_113_96,seq141,r_80_110_5,r_1_113_96,0.81,6,102,96,71
29,r_101_120_36,r_104_53_71,seq6,r_101_120_36,0.69,3,39,36,71
28,r_34_137_62,r_79_123_184,seq129,r_34_137_62,0.75,19,81,62,71
46,r_25_4_40,r_79_123_184,seq28,r_25_4_40,0.99,1,41,40,71
49,r_108_66_142,r_29_58_188,r_124_43_92,r_124_43_92,0.83,52,144,92,71
44,r_84_135_159,r_118_54_80,r_35_136_60,r_118_54_80,0.5,83,163,80,71
12,r_26_70_126,r_24_3_84,r_92_134_133,r_26_70_126,0.67,9,135,126,71
14,r_58_107_114,seq62,seq146,r_58_107_114,0.61,10,124,114,72
8,r_92_130_172,r_14_51_19,r_4_84_127,r_4_84_127,0.7,36,163,127,72
37,r_93_102_62,seq114,seq129,r_93_102_62,0.83,23,85,62,72
1,r_80_123_119,r_35_41_182,r_38_85_106,r_38_85_106,0.79,60,166,106,72
46,r_104_115_137,seq44,r_24_91_25,r_104_115_137,0.49,0,137,137,72
42,r_33_8_159,r_28_109_43,seq135,r_33_8_159,0.57,-131,28,159,72
19,r_79_145_148,r_40_63_3,r_72_69_94,r_79_145_148,0.56,1,149,148,72
28,r_122_111_42,r_38_85_106,r_48_116_195,r_122_111_42,0.98,2,44,42,72
17,r_50_87_37,r_17_113_109,r_80_123_119,r_50_87_37,0.82,2,39,37,72
3,r_149_67_141,r_78_6_138,r_14_51_19,r_149_67_141,0.46,4,145,141,72
0,r_4_84_127,r_40_63_3,seq132,r_4_84_127,0.65,7,134,127,72
23,r_125_68_68,r_35_41_182,seq100,r_125_68_68,0.88,-11,57,68,72
13,r_112_23_110,r_98_90_1,seq30,r_112_23_110,0.86,-6,104,110,72
98,seq121,r_149_67_141,r_25_7_126,r_149_67_141,0.91,0,141,141,72
42,r_33_8_159,seq135,r_79_145_148,r_33_8_159,0.62,-97,62,159,72
27,r_24_91_25,r_57_89_76,seq5,r_24_91_25,0.54,1,26,25,72
2,r_17_113_109,r_149_67_141,r_40_63_3,r_17_113_109,0.87,3,112,109,72
18,r_57_89_76,r_143_27_75,r_98_90_1,r_57_89_76,0.91,2,78,76,72
25,r_136_144_72,r_58_107_114,seq86,r_136_144_72,0.99,0,72,72,72
33,r_38_85_106,seq34,r_50_87_37,r_38_85_106,0.8,6,112,106,72
39,r_11_105_56,r_60_61_129,seq30,r_11_105_56,0.9,1,57,56,72
38,r_60_61_129,seq141,r_136_144_72,r_60_61_129,0.69,1,130,129,72
34,r_78_6_138,r_149_67_141,r_58_107_114,r_78_6_138,0.52,7,145,138,72
9,r_147_142_96,r_138_75_53,r_97_21_27,r_147_142_96,0.82,0,96,96,72
22,r_143_27_75,r_57_89_76,r_40_63_3,r_143_27_75,0.53,3,78,75,72
91,seq100,seq12,r_125_68_68,r_125_68_68,0.84,25,93,68,72
44,r_25_7_126,r_35_41_182,seq121,r_35_41_182,0.84,-69,113,182,72
12,r_88_126_52,seq5,r_48_116_195,r_88_126_52,0.99,0,52,52,72
6,r_32_99_57,r_72_69_94,r_83_139_33,r_32_99_57,0.95,0,57,57,72
35,r_47_53_103,r_40_63_3,r_77_3_85,r_77_3_85,0.6,19,104,85,72
5,r_28_109_43,seq30,r_50_87_37,r_28_109_43,0.89,12,55,43,72
36,r_0_83_93,seq53,r_50_131_63,r_0_83_93,0.66,2,95,93,73
14,r_86_113_124,r_55_68_170,r_103_132_9,r_86_113_124,0.7,27,151,124,73
8,r_133_119_77,r_22_138_109,r_103_132_9,r_133_119_77,0.53,0,77,77,73
43,r_52_128_91,seq9,seq5,r_52_128_91,0.97,2,93,91,73
25,r_70_43_52,r_133_119_77,r_103_132_9,r_103_132_9,0.99,46,55,9,73
71,seq53,r_0_83_93,seq135,r_0_83_93,0.98,2,95,93,73
21,r_126_142_119,r_147_19_151,seq135,r_126_142_119,0.83,1,120,119,73
16,r_102_96_43,r_28_63_155,r_78_107_182,r_102_96_43,1.0,1,44,43,73
5,r_147_19_151,r_124_31_10,r_52_128_91,r_52_128_91,0.52,60,151,91,73
45,r_122_60_140,seq20,seq36,r_122_60_140,0.55,8,148,140,73
19,r_87_99_141,seq14,r_124_31_10,r_87_99_141,0.67,4,145,141,73
41,r_44_81_73,r_148_85_71,seq9,r_44_81_73,0.91,4,77,73,73
31,r_137_4_50,r_24_16_108,seq12,r_137_4_50,0.53,5,55,50,73
3,r_110_115_69,seq9,seq23,r_110_115_69,0.89,8,77,69,73
26,r_41_76_87,r_118_18_62,r_29_13_178,r_41_76_87,0.69,20,107,87,73
0,r_105_45_162,r_38_2_191,r_37_117_75,r_105_45_162,0.52,1,163,162,73
11,r_55_68_170,seq1,r_78_107_182,r_55_68_170,0.47,2,172,170,73
20,r_42_90_53,r_41_76_87,seq14,r_42_90_53,0.79,7,60,53,73
13,r_28_63_155,seq23,r_38_2_191,r_28_63_155,0.48,3,158,155,73
15,r_46_100_64,r_105_45_162,r_78_107_182,r_46_100_64,1.0,0,64,64,73
27,r_125_59_46,r_21_106_158,r_124_31_10,r_125_59_46,0.89,2,48,46,73
9,r_48_57_27,r_21_106_158,r_86_113_124,r_48_57_27,0.96,1,28,27,73
2,r_130_66_147,r_147_19_151,seq64,r_147_19_151,0.91,-5,146,151,73
40,r_22_138_109,r_122_60_140,r_101_112_79,r_22_138_109,0.59,8,117,109,73
18,r_24_16_108,seq82,r_38_2_191,r_24_16_108,0.8,9,117,108,73
29,r_88_73_97,r_21_106_158,seq53,r_88_73_97,0.77,3,100,97,73
32,r_124_31_10,r_147_19_151,r_48_57_27,r_124_31_10,0.82,143,153,10,73
38,r_32_10_99,r_24_16_108,seq97,r_32_10_99,0.99,3,102,99,73
17,r_37_117_75,r_25_109_165,r_77_35_107,r_25_109_165,0.7,-62,103,165,73
49,r_78_107_182,seq5,r_102_96_43,r_102_96_43,1.0,-2,41,43,73
28,r_33_47_112,seq51,r_110_115_69,r_33_47_112,0.92,1,113,112,73
22,r_75_62_35,r_147_19_151,seq17,r_75_62_35,0.79,2,37,35,73
39,r_93_129_39,r_42_90_53,seq91,r_93_129_39,0.86,5,44,39,73
44,r_58_72_167,seq11,r_48_57_27,r_48_57_27,0.89,144,171,27,73
8,r_127_83_105,r_39_54_14,r_143_18_52,r_143_18_52,0.85,69,121,52,74
71,seq44,r_100_17_187,r_114_67_70,r_114_67_70,0.97,15,85,70,74
16,r_90_55_104,r_39_54_14,seq128,r_90_55_104,0.89,3,107,104,74
39,r_113_62_118,r_2_81_142,r_39_54_14,r_113_62_118,0.64,1,119,118,74
42,r_145_119_120,seq16,r_122_135_79,r_145_119_120,0.51,1,121,120,74
80,seq80,r_48_126_122,seq11,r_48_126_122,0.94,0,122,122,74
14,r_47_76_45,r_8_140_111,seq36,r_47_76_45,0.91,1,46,45,74
43,r_7_78_38,seq93,seq84,r_7_78_38,0.98,11,49,38,74
37,r_121_38_25,seq36,seq133,r_121_38_25,0.97,1,26,25,74
41,r_114_67_70,r_8_140_111,seq44,r_114_67_70,0.96,0,70,70,74
10,r_106_10_7,r_130_53_28,r_42_138_98,r_42_138_98,0.66,21,119,98,74
26,r_31_71_148,seq89,r_106_10_7,r_31_71_148,0.63,0,148,148,74
4,r_56_64_154,r_129_21_158,r_115_116_192,r_129_21_158,0.29,-2,156,158,74
13,r_42_138_98,seq11,r_106_10_7,r_42_138_98,0.62,1,99,98,74
48,r_51_98_156,seq79,r_85_111_54,r_85_111_54,0.63,102,156,54,74
29,r_141_15_48,r_39_54_14,seq40,r_141_15_48,0.95,1,49,48,74
17,r_130_53_28,r_106_10_7,r_129_21_158,r_130_53_28,0.71,0,28,28,74
2,r_123_29_184,seq3,r_41_69_24,r_41_69_24,0.97,162,186,24,74
47,r_59_104_64,seq61,seq43,r_59_104_64,0.92,4,68,64,74
18,r_49_144_103,seq40,r_122_135_79,r_49_144_103,0.82,3,106,103,74
33,r_23_70_164,r_100_17_187,r_41_69_24,r_41_69_24,0.58,141,165,24,74
10,r_106_10_7,r_42_138_98,r_31_71_148,r_31_71_148,1.0,-4,144,148,74
32,r_45_112_140,r_123_29_184,r_139_46_124,r_123_29_184,0.77,-43,141,184,74
34,r_63_24_130,seq93,r_60_92_139,r_63_24_130,0.61,0,130,130,74
9,r_8_140_111,seq19,r_122_135_79,r_8_140_111,0.85,1,112,111,74
22,r_143_18_52,r_27_20_83,r_127_83_105,r_27_20_83,0.86,-28,55,83,74
44,r_48_126_122,seq80,r_141_15_48,r_48_126_122,0.59,0,122,122,74
23,r_5_22_41,seq84,seq77,r_5_22_41,0.72,42,83,41,74
5,r_105_88_42,r_27_20_83,r_130_53_28,r_27_20_83,0.53,-34,49,83,74
82,seq84,r_5_22_41,r_7_78_38,r_7_78_38,0.98,45,83,38,74
79,seq79,r_51_98_156,r_127_83_105,r_51_98_156,0.99,0,156,156,74
35,r_139_46_124,r_115_116_192,seq61,r_139_46_124,0.5,4,128,124,74
12,r_27_20_83,r_63_24_130,seq26,r_27_20_83,0.91,0,83,83,74
45,r_85_111_54,r_39_54_14,r_121_38_25,r_39_54_14,0.97,40,54,14,74
36,r_75_145_164,r_7_83_195,seq9,r_7_83_195,0.69,-20,175,195,75
43,r_143_101_105,seq27,r_104_51_58,r_104_51_58,1.0,49,107,58,75
10,r_44_39_33,r_118_36_183,seq128,r_118_36_183,0.77,-131,52,183,75
26,r_98_140_40,r_82_11_89,r_44_39_33,r_98_140_40,1.0,0,40,40,75
71,seq42,r_103_13_177,r_81_120_147,r_81_120_147,0.9,6,153,147,75
21,r_114_59_80,r_146_73_128,r_141_126_8,r_146_73_128,1.0,-42,86,128,75
30,r_105_122_23,r_81_120_147,seq60,r_105_122_23,0.99,0,23,23,75
37,r_37_31_29,r_81_120_147,r_8_22_171,r_37_31_29,1.0,1,30,29,75
45,r_103_13_177,r_67_38_129,r_104_51_58,r_104_51_58,1.0,124,182,58,75
3,r_146_73_128,r_34_142_28,r_16_144_37,r_34_142_28,0.99,100,128,28,75
40,r_16_144_37,r_146_73_128,seq2,r_16_144_37,0.98,0,37,37,75
4,r_81_120_147,r_7_83_195,seq42,r_81_120_147,0.88,0,147,147,75
73,seq45,r_85_24_173,r_99_97_84,r_99_97_84,0.59,15,99,84,75
98,seq124,r_117_132_18,r_148_90_161,r_117_132_18,0.68,108,126,18,75
18,r_104_51_58,r_57_53_113,seq29,r_104_51_58,0.73,0,58,58,75
6,r_96_116_159,seq2,r_62_6_191,r_96_116_159,0.74,0,159,159,75
48,r_61_119_11,r_88_0_9,r_141_126_8,r_61_119_11,0.82,7,18,11,75
27,r_57_53_113,r_75_145_164,r_62_6_191,r_57_53_113,0.99,0,113,113,75
2,r_99_97_84,r_19_134_169,seq45,r_99_97_84,0.58,2,86,84,75
29,r_85_24_173,seq48,r_57_53_113,r_57_53_113,1.0,61,174,113,75
46,r_84_125_30,r_118_36_183,seq60,r_84_125_30,1.0,0,30,30,75
33,r_110_147_90,r_57_53_113,r_79_100_137,r_79_100_137,0.75,-47,90,137,75
32,r_49_135_188,r_111_15_10,r_26_74_101,r_111_15_10,0.32,178,188,10,75
15,r_30_121_46,r_146_73_128,seq10,r_30_121_46,0.88,1,47,46,75
17,r_136_1_178,seq72,r_99_97_84,r_99_97_84,0.73,94,178,84,75
22,r_91_35_134,r_67_38_129,r_44_39_33,r_91_35_134,0.94,1,135,134,75
7,r_26_74_101,seq115,r_127_63_152,r_127_63_152,0.95,27,179,152,75
44,r_4_133_136,r_81_120_147,r_99_97_84,r_99_97_84,0.61,52,136,84,75
23,r_130_65_143,r_62_6_191,r_146_73_128,r_62_6_191,1.0,-48,143,191,75
79,seq60,r_123_87_98,r_105_122_23,r_105_122_23,1.0,58,81,23,75
38,r_88_0_9,r_61_119_11,r_8_22_171,r_88_0_9,0.77,9,18,9,75
12,r_127_63_152,r_49_135_188,r_26_74_101,r_127_63_152,0.83,0,152,152,75
30,r_51_65_138,seq30,r_88_67_44,r_51_65_138,0.49,0,138,138,76
14,r_130_71_57,r_102_144_79,r_75_116_64,r_130_71_57,0.89,3,60,57,76
8,r_35_124_123,r_129_76_164,r_95_10_112,r_35_124_123,0.79,0,123,123,76
43,r_97_109_175,r_22_45_26,r_141_7_15,r_141_7_15,0.86,160,175,15,76
16,r_95_10_112,seq105,r_81_137_37,r_95_10_112,0.56,3,115,112,76
1,r_47_34_108,seq139,r_82_48_56,r_47_34_108,0.93,0,108,108,76
46,r_40_92_143,r_11_38_171,r_108_122_110,r_11_38_171,0.71,-27,144,171,76
24,r_42_33_30,r_22_45_26,seq8,r_42_33_30,0.89,-3,27,30,76
19,r_82_48_56,r_66_52_92,r_113_117_163,r_66_52_92,0.73,-24,68,92,76
22,r_55_142_14,r_129_76_164,r_88_67_44,r_88_67_44,0.97,-29,15,44,76
76,seq72,seq96,r_75_116_64,r_75_116_64,1.0,3,67,64,76
31,r_84_43_121,seq17,seq44,r_84_43_121,0.71,1,122,121,76
3,r_149_73_128,seq112,seq30,r_149_73_128,0.52,5,133,128,76
10,r_91_140_150,r_129_76_164,r_66_52_92,r_129_76_164,0.92,-11,153,164,76
26,r_5_23_101,seq103,seq28,r_5_23_101,0.84,5,106,101,76
23,r_13_138_41,r_50_110_190,r_22_45_26,r_13_138_41,0.86,1,42,41,76
4,r_98_12_114,r_131_143_149,r_5_23_101,r_131_143_149,1.0,-35,114,149,76
0,r_11_38_171,r_40_92_143,r_98_12_114,r_98_12_114,0.46,30,144,114,76
0,r_11_38_171,r_98_12_114,seq139,r_98_12_114,0.64,60,174,114,76
11,r_29_9_151,seq30,r_88_67_44,r_29_9_151,0.55,3,154,151,76
20,r_66_52_92,seq16,seq147,r_66_52_92,0.82,2,94,92,76
82,seq90,seq8,r_94_132_29,r_94_132_29,0.97,16,45,29,76
15,r_87_14_53,r_39_3_161,seq70,r_87_14_53,0.71,2,55,53,76
12,r_39_3_161,r_20_53_9,r_21_1_91,r_20_53_9,0.83,152,161,9,76
6,r_107_145_118,r_59_148_66,r_37_31_55,r_59_148_66,0.38,62,128,66,76
21,r_20_53_9,r_39_3_161,r_47_34_108,r_20_53_9,0.67,152,161,9,76
27,r_36_104_185,r_69_32_97,r_47_34_108,r_47_34_108,0.94,78,186,108,76
25,r_81_137_37,r_11_38_171,seq49,r_81_137_37,0.87,-10,27,37,76
2,r_129_76_164,r_91_140_150,r_47_34_108,r_129_76_164,0.87,-11,153,164,76
47,r_128_77_136,seq2,seq106,r_128_77_136,0.67,0,136,136,76
40,r_75_116_64,r_36_104_185,seq72,r_75_116_64,0.99,2,66,64,76
18,r_119_68_133,seq86,r_93_74_119,r_119_68_133,0.73,3,136,133,76
34,r_78_118_77,r_39_3_161,r_88_67_44,r_39_3_161,0.61,-70,91,161,76
9,r_131_143_149,r_97_109_175,r_35_124_123,r_131_143_149,0.44,6,155,149,76
28,r_102_144_79,r_51_65_138,r_13_138_41,r_102_144_79,0.98,0,79,79,76
5,r_94_132_29,r_119_68_133,seq90,r_94_132_29,0.88,-2,27,29,76
49,r_93_74_119,r_11_38_171,seq105,r_93_74_119,0.49,2,121,119,76
56,seq16,r_66_52_92,r_37_31_55,r_66_52_92,0.46,2,94,92,76
44,r_46_60_84,r_128_77_136,r_69_32_97,r_128_77_136,0.68,-46,90,136,76
35,r_59_148_66,r_88_67_44,r_107_145_118,r_59_148_66,0.54,3,69,66,76
36,r_92_88_169,seq43,r_35_0_62,r_35_0_62,1.0,107,169,62,77
14,r_71_52_131,r_141_132_122,r_67_123_48,r_71_52_131,0.53,-9,122,131,77
8,r_39_14_134,r_112_148_110,r_24_34_139,r_112_148_110,0.51,0,110,110,77
43,r_49_81_120,r_80_60_71,r_7_21_74,r_80_60_71,0.95,51,122,71,77
1,r_35_0_62,r_42_68_144,r_78_15_58,r_35_0_62,0.86,0,62,62,77
42,r_70_33_118,r_54_113_193,r_67_123_48,r_54_113_193,0.57,-74,119,193,77
45,r_19_36_173,seq30,r_77_130_51,r_77_130_51,0.83,125,176,51,77
19,r_91_96_164,seq40,r_28_2_35,r_91_96_164,0.59,0,164,164,77
31,r_42_68_144,seq86,r_114_20_66,r_114_20_66,0.98,80,146,66,77
3,r_112_148_110,r_39_14_134,r_78_15_58,r_78_15_58,0.74,52,110,58,77
11,r_67_123_48,r_99_72_196,seq30,r_67_123_48,1.0,0,48,48,77
4,r_108_17_26,r_24_34_139,r_55_93_167,r_108_17_26,0.93,1,27,26,77
16,r_53_59_55,r_18_5_183,seq129,r_53_59_55,0.98,2,57,55,77
13,r_98_44_172,r_128_27_4,r_112_148_110,r_112_148_110,0.71,64,174,110,77
27,r_144_48_83,seq13,seq66,r_144_48_83,0.99,1,84,83,77
26,r_62_116_20,r_117_134_136,seq146,r_62_116_20,0.66,-5,15,20,77
2,r_117_134_136,r_19_36_173,r_49_81_120,r_117_134_136,0.83,0,136,136,77
47,r_7_21_74,seq66,seq26,r_7_21_74,0.99,0,74,74,77
28,r_9_140_12,r_71_52_131,seq16,r_9_140_12,0.82,-1,11,12,77
40,r_114_20_66,r_29_50_107,seq65,r_114_20_66,1.0,0,66,66,77
25,r_147_127_163,seq149,r_67_123_48,r_67_123_48,0.56,118,166,48,77
7,r_124_89_82,r_39_14_134,seq13,r_39_14_134,0.89,1,135,134,77
39,r_121_31_53,r_77_130_51,r_75_3_19,r_75_3_19,0.82,40,59,19,77
32,r_141_132_122,r_71_52_131,r_35_0_62,r_35_0_62,0.93,60,122,62,77
38,r_18_5_183,seq84,r_117_134_136,r_18_5_183,0.35,0,183,183,77
77,seq66,r_11_47_1,r_144_48_83,r_144_48_83,0.99,0,83,83,77
23,r_78_15_58,r_8_118_162,seq41,r_78_15_58,1.0,0,58,58,77
34,r_28_2_35,r_8_118_162,r_62_116_20,r_62_116_20,0.61,70,90,20,77
6,r_61_51_39,r_117_134_136,seq58,r_61_51_39,0.93,1,40,39,77
17,r_6_104_165,seq41,r_117_134_136,r_6_104_165,0.54,1,166,165,77
5,r_95_126_52,r_117_134_136,seq86,r_95_126_52,0.64,5,57,52,77
9,r_8_118_162,r_128_27_4,r_124_89_82,r_124_89_82,0.95,77,159,82,77
49,r_122_90_94,r_8_118_162,r_78_15_58,r_8_118_162,1.0,-68,94,162,77
0,r_77_130_51,r_121_31_53,r_73_45_91,r_73_45_91,0.64,-32,59,91,77
7,r_124_89_82,r_99_72_196,r_39_14_134,r_124_89_82,0.91,0,82,82,77
44,r_107_94_140,r_54_113_193,seq10,r_107_94_140,0.72,0,140,140,77
12,r_106_131_179,seq30,r_137_135_145,r_106_131_179,0.35,2,181,179,77
84,seq84,r_18_5_183,r_78_15_58,r_78_15_58,0.98,55,113,58,77
30,r_92_36_132,r_48_32_81,r_77_15_44,r_48_32_81,0.96,51,132,81,78
25,r_7_140_19,r_148_124_196,seq9,r_7_140_19,0.88,-1,18,19,78
14,r_18_126_171,r_99_134_180,r_26_120_152,r_18_126_171,0.26,1,172,171,78
8,r_99_134_180,seq12,r_48_32_81,r_99_134_180,0.35,3,183,180,78
17,r_110_22_23,r_95_115_195,seq44,r_110_22_23,0.8,-1,22,23,78
13,r_77_15_44,r_26_120_152,seq85,r_77_15_44,0.97,-1,43,44,78
21,r_45_143_191,r_79_68_153,r_1_69_197,r_79_68_153,0.98,-1,152,153,78
34,r_127_39_52,r_101_3_199,r_84_96_31,r_127_39_52,0.94,0,52,52,78
67,seq27,seq129,r_7_140_19,r_7_140_19,0.91,101,120,19,78
47,r_24_71_28,r_26_120_152,r_90_55_7,r_24_71_28,0.65,0,28,28,78
10,r_31_111_74,r_0_40_85,seq75,r_31_111_74,0.93,0,74,74,78
11,r_79_68_153,r_45_143_191,r_43_149_51,r_79_68_153,0.54,-1,152,153,78
5,r_135_113_16,r_98_61_56,seq19,r_135_113_16,0.91,-2,14,16,78
15,r_41_42_181,r_29_49_1,r_31_111_74,r_31_111_74,1.0,109,183,74,78
48,r_112_87_130,seq44,r_37_54_9,r_112_87_130,0.62,2,132,130,78
18,r_67_82_156,seq129,r_148_124_196,r_67_82_156,0.55,0,156,156,78
33,r_138_78_150,r_99_134_180,r_135_113_16,r_99_134_180,0.36,-30,150,180,78
29,r_98_61_56,seq9,r_101_3_199,r_98_61_56,0.69,-1,55,56,78
32,r_23_73_61,r_99_134_180,seq6,r_23_73_61,1.0,0,61,61,78
9,r_2_70_93,seq89,r_29_49_1,r_2_70_93,0.43,45,138,93,78
28,r_147_141_133,seq128,seq76,r_147_141_133,0.86,0,133,133,78
49,r_144_106_111,seq72,r_7_140_19,r_7_140_19,0.73,95,114,19,78
44,r_53_4_65,r_26_120_152,seq75,r_53_4_65,0.99,0,65,65,78
27,r_102_62_57,seq19,seq89,r_102_62_57,0.53,-20,37,57,78
12,r_14_121_137,seq133,r_148_124_196,r_14_121_137,0.74,1,138,137,78
30,r_74_61_164,r_17_127_162,r_139_143_149,r_139_143_149,0.69,16,165,149,79
36,r_122_131_78,r_114_91_140,r_89_46_66,r_122_131_78,0.71,1,79,78,79
60,seq15,r_134_140_23,r_121_147_50,r_121_147_50,1.0,-1,49,50,79
37,r_17_127_162,seq141,r_43_12_26,r_43_12_26,0.73,140,166,26,79
26,r_121_147_50,seq126,seq15,r_121_147_50,0.83,0,50,50,79
1,r_139_143_149,seq47,r_105_42_76,r_105_42_76,0.74,89,165,76,79
6,r_65_144_53,r_0_145_34,seq141,r_65_144_53,0.63,-11,42,53,79
45,r_34_133_79,seq50,seq1,r_34_133_79,0.45,0,79,79,79
27,r_43_12_26,r_89_46_66,seq8,r_43_12_26,0.6,-1,25,26,79
5,r_16_119_24,r_111_78_102,seq15,r_111_78_102,0.54,-77,25,102,79
91,seq99,r_118_59_135,r_149_58_15,r_149_58_15,0.69,4,19,15,79
31,r_101_124_94,seq4,seq132,r_101_124_94,0.54,-5,89,94,79
4,r_89_46_66,r_108_135_80,r_62_68_39,r_108_135_80,0.78,-14,66,80,79
0,r_29_106_124,r_137_57_198,r_24_73_90,r_24_73_90,0.58,34,124,90,79
11,r_114_91_140,r_37_23_169,r_96_45_4,r_96_45_4,0.88,161,165,4,79
15,r_31_146_100,r_24_73_90,r_88_72_58,r_31_146_100,0.64,4,104,100,79
48,r_13_38_89,seq49,r_43_12_26,r_13_38_89,0.61,-12,77,89,79
29,r_123_93_7,r_35_130_188,r_139_143_149,r_35_130_188,0.46,1,189,188,79
24,r_28_125_139,r_9_53_191,r_29_106_124,r_29_106_124,0.83,20,144,124,79
25,r_105_42_76,r_110_116_154,seq64,r_105_42_76,0.92,-6,70,76,79
23,r_80_27_65,r_114_91_140,r_149_58_15,r_149_58_15,0.83,43,58,15,79
17,r_108_135_80,seq6,r_52_94_28,r_108_135_80,0.82,-10,70,80,79
13,r_86_103_52,r_114_91_140,seq47,r_86_103_52,0.65,-6,46,52,79
9,r_134_140_23,seq15,r_138_70_71,r_138_70_71,0.95,0,71,71,79
44,r_118_59_135,seq126,r_29_106_124,r_29_106_124,0.63,14,138,124,79
18,r_11_148_43,r_137_57_198,r_134_140_23,r_11_148_43,0.78,-3,40,43,79
12,r_138_70_71,r_114_91_140,r_134_140_23,r_138_70_71,0.81,-1,70,71,79
8,r_17_148_98,r_35_82_140,r_19_135_153,r_17_148_98,0.46,0,98,98,80
8,r_17_148_98,r_19_135_153,r_2_119_12,r_17_148_98,0.69,46,144,98,80
39,r_73_38_179,r_84_90_186,r_78_66_95,r_78_66_95,0.98,91,186,95,80
5,r_94_118_88,r_87_120_107,seq128,r_94_118_88,0.58,2,90,88,80
24,r_39_59_22,r_13_20_172,r_111_108_124,r_39_59_22,0.36,161,183,22,80
19,r_25_54_155,seq45,r_2_119_12,r_25_54_155,0.36,1,156,155,80
31,r_92_79_96,r_49_72_29,r_70_88_35,r_49_72_29,1.0,69,98,29,80
41,r_43_115_118,r_10_75_128,seq116,r_43_115_118,0.47,0,118,118,80
63,seq26,r_102_93_94,r_9_139_93,r_9_139_93,0.7,8,101,93,80
20,r_10_75_128,r_15_16_173,seq14,r_10_75_128,0.47,-6,122,128,80
13,r_19_135_153,r_5_24_63,r_17_148_98,r_19_135_153,0.44,-63,90,153,80
13,r_19_135_153,r_17_148_98,r_97_76_47,r_19_135_153,0.9,2,155,153,80
47,r_70_88_35,r_49_72_29,r_10_75_128,r_70_88_35,0.87,1,36,35,80
22,r_13_20_172,r_39_59_22,r_112_50_89,r_39_59_22,0.46,161,183,22,80
18,r_15_16_173,seq27,r_25_54_155,r_15_16_173,0.35,5,178,173,80
25,r_9_139_93,r_5_24_63,r_87_120_107,r_9_139_93,0.72,5,98,93,80
47,r_70_88_35,r_10_75_128,r_92_79_96,r_70_88_35,0.86,87,122,35,80
34,r_107_6_158,r_100_121_167,r_78_66_95,r_78_66_95,0.69,64,159,95,80
24,r_39_59_22,r_47_95_64,r_13_20_172,r_39_59_22,0.65,3,25,22,80
17,r_84_90_186,r_73_38_179,r_5_24_63,r_5_24_63,0.7,123,186,63,80
22,r_13_20_172,r_3_36_65,r_39_59_22,r_3_36_65,0.55,4,69,65,80
28,r_3_36_65,r_13_20_172,r_5_24_63,r_3_36_65,0.88,4,69,65,80
7,r_111_108_124,r_28_62_139,r_39_59_22,r_28_62_139,0.52,-6,133,139,80
44,r_147_12_127,r_56_34_97,r_5_24_63,r_56_34_97,0.64,32,129,97,80
23,r_78_66_95,r_11_101_191,r_67_1_78,r_78_66_95,0.7,3,98,95,80
35,r_67_1_78,r_5_24_63,r_78_66_95,r_67_1_78,0.72,12,90,78,80
12,r_100_121_167,r_107_6_158,r_133_31_7,r_107_6_158,0.66,1,159,158,80
14,r_80_141_114,r_26_66_89,r_53_28_51,r_80_141_114,0.9,3,117,114,81
23,r_94_86_31,r_70_24_198,seq146,r_94_86_31,0.98,1,32,31,81
1,r_74_130_63,seq5,seq83,r_74_130_63,0.87,0,63,63,81
5,r_44_129_110,r_26_66_89,r_65_115_52,r_26_66_89,0.63,22,111,89,81
46,r_75_123_141,seq128,r_107_142_66,r_75_123_141,0.77,1,142,141,81
42,r_33_140_156,r_126_30_196,r_13_131_88,r_13_131_88,0.89,77,165,88,81
31,r_107_142_66,r_112_50_104,r_126_30_196,r_126_30_196,0.43,-125,71,196,81
71,seq51,r_88_95_115,r_92_63_11,r_92_63_11,0.89,1,12,11,81
0,r_88_95_115,seq41,r_8_149_46,r_8_149_46,0.99,67,113,46,81
20,r_98_42_130,r_36_67_127,r_69_76_56,r_69_76_56,0.93,83,139,56,81
13,r_110_109_129,r_136_72_172,r_74_130_63,r_136_72_172,0.51,-43,129,172,81
17,r_53_28_51,r_70_24_198,seq41,r_53_28_51,1.0,1,52,51,81
6,r_29_6_101,r_147_0_182,seq89,r_29_6_101,0.95,1,102,101,81
62,seq20,r_147_0_182,r_44_129_110,r_44_129_110,1.0,63,173,110,81
41,r_8_149_46,r_119_21_105,seq52,r_8_149_46,0.98,0,46,46,81
47,r_136_72_172,r_138_55_138,r_74_130_63,r_136_72_172,0.75,1,173,172,81
37,r_65_115_52,seq89,seq20,r_65_115_52,1.0,0,52,52,81
27,r_137_31_74,r_44_129_110,r_70_24_198,r_137_31_74,0.94,2,76,74,81
47,r_136_72_172,r_110_109_129,r_138_55_138,r_110_109_129,0.87,0,129,129,81
40,r_3_45_162,seq125,r_74_130_63,r_74_130_63,1.0,102,165,63,81
18,r_69_76_56,seq71,seq83,r_69_76_56,1.0,4,60,56,81
15,r_144_39_53,r_44_129_110,seq143,r_144_39_53,0.5,0,53,53,81
9,r_43_148_41,r_70_24_198,r_22_135_171,r_43_148_41,0.98,0,41,41,81
32,r_147_0_182,seq20,seq89,r_147_0_182,0.22,8,190,182,81
81,seq89,r_13_131_88,r_29_6_101,r_29_6_101,1.0,6,107,101,81
28,r_92_63_11,r_122_17_3,seq51,r_92_63_11,0.79,1,12,11,81
45,r_105_113_42,r_47_108_36,seq128,r_105_113_42,0.99,0,42,42,81
22,r_32_34_154,seq4,seq23,r_32_34_154,0.66,3,157,154,81
49,r_15_102_121,r_112_50_104,r_38_85_157,r_38_85_157,0.75,-18,139,157,81
35,r_9_84_169,seq35,r_122_17_3,r_122_17_3,0.72,168,171,3,81
20,r_90_92_37,r_5_95_132,r_54_93_127,r_54_93_127,0.96,-86,41,127,82
8,r_65_36_126,r_143_124_134,r_59_22_194,r_59_22_194,0.95,-65,129,194,82
43,r_133_126_123,seq20,r_55_58_159,r_55_58_159,0.88,-35,124,159,82
54,seq4,r_130_119_81,r_56_42_79,r_56_42_79,0.45,10,89,79,82
18,r_34_99_6,r_121_104_9,r_70_87_63,r_34_99_6,0.66,50,56,6,82
21,r_105_18_110,seq129,seq30,r_105_18_110,0.78,2,112,110,82
39,r_54_93_127,r_145_49_112,r_90_92_37,r_90_92_37,1.0,77,114,37,82
23,r_149_16_19,seq4,seq3,r_149_16_19,0.96,0,19,19,82
5,r_7_100_119,seq128,r_138_63_172,r_7_100_119,0.71,2,121,119,82
19,r_86_68_100,seq98,r_66_71_4,r_86_68_100,0.72,4,104,100,82
7,r_89_24_44,r_84_15_188,seq91,r_89_24_44,0.88,10,54,44,82
31,r_8_47_113,seq91,seq106,r_8_47_113,0.7,0,113,113,82
3,r_5_95_132,r_75_94_199,seq81,r_5_95_132,0.67,0,132,132,82
90,seq97,r_19_39_154,r_1_76_45,r_1_76_45,1.0,112,157,45,82
4,r_10_46_15,r_133_126_123,r_52_51_16,r_52_51_16,0.77,-2,14,16,82
0,r_45_127_179,r_116_101_7,r_5_95_132,r_5_95_132,0.71,47,179,132,82
13,r_75_94_199,r_5_95_132,r_140_50_25,r_75_94_199,0.77,-67,132,199,82
44,r_110_9_46,r_19_39_154,seq64,r_110_9_46,0.74,5,51,46,82
48,r_83_41_166,seq81,r_88_48_168,r_88_48_168,0.69,2,170,168,82
17,r_6_146_43,r_114_107_1,r_116_101_7,r_6_146_43,1.0,8,51,43,82
46,r_1_76_45,seq139,seq97,r_1_76_45,1.0,6,51,45,82
27,r_56_42_79,seq53,seq4,r_56_42_79,0.41,13,92,79,82
2,r_143_124_134,r_111_11_77,r_85_109_62,r_85_109_62,0.66,72,134,62,82
47,r_12_27_139,seq136,r_66_71_4,r_66_71_4,0.59,139,143,4,82
29,r_26_79_89,r_143_124_134,r_10_46_15,r_26_79_89,0.68,0,89,89,82
24,r_35_141_121,seq20,r_34_99_6,r_35_141_121,0.65,0,121,121,82
33,r_116_101_7,r_45_127_179,r_140_50_25,r_140_50_25,0.97,154,179,25,82
32,r_118_122_39,r_35_141_121,r_140_50_25,r_118_122_39,0.93,4,43,39,82
6,r_140_50_25,r_145_49_112,seq139,r_140_50_25,0.85,0,25,25,82
34,r_70_87_63,r_117_29_99,r_34_99_6,r_70_87_63,0.63,6,69,63,82
9,r_19_39_154,seq97,r_10_46_15,r_10_46_15,0.46,142,157,15,82
28,r_43_123_54,seq3,r_10_46_15,r_43_123_54,1.0,1,55,54,82
36,r_144_98_161,seq12,r_47_148_62,r_47_148_62,1.0,99,161,62,83
14,r_4_103_149,r_40_63_10,r_34_82_92,r_4_103_149,0.48,4,153,149,83
54,seq136,r_35_15_137,r_10_129_47,r_35_15_137,0.87,1,138,137,83
26,r_55_83_24,r_40_63_10,seq97,r_55_83_24,0.99,-3,21,24,83
55,seq12,r_144_98_161,r_70_66_115,r_144_98_161,0.99,0,161,161,83
16,r_147_74_154,r_9_62_173,r_43_50_196,r_147_74_154,0.55,3,157,154,83
1,r_67_3_91,seq28,seq134,r_67_3_91,1.0,2,93,91,83
5,r_35_15_137,seq136,seq2,r_35_15_137,0.88,1,138,137,83
46,r_42_37_135,r_89_112_160,r_67_3_91,r_67_3_91,0.99,47,138,91,83
45,r_116_124_86,r_147_74_154,r_122_26_73,r_116_124_86,0.69,3,89,86,83
13,r_140_137_41,r_128_110_1,seq57,r_140_137_41,0.6,1,42,41,83
11,r_149_81_81,r_101_130_80,r_102_33_177,r_149_81_81,0.6,10,91,81,83
20,r_101_130_80,r_149_81_81,seq77,r_149_81_81,0.76,10,91,81,83
48,r_56_85_68,r_49_127_124,seq36,r_56_85_68,1.0,0,68,68,83
29,r_34_82_92,r_128_110_1,r_92_138_28,r_34_82_92,0.63,4,96,92,83
24,r_46_75_167,seq36,r_115_1_118,r_115_1_118,1.0,53,171,118,83
33,r_139_125_126,r_128_110_1,r_14_5_96,r_14_5_96,0.79,40,136,96,83
31,r_114_105_27,r_115_1_118,seq69,r_114_105_27,0.75,3,30,27,83
34,r_111_131_67,r_14_5_96,seq0,r_111_131_67,0.66,12,79,67,83
9,r_7_78_88,seq17,r_34_82_92,r_7_78_88,0.4,23,111,88,83
22,r_58_107_71,r_115_1_118,seq48,r_58_107_71,0.69,1,72,71,83
28,r_22_60_142,seq134,r_70_66_115,r_22_60_142,0.24,4,146,142,83
35,r_89_112_160,r_106_132_45,r_128_110_1,r_128_110_1,0.56,160,161,1,83
32,r_65_141_16,r_49_127_124,r_128_110_1,r_65_141_16,0.55,26,42,16,83
14,r_119_36_180,seq129,r_112_91_47,r_119_36_180,0.36,0,180,180,84
16,r_26_110_71,r_76_41_197,r_50_107_22,r_50_107_22,0.79,52,74,22,84
21,r_61_47_76,r_34_66_183,r_90_86_4,r_61_47_76,0.95,2,78,76,84
46,r_68_92_66,r_102_38_107,r_26_110_71,r_26_110_71,0.96,0,71,71,84
45,r_49_99_90,seq45,r_111_96_54,r_49_99_90,0.93,2,92,90,84
49,r_136_6_24,r_22_71_162,seq129,r_136_6_24,0.88,3,27,24,84
31,r_130_80_123,r_78_85_165,r_76_41_197,r_130_80_123,0.79,2,125,123,84
41,r_143_87_72,r_49_99_90,r_26_110_71,r_143_87_72,0.78,2,74,72,84
10,r_22_71_162,r_16_12_188,seq135,r_16_12_188,0.56,-18,170,188,84
26,r_148_83_177,seq100,r_123_31_137,r_123_31_137,0.79,43,180,137,84
6,r_112_91_47,r_0_60_57,seq138,r_112_91_47,0.96,11,58,47,84
8,r_0_60_57,r_89_77_127,r_103_33_5,r_89_77_127,0.63,-70,57,127,84
42,r_132_55_33,r_123_31_137,seq122,r_132_55_33,0.93,3,36,33,84
27,r_108_128_61,seq40,r_149_48_20,r_149_48_20,0.77,58,78,20,84
2,r_54_142_113,r_119_36_180,r_26_110_71,r_54_142_113,0.85,6,119,113,84
40,r_141_120_117,r_123_31_137,r_106_70_93,r_123_31_137,0.71,-11,126,137,84
75,seq58,seq40,r_105_145_17,r_105_145_17,0.54,27,44,17,84
29,r_147_53_143,r_22_71_162,r_29_75_32,r_29_75_32,0.54,129,161,32,84
33,r_102_38_107,r_137_133_136,r_7_11_67,r_7_11_67,0.99,40,107,67,84
1,r_111_96_54,r_78_85_165,seq25,r_78_85_165,0.66,-109,56,165,84
38,r_137_133_136,seq64,seq93,r_137_133_136,0.7,0,136,136,84
22,r_17_28_15,r_34_66_183,seq64,r_17_28_15,0.73,-1,14,15,84
94,seq118,r_57_14_79,r_149_48_20,r_57_14_79,0.85,0,79,79,84
9,r_117_113_140,r_63_62_195,seq134,r_117_113_140,0.57,1,141,140,84
28,r_15_52_51,r_37_69_50,r_7_11_67,r_7_11_67,0.99,3,70,67,84
7,r_7_11_67,seq122,r_15_52_51,r_7_11_67,0.97,0,67,67,84
30,r_93_125_151,r_30_81_126,r_82_6_37,r_93_125_151,0.92,-33,118,151,85
4,r_4_17_24,r_18_128_85,seq138,r_4_17_24,0.71,5,29,24,85
36,r_83_149_156,seq86,seq1,r_83_149_156,0.43,0,156,156,85
43,r_109_139_175,r_65_99_183,r_114_52_100,r_114_52_100,0.85,76,176,100,85
26,r_111_123_46,r_42_135_194,seq49,r_111_123_46,0.98,1,47,46,85
16,r_50_101_90,r_122_28_179,seq13,r_50_101_90,0.7,2,92,90,85
5,r_18_128_85,r_136_91_36,seq105,r_136_91_36,0.83,49,85,36,85
46,r_30_81_126,r_93_125_151,r_85_21_105,r_93_125_151,0.79,-24,127,151,85
95,seq113,r_65_99_183,r_8_61_71,r_8_61_71,0.75,114,185,71,85
52,seq132,r_83_149_156,r_94_98_12,r_94_98_12,0.88,3,15,12,85
3,r_114_52_100,r_42_135_194,r_20_19_93,r_114_52_100,0.92,2,102,100,85
90,seq86,r_83_149_156,r_42_135_194,r_83_149_156,0.56,0,156,156,85
11,r_145_110_174,seq53,r_103_130_99,r_103_130_99,0.7,75,174,99,85
48,r_44_119_168,r_122_28_179,r_72_137_101,r_122_28_179,0.55,-8,171,179,85
27,r_85_21_105,seq49,r_94_98_12,r_85_21_105,0.79,1,106,105,85
40,r_26_115_115,r_40_27_148,r_85_21_105,r_40_27_148,1.0,-31,117,148,85
18,r_143_58_96,r_67_41_125,r_136_91_36,r_67_41_125,0.93,-27,98,125,85
33,r_116_133_173,r_104_5_191,r_121_59_53,r_121_59_53,0.56,121,174,53,85
34,r_94_98_12,r_8_61_71,seq132,r_94_98_12,0.68,1,13,12,85
17,r_0_89_106,r_122_28_179,r_82_6_37,r_0_89_106,0.87,2,108,106,85
9,r_79_11_164,seq77,r_8_61_71,r_79_11_164,0.58,0,164,164,85
1,r_82_6_37,r_24_112_176,r_4_17_24,r_82_6_37,0.99,4,41,37,85
28,r_72_137_101,seq142,seq92,r_72_137_101,0.63,25,126,101,85
41,r_10_14_22,seq144,r_100_96_184,r_10_14_22,0.95,7,29,22,85
19,r_121_59_53,r_126_95_117,seq54,r_121_59_53,0.72,5,58,53,85
35,r_67_41_125,r_143_58_96,r_82_6_37,r_67_41_125,0.86,1,126,125,85
36,r_144_116_170,seq131,r_119_93_108,r_119_93_108,0.85,62,170,108,86
14,r_0_123_149,seq112,r_119_93_108,r_119_93_108,0.67,44,152,108,86
8,r_136_71_180,r_91_78_5,r_7_52_110,r_7_52_110,0.88,71,181,110,86
53,seq9,r_124_86_169,r_84_45_190,r_124_86_169,0.43,16,185,169,86
43,r_149_95_127,seq24,r_91_78_5,r_149_95_127,0.73,4,131,127,86
20,r_43_48_47,r_72_32_89,seq139,r_43_48_47,0.73,-7,40,47,86
16,r_102_81_25,r_1_5_196,seq18,r_102_81_25,0.76,0,25,25,86
21,r_118_11_122,r_106_74_193,r_59_22_22,r_106_74_193,0.68,-66,127,193,86
39,r_73_76_113,r_84_45_190,seq14,r_84_45_190,0.9,-76,114,190,86
1,r_72_32_89,r_36_98_118,r_106_74_193,r_36_98_118,1.0,-31,87,118,86
42,r_148_126_92,r_46_38_125,r_91_78_5,r_91_78_5,0.52,86,91,5,86
41,r_13_15_109,r_28_111_130,seq61,r_13_15_109,0.75,52,161,109,86
78,seq61,r_16_103_138,r_145_113_160,r_16_103_138,0.98,0,138,138,86
13,r_119_93_108,r_97_80_117,seq147,r_119_93_108,0.84,2,110,108,86
6,r_10_33_102,r_124_86_169,r_72_32_89,r_10_33_102,0.8,-1,101,102,86
27,r_37_40_61,r_120_108_96,seq69,r_37_40_61,0.68,0,61,61,86
40,r_91_78_5,r_136_71_180,r_8_4_119,r_8_4_119,0.62,62,181,119,86
33,r_87_141_154,seq31,r_97_80_117,r_87_141_154,0.31,5,159,154,86
17,r_26_20_39,r_10_33_102,seq25,r_26_20_39,0.94,-1,38,39,86
88,seq83,r_72_32_89,r_117_85_74,r_117_85_74,1.0,1,75,74,86
58,seq143,r_120_108_96,r_114_82_95,r_114_82_95,0.61,4,99,95,86
9,r_79_92_99,seq30,seq53,r_79_92_99,0.7,-19,80,99,86
22,r_16_103_138,seq61,r_28_111_130,r_16_103_138,0.7,0,138,138,86
49,r_114_82_95,seq27,seq143,r_114_82_95,0.9,0,95,95,86
7,r_8_4_119,r_84_45_190,seq57,r_8_4_119,0.84,3,122,119,86
44,r_124_86_169,seq9,r_1_5_196,r_124_86_169,0.38,0,169,169,86
23,r_142_100_112,seq54,seq35,r_142_100_112,0.91,0,112,112,86
12,r_7_52_110,r_136_71_180,seq140,r_7_52_110,0.8,1,111,110,86
9,r_139_128_88,r_97_141_142,r_90_148_72,r_97_141_142,0.91,5,147,142,87
14,r_79_12_98,r_37_105_109,seq103,r_79_12_98,0.69,-5,93,98,87
37,r_38_57_152,seq126,r_65_87_16,r_38_57_152,0.34,7,159,152,87
42,r_104_20_66,r_107_9_199,r_30_137_31,r_104_20_66,0.75,-3,63,66,87
35,r_43_5_38,r_95_78_58,r_55_125_33,r_55_125_33,1.0,5,38,33,87
10,r_26_110_139,r_122_52_41,seq47,r_26_110_139,0.47,2,141,139,87
26,r_65_87_16,r_48_130_35,seq4,r_65_87_16,0.76,1,17,16,87
0,r_97_141_142,r_83_101_186,r_85_124_195,r_97_141_142,0.33,-1,141,142,87
73,seq56,r_37_105_109,r_64_15_178,r_64_15_178,0.79,-1,177,178,87
41,r_18_96_39,r_113_121_173,r_135_114_12,r_18_96_39,0.84,-1,38,39,87
2,r_113_121_173,r_42_49_118,r_25_127_111,r_25_127_111,0.6,65,176,111,87
47,r_39_29_126,r_122_52_41,r_79_12_98,r_39_29_126,0.65,4,130,126,87
18,r_83_101_186,seq75,r_97_141_142,r_97_141_142,0.72,47,189,142,87
17,r_93_143_15,r_113_121_173,seq75,r_93_143_15,0.71,2,17,15,87
24,r_144_86_90,seq76,seq146,r_144_86_90,0.63,1,91,90,87
33,r_118_1_177,seq103,r_135_114_12,r_118_1_177,0.41,0,177,177,87
1,r_95_78_58,r_85_124_195,r_55_125_33,r_95_78_58,0.97,-2,56,58,87
38,r_53_27_148,seq10,r_107_9_199,r_53_27_148,0.37,4,152,148,87
34,r_132_120_89,seq108,seq149,r_132_120_89,0.71,-6,83,89,87
39,r_135_114_12,r_42_49_118,seq35,r_135_114_12,0.84,1,13,12,87
13,r_109_140_34,r_79_12_98,seq50,r_109_140_34,0.89,-2,32,34,87
9,r_139_128_88,r_45_99_181,r_97_141_142,r_139_128_88,0.73,-1,87,88,87
5,r_68_51_50,r_113_121_173,r_25_127_111,r_68_51_50,0.84,-8,42,50,87
49,r_31_6_83,r_79_12_98,r_122_52_41,r_31_6_83,0.91,-2,81,83,87
7,r_90_148_72,r_144_86_90,r_93_143_15,r_90_148_72,0.78,0,72,72,87
11,r_111_72_52,seq35,seq145,r_111_72_52,0.94,-10,42,52,87
44,r_123_80_28,r_113_121_173,seq76,r_123_80_28,0.87,0,28,28,87
92,seq99,r_38_79_176,r_46_82_132,r_46_82_132,0.6,45,177,132,88
18,r_83_25_48,r_146_73_164,seq2,r_83_25_48,0.92,-4,44,48,88
43,r_104_43_120,r_55_90_118,r_135_24_83,r_104_43_120,0.67,-2,118,120,88
3,r_30_68_33,r_5_116_50,r_97_33_4,r_30_68_33,0.74,-7,26,33,88
16,r_92_22_154,seq47,r_5_116_50,r_5_116_50,0.75,104,154,50,88
21,r_125_101_163,r_146_73_164,r_55_90_118,r_55_90_118,0.84,48,166,118,88
1,r_8_117_103,r_67_74_188,r_4_120_51,r_67_74_188,0.8,-87,101,188,88
32,r_4_120_51,r_88_122_187,r_53_94_8,r_4_120_51,0.93,-1,50,51,88
22,r_106_98_58,r_44_148_114,r_30_68_33,r_106_98_58,0.91,0,58,58,88
45,r_108_128_70,r_115_76_148,seq16,r_108_128_70,0.82,-4,66,70,88
42,r_139_60_169,r_108_128_70,r_114_89_55,r_139_60_169,0.48,-111,58,169,88
31,r_112_95_29,r_53_94_8,r_146_73_164,r_112_95_29,0.69,-3,26,29,88
14,r_71_119_32,r_18_28_63,seq86,r_71_119_32,0.71,-6,26,32,88
26,r_132_27_69,seq29,r_49_129_72,r_132_27_69,0.9,-3,66,69,88
63,seq20,r_137_140_138,r_49_129_72,r_49_129_72,0.56,-10,62,72,88
20,r_46_82_132,r_126_13_119,seq99,r_126_13_119,0.91,5,124,119,88
13,r_38_79_176,seq99,r_96_48_39,r_96_48_39,0.85,138,177,39,88
15,r_113_80_88,r_115_76_148,r_9_121_40,r_113_80_88,0.75,-4,84,88,88
4,r_5_116_50,r_104_43_120,r_137_140_138,r_5_116_50,0.41,91,141,50,88
12,r_111_102_35,r_8_117_103,seq58,r_111_102_35,0.78,-9,26,35,88
30,r_56_62_41,r_5_116_50,seq143,r_56_62_41,0.84,-1,40,41,88
4,r_5_116_50,r_92_22_154,r_104_43_120,r_5_116_50,0.66,0,50,50,88
2,r_40_37_66,seq0,seq2,r_40_37_66,0.92,0,66,66,88
40,r_49_129_72,r_115_76_148,seq20,r_49_129_72,0.92,-10,62,72,88
88,seq86,r_32_147_82,r_71_119_32,r_71_119_32,0.45,-10,22,32,88
34,r_18_28_63,seq0,r_53_94_8,r_18_28_63,0.87,-5,58,63,88
33,r_35_69_85,r_38_79_176,r_4_120_51,r_35_69_85,0.61,-1,84,85,88
8,r_96_48_39,r_55_90_118,seq0,r_96_48_39,0.83,-13,26,39,88
39,r_114_89_55,r_146_73_164,r_30_68_33,r_114_89_55,0.85,0,55,55,88
17,r_135_24_83,r_9_121_40,seq66,r_135_24_83,0.91,1,84,83,88
9,r_93_84_121,r_115_76_148,r_53_94_8,r_53_94_8,0.58,122,130,8,88
28,r_55_90_118,r_104_43_120,r_44_148_114,r_55_90_118,0.52,0,118,118,88
49,r_75_136_174,seq19,r_5_116_50,r_5_116_50,0.83,124,174,50,88
7,r_115_76_148,seq133,seq39,r_115_76_148,0.59,2,150,148,88
44,r_137_140_138,seq20,r_5_116_50,r_137_140_138,0.58,2,140,138,88
23,r_63_54_64,r_92_22_154,seq144,r_63_54_64,0.51,-4,60,64,88
47,r_65_118_36,r_137_140_138,r_30_68_33,r_65_118_36,0.6,-10,26,36,88
36,r_10_104_189,r_123_28_110,seq139,r_123_28_110,0.99,2,112,110,89
8,r_21_147_134,seq3,r_123_28_110,r_21_147_134,0.78,1,135,134,89
43,r_116_126_81,r_9_54_141,seq84,r_116_126_81,0.66,2,83,81,89
37,r_110_48_92,seq95,seq55,r_110_48_92,0.91,1,93,92,89
26,r_44_2_39,r_92_62_93,seq3,r_44_2_39,0.86,8,47,39,89
40,r_43_53_15,r_34_11_89,seq95,r_43_53_15,0.59,0,15,15,89
21,r_32_30_67,r_9_54_141,seq128,r_32_30_67,0.75,5,72,67,89
39,r_91_69_144,r_124_108_10,r_44_2_39,r_124_108_10,0.68,135,145,10,89
5,r_124_108_10,r_91_69_144,r_115_22_73,r_124_108_10,0.74,82,92,10,89
46,r_113_57_75,seq141,r_70_16_44,r_113_57_75,0.99,5,80,75,89
6,r_117_146_55,r_135_71_56,r_6_97_194,r_135_71_56,0.66,0,56,56,89
35,r_125_137_24,r_63_4_34,seq59,r_125_137_24,0.84,14,38,24,89
1,r_132_93_27,r_41_5_166,seq141,r_132_93_27,0.95,3,30,27,89
67,seq38,r_24_111_162,r_19_26_179,r_24_111_162,0.52,12,174,162,89
0,r_34_11_89,seq141,r_124_108_10,r_34_11_89,0.44,0,89,89,89
11,r_9_54_141,r_134_118_9,r_74_56_6,r_9_54_141,0.64,1,142,141,89
13,r_131_15_71,r_76_27_152,r_100_29_65,r_131_15_71,0.7,1,72,71,89
15,r_23_18_70,seq121,seq45,r_23_18_70,0.95,4,74,70,89
48,r_17_33_129,r_112_49_120,r_92_62_93,r_92_62_93,0.57,44,137,93,89
38,r_67_64_37,r_135_71_56,r_132_93_27,r_135_71_56,0.7,-14,42,56,89
29,r_31_73_108,r_9_54_141,r_34_11_89,r_9_54_141,0.85,-33,108,141,89
24,r_115_22_73,r_34_11_89,r_124_108_10,r_124_108_10,0.66,63,73,10,89
25,r_13_85_117,r_6_97_194,r_74_56_6,r_13_85_117,0.51,0,117,117,89
33,r_40_114_133,seq141,r_117_146_55,r_117_146_55,0.92,82,137,55,89
32,r_63_4_34,r_66_103_84,seq8,r_63_4_34,0.54,23,57,34,89
34,r_142_78_107,r_123_28_110,r_34_11_89,r_142_78_107,0.83,1,108,107,89
2,r_68_58_47,r_24_111_162,seq3,r_68_58_47,0.82,0,47,47,89
28,r_123_28_110,r_10_104_189,r_21_147_134,r_123_28_110,0.75,2,112,110,89
49,r_39_65_131,r_6_97_194,seq95,r_39_65_131,0.66,5,136,131,89
3,r_135_71_56,r_117_146_55,r_70_16_44,r_135_71_56,0.54,0,56,56,89
7,r_6_97_194,r_39_65_131,r_117_146_55,r_6_97_194,0.89,-58,136,194,89
42,r_70_16_44,r_41_5_166,seq138,r_70_16_44,0.66,0,44,44,89
30,r_70_134_173,r_139_0_151,r_86_9_34,r_86_9_34,0.98,139,173,34,90
18,r_102_78_59,r_31_131_114,seq35,r_102_78_59,1.0,0,59,59,90
36,r_29_2_89,seq130,r_7_17_12,r_29_2_89,1.0,1,90,89,90
43,r_74_59_100,r_95_20_157,r_7_17_12,r_74_59_100,1.0,0,100,100,90
16,r_106_84_85,seq136,r_97_50_11,r_106_84_85,1.0,0,85,85,90
39,r_5_56_111,seq146,seq10,r_5_56_111,0.97,1,112,111,90
46,r_8_75_63,r_79_63_149,seq14,r_8_75_63,0.75,0,63,63,90
42,r_115_67_132,r_27_128_131,r_108_120_163,r_115_67_132,0.97,0,132,132,90
19,r_144_145_152,r_107_53_198,r_42_122_104,r_42_122_104,0.77,49,153,104,90
27,r_116_65_19,r_95_20_157,seq19,r_116_65_19,1.0,0,19,19,90
27,r_116_65_19,seq19,r_112_124_101,r_112_124_101,1.0,7,108,101,90
31,r_55_71_176,r_95_20_157,r_79_63_149,r_55_71_176,0.6,1,177,176,90
10,r_25_39_72,r_27_128_131,r_49_104_15,r_25_39_72,1.0,0,72,72,90
32,r_38_54_49,r_95_20_157,seq136,r_38_54_49,1.0,0,49,49,90
45,r_86_9_34,r_95_20_157,seq88,r_86_9_34,1.0,1,35,34,90
11,r_112_124_101,seq47,r_116_65_19,r_116_65_19,0.73,83,102,19,90
20,r_69_76_166,seq83,seq148,r_69_76_166,0.73,0,166,166,90
13,r_51_64_183,seq111,r_27_128_131,r_51_64_183,0.38,0,183,183,90
15,r_42_122_104,r_16_68_66,seq126,r_42_122_104,1.0,0,104,104,90
24,r_66_28_38,seq22,seq111,r_66_28_38,1.0,0,38,38,90
0,r_49_104_15,r_79_63_149,seq125,r_49_104_15,0.97,0,15,15,90
33,r_73_44_119,r_69_76_166,r_7_17_12,r_73_44_119,0.86,0,119,119,90
34,r_114_36_165,seq14,r_99_105_73,r_99_105_73,1.0,94,167,73,90
44,r_45_138_57,r_114_36_165,r_72_24_3,r_45_138_57,0.6,-8,49,57,90
9,r_6_43_121,seq117,r_16_68_66,r_6_43_121,1.0,0,121,121,90
22,r_121_3_68,seq137,seq136,r_121_3_68,0.76,4,72,68,90
49,r_37_142_169,r_139_0_151,r_7_17_12,r_37_142_169,0.64,0,169,169,90
35,r_31_131_114,seq15,r_7_17_12,r_31_131_114,0.75,3,117,114,90
12,r_99_105_73,r_95_20_157,seq48,r_99_105_73,1.0,-1,72,73,90
38,r_58_85_27,seq118,seq125,r_58_85_27,1.0,0,27,27,90
36,r_101_108_140,r_15_79_158,r_33_123_12,r_33_123_12,0.75,130,142,12,91
14,r_146_102_170,seq8,r_113_57_31,r_113_57_31,0.71,141,172,31,91
8,r_49_127_110,r_101_108_140,r_88_92_79,r_101_108_140,0.91,-30,110,140,91
3,r_130_66_48,seq4,r_136_1_24,r_130_66_48,0.77,0,48,48,91
5,r_36_141_179,seq5,r_126_16_86,r_126_16_86,0.76,94,180,86,91
46,r_110_122_127,seq104,seq4,r_110_122_127,0.49,0,127,127,91
42,r_91_129_112,seq13,r_136_1_24,r_91_129_112,0.77,0,112,112,91
12,r_50_137_33,r_49_127_110,r_33_123_12,r_50_137_33,0.47,1,34,33,91
45,r_107_18_185,r_133_44_172,seq13,r_133_44_172,0.75,-78,94,172,91
19,r_41_72_75,r_133_44_172,r_47_53_198,r_41_72_75,1.0,0,75,75,91
39,r_113_57_31,r_86_124_1,seq104,r_113_57_31,0.89,-3,28,31,91
72,seq54,r_2_20_173,seq87,r_2_20_173,0.81,3,176,173,91
89,seq93,r_26_111_151,r_10_51_27,r_10_51_27,0.94,1,28,27,91
4,r_30_109_13,seq143,seq43,r_30_109_13,0.79,1,14,13,91
78,seq67,seq76,r_142_39_66,r_142_39_66,1.0,4,70,66,91
0,r_26_111_151,seq93,r_71_12_117,r_26_111_151,0.4,1,152,151,91
11,r_139_114_138,seq19,r_65_58_63,r_139_114_138,0.62,7,145,138,91
31,r_10_51_27,r_125_145_52,seq93,r_10_51_27,0.86,1,28,27,91
57,seq9,r_29_74_96,seq7,r_29_74_96,0.48,2,98,96,91
6,r_71_12_117,r_146_102_170,r_106_119_35,r_146_102_170,0.65,-50,120,170,91
27,r_34_134_59,r_2_20_173,seq67,r_34_134_59,1.0,1,60,59,91
35,r_125_145_52,seq131,seq147,r_125_145_52,0.7,-4,48,52,91
2,r_126_16_86,r_85_103_180,r_27_84_47,r_126_16_86,0.92,3,89,86,91
47,r_15_79_158,seq128,r_33_123_12,r_15_79_158,0.71,0,158,158,91
40,r_133_44_172,r_107_18_185,r_130_66_48,r_130_66_48,0.94,125,173,48,91
24,r_2_20_173,seq54,r_41_72_75,r_41_72_75,0.77,98,173,75,91
66,seq31,r_65_58_63,r_106_119_35,r_106_119_35,0.99,-1,34,35,91
25,r_95_24_77,r_146_102_170,r_30_109_13,r_95_24_77,0.86,-1,76,77,91
43,r_106_119_35,r_130_66_48,seq31,r_130_66_48,0.96,-14,34,48,91
33,r_83_45_141,r_36_141_179,r_33_123_12,r_33_123_12,0.72,141,153,12,91
30,r_94_22_43,r_64_35_123,r_33_123_12,r_94_22_43,0.61,-1,42,43,91
68,seq37,r_38_55_163,r_65_58_63,r_38_55_163,0.69,-45,118,163,91
32,r_17_138_147,r_85_103_180,r_33_123_12,r_17_138_147,0.53,5,152,147,91
34,r_60_96_156,r_0_118_146,seq61,r_60_96_156,0.39,3,159,156,91
9,r_88_92_79,r_49_127_110,r_10_51_27,r_10_51_27,1.0,53,80,27,91
22,r_142_39_66,seq6,seq67,r_142_39_66,1.0,0,66,66,91
28,r_144_11_131,r_49_127_110,r_41_72_75,r_144_11_131,0.91,-31,100,131,91
49,r_29_74_96,seq9,r_33_123_12,r_29_74_96,0.81,2,98,96,91
7,r_23_73_99,seq93,seq5,r_23_73_99,0.88,1,100,99,91
44,r_46_149_69,seq143,seq148,r_46_149_69,0.95,0,69,69,91
37,r_68_78_18,r_110_122_127,r_33_123_12,r_68_78_18,0.55,0,18,18,91
28,r_31_91_42,seq21,r_14_22_35,r_31_91_42,0.99,1,43,42,92
30,r_56_58_135,r_16_99_21,seq102,r_56_58_135,0.62,1,136,135,92
42,r_62_137_30,r_16_99_21,seq132,r_62_137_30,0.87,4,34,30,92
14,r_2_3_79,r_38_98_113,seq76,r_2_3_79,0.99,4,83,79,92
9,r_26_12_34,r_118_47_53,seq117,r_26_12_34,1.0,0,34,34,92
37,r_147_74_57,r_87_70_114,r_77_35_77,r_77_35_77,0.62,-17,60,77,92
16,r_37_149_115,seq136,r_118_47_53,r_37_149_115,0.8,3,118,115,92
21,r_138_107_122,r_42_95_174,r_119_127_2,r_138_107_122,0.66,22,144,122,92
39,r_120_89_125,seq143,r_97_5_98,r_97_5_98,1.0,31,129,98,92
1,r_97_5_98,seq128,r_77_35_77,r_97_5_98,0.98,1,99,98,92
7,r_39_59_172,r_126_109_49,r_87_70_114,r_39_59_172,0.88,0,172,172,92
38,r_126_109_49,r_39_59_172,r_84_125_32,r_126_109_49,0.49,123,172,49,92
41,r_133_148_131,r_77_35_77,r_68_10_48,r_133_148_131,0.65,0,131,131,92
27,r_71_4_40,r_78_23_105,r_19_113_92,r_19_113_92,0.58,-49,43,92,92
10,r_146_116_171,r_123_15_8,r_104_110_146,r_104_110_146,0.9,37,183,146,92
78,seq57,r_72_88_150,r_2_3_79,r_2_3_79,0.6,71,150,79,92
0,r_104_110_146,r_97_5_98,r_84_125_32,r_104_110_146,0.97,-84,62,146,92
20,r_28_40_160,seq9,r_97_5_98,r_97_5_98,0.62,67,165,98,92
13,r_1_0_107,seq57,r_26_12_34,r_1_0_107,0.64,1,108,107,92
6,r_87_70_114,seq9,seq143,r_87_70_114,0.83,5,119,114,92
48,r_79_108_59,seq66,seq142,r_79_108_59,1.0,0,59,59,92
0,r_104_110_146,r_84_125_32,r_16_99_21,r_104_110_146,0.87,0,146,146,92
38,r_126_109_49,r_146_116_171,r_39_59_172,r_126_109_49,0.98,1,50,49,92
18,r_124_63_116,r_39_59_172,r_68_10_48,r_124_63_116,0.87,4,120,116,92
29,r_78_23_105,r_105_50_126,r_83_69_106,r_78_23_105,0.88,1,106,105,92
25,r_48_60_63,r_133_148_131,seq75,r_48_60_63,0.54,0,63,63,92
33,r_55_51_139,r_19_113_92,r_52_27_185,r_19_113_92,0.72,48,140,92,92
61,seq143,r_120_89_125,r_87_70_114,r_87_70_114,0.96,15,129,114,92
32,r_42_95_174,seq81,r_97_5_98,r_97_5_98,0.59,77,175,98,92
17,r_84_125_32,seq76,r_104_110_146,r_84_125_32,0.86,3,35,32,92
22,r_112_80_166,r_52_27_185,r_84_125_32,r_52_27_185,0.35,-19,166,185,92
7,r_39_59_172,r_124_63_116,r_126_109_49,r_39_59_172,0.94,-52,120,172,92
44,r_105_50_126,seq45,r_126_109_49,r_105_50_126,0.53,1,127,126,92
17,r_84_125_32,r_104_110_146,r_79_108_59,r_84_125_32,0.88,114,146,32,92
35,r_41_30_130,seq102,r_17_18_11,r_41_30_130,0.48,0,130,130,92
12,r_83_69_106,seq76,r_78_23_105,r_83_69_106,0.88,0,106,106,92
14,r_98_20_151,seq3,r_68_29_40,r_98_20_151,0.5,2,153,151,93
43,r_108_31_121,r_129_43_184,r_130_128_110,r_129_43_184,0.78,-62,122,184,93
37,r_27_124_158,seq67,r_41_82_132,r_41_82_132,0.62,46,178,132,93
40,r_14_18_39,r_41_82_132,r_28_126_8,r_14_18_39,0.97,0,39,39,93
71,seq45,r_25_114_94,seq6,r_25_114_94,0.84,2,96,94,93
21,r_130_128_110,r_133_9_169,seq45,r_130_128_110,0.89,0,110,110,93
39,r_103_106_123,r_68_29_40,r_125_39_20,r_103_106_123,0.44,26,149,123,93
1,r_149_13_75,r_90_109_115,r_115_1_100,r_115_1_100,0.99,-16,84,100,93
46,r_99_110_72,r_101_53_92,r_21_107_47,r_21_107_47,0.91,25,72,47,93
42,r_78_35_81,r_10_127_124,r_101_53_92,r_101_53_92,0.94,-8,84,92,93
10,r_25_114_94,seq45,seq36,r_25_114_94,0.81,2,96,94,93
48,r_90_109_115,seq36,r_115_1_100,r_90_109_115,0.83,1,116,115,93
19,r_40_17_48,r_25_114_94,seq34,r_25_114_94,0.56,-45,49,94,93
27,r_102_5_112,r_121_75_192,r_79_139_179,r_121_75_192,0.63,-80,112,192,93
38,r_125_39_20,r_25_114_94,seq26,r_125_39_20,0.9,-1,19,20,93
2,r_11_70_114,r_103_106_123,r_105_52_3,r_103_106_123,0.7,-9,114,123,93
47,r_10_127_124,r_143_111_67,r_41_82_132,r_10_127_124,0.65,3,127,124,93
23,r_32_131_37,r_57_122_53,seq19,r_32_131_37,0.92,0,37,37,93
24,r_129_43_184,seq56,r_47_66_170,r_47_66_170,0.66,15,185,170,93
25,r_54_120_173,seq8,r_125_39_20,r_54_120_173,0.46,0,173,173,93
32,r_91_2_134,r_105_52_3,r_40_17_48,r_91_2_134,0.75,1,135,134,93
34,r_96_93_118,r_121_75_192,r_28_126_8,r_96_93_118,0.94,1,119,118,93
81,seq67,r_27_124_158,r_21_107_47,r_21_107_47,1.0,80,127,47,93
17,r_95_132_83,r_101_53_92,seq36,r_95_132_83,0.97,1,84,83,93
22,r_4_51_142,r_41_82_132,r_25_114_94,r_4_51_142,0.63,3,145,142,93
28,r_133_9_169,seq142,r_97_15_128,r_133_9_169,0.44,9,178,169,93
3,r_104_12_19,seq34,seq36,r_104_12_19,0.88,0,19,19,93
35,r_50_55_133,seq144,r_40_17_48,r_50_55_133,0.66,0,133,133,93
30,r_80_83_90,seq6,r_5_9_19,r_80_83_90,0.72,0,90,90,94
5,r_40_134_28,r_43_53_170,r_59_82_36,r_40_134_28,0.85,-2,26,28,94
8,r_5_9_19,r_103_118_103,r_80_83_90,r_80_83_90,0.99,5,95,90,94
42,r_8_1_59,r_110_17_174,seq24,r_8_1_59,0.97,-2,57,59,94
25,r_28_75_57,r_103_118_103,seq56,r_28_75_57,1.0,0,57,57,94
37,r_96_121_146,r_15_21_178,r_107_128_96,r_96_121_146,0.41,6,152,146,94
21,r_12_16_171,r_103_118_103,r_129_42_93,r_103_118_103,0.76,68,171,103,94
19,r_73_127_92,r_129_42_93,seq131,r_129_42_93,0.69,7,100,93,94
15,r_44_31_23,r_103_118_103,r_39_89_17,r_44_31_23,0.93,-2,21,23,94
43,r_58_114_54,r_36_136_64,seq68,r_58_114_54,0.97,-5,49,54,94
41,r_67_144_137,r_43_53_170,r_132_74_81,r_43_53_170,0.73,-31,139,170,94
38,r_87_13_34,r_52_148_172,r_0_109_198,r_87_13_34,0.72,-8,26,34,94
32,r_36_136_64,seq35,r_43_53_170,r_36_136_64,0.69,-15,49,64,94
0,r_45_54_118,seq6,r_113_49_128,r_45_54_118,0.6,11,129,118,94
63,seq26,r_147_123_152,r_37_141_130,r_147_123_152,0.41,0,152,152,94
48,r_0_109_198,r_103_118_103,r_87_13_34,r_87_13_34,0.97,-8,26,34,94
39,r_46_61_14,r_18_137_160,seq25,r_46_61_14,0.75,0,14,14,94
20,r_37_141_130,r_138_143_126,r_43_53_170,r_138_143_126,0.52,16,142,126,94
13,r_129_42_93,r_91_84_197,seq55,r_91_84_197,0.67,-126,71,197,94
36,r_32_97_45,r_147_123_152,r_87_13_34,r_32_97_45,0.94,0,45,45,94
2,r_18_137_160,seq34,r_28_75_57,r_28_75_57,0.98,103,160,57,94
47,r_145_81_165,r_106_2_194,seq131,r_106_2_194,0.28,-24,170,194,94
29,r_78_48_89,r_103_118_103,seq63,r_78_48_89,0.9,-1,88,89,94
24,r_7_142_125,seq55,r_103_118_103,r_7_142_125,0.52,0,125,125,94
33,r_66_88_180,r_125_135_175,r_147_123_152,r_147_123_152,0.6,27,179,152,94
17,r_113_49_128,seq131,r_45_54_118,r_113_49_128,0.49,6,134,128,94
22,r_43_53_170,r_67_144_137,r_36_136_64,r_43_53_170,0.84,-110,60,170,94
28,r_149_92_121,r_37_141_130,seq11,r_37_141_130,0.64,-7,123,130,94
49,r_95_29_94,r_107_128_96,r_122_27_189,r_95_29_94,0.87,-2,92,94,94
7,r_125_135_175,r_59_82_36,r_103_118_103,r_103_118_103,0.84,76,179,103,94
44,r_3_20_68,r_7_142_125,seq108,r_3_20_68,0.98,-1,67,68,94
46,r_139_41_47,seq64,seq57,r_139_41_47,0.74,-1,46,47,94
36,r_27_73_60,r_12_23_71,r_86_88_28,r_12_23_71,1.0,-11,60,71,95
14,r_50_31_183,r_107_61_148,r_92_119_144,r_107_61_148,0.68,0,148,148,95
8,r_136_53_67,r_71_66_57,seq109,r_136_53_67,0.98,1,68,67,95
32,r_42_117_10,r_8_51_76,r_86_88_28,r_42_117_10,0.97,0,10,10,95
43,r_1_137_134,r_121_38_151,r_127_47_65,r_1_137_134,0.9,0,134,134,95
39,r_95_81_132,seq17,r_86_88_28,r_95_81_132,0.8,0,132,132,95
5,r_2_34_95,seq17,r_106_62_52,r_2_34_95,0.95,0,95,95,95
18,r_55_7_51,r_9_104_174,seq21,r_55_7_51,0.99,-2,49,51,95
0,r_121_38_151,r_148_67_193,r_136_53_67,r_136_53_67,0.88,86,153,67,95
21,r_106_62_52,r_49_11_84,r_45_147_11,r_106_62_52,0.68,6,58,52,95
11,r_102_125_90,r_78_48_124,r_146_145_152,r_146_145_152,0.94,2,154,152,95
20,r_0_19_113,r_56_83_181,seq132,r_0_19_113,0.9,2,115,113,95
26,r_25_124_19,r_0_19_113,seq103,r_25_124_19,0.86,0,19,19,95
38,r_54_80_15,seq5,seq101,r_54_80_15,0.62,4,19,15,95
9,r_115_133_20,seq122,seq132,r_115_133_20,0.99,0,20,20,95
51,seq4,seq144,r_121_38_151,r_121_38_151,0.56,3,154,151,95
2,r_40_90_100,seq77,r_9_104_174,r_40_90_100,0.94,0,100,100,95
47,r_12_23_71,r_107_61_148,seq134,r_12_23_71,1.0,0,71,71,95
6,r_93_138_40,seq5,r_56_83_181,r_93_138_40,0.96,7,47,40,95
40,r_59_3_131,r_9_104_174,seq5,r_59_3_131,0.55,0,131,131,95
29,r_26_139_105,r_69_120_159,r_78_48_124,r_78_48_124,0.4,-7,117,124,95
25,r_64_14_53,seq111,seq72,r_64_14_53,1.0,0,53,53,95
34,r_146_145_152,r_121_38_151,r_102_125_90,r_146_145_152,0.84,0,152,152,95
48,r_141_130_56,r_0_19_113,seq39,r_141_130_56,0.98,0,56,56,95
24,r_45_147_11,seq20,r_56_83_181,r_45_147_11,0.9,2,13,11,95
22,r_79_84_75,seq134,r_86_88_28,r_79_84_75,0.98,0,75,75,95
7,r_8_51_76,r_102_125_90,seq20,r_8_51_76,0.63,-4,72,76,95
44,r_78_48_124,r_102_125_90,r_26_139_105,r_78_48_124,0.41,5,129,124,95
23,r_107_61_148,r_50_31_183,r_127_47_65,r_50_31_183,0.59,-35,148,183,95
79,seq72,r_0_19_113,r_64_14_53,r_64_14_53,0.72,8,61,53,95
93,seq146,r_17_85_186,r_119_105_76,r_17_85_186,0.73,0,186,186,96
30,r_118_76_188,seq81,r_89_82_2,r_118_76_188,0.45,0,188,188,96
36,r_129_108_162,r_89_82_2,r_106_65_41,r_129_108_162,0.69,0,162,162,96
14,r_64_148_161,seq128,r_43_63_73,r_64_148_161,0.74,1,162,161,96
8,r_68_80_158,r_26_91_146,seq3,r_68_80_158,0.86,0,158,158,96
43,r_9_31_167,seq139,r_89_82_2,r_9_31_167,0.51,3,170,167,96
23,r_106_65_41,r_120_100_67,seq83,r_120_100_67,0.52,-36,31,67,96
16,r_109_25_19,r_37_143_153,r_89_82_2,r_109_25_19,0.8,2,21,19,96
21,r_145_140_93,r_117_10_96,r_89_82_2,r_145_140_93,1.0,-2,91,93,96
39,r_117_10_96,r_145_140_93,r_113_39_55,r_145_140_93,1.0,-4,89,93,96
97,seq114,r_121_13_132,r_43_63_73,r_121_13_132,0.55,1,133,132,96
46,r_50_60_80,r_15_94_129,r_11_116_147,r_50_60_80,0.67,-7,73,80,96
45,r_78_142_57,r_97_49_59,seq139,r_78_142_57,1.0,-2,55,57,96
76,seq52,r_34_0_137,r_120_100_67,r_120_100_67,1.0,0,67,67,96
31,r_23_99_136,r_36_141_170,r_119_105_76,r_23_99_136,0.84,0,136,136,96
41,r_87_67_130,r_11_116_147,r_29_95_91,r_29_95_91,0.92,42,133,91,96
24,r_55_86_56,r_36_141_170,r_119_105_76,r_55_86_56,1.0,-1,55,56,96
3,r_43_63_73,seq30,seq69,r_43_63_73,0.74,-8,65,73,96
10,r_125_53_107,r_101_123_141,seq126,r_125_53_107,0.99,5,112,107,96
26,r_15_94_129,r_77_124_182,r_125_53_107,r_125_53_107,0.94,57,164,107,96
4,r_29_95_91,r_89_82_2,seq3,r_29_95_91,1.0,0,91,91,96
11,r_17_85_186,seq146,r_34_0_137,r_17_85_186,0.36,0,186,186,96
48,r_37_143_153,seq21,r_40_75_112,r_37_143_153,0.84,5,158,153,96
18,r_120_100_67,seq132,seq52,r_120_100_67,1.0,0,67,67,96
22,r_58_1_45,seq126,seq128,r_58_1_45,0.74,0,45,45,96
25,r_121_13_132,seq114,r_58_1_45,r_121_13_132,0.87,1,133,132,96
33,r_26_91_146,r_101_123_141,r_34_0_137,r_26_91_146,0.45,10,156,146,96
13,r_38_70_17,r_115_56_172,seq139,r_38_70_17,0.65,2,19,17,96
38,r_41_28_71,r_133_46_58,r_106_65_41,r_41_28_71,0.98,-2,69,71,96
28,r_97_49_59,seq3,seq83,r_97_49_59,0.95,0,59,59,96
20,r_35_122_27,r_136_7_197,r_119_105_76,r_35_122_27,0.82,0,27,27,96
17,r_24_2_154,seq3,r_125_53_107,r_125_53_107,0.97,57,164,107,96
9,r_34_0_137,seq52,r_78_142_57,r_78_142_57,1.0,93,150,57,96
49,r_12_79_103,r_118_76_188,r_89_82_2,r_12_79_103,0.95,3,106,103,96
44,r_113_39_55,r_15_94_129,r_117_10_96,r_113_39_55,0.57,44,99,55,96
35,r_98_73_97,seq16,seq48,r_98_73_97,1.0,2,99,97,96
71,seq43,r_53_77_171,r_55_2_59,r_55_2_59,1.0,94,153,59,97
39,r_106_52_112,r_118_18_121,seq72,r_106_52_112,0.86,1,113,112,97
25,r_89_34_34,r_4_37_140,r_130_3_24,r_89_34_34,0.95,2,36,34,97
31,r_118_18_121,r_106_52_112,r_107_49_111,r_118_18_121,0.55,-8,113,121,97
26,r_4_37_140,r_107_49_111,r_102_111_123,r_102_111_123,0.57,17,140,123,97
0,r_90_14_114,r_57_36_179,r_17_86_12,r_90_14_114,0.72,0,114,114,97
11,r_117_95_137,seq27,r_107_49_111,r_117_95_137,0.84,0,137,137,97
28,r_130_3_24,r_50_136_56,seq6,r_130_3_24,0.78,1,25,24,97
20,r_76_100_105,r_144_123_115,r_113_124_98,r_76_100_105,0.42,6,111,105,97
15,r_45_83_76,r_91_68_118,r_87_110_43,r_87_110_43,1.0,70,113,43,97
48,r_144_123_115,seq60,r_87_110_43,r_87_110_43,0.81,85,128,43,97
17,r_58_61_31,r_45_83_76,seq60,r_58_61_31,0.52,2,33,31,97
6,r_63_146_163,seq131,r_87_110_43,r_87_110_43,1.0,120,163,43,97
27,r_142_29_144,r_113_124_98,r_134_15_6,r_134_15_6,0.53,144,150,6,97
43,r_41_97_49,seq13,seq74,r_41_97_49,0.97,4,53,49,97
47,r_11_25_135,r_104_112_168,r_90_14_114,r_104_112_168,0.98,-33,135,168,97
40,r_53_77_171,r_148_139_181,r_87_110_43,r_87_110_43,0.89,128,171,43,97
4,r_87_110_43,seq72,seq48,r_87_110_43,0.98,0,43,43,97
24,r_40_125_150,r_137_114_190,r_81_59_5,r_137_114_190,0.49,-35,155,190,97
33,r_23_35_77,seq19,seq147,r_23_35_77,0.77,5,82,77,97
14,r_28_65_22,r_90_14_114,seq19,r_28_65_22,0.82,1,23,22,97
29,r_50_136_56,seq147,r_81_59_5,r_50_136_56,0.99,0,56,56,97
38,r_57_36_179,seq64,r_81_59_5,r_81_59_5,0.63,176,181,5,97
21,r_44_26_53,r_55_2_59,r_56_30_194,r_55_2_59,0.79,-3,56,59,97
45,r_55_2_59,r_144_123_115,seq43,r_55_2_59,0.96,0,59,59,97
44,r_7_103_145,r_113_124_98,r_81_59_5,r_7_103_145,0.44,10,155,145,97
13,r_39_73_32,r_104_112_168,seq141,r_39_73_32,0.77,6,38,32,97
35,r_71_47_101,r_63_146_163,r_44_26_53,r_71_47_101,0.63,0,101,101,97
14,r_44_17_68,r_7_42_135,seq5,r_44_17_68,0.4,1,69,68,98
43,r_108_136_113,r_36_51_133,r_142_58_114,r_36_51_133,0.5,-18,115,133,98
54,seq5,r_109_64_92,r_44_17_68,r_109_64_92,0.93,13,105,92,98
16,r_36_51_133,seq107,r_148_137_93,r_148_137_93,0.59,56,149,93,98
24,r_34_91_187,r_142_58_114,r_33_118_49,r_142_58_114,0.85,73,187,114,98
73,seq52,r_34_91_187,r_129_50_19,r_129_50_19,0.49,3,22,19,98
41,r_28_78_74,r_10_21_125,seq9,r_28_78_74,0.55,10,84,74,98
4,r_103_69_81,seq138,r_27_105_71,r_103_69_81,0.75,1,82,81,98
11,r_101_26_144,r_36_51_133,r_110_76_45,r_36_51_133,0.9,11,144,133,98
15,r_57_72_147,seq70,r_132_97_12,r_57_72_147,0.58,2,149,147,98
27,r_43_18_161,seq120,r_4_25_33,r_43_18_161,0.49,0,161,161,98
87,seq95,r_104_117_156,seq30,r_104_117_156,1.0,0,156,156,98
2,r_115_48_120,r_47_3_164,seq45,r_115_48_120,0.71,10,130,120,98
40,r_40_84_163,r_53_90_199,r_148_137_93,r_53_90_199,0.31,-35,164,199,98
25,r_38_89_128,seq30,r_73_31_38,r_38_89_128,0.68,0,128,128,98
33,r_135_75_57,r_10_21_125,r_24_67_15,r_135_75_57,0.7,9,66,57,98
20,r_122_92_52,r_53_90_199,r_102_11_25,r_122_92_52,0.77,4,56,52,98
32,r_106_113_159,r_53_90_199,r_115_48_120,r_53_90_199,0.49,-39,160,199,98
34,r_142_58_114,r_27_105_71,r_34_91_187,r_27_105_71,0.62,44,115,71,98
49,r_104_117_156,seq95,r_27_105_71,r_104_117_156,0.58,0,156,156,98
35,r_47_3_164,seq2,r_15_79_23,r_47_3_164,0.23,0,164,164,98
36,r_138_13_75,r_69_93_190,r_130_43_55,r_130_43_55,0.91,25,80,55,99
37,r_8_105_71,r_110_4_67,r_52_45_121,r_8_105_71,1.0,0,71,71,99
13,r_49_136_13,r_78_124_16,seq7,r_49_136_13,1.0,-1,12,13,99
1,r_92_137_136,seq57,r_89_128_105,r_92_137_136,0.86,0,136,136,99
5,r_91_15_160,seq47,r_37_108_159,r_91_15_160,0.6,2,162,160,99
46,r_27_60_66,r_33_121_102,r_86_63_63,r_33_121_102,1.0,-35,67,102,99
9,r_99_38_54,r_92_137_136,seq23,r_99_38_54,1.0,2,56,54,99
45,r_68_85_149,seq58,r_31_126_36,r_68_85_149,0.95,0,149,149,99
19,r_122_145_129,seq131,r_114_48_124,r_122_145_129,0.65,4,133,129,99
40,r_31_126_36,r_34_42_186,seq71,r_31_126_36,0.98,2,38,36,99
12,r_80_20_177,r_86_63_63,r_112_120_182,r_80_20_177,0.9,1,178,177,99
4,r_110_4_67,r_8_105_71,r_99_38_54,r_110_4_67,1.0,4,71,67,99
0,r_9_16_150,r_127_40_189,r_101_117_35,r_9_16_150,0.42,0,150,150,99
11,r_86_63_63,r_112_120_182,r_113_119_4,r_86_63_63,0.99,0,63,63,99
20,r_89_128_105,r_37_108_159,r_127_40_189,r_89_128_105,0.73,0,105,105,99
15,r_46_103_176,seq71,r_10_140_60,r_10_140_60,0.66,116,176,60,99
10,r_100_146_39,r_92_137_136,r_78_124_16,r_100_146_39,1.0,0,39,39,99
6,r_41_73_53,r_99_38_54,r_83_129_24,r_83_129_24,1.0,65,89,24,99
85,seq79,seq44,r_10_140_60,r_10_140_60,1.0,10,70,60,99
31,r_94_1_34,r_33_121_102,r_101_117_35,r_94_1_34,0.95,3,37,34,99
30,r_130_43_55,r_22_62_187,seq5,r_130_43_55,1.0,2,57,55,99
47,r_29_139_148,seq70,r_149_107_74,r_29_139_148,0.7,0,148,148,99
24,r_34_42_186,r_127_40_189,r_149_107_74,r_34_42_186,0.58,0,186,186,99
33,r_112_120_182,seq23,r_80_20_177,r_112_120_182,0.28,3,185,182,99
25,r_36_77_52,r_22_62_187,seq23,r_36_77_52,0.99,1,53,52,99
21,r_132_135_33,r_92_137_136,seq18,r_132_135_33,1.0,0,33,33,99
32,r_10_140_60,r_91_15_160,seq79,r_10_140_60,1.0,1,61,60,99
38,r_148_39_143,r_33_121_102,r_8_105_71,r_8_105_71,0.94,72,143,71,99
28,r_33_121_102,seq5,r_19_17_146,r_19_17_146,0.9,9,155,146,99
49,r_118_54_131,r_69_93_190,r_36_77_52,r_36_77_52,0.97,92,144,52,99
7,r_19_17_146,seq143,r_33_121_102,r_19_17_146,0.64,0,146,146,99
44,r_55_88_158,r_80_20_177,seq0,r_55_88_158,0.36,2,160,158,99
23,r_37_108_159,r_115_133_144,r_91_15_160,r_37_108_159,0.65,1,160,159,99
35,r_114_48_124,r_9_16_150,seq26,r_114_48_124,0.63,0,124,124,99
12,r_80_20_177,r_55_88_158,r_86_63_63,r_86_63_63,0.98,97,160,63,99
