93,seq111,seq126,r_12_15_122,r_12_15_122,1.0,23,145,122,0
36,r_0_104_133,seq61,r_129_27_8,r_0_104_133,0.52,0,133,133,0
14,r_100_103_176,r_67_76_104,seq1,r_67_76_104,0.98,1,105,104,0
8,r_146_55_136,seq136,r_42_77_172,r_146_55_136,0.52,0,136,136,0
43,r_123_51_132,seq115,r_100_103_176,r_123_51_132,0.37,0,132,132,0
27,r_119_107_10,r_138_91_54,r_70_98_64,r_138_91_54,0.98,2,56,54,0
83,seq82,seq132,r_139_149_74,r_139_149_74,0.91,0,74,74,0
37,r_69_89_66,seq4,seq5,r_69_89_66,0.98,0,66,66,0
55,seq136,r_2_116_75,r_45_11_25,r_2_116_75,0.67,-2,73,75,0
19,r_128_97_26,r_42_77_172,seq133,r_128_97_26,0.86,2,28,26,0
16,r_28_95_113,r_12_15_122,seq33,r_28_95_113,0.97,0,113,113,0
39,r_74_66_76,seq120,seq18,r_74_66_76,1.0,0,76,76,0
27,r_119_107_10,r_9_78_36,r_138_91_54,r_119_107_10,0.89,0,10,10,0
1,r_9_78_36,r_122_41_11,seq37,r_9_78_36,0.97,0,36,36,0
22,r_94_34_34,r_29_105_99,r_122_41_11,r_94_34_34,0.88,2,36,34,0
41,r_56_112_96,r_48_114_19,r_72_84_70,r_56_112_96,0.38,-26,70,96,0
41,r_56_112_96,r_72_84_70,r_8_43_24,r_56_112_96,0.54,1,97,96,0
89,seq148,seq4,r_19_24_40,r_19_24_40,1.0,66,106,40,0
10,r_12_15_122,seq23,r_70_98_64,r_12_15_122,0.56,1,123,122,0
15,r_122_41_11,r_9_78_36,seq14,r_9_78_36,0.99,0,36,36,0
14,r_100_103_176,seq1,r_54_10_15,r_100_103_176,0.56,1,177,176,0
9,r_109_3_39,r_48_114_19,seq47,r_109_3_39,0.98,0,39,39,0
63,seq23,r_12_15_122,r_62_99_87,r_12_15_122,1.0,1,123,122,0
2,r_19_24_40,r_2_116_75,seq148,r_19_24_40,1.0,2,42,40,0
20,r_13_22_144,seq61,r_128_97_26,r_13_22_144,0.52,1,145,144,0
30,r_8_43_24,r_29_105_99,r_48_114_19,r_8_43_24,1.0,2,26,24,0
48,r_90_125_97,seq73,r_9_78_36,r_90_125_97,0.99,0,97,97,0
24,r_138_91_54,r_123_51_132,r_122_41_11,r_138_91_54,1.0,2,56,54,0
30,r_8_43_24,r_48_114_19,r_56_112_96,r_56_112_96,0.97,31,127,96,0
18,r_30_46_147,seq14,r_123_51_132,r_30_46_147,0.85,1,148,147,0
29,r_68_81_143,seq50,r_49_35_21,r_68_81_143,0.91,2,145,143,0
25,r_71_134_162,seq44,r_62_99_87,r_71_134_162,0.67,-27,135,162,0
33,r_67_76_104,r_100_103_176,r_141_75_16,r_67_76_104,0.78,1,105,104,0
32,r_26_16_98,seq52,r_141_75_16,r_26_16_98,0.97,5,103,98,0
38,r_64_102_177,seq18,r_141_75_16,r_64_102_177,0.43,0,177,177,0
34,r_139_149_74,r_29_105_99,seq82,r_139_149_74,0.84,5,79,74,0
17,r_70_98_64,r_6_145_170,r_119_107_10,r_70_98_64,0.94,0,64,64,0
0,r_45_11_25,r_62_99_87,seq136,r_45_11_25,0.99,0,25,25,0
11,r_141_75_16,r_19_24_40,seq5,r_141_75_16,0.93,-4,12,16,0
46,r_83_57_27,r_92_80_154,seq18,r_83_57_27,0.99,1,28,27,0
49,r_72_84_70,r_2_116_75,r_56_112_96,r_2_116_75,0.73,-5,70,75,0
43,r_123_51_132,r_100_103_176,r_30_46_147,r_123_51_132,0.74,17,149,132,0
44,r_135_7_124,seq50,r_72_84_70,r_135_7_124,0.53,0,124,124,0
23,r_93_38_168,r_62_99_87,r_19_24_40,r_93_38_168,0.54,0,168,168,0
31,r_54_10_15,r_29_105_99,seq53,r_54_10_15,0.66,1,16,15,0
35,r_39_106_62,r_69_89_66,r_9_78_36,r_39_106_62,0.97,0,62,62,0
10,r_12_15_122,r_70_98_64,r_31_143_141,r_31_143_141,0.98,11,152,141,0
12,r_2_116_75,seq136,seq33,r_2_116_75,0.99,1,76,75,0
49,r_72_84_70,r_56_112_96,r_135_7_124,r_135_7_124,0.96,2,126,124,0
4,r_59_124_37,r_42_77_172,seq18,r_59_124_37,1.0,0,37,37,0
93,seq101,seq38,r_100_68_133,r_100_68_133,0.82,0,133,133,1
40,r_147_90_152,r_58_99_29,r_61_121_72,r_58_99_29,0.86,122,151,29,1
36,r_19_108_70,seq33,seq31,r_19_108_70,1.0,-1,69,70,1
43,r_50_46_159,r_0_30_151,seq137,r_0_30_151,0.85,1,152,151,1
22,r_84_142_62,seq88,seq105,r_84_142_62,0.89,-5,57,62,1
5,r_16_125_60,seq21,r_104_106_41,r_16_125_60,0.96,-1,59,60,1
15,r_117_41_22,seq103,r_74_89_169,r_117_41_22,0.89,0,22,22,1
16,r_12_78_114,seq137,r_118_5_85,r_118_5_85,1.0,41,126,85,1
21,r_148_72_73,r_102_111_170,seq77,r_148_72_73,0.73,1,74,73,1
46,r_69_20_113,r_45_123_148,seq103,r_69_20_113,0.45,3,116,113,1
19,r_10_127_102,r_104_106_41,r_13_25_51,r_13_25_51,1.0,54,105,51,1
48,r_59_113_126,r_98_140_83,seq33,r_59_113_126,0.8,0,126,126,1
40,r_147_90_152,seq32,r_58_99_29,r_58_99_29,1.0,0,29,29,1
31,r_102_111_170,seq135,seq35,r_102_111_170,0.64,0,170,170,1
11,r_49_1_181,r_81_110_32,r_84_142_62,r_49_1_181,0.98,0,181,181,1
3,r_63_87_182,r_100_68_133,r_146_22_17,r_63_87_182,0.57,-49,133,182,1
10,r_118_5_85,seq53,r_12_78_114,r_118_5_85,1.0,-1,84,85,1
26,r_8_14_144,seq42,seq21,r_8_14_144,0.64,0,144,144,1
4,r_130_129_137,r_49_1_181,r_141_131_103,r_130_129_137,0.92,2,139,137,1
0,r_0_30_151,r_50_46_159,seq27,r_50_46_159,0.63,-7,152,159,1
63,seq31,r_80_65_185,r_19_108_70,r_19_108_70,1.0,-1,69,70,1
11,r_49_1_181,r_130_129_137,r_81_110_32,r_49_1_181,0.56,-42,139,181,1
13,r_61_121_72,seq137,seq4,r_61_121_72,1.0,0,72,72,1
48,r_59_113_126,r_126_3_84,r_98_140_83,r_59_113_126,0.48,-42,84,126,1
6,r_115_55_94,seq122,r_126_3_84,r_115_55_94,0.62,-3,91,94,1
27,r_62_9_95,seq39,seq135,r_62_9_95,0.95,0,95,95,1
1,r_96_57_50,r_132_29_120,seq15,r_96_57_50,0.99,1,51,50,1
2,r_107_47_64,r_80_65_185,seq39,r_107_47_64,1.0,0,64,64,1
29,r_79_144_155,r_74_89_169,seq88,r_79_144_155,0.74,3,158,155,1
57,seq15,seq136,r_96_57_50,r_96_57_50,1.0,6,56,50,1
24,r_100_68_133,r_63_87_182,seq101,r_100_68_133,0.66,9,142,133,1
3,r_63_87_182,r_146_22_17,r_0_30_151,r_63_87_182,0.58,0,182,182,1
25,r_80_65_185,seq31,r_28_114_89,r_28_114_89,0.69,100,189,89,1
33,r_97_11_107,r_104_106_41,r_117_41_22,r_117_41_22,0.55,86,108,22,1
88,seq88,seq31,r_79_144_155,r_79_144_155,0.77,12,167,155,1
20,r_58_99_29,r_147_90_152,seq35,r_147_90_152,0.99,0,152,152,1
38,r_93_143_135,r_74_89_169,r_146_22_17,r_93_143_135,0.66,0,135,135,1
77,seq53,r_118_5_85,seq103,r_118_5_85,1.0,-6,79,85,1
34,r_45_123_148,seq105,seq53,r_45_123_148,0.44,8,156,148,1
47,r_81_110_32,r_148_72_73,seq70,r_81_110_32,1.0,0,32,32,1
81,seq70,seq40,r_119_23_98,r_119_23_98,1.0,2,100,98,1
17,r_54_86_79,seq21,r_19_108_70,r_19_108_70,0.56,10,80,70,1
28,r_98_140_83,seq139,r_59_113_126,r_98_140_83,0.99,1,84,83,1
41,r_146_22_17,r_80_65_185,seq26,r_146_22_17,0.83,-1,16,17,1
7,r_28_114_89,seq4,seq77,r_28_114_89,0.87,0,89,89,1
44,r_73_56_96,seq116,seq36,r_73_56_96,0.95,-1,95,96,1
20,r_58_99_29,seq135,r_147_90_152,r_58_99_29,1.0,0,29,29,1
23,r_119_23_98,r_93_143_135,seq70,r_119_23_98,0.99,0,98,98,1
28,r_98_140_83,r_59_113_126,r_10_127_102,r_59_113_126,0.92,5,131,126,1
42,r_13_25_51,r_63_87_182,seq48,r_13_25_51,1.0,-1,50,51,1
35,r_132_29_120,seq18,r_141_131_103,r_132_29_120,0.97,5,125,120,1
12,r_34_64_174,seq35,r_67_24_156,r_34_64_174,0.84,-1,173,174,1
30,r_34_39_155,seq112,r_24_142_37,r_34_39_155,0.36,2,157,155,2
8,r_40_99_197,r_93_111_194,r_110_123_65,r_110_123_65,1.0,0,65,65,2
53,seq136,seq144,r_131_127_66,r_131_127_66,0.95,-1,65,66,2
31,r_75_64_35,r_100_102_186,seq47,r_75_64_35,0.93,0,35,35,2
39,r_109_26_78,seq5,r_14_9_33,r_109_26_78,0.9,0,78,78,2
43,r_17_145_31,seq15,r_79_7_2,r_17_145_31,0.5,-4,27,31,2
1,r_33_66_132,r_135_30_136,r_141_130_22,r_33_66_132,0.7,0,132,132,2
5,r_107_22_121,r_3_50_146,seq35,r_107_22_121,0.61,2,123,121,2
46,r_62_55_139,seq144,seq31,r_62_55_139,0.58,4,143,139,2
42,r_3_50_146,r_107_22_121,seq103,r_107_22_121,0.97,2,123,121,2
45,r_89_27_152,seq113,r_16_101_83,r_16_101_83,1.0,69,152,83,2
37,r_129_37_42,seq103,seq19,r_129_37_42,0.85,-1,41,42,2
14,r_60_44_49,r_109_26_78,seq148,r_60_44_49,0.69,0,49,49,2
67,seq35,r_116_134_107,r_107_22_121,r_107_22_121,0.6,8,129,121,2
10,r_122_36_140,seq48,r_116_134_107,r_122_36_140,0.79,1,141,140,2
61,seq19,r_135_30_136,r_129_37_42,r_129_37_42,0.87,0,42,42,2
0,r_16_101_83,r_65_114_111,r_89_27_152,r_16_101_83,0.98,0,83,83,2
73,seq138,seq61,r_42_21_58,r_42_21_58,0.74,3,61,58,2
11,r_147_133_135,r_49_125_168,r_91_137_103,r_91_137_103,0.62,35,138,103,2
12,r_132_82_28,seq61,seq92,r_132_82_28,0.94,1,29,28,2
13,r_14_9_33,seq90,r_109_26_78,r_109_26_78,1.0,40,118,78,2
15,r_77_25_118,seq144,r_124_97_39,r_77_25_118,0.96,0,118,118,2
26,r_98_45_30,r_65_114_111,seq95,r_98_45_30,1.0,1,31,30,2
6,r_65_114_111,r_88_53_159,seq19,r_65_114_111,1.0,0,111,111,2
48,r_42_21_58,r_32_43_137,seq138,r_42_21_58,1.0,1,59,58,2
2,r_96_51_72,r_107_22_121,seq5,r_96_51_72,0.99,0,72,72,2
47,r_139_120_14,r_94_70_9,r_24_142_37,r_24_142_37,0.99,-2,35,37,2
40,r_131_127_66,r_16_101_83,seq136,r_131_127_66,1.0,0,66,66,2
74,seq56,seq58,r_12_57_57,r_12_57_57,0.96,8,65,57,2
18,r_100_102_186,seq148,r_59_118_198,r_100_102_186,0.41,4,190,186,2
25,r_88_53_159,seq128,r_116_134_107,r_88_53_159,0.84,2,161,159,2
21,r_12_57_57,seq108,seq56,r_12_57_57,0.79,0,57,57,2
34,r_105_54_125,r_88_53_159,seq90,r_105_54_125,0.95,2,127,125,2
41,r_87_6_40,r_100_102_186,seq106,r_87_6_40,0.98,-1,39,40,2
38,r_124_97_39,seq73,seq63,r_124_97_39,0.99,-2,37,39,2
9,r_141_130_22,r_77_25_118,seq128,r_141_130_22,0.99,0,22,22,2
28,r_38_20_67,seq113,seq10,r_38_20_67,1.0,0,67,67,2
4,r_24_142_37,r_147_133_135,r_94_70_9,r_24_142_37,0.96,-2,35,37,2
44,r_71_86_99,r_14_9_33,r_75_64_35,r_71_86_99,0.65,0,99,99,2
23,r_91_137_103,seq108,seq148,r_91_137_103,1.0,1,104,103,2
35,r_110_123_65,r_116_134_107,r_40_99_197,r_110_123_65,0.45,0,65,65,2
70,seq47,r_135_30_136,r_75_64_35,r_75_64_35,1.0,0,35,35,2
14,r_81_112_165,seq56,seq25,r_81_112_165,0.79,0,165,165,3
37,r_100_18_123,seq145,r_109_119_89,r_100_18_123,1.0,-1,122,123,3
55,seq11,r_92_0_185,r_30_136_110,r_30_136_110,1.0,75,185,110,3
17,r_2_21_48,r_92_0_185,r_37_52_8,r_2_21_48,0.84,-34,14,48,3
16,r_74_51_102,seq63,r_5_17_29,r_74_51_102,1.0,0,102,102,3
21,r_64_75_153,seq146,seq90,r_64_75_153,0.88,0,153,153,3
1,r_139_106_114,r_132_79_120,seq138,r_139_106_114,0.56,0,114,114,3
5,r_15_91_74,seq47,r_70_69_20,r_70_69_20,0.93,54,74,20,3
46,r_73_40_166,r_38_144_144,r_5_17_29,r_73_40_166,0.72,-22,144,166,3
45,r_143_49_103,r_92_0_185,r_6_54_35,r_143_49_103,0.94,1,104,103,3
76,seq65,seq46,r_72_9_169,r_72_9_169,0.39,-21,148,169,3
31,r_57_131_181,seq138,r_5_17_29,r_5_17_29,0.63,153,182,29,3
10,r_132_79_120,seq56,seq89,r_132_79_120,1.0,0,120,120,3
28,r_70_69_20,seq121,r_15_91_74,r_70_69_20,0.99,0,20,20,3
72,seq58,r_142_43_90,r_45_71_21,r_142_43_90,1.0,2,92,90,3
4,r_109_119_89,r_130_44_131,r_93_3_76,r_130_44_131,1.0,-42,89,131,3
11,r_149_78_72,seq35,r_53_101_75,r_149_78_72,1.0,3,75,72,3
22,r_115_133_51,seq22,r_6_54_35,r_115_133_51,1.0,0,51,51,3
20,r_105_20_100,r_122_128_107,seq89,r_105_20_100,1.0,0,100,100,3
13,r_104_134_135,seq60,r_45_71_21,r_104_134_135,0.86,1,136,135,3
15,r_122_128_107,seq68,seq83,r_122_128_107,0.84,0,107,107,3
48,r_10_99_91,r_92_0_185,seq66,r_92_0_185,0.63,-81,104,185,3
17,r_2_21_48,r_37_52_8,seq111,r_2_21_48,0.94,0,48,48,3
9,r_130_44_131,r_55_62_14,r_6_54_35,r_130_44_131,1.0,0,131,131,3
30,r_116_50_17,r_67_7_30,r_1_33_1,r_116_50_17,1.0,0,17,17,3
38,r_29_96_27,seq90,seq113,r_29_96_27,1.0,1,28,27,3
36,r_55_62_14,r_130_44_131,r_1_33_1,r_130_44_131,1.0,0,131,131,3
8,r_6_54_35,seq63,seq56,r_6_54_35,1.0,0,35,35,3
27,r_30_136_110,r_72_9_169,seq11,r_30_136_110,1.0,0,110,110,3
42,r_45_71_21,seq61,seq22,r_45_71_21,0.84,-1,20,21,3
39,r_37_52_8,r_2_21_48,r_102_117_23,r_37_52_8,0.68,39,47,8,3
40,r_87_19_88,r_59_95_105,r_45_71_21,r_87_19_88,1.0,1,89,88,3
18,r_93_3_76,seq90,seq63,r_93_3_76,1.0,-1,75,76,3
25,r_53_101_75,seq90,seq129,r_53_101_75,0.98,0,75,75,3
2,r_5_17_29,seq42,seq146,r_5_17_29,1.0,1,30,29,3
33,r_94_85_132,r_92_0_185,r_6_54_35,r_94_85_132,0.84,0,132,132,3
85,seq90,seq137,r_64_75_153,r_64_75_153,1.0,0,153,153,3
61,seq22,r_142_43_90,r_45_71_21,r_142_43_90,1.0,-17,73,90,3
32,r_31_28_163,seq66,r_139_106_114,r_139_106_114,0.91,50,164,114,3
34,r_23_14_128,seq138,seq76,r_23_14_128,0.99,0,128,128,3
24,r_102_117_23,r_72_9_169,seq35,r_102_117_23,1.0,0,23,23,3
36,r_55_62_14,r_140_12_197,r_130_44_131,r_55_62_14,0.9,0,14,14,3
81,seq82,seq63,r_24_48_62,r_24_48_62,1.0,5,67,62,3
9,r_130_44_131,r_109_119_89,r_55_62_14,r_109_119_89,0.91,0,89,89,3
46,r_73_40_166,r_5_17_29,r_108_86_170,r_73_40_166,1.0,-1,165,166,3
49,r_24_48_62,seq137,seq82,r_24_48_62,1.0,0,62,62,3
19,r_67_7_30,seq46,seq35,r_67_7_30,1.0,0,30,30,3
44,r_125_127_104,seq97,seq110,r_125_127_104,0.99,2,106,104,3
23,r_92_0_185,seq11,r_1_33_1,r_1_33_1,0.69,184,185,1,3
82,seq83,seq61,r_122_128_107,r_122_128_107,1.0,2,109,107,3
79,seq76,seq63,r_23_14_128,r_23_14_128,0.99,28,156,128,3
35,r_38_144_144,r_73_40_166,r_104_134_135,r_38_144_144,0.91,0,144,144,3
12,r_59_95_105,r_23_14_128,seq25,r_23_14_128,0.6,-24,104,128,3
30,r_6_142_163,seq25,r_86_81_45,r_86_81_45,0.72,118,163,45,4
14,r_124_137_185,seq144,r_135_59_34,r_135_59_34,0.95,152,186,34,4
8,r_88_106_2,r_148_49_177,r_117_100_17,r_88_106_2,0.52,175,177,2,4
43,r_109_138_138,seq123,r_22_58_21,r_109_138_138,1.0,0,138,138,4
48,r_133_57_24,r_1_51_66,r_33_126_12,r_133_57_24,0.9,-13,11,24,4
5,r_56_141_99,r_88_106_2,seq70,r_56_141_99,0.93,0,99,99,4
42,r_12_92_147,seq0,seq115,r_12_92_147,0.94,0,147,147,4
80,seq77,r_68_47_152,seq71,r_68_47_152,1.0,0,152,152,4
45,r_105_120_68,seq85,r_46_93_5,r_105_120_68,1.0,0,68,68,4
19,r_23_98_83,seq125,seq123,r_23_98_83,0.94,0,83,83,4
33,r_78_129_55,r_105_120_68,seq96,r_78_129_55,1.0,0,55,55,4
4,r_117_100_17,seq91,seq14,r_117_100_17,0.77,-2,15,17,4
24,r_75_131_43,r_82_52_136,seq25,r_75_131_43,1.0,-1,42,43,4
0,r_135_59_34,seq28,seq123,r_135_59_34,1.0,-1,33,34,4
41,r_103_130_81,r_68_47_152,seq139,r_103_130_81,0.66,-1,80,81,4
44,r_22_58_21,r_62_136_164,seq28,r_22_58_21,0.99,1,22,21,4
26,r_62_136_164,seq79,seq28,r_62_136_164,0.58,1,165,164,4
3,r_119_69_18,r_62_136_164,r_67_111_8,r_119_69_18,0.77,0,18,18,4
72,seq42,r_1_51_66,seq139,r_1_51_66,1.0,8,74,66,4
35,r_4_8_42,r_143_16_186,seq38,r_4_8_42,0.99,0,42,42,4
39,r_43_27_199,seq139,r_86_81_45,r_86_81_45,1.0,0,45,45,4
20,r_148_49_177,r_88_106_2,r_74_83_33,r_88_106_2,0.55,175,177,2,4
13,r_82_52_136,seq84,seq139,r_82_52_136,0.83,1,137,136,4
15,r_24_10_69,r_82_52_136,r_1_51_66,r_1_51_66,0.7,3,69,66,4
70,seq38,r_66_40_23,r_55_145_20,r_55_145_20,1.0,2,22,20,4
6,r_64_132_113,r_68_47_152,r_1_51_66,r_68_47_152,0.94,-39,113,152,4
38,r_55_145_20,r_56_141_99,seq38,r_55_145_20,0.9,0,20,20,4
47,r_7_80_142,r_36_102_112,r_135_59_34,r_7_80_142,0.91,0,142,142,4
27,r_19_94_38,r_64_132_113,seq5,r_19_94_38,1.0,0,38,38,4
40,r_48_149_26,r_1_51_66,seq90,r_48_149_26,0.51,0,26,26,4
29,r_36_102_112,r_7_80_142,seq0,r_7_80_142,0.97,-29,113,142,4
25,r_118_60_171,seq14,r_33_126_12,r_118_60_171,0.58,0,171,171,4
50,seq0,r_12_92_147,r_36_102_112,r_12_92_147,1.0,-51,96,147,4
58,seq144,r_124_137_185,r_68_47_152,r_68_47_152,1.0,1,153,152,4
9,r_1_51_66,r_24_10_69,r_64_132_113,r_64_132_113,0.87,13,126,113,4
22,r_112_45_14,r_13_89_196,seq79,r_112_45_14,0.98,0,14,14,4
34,r_97_31_128,seq11,r_117_100_17,r_97_31_128,0.96,0,128,128,4
94,seq115,seq84,r_12_92_147,r_12_92_147,1.0,6,153,147,4
9,r_1_51_66,r_133_57_24,r_24_10_69,r_1_51_66,0.86,4,70,66,4
96,seq121,r_110_44_158,r_13_89_196,r_110_44_158,0.98,1,159,158,4
12,r_86_81_45,r_6_142_163,r_43_27_199,r_86_81_45,0.95,0,45,45,4
28,r_46_93_5,r_124_137_185,r_105_120_68,r_105_120_68,1.0,17,85,68,4
31,r_33_126_12,r_64_132_113,r_133_57_24,r_33_126_12,0.76,-1,11,12,4
49,r_20_128_90,r_36_102_112,seq71,r_20_128_90,0.67,1,91,90,4
7,r_76_39_176,seq71,r_24_10_69,r_76_39_176,0.58,1,177,176,4
63,seq25,r_6_142_163,r_75_131_43,r_75_131_43,1.0,7,50,43,4
17,r_114_101_36,seq90,r_112_45_14,r_114_101_36,0.99,0,36,36,4
36,r_142_135_175,seq129,r_102_95_133,r_102_95_133,0.54,42,175,133,5
14,r_83_52_173,seq73,seq12,r_83_52_173,0.21,4,177,173,5
16,r_57_103_10,seq134,seq4,r_57_103_10,0.96,0,10,10,5
54,seq4,r_8_35_55,r_57_103_10,r_57_103_10,0.97,60,70,10,5
37,r_133_91_148,r_62_67_158,seq134,r_133_91_148,0.97,0,148,148,5
3,r_13_143_22,r_83_52_173,seq74,r_83_52_173,0.68,-21,152,173,5
3,r_13_143_22,r_96_117_75,r_83_52_173,r_96_117_75,0.61,-53,22,75,5
21,r_63_136_120,seq132,seq34,r_63_136_120,0.99,0,120,120,5
39,r_107_124_98,seq44,r_33_110_24,r_107_124_98,0.9,0,98,98,5
1,r_27_71_119,seq89,r_25_39_72,r_27_71_119,0.99,1,120,119,5
42,r_98_82_87,r_53_81_145,r_87_88_18,r_98_82_87,0.47,0,87,87,5
80,seq60,r_51_97_187,r_63_136_120,r_63_136_120,1.0,68,188,120,5
32,r_87_88_18,r_62_67_158,r_98_82_87,r_87_88_18,0.9,95,113,18,5
66,seq24,r_51_97_187,r_113_92_83,r_113_92_83,1.0,5,88,83,5
76,seq44,r_107_124_98,r_120_11_56,r_120_11_56,0.9,42,98,56,5
31,r_128_78_97,seq26,r_65_56_2,r_128_78_97,1.0,1,98,97,5
10,r_25_39_72,seq18,seq0,r_25_39_72,0.6,13,85,72,5
26,r_122_149_96,seq2,r_87_88_18,r_122_149_96,0.87,1,97,96,5
72,seq34,r_51_97_187,r_63_136_120,r_63_136_120,1.0,7,127,120,5
0,r_21_99_103,seq73,r_98_82_87,r_21_99_103,0.66,4,107,103,5
20,r_141_77_91,seq18,seq101,r_141_77_91,0.65,1,92,91,5
13,r_58_105_140,seq6,seq20,r_58_105_140,0.76,2,142,140,5
98,seq126,r_104_106_155,r_27_71_119,r_27_71_119,0.99,37,156,119,5
44,r_50_148_34,r_83_52_173,r_59_38_21,r_50_148_34,0.6,24,58,34,5
32,r_87_88_18,r_102_95_133,r_62_67_158,r_87_88_18,0.85,0,18,18,5
48,r_111_116_66,seq12,seq79,r_111_116_66,0.95,3,69,66,5
6,r_90_22_186,seq89,r_21_99_103,r_21_99_103,0.66,83,186,103,5
15,r_120_11_56,seq132,seq44,r_120_11_56,1.0,0,56,56,5
2,r_33_110_24,r_104_106_155,r_107_124_98,r_33_110_24,0.73,86,110,24,5
47,r_62_67_158,seq47,r_59_38_21,r_59_38_21,0.74,138,159,21,5
27,r_43_72_38,r_37_80_36,seq15,r_43_72_38,0.89,0,38,38,5
40,r_68_54_40,seq75,seq42,r_68_54_40,0.98,0,40,40,5
25,r_51_97_187,seq60,r_27_71_119,r_27_71_119,1.0,69,188,119,5
70,seq31,r_41_66_174,r_118_29_170,r_41_66_174,0.78,0,174,174,5
18,r_145_64_53,r_7_23_125,seq86,r_145_64_53,0.79,2,55,53,5
2,r_33_110_24,seq112,r_104_106_155,r_33_110_24,1.0,-2,22,24,5
38,r_14_109_121,seq79,r_7_23_125,r_14_109_121,0.81,9,130,121,5
52,seq2,r_122_149_96,seq74,r_122_149_96,0.9,4,100,96,5
34,r_108_40_67,r_27_71_119,r_7_23_125,r_108_40_67,0.9,0,67,67,5
45,r_55_45_30,seq132,seq89,r_55_45_30,1.0,0,30,30,5
17,r_100_130_44,r_41_66_174,seq48,r_41_66_174,0.64,-116,58,174,5
75,seq42,seq69,r_68_54_40,r_68_54_40,1.0,30,70,40,5
22,r_123_115_50,r_111_116_66,r_55_45_30,r_123_115_50,1.0,0,50,50,5
49,r_49_46_144,r_41_66_174,r_102_95_133,r_49_46_144,0.74,0,144,144,5
41,r_59_38_21,r_96_117_75,r_50_148_34,r_96_117_75,1.0,-17,58,75,5
8,r_37_80_36,r_43_72_38,seq48,r_43_72_38,1.0,0,38,38,5
56,seq6,r_58_105_140,r_27_71_119,r_27_71_119,0.93,23,142,119,5
23,r_102_95_133,r_139_61_195,seq32,r_102_95_133,0.98,0,133,133,5
11,r_138_30_58,r_96_117_75,seq17,r_96_117_75,0.99,-17,58,75,5
35,r_113_92_83,seq15,seq24,r_113_92_83,1.0,1,84,83,5
12,r_41_66_174,seq31,r_57_103_10,r_41_66_174,0.41,0,174,174,5
93,seq104,seq74,r_19_0_91,r_19_0_91,1.0,7,98,91,6
30,r_108_77_124,seq58,seq104,r_108_77_124,0.91,0,124,124,6
36,r_69_95_93,seq124,seq24,r_69_95_93,0.82,0,93,93,6
28,r_106_65_28,r_42_90_73,r_145_46_154,r_106_65_28,1.0,-1,27,28,6
53,seq6,seq20,r_148_92_106,r_148_92_106,1.0,10,116,106,6
43,r_28_52_196,seq14,r_112_53_127,r_112_53_127,0.76,-24,103,127,6
54,seq8,r_41_85_141,r_148_92_106,r_148_92_106,1.0,35,141,106,6
37,r_19_0_91,seq88,seq104,r_19_0_91,0.83,0,91,91,6
71,seq136,seq10,r_121_115_101,r_121_115_101,1.0,23,124,101,6
16,r_129_72_88,seq97,seq124,r_129_72_88,0.76,-3,85,88,6
21,r_93_51_152,r_63_70_19,seq78,r_93_51_152,0.55,0,152,152,6
1,r_141_43_188,r_117_114_82,r_86_18_98,r_141_43_188,0.58,0,188,188,6
1,r_141_43_188,r_98_54_87,r_117_114_82,r_141_43_188,1.0,-106,82,188,6
42,r_31_7_156,seq26,r_55_39_86,r_31_7_156,0.81,0,156,156,6
31,r_67_21_30,r_86_18_98,seq138,r_67_21_30,1.0,-1,29,30,6
24,r_117_114_82,r_141_43_188,r_73_135_109,r_73_135_109,0.73,79,188,109,6
19,r_109_140_133,r_79_127_134,r_129_72_88,r_109_140_133,0.91,0,133,133,6
15,r_23_29_40,r_137_2_183,r_98_54_87,r_98_54_87,1.0,96,183,87,6
41,r_71_128_170,r_117_114_82,seq87,r_117_114_82,0.99,-11,71,82,6
35,r_37_139_52,seq91,seq44,r_37_139_52,0.98,0,52,52,6
10,r_73_135_109,seq9,seq10,r_73_135_109,0.9,0,109,109,6
26,r_42_90_73,seq136,seq44,r_42_90_73,0.83,0,73,73,6
0,r_98_54_87,r_141_43_188,seq130,r_98_54_87,0.99,1,88,87,6
15,r_23_29_40,r_148_92_106,r_137_2_183,r_23_29_40,1.0,0,40,40,6
11,r_121_115_101,r_50_120_191,seq136,r_121_115_101,1.0,1,102,101,6
13,r_68_83_79,seq124,seq102,r_68_83_79,1.0,0,79,79,6
8,r_5_149_15,r_36_100_58,seq9,r_5_149_15,0.97,1,16,15,6
2,r_27_126_149,seq9,r_121_115_101,r_27_126_149,0.85,1,150,149,6
47,r_82_62_113,seq102,r_143_35_6,r_82_62_113,0.98,0,113,113,6
46,r_64_111_37,r_55_39_86,seq20,r_64_111_37,1.0,0,37,37,6
18,r_79_127_134,seq56,r_108_77_124,r_79_127_134,0.88,0,134,134,6
29,r_13_33_94,seq74,seq20,r_13_33_94,0.92,0,94,94,6
24,r_117_114_82,r_71_128_170,r_141_43_188,r_117_114_82,0.94,0,82,82,6
25,r_12_113_136,seq20,seq14,r_12_113_136,0.7,8,144,136,6
33,r_1_38_150,seq147,r_84_4_57,r_1_38_150,0.77,2,152,150,6
6,r_36_100_58,r_84_4_57,seq102,r_84_4_57,0.97,-18,39,57,6
20,r_145_46_154,r_106_65_28,r_123_25_23,r_145_46_154,0.58,3,157,154,6
32,r_137_2_183,seq102,r_69_95_93,r_137_2_183,0.39,1,184,183,6
77,seq138,seq9,r_67_21_30,r_67_21_30,1.0,116,146,30,6
17,r_116_34_159,seq20,seq14,r_116_34_159,0.4,1,160,159,6
9,r_50_120_191,r_121_115_101,r_41_85_141,r_121_115_101,1.0,7,108,101,6
27,r_84_4_57,seq130,r_106_65_28,r_84_4_57,1.0,0,57,57,6
26,r_42_90_73,seq44,r_37_139_52,r_42_90_73,0.64,64,137,73,6
28,r_106_65_28,r_145_46_154,r_84_4_57,r_84_4_57,0.69,100,157,57,6
20,r_145_46_154,r_68_83_79,r_106_65_28,r_145_46_154,0.64,-123,31,154,6
49,r_55_39_86,seq118,seq81,r_55_39_86,0.64,-15,71,86,6
7,r_148_92_106,seq147,seq8,r_148_92_106,1.0,0,106,106,6
44,r_112_53_127,r_94_48_2,r_28_52_196,r_112_53_127,0.39,19,146,127,6
22,r_123_25_23,r_42_90_73,r_94_48_2,r_123_25_23,1.0,0,23,23,6
30,r_4_75_185,seq142,seq141,r_4_75_185,0.57,0,185,185,7
36,r_143_38_76,r_101_50_138,r_131_49_10,r_143_38_76,1.0,0,76,76,7
27,r_67_55_25,r_129_46_34,r_22_139_172,r_129_46_34,0.77,-14,20,34,7
14,r_92_37_176,r_123_118_95,seq43,r_123_118_95,1.0,0,95,95,7
43,r_116_113_178,seq104,r_78_99_83,r_116_113_178,0.27,0,178,178,7
37,r_83_100_61,r_105_6_135,seq65,r_83_100_61,0.95,3,64,61,7
74,seq66,r_26_138_32,r_11_91_36,r_26_138_32,1.0,0,32,32,7
34,r_77_111_29,r_30_52_45,seq89,r_77_111_29,0.81,-5,24,29,7
21,r_101_50_138,seq124,seq141,r_101_50_138,0.44,6,144,138,7
1,r_29_3_75,seq43,seq124,r_29_3_75,1.0,0,75,75,7
29,r_26_138_32,seq66,seq136,r_26_138_32,0.98,0,32,32,7
46,r_123_118_95,r_92_37_176,seq19,r_123_118_95,1.0,0,95,95,7
42,r_70_24_165,r_69_41_2,seq16,r_69_41_2,0.5,166,168,2,7
22,r_53_134_105,r_11_91_36,r_0_12_114,r_0_12_114,0.96,6,120,114,7
15,r_42_130_50,seq80,seq88,r_42_130_50,0.99,0,50,50,7
7,r_9_13_190,r_11_91_36,r_68_15_144,r_68_15_144,0.96,46,190,144,7
69,seq54,r_73_64_142,r_93_62_11,r_73_64_142,1.0,-42,100,142,7
19,r_68_15_144,r_22_139_172,seq80,r_68_15_144,0.78,0,144,144,7
27,r_67_55_25,r_22_139_172,seq120,r_22_139_172,0.8,0,172,172,7
35,r_34_140_109,seq136,r_61_71_166,r_34_140_109,0.47,-87,22,109,7
26,r_31_47_115,seq88,r_133_122_44,r_31_47_115,1.0,0,115,115,7
8,r_22_139_172,r_67_55_25,r_149_35_139,r_22_139_172,0.54,0,172,172,7
14,r_92_37_176,seq43,seq63,r_92_37_176,0.66,0,176,176,7
4,r_61_71_166,r_34_140_109,r_31_47_115,r_31_47_115,0.98,-1,114,115,7
98,seq126,seq136,r_108_114_116,r_108_114_116,1.0,10,126,116,7
48,r_144_86_126,seq136,r_133_122_44,r_144_86_126,0.5,12,138,126,7
2,r_11_91_36,r_9_13_190,r_145_148_106,r_11_91_36,0.52,154,190,36,7
7,r_9_13_190,seq5,r_11_91_36,r_11_91_36,0.52,8,44,36,7
8,r_22_139_172,r_68_15_144,r_67_55_25,r_22_139_172,0.73,-140,32,172,7
4,r_61_71_166,r_31_47_115,r_117_58_99,r_61_71_166,0.96,1,167,166,7
18,r_7_45_128,r_4_75_185,seq124,r_7_45_128,0.98,0,128,128,7
24,r_82_1_63,seq20,r_93_62_11,r_82_1_63,1.0,1,64,63,7
35,r_34_140_109,r_61_71_166,r_69_41_2,r_34_140_109,0.57,0,109,109,7
33,r_18_59_68,r_69_41_2,seq63,r_18_59_68,0.97,4,72,68,7
64,seq43,r_29_3_75,r_132_17_181,r_29_3_75,1.0,0,75,75,7
47,r_30_52_45,r_144_86_126,seq76,r_30_52_45,0.75,1,46,45,7
68,seq51,r_0_12_114,r_78_99_83,r_0_12_114,0.96,-14,100,114,7
32,r_105_6_135,seq10,r_123_118_95,r_105_6_135,0.8,0,135,135,7
38,r_78_99_83,r_149_35_139,seq51,r_78_99_83,0.92,0,83,83,7
11,r_103_109_49,seq141,r_8_135_163,r_103_109_49,0.83,-11,38,49,7
45,r_36_96_13,r_132_17_181,seq16,r_36_96_13,0.75,-1,12,13,7
17,r_108_114_116,seq40,seq126,r_108_114_116,0.97,0,116,116,7
94,seq120,r_68_15_144,r_67_55_25,r_68_15_144,0.92,0,144,144,7
39,r_131_49_10,r_9_13_190,seq20,r_131_49_10,0.99,1,11,10,7
9,r_32_128_160,seq14,r_53_134_105,r_53_134_105,1.0,58,163,105,7
96,seq124,r_101_50_138,r_7_45_128,r_7_45_128,1.0,11,139,128,7
22,r_53_134_105,r_32_128_160,r_11_91_36,r_11_91_36,0.52,69,105,36,7
2,r_11_91_36,seq88,r_9_13_190,r_11_91_36,0.71,-2,34,36,7
49,r_23_84_130,seq16,seq48,r_23_84_130,0.97,1,131,130,7
44,r_146_33_136,r_132_17_181,seq44,r_146_33_136,0.95,0,136,136,7
16,r_8_135_163,r_101_50_138,r_103_109_49,r_8_135_163,0.62,-107,56,163,7
23,r_102_79_125,seq21,seq14,r_102_79_125,0.53,13,138,125,7
5,r_129_46_34,r_31_47_115,seq21,r_129_46_34,0.93,0,34,34,7
12,r_149_35_139,seq25,r_26_138_32,r_26_138_32,1.0,110,142,32,7
30,r_90_67_137,r_147_137_167,seq3,r_147_137_167,0.42,-30,137,167,8
36,r_124_11_67,r_66_112_168,seq38,r_124_11_67,1.0,0,67,67,8
14,r_31_0_158,seq120,seq142,r_31_0_158,0.7,0,158,158,8
8,r_131_78_89,r_79_125_88,seq104,r_131_78_89,1.0,0,89,89,8
43,r_29_35_97,seq9,seq65,r_29_35_97,1.0,0,97,97,8
37,r_41_89_71,seq28,r_23_72_169,r_41_89_71,0.75,7,78,71,8
16,r_105_103_175,r_128_45_144,r_42_85_63,r_42_85_63,1.0,32,95,63,8
42,r_71_138_29,seq26,seq56,r_71_138_29,0.95,1,30,29,8
21,r_92_113_189,r_139_110_87,r_34_146_55,r_92_113_189,1.0,-102,87,189,8
1,r_14_86_8,r_132_15_5,r_69_122_86,r_69_122_86,1.0,4,90,86,8
5,r_23_72_169,r_2_115_83,r_41_89_71,r_2_115_83,1.0,0,83,83,8
46,r_83_33_184,seq17,r_66_112_168,r_66_112_168,0.76,16,184,168,8
19,r_127_144_117,r_25_51_33,seq28,r_127_144_117,1.0,0,117,117,8
31,r_32_98_127,seq3,r_106_73_48,r_32_98_127,1.0,0,127,127,8
41,r_118_101_124,r_31_0_158,seq129,r_118_101_124,0.62,0,124,124,8
67,seq36,r_1_10_153,r_58_93_141,r_58_93_141,1.0,13,154,141,8
10,r_50_57_68,seq21,seq142,r_50_57_68,0.88,1,69,68,8
16,r_105_103_175,r_42_85_63,r_130_107_27,r_105_103_175,0.98,-1,174,175,8
4,r_1_10_153,seq36,r_32_98_127,r_32_98_127,0.72,27,154,127,8
20,r_139_110_87,r_92_113_189,seq120,r_139_110_87,1.0,0,87,87,8
48,r_42_85_63,r_29_35_97,r_128_45_144,r_42_85_63,0.99,0,63,63,8
57,seq13,r_82_143_180,seq53,r_82_143_180,0.82,0,180,180,8
6,r_66_112_168,seq77,r_5_95_18,r_66_112_168,0.5,0,168,168,8
62,seq21,r_50_57_68,r_147_137_167,r_50_57_68,1.0,0,68,68,8
21,r_92_113_189,r_34_146_55,r_1_10_153,r_92_113_189,0.67,-1,188,189,8
10,r_50_57_68,seq142,r_58_93_141,r_58_93_141,1.0,1,142,141,8
27,r_2_115_83,r_23_72_169,seq3,r_2_115_83,1.0,0,83,83,8
1,r_14_86_8,seq38,r_132_15_5,r_132_15_5,0.87,7,12,5,8
64,seq26,r_71_138_29,seq55,r_71_138_29,0.63,1,30,29,8
2,r_52_30_148,seq65,r_61_114_25,r_52_30_148,0.96,0,148,148,8
18,r_79_125_88,r_131_78_89,seq129,r_131_78_89,1.0,0,89,89,8
29,r_69_122_86,seq99,r_14_86_8,r_69_122_86,1.0,0,86,86,8
22,r_76_141_40,r_52_30_148,seq116,r_76_141_40,0.97,1,41,40,8
25,r_94_16_92,r_32_98_127,r_23_72_169,r_23_72_169,0.69,-77,92,169,8
33,r_47_4_125,seq27,seq39,r_47_4_125,0.99,0,125,125,8
48,r_42_85_63,r_128_45_144,seq21,r_128_45_144,0.94,1,145,144,8
15,r_130_107_27,seq36,seq27,r_130_107_27,0.6,0,27,27,8
38,r_128_45_144,r_105_103_175,r_47_4_125,r_128_45_144,0.77,1,145,144,8
12,r_49_43_19,r_61_114_25,seq65,r_49_43_19,1.0,0,19,19,8
34,r_121_22_186,seq17,r_2_115_83,r_2_115_83,1.0,103,186,83,8
17,r_82_143_180,seq13,r_66_112_168,r_66_112_168,0.88,12,180,168,8
9,r_109_119_70,seq19,seq108,r_109_119_70,0.93,1,71,70,8
62,seq21,r_147_137_167,r_42_85_63,r_147_137_167,0.77,-58,109,167,8
49,r_106_73_48,seq27,seq17,r_106_73_48,0.94,11,59,48,8
7,r_70_60_165,seq111,r_14_86_8,r_70_60_165,0.88,0,165,165,8
44,r_133_81_75,seq111,r_50_57_68,r_50_57_68,0.99,37,105,68,8
23,r_147_137_167,seq96,seq7,r_147_137_167,0.41,3,170,167,8
11,r_34_146_55,r_136_91_91,r_135_145_58,r_34_146_55,0.82,3,58,55,8
35,r_97_18_122,r_70_60_165,r_109_119_70,r_70_60_165,1.0,-43,122,165,8
84,seq77,r_66_112_168,seq75,r_66_112_168,0.72,0,168,168,8
30,r_5_15_113,seq48,r_112_22_9,r_5_15_113,0.89,0,113,113,9
36,r_1_0_168,r_52_122_185,r_13_102_120,r_13_102_120,1.0,48,168,120,9
92,seq114,r_45_10_171,seq98,r_45_10_171,0.67,-25,146,171,9
69,seq44,r_27_50_141,r_16_74_36,r_16_74_36,1.0,0,36,36,9
43,r_113_116_156,seq29,seq6,r_113_116_156,0.54,0,156,156,9
6,r_103_64_21,r_31_33_85,seq48,r_103_64_21,0.91,-3,18,21,9
28,r_3_28_32,seq44,seq140,r_3_28_32,0.9,0,32,32,9
59,seq19,seq53,r_31_33_85,r_31_33_85,1.0,13,98,85,9
16,r_81_54_72,r_113_116_156,seq18,r_81_54_72,1.0,0,72,72,9
21,r_79_109_105,seq18,r_3_28_32,r_79_109_105,1.0,0,105,105,9
1,r_112_22_9,r_97_7_101,r_37_144_80,r_112_22_9,0.96,92,101,9,9
5,r_82_133_161,seq35,r_40_87_140,r_40_87_140,0.89,22,162,140,9
19,r_45_10_171,seq114,r_108_14_112,r_108_14_112,0.67,63,175,112,9
26,r_130_65_46,r_31_33_85,r_16_74_36,r_130_65_46,0.91,10,56,46,9
31,r_108_14_112,seq12,seq90,r_108_14_112,0.91,0,112,112,9
26,r_130_65_46,r_16_74_36,r_97_7_101,r_97_7_101,0.88,1,102,101,9
89,seq101,r_66_104_117,seq6,r_66_104_117,0.92,2,119,117,9
3,r_62_24_123,r_69_59_20,r_52_122_185,r_62_24_123,0.91,1,124,123,9
4,r_96_128_107,seq60,r_135_80_67,r_96_128_107,0.88,0,107,107,9
78,seq70,r_131_94_108,seq20,r_131_94_108,1.0,0,108,108,9
0,r_27_50_141,r_38_106_157,seq137,r_38_106_157,0.84,-6,151,157,9
63,seq32,r_41_91_152,r_63_34_60,r_63_34_60,0.89,35,95,60,9
11,r_85_142_173,r_143_126_170,seq70,r_85_142_173,0.59,-3,170,173,9
13,r_40_87_140,r_13_102_120,r_41_91_152,r_13_102_120,0.87,0,120,120,9
15,r_51_84_188,seq90,seq114,r_51_84_188,0.28,0,188,188,9
48,r_69_59_20,r_62_24_123,seq29,r_62_24_123,0.99,1,124,123,9
62,seq29,r_113_116_156,r_69_59_20,r_113_116_156,0.93,0,156,156,9
85,seq90,r_51_84_188,r_108_14_112,r_108_14_112,1.0,41,153,112,9
44,r_25_42_31,seq9,r_68_111_17,r_25_42_31,1.0,0,31,31,9
9,r_129_23_35,r_132_121_87,seq48,r_129_23_35,1.0,0,35,35,9
27,r_13_102_120,r_40_87_140,seq77,r_13_102_120,0.65,1,121,120,9
13,r_40_87_140,r_41_91_152,r_83_26_154,r_83_26_154,0.62,-14,140,154,9
2,r_47_92_110,seq88,r_132_121_87,r_132_121_87,1.0,23,110,87,9
40,r_132_121_87,seq127,seq60,r_132_121_87,1.0,1,88,87,9
18,r_143_126_170,r_85_142_173,r_78_58_79,r_143_126_170,0.76,0,170,170,9
29,r_38_106_157,r_27_50_141,r_132_121_87,r_38_106_157,0.89,2,159,157,9
37,r_141_56_40,r_108_14_112,seq90,r_141_56_40,0.75,-1,39,40,9
33,r_63_34_60,seq17,seq32,r_63_34_60,1.0,1,61,60,9
20,r_119_93_19,r_25_42_31,r_146_61_56,r_119_93_19,0.97,0,19,19,9
65,seq36,r_97_7_101,r_68_111_17,r_97_7_101,0.95,-31,70,101,9
32,r_30_139_164,r_85_142_173,r_13_102_120,r_85_142_173,0.94,-8,165,173,9
34,r_37_144_80,seq71,r_112_22_9,r_37_144_80,0.99,0,80,80,9
8,r_16_74_36,r_83_26_154,seq44,r_16_74_36,1.0,1,37,36,9
17,r_78_58_79,seq18,seq12,r_78_58_79,0.98,1,80,79,9
22,r_131_94_108,seq70,r_129_23_35,r_131_94_108,1.0,0,108,108,9
35,r_68_111_17,r_47_92_110,seq36,r_68_111_17,0.96,-2,15,17,9
49,r_86_110_148,r_27_50_141,r_13_102_120,r_86_110_148,0.95,2,150,148,9
7,r_2_89_104,r_51_84_188,seq20,r_2_89_104,0.91,1,105,104,9
12,r_31_33_85,seq99,seq19,r_31_33_85,1.0,0,85,85,9
84,seq88,r_47_92_110,seq32,r_47_92_110,0.57,0,110,110,9
36,r_28_73_157,r_7_136_153,r_144_36_81,r_144_36_81,0.84,73,154,81,10
14,r_25_56_195,seq124,seq70,r_25_56_195,0.56,-87,108,195,10
11,r_106_132_29,r_1_33_51,seq22,r_106_132_29,0.95,0,29,29,10
37,r_5_112_61,r_104_58_79,r_115_20_57,r_5_112_61,0.89,4,65,61,10
86,seq90,r_25_56_195,r_79_145_134,r_79_145_134,0.89,1,135,134,10
42,r_31_94_114,seq91,seq76,r_31_94_114,1.0,1,115,114,10
32,r_50_108_199,r_92_24_151,r_116_14_26,r_116_14_26,1.0,8,34,26,10
19,r_80_129_182,r_92_24_151,r_72_143_84,r_72_143_84,1.0,14,98,84,10
13,r_137_109_31,seq120,seq139,r_137_109_31,1.0,3,34,31,10
66,seq41,seq124,r_62_0_47,r_62_0_47,1.0,26,73,47,10
20,r_1_33_51,r_27_34_176,r_60_81_88,r_60_81_88,0.92,1,89,88,10
31,r_37_114_187,r_32_55_1,r_115_20_57,r_115_20_57,1.0,129,186,57,10
3,r_29_83_63,seq41,seq128,r_29_83_63,1.0,2,65,63,10
10,r_39_101_161,r_119_134_188,r_118_19_2,r_39_101_161,0.64,2,163,161,10
26,r_119_134_188,r_39_101_161,r_138_44_96,r_119_134_188,0.77,-93,95,188,10
14,r_25_56_195,seq70,r_126_84_7,r_126_84_7,0.91,183,190,7,10
4,r_96_68_155,seq59,r_43_97_59,r_43_97_59,0.35,96,155,59,10
0,r_43_97_59,seq45,r_35_15_107,r_43_97_59,1.0,5,64,59,10
82,seq139,r_35_15_107,r_137_109_31,r_137_109_31,1.0,14,45,31,10
15,r_60_81_88,r_99_142_173,r_1_33_51,r_60_81_88,1.0,0,88,88,10
48,r_30_98_99,seq78,r_144_36_81,r_30_98_99,0.91,0,99,99,10
6,r_53_107_177,seq123,r_60_81_88,r_60_81_88,0.7,90,178,88,10
2,r_126_84_7,r_79_145_134,r_29_83_63,r_126_84_7,0.9,129,136,7,10
43,r_62_0_47,r_1_33_51,seq41,r_62_0_47,0.83,0,47,47,10
23,r_40_122_12,r_137_109_31,seq82,r_40_122_12,0.93,0,12,12,10
21,r_116_14_26,r_113_148_191,r_50_108_199,r_116_14_26,0.94,2,28,26,10
47,r_77_69_146,seq82,r_115_20_57,r_115_20_57,0.96,93,150,57,10
40,r_138_44_96,seq13,seq125,r_138_44_96,0.63,1,97,96,10
18,r_12_111_148,r_146_9_178,r_86_65_22,r_146_9_178,0.79,-30,148,178,10
24,r_72_143_84,seq85,r_80_129_182,r_72_143_84,0.99,0,84,84,10
34,r_115_20_57,seq133,seq91,r_115_20_57,1.0,1,58,57,10
25,r_52_147_94,seq59,r_29_83_63,r_52_147_94,0.84,1,95,94,10
33,r_110_16_131,r_61_88_140,r_106_132_29,r_61_88_140,0.94,-4,136,140,10
50,seq128,r_79_145_134,r_29_83_63,r_29_83_63,0.49,49,112,63,10
94,seq120,r_137_109_31,seq46,r_137_109_31,0.98,3,34,31,10
38,r_61_88_140,r_110_16_131,seq87,r_110_16_131,0.89,5,136,131,10
26,r_119_134_188,r_138_44_96,r_43_97_59,r_138_44_96,0.39,93,189,96,10
27,r_86_65_22,r_30_98_99,seq91,r_86_65_22,0.56,0,22,22,10
96,seq123,r_53_107_177,r_7_136_153,r_7_136_153,1.0,25,178,153,10
29,r_79_145_134,r_126_84_7,seq90,r_79_145_134,0.94,2,136,134,10
22,r_144_36_81,seq103,seq120,r_144_36_81,1.0,0,81,81,10
49,r_141_48_108,seq74,seq4,r_141_48_108,0.98,0,108,108,10
29,r_79_145_134,r_37_114_187,r_126_84_7,r_79_145_134,0.75,-94,40,134,10
35,r_38_51_142,seq91,seq70,r_38_51_142,0.6,3,145,142,10
17,r_54_149_36,r_72_143_84,seq103,r_54_149_36,0.76,0,36,36,10
20,r_1_33_51,r_115_20_57,r_27_34_176,r_1_33_51,0.8,3,54,51,10
93,seq110,r_9_127_172,r_68_45_144,r_9_127_172,0.47,0,172,172,11
51,seq132,r_55_129_194,r_146_81_79,r_146_81_79,1.0,0,79,79,11
92,seq108,r_104_64_99,r_65_38_7,r_104_64_99,1.0,0,99,99,11
14,r_71_34_90,r_0_85_157,seq40,r_71_34_90,0.99,1,91,90,11
43,r_100_87_85,seq69,seq77,r_100_87_85,1.0,0,85,85,11
37,r_36_29_148,seq84,seq44,r_36_29_148,0.71,1,149,148,11
16,r_104_64_99,seq108,seq69,r_104_64_99,1.0,0,99,99,11
21,r_145_136_120,r_8_28_130,seq130,r_8_28_130,0.96,-10,120,130,11
39,r_54_19_88,seq30,seq141,r_54_19_88,0.99,0,88,88,11
30,r_76_113_46,r_67_70_195,seq141,r_76_113_46,0.83,-1,45,46,11
19,r_32_94_70,seq99,seq72,r_32_94_70,1.0,0,70,70,11
11,r_148_143_133,r_7_3_29,seq50,r_148_143_133,1.0,0,133,133,11
11,r_148_143_133,r_67_70_195,r_7_3_29,r_7_3_29,0.77,6,35,29,11
46,r_16_131_21,r_37_5_57,seq77,r_16_131_21,0.74,-1,20,21,11
31,r_25_124_113,seq96,seq144,r_25_124_113,1.0,0,113,113,11
10,r_86_112_86,r_9_127_172,seq144,r_86_112_86,1.0,2,88,86,11
35,r_35_134_51,r_23_13_111,seq56,r_35_134_51,0.47,4,55,51,11
26,r_39_47_132,seq30,seq116,r_39_47_132,0.88,0,132,132,11
0,r_8_28_130,r_79_14_139,seq91,r_8_28_130,0.97,1,131,130,11
15,r_138_75_134,seq84,r_32_94_70,r_32_94_70,1.0,64,134,70,11
48,r_107_6_145,r_105_133_169,r_26_12_105,r_105_133_169,0.61,-20,149,169,11
12,r_10_88_190,r_74_142_15,r_31_92_56,r_74_142_15,0.48,175,190,15,11
28,r_33_2_189,r_122_140_81,r_106_120_84,r_33_2_189,0.99,0,189,189,11
8,r_59_121_17,seq40,seq149,r_59_121_17,1.0,0,17,17,11
13,r_74_142_15,r_10_88_190,r_146_81_79,r_146_81_79,1.0,108,187,79,11
6,r_105_133_169,r_107_6_145,r_117_43_197,r_107_6_145,0.74,4,149,145,11
17,r_101_20_44,r_46_83_160,r_128_114_8,r_101_20_44,1.0,0,44,44,11
27,r_78_137_67,r_54_19_88,seq50,r_78_137_67,1.0,0,67,67,11
2,r_60_4_100,seq61,seq30,r_60_4_100,1.0,0,100,100,11
40,r_135_125_75,r_86_112_86,r_7_3_29,r_135_125_75,1.0,0,75,75,11
18,r_146_81_79,seq73,seq132,r_146_81_79,1.0,0,79,79,11
29,r_106_120_84,r_18_49_119,r_111_62_50,r_106_120_84,0.99,29,113,84,11
12,r_10_88_190,seq24,r_74_142_15,r_10_88_190,0.58,-135,55,190,11
24,r_26_12_105,seq11,seq42,r_26_12_105,0.91,4,109,105,11
25,r_9_127_172,seq110,r_78_137_67,r_78_137_67,0.78,105,172,67,11
13,r_74_142_15,seq115,r_10_88_190,r_74_142_15,0.61,-5,10,15,11
20,r_1_109_32,seq48,seq21,r_1_109_32,0.98,0,32,32,11
36,r_111_62_50,seq147,seq95,r_111_62_50,1.0,0,50,50,11
23,r_118_63_53,r_10_88_190,seq99,r_118_63_53,1.0,0,53,53,11
38,r_122_140_81,r_10_88_190,r_16_131_21,r_122_140_81,0.99,1,82,81,11
34,r_0_85_157,r_33_2_189,seq119,r_0_85_157,0.88,1,158,157,11
49,r_7_3_29,r_31_92_56,r_105_133_169,r_31_92_56,0.6,-35,21,56,11
75,seq69,r_68_45_144,r_128_114_8,r_68_45_144,0.71,1,145,144,11
7,r_31_92_56,seq61,seq15,r_31_92_56,1.0,0,56,56,11
9,r_23_13_111,seq119,seq149,r_23_13_111,0.8,0,111,111,11
50,seq130,r_65_38_7,r_145_136_120,r_145_136_120,0.72,-3,117,120,11
29,r_106_120_84,r_111_62_50,r_33_2_189,r_33_2_189,0.89,0,189,189,11
22,r_18_49_119,seq15,seq149,r_18_49_119,0.98,1,120,119,11
28,r_33_2_189,r_0_85_157,r_122_140_81,r_122_140_81,1.0,77,158,81,11
41,r_37_5_57,seq44,seq11,r_37_5_57,1.0,0,57,57,11
58,seq21,seq144,r_1_109_32,r_1_109_32,1.0,7,39,32,11
84,seq93,seq84,r_79_14_139,r_79_14_139,0.55,6,145,139,11
30,r_121_134_165,seq64,seq13,r_121_134_165,0.41,0,165,165,12
36,r_57_78_109,r_73_60_138,seq28,r_57_78_109,1.0,1,110,109,12
14,r_36_15_97,seq21,seq72,r_36_15_97,1.0,0,97,97,12
43,r_112_87_158,r_121_134_165,seq101,r_112_87_158,0.96,1,159,158,12
83,seq141,seq113,r_92_59_116,r_92_59_116,1.0,5,121,116,12
12,r_81_111_54,r_5_71_33,seq55,r_81_111_54,1.0,0,54,54,12
16,r_140_114_184,seq55,seq18,r_140_114_184,0.39,0,184,184,12
21,r_73_60_138,r_57_78_109,r_70_22_185,r_57_78_109,0.94,1,110,109,12
39,r_96_89_163,r_44_75_152,seq9,r_44_75_152,1.0,3,155,152,12
1,r_136_63_171,seq105,r_123_66_82,r_136_63_171,0.79,0,171,171,12
5,r_123_66_82,r_73_60_138,seq124,r_123_66_82,1.0,1,83,82,12
46,r_43_126_148,r_136_63_171,r_115_86_68,r_115_86_68,0.71,20,88,68,12
80,seq72,r_41_42_182,r_84_79_77,r_84_79_77,1.0,20,97,77,12
45,r_97_27_108,seq128,r_35_143_59,r_97_27_108,1.0,0,108,108,12
15,r_7_122_16,r_92_59_116,r_56_54_117,r_7_122_16,1.0,0,16,16,12
2,r_116_145_50,r_103_120_94,seq51,r_116_145_50,1.0,0,50,50,12
19,r_93_58_126,seq64,seq12,r_93_58_126,0.97,1,127,126,12
33,r_16_11_36,seq128,r_36_15_97,r_36_15_97,1.0,28,125,97,12
33,r_16_11_36,r_44_75_152,seq128,r_16_11_36,0.86,0,36,36,12
41,r_85_40_144,seq139,r_116_145_50,r_116_145_50,1.0,95,145,50,12
67,seq28,seq128,r_57_78_109,r_57_78_109,1.0,1,110,109,12
3,r_17_24_121,seq146,r_5_71_33,r_17_24_121,0.96,0,121,121,12
26,r_115_86_68,r_41_42_182,r_125_127_1,r_41_42_182,0.72,-110,72,182,12
4,r_35_143_59,seq131,seq21,r_35_143_59,0.71,4,63,59,12
0,r_46_4_162,seq72,r_3_2_114,r_46_4_162,0.95,0,162,162,12
11,r_41_42_182,seq113,r_81_111_54,r_41_42_182,0.66,0,182,182,12
20,r_67_132_70,r_29_129_122,r_116_145_50,r_116_145_50,1.0,37,87,50,12
13,r_92_59_116,r_102_10_142,seq141,r_92_59_116,0.96,0,116,116,12
46,r_43_126_148,r_115_86_68,r_35_143_59,r_43_126_148,1.0,0,148,148,12
48,r_135_62_154,seq72,seq90,r_135_62_154,0.97,1,155,154,12
6,r_56_54_117,r_137_94_168,r_35_143_59,r_137_94_168,0.7,-34,134,168,12
23,r_23_31_15,r_43_126_148,seq139,r_23_31_15,1.0,0,15,15,12
27,r_29_129_122,r_32_119_118,seq50,r_32_119_118,0.64,-1,117,118,12
9,r_76_20_53,r_46_4_162,seq131,r_76_20_53,1.0,0,53,53,12
47,r_84_79_77,seq124,seq72,r_84_79_77,1.0,0,77,77,12
18,r_38_95_172,r_103_120_94,r_44_75_152,r_103_120_94,0.85,77,171,94,12
25,r_137_94_168,seq91,r_29_129_122,r_29_129_122,0.64,49,171,122,12
64,seq21,r_36_15_97,r_35_143_59,r_36_15_97,1.0,0,97,97,12
50,seq128,r_97_27_108,r_46_4_162,r_97_27_108,1.0,0,108,108,12
58,seq139,r_85_40_144,r_23_31_15,r_23_31_15,0.79,71,86,15,12
32,r_142_106_64,r_36_15_97,seq33,r_36_15_97,0.95,-33,64,97,12
38,r_147_48_130,seq47,seq128,r_147_48_130,1.0,3,133,130,12
52,seq131,r_35_143_59,r_76_20_53,r_76_20_53,1.0,10,63,53,12
60,seq13,seq74,r_0_53_51,r_0_53_51,0.99,45,96,51,12
17,r_102_10_142,seq69,r_23_31_15,r_102_10_142,0.71,0,142,142,12
42,r_5_71_33,r_81_111_54,seq21,r_81_111_54,1.0,-15,39,54,12
31,r_0_53_51,r_56_54_117,seq13,r_0_53_51,0.97,0,51,51,12
91,seq105,r_136_63_171,r_39_52_28,r_39_52_28,0.77,143,171,28,12
49,r_108_68_180,seq77,r_136_63_171,r_136_63_171,0.59,10,181,171,12
7,r_44_75_152,r_96_89_163,r_116_145_50,r_96_89_163,0.86,-11,152,163,12
21,r_73_60_138,r_70_22_185,r_116_145_50,r_70_22_185,0.68,-40,145,185,12
30,r_128_148_88,r_42_127_142,seq74,r_128_148_88,0.91,1,89,88,13
14,r_83_125_112,r_1_39_124,seq28,r_1_39_124,1.0,-10,114,124,13
21,r_84_90_15,r_19_27_35,seq76,r_84_90_15,0.91,0,15,15,13
39,r_13_92_162,seq116,r_149_98_120,r_13_92_162,0.67,0,162,162,13
5,r_108_25_165,r_11_132_1,r_55_29_192,r_108_25_165,0.59,0,165,165,13
46,r_110_118_72,seq138,r_59_112_13,r_59_112_13,0.64,59,72,13,13
42,r_123_3_170,seq126,r_117_9_74,r_117_9_74,0.96,96,170,74,13
95,seq114,seq124,r_46_142_150,r_46_142_150,0.83,7,157,150,13
41,r_44_73_121,seq124,seq143,r_44_73_121,1.0,0,121,121,13
3,r_43_121_97,r_6_101_183,seq99,r_43_121_97,1.0,1,98,97,13
10,r_21_78_167,seq133,r_44_73_121,r_44_73_121,1.0,50,171,121,13
16,r_141_60_30,r_122_26_111,seq5,r_122_26_111,0.98,3,114,111,13
43,r_61_4_36,r_146_134_84,seq77,r_61_4_36,0.84,0,36,36,13
27,r_100_91_17,r_103_71_24,seq7,r_103_71_24,0.81,-9,15,24,13
0,r_95_47_172,r_145_20_160,r_84_90_15,r_95_47_172,0.83,-12,160,172,13
19,r_64_35_45,seq88,seq50,r_64_35_45,1.0,0,45,45,13
11,r_104_53_174,seq32,r_141_60_30,r_141_60_30,1.0,148,178,30,13
20,r_49_136_171,seq5,r_6_101_183,r_49_136_171,0.46,1,172,171,13
15,r_103_71_24,r_49_136_171,seq81,r_103_71_24,1.0,0,24,24,13
26,r_89_37_31,r_95_47_172,seq28,r_89_37_31,1.0,0,31,31,13
9,r_19_27_35,r_42_127_142,seq86,r_19_27_35,0.99,0,35,35,13
2,r_146_134_84,seq36,seq66,r_146_134_84,0.98,1,85,84,13
47,r_52_15_73,r_10_111_193,seq76,r_52_15_73,0.99,1,74,73,13
29,r_42_127_142,seq50,r_84_90_15,r_42_127_142,0.87,0,142,142,13
24,r_38_67_50,seq81,seq31,r_38_67_50,0.55,99,149,50,13
25,r_149_98_120,seq143,seq48,r_149_98_120,0.99,0,120,120,13
33,r_117_9_74,seq31,seq36,r_117_9_74,1.0,0,74,74,13
32,r_106_85_86,seq40,seq113,r_106_85_86,0.98,2,88,86,13
52,seq5,r_49_136_171,r_141_60_30,r_141_60_30,1.0,103,133,30,13
38,r_8_58_23,r_146_134_84,seq40,r_8_58_23,0.77,0,23,23,13
17,r_65_12_105,r_104_53_174,seq124,r_65_12_105,1.0,2,107,105,13
94,seq113,seq36,r_106_85_86,r_106_85_86,0.97,18,104,86,13
37,r_59_112_13,seq80,r_110_118_72,r_110_118_72,0.99,12,84,72,13
22,r_119_115_95,r_49_136_171,seq80,r_119_115_95,1.0,0,95,95,13
49,r_17_137_151,r_6_101_183,seq126,r_17_137_151,0.92,0,151,151,13
7,r_145_20_160,r_95_47_172,r_64_35_45,r_64_35_45,0.83,115,160,45,13
44,r_33_69_149,r_108_25_165,r_146_134_84,r_108_25_165,0.71,-15,150,165,13
23,r_122_26_111,seq5,r_6_101_183,r_122_26_111,0.98,0,111,111,13
37,r_59_112_13,r_6_101_183,seq80,r_59_112_13,0.73,0,13,13,13
16,r_141_60_30,r_83_125_112,r_122_26_111,r_141_60_30,0.99,1,31,30,13
35,r_46_142_150,r_95_47_172,seq114,r_46_142_150,0.89,0,150,150,13
4,r_72_51_37,r_38_67_50,r_140_0_2,r_72_51_37,1.0,0,37,37,13
36,r_3_17_187,r_21_135_184,r_107_12_78,r_21_135_184,0.42,1,185,184,14
8,r_147_93_175,seq59,r_44_75_182,r_147_93_175,0.64,0,175,175,14
16,r_27_35_43,seq43,r_114_57_88,r_27_35_43,1.0,0,43,43,14
37,r_128_71_149,r_90_73_59,r_8_52_90,r_90_73_59,0.5,91,150,59,14
55,seq11,r_13_95_173,r_106_51_36,r_106_51_36,0.98,137,173,36,14
39,r_108_134_158,r_21_135_184,r_100_31_128,r_108_134_158,0.61,0,158,158,14
1,r_100_31_128,r_110_142_186,r_112_87_183,r_100_31_128,0.91,0,128,128,14
5,r_8_52_90,r_21_135_184,r_84_118_66,r_8_52_90,1.0,3,93,90,14
46,r_0_148_75,r_32_62_167,r_107_12_78,r_0_148_75,1.0,3,78,75,14
42,r_13_95_173,seq11,seq138,r_13_95_173,0.5,0,173,173,14
21,r_106_51_36,seq76,seq43,r_106_51_36,0.99,0,36,36,14
45,r_117_130_83,r_45_7_189,r_105_47_6,r_117_130_83,0.97,2,85,83,14
19,r_107_12_78,r_147_93_175,r_0_148_75,r_107_12_78,1.0,0,78,78,14
33,r_92_25_169,r_105_47_6,r_79_129_47,r_92_25_169,0.71,1,170,169,14
29,r_125_121_38,r_110_142_186,seq11,r_125_121_38,0.98,0,38,38,14
14,r_79_129_47,seq48,seq15,r_79_129_47,1.0,2,49,47,14
41,r_32_62_167,r_0_148_75,seq145,r_0_148_75,1.0,0,75,75,14
3,r_110_142_186,seq48,r_124_143_16,r_124_143_16,0.84,171,187,16,14
78,seq59,r_147_93_175,r_79_129_47,r_79_129_47,0.68,129,176,47,14
0,r_122_91_137,seq89,r_8_52_90,r_8_52_90,1.0,53,143,90,14
11,r_19_96_115,r_136_119_194,seq22,r_19_96_115,1.0,0,115,115,14
15,r_137_77_122,seq145,seq15,r_137_77_122,1.0,0,122,122,14
6,r_58_60_76,r_13_95_173,r_139_42_1,r_58_60_76,0.99,0,76,76,14
62,seq22,r_122_91_137,r_19_96_115,r_19_96_115,0.97,27,142,115,14
34,r_124_143_16,r_112_87_183,seq6,r_124_143_16,0.97,0,16,16,14
27,r_5_69_165,r_114_57_88,seq14,r_5_69_165,0.63,0,165,165,14
84,seq70,seq89,r_126_40_31,r_126_40_31,1.0,24,55,31,14
2,r_44_75_182,r_117_130_83,r_84_118_66,r_84_118_66,1.0,16,82,66,14
41,r_32_62_167,seq145,r_139_42_1,r_32_62_167,0.91,0,167,167,14
24,r_21_135_184,r_3_17_187,r_106_51_36,r_106_51_36,0.53,148,184,36,14
32,r_74_101_56,r_122_91_137,seq133,r_74_101_56,1.0,1,57,56,14
7,r_80_61_11,r_58_60_76,seq76,r_80_61_11,0.98,0,11,11,14
60,seq145,r_137_77_122,r_120_149_147,r_137_77_122,1.0,1,123,122,14
17,r_84_118_66,seq29,seq55,r_84_118_66,1.0,0,66,66,14
22,r_30_127_63,r_117_130_83,seq29,r_30_127_63,1.0,0,63,63,14
43,r_56_20_45,r_82_26_57,r_1_99_64,r_56_20_45,1.0,1,46,45,14
49,r_23_144_77,r_114_57_88,r_131_37_65,r_114_57_88,1.0,-10,78,88,14
31,r_126_40_31,r_79_129_47,seq70,r_126_40_31,1.0,0,31,31,14
35,r_131_37_65,r_114_57_88,seq50,r_131_37_65,0.96,2,67,65,14
23,r_105_47_6,r_92_25_169,r_117_130_83,r_117_130_83,0.47,87,170,83,14
43,r_106_7_176,r_96_89_168,r_137_103_61,r_137_103_61,1.0,107,168,61,15
3,r_109_121_179,r_37_90_24,r_12_125_167,r_109_121_179,0.62,0,179,179,15
16,r_91_25_65,r_69_124_177,seq17,r_91_25_65,0.73,2,67,65,15
1,r_107_83_188,seq141,r_19_128_59,r_19_128_59,0.59,130,189,59,15
5,r_18_22_103,seq53,seq97,r_18_22_103,0.72,2,105,103,15
46,r_123_70_82,seq94,seq145,r_123_70_82,0.64,2,84,82,15
42,r_112_23_87,seq6,r_102_76_92,r_112_23_87,0.5,7,94,87,15
20,r_1_80_53,r_19_128_59,seq95,r_1_80_53,1.0,0,53,53,15
19,r_113_138_153,seq130,seq98,r_113_138_153,0.85,2,155,153,15
9,r_62_68_45,r_75_34_73,r_28_134_196,r_62_68_45,0.91,3,48,45,15
27,r_117_48_129,seq135,r_74_31_127,r_117_48_129,0.87,2,131,129,15
21,r_67_142_20,r_54_41_135,r_102_76_92,r_67_142_20,1.0,-1,19,20,15
31,r_131_105_180,seq87,r_74_31_127,r_74_31_127,0.76,53,180,127,15
3,r_109_121_179,r_1_80_53,r_37_90_24,r_109_121_179,0.98,-156,23,179,15
10,r_19_128_59,r_109_121_179,seq135,r_19_128_59,0.79,4,63,59,15
26,r_69_124_177,r_33_51_172,r_96_89_168,r_69_124_177,0.48,1,178,177,15
4,r_43_100_160,r_15_4_81,r_28_134_196,r_15_4_81,1.0,0,81,81,15
32,r_111_0_118,r_108_116_174,r_127_147_132,r_108_116_174,1.0,3,177,174,15
0,r_75_34_73,seq135,seq93,r_75_34_73,1.0,0,73,73,15
11,r_39_14_181,seq149,r_18_22_103,r_18_22_103,1.0,79,182,103,15
13,r_16_40_131,seq26,seq130,r_16_40_131,0.62,1,132,131,15
15,r_137_103_61,r_117_48_129,r_106_7_176,r_137_103_61,0.65,1,62,61,15
48,r_108_116_174,seq47,r_111_0_118,r_111_0_118,0.54,-18,100,118,15
4,r_43_100_160,r_28_134_196,r_81_140_41,r_43_100_160,0.77,2,162,160,15
30,r_3_56_29,r_33_51_172,seq141,r_3_56_29,1.0,2,31,29,15
6,r_127_147_132,seq27,r_111_0_118,r_127_147_132,0.94,3,135,132,15
21,r_67_142_20,r_102_76_92,seq110,r_102_76_92,1.0,2,94,92,15
40,r_10_92_50,seq85,seq145,r_10_92_50,1.0,3,53,50,15
27,r_117_48_129,r_137_103_61,seq135,r_137_103_61,1.0,1,62,61,15
87,seq95,r_65_136_165,r_1_80_53,r_1_80_53,1.0,113,166,53,15
2,r_118_139_119,r_96_89_168,seq36,r_118_139_119,0.9,1,120,119,15
18,r_99_55_163,seq114,r_118_139_119,r_118_139_119,0.95,44,163,119,15
29,r_9_72_112,seq27,r_5_45_90,r_5_45_90,1.0,22,112,90,15
24,r_148_64_126,seq145,seq129,r_148_64_126,0.84,1,127,126,15
45,r_102_76_92,seq26,r_67_142_20,r_67_142_20,0.98,26,46,20,15
34,r_37_90_24,r_109_121_179,r_59_61_100,r_37_90_24,0.68,155,179,24,15
33,r_59_61_100,r_69_124_177,r_37_90_24,r_69_124_177,0.78,-77,100,177,15
48,r_108_116_174,r_111_0_118,r_62_68_45,r_108_116_174,0.64,9,183,174,15
47,r_81_140_41,seq47,seq94,r_81_140_41,0.87,10,51,41,15
32,r_111_0_118,seq46,r_108_116_174,r_111_0_118,0.67,1,119,118,15
38,r_5_45_90,r_35_8_198,seq141,r_5_45_90,1.0,0,90,90,15
45,r_102_76_92,r_67_142_20,r_112_23_87,r_102_76_92,1.0,2,94,92,15
22,r_15_4_81,r_43_100_160,seq47,r_15_4_81,1.0,0,81,81,15
34,r_37_90_24,r_137_103_61,r_109_121_179,r_37_90_24,0.98,-1,23,24,15
7,r_73_88_125,r_65_136_165,seq145,r_73_88_125,0.89,0,125,125,15
44,r_30_132_101,r_148_64_126,r_67_142_20,r_30_132_101,0.94,1,102,101,15
23,r_146_57_76,seq52,seq13,r_146_57_76,0.99,0,76,76,15
35,r_96_89_168,r_107_83_188,r_49_122_4,r_96_89_168,0.83,0,168,168,15
93,seq115,seq70,r_1_60_97,r_1_60_97,0.87,8,105,97,16
30,r_118_77_87,seq138,seq79,r_118_77_87,0.98,4,91,87,16
6,r_131_126_22,r_91_89_196,seq136,r_131_126_22,0.86,0,22,22,16
36,r_3_73_154,r_36_59_164,r_111_27_145,r_36_59_164,0.78,-10,154,164,16
9,r_137_9_92,r_0_21_185,r_142_139_159,r_142_139_159,0.8,2,161,159,16
38,r_41_90_176,r_30_133_118,r_44_42_6,r_41_90_176,0.86,0,176,176,16
14,r_130_144_137,seq146,seq105,r_130_144_137,0.93,1,138,137,16
53,seq8,seq53,r_64_129_122,r_64_129_122,1.0,11,133,122,16
15,r_7_25_24,r_11_134_160,seq120,r_7_25_24,0.76,-2,22,24,16
21,r_71_104_79,r_68_15_134,seq112,r_71_104_79,1.0,0,79,79,16
1,r_36_59_164,seq22,seq145,r_36_59_164,0.5,1,165,164,16
46,r_68_15_134,seq4,r_125_69_34,r_125_69_34,0.88,103,137,34,16
55,seq12,r_113_110_56,r_17_85_7,r_113_110_56,0.98,0,56,56,16
12,r_91_89_196,r_131_126_22,r_125_69_34,r_91_89_196,0.47,-162,34,196,16
35,r_39_33_41,r_68_15_134,seq102,r_39_33_41,0.99,-5,36,41,16
19,r_30_133_118,seq32,seq145,r_30_133_118,0.81,0,118,118,16
41,r_93_97_130,seq79,r_113_110_56,r_93_97_130,0.73,12,142,130,16
10,r_96_116_136,r_41_90_176,seq12,r_96_116_136,0.72,3,139,136,16
90,seq146,r_130_144_137,r_46_51_59,r_46_51_59,0.98,1,60,59,16
0,r_109_141_75,r_119_81_184,seq50,r_109_141_75,1.0,0,75,75,16
11,r_64_129_122,r_34_58_191,seq8,r_64_129_122,0.91,0,122,122,16
20,r_11_134_160,seq101,seq22,r_11_134_160,0.59,0,160,160,16
13,r_61_14_124,seq102,r_76_103_15,r_61_14_124,0.65,1,125,124,16
98,seq123,r_149_132_151,r_121_57_55,r_149_132_151,0.94,-91,60,151,16
48,r_1_60_97,seq4,seq115,r_1_60_97,0.71,-1,96,97,16
87,seq102,r_0_21_185,r_39_33_41,r_39_33_41,0.97,-5,36,41,16
27,r_74_65_63,seq122,seq53,r_74_65_63,1.0,0,63,63,16
2,r_119_81_184,r_34_58_191,seq4,r_34_58_191,0.65,-6,185,191,16
47,r_26_99_152,seq117,r_149_132_151,r_26_99_152,0.6,0,152,152,16
18,r_5_49_156,seq37,seq48,r_5_49_156,0.82,0,156,156,16
28,r_142_139_159,r_83_43_85,r_137_9_92,r_142_139_159,0.82,2,161,159,16
24,r_111_27_145,r_17_85_7,r_6_143_1,r_111_27_145,0.71,0,145,145,16
25,r_149_132_151,seq123,r_26_99_152,r_149_132_151,0.54,1,152,151,16
65,seq32,r_30_133_118,seq13,r_30_133_118,1.0,1,119,118,16
38,r_41_90_176,r_96_116_136,r_30_133_118,r_30_133_118,0.68,21,139,118,16
34,r_75_35_99,r_149_132_151,seq67,r_75_35_99,0.92,-3,96,99,16
17,r_82_92_110,seq112,r_109_141_75,r_82_92_110,0.91,0,110,110,16
9,r_137_9_92,r_130_144_137,r_0_21_185,r_137_9_92,0.99,0,92,92,16
22,r_98_107_106,r_142_139_159,seq148,r_98_107_106,0.58,0,106,106,16
28,r_142_139_159,r_98_107_106,r_83_43_85,r_142_139_159,0.45,-53,106,159,16
49,r_83_43_85,r_93_97_130,r_76_103_15,r_83_43_85,0.75,10,95,85,16
7,r_10_84_141,seq122,r_6_143_1,r_10_84_141,0.75,0,141,141,16
42,r_46_51_59,seq148,seq146,r_46_51_59,1.0,0,59,59,16
8,r_125_69_34,r_23_24_38,r_91_89_196,r_125_69_34,0.96,-1,33,34,16
44,r_23_24_38,seq66,seq112,r_23_24_38,1.0,0,38,38,16
95,seq120,r_5_49_156,r_7_25_24,r_5_49_156,0.62,-134,22,156,16
4,r_113_110_56,seq12,seq100,r_113_110_56,1.0,0,56,56,16
30,r_128_8_176,r_0_21_192,r_6_94_103,r_128_8_176,0.56,1,177,176,17
36,r_14_49_82,seq66,seq12,r_14_49_82,1.0,0,82,82,17
14,r_136_121_45,r_14_49_82,seq47,r_14_49_82,0.97,-19,63,82,17
43,r_78_41_126,seq33,r_10_50_28,r_78_41_126,0.93,0,126,126,17
37,r_7_25_16,r_90_64_138,seq114,r_7_25_16,0.56,1,17,16,17
20,r_100_93_36,r_71_137_112,seq32,r_100_93_36,0.88,3,39,36,17
5,r_124_138_58,r_141_37_148,r_100_93_36,r_124_138_58,1.0,1,59,58,17
39,r_44_2_80,r_23_42_123,seq24,r_44_2_80,0.79,0,80,80,17
46,r_119_143_114,seq32,seq70,r_119_143_114,0.98,1,115,114,17
42,r_3_118_109,seq13,seq111,r_3_118_109,0.96,2,111,109,17
15,r_85_105_50,seq61,seq32,r_85_105_50,1.0,0,50,50,17
45,r_52_132_171,r_135_129_120,r_11_112_75,r_11_112_75,1.0,7,82,75,17
19,r_90_64_138,seq33,r_107_51_64,r_107_51_64,1.0,82,146,64,17
38,r_89_46_6,r_55_102_151,r_71_137_112,r_89_46_6,0.86,105,111,6,17
31,r_43_39_98,seq77,seq68,r_43_39_98,0.91,1,99,98,17
3,r_141_37_148,r_139_116_193,r_103_140_144,r_103_140_144,0.98,5,149,144,17
10,r_135_129_120,seq104,r_73_88_31,r_73_88_31,0.97,89,120,31,17
35,r_5_60_51,r_75_36_172,seq84,r_75_36_172,0.51,-117,55,172,17
28,r_45_31_52,seq77,seq66,r_45_31_52,1.0,0,52,52,17
48,r_75_36_172,r_5_60_51,r_7_25_16,r_5_60_51,0.74,4,55,51,17
8,r_22_15_49,r_101_76_130,seq34,r_101_76_130,1.0,-75,55,130,17
0,r_62_9_78,r_135_129_120,seq18,r_62_9_78,1.0,0,78,78,17
11,r_122_148_69,r_101_76_130,r_142_28_32,r_122_148_69,1.0,0,69,69,17
13,r_29_145_101,r_23_42_123,r_110_56_12,r_29_145_101,0.67,0,101,101,17
49,r_11_112_75,r_52_132_171,r_23_42_123,r_23_42_123,1.0,48,171,123,17
18,r_73_88_31,seq1,seq33,r_73_88_31,0.98,0,31,31,17
78,seq77,r_83_48_10,r_142_28_32,r_142_28_32,0.99,4,36,32,17
26,r_10_50_28,r_73_88_31,seq130,r_10_50_28,0.58,2,30,28,17
21,r_110_56_12,r_146_26_11,seq133,r_146_26_11,0.58,1,12,11,17
99,seq125,seq68,r_6_94_103,r_6_94_103,1.0,24,127,103,17
2,r_6_94_103,r_55_102_151,seq125,r_6_94_103,1.0,0,103,103,17
29,r_144_16_100,seq134,r_65_117_65,r_144_16_100,1.0,1,101,100,17
24,r_65_117_65,r_23_42_123,seq13,r_23_42_123,0.97,-51,72,123,17
25,r_98_86_180,seq92,r_126_131_70,r_126_131_70,1.0,110,180,70,17
48,r_75_36_172,r_7_25_16,r_62_9_78,r_7_25_16,0.86,156,172,16,17
32,r_103_140_144,r_72_54_198,seq134,r_103_140_144,0.96,0,144,144,17
75,seq68,r_82_120_147,r_43_39_98,r_43_39_98,1.0,58,156,98,17
68,seq47,r_62_9_78,r_136_121_45,r_62_9_78,0.72,-30,48,78,17
45,r_52_132_171,r_11_112_75,r_29_145_101,r_29_145_101,0.77,70,171,101,17
7,r_146_26_11,r_110_56_12,seq92,r_146_26_11,0.98,1,12,11,17
6,r_142_28_32,r_141_37_148,seq77,r_142_28_32,0.97,1,33,32,17
17,r_126_131_70,r_6_94_103,seq66,r_126_131_70,1.0,0,70,70,17
94,seq111,seq59,r_3_118_109,r_3_118_109,1.0,57,166,109,17
41,r_40_35_23,seq125,seq114,r_40_35_23,1.0,1,24,23,17
9,r_71_137_112,r_82_120_147,r_89_46_6,r_71_137_112,1.0,1,113,112,17
28,r_45_31_52,seq66,r_11_112_75,r_11_112_75,0.95,77,152,75,17
22,r_107_51_64,r_23_42_123,seq57,r_107_51_64,0.89,0,64,64,17
49,r_11_112_75,seq4,r_52_132_171,r_11_112_75,1.0,0,75,75,17
56,seq13,r_3_118_109,r_65_117_65,r_3_118_109,0.71,-33,76,109,17
23,r_82_120_147,seq68,r_6_94_103,r_6_94_103,1.0,53,156,103,17
30,r_80_124_149,r_21_116_150,r_79_117_69,r_79_117_69,0.55,79,148,69,18
51,seq2,r_77_9_146,r_74_43_67,r_77_9_146,0.64,0,146,146,18
36,r_106_63_76,seq4,seq57,r_106_63_76,1.0,0,76,76,18
14,r_41_133_86,seq54,r_11_149_36,r_41_133_86,0.89,2,88,86,18
37,r_79_117_69,seq141,r_134_49_176,r_79_117_69,1.0,1,70,69,18
59,seq19,seq59,r_22_75_89,r_22_75_89,1.0,5,94,89,18
55,seq140,seq14,r_20_97_25,r_20_97_25,1.0,55,80,25,18
21,r_138_118_82,r_8_39_138,seq72,r_138_118_82,0.89,2,84,82,18
39,r_112_37_152,r_131_69_153,r_138_118_82,r_112_37_152,0.56,-17,135,152,18
1,r_144_111_107,seq24,seq54,r_144_111_107,0.99,0,107,107,18
41,r_22_75_89,r_55_92_27,seq109,r_55_92_27,0.83,0,27,27,18
22,r_91_40_28,r_142_36_77,seq5,r_142_36_77,0.51,-41,36,77,18
24,r_21_116_150,r_55_92_27,r_138_118_82,r_21_116_150,1.0,1,151,150,18
8,r_55_92_27,r_22_75_89,r_21_116_150,r_55_92_27,1.0,0,27,27,18
27,r_107_12_19,seq105,r_18_130_50,r_18_130_50,0.99,42,92,50,18
31,r_95_90_66,seq76,r_55_92_27,r_95_90_66,1.0,0,66,66,18
27,r_107_12_19,r_45_10_178,seq105,r_107_12_19,1.0,-2,17,19,18
3,r_0_6_162,r_73_132_3,r_80_124_149,r_0_6_162,0.51,6,168,162,18
42,r_20_97_25,r_142_36_77,seq140,r_20_97_25,0.99,0,25,25,18
10,r_23_119_122,r_131_69_153,seq5,r_23_119_122,0.94,0,122,122,18
90,seq101,seq33,r_136_110_51,r_136_110_51,0.82,117,168,51,18
28,r_18_130_50,seq24,r_107_12_19,r_18_130_50,1.0,2,52,50,18
8,r_55_92_27,r_21_116_150,r_95_90_66,r_55_92_27,0.99,124,151,27,18
29,r_53_51_41,seq70,seq146,r_53_51_41,1.0,0,41,41,18
20,r_73_132_3,r_0_6_162,r_55_92_27,r_55_92_27,0.99,152,179,27,18
13,r_46_35_181,seq47,r_67_60_2,r_67_60_2,0.71,180,182,2,18
2,r_134_49_176,r_79_117_69,r_41_133_86,r_134_49_176,0.9,0,176,176,18
19,r_50_15_42,seq83,seq48,r_50_15_42,1.0,0,42,42,18
25,r_129_143_38,r_62_98_189,seq24,r_129_143_38,0.98,0,38,38,18
48,r_27_114_34,r_138_118_82,seq4,r_27_114_34,0.97,1,35,34,18
2,r_134_49_176,seq86,r_79_117_69,r_79_117_69,1.0,1,70,69,18
41,r_22_75_89,seq109,seq19,r_22_75_89,0.97,0,89,89,18
40,r_135_128_62,r_134_49_176,r_27_114_34,r_135_128_62,0.98,0,62,62,18
18,r_142_36_77,seq76,seq109,r_142_36_77,1.0,1,78,77,18
24,r_21_116_150,r_46_35_181,r_55_92_27,r_55_92_27,0.99,23,50,27,18
33,r_82_26_71,r_138_118_82,seq148,r_82_26_71,0.86,0,71,71,18
46,r_136_110_51,seq65,seq29,r_136_110_51,1.0,2,53,51,18
32,r_115_93_114,seq33,r_41_133_86,r_115_93_114,1.0,1,115,114,18
38,r_113_139_95,seq59,seq48,r_113_139_95,1.0,1,96,95,18
6,r_11_149_36,r_0_6_162,seq104,r_11_149_36,0.99,0,36,36,18
34,r_56_13_75,r_46_35_181,seq2,r_56_13_75,1.0,2,77,75,18
17,r_131_69_153,seq1,seq105,r_131_69_153,0.45,3,156,153,18
9,r_77_9_146,seq2,r_66_123_133,r_77_9_146,0.92,0,146,146,18
37,r_79_117_69,r_134_49_176,r_0_6_162,r_79_117_69,0.88,107,176,69,18
49,r_66_123_133,seq29,r_94_137_158,r_66_123_133,0.39,-53,80,133,18
7,r_121_17_80,r_45_10_178,seq146,r_121_17_80,0.93,0,80,80,18
49,r_66_123_133,r_94_137_158,r_79_117_69,r_66_123_133,1.0,0,133,133,18
47,r_58_81_37,seq104,seq57,r_58_81_37,0.99,1,38,37,18
12,r_74_43_67,seq122,seq2,r_74_43_67,0.82,14,81,67,18
36,r_131_67_178,r_73_24_197,r_121_149_170,r_73_24_197,0.21,-19,178,197,19
30,r_85_105_28,r_28_129_103,r_122_115_58,r_85_105_28,0.8,21,49,28,19
45,r_30_92_49,r_1_117_152,r_78_75_35,r_30_92_49,1.0,0,49,49,19
55,seq8,r_110_118_164,r_1_117_152,r_1_117_152,0.89,12,164,152,19
21,r_99_94_104,r_96_36_199,seq23,r_99_94_104,1.0,4,108,104,19
1,r_122_115_58,r_51_146_181,r_85_105_28,r_122_115_58,0.95,3,61,58,19
18,r_56_3_19,seq23,seq7,r_56_3_19,0.84,10,29,19,19
95,seq114,r_46_34_183,r_133_37_64,r_133_37_64,0.68,24,88,64,19
31,r_65_27_114,seq77,seq82,r_65_27_114,1.0,-2,112,114,19
41,r_133_37_64,seq137,seq114,r_133_37_64,0.91,2,66,64,19
3,r_49_53_186,r_112_108_175,seq61,r_49_53_186,0.2,2,188,186,19
26,r_84_57_126,r_111_89_149,r_122_115_58,r_84_57_126,0.71,0,126,126,19
0,r_121_149_170,r_111_89_149,seq61,r_121_149_170,0.4,-20,150,170,19
63,seq23,r_45_64_163,r_99_94_104,r_99_94_104,0.67,4,108,104,19
19,r_60_21_45,r_1_117_152,seq25,r_60_21_45,1.0,0,45,45,19
11,r_143_0_153,seq7,r_66_29_87,r_143_0_153,0.56,-1,152,153,19
20,r_2_104_182,seq138,r_56_3_19,r_56_3_19,0.89,163,182,19,19
48,r_112_108_175,r_96_36_199,r_33_40_22,r_33_40_22,0.86,164,186,22,19
8,r_44_91_50,seq42,seq25,r_44_91_50,0.94,1,51,50,19
16,r_31_142_44,r_148_100_65,seq116,r_31_142_44,0.9,3,47,44,19
0,r_121_149_170,seq61,r_86_14_90,r_121_149_170,0.65,0,170,170,19
6,r_120_12_88,r_10_5_107,seq102,r_120_12_88,0.96,1,89,88,19
40,r_125_17_53,r_74_87_80,seq22,r_125_17_53,0.65,0,53,53,19
99,seq127,r_97_79_125,r_78_75_35,r_97_79_125,0.92,0,125,125,19
30,r_85_105_28,r_145_58_144,r_28_129_103,r_145_58_144,0.81,-115,29,144,19
47,r_73_24_197,r_131_67_178,seq124,r_131_67_178,0.65,0,178,178,19
33,r_110_118_164,seq8,r_133_37_64,r_110_118_164,0.47,0,164,164,19
12,r_78_75_35,r_46_34_183,seq47,r_78_75_35,0.48,4,39,35,19
68,seq41,r_39_147_96,seq77,r_39_147_96,1.0,2,98,96,19
32,r_20_69_91,seq124,r_33_40_22,r_20_69_91,0.59,4,95,91,19
38,r_45_64_163,seq47,r_65_27_114,r_65_27_114,0.99,53,167,114,19
52,seq4,seq114,r_39_147_96,r_39_147_96,1.0,28,124,96,19
64,seq25,seq130,r_44_91_50,r_44_91_50,0.98,9,59,50,19
34,r_111_89_149,r_121_149_170,seq48,r_121_149_170,0.67,-20,150,170,19
17,r_95_32_120,seq9,r_99_94_104,r_95_32_120,0.8,1,121,120,19
9,r_28_129_103,r_96_36_199,seq128,r_28_129_103,1.0,0,103,103,19
22,r_145_58_144,r_45_64_163,r_44_91_50,r_145_58_144,0.58,1,145,144,19
28,r_16_11_68,r_20_69_91,r_60_21_45,r_16_11_68,0.77,2,70,68,19
49,r_148_100_65,seq9,seq8,r_148_100_65,0.93,4,69,65,19
56,seq9,r_148_100_65,seq136,r_148_100_65,1.0,4,69,65,19
7,r_1_117_152,seq41,seq82,r_1_117_152,0.88,1,153,152,19
44,r_10_5_107,seq141,seq128,r_10_5_107,0.98,1,108,107,19
82,seq77,r_65_27_114,seq41,r_65_27_114,1.0,-2,112,114,19
42,r_140_19_33,r_71_50_72,seq141,r_140_19_33,0.77,4,37,33,19
30,r_147_34_66,r_129_35_136,seq37,r_147_34_66,1.0,2,68,66,20
36,r_61_107_180,seq135,r_88_113_129,r_88_113_129,0.61,51,180,129,20
92,seq102,r_126_30_122,r_76_54_4,r_126_30_122,1.0,0,122,122,20
14,r_21_123_81,r_132_64_145,r_0_14_9,r_21_123_81,1.0,4,85,81,20
43,r_28_96_120,seq56,r_4_78_73,r_28_96_120,0.9,0,120,120,20
37,r_126_30_122,seq102,seq90,r_126_30_122,0.95,0,122,122,20
16,r_4_78_73,seq106,r_36_119_47,r_36_119_47,0.98,32,79,47,20
21,r_89_99_100,r_23_9_169,seq90,r_89_99_100,0.99,0,100,100,20
39,r_115_95_22,r_47_49_160,r_63_7_111,r_47_49_160,0.92,2,162,160,20
46,r_97_84_121,seq109,r_4_78_73,r_97_84_121,0.99,0,121,121,20
42,r_105_92_141,seq6,seq2,r_105_92_141,0.68,1,142,141,20
8,r_39_27_54,r_133_60_186,seq17,r_39_27_54,1.0,0,54,54,20
27,r_83_22_26,r_129_35_136,seq144,r_83_22_26,0.98,-1,25,26,20
11,r_148_72_57,r_133_60_186,r_41_12_109,r_133_60_186,0.5,-57,129,186,20
31,r_75_127_170,r_51_118_198,r_110_117_133,r_75_127_170,0.47,0,170,170,20
41,r_23_9_169,seq2,r_88_113_129,r_88_113_129,0.8,40,169,129,20
3,r_143_5_188,seq124,r_148_72_57,r_143_5_188,0.41,0,188,188,20
10,r_1_136_84,r_41_12_109,r_57_40_46,r_1_136_84,1.0,0,84,84,20
4,r_98_3_181,r_57_40_46,r_110_117_133,r_98_3_181,0.42,-1,180,181,20
0,r_93_42_175,seq43,seq11,r_93_42_175,0.48,0,175,175,20
20,r_101_70_128,seq91,r_103_134_11,r_101_70_128,0.63,1,129,128,20
13,r_88_113_129,seq2,seq146,r_88_113_129,0.88,1,130,129,20
6,r_140_45_161,seq56,r_110_117_133,r_140_45_161,0.49,1,162,161,20
99,seq124,r_143_5_188,r_139_74_154,r_139_74_154,0.63,28,182,154,20
22,r_103_134_11,seq11,seq53,r_103_134_11,0.97,1,12,11,20
87,seq90,r_139_74_154,r_126_30_122,r_126_30_122,0.99,33,155,122,20
35,r_62_80_12,r_93_42_175,seq32,r_62_80_12,0.71,0,12,12,20
11,r_148_72_57,r_59_68_139,r_133_60_186,r_148_72_57,0.43,0,57,57,20
2,r_110_117_133,seq109,seq52,r_110_117_133,0.49,2,135,133,20
47,r_59_68_139,r_148_72_57,r_137_131_78,r_148_72_57,0.49,82,139,57,20
40,r_133_60_186,seq79,r_110_117_133,r_110_117_133,0.62,53,186,133,20
18,r_132_64_145,seq128,r_103_134_11,r_132_64_145,0.83,0,145,145,20
29,r_48_125_165,r_63_7_111,r_110_117_133,r_63_7_111,0.66,54,165,111,20
25,r_120_86_159,seq17,r_132_64_145,r_120_86_159,0.27,4,163,159,20
52,seq6,r_105_92_141,seq11,r_105_92_141,0.56,27,168,141,20
77,seq65,r_20_16_171,r_139_74_154,r_20_16_171,0.47,2,173,171,20
34,r_77_50_70,r_126_30_122,seq141,r_77_50_70,0.94,0,70,70,20
17,r_63_7_111,r_33_111_30,seq24,r_63_7_111,0.41,24,135,111,20
96,seq114,r_59_68_139,seq146,r_59_68_139,0.93,-21,118,139,20
7,r_38_108_98,r_61_107_180,seq128,r_38_108_98,0.98,1,99,98,20
44,r_47_49_160,r_115_95_22,r_76_54_4,r_47_49_160,0.54,2,162,160,20
23,r_41_12_109,r_33_111_30,r_148_72_57,r_33_111_30,0.51,88,118,30,20
12,r_51_118_198,r_75_127_170,r_21_123_81,r_21_123_81,1.0,89,170,81,20
19,r_19_112_21,r_129_35_136,r_76_54_4,r_19_112_21,0.63,0,21,21,20
36,r_28_122_69,seq10,seq5,r_28_122_69,1.0,0,69,69,21
33,r_124_143_148,r_26_50_71,r_81_36_57,r_124_143_148,1.0,0,148,148,21
14,r_49_98_147,r_8_29_170,seq3,r_49_98_147,0.95,0,147,147,21
8,r_30_32_140,seq148,r_70_147_114,r_30_32_140,0.73,0,140,140,21
88,seq89,r_40_34_196,r_140_12_10,r_140_12_10,0.64,24,34,10,21
16,r_46_116_102,seq38,seq24,r_46_116_102,1.0,0,102,102,21
21,r_47_13_62,seq128,seq44,r_47_13_62,0.92,-1,61,62,21
39,r_26_50_71,r_59_39_1,seq96,r_26_50_71,1.0,0,71,71,21
46,r_118_127_159,r_88_123_162,r_15_25_117,r_15_25_117,0.97,42,159,117,21
5,r_141_66_161,seq142,r_140_12_10,r_140_12_10,0.46,38,48,10,21
42,r_45_107_120,seq77,r_47_13_62,r_45_107_120,1.0,1,121,120,21
45,r_11_54_153,seq57,r_106_68_118,r_11_54_153,0.63,0,153,153,21
19,r_132_105_84,seq5,seq27,r_132_105_84,0.99,0,84,84,21
95,seq111,r_101_62_91,r_4_125_191,r_101_62_91,0.6,1,92,91,21
66,seq24,seq86,r_46_116_102,r_46_116_102,0.98,1,103,102,21
38,r_140_12_10,seq142,r_70_147_114,r_70_147_114,1.0,3,117,114,21
31,r_139_102_176,seq87,r_37_104_145,r_37_104_145,0.89,31,176,145,21
41,r_8_29_170,r_49_98_147,r_0_94_25,r_0_94_25,0.62,75,100,25,21
67,seq27,seq137,r_132_105_84,r_132_105_84,1.0,29,113,84,21
89,seq96,r_92_138_132,r_26_50_71,r_26_50_71,0.91,21,92,71,21
3,r_37_104_145,seq38,r_46_116_102,r_46_116_102,0.65,43,145,102,21
43,r_0_94_25,seq137,seq23,r_0_94_25,0.94,-1,24,25,21
0,r_130_65_178,seq135,r_49_98_147,r_49_98_147,0.58,31,178,147,21
73,seq44,r_40_34_196,r_47_13_62,r_47_13_62,1.0,7,69,62,21
20,r_15_25_117,r_40_34_196,seq78,r_15_25_117,0.99,0,117,117,21
13,r_91_35_190,r_37_104_145,r_133_60_65,r_91_35_190,0.77,-117,73,190,21
15,r_81_36_57,r_30_32_140,seq31,r_30_32_140,0.93,-37,103,140,21
49,r_133_60_65,r_91_35_190,r_73_63_168,r_73_63_168,0.83,-1,167,168,21
50,seq128,seq24,r_101_62_91,r_101_62_91,1.0,0,91,91,21
62,seq148,r_30_32_140,r_81_36_57,r_30_32_140,1.0,1,141,140,21
5,r_141_66_161,r_140_12_10,r_101_62_91,r_141_66_161,0.88,0,161,161,21
27,r_92_138_132,seq96,r_67_117_193,r_92_138_132,0.95,0,132,132,21
34,r_33_19_47,r_130_65_178,seq51,r_33_19_47,1.0,0,47,47,21
24,r_73_63_168,r_70_147_114,r_133_60_65,r_73_63_168,0.69,0,168,168,21
1,r_113_95_52,seq41,seq135,r_113_95_52,1.0,1,53,52,21
41,r_8_29_170,r_0_94_25,r_28_122_69,r_8_29_170,0.69,1,171,170,21
47,r_58_83_109,seq38,r_113_95_52,r_113_95_52,0.93,57,109,52,21
74,seq51,seq72,r_33_19_47,r_33_19_47,1.0,50,97,47,21
18,r_18_17_103,r_124_143_148,seq86,r_18_17_103,0.51,1,104,103,21
29,r_88_123_162,r_118_127_159,r_70_147_114,r_70_147_114,0.96,19,133,114,21
38,r_140_12_10,r_30_32_140,seq142,r_140_12_10,0.83,0,10,10,21
4,r_75_134_43,r_43_114_156,r_20_119_6,r_75_134_43,0.92,0,43,43,21
24,r_73_63_168,r_15_25_117,r_70_147_114,r_73_63_168,0.95,-51,117,168,21
33,r_124_143_148,r_18_17_103,r_26_50_71,r_124_143_148,0.62,-44,104,148,21
64,seq22,r_70_147_114,seq3,r_70_147_114,1.0,0,114,114,21
50,seq128,r_47_13_62,seq24,r_47_13_62,0.97,2,64,62,21
32,r_16_82_158,seq51,seq22,r_16_82_158,0.86,0,158,158,21
30,r_61_131_15,r_113_95_52,seq57,r_61_131_15,1.0,0,15,15,21
29,r_88_123_162,r_70_147_114,r_92_138_132,r_88_123_162,0.98,0,162,162,21
17,r_74_21_119,seq121,r_81_36_57,r_74_21_119,1.0,2,121,119,21
9,r_93_2_64,r_90_97_116,seq87,r_93_2_64,0.81,7,71,64,21
22,r_90_97_116,r_48_64_182,r_59_39_1,r_90_97_116,0.88,0,116,116,21
28,r_70_147_114,seq22,r_140_12_10,r_70_147_114,1.0,0,114,114,21
49,r_133_60_65,r_115_76_110,r_91_35_190,r_133_60_65,0.82,1,66,65,21
44,r_4_125_191,r_26_50_71,seq57,r_26_50_71,1.0,0,71,71,21
23,r_101_62_91,seq111,seq128,r_101_62_91,1.0,0,91,91,21
82,seq77,r_45_107_120,r_106_68_118,r_45_107_120,0.99,1,121,120,21
35,r_85_7_124,seq108,r_70_147_114,r_85_7_124,0.95,0,124,124,21
92,seq102,seq109,r_120_20_110,r_120_20_110,0.98,2,112,110,22
54,seq5,r_75_3_64,r_122_123_51,r_75_3_64,0.82,5,69,64,22
71,seq47,r_144_127_154,r_26_143_163,r_144_127_154,0.56,2,156,154,22
16,r_25_86_77,r_62_99_172,r_148_10_195,r_25_86_77,0.73,1,78,77,22
5,r_94_98_60,r_57_74_94,seq109,r_94_98_60,1.0,0,60,60,22
46,r_75_3_64,seq5,r_68_39_117,r_75_3_64,0.98,5,69,64,22
42,r_142_49_152,seq132,seq19,r_142_49_152,0.62,2,154,152,22
24,r_28_89_40,r_112_121_126,r_101_117_13,r_28_89_40,0.91,1,41,40,22
19,r_0_130_181,r_68_39_117,seq47,r_68_39_117,0.52,66,183,117,22
14,r_101_117_13,r_17_145_192,r_28_89_40,r_28_89_40,0.77,16,56,40,22
44,r_103_95_103,r_122_123_51,r_41_131_5,r_103_95_103,0.8,4,107,103,22
3,r_73_147_55,seq146,seq80,r_73_147_55,0.99,0,55,55,22
14,r_101_117_13,seq59,r_17_145_192,r_101_117_13,0.58,1,14,13,22
41,r_62_99_172,seq27,r_22_29_72,r_22_29_72,1.0,102,174,72,22
0,r_82_87_182,r_135_81_69,r_84_35_10,r_84_35_10,0.64,173,183,10,22
73,seq51,r_72_92_65,r_122_123_51,r_72_92_65,1.0,-1,64,65,22
15,r_129_24_22,r_18_138_14,r_68_39_117,r_129_24_22,0.91,2,24,22,22
25,r_122_123_51,seq109,seq5,r_122_123_51,0.84,5,56,51,22
49,r_15_149_45,r_68_39_117,seq43,r_15_149_45,0.61,2,47,45,22
62,seq19,r_112_121_126,r_18_138_14,r_112_121_126,0.94,0,126,126,22
99,seq126,r_97_66_185,r_129_24_22,r_129_24_22,0.92,163,185,22,22
31,r_137_31_19,r_46_13_145,r_48_125_11,r_137_31_19,0.78,1,20,19,22
27,r_22_29_72,r_25_86_77,seq55,r_22_29_72,0.67,1,73,72,22
64,seq23,r_106_4_143,r_32_38_53,r_32_38_53,0.57,2,55,53,22
47,r_58_119_162,seq52,r_84_35_10,r_84_35_10,0.5,155,165,10,22
40,r_107_83_106,r_112_121_126,r_28_89_40,r_112_121_126,1.0,-19,107,126,22
18,r_57_74_94,r_41_131_5,r_68_39_117,r_41_131_5,0.65,92,97,5,22
33,r_120_20_110,r_88_33_86,r_94_98_60,r_120_20_110,0.78,2,112,110,22
32,r_44_115_171,seq6,seq19,r_44_115_171,0.48,0,171,171,22
52,seq2,r_106_4_143,seq7,r_106_4_143,0.98,-36,107,143,22
34,r_72_92_65,seq51,seq96,r_72_92_65,1.0,-1,64,65,22
26,r_12_45_197,seq70,r_136_90_12,r_136_90_12,0.91,21,33,12,22
94,seq109,seq102,r_94_98_60,r_94_98_60,1.0,17,77,60,22
11,r_136_90_12,r_25_86_77,r_12_45_197,r_136_90_12,0.96,0,12,12,22
22,r_32_38_53,r_34_67_71,seq23,r_32_38_53,0.99,2,55,53,22
56,seq7,r_85_16_147,seq2,r_85_16_147,0.89,-21,126,147,22
35,r_85_16_147,seq7,r_94_98_60,r_94_98_60,0.81,91,151,60,22
44,r_103_95_103,r_75_3_64,r_122_123_51,r_103_95_103,0.56,-50,53,103,22
12,r_34_67_71,r_142_49_152,seq21,r_34_67_71,0.87,0,71,71,22
39,r_93_108_35,r_17_145_192,seq61,r_93_108_35,0.75,1,36,35,22
93,seq104,r_116_34_143,seq13,r_116_34_143,0.94,5,148,143,23
40,r_60_41_66,r_90_88_175,r_110_73_180,r_60_41_66,0.5,117,183,66,23
30,r_113_44_126,seq149,seq57,r_113_44_126,1.0,0,126,126,23
1,r_22_2_39,r_107_121_68,r_140_68_116,r_22_2_39,0.63,90,129,39,23
92,seq97,r_5_16_146,r_101_122_27,r_5_16_146,0.99,1,147,146,23
14,r_12_4_83,r_140_68_116,seq13,r_12_4_83,0.97,0,83,83,23
8,r_116_34_143,seq104,r_77_19_73,r_116_34_143,0.74,0,143,143,23
43,r_18_93_115,seq13,seq11,r_18_93_115,0.98,2,117,115,23
13,r_49_82_51,r_6_112_140,r_99_84_47,r_6_112_140,1.0,-88,52,140,23
37,r_31_129_75,seq61,r_64_17_49,r_31_129_75,1.0,0,75,75,23
21,r_107_121_68,seq135,seq128,r_107_121_68,1.0,0,68,68,23
39,r_148_70_147,r_138_94_168,r_12_4_83,r_12_4_83,0.78,65,148,83,23
46,r_77_19_73,seq106,r_138_94_168,r_138_94_168,0.78,-93,75,168,23
42,r_109_72_165,seq9,seq65,r_109_72_165,0.72,0,165,165,23
1,r_22_2_39,r_140_68_116,r_64_17_49,r_22_2_39,0.34,137,176,39,23
80,seq66,r_90_88_175,r_15_32_58,r_15_32_58,1.0,13,71,58,23
45,r_67_103_141,r_63_26_167,r_115_108_199,r_115_108_199,0.52,-57,142,199,23
16,r_86_36_36,r_3_147_154,seq9,r_86_36_36,0.9,2,38,36,23
19,r_45_42_19,seq81,r_71_100_8,r_45_42_19,1.0,0,19,19,23
95,seq114,r_89_143_125,r_48_98_77,r_48_98_77,1.0,52,129,77,23
11,r_20_53_13,r_64_17_49,r_144_111_1,r_20_53_13,1.0,0,13,13,23
31,r_63_26_167,r_67_103_141,r_30_40_113,r_30_40_113,0.81,29,142,113,23
12,r_101_122_27,r_140_68_116,r_105_33_187,r_140_68_116,0.75,-89,27,116,23
3,r_3_147_154,r_74_21_29,seq61,r_3_147_154,0.93,3,157,154,23
10,r_46_35_61,seq145,r_3_147_154,r_46_35_61,1.0,0,61,61,23
15,r_8_78_23,r_89_143_125,r_71_100_8,r_8_78_23,0.98,0,23,23,23
9,r_120_132_24,r_110_73_180,seq59,r_120_132_24,0.99,0,24,24,23
26,r_30_40_113,seq39,seq76,r_30_40_113,1.0,0,113,113,23
14,r_12_4_83,seq13,r_148_70_147,r_148_70_147,1.0,1,148,147,23
78,seq62,r_110_73_180,r_49_82_51,r_49_82_51,1.0,55,106,51,23
0,r_27_119_133,r_63_26_167,r_46_35_61,r_46_35_61,0.82,77,138,61,23
63,seq149,r_113_44_126,seq61,r_113_44_126,1.0,0,126,126,23
5,r_56_14_40,r_89_143_125,r_86_36_36,r_56_14_40,1.0,0,40,40,23
20,r_51_23_148,seq131,seq106,r_51_23_148,0.81,1,149,148,23
46,r_77_19_73,r_138_94_168,r_116_34_143,r_116_34_143,0.99,32,175,143,23
48,r_80_102_130,seq1,seq39,r_80_102_130,0.95,0,130,130,23
18,r_15_32_58,seq59,seq66,r_15_32_58,1.0,0,58,58,23
1,r_22_2_39,r_48_98_77,r_107_121_68,r_22_2_39,0.79,39,78,39,23
2,r_90_88_175,r_60_41_66,r_101_122_27,r_90_88_175,0.55,8,183,175,23
99,seq126,r_138_94_168,r_3_147_154,r_3_147_154,0.97,21,175,154,23
31,r_63_26_167,r_30_40_113,r_49_82_51,r_63_26_167,0.89,0,167,167,23
10,r_46_35_61,r_3_147_154,r_27_119_133,r_46_35_61,0.54,96,157,61,23
32,r_37_124_15,r_90_88_175,seq118,r_37_124_15,0.8,0,15,15,23
27,r_123_25_185,seq11,r_56_14_40,r_56_14_40,1.0,147,187,40,23
29,r_64_17_49,seq133,seq1,r_64_17_49,1.0,0,49,49,23
2,r_90_88_175,seq66,r_60_41_66,r_60_41_66,1.0,5,71,66,23
40,r_60_41_66,seq104,r_90_88_175,r_60_41_66,1.0,0,66,66,23
24,r_83_117_106,r_5_16_146,seq29,r_83_117_106,0.77,2,108,106,23
25,r_74_21_29,r_3_147_154,r_27_119_133,r_74_21_29,0.6,128,157,29,23
33,r_110_73_180,seq62,r_60_41_66,r_110_73_180,0.58,0,180,180,23
38,r_115_108_199,seq54,r_67_103_141,r_67_103_141,1.0,10,151,141,23
34,r_136_127_182,seq38,r_140_68_116,r_140_68_116,1.0,67,183,116,23
6,r_48_98_77,seq59,r_22_2_39,r_22_2_39,1.0,1,40,39,23
6,r_48_98_77,r_22_2_39,seq114,r_48_98_77,0.99,1,78,77,23
94,seq106,r_77_19_73,r_51_23_148,r_51_23_148,0.98,0,148,148,23
47,r_99_84_47,r_107_121_68,seq62,r_99_84_47,0.55,2,49,47,23
28,r_89_143_125,seq114,r_80_102_130,r_80_102_130,0.68,-1,129,130,23
36,r_144_111_1,r_89_143_125,r_20_53_13,r_144_111_1,0.69,40,41,1,23
49,r_138_94_168,seq126,seq106,r_138_94_168,0.42,7,175,168,23
56,seq9,r_51_23_148,r_56_14_40,r_56_14_40,0.61,29,69,40,23
7,r_140_68_116,seq24,r_120_132_24,r_140_68_116,1.0,0,116,116,23
44,r_91_146_84,r_83_117_106,seq145,r_91_146_84,1.0,0,84,84,23
23,r_0_43_145,r_5_16_146,r_6_112_140,r_5_16_146,0.98,-47,99,146,23
35,r_52_134_105,seq57,seq76,r_52_134_105,1.0,1,106,105,23
1,r_22_2_39,r_60_41_66,r_48_98_77,r_22_2_39,1.0,1,40,39,23
84,seq76,r_27_119_133,r_30_40_113,r_30_40_113,0.99,3,116,113,23
30,r_7_31_97,seq42,seq68,r_7_31_97,0.93,0,97,97,24
9,r_70_128_47,r_97_119_140,r_126_3_93,r_70_128_47,1.0,93,140,47,24
14,r_28_6_188,seq73,r_74_102_179,r_74_102_179,0.5,11,190,179,24
82,seq80,r_74_102_179,r_124_115_19,r_124_115_19,0.95,-4,15,19,24
26,r_134_53_56,seq63,seq89,r_134_53_56,1.0,-4,52,56,24
16,r_149_2_89,seq105,seq110,r_149_2_89,0.77,-13,76,89,24
39,r_98_92_87,r_104_113_141,r_64_44_13,r_98_92_87,0.96,0,87,87,24
12,r_35_23_53,seq51,seq133,r_35_23_53,0.76,-4,49,53,24
5,r_141_57_182,r_116_78_5,seq63,r_116_78_5,0.48,177,182,5,24
46,r_41_88_69,r_84_62_104,seq73,r_41_88_69,0.62,0,69,69,24
45,r_135_9_80,seq5,r_146_12_8,r_135_9_80,0.95,0,80,80,24
24,r_30_45_18,r_135_9_80,seq105,r_30_45_18,0.69,0,18,18,24
43,r_124_115_19,r_101_112_191,seq80,r_124_115_19,0.63,1,20,19,24
13,r_108_4_26,r_22_83_60,seq75,r_108_4_26,0.46,0,26,26,24
38,r_122_125_175,r_91_27_17,r_95_103_45,r_91_27_17,0.64,161,178,17,24
36,r_17_48_44,r_74_102_179,r_116_78_5,r_17_48_44,0.82,0,44,44,24
4,r_11_96_132,r_28_6_188,seq69,r_11_96_132,0.79,0,132,132,24
38,r_122_125_175,seq52,r_91_27_17,r_122_125_175,0.59,-146,29,175,24
31,r_139_55_185,r_74_102_179,seq16,r_74_102_179,0.57,-147,32,179,24
8,r_136_65_58,seq137,seq106,r_136_65_58,0.88,-5,53,58,24
6,r_131_81_145,seq85,r_35_23_53,r_35_23_53,0.51,105,158,53,24
1,r_95_103_45,seq52,seq137,r_95_103_45,0.91,3,48,45,24
48,r_91_27_17,r_74_102_179,r_122_125_175,r_91_27_17,0.93,1,18,17,24
9,r_70_128_47,r_84_62_104,r_97_119_140,r_70_128_47,0.75,-2,45,47,24
17,r_130_47_49,r_7_31_97,r_91_27_17,r_130_47_49,0.94,0,49,49,24
2,r_74_102_179,r_114_38_133,seq10,r_114_38_133,0.68,-43,90,133,24
47,r_58_1_100,seq67,seq90,r_58_1_100,1.0,0,100,100,24
40,r_32_50_98,seq67,r_149_2_89,r_32_50_98,1.0,1,99,98,24
28,r_121_34_40,seq79,seq142,r_121_34_40,0.9,1,41,40,24
74,seq68,r_28_6_188,r_7_31_97,r_7_31_97,1.0,2,99,97,24
35,r_87_100_57,r_141_57_182,r_60_82_9,r_87_100_57,1.0,0,57,57,24
48,r_91_27_17,r_122_125_175,r_130_47_49,r_130_47_49,0.76,129,178,49,24
29,r_8_144_50,r_74_102_179,r_21_99_55,r_8_144_50,0.66,5,55,50,24
32,r_22_83_60,seq127,r_17_48_44,r_22_83_60,1.0,-2,58,60,24
44,r_21_99_55,seq129,r_8_144_50,r_21_99_55,0.52,0,55,55,24
65,seq39,r_122_125_175,r_148_46_41,r_148_46_41,1.0,129,170,41,24
68,seq52,seq75,r_8_144_50,r_8_144_50,0.61,32,82,50,24
66,seq42,r_7_31_97,seq69,r_7_31_97,1.0,-44,53,97,24
3,r_14_29_31,r_122_125_175,r_116_78_5,r_14_29_31,0.89,-10,21,31,24
31,r_139_55_185,seq16,r_71_56_142,r_71_56_142,0.95,44,186,142,24
0,r_66_43_25,r_145_117_146,seq80,r_66_43_25,0.95,0,25,25,24
22,r_104_113_141,seq20,seq105,r_104_113_141,0.63,0,141,141,24
63,seq133,seq63,r_35_23_53,r_35_23_53,0.7,-3,50,53,24
27,r_148_46_41,seq63,seq75,r_148_46_41,1.0,0,41,41,24
78,seq75,seq52,r_148_46_41,r_148_46_41,1.0,0,41,41,24
30,r_108_37_194,seq45,r_112_102_37,r_112_102_37,1.0,83,120,37,25
5,r_137_100_45,seq30,seq48,r_137_100_45,1.0,0,45,45,25
35,r_26_60_124,r_32_52_73,r_61_21_61,r_26_60_124,0.94,0,124,124,25
37,r_139_18_55,seq140,r_69_96_185,r_139_18_55,0.98,0,55,55,25
14,r_86_88_93,r_23_11_177,seq3,r_86_88_93,0.72,1,94,93,25
88,seq93,r_112_102_37,seq40,r_112_102_37,1.0,0,37,37,25
8,r_64_80_111,r_26_60_124,r_97_129_92,r_26_60_124,0.63,-13,111,124,25
43,r_147_104_113,seq140,r_73_10_116,r_147_104_113,0.98,0,113,113,25
6,r_125_28_170,seq75,r_33_116_15,r_125_28_170,0.97,0,170,170,25
27,r_109_87_11,r_16_20_191,seq99,r_109_87_11,0.99,1,12,11,25
18,r_89_38_29,r_97_129_92,r_64_80_111,r_89_38_29,0.86,3,32,29,25
83,seq67,r_42_68_140,seq132,r_42_68_140,0.95,13,153,140,25
21,r_15_126_108,seq5,r_32_52_73,r_32_52_73,1.0,44,117,73,25
46,r_1_91_125,r_16_20_191,seq62,r_1_91_125,0.99,0,125,125,25
88,seq93,seq40,r_73_10_116,r_73_10_116,0.88,11,127,116,25
39,r_128_84_86,r_108_37_194,r_112_102_37,r_112_102_37,0.99,10,47,37,25
66,seq133,seq22,r_13_24_154,r_13_24_154,0.99,1,155,154,25
33,r_32_52_73,r_26_60_124,r_15_126_108,r_26_60_124,1.0,0,124,124,25
41,r_55_134_121,seq51,r_9_103_10,r_55_134_121,1.0,1,122,121,25
47,r_6_113_28,r_111_58_48,seq146,r_6_113_28,0.78,0,28,28,25
90,seq98,r_57_43_188,r_50_141_56,r_50_141_56,0.98,13,69,56,25
15,r_33_116_15,r_55_134_121,seq14,r_33_116_15,0.92,0,15,15,25
72,seq41,seq45,r_64_80_111,r_64_80_111,1.0,9,120,111,25
12,r_130_49_99,r_65_107_50,r_142_114_44,r_130_49_99,1.0,-48,51,99,25
4,r_149_123_184,seq46,r_142_114_44,r_142_114_44,1.0,141,185,44,25
11,r_50_141_56,seq133,seq98,r_50_141_56,0.97,11,67,56,25
20,r_97_129_92,seq39,seq48,r_97_129_92,1.0,2,94,92,25
13,r_77_4_83,r_9_103_10,seq85,r_77_4_83,1.0,0,83,83,25
48,r_61_21_61,r_69_96_185,r_9_103_10,r_61_21_61,1.0,0,61,61,25
57,seq14,r_138_118_82,r_33_116_15,r_138_118_82,0.96,0,82,82,25
36,r_25_29_53,r_77_4_83,r_50_141_56,r_50_141_56,1.0,-2,54,56,25
6,r_125_28_170,seq75,seq17,r_125_28_170,0.5,-98,72,170,25
29,r_2_81_12,r_65_107_50,seq136,r_2_81_12,0.51,2,14,12,25
1,r_111_58_48,r_12_74_143,r_89_38_29,r_111_58_48,1.0,0,48,48,25
23,r_112_102_37,seq93,r_128_84_86,r_112_102_37,1.0,0,37,37,25
40,r_144_82_139,seq27,seq8,r_144_82_139,0.79,0,139,139,25
74,seq45,seq41,r_112_102_37,r_112_102_37,1.0,141,178,37,25
49,r_9_103_10,r_137_100_45,r_130_49_99,r_130_49_99,0.68,7,106,99,25
33,r_32_52_73,seq45,r_26_60_124,r_32_52_73,1.0,1,74,73,25
6,r_125_28_170,seq17,seq75,r_125_28_170,0.62,-37,133,170,25
38,r_13_24_154,seq44,seq133,r_13_24_154,0.95,0,154,154,25
34,r_66_76_142,seq59,r_50_141_56,r_66_76_142,0.83,0,142,142,25
75,seq46,r_149_123_184,r_50_141_56,r_50_141_56,0.99,129,185,56,25
37,r_139_18_55,r_69_96_185,r_128_84_86,r_128_84_86,1.0,7,93,86,25
39,r_128_84_86,r_112_102_37,r_139_18_55,r_128_84_86,0.89,2,88,86,25
17,r_63_72_59,seq8,seq54,r_63_72_59,1.0,1,60,59,25
9,r_73_10_116,seq117,r_147_104_113,r_147_104_113,0.86,4,117,113,25
32,r_95_121_20,r_77_4_83,seq36,r_95_121_20,0.99,0,20,20,25
16,r_92_131_57,seq3,r_83_70_198,r_92_131_57,0.98,-4,53,57,25
22,r_56_115_147,r_42_68_140,r_86_88_93,r_56_115_147,0.83,0,147,147,25
10,r_106_79_51,seq39,r_142_114_44,r_142_114_44,0.92,11,55,44,25
28,r_138_118_82,seq14,r_6_113_28,r_138_118_82,1.0,0,82,82,25
91,seq99,r_69_96_185,r_109_87_11,r_109_87_11,0.88,97,108,11,25
0,r_142_114_44,r_92_131_57,r_106_79_51,r_142_114_44,1.0,2,46,44,25
49,r_9_103_10,r_77_4_83,r_137_100_45,r_9_103_10,0.68,73,83,10,25
56,seq140,r_139_18_55,seq3,r_139_18_55,1.0,0,55,55,25
18,r_89_38_29,r_64_80_111,r_111_58_48,r_64_80_111,1.0,-19,92,111,25
44,r_101_53_66,r_135_90_137,seq27,r_101_53_66,0.99,1,67,66,25
23,r_112_102_37,r_128_84_86,r_108_37_194,r_128_84_86,1.0,2,88,86,25
35,r_26_60_124,r_64_80_111,r_32_52_73,r_32_52_73,0.95,19,92,73,25
12,r_130_49_99,r_142_114_44,r_9_103_10,r_130_49_99,0.98,0,99,99,25
30,r_91_108_144,r_124_11_173,r_46_123_8,r_124_11_173,0.7,-29,144,173,26
14,r_67_70_65,seq116,r_107_113_18,r_67_70_65,0.94,5,70,65,26
8,r_47_89_152,seq126,r_67_70_65,r_47_89_152,0.87,1,153,152,26
43,r_122_146_183,seq130,r_60_32_129,r_122_146_183,0.42,0,183,183,26
46,r_10_120_24,r_60_32_129,seq42,r_10_120_24,1.0,1,25,24,26
16,r_81_92_170,r_122_146_183,seq20,r_81_92_170,0.73,0,170,170,26
21,r_58_62_70,r_24_75_186,seq22,r_58_62_70,0.95,1,71,70,26
42,r_55_119_103,r_84_57_194,seq76,r_55_119_103,0.91,-5,98,103,26
37,r_37_144_15,r_97_74_163,seq85,r_37_144_15,0.82,-1,14,15,26
69,seq129,seq116,r_44_95_58,r_44_95_58,0.96,73,131,58,26
45,r_135_36_150,seq118,r_44_95_58,r_135_36_150,0.97,0,150,150,26
0,r_79_145_22,r_135_36_150,seq45,r_79_145_22,1.0,0,22,22,26
19,r_13_128_87,seq22,seq14,r_13_128_87,0.98,-1,86,87,26
23,r_148_40_30,r_97_74_163,seq143,r_148_40_30,1.0,-1,29,30,26
9,r_83_8_23,r_63_103_147,seq141,r_83_8_23,0.96,0,23,23,26
31,r_78_99_79,seq141,r_25_101_9,r_78_99_79,0.96,0,79,79,26
12,r_23_16_31,r_73_134_140,seq133,r_23_16_31,0.97,-4,27,31,26
10,r_5_6_92,r_142_64_137,seq53,r_5_6_92,0.58,0,92,92,26
47,r_65_28_17,r_63_103_147,r_59_68_81,r_65_28_17,0.97,1,18,17,26
15,r_44_95_58,seq4,r_96_9_84,r_44_95_58,0.59,46,104,58,26
4,r_131_43_113,r_81_92_170,r_80_140_5,r_131_43_113,0.85,1,114,113,26
63,seq20,r_96_9_84,seq143,r_96_9_84,1.0,-17,67,84,26
11,r_82_52_107,r_39_15_105,r_23_16_31,r_39_15_105,0.94,1,106,105,26
13,r_59_68_81,r_131_43_113,r_78_99_79,r_78_99_79,0.99,2,81,79,26
15,r_44_95_58,r_80_140_5,seq4,r_44_95_58,0.7,10,68,58,26
6,r_35_106_60,seq129,seq38,r_35_106_60,1.0,0,60,60,26
20,r_107_113_18,r_47_89_152,r_24_75_186,r_107_113_18,1.0,0,18,18,26
79,seq147,r_61_87_171,r_30_77_20,r_30_77_20,0.66,39,59,20,26
3,r_30_77_20,r_78_99_79,seq147,r_30_77_20,0.94,0,20,20,26
34,r_21_54_19,r_23_16_31,seq130,r_21_54_19,0.99,0,19,19,26
40,r_94_51_28,r_61_87_171,seq147,r_94_51_28,0.57,52,80,28,26
18,r_124_11_173,r_91_108_144,r_139_88_88,r_139_88_88,0.81,86,174,88,26
24,r_138_111_69,r_84_57_194,r_65_28_17,r_138_111_69,1.0,0,69,69,26
25,r_142_64_137,seq3,r_79_145_22,r_142_64_137,0.85,3,140,137,26
33,r_31_137_172,seq17,r_55_119_103,r_31_137_172,0.43,2,174,172,26
64,seq22,r_13_128_87,r_58_62_70,r_13_128_87,0.61,-1,86,87,26
47,r_65_28_17,r_59_68_81,seq130,r_59_68_81,1.0,0,81,81,26
58,seq14,r_125_12_184,r_13_128_87,r_13_128_87,1.0,47,134,87,26
68,seq38,r_125_12_184,r_35_106_60,r_35_106_60,1.0,124,184,60,26
32,r_73_134_140,seq115,r_25_101_9,r_73_134_140,0.51,0,140,140,26
38,r_39_15_105,r_82_52_107,seq126,r_39_15_105,0.99,1,106,105,26
29,r_105_136_12,seq147,seq3,r_105_136_12,1.0,0,12,12,26
84,seq85,r_63_103_147,r_37_144_15,r_37_144_15,0.92,12,27,15,26
96,seq118,r_135_36_150,seq66,r_135_36_150,1.0,0,150,150,26
22,r_139_88_88,r_61_87_171,r_138_111_69,r_61_87_171,0.99,-83,88,171,26
28,r_26_29_61,seq85,r_23_16_31,r_26_29_61,0.97,0,61,61,26
49,r_80_140_5,r_25_101_9,r_131_43_113,r_131_43_113,1.0,12,125,113,26
7,r_93_149_162,r_125_12_184,seq147,r_125_12_184,0.53,-22,162,184,26
44,r_96_9_84,seq20,r_44_95_58,r_96_9_84,0.99,1,85,84,26
51,seq3,r_41_75_174,r_145_44_63,r_145_44_63,0.66,48,111,63,27
55,seq9,r_88_139_69,seq55,r_88_139_69,0.98,1,70,69,27
1,r_85_27_140,r_122_52_197,r_120_143_159,r_122_52_197,0.93,-54,143,197,27
5,r_86_129_107,r_23_80_167,r_102_123_61,r_86_129_107,0.82,2,109,107,27
46,r_132_142_125,r_85_27_140,seq149,r_132_142_125,0.84,1,126,125,27
42,r_21_35_70,seq148,r_7_17_192,r_21_35_70,1.0,0,70,70,27
19,r_81_116_171,r_36_58_127,seq29,r_36_58_127,1.0,1,128,127,27
6,r_37_136_50,r_92_76_126,seq46,r_37_136_50,1.0,3,53,50,27
34,r_0_126_41,r_115_51_130,seq57,r_0_126_41,0.5,11,52,41,27
30,r_12_90_59,seq29,seq148,r_12_90_59,1.0,0,59,59,27
65,seq32,r_145_44_63,seq87,r_145_44_63,0.62,-4,59,63,27
27,r_39_105_81,seq87,r_147_18_168,r_147_18_168,0.53,-45,123,168,27
41,r_107_14_199,r_67_31_114,r_118_30_77,r_118_30_77,1.0,32,109,77,27
19,r_81_116_171,seq29,r_36_58_127,r_81_116_171,0.88,0,171,171,27
10,r_67_31_114,seq78,seq149,r_67_31_114,0.45,5,119,114,27
39,r_138_70_10,seq63,seq124,r_138_70_10,1.0,0,10,10,27
26,r_36_58_127,r_81_116_171,seq6,r_36_58_127,0.57,1,128,127,27
78,seq78,r_67_31_114,r_118_30_77,r_118_30_77,1.0,42,119,77,27
11,r_2_61_115,r_68_1_134,r_0_126_41,r_68_1_134,0.81,-17,117,134,27
20,r_33_106_188,seq49,r_85_27_140,r_85_27_140,0.99,48,188,140,27
13,r_64_97_179,seq55,seq72,r_64_97_179,0.76,0,179,179,27
48,r_130_117_85,seq94,r_145_44_63,r_130_117_85,0.99,2,87,85,27
9,r_135_42_13,r_33_106_188,r_138_70_10,r_135_42_13,1.0,0,13,13,27
27,r_39_105_81,r_41_75_174,seq87,r_39_105_81,0.68,1,82,81,27
2,r_145_44_63,r_85_27_140,seq3,r_145_44_63,0.52,0,63,63,27
15,r_54_48_23,r_7_17_192,seq49,r_54_48_23,0.74,-5,18,23,27
24,r_88_139_69,seq9,seq38,r_88_139_69,0.89,1,70,69,27
64,seq29,r_12_90_59,r_125_96_44,r_12_90_59,1.0,-8,51,59,27
70,seq57,r_85_27_140,r_2_61_115,r_85_27_140,1.0,4,144,140,27
38,r_118_30_77,seq19,r_107_14_199,r_118_30_77,0.95,0,77,77,27
21,r_125_96_44,r_10_11_164,seq29,r_10_11_164,0.52,-112,52,164,27
96,seq113,r_41_75_174,r_10_11_164,r_41_75_174,0.62,-5,169,174,27
28,r_23_80_167,r_59_24_194,seq78,r_59_24_194,0.45,-27,167,194,27
49,r_45_127_72,r_120_143_159,r_5_40_49,r_45_127_72,1.0,0,72,72,27
82,seq89,r_92_76_126,r_5_40_49,r_92_76_126,0.59,3,129,126,27
35,r_122_52_197,r_85_27_140,r_114_50_142,r_85_27_140,1.0,3,143,140,27
12,r_103_43_94,seq38,r_59_24_194,r_103_43_94,0.83,1,95,94,27
26,r_104_65_61,seq132,r_125_57_50,r_104_65_61,0.6,64,125,61,28
36,r_10_79_169,r_37_146_172,r_125_57_50,r_125_57_50,0.54,120,170,50,28
6,r_135_53_20,seq22,seq133,r_135_53_20,0.94,0,20,20,28
0,r_78_16_11,r_84_85_33,seq15,r_78_16_11,0.82,0,11,11,28
43,r_122_55_98,seq0,r_77_111_79,r_122_55_98,0.97,0,98,98,28
59,seq140,seq4,r_64_126_102,r_64_126_102,0.92,1,103,102,28
71,seq34,r_143_105_175,seq138,r_143_105_175,0.52,-75,100,175,28
39,r_11_20_185,seq90,r_64_126_102,r_11_20_185,0.57,0,185,185,28
1,r_64_126_102,seq132,seq140,r_64_126_102,0.95,1,103,102,28
46,r_71_60_111,r_129_63_121,r_17_30_39,r_17_30_39,0.55,72,111,39,28
42,r_148_131_124,r_17_30_39,r_135_53_20,r_148_131_124,0.95,0,124,124,28
19,r_47_41_155,seq45,r_145_144_21,r_145_144_21,0.52,142,163,21,28
63,seq19,r_17_30_39,r_36_31_19,r_36_31_19,1.0,1,20,19,28
31,r_130_117_162,seq67,r_64_126_102,r_64_126_102,0.95,60,162,102,28
47,r_147_119_28,r_113_139_64,r_17_30_39,r_17_30_39,1.0,-11,28,39,28
7,r_84_85_33,r_143_105_175,seq1,r_84_85_33,0.68,1,34,33,28
3,r_113_139_64,r_54_97_81,r_114_83_38,r_113_139_64,0.56,0,64,64,28
4,r_9_116_59,r_134_52_114,seq115,r_9_116_59,1.0,-1,58,59,28
26,r_104_65_61,seq133,seq132,r_104_65_61,0.52,22,83,61,28
83,seq68,seq4,r_125_57_50,r_125_57_50,1.0,5,55,50,28
11,r_128_74_112,seq8,r_43_127_105,r_128_74_112,0.7,0,112,112,28
20,r_73_98_100,seq28,r_17_30_39,r_73_98_100,0.87,2,102,100,28
13,r_129_63_121,seq141,seq90,r_129_63_121,0.98,1,122,121,28
57,seq138,r_5_88_171,seq27,r_5_88_171,0.68,0,171,171,28
27,r_134_52_114,r_9_116_59,seq45,r_9_116_59,1.0,-4,55,59,28
8,r_96_24_22,r_94_110_86,seq0,r_96_24_22,1.0,0,22,22,28
2,r_72_69_4,r_54_97_81,r_103_100_85,r_72_69_4,0.62,83,87,4,28
61,seq15,r_64_126_102,r_78_16_11,r_78_16_11,1.0,1,12,11,28
40,r_37_146_172,seq50,r_113_139_64,r_113_139_64,1.0,112,176,64,28
18,r_48_6_99,seq18,r_77_111_79,r_77_111_79,0.57,19,98,79,28
29,r_13_51_139,seq133,r_80_26_8,r_13_51_139,0.71,0,139,139,28
24,r_3_35_113,seq45,r_72_69_4,r_3_35_113,0.95,0,113,113,28
25,r_143_105_175,seq75,r_12_108_165,r_12_108_165,0.97,12,177,165,28
48,r_95_40_45,r_14_107_71,seq18,r_14_107_71,0.66,-27,44,71,28
34,r_77_111_79,r_94_110_86,r_3_35_113,r_77_111_79,0.58,0,79,79,28
45,r_54_97_81,r_72_69_4,r_96_24_22,r_54_97_81,1.0,0,81,81,28
17,r_14_107_71,seq39,seq8,r_14_107_71,1.0,0,71,71,28
21,r_125_57_50,r_142_124_186,seq68,r_125_57_50,0.98,2,52,50,28
9,r_142_124_186,seq2,seq138,r_142_124_186,0.19,2,188,186,28
22,r_103_100_85,r_129_63_121,r_72_69_4,r_103_100_85,0.96,1,86,85,28
28,r_81_23_101,r_143_105_175,r_102_29_62,r_143_105_175,1.0,-74,101,175,28
49,r_36_31_19,r_130_117_162,seq19,r_36_31_19,0.96,0,19,19,28
34,r_77_111_79,r_3_35_113,r_48_6_99,r_77_111_79,0.58,20,99,79,28
44,r_102_29_62,r_17_30_39,seq58,r_102_29_62,1.0,0,62,62,28
23,r_5_88_171,seq138,r_9_116_59,r_9_116_59,1.0,112,171,59,28
35,r_149_121_168,seq1,r_94_110_86,r_94_110_86,0.42,82,168,86,28
12,r_114_83_38,r_128_74_112,r_89_91_192,r_114_83_38,0.99,0,38,38,28
21,r_6_106_53,seq2,seq88,r_6_106_53,1.0,1,54,53,29
4,r_14_138_13,r_145_40_64,seq122,r_14_138_13,0.97,0,13,13,29
36,r_80_126_5,r_105_17_155,seq12,r_105_17_155,0.81,-3,152,155,29
8,r_128_59_175,seq130,r_31_9_55,r_31_9_55,0.97,120,175,55,29
43,r_149_69_151,seq111,seq32,r_149_69_151,0.79,1,152,151,29
37,r_64_116_148,r_99_112_199,seq76,r_64_116_148,0.29,16,164,148,29
55,seq10,r_54_104_89,r_97_42_16,r_97_42_16,0.57,62,78,16,29
40,r_97_42_16,r_108_133_191,seq10,r_97_42_16,1.0,-1,15,16,29
39,r_99_112_199,r_64_116_148,r_65_147_133,r_65_147_133,0.99,32,165,133,29
1,r_39_57_123,seq53,r_48_47_84,r_39_57_123,0.86,0,123,123,29
46,r_20_27_103,r_39_57_123,seq144,r_39_57_123,0.58,-19,104,123,29
18,r_83_92_28,seq32,r_84_35_132,r_83_92_28,1.0,1,29,28,29
69,seq38,r_51_77_159,r_50_60_125,r_50_60_125,1.0,44,169,125,29
45,r_51_77_159,r_65_147_133,r_82_113_58,r_51_77_159,0.87,-23,136,159,29
15,r_1_142_38,seq85,seq130,r_1_142_38,1.0,4,42,38,29
19,r_50_60_125,seq63,seq38,r_50_60_125,0.97,2,127,125,29
11,r_145_40_64,seq148,r_39_57_123,r_39_57_123,1.0,8,131,123,29
23,r_23_129_187,r_56_21_7,r_135_71_46,r_135_71_46,0.98,5,51,46,29
66,seq32,r_145_40_64,seq63,r_145_40_64,1.0,1,65,64,29
31,r_7_146_160,seq132,r_14_138_13,r_7_146_160,0.92,2,162,160,29
41,r_96_102_173,r_15_89_178,seq95,r_15_89_178,0.49,-4,174,178,29
0,r_31_9_55,r_54_104_89,r_6_106_53,r_31_9_55,1.0,3,58,55,29
3,r_25_41_122,seq148,seq19,r_25_41_122,1.0,0,122,122,29
26,r_110_49_62,r_44_58_80,r_135_71_46,r_110_49_62,1.0,0,62,62,29
16,r_84_35_132,r_83_92_28,r_54_104_89,r_84_35_132,1.0,4,136,132,29
63,seq148,r_25_41_122,r_145_40_64,r_145_40_64,0.64,0,64,64,29
11,r_145_40_64,seq32,seq148,r_145_40_64,1.0,1,65,64,29
13,r_15_89_178,r_96_102_173,r_14_138_13,r_15_89_178,0.44,0,178,178,29
6,r_109_30_104,seq61,r_140_13_65,r_109_30_104,1.0,0,104,104,29
89,seq91,seq67,r_36_127_39,r_36_127_39,1.0,-1,38,39,29
32,r_26_75_68,r_64_116_148,seq61,r_26_75_68,0.82,-17,51,68,29
42,r_0_115_18,r_145_40_64,seq132,r_0_115_18,0.94,-1,17,18,29
10,r_135_71_46,r_23_129_187,r_110_49_62,r_110_49_62,0.83,124,186,62,29
14,r_11_136_42,r_94_90_141,seq74,r_11_136_42,1.0,0,42,42,29
30,r_82_113_58,r_87_119_86,r_97_42_16,r_82_113_58,1.0,0,58,58,29
47,r_33_114_70,r_109_30_104,r_140_13_65,r_140_13_65,1.0,5,70,65,29
9,r_118_93_47,seq78,seq85,r_118_93_47,1.0,0,47,47,29
29,r_46_117_167,seq8,r_54_104_89,r_46_117_167,0.82,0,167,167,29
24,r_44_58_80,seq37,seq95,r_44_58_80,0.99,0,80,80,29
25,r_140_13_65,seq74,r_97_42_16,r_97_42_16,0.73,58,74,16,29
33,r_107_131_91,seq95,seq8,r_107_131_91,0.98,0,91,91,29
58,seq130,r_128_59_175,r_1_142_38,r_1_142_38,1.0,137,175,38,29
38,r_48_47_84,r_15_89_178,seq67,r_48_47_84,0.99,0,84,84,29
34,r_87_119_86,seq88,r_26_75_68,r_87_119_86,0.76,0,86,86,29
75,seq63,r_50_60_125,r_56_21_7,r_50_60_125,0.9,2,127,125,29
17,r_123_43_140,seq18,r_0_115_18,r_123_43_140,0.68,0,140,140,29
5,r_3_4_41,seq19,seq111,r_3_4_41,1.0,0,41,41,29
10,r_135_71_46,r_22_103_112,r_23_129_187,r_135_71_46,1.0,1,47,46,29
16,r_84_35_132,r_135_71_46,r_83_92_28,r_84_35_132,1.0,-97,35,132,29
22,r_94_90_141,r_46_117_167,r_39_57_123,r_94_90_141,0.75,0,141,141,29
28,r_65_147_133,r_51_77_159,r_99_112_199,r_65_147_133,0.94,3,136,133,29
35,r_36_127_39,r_135_71_46,seq91,r_36_127_39,0.99,1,40,39,29
49,r_105_17_155,r_80_126_5,r_54_104_89,r_80_126_5,0.58,150,155,5,29
7,r_54_104_89,seq10,r_11_136_42,r_11_136_42,1.0,47,89,42,29
18,r_83_92_28,r_84_35_132,r_31_9_55,r_83_92_28,0.81,108,136,28,29
44,r_134_73_113,r_108_133_191,r_54_104_89,r_134_73_113,1.0,0,113,113,29
23,r_23_129_187,r_135_71_46,r_39_57_123,r_23_129_187,0.28,-1,186,187,29
44,r_22_10_130,r_71_103_132,seq139,r_22_10_130,0.92,4,134,130,30
36,r_138_136_103,seq104,r_30_7_16,r_138_136_103,1.0,2,105,103,30
62,seq16,r_62_34_53,r_14_133_8,r_62_34_53,0.74,-25,28,53,30
28,r_102_132_27,r_65_21_129,r_115_106_4,r_102_132_27,0.92,0,27,27,30
92,seq108,r_130_143_131,seq123,r_130_143_131,1.0,-63,68,131,30
8,r_60_92_152,seq57,r_19_72_7,r_60_92_152,0.67,1,153,152,30
21,r_37_128_181,r_3_111_154,r_110_47_187,r_3_111_154,0.75,-3,151,154,30
39,r_100_79_91,r_22_10_130,r_117_112_71,r_22_10_130,1.0,-39,91,130,30
18,r_40_107_51,r_120_1_135,seq45,r_40_107_51,1.0,-1,50,51,30
5,r_110_47_187,r_98_82_171,r_3_111_154,r_3_111_154,0.96,36,190,154,30
46,r_26_87_111,r_65_21_129,seq42,r_65_21_129,0.97,-51,78,129,30
14,r_62_34_53,r_115_106_4,seq142,r_62_34_53,0.88,-3,50,53,30
69,seq36,r_54_63_117,seq123,r_54_63_117,0.72,-19,98,117,30
45,r_32_89_144,r_110_47_187,r_102_132_27,r_32_89_144,0.8,0,144,144,30
19,r_3_111_154,seq113,seq51,r_3_111_154,0.88,0,154,154,30
33,r_149_127_70,r_3_111_154,r_40_107_51,r_3_111_154,1.0,-2,152,154,30
21,r_37_128_181,r_110_47_187,seq104,r_37_128_181,0.99,0,181,181,30
31,r_93_68_78,seq12,r_83_23_76,r_93_68_78,1.0,2,80,78,30
37,r_131_55_48,r_138_136_103,seq8,r_131_55_48,0.86,0,48,48,30
3,r_67_80_188,seq84,r_148_4_22,r_148_4_22,0.91,167,189,22,30
10,r_134_124_83,seq139,seq24,r_134_124_83,1.0,0,83,83,30
26,r_73_64_65,seq140,r_19_72_7,r_73_64_65,0.99,0,65,65,30
1,r_148_4_22,r_62_34_53,seq2,r_148_4_22,0.98,5,27,22,30
0,r_65_21_129,r_99_90_168,seq109,r_99_90_168,0.57,-36,132,168,30
63,seq17,r_41_125_108,seq6,r_41_125_108,0.97,0,108,108,30
11,r_130_143_131,seq108,r_138_136_103,r_130_143_131,0.49,1,132,131,30
13,r_135_85_165,r_138_136_103,r_117_112_71,r_135_85_165,0.91,-89,76,165,30
98,seq123,r_147_33_127,seq108,r_147_33_127,1.0,-59,68,127,30
15,r_83_23_76,r_60_92_152,seq129,r_60_92_152,0.65,-84,68,152,30
6,r_147_33_127,seq123,r_39_44_13,r_147_33_127,0.77,0,127,127,30
27,r_41_125_108,seq17,seq75,r_41_125_108,0.91,0,108,108,30
38,r_49_88_55,seq129,seq12,r_49_88_55,1.0,1,56,55,30
2,r_20_145_95,seq0,seq69,r_20_145_95,1.0,0,95,95,30
12,r_39_44_13,r_130_143_131,seq140,r_39_44_13,0.84,0,13,13,30
29,r_98_82_171,r_110_47_187,r_86_52_42,r_86_52_42,0.86,148,190,42,30
33,r_149_127_70,seq9,r_3_111_154,r_149_127_70,0.72,5,75,70,30
32,r_117_112_71,r_110_47_187,seq141,r_117_112_71,1.0,1,72,71,30
77,seq139,seq66,r_22_10_130,r_22_10_130,0.96,7,137,130,30
34,r_61_38_182,seq137,seq36,r_61_38_182,0.46,0,182,182,30
75,seq57,r_60_92_152,seq74,r_60_92_152,0.7,1,153,152,30
4,r_86_52_42,r_147_33_127,seq45,r_86_52_42,0.82,-4,38,42,30
25,r_19_72_7,r_56_53_190,r_73_64_65,r_73_64_65,1.0,17,82,65,30
9,r_25_46_86,r_41_125_108,seq12,r_25_46_86,0.98,7,93,86,30
22,r_116_43_99,r_98_82_171,r_117_112_71,r_98_82_171,1.0,-71,100,171,30
7,r_58_48_94,seq97,r_30_7_16,r_58_48_94,0.78,0,94,94,30
44,r_22_10_130,r_100_79_91,r_71_103_132,r_100_79_91,1.0,-26,65,91,30
35,r_81_94_128,seq42,r_134_124_83,r_81_94_128,0.99,0,128,128,30
36,r_41_13_85,r_123_35_148,seq20,r_41_13_85,1.0,5,90,85,31
54,seq7,r_54_105_172,r_85_16_104,r_85_16_104,0.96,69,173,104,31
37,r_3_99_69,seq144,seq9,r_3_99_69,0.99,4,73,69,31
16,r_40_27_100,seq137,seq68,r_40_27_100,0.46,17,117,100,31
21,r_124_44_90,seq32,seq121,r_124_44_90,1.0,2,92,90,31
39,r_135_50_159,seq58,r_75_22_2,r_135_50_159,0.58,1,160,159,31
1,r_26_115_157,seq63,r_85_16_104,r_26_115_157,0.76,0,157,157,31
5,r_76_125_138,seq98,seq146,r_76_125_138,0.96,2,140,138,31
46,r_118_97_190,r_78_72_137,seq98,r_78_72_137,0.13,53,190,137,31
92,seq101,r_116_65_8,r_89_33_40,r_89_33_40,0.98,7,47,40,31
19,r_95_6_116,seq144,r_89_33_40,r_89_33_40,0.89,77,117,40,31
11,r_56_142_30,r_124_44_90,r_106_148_111,r_124_44_90,1.0,-55,35,90,31
34,r_77_110_53,seq0,r_71_149_52,r_77_110_53,1.0,1,54,53,31
0,r_126_80_43,seq9,r_30_134_164,r_126_80_43,0.98,0,43,43,31
31,r_127_130_78,seq133,seq46,r_127_130_78,1.0,0,78,78,31
67,seq32,r_124_44_90,r_48_59_179,r_124_44_90,1.0,2,92,90,31
3,r_15_2_147,seq81,r_139_112_64,r_15_2_147,0.62,8,155,147,31
4,r_139_112_64,r_40_27_100,seq96,r_139_112_64,0.46,3,67,64,31
33,r_136_69_28,r_139_112_64,seq144,r_136_69_28,0.73,-3,25,28,31
20,r_57_5_130,seq43,r_113_82_59,r_57_5_130,0.65,0,130,130,31
13,r_111_129_89,r_41_13_85,seq122,r_111_129_89,0.71,3,92,89,31
48,r_25_128_87,seq14,r_48_59_179,r_25_128_87,1.0,3,90,87,31
57,seq11,r_86_132_97,seq117,r_86_132_97,1.0,-6,91,97,31
28,r_45_53_37,r_92_10_161,r_104_31_20,r_45_53_37,1.0,0,37,37,31
6,r_54_105_172,seq7,r_15_2_147,r_54_105_172,0.78,1,173,172,31
26,r_104_31_20,r_126_80_43,seq62,r_104_31_20,1.0,0,20,20,31
99,seq122,seq9,r_111_129_89,r_111_129_89,1.0,8,97,89,31
9,r_113_82_59,r_40_27_100,r_104_31_20,r_113_82_59,1.0,0,59,59,31
27,r_94_38_75,seq58,r_73_87_35,r_94_38_75,1.0,3,78,75,31
92,seq101,r_51_90_154,r_116_65_8,r_116_65_8,0.72,5,13,8,31
47,r_51_90_154,seq88,r_95_6_116,r_51_90_154,0.49,5,159,154,31
30,r_42_79_51,r_127_130_78,seq140,r_42_79_51,1.0,0,51,51,31
24,r_141_145_66,seq8,r_29_52_198,r_141_145_66,1.0,0,66,66,31
40,r_89_33_40,r_141_145_66,seq101,r_89_33_40,0.73,0,40,40,31
65,seq20,seq144,r_41_13_85,r_41_13_85,0.99,3,88,85,31
61,seq144,r_95_6_116,r_75_22_2,r_95_6_116,0.81,1,117,116,31
32,r_29_52_198,r_86_132_97,r_141_145_66,r_29_52_198,0.64,-118,80,198,31
17,r_48_59_179,r_124_44_90,r_25_128_87,r_48_59_179,1.0,-89,90,179,31
14,r_21_4_58,r_74_19_124,seq133,r_21_4_58,1.0,0,58,58,31
41,r_119_37_48,r_15_2_147,r_106_148_111,r_119_37_48,0.47,0,48,48,31
49,r_85_16_104,seq81,seq7,r_85_16_104,1.0,1,105,104,31
56,seq9,seq122,r_3_99_69,r_3_99_69,0.9,14,83,69,31
23,r_74_19_124,seq46,seq32,r_74_19_124,1.0,1,125,124,31
79,seq63,r_26_115_157,seq43,r_26_115_157,1.0,0,157,157,31
12,r_55_91_96,r_57_5_130,seq60,r_55_91_96,1.0,0,96,96,31
45,r_92_10_161,r_45_53_37,seq58,r_45_53_37,1.0,0,37,37,31
2,r_18_28_45,r_77_110_53,seq81,r_18_28_45,1.0,0,45,45,31
40,r_45_46_123,r_113_40_1,seq7,r_45_46_123,1.0,0,123,123,32
43,r_147_144_194,r_71_114_156,seq146,r_71_114_156,1.0,-26,130,156,32
68,seq33,r_28_101_140,r_110_61_50,r_110_61_50,0.98,0,50,50,32
37,r_90_57_182,seq7,r_87_27_98,r_87_27_98,0.71,85,183,98,32
49,r_15_8_38,seq64,seq58,r_15_8_38,1.0,0,38,38,32
30,r_59_53_57,seq128,r_77_95_122,r_59_53_57,0.78,-4,53,57,32
21,r_1_120_65,r_63_140_81,r_110_61_50,r_1_120_65,0.66,0,65,65,32
1,r_87_27_98,seq70,r_26_50_80,r_87_27_98,1.0,0,98,98,32
5,r_28_101_140,seq33,seq70,r_28_101_140,0.65,2,142,140,32
42,r_71_114_156,r_90_57_182,seq83,r_71_114_156,0.88,0,156,156,32
45,r_19_81_77,seq47,seq16,r_19_81_77,1.0,0,77,77,32
85,seq74,r_121_38_132,r_115_141_32,r_115_141_32,0.98,1,33,32,32
31,r_113_40_1,r_45_46_123,r_37_125_12,r_45_46_123,0.88,0,123,123,32
41,r_26_50_80,r_77_95_122,seq20,r_77_95_122,0.94,-41,81,122,32
3,r_63_140_81,r_87_27_98,seq13,r_63_140_81,0.94,0,81,81,32
8,r_77_95_122,r_75_84_39,seq70,r_77_95_122,1.0,0,122,122,32
72,seq47,r_19_81_77,seq83,r_19_81_77,1.0,-10,67,77,32
78,seq56,seq70,r_106_14_121,r_106_14_121,0.99,5,126,121,32
19,r_66_82_44,r_19_81_77,seq29,r_66_82_44,1.0,1,45,44,32
29,r_43_67_2,seq107,r_44_4_45,r_44_4_45,0.88,14,59,45,32
11,r_89_85_97,r_97_102_141,r_59_53_57,r_89_85_97,1.0,0,97,97,32
13,r_118_3_125,seq58,r_136_25_15,r_118_3_125,1.0,0,125,125,32
48,r_75_84_39,r_77_95_122,r_89_85_97,r_75_84_39,0.86,83,122,39,32
6,r_60_93_99,r_118_3_125,seq11,r_60_93_99,0.93,0,99,99,32
27,r_32_109_55,r_90_57_182,seq49,r_32_109_55,1.0,0,55,55,32
8,r_77_95_122,r_26_50_80,r_75_84_39,r_75_84_39,0.66,-4,35,39,32
23,r_37_125_12,r_123_22_71,seq49,r_37_125_12,0.85,0,12,12,32
30,r_59_53_57,r_77_95_122,r_89_85_97,r_59_53_57,1.0,62,119,57,32
36,r_44_4_45,r_69_18_102,r_43_67_2,r_44_4_45,0.97,0,45,45,32
2,r_106_14_121,seq13,seq56,r_106_14_121,0.94,0,121,121,32
74,seq49,r_126_91_169,seq12,r_126_91_169,0.87,0,169,169,32
18,r_69_18_102,r_45_46_123,r_137_17_27,r_45_46_123,0.89,-21,102,123,32
24,r_99_34_167,seq21,r_111_35_64,r_111_35_64,0.5,103,167,64,32
33,r_121_38_132,seq74,seq21,r_121_38_132,0.98,0,132,132,32
12,r_115_141_32,seq11,seq74,r_115_141_32,0.99,0,32,32,32
58,seq12,r_142_124_111,seq49,r_142_124_111,0.97,-43,68,111,32
32,r_55_78_117,seq135,r_89_85_97,r_89_85_97,1.0,21,118,97,32
9,r_136_25_15,r_66_82_44,r_23_116_100,r_136_25_15,0.99,0,15,15,32
38,r_23_116_100,r_143_86_87,r_136_25_15,r_136_25_15,1.0,0,15,15,32
22,r_127_112_70,r_99_34_167,seq128,r_99_34_167,0.75,-100,67,167,32
28,r_123_22_71,seq98,r_59_53_57,r_123_22_71,1.0,1,72,71,32
40,r_45_46_123,r_69_18_102,r_113_40_1,r_69_18_102,0.91,-43,59,102,32
44,r_2_0_180,r_90_57_182,r_37_125_12,r_90_57_182,0.37,-2,180,182,32
79,seq58,r_60_93_99,seq54,r_60_93_99,1.0,-1,98,99,32
35,r_31_94_89,seq29,r_37_125_12,r_31_94_89,1.0,0,89,89,32
26,r_92_96_58,seq64,seq70,r_92_96_58,0.99,0,58,58,32
93,seq102,seq107,r_130_35_53,r_130_35_53,1.0,9,62,53,33
30,r_34_139_95,seq107,r_72_16_49,r_34_139_95,1.0,0,95,95,33
14,r_49_6_82,seq61,seq107,r_49_6_82,1.0,0,82,82,33
8,r_42_51_166,seq4,r_100_60_105,r_100_60_105,0.96,61,166,105,33
53,seq5,r_40_106_125,seq4,r_40_106_125,0.99,0,125,125,33
43,r_120_104_99,seq65,seq78,r_120_104_99,0.99,6,105,99,33
55,seq11,r_105_118_196,r_100_60_105,r_100_60_105,1.0,48,153,105,33
71,seq50,r_95_25_182,r_49_6_82,r_49_6_82,1.0,101,183,82,33
21,r_70_2_102,r_42_51_166,seq36,r_70_2_102,1.0,3,105,102,33
34,r_31_126_109,r_113_117_16,r_123_75_15,r_31_126_109,0.96,-94,15,109,33
32,r_56_87_13,r_37_7_147,r_103_125_52,r_37_7_147,0.84,-38,109,147,33
45,r_135_26_144,seq97,seq91,r_135_26_144,0.5,1,145,144,33
20,r_130_35_53,r_138_85_85,seq102,r_130_35_53,1.0,0,53,53,33
13,r_59_137_46,seq119,seq127,r_59_137_46,0.97,5,51,46,33
19,r_14_92_118,r_95_25_182,seq136,r_14_92_118,1.0,0,118,118,33
39,r_86_134_19,r_83_145_94,seq13,r_86_134_19,1.0,0,19,19,33
15,r_147_62_26,r_128_21_167,r_59_137_46,r_147_62_26,0.81,143,169,26,33
27,r_128_21_167,r_147_62_26,r_141_121_104,r_128_21_167,0.92,0,167,167,33
41,r_8_24_134,seq78,seq38,r_8_24_134,0.79,0,134,134,33
26,r_52_124_112,r_135_26_144,r_81_131_89,r_52_124_112,0.89,0,112,112,33
11,r_33_22_81,r_41_80_168,r_29_116_130,r_33_22_81,1.0,0,81,81,33
44,r_122_32_111,r_44_74_2,r_40_106_125,r_40_106_125,1.0,3,128,125,33
57,seq13,r_41_80_168,seq38,r_41_80_168,0.96,-78,90,168,33
23,r_123_75_15,r_100_60_105,r_31_126_109,r_123_75_15,0.96,0,15,15,33
27,r_128_21_167,seq127,r_147_62_26,r_147_62_26,1.0,30,56,26,33
99,seq127,r_128_21_167,r_59_137_46,r_59_137_46,0.6,66,112,46,33
28,r_113_117_16,r_3_17_188,seq78,r_113_117_16,0.95,-3,13,16,33
3,r_110_79_47,r_100_60_105,seq132,r_110_79_47,1.0,3,50,47,33
2,r_100_60_105,r_99_76_191,seq11,r_100_60_105,1.0,1,106,105,33
47,r_37_7_147,seq89,r_100_60_105,r_37_7_147,0.88,1,148,147,33
40,r_23_63_64,r_83_145_94,seq97,r_23_63_64,1.0,1,65,64,33
74,seq65,r_111_108_192,seq149,r_111_108_192,0.8,-11,181,192,33
18,r_41_80_168,seq13,r_33_22_81,r_33_22_81,1.0,87,168,81,33
24,r_77_45_92,seq143,seq13,r_77_45_92,1.0,2,94,92,33
34,r_31_126_109,r_123_75_15,seq142,r_123_75_15,0.58,104,119,15,33
32,r_56_87_13,r_34_139_95,r_37_7_147,r_56_87_13,0.98,0,13,13,33
25,r_83_145_94,r_23_63_64,r_99_76_191,r_23_63_64,0.99,1,65,64,33
33,r_138_85_85,seq144,seq71,r_138_85_85,1.0,0,85,85,33
6,r_47_9_173,seq82,r_40_106_125,r_47_9_173,0.76,1,174,173,33
68,seq36,seq65,r_70_2_102,r_70_2_102,1.0,37,139,102,33
15,r_147_62_26,seq82,r_128_21_167,r_147_62_26,0.99,-1,25,26,33
38,r_27_48_157,r_44_74_2,r_100_60_105,r_44_74_2,0.48,155,157,2,33
77,seq71,r_109_55_146,r_138_85_85,r_138_85_85,0.48,3,88,85,33
46,r_72_16_49,seq0,seq144,r_72_16_49,0.66,0,49,49,33
60,seq144,r_138_85_85,r_72_16_49,r_138_85_85,0.98,0,85,85,33
17,r_109_55_146,seq11,r_20_28_51,r_109_55_146,0.98,0,146,146,33
5,r_103_125_52,r_53_115_194,r_56_87_13,r_103_125_52,0.54,5,57,52,33
9,r_40_106_125,seq5,r_122_32_111,r_40_106_125,1.0,0,125,125,33
22,r_81_131_89,r_37_7_147,seq19,r_81_131_89,0.99,2,91,89,33
25,r_83_145_94,r_99_76_191,seq84,r_83_145_94,0.89,1,95,94,33
44,r_122_32_111,seq119,r_44_74_2,r_122_32_111,0.72,0,111,111,33
35,r_64_39_65,seq30,seq66,r_64_39_65,1.0,0,65,65,33
12,r_141_121_104,seq136,seq4,r_141_121_104,0.96,4,108,104,33
23,r_123_75_15,r_31_126_109,seq149,r_31_126_109,0.82,10,119,109,33
30,r_36_110_115,seq109,seq71,r_36_110_115,1.0,0,115,115,34
53,seq6,r_62_68_173,r_36_110_115,r_36_110_115,1.0,58,173,115,34
43,r_28_88_185,seq130,r_146_14_74,r_146_14_74,0.74,111,185,74,34
37,r_76_50_99,r_93_23_150,seq129,r_76_50_99,0.56,0,99,99,34
59,seq145,r_40_24_120,seq39,r_40_24_120,1.0,3,123,120,34
71,seq47,seq143,r_1_17_70,r_1_17_70,1.0,11,81,70,34
16,r_12_101_88,seq9,r_81_20_41,r_12_101_88,1.0,0,88,88,34
46,r_81_20_41,r_57_80_161,r_12_101_88,r_12_101_88,0.99,3,91,88,34
42,r_51_5_136,r_146_14_74,r_21_22_2,r_51_5_136,0.97,0,136,136,34
80,seq75,r_15_58_155,r_106_148_57,r_106_148_57,1.0,91,148,57,34
19,r_93_23_150,seq145,r_19_78_104,r_93_23_150,0.86,0,150,150,34
33,r_85_117_15,r_79_128_138,r_61_97_19,r_79_128_138,1.0,0,138,138,34
31,r_57_80_161,r_113_45_31,r_8_48_18,r_113_45_31,0.6,130,161,31,34
41,r_73_67_107,r_21_22_2,r_98_84_37,r_73_67_107,0.95,0,107,107,34
3,r_40_24_120,seq145,r_31_27_94,r_31_27_94,0.83,29,123,94,34
35,r_61_97_19,r_70_107_47,r_85_117_15,r_61_97_19,1.0,0,19,19,34
4,r_0_138_193,seq118,r_123_136_113,r_123_136_113,1.0,10,123,113,34
11,r_15_58_155,seq75,r_21_22_2,r_15_58_155,0.61,0,155,155,34
44,r_56_33_12,r_12_101_88,r_113_45_31,r_113_45_31,0.85,-20,11,31,34
6,r_119_2_176,seq131,seq82,r_119_2_176,0.63,0,176,176,34
62,seq25,seq64,r_70_107_47,r_70_107_47,1.0,97,144,47,34
27,r_104_100_170,r_147_63_135,seq47,r_147_63_135,0.99,-20,115,135,34
39,r_83_30_35,r_41_13_43,seq75,r_41_13_43,0.94,-5,38,43,34
87,seq105,r_90_127_121,r_8_48_18,r_90_127_121,0.76,0,121,121,34
2,r_31_27_94,seq108,seq131,r_31_27_94,1.0,0,94,94,34
18,r_147_63_135,seq25,r_19_78_104,r_147_63_135,0.99,0,135,135,34
29,r_132_103_86,seq137,r_141_4_146,r_132_103_86,1.0,0,86,86,34
27,r_104_100_170,seq47,r_8_48_18,r_104_100_170,0.86,0,170,170,34
25,r_144_99_81,seq82,seq29,r_144_99_81,1.0,0,81,81,34
88,seq108,r_31_27_94,r_21_22_2,r_31_27_94,1.0,0,94,94,34
32,r_106_148_57,r_132_103_86,r_83_30_35,r_106_148_57,1.0,0,57,57,34
50,seq129,r_113_45_31,r_76_50_99,r_76_50_99,1.0,13,112,99,34
58,seq143,r_119_2_176,r_3_133_97,r_3_133_97,1.0,33,130,97,34
45,r_79_128_138,r_31_27_94,r_85_117_15,r_85_117_15,0.93,0,15,15,34
33,r_85_117_15,r_12_101_88,r_79_128_138,r_85_117_15,0.99,0,15,15,34
0,r_70_107_47,r_113_45_31,seq25,r_70_107_47,1.0,0,47,47,34
45,r_79_128_138,r_85_117_15,seq25,r_79_128_138,0.98,0,138,138,34
17,r_26_38_60,r_147_63_135,r_60_65_5,r_26_38_60,0.93,0,60,60,34
9,r_146_14_74,r_11_49_158,r_141_4_146,r_11_49_158,0.9,-69,89,158,34
5,r_41_13_43,r_83_30_35,seq52,r_41_13_43,1.0,-1,42,43,34
7,r_3_133_97,seq52,seq143,r_3_133_97,0.99,0,97,97,34
30,r_48_112_70,r_43_6_92,seq81,r_48_112_70,1.0,-1,69,70,35
26,r_121_73_46,r_140_37_83,r_46_24_31,r_121_73_46,0.68,-1,45,46,35
43,r_113_10_140,r_104_128_141,r_39_129_63,r_104_128_141,0.88,-1,140,141,35
16,r_21_78_44,r_107_70_136,r_55_30_135,r_21_78_44,0.92,-1,43,44,35
83,seq90,r_60_52_160,r_119_136_59,r_119_136_59,0.98,22,81,59,35
3,r_59_109_15,r_149_126_113,r_31_85_53,r_31_85_53,0.77,29,82,53,35
21,r_142_80_22,r_107_70_136,seq105,r_107_70_136,1.0,0,136,136,35
39,r_69_131_119,seq1,r_46_24_31,r_69_131_119,0.75,3,122,119,35
5,r_143_61_100,seq54,r_21_78_44,r_143_61_100,1.0,0,100,100,35
42,r_144_42_155,seq34,r_48_112_70,r_48_112_70,1.0,97,167,70,35
7,r_15_12_25,r_140_37_83,seq57,r_140_37_83,0.95,16,99,83,35
51,seq7,r_95_115_177,r_102_20_51,r_102_20_51,1.0,0,51,51,35
34,r_140_37_83,r_15_12_25,seq18,r_140_37_83,0.94,5,88,83,35
34,r_140_37_83,r_121_73_46,r_15_12_25,r_140_37_83,0.87,-54,29,83,35
31,r_96_41_167,seq9,r_119_136_59,r_96_41_167,0.82,0,167,167,35
15,r_39_129_63,r_149_126_113,seq44,r_39_129_63,0.87,-4,59,63,35
16,r_21_78_44,r_55_30_135,r_143_61_100,r_143_61_100,0.52,36,136,100,35
6,r_119_136_59,r_107_70_136,seq90,r_119_136_59,0.92,-1,58,59,35
4,r_28_124_97,seq26,seq49,r_28_124_97,0.54,1,98,97,35
78,seq81,r_28_124_97,r_48_112_70,r_48_112_70,0.78,-5,65,70,35
11,r_138_53_147,r_104_128_141,seq50,r_104_128_141,0.96,1,142,141,35
14,r_23_40_17,seq90,seq135,r_23_40_17,0.98,1,18,17,35
62,seq34,r_144_42_155,r_46_24_31,r_46_24_31,0.88,136,167,31,35
46,r_102_20_51,r_107_70_136,seq7,r_102_20_51,1.0,0,51,51,35
8,r_145_45_21,r_28_124_97,seq67,r_145_45_21,0.68,4,25,21,35
27,r_11_0_183,seq120,r_145_45_21,r_11_0_183,0.24,1,184,183,35
1,r_31_85_53,r_35_116_122,r_59_109_15,r_31_85_53,1.0,0,53,53,35
2,r_95_115_177,seq7,r_28_124_97,r_95_115_177,0.6,1,178,177,35
18,r_122_71_105,r_144_42_155,r_23_40_17,r_122_71_105,0.85,4,109,105,35
7,r_15_12_25,r_35_116_122,r_140_37_83,r_15_12_25,0.94,3,28,25,35
36,r_46_24_31,r_2_86_80,seq34,r_46_24_31,1.0,0,31,31,35
19,r_72_25_42,r_119_136_59,r_147_65_6,r_147_65_6,0.71,35,41,6,35
33,r_82_114_149,seq38,seq33,r_82_114_149,0.86,-1,148,149,35
58,seq26,r_28_124_97,seq33,r_28_124_97,1.0,-6,91,97,35
3,r_59_109_15,r_96_41_167,r_149_126_113,r_59_109_15,1.0,0,15,15,35
32,r_63_94_107,r_107_70_136,seq108,r_63_94_107,0.9,6,113,107,35
38,r_32_130_95,r_60_52_160,r_48_112_70,r_32_130_95,0.74,1,96,95,35
77,seq79,r_104_128_141,seq1,r_104_128_141,1.0,1,142,141,35
9,r_5_77_60,r_122_71_105,seq49,r_122_71_105,0.55,-44,61,105,35
22,r_107_70_136,r_142_80_22,r_35_116_122,r_107_70_136,0.91,0,136,136,35
49,r_2_86_80,seq44,seq117,r_2_86_80,0.61,-1,79,80,35
45,r_133_66_55,r_28_124_97,r_147_65_6,r_133_66_55,0.53,4,59,55,35
44,r_104_128_141,r_113_10_140,seq8,r_104_128_141,0.9,1,142,141,35
23,r_60_52_160,seq33,r_111_99_91,r_60_52_160,0.77,-1,159,160,35
17,r_74_16_24,r_133_66_55,r_43_6_92,r_74_16_24,0.98,-3,21,24,35
35,r_51_100_106,seq87,r_145_45_21,r_51_100_106,0.99,0,106,106,35
40,r_124_63_14,r_98_73_123,r_29_71_74,r_124_63_14,0.89,109,123,14,36
14,r_29_71_74,seq134,r_148_97_48,r_29_71_74,0.98,1,75,74,36
43,r_58_138_186,seq114,r_55_25_45,r_55_25_45,1.0,142,187,45,36
22,r_68_69_56,r_66_149_134,r_23_95_80,r_23_95_80,0.99,10,90,80,36
37,r_12_118_62,r_66_149_134,seq31,r_12_118_62,1.0,2,64,62,36
16,r_98_73_123,seq24,r_125_16_65,r_98_73_123,0.92,-1,122,123,36
1,r_87_35_146,r_125_16_65,r_84_65_198,r_87_35_146,0.79,0,146,146,36
5,r_117_26_161,seq0,seq86,r_117_26_161,0.71,0,161,161,36
22,r_68_69_56,seq7,r_66_149_134,r_68_69_56,0.97,2,58,56,36
45,r_75_21_130,seq90,seq13,r_75_21_130,0.89,0,130,130,36
30,r_84_65_198,r_131_6_27,seq13,r_131_6_27,0.82,17,44,27,36
19,r_17_120_78,r_41_133_3,seq31,r_17_120_78,0.76,2,80,78,36
95,seq114,r_58_138_186,r_83_99_116,r_83_99_116,0.92,71,187,116,36
67,seq31,r_72_106_189,r_61_79_187,r_61_79_187,0.65,2,189,187,36
89,seq90,r_75_21_130,r_68_69_56,r_68_69_56,0.75,51,107,56,36
10,r_61_79_187,seq80,r_17_120_78,r_17_120_78,0.65,108,186,78,36
26,r_34_42_86,r_75_21_130,r_55_25_45,r_55_25_45,0.86,41,86,45,36
55,seq7,r_68_69_56,r_124_63_14,r_68_69_56,0.93,2,58,56,36
4,r_40_45_79,seq135,r_131_6_27,r_40_45_79,1.0,0,79,79,36
20,r_96_85_111,seq39,seq135,r_96_85_111,0.99,0,111,111,36
15,r_131_6_27,r_84_65_198,r_20_57_52,r_20_57_52,0.58,-28,24,52,36
27,r_47_18_121,r_94_91_17,seq89,r_94_91_17,0.31,105,122,17,36
72,seq129,r_117_26_161,r_104_107_13,r_104_107_13,0.97,3,16,13,36
2,r_70_11_147,seq129,r_43_115_35,r_70_11_147,0.66,0,147,147,36
47,r_27_60_176,r_94_91_17,r_40_45_79,r_40_45_79,0.99,97,176,79,36
40,r_124_63_14,r_34_42_86,r_98_73_123,r_124_63_14,1.0,2,16,14,36
29,r_122_76_144,r_87_35_146,r_55_25_45,r_55_25_45,0.99,99,144,45,36
24,r_20_57_52,seq139,r_131_6_27,r_131_6_27,0.84,34,61,27,36
8,r_54_103_10,r_61_79_187,seq145,r_54_103_10,0.99,0,10,10,36
25,r_142_92_127,r_117_26_161,r_43_115_35,r_142_92_127,0.93,1,128,127,36
88,seq89,seq90,r_47_18_121,r_47_18_121,0.59,1,122,121,36
50,seq0,r_117_26_161,r_40_45_79,r_40_45_79,0.99,82,161,79,36
11,r_121_123_28,r_117_26_161,seq15,r_121_123_28,1.0,0,28,28,36
32,r_36_5_122,seq13,seq52,r_36_5_122,0.91,0,122,122,36
38,r_140_111_105,seq129,seq67,r_140_111_105,0.97,2,107,105,36
34,r_78_51_139,seq136,r_124_63_14,r_78_51_139,0.6,1,140,139,36
39,r_104_107_13,r_61_79_187,seq129,r_104_107_13,1.0,0,13,13,36
17,r_72_106_189,seq31,seq134,r_72_106_189,0.22,0,189,189,36
9,r_3_44_173,r_58_138_186,r_47_18_121,r_3_44_173,0.72,0,173,173,36
31,r_148_97_48,r_94_91_17,seq114,r_148_97_48,1.0,3,51,48,36
12,r_55_25_45,r_3_44_173,r_104_107_13,r_55_25_45,1.0,0,45,45,36
48,r_14_2_41,r_3_44_173,seq108,r_14_2_41,1.0,1,42,41,36
44,r_101_100_89,r_43_115_35,r_94_91_17,r_43_115_35,0.97,54,89,35,36
23,r_23_95_80,r_3_44_173,r_68_69_56,r_3_44_173,1.0,-93,80,173,36
35,r_143_32_98,r_61_79_187,r_55_25_45,r_143_32_98,1.0,0,98,98,36
84,seq80,r_61_79_187,r_70_11_147,r_70_11_147,0.95,42,189,147,36
30,r_88_74_185,r_87_20_50,r_22_60_52,r_22_60_52,0.62,133,185,52,37
36,r_125_84_139,r_38_121_91,seq145,r_125_84_139,0.44,1,140,139,37
8,r_132_103_154,seq122,seq105,r_132_103_154,0.65,0,154,154,37
25,r_144_82_23,r_91_54_131,seq4,r_144_82_23,1.0,1,24,23,37
37,r_18_44_168,seq77,r_123_97_159,r_123_97_159,0.56,9,168,159,37
3,r_19_108_96,r_110_51_22,seq115,r_19_108_96,0.99,0,96,96,37
3,r_19_108_96,r_32_96_57,r_110_51_22,r_19_108_96,0.72,-74,22,96,37
21,r_78_69_134,seq49,r_134_93_138,r_78_69_134,0.97,4,138,134,37
39,r_25_29_94,seq4,r_81_146_198,r_25_29_94,1.0,1,95,94,37
1,r_53_1_162,r_34_109_58,r_13_136_33,r_53_1_162,0.93,1,163,162,37
43,r_58_67_175,r_63_10_115,r_144_82_23,r_58_67_175,0.94,-3,172,175,37
24,r_98_120_27,seq6,seq106,r_98_120_27,0.95,1,28,27,37
80,seq65,r_66_118_147,r_68_83_71,r_68_83_71,0.87,76,147,71,37
69,seq33,seq36,r_32_96_57,r_32_96_57,0.99,9,66,57,37
45,r_147_21_77,r_78_69_134,r_85_24_149,r_147_21_77,0.5,1,78,77,37
2,r_101_86_21,seq145,seq130,r_101_86_21,1.0,0,21,21,37
31,r_39_111_133,seq100,r_19_108_96,r_39_111_133,0.84,3,136,133,37
14,r_110_51_22,r_91_54_131,r_19_108_96,r_110_51_22,0.85,0,22,22,37
4,r_34_109_58,seq48,seq122,r_34_109_58,1.0,0,58,58,37
72,seq46,seq17,r_133_107_102,r_133_107_102,0.87,27,129,102,37
14,r_110_51_22,r_19_108_96,seq148,r_19_108_96,1.0,0,96,96,37
11,r_57_42_130,r_76_11_190,r_63_10_115,r_57_42_130,0.47,0,130,130,37
20,r_80_2_145,r_76_11_190,r_141_143_34,r_80_2_145,0.94,1,146,145,37
10,r_95_0_26,r_133_107_102,seq28,r_95_0_26,0.69,2,28,26,37
15,r_38_121_91,seq28,r_35_64_4,r_35_64_4,0.5,74,78,4,37
48,r_119_30_78,r_53_1_162,seq15,r_119_30_78,1.0,0,78,78,37
49,r_85_24_149,r_147_21_77,r_90_99_171,r_85_24_149,0.9,0,149,149,37
6,r_129_37_143,seq33,seq135,r_129_37_143,0.97,0,143,143,37
35,r_123_97_159,r_50_124_86,r_110_51_22,r_50_124_86,0.72,-32,54,86,37
27,r_131_92_72,r_88_74_185,seq122,r_131_92_72,1.0,0,72,72,37
68,seq28,r_38_121_91,r_95_0_26,r_95_0_26,0.9,2,28,26,37
47,r_90_99_171,r_132_103_154,r_85_24_149,r_85_24_149,0.82,0,149,149,37
33,r_137_89_66,seq70,seq149,r_137_89_66,1.0,-8,58,66,37
40,r_50_124_86,r_123_97_159,r_137_89_66,r_50_124_86,0.96,0,86,86,37
18,r_68_83_71,r_63_10_115,seq65,r_68_83_71,0.99,0,71,71,37
1,r_53_1_162,r_119_30_78,r_34_109_58,r_53_1_162,0.79,-104,58,162,37
35,r_123_97_159,r_110_51_22,r_55_23_183,r_123_97_159,0.7,0,159,159,37
32,r_76_11_190,seq9,r_53_1_162,r_53_1_162,0.77,28,190,162,37
75,seq49,r_78_69_134,seq12,r_78_69_134,0.99,6,140,134,37
45,r_147_21_77,r_85_24_149,r_78_69_134,r_147_21_77,1.0,72,149,77,37
17,r_104_31_60,seq48,r_22_60_52,r_22_60_52,0.88,8,60,52,37
9,r_63_10_115,r_35_64_4,r_81_146_198,r_63_10_115,0.67,1,116,115,37
22,r_40_45_104,r_55_23_183,seq48,r_40_45_104,0.99,0,104,104,37
28,r_66_118_147,seq65,r_129_37_143,r_66_118_147,0.68,0,147,147,37
49,r_85_24_149,r_14_43_128,r_147_21_77,r_147_21_77,0.99,1,78,77,37
13,r_32_96_57,r_50_124_86,seq33,r_32_96_57,1.0,0,57,57,37
0,r_22_60_52,seq4,seq100,r_22_60_52,0.99,1,53,52,37
7,r_138_7_121,r_76_11_190,r_40_45_104,r_40_45_104,1.0,21,125,104,37
44,r_134_93_138,r_91_54_131,r_78_69_134,r_134_93_138,0.92,0,138,138,37
16,r_13_136_33,r_53_1_162,seq72,r_13_136_33,0.97,-2,31,33,37
12,r_14_43_128,seq100,seq6,r_14_43_128,0.98,0,128,128,37
36,r_89_73_172,seq131,seq14,r_89_73_172,0.57,0,172,172,38
8,r_18_35_134,r_77_126_165,r_57_0_131,r_18_35_134,0.57,6,140,134,38
43,r_97_58_58,r_57_0_131,r_5_145_14,r_97_58_58,0.86,33,91,58,38
37,r_98_138_179,r_19_125_184,r_18_35_134,r_18_35_134,0.67,46,180,134,38
16,r_146_21_148,r_132_12_193,r_5_145_14,r_146_21_148,0.65,2,150,148,38
21,r_19_125_184,r_98_138_179,r_27_119_188,r_19_125_184,0.29,-4,180,184,38
39,r_136_44_158,r_77_126_165,r_37_28_90,r_37_28_90,0.87,70,160,90,38
5,r_48_62_66,seq60,seq144,r_48_62_66,0.89,11,77,66,38
42,r_23_81_82,r_95_45_182,seq7,r_23_81_82,1.0,1,83,82,38
69,seq43,seq55,r_149_80_70,r_149_80_70,1.0,8,78,70,38
45,r_103_3_122,r_91_30_186,seq52,r_103_3_122,0.82,3,125,122,38
24,r_135_8_159,r_37_28_90,seq53,r_135_8_159,0.86,2,161,159,38
19,r_137_116_166,seq51,r_37_28_90,r_37_28_90,1.0,81,171,90,38
1,r_11_42_25,seq4,seq117,r_11_42_25,0.82,0,25,25,38
31,r_142_13_173,seq101,r_5_145_14,r_5_145_14,0.6,159,173,14,38
41,r_95_45_182,r_23_81_82,r_102_114_2,r_23_81_82,1.0,1,83,82,38
10,r_26_83_164,seq6,seq55,r_26_83_164,0.56,1,165,164,38
72,seq51,r_137_116_166,r_90_93_55,r_90_93_55,1.0,25,80,55,38
89,seq144,seq129,r_48_62_66,r_48_62_66,0.62,-21,45,66,38
94,seq111,seq68,r_40_10_39,r_40_10_39,1.0,14,53,39,38
0,r_122_9_95,r_91_30_186,r_149_80_70,r_149_80_70,0.96,34,104,70,38
20,r_88_139_92,seq2,seq34,r_88_139_92,1.0,0,92,92,38
13,r_141_59_59,r_48_62_66,r_70_113_5,r_141_59_59,0.95,7,66,59,38
15,r_90_93_55,r_48_62_66,r_128_84_32,r_90_93_55,0.93,0,55,55,38
46,r_72_112_36,r_26_83_164,r_11_42_25,r_11_42_25,0.66,11,36,25,38
11,r_115_107_12,r_134_32_89,seq64,r_115_107_12,0.54,9,21,12,38
2,r_37_28_90,r_135_8_159,r_136_44_158,r_37_28_90,0.97,70,160,90,38
27,r_71_108_115,seq82,seq2,r_71_108_115,1.0,0,115,115,38
2,r_37_28_90,r_18_35_134,r_135_8_159,r_37_28_90,1.0,0,90,90,38
41,r_95_45_182,r_102_114_2,seq140,r_102_114_2,0.4,183,185,2,38
47,r_102_114_2,seq92,r_95_45_182,r_95_45_182,0.6,-117,65,182,38
40,r_50_74_118,r_137_116_166,r_5_145_14,r_50_74_118,1.0,0,118,118,38
18,r_79_148_133,seq99,seq144,r_79_148_133,0.82,6,139,133,38
29,r_67_38_100,seq117,seq100,r_67_38_100,0.4,16,116,100,38
24,r_135_8_159,r_50_74_118,r_37_28_90,r_37_28_90,0.76,0,90,90,38
35,r_77_126_165,r_5_145_14,r_110_17_63,r_77_126_165,0.62,0,165,165,38
25,r_149_80_70,r_26_83_164,seq43,r_149_80_70,0.66,0,70,70,38
50,seq1,r_57_0_131,seq64,r_57_0_131,0.53,1,132,131,38
52,seq131,r_89_73_172,r_11_42_25,r_89_73_172,0.73,0,172,172,38
28,r_85_56_30,r_37_28_90,r_48_62_66,r_85_56_30,0.96,5,35,30,38
34,r_57_0_131,seq1,seq96,r_57_0_131,0.71,1,132,131,38
4,r_133_109_77,r_19_125_184,r_72_112_36,r_133_109_77,0.81,-20,57,77,38
17,r_121_124_99,r_136_44_158,r_5_145_14,r_136_44_158,0.83,2,160,158,38
6,r_5_145_14,r_98_138_179,r_121_124_99,r_5_145_14,0.9,2,16,14,38
91,seq100,r_86_25_121,r_67_38_100,r_86_25_121,0.94,1,122,121,38
49,r_110_17_63,r_142_13_173,r_77_126_165,r_110_17_63,0.98,88,151,63,38
48,r_128_84_32,r_142_13_173,seq51,r_128_84_32,1.0,0,32,32,38
7,r_31_105_145,seq29,seq4,r_31_105_145,0.88,-1,144,145,38
23,r_78_143_98,r_67_38_100,r_5_145_14,r_78_143_98,0.75,7,105,98,38
35,r_77_126_165,seq16,r_5_145_14,r_5_145_14,0.58,68,82,14,38
51,seq2,r_144_17_162,seq114,r_144_17_162,0.97,0,162,162,39
29,r_135_104_27,r_78_127_181,seq34,r_135_104_27,1.0,0,27,27,39
19,r_137_42_47,seq62,r_39_94_19,r_137_42_47,0.91,-11,36,47,39
44,r_87_28_13,r_13_31_132,seq16,r_87_28_13,0.66,0,13,13,39
53,seq4,r_29_1_78,seq20,r_29_1_78,1.0,-3,75,78,39
18,r_39_94_19,r_38_130_158,r_137_42_47,r_137_42_47,0.79,-15,32,47,39
21,r_13_31_132,seq61,seq3,r_13_31_132,0.95,2,134,132,39
39,r_98_149_101,seq56,seq81,r_98_149_101,0.94,0,101,101,39
97,seq119,seq9,r_51_105_116,r_51_105_116,0.99,22,138,116,39
5,r_129_83_125,seq3,seq20,r_129_83_125,0.96,1,126,125,39
46,r_90_142_165,r_69_63_176,r_14_55_8,r_90_142_165,0.62,0,165,165,39
33,r_35_120_33,r_98_149_101,seq147,r_35_120_33,0.96,-1,32,33,39
69,seq47,r_11_122_100,seq134,r_11_122_100,0.96,0,100,100,39
45,r_144_17_162,seq2,r_5_110_114,r_5_110_114,1.0,48,162,114,39
27,r_132_112_72,r_78_127_181,r_14_55_8,r_132_112_72,0.79,110,182,72,39
31,r_109_0_73,seq12,r_64_133_64,r_109_0_73,0.98,-1,72,73,39
41,r_11_122_100,seq47,r_64_133_64,r_64_133_64,1.0,39,103,64,39
26,r_8_91_134,r_43_32_174,r_137_42_47,r_8_91_134,0.77,0,134,134,39
8,r_38_130_158,r_137_42_47,r_14_55_8,r_38_130_158,0.61,0,158,158,39
43,r_99_145_39,r_60_80_113,seq16,r_99_145_39,0.98,-3,36,39,39
98,seq123,r_78_127_181,r_37_124_121,r_37_124_121,1.0,19,140,121,39
15,r_68_103_63,r_132_112_72,r_87_28_13,r_68_103_63,0.61,-3,60,63,39
6,r_78_127_181,seq123,r_132_112_72,r_132_112_72,1.0,10,82,72,39
78,seq62,r_137_42_47,seq134,r_137_42_47,0.89,8,55,47,39
27,r_132_112_72,r_69_63_176,r_78_127_181,r_132_112_72,1.0,0,72,72,39
4,r_74_7_52,seq53,seq56,r_74_7_52,0.92,-2,50,52,39
42,r_37_124_121,r_116_126_42,r_74_7_52,r_116_126_42,0.99,0,42,42,39
2,r_60_80_113,seq20,seq101,r_60_80_113,0.68,14,127,113,39
47,r_49_146_70,seq108,r_68_103_63,r_68_103_63,0.52,5,68,63,39
24,r_19_148_152,seq119,r_30_40_53,r_30_40_53,1.0,99,152,53,39
49,r_116_126_42,r_37_124_121,seq3,r_116_126_42,0.43,0,42,42,39
6,r_78_127_181,r_132_112_72,r_30_40_53,r_78_127_181,0.64,1,182,181,39
65,seq34,r_58_15_102,r_135_104_27,r_135_104_27,0.91,102,129,27,39
42,r_37_124_121,r_74_7_52,seq26,r_37_124_121,0.89,0,121,121,39
32,r_69_63_176,r_90_142_165,r_60_80_113,r_69_63_176,0.64,-11,165,176,39
52,seq3,r_129_83_125,seq123,r_129_83_125,0.85,1,126,125,39
34,r_58_15_102,seq34,r_139_111_23,r_139_111_23,0.75,91,114,23,39
8,r_38_130_158,r_39_94_19,r_137_42_47,r_137_42_47,0.98,-21,26,47,39
40,r_139_111_23,r_19_148_152,seq138,r_139_111_23,1.0,0,23,23,39
59,seq16,seq140,r_87_28_13,r_87_28_13,0.67,12,25,13,39
17,r_121_33_66,seq18,seq61,r_121_33_66,1.0,0,66,66,39
9,r_100_107_96,seq123,seq86,r_100_107_96,0.93,2,98,96,39
28,r_51_105_116,seq138,seq119,r_51_105_116,0.99,0,116,116,39
0,r_30_40_53,seq34,seq128,r_30_40_53,1.0,0,53,53,39
11,r_75_89_51,seq20,seq52,r_75_89_51,1.0,1,52,51,39
23,r_64_133_64,seq123,seq108,r_64_133_64,0.99,-2,62,64,39
2,r_77_133_25,r_107_84_131,seq19,r_77_133_25,0.91,2,27,25,40
25,r_65_72_18,r_107_84_131,r_26_90_180,r_65_72_18,0.9,0,18,18,40
14,r_37_40_64,seq42,r_48_15_19,r_37_40_64,1.0,0,64,64,40
8,r_128_78_82,r_143_0_162,seq136,r_128_78_82,0.93,5,87,82,40
45,r_25_66_11,r_100_70_94,r_104_140_76,r_25_66_11,0.83,-1,10,11,40
3,r_137_5_40,seq73,r_11_21_119,r_11_21_119,1.0,36,155,119,40
22,r_26_90_180,r_99_148_42,r_65_72_18,r_26_90_180,0.95,-163,17,180,40
86,seq91,r_64_45_151,r_14_149_70,r_64_45_151,0.86,0,151,151,40
16,r_111_130_147,seq47,r_77_133_25,r_111_130_147,0.93,1,148,147,40
39,r_107_84_131,seq41,r_28_38_30,r_107_84_131,0.55,0,131,131,40
24,r_1_112_28,r_58_68_157,r_65_72_18,r_1_112_28,0.96,0,28,28,40
23,r_48_15_19,r_33_101_122,r_25_66_11,r_48_15_19,0.99,0,19,19,40
46,r_9_117_106,r_104_140_76,seq19,r_104_140_76,0.7,37,113,76,40
42,r_55_105_99,seq7,r_30_79_10,r_55_105_99,0.96,4,103,99,40
80,seq141,r_75_94_171,r_31_129_118,r_31_129_118,0.89,59,177,118,40
19,r_2_23_127,seq19,seq8,r_2_23_127,0.86,0,127,127,40
41,r_95_122_138,seq113,r_2_23_127,r_95_122_138,0.76,0,138,138,40
89,seq98,r_35_119_130,r_16_82_57,r_35_119_130,0.58,-16,114,130,40
10,r_93_69_150,r_39_109_169,r_33_101_122,r_33_101_122,0.99,28,150,122,40
26,r_44_34_152,r_31_129_118,r_67_56_84,r_44_34_152,0.54,-34,118,152,40
4,r_28_38_30,seq136,r_107_84_131,r_28_38_30,0.39,75,105,30,40
78,seq74,r_16_82_57,r_64_45_151,r_64_45_151,0.72,16,167,151,40
0,r_64_45_151,seq91,seq74,r_64_45_151,0.85,0,151,151,40
11,r_67_56_84,seq42,seq114,r_67_56_84,0.97,0,84,84,40
20,r_92_71_108,seq121,r_65_72_18,r_92_71_108,0.97,0,108,108,40
48,r_143_0_162,r_128_78_82,r_1_112_28,r_143_0_162,0.82,-75,87,162,40
62,seq19,r_2_23_127,r_9_117_106,r_2_23_127,0.91,0,127,127,40
99,seq127,r_26_90_180,r_1_112_28,r_1_112_28,0.71,64,92,28,40
31,r_115_60_13,r_75_94_171,seq54,r_115_60_13,0.83,-3,10,13,40
22,r_26_90_180,r_65_72_18,seq4,r_26_90_180,0.45,1,181,180,40
18,r_11_21_119,r_39_109_169,r_137_5_40,r_11_21_119,0.9,2,121,119,40
29,r_88_18_61,r_104_140_76,seq134,r_88_18_61,1.0,1,62,61,40
33,r_100_70_94,seq136,seq83,r_100_70_94,0.79,3,97,94,40
48,r_143_0_162,r_1_112_28,r_25_66_11,r_143_0_162,0.96,0,162,162,40
26,r_44_34_152,r_67_56_84,seq142,r_44_34_152,0.95,0,152,152,40
68,seq41,r_107_84_131,r_67_56_84,r_67_56_84,0.89,47,131,84,40
21,r_16_82_57,seq85,seq98,r_16_82_57,0.68,-20,37,57,40
32,r_118_27_71,seq6,seq83,r_118_27_71,0.97,0,71,71,40
38,r_31_129_118,r_44_34_152,seq73,r_31_129_118,1.0,0,118,118,40
52,seq6,r_118_27_71,seq41,r_118_27_71,0.88,0,71,71,40
47,r_99_148_42,r_26_90_180,seq12,r_99_148_42,0.94,0,42,42,40
3,r_137_5_40,r_28_38_30,seq73,r_137_5_40,0.87,1,41,40,40
17,r_39_109_169,seq4,r_14_149_70,r_14_149_70,0.99,99,169,70,40
25,r_65_72_18,r_26_90_180,r_92_71_108,r_92_71_108,0.97,40,148,108,40
94,seq114,seq22,r_67_56_84,r_67_56_84,1.0,3,87,84,40
9,r_35_119_130,seq98,r_100_70_94,r_35_119_130,0.93,0,130,130,40
7,r_144_29_136,r_106_50_158,r_67_56_84,r_67_56_84,0.71,52,136,84,40
44,r_59_138_142,r_39_109_169,seq7,r_59_138_142,0.87,0,142,142,40
82,seq83,seq7,r_100_70_94,r_100_70_94,1.0,13,107,94,40
35,r_97_87_95,r_104_140_76,r_14_149_70,r_97_87_95,1.0,3,98,95,40
12,r_106_50_158,r_144_29_136,r_9_117_106,r_106_50_158,0.7,2,160,158,40
36,r_60_114_178,seq47,r_91_80_154,r_60_114_178,0.46,0,178,178,41
43,r_50_119_142,r_4_116_197,seq143,r_50_119_142,0.81,0,142,142,41
3,r_104_77_33,r_88_86_175,r_69_134_40,r_88_86_175,0.74,5,180,175,41
21,r_59_70_185,r_24_40_150,r_26_56_69,r_59_70_185,0.79,-35,150,185,41
39,r_52_101_71,r_142_128_110,r_69_134_40,r_52_101_71,0.75,8,79,71,41
10,r_113_42_119,r_129_64_49,seq78,r_113_42_119,1.0,0,119,119,41
1,r_98_58_53,seq6,r_123_31_42,r_123_31_42,0.97,17,59,42,41
11,r_89_124_31,seq133,seq109,r_89_124_31,0.98,0,31,31,41
13,r_142_128_110,r_44_122_76,r_89_124_31,r_142_128_110,0.94,0,110,110,41
47,r_18_115_28,r_19_22_143,r_5_46_10,r_18_115_28,0.99,0,28,28,41
10,r_113_42_119,r_7_145_5,r_129_64_49,r_129_64_49,1.0,23,72,49,41
26,r_26_56_69,r_85_34_124,seq10,r_26_56_69,0.89,10,79,69,41
72,seq47,r_53_55_159,r_90_15_93,r_90_15_93,0.8,66,159,93,41
4,r_44_122_76,r_88_86_175,r_142_128_110,r_44_122_76,0.81,5,81,76,41
0,r_136_39_186,seq27,r_69_134_40,r_69_134_40,0.84,146,186,40,41
13,r_142_128_110,r_52_101_71,r_44_122_76,r_142_128_110,0.76,-31,79,110,41
42,r_129_64_49,r_25_67_58,seq125,r_129_64_49,1.0,0,49,49,41
48,r_105_118_70,seq28,r_0_130_34,r_105_118_70,0.97,0,70,70,41
6,r_19_22_143,seq30,r_110_144_63,r_110_144_63,1.0,82,145,63,41
23,r_123_31_42,seq95,r_98_58_53,r_123_31_42,1.0,3,45,42,41
5,r_69_134_40,r_120_38_160,r_91_80_154,r_120_38_160,0.9,-47,113,160,41
27,r_110_144_63,r_54_57_194,seq28,r_110_144_63,1.0,1,64,63,41
30,r_25_67_58,r_129_64_49,r_139_146_54,r_25_67_58,1.0,-7,51,58,41
29,r_84_8_102,r_111_1_188,seq49,r_84_8_102,0.99,0,102,102,41
34,r_88_86_175,r_104_77_33,r_108_131_18,r_88_86_175,0.89,0,175,175,41
2,r_108_131_18,r_132_112_14,seq125,r_108_131_18,0.66,6,24,18,41
38,r_48_68_180,r_88_86_175,seq13,r_48_68_180,0.34,-1,179,180,41
34,r_88_86_175,r_44_122_76,r_104_77_33,r_88_86_175,0.82,-94,81,175,41
4,r_44_122_76,r_142_128_110,seq133,r_142_128_110,0.98,0,110,110,41
48,r_105_118_70,r_23_135_17,seq28,r_105_118_70,0.52,-47,23,70,41
3,r_104_77_33,r_111_1_188,r_88_86_175,r_104_77_33,0.95,0,33,33,41
17,r_90_15_93,r_103_35_187,seq47,r_90_15_93,1.0,0,93,93,41
9,r_24_40_150,r_59_70_185,r_84_8_102,r_59_70_185,0.89,-35,150,185,41
24,r_139_146_54,r_53_55_159,r_25_67_58,r_139_146_54,1.0,0,54,54,41
5,r_69_134_40,seq14,r_120_38_160,r_69_134_40,1.0,2,42,40,41
49,r_121_97_138,r_53_55_159,seq138,r_121_97_138,0.81,1,139,138,41
44,r_4_116_197,r_50_119_142,r_75_66_192,r_4_116_197,0.55,-55,142,197,41
82,seq78,seq9,r_113_42_119,r_113_42_119,1.0,16,135,119,41
31,r_3_37_15,r_121_97_138,r_91_80_154,r_3_37_15,1.0,2,17,15,41
35,r_53_55_159,seq47,r_20_29_20,r_53_55_159,0.82,0,159,159,41
21,r_59_70_185,r_26_56_69,r_4_116_197,r_59_70_185,0.87,0,185,185,41
36,r_124_68_83,r_110_29_136,seq72,r_124_68_83,0.85,1,84,83,42
14,r_85_25_185,r_123_45_196,r_126_27_53,r_126_27_53,0.54,136,189,53,42
43,r_69_93_108,seq115,r_84_134_82,r_84_134_82,0.99,50,132,82,42
1,r_137_98_39,r_9_42_73,r_129_74_5,r_137_98_39,0.51,3,42,39,42
37,r_128_105_115,r_100_140_120,seq15,r_128_105_115,0.98,0,115,115,42
30,r_37_139_52,r_32_14_135,seq31,r_37_139_52,1.0,1,53,52,42
16,r_17_10_144,r_123_45_196,seq135,r_123_45_196,0.92,-50,146,196,42
21,r_87_7_113,r_69_93_108,seq79,r_87_7_113,0.65,5,118,113,42
5,r_127_8_164,seq72,r_108_101_88,r_108_101_88,0.45,79,167,88,42
42,r_6_70_188,seq50,seq60,r_6_70_188,0.2,2,190,188,42
39,r_67_35_189,seq3,r_100_140_120,r_67_35_189,0.62,-146,43,189,42
15,r_56_78_170,r_111_48_14,r_37_139_52,r_56_78_170,0.53,5,175,170,42
39,r_67_35_189,r_100_140_120,seq59,r_100_140_120,0.82,9,129,120,42
31,r_114_19_67,r_81_23_26,seq24,r_114_19_67,0.92,5,72,67,42
41,r_22_144_75,r_56_78_170,r_9_42_73,r_56_78_170,0.7,-95,75,170,42
67,seq34,r_0_116_176,r_131_86_105,r_131_86_105,0.79,15,120,105,42
44,r_125_107_166,r_43_83_62,r_20_145_197,r_125_107_166,0.94,0,166,166,42
0,r_82_97_58,r_127_8_164,seq138,r_82_97_58,1.0,0,58,58,42
3,r_84_134_82,seq132,r_111_48_14,r_84_134_82,0.99,7,89,82,42
10,r_81_23_26,r_114_19_67,r_76_143_45,r_81_23_26,0.8,46,72,26,42
4,r_30_99_154,r_38_113_174,r_137_98_39,r_30_99_154,0.57,2,156,154,42
26,r_111_48_14,seq65,r_56_78_170,r_111_48_14,1.0,0,14,14,42
11,r_88_77_118,seq18,r_137_98_39,r_88_77_118,0.74,3,121,118,42
20,r_43_83_62,seq16,r_125_107_166,r_43_83_62,0.91,1,63,62,42
15,r_56_78_170,r_22_144_75,r_111_48_14,r_56_78_170,0.55,-95,75,170,42
6,r_9_42_73,r_110_29_136,seq73,r_9_42_73,1.0,1,74,73,42
13,r_5_33_33,r_126_27_53,seq55,r_5_33_33,0.99,3,36,33,42
87,seq79,seq130,r_87_7_113,r_87_7_113,0.78,31,144,113,42
2,r_26_104_157,r_20_145_197,r_5_33_33,r_26_104_157,0.72,6,163,157,42
47,r_58_95_140,seq4,seq138,r_58_95_140,0.8,1,141,140,42
38,r_76_143_45,r_109_57_122,r_81_23_26,r_76_143_45,0.61,5,50,45,42
40,r_21_146_102,r_109_57_122,r_131_86_105,r_109_57_122,0.7,-16,106,122,42
18,r_131_86_105,r_58_95_140,r_21_146_102,r_58_95_140,0.62,-34,106,140,42
29,r_63_11_71,r_88_77_118,r_5_33_33,r_5_33_33,0.61,59,92,33,42
24,r_32_14_135,r_20_145_197,seq59,r_32_14_135,0.87,1,136,135,42
25,r_123_45_196,r_17_10_144,r_39_92_80,r_39_92_80,1.0,7,87,80,42
39,r_67_35_189,seq59,r_91_118_167,r_67_35_189,0.83,-2,187,189,42
33,r_52_13_127,r_125_107_166,r_136_71_24,r_52_13_127,0.89,0,127,127,42
48,r_126_27_53,r_100_140_120,r_67_35_189,r_100_140_120,0.95,5,125,120,42
48,r_126_27_53,r_67_35_189,r_85_25_185,r_126_27_53,0.72,132,185,53,42
58,seq15,seq75,r_109_57_122,r_109_57_122,1.0,24,146,122,42
35,r_136_71_24,r_67_35_189,seq120,r_136_71_24,0.99,-1,23,24,42
20,r_43_83_62,r_125_107_166,seq130,r_125_107_166,0.96,-18,148,166,42
34,r_119_53_96,r_100_140_120,seq50,r_119_53_96,0.91,0,96,96,42
48,r_126_27_53,r_5_33_33,r_100_140_120,r_126_27_53,0.58,-3,50,53,42
26,r_111_48_14,r_56_78_170,r_84_134_82,r_84_134_82,1.0,66,148,82,42
22,r_100_140_120,r_128_105_115,seq147,r_100_140_120,0.72,-5,115,120,42
49,r_39_92_80,r_6_70_188,r_123_45_196,r_39_92_80,1.0,1,81,80,42
44,r_125_107_166,r_52_13_127,r_43_83_62,r_125_107_166,0.94,-39,127,166,42
23,r_109_57_122,seq31,r_128_105_115,r_109_57_122,0.63,0,122,122,42
12,r_91_118_167,seq115,r_110_29_136,r_110_29_136,0.44,33,169,136,42
84,seq72,r_127_8_164,r_124_68_83,r_124_68_83,0.96,71,154,83,42
14,r_81_116_98,r_138_141_168,r_30_68_177,r_81_116_98,0.83,1,99,98,43
8,r_59_21_123,r_30_68_177,seq25,r_59_21_123,0.77,4,127,123,43
43,r_102_43_171,seq128,r_27_140_4,r_102_43_171,0.66,0,171,171,43
21,r_6_80_145,seq72,r_143_50_88,r_143_50_88,0.99,51,139,88,43
5,r_88_125_138,r_66_35_187,seq146,r_88_125_138,0.84,8,146,138,43
46,r_85_28_97,seq32,seq69,r_85_28_97,1.0,1,98,97,43
16,r_46_104_46,r_88_125_138,r_106_26_191,r_88_125_138,0.81,-35,103,138,43
19,r_106_26_191,r_143_50_88,r_46_104_46,r_106_26_191,0.94,-102,89,191,43
32,r_107_147_31,r_57_58_65,seq149,r_107_147_31,0.73,4,35,31,43
34,r_12_44_26,seq130,seq126,r_12_44_26,1.0,0,26,26,43
40,r_101_18_54,r_48_22_166,r_46_104_46,r_101_18_54,0.8,2,56,54,43
18,r_148_145_18,seq11,seq95,r_148_145_18,0.8,0,18,18,43
31,r_144_9_180,seq92,r_118_109_14,r_118_109_14,0.59,167,181,14,43
41,r_31_3_133,seq135,r_46_104_46,r_31_3_133,0.96,0,133,133,43
26,r_129_10_172,r_30_68_177,r_7_14_9,r_7_14_9,0.6,163,172,9,43
4,r_131_41_197,r_55_42_188,r_47_2_163,r_47_2_163,0.87,2,165,163,43
11,r_34_71_34,r_144_9_180,r_57_58_65,r_34_71_34,0.58,45,79,34,43
1,r_118_109_14,r_34_71_34,seq45,r_118_109_14,1.0,2,16,14,43
20,r_56_74_117,r_88_125_138,r_85_28_97,r_88_125_138,0.51,-21,117,138,43
13,r_82_133_167,r_5_97_136,r_118_109_14,r_82_133_167,0.54,-25,142,167,43
15,r_49_111_91,seq136,r_34_71_34,r_49_111_91,1.0,0,91,91,43
48,r_108_78_125,seq134,r_7_14_9,r_108_78_125,0.97,0,125,125,43
13,r_82_133_167,r_118_109_14,r_7_14_9,r_82_133_167,0.94,1,168,167,43
6,r_96_15_158,seq142,r_24_114_67,r_96_15_158,0.47,4,162,158,43
85,seq86,seq146,r_81_116_98,r_81_116_98,0.83,19,117,98,43
27,r_67_77_82,r_5_97_136,seq146,r_67_77_82,0.98,0,82,82,43
87,seq92,r_144_9_180,r_107_147_31,r_144_9_180,0.82,-4,176,180,43
39,r_48_22_166,r_101_18_54,seq72,r_101_18_54,0.9,2,56,54,43
35,r_0_8_24,seq139,seq130,r_0_8_24,0.99,0,24,24,43
47,r_24_114_67,r_59_21_123,seq61,r_24_114_67,0.84,0,67,67,43
25,r_55_42_188,r_131_41_197,r_143_50_88,r_131_41_197,0.36,-9,188,197,43
33,r_5_97_136,r_82_133_167,r_81_116_98,r_82_133_167,0.9,-25,142,167,43
44,r_117_87_32,seq69,seq17,r_117_87_32,1.0,1,33,32,43
61,seq149,r_144_9_180,r_107_147_31,r_144_9_180,0.74,-101,79,180,43
14,r_81_116_98,r_30_68_177,r_5_97_136,r_5_97_136,0.56,7,143,136,43
17,r_66_35_187,r_88_125_138,r_46_104_46,r_66_35_187,0.61,-87,100,187,43
28,r_33_100_181,seq40,r_110_93_38,r_110_93_38,0.8,143,181,38,43
49,r_57_58_65,seq53,r_34_71_34,r_57_58_65,0.83,17,82,65,43
10,r_91_13_39,seq84,r_110_93_38,r_91_13_39,0.89,-2,37,39,43
56,seq11,r_48_22_166,r_143_50_88,r_143_50_88,0.99,-1,87,88,43
7,r_143_50_88,r_106_26_191,seq11,r_143_50_88,0.91,1,89,88,43
16,r_46_104_46,seq146,r_88_125_138,r_46_104_46,0.87,10,56,46,43
23,r_16_20_124,r_31_3_133,r_48_22_166,r_48_22_166,0.83,-41,125,166,43
17,r_66_35_187,r_46_104_46,r_110_93_38,r_66_35_187,0.53,2,189,187,43
12,r_89_121_157,r_66_35_187,r_16_20_124,r_16_20_124,0.89,34,158,124,43
40,r_96_75_23,r_63_117_157,r_138_124_148,r_138_124_148,0.58,3,151,148,44
30,r_62_126_100,seq143,r_103_141_93,r_103_141_93,0.74,7,100,93,44
44,r_63_117_157,r_96_75_23,r_142_108_98,r_96_75_23,0.49,136,159,23,44
14,r_55_22_96,r_97_8_119,seq57,r_55_22_96,1.0,1,97,96,44
8,r_120_111_183,seq60,r_45_23_20,r_120_111_183,0.52,2,185,183,44
43,r_103_141_93,r_40_78_24,seq21,r_103_141_93,0.94,2,95,93,44
37,r_73_81_131,seq128,seq59,r_73_81_131,1.0,0,131,131,44
13,r_84_109_45,seq60,seq123,r_84_109_45,1.0,0,45,45,44
16,r_102_146_89,r_27_101_101,r_45_23_20,r_102_146_89,0.9,0,89,89,44
21,r_27_101_101,r_30_132_113,r_0_34_181,r_0_34_181,0.71,-80,101,181,44
1,r_14_37_82,seq139,seq74,r_14_37_82,0.99,0,82,82,44
5,r_82_39_68,seq59,seq66,r_82_39_68,1.0,0,68,68,44
46,r_105_18_126,seq10,r_24_89_16,r_24_89_16,0.6,110,126,16,44
42,r_142_108_98,r_114_71_147,r_103_141_93,r_103_141_93,0.74,6,99,93,44
45,r_26_47_121,seq99,r_135_110_99,r_26_47_121,0.99,1,122,121,44
40,r_96_75_23,r_14_37_82,r_63_117_157,r_96_75_23,1.0,1,24,23,44
19,r_85_51_158,seq66,seq59,r_85_51_158,0.92,0,158,158,44
6,r_76_11_51,r_72_4_73,r_45_23_20,r_76_11_51,1.0,2,53,51,44
36,r_135_110_99,r_115_33_54,seq74,r_115_33_54,1.0,1,55,54,44
3,r_72_4_73,r_63_117_157,r_24_89_16,r_72_4_73,1.0,1,74,73,44
10,r_86_32_170,r_45_23_20,r_84_109_45,r_45_23_20,0.71,152,172,20,44
72,seq59,seq74,r_85_51_158,r_85_51_158,0.94,7,165,158,44
26,r_19_12_137,r_15_68_85,r_38_50_40,r_19_12_137,0.91,-95,42,137,44
4,r_15_68_85,r_0_34_181,seq21,r_15_68_85,1.0,1,86,85,44
0,r_43_28_75,r_16_100_80,r_76_11_51,r_16_100_80,1.0,-5,75,80,44
63,seq21,r_20_49_185,r_15_68_85,r_15_68_85,1.0,100,185,85,44
73,seq60,r_120_111_183,r_3_56_76,r_3_56_76,1.0,109,185,76,44
2,r_38_50_40,r_41_129_159,r_19_12_137,r_38_50_40,0.88,2,42,40,44
20,r_16_100_80,r_43_28_75,seq99,r_43_28_75,1.0,0,75,75,44
22,r_148_1_32,r_121_5_33,seq46,r_148_1_32,1.0,0,32,32,44
44,r_63_117_157,r_72_4_73,r_96_75_23,r_63_117_157,0.71,-106,51,157,44
15,r_53_125_149,seq13,r_6_77_97,r_6_77_97,0.94,52,149,97,44
48,r_54_122_133,r_20_49_185,seq130,r_54_122_133,0.9,0,133,133,44
21,r_27_101_101,r_0_34_181,r_38_50_40,r_0_34_181,0.92,0,181,181,44
2,r_38_50_40,r_19_12_137,r_27_101_101,r_38_50_40,0.75,97,137,40,44
36,r_135_110_99,seq74,r_26_47_121,r_26_47_121,1.0,44,165,121,44
31,r_116_31_21,r_62_126_100,seq87,r_116_31_21,1.0,-1,20,21,44
39,r_24_89_16,r_85_51_158,seq145,r_24_89_16,1.0,0,16,16,44
47,r_30_132_113,seq10,seq44,r_30_132_113,0.99,5,118,113,44
24,r_134_107_136,seq130,r_103_141_93,r_134_107_136,0.91,0,136,136,44
25,r_41_129_159,seq2,r_138_124_148,r_41_129_159,0.87,0,159,159,44
33,r_40_78_24,r_103_141_93,seq67,r_103_141_93,1.0,2,95,93,44
70,seq57,r_30_132_113,r_55_22_96,r_55_22_96,0.7,6,102,96,44
18,r_115_33_54,r_135_110_99,seq48,r_115_33_54,1.0,1,55,54,44
68,seq46,r_114_71_147,r_148_1_32,r_148_1_32,0.98,118,150,32,44
32,r_147_65_62,r_26_47_121,seq87,r_147_65_62,1.0,0,62,62,44
38,r_114_71_147,seq46,r_138_124_148,r_114_71_147,0.53,3,150,147,44
34,r_6_77_97,seq44,seq61,r_6_77_97,1.0,0,97,97,44
6,r_76_11_51,r_45_23_20,r_43_28_75,r_43_28_75,0.95,6,81,75,44
9,r_52_17_164,seq74,seq46,r_52_17_164,0.64,-1,163,164,44
26,r_19_12_137,r_38_50_40,r_96_75_23,r_19_12_137,0.97,0,137,137,44
28,r_138_124_148,r_45_23_20,r_114_71_147,r_138_124_148,0.69,0,148,148,44
91,seq99,r_26_47_121,r_16_100_80,r_26_47_121,0.98,-26,95,121,44
49,r_0_34_181,r_15_68_85,r_14_37_82,r_0_34_181,0.9,-95,86,181,44
49,r_0_34_181,r_14_37_82,r_27_101_101,r_27_101_101,0.66,4,105,101,44
7,r_3_56_76,seq92,seq87,r_3_56_76,1.0,0,76,76,44
23,r_97_8_119,r_20_49_185,r_91_80_87,r_97_8_119,0.54,2,121,119,44
49,r_0_34_181,r_27_101_101,r_53_125_149,r_0_34_181,0.81,0,181,181,44
82,seq79,seq74,r_24_89_16,r_24_89_16,1.0,118,134,16,44
35,r_137_144_88,r_73_81_131,r_96_75_23,r_137_144_88,0.91,7,95,88,44
30,r_30_8_165,seq1,seq94,r_30_8_165,0.64,2,167,165,45
36,r_21_43_90,seq149,r_143_108_78,r_21_43_90,1.0,0,90,90,45
8,r_41_4_79,r_144_82_136,seq141,r_41_4_79,1.0,0,79,79,45
37,r_143_108_78,seq131,seq26,r_143_108_78,1.0,0,78,78,45
71,seq42,seq33,r_92_146_92,r_92_146_92,1.0,15,107,92,45
86,seq88,r_58_119_184,r_140_23_53,r_140_23_53,1.0,131,184,53,45
21,r_15_77_85,seq74,seq9,r_15_77_85,0.37,0,85,85,45
97,seq118,r_5_57_9,seq90,r_5_57_9,0.25,120,129,9,45
5,r_22_72_61,r_21_43_90,seq1,r_22_72_61,1.0,0,61,61,45
46,r_80_123_114,seq12,r_21_43_90,r_80_123_114,1.0,0,114,114,45
33,r_111_51_31,seq32,seq105,r_111_51_31,0.98,1,32,31,45
7,r_86_40_67,r_121_84_163,r_128_18_160,r_128_18_160,0.98,11,171,160,45
45,r_0_104_173,seq147,r_41_4_79,r_41_4_79,1.0,95,174,79,45
23,r_27_133_48,seq74,seq25,r_27_133_48,1.0,1,49,48,45
19,r_28_35_62,seq1,r_5_57_9,r_28_35_62,1.0,2,64,62,45
41,r_2_20_104,r_109_91_155,r_24_69_49,r_2_20_104,0.94,0,104,104,45
64,seq25,seq87,r_27_133_48,r_27_133_48,1.0,9,57,48,45
20,r_113_73_28,r_130_56_119,seq38,r_113_73_28,0.83,0,28,28,45
11,r_96_132_70,seq145,seq148,r_96_132_70,1.0,0,70,70,45
13,r_128_18_160,seq47,r_3_66_164,r_128_18_160,0.95,0,160,160,45
15,r_100_6_81,r_83_17_179,seq61,r_100_6_81,1.0,0,81,81,45
57,seq141,seq62,r_41_4_79,r_41_4_79,1.0,3,82,79,45
1,r_140_23_53,r_45_36_121,r_78_76_50,r_140_23_53,1.0,1,54,53,45
62,seq148,r_75_124_140,seq85,r_75_124_140,1.0,1,141,140,45
6,r_78_76_50,seq25,seq88,r_78_76_50,1.0,0,50,50,45
2,r_3_66_164,r_58_119_184,r_86_40_67,r_58_119_184,0.66,-20,164,184,45
40,r_68_70_176,seq137,r_28_35_62,r_28_35_62,1.0,117,179,62,45
18,r_58_119_184,seq88,seq42,r_58_119_184,0.49,0,184,184,45
29,r_75_124_140,seq148,seq149,r_75_124_140,0.91,1,141,140,45
24,r_144_82_136,seq131,seq29,r_144_82_136,0.98,0,136,136,45
25,r_127_52_170,r_102_112_130,seq29,r_102_112_130,0.89,0,130,130,45
27,r_60_63_34,seq19,seq97,r_60_63_34,0.99,0,34,34,45
44,r_109_91_155,r_89_59_46,seq62,r_109_91_155,1.0,1,156,155,45
28,r_37_93_168,seq25,r_89_59_46,r_37_93_168,0.97,2,170,168,45
9,r_102_112_130,seq19,seq1,r_102_112_130,0.91,0,130,130,45
22,r_130_56_119,r_75_124_140,r_120_11_115,r_130_56_119,0.9,0,119,119,45
28,r_37_93_168,r_5_57_9,seq25,r_37_93_168,0.42,-39,129,168,45
49,r_49_31_172,seq26,r_30_8_165,r_49_31_172,0.82,0,172,172,45
7,r_86_40_67,r_129_126_182,r_121_84_163,r_86_40_67,0.39,6,73,67,45
44,r_109_91_155,r_2_20_104,r_89_59_46,r_2_20_104,1.0,0,104,104,45
25,r_127_52_170,seq29,r_15_77_85,r_127_52_170,1.0,-1,169,170,45
35,r_92_146_92,seq16,seq42,r_92_146_92,1.0,-1,91,92,45
12,r_45_36_121,seq26,seq131,r_45_36_121,0.98,0,121,121,45
84,seq85,r_75_124_140,seq148,r_75_124_140,1.0,1,141,140,45
37,r_29_28_56,r_73_100_109,seq112,r_29_28_56,1.0,0,56,56,46
30,r_106_62_80,r_92_56_59,r_29_28_56,r_106_62_80,0.95,-20,60,80,46
51,seq1,r_61_46_144,r_124_129_100,r_124_129_100,0.97,47,147,100,46
36,r_58_60_138,r_104_105_183,seq64,r_58_60_138,0.77,0,138,138,46
92,seq112,r_106_62_80,r_29_28_56,r_29_28_56,0.99,25,81,56,46
16,r_73_100_109,seq76,seq38,r_73_100_109,1.0,2,111,109,46
21,r_36_66_154,seq63,r_37_97_108,r_36_66_154,0.89,0,154,154,46
5,r_70_108_113,seq38,seq48,r_70_108_113,0.4,12,125,113,46
46,r_77_22_181,seq67,r_30_138_112,r_30_138_112,0.57,73,185,112,46
42,r_74_99_107,seq142,r_94_17_1,r_74_99_107,0.96,0,107,107,46
41,r_144_52_44,r_101_31_147,seq148,r_144_52_44,1.0,0,44,44,46
45,r_130_10_163,seq67,r_107_16_110,r_130_10_163,0.67,0,163,163,46
34,r_20_119_49,r_133_110_120,seq67,r_20_119_49,0.95,0,49,49,46
14,r_41_19_33,r_42_111_52,seq43,r_41_19_33,0.99,0,33,33,46
31,r_47_55_60,seq4,r_42_111_52,r_47_55_60,0.91,15,75,60,46
3,r_101_31_147,seq3,r_128_12_131,r_101_31_147,0.87,1,148,147,46
30,r_106_62_80,r_29_28_56,seq79,r_106_62_80,0.71,1,81,80,46
10,r_124_129_100,r_98_35_68,seq1,r_124_129_100,0.85,2,102,100,46
4,r_92_56_59,r_106_62_80,r_42_111_52,r_92_56_59,1.0,1,60,59,46
0,r_30_138_112,r_42_111_52,seq134,r_30_138_112,0.76,1,113,112,46
20,r_89_45_137,seq81,seq115,r_89_45_137,0.77,0,137,137,46
13,r_37_97_108,seq115,r_29_28_56,r_29_28_56,0.83,52,108,56,46
15,r_11_116_85,r_104_105_183,r_42_111_52,r_11_116_85,0.69,2,87,85,46
6,r_139_50_167,seq123,seq82,r_139_50_167,0.88,0,167,167,46
27,r_42_111_52,r_30_138_112,r_11_116_85,r_42_111_52,0.85,61,113,52,46
2,r_147_25_127,seq134,r_37_97_108,r_147_25_127,0.97,0,127,127,46
47,r_140_32_145,seq43,seq6,r_140_32_145,0.93,1,146,145,46
40,r_23_57_69,r_101_31_147,seq79,r_23_57_69,1.0,0,69,69,46
18,r_84_80_173,r_98_35_68,r_147_25_127,r_147_25_127,0.8,46,173,127,46
29,r_103_72_89,r_104_105_183,r_41_19_33,r_103_72_89,0.8,0,89,89,46
8,r_127_54_10,r_139_50_167,seq53,r_127_54_10,0.53,0,10,10,46
25,r_61_46_144,seq1,r_106_62_80,r_61_46_144,0.42,3,147,144,46
33,r_88_8_118,seq51,seq112,r_88_8_118,0.99,0,118,118,46
64,seq148,seq115,r_144_52_44,r_144_52_44,1.0,28,72,44,46
32,r_133_110_120,seq43,seq126,r_133_110_120,0.98,0,120,120,46
38,r_95_102_74,r_139_50_167,r_98_35_68,r_95_102_74,1.0,0,74,74,46
81,seq76,r_73_100_109,r_69_87_4,r_73_100_109,0.76,12,121,109,46
17,r_128_12_131,seq81,seq142,r_128_12_131,0.84,1,132,131,46
9,r_39_146_166,seq14,r_30_138_112,r_30_138_112,0.72,54,166,112,46
7,r_65_118_37,r_75_49_88,r_98_35_68,r_65_118_37,1.0,1,38,37,46
28,r_18_59_57,r_11_116_85,r_41_19_33,r_11_116_85,0.53,-25,60,85,46
44,r_75_49_88,r_77_22_181,seq0,r_75_49_88,1.0,0,88,88,46
79,seq67,r_77_22_181,r_20_119_49,r_20_119_49,1.0,57,106,49,46
35,r_117_122_95,r_130_10_163,r_29_28_56,r_117_122_95,1.0,0,95,95,46
12,r_27_90_150,seq76,r_98_35_68,r_27_90_150,0.7,0,150,150,46
84,seq81,r_128_12_131,r_98_35_68,r_128_12_131,0.75,1,132,131,46
51,seq2,seq125,r_83_117_49,r_83_117_49,0.82,48,97,49,47
14,r_69_78_130,r_32_72_169,r_60_13_25,r_60_13_25,0.57,106,131,25,47
8,r_57_89_121,r_32_72_169,seq126,r_57_89_121,0.62,7,128,121,47
0,r_60_13_25,r_34_74_193,seq47,r_60_13_25,0.99,2,27,25,47
37,r_43_147_87,seq47,seq29,r_43_147_87,1.0,0,87,87,47
71,seq46,r_66_103_164,r_35_22_42,r_35_22_42,0.95,122,164,42,47
86,seq95,seq2,r_83_117_49,r_83_117_49,0.98,13,62,49,47
16,r_21_14_2,r_41_97_194,r_26_90_58,r_26_90_58,1.0,15,73,58,47
39,r_118_143_118,seq106,seq7,r_118_143_118,0.99,0,118,118,47
97,seq125,seq2,r_4_148_74,r_4_148_74,1.0,23,97,74,47
42,r_4_148_74,seq126,seq125,r_4_148_74,0.99,-1,73,74,47
31,r_111_3_155,seq138,r_141_94_152,r_141_94_152,0.85,4,156,152,47
46,r_5_80_165,r_48_107_40,r_113_56_161,r_48_107_40,0.45,-6,34,40,47
3,r_10_71_85,r_66_103_164,seq121,r_10_71_85,1.0,0,85,85,47
26,r_17_82_15,r_58_146_151,r_144_145_96,r_17_82_15,0.99,2,17,15,47
80,seq77,seq28,r_48_107_40,r_48_107_40,1.0,6,46,40,47
72,seq47,r_43_147_87,r_60_13_25,r_43_147_87,0.83,-14,73,87,47
4,r_32_72_169,seq85,seq110,r_32_72_169,0.55,1,170,169,47
11,r_135_63_82,seq27,r_20_109_133,r_135_63_82,1.0,1,83,82,47
13,r_139_23_116,seq51,seq138,r_139_23_116,0.44,23,139,116,47
98,seq126,r_4_148_74,r_57_89_121,r_4_148_74,1.0,-1,73,74,47
15,r_38_88_63,r_61_24_124,seq59,r_61_24_124,0.94,-59,65,124,47
48,r_113_56_161,seq47,r_136_140_8,r_113_56_161,0.63,-69,92,161,47
46,r_5_80_165,r_1_39_66,r_136_140_8,r_136_140_8,0.79,157,165,8,47
57,seq137,seq122,r_70_99_77,r_70_99_77,1.0,45,122,77,47
6,r_149_123_175,seq131,r_136_140_8,r_149_123_175,0.48,-94,81,175,47
10,r_33_84_7,seq42,r_9_68_97,r_9_68_97,1.0,22,119,97,47
27,r_141_94_152,seq29,seq142,r_141_94_152,0.57,0,152,152,47
41,r_36_40_23,r_43_147_87,seq51,r_36_40_23,1.0,0,23,23,47
2,r_91_92_98,seq121,seq54,r_91_92_98,0.95,0,98,98,47
47,r_93_6_101,seq62,r_38_88_63,r_93_6_101,1.0,0,101,101,47
40,r_8_25_166,r_20_109_133,seq2,r_8_25_166,0.6,0,166,166,47
18,r_70_99_77,r_9_68_97,seq137,r_70_99_77,0.65,0,77,77,47
20,r_83_117_49,seq42,seq95,r_83_117_49,0.96,6,55,49,47
43,r_12_53_195,r_111_3_155,r_119_52_192,r_12_53_195,0.41,-23,172,195,47
33,r_61_24_124,seq105,seq11,r_61_24_124,1.0,0,124,124,47
9,r_114_96_55,seq137,seq11,r_114_96_55,1.0,2,57,55,47
1,r_49_50_36,seq133,seq42,r_49_50_36,1.0,1,37,36,47
6,r_149_123_175,r_136_140_8,r_141_94_152,r_149_123_175,0.84,2,177,175,47
61,seq142,r_111_3_155,r_141_94_152,r_141_94_152,0.79,0,152,152,47
32,r_58_146_151,seq131,seq121,r_58_146_151,0.31,-11,140,151,47
46,r_5_80_165,r_113_56_161,r_1_39_66,r_5_80_165,0.83,-106,59,165,47
17,r_66_103_164,seq46,r_135_63_82,r_66_103_164,0.73,0,164,164,47
34,r_48_107_40,r_5_80_165,seq77,r_48_107_40,1.0,0,40,40,47
26,r_17_82_15,r_144_145_96,r_57_89_121,r_144_145_96,0.43,16,112,96,47
96,seq122,r_37_98_149,r_10_71_85,r_10_71_85,1.0,65,150,85,47
45,r_35_22_42,seq128,seq11,r_35_22_42,1.0,0,42,42,47
22,r_0_31_79,seq87,r_38_88_63,r_0_31_79,1.0,0,79,79,47
5,r_44_108_16,r_83_117_49,seq27,r_44_108_16,0.67,3,19,16,47
24,r_26_90_58,seq29,r_21_14_2,r_26_90_58,1.0,0,58,58,47
7,r_1_39_66,r_67_129_143,r_5_80_165,r_1_39_66,0.46,5,71,66,47
44,r_124_15_174,seq16,r_57_89_121,r_124_15_174,0.35,0,174,174,47
35,r_9_68_97,r_8_25_166,r_33_84_7,r_9_68_97,0.98,2,99,97,47
93,seq112,seq26,r_134_97_78,r_134_97_78,0.97,6,84,78,48
43,r_106_17_118,r_105_87_174,seq70,r_106_17_118,0.92,0,118,118,48
37,r_32_133_99,seq46,r_127_115_38,r_32_133_99,0.98,0,99,99,48
21,r_82_121_80,r_24_3_81,r_49_44_50,r_82_121_80,1.0,0,80,80,48
39,r_65_12_83,seq70,r_68_76_63,r_68_76_63,0.95,22,85,63,48
34,r_107_141_42,r_67_101_126,seq73,r_107_141_42,1.0,0,42,42,48
1,r_81_27_185,seq95,r_100_136_145,r_81_27_185,0.32,0,185,185,48
46,r_71_118_103,seq84,seq19,r_71_118_103,0.57,5,108,103,48
6,r_51_66_45,seq29,seq38,r_51_66_45,1.0,-1,44,45,48
45,r_134_97_78,r_100_136_145,seq112,r_100_136_145,0.48,-70,75,145,48
19,r_47_34_179,seq15,r_64_86_168,r_47_34_179,0.36,4,183,179,48
0,r_49_44_50,r_23_63_123,seq92,r_49_44_50,0.95,0,50,50,48
11,r_100_136_145,seq109,seq6,r_100_136_145,1.0,0,145,145,48
31,r_79_75_93,r_64_86_168,r_24_3_81,r_24_3_81,0.93,13,94,81,48
41,r_68_76_63,r_132_113_105,r_65_12_83,r_68_76_63,1.0,1,64,63,48
67,seq39,r_122_104_166,r_114_85_75,r_114_85_75,1.0,1,76,75,48
3,r_36_135_170,r_47_34_179,r_130_128_131,r_36_135_170,0.66,0,170,170,48
10,r_129_55_120,seq2,seq103,r_129_55_120,0.97,2,122,120,48
90,seq108,seq140,r_132_113_105,r_132_113_105,0.95,8,113,105,48
26,r_105_87_174,r_106_17_118,seq14,r_106_17_118,0.92,-28,90,118,48
85,seq92,r_20_99_161,r_49_44_50,r_49_44_50,1.0,0,50,50,48
11,r_100_136_145,r_134_97_78,seq109,r_134_97_78,1.0,-16,62,78,48
20,r_83_7_125,seq73,r_68_76_63,r_68_76_63,1.0,4,67,63,48
13,r_16_43_182,r_81_27_185,r_20_99_161,r_81_27_185,0.5,-3,182,185,48
15,r_114_85_75,seq46,seq39,r_114_85_75,1.0,1,76,75,48
48,r_148_125_186,seq123,r_129_55_120,r_148_125_186,0.37,0,186,186,48
17,r_21_5_52,r_11_62_77,r_49_44_50,r_49_44_50,0.72,2,52,50,48
36,r_142_48_128,seq25,seq29,r_142_48_128,0.99,-1,127,128,48
27,r_88_96_85,r_20_99_161,seq8,r_88_96_85,0.87,-3,82,85,48
22,r_54_56_65,seq140,r_132_113_105,r_132_113_105,0.58,39,144,105,48
47,r_145_126_82,r_105_87_174,seq59,r_145_126_82,1.0,0,82,82,48
40,r_69_74_87,r_21_5_52,seq117,r_69_74_87,0.96,0,87,87,48
18,r_67_101_126,seq46,r_88_96_85,r_67_101_126,0.87,0,126,126,48
29,r_144_40_79,seq33,seq143,r_144_40_79,1.0,3,82,79,48
24,r_64_86_168,seq14,r_65_12_83,r_65_12_83,0.97,91,174,83,48
25,r_23_63_123,seq117,seq109,r_23_63_123,0.98,0,123,123,48
20,r_83_7_125,r_68_76_63,seq57,r_83_7_125,0.99,2,127,125,48
32,r_132_113_105,seq109,seq108,r_132_113_105,0.91,1,106,105,48
38,r_28_18_70,r_54_56_65,seq53,r_28_18_70,1.0,0,70,70,48
30,r_31_30_16,r_124_94_184,seq95,r_31_30_16,0.93,-1,15,16,48
4,r_127_115_38,seq13,seq92,r_127_115_38,1.0,0,38,38,48
60,seq15,r_47_34_179,r_146_50_143,r_146_50_143,0.96,40,183,143,48
81,seq84,r_71_118_103,r_24_3_81,r_24_3_81,0.96,1,82,81,48
9,r_24_3_81,seq38,seq84,r_24_3_81,1.0,1,82,81,48
26,r_105_87_174,seq14,r_24_3_81,r_105_87_174,0.49,8,182,174,48
22,r_54_56_65,r_28_18_70,seq140,r_54_56_65,1.0,-1,64,65,48
91,seq109,r_132_113_105,seq93,r_132_113_105,1.0,1,106,105,48
35,r_146_50_143,seq137,seq15,r_146_50_143,0.99,1,144,143,48
93,seq114,r_101_135_95,seq68,r_101_135_95,1.0,-1,94,95,49
30,r_141_46_87,seq93,r_121_66_4,r_141_46_87,0.76,5,92,87,49
36,r_82_64_169,r_48_123_165,r_131_89_140,r_82_64_169,0.9,-4,165,169,49
6,r_1_113_113,r_97_133_52,r_90_128_18,r_97_133_52,0.97,0,52,52,49
8,r_138_25_60,r_7_12_192,seq22,r_138_25_60,0.99,0,60,60,49
43,r_8_142_82,r_38_11_147,r_26_120_75,r_8_142_82,0.56,0,82,82,49
31,r_90_128_18,r_38_11_147,seq67,r_90_128_18,0.99,0,18,18,49
83,seq93,r_141_46_87,seq115,r_141_46_87,1.0,5,92,87,49
37,r_29_126_154,seq68,r_145_127_38,r_29_126_154,0.82,0,154,154,49
71,seq53,r_7_12_192,r_136_102_149,r_136_102_149,0.92,11,160,149,49
86,seq99,r_49_9_181,r_131_89_140,r_131_89_140,0.91,5,145,140,49
21,r_14_132_124,r_29_126_154,r_111_108_142,r_29_126_154,0.54,-2,152,154,49
39,r_70_79_98,seq34,seq40,r_70_79_98,0.78,2,100,98,49
1,r_101_135_95,seq114,seq34,r_101_135_95,0.99,-1,94,95,49
42,r_0_143_156,r_49_9_181,r_96_42_110,r_96_42_110,0.95,47,157,110,49
45,r_119_62_158,seq13,r_81_71_76,r_81_71_76,1.0,83,159,76,49
19,r_129_47_130,seq40,seq144,r_129_47_130,1.0,0,130,130,49
10,r_118_61_125,seq44,seq115,r_118_61_125,0.64,1,126,125,49
14,r_36_32_40,r_138_25_60,seq77,r_36_32_40,0.98,0,40,40,49
26,r_26_120_75,r_111_108_142,r_8_142_82,r_111_108_142,0.93,-59,83,142,49
3,r_92_63_24,r_136_102_149,seq30,r_92_63_24,0.81,-6,18,24,49
72,seq55,r_107_88_189,r_51_2_183,r_107_88_189,0.42,0,189,189,49
4,r_38_11_147,seq125,r_141_46_87,r_38_11_147,0.18,11,158,147,49
7,r_97_133_52,r_1_113_113,seq13,r_97_133_52,1.0,0,52,52,49
20,r_65_43_180,r_7_12_192,r_26_120_75,r_7_12_192,0.43,-11,181,192,49
13,r_87_139_174,seq106,r_138_25_60,r_138_25_60,0.88,115,175,60,49
98,seq125,r_38_11_147,r_57_45_103,r_57_45_103,1.0,8,111,103,49
57,seq147,r_117_56_185,r_118_61_125,r_118_61_125,0.8,60,185,125,49
29,r_17_58_15,r_138_25_60,seq106,r_17_58_15,0.81,-5,10,15,49
27,r_16_59_117,seq34,r_26_120_75,r_16_59_117,1.0,0,117,117,49
22,r_49_9_181,r_54_137_86,seq24,r_49_9_181,0.84,0,181,181,49
2,r_131_89_140,seq39,r_1_113_113,r_131_89_140,0.79,0,140,140,49
40,r_75_76_160,seq144,r_118_61_125,r_75_76_160,0.77,2,162,160,49
24,r_146_4_107,seq35,r_148_84_49,r_146_4_107,0.43,0,107,107,49
25,r_27_94_67,r_41_28_106,seq55,r_27_94_67,0.75,0,67,67,49
64,seq34,r_70_79_98,r_101_135_95,r_101_135_95,1.0,5,100,95,49
6,r_1_113_113,r_90_128_18,r_54_137_86,r_1_113_113,1.0,0,113,113,49
47,r_6_100_14,r_51_2_183,seq91,r_6_100_14,0.73,0,14,14,49
38,r_107_88_189,seq55,r_69_73_9,r_69_73_9,0.59,180,189,9,49
77,seq77,r_41_28_106,r_36_32_40,r_36_32_40,0.79,66,106,40,49
46,r_74_18_50,r_96_42_110,r_54_137_86,r_74_18_50,0.99,54,104,50,49
46,r_74_18_50,r_138_25_60,r_96_42_110,r_74_18_50,1.0,0,50,50,49
75,seq68,r_29_126_154,seq114,r_29_126_154,0.99,0,154,154,49
0,r_145_127_38,r_129_47_130,seq106,r_145_127_38,0.99,0,38,38,49
17,r_48_123_165,r_82_64_169,r_69_73_9,r_48_123_165,0.61,0,165,165,49
94,seq115,r_111_108_142,seq93,r_111_108_142,1.0,0,142,142,49
9,r_96_42_110,r_49_9_181,r_70_79_98,r_96_42_110,0.95,0,110,110,49
22,r_49_9_181,r_96_42_110,r_54_137_86,r_49_9_181,0.97,-71,110,181,49
28,r_81_71_76,r_119_62_158,seq144,r_81_71_76,0.84,0,76,76,49
49,r_52_140_77,r_141_46_87,seq37,r_52_140_77,1.0,0,77,77,49
26,r_26_120_75,r_8_142_82,r_16_59_117,r_16_59_117,1.0,2,119,117,49
56,seq144,r_75_76_160,r_129_47_130,r_129_47_130,0.98,32,162,130,49
44,r_10_19_152,seq72,r_6_100_14,r_10_19_152,0.94,0,152,152,49
23,r_104_33_62,r_87_139_174,seq44,r_104_33_62,0.98,2,64,62,49
35,r_41_28_106,seq77,r_101_135_95,r_101_135_95,1.0,11,106,95,49
30,r_102_143_187,seq140,r_96_82_72,r_96_82_72,1.0,117,189,72,50
92,seq105,r_72_41_164,seq32,r_72_41_164,0.97,0,164,164,50
18,r_103_112_44,r_51_65_181,r_23_145_48,r_103_112_44,1.0,0,44,44,50
8,r_48_144_173,seq28,r_39_60_39,r_48_144_173,0.83,0,173,173,50
31,r_110_113_17,r_138_71_93,seq107,r_110_113_17,0.92,1,18,17,50
37,r_56_29_83,r_92_99_101,seq67,r_56_29_83,1.0,0,83,83,50
55,seq8,r_74_7_77,r_88_0_116,r_74_7_77,0.39,25,102,77,50
71,seq35,seq8,r_88_0_116,r_88_0_116,0.82,-21,95,116,50
86,seq139,r_75_10_188,r_96_82_72,r_96_82_72,1.0,117,189,72,50
16,r_92_99_101,r_52_121_191,r_93_33_75,r_92_99_101,0.55,0,101,101,50
40,r_93_33_75,r_147_104_135,r_92_99_101,r_93_33_75,0.6,23,98,75,50
1,r_91_115_10,r_125_77_117,r_17_94_53,r_17_94_53,0.5,66,119,53,50
5,r_96_82_72,seq79,seq139,r_96_82_72,1.0,0,72,72,50
15,r_37_22_58,seq12,seq14,r_37_22_58,1.0,0,58,58,50
10,r_98_118_47,r_90_69_183,seq100,r_98_118_47,0.88,1,48,47,50
19,r_20_148_62,seq87,r_119_42_57,r_20_148_62,0.84,0,62,62,50
33,r_111_81_22,seq122,r_147_104_135,r_147_104_135,0.9,22,157,135,50
32,r_55_38_35,r_23_145_48,seq5,r_55_38_35,1.0,0,35,35,50
49,r_17_94_53,r_133_57_127,r_91_115_10,r_17_94_53,1.0,0,53,53,50
66,seq27,r_70_36_153,r_85_47_108,r_85_47_108,0.92,45,153,108,50
14,r_39_60_39,r_149_18_74,r_6_45_9,r_39_60_39,0.62,10,49,39,50
41,r_89_101_110,seq73,r_92_99_101,r_89_101_110,0.97,0,110,110,50
3,r_85_47_108,r_64_4_113,r_110_113_17,r_85_47_108,0.86,1,109,108,50
4,r_133_57_127,r_134_127_182,seq61,r_134_127_182,0.81,-55,127,182,50
20,r_64_4_113,seq11,r_56_29_83,r_64_4_113,1.0,0,113,113,50
48,r_90_69_183,seq78,r_85_47_108,r_85_47_108,0.99,75,183,108,50
6,r_75_10_188,seq139,r_92_99_101,r_75_10_188,0.45,1,189,188,50
29,r_62_95_41,r_72_41_164,seq107,r_62_95_41,0.78,2,43,41,50
27,r_66_19_174,seq11,r_91_115_10,r_66_19_174,0.5,1,175,174,50
1,r_91_115_10,r_86_54_61,r_125_77_117,r_91_115_10,0.97,0,10,10,50
47,r_120_84_157,seq122,r_88_0_116,r_120_84_157,0.9,0,157,157,50
40,r_93_33_75,r_88_0_116,r_147_104_135,r_93_33_75,0.94,1,76,75,50
51,seq2,r_70_36_153,r_146_13_5,r_146_13_5,0.92,5,10,5,50
24,r_125_77_117,seq142,r_92_99_101,r_125_77_117,0.91,2,119,117,50
43,r_135_83_18,r_40_44_90,seq137,r_135_83_18,1.0,0,18,18,50
25,r_86_54_61,seq34,seq100,r_86_54_61,0.96,0,61,61,50
17,r_106_130_21,r_48_144_173,seq12,r_106_130_21,1.0,-3,18,21,50
88,seq87,r_75_10_188,r_53_131_64,r_53_131_64,1.0,10,74,64,50
38,r_58_59_87,r_48_144_173,r_74_7_77,r_58_59_87,1.0,0,87,87,50
34,r_116_68_162,seq142,r_85_47_108,r_85_47_108,0.67,54,162,108,50
26,r_119_42_57,r_96_82_72,seq137,r_119_42_57,0.57,0,57,57,50
60,seq14,seq50,r_37_22_58,r_37_22_58,1.0,6,64,58,50
21,r_23_145_48,r_55_38_35,r_110_113_17,r_23_145_48,0.92,-13,35,48,50
81,seq73,r_138_71_93,seq139,r_138_71_93,1.0,0,93,93,50
94,seq108,seq16,r_40_44_90,r_40_44_90,1.0,13,103,90,50
9,r_40_44_90,seq63,seq108,r_40_44_90,1.0,0,90,90,50
22,r_53_131_64,seq132,seq87,r_53_131_64,1.0,0,64,64,50
28,r_134_127_182,r_133_57_127,r_96_82_72,r_96_82_72,1.0,111,183,72,50
56,seq9,seq21,r_74_7_77,r_74_7_77,1.0,58,135,77,50
7,r_138_71_93,seq73,seq16,r_138_71_93,1.0,0,93,93,50
23,r_74_7_77,seq8,seq9,r_74_7_77,0.91,1,78,77,50
42,r_124_109_59,r_147_104_135,seq142,r_124_109_59,0.85,0,59,59,50
12,r_88_0_116,seq21,seq35,r_88_0_116,0.86,1,117,116,50
33,r_111_81_22,r_40_44_90,seq122,r_111_81_22,0.99,0,22,22,50
4,r_54_110_24,r_140_82_62,seq12,r_54_110_24,1.0,-2,22,24,51
93,seq111,r_127_41_123,r_42_8_57,r_127_41_123,0.53,-1,122,123,51
14,r_98_65_105,seq26,seq34,r_98_65_105,0.39,5,110,105,51
8,r_123_93_128,seq9,r_24_81_7,r_123_93_128,0.61,1,129,128,51
17,r_33_68_169,r_140_82_62,r_125_121_102,r_33_68_169,0.91,3,172,169,51
37,r_35_58_121,r_33_68_169,r_125_121_102,r_35_58_121,0.81,1,122,121,51
71,seq34,r_44_60_120,r_127_41_123,r_127_41_123,0.65,7,130,123,51
16,r_92_147_55,r_42_8_57,seq132,r_92_147_55,0.55,16,71,55,51
21,r_114_67_113,seq0,seq20,r_114_67_113,0.97,0,113,113,51
39,r_44_60_120,seq34,r_125_121_102,r_125_121_102,0.95,39,141,102,51
1,r_47_10_75,seq79,r_72_3_137,r_47_10_75,0.97,0,75,75,51
29,r_141_83_32,seq135,r_145_148_192,r_141_83_32,0.98,0,32,32,51
46,r_142_40_168,seq57,r_116_143_58,r_116_143_58,0.56,110,168,58,51
42,r_125_121_102,seq79,r_145_148_192,r_125_121_102,0.81,-1,101,102,51
45,r_49_104_158,seq139,r_43_52_72,r_49_104_158,0.68,2,160,158,51
23,r_103_27_29,r_116_143_58,seq118,r_103_27_29,0.94,0,29,29,51
31,r_146_133_107,r_62_94_171,r_50_1_96,r_50_1_96,0.99,13,109,96,51
3,r_16_100_165,seq75,r_42_8_57,r_42_8_57,0.48,109,166,57,51
10,r_140_82_62,seq2,r_33_68_169,r_140_82_62,0.84,2,64,62,51
26,r_71_115_71,seq69,r_97_70_40,r_71_115_71,0.97,0,71,71,51
0,r_136_31_129,r_50_1_96,r_103_27_29,r_136_31_129,0.88,-32,97,129,51
13,r_127_41_123,seq111,r_98_65_105,r_127_41_123,0.92,-1,122,123,51
47,r_53_144_20,r_98_65_105,seq88,r_53_144_20,0.98,0,20,20,51
48,r_105_74_63,seq79,seq7,r_105_74_63,0.99,2,65,63,51
6,r_107_76_141,seq79,r_35_58_121,r_107_76_141,0.85,3,144,141,51
10,r_140_82_62,r_33_68_169,r_146_133_107,r_33_68_169,0.87,-7,162,169,51
87,seq88,r_55_126_174,r_28_25_100,r_28_25_100,0.98,78,178,100,51
50,seq0,seq77,r_86_84_152,r_86_84_152,0.81,10,162,152,51
40,r_131_101_131,seq118,seq75,r_131_101_131,0.7,0,131,131,51
74,seq46,r_72_3_137,r_47_10_75,r_47_10_75,1.0,67,142,75,51
18,r_90_30_138,seq79,seq135,r_90_30_138,0.66,0,138,138,51
33,r_36_109_93,r_145_148_192,seq21,r_36_109_93,0.49,1,94,93,51
50,seq0,r_114_67_113,seq77,r_114_67_113,0.78,-1,112,113,51
0,r_136_31_129,r_103_27_29,r_43_52_72,r_136_31_129,0.93,0,129,129,51
68,seq26,r_98_65_105,r_108_59_92,r_98_65_105,0.94,6,111,105,51
61,seq14,r_86_84_152,r_43_52_72,r_43_52_72,1.0,1,73,72,51
38,r_28_25_100,r_117_6_194,seq89,r_28_25_100,1.0,0,100,100,51
34,r_37_102_136,seq2,r_123_93_128,r_123_93_128,0.55,9,137,128,51
81,seq75,r_16_100_165,r_131_101_131,r_131_101_131,0.94,35,166,131,51
17,r_33_68_169,r_35_58_121,r_140_82_62,r_33_68_169,0.87,-47,122,169,51
43,r_38_129_33,r_23_61_80,seq79,r_38_129_33,0.51,2,35,33,51
9,r_62_94_171,r_146_133_107,seq119,r_146_133_107,0.54,65,172,107,51
22,r_43_52_72,seq20,seq14,r_43_52_72,1.0,0,72,72,51
28,r_55_126_174,seq88,r_42_8_57,r_42_8_57,0.6,130,187,57,51
49,r_50_1_96,r_136_31_129,r_146_133_107,r_50_1_96,1.0,1,97,96,51
41,r_97_70_40,r_55_126_174,seq5,r_97_70_40,1.0,0,40,40,51
12,r_23_61_80,seq14,r_130_39_37,r_23_61_80,0.97,0,80,80,51
95,seq118,r_42_8_57,r_103_27_29,r_103_27_29,0.89,7,36,29,51
7,r_130_39_37,seq69,r_63_113_18,r_130_39_37,1.0,3,40,37,51
30,r_26_29_71,r_74_58_134,r_79_66_46,r_26_29_71,0.99,3,74,71,52
92,seq106,seq108,r_3_109_36,r_3_109_36,1.0,25,61,36,52
14,r_97_22_188,seq99,r_56_91_117,r_56_91_117,0.98,4,121,117,52
43,r_92_17_95,r_135_41_146,r_89_134_54,r_92_17_95,0.62,0,95,95,52
83,seq84,seq9,r_82_45_91,r_82_45_91,0.95,5,96,91,52
37,r_63_5_108,seq23,r_78_103_48,r_63_5_108,0.83,2,110,108,52
55,seq13,seq99,r_124_53_88,r_124_53_88,0.94,53,141,88,52
86,seq94,r_115_118_106,r_89_134_54,r_89_134_54,0.85,53,107,54,52
39,r_129_67_161,seq7,seq55,r_129_67_161,0.53,0,161,161,52
46,r_75_132_191,r_112_15_98,seq28,r_112_15_98,1.0,0,98,98,52
9,r_120_107_17,r_39_11_87,seq23,r_120_107_17,0.97,0,17,17,52
19,r_128_48_102,seq6,r_112_15_98,r_112_15_98,1.0,13,111,98,52
21,r_72_52_28,r_74_58_134,r_147_123_159,r_72_52_28,1.0,2,30,28,52
2,r_43_51_142,r_110_85_81,r_69_119_35,r_110_85_81,0.68,-32,49,81,52
27,r_147_123_159,r_72_52_28,r_20_126_18,r_147_123_159,0.91,1,160,159,52
95,seq114,seq108,r_33_49_128,r_33_49_128,0.96,2,130,128,52
32,r_78_103_48,r_142_30_86,r_63_5_108,r_142_30_86,0.92,0,86,86,52
3,r_57_12_79,seq4,seq7,r_57_12_79,1.0,1,80,79,52
42,r_89_134_54,r_33_49_128,seq133,r_89_134_54,1.0,0,54,54,52
10,r_146_47_127,seq55,seq4,r_146_47_127,0.94,0,127,127,52
26,r_115_118_106,seq94,r_90_83_9,r_115_118_106,0.99,1,107,106,52
4,r_33_49_128,r_1_10_136,seq114,r_33_49_128,0.63,3,131,128,52
11,r_112_15_98,r_75_132_191,r_128_48_102,r_112_15_98,1.0,1,99,98,52
20,r_127_38_83,seq55,seq87,r_127_38_83,1.0,0,83,83,52
13,r_130_8_126,r_40_111_193,seq46,r_130_8_126,0.94,0,126,126,52
15,r_81_34_105,seq16,r_124_53_88,r_81_34_105,1.0,0,105,105,52
48,r_70_31_92,r_74_58_134,seq14,r_70_31_92,0.98,2,94,92,52
21,r_72_52_28,r_147_123_159,r_141_138_123,r_72_52_28,0.78,132,160,28,52
2,r_43_51_142,r_69_119_35,r_120_107_17,r_43_51_142,1.0,0,142,142,52
16,r_95_131_45,r_39_11_87,seq59,r_95_131_45,1.0,1,46,45,52
99,seq149,r_1_10_136,seq55,r_1_10_136,1.0,2,138,136,52
45,r_73_136_12,r_40_111_193,seq7,r_73_136_12,0.96,-1,11,12,52
31,r_3_109_36,seq36,seq106,r_3_109_36,1.0,1,37,36,52
27,r_147_123_159,seq9,r_72_52_28,r_72_52_28,0.98,36,64,28,52
41,r_142_30_86,r_35_96_38,r_78_103_48,r_35_96_38,0.78,0,38,38,52
87,seq98,r_102_125_169,r_26_29_71,r_26_29_71,0.57,99,170,71,52
22,r_101_0_10,r_130_8_126,r_3_109_36,r_101_0_10,0.92,64,74,10,52
47,r_61_143_3,r_135_41_146,r_39_11_87,r_135_41_146,0.94,1,147,146,52
36,r_79_66_46,r_97_22_188,seq98,r_79_66_46,0.95,0,46,46,52
40,r_124_53_88,r_102_125_169,r_110_85_81,r_124_53_88,0.98,4,92,88,52
18,r_110_85_81,r_43_51_142,r_124_53_88,r_110_85_81,0.86,9,90,81,52
29,r_74_58_134,seq7,r_127_38_83,r_74_58_134,0.51,6,140,134,52
24,r_148_60_125,seq4,r_39_11_87,r_148_60_125,0.63,13,138,125,52
25,r_139_117_62,r_146_47_127,r_40_111_193,r_139_117_62,0.56,0,62,62,52
33,r_1_10_136,seq149,r_40_111_193,r_1_10_136,0.82,2,138,136,52
17,r_35_96_38,r_142_30_86,seq104,r_35_96_38,0.64,0,38,38,52
64,seq25,r_137_32_111,r_69_119_35,r_137_32_111,1.0,0,111,111,52
88,seq99,r_39_11_87,r_127_38_83,r_127_38_83,1.0,0,83,83,52
50,seq4,r_57_12_79,r_148_60_125,r_57_12_79,1.0,1,80,79,52
38,r_141_138_123,r_146_47_127,seq9,r_141_138_123,0.99,0,123,123,52
23,r_69_119_35,r_137_32_111,r_43_51_142,r_137_32_111,0.61,-75,36,111,52
34,r_37_88_137,r_40_111_193,r_57_12_79,r_40_111_193,0.68,-55,138,193,52
32,r_78_103_48,seq84,r_142_30_86,r_78_103_48,0.96,0,48,48,52
41,r_142_30_86,r_78_103_48,seq65,r_142_30_86,1.0,0,86,86,52
28,r_56_91_117,seq76,r_97_22_188,r_56_91_117,0.92,1,118,117,52
7,r_135_41_146,r_61_143_3,r_57_12_79,r_61_143_3,0.77,144,147,3,52
44,r_137_32_111,seq25,r_63_5_108,r_137_32_111,1.0,0,111,111,52
35,r_144_140_165,seq23,r_57_12_79,r_144_140_165,0.54,0,165,165,52
12,r_82_45_91,r_63_5_108,seq84,r_82_45_91,0.95,0,91,91,52
5,r_20_126_18,r_43_51_142,seq76,r_20_126_18,0.44,-3,15,18,52
23,r_69_119_35,r_43_51_142,seq55,r_43_51_142,1.0,0,142,142,52
30,r_124_105_161,r_142_121_108,r_34_40_107,r_142_121_108,0.39,1,109,108,53
44,r_94_79_140,r_4_90_30,r_142_121_108,r_4_90_30,0.71,110,140,30,53
28,r_98_21_6,r_4_90_30,r_48_77_154,r_98_21_6,0.71,170,176,6,53
36,r_34_40_107,r_106_85_186,seq13,r_34_40_107,0.86,2,109,107,53
26,r_42_140_44,r_19_87_147,seq88,r_42_140_44,0.92,1,45,44,53
8,r_95_96_176,r_48_77_154,r_39_148_16,r_95_96_176,0.71,-22,154,176,53
53,seq136,r_27_23_182,r_142_121_108,r_142_121_108,0.97,68,176,108,53
43,r_51_25_122,seq114,seq125,r_51_25_122,0.97,3,125,122,53
19,r_8_130_84,r_15_22_169,r_84_109_141,r_8_130_84,0.89,80,164,84,53
55,seq139,r_134_59_175,r_106_85_186,r_106_85_186,0.56,0,186,186,53
21,r_68_2_78,seq116,seq64,r_68_2_78,1.0,2,80,78,53
39,r_45_146_170,seq147,r_124_105_161,r_45_146_170,0.3,2,172,170,53
5,r_16_81_145,seq72,r_4_90_30,r_4_90_30,0.92,117,147,30,53
46,r_48_77_154,r_95_96_176,r_98_21_6,r_48_77_154,0.78,0,154,154,53
42,r_128_73_87,seq111,r_132_70_66,r_128_73_87,0.91,0,87,87,53
45,r_27_23_182,seq136,r_133_102_160,r_27_23_182,0.49,2,184,182,53
19,r_8_130_84,r_131_123_168,r_15_22_169,r_8_130_84,1.0,0,84,84,53
80,seq72,r_16_81_145,r_141_86_7,r_141_86_7,0.89,3,10,7,53
76,seq63,r_19_87_147,r_128_73_87,r_128_73_87,1.0,18,105,87,53
31,r_138_17_121,r_15_22_169,r_57_60_39,r_15_22_169,0.67,-46,123,169,53
41,r_142_121_108,r_124_105_161,seq20,r_142_121_108,0.99,1,109,108,53
30,r_124_105_161,r_34_40_107,seq64,r_124_105_161,0.99,0,161,161,53
10,r_28_9_68,r_45_146_170,r_48_77_154,r_28_9_68,0.99,0,68,68,53
0,r_26_56_89,r_15_22_169,r_50_62_2,r_26_56_89,0.78,1,90,89,53
11,r_131_123_168,seq41,r_122_78_104,r_122_78_104,0.98,64,168,104,53
15,r_11_144_114,seq31,r_28_9_68,r_28_9_68,1.0,48,116,68,53
6,r_122_78_104,seq112,seq36,r_122_78_104,0.96,1,105,104,53
13,r_57_60_39,r_132_70_66,seq55,r_57_60_39,0.99,0,39,39,53
33,r_39_148_16,seq13,r_3_118_171,r_39_148_16,0.88,1,17,16,53
27,r_133_102_160,r_45_146_170,seq114,r_45_146_170,0.47,-2,168,170,53
44,r_94_79_140,seq107,r_4_90_30,r_4_90_30,1.0,2,32,30,53
37,r_113_46_49,r_131_123_168,r_4_90_30,r_113_46_49,0.88,0,49,49,53
2,r_14_69_105,r_106_85_186,r_95_96_176,r_14_69_105,0.97,3,108,105,53
18,r_103_71_62,r_43_99_187,seq147,r_103_71_62,1.0,1,63,62,53
29,r_15_22_169,r_26_56_89,r_8_130_84,r_15_22_169,0.81,-79,90,169,53
24,r_110_92_111,r_43_99_187,r_39_148_16,r_110_92_111,0.93,0,111,111,53
10,r_28_9_68,r_48_77_154,r_11_144_114,r_28_9_68,0.6,50,118,68,53
38,r_115_33_123,seq55,r_50_62_2,r_115_33_123,0.7,1,124,123,53
52,seq7,r_51_25_122,r_124_105_161,r_51_25_122,0.54,-92,30,122,53
34,r_100_75_109,seq5,seq117,r_100_75_109,0.99,0,109,109,53
60,seq147,r_45_146_170,r_103_71_62,r_103_71_62,1.0,110,172,62,53
17,r_120_49_127,r_43_99_187,seq126,r_120_49_127,0.98,0,127,127,53
90,seq107,r_94_79_140,r_44_119_28,r_44_119_28,0.81,4,32,28,53
94,seq114,r_51_25_122,r_133_102_160,r_51_25_122,0.97,3,125,122,53
9,r_43_99_187,seq129,r_14_69_105,r_14_69_105,0.83,84,189,105,53
96,seq117,seq97,r_100_75_109,r_100_75_109,1.0,32,141,109,53
28,r_98_21_6,r_149_10_129,r_4_90_30,r_98_21_6,0.95,120,126,6,53
29,r_15_22_169,r_8_130_84,r_110_92_111,r_8_130_84,0.76,85,169,84,53
22,r_149_10_129,r_98_21_6,seq32,r_149_10_129,0.94,1,130,129,53
49,r_47_1_158,r_19_87_147,r_76_66_51,r_19_87_147,0.83,11,158,147,53
56,seq13,seq137,r_34_40_107,r_34_40_107,0.99,2,109,107,53
7,r_132_70_66,seq24,r_54_29_4,r_132_70_66,0.81,6,72,66,53
23,r_93_6_117,seq97,seq111,r_93_6_117,0.77,0,117,117,53
35,r_19_87_147,r_47_1_158,r_141_86_7,r_47_1_158,0.63,0,158,158,53
48,r_76_66_51,r_138_17_121,seq5,r_76_66_51,1.0,0,51,51,53
93,seq93,r_119_18_84,r_113_141_78,r_113_141_78,1.0,13,91,78,54
40,r_85_12_44,r_83_20_183,r_48_73_2,r_85_12_44,0.74,82,126,44,54
37,r_122_19_71,r_62_21_162,r_85_12_44,r_122_19_71,1.0,0,71,71,54
10,r_131_17_30,seq4,r_48_73_2,r_131_17_30,0.7,0,30,30,54
21,r_137_94_115,r_35_28_171,seq100,r_137_94_115,0.96,0,115,115,54
5,r_126_124_102,seq22,seq97,r_126_124_102,0.96,0,102,102,54
46,r_90_60_77,seq1,seq11,r_90_60_77,1.0,0,77,77,54
6,r_123_64_116,seq49,r_130_95_136,r_130_95_136,0.93,7,143,136,54
45,r_82_24_153,seq67,r_138_50_83,r_138_50_83,0.63,70,153,83,54
19,r_62_21_162,seq71,r_107_106_29,r_62_21_162,0.55,0,162,162,54
95,seq100,seq7,r_137_94_115,r_137_94_115,0.99,55,170,115,54
39,r_111_136_27,r_6_129_109,r_125_41_60,r_111_136_27,0.97,2,29,27,54
31,r_147_102_99,r_123_64_116,r_125_41_60,r_147_102_99,0.97,0,99,99,54
41,r_38_65_110,r_126_124_102,r_107_106_29,r_126_124_102,0.98,-4,98,102,54
67,seq30,r_74_96_160,r_126_124_102,r_126_124_102,0.7,58,160,102,54
49,r_37_70_49,r_6_129_109,seq4,r_37_70_49,1.0,0,49,49,54
8,r_107_106_29,seq93,r_38_65_110,r_38_65_110,0.83,14,124,110,54
4,r_142_9_86,r_74_96_160,r_47_146_151,r_142_9_86,1.0,0,86,86,54
8,r_107_106_29,r_48_73_2,seq93,r_107_106_29,0.77,1,30,29,54
11,r_74_96_160,seq30,seq71,r_74_96_160,0.66,0,160,160,54
98,seq117,r_104_2_197,r_39_79_55,r_39_79_55,1.0,21,76,55,54
20,r_26_148_11,r_6_129_109,seq7,r_26_148_11,1.0,0,11,11,54
48,r_138_50_83,r_126_124_102,seq58,r_138_50_83,1.0,1,84,83,54
40,r_85_12_44,r_104_2_197,r_83_20_183,r_85_12_44,1.0,0,44,44,54
57,seq11,seq8,r_6_129_109,r_6_129_109,0.99,23,132,109,54
6,r_123_64_116,r_147_102_99,seq49,r_147_102_99,1.0,0,99,99,54
14,r_51_143_41,seq11,seq10,r_51_143_41,1.0,1,42,41,54
2,r_55_118_149,seq34,r_131_17_30,r_55_118_149,0.96,0,149,149,54
18,r_99_33_70,r_126_124_102,r_131_17_30,r_126_124_102,0.62,-23,79,102,54
29,r_52_0_63,seq45,r_110_68_92,r_52_0_63,1.0,0,63,63,54
25,r_110_68_92,seq128,r_52_0_63,r_52_0_63,1.0,30,93,63,54
33,r_135_54_172,seq93,r_127_46_40,r_127_46_40,1.0,141,181,40,54
47,r_83_20_183,r_85_12_44,seq133,r_83_20_183,0.61,0,183,183,54
27,r_98_108_34,r_48_73_2,seq15,r_98_108_34,1.0,0,34,34,54
56,seq10,r_119_18_84,r_51_143_41,r_51_143_41,1.0,10,51,41,54
38,r_130_95_136,seq71,r_123_64_116,r_130_95_136,0.92,0,136,136,54
34,r_57_63_147,r_110_68_92,seq1,r_57_63_147,0.91,0,147,147,54
60,seq14,r_35_28_171,seq88,r_35_28_171,0.89,0,171,171,54
17,r_119_18_84,seq10,r_103_42_28,r_103_42_28,0.92,63,91,28,54
32,r_103_42_28,seq8,seq67,r_103_42_28,1.0,1,29,28,54
9,r_6_129_109,r_130_95_136,r_90_60_77,r_6_129_109,1.0,0,109,109,54
47,r_83_20_183,seq89,r_85_12_44,r_85_12_44,1.0,5,49,44,54
22,r_87_72_163,r_48_73_2,r_109_3_59,r_109_3_59,0.93,105,164,59,54
24,r_127_46_40,seq100,r_111_136_27,r_127_46_40,1.0,0,40,40,54
7,r_134_29_144,r_35_28_171,seq22,r_134_29_144,0.74,0,144,144,54
0,r_125_41_60,r_52_0_63,r_27_75_1,r_52_0_63,1.0,-12,51,63,54
44,r_25_144_127,r_134_29_144,r_110_68_92,r_25_144_127,0.74,2,129,127,54
23,r_113_141_78,seq100,seq93,r_113_141_78,1.0,0,78,78,54
36,r_39_79_55,r_35_28_171,seq117,r_39_79_55,0.95,4,59,55,54
39,r_111_136_27,r_125_41_60,r_127_46_40,r_111_136_27,0.57,30,57,27,54
10,r_131_17_30,r_48_73_2,r_99_33_70,r_99_33_70,0.95,-11,59,70,54
12,r_5_69_157,seq145,r_47_146_151,r_5_69_157,0.87,0,157,157,54
42,r_27_75_1,seq4,r_125_41_60,r_27_75_1,0.52,50,51,1,54
14,r_37_80_29,r_52_13_123,r_10_111_108,r_37_80_29,0.76,0,29,29,55
30,r_85_0_81,r_130_149_177,r_83_146_70,r_85_0_81,1.0,1,82,81,55
44,r_130_149_177,r_101_74_52,r_129_143_114,r_130_149_177,0.76,-2,175,177,55
51,seq2,r_135_8_171,r_56_70_96,r_56_70_96,0.79,58,154,96,55
28,r_108_49_131,r_9_51_79,r_37_80_29,r_108_49_131,0.98,0,131,131,55
19,r_66_76_12,r_107_109_77,r_48_18_106,r_66_76_12,0.5,4,16,12,55
37,r_133_32_90,r_108_49_131,r_85_0_81,r_85_0_81,0.65,10,91,81,55
19,r_66_76_12,r_48_18_106,r_61_97_54,r_66_76_12,1.0,76,88,12,55
21,r_147_94_78,seq141,seq17,r_147_94_78,1.0,-2,76,78,55
39,r_1_139_75,r_68_62_127,r_83_146_70,r_1_139_75,0.98,-1,74,75,55
1,r_59_124_98,seq122,seq5,r_59_124_98,0.98,5,103,98,55
45,r_77_118_92,seq84,seq110,r_77_118_92,0.99,0,92,92,55
46,r_116_75_20,r_107_109_77,seq39,r_116_75_20,1.0,0,20,20,55
31,r_21_16_110,seq17,r_56_70_96,r_56_70_96,0.55,16,112,96,55
41,r_132_71_140,r_129_143_114,r_37_80_29,r_132_71_140,0.81,-49,91,140,55
3,r_68_62_127,seq144,r_116_75_20,r_68_62_127,0.99,0,127,127,55
10,r_83_146_70,r_105_112_74,seq14,r_83_146_70,0.51,0,70,70,55
26,r_88_100_72,r_114_87_69,seq144,r_88_100_72,0.61,-4,68,72,55
41,r_132_71_140,r_37_80_29,r_129_143_114,r_132_71_140,0.71,0,140,140,55
14,r_37_80_29,r_10_111_108,r_108_49_131,r_37_80_29,0.95,88,117,29,55
0,r_107_109_77,seq58,seq40,r_107_109_77,0.96,0,77,77,55
11,r_9_51_79,r_147_94_78,r_26_123_63,r_9_51_79,0.94,-1,78,79,55
20,r_56_70_96,seq126,seq34,r_56_70_96,1.0,0,96,96,55
13,r_105_112_74,r_21_16_110,seq15,r_105_112_74,1.0,0,74,74,55
42,r_101_74_52,r_59_124_98,seq58,r_101_74_52,0.98,-3,49,52,55
15,r_52_13_123,r_91_72_142,r_121_117_40,r_91_72_142,0.47,-18,124,142,55
12,r_26_123_63,r_108_49_131,r_9_51_79,r_108_49_131,0.98,0,131,131,55
82,seq142,seq134,r_121_117_40,r_121_117_40,1.0,1,41,40,55
47,r_41_38_64,seq84,r_78_136_194,r_41_38_64,0.73,1,65,64,55
18,r_129_143_114,r_132_71_140,r_147_94_78,r_147_94_78,1.0,35,113,78,55
24,r_12_53_24,seq131,r_29_7_18,r_12_53_24,0.93,5,29,24,55
33,r_22_31_93,r_108_49_131,seq19,r_22_31_93,0.95,1,94,93,55
32,r_69_73_115,seq126,seq138,r_69_73_115,0.91,1,116,115,55
25,r_140_145_195,r_105_112_74,r_29_7_18,r_140_145_195,0.95,-173,22,195,55
22,r_29_7_18,r_107_109_77,r_140_145_195,r_29_7_18,0.98,0,18,18,55
8,r_121_117_40,r_54_6_83,seq142,r_121_117_40,1.0,0,40,40,55
9,r_60_90_102,seq125,seq39,r_60_90_102,0.98,2,104,102,55
96,seq122,r_59_124_98,r_65_63_44,r_59_124_98,1.0,-25,73,98,55
27,r_61_97_54,r_1_139_75,r_66_76_12,r_61_97_54,1.0,-1,53,54,55
28,r_108_49_131,r_133_32_90,r_9_51_79,r_9_51_79,0.99,0,79,79,55
49,r_93_113_66,seq142,seq84,r_93_113_66,1.0,0,66,66,55
7,r_48_18_106,r_67_102_1,r_41_38_64,r_48_18_106,1.0,0,106,106,55
44,r_130_149_177,r_85_0_81,r_101_74_52,r_130_149_177,0.97,-103,74,177,55
35,r_114_87_69,r_52_13_123,r_67_102_1,r_114_87_69,1.0,0,69,69,55
12,r_26_123_63,seq142,r_108_49_131,r_26_123_63,0.98,0,63,63,55
36,r_98_50_178,seq27,seq109,r_98_50_178,0.66,0,178,178,56
14,r_15_54_72,r_105_67_142,r_135_143_6,r_15_54_72,0.71,0,72,72,56
8,r_59_107_84,seq4,r_119_87_52,r_119_87_52,0.96,34,86,52,56
43,r_42_77_131,r_19_86_121,seq82,r_42_77_131,0.82,0,131,131,56
3,r_106_101_35,r_19_86_121,r_16_131_199,r_106_101_35,1.0,0,35,35,56
86,seq82,r_97_30_152,r_42_77_131,r_42_77_131,0.72,22,153,131,56
21,r_97_30_152,seq82,r_26_126_75,r_26_126_75,0.85,78,153,75,56
1,r_142_130_139,seq39,seq55,r_142_130_139,0.83,0,139,139,56
5,r_26_126_75,seq78,r_100_73_63,r_26_126_75,1.0,1,76,75,56
42,r_133_118_190,r_19_86_121,r_74_64_15,r_133_118_190,0.65,-69,121,190,56
45,r_7_63_58,seq24,seq102,r_7_63_58,1.0,2,60,58,56
28,r_123_44_44,r_19_86_121,r_65_104_13,r_65_104_13,0.95,31,44,13,56
31,r_62_46_10,r_100_73_63,r_106_101_35,r_62_46_10,0.92,53,63,10,56
41,r_138_75_153,r_93_40_157,r_26_126_75,r_26_126_75,0.98,79,154,75,56
10,r_105_67_142,r_88_23_179,r_90_34_70,r_88_23_179,0.91,-22,157,179,56
4,r_103_22_76,seq113,r_139_45_48,r_103_22_76,0.99,0,76,76,56
0,r_71_5_125,seq146,seq1,r_71_5_125,0.98,0,125,125,56
11,r_115_41_150,r_88_23_179,seq24,r_115_41_150,0.88,0,150,150,56
20,r_47_38_105,seq36,r_65_104_13,r_47_38_105,0.91,0,105,105,56
13,r_100_73_63,r_62_46_10,r_74_64_15,r_100_73_63,0.98,0,63,63,56
15,r_134_89_100,seq79,r_122_127_83,r_134_89_100,0.66,3,103,100,56
13,r_100_73_63,r_74_64_15,r_97_30_152,r_97_30_152,0.88,1,153,152,56
85,seq81,r_124_111_168,r_103_22_76,r_103_22_76,1.0,62,138,76,56
27,r_49_3_127,seq33,r_96_0_65,r_49_3_127,0.81,0,127,127,56
47,r_93_40_157,seq149,r_142_130_139,r_142_130_139,0.93,18,157,139,56
29,r_14_21_146,seq146,r_7_63_58,r_14_21_146,0.73,0,146,146,56
24,r_122_127_83,r_48_125_18,seq37,r_122_127_83,0.54,24,107,83,56
25,r_17_6_138,r_16_131_199,r_148_2_112,r_16_131_199,0.79,-61,138,199,56
33,r_145_51_126,seq60,r_49_3_127,r_145_51_126,0.74,2,128,126,56
32,r_19_86_121,r_42_77_131,r_128_61_37,r_19_86_121,0.62,0,121,121,56
38,r_70_52_79,r_88_23_179,r_106_101_35,r_70_52_79,0.94,0,79,79,56
34,r_148_2_112,seq102,seq149,r_148_2_112,1.0,0,112,112,56
44,r_119_87_52,seq56,seq117,r_119_87_52,0.96,0,52,52,56
39,r_65_104_13,r_88_23_179,seq33,r_65_104_13,0.7,0,13,13,56
17,r_124_111_168,seq81,r_59_107_84,r_59_107_84,0.58,85,169,84,56
94,seq112,r_141_8_169,seq147,r_141_8_169,1.0,0,169,169,56
2,r_128_61_37,seq137,seq129,r_128_61_37,0.65,0,37,37,56
9,r_141_8_169,seq112,seq56,r_141_8_169,0.44,1,170,169,56
7,r_88_23_179,r_91_121_193,r_96_0_65,r_96_0_65,0.71,114,179,65,56
79,seq69,r_136_28_148,seq149,r_136_28_148,0.67,3,151,148,56
35,r_10_31_108,seq99,r_103_22_76,r_103_22_76,0.99,32,108,76,56
12,r_136_28_148,seq69,r_128_61_37,r_128_61_37,0.78,114,151,37,56
30,r_61_66_120,seq35,r_17_140_2,r_61_66_120,0.98,1,121,120,57
36,r_69_87_143,r_38_117_142,seq52,r_69_87_143,0.83,0,143,143,57
92,seq102,r_98_79_158,r_145_25_75,r_145_25_75,0.93,-2,73,75,57
8,r_100_136_88,seq14,seq35,r_100_136_88,0.98,0,88,88,57
43,r_23_147_82,seq84,seq104,r_23_147_82,1.0,1,83,82,57
37,r_51_45_60,seq60,r_70_130_26,r_51_45_60,1.0,0,60,60,57
71,seq41,r_55_121_188,r_138_131_25,r_138_131_25,1.0,48,73,25,57
21,r_65_112_108,r_22_118_170,seq62,r_65_112_108,0.96,2,110,108,57
39,r_22_118_170,r_65_112_108,seq4,r_65_112_108,0.97,2,110,108,57
1,r_144_132_93,r_75_143_124,seq92,r_144_132_93,0.99,0,93,93,57
97,seq148,r_80_111_150,r_58_54_101,r_58_54_101,0.97,53,154,101,57
5,r_133_110_185,seq137,r_68_73_11,r_133_110_185,0.44,-51,134,185,57
5,r_133_110_185,r_68_73_11,r_122_34_163,r_133_110_185,0.99,0,185,185,57
19,r_95_126_164,seq19,r_68_73_11,r_95_126_164,0.65,0,164,164,57
0,r_82_105_23,r_113_129_99,r_74_63_137,r_82_105_23,0.74,1,24,23,57
39,r_22_118_170,seq4,r_42_26_87,r_22_118_170,0.99,3,173,170,57
25,r_2_123_151,r_82_105_23,r_68_73_11,r_2_123_151,0.59,-137,14,151,57
16,r_114_6_32,seq60,seq7,r_114_6_32,0.84,-3,29,32,57
41,r_42_26_87,r_95_126_164,r_58_54_101,r_58_54_101,0.74,23,124,101,57
45,r_138_131_25,r_94_141_127,seq41,r_138_131_25,1.0,1,26,25,57
10,r_75_143_124,seq33,r_72_135_109,r_75_143_124,0.99,1,125,124,57
17,r_108_85_117,r_22_118_170,r_74_63_137,r_22_118_170,1.0,3,173,170,57
26,r_77_64_171,r_17_140_2,seq4,r_17_140_2,0.36,169,171,2,57
48,r_38_117_142,r_103_36_111,r_42_26_87,r_38_117_142,0.4,-24,118,142,57
4,r_68_73_11,r_2_123_151,r_18_16_104,r_18_16_104,1.0,3,107,104,57
57,seq14,r_100_136_88,seq146,r_100_136_88,1.0,0,88,88,57
65,seq30,r_82_105_23,r_109_44_8,r_82_105_23,0.58,-13,10,23,57
27,r_18_16_104,seq14,r_68_73_11,r_18_16_104,0.98,1,105,104,57
87,seq90,seq35,r_103_36_111,r_103_36_111,0.89,11,122,111,57
18,r_124_49_69,r_106_59_144,seq146,r_124_49_69,0.99,2,71,69,57
29,r_99_142_65,r_108_85_117,r_86_43_14,r_108_85_117,1.0,-18,99,117,57
24,r_80_111_150,seq148,r_103_36_111,r_80_111_150,0.63,2,152,150,57
33,r_103_36_111,r_38_117_142,seq90,r_103_36_111,0.49,12,123,111,57
47,r_70_130_26,seq0,r_51_45_60,r_51_45_60,1.0,62,122,60,57
32,r_58_54_101,r_98_79_158,r_42_26_87,r_58_54_101,0.99,0,101,101,57
47,r_70_130_26,r_98_79_158,seq0,r_70_130_26,0.93,1,27,26,57
46,r_13_149_9,seq0,seq92,r_13_149_9,0.75,1,10,9,57
4,r_68_73_11,r_134_8_191,r_2_123_151,r_68_73_11,0.92,0,11,11,57
75,seq52,seq20,r_37_29_43,r_37_29_43,0.73,34,77,43,57
48,r_38_117_142,r_42_26_87,r_100_136_88,r_38_117_142,0.89,0,142,142,57
17,r_108_85_117,seq21,r_22_118_170,r_108_85_117,0.94,0,117,117,57
22,r_46_1_134,r_95_126_164,seq9,r_46_1_134,0.91,0,134,134,57
28,r_74_63_137,seq33,r_108_85_117,r_108_85_117,0.96,17,134,117,57
49,r_55_121_188,r_86_43_14,r_94_141_127,r_94_141_127,0.78,61,188,127,57
44,r_40_81_121,seq9,r_68_73_11,r_40_81_121,1.0,0,121,121,57
23,r_72_135_109,seq96,r_75_143_124,r_75_143_124,1.0,5,129,124,57
35,r_94_141_127,seq4,r_107_93_182,r_94_141_127,0.87,0,127,127,57
12,r_97_53_63,r_77_64_171,seq20,r_97_53_63,0.94,0,63,63,57
44,r_112_11_53,r_12_139_139,r_78_65_29,r_112_11_53,0.53,86,139,53,58
51,seq5,r_59_86_102,r_101_118_190,r_59_86_102,0.93,1,103,102,58
36,r_132_3_125,r_34_113_187,seq106,r_132_3_125,0.62,4,129,125,58
25,r_31_15_19,r_41_4_101,seq32,r_31_15_19,0.94,-1,18,19,58
28,r_147_131_195,r_38_55_13,r_145_146_158,r_38_55_13,0.56,3,16,13,58
14,r_145_146_158,seq19,r_128_20_4,r_145_146_158,0.28,0,158,158,58
43,r_72_79_70,r_112_11_53,r_121_107_25,r_72_79_70,0.66,-3,67,70,58
71,seq46,r_1_119_94,r_91_25_24,r_1_119_94,0.65,-19,75,94,58
39,r_49_136_77,r_28_148_155,r_149_127_120,r_28_148_155,0.79,-32,123,155,58
1,r_75_99_152,r_0_73_146,r_48_29_11,r_75_99_152,0.47,1,153,152,58
97,seq110,r_28_148_155,r_38_55_13,r_28_148_155,0.51,2,157,155,58
46,r_0_73_146,r_75_99_152,seq137,r_75_99_152,0.53,-6,146,152,58
42,r_28_148_155,seq110,r_1_119_94,r_1_119_94,0.7,63,157,94,58
11,r_66_122_23,r_12_139_139,r_34_113_187,r_66_122_23,0.78,-1,22,23,58
2,r_42_105_57,r_141_43_157,seq95,r_42_105_57,0.97,0,57,57,58
95,seq106,r_128_20_4,r_132_3_125,r_132_3_125,0.79,4,129,125,58
38,r_48_29_11,seq80,r_75_99_152,r_75_99_152,0.76,0,152,152,58
41,r_10_61_107,r_0_73_146,r_71_124_91,r_0_73_146,0.94,-38,108,146,58
3,r_54_81_135,r_111_100_184,seq5,r_54_81_135,0.8,3,138,135,58
10,r_149_127_120,r_98_27_97,seq106,r_98_27_97,0.66,-24,73,97,58
72,seq47,r_85_70_79,r_135_50_41,r_85_70_79,0.82,-1,78,79,58
40,r_6_94_15,r_59_86_102,seq140,r_6_94_15,1.0,2,17,15,58
4,r_1_119_94,seq46,seq13,r_1_119_94,0.79,2,96,94,58
0,r_98_27_97,r_149_127_120,r_17_39_69,r_149_127_120,0.59,-18,102,120,58
6,r_38_55_13,r_147_131_195,seq64,r_38_55_13,0.85,1,14,13,58
20,r_88_97_95,seq19,seq52,r_88_97_95,0.98,6,101,95,58
5,r_12_139_139,r_66_122_23,r_112_11_53,r_66_122_23,0.82,24,47,23,58
48,r_17_39_69,r_34_113_187,r_31_15_19,r_17_39_69,1.0,0,69,69,58
4,r_1_119_94,seq13,r_28_148_155,r_28_148_155,0.99,10,165,155,58
5,r_12_139_139,r_112_11_53,r_132_3_125,r_12_139_139,0.57,0,139,139,58
27,r_85_70_79,seq47,seq58,r_85_70_79,0.99,-1,78,79,58
38,r_48_29_11,r_145_146_158,seq80,r_48_29_11,0.9,0,11,11,58
33,r_114_60_183,seq30,r_76_117_37,r_76_117_37,0.7,149,186,37,58
37,r_78_65_29,r_128_20_4,seq58,r_78_65_29,0.68,9,38,29,58
50,seq129,r_108_37_31,r_49_136_77,r_108_37_31,0.82,84,115,31,58
7,r_71_124_91,r_141_43_157,r_10_61_107,r_141_43_157,0.89,-8,149,157,58
21,r_91_25_24,seq64,seq46,r_91_25_24,0.99,0,24,24,58
32,r_41_4_101,seq68,r_128_20_4,r_41_4_101,0.89,2,103,101,58
10,r_149_127_120,seq106,r_49_136_77,r_149_127_120,0.71,3,123,120,58
77,seq57,r_128_20_4,r_38_55_13,r_38_55_13,0.72,75,88,13,58
34,r_59_86_102,seq5,seq110,r_59_86_102,0.7,0,102,102,58
81,seq64,r_128_20_4,r_38_55_13,r_38_55_13,0.88,75,88,13,58
17,r_103_24_81,r_149_127_120,seq95,r_103_24_81,0.94,1,82,81,58
94,seq104,r_2_125_176,seq45,r_2_125_176,0.45,-9,167,176,58
9,r_34_113_187,r_132_3_125,r_66_122_23,r_34_113_187,0.77,-58,129,187,58
96,seq109,r_0_73_146,r_98_27_97,r_98_27_97,0.86,53,150,97,58
18,r_116_138_168,r_88_97_95,r_142_9_5,r_116_138_168,0.47,-158,10,168,58
28,r_147_131_195,r_145_146_158,seq133,r_147_131_195,0.42,-52,143,195,58
22,r_141_43_157,r_28_148_155,r_35_92_2,r_28_148_155,0.52,4,159,155,58
7,r_71_124_91,seq133,r_141_43_157,r_71_124_91,0.7,0,91,91,58
18,r_116_138_168,r_142_9_5,r_1_119_94,r_1_119_94,1.0,32,126,94,58
44,r_112_11_53,r_72_79_70,r_12_139_139,r_72_79_70,0.72,-7,63,70,58
84,seq69,r_145_146_158,r_1_119_94,r_1_119_94,0.98,48,142,94,58
30,r_90_29_149,seq72,r_145_125_107,r_145_125_107,1.0,42,149,107,59
36,r_112_9_67,seq14,seq38,r_112_9_67,1.0,1,68,67,59
5,r_52_92_56,seq12,r_145_125_107,r_52_92_56,0.97,0,56,56,59
14,r_85_22_115,r_21_134_137,seq49,r_85_22_115,0.97,1,116,115,59
39,r_91_141_109,seq113,r_69_80_59,r_91_141_109,0.99,0,109,109,59
1,r_145_125_107,r_130_36_196,seq26,r_145_125_107,0.87,2,109,107,59
42,r_133_97_123,r_40_74_189,seq6,r_133_97_123,0.99,0,123,123,59
8,r_84_115_24,r_120_1_150,seq51,r_84_115_24,1.0,0,24,24,59
5,r_52_92_56,r_145_125_107,r_88_68_77,r_52_92_56,0.77,24,80,56,59
19,r_104_25_157,r_3_127_169,r_55_17_125,r_55_17_125,0.66,32,157,125,59
40,r_69_80_59,r_126_76_8,seq30,r_69_80_59,1.0,-3,56,59,59
76,seq49,r_3_127_169,r_85_22_115,r_85_22_115,0.99,54,169,115,59
0,r_124_79_33,r_28_116_64,seq14,r_124_79_33,1.0,0,33,33,59
31,r_10_117_138,seq58,r_24_65_41,r_10_117_138,0.51,1,139,138,59
41,r_20_62_105,r_66_11_161,seq7,r_20_62_105,0.87,0,105,105,59
3,r_109_53_83,seq75,seq128,r_109_53_83,0.97,0,83,83,59
10,r_95_123_93,seq58,r_60_129_52,r_95_123_93,0.97,0,93,93,59
90,seq86,r_40_74_189,r_114_121_20,r_114_121_20,0.75,111,131,20,59
26,r_101_118_73,r_67_140_190,seq147,r_101_118_73,0.67,-5,68,73,59
37,r_135_73_19,seq128,r_111_89_198,r_135_73_19,0.99,0,19,19,59
4,r_28_116_64,seq113,seq48,r_28_116_64,0.95,0,64,64,59
20,r_37_2_82,r_109_53_83,seq58,r_37_2_82,0.99,0,82,82,59
13,r_94_16_143,r_71_31_68,r_23_46_11,r_71_31_68,1.0,0,68,68,59
15,r_55_17_125,seq146,seq12,r_55_17_125,0.84,7,132,125,59
48,r_82_122_98,r_120_1_150,r_114_121_20,r_82_122_98,0.62,2,100,98,59
13,r_94_16_143,r_23_46_11,seq139,r_94_16_143,0.86,6,149,143,59
6,r_40_74_189,r_133_97_123,r_114_121_20,r_133_97_123,0.74,0,123,123,59
27,r_131_18_30,r_40_74_189,seq51,r_131_18_30,1.0,0,30,30,59
2,r_78_35_91,seq99,r_101_118_73,r_78_35_91,0.79,0,91,91,59
47,r_111_89_198,seq75,r_135_73_19,r_135_73_19,0.99,50,69,19,59
18,r_54_100_180,seq30,seq4,r_54_100_180,0.5,0,180,180,59
29,r_88_68_77,seq7,r_52_92_56,r_88_68_77,0.43,4,81,77,59
24,r_71_31_68,r_94_16_143,r_28_116_64,r_71_31_68,1.0,0,68,68,59
25,r_149_43_121,seq128,seq98,r_149_43_121,0.85,1,122,121,59
33,r_19_64_120,r_130_36_196,seq128,r_19_64_120,0.8,2,122,120,59
70,seq38,seq113,r_112_9_67,r_112_9_67,1.0,20,87,67,59
6,r_40_74_189,r_114_121_20,r_52_92_56,r_114_121_20,0.55,170,190,20,59
61,seq146,r_55_17_125,seq137,r_55_17_125,0.89,-9,116,125,59
38,r_47_105_188,seq147,r_55_17_125,r_55_17_125,0.55,63,188,125,59
34,r_3_127_169,seq49,r_10_117_138,r_3_127_169,0.82,0,169,169,59
32,r_23_46_11,r_67_140_190,r_114_121_20,r_23_46_11,0.79,8,19,11,59
75,seq48,seq12,r_28_116_64,r_28_116_64,0.99,20,84,64,59
94,seq99,r_78_35_91,r_90_29_149,r_78_35_91,0.93,0,91,91,59
9,r_120_1_150,seq30,seq75,r_120_1_150,0.82,0,150,150,59
22,r_21_134_137,seq70,r_37_2_82,r_21_134_137,0.67,0,137,137,59
28,r_0_77_87,seq113,r_69_80_59,r_0_77_87,1.0,0,87,87,59
46,r_24_65_41,seq50,seq70,r_24_65_41,1.0,0,41,41,59
44,r_13_8_140,seq38,r_10_117_138,r_13_8_140,0.68,0,140,140,59
11,r_60_129_52,seq26,r_107_83_1,r_60_129_52,1.0,0,52,52,59
45,r_114_121_20,r_52_92_56,r_23_46_11,r_114_121_20,0.93,0,20,20,59
23,r_39_93_126,r_66_11_161,seq38,r_66_11_161,0.79,-35,126,161,59
35,r_144_15_108,r_21_134_137,r_23_46_11,r_144_15_108,1.0,0,108,108,59
12,r_102_108_89,r_120_1_150,seq98,r_102_108_89,0.97,0,89,89,59
84,seq63,r_28_116_64,r_60_129_52,r_60_129_52,0.98,108,160,52,59
30,r_29_20_178,r_75_89_169,r_105_128_124,r_29_20_178,0.52,0,178,178,60
38,r_50_15_34,r_102_148_52,seq3,r_50_15_34,1.0,0,34,34,60
2,r_42_86_165,r_123_140_103,r_116_28_8,r_42_86_165,0.97,0,165,165,60
36,r_108_16_96,seq104,r_91_124_66,r_108_16_96,0.97,2,98,96,60
8,r_36_99_81,seq117,r_84_135_59,r_36_99_81,0.97,0,81,81,60
43,r_2_95_187,seq37,r_44_85_60,r_2_95_187,0.42,0,187,187,60
37,r_26_146_175,seq66,r_133_80_3,r_26_146_175,0.5,0,175,175,60
59,seq18,r_144_113_184,r_84_135_59,r_84_135_59,0.98,7,66,59,60
31,r_57_132_43,seq68,seq37,r_57_132_43,1.0,0,43,43,60
71,seq53,r_43_130_112,r_44_85_60,r_44_85_60,1.0,17,77,60,60
16,r_123_140_103,r_81_110_180,r_102_148_52,r_123_140_103,0.95,0,103,103,60
21,r_0_22_100,seq106,seq25,r_0_22_100,0.96,1,101,100,60
39,r_81_110_180,seq4,r_0_22_100,r_81_110_180,0.32,1,181,180,60
24,r_111_100_26,r_42_86_165,r_5_48_142,r_111_100_26,1.0,2,28,26,60
5,r_44_85_60,r_35_1_1,seq53,r_44_85_60,1.0,0,60,60,60
46,r_51_134_85,seq64,seq52,r_51_134_85,1.0,0,85,85,60
42,r_73_10_70,r_118_93_193,r_141_74_116,r_73_10_70,0.99,2,72,70,60
80,seq72,r_144_113_184,r_65_45_31,r_65_45_31,0.86,35,66,31,60
34,r_142_96_15,r_123_140_103,seq24,r_142_96_15,0.84,0,15,15,60
28,r_115_46_84,r_35_1_1,r_40_11_123,r_40_11_123,1.0,7,130,123,60
78,seq68,r_57_132_43,seq106,r_57_132_43,0.99,0,43,43,60
41,r_87_71_22,r_141_74_116,r_75_89_169,r_87_71_22,1.0,0,22,22,60
67,seq37,r_2_95_187,r_67_58_168,r_2_95_187,0.5,-1,186,187,60
10,r_8_17_155,seq109,seq106,r_8_17_155,0.6,2,157,155,60
26,r_35_1_1,r_125_94_181,r_115_46_84,r_115_46_84,0.97,1,85,84,60
26,r_35_1_1,r_44_85_60,r_125_94_181,r_35_1_1,0.42,68,69,1,60
4,r_141_74_116,r_43_130_112,seq66,r_43_130_112,0.81,-33,79,112,60
11,r_56_63_95,seq66,r_75_89_169,r_56_63_95,1.0,0,95,95,60
17,r_82_19_39,r_98_34_94,seq78,r_82_19_39,0.78,2,41,39,60
13,r_105_128_124,r_42_86_165,seq64,r_105_128_124,0.98,0,124,124,60
6,r_137_6_71,seq101,seq3,r_137_6_71,1.0,0,71,71,60
27,r_69_92_56,r_102_148_52,seq117,r_69_92_56,1.0,0,56,56,60
1,r_138_131_49,r_91_124_66,r_116_28_8,r_116_28_8,0.83,43,51,8,60
2,r_42_86_165,r_105_128_124,r_123_140_103,r_42_86_165,0.88,-41,124,165,60
40,r_75_89_169,r_29_20_178,r_56_63_95,r_56_63_95,0.98,83,178,95,60
74,seq60,seq70,r_69_92_56,r_69_92_56,1.0,64,120,56,60
18,r_5_48_142,r_2_95_187,r_91_124_66,r_91_124_66,1.0,0,66,66,60
29,r_91_124_66,seq24,r_5_48_142,r_91_124_66,1.0,0,66,66,60
33,r_103_41_166,seq32,r_133_80_3,r_103_41_166,0.77,1,167,166,60
70,seq52,r_42_86_165,r_51_134_85,r_51_134_85,0.92,4,89,85,60
52,seq4,r_67_58_168,seq7,r_67_58_168,1.0,0,168,168,60
47,r_136_27_13,r_42_86_165,seq109,r_136_27_13,0.93,0,13,13,60
9,r_98_34_94,seq21,seq90,r_98_34_94,0.99,1,95,94,60
25,r_102_148_52,r_69_92_56,seq52,r_69_92_56,1.0,-4,52,56,60
28,r_115_46_84,seq14,r_35_1_1,r_115_46_84,0.61,1,85,84,60
49,r_40_11_123,seq97,r_115_46_84,r_40_11_123,0.85,5,128,123,60
45,r_84_135_59,r_33_47_127,r_65_45_31,r_84_135_59,0.95,0,59,59,60
23,r_43_130_112,seq53,r_0_22_100,r_0_22_100,0.79,13,113,100,60
35,r_33_47_127,r_67_58_168,r_91_124_66,r_33_47_127,0.91,1,128,127,60
12,r_61_147_68,seq12,seq101,r_61_147_68,1.0,1,69,68,60
21,r_25_78_48,r_57_116_171,seq18,r_25_78_48,0.86,0,48,48,61
17,r_67_111_29,seq19,seq138,r_67_111_29,0.98,0,29,29,61
38,r_43_63_53,seq110,seq4,r_43_63_53,0.89,0,53,53,61
14,r_72_92_168,seq137,r_106_108_51,r_72_92_168,0.44,0,168,168,61
8,r_44_7_121,seq71,r_75_2_127,r_44_7_121,0.98,2,123,121,61
53,seq4,r_46_105_159,r_36_9_120,r_36_9_120,0.81,24,144,120,61
43,r_141_56_123,r_149_144_187,r_100_55_94,r_141_56_123,0.68,1,124,123,61
24,r_62_140_16,r_46_105_159,r_14_39_128,r_62_140_16,1.0,0,16,16,61
39,r_139_96_62,seq136,seq18,r_139_96_62,1.0,0,62,62,61
5,r_36_9_120,r_74_126_197,r_57_116_171,r_36_9_120,1.0,0,120,120,61
42,r_100_55_94,r_103_65_188,seq15,r_100_55_94,0.97,0,94,94,61
80,seq60,r_35_91_115,r_134_29_75,r_35_91_115,0.73,-47,68,115,61
45,r_112_26_144,seq125,r_25_78_48,r_25_78_48,1.0,97,145,48,61
19,r_147_107_112,r_36_9_120,r_43_63_53,r_147_107_112,0.7,0,112,112,61
66,seq23,r_45_33_178,r_133_86_4,r_133_86_4,0.45,171,175,4,61
41,r_40_58_68,seq1,r_43_63_53,r_40_58_68,0.94,0,68,68,61
3,r_5_85_142,seq37,r_81_146_10,r_5_85_142,0.32,3,145,142,61
11,r_20_10_33,r_112_26_144,seq136,r_20_10_33,1.0,1,34,33,61
26,r_45_33_178,r_6_128_6,r_49_82_46,r_49_82_46,1.0,133,179,46,61
4,r_113_123_108,r_45_33_178,seq110,r_45_33_178,0.54,-50,128,178,61
0,r_149_144_187,seq53,r_147_107_112,r_147_107_112,0.74,76,188,112,61
2,r_102_121_55,r_149_144_187,seq137,r_102_121_55,1.0,1,56,55,61
57,seq138,r_103_65_188,r_67_111_29,r_67_111_29,0.99,19,48,29,61
48,r_75_2_127,seq98,r_44_7_121,r_44_7_121,1.0,31,152,121,61
10,r_131_120_37,r_72_92_168,seq31,r_131_120_37,0.99,2,39,37,61
22,r_81_146_10,r_94_64_183,r_77_119_21,r_77_119_21,0.56,1,22,21,61
12,r_50_118_26,r_141_56_123,r_51_41_154,r_50_118_26,1.0,0,26,26,61
46,r_49_82_46,r_44_7_121,seq37,r_49_82_46,0.53,2,48,46,61
49,r_51_41_154,seq31,r_50_118_26,r_50_118_26,1.0,0,26,26,61
33,r_35_91_115,seq60,r_106_108_51,r_35_91_115,0.9,1,116,115,61
15,r_124_90_38,r_40_58_68,seq22,r_40_58_68,0.75,-30,38,68,61
70,seq34,r_148_89_153,seq60,r_148_89_153,0.94,-17,136,153,61
22,r_81_146_10,r_77_119_21,r_143_48_76,r_143_48_76,1.0,0,76,76,61
32,r_142_130_114,seq122,r_32_99_69,r_142_130_114,0.58,0,114,114,61
34,r_134_29_75,r_149_144_187,seq60,r_134_29_75,0.8,8,83,75,61
25,r_77_119_21,r_20_10_33,r_81_146_10,r_77_119_21,0.99,0,21,21,61
9,r_32_99_69,seq95,seq83,r_32_99_69,1.0,0,69,69,61
30,r_106_108_51,seq114,seq71,r_106_108_51,1.0,3,54,51,61
7,r_93_28_132,seq117,seq129,r_93_28_132,0.99,1,133,132,61
44,r_6_128_6,r_45_33_178,r_5_85_142,r_6_128_6,0.28,173,179,6,61
23,r_143_48_76,r_149_144_187,r_81_146_10,r_143_48_76,1.0,0,76,76,61
38,r_43_63_53,seq4,r_40_58_68,r_40_58_68,0.96,2,70,68,61
13,r_59_27_58,seq22,seq24,r_59_27_58,1.0,1,59,58,61
44,r_130_71_36,r_3_83_164,r_42_64_120,r_42_64_120,0.82,6,126,120,62
8,r_103_32_110,seq89,seq132,r_103_32_110,0.54,1,111,110,62
53,seq4,r_24_135_71,seq36,r_24_135_71,0.96,7,78,71,62
43,r_23_26_72,seq17,r_143_8_19,r_23_26_72,0.93,0,72,72,62
19,r_97_5_16,r_92_35_46,seq106,r_97_5_16,1.0,0,16,16,62
42,r_77_88_52,r_92_35_46,seq44,r_77_88_52,1.0,0,52,52,62
16,r_3_83_164,r_136_0_83,r_130_71_36,r_130_71_36,0.86,43,79,36,62
39,r_24_135_71,seq4,seq106,r_24_135_71,0.98,7,78,71,62
1,r_93_41_106,r_66_98_143,r_137_29_3,r_93_41_106,1.0,1,107,106,62
5,r_50_145_122,r_72_74_168,seq146,r_72_74_168,0.74,-34,134,168,62
46,r_33_10_156,seq55,r_22_45_41,r_33_10_156,0.75,1,157,156,62
31,r_59_119_55,r_118_149_182,r_6_7_29,r_59_119_55,1.0,1,56,55,62
45,r_131_113_132,seq62,seq1,r_131_113_132,0.7,0,132,132,62
83,seq76,r_129_38_33,seq20,r_129_38_33,0.7,-17,16,33,62
95,seq115,r_18_11_155,r_110_117_49,r_110_117_49,0.99,14,63,49,62
18,r_92_35_46,r_77_88_52,r_144_95_154,r_77_88_52,0.95,-9,43,52,62
41,r_66_98_143,r_143_8_19,seq9,r_66_98_143,0.7,0,143,143,62
49,r_129_38_33,seq76,seq36,r_129_38_33,0.88,0,33,33,62
3,r_111_86_191,seq138,r_68_148_107,r_111_86_191,0.58,-81,110,191,62
36,r_34_27_17,r_42_64_120,seq37,r_42_64_120,0.58,-104,16,120,62
16,r_3_83_164,r_130_71_36,seq4,r_3_83_164,0.84,2,166,164,62
4,r_79_61_162,seq141,seq123,r_79_61_162,0.64,0,162,162,62
78,seq62,r_131_113_132,seq36,r_131_113_132,1.0,0,132,132,62
34,r_6_7_29,seq126,seq128,r_6_7_29,0.99,1,30,29,62
20,r_120_73_113,seq128,seq142,r_120_73_113,0.9,2,115,113,62
15,r_70_51_109,r_72_74_168,seq16,r_70_51_109,1.0,0,109,109,62
48,r_143_8_19,r_66_98_143,r_23_26_72,r_23_26_72,0.63,71,143,72,62
26,r_94_96_32,r_3_83_164,r_144_95_154,r_94_96_32,0.84,-2,30,32,62
10,r_81_102_54,seq138,seq17,r_81_102_54,1.0,0,54,54,62
14,r_22_45_41,r_23_26_72,r_97_5_16,r_97_5_16,1.0,26,42,16,62
87,seq142,r_99_104_180,r_120_73_113,r_120_73_113,0.52,-2,111,113,62
2,r_72_74_168,r_118_149_182,seq89,r_72_74_168,0.34,0,168,168,62
47,r_114_82_115,seq47,r_129_38_33,r_114_82_115,0.62,0,115,115,62
40,r_30_147_104,seq89,r_110_117_49,r_110_117_49,0.55,57,106,49,62
29,r_101_133_94,r_63_90_8,seq54,r_101_133_94,0.89,3,97,94,62
24,r_91_52_140,r_72_74_168,seq14,r_91_52_140,0.68,1,141,140,62
25,r_68_148_107,seq106,r_111_86_191,r_68_148_107,0.58,-2,105,107,62
13,r_110_117_49,seq140,seq100,r_110_117_49,0.98,1,50,49,62
58,seq141,r_79_61_162,r_23_26_72,r_23_26_72,0.96,90,162,72,62
44,r_130_71_36,r_6_7_29,r_3_83_164,r_130_71_36,0.99,0,36,36,62
61,seq16,seq53,r_70_51_109,r_70_51_109,1.0,1,110,109,62
32,r_21_57_129,seq20,seq140,r_21_57_129,0.97,0,129,129,62
38,r_2_139_114,seq54,seq19,r_2_139_114,0.92,0,114,114,62
89,seq100,r_18_11_155,r_110_117_49,r_110_117_49,0.99,4,53,49,62
9,r_136_0_83,r_3_83_164,seq146,r_136_0_83,0.89,1,84,83,62
28,r_48_13_97,seq80,seq78,r_48_13_97,0.91,0,97,97,62
7,r_125_49_125,seq37,seq36,r_125_49_125,0.77,0,125,125,62
23,r_42_64_120,seq14,r_130_71_36,r_42_64_120,0.86,0,120,120,62
84,seq78,r_99_104_180,r_48_13_97,r_48_13_97,0.91,0,97,97,62
20,r_149_88_37,r_90_51_174,seq78,r_149_88_37,1.0,0,37,37,63
17,r_40_100_29,r_114_82_195,r_53_98_28,r_40_100_29,1.0,0,29,29,63
81,seq78,r_28_80_138,r_149_88_37,r_149_88_37,1.0,0,37,37,63
14,r_62_9_177,r_16_25_184,r_73_7_108,r_73_7_108,1.0,69,177,108,63
8,r_105_8_91,r_5_126_190,seq146,r_105_8_91,0.97,2,93,91,63
61,seq19,seq70,r_58_138_9,r_58_138_9,1.0,5,14,9,63
43,r_90_51_174,seq52,r_28_80_138,r_28_80_138,0.67,37,175,138,63
87,seq96,seq61,r_40_100_29,r_40_100_29,1.0,0,29,29,63
21,r_65_26_73,seq3,r_45_115_75,r_65_26_73,0.91,0,73,73,63
39,r_94_135_163,seq60,seq118,r_94_135_163,0.59,0,163,163,63
5,r_104_31_141,r_30_66_191,r_44_129_7,r_104_31_141,0.88,0,141,141,63
46,r_55_81_114,r_136_77_111,r_14_72_84,r_55_81_114,0.79,0,114,114,63
10,r_22_112_44,r_65_26_73,seq71,r_22_112_44,1.0,1,45,44,63
1,r_76_29_38,r_133_15_185,r_148_134_3,r_76_29_38,1.0,1,39,38,63
45,r_74_92_58,r_55_81_114,r_67_99_167,r_55_81_114,1.0,0,114,114,63
30,r_114_82_195,r_40_100_29,r_35_23_13,r_114_82_195,0.53,-168,27,195,63
38,r_33_41_57,r_69_49_123,r_75_39_86,r_69_49_123,1.0,0,123,123,63
41,r_11_117_170,r_137_32_23,r_123_10_64,r_11_117_170,0.82,0,170,170,63
89,seq101,r_133_15_185,r_45_115_75,r_45_115_75,0.88,110,185,75,63
3,r_28_80_138,seq78,seq60,r_28_80_138,0.66,2,140,138,63
26,r_133_15_185,seq101,seq70,r_133_15_185,0.49,0,185,185,63
45,r_74_92_58,r_67_99_167,r_131_89_127,r_74_92_58,0.81,74,132,58,63
4,r_116_147_83,r_5_126_190,r_53_98_28,r_116_147_83,0.99,0,83,83,63
0,r_16_25_184,seq48,seq13,r_16_25_184,0.57,0,184,184,63
16,r_68_86_20,r_104_31_141,r_140_34_193,r_104_31_141,0.95,-119,22,141,63
13,r_110_128_149,seq52,seq46,r_110_128_149,0.72,1,150,149,63
48,r_75_39_86,r_94_135_163,seq144,r_75_39_86,0.96,2,88,86,63
6,r_73_7_108,r_16_25_184,seq118,r_73_7_108,1.0,0,108,108,63
2,r_24_2_164,seq13,seq145,r_24_2_164,0.76,0,164,164,63
40,r_69_49_123,seq3,r_149_88_37,r_69_49_123,0.99,0,123,123,63
18,r_143_85_125,r_104_31_141,seq6,r_143_85_125,1.0,1,126,125,63
29,r_136_77_111,r_55_81_114,seq142,r_136_77_111,0.78,0,111,111,63
24,r_14_72_84,r_94_135_163,seq101,r_14_72_84,0.87,0,84,84,63
25,r_59_109_65,r_116_147_83,r_127_125_46,r_59_109_65,0.93,0,65,65,63
33,r_131_89_127,r_5_126_190,r_74_92_58,r_5_126_190,0.96,-61,129,190,63
9,r_67_99_167,r_74_92_58,r_123_10_64,r_67_99_167,0.97,0,167,167,63
15,r_53_98_28,r_104_31_141,r_40_100_29,r_53_98_28,0.99,-1,27,28,63
47,r_127_125_46,r_14_72_84,seq119,r_127_125_46,1.0,-1,45,46,63
7,r_35_23_13,seq0,r_114_82_195,r_35_23_13,0.98,1,14,13,63
75,seq60,r_94_135_163,r_28_80_138,r_28_80_138,0.65,25,163,138,63
94,seq146,seq95,r_105_8_91,r_105_8_91,0.99,8,99,91,63
31,r_84_124_61,seq46,r_149_88_37,r_84_124_61,1.0,-2,59,61,63
9,r_67_99_167,r_136_77_111,r_74_92_58,r_67_99_167,0.97,-56,111,167,63
22,r_12_56_140,seq63,seq130,r_12_56_140,0.37,6,146,140,63
68,seq46,r_84_124_61,seq38,r_84_124_61,1.0,-16,45,61,63
45,r_74_92_58,seq132,r_55_81_114,r_74_92_58,1.0,1,59,58,63
44,r_91_108_183,seq78,seq139,r_91_108_183,0.5,0,183,183,63
35,r_123_10_64,r_16_25_184,seq54,r_123_10_64,1.0,-3,61,64,63
12,r_45_115_75,seq132,r_65_26_73,r_45_115_75,0.91,0,75,75,63
38,r_33_41_57,seq18,r_69_49_123,r_33_41_57,1.0,0,57,57,63
93,seq104,r_57_9_162,r_35_108_82,r_57_9_162,0.91,0,162,162,64
30,r_120_100_75,seq143,seq110,r_120_100_75,0.95,0,75,75,64
43,r_35_108_82,r_129_90_135,seq104,r_35_108_82,0.5,56,138,82,64
83,seq71,r_117_144_98,r_135_54_138,r_135_54_138,0.78,8,146,138,64
61,seq17,seq60,r_97_112_36,r_97_112_36,1.0,0,36,36,64
59,seq14,seq1,r_137_7_183,r_137_7_183,0.69,0,183,183,64
16,r_137_7_183,seq30,seq14,r_137_7_183,0.3,1,184,183,64
46,r_75_83_118,r_6_44_140,seq60,r_75_83_118,0.89,0,118,118,64
42,r_48_95_108,seq12,r_117_144_98,r_48_95_108,0.96,1,109,108,64
8,r_114_99_53,seq147,seq143,r_114_99_53,0.65,1,54,53,64
21,r_130_136_57,r_114_99_53,r_120_100_75,r_130_136_57,0.7,-38,19,57,64
73,seq37,seq78,r_64_105_114,r_64_105_114,0.61,6,120,114,64
41,r_102_146_177,seq43,r_120_100_75,r_102_146_177,0.74,0,177,177,64
49,r_94_132_22,r_98_56_131,seq52,r_94_132_22,0.99,0,22,22,64
3,r_73_119_89,r_124_116_181,seq143,r_73_119_89,0.85,5,94,89,64
10,r_124_116_181,r_73_119_89,r_91_47_6,r_124_116_181,0.67,-93,88,181,64
4,r_6_44_140,r_67_69_166,seq18,r_67_69_166,0.94,-26,140,166,64
17,r_21_24_45,r_49_126_109,r_70_3_28,r_70_3_28,0.91,20,48,28,64
20,r_111_142_178,r_122_85_2,r_80_134_58,r_80_134_58,0.58,122,180,58,64
13,r_113_2_81,r_117_144_98,seq43,r_113_2_81,1.0,0,81,81,64
48,r_11_51_163,seq10,seq31,r_11_51_163,0.34,4,167,163,64
6,r_39_81_103,seq78,seq106,r_39_81_103,0.99,0,103,103,64
15,r_72_140_56,r_19_87_86,seq53,r_72_140_56,1.0,0,56,56,64
74,seq40,seq4,r_89_46_164,r_89_46_164,1.0,3,167,164,64
85,seq78,r_39_81_103,seq37,r_39_81_103,1.0,0,103,103,64
7,r_82_27_148,r_80_134_58,r_50_42_63,r_82_27_148,0.98,0,148,148,64
10,r_124_116_181,r_91_47_6,r_89_46_164,r_91_47_6,0.94,175,181,6,64
5,r_80_134_58,r_50_42_63,seq43,r_50_42_63,1.0,-10,53,63,64
2,r_77_5_67,r_6_44_140,seq1,r_77_5_67,0.93,3,70,67,64
47,r_38_0_76,r_57_9_162,seq52,r_38_0_76,1.0,0,76,76,64
40,r_19_87_86,r_66_107_147,r_127_141_7,r_19_87_86,1.0,0,86,86,64
74,seq40,r_66_107_147,seq4,r_66_107_147,1.0,-51,96,147,64
18,r_64_105_114,r_82_27_148,seq37,r_64_105_114,0.87,0,114,114,64
29,r_50_42_63,seq4,seq62,r_50_42_63,1.0,0,63,63,64
25,r_129_90_135,r_35_108_82,r_49_126_109,r_49_126_109,0.94,29,138,109,64
36,r_79_76_21,r_123_20_151,r_41_22_38,r_79_76_21,1.0,1,22,21,64
1,r_89_46_164,seq148,seq40,r_89_46_164,0.49,2,166,164,64
32,r_66_107_147,seq40,r_77_5_67,r_66_107_147,0.66,0,147,147,64
21,r_130_136_57,r_120_100_75,r_61_121_33,r_61_121_33,1.0,24,57,33,64
77,seq52,r_6_44_140,r_38_0_76,r_38_0_76,1.0,50,126,76,64
88,seq143,r_114_99_53,r_73_119_89,r_73_119_89,0.83,1,90,89,64
9,r_34_138_49,seq106,r_41_22_38,r_34_138_49,0.43,53,102,49,64
96,seq110,seq1,r_120_100_75,r_120_100_75,1.0,6,81,75,64
19,r_61_121_33,seq31,seq25,r_61_121_33,1.0,0,33,33,64
22,r_123_20_151,r_137_7_183,seq139,r_123_20_151,0.74,12,163,151,64
28,r_86_26_158,r_67_69_166,r_80_134_58,r_86_26_158,0.6,0,158,158,64
7,r_82_27_148,r_64_105_114,r_80_134_58,r_64_105_114,0.84,0,114,114,64
23,r_101_128_176,seq12,r_89_46_164,r_101_128_176,0.64,0,176,176,64
26,r_97_112_36,seq1,seq17,r_97_112_36,0.99,0,36,36,64
79,seq60,seq106,r_75_83_118,r_75_83_118,1.0,2,120,118,64
35,r_58_59_142,r_89_46_164,seq106,r_58_59_142,0.82,0,142,142,64
12,r_98_56_131,r_102_146_177,seq15,r_98_56_131,0.99,0,131,131,64
24,r_70_3_28,seq68,r_21_24_45,r_21_24_45,0.99,0,45,45,64
30,r_52_87_105,seq142,seq125,r_52_87_105,1.0,0,105,105,65
14,r_10_54_165,r_69_133_198,r_95_29_103,r_10_54_165,0.7,0,165,165,65
8,r_102_16_98,r_135_110_138,seq59,r_102_16_98,0.93,1,99,98,65
43,r_80_5_71,r_135_110_138,r_45_78_50,r_135_110_138,0.54,-72,66,138,65
37,r_62_91_135,seq136,r_17_18_13,r_62_91_135,0.97,0,135,135,65
16,r_8_3_113,seq48,seq12,r_8_3_113,0.96,0,113,113,65
21,r_83_149_107,seq38,seq40,r_83_149_107,0.98,2,109,107,65
46,r_123_25_143,seq119,r_131_97_38,r_123_25_143,0.82,0,143,143,65
93,seq116,r_45_78_50,r_147_33_42,r_45_78_50,0.97,-1,49,50,65
39,r_79_138_43,seq141,seq106,r_79_138_43,1.0,0,43,43,65
42,r_35_132_65,r_31_107_152,seq60,r_35_132_65,0.75,-12,53,65,65
31,r_108_64_102,seq113,r_23_145_6,r_108_64_102,0.93,1,103,102,65
41,r_31_107_152,seq21,seq119,r_31_107_152,0.52,1,153,152,65
3,r_76_115_90,r_68_143_169,r_32_55_2,r_76_115_90,0.85,1,91,90,65
90,seq106,r_68_143_169,r_79_138_43,r_79_138_43,1.0,127,170,43,65
0,r_135_110_138,seq129,r_14_24_141,r_135_110_138,0.84,10,148,138,65
29,r_75_126_34,seq44,seq104,r_75_126_34,1.0,0,34,34,65
13,r_70_15_133,seq38,r_135_110_138,r_70_15_133,0.85,5,138,133,65
48,r_63_36_96,seq120,r_124_0_17,r_63_36_96,1.0,3,99,96,65
6,r_95_29_103,r_41_9_111,seq38,r_95_29_103,0.95,0,103,103,65
19,r_45_78_50,seq116,seq11,r_45_78_50,0.97,-1,49,50,65
27,r_144_74_187,seq40,r_76_115_90,r_76_115_90,0.94,97,187,90,65
4,r_6_51_24,r_135_110_138,seq43,r_6_51_24,0.95,-1,23,24,65
47,r_14_24_141,seq46,r_135_110_138,r_14_24_141,0.89,0,141,141,65
15,r_131_97_38,r_83_149_107,seq46,r_131_97_38,0.93,1,39,38,65
18,r_103_109_125,r_17_18_13,r_86_7_15,r_103_109_125,0.96,0,125,125,65
40,r_148_72_40,r_62_91_135,r_17_18_13,r_148_72_40,0.9,0,40,40,65
25,r_96_22_75,r_76_115_90,seq46,r_96_22_75,1.0,0,75,75,65
33,r_140_4_61,seq77,r_147_33_42,r_140_4_61,1.0,0,61,61,65
11,r_86_7_15,r_14_24_141,r_112_1_94,r_86_7_15,0.77,2,17,15,65
65,seq38,r_84_101_161,r_95_29_103,r_95_29_103,0.77,60,163,103,65
44,r_147_33_42,r_135_110_138,r_23_145_6,r_147_33_42,0.8,-32,10,42,65
2,r_50_117_22,r_81_100_160,seq56,r_50_117_22,1.0,0,22,22,65
38,r_2_39_97,r_108_64_102,seq89,r_2_39_97,0.61,-2,95,97,65
34,r_84_101_161,seq38,r_98_130_76,r_84_101_161,0.71,2,163,161,65
10,r_42_94_12,r_76_115_90,seq12,r_42_94_12,0.98,0,12,12,65
94,seq119,r_123_25_143,seq48,r_123_25_143,0.99,0,143,143,65
9,r_28_53_131,r_32_55_2,r_45_78_50,r_32_55_2,0.89,129,131,2,65
75,seq60,r_147_33_42,r_35_132_65,r_35_132_65,0.57,-20,45,65,65
49,r_128_118_128,seq121,r_114_61_120,r_128_118_128,0.95,2,130,128,65
68,seq44,r_75_126_34,r_98_130_76,r_75_126_34,1.0,-1,33,34,65
12,r_85_49_69,seq137,seq26,r_85_49_69,1.0,-2,67,69,65
30,r_64_94_65,r_51_4_147,seq128,r_64_94_65,0.69,6,71,65,66
13,r_109_11_24,seq63,seq16,r_109_11_24,0.96,0,24,24,66
8,r_8_142_175,r_125_75_194,r_84_25_19,r_125_75_194,0.62,-19,175,194,66
43,r_73_30_167,seq3,r_58_121_190,r_73_30_167,0.53,0,167,167,66
37,r_42_138_136,r_8_142_175,r_131_48_86,r_42_138_136,0.88,0,136,136,66
26,r_15_62_14,r_1_95_141,r_102_117_15,r_15_62_14,0.51,2,16,14,66
1,r_5_126_90,r_23_35_131,r_107_36_125,r_5_126_90,0.99,0,90,90,66
97,seq122,r_107_36_125,r_143_136_47,r_143_136_47,1.0,95,142,47,66
5,r_81_45_180,seq101,r_58_121_190,r_81_45_180,0.56,0,180,180,66
31,r_83_105_54,r_146_43_4,seq96,r_83_105_54,1.0,0,54,54,66
15,r_98_76_108,r_135_32_115,r_46_33_123,r_46_33_123,0.79,-1,122,123,66
3,r_93_79_104,r_135_32_115,seq34,r_93_79_104,0.86,-11,93,104,66
28,r_10_141_42,r_1_95_141,r_19_67_37,r_10_141_42,0.99,0,42,42,66
10,r_140_149_135,r_42_138_136,r_113_41_75,r_42_138_136,0.5,5,141,136,66
4,r_1_95_141,seq101,r_15_62_14,r_1_95_141,0.56,0,141,141,66
11,r_107_36_125,seq122,r_5_126_90,r_5_126_90,1.0,42,132,90,66
39,r_133_54_29,r_8_142_175,seq122,r_8_142_175,0.54,-144,31,175,66
20,r_53_9_138,seq120,r_100_59_76,r_53_9_138,0.59,0,138,138,66
98,seq124,seq74,r_135_32_115,r_135_32_115,0.92,-28,87,115,66
15,r_98_76_108,r_125_75_194,r_135_32_115,r_98_76_108,0.45,1,109,108,66
48,r_125_75_194,r_8_142_175,r_38_60_69,r_38_60_69,1.0,106,175,69,66
57,seq13,seq74,r_19_67_37,r_19_67_37,1.0,49,86,37,66
6,r_135_32_115,r_93_79_104,seq124,r_135_32_115,0.86,-3,112,115,66
49,r_102_117_15,r_23_35_131,r_15_62_14,r_102_117_15,0.91,0,15,15,66
42,r_40_123_17,r_23_35_131,seq16,r_40_123_17,0.72,0,17,17,66
27,r_86_21_110,seq6,seq22,r_86_21_110,0.94,2,112,110,66
87,seq101,r_1_95_141,r_83_105_54,r_83_105_54,0.99,87,141,54,66
2,r_130_57_97,seq29,r_61_31_16,r_130_57_97,0.96,1,98,97,66
40,r_24_148_146,seq132,seq55,r_24_148_146,0.92,0,146,146,66
29,r_143_136_47,seq108,seq29,r_143_136_47,1.0,0,47,47,66
24,r_90_20_160,seq91,r_83_105_54,r_83_105_54,1.0,106,160,54,66
14,r_61_31_16,r_8_142_175,seq13,r_61_31_16,1.0,1,17,16,66
33,r_144_0_111,seq132,seq16,r_144_0_111,0.82,1,112,111,66
0,r_19_67_37,seq115,seq13,r_19_67_37,0.62,2,39,37,66
34,r_38_60_69,seq13,r_15_62_14,r_38_60_69,1.0,0,69,69,66
17,r_28_85_140,r_8_142_175,seq80,r_28_85_140,0.93,0,140,140,66
22,r_46_33_123,r_73_30_167,r_98_76_108,r_73_30_167,0.91,-44,123,167,66
56,seq137,r_118_44_66,r_113_41_75,r_113_41_75,0.99,1,76,75,66
7,r_118_44_66,seq137,r_58_121_190,r_118_44_66,0.72,4,70,66,66
44,r_51_4_147,seq34,seq3,r_51_4_147,0.88,0,147,147,66
23,r_111_134_99,r_66_139_195,r_147_87_94,r_147_87_94,0.75,12,106,94,66
12,r_113_41_75,seq17,seq137,r_113_41_75,1.0,0,75,75,66
84,seq96,r_1_95_141,r_83_105_54,r_83_105_54,0.98,38,92,54,66
30,r_42_103_74,seq7,r_124_105_63,r_42_103_74,0.65,0,74,74,67
44,r_121_88_169,r_63_11_26,r_30_29_151,r_121_88_169,0.61,2,171,169,67
36,r_127_10_125,r_76_128_179,seq136,r_127_10_125,0.64,-4,121,125,67
43,r_19_80_118,r_113_125_121,seq144,r_113_125_121,0.63,-1,120,121,67
8,r_99_129_149,seq97,r_90_117_28,r_90_117_28,0.59,3,31,28,67
83,seq74,r_140_84_174,seq97,r_140_84_174,0.58,1,175,174,67
21,r_53_116_116,r_139_40_191,seq87,r_53_116_116,0.93,2,118,116,67
39,r_49_146_130,r_15_34_156,seq44,r_49_146_130,0.54,2,132,130,67
42,r_25_43_81,seq45,r_108_22_37,r_25_43_81,0.91,5,86,81,67
6,r_115_5_34,r_118_35_193,seq55,r_115_5_34,0.97,1,35,34,67
45,r_78_102_165,r_119_149_167,r_30_29_151,r_30_29_151,0.65,17,168,151,67
19,r_31_122_90,seq71,seq136,r_31_122_90,0.89,1,91,90,67
23,r_135_75_23,seq44,seq87,r_135_75_23,0.95,6,29,23,67
95,seq144,r_107_94_140,r_19_80_118,r_107_94_140,0.61,0,140,140,67
41,r_106_91_161,seq18,r_86_82_51,r_86_82_51,0.91,109,160,51,67
89,seq89,r_9_100_76,r_78_102_165,r_9_100_76,0.99,3,79,76,67
10,r_64_1_105,seq93,seq52,r_64_1_105,0.82,5,110,105,67
44,r_121_88_169,r_134_110_197,r_63_11_26,r_63_11_26,1.0,-5,21,26,67
8,r_99_129_149,r_90_117_28,seq89,r_90_117_28,0.74,124,152,28,67
72,seq52,r_39_47_88,r_111_72_9,r_39_47_88,0.82,2,90,88,67
11,r_107_94_140,seq144,seq66,r_107_94_140,0.92,0,140,140,67
12,r_90_117_28,seq83,r_99_129_149,r_90_117_28,0.94,1,29,28,67
13,r_6_85_68,r_98_28_194,r_57_36_112,r_98_28_194,0.64,-124,70,194,67
15,r_101_16_84,r_142_67_164,r_68_14_49,r_101_16_84,0.96,7,91,84,67
48,r_119_149_167,r_78_102_165,seq12,r_78_102_165,0.61,3,168,165,67
35,r_108_22_37,seq104,seq44,r_108_22_37,0.84,0,37,37,67
4,r_63_11_26,r_121_88_169,r_124_105_63,r_121_88_169,0.58,2,171,169,67
12,r_90_117_28,r_99_129_149,r_135_75_23,r_90_117_28,0.74,125,153,28,67
33,r_68_14_49,seq3,seq58,r_68_14_49,1.0,5,54,49,67
85,seq79,r_113_125_121,r_30_29_151,r_30_29_151,0.92,1,152,151,67
27,r_33_65_137,seq147,r_53_116_116,r_33_65_137,0.63,6,143,137,67
47,r_139_40_191,r_53_116_116,r_115_5_34,r_139_40_191,0.92,-73,118,191,67
70,seq44,r_113_125_121,r_108_22_37,r_108_22_37,0.95,25,62,37,67
34,r_30_29_151,seq56,seq79,r_30_29_151,0.68,1,152,151,67
80,seq69,r_86_82_51,seq89,r_86_82_51,1.0,7,58,51,67
28,r_86_82_51,seq69,seq104,r_86_82_51,0.8,2,53,51,67
4,r_63_11_26,r_9_100_76,r_121_88_169,r_63_11_26,0.92,-5,21,26,67
17,r_9_100_76,seq89,r_111_72_9,r_9_100_76,0.64,2,78,76,67
22,r_112_70_36,r_106_91_161,seq26,r_112_70_36,0.81,1,37,36,67
49,r_92_37_128,r_15_34_156,r_42_103_74,r_42_103_74,0.68,54,128,74,67
56,seq12,r_15_34_156,r_119_149_167,r_15_34_156,0.63,19,175,156,67
7,r_2_51_103,r_140_84_174,r_111_72_9,r_140_84_174,0.6,-70,104,174,67
8,r_143_107_88,r_111_10_107,seq4,r_143_107_88,0.99,2,90,88,68
48,r_75_74_33,r_50_56_41,r_90_93_8,r_75_74_33,1.0,0,33,33,68
37,r_48_63_71,seq100,seq15,r_48_63_71,1.0,0,71,71,68
49,r_34_61_31,r_143_107_88,seq148,r_34_61_31,1.0,0,31,31,68
55,seq5,r_98_106_114,r_141_41_52,r_141_41_52,1.0,71,123,52,68
39,r_24_120_166,seq15,seq97,r_24_120_166,0.52,2,168,166,68
1,r_118_28_132,seq51,r_19_76_192,r_118_28_132,0.39,3,135,132,68
28,r_113_123_77,r_59_66_51,r_88_103_172,r_59_66_51,0.78,0,51,51,68
11,r_86_25_10,seq125,seq43,r_86_25_10,0.99,1,11,10,68
14,r_127_64_20,r_118_28_132,seq97,r_127_64_20,1.0,0,20,20,68
13,r_139_21_58,seq49,seq126,r_139_21_58,0.99,0,58,58,68
41,r_2_138_180,seq8,r_143_107_88,r_143_107_88,0.67,92,180,88,68
3,r_18_44_130,r_20_6_125,seq145,r_18_44_130,0.63,1,131,130,68
26,r_31_82_67,seq131,r_50_56_41,r_31_82_67,0.85,1,68,67,68
47,r_115_142_147,r_108_124_144,seq148,r_108_124_144,0.88,-86,58,144,68
4,r_102_12_106,seq95,seq130,r_102_12_106,1.0,0,106,106,68
0,r_108_124_144,r_133_14_167,r_9_26_87,r_108_124_144,0.87,0,144,144,68
73,seq43,r_111_10_107,r_86_25_10,r_111_10_107,0.88,2,109,107,68
20,r_134_55_66,seq16,seq79,r_134_55_66,1.0,0,66,66,68
36,r_90_93_8,r_86_25_10,r_75_74_33,r_75_74_33,1.0,3,36,33,68
99,seq126,seq145,r_139_21_58,r_139_21_58,1.0,35,93,58,68
9,r_144_73_42,r_60_70_183,seq121,r_144_73_42,1.0,0,42,42,68
27,r_40_116_136,r_46_117_149,seq149,r_46_117_149,0.39,-7,142,149,68
87,seq94,r_40_116_136,r_119_42_113,r_119_42_113,0.53,0,113,113,68
40,r_132_101_81,r_119_42_113,seq109,r_119_42_113,1.0,-19,94,113,68
29,r_60_70_183,r_37_17_126,r_118_28_132,r_118_28_132,0.7,51,183,132,68
24,r_111_10_107,seq43,r_134_55_66,r_111_10_107,0.97,2,109,107,68
10,r_84_81_22,r_102_12_106,r_65_57_9,r_84_81_22,0.72,0,22,22,68
25,r_133_14_167,seq71,r_143_107_88,r_133_14_167,0.58,0,167,167,68
33,r_46_117_149,r_40_116_136,seq5,r_46_117_149,0.61,-7,142,149,68
43,r_3_122_27,seq7,seq83,r_3_122_27,0.59,10,37,27,68
82,seq78,r_60_70_183,r_59_66_51,r_59_66_51,0.94,8,59,51,68
61,seq15,r_24_120_166,r_48_63_71,r_48_63_71,1.0,73,144,71,68
32,r_68_104_143,seq105,r_80_35_120,r_68_104_143,0.86,0,143,143,68
38,r_23_77_84,r_118_28_132,r_72_96_111,r_23_77_84,1.0,0,84,84,68
28,r_113_123_77,r_88_103_172,r_90_93_8,r_113_123_77,0.91,-1,76,77,68
45,r_50_56_41,r_1_91_112,seq140,r_50_56_41,1.0,0,41,41,68
34,r_72_96_111,r_50_56_41,seq136,r_50_56_41,1.0,0,41,41,68
17,r_9_26_87,seq47,r_72_96_111,r_9_26_87,0.97,2,89,87,68
46,r_87_45_59,r_1_91_112,r_84_81_22,r_87_45_59,0.97,0,59,59,68
22,r_119_42_113,seq149,seq94,r_119_42_113,0.74,1,114,113,68
7,r_88_103_172,seq136,r_18_44_130,r_18_44_130,0.63,42,172,130,68
44,r_53_92_176,seq83,r_20_6_125,r_20_6_125,0.59,51,176,125,68
23,r_20_6_125,r_18_44_130,seq29,r_18_44_130,0.81,1,131,130,68
35,r_146_13_101,r_60_70_183,seq36,r_60_70_183,0.7,-52,131,183,68
12,r_52_22_131,r_60_70_183,r_113_123_77,r_60_70_183,0.59,-52,131,183,68
42,r_59_66_51,r_113_123_77,seq78,r_59_66_51,0.77,0,51,51,68
51,seq2,r_108_137_146,r_9_130_74,r_9_130_74,0.63,70,144,74,69
92,seq101,r_78_84_139,r_9_130_74,r_9_130_74,1.0,56,130,74,69
14,r_21_122_145,seq147,seq11,r_21_122_145,1.0,0,145,145,69
8,r_90_15_173,r_76_146_176,r_62_13_4,r_76_146_176,0.53,-3,173,176,69
43,r_149_32_133,r_112_7_1,seq26,r_149_32_133,0.94,0,133,133,69
37,r_55_79_93,r_20_135_103,r_49_27_43,r_20_135_103,1.0,-10,93,103,69
19,r_49_27_43,r_136_14_36,r_55_79_93,r_55_79_93,1.0,12,105,93,69
16,r_46_80_17,r_133_34_154,r_25_97_189,r_133_34_154,1.0,0,154,154,69
39,r_78_84_139,seq101,r_116_74_152,r_116_74_152,0.79,2,154,152,69
46,r_5_117_82,r_125_44_87,seq17,r_125_44_87,0.67,-5,82,87,69
45,r_35_42_80,r_103_139_193,seq147,r_35_42_80,0.99,0,80,80,69
31,r_116_74_152,r_25_97_189,r_78_84_139,r_78_84_139,0.65,13,152,139,69
41,r_129_98_177,r_43_61_174,r_46_80_17,r_43_61_174,0.56,9,183,174,69
3,r_125_44_87,seq66,seq26,r_125_44_87,1.0,0,87,87,69
10,r_104_141_163,seq11,r_109_132_2,r_104_141_163,0.76,1,164,163,69
26,r_30_114_148,seq83,r_131_113_13,r_30_114_148,0.88,0,148,148,69
7,r_56_92_57,r_20_135_103,r_105_18_68,r_56_92_57,1.0,0,57,57,69
4,r_9_130_74,r_21_122_145,seq101,r_9_130_74,0.66,0,74,74,69
0,r_93_65_70,r_16_36_182,seq144,r_93_65_70,1.0,1,71,70,69
11,r_119_77_191,r_134_59_180,r_50_110_71,r_50_110_71,1.0,11,82,71,69
20,r_105_18_68,seq66,r_56_92_57,r_56_92_57,1.0,45,102,57,69
13,r_133_34_154,r_46_80_17,seq91,r_133_34_154,0.79,0,154,154,69
48,r_134_59_180,r_9_130_74,seq52,r_9_130_74,1.0,0,74,74,69
57,seq144,seq58,r_93_65_70,r_93_65_70,1.0,33,103,70,69
21,r_60_6_24,r_109_132_2,seq91,r_60_6_24,0.97,4,28,24,69
27,r_50_110_71,seq100,seq52,r_50_110_71,1.0,0,71,71,69
22,r_43_61_174,r_129_98_177,r_116_74_152,r_129_98_177,0.75,6,183,177,69
47,r_19_102_178,seq128,r_50_110_71,r_50_110_71,0.79,107,178,71,69
40,r_138_142_88,seq26,seq89,r_138_142_88,1.0,0,88,88,69
29,r_16_36_182,seq128,r_106_124_113,r_106_124_113,1.0,69,182,113,69
2,r_136_14_36,r_138_142_88,r_29_45_78,r_136_14_36,0.91,48,84,36,69
33,r_12_0_159,r_43_61_174,r_3_22_153,r_12_0_159,0.84,0,159,159,69
48,r_134_59_180,seq52,r_62_13_4,r_134_59_180,0.55,0,180,180,69
6,r_71_51_39,r_25_97_189,seq111,r_71_51_39,1.0,0,39,39,69
32,r_106_124_113,r_16_36_182,seq48,r_106_124_113,0.89,0,113,113,69
34,r_29_45_78,r_21_122_145,r_136_14_36,r_29_45_78,1.0,0,78,78,69
24,r_131_113_13,r_93_65_70,seq120,r_131_113_13,0.84,0,13,13,69
94,seq111,r_112_7_1,r_71_51_39,r_71_51_39,1.0,62,101,39,69
30,r_57_95_25,r_21_122_145,seq128,r_57_95_25,0.9,0,25,25,69
22,r_43_61_174,r_12_0_159,r_129_98_177,r_12_0_159,0.99,-43,116,159,69
28,r_1_69_61,r_90_15_173,seq147,r_1_69_61,1.0,0,61,61,69
49,r_108_137_146,seq2,r_29_45_78,r_108_137_146,0.99,2,148,146,69
44,r_10_63_94,r_126_31_175,r_71_51_39,r_10_63_94,1.0,1,95,94,69
2,r_136_14_36,r_25_97_189,r_138_142_88,r_136_14_36,0.95,0,36,36,69
30,r_134_49_79,seq3,r_58_82_199,r_134_49_79,1.0,0,79,79,70
36,r_28_75_134,r_134_49_79,r_37_88_17,r_28_75_134,0.53,-71,63,134,70
8,r_57_15_190,r_73_130_116,r_34_18_30,r_34_18_30,0.99,1,31,30,70
22,r_118_42_55,r_112_11_84,r_129_2_21,r_118_42_55,1.0,-1,54,55,70
37,r_40_32_127,seq135,seq109,r_40_32_127,0.94,0,127,127,70
3,r_132_144_11,r_108_72_157,seq36,r_132_144_11,0.98,0,11,11,70
5,r_101_114_93,seq1,r_37_88_17,r_101_114_93,0.99,-1,92,93,70
69,seq36,r_100_38_173,r_67_5_57,r_67_5_57,0.71,117,174,57,70
45,r_96_4_148,seq111,r_12_13_71,r_12_13_71,0.63,77,148,71,70
95,seq111,r_96_4_148,r_112_11_84,r_112_11_84,0.95,64,148,84,70
31,r_107_33_108,r_12_13_71,r_41_77_155,r_12_13_71,0.99,-1,70,71,70
10,r_68_131_119,r_61_81_123,r_66_121_133,r_68_131_119,0.72,-1,118,119,70
23,r_112_11_84,seq3,seq46,r_112_11_84,0.98,0,84,84,70
8,r_57_15_190,r_34_18_30,r_12_13_71,r_57_15_190,0.36,0,190,190,70
23,r_112_11_84,r_118_42_55,seq3,r_118_42_55,1.0,-13,42,55,70
4,r_6_48_99,seq27,seq24,r_6_48_99,0.96,-1,98,99,70
0,r_117_126_149,seq26,r_28_75_134,r_117_126_149,0.65,1,150,149,70
20,r_79_89_170,seq128,seq93,r_79_89_170,0.4,1,171,170,70
49,r_52_84_35,r_96_4_148,r_138_53_1,r_52_84_35,0.99,-1,34,35,70
46,r_34_18_30,r_57_15_190,r_47_102_152,r_47_102_152,0.98,38,190,152,70
14,r_129_2_21,r_106_139_104,seq8,r_129_2_21,0.56,-3,18,21,70
48,r_95_148_90,seq25,seq128,r_95_148_90,1.0,3,93,90,70
13,r_37_88_17,r_28_75_134,r_101_114_93,r_37_88_17,0.93,80,97,17,70
6,r_63_133_124,seq92,seq141,r_63_133_124,0.84,1,125,124,70
62,seq22,r_108_72_157,seq135,r_108_72_157,1.0,0,157,157,70
36,r_28_75_134,r_37_88_17,r_91_54_36,r_28_75_134,0.99,0,134,134,70
27,r_39_120_147,seq70,r_71_50_8,r_39_120_147,0.81,1,148,147,70
47,r_91_54_36,r_40_32_127,seq20,r_91_54_36,1.0,0,36,36,70
2,r_106_139_104,seq128,seq87,r_106_139_104,0.97,0,104,104,70
18,r_66_121_133,seq3,r_68_131_119,r_68_131_119,0.91,0,119,119,70
46,r_34_18_30,r_6_48_99,r_57_15_190,r_34_18_30,1.0,0,30,30,70
24,r_47_102_152,r_100_38_173,seq22,r_47_102_152,0.88,1,153,152,70
26,r_110_80_27,r_118_42_55,seq1,r_110_80_27,0.95,1,28,27,70
33,r_56_99_105,r_58_82_199,seq141,r_56_99_105,0.99,-1,104,105,70
47,r_91_54_36,seq20,r_28_75_134,r_28_75_134,0.98,-3,131,134,70
42,r_43_0_14,r_100_38_173,seq136,r_43_0_14,0.53,0,14,14,70
13,r_37_88_17,r_104_125_196,r_28_75_134,r_37_88_17,0.97,3,20,17,70
1,r_67_5_57,r_17_59_112,r_113_122_54,r_67_5_57,1.0,-1,56,57,70
32,r_58_82_199,r_56_99_105,r_134_49_79,r_58_82_199,1.0,-120,79,199,70
38,r_73_130_116,r_57_15_190,r_56_99_105,r_73_130_116,0.94,0,116,116,70
52,seq3,r_134_49_79,r_66_121_133,r_134_49_79,1.0,-1,78,79,70
34,r_61_81_123,r_68_131_119,seq90,r_68_131_119,1.0,-1,118,119,70
75,seq62,r_57_15_190,r_34_18_30,r_34_18_30,0.83,129,159,30,70
43,r_113_122_54,r_35_145_193,seq76,r_113_122_54,1.0,0,54,54,70
17,r_12_13_71,r_107_33_108,seq128,r_12_13_71,1.0,0,71,71,70
94,seq109,r_138_53_1,r_40_32_127,r_40_32_127,1.0,22,149,127,70
9,r_17_59_112,r_127_23_197,r_6_48_99,r_127_23_197,0.54,-84,113,197,70
31,r_107_33_108,r_41_77_155,r_6_48_99,r_107_33_108,0.81,0,108,108,70
28,r_41_77_155,seq29,r_134_49_79,r_41_77_155,0.75,-1,154,155,70
7,r_108_72_157,seq22,seq29,r_108_72_157,0.82,0,157,157,70
16,r_146_69_56,r_67_5_57,r_60_14_45,r_146_69_56,0.63,0,56,56,70
29,r_78_21_40,seq64,seq98,r_78_21_40,0.96,0,40,40,70
19,r_60_14_45,r_58_82_199,seq24,r_60_14_45,1.0,-5,40,45,70
51,seq131,r_8_36_164,seq1,r_8_36_164,0.94,2,166,164,71
36,r_92_45_80,r_114_112_146,seq134,r_92_45_80,0.91,6,86,80,71
8,r_118_57_150,r_28_91_144,r_25_89_31,r_25_89_31,0.99,120,151,31,71
43,r_16_137_151,seq120,r_84_77_16,r_16_137_151,0.92,0,151,151,71
83,seq86,r_20_87_115,seq27,r_20_87_115,1.0,0,115,115,71
5,r_129_46_157,seq52,r_48_148_9,r_129_46_157,0.66,1,158,157,71
46,r_144_83_139,seq120,r_42_18_117,r_144_83_139,0.86,3,142,139,71
42,r_34_135_161,r_32_10_179,r_48_148_9,r_32_10_179,0.57,-16,163,179,71
27,r_127_149_54,seq99,r_51_21_135,r_127_149_54,1.0,0,54,54,71
19,r_20_87_115,seq86,r_95_22_56,r_20_87_115,0.87,0,115,115,71
15,r_82_23_71,r_69_76_175,seq55,r_69_76_175,0.88,0,175,175,71
31,r_13_130_28,r_42_18_117,seq33,r_13_130_28,0.98,-3,25,28,71
39,r_72_39_24,r_100_49_199,r_136_41_3,r_72_39_24,0.58,1,25,24,71
67,seq52,r_129_46_157,r_14_7_108,r_14_7_108,0.63,30,138,108,71
3,r_56_61_66,seq44,seq117,r_56_61_66,0.98,0,66,66,71
26,r_47_102_165,r_69_76_175,seq99,r_69_76_175,0.62,-9,166,175,71
4,r_29_103_95,seq63,seq86,r_29_103_95,0.95,3,98,95,71
0,r_69_76_175,r_47_102_165,r_26_50_107,r_47_102_165,0.97,1,166,165,71
20,r_97_126_110,seq134,r_40_101_41,r_97_126_110,0.96,0,110,110,71
15,r_82_23_71,r_15_133_182,r_69_76_175,r_82_23_71,0.94,1,72,71,71
6,r_70_106_163,r_28_91_144,r_141_109_78,r_28_91_144,0.83,19,163,144,71
88,seq99,r_127_149_54,r_136_41_3,r_127_149_54,1.0,1,55,54,71
10,r_116_11_68,r_34_135_161,seq43,r_116_11_68,0.97,-9,59,68,71
2,r_0_146_64,r_26_50_107,r_95_22_56,r_26_50_107,0.44,-42,65,107,71
47,r_15_133_182,r_82_23_71,seq1,r_82_23_71,1.0,2,73,71,71
18,r_26_50_107,seq17,seq93,r_26_50_107,0.81,3,110,107,71
24,r_128_73_142,r_38_147_13,r_118_57_150,r_38_147_13,0.47,146,159,13,71
37,r_25_89_31,r_0_146_64,seq71,r_25_89_31,1.0,1,32,31,71
65,seq43,seq5,r_116_11_68,r_116_11_68,1.0,26,94,68,71
32,r_138_12_141,r_118_57_150,seq5,r_138_12_141,0.82,1,142,141,71
38,r_38_147_13,r_128_73_142,r_28_91_144,r_38_147_13,0.49,146,159,13,71
34,r_40_101_41,r_127_149_54,r_24_67_8,r_40_101_41,0.99,0,41,41,71
94,seq117,seq78,r_56_61_66,r_56_61_66,1.0,4,70,66,71
17,r_84_77_16,r_4_140_185,r_59_110_129,r_84_77_16,0.94,0,16,16,71
22,r_59_110_129,r_119_105_166,seq134,r_59_110_129,0.8,2,131,129,71
7,r_119_105_166,seq66,r_28_91_144,r_119_105_166,0.68,0,166,166,71
23,r_141_109_78,seq30,seq1,r_141_109_78,0.53,0,78,78,71
17,r_84_77_16,r_59_110_129,seq66,r_59_110_129,1.0,-13,116,129,71
35,r_28_91_144,r_118_57_150,r_38_147_13,r_28_91_144,0.53,7,151,144,71
12,r_107_79_100,seq120,seq139,r_107_79_100,0.97,0,100,100,71
23,r_141_109_78,seq1,r_70_106_163,r_70_106_163,0.97,11,174,163,71
93,seq100,r_140_108_109,r_59_61_90,r_140_108_109,0.98,3,112,109,72
30,r_121_125_115,seq35,seq89,r_121_125_115,0.99,0,115,115,72
36,r_85_18_126,seq132,r_30_112_5,r_85_18_126,0.74,4,130,126,72
14,r_99_145_144,r_0_64_148,r_149_83_45,r_0_64_148,1.0,0,148,148,72
8,r_62_117_152,seq75,r_48_7_37,r_62_117_152,0.81,0,152,152,72
43,r_49_34_154,seq63,seq91,r_49_34_154,0.78,4,158,154,72
83,seq141,seq89,r_16_74_182,r_16_74_182,0.59,2,184,182,72
38,r_116_40_92,r_10_80_20,seq25,r_116_40_92,1.0,0,92,92,72
16,r_139_29_173,r_16_74_182,r_115_51_158,r_139_29_173,0.76,0,173,173,72
1,r_16_74_182,seq130,seq141,r_16_74_182,0.47,0,182,182,72
5,r_73_134_83,seq55,seq110,r_73_134_83,1.0,0,83,83,72
46,r_36_106_138,seq110,seq25,r_36_106_138,0.38,7,145,138,72
39,r_101_122_32,r_16_74_182,r_48_7_37,r_101_122_32,1.0,0,32,32,72
19,r_15_9_111,seq44,r_10_80_20,r_10_80_20,1.0,98,118,20,72
45,r_19_47_57,r_17_54_98,seq63,r_19_47_57,1.0,-2,55,57,72
31,r_37_8_65,r_17_54_98,seq144,r_37_8_65,1.0,0,65,65,72
41,r_77_129_132,seq136,r_6_58_52,r_77_129_132,0.93,0,132,132,72
3,r_67_11_114,r_33_56_195,seq23,r_67_11_114,0.59,4,118,114,72
63,seq22,r_115_51_158,r_124_126_23,r_124_126_23,0.97,5,28,23,72
11,r_39_111_97,r_140_108_109,r_10_80_20,r_39_111_97,0.84,1,98,97,72
48,r_33_56_195,r_67_11_114,seq43,r_67_11_114,0.71,4,118,114,72
42,r_48_7_37,r_21_32_142,seq100,r_48_7_37,1.0,-1,36,37,72
87,seq89,seq141,r_121_125_115,r_121_125_115,1.0,-2,113,115,72
6,r_92_27_171,r_102_133_50,r_139_29_173,r_102_133_50,1.0,0,50,50,72
47,r_21_32_142,seq144,seq23,r_21_32_142,0.95,0,142,142,72
40,r_0_64_148,seq93,r_50_84_82,r_0_64_148,0.94,0,148,148,72
18,r_90_31_166,seq144,r_103_72_9,r_90_31_166,0.8,1,167,166,72
24,r_137_114_102,seq119,r_96_46_24,r_137_114_102,1.0,0,102,102,72
25,r_140_108_109,seq100,seq119,r_140_108_109,0.99,3,112,109,72
20,r_102_133_50,r_92_27_171,seq93,r_102_133_50,1.0,0,50,50,72
38,r_116_40_92,r_113_146_33,r_10_80_20,r_116_40_92,0.75,-56,36,92,72
33,r_57_88_151,r_59_61_90,seq132,r_57_88_151,0.99,-5,146,151,72
34,r_14_86_16,r_33_56_195,seq144,r_14_86_16,0.66,1,17,16,72
70,seq43,r_109_66_168,r_102_133_50,r_102_133_50,0.98,118,168,50,72
6,r_92_27_171,r_139_29_173,r_116_40_92,r_92_27_171,0.35,0,171,171,72
35,r_124_126_23,r_16_74_182,seq22,r_124_126_23,0.99,0,23,23,72
4,r_65_42_42,r_6_58_52,seq136,r_65_42_42,1.0,0,42,42,72
32,r_104_143_86,seq1,seq3,r_104_143_86,0.99,0,86,86,72
9,r_6_58_52,r_139_29_173,seq119,r_6_58_52,0.59,-2,50,52,72
37,r_10_80_20,r_50_84_82,r_116_40_92,r_10_80_20,0.95,0,20,20,72
59,seq130,seq20,r_113_146_33,r_113_146_33,1.0,-1,32,33,72
13,r_149_83_45,r_62_117_152,seq25,r_62_117_152,0.77,-108,44,152,72
17,r_94_135_149,seq100,r_85_18_126,r_94_135_149,0.9,0,149,149,72
37,r_10_80_20,r_116_40_92,r_15_9_111,r_116_40_92,1.0,-8,84,92,72
29,r_96_46_24,seq24,r_137_114_102,r_137_114_102,1.0,0,102,102,72
22,r_115_51_158,seq22,seq138,r_115_51_158,0.44,1,159,158,72
28,r_45_123_81,r_121_125_115,seq93,r_121_125_115,1.0,-36,79,115,72
49,r_38_105_186,seq110,r_103_72_9,r_38_105_186,0.51,0,186,186,72
7,r_59_61_90,r_57_88_151,seq100,r_57_88_151,0.9,-61,90,151,72
44,r_109_66_168,seq43,r_39_111_97,r_109_66_168,0.8,0,168,168,72
23,r_68_26_185,seq2,r_103_72_9,r_68_26_185,0.43,0,185,185,72
26,r_113_146_33,r_116_40_92,seq130,r_113_146_33,1.0,3,36,33,72
12,r_13_131_130,seq119,r_37_8_65,r_13_131_130,0.9,1,131,130,72
29,r_96_46_24,r_104_143_86,seq24,r_104_143_86,0.84,-61,25,86,72
30,r_9_70_109,seq122,r_48_1_170,r_9_70_109,0.94,0,109,109,73
12,r_19_63_45,r_11_41_93,r_37_134_176,r_19_63_45,0.96,2,47,45,73
8,r_17_7_29,r_0_147_114,r_55_93_54,r_55_93_54,0.98,46,100,54,73
37,r_52_24_145,seq79,r_0_147_114,r_0_147_114,0.71,61,175,114,73
16,r_25_15_172,r_66_112_77,r_133_74_11,r_66_112_77,1.0,0,77,77,73
1,r_142_3_117,r_98_57_122,seq101,r_142_3_117,0.87,1,118,117,73
83,seq94,r_37_134_176,r_131_110_40,r_131_110_40,1.0,8,48,40,73
5,r_0_147_114,r_17_7_29,seq72,r_0_147_114,0.77,1,115,114,73
46,r_144_44_189,seq16,r_58_22_108,r_58_22_108,1.0,4,112,108,73
24,r_5_12_83,r_51_36_165,r_61_20_115,r_5_12_83,0.57,83,166,83,73
4,r_29_10_46,r_48_1_170,seq116,r_29_10_46,1.0,0,46,46,73
36,r_128_148_44,r_85_54_65,r_133_74_11,r_128_148_44,1.0,0,44,44,73
39,r_121_91_5,r_25_15_172,r_133_74_11,r_25_15_172,1.0,0,172,172,73
31,r_23_84_144,r_48_1_170,r_133_74_11,r_23_84_144,0.7,1,145,144,73
42,r_55_93_54,r_118_53_73,r_17_7_29,r_55_93_54,0.82,0,54,54,73
10,r_30_31_87,seq99,seq124,r_30_31_87,0.46,0,87,87,73
26,r_48_1_170,r_23_84_144,r_9_70_109,r_48_1_170,0.9,-25,145,170,73
16,r_25_15_172,r_133_74_11,seq2,r_25_15_172,0.78,0,172,172,73
78,seq77,seq140,r_40_123_71,r_40_123_71,1.0,3,74,71,73
0,r_88_100_154,r_5_12_83,seq111,r_5_12_83,1.0,7,90,83,73
11,r_146_42_88,seq106,seq65,r_146_42_88,0.7,0,88,88,73
20,r_108_81_99,seq135,r_67_73_94,r_67_73_94,0.54,14,108,94,73
13,r_78_46_98,r_92_125_183,r_67_73_94,r_67_73_94,0.6,6,100,94,73
7,r_37_134_176,seq94,r_19_63_45,r_19_63_45,1.0,3,48,45,73
49,r_51_36_165,r_5_12_83,seq32,r_51_36_165,1.0,1,166,165,73
6,r_66_112_77,r_25_15_172,r_48_1_170,r_66_112_77,1.0,0,77,77,73
62,seq32,r_144_44_189,r_51_36_165,r_51_36_165,0.75,10,175,165,73
99,seq124,seq106,r_30_31_87,r_30_31_87,0.39,6,93,87,73
27,r_118_53_73,r_127_34_3,seq140,r_118_53_73,1.0,0,73,73,73
29,r_126_27_19,r_19_63_45,seq79,r_126_27_19,0.89,0,19,19,73
2,r_61_20_115,seq82,r_5_12_83,r_61_20_115,0.98,0,115,115,73
47,r_58_22_108,seq2,r_144_44_189,r_58_22_108,0.93,1,109,108,73
40,r_85_54_65,r_87_64_180,seq62,r_85_54_65,0.71,5,70,65,73
28,r_143_28_142,r_49_105_153,seq26,r_143_28_142,0.96,0,142,142,73
24,r_5_12_83,r_88_100_154,r_51_36_165,r_5_12_83,1.0,1,84,83,73
33,r_80_129_102,seq101,seq107,r_80_129_102,0.94,0,102,102,73
47,r_58_22_108,r_144_44_189,seq16,r_144_44_189,0.64,0,189,189,73
70,seq60,seq107,r_67_73_94,r_67_73_94,1.0,25,119,94,73
65,seq38,r_92_125_183,r_118_53_73,r_118_53_73,1.0,110,183,73,73
25,r_133_74_11,r_141_75_18,r_121_91_5,r_133_74_11,0.91,-1,10,11,73
61,seq26,r_87_64_180,r_143_28_142,r_143_28_142,0.98,15,157,142,73
32,r_149_102_110,r_142_3_117,seq103,r_149_102_110,0.99,3,113,110,73
38,r_49_105_153,seq119,r_88_100_154,r_49_105_153,0.82,0,153,153,73
19,r_89_117_50,seq139,seq43,r_89_117_50,1.0,0,50,50,73
34,r_98_57_122,r_142_3_117,r_48_1_170,r_98_57_122,0.92,-4,118,122,73
17,r_115_132_106,seq119,seq103,r_115_132_106,0.96,0,106,106,73
9,r_67_73_94,r_143_28_142,seq60,r_67_73_94,0.52,0,94,94,73
22,r_109_104_82,seq16,seq138,r_109_104_82,1.0,0,82,82,73
28,r_143_28_142,r_67_73_94,r_49_105_153,r_67_73_94,1.0,0,94,94,73
91,seq107,seq26,r_80_129_102,r_80_129_102,0.99,11,113,102,73
49,r_51_36_165,r_8_136_95,r_5_12_83,r_51_36_165,1.0,-70,95,165,73
72,seq65,r_146_42_88,r_52_24_145,r_146_42_88,0.5,63,151,88,73
56,seq140,seq113,r_118_53_73,r_118_53_73,1.0,88,161,73,73
44,r_8_136_95,r_51_36_165,r_67_73_94,r_8_136_95,0.98,0,95,95,73
43,r_59_45_24,r_48_1_170,seq77,r_59_45_24,0.98,-2,22,24,73
23,r_40_123_71,r_142_3_117,seq77,r_40_123_71,0.97,2,73,71,73
35,r_92_125_183,seq38,seq145,r_92_125_183,0.42,0,183,183,73
3,r_131_110_40,r_51_36_165,seq94,r_131_110_40,1.0,2,42,40,73
30,r_85_76_139,r_101_81_173,seq123,r_85_76_139,0.87,1,140,139,74
42,r_22_58_33,r_0_74_31,r_71_149_151,r_22_58_33,1.0,1,34,33,74
35,r_116_128_56,r_117_26_166,r_3_32_90,r_117_26_166,0.58,-31,135,166,74
8,r_90_35_129,r_121_43_165,seq24,r_90_35_129,0.97,0,129,129,74
53,seq134,seq82,r_60_145_47,r_60_145_47,0.98,85,132,47,74
43,r_40_92_85,r_127_16_160,r_9_137_180,r_127_16_160,0.8,-75,85,160,74
18,r_0_74_31,r_22_58_33,seq83,r_22_58_33,0.93,1,34,33,74
37,r_15_140_89,r_66_8_149,seq67,r_15_140_89,1.0,0,89,89,74
16,r_36_6_172,seq63,r_72_108_54,r_72_108_54,0.64,116,170,54,74
1,r_119_45_121,seq30,seq95,r_119_45_121,0.71,3,124,121,74
6,r_60_145_47,r_116_128_56,seq134,r_60_145_47,0.92,9,56,47,74
45,r_64_41_134,seq18,r_3_32_90,r_64_41_134,0.96,0,134,134,74
13,r_129_75_19,r_126_25_178,r_33_94_35,r_129_75_19,0.34,23,42,19,74
15,r_62_19_58,r_51_59_177,seq123,r_62_19_58,1.0,0,58,58,74
10,r_72_108_54,seq95,seq56,r_72_108_54,0.97,3,57,54,74
39,r_71_149_151,r_36_6_172,r_22_58_33,r_22_58_33,1.0,10,43,33,74
19,r_3_32_90,r_61_125_11,r_126_25_178,r_3_32_90,0.63,9,99,90,74
95,seq114,r_127_16_160,r_13_52_12,r_127_16_160,0.96,0,160,160,74
76,seq63,r_36_6_172,r_22_58_33,r_22_58_33,1.0,86,119,33,74
96,seq115,r_146_100_55,r_144_136_97,r_146_100_55,1.0,1,56,55,74
39,r_71_149_151,r_22_58_33,seq123,r_71_149_151,0.9,1,152,151,74
31,r_29_20_185,seq83,r_61_125_11,r_29_20_185,0.19,0,185,185,74
3,r_144_136_97,r_109_50_188,seq115,r_144_136_97,0.63,8,105,97,74
4,r_37_106_108,seq123,r_78_55_62,r_37_106_108,0.99,1,109,108,74
38,r_146_100_55,seq115,r_80_57_67,r_146_100_55,1.0,0,55,55,74
20,r_27_69_117,r_132_2_163,r_70_148_59,r_27_69_117,0.43,1,118,117,74
2,r_117_26_166,r_116_128_56,r_66_8_149,r_117_26_166,0.88,0,166,166,74
46,r_33_94_35,seq38,r_129_75_19,r_33_94_35,0.77,13,48,35,74
27,r_68_11_111,seq142,r_72_108_54,r_68_11_111,0.97,0,111,111,74
87,seq95,seq104,r_119_45_121,r_119_45_121,0.8,18,139,121,74
35,r_116_128_56,r_60_145_47,r_78_55_62,r_60_145_47,0.64,9,56,47,74
47,r_12_79_109,r_66_8_149,r_15_140_89,r_66_8_149,1.0,-40,109,149,74
29,r_99_49_143,r_66_8_149,r_90_35_129,r_66_8_149,0.82,-6,143,149,74
24,r_121_43_165,r_90_35_129,r_77_120_95,r_90_35_129,0.76,0,129,129,74
33,r_78_55_62,r_70_148_59,seq124,r_78_55_62,0.69,1,63,62,74
35,r_116_128_56,r_78_55_62,r_117_26_166,r_116_128_56,0.63,35,91,56,74
42,r_22_58_33,r_71_149_151,seq63,r_71_149_151,0.95,-3,148,151,74
32,r_105_47_181,r_66_8_149,r_116_128_56,r_105_47_181,0.54,-1,180,181,74
17,r_113_23_98,seq24,seq30,r_113_23_98,0.65,3,101,98,74
49,r_93_42_64,r_64_41_134,seq123,r_93_42_64,0.6,1,65,64,74
44,r_77_120_95,seq138,seq141,r_77_120_95,0.45,7,102,95,74
23,r_51_59_177,r_126_25_178,r_90_35_129,r_90_35_129,0.98,50,179,129,74
35,r_116_128_56,r_3_32_90,r_105_47_181,r_105_47_181,0.96,-1,180,181,74
79,seq73,r_132_2_163,r_90_35_129,r_90_35_129,0.92,3,132,129,74
12,r_122_107_137,seq147,r_80_57_67,r_122_107_137,0.97,0,137,137,74
14,r_112_30_144,seq42,r_16_129_28,r_112_30_144,0.73,0,144,144,75
8,r_59_70_108,seq12,seq21,r_59_70_108,1.0,0,108,108,75
43,r_101_128_81,seq4,r_82_81_29,r_101_128_81,1.0,0,81,81,75
37,r_26_71_103,seq96,seq99,r_26_71_103,1.0,0,103,103,75
3,r_60_39_163,r_86_113_22,seq37,r_60_39_163,0.81,1,164,163,75
3,r_60_39_163,r_16_129_28,r_86_113_22,r_86_113_22,1.0,0,22,22,75
86,seq96,r_26_71_103,r_16_129_28,r_26_71_103,0.97,0,103,103,75
21,r_10_105_97,r_47_76_127,seq29,r_10_105_97,0.58,2,99,97,75
1,r_34_49_107,seq4,seq106,r_34_49_107,1.0,0,107,107,75
46,r_0_18_93,seq148,seq114,r_0_18_93,0.73,6,99,93,75
41,r_86_113_22,seq141,r_60_39_163,r_86_113_22,0.99,0,22,22,75
26,r_149_72_91,seq54,r_35_145_145,r_149_72_91,0.91,-3,88,91,75
0,r_100_74_158,seq146,r_138_52_192,r_100_74_158,0.89,0,158,158,75
11,r_139_77_58,r_149_72_91,r_2_38_76,r_2_38_76,0.93,-15,61,76,75
20,r_27_80_84,seq44,r_17_55_143,r_27_80_84,1.0,0,84,84,75
13,r_35_145_145,seq114,r_149_72_91,r_149_72_91,1.0,28,119,91,75
62,seq21,seq148,r_59_70_108,r_59_70_108,1.0,3,111,108,75
19,r_22_122_55,r_36_25_112,r_134_79_26,r_134_79_26,0.77,29,55,26,75
6,r_82_81_29,r_138_52_192,seq90,r_82_81_29,1.0,0,29,29,75
45,r_73_19_47,r_35_145_145,r_82_81_29,r_73_19_47,0.98,1,48,47,75
10,r_117_14_25,r_149_72_91,r_123_13_79,r_117_14_25,0.72,66,91,25,75
27,r_136_110_164,seq99,seq15,r_136_110_164,0.57,2,166,164,75
48,r_147_61_35,seq15,r_91_132_5,r_147_61_35,0.91,0,35,35,75
2,r_36_25_112,seq12,r_134_79_26,r_36_25_112,1.0,0,112,112,75
41,r_86_113_22,r_60_39_163,seq6,r_60_39_163,0.98,1,164,163,75
40,r_133_97_89,seq94,seq45,r_133_97_89,0.95,3,92,89,75
18,r_63_53_141,seq45,r_125_142_118,r_125_142_118,0.7,26,144,118,75
35,r_64_67_31,r_16_129_28,r_116_50_99,r_116_50_99,1.0,1,100,99,75
25,r_66_109_62,r_133_97_89,r_91_132_5,r_66_109_62,1.0,2,64,62,75
33,r_95_65_96,r_100_74_158,seq124,r_95_65_96,0.89,8,104,96,75
88,seq99,r_138_52_192,r_126_33_129,r_126_33_129,0.99,17,146,129,75
38,r_17_55_143,r_75_119_196,r_138_52_192,r_17_55_143,0.52,3,146,143,75
34,r_116_50_99,seq24,r_64_67_31,r_116_50_99,0.99,0,99,99,75
58,seq141,r_86_113_22,seq62,r_86_113_22,0.99,-2,20,22,75
36,r_16_129_28,seq5,r_69_92_38,r_69_92_38,0.72,-1,37,38,75
17,r_125_142_118,r_75_119_196,seq29,r_125_142_118,1.0,1,119,118,75
9,r_123_13_79,r_138_52_192,r_117_14_25,r_123_13_79,1.0,0,79,79,75
32,r_134_79_26,r_47_76_127,seq31,r_134_79_26,0.77,4,30,26,75
22,r_126_33_129,r_112_30_144,r_26_71_103,r_126_33_129,0.8,0,129,129,75
28,r_47_76_127,seq137,seq146,r_47_76_127,0.82,-2,125,127,75
91,seq106,seq15,r_34_49_107,r_34_49_107,1.0,0,107,107,75
10,r_117_14_25,r_35_145_145,r_149_72_91,r_117_14_25,0.97,0,25,25,75
35,r_64_67_31,r_35_145_145,r_16_129_28,r_64_67_31,0.82,1,32,31,75
23,r_3_20_177,seq31,r_59_70_108,r_59_70_108,1.0,72,180,108,75
47,r_69_92_38,r_85_88_60,r_16_129_28,r_69_92_38,0.97,0,38,38,75
44,r_84_108_53,r_138_52_192,seq32,r_84_108_53,1.0,0,53,53,75
30,r_85_64_99,seq11,seq23,r_85_64_99,1.0,1,100,99,76
36,r_146_22_136,seq3,seq99,r_146_22_136,0.83,0,136,136,76
8,r_15_106_170,seq25,r_110_17_145,r_15_106_170,0.46,1,171,170,76
49,r_126_51_58,r_110_17_145,r_82_1_199,r_126_51_58,1.0,0,58,58,76
43,r_9_36_109,r_82_1_199,r_115_32_95,r_82_1_199,0.98,-89,110,199,76
59,seq13,r_142_105_65,seq104,r_142_105_65,1.0,1,66,65,76
55,seq136,r_60_111_149,r_8_80_41,r_8_80_41,0.71,108,149,41,76
16,r_75_65_86,seq3,r_117_120_78,r_75_65_86,0.94,1,87,86,76
39,r_110_17_145,seq63,seq125,r_110_17_145,0.95,0,145,145,76
46,r_42_5_187,seq112,r_96_101_30,r_42_5_187,0.49,0,187,187,76
5,r_58_21_48,r_77_97_97,seq10,r_58_21_48,0.97,0,48,48,76
47,r_130_128_105,seq89,r_86_79_146,r_86_79_146,0.85,7,153,146,76
32,r_76_71_47,seq148,seq109,r_76_71_47,1.0,0,47,47,76
95,seq112,r_42_5_187,r_16_90_12,r_16_90_12,0.63,175,187,12,76
13,r_12_26_57,r_73_78_154,seq6,r_12_26_57,1.0,1,58,57,76
41,r_129_141_167,seq113,r_103_39_168,r_129_141_167,0.57,1,168,167,76
3,r_103_39_168,seq125,r_129_141_167,r_103_39_168,0.54,-14,154,168,76
20,r_122_38_53,r_87_118_32,r_74_67_38,r_122_38_53,0.79,6,59,53,76
90,seq100,r_131_44_132,r_122_38_53,r_131_44_132,0.38,18,150,132,76
26,r_115_32_95,r_117_120_78,r_12_26_57,r_117_120_78,1.0,16,94,78,76
0,r_16_90_12,r_45_84_108,r_95_14_33,r_95_14_33,0.53,76,109,33,76
11,r_34_20_13,r_12_26_57,seq148,r_34_20_13,0.99,1,14,13,76
48,r_48_70_122,r_73_78_154,r_96_101_30,r_48_70_122,0.91,0,122,122,76
6,r_88_40_93,seq18,seq13,r_88_40_93,0.75,1,94,93,76
15,r_8_80_41,r_42_5_187,seq140,r_8_80_41,0.98,2,43,41,76
10,r_45_84_108,r_16_90_12,r_82_1_199,r_45_84_108,0.85,0,108,108,76
27,r_60_111_149,seq136,r_87_118_32,r_60_111_149,0.52,0,149,149,76
2,r_82_1_199,seq29,r_126_51_58,r_126_51_58,1.0,39,97,58,76
47,r_130_128_105,seq140,seq89,r_130_128_105,0.84,0,105,105,76
18,r_135_33_159,seq121,r_87_118_32,r_135_33_159,0.59,0,159,159,76
29,r_77_97_97,seq99,seq3,r_77_97_97,0.96,0,97,97,76
25,r_53_4_166,seq72,seq57,r_53_4_166,0.82,0,166,166,76
40,r_31_30_17,r_85_64_99,seq72,r_31_30_17,1.0,1,18,17,76
21,r_95_14_33,r_131_44_132,r_16_90_12,r_95_14_33,0.61,0,33,33,76
38,r_117_120_78,r_115_32_95,r_75_65_86,r_117_120_78,0.71,16,94,78,76
34,r_123_133_157,r_15_106_170,r_54_132_28,r_123_133_157,0.47,0,157,157,76
94,seq109,r_73_78_154,r_76_71_47,r_76_71_47,1.0,80,127,47,76
9,r_114_149_178,seq52,r_8_80_41,r_8_80_41,0.99,137,178,41,76
22,r_37_116_70,r_88_40_93,r_74_67_38,r_37_116_70,1.0,5,75,70,76
28,r_142_105_65,seq13,seq66,r_142_105_65,1.0,1,66,65,76
91,seq104,r_54_132_28,r_88_40_93,r_88_40_93,0.75,7,100,93,76
44,r_28_41_81,r_137_139_111,r_8_80_41,r_8_80_41,0.47,51,92,41,76
23,r_131_44_132,r_15_106_170,r_81_24_19,r_131_44_132,0.84,0,132,132,76
10,r_45_84_108,r_103_39_168,r_16_90_12,r_16_90_12,0.96,4,16,12,76
12,r_59_35_129,r_37_116_70,r_76_71_47,r_76_71_47,0.76,45,92,47,76
8,r_146_144_178,seq38,seq120,r_146_144_178,0.56,0,178,178,77
16,r_124_83_109,r_81_8_163,seq7,r_124_83_109,0.97,0,109,109,77
21,r_63_104_189,seq100,r_33_108_115,r_33_108_115,0.99,74,189,115,77
39,r_52_37_155,seq59,r_17_76_19,r_52_37_155,0.63,1,156,155,77
5,r_1_107_78,seq53,r_44_91_13,r_1_107_78,0.81,0,78,78,77
42,r_140_31_177,seq53,r_33_108_115,r_33_108_115,0.99,62,177,115,77
43,r_22_99_40,r_16_27_96,r_81_8_163,r_22_99_40,1.0,0,40,40,77
37,r_46_126_20,seq70,seq7,r_46_126_20,0.97,1,21,20,77
19,r_94_145_100,seq36,r_89_34_95,r_94_145_100,1.0,0,100,100,77
33,r_142_50_9,r_134_6_129,r_137_132_47,r_142_50_9,1.0,115,124,9,77
11,r_81_8_163,r_15_2_86,seq38,r_81_8_163,0.9,0,163,163,77
31,r_123_0_138,r_140_31_177,r_15_2_86,r_140_31_177,0.88,-39,138,177,77
97,seq119,r_11_88_80,r_35_78_52,r_35_78_52,1.0,1,53,52,77
10,r_112_84_84,seq7,seq101,r_112_84_84,1.0,0,84,84,77
26,r_147_111_71,r_146_144_178,r_11_88_80,r_147_111_71,1.0,1,72,71,77
6,r_69_106_58,seq100,seq82,r_69_106_58,1.0,0,58,58,77
4,r_33_108_115,seq58,r_124_83_109,r_33_108_115,1.0,2,117,115,77
78,seq62,r_103_20_123,seq120,r_103_20_123,0.98,2,125,123,77
0,r_90_97_146,seq149,r_102_14_55,r_102_14_55,1.0,92,147,55,77
11,r_81_8_163,r_124_83_109,r_15_2_86,r_81_8_163,0.98,-77,86,163,77
30,r_41_117_31,r_81_8_163,seq136,r_41_117_31,1.0,0,31,31,77
5,r_1_107_78,r_44_91_13,r_130_3_97,r_130_3_97,0.99,3,100,97,77
27,r_141_40_142,seq139,r_19_47_124,r_141_40_142,0.9,0,142,142,77
49,r_16_27_96,r_22_99_40,seq70,r_22_99_40,1.0,-12,28,40,77
12,r_11_88_80,r_113_92_113,seq129,r_11_88_80,0.52,-52,28,80,77
30,r_41_117_31,seq136,r_147_111_71,r_147_111_71,1.0,56,127,71,77
47,r_19_47_124,seq100,r_141_40_142,r_141_40_142,0.98,4,146,142,77
14,r_116_18_27,r_35_78_52,seq66,r_116_18_27,1.0,0,27,27,77
48,r_109_105_45,r_89_34_95,seq139,r_109_105_45,1.0,0,45,45,77
40,r_103_20_123,seq62,seq110,r_103_20_123,1.0,2,125,123,77
29,r_118_114_105,seq139,r_17_76_19,r_17_76_19,0.9,104,123,19,77
24,r_65_143_126,seq139,r_73_39_12,r_65_143_126,0.57,1,127,126,77
25,r_130_3_97,seq7,r_1_107_78,r_1_107_78,0.95,19,97,78,77
43,r_22_99_40,r_81_8_163,r_15_2_86,r_15_2_86,0.89,49,135,86,77
64,seq36,r_94_145_100,seq148,r_94_145_100,1.0,0,100,100,77
20,r_17_76_19,r_33_108_115,seq43,r_17_76_19,0.93,0,19,19,77
18,r_102_14_55,r_25_4_199,seq80,r_102_14_55,1.0,0,55,55,77
32,r_127_23_141,seq74,r_90_97_146,r_127_23_141,0.6,7,148,141,77
80,seq67,r_89_34_95,r_44_91_13,r_44_91_13,0.84,15,28,13,77
75,seq59,r_52_37_155,r_41_117_31,r_41_117_31,1.0,125,156,31,77
9,r_15_2_86,seq80,r_22_99_40,r_15_2_86,0.99,0,86,86,77
17,r_44_91_13,r_32_135_161,seq67,r_44_91_13,1.0,0,13,13,77
22,r_131_79_85,seq58,seq49,r_131_79_85,0.82,4,89,85,77
41,r_137_132_47,seq82,r_142_50_9,r_137_132_47,1.0,1,48,47,77
7,r_89_34_95,seq67,seq70,r_89_34_95,0.87,0,95,95,77
44,r_113_92_113,seq74,r_73_39_12,r_73_39_12,0.63,112,124,12,77
23,r_133_51_171,seq129,r_112_84_84,r_112_84_84,0.99,89,173,84,77
35,r_71_42_67,r_52_37_155,seq58,r_71_42_67,0.74,-3,64,67,77
49,r_11_38_44,seq52,r_112_95_28,r_11_38_44,0.55,0,44,44,78
14,r_98_27_161,r_39_113_180,r_64_46_101,r_98_27_161,0.71,0,161,161,78
37,r_5_86_65,seq45,seq37,r_5_86_65,1.0,0,65,65,78
86,seq75,r_124_73_179,seq59,r_124_73_179,0.75,0,179,179,78
16,r_53_20_178,seq141,r_122_119_113,r_122_119_113,0.98,63,176,113,78
21,r_96_4_14,r_98_27_161,r_122_119_113,r_122_119_113,0.66,48,161,113,78
5,r_102_63_195,r_115_77_107,r_36_101_71,r_36_101_71,0.98,37,108,71,78
46,r_30_130_134,seq60,r_17_103_83,r_30_130_134,0.64,3,137,134,78
42,r_23_26_184,seq136,r_39_113_180,r_23_26_184,0.48,0,184,184,78
80,seq60,r_30_130_134,seq141,r_30_130_134,0.86,-48,86,134,78
45,r_115_77_107,r_102_63_195,r_17_103_83,r_115_77_107,0.93,1,108,107,78
11,r_100_74_166,r_1_145_25,seq37,r_1_145_25,0.53,141,166,25,78
76,seq51,r_98_27_161,r_122_119_113,r_122_119_113,0.75,43,156,113,78
41,r_64_46_101,r_104_6_12,seq143,r_64_46_101,0.89,0,101,101,78
10,r_80_19_186,seq48,r_71_42_9,r_80_19_186,0.49,0,186,186,78
26,r_43_54_136,r_80_19_186,r_116_18_57,r_116_18_57,0.97,80,137,57,78
0,r_70_87_127,seq110,seq50,r_70_87_127,0.43,1,128,127,78
11,r_100_74_166,r_90_15_194,r_1_145_25,r_1_145_25,0.95,50,75,25,78
20,r_126_123_42,seq12,seq61,r_126_123_42,0.92,21,63,42,78
13,r_39_113_180,r_96_4_14,r_78_56_55,r_78_56_55,0.9,127,182,55,78
48,r_93_139_85,r_98_27_161,seq40,r_93_139_85,0.99,1,86,85,78
6,r_29_133_77,seq75,r_128_0_3,r_29_133_77,1.0,0,77,77,78
27,r_65_131_141,r_124_73_179,r_83_148_115,r_65_131_141,0.97,0,141,141,78
47,r_44_9_91,seq127,seq82,r_44_9_91,0.98,0,91,91,78
40,r_76_146_119,seq135,r_140_41_95,r_140_41_95,0.61,34,129,95,78
18,r_94_129_98,seq137,seq48,r_94_129_98,0.86,12,110,98,78
22,r_112_95_28,r_115_77_107,r_11_38_44,r_112_95_28,0.86,36,64,28,78
25,r_78_56_55,r_58_25_167,seq35,r_78_56_55,0.94,9,64,55,78
43,r_1_145_25,r_100_74_166,r_92_21_168,r_1_145_25,0.85,143,168,25,78
61,seq16,r_8_7_112,seq3,r_8_7_112,1.0,1,113,112,78
32,r_83_148_115,seq91,seq60,r_83_148_115,0.81,1,116,115,78
22,r_112_95_28,r_100_74_166,r_115_77_107,r_112_95_28,0.96,2,30,28,78
3,r_14_105_31,r_78_56_55,seq37,r_14_105_31,1.0,0,31,31,78
60,seq143,r_122_119_113,r_64_46_101,r_122_119_113,0.89,0,113,113,78
17,r_69_121_146,r_80_19_186,r_17_103_83,r_80_19_186,0.76,-40,146,186,78
4,r_134_114_16,r_102_63_195,seq138,r_134_114_16,0.95,1,17,16,78
9,r_55_81_174,seq62,r_79_88_22,r_55_81_174,0.54,0,174,174,78
96,seq110,r_70_87_127,r_79_88_22,r_70_87_127,0.72,1,128,127,78
43,r_1_145_25,seq22,r_100_74_166,r_1_145_25,1.0,0,25,25,78
7,r_36_101_71,r_55_81_174,r_102_63_195,r_36_101_71,1.0,0,71,71,78
19,r_57_144_24,r_39_113_180,seq61,r_57_144_24,0.67,6,30,24,78
44,r_120_99_128,seq24,seq138,r_120_99_128,0.93,0,128,128,78
23,r_17_103_83,r_79_88_22,seq12,r_17_103_83,0.89,19,102,83,78
12,r_140_41_95,seq10,r_94_129_98,r_140_41_95,0.97,8,103,95,78
63,seq32,r_129_57_47,seq15,r_129_57_47,1.0,1,48,47,79
30,r_129_57_47,seq32,seq54,r_129_57_47,1.0,0,47,47,79
83,seq85,r_121_146_169,r_111_59_145,r_111_59_145,0.5,26,171,145,79
2,r_115_2_33,seq52,seq37,r_115_2_33,0.85,0,33,33,79
16,r_143_87_74,seq42,seq74,r_143_87_74,1.0,0,74,74,79
39,r_24_106_109,r_67_30_124,r_31_91_16,r_67_30_124,0.87,-15,109,124,79
46,r_49_28_99,seq7,seq20,r_49_28_99,0.84,2,101,99,79
5,r_19_141_48,r_103_0_89,seq131,r_19_141_48,1.0,0,48,48,79
42,r_66_6_179,seq7,r_65_38_176,r_65_38_176,0.46,5,181,176,79
45,r_17_109_79,seq33,seq3,r_17_109_79,0.98,1,80,79,79
31,r_111_59_145,r_18_53_90,seq33,r_111_59_145,0.73,6,151,145,79
67,seq42,r_143_87_74,r_116_29_13,r_143_87_74,0.96,0,74,74,79
10,r_67_30_124,r_119_12_196,seq79,r_67_30_124,0.81,0,124,124,79
4,r_93_73_87,r_49_28_99,seq27,r_49_28_99,0.79,-7,92,99,79
0,r_25_68_174,r_126_122_165,seq54,r_25_68_174,0.58,1,175,174,79
13,r_99_72_83,seq139,seq27,r_99_72_83,0.9,0,83,83,79
15,r_140_14_167,seq89,r_103_0_89,r_140_14_167,0.81,0,167,167,79
48,r_60_113_69,r_140_14_167,r_115_2_33,r_60_113_69,1.0,0,69,69,79
57,seq15,seq3,r_48_70_93,r_48_70_93,1.0,20,113,93,79
40,r_121_146_169,seq85,r_90_145_18,r_121_146_169,0.45,2,171,169,79
29,r_82_47_110,seq22,r_124_134_7,r_82_47_110,0.99,0,110,110,79
33,r_126_122_165,r_25_68_174,seq102,r_126_122_165,0.61,0,165,165,79
25,r_64_13_53,seq37,seq22,r_64_13_53,1.0,0,53,53,79
20,r_63_81_19,seq55,seq74,r_63_81_19,0.86,0,19,19,79
50,seq3,seq15,r_1_45_119,r_1_45_119,0.99,20,139,119,79
70,seq52,r_115_2_33,r_31_91_16,r_31_91_16,0.67,-1,15,16,79
32,r_1_45_119,r_67_30_124,seq3,r_1_45_119,0.87,0,119,119,79
36,r_4_78_21,r_123_39_168,seq51,r_4_78_21,1.0,0,21,21,79
34,r_46_94_118,seq41,seq71,r_46_94_118,0.94,1,119,118,79
99,seq125,seq10,r_138_97_28,r_138_97_28,1.0,13,41,28,79
1,r_138_97_28,r_143_87_74,seq125,r_138_97_28,0.79,3,31,28,79
94,seq114,r_80_136_125,r_128_107_42,r_80_136_125,1.0,1,126,125,79
9,r_103_0_89,r_9_36_134,r_60_113_69,r_103_0_89,1.0,2,91,89,79
38,r_31_91_16,r_140_14_167,seq52,r_31_91_16,0.97,-1,15,16,79
28,r_48_70_93,r_67_30_124,seq15,r_48_70_93,0.99,2,95,93,79
49,r_84_26_60,r_93_73_87,seq71,r_84_26_60,1.0,1,61,60,79
7,r_23_95_133,seq74,seq100,r_23_95_133,0.68,1,134,133,79
44,r_117_133_61,seq71,r_56_21_136,r_117_133_61,1.0,0,61,61,79
21,r_128_107_42,r_93_73_87,seq114,r_128_107_42,0.56,0,42,42,79
6,r_101_40_23,seq15,r_119_12_196,r_101_40_23,1.0,0,23,23,79
35,r_92_43_135,seq100,r_56_21_136,r_92_43_135,0.55,4,139,135,79
14,r_25_12_136,r_131_46_164,seq14,r_131_46_164,0.69,-26,138,164,80
8,r_137_114_163,seq83,r_61_78_180,r_137_114_163,0.82,3,166,163,80
37,r_125_9_4,r_23_79_91,r_0_90_92,r_125_9_4,0.81,89,93,4,80
39,r_102_64_132,r_122_112_145,seq138,r_122_112_145,0.78,-7,138,145,80
1,r_42_141_104,r_70_116_168,seq7,r_42_141_104,0.62,2,106,104,80
46,r_34_118_55,seq26,r_110_142_44,r_34_118_55,0.92,7,62,55,80
42,r_62_82_63,r_85_103_94,seq31,r_62_82_63,0.95,0,63,63,80
35,r_110_142_44,r_23_79_91,r_70_116_168,r_110_142_44,0.9,1,45,44,80
7,r_75_24_179,r_97_140_182,seq15,r_97_140_182,0.57,-3,179,182,80
45,r_80_127_178,seq38,r_73_40_118,r_80_127_178,0.67,0,178,178,80
19,r_77_55_149,r_50_20_152,seq86,r_50_20_152,0.45,-2,150,152,80
33,r_70_116_168,r_110_142_44,r_129_48_72,r_70_116_168,0.97,0,168,168,80
66,seq31,r_121_81_1,r_62_82_63,r_62_82_63,1.0,39,102,63,80
31,r_36_3_185,seq94,r_73_40_118,r_73_40_118,0.57,68,186,118,80
21,r_44_58_27,r_129_48_72,seq96,r_44_58_27,0.76,0,27,27,80
56,seq138,r_42_141_104,r_102_64_132,r_102_64_132,0.99,3,135,132,80
3,r_129_48_72,seq16,r_4_128_50,r_129_48_72,0.91,1,73,72,80
10,r_59_115_162,seq108,r_129_48_72,r_59_115_162,0.68,0,162,162,80
40,r_52_39_45,r_36_3_185,seq1,r_52_39_45,0.98,0,45,45,80
16,r_28_5_33,r_137_114_163,seq109,r_137_114_163,0.98,-30,133,163,80
4,r_51_135_121,r_149_123_127,r_43_2_100,r_51_135_121,0.65,0,121,121,80
0,r_45_21_171,seq38,seq108,r_45_21_171,0.51,0,171,171,80
73,seq56,r_13_54_147,r_18_133_6,r_18_133_6,0.74,77,83,6,80
11,r_149_123_127,r_51_135_121,r_8_71_123,r_51_135_121,0.82,6,127,121,80
20,r_60_100_67,r_75_24_179,seq132,r_60_100_67,1.0,0,67,67,80
16,r_28_5_33,r_65_10_36,r_137_114_163,r_28_5_33,1.0,1,34,33,80
27,r_43_2_100,r_122_112_145,seq22,r_43_2_100,0.86,2,102,100,80
2,r_131_46_164,seq143,r_129_48_72,r_129_48_72,0.65,94,166,72,80
29,r_50_20_152,seq35,seq22,r_50_20_152,0.56,3,155,152,80
35,r_110_142_44,r_70_116_168,r_34_118_55,r_70_116_168,1.0,0,168,168,80
25,r_0_90_92,seq126,r_125_9_4,r_0_90_92,0.96,0,92,92,80
33,r_70_116_168,r_42_141_104,r_110_142_44,r_70_116_168,0.75,-62,106,168,80
18,r_18_133_6,r_70_116_168,seq56,r_18_133_6,0.73,8,14,6,80
58,seq14,r_91_88_82,seq57,r_91_88_82,1.0,3,85,82,80
32,r_73_40_118,r_125_9_4,r_52_39_45,r_52_39_45,0.89,88,133,45,80
38,r_66_72_184,seq38,r_102_64_132,r_102_64_132,0.63,52,184,132,80
9,r_19_69_150,r_131_46_164,r_42_141_104,r_131_46_164,0.59,-14,150,164,80
22,r_23_79_91,r_125_9_4,seq119,r_23_79_91,0.96,0,91,91,80
28,r_91_88_82,seq14,seq16,r_91_88_82,0.93,3,85,82,80
56,seq138,r_85_103_94,r_42_141_104,r_85_103_94,0.94,2,96,94,80
7,r_75_24_179,r_60_100_67,r_97_140_182,r_60_100_67,1.0,0,67,67,80
44,r_8_71_123,r_122_112_145,r_4_128_50,r_122_112_145,0.64,-18,127,145,80
26,r_65_10_36,seq130,seq87,r_65_10_36,0.85,0,36,36,80
82,seq143,r_131_46_164,r_30_101_46,r_131_46_164,0.84,2,166,164,80
49,r_30_101_46,r_97_140_182,seq143,r_30_101_46,0.63,0,46,46,80
48,r_4_128_50,seq111,seq38,r_4_128_50,1.0,1,51,50,80
17,r_76_124_35,r_80_127_178,seq17,r_76_124_35,1.0,1,36,35,80
40,r_45_104_23,r_88_141_1,r_57_4_186,r_57_4_186,0.55,-11,175,186,81
30,r_47_97_155,seq68,seq112,r_47_97_155,0.68,0,155,155,81
14,r_118_132_81,r_12_113_161,seq35,r_118_132_81,1.0,2,83,81,81
43,r_23_82_110,seq15,r_62_58_5,r_23_82_110,0.69,3,113,110,81
54,seq6,r_50_74_195,r_103_70_91,r_103_70_91,0.74,24,115,91,81
16,r_31_10_151,seq35,r_83_65_27,r_31_10_151,0.97,0,151,151,81
21,r_147_34_73,r_53_3_159,seq39,r_147_34_73,1.0,0,73,73,81
39,r_114_64_167,seq5,r_53_3_159,r_114_64_167,0.63,0,167,167,81
1,r_21_119_86,seq14,seq68,r_21_119_86,1.0,0,86,86,81
5,r_12_113_161,r_118_132_81,seq75,r_118_132_81,1.0,2,83,81,81
46,r_126_7_113,seq110,r_102_76_43,r_126_7_113,0.98,0,113,113,81
42,r_80_78_95,r_144_61_108,r_83_65_27,r_144_61_108,0.95,-13,95,108,81
22,r_92_91_42,r_98_46_128,seq59,r_92_91_42,0.7,16,58,42,81
8,r_101_89_54,r_147_34_73,seq111,r_101_89_54,0.8,0,54,54,81
45,r_62_58_5,r_122_29_104,r_23_82_110,r_23_82_110,0.88,5,115,110,81
95,seq112,seq109,r_12_113_161,r_12_113_161,0.88,16,177,161,81
0,r_102_76_43,r_131_69_63,r_13_43_192,r_13_43_192,0.61,-149,43,192,81
76,seq60,r_86_1_153,seq17,r_86_1_153,0.95,1,154,153,81
41,r_9_37_140,r_47_97_155,seq28,r_9_37_140,0.91,0,140,140,81
3,r_54_140_90,seq17,r_148_81_13,r_54_140_90,0.89,0,90,90,81
26,r_98_46_128,seq28,r_126_7_113,r_98_46_128,0.93,5,133,128,81
36,r_95_72_48,r_23_82_110,r_88_141_1,r_95_72_48,0.95,1,49,48,81
4,r_142_124_119,seq35,seq84,r_142_124_119,0.93,3,122,119,81
78,seq67,r_57_4_186,r_95_72_48,r_95_72_48,0.95,19,67,48,81
38,r_120_42_28,r_23_82_110,r_83_65_27,r_120_42_28,1.0,1,29,28,81
11,r_63_90_132,seq145,r_88_141_1,r_63_90_132,0.84,0,132,132,81
57,seq130,r_92_91_42,r_62_58_5,r_92_91_42,0.85,6,48,42,81
48,r_86_1_153,seq60,r_103_70_91,r_86_1_153,0.74,1,154,153,81
62,seq149,r_133_77_190,r_40_16_121,r_40_16_121,1.0,46,167,121,81
5,r_12_113_161,seq75,seq112,r_12_113_161,0.87,3,164,161,81
0,r_102_76_43,r_13_43_192,r_126_7_113,r_126_7_113,1.0,12,125,113,81
2,r_133_77_190,seq149,r_103_70_91,r_103_70_91,0.7,99,190,91,81
7,r_11_24_47,r_50_74_195,seq115,r_11_24_47,1.0,0,47,47,81
47,r_40_16_121,seq51,seq149,r_40_16_121,1.0,0,121,121,81
18,r_131_69_63,r_40_16_121,seq8,r_131_69_63,0.8,1,64,63,81
24,r_144_61_108,r_52_136_2,r_50_74_195,r_144_61_108,0.93,1,109,108,81
25,r_137_127_96,r_13_43_192,r_148_81_13,r_137_127_96,0.99,1,97,96,81
33,r_53_3_159,r_93_19_158,seq28,r_93_19_158,0.6,0,158,158,81
13,r_88_141_1,r_131_69_63,r_95_72_48,r_88_141_1,1.0,49,50,1,81
35,r_83_65_27,r_63_90_132,r_120_42_28,r_83_65_27,1.0,2,29,27,81
40,r_45_104_23,seq59,r_88_141_1,r_45_104_23,0.9,0,23,23,81
17,r_13_43_192,r_137_127_96,r_102_76_43,r_13_43_192,0.96,-95,97,192,81
94,seq111,r_88_141_1,r_101_89_54,r_101_89_54,1.0,24,78,54,81
9,r_33_73_60,r_125_48_11,r_11_24_47,r_33_73_60,1.0,0,60,60,81
49,r_93_19_158,r_53_3_159,r_144_61_108,r_93_19_158,0.55,0,158,158,81
27,r_32_128_41,r_13_43_192,r_148_81_13,r_32_128_41,1.0,1,42,41,81
30,r_109_123_120,seq15,r_110_69_97,r_109_123_120,1.0,0,120,120,82
51,seq2,r_82_51_151,r_147_62_50,r_147_62_50,0.94,51,101,50,82
36,r_19_57_77,r_10_125_119,seq142,r_19_57_77,1.0,0,77,77,82
8,r_65_118_106,r_144_137_168,seq138,r_65_118_106,1.0,0,106,106,82
43,r_132_87_78,r_25_89_82,r_61_116_47,r_61_116_47,1.0,34,81,47,82
39,r_39_134_19,r_78_46_138,r_145_55_2,r_39_134_19,0.83,2,21,19,82
40,r_61_116_47,seq90,r_110_69_97,r_61_116_47,1.0,0,47,47,82
55,seq138,r_122_76_182,r_65_118_106,r_65_118_106,1.0,78,184,106,82
16,r_37_101_167,seq16,r_78_46_138,r_37_101_167,0.59,0,167,167,82
21,r_70_80_99,r_79_68_132,seq131,r_70_80_99,0.78,0,99,99,82
42,r_33_21_116,r_3_139_184,r_41_73_134,r_33_21_116,0.5,18,134,116,82
28,r_5_11_146,r_70_80_99,r_110_69_97,r_5_11_146,0.98,4,150,146,82
69,seq36,r_22_95_110,r_59_12_23,r_22_95_110,1.0,0,110,110,82
19,r_22_95_110,seq36,seq28,r_22_95_110,1.0,0,110,110,82
73,seq50,r_38_128_193,r_84_133_37,r_84_133_37,1.0,1,38,37,82
66,seq29,r_106_124_75,seq135,r_106_124_75,1.0,3,78,75,82
31,r_106_124_75,seq29,r_140_92_178,r_106_124_75,1.0,0,75,75,82
41,r_35_113_58,r_38_128_193,seq58,r_35_113_58,1.0,3,61,58,82
3,r_82_51_151,seq2,r_45_53_8,r_82_51_151,0.97,0,151,151,82
10,r_40_146_96,r_140_92_178,r_148_31_172,r_40_146_96,0.59,-8,88,96,82
90,seq100,r_78_46_138,r_86_54_122,r_86_54_122,0.86,17,139,122,82
2,r_141_64_29,r_71_74_174,r_39_134_19,r_141_64_29,0.81,0,29,29,82
59,seq16,r_37_101_167,r_30_126_10,r_30_126_10,1.0,0,10,10,82
11,r_140_92_178,r_40_146_96,r_106_124_75,r_106_124_75,0.79,11,86,75,82
15,r_25_89_82,r_107_112_126,seq13,r_25_89_82,0.95,-1,81,82,82
48,r_144_137_168,r_65_118_106,seq98,r_65_118_106,1.0,-5,101,106,82
6,r_41_73_134,r_43_14_179,seq142,r_41_73_134,0.71,5,139,134,82
27,r_10_125_119,seq72,seq27,r_10_125_119,0.98,0,119,119,82
47,r_66_81_118,r_10_125_119,seq93,r_66_81_118,0.99,1,119,118,82
18,r_117_94_173,seq47,seq8,r_117_94_173,0.69,0,173,173,82
29,r_79_68_132,r_70_80_99,r_9_85_105,r_70_80_99,0.9,0,99,99,82
24,r_129_97_117,r_122_76_182,r_110_69_97,r_129_97_117,0.73,1,118,117,82
25,r_42_60_165,seq2,r_59_12_23,r_42_60_165,0.92,1,166,165,82
48,r_144_137_168,seq98,seq20,r_144_137_168,0.98,0,168,168,82
39,r_39_134_19,r_145_55_2,r_141_64_29,r_141_64_29,0.84,14,43,29,82
70,seq135,r_122_76_182,seq29,r_122_76_182,0.87,-103,79,182,82
68,seq34,seq142,r_18_6_70,r_18_6_70,1.0,10,80,70,82
32,r_9_85_105,r_44_67_145,r_110_69_97,r_110_69_97,0.67,4,101,97,82
38,r_148_31_172,seq27,r_82_51_151,r_82_51_151,0.98,25,176,151,82
34,r_78_46_138,seq100,r_18_6_70,r_18_6_70,0.98,69,139,70,82
9,r_147_62_50,r_10_125_119,seq2,r_147_62_50,1.0,1,51,50,82
29,r_79_68_132,r_9_85_105,seq143,r_79_68_132,0.61,0,132,132,82
26,r_30_126_10,r_147_62_50,seq16,r_30_126_10,0.98,0,10,10,82
5,r_102_115_36,seq49,r_145_55_2,r_102_115_36,0.96,2,38,36,82
81,seq77,seq93,r_71_74_174,r_71_74_174,0.65,-2,172,174,82
17,r_110_69_97,r_79_68_132,r_129_97_117,r_129_97_117,0.73,15,132,117,82
28,r_5_11_146,r_149_4_131,r_70_80_99,r_70_80_99,0.72,2,101,99,82
49,r_149_4_131,r_5_11_146,seq24,r_149_4_131,0.48,0,131,131,82
7,r_86_54_122,seq16,seq100,r_86_54_122,0.93,0,122,122,82
44,r_43_14_179,seq143,r_149_4_131,r_149_4_131,0.4,48,179,131,82
23,r_18_6_70,seq16,seq34,r_18_6_70,1.0,0,70,70,82
20,r_45_53_8,r_3_139_184,r_30_126_10,r_45_53_8,1.0,2,10,8,82
35,r_122_76_182,seq138,r_70_80_99,r_70_80_99,0.95,85,184,99,82
4,r_84_133_37,r_102_115_36,seq50,r_84_133_37,1.0,0,37,37,82
93,seq103,r_142_44_132,r_27_42_65,r_27_42_65,0.61,67,132,65,83
40,r_7_45_50,seq22,r_108_18_100,r_108_18_100,1.0,10,110,100,83
8,r_56_148_71,r_30_92_136,seq39,r_56_148_71,1.0,1,72,71,83
53,seq132,r_122_38_149,seq33,r_122_38_149,0.89,2,151,149,83
37,r_99_138_68,r_142_44_132,r_24_12_32,r_99_138_68,0.82,0,68,68,83
59,seq11,r_43_51_146,seq107,r_43_51_146,1.0,1,147,146,83
55,seq134,r_30_92_136,r_27_42_65,r_27_42_65,0.9,72,137,65,83
39,r_64_49_164,seq118,seq32,r_64_49_164,0.87,0,164,164,83
5,r_19_140_130,seq55,r_76_59_185,r_19_140_130,0.94,0,130,130,83
46,r_149_90_156,r_64_49_164,seq85,r_149_90_156,0.51,1,157,156,83
42,r_115_25_85,r_113_62_183,seq9,r_115_25_85,0.95,1,86,85,83
69,seq39,r_100_137_176,r_56_148_71,r_56_148_71,1.0,105,176,71,83
43,r_106_72_48,r_0_128_199,seq50,r_106_72_48,1.0,1,49,48,83
40,r_7_45_50,seq85,seq22,r_7_45_50,0.98,0,50,50,83
31,r_23_31_81,seq9,r_57_125_2,r_23_31_81,0.53,13,94,81,83
20,r_110_79_56,seq87,r_74_40_107,r_74_40_107,1.0,1,108,107,83
3,r_91_1_113,seq111,r_57_125_2,r_91_1_113,0.94,2,115,113,83
10,r_74_40_107,seq116,r_110_79_56,r_74_40_107,0.95,1,108,107,83
47,r_6_98_40,r_68_77_170,seq135,r_6_98_40,0.94,0,40,40,83
26,r_68_77_170,seq20,r_108_18_100,r_108_18_100,1.0,72,172,100,83
4,r_60_81_171,r_53_10_173,r_24_12_32,r_24_12_32,0.74,138,170,32,83
0,r_16_34_118,r_76_59_185,seq132,r_16_34_118,0.93,1,119,118,83
63,seq20,r_68_77_170,r_43_51_146,r_43_51_146,0.97,26,172,146,83
2,r_57_125_2,seq143,r_73_69_47,r_73_69_47,1.0,9,56,47,83
20,r_110_79_56,r_108_18_100,seq87,r_110_79_56,0.83,9,65,56,83
13,r_37_84_115,seq89,seq21,r_37_84_115,1.0,0,115,115,83
6,r_67_48_177,seq141,seq86,r_67_48_177,0.62,0,177,177,83
85,seq87,r_27_42_65,r_110_79_56,r_27_42_65,1.0,0,65,65,83
99,seq123,r_139_119_17,r_7_45_50,r_7_45_50,0.99,44,94,50,83
34,r_73_69_47,seq21,r_57_125_2,r_73_69_47,0.94,3,50,47,83
74,seq55,r_19_140_130,seq8,r_19_140_130,1.0,0,130,130,83
24,r_27_42_65,seq87,seq89,r_27_42_65,1.0,0,65,65,83
33,r_122_38_149,seq132,r_19_140_130,r_19_140_130,0.71,21,151,130,83
12,r_24_12_32,r_139_119_17,seq143,r_24_12_32,0.96,0,32,32,83
58,seq9,r_23_31_81,r_115_25_85,r_115_25_85,1.0,9,94,85,83
61,seq143,r_26_41_160,r_24_12_32,r_24_12_32,0.97,31,63,32,83
32,r_108_18_100,r_122_38_149,r_7_45_50,r_108_18_100,0.99,1,101,100,83
38,r_120_65_137,r_67_48_177,r_74_40_107,r_67_48_177,0.79,-37,140,177,83
36,r_124_104_42,seq70,r_15_127_22,r_124_104_42,1.0,0,42,42,83
25,r_15_127_22,r_0_128_199,r_96_80_6,r_15_127_22,0.82,-1,21,22,83
64,seq21,r_67_48_177,r_37_84_115,r_37_84_115,0.93,1,116,115,83
17,r_4_114_181,r_113_62_183,r_19_140_130,r_19_140_130,0.89,51,181,130,83
22,r_17_133_189,seq135,r_27_42_65,r_27_42_65,1.0,124,189,65,83
7,r_113_62_183,r_4_114_181,seq130,r_113_62_183,0.52,0,183,183,83
44,r_43_51_146,seq11,seq20,r_43_51_146,0.91,1,147,146,83
35,r_29_35_125,seq94,seq22,r_29_35_125,0.98,0,125,125,83
64,seq21,r_73_69_47,r_67_48_177,r_73_69_47,0.89,3,50,47,83
30,r_138_67_151,r_56_94_158,seq96,r_138_67_151,0.73,0,151,151,84
19,r_47_10_44,r_99_119_166,seq141,r_47_10_44,1.0,-1,43,44,84
42,r_24_55_31,r_52_88_50,seq9,r_24_55_31,1.0,0,31,31,84
92,seq107,r_124_76_138,r_32_39_57,r_124_76_138,0.89,0,138,138,84
8,r_60_86_85,seq129,seq146,r_60_86_85,1.0,0,85,85,84
87,seq96,seq139,r_138_67_151,r_138_67_151,1.0,0,151,151,84
37,r_42_35_144,r_78_79_195,r_60_86_85,r_42_35_144,0.97,2,146,144,84
16,r_149_81_65,seq96,r_138_67_151,r_149_81_65,1.0,0,65,65,84
21,r_148_22_108,seq114,r_61_135_25,r_61_135_25,0.99,73,98,25,84
39,r_5_105_76,r_126_143_103,seq12,r_126_143_103,0.77,-29,74,103,84
1,r_89_6_94,seq9,seq19,r_89_6_94,1.0,2,96,94,84
46,r_56_94_158,r_137_84_110,r_149_81_65,r_149_81_65,1.0,0,65,65,84
45,r_95_49_173,seq139,r_121_14_11,r_95_49_173,0.64,1,174,173,84
89,seq101,r_8_134_28,r_2_82_96,r_2_82_96,1.0,23,119,96,84
13,r_65_83_184,seq140,r_92_68_30,r_65_83_184,1.0,0,184,184,84
0,r_32_39_57,seq23,r_8_134_28,r_8_134_28,0.97,30,58,28,84
3,r_1_57_188,seq0,r_138_67_151,r_1_57_188,0.38,0,188,188,84
26,r_136_118_136,seq141,r_54_43_68,r_54_43_68,1.0,69,137,68,84
16,r_149_81_65,r_138_67_151,r_137_84_110,r_138_67_151,1.0,0,151,151,84
88,seq131,r_42_35_144,r_52_88_50,r_52_88_50,0.95,-1,49,50,84
34,r_92_68_30,seq91,seq139,r_92_68_30,1.0,0,30,30,84
73,seq53,seq127,r_120_72_45,r_120_72_45,1.0,37,82,45,84
11,r_98_102_98,seq37,r_17_7_33,r_98_102_98,1.0,0,98,98,84
20,r_2_82_96,r_122_125_181,seq101,r_2_82_96,1.0,0,96,96,84
13,r_65_83_184,r_128_36_155,seq140,r_128_36_155,0.69,5,160,155,84
98,seq117,r_93_100_190,r_145_116_100,r_145_116_100,1.0,22,122,100,84
46,r_56_94_158,r_149_81_65,seq62,r_56_94_158,0.92,-2,156,158,84
48,r_137_84_110,r_56_94_158,r_40_103_37,r_137_84_110,0.94,-20,90,110,84
6,r_128_36_155,r_65_83_184,seq29,r_128_36_155,0.89,0,155,155,84
2,r_122_125_181,r_78_79_195,r_45_74_24,r_122_125_181,0.73,0,181,181,84
27,r_28_48_179,r_78_79_195,r_120_72_45,r_28_48_179,0.76,0,179,179,84
49,r_40_103_37,seq19,r_137_84_110,r_40_103_37,1.0,2,39,37,84
35,r_45_74_24,r_138_67_151,r_93_100_190,r_45_74_24,1.0,0,24,24,84
2,r_122_125_181,r_2_82_96,r_78_79_195,r_2_82_96,1.0,-22,74,96,84
4,r_61_135_25,r_78_79_195,seq133,r_61_135_25,0.98,-1,24,25,84
32,r_8_134_28,r_52_88_50,seq91,r_8_134_28,1.0,-1,27,28,84
24,r_64_123_180,seq12,r_121_14_11,r_121_14_11,0.55,171,182,11,84
15,r_90_59_53,seq101,seq23,r_90_59_53,0.93,0,53,53,84
63,seq23,seq127,r_90_59_53,r_90_59_53,1.0,0,53,53,84
50,seq0,r_1_57_188,r_61_135_25,r_61_135_25,0.92,163,188,25,84
58,seq12,r_64_123_180,r_5_105_76,r_5_105_76,1.0,106,182,76,84
77,seq139,r_95_49_173,r_92_68_30,r_92_68_30,0.88,144,174,30,84
28,r_142_16_35,r_32_39_57,r_112_144_9,r_142_16_35,1.0,0,35,35,84
89,seq101,r_90_59_53,r_8_134_28,r_8_134_28,0.81,25,53,28,84
17,r_124_76_138,seq107,seq3,r_124_76_138,1.0,0,138,138,84
22,r_99_119_166,seq53,seq85,r_99_119_166,0.68,0,166,166,84
10,r_63_13_55,r_33_66_194,seq4,r_63_13_55,1.0,0,55,55,84
23,r_145_116_100,seq106,seq117,r_145_116_100,1.0,0,100,100,84
25,r_52_88_50,seq140,seq131,r_52_88_50,1.0,-1,49,50,84
33,r_17_7_33,r_47_10_44,seq58,r_47_10_44,0.89,-15,29,44,84
12,r_54_43_68,r_95_49_173,seq0,r_54_43_68,1.0,0,68,68,84
7,r_120_72_45,r_128_36_155,seq53,r_120_72_45,1.0,0,45,45,84
30,r_46_66_65,r_93_40_159,seq112,r_46_66_65,0.9,1,66,65,85
36,r_10_125_137,seq21,r_147_109_25,r_147_109_25,0.8,117,142,25,85
8,r_113_31_149,r_17_57_157,seq95,r_113_31_149,0.48,-6,143,149,85
43,r_14_27_60,seq21,r_12_13_42,r_12_13_42,0.67,18,60,42,85
21,r_102_37_182,r_124_100_115,seq97,r_124_100_115,1.0,1,116,115,85
1,r_141_62_130,r_132_56_92,seq19,r_132_56_92,0.44,39,131,92,85
5,r_138_23_179,r_75_59_10,r_104_3_119,r_104_3_119,0.78,61,180,119,85
45,r_79_44_93,r_110_58_114,r_55_88_27,r_110_58_114,0.87,-21,93,114,85
57,seq142,r_136_103_172,r_147_109_25,r_147_109_25,0.99,-1,24,25,85
95,seq112,seq15,r_46_66_65,r_46_66_65,1.0,19,84,65,85
10,r_70_69_73,r_119_38_76,seq20,r_119_38_76,0.84,-1,75,76,85
19,r_147_109_25,seq5,seq142,r_147_109_25,0.97,-1,24,25,85
26,r_72_25_190,seq48,r_12_13_42,r_12_13_42,0.84,148,190,42,85
46,r_16_7_49,seq2,seq1,r_16_7_49,0.88,3,52,49,85
49,r_35_77_33,r_138_23_179,seq97,r_35_77_33,0.87,1,34,33,85
15,r_137_34_84,seq112,seq126,r_137_34_84,0.88,0,84,84,85
0,r_12_13_42,r_116_50_166,r_14_27_60,r_12_13_42,0.99,3,45,42,85
41,r_89_78_20,seq42,r_75_59_10,r_89_78_20,0.71,0,20,20,85
6,r_124_100_115,r_102_37_182,seq143,r_124_100_115,0.71,1,116,115,85
62,seq21,r_10_125_137,seq128,r_10_125_137,0.35,6,143,137,85
21,r_102_37_182,seq97,r_137_34_84,r_102_37_182,0.64,3,185,182,85
47,r_118_133_79,seq68,seq15,r_118_133_79,0.93,0,79,79,85
40,r_6_47_98,r_131_52_184,seq99,r_6_47_98,0.7,0,98,98,85
29,r_17_57_157,r_113_31_149,seq64,r_113_31_149,0.43,11,160,149,85
24,r_121_29_81,seq24,seq73,r_121_29_81,0.67,0,81,81,85
2,r_55_88_27,r_67_129_41,seq143,r_55_88_27,0.53,-3,24,27,85
58,seq15,seq112,r_118_133_79,r_118_133_79,0.95,5,84,79,85
65,seq32,r_41_84_118,r_63_26_131,r_41_84_118,1.0,1,119,118,85
32,r_148_115_135,r_75_59_10,r_61_22_95,r_61_22_95,0.52,41,136,95,85
34,r_9_0_99,seq68,seq108,r_9_0_99,0.37,2,101,99,85
9,r_45_90_72,seq68,seq64,r_45_90_72,0.85,6,78,72,85
22,r_136_103_172,seq142,seq8,r_136_103_172,0.57,0,172,172,85
23,r_81_101_62,r_70_69_73,seq48,r_81_101_62,0.84,1,63,62,85
31,r_11_117_53,r_149_30_148,seq142,r_11_117_53,0.71,4,57,53,85
35,r_119_38_76,r_70_69_73,seq5,r_119_38_76,0.86,-1,75,76,85
36,r_139_67_122,seq99,seq133,r_139_67_122,0.85,0,122,122,86
14,r_17_46_144,r_147_137_191,r_51_47_41,r_17_46_144,0.74,2,146,144,86
43,r_120_108_137,r_73_115_163,r_129_29_23,r_120_108_137,0.98,0,137,137,86
83,seq94,r_140_102_158,r_105_100_182,r_140_102_158,0.97,2,160,158,86
52,seq3,seq62,r_64_34_42,r_64_34_42,0.98,4,46,42,86
23,r_41_142_28,seq53,r_58_61_118,r_41_142_28,0.99,4,32,28,86
16,r_33_111_187,seq81,r_6_148_165,r_6_148_165,0.67,22,187,165,86
21,r_89_118_70,r_6_148_165,seq145,r_89_118_70,0.99,0,70,70,86
1,r_23_123_68,seq85,seq53,r_23_123_68,1.0,0,68,68,86
5,r_45_31_86,seq133,r_129_29_23,r_45_31_86,0.98,4,90,86,86
42,r_73_115_163,seq121,r_1_16_124,r_73_115_163,0.43,0,163,163,86
45,r_2_75_151,seq43,seq11,r_2_75_151,0.76,0,151,151,86
13,r_64_34_42,r_33_111_187,seq3,r_64_34_42,1.0,0,42,42,86
48,r_125_40_24,r_114_50_153,seq103,r_125_40_24,0.94,0,24,24,86
19,r_141_7_92,r_129_29_23,seq77,r_141_7_92,0.97,0,92,92,86
76,seq66,r_5_95_82,r_19_20_74,r_5_95_82,0.92,0,82,82,86
26,r_63_138_71,r_82_88_116,r_25_32_98,r_63_138_71,0.77,45,116,71,86
31,r_68_38_164,seq94,r_114_50_153,r_114_50_153,0.78,13,166,153,86
41,r_49_124_9,r_35_69_180,r_80_78_77,r_80_78_77,1.0,5,82,77,86
3,r_1_16_124,seq8,seq135,r_1_16_124,0.57,1,125,124,86
10,r_130_21_91,r_136_131_3,r_54_127_4,r_130_21_91,1.0,0,91,91,86
17,r_39_27_15,r_68_38_164,seq24,r_39_27_15,0.95,-3,12,15,86
26,r_63_138_71,r_130_21_91,r_82_88_116,r_63_138_71,0.99,5,76,71,86
0,r_6_148_165,seq93,r_136_131_3,r_136_131_3,0.71,171,174,3,86
20,r_122_132_60,seq3,seq96,r_122_132_60,1.0,0,60,60,86
15,r_12_15_129,seq110,r_51_47_41,r_12_15_129,0.74,1,130,129,86
6,r_4_83_76,r_13_65_178,seq62,r_4_83_76,1.0,0,76,76,86
27,r_71_86_117,seq121,r_82_88_116,r_71_86_117,0.94,1,118,117,86
2,r_25_32_98,r_33_111_187,seq107,r_25_32_98,0.92,0,98,98,86
40,r_140_102_158,seq94,r_64_34_42,r_64_34_42,1.0,118,160,42,86
18,r_35_69_180,r_49_124_9,r_89_118_70,r_89_118_70,0.91,113,183,70,86
29,r_80_78_77,seq96,r_49_124_9,r_80_78_77,1.0,0,77,77,86
24,r_129_29_23,r_141_7_92,r_45_31_86,r_129_29_23,0.81,69,92,23,86
25,r_13_65_178,seq101,r_23_123_68,r_23_123_68,0.98,110,178,68,86
33,r_19_20_74,seq24,seq66,r_19_20_74,0.91,8,82,74,86
38,r_98_22_121,r_139_67_122,seq97,r_98_22_121,0.89,1,122,121,86
75,seq62,r_68_38_164,r_4_83_76,r_4_83_76,0.98,6,82,76,86
60,seq145,r_114_50_153,r_89_118_70,r_89_118_70,0.97,12,82,70,86
9,r_76_84_183,seq110,r_1_16_124,r_1_16_124,0.48,59,183,124,86
22,r_114_50_153,seq106,seq93,r_114_50_153,0.87,0,153,153,86
49,r_5_95_82,seq66,r_60_72_17,r_5_95_82,0.9,0,82,82,86
44,r_92_70_155,seq66,seq93,r_92_70_155,0.7,2,157,155,86
82,seq93,r_6_148_165,r_92_70_155,r_92_70_155,0.59,19,174,155,86
35,r_82_88_116,r_49_124_9,r_71_86_117,r_82_88_116,0.99,1,117,116,86
34,r_60_72_17,r_35_69_180,seq8,r_60_72_17,0.82,1,18,17,86
12,r_42_143_63,seq85,seq26,r_42_143_63,1.0,0,63,63,86
8,r_14_59_39,r_58_61_118,seq66,r_14_59_39,0.77,3,42,39,86
30,r_68_41_60,r_67_12_121,r_44_17_63,r_68_41_60,1.0,1,61,60,87
36,r_144_63_100,r_141_18_172,seq2,r_144_63_100,0.96,0,100,100,87
14,r_141_18_172,r_66_93_178,r_89_57_39,r_89_57_39,0.63,137,176,39,87
8,r_84_36_118,r_25_98_136,r_13_37_1,r_25_98_136,0.59,-18,118,136,87
41,r_146_22_170,r_25_98_136,r_92_94_46,r_146_22_170,0.95,-121,49,170,87
43,r_125_129_75,r_124_120_135,r_27_122_73,r_27_122_73,0.94,3,76,73,87
6,r_0_81_18,seq42,seq109,r_0_81_18,0.95,0,18,18,87
37,r_111_121_148,r_137_58_169,seq108,r_111_121_148,0.74,1,149,148,87
19,r_91_113_28,r_103_88_26,seq80,r_91_113_28,1.0,0,28,28,87
16,r_49_29_6,r_55_51_183,r_112_62_43,r_112_62_43,0.65,141,184,43,87
21,r_28_107_77,r_97_117_194,r_142_143_32,r_28_107_77,1.0,2,79,77,87
39,r_66_93_178,seq139,r_19_31_40,r_66_93_178,0.46,0,178,178,87
1,r_9_118_186,seq138,r_50_15_199,r_50_15_199,0.77,-13,186,199,87
42,r_26_101_113,seq87,seq5,r_26_101_113,0.95,3,116,113,87
46,r_142_143_32,r_73_59_189,r_28_107_77,r_28_107_77,1.0,1,78,77,87
93,seq102,r_89_57_39,seq90,r_89_57_39,1.0,0,39,39,87
31,r_3_140_130,seq77,seq65,r_3_140_130,0.92,6,136,130,87
96,seq109,r_1_52_168,r_0_81_18,r_0_81_18,0.78,22,40,18,87
24,r_92_94_46,seq74,r_146_22_170,r_92_94_46,0.98,2,48,46,87
4,r_45_69_126,r_127_56_12,seq87,r_127_56_12,0.81,114,126,12,87
11,r_35_54_131,seq87,seq132,r_35_54_131,0.87,1,132,131,87
78,seq74,r_92_94_46,seq108,r_92_94_46,0.98,2,48,46,87
13,r_55_51_183,r_49_29_6,r_53_114_51,r_53_114_51,0.56,133,184,51,87
10,r_103_88_26,r_91_113_28,seq83,r_91_113_28,0.79,0,28,28,87
15,r_149_136_119,r_1_52_168,seq20,r_149_136_119,0.89,0,119,119,87
48,r_137_58_169,r_50_15_199,r_104_116_105,r_137_58_169,0.48,0,169,169,87
57,seq139,r_66_93_178,r_1_52_168,r_66_93_178,0.78,0,178,178,87
18,r_46_72_58,r_73_59_189,seq96,r_46_72_58,1.0,0,58,58,87
0,r_19_31_40,r_9_118_186,r_123_39_133,r_123_39_133,0.94,2,135,133,87
40,r_10_82_78,r_35_54_131,seq61,r_35_54_131,0.97,-53,78,131,87
29,r_27_122_73,seq86,r_0_81_18,r_27_122_73,0.99,2,75,73,87
46,r_142_143_32,r_146_22_170,r_73_59_189,r_142_143_32,0.74,1,33,32,87
25,r_44_17_63,seq132,r_68_41_60,r_44_17_63,1.0,0,63,63,87
34,r_53_114_51,r_148_7_197,seq40,r_53_114_51,1.0,0,51,51,87
33,r_124_120_135,seq85,seq128,r_124_120_135,0.79,1,136,135,87
88,seq87,r_35_54_131,r_45_69_126,r_35_54_131,0.99,1,132,131,87
50,seq128,r_30_64_59,r_124_120_135,r_124_120_135,0.67,-5,130,135,87
38,r_133_99_86,r_124_120_135,seq105,r_133_99_86,1.0,0,86,86,87
0,r_19_31_40,seq147,r_9_118_186,r_19_31_40,1.0,2,42,40,87
81,seq77,r_3_140_130,r_89_57_39,r_89_57_39,0.77,48,87,39,87
17,r_73_59_189,r_46_72_58,r_142_143_32,r_46_72_58,0.93,-4,54,58,87
2,r_89_57_39,seq102,seq77,r_89_57_39,0.96,0,39,39,87
91,seq96,r_137_58_169,r_46_72_58,r_46_72_58,0.81,0,58,58,87
22,r_25_98_136,r_135_47_193,seq145,r_25_98_136,0.95,0,136,136,87
49,r_50_15_199,r_137_58_169,seq83,r_137_58_169,1.0,0,169,169,87
7,r_11_131_159,seq147,r_149_136_119,r_149_136_119,0.78,44,163,119,87
44,r_123_39_133,r_124_120_135,r_19_31_40,r_123_39_133,0.9,1,134,133,87
17,r_73_59_189,r_142_143_32,r_49_29_6,r_142_143_32,0.23,157,189,32,87
30,r_112_145_163,seq109,seq53,r_112_145_163,0.72,1,164,163,88
36,r_28_27_86,seq17,r_137_124_191,r_28_27_86,0.3,6,92,86,88
14,r_0_127_154,seq90,seq135,r_0_127_154,0.82,1,155,154,88
8,r_88_3_178,seq135,r_69_21_5,r_88_3_178,0.46,0,178,178,88
43,r_6_67_62,r_0_127_154,seq56,r_6_67_62,1.0,2,64,62,88
37,r_22_45_114,seq129,seq102,r_22_45_114,1.0,0,114,114,88
19,r_133_134_11,seq130,r_23_5_142,r_23_5_142,0.97,2,144,142,88
16,r_74_20_77,r_95_79_166,r_6_67_62,r_74_20_77,0.97,1,78,77,88
21,r_121_82_118,seq102,r_69_21_5,r_121_82_118,0.99,0,118,118,88
39,r_142_7_177,r_146_98_106,r_49_105_83,r_142_7_177,0.99,-92,85,177,88
1,r_48_97_72,r_74_20_77,seq51,r_48_97_72,1.0,3,75,72,88
5,r_140_132_187,seq10,r_12_84_167,r_12_84_167,0.76,20,187,167,88
42,r_49_105_83,r_92_47_108,r_142_7_177,r_142_7_177,0.88,-94,83,177,88
58,seq19,r_0_127_154,r_139_148_78,r_139_148_78,0.92,0,78,78,88
39,r_142_7_177,r_49_105_83,r_83_85_149,r_49_105_83,0.9,93,176,83,88
31,r_61_107_59,r_83_85_149,seq90,r_83_85_149,0.74,-82,67,149,88
41,r_95_79_166,seq128,r_22_45_114,r_22_45_114,1.0,52,166,114,88
24,r_78_38_51,r_42_81_63,seq111,r_78_38_51,0.99,2,53,51,88
90,seq106,r_11_89_94,r_31_15_26,r_11_89_94,0.86,0,94,94,88
26,r_14_143_140,r_131_40_182,seq17,r_14_143_140,0.99,0,140,140,88
4,r_33_87_71,r_11_89_94,seq101,r_33_87_71,1.0,0,71,71,88
11,r_12_84_167,seq60,r_0_127_154,r_0_127_154,0.8,13,167,154,88
15,r_113_2_137,seq26,seq10,r_113_2_137,0.47,13,150,137,88
48,r_16_55_90,r_14_143_140,seq77,r_16_55_90,1.0,0,90,90,88
22,r_34_62_12,r_42_81_63,seq57,r_34_62_12,0.68,-2,10,12,88
57,seq17,r_28_27_86,r_14_143_140,r_14_143_140,0.98,0,140,140,88
36,r_28_27_86,r_137_124_191,r_131_40_182,r_28_27_86,0.44,101,187,86,88
10,r_108_99_40,r_29_50_174,r_112_145_163,r_29_50_174,0.67,-6,168,174,88
27,r_131_40_182,r_14_143_140,seq39,r_14_143_140,0.98,-16,124,140,88
2,r_11_89_94,seq106,r_103_18_8,r_11_89_94,1.0,0,94,94,88
47,r_63_32_117,r_95_79_166,seq135,r_63_32_117,0.93,0,117,117,88
40,r_31_15_26,r_142_7_177,seq106,r_31_15_26,1.0,0,26,26,88
74,seq60,r_12_84_167,r_146_98_106,r_146_98_106,1.0,61,167,106,88
18,r_123_93_129,seq46,r_69_21_5,r_123_93_129,0.99,0,129,129,88
29,r_114_75_80,seq60,seq90,r_114_75_80,1.0,0,80,80,88
27,r_131_40_182,seq39,r_28_27_86,r_131_40_182,0.81,0,182,182,88
25,r_65_149_157,seq68,seq71,r_65_149_157,0.69,0,157,157,88
19,r_133_134_11,r_104_64_183,seq130,r_133_134_11,0.89,0,11,11,88
33,r_137_124_191,r_144_141_73,r_28_27_86,r_144_141_73,0.98,1,74,73,88
6,r_43_96_189,r_113_2_137,r_117_4_54,r_117_4_54,1.0,0,54,54,88
88,seq101,seq60,r_33_87_71,r_33_87_71,1.0,0,71,71,88
6,r_43_96_189,r_117_4_54,r_91_116_37,r_43_96_189,0.39,0,189,189,88
20,r_1_66_56,seq60,r_113_2_137,r_1_66_56,0.97,0,56,56,88
20,r_1_66_56,r_113_2_137,r_92_47_108,r_92_47_108,1.0,9,117,108,88
70,seq56,seq53,r_91_116_37,r_91_116_37,1.0,11,48,37,88
42,r_49_105_83,r_142_7_177,r_69_21_5,r_142_7_177,0.77,1,178,177,88
61,seq26,r_113_2_137,r_92_47_108,r_92_47_108,1.0,42,150,108,88
32,r_30_9_67,r_11_89_94,r_69_21_5,r_30_9_67,1.0,0,67,67,88
38,r_35_115_103,r_137_124_191,r_74_20_77,r_35_115_103,0.97,2,105,103,88
10,r_108_99_40,seq130,r_29_50_174,r_108_99_40,0.6,2,42,40,88
45,r_117_4_54,r_43_96_189,r_14_143_140,r_14_143_140,0.96,49,189,140,88
9,r_42_81_63,seq77,r_6_67_62,r_42_81_63,1.0,0,63,63,88
28,r_139_148_78,r_29_50_174,seq19,r_139_148_78,1.0,2,80,78,88
56,seq13,r_146_98_106,r_69_21_5,r_146_98_106,1.0,0,106,106,88
44,r_144_141_73,r_137_124_191,seq94,r_144_141_73,0.98,0,73,73,88
23,r_29_50_174,r_139_148_78,r_8_44_15,r_139_148_78,1.0,2,80,78,88
82,seq77,seq109,r_16_55_90,r_16_55_90,1.0,39,129,90,88
3,r_91_116_37,r_12_84_167,seq56,r_91_116_37,0.99,0,37,37,88
35,r_83_85_149,seq73,r_14_143_140,r_14_143_140,0.98,10,150,140,88
12,r_146_98_106,seq13,seq60,r_146_98_106,0.99,0,106,106,88
45,r_117_4_54,r_1_66_56,r_43_96_189,r_43_96_189,0.99,-135,54,189,88
23,r_29_50_174,r_8_44_15,r_14_143_140,r_29_50_174,1.0,2,176,174,88
36,r_98_3_95,r_33_41_91,r_40_73_31,r_98_3_95,1.0,1,96,95,89
22,r_75_110_42,seq38,seq106,r_75_110_42,1.0,0,42,42,89
37,r_118_14_12,r_17_126_67,r_124_105_169,r_118_14_12,0.8,4,16,12,89
43,r_21_115_63,r_137_93_128,r_99_141_47,r_21_115_63,1.0,3,66,63,89
54,seq7,r_114_95_103,r_18_15_11,r_114_95_103,0.74,0,103,103,89
83,seq77,r_124_105_169,r_9_61_102,r_9_61_102,0.94,42,144,102,89
1,r_17_126_67,r_6_58_62,seq106,r_17_126_67,1.0,1,68,67,89
24,r_124_105_169,r_118_14_12,r_139_121_61,r_139_121_61,0.6,109,170,61,89
19,r_47_117_139,seq132,r_135_103_17,r_47_117_139,0.66,0,139,139,89
45,r_111_147_27,seq125,seq132,r_111_147_27,0.99,1,28,27,89
31,r_64_59_152,r_128_120_29,seq24,r_64_59_152,0.45,4,156,152,89
41,r_139_121_61,seq0,seq24,r_139_121_61,0.99,1,62,61,89
10,r_33_41_91,r_98_3_95,r_17_126_67,r_98_3_95,0.98,-4,91,95,89
8,r_43_119_23,r_60_71_60,r_98_3_95,r_43_119_23,1.0,0,23,23,89
26,r_116_26_113,r_128_120_29,r_79_35_14,r_116_26_113,0.92,0,113,113,89
8,r_43_119_23,r_98_3_95,r_135_103_17,r_98_3_95,0.77,6,101,95,89
14,r_146_56_51,r_149_107_107,seq82,r_149_107_107,0.47,14,121,107,89
20,r_9_61_102,seq16,seq77,r_9_61_102,0.95,1,103,102,89
13,r_86_87_173,r_129_145_195,r_40_73_31,r_40_73_31,0.97,143,174,31,89
48,r_149_107_107,r_146_56_51,r_20_134_85,r_149_107_107,0.88,6,113,107,89
15,r_20_134_85,seq51,r_40_73_31,r_40_73_31,0.9,61,92,31,89
48,r_149_107_107,seq49,r_146_56_51,r_146_56_51,0.79,15,66,51,89
94,seq106,r_85_90_30,r_17_126_67,r_17_126_67,0.9,17,84,67,89
85,seq82,r_148_127_119,seq39,r_148_127_119,0.98,0,119,119,89
22,r_75_110_42,seq106,r_33_41_91,r_33_41_91,1.0,40,131,91,89
39,r_84_144_56,r_25_55_104,r_85_90_30,r_84_144_56,0.99,0,56,56,89
47,r_67_2_146,seq142,r_133_5_5,r_67_2_146,0.85,0,146,146,89
33,r_85_90_30,r_67_2_146,seq70,r_85_90_30,0.93,0,30,30,89
40,r_54_76_4,r_128_120_29,seq102,r_128_120_29,0.31,127,156,29,89
74,seq48,seq125,r_1_11_52,r_1_11_52,1.0,67,119,52,89
25,r_66_88_66,r_91_27_54,seq51,r_66_88_66,0.99,0,66,66,89
18,r_74_122_45,seq97,seq51,r_74_122_45,0.99,2,47,45,89
50,seq0,r_139_121_61,r_133_5_5,r_139_121_61,0.99,1,62,61,89
70,seq38,r_81_123_183,r_1_11_52,r_1_11_52,0.98,128,180,52,89
42,r_140_12_143,r_45_89_20,r_25_55_104,r_25_55_104,1.0,42,146,104,89
32,r_137_93_128,seq112,r_6_58_62,r_137_93_128,0.99,-1,127,128,89
38,r_50_65_163,seq29,r_118_14_12,r_50_65_163,0.63,0,163,163,89
3,r_40_73_31,seq106,r_91_27_54,r_40_73_31,1.0,0,31,31,89
14,r_146_56_51,r_129_145_195,r_149_107_107,r_146_56_51,0.99,0,51,51,89
4,r_135_103_17,r_149_107_107,seq130,r_135_103_17,0.97,0,17,17,89
9,r_129_145_195,r_86_87_173,r_9_61_102,r_9_61_102,0.97,68,170,102,89
76,seq51,seq38,r_74_122_45,r_74_122_45,1.0,3,48,45,89
37,r_118_14_12,r_124_105_169,r_50_65_163,r_50_65_163,0.59,7,170,163,89
28,r_25_55_104,seq109,seq49,r_25_55_104,0.81,4,108,104,89
24,r_124_105_169,seq77,r_118_14_12,r_118_14_12,0.82,28,40,12,89
46,r_1_11_52,seq44,seq48,r_1_11_52,1.0,2,54,52,89
49,r_79_35_14,r_138_96_160,r_116_26_113,r_116_26_113,0.99,47,160,113,89
56,seq10,r_128_120_29,r_108_32_153,r_128_120_29,0.51,125,154,29,89
44,r_80_62_83,r_114_95_103,seq8,r_80_62_83,1.0,0,83,83,89
23,r_6_58_62,seq130,r_111_147_27,r_6_58_62,0.91,7,69,62,89
12,r_148_127_119,seq82,seq101,r_148_127_119,0.62,0,119,119,89
35,r_45_89_20,r_25_55_104,r_140_12_143,r_45_89_20,0.83,1,21,20,89
42,r_140_12_143,seq113,r_45_89_20,r_45_89_20,0.8,31,51,20,89
6,r_24_85_20,seq43,seq36,r_24_85_20,0.86,0,20,20,90
14,r_55_147_138,seq25,r_78_69_51,r_55_147_138,0.9,0,138,138,90
8,r_136_74_59,r_41_7_133,seq97,r_136_74_59,0.99,6,65,59,90
83,seq84,seq28,r_47_2_91,r_47_2_91,0.68,-10,81,91,90
37,r_145_26_74,seq29,r_24_85_20,r_145_26_74,1.0,0,74,74,90
5,r_142_32_113,r_119_65_142,seq23,r_119_65_142,0.96,-43,99,142,90
42,r_134_9_84,r_91_88_139,seq97,r_91_88_139,0.9,-48,91,139,90
3,r_91_88_139,r_13_11_62,r_55_147_138,r_13_11_62,1.0,78,140,62,90
21,r_15_102_35,r_104_89_172,seq43,r_15_102_35,1.0,1,36,35,90
39,r_131_16_26,r_91_88_139,r_48_81_100,r_131_16_26,0.78,1,27,26,90
19,r_56_129_137,seq6,seq128,r_56_129_137,0.72,3,140,137,90
39,r_131_16_26,r_48_81_100,r_18_146_87,r_131_16_26,1.0,64,90,26,90
41,r_41_7_133,seq83,seq117,r_41_7_133,0.79,-1,132,133,90
40,r_149_76_31,r_63_138_185,r_139_19_5,r_149_76_31,0.92,1,32,31,90
15,r_111_53_50,seq67,seq143,r_111_53_50,0.7,1,51,50,90
3,r_91_88_139,r_134_9_84,r_13_11_62,r_13_11_62,0.94,37,99,62,90
26,r_49_71_161,seq115,seq83,r_49_71_161,0.52,1,162,161,90
4,r_133_98_93,seq143,r_134_9_84,r_133_98_93,0.91,0,93,93,90
0,r_119_65_142,r_142_32_113,seq83,r_119_65_142,0.83,4,146,142,90
73,seq61,r_116_144_77,r_47_2_91,r_116_144_77,0.56,-3,74,77,90
11,r_57_90_132,r_5_95_182,seq113,r_57_90_132,0.75,0,132,132,90
20,r_21_141_152,seq62,r_22_110_66,r_21_141_152,0.78,0,152,152,90
13,r_109_68_165,seq12,r_22_110_66,r_22_110_66,0.8,101,167,66,90
10,r_99_75_27,r_133_98_93,seq67,r_99_75_27,0.83,1,28,27,90
48,r_39_40_75,r_134_9_84,seq37,r_39_40_75,0.63,0,75,75,90
33,r_60_120_17,r_124_123_153,seq31,r_60_120_17,0.89,0,17,17,90
27,r_114_58_148,r_5_95_182,r_14_30_178,r_114_58_148,0.62,1,149,148,90
18,r_104_89_172,seq4,r_142_32_113,r_104_89_172,0.58,0,172,172,90
29,r_34_132_116,r_124_123_153,r_103_127_81,r_124_123_153,0.39,-21,132,153,90
28,r_78_69_51,seq77,seq86,r_78_69_51,0.77,6,57,51,90
24,r_100_46_140,seq86,seq1,r_100_46_140,0.98,1,141,140,90
69,seq43,r_24_85_20,r_93_137_141,r_24_85_20,0.84,0,20,20,90
32,r_70_126_110,seq83,r_24_85_20,r_70_126_110,0.79,2,112,110,90
38,r_47_2_91,r_55_147_138,r_39_40_75,r_47_2_91,0.88,6,97,91,90
34,r_52_44_121,seq12,r_47_2_91,r_47_2_91,0.93,40,131,91,90
2,r_50_10_25,r_145_26_74,seq128,r_50_10_25,0.72,0,25,25,90
17,r_93_137_141,seq31,seq77,r_93_137_141,0.73,0,141,141,90
50,seq128,seq20,r_56_129_137,r_56_129_137,0.65,2,139,137,90
49,r_18_146_87,r_93_137_141,r_131_16_26,r_18_146_87,0.88,0,87,87,90
7,r_13_11_62,r_48_81_100,r_63_138_185,r_13_11_62,0.98,-1,61,62,90
23,r_3_108_112,seq51,r_134_9_84,r_3_108_112,0.73,1,113,112,90
73,seq61,r_47_2_91,r_48_81_100,r_47_2_91,0.5,21,112,91,90
35,r_116_144_77,seq61,r_24_85_20,r_116_144_77,0.93,-5,72,77,90
12,r_22_110_66,r_63_138_185,r_131_16_26,r_22_110_66,0.57,5,71,66,90
28,r_28_61_42,r_95_17_101,r_94_55_24,r_28_61_42,1.0,1,43,42,91
8,r_90_124_84,r_125_14_169,r_53_29_69,r_125_14_169,0.8,-84,85,169,91
37,r_48_16_120,r_19_113_183,r_72_42_95,r_48_16_120,0.93,0,120,120,91
3,r_51_20_74,r_19_113_183,seq65,r_19_113_183,0.99,0,183,183,91
55,seq11,seq30,r_137_129_59,r_137_129_59,1.0,4,63,59,91
1,r_43_100_94,seq57,r_49_18_19,r_43_100_94,1.0,0,94,94,91
46,r_137_129_59,r_142_132_148,seq11,r_137_129_59,1.0,3,62,59,91
7,r_19_113_183,r_51_20_74,r_91_3_116,r_19_113_183,0.73,0,183,183,91
69,seq54,r_2_89_138,r_142_132_148,r_2_89_138,1.0,7,145,138,91
32,r_56_115_26,seq140,r_32_62_34,r_56_115_26,0.81,8,34,26,91
25,r_60_31_194,seq25,r_49_18_19,r_49_18_19,0.91,17,36,19,91
11,r_50_13_14,seq114,r_66_92_5,r_50_13_14,1.0,1,15,14,91
31,r_10_12_88,seq84,seq40,r_10_12_88,0.97,1,89,88,91
67,seq40,r_139_103_187,r_91_3_116,r_91_3_116,1.0,48,164,116,91
3,r_51_20_74,seq78,r_19_113_183,r_51_20_74,0.97,0,74,74,91
10,r_87_116_115,r_82_143_37,r_51_20_74,r_87_116_115,1.0,1,116,115,91
26,r_72_42_95,seq27,seq84,r_72_42_95,1.0,2,97,95,91
4,r_39_120_131,r_142_132_148,seq119,r_39_120_131,0.65,2,133,131,91
0,r_9_52_125,seq0,r_82_143_37,r_9_52_125,0.7,2,127,125,91
22,r_1_85_51,r_139_103_187,seq133,r_1_85_51,1.0,0,51,51,91
20,r_53_29_69,r_19_113_183,seq119,r_53_29_69,1.0,1,70,69,91
13,r_91_3_116,r_34_44_189,seq40,r_91_3_116,1.0,0,116,116,91
98,seq119,r_123_97_104,r_53_29_69,r_53_29_69,1.0,14,83,69,91
48,r_148_15_127,seq81,seq78,r_148_15_127,0.85,0,127,127,91
6,r_125_14_169,seq96,seq21,r_125_14_169,0.65,0,169,169,91
36,r_49_18_19,r_60_31_194,r_43_100_94,r_43_100_94,1.0,6,100,94,91
24,r_80_35_46,r_88_118_199,seq81,r_80_35_46,1.0,0,46,46,91
47,r_83_141_73,r_10_12_88,seq101,r_83_141_73,1.0,0,73,73,91
40,r_110_5_123,seq133,r_137_129_59,r_110_5_123,0.96,1,124,123,91
18,r_126_45_60,seq46,seq108,r_126_45_60,1.0,3,63,60,91
29,r_98_70_153,r_145_77_182,r_80_35_46,r_98_70_153,0.49,0,153,153,91
36,r_49_18_19,r_19_113_183,r_60_31_194,r_49_18_19,0.6,12,31,19,91
33,r_47_121_65,r_98_70_153,seq109,r_47_121_65,0.86,5,70,65,91
58,seq147,r_111_22_126,r_94_55_24,r_111_22_126,0.61,2,128,126,91
27,r_32_62_34,r_110_5_123,r_56_115_26,r_32_62_34,1.0,0,34,34,91
35,r_131_4_21,seq46,seq6,r_131_4_21,0.82,2,23,21,91
39,r_93_127_49,r_88_118_199,seq23,r_93_127_49,0.99,3,52,49,91
77,seq71,r_142_132_148,seq0,r_142_132_148,0.45,-48,100,148,91
12,r_145_77_182,r_142_132_148,r_131_4_21,r_145_77_182,0.89,1,183,182,91
17,r_66_92_5,seq75,r_50_13_14,r_50_13_14,0.8,90,104,14,91
9,r_59_67_147,r_142_132_148,r_2_89_138,r_142_132_148,0.98,1,149,148,91
44,r_122_38_35,r_98_70_153,seq40,r_122_38_35,0.65,9,44,35,91
49,r_142_132_148,r_59_67_147,seq54,r_59_67_147,1.0,2,149,147,91
7,r_19_113_183,r_48_16_120,r_51_20_74,r_19_113_183,0.82,-63,120,183,91
23,r_111_22_126,seq147,r_32_62_34,r_111_22_126,0.99,2,128,126,91
41,r_24_144_54,r_95_17_101,r_56_115_26,r_24_144_54,1.0,0,54,54,91
12,r_145_77_182,r_98_70_153,r_142_132_148,r_98_70_153,0.63,0,153,153,91
30,r_2_123_110,r_1_132_171,r_102_23_72,r_102_23_72,0.98,44,116,72,92
92,seq108,r_61_50_87,r_11_5_178,r_61_50_87,1.0,2,89,87,92
8,r_51_58_85,r_11_5_178,r_73_37_71,r_51_58_85,1.0,0,85,85,92
43,r_14_49_69,r_17_25_168,seq19,r_14_49_69,0.98,2,71,69,92
37,r_124_83_89,seq53,seq45,r_124_83_89,1.0,0,89,89,92
71,seq53,r_124_83_89,r_48_112_119,r_124_83_89,0.99,-14,75,89,92
16,r_126_44_144,seq131,seq16,r_126_44_144,0.64,0,144,144,92
39,r_24_33_95,seq101,seq103,r_24_33_95,0.93,0,95,95,92
5,r_127_39_170,seq143,r_81_144_108,r_127_39_170,0.84,0,170,170,92
80,seq141,r_81_144_108,r_124_83_89,r_124_83_89,1.0,21,110,89,92
45,r_28_79_167,seq143,r_43_98_67,r_43_98_67,1.0,19,86,67,92
19,r_22_92_182,seq40,seq135,r_22_92_182,0.65,-4,178,182,92
6,r_82_96_53,r_30_46_132,seq143,r_82_96_53,1.0,0,53,53,92
15,r_134_130_21,r_124_83_89,seq143,r_134_130_21,0.96,0,21,21,92
31,r_55_148_33,r_35_9_36,seq147,r_35_9_36,0.99,2,38,36,92
76,seq68,r_71_109_154,r_61_50_87,r_61_50_87,0.98,67,154,87,92
3,r_81_144_108,seq141,r_67_86_52,r_67_86_52,1.0,58,110,52,92
10,r_102_23_72,r_11_5_178,seq111,r_102_23_72,1.0,0,72,72,92
24,r_142_56_22,r_81_144_108,r_93_36_19,r_142_56_22,1.0,-1,21,22,92
26,r_32_136_93,seq77,seq53,r_32_136_93,0.9,3,96,93,92
4,r_120_26_126,seq122,seq108,r_120_26_126,0.99,1,127,126,92
0,r_34_140_155,seq40,seq122,r_34_140_155,0.9,1,156,155,92
11,r_43_98_67,r_30_46_132,r_28_79_167,r_43_98_67,1.0,0,67,67,92
13,r_73_37_71,r_8_60_76,seq89,r_73_37_71,1.0,0,71,71,92
98,seq122,r_120_26_126,seq141,r_120_26_126,0.99,1,127,126,92
25,r_52_94_29,r_17_25_168,r_74_64_18,r_17_25_168,0.99,-139,29,168,92
42,r_70_78_42,r_10_0_151,seq7,r_70_78_42,0.72,3,45,42,92
18,r_87_113_68,r_32_136_93,seq104,r_32_136_93,1.0,-11,82,93,92
92,seq108,r_11_5_178,r_120_26_126,r_120_26_126,1.0,2,128,126,92
26,r_32_136_93,seq53,r_48_112_119,r_32_136_93,0.56,33,126,93,92
33,r_21_3_60,r_81_144_108,seq66,r_21_3_60,1.0,3,63,60,92
32,r_118_138_107,seq129,seq16,r_118_138_107,0.99,1,108,107,92
48,r_93_36_19,r_128_91_25,seq129,r_93_36_19,0.9,0,19,19,92
38,r_99_20_111,seq13,r_67_86_52,r_99_20_111,0.58,0,111,111,92
29,r_67_86_52,seq16,seq75,r_67_86_52,1.0,0,52,52,92
34,r_107_145_136,seq4,seq88,r_107_145_136,0.98,1,137,136,92
81,seq84,r_67_86_52,r_128_91_25,r_67_86_52,0.93,-29,23,52,92
75,seq66,r_10_0_151,r_21_3_60,r_21_3_60,0.92,21,81,60,92
21,r_35_9_36,r_55_148_33,seq41,r_35_9_36,1.0,2,38,36,92
17,r_48_112_119,seq95,r_32_136_93,r_32_136_93,0.98,35,128,93,92
46,r_128_91_25,seq47,seq84,r_128_91_25,0.74,-2,23,25,92
94,seq111,r_1_132_171,r_102_23_72,r_102_23_72,0.98,3,75,72,92
9,r_30_46_132,seq45,seq47,r_30_46_132,0.98,-1,131,132,92
22,r_8_60_76,r_63_106_79,r_114_69_45,r_63_106_79,0.53,-1,78,79,92
28,r_80_110_130,r_34_140_155,seq7,r_34_140_155,0.98,-15,140,155,92
49,r_90_76_92,seq147,r_21_3_60,r_90_76_92,1.0,2,94,92,92
44,r_71_109_154,seq68,r_128_91_25,r_71_109_154,0.82,0,154,154,92
23,r_63_106_79,r_107_145_136,seq54,r_63_106_79,1.0,0,79,79,92
82,seq147,r_90_76_92,r_55_148_33,r_90_76_92,1.0,2,94,92,92
35,r_10_0_151,seq66,seq13,r_10_0_151,0.98,-1,150,151,92
12,r_31_65_101,seq6,r_61_50_87,r_31_65_101,1.0,0,101,101,92
14,r_38_57_135,seq2,r_23_79_118,r_38_57_135,0.89,2,137,135,93
8,r_84_130_176,r_60_67_197,r_34_80_110,r_84_130_176,0.28,-4,172,176,93
35,r_81_119_11,r_32_86_190,r_43_124_10,r_43_124_10,0.89,0,10,10,93
37,r_8_37_91,r_48_92_121,seq2,r_48_92_121,0.98,-28,93,121,93
1,r_143_123_66,seq58,seq66,r_143_123_66,0.82,4,70,66,93
5,r_11_114_77,r_105_85_115,r_63_101_35,r_11_114_77,0.78,0,77,77,93
46,r_39_13_83,r_31_3_192,r_63_101_35,r_39_13_83,1.0,0,83,83,93
42,r_22_88_144,seq91,r_34_80_110,r_22_88_144,0.79,2,146,144,93
45,r_74_17_156,r_38_57_135,r_98_135_79,r_98_135_79,0.47,5,84,79,93
19,r_93_41_107,r_12_107_187,r_63_101_35,r_12_107_187,0.6,-80,107,187,93
21,r_24_146_30,r_133_62_113,seq73,r_24_146_30,0.95,0,30,30,93
36,r_117_65_56,seq35,r_109_137_52,r_117_65_56,0.98,0,56,56,93
31,r_98_135_79,r_46_26_76,r_74_17_156,r_98_135_79,0.98,1,80,79,93
89,seq100,r_38_57_135,r_52_138_95,r_52_138_95,1.0,2,97,95,93
6,r_132_99_31,r_63_101_35,seq145,r_132_99_31,0.81,0,31,31,93
10,r_10_15_72,r_23_79_118,seq139,r_10_15_72,1.0,5,77,72,93
24,r_78_77_53,r_46_26_76,seq16,r_78_77_53,0.99,0,53,53,93
4,r_149_68_85,r_38_57_135,r_132_99_31,r_132_99_31,0.39,55,86,31,93
11,r_120_95_139,r_87_30_174,r_34_80_110,r_87_30_174,0.97,-29,145,174,93
20,r_47_9_152,seq16,r_97_94_126,r_47_9_152,0.76,1,153,152,93
3,r_121_140_48,r_96_33_182,seq136,r_121_140_48,1.0,1,49,48,93
65,seq27,r_84_130_176,r_63_101_35,r_63_101_35,0.97,19,54,35,93
48,r_87_30_174,r_120_95_139,r_78_77_53,r_120_95_139,0.67,35,174,139,93
13,r_63_101_35,r_78_77_53,seq27,r_63_101_35,0.56,2,37,35,93
18,r_112_42_23,r_38_57_135,seq59,r_112_42_23,0.99,-1,22,23,93
2,r_148_147_178,seq19,seq5,r_148_147_178,0.68,0,178,178,93
40,r_29_45_179,seq70,r_34_80_110,r_29_45_179,0.56,1,180,179,93
33,r_52_138_95,seq136,seq100,r_52_138_95,1.0,0,95,95,93
32,r_105_85_115,seq113,r_132_99_31,r_105_85_115,0.97,2,117,115,93
23,r_109_137_52,seq5,seq111,r_109_137_52,1.0,1,53,52,93
38,r_96_33_182,seq16,r_11_114_77,r_11_114_77,1.0,106,183,77,93
34,r_133_62_113,seq66,r_23_79_118,r_23_79_118,0.95,4,122,118,93
45,r_74_17_156,r_98_135_79,r_143_123_66,r_74_17_156,0.87,0,156,156,93
81,seq70,r_29_45_179,seq36,r_29_45_179,0.82,1,180,179,93
9,r_12_107_187,seq106,r_43_124_10,r_12_107_187,0.45,0,187,187,93
31,r_98_135_79,r_74_17_156,r_78_77_53,r_74_17_156,0.62,0,156,156,93
22,r_142_102_134,seq136,r_132_99_31,r_132_99_31,0.48,103,134,31,93
28,r_46_26_76,seq6,r_34_80_110,r_46_26_76,0.93,11,87,76,93
29,r_54_126_24,r_120_95_139,seq91,r_54_126_24,0.98,0,24,24,93
49,r_48_92_121,r_8_37_91,r_121_140_48,r_8_37_91,1.0,31,122,91,93
79,seq66,r_133_62_113,r_143_123_66,r_143_123_66,1.0,56,122,66,93
51,seq4,r_127_146_183,r_149_50_147,r_127_146_183,0.54,-26,157,183,94
36,r_19_145_163,seq88,r_138_0_30,r_19_145_163,0.66,0,163,163,94
53,seq129,r_92_28_86,r_11_125_19,r_92_28_86,0.99,0,86,86,94
83,seq79,r_71_142_135,seq102,r_71_142_135,1.0,-44,91,135,94
59,seq21,r_105_27_146,r_89_34_3,r_105_27_146,0.4,2,148,146,94
16,r_2_106_80,r_86_67_145,r_16_103_41,r_86_67_145,0.99,-51,94,145,94
21,r_6_17_102,r_55_113_107,r_92_28_86,r_55_113_107,0.94,-4,103,107,94
1,r_60_74_52,r_134_98_65,seq136,r_134_98_65,0.93,6,71,65,94
14,r_112_32_43,seq13,seq31,r_112_32_43,1.0,0,43,43,94
45,r_130_110_127,seq1,r_132_135_53,r_132_135_53,0.69,71,124,53,94
19,r_86_67_145,seq63,seq129,r_86_67_145,0.66,0,145,145,94
42,r_132_135_53,r_107_108_167,seq42,r_132_135_53,1.0,0,53,53,94
20,r_147_15_120,r_128_18_169,r_92_28_86,r_147_15_120,0.98,1,121,120,94
31,r_107_108_167,seq46,seq120,r_107_108_167,0.73,0,167,167,94
90,seq102,r_71_142_135,seq79,r_71_142_135,1.0,0,135,135,94
26,r_71_142_135,seq102,r_138_0_30,r_71_142_135,0.93,0,135,135,94
4,r_78_66_60,r_87_93_168,seq124,r_78_66_60,1.0,0,60,60,94
78,seq63,r_86_67_145,r_138_0_30,r_86_67_145,0.88,0,145,145,94
0,r_131_85_90,r_22_148_192,r_134_98_65,r_131_85_90,1.0,0,90,90,94
20,r_147_15_120,r_92_28_86,r_128_18_169,r_92_28_86,1.0,0,86,86,94
13,r_105_27_146,r_40_81_124,seq21,r_40_81_124,0.66,3,127,124,94
17,r_139_56_50,seq52,seq1,r_139_56_50,0.99,1,51,50,94
6,r_111_51_148,r_83_133_180,seq64,r_83_133_180,0.68,-32,148,180,94
99,seq124,r_60_74_52,r_78_66_60,r_78_66_60,1.0,7,67,60,94
27,r_134_98_65,r_119_29_171,r_19_145_163,r_134_98_65,0.9,2,67,65,94
11,r_11_125_19,seq42,seq129,r_11_125_19,0.69,-1,18,19,94
13,r_105_27_146,seq21,seq84,r_105_27_146,0.74,1,147,146,94
30,r_101_126_51,r_107_108_167,seq25,r_101_126_51,1.0,0,51,51,94
47,r_61_141_35,r_112_32_43,seq1,r_61_141_35,0.78,0,35,35,94
40,r_35_82_121,r_127_146_183,r_23_10_7,r_35_82_121,0.82,2,123,121,94
29,r_40_81_124,r_105_27_146,r_55_113_107,r_40_81_124,0.83,3,127,124,94
24,r_83_133_180,seq137,r_112_32_43,r_112_32_43,0.98,138,181,43,94
33,r_72_37_166,seq5,seq64,r_72_37_166,0.34,2,168,166,94
37,r_97_7_12,seq62,seq12,r_97_7_12,1.0,-1,11,12,94
10,r_143_73_32,r_69_94_186,r_97_7_12,r_143_73_32,0.85,0,32,32,94
39,r_100_104_57,r_128_18_169,seq91,r_100_104_57,0.98,0,57,57,94
61,seq25,r_119_29_171,r_101_126_51,r_101_126_51,0.91,70,121,51,94
32,r_8_68_176,r_22_148_192,seq5,r_22_148_192,0.54,-16,176,192,94
27,r_134_98_65,r_19_145_163,r_131_85_90,r_134_98_65,0.98,49,114,65,94
7,r_87_93_168,seq75,seq144,r_87_93_168,0.46,2,170,168,94
44,r_69_94_186,seq137,r_112_32_43,r_112_32_43,1.0,143,186,43,94
23,r_80_20_159,seq63,seq75,r_80_20_159,0.34,4,163,159,94
63,seq31,seq79,r_112_32_43,r_112_32_43,1.0,6,49,43,94
35,r_55_113_107,seq1,seq52,r_55_113_107,0.87,3,110,107,94
12,r_92_28_86,r_147_15_120,r_57_3_13,r_57_3_13,0.97,73,86,13,94
8,r_16_103_41,r_80_20_159,seq137,r_16_103_41,0.84,1,42,41,94
36,r_76_51_164,r_85_54_173,r_112_147_58,r_112_147_58,0.94,106,164,58,95
14,r_10_137_121,seq65,r_39_69_100,r_10_137_121,1.0,0,121,121,95
83,seq66,r_27_94_115,r_106_142_188,r_27_94_115,0.85,8,123,115,95
37,r_27_94_115,seq66,seq148,r_27_94_115,0.68,8,123,115,95
39,r_136_88_97,seq41,seq133,r_136_88_97,1.0,0,97,97,95
1,r_74_47_133,r_9_5_137,r_112_147_58,r_74_47_133,0.94,0,133,133,95
46,r_87_29_178,seq107,r_74_47_133,r_74_47_133,0.99,45,178,133,95
27,r_50_60_27,r_62_89_91,seq70,r_50_60_27,0.85,-4,23,27,95
31,r_62_89_91,seq46,r_106_142_188,r_62_89_91,0.76,4,95,91,95
41,r_112_147_58,r_82_25_195,r_85_54_173,r_112_147_58,0.84,9,67,58,95
67,seq33,seq0,r_92_115_42,r_92_115_42,0.87,53,95,42,95
90,seq98,r_21_125_175,seq56,r_21_125_175,0.91,-75,100,175,95
26,r_44_35_131,r_22_91_75,r_68_149_41,r_22_91_75,0.88,7,82,75,95
4,r_61_121_155,seq107,seq138,r_61_121_155,0.64,0,155,155,95
0,r_109_71_88,seq111,r_64_59_6,r_109_71_88,0.64,3,91,88,95
11,r_22_91_75,r_44_35_131,r_24_1_77,r_22_91_75,0.74,-2,73,75,95
20,r_145_134_132,seq42,r_77_26_104,r_77_26_104,1.0,28,132,104,95
15,r_82_25_195,r_112_147_58,r_92_115_42,r_112_147_58,1.0,2,60,58,95
48,r_13_81_66,r_9_5_137,r_106_142_188,r_13_81_66,0.92,1,67,66,95
19,r_117_102_59,r_10_137_121,seq3,r_117_102_59,1.0,0,59,59,95
25,r_77_26_104,seq129,r_136_88_97,r_77_26_104,0.99,0,104,104,95
22,r_143_132_43,r_61_121_155,seq11,r_143_132_43,1.0,0,43,43,95
2,r_16_75_116,r_127_139_196,seq42,r_127_139_196,0.92,-68,128,196,95
41,r_112_147_58,r_85_54_173,r_74_47_133,r_74_47_133,0.56,-6,127,133,95
47,r_85_54_173,seq23,r_95_96_153,r_85_54_173,0.48,0,173,173,95
29,r_24_1_77,r_77_26_104,r_58_126_46,r_77_26_104,1.0,-27,77,104,95
25,r_77_26_104,r_24_1_77,seq129,r_24_1_77,1.0,0,77,77,95
33,r_146_45_138,r_130_118_184,seq41,r_130_118_184,0.54,-46,138,184,95
64,seq23,r_85_54_173,r_61_121_155,r_61_121_155,0.99,18,173,155,95
18,r_49_103_14,r_106_142_188,seq141,r_49_103_14,0.99,0,14,14,95
65,seq28,r_86_8_170,r_17_128_113,r_86_8_170,0.79,5,175,170,95
38,r_58_126_46,r_119_135_9,r_24_1_77,r_24_1_77,1.0,12,89,77,95
26,r_44_35_131,r_68_149_41,r_119_135_9,r_44_35_131,0.96,4,135,131,95
34,r_110_18_16,r_85_54_173,r_113_104_103,r_113_104_103,0.81,0,103,103,95
75,seq43,r_130_118_184,r_106_142_188,r_130_118_184,0.63,0,184,184,95
17,r_113_104_103,r_136_88_97,r_110_18_16,r_136_88_97,0.76,-15,82,97,95
9,r_32_14_127,r_105_48_145,seq4,r_32_14_127,0.99,1,128,127,95
38,r_58_126_46,r_17_128_113,r_119_135_9,r_58_126_46,0.98,3,49,46,95
28,r_108_7_136,seq123,r_106_142_188,r_108_7_136,0.91,0,136,136,95
49,r_73_67_93,seq133,seq63,r_73_67_93,1.0,0,93,93,95
44,r_130_118_184,seq43,r_61_121_155,r_61_121_155,0.57,29,184,155,95
23,r_39_69_100,r_9_5_137,r_10_137_121,r_39_69_100,0.99,25,125,100,95
82,seq65,r_10_137_121,seq97,r_10_137_121,0.99,0,121,121,95
35,r_53_116_117,seq70,r_27_94_115,r_53_116_117,0.54,12,129,117,95
12,r_9_5_137,seq30,seq57,r_9_5_137,1.0,0,137,137,95
40,r_99_124_10,r_17_128_113,r_119_135_9,r_99_124_10,0.97,1,11,10,95
32,r_92_115_42,r_146_45_138,seq33,r_92_115_42,0.64,0,42,42,95
93,seq114,seq17,r_99_149_99,r_99_149_99,1.0,13,112,99,96
30,r_69_24_62,r_99_149_99,r_52_22_141,r_99_149_99,0.99,-37,62,99,96
14,r_43_28_111,seq20,r_12_91_78,r_12_91_78,0.98,34,112,78,96
8,r_124_26_188,seq54,r_3_15_146,r_124_26_188,0.36,0,188,188,96
37,r_92_59_73,r_100_36_164,seq123,r_92_59_73,1.0,0,73,73,96
16,r_78_45_94,seq85,r_52_22_141,r_78_45_94,1.0,0,94,94,96
39,r_31_102_123,r_94_140_131,seq146,r_31_102_123,1.0,0,123,123,96
1,r_147_136_153,r_137_87_171,r_31_102_123,r_137_87_171,0.84,-18,153,171,96
5,r_133_7_129,r_41_53_138,seq13,r_133_7_129,0.99,0,129,129,96
46,r_63_96_75,r_41_53_138,seq9,r_63_96_75,0.66,3,78,75,96
42,r_12_91_78,r_86_104_173,r_10_77_61,r_12_91_78,1.0,0,78,78,96
45,r_10_77_61,seq97,seq74,r_10_77_61,1.0,0,61,61,96
15,r_11_144_20,r_3_15_146,seq48,r_11_144_20,0.97,1,21,20,96
66,seq29,seq5,r_16_138_66,r_16_138_66,1.0,20,86,66,96
19,r_44_107_52,r_41_53_138,seq141,r_44_107_52,1.0,0,52,52,96
76,seq65,r_49_82_106,r_11_144_20,r_49_82_106,0.61,0,106,106,96
31,r_88_2_108,seq118,seq129,r_88_2_108,0.41,6,114,108,96
41,r_49_82_106,seq65,r_110_50_103,r_49_82_106,1.0,0,106,106,96
27,r_61_1_32,r_143_34_190,seq38,r_61_1_32,0.95,3,35,32,96
3,r_30_27_148,r_62_112_155,r_70_23_87,r_70_23_87,0.5,63,150,87,96
10,r_137_87_171,seq117,r_43_28_111,r_43_28_111,0.56,61,172,111,96
40,r_126_76_45,r_3_15_146,seq54,r_126_76_45,1.0,0,45,45,96
26,r_16_138_66,r_30_27_148,seq29,r_16_138_66,1.0,3,69,66,96
4,r_99_149_99,r_90_42_192,seq114,r_99_149_99,1.0,0,99,99,96
0,r_3_15_146,seq85,r_94_140_131,r_3_15_146,0.93,0,146,146,96
63,seq146,r_135_84_174,r_31_102_123,r_31_102_123,1.0,26,149,123,96
11,r_90_42_192,r_99_149_99,seq55,r_99_149_99,1.0,0,99,99,96
3,r_30_27_148,r_70_23_87,r_100_36_164,r_100_36_164,0.62,7,171,164,96
20,r_116_4_83,seq5,seq17,r_116_4_83,1.0,0,83,83,96
98,seq148,r_47_57_162,r_121_32_126,r_121_32_126,0.99,13,139,126,96
6,r_94_140_131,r_47_57_162,seq115,r_94_140_131,0.78,0,131,131,96
70,seq48,seq93,r_11_144_20,r_11_144_20,0.99,16,36,20,96
2,r_110_50_103,seq79,r_49_82_106,r_49_82_106,1.0,1,107,106,96
74,seq58,seq141,r_70_23_87,r_70_23_87,1.0,0,87,87,96
47,r_122_130_55,seq134,r_52_22_141,r_122_130_55,1.0,1,56,55,96
18,r_86_104_173,seq9,r_44_107_52,r_44_107_52,0.54,121,173,52,96
29,r_41_53_138,seq132,seq21,r_41_53_138,0.57,2,140,138,96
24,r_62_112_155,r_86_104_173,r_122_130_55,r_122_130_55,0.84,100,155,55,96
36,r_95_127_57,r_135_84_174,seq38,r_95_127_57,1.0,0,57,57,96
25,r_18_25_176,r_143_34_190,r_92_59_73,r_92_59_73,0.87,103,176,73,96
33,r_106_71_69,r_30_27_148,seq29,r_106_71_69,0.99,0,69,69,96
64,seq20,r_43_28_111,seq66,r_43_28_111,0.79,-9,102,111,96
38,r_70_23_87,r_52_22_141,seq58,r_70_23_87,1.0,1,88,87,96
60,seq142,r_80_73_85,seq97,r_80_73_85,1.0,0,85,85,96
17,r_80_73_85,seq142,r_16_138_66,r_80_73_85,1.0,0,85,85,96
94,seq115,r_143_34_190,r_94_140_131,r_94_140_131,0.82,2,133,131,96
22,r_52_22_141,r_70_23_87,r_122_130_55,r_52_22_141,1.0,-76,65,141,96
45,r_10_77_61,seq74,r_12_91_78,r_12_91_78,0.91,19,97,78,96
49,r_100_36_164,seq118,r_30_27_148,r_100_36_164,0.77,2,166,164,96
7,r_121_32_126,seq79,seq148,r_121_32_126,0.97,0,126,126,96
44,r_72_98_64,r_143_34_190,r_10_77_61,r_72_98_64,0.81,4,68,64,96
23,r_47_57_162,seq13,r_94_140_131,r_94_140_131,0.87,31,162,131,96
43,r_113_139_50,seq38,seq141,r_113_139_50,1.0,1,51,50,96
35,r_6_108_158,seq17,r_78_45_94,r_78_45_94,0.98,64,158,94,96
12,r_120_37_161,seq29,seq38,r_120_37_161,0.78,1,162,161,96
36,r_130_112_190,seq84,r_103_108_164,r_103_108_164,0.97,26,190,164,97
92,seq92,r_103_108_164,r_96_75_153,r_103_108_164,0.98,0,164,164,97
44,r_134_147_58,r_67_136_133,seq30,r_134_147_58,0.99,1,59,58,97
8,r_67_136_133,r_119_66_85,r_43_62_64,r_119_66_85,0.93,3,88,85,97
43,r_23_61_144,r_52_90_111,r_104_7_114,r_23_61_144,0.69,-28,116,144,97
16,r_104_7_114,seq38,seq93,r_104_7_114,0.58,0,114,114,97
5,r_144_56_188,r_72_121_118,r_94_55_38,r_94_55_38,0.38,150,188,38,97
46,r_114_12_105,r_109_31_142,r_94_55_38,r_94_55_38,0.9,109,147,38,97
42,r_81_6_140,seq135,r_99_97_12,r_81_6_140,0.49,0,140,140,97
69,seq35,r_109_31_142,r_94_55_38,r_94_55_38,0.78,46,84,38,97
45,r_107_21_125,r_115_53_132,seq133,r_107_21_125,0.99,0,125,125,97
13,r_80_145_39,seq8,seq116,r_80_145_39,0.99,3,42,39,97
19,r_5_40_172,r_44_127_122,r_52_90_111,r_5_40_172,0.94,-50,122,172,97
2,r_149_16_21,r_41_13_34,r_60_132_179,r_60_132_179,1.0,-158,21,179,97
31,r_141_17_168,r_91_71_20,r_67_136_133,r_141_17_168,0.9,-13,155,168,97
16,r_104_7_114,seq93,r_44_127_122,r_104_7_114,0.56,19,133,114,97
1,r_49_33_30,r_34_15_196,seq0,r_49_33_30,1.0,0,30,30,97
31,r_141_17_168,r_115_53_132,r_91_71_20,r_91_71_20,0.72,102,122,20,97
41,r_46_86_73,r_72_121_118,seq84,r_46_86_73,1.0,0,73,73,97
90,seq84,r_130_112_190,r_144_56_188,r_130_112_190,0.38,0,190,190,97
22,r_41_13_34,r_73_124_41,r_102_105_26,r_41_13_34,1.0,0,34,34,97
72,seq39,r_119_66_85,seq2,r_119_66_85,1.0,3,88,85,97
35,r_73_124_41,r_115_53_132,seq1,r_73_124_41,0.75,1,42,41,97
4,r_109_31_142,r_114_12_105,seq37,r_109_31_142,0.49,5,147,142,97
0,r_95_74_184,seq129,r_52_90_111,r_52_90_111,0.9,73,184,111,97
23,r_20_32_36,r_73_124_41,seq100,r_73_124_41,1.0,0,41,41,97
20,r_44_127_122,r_5_40_172,r_104_7_114,r_44_127_122,0.85,0,122,122,97
47,r_91_71_20,r_102_105_26,seq24,r_91_71_20,0.99,0,20,20,97
15,r_103_108_164,seq92,seq65,r_103_108_164,0.64,0,164,164,97
48,r_143_48_63,seq116,seq38,r_143_48_63,1.0,0,63,63,97
6,r_29_68_70,seq1,seq85,r_29_68_70,0.64,3,73,70,97
2,r_149_16_21,r_60_132_179,r_23_61_144,r_23_61_144,0.93,5,149,144,97
27,r_87_82_94,r_104_7_114,r_94_55_38,r_87_82_94,0.71,1,95,94,97
40,r_63_18_77,seq58,seq140,r_63_18_77,1.0,0,77,77,97
29,r_119_66_85,r_67_136_133,r_80_145_39,r_119_66_85,1.0,3,88,85,97
28,r_120_22_45,r_104_7_114,r_19_47_67,r_120_22_45,0.97,22,67,45,97
17,r_110_50_10,r_88_14_175,seq69,r_110_50_10,0.81,0,10,10,97
43,r_23_61_144,r_104_7_114,r_149_16_21,r_23_61_144,0.73,0,144,144,97
11,r_94_55_38,r_118_51_183,seq35,r_94_55_38,1.0,0,38,38,97
28,r_120_22_45,seq135,r_104_7_114,r_120_22_45,0.99,0,45,45,97
34,r_111_64_120,r_34_15_196,r_20_32_36,r_111_64_120,0.98,0,120,120,97
9,r_52_90_111,r_23_61_144,r_110_50_10,r_52_90_111,1.0,4,115,111,97
49,r_115_53_132,seq0,r_52_90_111,r_115_53_132,0.97,0,132,132,97
7,r_19_47_67,r_89_36_192,r_120_22_45,r_89_36_192,0.99,-125,67,192,97
8,r_67_136_133,r_43_62_64,seq123,r_67_136_133,0.85,0,133,133,97
19,r_5_40_172,r_52_90_111,r_72_121_118,r_5_40_172,0.98,1,173,172,97
12,r_118_51_183,seq85,r_149_16_21,r_118_51_183,0.47,0,183,183,97
84,seq70,r_67_136_133,seq2,r_67_136_133,1.0,0,133,133,97
30,r_62_25_61,r_69_28_86,r_139_104_160,r_62_25_61,0.67,1,62,61,98
51,seq129,r_39_110_116,seq9,r_39_110_116,0.73,23,139,116,98
36,r_82_49_141,r_134_3_164,seq17,r_82_49_141,0.84,1,142,141,98
92,seq108,seq125,r_69_28_86,r_69_28_86,0.98,69,155,86,98
14,r_88_0_177,r_68_22_199,r_141_54_29,r_88_0_177,0.59,0,177,177,98
8,r_116_94_60,seq4,r_31_20_16,r_116_94_60,0.98,0,60,60,98
83,seq77,r_78_35_123,r_134_3_164,r_78_35_123,0.87,3,126,123,98
21,r_10_91_68,seq80,seq72,r_10_91_68,0.76,0,68,68,98
39,r_143_146_69,seq97,r_141_54_29,r_143_146_69,0.91,3,72,69,98
1,r_26_147_89,r_8_111_182,r_52_75_2,r_26_147_89,0.92,0,89,89,98
5,r_74_12_147,r_126_112_174,seq13,r_74_12_147,0.7,11,158,147,98
42,r_114_119_119,seq131,seq80,r_114_119_119,0.6,1,120,119,98
45,r_87_122_187,seq140,r_26_147_89,r_26_147_89,0.87,97,186,89,98
31,r_69_28_86,r_126_112_174,seq108,r_69_28_86,0.77,1,87,86,98
41,r_7_85_186,seq133,r_141_54_29,r_141_54_29,0.78,55,84,29,98
3,r_47_38_115,seq60,r_27_6_82,r_47_38_115,0.59,0,115,115,98
26,r_136_109_76,r_74_12_147,r_138_113_20,r_136_109_76,0.54,0,76,76,98
4,r_100_15_165,seq130,r_14_73_85,r_100_15_165,0.61,0,165,165,98
78,seq60,r_47_38_115,seq132,r_47_38_115,0.88,0,115,115,98
0,r_78_35_123,seq77,r_10_91_68,r_10_91_68,0.75,60,128,68,98
99,seq127,r_93_65_138,r_24_92_41,r_24_92_41,0.7,9,50,41,98
11,r_14_73_85,seq84,seq137,r_14_73_85,0.81,4,89,85,98
2,r_46_144_10,r_149_81_43,r_33_48_19,r_149_81_43,0.95,0,43,43,98
20,r_86_45_117,r_88_0_177,r_103_19_12,r_86_45_117,0.68,4,121,117,98
13,r_96_23_90,seq125,seq21,r_96_23_90,0.91,0,90,90,98
48,r_61_30_67,r_93_65_138,seq76,r_61_30_67,0.78,3,70,67,98
12,r_139_104_160,r_62_25_61,r_47_38_115,r_139_104_160,0.78,3,163,160,98
43,r_33_48_19,r_138_113_20,r_46_144_10,r_33_48_19,0.94,-2,17,19,98
9,r_89_120_45,r_10_91_68,seq4,r_89_120_45,0.99,0,45,45,98
29,r_138_113_20,r_33_48_19,seq133,r_138_113_20,0.73,-1,19,20,98
30,r_62_25_61,r_139_104_160,seq77,r_62_25_61,0.56,103,164,61,98
41,r_7_85_186,r_141_54_29,seq63,r_7_85_186,0.48,0,186,186,98
40,r_106_53_77,seq135,seq16,r_106_53_77,0.83,3,80,77,98
18,r_27_6_82,r_32_58_157,seq107,r_27_6_82,0.75,4,86,82,98
24,r_93_65_138,seq57,r_32_58_157,r_93_65_138,0.62,1,139,138,98
25,r_2_37_184,seq57,r_86_45_117,r_86_45_117,0.72,71,188,117,98
34,r_149_81_43,seq123,seq124,r_149_81_43,1.0,0,43,43,98
65,seq148,r_139_104_160,seq77,r_139_104_160,0.46,-90,70,160,98
37,r_64_117_44,r_39_110_116,r_141_54_29,r_64_117_44,1.0,1,45,44,98
61,seq142,seq80,r_43_105_34,r_43_105_34,0.85,75,109,34,98
15,r_79_40_46,r_106_53_77,seq17,r_79_40_46,1.0,0,46,46,98
16,r_141_54_29,seq76,seq84,r_141_54_29,0.96,4,33,29,98
22,r_5_1_181,seq124,r_78_35_123,r_5_1_181,0.29,0,181,181,98
28,r_32_58_157,r_5_1_181,r_93_65_138,r_32_58_157,0.42,-20,137,157,98
91,seq107,r_126_112_174,r_47_38_115,r_47_38_115,0.46,60,175,115,98
7,r_43_105_34,r_27_6_82,seq142,r_43_105_34,0.96,2,36,34,98
27,r_31_20_16,r_10_91_68,r_116_94_60,r_116_94_60,0.73,1,61,60,98
44,r_134_3_164,r_82_49_141,seq77,r_82_49_141,1.0,-29,112,141,98
23,r_126_112_174,seq107,r_78_35_123,r_126_112_174,0.35,1,175,174,98
27,r_31_20_16,r_138_113_20,r_10_91_68,r_10_91_68,0.54,-31,37,68,98
35,r_29_95_97,seq107,r_14_73_85,r_29_95_97,0.71,2,99,97,98
12,r_139_104_160,seq148,r_62_25_61,r_62_25_61,0.93,9,70,61,98
32,r_24_92_41,r_116_94_60,seq127,r_24_92_41,0.48,1,42,41,98
84,seq80,r_10_91_68,r_71_83_13,r_10_91_68,0.96,0,68,68,98
93,seq116,r_68_10_172,r_64_79_69,r_64_79_69,1.0,78,147,69,99
30,r_45_101_141,seq15,seq107,r_45_101_141,0.62,2,143,141,99
92,seq112,r_147_59_77,r_141_65_51,r_147_59_77,0.65,0,77,77,99
14,r_72_100_81,r_127_87_154,r_39_61_39,r_72_100_81,0.56,1,82,81,99
43,r_7_23_137,seq78,r_142_135_119,r_7_23_137,0.61,1,138,137,99
37,r_5_124_92,seq136,seq95,r_5_124_92,1.0,0,92,92,99
3,r_140_24_105,r_70_67_182,r_37_89_121,r_70_67_182,0.92,0,182,182,99
59,seq15,r_45_101_141,seq112,r_45_101_141,0.85,3,144,141,99
55,seq9,r_52_99_176,r_32_134_116,r_32_134_116,0.99,60,176,116,99
16,r_35_92_54,r_127_87_154,r_14_42_10,r_35_92_54,0.63,7,61,54,99
1,r_52_99_176,seq9,r_90_138_128,r_52_99_176,0.59,0,176,176,99
46,r_113_2_152,seq107,r_90_138_128,r_90_138_128,0.8,24,152,128,99
42,r_108_131_63,r_117_123_164,seq86,r_108_131_63,1.0,0,63,63,99
45,r_70_67_182,seq125,r_62_110_83,r_62_110_83,1.0,99,182,83,99
19,r_88_114_133,r_137_81_127,seq126,r_137_81_127,0.99,1,128,127,99
21,r_129_75_25,r_111_11_89,seq55,r_111_11_89,0.67,-59,30,89,99
31,r_14_42_10,seq1,r_35_92_54,r_35_92_54,0.67,11,65,54,99
3,r_140_24_105,seq55,r_70_67_182,r_140_24_105,1.0,4,109,105,99
10,r_18_50_93,r_76_40_138,seq47,r_18_50_93,1.0,1,94,93,99
90,seq107,r_113_2_152,r_45_101_141,r_45_101_141,0.59,11,152,141,99
26,r_25_130_155,seq44,r_17_3_187,r_25_130_155,0.97,0,155,155,99
36,r_97_16_43,seq93,r_39_61_39,r_39_61_39,0.75,10,49,39,99
4,r_137_81_127,r_88_114_133,r_22_33_72,r_88_114_133,0.98,-5,128,133,99
78,seq78,r_7_23_137,r_4_85_2,r_7_23_137,0.85,1,138,137,99
0,r_54_53_171,seq27,r_31_83_36,r_54_53_171,0.44,0,171,171,99
20,r_122_144_53,r_30_34_169,r_52_99_176,r_122_144_53,0.75,15,68,53,99
13,r_37_89_121,seq146,r_35_92_54,r_37_89_121,0.84,5,126,121,99
38,r_141_65_51,r_32_134_116,seq112,r_141_65_51,0.58,1,52,51,99
15,r_111_11_89,r_60_26_198,r_17_3_187,r_60_26_198,0.53,-106,92,198,99
74,seq49,r_30_34_169,r_115_63_159,r_115_63_159,1.0,17,176,159,99
48,r_31_83_36,r_115_63_159,seq48,r_31_83_36,0.92,1,37,36,99
27,r_115_63_159,seq139,seq27,r_115_63_159,0.76,0,159,159,99
39,r_8_56_38,r_25_130_155,seq136,r_8_56_38,1.0,1,39,38,99
2,r_30_34_169,seq49,r_122_144_53,r_122_144_53,0.96,112,165,53,99
47,r_74_91_199,r_118_103_181,r_62_110_83,r_62_110_83,1.0,98,181,83,99
40,r_118_103_181,r_74_91_199,seq128,r_118_103_181,0.4,0,181,181,99
74,seq49,r_58_77_99,r_30_34_169,r_58_77_99,1.0,-4,95,99,99
18,r_147_59_77,seq112,seq0,r_147_59_77,1.0,0,77,77,99
29,r_22_33_72,seq66,seq44,r_22_33_72,1.0,2,74,72,99
62,seq20,seq6,r_145_69_30,r_145_69_30,1.0,16,46,30,99
24,r_90_138_128,r_68_10_172,r_108_131_63,r_108_131_63,1.0,70,133,63,99
70,seq44,seq95,r_22_33_72,r_22_33_72,1.0,5,77,72,99
65,seq27,r_54_53_171,r_88_114_133,r_54_53_171,0.87,0,171,171,99
20,r_122_144_53,r_52_99_176,r_30_34_169,r_52_99_176,0.8,-6,170,176,99
32,r_58_77_99,seq49,r_18_50_93,r_58_77_99,0.99,2,101,99,99
77,seq66,r_22_33_72,seq28,r_22_33_72,1.0,3,75,72,99
34,r_117_123_164,seq46,seq105,r_117_123_164,0.78,1,165,164,99
41,r_39_61_39,seq82,r_117_123_164,r_39_61_39,1.0,0,39,39,99
9,r_145_69_30,seq125,seq20,r_145_69_30,1.0,0,30,30,99
60,seq146,r_37_89_121,r_71_133_59,r_71_133_59,1.0,52,111,59,99
81,seq86,r_106_80_120,r_90_138_128,r_106_80_120,1.0,1,121,120,99
17,r_76_40_138,seq48,seq132,r_76_40_138,0.4,16,154,138,99
12,r_71_133_59,r_52_99_176,seq146,r_71_133_59,1.0,0,59,59,99
22,r_41_12_80,r_4_85_2,seq82,r_41_12_80,1.0,0,80,80,99
28,r_64_79_69,seq0,seq120,r_64_79_69,1.0,0,69,69,99
49,r_68_10_172,seq120,r_22_33_72,r_22_33_72,1.0,101,173,72,99
7,r_127_87_154,seq132,r_14_42_10,r_14_42_10,0.74,144,154,10,99
44,r_32_134_116,seq105,seq13,r_32_134_116,0.99,0,116,116,99
23,r_102_73_71,r_41_12_80,seq107,r_102_73_71,0.96,0,71,71,99
79,seq82,r_39_61_39,r_141_65_51,r_39_61_39,0.9,1,40,39,99
41,r_39_61_39,r_117_123_164,r_72_100_81,r_72_100_81,0.85,4,85,81,99
