26,r_142_140_26,seq137,r_0_96_163,r_142_140_26,0.99,1,27,26,0
30,r_38_138_64,r_128_65_169,r_54_118_118,r_38_138_64,1.0,0,64,64,0
36,r_113_3_113,seq62,r_6_127_100,r_113_3_113,0.98,1,114,113,0
14,r_32_93_23,r_85_109_4,r_37_15_29,r_32_93_23,0.46,15,38,23,0
16,r_119_25_49,seq53,r_98_123_27,r_98_123_27,1.0,0,27,27,0
28,r_0_96_163,r_77_23_82,r_142_140_26,r_0_96_163,0.9,-136,27,163,0
83,seq75,r_63_106_174,r_71_133_123,r_71_133_123,0.87,6,129,123,0
37,r_103_40_119,seq58,seq137,r_103_40_119,0.95,0,119,119,0
39,r_100_13_145,r_51_145_191,seq12,r_100_13_145,0.92,0,145,145,0
5,r_74_60_124,seq80,r_83_130_33,r_74_60_124,0.88,0,124,124,0
42,r_104_34_193,r_33_141_158,r_48_99_81,r_48_99_81,0.86,-2,79,81,0
45,r_54_118_118,r_71_133_123,seq1,r_54_118_118,0.8,0,118,118,0
19,r_64_36_132,r_119_25_49,seq139,r_64_36_132,0.96,0,132,132,0
8,r_98_123_27,seq139,r_119_25_49,r_98_123_27,1.0,0,27,27,0
66,seq31,r_19_146_104,r_4_45_122,r_19_146_104,1.0,1,105,104,0
11,r_5_111_15,seq18,seq129,r_5_111_15,0.82,0,15,15,0
31,r_39_120_166,r_51_145_191,r_142_140_26,r_51_145_191,0.69,-25,166,191,0
41,r_77_23_82,r_4_45_122,r_37_15_29,r_77_23_82,0.84,0,82,82,0
46,r_68_7_34,r_44_122_60,seq62,r_44_122_60,0.39,-26,34,60,0
20,r_44_122_60,r_114_95_120,seq53,r_44_122_60,1.0,0,60,60,0
13,r_148_76_143,r_51_145_191,r_74_60_124,r_148_76_143,0.82,0,143,143,0
15,r_63_106_174,r_115_88_125,r_6_127_100,r_63_106_174,0.7,-48,126,174,0
48,r_33_141_158,r_104_34_193,r_74_60_124,r_104_34_193,0.95,-35,158,193,0
15,r_63_106_174,r_6_127_100,r_19_146_104,r_63_106_174,0.93,0,174,174,0
27,r_6_127_100,r_114_95_120,seq75,r_6_127_100,1.0,0,100,100,0
74,seq55,seq102,r_86_52_45,r_86_52_45,1.0,2,47,45,0
18,r_48_99_81,r_71_133_123,r_46_108_111,r_71_133_123,0.84,0,123,123,0
40,r_94_117_107,seq107,seq92,r_94_117_107,1.0,0,107,107,0
18,r_48_99_81,seq72,r_71_133_123,r_48_99_81,0.93,-2,79,81,0
29,r_26_29_70,r_149_21_89,r_85_109_4,r_26_29_70,1.0,1,71,70,0
24,r_43_47_78,r_33_141_158,r_112_125_7,r_43_47_78,1.0,0,78,78,0
25,r_46_108_111,seq134,r_48_99_81,r_46_108_111,0.98,0,111,111,0
3,r_37_15_29,seq80,r_32_93_23,r_37_15_29,0.96,0,29,29,0
30,r_38_138_64,r_54_118_118,r_46_108_111,r_38_138_64,0.7,54,118,64,0
14,r_32_93_23,seq12,r_85_109_4,r_32_93_23,0.84,0,23,23,0
61,seq147,r_82_105_188,r_115_88_125,r_115_88_125,1.0,63,188,125,0
32,r_19_146_104,r_0_96_163,seq22,r_19_146_104,0.96,1,105,104,0
38,r_115_88_125,r_63_106_174,seq84,r_115_88_125,0.98,1,126,125,0
34,r_149_21_89,seq1,r_4_45_122,r_149_21_89,1.0,-1,88,89,0
6,r_83_130_33,r_63_106_174,seq134,r_83_130_33,1.0,0,33,33,0
9,r_71_133_123,r_54_118_118,r_113_3_113,r_54_118_118,0.96,6,124,118,0
26,r_142_140_26,r_0_96_163,seq31,r_0_96_163,0.44,9,172,163,0
47,r_4_45_122,r_77_23_82,r_2_24_14,r_4_45_122,0.81,-101,21,122,0
17,r_2_24_14,r_51_145_191,r_4_45_122,r_2_24_14,0.91,-1,13,14,0
28,r_0_96_163,r_142_140_26,r_74_60_124,r_74_60_124,0.82,47,171,124,0
22,r_131_9_139,r_51_145_191,seq143,r_51_145_191,0.5,-48,143,191,0
49,r_10_136_165,seq107,seq78,r_10_136_165,0.55,0,165,165,0
0,r_28_8_53,r_19_146_104,seq129,r_28_8_53,1.0,0,53,53,0
4,r_86_52_45,r_48_99_81,seq55,r_86_52_45,0.98,0,45,45,0
7,r_132_91_178,seq84,r_114_95_120,r_114_95_120,0.55,58,178,120,0
44,r_81_59_102,seq116,seq1,r_81_59_102,0.95,6,108,102,0
23,r_56_124_86,seq102,seq92,r_56_124_86,0.78,-5,81,86,0
35,r_16_69_144,seq92,seq12,r_16_69_144,0.97,0,144,144,0
12,r_128_65_169,seq22,r_71_133_123,r_128_65_169,0.61,0,169,169,0
30,r_42_119_164,r_82_143_196,r_110_1_59,r_42_119_164,0.57,0,164,164,1
48,r_60_137_155,r_134_125_97,r_40_11_148,r_134_125_97,0.67,59,156,97,1
36,r_39_105_52,r_16_107_125,seq122,r_39_105_52,0.97,11,63,52,1
14,r_44_45_110,r_83_118_132,r_101_2_54,r_44_45_110,1.0,0,110,110,1
8,r_146_74_79,r_58_68_74,seq12,r_146_74_79,0.95,5,84,79,1
42,r_116_149_57,r_106_78_151,seq128,r_116_149_57,1.0,0,57,57,1
44,r_83_118_132,r_110_1_59,seq129,r_83_118_132,0.79,0,132,132,1
37,r_37_124_75,seq36,seq34,r_37_124_75,0.92,12,87,75,1
39,r_40_11_148,seq66,r_112_26_111,r_40_11_148,0.77,1,149,148,1
5,r_73_142_42,seq12,r_47_121_170,r_73_142_42,0.93,1,43,42,1
32,r_134_125_97,r_60_137_155,r_16_107_125,r_60_137_155,0.9,2,157,155,1
45,r_20_0_175,seq19,r_102_111_191,r_20_0_175,0.3,0,175,175,1
19,r_88_31_31,r_47_121_170,seq28,r_88_31_31,0.99,0,31,31,1
31,r_106_78_151,seq129,seq66,r_106_78_151,0.98,0,151,151,1
15,r_110_1_59,r_69_59_185,seq18,r_110_1_59,1.0,0,59,59,1
3,r_101_2_54,seq34,seq9,r_101_2_54,0.91,8,62,54,1
10,r_139_48_86,seq13,seq95,r_139_48_86,0.91,0,86,86,1
26,r_30_65_168,r_33_57_146,r_134_125_97,r_134_125_97,1.0,71,168,97,1
4,r_46_53_177,r_104_136_161,r_73_142_42,r_73_142_42,0.92,127,169,42,1
6,r_115_96_17,r_112_26_111,seq25,r_115_96_17,0.99,0,17,17,1
11,r_52_120_123,seq61,seq128,r_52_120_123,0.83,0,123,123,1
20,r_148_132_179,seq43,r_114_126_92,r_114_126_92,0.68,88,180,92,1
13,r_93_10_77,seq108,r_115_96_17,r_93_10_77,1.0,2,79,77,1
98,seq122,seq12,r_39_105_52,r_39_105_52,1.0,39,91,52,1
48,r_60_137_155,r_86_100_95,r_134_125_97,r_134_125_97,1.0,5,102,97,1
21,r_76_85_53,seq18,seq113,r_76_85_53,1.0,0,53,53,1
49,r_47_121_170,r_73_142_42,r_83_118_132,r_73_142_42,0.65,128,170,42,1
85,seq77,r_148_132_179,r_146_74_79,r_146_74_79,0.72,-10,69,79,1
5,r_73_142_42,r_47_121_170,r_46_53_177,r_47_121_170,0.96,0,170,170,1
2,r_15_50_102,seq113,r_99_80_12,r_99_80_12,0.99,92,104,12,1
49,r_47_121_170,seq27,r_73_142_42,r_73_142_42,0.98,3,45,42,1
47,r_104_136_161,r_46_53_177,r_139_48_86,r_139_48_86,0.8,77,163,86,1
23,r_98_35_36,seq12,r_115_96_17,r_98_35_36,0.84,1,37,36,1
40,r_23_32_4,seq66,r_16_107_125,r_16_107_125,0.76,57,182,125,1
18,r_89_90_181,seq54,r_102_111_191,r_102_111_191,0.56,-10,181,191,1
25,r_141_72_135,seq38,r_73_142_42,r_141_72_135,1.0,0,135,135,1
33,r_58_68_74,r_146_74_79,r_99_80_12,r_58_68_74,0.9,10,84,74,1
50,seq128,r_58_68_74,r_116_149_57,r_116_149_57,1.0,31,88,57,1
32,r_134_125_97,r_141_72_135,r_60_137_155,r_134_125_97,0.98,0,97,97,1
38,r_114_126_92,r_52_120_123,r_103_70_96,r_103_70_96,0.96,-2,94,96,1
7,r_99_80_12,r_6_4_188,r_62_3_7,r_99_80_12,1.0,0,12,12,1
9,r_69_59_185,seq24,seq25,r_69_59_185,0.44,0,185,185,1
28,r_16_107_125,r_76_85_53,r_134_125_97,r_16_107_125,0.92,2,127,125,1
22,r_6_4_188,seq25,r_15_50_102,r_15_50_102,0.74,85,187,102,1
28,r_16_107_125,r_39_105_52,r_76_85_53,r_76_85_53,0.72,10,63,53,1
44,r_83_118_132,r_44_45_110,r_110_1_59,r_110_1_59,0.85,51,110,59,1
85,seq77,r_146_74_79,seq61,r_146_74_79,0.6,12,91,79,1
35,r_55_67_93,r_46_53_177,r_98_35_36,r_55_67_93,0.99,0,93,93,1
12,r_103_70_96,seq8,r_76_85_53,r_76_85_53,1.0,51,104,53,1
23,r_98_35_36,r_115_96_17,r_55_67_93,r_55_67_93,1.0,5,98,93,1
30,r_111_76_65,r_95_68_160,seq41,r_111_76_65,0.94,-2,63,65,2
36,r_141_44_63,r_94_145_164,seq39,r_141_44_63,1.0,0,63,63,2
92,seq98,r_12_80_94,r_57_81_82,r_57_81_82,0.99,20,102,82,2
28,r_116_19_15,r_69_25_156,seq67,r_116_19_15,0.91,0,15,15,2
14,r_57_81_82,r_3_48_184,seq98,r_57_81_82,1.0,1,83,82,2
8,r_35_144_183,seq134,r_136_66_68,r_136_66_68,1.0,115,183,68,2
43,r_79_122_104,r_31_121_124,r_136_66_68,r_79_122_104,0.92,0,104,104,2
3,r_74_22_176,r_147_83_37,r_95_68_160,r_147_83_37,0.66,139,176,37,2
19,r_109_85_55,r_129_50_173,seq101,r_129_50_173,0.48,3,176,173,2
55,seq7,r_136_66_68,seq134,r_136_66_68,1.0,0,68,68,2
16,r_120_62_115,r_129_50_173,seq73,r_120_62_115,0.85,0,115,115,2
40,r_55_2_87,r_28_93_92,r_118_139_11,r_55_2_87,0.9,1,88,87,2
1,r_94_145_164,seq24,r_57_81_82,r_57_81_82,1.0,85,167,82,2
42,r_3_48_184,seq128,r_120_62_115,r_120_62_115,0.59,69,184,115,2
45,r_54_56_129,r_3_48_184,seq21,r_54_56_129,0.97,-3,126,129,2
11,r_46_142_23,seq101,seq107,r_46_142_23,0.73,0,23,23,2
10,r_45_43_67,r_140_75_185,r_141_44_63,r_45_43_67,1.0,0,67,67,2
26,r_148_127_105,seq64,seq128,r_148_127_105,0.92,0,105,105,2
0,r_53_149_41,r_31_121_124,r_6_0_199,r_53_149_41,1.0,0,41,41,2
73,seq49,r_47_33_119,seq17,r_47_33_119,0.98,0,119,119,2
48,r_69_25_156,r_116_19_15,r_26_82_36,r_69_25_156,0.52,-143,13,156,2
20,r_28_93_92,seq41,r_141_44_63,r_28_93_92,0.68,3,95,92,2
46,r_147_83_37,r_74_22_176,r_118_139_11,r_74_22_176,0.89,0,176,176,2
17,r_26_82_36,seq63,r_69_25_156,r_26_82_36,0.91,1,37,36,2
12,r_129_50_173,seq8,seq49,r_129_50_173,0.64,3,176,173,2
6,r_31_121_124,seq64,r_126_131_27,r_31_121_124,0.86,2,126,124,2
19,r_109_85_55,r_130_10_158,r_129_50_173,r_109_85_55,0.71,0,55,55,2
27,r_91_115_101,r_129_50_173,r_118_139_11,r_91_115_101,0.99,0,101,101,2
39,r_138_97_34,r_125_88_181,seq18,r_138_97_34,1.0,1,35,34,2
22,r_136_66_68,r_11_137_154,r_138_97_34,r_11_137_154,1.0,0,154,154,2
2,r_123_146_131,seq4,seq38,r_123_146_131,0.94,1,132,131,2
40,r_55_2_87,r_20_112_62,r_28_93_92,r_20_112_62,0.75,4,66,62,2
46,r_147_83_37,r_129_50_173,r_74_22_176,r_147_83_37,1.0,0,37,37,2
18,r_133_27_141,seq8,seq4,r_133_27_141,0.93,0,141,141,2
29,r_11_137_154,seq18,r_136_66_68,r_136_66_68,1.0,13,81,68,2
24,r_110_113_73,r_140_75_185,seq42,r_110_113_73,1.0,0,73,73,2
33,r_12_80_94,seq98,r_106_36_59,r_12_80_94,0.6,8,102,94,2
48,r_69_25_156,r_26_82_36,r_103_71_80,r_103_71_80,0.99,10,90,80,2
64,seq30,r_14_114_171,r_110_113_73,r_110_113_73,1.0,73,146,73,2
48,r_69_25_156,r_103_71_80,seq51,r_69_25_156,0.99,0,156,156,2
50,seq128,r_3_48_184,r_118_139_11,r_3_48_184,0.45,0,184,184,2
32,r_20_112_62,r_55_2_87,seq72,r_20_112_62,0.97,4,66,62,2
15,r_126_131_27,r_94_145_164,seq41,r_126_131_27,0.86,0,27,27,2
34,r_9_135_91,seq39,seq73,r_9_135_91,0.94,0,91,91,2
95,seq107,r_109_85_55,r_46_142_23,r_109_85_55,0.85,-2,53,55,2
5,r_99_65_58,r_11_137_154,seq61,r_99_65_58,1.0,-1,57,58,2
9,r_140_75_185,seq1,r_109_85_55,r_140_75_185,0.22,2,187,185,2
29,r_11_137_154,r_136_66_68,seq132,r_11_137_154,0.57,1,155,154,2
22,r_136_66_68,seq7,r_11_137_154,r_136_66_68,1.0,0,68,68,2
73,seq49,seq17,r_129_50_173,r_129_50_173,0.8,14,187,173,2
91,seq96,r_11_137_154,r_138_97_34,r_138_97_34,0.48,122,156,34,2
56,seq8,r_133_27_141,r_60_84_10,r_133_27_141,1.0,0,141,141,2
7,r_47_33_119,seq49,seq128,r_47_33_119,0.96,0,119,119,2
44,r_95_68_160,seq34,seq5,r_95_68_160,0.46,-7,153,160,2
23,r_103_71_80,r_28_93_92,r_69_25_156,r_103_71_80,0.55,0,80,80,2
41,r_106_36_59,r_111_76_65,seq63,r_106_36_59,0.89,-2,57,59,2
17,r_26_82_36,r_69_25_156,r_103_71_80,r_26_82_36,0.8,97,133,36,2
12,r_129_50_173,r_120_62_115,seq8,r_120_62_115,1.0,0,115,115,2
23,r_103_71_80,r_69_25_156,r_26_82_36,r_69_25_156,0.99,0,156,156,2
3,r_74_22_176,seq7,r_147_83_37,r_147_83_37,1.0,1,38,37,2
40,r_25_23_169,r_111_124_85,r_28_14_111,r_25_23_169,0.66,0,169,169,3
30,r_96_133_143,seq112,r_91_17_70,r_96_133_143,1.0,1,144,143,3
38,r_13_119_75,r_80_56_44,seq120,r_80_56_44,1.0,2,46,44,3
36,r_77_128_100,seq31,seq92,r_77_128_100,0.97,0,100,100,3
14,r_91_17_70,r_145_113_68,seq138,r_145_113_68,0.8,0,68,68,3
8,r_76_66_107,seq52,seq30,r_76_66_107,0.97,1,108,107,3
53,seq6,r_110_89_194,r_103_15_186,r_110_89_194,0.41,-6,188,194,3
37,r_82_68_61,seq60,r_65_19_55,r_82_68_61,0.62,0,61,61,3
19,r_140_135_18,r_122_87_192,r_7_5_156,r_122_87_192,0.56,-28,164,192,3
16,r_98_3_94,r_25_23_169,r_100_20_65,r_25_23_169,0.52,-61,108,169,3
39,r_99_137_98,r_27_97_45,seq16,r_99_137_98,1.0,0,98,98,3
97,seq120,r_26_118_56,seq39,r_26_118_56,1.0,5,61,56,3
42,r_27_97_45,r_99_137_98,r_63_148_33,r_27_97_45,1.0,53,98,45,3
69,seq39,r_109_51_105,seq120,r_109_51_105,1.0,0,105,105,3
45,r_100_20_65,seq88,r_67_84_173,r_100_20_65,0.95,5,70,65,3
41,r_18_132_104,seq11,seq61,r_18_132_104,0.78,2,106,104,3
43,r_136_78_14,r_110_89_194,r_91_17_70,r_110_89_194,0.55,-178,16,194,3
3,r_121_114_139,seq24,seq88,r_121_114_139,0.58,0,139,139,3
5,r_63_148_33,r_100_20_65,r_122_87_192,r_63_148_33,1.0,0,33,33,3
26,r_64_106_184,r_4_32_157,r_121_114_139,r_4_32_157,0.69,0,157,157,3
48,r_53_59_17,r_103_15_186,seq142,r_53_59_17,1.0,0,17,17,3
4,r_57_9_130,seq85,seq37,r_57_9_130,0.97,0,130,130,3
0,r_145_113_68,r_91_17_70,seq30,r_145_113_68,1.0,0,68,68,3
11,r_109_51_105,seq39,seq60,r_109_51_105,0.98,0,105,105,3
31,r_40_29_26,seq37,r_71_74_42,r_40_29_26,1.0,1,27,26,3
46,r_122_87_192,r_99_137_98,r_63_148_33,r_122_87_192,1.0,-145,47,192,3
34,r_65_19_55,seq34,r_82_68_61,r_65_19_55,1.0,1,56,55,3
19,r_140_135_18,r_67_84_173,r_122_87_192,r_140_135_18,0.98,0,18,18,3
27,r_26_118_56,seq120,r_93_105_62,r_26_118_56,1.0,7,63,56,3
2,r_46_102_116,seq24,r_145_113_68,r_46_102_116,0.89,4,120,116,3
47,r_72_134_80,seq50,r_93_105_62,r_72_134_80,1.0,0,80,80,3
40,r_25_23_169,r_98_3_94,r_111_124_85,r_111_124_85,0.68,23,108,85,3
29,r_0_125_124,seq117,seq112,r_0_125_124,0.98,0,124,124,3
59,seq143,seq2,r_80_56_44,r_80_56_44,1.0,1,45,44,3
25,r_107_146_114,seq31,seq34,r_107_146_114,0.93,0,114,114,3
33,r_47_1_89,r_111_124_85,r_63_148_33,r_47_1_89,0.84,3,92,89,3
70,seq42,seq88,r_111_124_85,r_111_124_85,0.93,10,95,85,3
32,r_93_105_62,r_103_15_186,seq31,r_93_105_62,1.0,1,63,62,3
18,r_80_56_44,r_13_119_75,seq143,r_80_56_44,1.0,2,46,44,3
17,r_7_5_156,seq85,r_140_135_18,r_140_135_18,0.86,146,164,18,3
9,r_111_124_85,r_47_1_89,seq42,r_47_1_89,0.73,-2,87,89,3
96,seq117,r_0_125_124,r_12_115_106,r_0_125_124,1.0,0,124,124,3
22,r_4_32_157,r_64_106_184,seq39,r_64_106_184,0.69,-27,157,184,3
91,seq95,r_49_10_131,r_65_19_55,r_65_19_55,0.92,76,131,55,3
49,r_104_33_108,r_38_43_176,r_93_105_62,r_38_43_176,1.0,-68,108,176,3
7,r_28_14_111,seq58,r_98_3_94,r_28_14_111,1.0,0,111,111,3
44,r_49_10_131,seq95,r_18_132_104,r_49_10_131,1.0,0,131,131,3
35,r_48_108_160,seq126,r_121_114_139,r_48_108_160,0.97,0,160,160,3
8,r_3_147_67,seq25,seq65,r_3_147_67,1.0,-1,66,67,4
83,seq85,r_120_33_185,seq54,r_120_33_185,0.5,0,185,185,4
37,r_102_36_30,r_88_131_121,seq35,r_102_36_30,0.92,-2,28,30,4
2,r_67_97_58,seq142,seq34,r_67_97_58,0.97,0,58,58,4
3,r_45_71_11,r_88_131_121,seq48,r_45_71_11,0.97,0,11,11,4
16,r_73_149_158,r_109_2_133,r_124_87_80,r_109_2_133,0.66,0,133,133,4
97,seq121,r_16_17_157,seq89,r_16_17_157,0.86,0,157,157,4
5,r_16_17_157,seq121,seq134,r_16_17_157,0.46,10,167,157,4
46,r_126_38_144,seq48,r_5_96_106,r_126_38_144,0.99,0,144,144,4
1,r_91_57_39,seq85,r_56_49_38,r_91_57_39,0.99,0,39,39,4
47,r_56_49_38,seq55,r_91_57_39,r_56_49_38,0.96,-4,34,38,4
19,r_10_83_91,seq113,seq52,r_10_83_91,1.0,0,91,91,4
15,r_5_96_106,r_16_17_157,r_30_59_45,r_30_59_45,1.0,-4,41,45,4
15,r_5_96_106,r_30_59_45,seq54,r_5_96_106,0.99,0,106,106,4
41,r_47_128_90,seq15,r_66_114_75,r_47_128_90,0.96,2,92,90,4
67,seq32,seq119,r_66_114_75,r_66_114_75,1.0,33,108,75,4
10,r_148_123_99,seq146,r_3_147_67,r_148_123_99,0.97,1,100,99,4
25,r_133_28_175,seq99,r_91_57_39,r_91_57_39,1.0,6,45,39,4
4,r_79_93_73,r_21_46_187,r_112_60_141,r_79_93_73,0.91,1,74,73,4
26,r_145_64_60,r_69_104_81,seq136,r_145_64_60,0.57,2,62,60,4
12,r_124_87_80,r_10_83_91,r_133_28_175,r_124_87_80,0.82,102,182,80,4
0,r_66_114_75,r_80_101_142,seq113,r_66_114_75,1.0,0,75,75,4
11,r_103_13_79,r_81_61_100,seq113,r_81_61_100,1.0,-26,74,100,4
20,r_81_61_100,r_103_13_79,seq77,r_81_61_100,0.97,0,100,100,4
13,r_72_9_146,seq48,seq7,r_72_9_146,0.93,0,146,146,4
12,r_124_87_80,r_73_149_158,r_10_83_91,r_10_83_91,0.58,71,162,91,4
6,r_120_33_185,seq85,r_3_147_67,r_120_33_185,0.28,0,185,185,4
4,r_79_93_73,r_40_144_24,r_21_46_187,r_40_144_24,0.88,10,34,24,4
40,r_53_39_104,seq136,seq119,r_53_39_104,0.88,4,108,104,4
45,r_74_107_40,seq32,seq135,r_74_107_40,0.87,-4,36,40,4
18,r_80_101_142,seq62,r_12_125_22,r_80_101_142,0.54,0,142,142,4
29,r_29_43_65,seq142,r_12_125_22,r_29_43_65,0.68,2,67,65,4
34,r_30_59_45,r_5_96_106,seq89,r_5_96_106,1.0,0,106,106,4
16,r_73_149_158,r_124_87_80,r_81_61_100,r_73_149_158,0.76,15,173,158,4
88,seq99,r_44_14_130,r_31_117_82,r_31_117_82,0.46,23,105,82,4
32,r_24_75_114,r_108_76_154,r_79_93_73,r_108_76_154,0.79,-39,115,154,4
24,r_139_58_12,seq18,seq77,r_139_58_12,0.92,0,12,12,4
75,seq52,r_88_131_121,r_10_83_91,r_10_83_91,0.98,1,92,91,4
14,r_86_98_29,r_72_9_146,r_1_23_34,r_86_98_29,1.0,-1,28,29,4
34,r_30_59_45,seq19,r_5_96_106,r_30_59_45,0.97,-5,40,45,4
43,r_40_144_24,r_79_93_73,r_103_13_79,r_79_93_73,0.74,-50,23,73,4
25,r_133_28_175,r_91_57_39,r_124_87_80,r_133_28_175,0.51,0,175,175,4
21,r_118_84_21,r_66_114_75,r_45_71_11,r_118_84_21,0.6,0,21,21,4
44,r_109_2_133,r_73_149_158,r_130_92_170,r_73_149_158,0.52,-25,133,158,4
23,r_31_117_82,r_80_101_142,seq99,r_80_101_142,0.89,-55,87,142,4
4,r_79_93_73,r_112_60_141,r_24_75_114,r_79_93_73,0.98,46,119,73,4
35,r_70_50_159,seq52,r_5_96_106,r_5_96_106,0.75,53,159,106,4
12,r_124_87_80,r_8_110_93,r_73_149_158,r_8_110_93,0.91,-13,80,93,4
30,r_96_108_98,r_131_16_130,seq18,r_96_108_98,1.0,0,98,98,5
32,r_93_114_197,r_38_57_39,seq103,r_38_57_39,0.63,7,46,39,5
83,seq83,r_23_59_133,seq63,r_23_59_133,1.0,-15,118,133,5
37,r_106_53_167,r_26_14_143,r_127_104_23,r_106_53_167,0.75,0,167,167,5
46,r_66_31_162,seq43,r_61_102_25,r_66_31_162,0.74,2,164,162,5
42,r_148_72_92,seq2,seq79,r_148_72_92,0.98,0,92,92,5
32,r_93_114_197,seq103,r_119_141_147,r_119_141_147,1.0,1,148,147,5
7,r_95_20_36,seq4,r_48_149_99,r_48_149_99,1.0,55,154,99,5
19,r_46_145_12,r_30_51_106,seq41,r_46_145_12,0.93,0,12,12,5
27,r_111_139_83,r_132_100_142,r_28_17_95,r_111_139_83,0.83,40,123,83,5
31,r_119_141_147,seq67,r_93_114_197,r_119_141_147,0.92,0,147,147,5
41,r_121_42_85,r_34_12_140,r_116_86_45,r_121_42_85,0.99,0,85,85,5
67,seq43,r_66_31_162,seq55,r_66_31_162,0.9,-4,158,162,5
89,seq99,r_48_149_99,seq7,r_48_149_99,1.0,0,99,99,5
3,r_147_80_154,r_5_97_170,r_38_57_39,r_38_57_39,0.71,57,96,39,5
10,r_92_115_131,seq58,seq36,r_92_115_131,0.95,0,131,131,5
8,r_127_104_23,r_24_123_37,seq107,r_127_104_23,0.95,0,23,23,5
26,r_37_126_77,seq84,seq82,r_37_126_77,0.95,2,79,77,5
4,r_74_94_109,r_138_109_118,seq120,r_138_109_118,1.0,-9,109,118,5
0,r_1_124_104,r_50_39_159,r_71_64_11,r_50_39_159,0.6,-54,105,159,5
15,r_81_70_80,seq63,seq43,r_81_70_80,1.0,1,81,80,5
48,r_26_14_143,r_106_53_167,seq77,r_106_53_167,0.93,0,167,167,5
6,r_45_130_124,r_19_78_52,r_54_75_56,r_54_75_56,0.96,70,126,56,5
9,r_24_123_37,r_121_42_85,seq142,r_24_123_37,1.0,0,37,37,5
16,r_29_49_34,seq110,seq83,r_29_49_34,0.97,0,34,34,5
52,seq4,r_95_20_36,r_112_129_127,r_112_129_127,1.0,21,148,127,5
45,r_116_86_45,r_89_146_196,seq58,r_116_86_45,1.0,0,45,45,5
27,r_111_139_83,r_28_17_95,r_132_100_142,r_132_100_142,0.86,-59,83,142,5
47,r_11_3_81,r_28_17_95,seq2,r_11_3_81,0.83,0,81,81,5
40,r_13_60_146,seq83,r_22_32_24,r_22_32_24,0.72,123,147,24,5
18,r_30_51_106,r_112_129_127,r_81_70_80,r_112_129_127,1.0,-21,106,127,5
29,r_6_9_120,seq82,r_1_124_104,r_6_9_120,0.52,4,124,120,5
28,r_54_75_56,r_81_70_80,seq125,r_54_75_56,0.63,1,57,56,5
25,r_88_25_84,seq33,seq27,r_88_25_84,1.0,0,84,84,5
64,seq36,seq84,r_92_115_131,r_92_115_131,0.93,-1,130,131,5
21,r_22_32_24,seq137,seq56,r_22_32_24,1.0,0,24,24,5
22,r_138_109_118,r_81_70_80,seq44,r_138_109_118,0.95,0,118,118,5
38,r_112_129_127,r_85_15_171,seq4,r_112_129_127,0.96,1,128,127,5
24,r_38_57_39,r_93_114_197,r_147_80_154,r_93_114_197,0.78,-153,44,197,5
81,seq79,r_147_80_154,r_148_72_92,r_148_72_92,1.0,2,94,92,5
17,r_132_100_142,seq27,seq63,r_132_100_142,0.59,5,147,142,5
94,seq110,r_61_102_25,r_23_59_133,r_23_59_133,0.98,34,167,133,5
22,r_138_109_118,r_74_94_109,r_81_70_80,r_81_70_80,0.96,14,94,80,5
7,r_95_20_36,seq55,seq4,r_95_20_36,1.0,0,36,36,5
49,r_50_39_159,seq43,seq8,r_50_39_159,0.83,0,159,159,5
39,r_144_10_42,seq7,seq21,r_144_10_42,1.0,2,44,42,5
56,seq8,r_140_122_192,r_50_39_159,r_50_39_159,0.75,23,182,159,5
23,r_48_149_99,seq99,r_95_20_36,r_48_149_99,1.0,0,99,99,5
35,r_23_59_133,seq83,seq110,r_23_59_133,0.97,0,133,133,5
30,r_19_50_104,r_116_43_188,r_52_77_136,r_19_50_104,1.0,2,106,104,6
14,r_14_101_93,r_111_108_13,seq7,r_14_101_93,0.98,0,93,93,6
8,r_127_54_141,seq92,seq6,r_127_54_141,0.83,0,141,141,6
24,r_69_86_165,seq78,r_62_93_41,r_62_93_41,1.0,8,49,41,6
1,r_119_83_97,seq15,r_46_99_52,r_119_83_97,0.95,0,97,97,6
5,r_133_91_113,seq118,seq126,r_133_91_113,0.99,0,113,113,6
46,r_63_18_118,seq126,seq92,r_63_18_118,0.94,2,120,118,6
42,r_45_148_78,r_4_5_134,r_115_122_4,r_115_122_4,0.54,74,78,4,6
24,r_69_86_165,r_62_93_41,seq71,r_69_86_165,0.85,1,166,165,6
34,r_125_33_25,r_124_123_53,seq24,r_125_33_25,1.0,1,26,25,6
78,seq65,r_124_123_53,r_100_10_29,r_124_123_53,0.82,0,53,53,6
16,r_134_44_33,r_62_93_41,seq113,r_134_44_33,0.91,-3,30,33,6
45,r_100_10_29,seq13,seq65,r_100_10_29,1.0,0,29,29,6
31,r_102_39_157,seq66,r_98_112_7,r_102_39_157,0.87,0,157,157,6
41,r_149_75_82,seq90,seq17,r_149_75_82,0.88,0,82,82,6
12,r_110_81_24,seq118,r_72_38_122,r_110_81_24,0.89,3,27,24,6
90,seq92,r_127_54_141,seq15,r_127_54_141,0.87,0,141,141,6
0,r_135_2_126,seq118,r_55_138_124,r_135_2_126,0.95,2,128,126,6
11,r_52_77_136,seq136,r_19_50_104,r_19_50_104,1.0,49,153,104,6
13,r_12_61_100,r_63_18_118,r_144_107_59,r_12_61_100,1.0,0,100,100,6
98,seq118,r_111_108_13,r_29_80_40,r_29_80_40,1.0,38,78,40,6
15,r_60_76_116,r_140_130_174,r_29_80_40,r_60_76_116,0.98,1,117,116,6
12,r_110_81_24,r_72_38_122,seq147,r_72_38_122,1.0,-8,114,122,6
39,r_124_123_53,seq65,r_115_122_4,r_124_123_53,1.0,0,53,53,6
27,r_68_35_127,seq66,r_20_27_68,r_68_35_127,0.99,1,128,127,6
20,r_58_0_15,r_100_10_29,seq87,r_58_0_15,1.0,0,15,15,6
2,r_9_82_66,r_20_27_68,seq13,r_9_82_66,0.97,1,67,66,6
40,r_103_34_61,r_60_76_116,r_29_80_40,r_29_80_40,0.6,21,61,40,6
28,r_62_93_41,r_4_5_134,r_69_86_165,r_62_93_41,0.98,0,41,41,6
18,r_116_43_188,seq21,r_52_77_136,r_116_43_188,0.53,0,188,188,6
29,r_55_138_124,seq7,r_135_2_126,r_55_138_124,0.89,2,126,124,6
25,r_37_143_70,r_121_56_195,seq106,r_37_143_70,1.0,0,70,70,6
47,r_72_38_122,r_110_81_24,r_133_91_113,r_110_81_24,0.79,99,123,24,6
88,seq89,r_36_142_178,r_8_74_58,r_8_74_58,1.0,121,179,58,6
50,seq131,r_121_56_195,r_46_99_52,r_46_99_52,1.0,29,81,52,6
65,seq24,r_140_130_174,r_125_33_25,r_125_33_25,0.92,149,174,25,6
94,seq106,seq136,r_37_143_70,r_37_143_70,1.0,8,78,70,6
9,r_48_1_119,seq22,r_45_148_78,r_48_1_119,0.99,1,120,119,6
50,seq131,r_46_99_52,r_121_56_195,r_46_99_52,0.67,108,160,52,6
28,r_62_93_41,r_69_86_165,seq78,r_62_93_41,0.55,90,131,41,6
17,r_59_146_14,r_119_83_97,seq22,r_59_146_14,0.98,1,15,14,6
22,r_144_107_59,r_135_2_126,seq139,r_144_107_59,0.51,5,64,59,6
1,r_119_83_97,r_46_99_52,r_4_5_134,r_4_5_134,1.0,3,137,134,6
44,r_115_122_4,r_55_138_124,r_45_148_78,r_115_122_4,0.96,74,78,4,6
23,r_20_27_68,seq139,seq114,r_20_27_68,1.0,2,70,68,6
17,r_59_146_14,seq22,r_110_81_24,r_110_81_24,0.33,139,163,24,6
10,r_46_99_52,seq88,seq141,r_46_99_52,1.0,1,53,52,6
47,r_72_38_122,seq147,r_110_81_24,r_110_81_24,0.81,14,38,24,6
32,r_73_145_17,r_62_93_41,seq21,r_73_145_17,0.9,0,17,17,6
79,seq66,r_68_35_127,seq141,r_68_35_127,1.0,1,128,127,6
19,r_29_80_40,seq7,seq118,r_29_80_40,1.0,0,40,40,6
84,seq141,seq7,r_46_99_52,r_46_99_52,1.0,22,74,52,6
36,r_32_39_110,seq27,seq58,r_32_39_110,0.87,0,110,110,7
9,r_0_12_127,r_22_91_44,r_82_73_101,r_0_12_127,0.98,0,127,127,7
28,r_76_74_16,r_96_131_36,seq69,r_76_74_16,0.95,0,16,16,7
17,r_16_24_28,r_79_45_73,seq106,r_16_24_28,0.52,-6,22,28,7
27,r_80_81_161,seq21,r_53_123_37,r_80_81_161,1.0,0,161,161,7
37,r_134_50_130,r_95_109_156,r_117_33_129,r_95_109_156,0.8,-25,131,156,7
5,r_145_5_45,seq126,seq147,r_145_5_45,1.0,1,46,45,7
39,r_4_119_93,r_85_14_4,r_1_43_64,r_85_14_4,1.0,89,93,4,7
1,r_72_42_112,r_11_135_123,r_9_136_116,r_11_135_123,0.63,-9,114,123,7
42,r_70_140_83,seq128,seq111,r_70_140_83,0.99,5,88,83,7
45,r_41_66_69,r_49_113_147,seq35,r_41_66_69,1.0,-1,68,69,7
19,r_95_109_156,r_3_17_160,r_117_33_129,r_3_17_160,0.48,-4,156,160,7
76,seq68,r_54_10_187,r_117_33_129,r_117_33_129,1.0,37,166,129,7
10,r_104_36_132,seq147,seq8,r_104_36_132,0.87,1,133,132,7
26,r_1_43_64,seq141,r_26_118_173,r_1_43_64,1.0,0,64,64,7
16,r_65_51_49,r_37_52_162,r_121_46_106,r_121_46_106,1.0,1,107,106,7
0,r_11_135_123,seq124,r_59_97_196,r_11_135_123,0.61,2,125,123,7
20,r_54_10_187,r_116_94_158,r_72_42_112,r_116_94_158,0.26,29,187,158,7
13,r_117_33_129,seq111,r_116_94_158,r_117_33_129,0.97,0,129,129,7
15,r_49_113_147,r_26_118_173,r_117_33_129,r_49_113_147,0.96,0,147,147,7
48,r_26_118_173,r_49_113_147,r_4_119_93,r_4_119_93,1.0,16,109,93,7
4,r_22_91_44,r_0_12_127,r_4_119_93,r_22_91_44,0.99,83,127,44,7
6,r_53_123_37,r_105_99_138,seq146,r_53_123_37,1.0,0,37,37,7
27,r_80_81_161,r_31_60_128,seq21,r_31_60_128,0.96,0,128,128,7
9,r_0_12_127,r_49_113_147,r_22_91_44,r_22_91_44,1.0,1,45,44,7
22,r_56_127_150,r_57_132_26,r_32_39_110,r_32_39_110,1.0,40,150,110,7
2,r_114_103_153,seq58,r_22_91_44,r_114_103_153,0.77,1,154,153,7
24,r_34_28_80,r_82_73_101,seq126,r_34_28_80,1.0,0,80,80,7
33,r_31_60_128,r_80_81_161,r_72_42_112,r_31_60_128,0.87,0,128,128,7
48,r_26_118_173,r_4_119_93,seq88,r_26_118_173,0.99,0,173,173,7
50,seq128,r_70_140_83,seq40,r_70_140_83,1.0,5,88,83,7
65,seq27,r_32_39_110,r_110_92_115,r_32_39_110,1.0,0,110,110,7
3,r_19_143_15,r_116_94_158,seq78,r_19_143_15,1.0,0,15,15,7
32,r_37_52_162,r_116_94_158,r_96_131_36,r_96_131_36,0.64,126,162,36,7
22,r_56_127_150,r_11_135_123,r_57_132_26,r_57_132_26,1.0,4,30,26,7
4,r_22_91_44,r_96_131_36,r_0_12_127,r_22_91_44,0.99,0,44,44,7
25,r_57_132_26,r_56_127_150,seq124,r_56_127_150,0.82,0,150,150,7
21,r_96_131_36,seq138,seq147,r_96_131_36,0.94,10,46,36,7
11,r_144_129_23,r_104_36_132,seq83,r_144_129_23,0.86,1,24,23,7
26,r_1_43_64,r_26_118_173,r_4_119_93,r_1_43_64,0.82,109,173,64,7
49,r_125_63_65,r_117_33_129,seq137,r_117_33_129,0.97,-64,65,129,7
25,r_57_132_26,seq83,r_56_127_150,r_57_132_26,1.0,0,26,26,7
23,r_139_13_91,r_95_109_156,seq138,r_139_13_91,0.97,1,92,91,7
34,r_7_61_35,r_49_113_147,r_85_14_4,r_7_61_35,1.0,1,36,35,7
16,r_65_51_49,r_48_6_155,r_37_52_162,r_65_51_49,1.0,0,49,49,7
12,r_105_99_138,seq2,r_34_28_80,r_105_99_138,0.92,0,138,138,7
40,r_96_64_168,r_32_112_75,seq86,r_96_64_168,0.95,0,168,168,8
30,r_18_89_177,seq6,r_146_56_184,r_18_89_177,0.75,0,177,177,8
36,r_119_35_96,r_48_30_186,seq73,r_119_35_96,1.0,1,97,96,8
28,r_132_22_26,r_96_64_168,seq7,r_132_22_26,1.0,1,27,26,8
37,r_48_30_186,r_75_142_62,r_132_22_26,r_132_22_26,0.85,160,186,26,8
16,r_125_76_66,r_66_104_194,seq6,r_125_76_66,1.0,-2,64,66,8
21,r_78_27_97,r_92_116_190,r_26_85_25,r_78_27_97,1.0,0,97,97,8
39,r_84_63_143,r_62_58_149,r_34_143_146,r_84_63_143,0.94,2,145,143,8
1,r_74_70_126,seq94,seq141,r_74_70_126,0.86,0,126,126,8
5,r_41_126_123,r_37_28_104,seq1,r_37_28_104,0.94,1,105,104,8
46,r_99_44_150,seq86,seq20,r_99_44_150,0.76,1,151,150,8
42,r_87_140_179,r_146_56_184,r_132_22_26,r_132_22_26,0.96,153,179,26,8
45,r_134_91_198,r_0_3_125,r_24_57_112,r_134_91_198,0.99,-73,125,198,8
19,r_47_124_49,r_18_89_177,seq135,r_18_89_177,0.83,-114,63,177,8
76,seq138,r_106_2_140,seq68,r_106_2_140,0.97,-6,134,140,8
31,r_31_123_70,seq118,seq79,r_31_123_70,1.0,0,70,70,8
41,r_54_103_100,r_72_53_103,seq131,r_72_53_103,0.99,0,103,103,8
26,r_98_80_185,r_9_136_166,seq67,r_9_136_166,0.96,-60,106,166,8
72,seq50,r_146_56_184,r_0_3_125,r_0_3_125,1.0,5,130,125,8
2,r_77_15_13,seq137,seq14,r_77_15_13,1.0,0,13,13,8
4,r_95_144_101,seq141,r_75_142_62,r_95_144_101,1.0,2,103,101,8
78,seq68,r_106_2_140,seq138,r_106_2_140,0.75,-20,120,140,8
0,r_42_11_141,seq145,r_132_22_26,r_42_11_141,0.79,1,142,141,8
20,r_37_28_104,r_41_126_123,r_147_148_46,r_37_28_104,1.0,1,105,104,8
15,r_72_53_103,seq29,r_83_105_44,r_72_53_103,1.0,0,103,103,8
9,r_34_143_146,r_46_110_147,r_43_5_163,r_43_5_163,0.74,9,172,163,8
6,r_9_136_166,r_43_5_163,r_26_85_25,r_9_136_166,0.96,0,166,166,8
78,seq68,seq138,r_65_51_154,r_65_51_154,1.0,5,159,154,8
27,r_75_142_62,r_24_57_112,r_129_139_27,r_75_142_62,0.97,1,63,62,8
22,r_32_112_75,r_96_64_168,r_83_105_44,r_96_64_168,0.98,0,168,168,8
3,r_21_45_28,r_83_105_44,seq1,r_21_45_28,0.99,0,28,28,8
40,r_96_64_168,seq20,r_32_112_75,r_32_112_75,1.0,1,76,75,8
74,seq55,r_106_2_140,r_23_36_74,r_23_36_74,0.47,66,140,74,8
47,r_127_4_55,r_106_2_140,seq149,r_127_4_55,1.0,1,56,55,8
24,r_0_3_125,r_134_91_198,seq50,r_0_3_125,1.0,0,125,125,8
13,r_83_105_44,seq94,seq20,r_83_105_44,0.75,6,50,44,8
32,r_49_25_58,r_48_30_186,seq79,r_49_25_58,0.82,5,63,58,8
38,r_65_51_154,seq1,seq68,r_65_51_154,0.7,2,156,154,8
34,r_60_8_90,seq52,seq6,r_60_8_90,0.88,0,90,90,8
33,r_129_139_27,r_42_11_141,r_75_142_62,r_129_139_27,1.0,0,27,27,8
17,r_62_58_149,r_84_63_143,r_95_144_101,r_95_144_101,0.52,44,145,101,8
9,r_34_143_146,r_115_117_155,r_46_110_147,r_34_143_146,0.18,0,146,146,8
22,r_32_112_75,r_65_51_154,r_96_64_168,r_32_112_75,1.0,1,76,75,8
91,seq145,r_42_11_141,seq82,r_42_11_141,1.0,0,141,141,8
49,r_43_5_163,r_9_136_166,r_34_143_146,r_9_136_166,0.6,-1,165,166,8
7,r_23_36_74,r_92_116_190,seq55,r_23_36_74,0.99,0,74,74,8
48,r_93_100_42,r_75_142_62,seq141,r_93_100_42,1.0,0,42,42,8
44,r_24_57_112,seq128,seq97,r_24_57_112,1.0,0,112,112,8
23,r_90_61_156,r_48_30_186,r_54_103_100,r_90_61_156,0.42,4,160,156,8
82,seq79,r_84_63_143,r_31_123_70,r_31_123_70,0.9,14,84,70,8
35,r_106_2_140,r_115_117_155,r_60_8_90,r_115_117_155,0.91,-15,140,155,8
22,r_47_46_27,r_108_78_85,seq62,r_108_78_85,1.0,-46,39,85,9
92,seq100,seq130,r_50_8_110,r_50_8_110,0.94,42,152,110,9
61,seq21,r_47_46_27,r_13_16_43,r_13_16_43,1.0,8,51,43,9
8,r_37_34_71,r_9_87_194,seq118,r_37_34_71,0.94,1,72,71,9
32,r_24_104_29,r_95_140_67,seq149,r_24_104_29,0.82,2,31,29,9
37,r_82_96_124,seq147,seq65,r_82_96_124,0.9,0,124,124,9
3,r_69_11_65,r_56_36_133,seq44,r_56_36_133,1.0,0,133,133,9
69,seq40,r_41_119_30,seq130,r_41_119_30,0.75,3,33,30,9
19,r_121_5_45,r_110_32_34,r_74_20_75,r_74_20_75,0.64,34,109,75,9
71,seq48,r_26_142_118,seq57,r_26_142_118,0.73,-2,116,118,9
86,seq143,r_124_42_156,seq48,r_124_42_156,0.65,2,158,156,9
39,r_124_42_156,seq143,r_75_76_52,r_124_42_156,0.72,2,158,156,9
1,r_141_125_167,seq33,seq130,r_141_125_167,0.7,0,167,167,9
5,r_26_142_118,seq48,seq28,r_26_142_118,0.91,-2,116,118,9
42,r_108_78_85,r_47_46_27,r_45_14_31,r_108_78_85,1.0,0,85,85,9
80,seq63,r_127_102_129,r_56_36_133,r_56_36_133,0.94,1,134,133,9
44,r_129_135_90,r_41_119_30,r_43_134_115,r_43_134_115,1.0,20,135,115,9
16,r_23_139_42,r_43_134_115,r_79_53_9,r_23_139_42,0.84,0,42,42,9
38,r_85_136_182,r_12_80_58,r_138_92_57,r_138_92_57,0.76,127,184,57,9
31,r_66_19_87,seq128,seq93,r_66_19_87,0.97,2,89,87,9
33,r_138_92_57,seq147,seq103,r_138_92_57,1.0,0,57,57,9
41,r_95_140_67,r_129_135_90,r_114_90_137,r_95_140_67,0.95,1,68,67,9
67,seq33,r_141_125_167,r_69_11_65,r_69_11_65,1.0,102,167,65,9
34,r_18_107_150,r_126_51_100,r_12_80_58,r_18_107_150,1.0,0,150,150,9
3,r_69_11_65,r_4_38_191,r_56_36_133,r_69_11_65,1.0,0,65,65,9
41,r_95_140_67,r_114_90_137,r_41_119_30,r_114_90_137,0.99,-20,117,137,9
20,r_45_14_31,seq10,r_108_78_85,r_108_78_85,1.0,21,106,85,9
15,r_88_131_62,seq93,r_120_83_41,r_88_131_62,0.93,7,69,62,9
48,r_109_17_149,r_45_14_31,r_56_36_133,r_109_17_149,0.73,0,149,149,9
49,r_114_90_137,r_95_140_67,r_146_105_47,r_114_90_137,0.97,1,138,137,9
6,r_137_77_80,r_138_92_57,r_145_98_117,r_145_98_117,0.67,-13,104,117,9
6,r_137_77_80,seq55,r_138_92_57,r_138_92_57,1.0,14,71,57,9
36,r_43_134_115,r_45_14_31,r_129_135_90,r_43_134_115,0.98,0,115,115,9
27,r_116_144_73,r_4_38_191,seq132,r_116_144_73,1.0,1,74,73,9
7,r_146_105_47,r_109_17_149,seq62,r_146_105_47,1.0,0,47,47,9
47,r_52_59_166,seq10,r_146_105_47,r_146_105_47,0.9,119,166,47,9
14,r_120_83_41,r_85_136_182,r_88_131_62,r_120_83_41,0.8,6,47,41,9
29,r_56_36_133,seq147,seq63,r_56_36_133,0.97,-2,131,133,9
45,r_13_16_43,r_66_19_87,seq21,r_13_16_43,1.0,3,46,43,9
68,seq39,r_85_136_182,r_75_76_52,r_75_76_52,1.0,53,105,52,9
21,r_41_119_30,seq40,seq65,r_41_119_30,0.99,3,33,30,9
38,r_85_136_182,seq39,r_12_80_58,r_12_80_58,1.0,47,105,58,9
36,r_43_134_115,r_23_139_42,r_45_14_31,r_23_139_42,1.0,0,42,42,9
34,r_18_107_150,r_43_134_115,r_126_51_100,r_18_107_150,0.92,-47,103,150,9
17,r_145_98_117,r_85_136_182,r_137_77_80,r_145_98_117,0.5,-12,105,117,9
9,r_126_51_100,r_25_81_107,r_18_107_150,r_126_51_100,1.0,0,100,100,9
40,r_117_86_54,seq44,r_4_38_191,r_117_86_54,1.0,0,54,54,9
96,seq118,seq7,r_37_34_71,r_37_34_71,1.0,38,109,71,9
28,r_74_20_75,r_9_87_194,r_121_5_45,r_9_87_194,0.47,-117,77,194,9
10,r_3_99_19,seq29,seq132,r_3_99_19,0.8,0,19,19,9
49,r_114_90_137,seq65,r_95_140_67,r_95_140_67,0.98,4,71,67,9
13,r_35_106_28,r_66_19_87,r_25_81_107,r_35_106_28,0.98,0,28,28,9
23,r_89_115_105,r_50_8_110,r_24_104_29,r_89_115_105,0.94,1,106,105,9
9,r_126_51_100,r_18_107_150,r_111_70_113,r_18_107_150,1.0,0,150,150,9
19,r_121_5_45,r_101_133_64,r_110_32_34,r_121_5_45,0.69,2,47,45,9
11,r_79_53_9,r_145_98_117,r_23_139_42,r_23_139_42,0.7,21,63,42,9
35,r_50_8_110,r_89_115_105,seq100,r_50_8_110,0.98,-1,109,110,9
12,r_101_133_64,r_89_115_105,seq132,r_101_133_64,0.99,0,64,64,9
14,r_109_45_174,seq57,r_9_44_75,r_109_45_174,0.42,-4,170,174,10
43,r_78_37_68,seq64,seq77,r_78_37_68,0.98,0,68,68,10
38,r_92_91_62,r_50_120_181,r_119_18_100,r_119_18_100,0.57,18,118,100,10
37,r_146_28_128,seq126,r_89_100_24,r_146_28_128,0.62,0,128,128,10
16,r_34_19_144,r_43_130_160,r_21_121_137,r_43_130_160,0.52,-16,144,160,10
1,r_147_132_107,seq68,seq75,r_147_132_107,1.0,1,108,107,10
32,r_145_23_28,r_96_12_33,r_55_59_66,r_55_59_66,1.0,-12,54,66,10
46,r_88_108_74,r_34_19_144,r_105_97_71,r_88_108_74,1.0,0,74,74,10
42,r_143_93_114,seq66,seq126,r_143_93_114,0.77,1,115,114,10
92,seq98,r_102_73_50,r_116_124_17,r_116_124_17,0.98,3,20,17,10
69,seq39,r_84_20_183,r_50_120_181,r_84_20_183,0.5,0,183,183,10
19,r_90_125_82,r_109_45_174,seq126,r_90_125_82,1.0,1,83,82,10
8,r_49_31_59,r_9_44_75,r_82_2_56,r_49_31_59,1.0,0,59,59,10
76,seq57,r_109_45_174,r_105_97_71,r_105_97_71,0.89,58,129,71,10
41,r_104_99_123,seq85,r_82_2_56,r_104_99_123,0.92,0,123,123,10
67,seq27,r_33_42_67,seq85,r_33_42_67,1.0,0,67,67,10
3,r_38_122_78,seq85,r_90_125_82,r_90_125_82,1.0,0,82,82,10
10,r_101_25_127,r_21_121_137,r_9_44_75,r_9_44_75,0.67,52,127,75,10
18,r_89_100_24,r_0_113_30,seq83,r_89_100_24,1.0,0,24,24,10
0,r_94_56_168,seq68,r_129_127_6,r_129_127_6,0.51,162,168,6,10
11,r_102_73_50,seq137,seq66,r_102_73_50,0.92,10,60,50,10
13,r_131_62_154,seq71,r_90_125_82,r_90_125_82,0.49,72,154,82,10
15,r_119_18_100,seq148,r_92_91_62,r_119_18_100,0.92,0,100,100,10
6,r_105_97_71,seq4,seq71,r_105_97_71,0.61,2,73,71,10
27,r_74_58_177,r_95_52_130,r_105_97_71,r_74_58_177,0.43,-1,176,177,10
2,r_118_26_141,r_74_58_177,seq79,r_118_26_141,0.67,0,141,141,10
47,r_5_80_119,r_6_112_106,r_95_52_130,r_5_80_119,0.98,0,119,119,10
40,r_65_144_61,r_101_25_127,r_129_127_6,r_65_144_61,1.0,0,61,61,10
29,r_116_124_17,r_118_26_141,seq98,r_116_124_17,0.87,0,17,17,10
25,r_14_140_86,r_43_130_160,seq106,r_43_130_160,0.61,-73,87,160,10
38,r_92_91_62,r_38_122_78,r_50_120_181,r_92_91_62,0.61,0,62,62,10
34,r_72_142_147,r_9_44_75,r_38_122_78,r_72_142_147,0.97,0,147,147,10
21,r_30_32_41,seq134,r_9_44_75,r_30_32_41,1.0,0,41,41,10
33,r_87_15_18,r_118_26_141,seq106,r_87_15_18,0.95,0,18,18,10
17,r_6_112_106,r_5_80_119,seq13,r_6_112_106,0.76,6,112,106,10
26,r_86_29_31,r_109_45_174,r_129_127_6,r_86_29_31,1.0,2,33,31,10
39,r_63_141_14,r_102_73_50,seq10,r_63_141_14,1.0,1,15,14,10
35,r_21_121_137,r_147_132_107,r_95_52_130,r_21_121_137,0.66,0,137,137,10
48,r_136_60_43,seq57,seq126,r_136_60_43,1.0,0,43,43,10
94,seq106,r_102_73_50,r_87_15_18,r_87_15_18,1.0,2,20,18,10
45,r_7_139_53,r_82_2_56,seq8,r_7_139_53,1.0,0,53,53,10
22,r_110_36_113,seq10,seq27,r_110_36_113,0.99,0,113,113,10
49,r_84_20_183,seq39,r_94_56_168,r_84_20_183,0.54,0,183,183,10
4,r_96_12_33,r_118_26_141,seq85,r_96_12_33,0.99,0,33,33,10
44,r_33_42_67,seq27,r_61_46_27,r_33_42_67,0.98,0,67,67,10
7,r_61_46_27,r_43_130_160,r_9_44_75,r_61_46_27,0.98,0,27,27,10
23,r_55_59_66,r_129_127_6,r_145_23_28,r_145_23_28,0.95,38,66,28,10
31,r_123_149_32,r_38_122_78,seq134,r_123_149_32,0.85,1,33,32,10
35,r_21_121_137,r_101_25_127,r_147_132_107,r_147_132_107,0.99,20,127,107,10
12,r_82_2_56,seq35,seq137,r_82_2_56,0.98,4,60,56,10
30,r_73_37_96,r_91_92_157,seq111,r_91_92_157,0.65,-61,96,157,11
45,r_108_85_13,r_109_23_44,seq48,r_108_85_13,0.79,1,14,13,11
54,seq133,r_18_62_130,r_141_27_59,r_141_27_59,0.88,71,130,59,11
37,r_127_94_85,seq111,r_35_118_26,r_127_94_85,1.0,0,85,85,11
26,r_86_120_186,r_84_146_53,r_9_79_75,r_86_120_186,0.79,0,186,186,11
55,seq6,seq16,r_47_82_66,r_47_82_66,1.0,2,68,66,11
86,seq93,r_19_38_160,r_11_24_103,r_11_24_103,0.55,57,160,103,11
21,r_81_140_172,r_86_120_186,seq99,r_81_140_172,0.65,0,172,172,11
39,r_18_62_130,seq133,seq71,r_18_62_130,0.93,0,130,130,11
16,r_87_3_3,r_109_23_44,seq115,r_109_23_44,1.0,0,44,44,11
5,r_98_33_131,r_45_69_89,r_124_39_23,r_98_33_131,0.85,1,132,131,11
46,r_31_138_90,seq99,seq136,r_31_138_90,0.99,2,92,90,11
32,r_91_92_157,r_116_59_20,r_106_10_31,r_91_92_157,0.67,0,157,157,11
12,r_124_39_23,r_18_62_130,r_32_0_198,r_124_39_23,0.5,0,23,23,11
66,seq25,seq131,r_128_103_107,r_128_103_107,1.0,5,112,107,11
3,r_88_137_120,r_81_140_172,seq101,r_88_137_120,0.99,0,120,120,11
28,r_116_59_20,seq132,r_91_92_157,r_116_59_20,0.89,0,20,20,11
26,r_86_120_186,r_81_140_172,r_84_146_53,r_84_146_53,1.0,119,172,53,11
94,seq111,r_11_24_103,r_73_37_96,r_11_24_103,0.81,-2,101,103,11
41,r_65_125_74,r_106_10_31,r_114_1_50,r_65_125_74,0.84,0,74,74,11
4,r_9_79_75,seq149,seq8,r_9_79_75,0.99,0,75,75,11
11,r_54_50_77,r_81_140_172,seq147,r_54_50_77,1.0,0,77,77,11
20,r_53_75_111,r_42_60_127,r_116_59_20,r_42_60_127,0.98,-15,112,127,11
33,r_67_49_39,r_32_0_198,r_45_69_89,r_67_49_39,0.98,2,41,39,11
19,r_141_27_59,seq43,seq133,r_141_27_59,1.0,0,59,59,11
6,r_128_103_107,r_61_22_192,seq25,r_128_103_107,0.94,0,107,107,11
2,r_84_146_53,r_81_140_172,seq16,r_81_140_172,0.99,-13,159,172,11
1,r_119_76_45,r_42_60_127,seq90,r_119_76_45,0.94,0,45,45,11
31,r_104_122_48,r_42_60_127,seq139,r_104_122_48,0.9,0,48,48,11
97,seq115,seq111,r_87_3_3,r_87_3_3,0.59,54,57,3,11
42,r_30_46_36,r_54_50_77,r_45_69_89,r_30_46_36,1.0,0,36,36,11
27,r_40_70_175,seq135,seq99,r_40_70_175,0.75,1,176,175,11
47,r_63_15_184,seq72,r_53_75_111,r_53_75_111,0.87,76,187,111,11
40,r_47_82_66,r_18_62_130,seq6,r_18_62_130,0.64,-61,69,130,11
24,r_64_145_55,seq71,seq147,r_64_145_55,0.93,7,62,55,11
35,r_106_10_31,r_65_125_74,r_12_20_159,r_106_10_31,0.59,132,163,31,11
25,r_11_24_103,seq111,seq26,r_11_24_103,0.94,-2,101,103,11
63,seq17,r_19_38_160,r_114_1_50,r_114_1_50,0.61,9,59,50,11
88,seq99,r_31_138_90,seq115,r_31_138_90,0.95,8,98,90,11
36,r_114_1_50,r_73_37_96,seq17,r_114_1_50,0.92,0,50,50,11
10,r_109_23_44,r_87_3_3,seq129,r_109_23_44,1.0,0,44,44,11
68,seq28,seq130,r_84_146_53,r_84_146_53,1.0,102,155,53,11
41,r_65_125_74,r_134_77_188,r_106_10_31,r_65_125_74,0.47,-41,33,74,11
52,seq131,seq25,r_35_118_26,r_35_118_26,0.99,4,30,26,11
34,r_148_5_132,seq8,r_11_24_103,r_148_5_132,0.71,0,132,132,11
8,r_35_118_26,r_98_33_131,seq131,r_35_118_26,0.99,0,26,26,11
2,r_84_146_53,seq48,r_81_140_172,r_84_146_53,1.0,0,53,53,11
9,r_4_55_68,seq57,r_121_29_11,r_4_55_68,1.0,0,68,68,11
32,r_91_92_157,r_73_37_96,r_116_59_20,r_116_59_20,1.0,0,20,20,11
28,r_116_59_20,r_91_92_157,r_53_75_111,r_116_59_20,0.96,125,145,20,11
22,r_66_123_121,r_45_69_89,r_73_37_96,r_66_123_121,0.73,4,125,121,11
49,r_142_21_170,seq90,r_18_62_130,r_18_62_130,0.88,40,170,130,11
56,seq135,seq80,r_56_36_144,r_56_36_144,0.83,2,146,144,11
44,r_19_38_160,seq93,r_9_79_75,r_9_79_75,1.0,85,160,75,11
17,r_97_105_133,seq80,r_45_69_89,r_97_105_133,0.97,0,133,133,11
35,r_106_10_31,r_53_75_111,r_65_125_74,r_106_10_31,1.0,0,31,31,11
30,r_81_44_71,r_18_5_139,r_36_4_3,r_81_44_71,0.85,0,71,71,12
66,seq27,r_114_144_137,r_142_130_45,r_142_130_45,1.0,1,46,45,12
40,r_117_89_59,seq103,seq25,r_117_89_59,0.68,-1,58,59,12
47,r_24_59_17,r_147_95_88,r_58_47_7,r_24_59_17,0.93,0,17,17,12
86,seq96,r_14_54_174,r_15_122_94,r_15_122_94,1.0,6,100,94,12
16,r_2_146_85,seq35,r_7_125_95,r_2_146_85,1.0,0,85,85,12
21,r_63_50_138,r_31_88_153,seq104,r_63_50_138,0.75,0,138,138,12
39,r_7_125_95,r_129_21_182,r_2_146_85,r_2_146_85,0.82,10,95,85,12
5,r_90_108_133,seq39,r_28_132_39,r_90_108_133,0.98,0,133,133,12
46,r_10_70_178,seq74,r_142_130_45,r_10_70_178,0.65,0,178,178,12
55,seq137,seq6,r_13_3_46,r_13_3_46,1.0,10,56,46,12
80,seq69,r_133_9_117,r_114_144_137,r_133_9_117,1.0,1,118,117,12
14,r_142_130_45,r_68_84_192,seq27,r_142_130_45,1.0,1,46,45,12
8,r_43_123_53,seq65,seq101,r_43_123_53,1.0,1,54,53,12
33,r_99_87_92,r_114_144_137,r_93_48_181,r_99_87_92,0.91,0,92,92,12
76,seq56,r_114_144_137,r_85_73_120,r_85_73_120,1.0,15,135,120,12
31,r_76_66_109,seq67,seq145,r_76_66_109,0.99,1,110,109,12
41,r_147_95_88,seq134,seq109,r_147_95_88,0.99,0,88,88,12
67,seq34,r_20_92_175,r_148_33_172,r_20_92_175,0.76,0,175,175,12
37,r_91_71_15,r_28_132_39,r_86_83_161,r_91_71_15,0.75,0,15,15,12
3,r_41_102_110,r_80_139_156,r_15_122_94,r_80_139_156,1.0,-46,110,156,12
10,r_111_45_186,r_11_52_4,r_85_73_120,r_85_73_120,0.6,66,186,120,12
0,r_129_21_182,r_7_125_95,seq22,r_7_125_95,0.96,-5,90,95,12
73,seq49,r_19_38_112,seq61,r_19_38_112,1.0,0,112,112,12
20,r_133_9_117,seq69,seq109,r_133_9_117,1.0,1,118,117,12
13,r_112_60_142,r_114_144_137,r_99_87_92,r_114_144_137,0.92,9,146,137,12
48,r_11_52_4,r_111_45_186,seq97,r_11_52_4,0.46,182,186,4,12
0,r_129_21_182,seq22,r_86_83_161,r_129_21_182,0.52,1,183,182,12
36,r_18_5_139,seq67,seq128,r_18_5_139,0.84,0,139,139,12
17,r_13_3_46,r_63_50_138,seq137,r_13_3_46,1.0,-2,44,46,12
27,r_80_139_156,r_98_120_99,r_46_51_37,r_98_120_99,0.9,57,156,99,12
6,r_46_51_37,seq55,r_57_118_125,r_46_51_37,1.0,1,38,37,12
34,r_121_131_19,r_99_87_92,r_98_120_99,r_98_120_99,0.68,-80,19,99,12
24,r_15_122_94,r_93_48_181,seq96,r_15_122_94,0.98,-3,91,94,12
3,r_41_102_110,r_15_122_94,r_18_5_139,r_18_5_139,0.99,20,159,139,12
25,r_29_32_103,r_68_84_192,r_13_3_46,r_29_32_103,0.93,3,106,103,12
54,seq8,r_30_62_44,seq96,r_30_62_44,1.0,-6,38,44,12
68,seq35,r_2_146_85,seq34,r_2_146_85,1.0,-7,78,85,12
61,seq145,r_64_17_143,r_76_66_109,r_76_66_109,0.8,44,153,109,12
33,r_99_87_92,r_121_131_19,r_114_144_137,r_121_131_19,0.94,-1,18,19,12
9,r_19_38_112,seq49,seq42,r_19_38_112,0.84,0,112,112,12
18,r_119_26_28,seq141,seq67,r_119_26_28,0.66,0,28,28,12
22,r_85_73_120,r_68_84_192,seq56,r_85_73_120,0.98,0,120,120,12
49,r_37_138_83,seq53,seq103,r_37_138_83,1.0,-9,74,83,12
4,r_58_47_7,r_14_54_174,r_24_59_17,r_24_59_17,0.99,-1,16,17,12
36,r_18_5_139,r_81_44_71,seq67,r_81_44_71,0.92,-31,40,71,12
7,r_64_17_143,seq145,r_142_130_45,r_142_130_45,0.99,127,172,45,12
44,r_78_72_111,r_68_84_192,r_2_146_85,r_68_84_192,0.98,-80,112,192,12
42,r_30_62_44,seq8,r_121_131_19,r_30_62_44,1.0,0,44,44,12
35,r_113_136_140,seq103,seq23,r_113_136_140,0.91,0,140,140,12
12,r_93_48_181,r_15_122_94,r_99_87_92,r_93_48_181,0.99,-90,91,181,12
30,r_25_128_182,seq47,seq131,r_25_128_182,0.39,4,186,182,13
14,r_0_125_111,r_121_18_106,r_129_40_32,r_0_125_111,0.7,0,111,111,13
43,r_138_41_199,r_92_67_133,r_0_125_111,r_138_41_199,0.54,-77,122,199,13
86,seq84,r_112_85_136,seq91,r_112_85_136,0.5,25,161,136,13
37,r_105_65_132,seq68,r_26_88_107,r_105_65_132,0.98,0,132,132,13
86,seq84,r_32_3_74,r_112_85_136,r_32_3_74,0.63,1,75,74,13
16,r_62_74_198,r_59_135_157,r_142_141_13,r_142_141_13,0.64,118,131,13,13
21,r_100_98_65,r_59_135_157,seq16,r_100_98_65,1.0,0,65,65,13
39,r_55_27_168,r_8_114_172,r_117_54_78,r_117_54_78,1.0,18,96,78,13
1,r_81_34_130,r_60_15_126,r_78_7_97,r_81_34_130,0.58,3,133,130,13
97,seq122,r_60_15_126,r_61_58_164,r_61_58_164,0.89,6,170,164,13
5,r_8_114_172,seq134,seq36,r_8_114_172,0.84,0,172,172,13
46,r_83_137_153,seq57,r_105_65_132,r_83_137_153,0.62,2,155,153,13
42,r_117_54_78,seq123,r_55_27_168,r_117_54_78,1.0,1,79,78,13
44,r_71_93_23,r_24_132_120,r_142_141_13,r_71_93_23,0.99,0,23,23,13
45,r_69_12_59,r_25_128_182,seq145,r_69_12_59,0.74,3,62,59,13
19,r_86_73_100,seq80,seq52,r_86_73_100,1.0,0,100,100,13
32,r_14_33_49,seq46,seq103,r_14_33_49,0.99,5,54,49,13
20,r_97_19_83,r_118_5_118,r_26_88_107,r_118_5_118,0.95,0,118,118,13
39,r_55_27_168,r_117_54_78,r_61_58_164,r_55_27_168,0.94,0,168,168,13
41,r_101_42_70,r_120_119_110,r_96_77_145,r_101_42_70,0.99,2,72,70,13
10,r_118_5_118,seq9,r_97_19_83,r_97_19_83,0.8,1,84,83,13
26,r_120_119_110,seq31,r_100_98_65,r_120_119_110,0.85,1,111,110,13
60,seq143,r_51_38_62,r_126_37_17,r_51_38_62,0.99,-32,30,62,13
4,r_92_67_133,r_144_76_165,r_142_141_13,r_92_67_133,0.47,0,133,133,13
11,r_60_15_126,seq122,r_69_12_59,r_69_12_59,0.87,89,148,59,13
20,r_97_19_83,r_26_88_107,r_118_5_118,r_97_19_83,0.49,0,83,83,13
15,r_24_132_120,seq103,r_121_18_106,r_24_132_120,0.65,0,120,120,13
31,r_142_141_13,r_139_23_129,seq136,r_142_141_13,0.95,0,13,13,13
6,r_32_3_74,seq84,seq75,r_32_3_74,0.67,1,75,74,13
13,r_104_87_29,seq10,seq57,r_104_87_29,0.99,0,29,29,13
0,r_44_11_151,seq36,r_139_23_129,r_44_11_151,0.83,-4,147,151,13
22,r_144_76_165,r_39_149_187,r_26_88_107,r_144_76_165,0.97,0,165,165,13
48,r_126_37_17,seq2,seq143,r_126_37_17,0.62,18,35,17,13
2,r_140_50_122,seq4,r_117_54_78,r_140_50_122,0.96,4,126,122,13
40,r_51_38_62,r_55_27_168,seq36,r_51_38_62,1.0,0,62,62,13
10,r_118_5_118,r_97_19_83,seq31,r_118_5_118,0.99,0,118,118,13
18,r_26_88_107,seq136,seq9,r_26_88_107,0.83,6,113,107,13
29,r_61_58_164,r_95_127_191,seq122,r_61_58_164,0.86,0,164,164,13
24,r_78_7_97,r_90_28_139,seq108,r_78_7_97,0.99,0,97,97,13
25,r_43_30_184,seq133,r_86_73_100,r_86_73_100,0.64,86,186,100,13
47,r_102_64_51,seq131,seq123,r_102_64_51,1.0,0,51,51,13
58,seq10,r_95_127_191,r_0_125_111,r_0_125_111,1.0,68,179,111,13
42,r_117_54_78,r_55_27_168,r_140_50_122,r_117_54_78,0.89,90,168,78,13
77,seq52,r_90_28_139,r_86_73_100,r_86_73_100,0.68,43,143,100,13
34,r_35_49_115,seq107,seq136,r_35_49_115,0.76,0,115,115,13
38,r_115_53_39,r_72_66_174,seq131,r_115_53_39,0.99,-2,37,39,13
9,r_139_23_129,seq46,seq146,r_139_23_129,0.7,1,130,129,13
22,r_144_76_165,r_92_67_133,r_39_149_187,r_92_67_133,0.64,-46,87,133,13
28,r_95_127_191,r_61_58_164,r_129_40_32,r_95_127_191,0.67,-111,80,191,13
49,r_90_28_139,seq52,r_112_85_136,r_90_28_139,0.63,4,143,139,13
0,r_44_11_151,r_95_127_191,seq36,r_44_11_151,0.48,-115,36,151,13
23,r_72_66_174,r_121_18_106,r_59_135_157,r_72_66_174,0.5,1,175,174,13
7,r_129_40_32,r_59_135_157,r_95_127_191,r_129_40_32,1.0,0,32,32,13
35,r_109_130_98,r_83_137_153,r_129_40_32,r_83_137_153,0.61,-53,100,153,13
40,r_53_23_61,seq76,r_134_54_111,r_134_54_111,1.0,37,148,111,14
36,r_131_19_166,r_56_109_3,seq140,r_131_19_166,0.82,1,167,166,14
43,r_94_78_73,seq76,seq46,r_94_78_73,1.0,0,73,73,14
86,seq92,r_129_88_122,seq47,r_129_88_122,1.0,0,122,122,14
21,r_9_57_96,r_129_88_122,r_114_132_72,r_9_57_96,0.99,0,96,96,14
39,r_129_88_122,seq92,seq135,r_129_88_122,0.95,0,122,122,14
5,r_89_125_178,seq68,seq108,r_89_125_178,0.51,1,179,178,14
46,r_56_109_3,r_131_19_166,r_15_77_8,r_131_19_166,0.86,1,167,166,14
42,r_63_112_99,seq97,r_100_136_28,r_63_112_99,0.72,7,106,99,14
67,seq39,r_148_118_45,r_87_65_13,r_148_118_45,0.44,-31,14,45,14
0,r_66_3_48,r_98_126_36,r_105_103_137,r_66_3_48,0.83,1,49,48,14
19,r_84_81_172,r_59_32_187,r_66_3_48,r_59_32_187,0.7,-14,173,187,14
1,r_130_143_33,r_105_103_137,seq76,r_130_143_33,0.99,1,34,33,14
11,r_83_79_34,r_40_29_124,seq13,r_40_29_124,0.75,3,127,124,14
11,r_83_79_34,seq4,r_40_29_124,r_83_79_34,0.97,1,35,34,14
49,r_138_137_53,r_94_78_73,seq1,r_94_78_73,0.76,-20,53,73,14
66,seq36,r_0_44_190,seq28,r_0_44_190,0.76,-59,131,190,14
76,seq68,r_89_125_178,r_62_43_183,r_89_125_178,0.7,-68,110,178,14
41,r_40_29_124,r_115_30_128,seq85,r_40_29_124,0.62,7,131,124,14
8,r_117_33_52,r_113_24_27,seq74,r_117_33_52,0.92,-2,50,52,14
3,r_86_5_104,seq17,seq135,r_86_5_104,0.98,-6,98,104,14
90,seq104,r_0_44_190,r_40_29_124,r_40_29_124,0.6,66,190,124,14
26,r_49_124_78,r_105_103_137,seq133,r_49_124_78,0.99,1,79,78,14
63,seq27,seq97,r_61_147_67,r_61_147_67,1.0,23,90,67,14
85,seq91,r_114_132_72,r_70_34_22,r_114_132_72,0.97,-22,50,72,14
20,r_8_11_114,r_67_48_184,r_134_54_111,r_8_11_114,1.0,0,114,114,14
13,r_69_102_84,seq16,r_114_132_72,r_69_102_84,1.0,0,84,84,14
15,r_38_101_125,r_2_80_146,r_21_116_66,r_2_80_146,0.56,-21,125,146,14
0,r_66_3_48,r_105_103_137,r_2_80_146,r_2_80_146,0.52,12,158,146,14
31,r_98_126_36,r_66_3_48,r_15_77_8,r_98_126_36,0.88,-26,10,36,14
48,r_70_34_22,r_59_32_187,seq91,r_70_34_22,0.98,0,22,22,14
29,r_14_142_155,r_100_136_28,r_119_145_47,r_119_145_47,1.0,2,49,47,14
22,r_105_103_137,r_66_3_48,seq47,r_105_103_137,0.71,0,137,137,14
2,r_121_52_151,r_40_29_124,r_83_79_34,r_83_79_34,0.94,96,130,34,14
47,r_0_44_190,seq104,r_37_149_55,r_37_149_55,0.92,135,190,55,14
24,r_114_132_72,seq123,r_148_118_45,r_114_132_72,1.0,0,72,72,14
22,r_105_103_137,r_49_124_78,r_66_3_48,r_105_103_137,0.97,-92,45,137,14
25,r_2_80_146,seq95,r_66_3_48,r_66_3_48,0.92,99,147,48,14
92,seq108,r_90_41_82,seq20,r_90_41_82,1.0,-29,53,82,14
70,seq46,seq140,r_94_78_73,r_94_78_73,1.0,14,87,73,14
32,r_21_116_66,seq64,seq82,r_21_116_66,1.0,0,66,66,14
6,r_100_136_28,r_117_33_52,seq122,r_117_33_52,0.97,-16,36,52,14
34,r_139_106_156,r_59_32_187,r_9_57_96,r_59_32_187,0.66,-31,156,187,14
14,r_18_6_50,r_89_125_178,seq123,r_18_6_50,0.99,1,51,50,14
81,seq76,r_94_78_73,r_130_143_33,r_94_78_73,0.9,0,73,73,14
17,r_59_32_187,seq122,seq39,r_59_32_187,0.23,0,187,187,14
27,r_87_65_13,seq47,seq39,r_87_65_13,1.0,3,16,13,14
9,r_115_30_128,r_40_29_124,r_138_137_53,r_115_30_128,0.81,3,131,128,14
33,r_119_145_47,r_8_11_114,r_14_142_155,r_119_145_47,1.0,0,47,47,14
29,r_14_142_155,r_119_145_47,seq12,r_14_142_155,0.45,1,156,155,14
28,r_148_118_45,seq140,r_114_132_72,r_114_132_72,1.0,1,73,72,14
2,r_121_52_151,r_83_79_34,seq7,r_121_52_151,0.88,-1,150,151,14
7,r_61_147_67,r_8_11_114,seq27,r_61_147_67,1.0,3,70,67,14
44,r_99_96_131,seq146,r_138_137_53,r_99_96_131,0.66,2,133,131,14
12,r_90_41_82,r_69_102_84,seq71,r_90_41_82,0.98,0,82,82,14
95,seq140,r_75_144_191,r_131_19_166,r_131_19_166,0.9,16,182,166,14
30,r_101_46_117,seq102,seq120,r_101_46_117,0.95,1,118,117,15
36,r_130_42_167,seq52,r_126_30_73,r_126_30_73,1.0,96,169,73,15
14,r_111_67_81,r_62_138_172,seq105,r_111_67_81,0.99,2,83,81,15
8,r_76_17_64,r_15_72_196,seq12,r_76_17_64,0.99,1,65,64,15
43,r_2_27_71,seq78,seq11,r_2_27_71,1.0,0,71,71,15
46,r_37_144_11,r_126_30_73,r_7_80_138,r_37_144_11,1.0,0,11,11,15
37,r_107_103_72,seq32,seq102,r_107_103_72,1.0,0,72,72,15
55,seq142,r_94_60_134,r_149_47_57,r_149_47_57,0.96,3,60,57,15
16,r_23_79_60,r_5_116_106,r_48_73_147,r_23_79_60,1.0,1,61,60,15
39,r_20_106_99,r_87_75_144,seq6,r_20_106_99,0.91,-1,98,99,15
1,r_62_138_172,r_107_103_72,r_38_28_95,r_62_138_172,0.85,0,172,172,15
1,r_62_138_172,r_111_67_81,r_107_103_72,r_62_138_172,0.99,-89,83,172,15
42,r_127_63_175,r_38_28_95,r_4_59_184,r_38_28_95,0.59,5,100,95,15
18,r_5_116_106,r_128_9_130,seq32,r_5_116_106,1.0,0,106,106,15
33,r_38_28_95,r_122_119_100,r_62_138_172,r_62_138_172,1.0,0,172,172,15
31,r_141_51_143,r_122_119_100,r_45_110_56,r_45_110_56,1.0,9,65,56,15
64,seq35,r_128_9_130,r_37_144_11,r_128_9_130,0.62,-73,57,130,15
10,r_87_75_144,r_131_34_166,seq132,r_87_75_144,0.86,0,144,144,15
26,r_88_112_102,seq12,seq19,r_88_112_102,0.98,0,102,102,15
16,r_23_79_60,r_48_73_147,r_141_51_143,r_48_73_147,0.99,2,149,147,15
4,r_122_119_100,r_141_51_143,r_85_49_7,r_122_119_100,0.96,4,104,100,15
45,r_57_13_24,seq58,seq82,r_57_13_24,0.95,0,24,24,15
0,r_126_30_73,r_113_135_198,seq11,r_126_30_73,0.98,0,73,73,15
63,seq32,r_107_103_72,r_125_108_158,r_107_103_72,1.0,0,72,72,15
23,r_149_47_57,seq11,seq142,r_149_47_57,1.0,0,57,57,15
46,r_37_144_11,r_7_80_138,seq142,r_7_80_138,1.0,0,138,138,15
15,r_114_55_77,r_87_75_144,seq124,r_114_55_77,1.0,1,78,77,15
49,r_48_73_147,r_23_79_60,r_76_17_64,r_48_73_147,0.94,2,149,147,15
6,r_109_31_188,seq98,r_104_133_126,r_104_133_126,0.99,63,189,126,15
99,seq124,seq97,r_114_55_77,r_114_55_77,1.0,2,79,77,15
26,r_88_112_102,seq19,r_128_9_130,r_128_9_130,0.99,9,139,130,15
27,r_131_34_166,seq71,r_113_135_198,r_131_34_166,0.89,0,166,166,15
2,r_61_140_131,r_43_8_189,seq102,r_61_140_131,0.94,0,131,131,15
47,r_39_33_69,r_2_27_71,seq83,r_39_33_69,1.0,0,69,69,15
24,r_117_36_22,r_61_140_131,seq99,r_117_36_22,1.0,0,22,22,15
40,r_125_108_158,seq115,seq25,r_125_108_158,0.7,0,158,158,15
18,r_5_116_106,r_23_79_60,r_128_9_130,r_23_79_60,1.0,1,61,60,15
33,r_38_28_95,r_127_63_175,r_122_119_100,r_38_28_95,0.97,5,100,95,15
29,r_45_110_56,seq16,r_141_51_143,r_45_110_56,1.0,0,56,56,15
32,r_70_0_160,r_4_59_184,r_125_108_158,r_125_108_158,0.98,8,166,158,15
48,r_54_89_19,seq143,seq58,r_54_89_19,1.0,0,19,19,15
81,seq82,r_43_8_189,r_57_13_24,r_57_13_24,0.95,165,189,24,15
17,r_43_8_189,seq82,r_114_55_77,r_114_55_77,1.0,112,189,77,15
25,r_145_100_14,seq120,r_141_51_143,r_145_100_14,0.55,96,110,14,15
94,seq105,seq97,r_111_67_81,r_111_67_81,1.0,53,134,81,15
9,r_148_91_61,r_88_112_102,seq102,r_148_91_61,1.0,0,61,61,15
31,r_141_51_143,r_45_110_56,r_23_79_60,r_141_51_143,0.62,2,145,143,15
29,r_45_110_56,r_141_51_143,r_18_22_123,r_18_22_123,1.0,22,145,123,15
22,r_10_90_53,r_4_59_184,seq120,r_10_90_53,1.0,2,55,53,15
49,r_48_73_147,seq120,r_23_79_60,r_23_79_60,1.0,2,62,60,15
7,r_104_133_126,r_14_123_186,seq84,r_104_133_126,1.0,1,127,126,15
44,r_94_60_134,seq142,r_117_36_22,r_94_60_134,0.99,0,134,134,15
53,seq11,r_117_36_22,r_126_30_73,r_126_30_73,0.81,0,73,73,15
82,seq83,r_50_69_156,r_39_33_69,r_39_33_69,0.93,87,156,69,15
11,r_146_3_58,seq124,seq143,r_146_3_58,1.0,0,58,58,15
30,r_38_49_144,seq35,r_21_48_11,r_38_49_144,0.54,2,146,144,16
14,r_43_109_155,r_118_74_111,seq83,r_43_109_155,0.62,0,155,155,16
53,seq137,r_8_53_140,r_76_30_54,r_76_30_54,0.94,86,140,54,16
83,seq92,seq112,r_135_31_110,r_135_31_110,1.0,5,115,110,16
37,r_5_60_105,seq33,r_19_2_29,r_5_60_105,0.78,0,105,105,16
16,r_80_134_70,seq72,seq104,r_80_134_70,1.0,1,71,70,16
39,r_42_139_82,r_118_74_111,seq130,r_42_139_82,1.0,0,82,82,16
5,r_12_27_163,r_96_123_181,seq75,r_12_27_163,0.88,2,165,163,16
42,r_8_53_140,seq137,r_122_28_147,r_8_53_140,0.7,14,154,140,16
69,seq61,r_89_57_141,r_146_59_83,r_146_59_83,0.99,11,94,83,16
45,r_24_145_66,seq108,seq72,r_24_145_66,0.99,0,66,66,16
19,r_121_97_91,seq143,seq106,r_121_97_91,0.49,-13,78,91,16
11,r_132_7_25,r_91_11_149,r_89_57_141,r_132_7_25,0.57,125,150,25,16
31,r_17_16_113,seq55,seq26,r_17_16_113,0.57,12,125,113,16
41,r_89_57_141,seq61,r_132_7_25,r_89_57_141,0.61,6,147,141,16
3,r_146_59_83,seq77,seq61,r_146_59_83,1.0,0,83,83,16
10,r_122_28_147,r_118_74_111,r_91_11_149,r_91_11_149,0.61,0,149,149,16
90,seq106,r_41_65_171,r_142_149_85,r_142_149_85,0.97,92,177,85,16
26,r_135_31_110,r_93_56_4,seq92,r_135_31_110,1.0,0,110,110,16
0,r_100_6_68,seq143,r_118_74_111,r_100_6_68,0.99,0,68,68,16
38,r_19_2_29,r_23_36_63,seq72,r_19_2_29,0.96,0,29,29,16
20,r_91_11_149,seq111,r_122_28_147,r_91_11_149,0.93,0,149,149,16
48,r_86_85_136,seq15,r_5_60_105,r_86_85_136,0.94,0,136,136,16
49,r_21_48_11,seq127,r_38_49_144,r_38_49_144,0.78,3,147,144,16
40,r_76_30_54,seq54,seq137,r_76_30_54,1.0,-1,53,54,16
27,r_52_129_148,r_41_65_171,seq13,r_52_129_148,0.89,2,150,148,16
2,r_142_149_85,r_5_60_105,r_121_97_91,r_142_149_85,0.99,1,86,85,16
47,r_148_62_174,r_96_123_181,r_142_149_85,r_148_62_174,0.38,1,175,174,16
43,r_40_18_15,r_50_25_161,seq111,r_40_18_15,1.0,0,15,15,16
29,r_96_123_181,seq63,r_147_64_135,r_147_64_135,0.92,48,183,135,16
24,r_87_114_74,seq78,seq15,r_87_114_74,1.0,2,76,74,16
25,r_41_65_171,seq106,r_43_109_155,r_41_65_171,0.42,6,177,171,16
49,r_21_48_11,r_32_3_35,seq127,r_21_48_11,0.5,-1,10,11,16
9,r_144_14_173,r_23_36_63,r_138_115_87,r_144_14_173,0.84,2,175,173,16
70,seq63,r_96_123_181,r_100_6_68,r_100_6_68,0.99,112,180,68,16
1,r_101_90_94,r_133_95_28,seq125,r_133_95_28,0.7,15,43,28,16
34,r_113_124_118,seq125,r_135_31_110,r_135_31_110,0.85,15,125,110,16
8,r_133_95_28,r_24_145_66,seq98,r_24_145_66,0.53,-29,37,66,16
4,r_32_3_35,r_82_131_185,r_93_56_4,r_32_3_35,1.0,1,36,35,16
32,r_51_79_51,seq29,seq54,r_51_79_51,1.0,2,53,51,16
15,r_45_84_46,r_50_25_161,seq98,r_45_84_46,0.84,1,47,46,16
21,r_128_103_38,r_50_25_161,seq111,r_128_103_38,0.99,0,38,38,16
17,r_81_9_86,r_43_109_155,seq33,r_81_9_86,0.94,0,86,86,16
9,r_144_14_173,seq112,r_23_36_63,r_23_36_63,1.0,64,127,63,16
11,r_132_7_25,seq75,r_91_11_149,r_132_7_25,0.83,-1,24,25,16
91,seq108,r_24_145_66,seq63,r_24_145_66,0.76,15,81,66,16
33,r_58_107_49,r_80_134_70,seq143,r_58_107_49,0.99,0,49,49,16
7,r_50_25_161,seq20,seq69,r_50_25_161,0.93,3,164,161,16
44,r_138_115_87,seq72,seq63,r_138_115_87,0.99,0,87,87,16
23,r_1_119_177,seq0,r_81_9_86,r_81_9_86,0.92,99,185,86,16
82,seq143,r_68_116_80,r_23_36_63,r_23_36_63,1.0,30,93,63,16
12,r_23_36_63,r_88_46_142,r_58_107_49,r_23_36_63,1.0,0,63,63,16
30,r_36_40_106,seq20,r_4_60_59,r_36_40_106,0.85,1,107,106,17
23,r_76_75_28,r_13_53_86,r_70_51_6,r_76_75_28,0.97,0,28,28,17
92,seq103,seq81,r_115_114_75,r_115_114_75,0.99,14,89,75,17
8,r_28_90_160,seq99,seq138,r_28_90_160,0.56,4,164,160,17
10,r_127_52_40,r_0_112_102,seq41,r_127_52_40,1.0,0,40,40,17
43,r_35_137_143,seq56,r_17_124_67,r_35_137_143,0.54,0,143,143,17
37,r_47_2_168,r_22_11_169,r_106_86_87,r_47_2_168,0.49,0,168,168,17
14,r_45_102_198,seq43,r_76_75_28,r_76_75_28,0.99,6,34,28,17
16,r_143_87_124,r_25_27_127,r_1_108_100,r_143_87_124,0.59,1,125,124,17
39,r_0_112_102,seq82,seq134,r_0_112_102,0.77,3,105,102,17
1,r_115_114_75,r_71_33_190,seq103,r_115_114_75,0.89,0,75,75,17
29,r_91_9_31,r_84_39_145,r_146_50_13,r_91_9_31,0.87,1,32,31,17
46,r_17_124_67,seq113,seq68,r_17_124_67,0.89,0,67,67,17
42,r_97_34_176,seq138,r_105_100_50,r_105_100_50,0.54,127,177,50,17
45,r_77_141_126,seq7,r_0_112_102,r_77_141_126,0.87,3,129,126,17
75,seq56,r_35_137_143,r_146_50_13,r_146_50_13,0.7,-3,10,13,17
27,r_85_148_170,r_38_62_10,seq6,r_85_148_170,0.78,1,171,170,17
58,seq15,r_84_39_145,r_61_66_46,r_61_66_46,0.48,8,54,46,17
41,r_57_109_109,seq10,r_61_66_46,r_57_109_109,0.87,0,109,109,17
3,r_1_108_100,r_85_148_170,r_119_64_136,r_85_148_170,0.69,-69,101,170,17
26,r_21_12_78,seq24,seq136,r_21_12_78,0.89,0,78,78,17
0,r_131_58_107,seq44,r_133_59_17,r_131_58_107,0.91,0,107,107,17
11,r_121_19_103,seq81,seq149,r_121_19_103,0.6,4,107,103,17
20,r_84_39_145,seq15,seq42,r_84_39_145,0.76,2,147,145,17
15,r_71_33_190,r_115_114_75,seq78,r_115_114_75,0.67,0,75,75,17
6,r_4_60_59,seq139,seq81,r_4_60_59,1.0,3,62,59,17
62,seq149,seq20,r_121_19_103,r_121_19_103,0.7,15,118,103,17
40,r_26_63_48,r_101_98_93,seq139,r_26_63_48,0.99,1,49,48,17
27,r_85_148_170,r_1_108_100,r_38_62_10,r_1_108_100,0.69,-23,77,100,17
3,r_1_108_100,r_119_64_136,r_143_87_124,r_143_87_124,0.61,12,136,124,17
2,r_79_117_167,seq136,r_146_50_13,r_79_117_167,0.33,0,167,167,17
47,r_22_11_169,r_47_2_168,r_127_52_40,r_47_2_168,0.61,0,168,168,17
18,r_104_16_61,seq103,r_26_63_48,r_104_16_61,0.89,1,62,61,17
5,r_146_50_13,r_127_52_40,seq56,r_146_50_13,0.88,-3,10,13,17
24,r_107_83_178,seq138,r_115_114_75,r_115_114_75,0.69,107,182,75,17
36,r_140_126_37,r_104_16_61,seq20,r_140_126_37,0.7,15,52,37,17
25,r_128_65_105,seq81,r_91_9_31,r_128_65_105,0.94,0,105,105,17
33,r_32_125_150,seq18,r_76_75_28,r_76_75_28,0.97,122,150,28,17
39,r_0_112_102,seq134,r_77_141_126,r_77_141_126,0.82,23,149,126,17
19,r_3_37_14,r_1_108_100,seq15,r_3_37_14,0.81,0,14,14,17
34,r_119_64_136,r_1_108_100,r_121_19_103,r_119_64_136,0.64,0,136,136,17
32,r_13_53_86,seq29,seq92,r_13_53_86,0.9,0,86,86,17
38,r_80_135_119,r_123_132_196,r_57_109_109,r_123_132_196,0.75,-75,121,196,17
34,r_119_64_136,seq113,r_1_108_100,r_119_64_136,0.36,-33,103,136,17
48,r_61_66_46,r_30_54_154,seq15,r_61_66_46,1.0,0,46,46,17
60,seq147,r_101_98_93,seq10,r_101_98_93,1.0,0,93,93,17
9,r_106_86_87,r_101_98_93,r_145_130_16,r_106_86_87,0.89,1,88,87,17
26,r_21_12_78,seq136,r_25_27_127,r_25_27_127,0.99,57,184,127,17
31,r_105_100_50,r_32_125_150,r_123_132_196,r_105_100_50,0.98,1,51,50,17
17,r_145_130_16,r_4_60_59,seq49,r_145_130_16,0.83,-1,15,16,17
29,r_91_9_31,r_146_50_13,r_128_65_105,r_128_65_105,1.0,3,108,105,17
49,r_25_27_127,seq6,r_21_12_78,r_25_27_127,0.86,1,128,127,17
68,seq41,r_84_39_145,r_127_52_40,r_127_52_40,0.88,5,45,40,17
44,r_70_51_6,r_0_112_102,r_76_75_28,r_70_51_6,0.64,96,102,6,17
52,seq6,r_104_16_61,r_85_148_170,r_85_148_170,0.89,3,173,170,17
12,r_123_132_196,r_80_135_119,r_105_100_50,r_123_132_196,0.99,-75,121,196,17
30,r_55_131_185,seq57,r_102_67_101,r_102_67_101,0.49,84,185,101,18
51,seq1,r_18_8_145,seq137,r_18_8_145,0.95,0,145,145,18
9,r_60_140_169,seq90,r_84_95_7,r_60_140_169,0.99,0,169,169,18
92,seq104,r_145_134_108,r_50_100_8,r_145_134_108,0.78,-35,73,108,18
87,seq90,r_60_140_169,r_143_79_45,r_143_79_45,1.0,3,48,45,18
14,r_10_26_59,seq126,seq29,r_10_26_59,1.0,0,59,59,18
59,seq14,r_115_118_113,r_53_87_36,r_115_118_113,1.0,-8,105,113,18
1,r_51_109_174,r_122_37_187,r_145_134_108,r_51_109_174,0.74,1,175,174,18
97,seq117,r_115_118_113,r_84_95_7,r_115_118_113,0.99,-8,105,113,18
5,r_146_2_81,r_133_4_163,r_54_105_38,r_146_2_81,0.78,0,81,81,18
46,r_98_89_115,r_115_118_113,r_146_2_81,r_98_89_115,0.99,-2,113,115,18
42,r_25_31_107,r_60_140_169,r_146_2_81,r_60_140_169,1.0,-62,107,169,18
43,r_23_82_32,r_51_109_174,r_145_134_108,r_23_82_32,1.0,0,32,32,18
45,r_115_118_113,r_98_89_115,r_50_100_8,r_115_118_113,1.0,0,113,113,18
35,r_12_136_34,r_55_131_185,r_54_105_38,r_54_105_38,0.99,0,38,38,18
19,r_65_99_118,seq49,r_9_78_166,r_65_99_118,0.99,0,118,118,18
2,r_20_144_43,r_130_106_119,seq81,r_20_144_43,0.79,6,49,43,18
95,seq110,r_32_147_64,seq80,r_32_147_64,1.0,1,65,64,18
39,r_69_27_12,r_102_67_101,seq125,r_102_67_101,1.0,0,101,101,18
41,r_124_75_109,r_115_118_113,seq81,r_124_75_109,1.0,0,109,109,18
37,r_102_67_101,seq125,r_69_27_12,r_69_27_12,0.99,3,15,12,18
3,r_135_92_155,seq45,r_149_41_133,r_135_92_155,0.55,4,159,155,18
10,r_28_138_132,seq141,seq126,r_28_138_132,0.88,0,132,132,18
72,seq57,r_55_131_185,r_32_147_64,r_32_147_64,0.93,121,185,64,18
99,seq126,r_23_82_32,r_28_138_132,r_28_138_132,1.0,0,132,132,18
36,r_53_87_36,r_83_123_69,seq14,r_83_123_69,0.98,-33,36,69,18
48,r_122_37_187,r_51_109_174,r_135_92_155,r_135_92_155,0.95,20,175,155,18
49,r_119_36_77,r_23_82_32,r_50_100_8,r_50_100_8,0.48,143,151,8,18
12,r_139_68_158,seq49,seq34,r_139_68_158,0.99,0,158,158,18
6,r_18_8_145,seq1,seq61,r_18_8_145,0.75,0,145,145,18
27,r_127_48_165,seq0,r_135_92_155,r_127_48_165,0.81,0,165,165,18
22,r_59_16_17,r_55_131_185,r_32_147_64,r_32_147_64,0.53,41,105,64,18
18,r_149_41_133,r_122_37_187,r_135_92_155,r_122_37_187,1.0,0,187,187,18
47,r_120_111_67,seq34,seq3,r_120_111_67,1.0,0,67,67,18
18,r_149_41_133,seq108,r_122_37_187,r_149_41_133,0.38,0,133,133,18
24,r_63_93_76,seq104,seq15,r_63_93_76,1.0,0,76,76,18
8,r_43_71_10,r_32_147_64,seq107,r_43_71_10,0.92,0,10,10,18
43,r_23_82_32,r_145_134_108,r_102_67_101,r_102_67_101,0.99,5,106,101,18
33,r_113_38_78,seq3,r_30_42_9,r_113_38_78,1.0,0,78,78,18
48,r_122_37_187,r_135_92_155,r_143_79_45,r_122_37_187,0.64,0,187,187,18
22,r_59_16_17,r_20_144_43,r_55_131_185,r_59_16_17,0.73,-1,16,17,18
50,seq0,r_127_48_165,r_143_79_45,r_143_79_45,1.0,120,165,45,18
20,r_73_112_30,seq34,r_43_71_10,r_73_112_30,0.97,2,32,30,18
68,seq45,r_135_92_155,seq49,r_135_92_155,0.83,4,159,155,18
67,seq44,seq137,r_54_105_38,r_54_105_38,1.0,0,38,38,18
39,r_69_27_12,r_20_144_43,r_102_67_101,r_69_27_12,0.99,0,12,12,18
96,seq116,r_24_46_15,r_39_114_29,r_24_46_15,0.63,8,23,15,18
32,r_83_123_69,r_149_41_133,r_9_78_166,r_83_123_69,1.0,0,69,69,18
38,r_19_66_71,r_139_68_158,r_9_78_166,r_19_66_71,1.0,0,71,71,18
34,r_142_21_121,r_145_134_108,r_120_111_67,r_142_21_121,0.99,1,122,121,18
11,r_39_114_29,r_55_131_185,seq116,r_55_131_185,0.75,-155,30,185,18
0,r_54_105_38,r_146_2_81,r_12_136_34,r_12_136_34,1.0,4,38,34,18
60,seq15,seq14,r_63_93_76,r_63_93_76,0.99,0,76,76,18
9,r_60_140_169,r_25_31_107,seq90,r_25_31_107,1.0,0,107,107,18
93,seq107,r_20_144_43,r_43_71_10,r_43_71_10,0.54,0,10,10,18
37,r_102_67_101,r_69_27_12,r_23_82_32,r_102_67_101,0.81,0,101,101,18
28,r_133_4_163,seq62,r_84_95_7,r_133_4_163,0.92,0,163,163,18
91,seq101,r_65_99_118,seq125,r_65_99_118,0.97,1,119,118,18
49,r_119_36_77,r_127_48_165,r_23_82_32,r_119_36_77,1.0,0,77,77,18
4,r_143_79_45,seq128,seq90,r_143_79_45,1.0,0,45,45,18
7,r_32_147_64,seq110,r_59_16_17,r_32_147_64,0.98,1,65,64,18
44,r_64_132_157,r_9_78_166,r_18_8_145,r_64_132_157,0.9,0,157,157,18
82,seq141,r_28_138_132,seq62,r_28_138_132,1.0,0,132,132,18
12,r_139_68_158,r_19_66_71,seq49,r_19_66_71,1.0,1,72,71,18
84,seq81,seq76,r_124_75_109,r_124_75_109,1.0,13,122,109,18
8,r_92_140_47,r_128_97_76,seq32,r_92_140_47,1.0,0,47,47,19
36,r_56_80_124,seq1,seq71,r_56_80_124,0.97,0,124,124,19
92,seq112,r_120_116_79,r_105_28_9,r_120_116_79,0.41,0,79,79,19
14,r_91_138_120,seq144,r_40_90_32,r_91_138_120,0.84,0,120,120,19
43,r_100_5_78,r_123_53_183,seq147,r_100_5_78,0.91,1,79,78,19
28,r_40_90_32,r_122_103_189,seq54,r_40_90_32,1.0,0,32,32,19
37,r_22_70_122,r_21_96_162,r_101_143_101,r_22_70_122,0.66,0,122,122,19
59,seq26,r_55_9_174,seq1,r_55_9_174,1.0,0,174,174,19
21,r_94_117_105,r_13_129_107,seq109,r_94_117_105,0.71,0,105,105,19
1,r_21_96_162,r_55_9_174,r_89_66_138,r_55_9_174,0.51,-11,163,174,19
5,r_55_9_174,seq26,r_3_131_59,r_3_131_59,0.7,115,174,59,19
69,seq59,r_61_43_123,r_3_131_59,r_3_131_59,0.96,64,123,59,19
39,r_27_65_19,seq41,seq60,r_27_65_19,0.97,0,19,19,19
12,r_58_69_16,r_37_114_114,r_122_103_189,r_58_69_16,1.0,1,17,16,19
16,r_17_25_30,r_92_140_47,seq73,r_17_25_30,0.63,0,30,30,19
76,seq73,r_21_96_162,r_17_25_30,r_17_25_30,0.78,66,96,30,19
10,r_122_103_189,r_40_90_32,r_58_69_16,r_122_103_189,1.0,-172,17,189,19
3,r_139_111_70,seq78,seq47,r_139_111_70,1.0,0,70,70,19
79,seq77,r_44_76_136,r_146_36_18,r_146_36_18,0.99,3,21,18,19
11,r_128_97_76,r_123_53_183,seq46,r_128_97_76,0.99,0,76,76,19
13,r_104_87_152,seq126,seq144,r_104_87_152,0.92,0,152,152,19
15,r_134_50_69,r_122_103_189,seq1,r_134_50_69,1.0,0,69,69,19
48,r_44_76_136,seq72,seq82,r_44_76_136,0.98,0,136,136,19
12,r_58_69_16,r_122_103_189,r_6_136_163,r_6_136_163,0.72,5,168,163,19
67,seq52,r_137_20_53,r_31_12_134,r_137_20_53,1.0,-10,43,53,19
85,seq144,seq45,r_120_116_79,r_120_116_79,0.95,0,79,79,19
80,seq78,seq119,r_10_64_40,r_10_64_40,1.0,17,57,40,19
20,r_146_36_18,r_92_140_47,seq77,r_146_36_18,0.98,0,18,18,19
47,r_30_83_10,r_44_76_136,r_49_125_139,r_30_83_10,0.9,0,10,10,19
10,r_122_103_189,r_58_69_16,r_92_140_47,r_92_140_47,0.77,142,189,47,19
2,r_63_14_146,seq0,r_128_97_76,r_63_14_146,0.76,0,146,146,19
18,r_85_42_90,seq52,seq107,r_85_42_90,0.78,0,90,90,19
29,r_11_135_130,seq86,seq0,r_11_135_130,0.96,0,130,130,19
24,r_123_53_183,seq47,r_94_117_105,r_94_117_105,0.97,80,185,105,19
33,r_7_79_116,r_121_141_117,r_37_114_114,r_7_79_116,0.85,0,116,116,19
64,seq45,seq144,r_92_140_47,r_92_140_47,1.0,135,182,47,19
0,r_137_20_53,seq52,seq0,r_137_20_53,1.0,1,54,53,19
42,r_49_125_139,r_11_135_130,r_30_83_10,r_30_83_10,0.98,1,11,10,19
68,seq54,r_6_136_163,r_40_90_32,r_40_90_32,0.67,131,163,32,19
32,r_61_43_123,seq59,seq132,r_61_43_123,0.95,0,123,123,19
38,r_31_12_134,seq52,r_128_97_76,r_31_12_134,0.87,0,134,134,19
52,seq132,r_4_106_178,r_128_97_76,r_128_97_76,0.89,66,142,76,19
4,r_19_33_20,seq60,seq67,r_19_33_20,0.96,0,20,20,19
34,r_29_130_125,r_21_96_162,seq82,r_29_130_125,0.91,0,125,125,19
41,r_18_88_39,seq112,seq133,r_18_88_39,1.0,0,39,39,19
81,seq82,seq47,r_44_76_136,r_44_76_136,1.0,6,142,136,19
27,r_10_64_40,r_89_66_138,seq78,r_10_64_40,1.0,0,40,40,19
9,r_101_143_101,seq78,seq34,r_101_143_101,0.99,0,101,101,19
53,seq133,r_37_114_114,r_18_88_39,r_18_88_39,0.95,2,41,39,19
7,r_120_116_79,seq112,seq144,r_120_116_79,0.99,0,79,79,19
44,r_15_23_135,r_6_136_163,r_29_130_125,r_29_130_125,0.64,12,137,125,19
23,r_37_114_114,seq126,r_105_28_9,r_37_114_114,1.0,0,114,114,19
35,r_39_57_108,r_21_96_162,r_89_66_138,r_39_57_108,0.44,-2,106,108,19
36,r_148_60_156,seq58,seq113,r_148_60_156,0.75,0,156,156,20
14,r_77_78_135,r_73_115_170,r_118_35_91,r_77_78_135,0.84,0,135,135,20
8,r_88_61_61,seq4,r_72_93_140,r_88_61_61,0.51,3,64,61,20
71,seq32,r_72_93_140,r_79_146_78,r_79_146_78,0.61,5,83,78,20
15,r_39_63_41,r_16_22_38,seq100,r_16_22_38,0.95,-9,29,38,20
46,r_110_55_80,r_85_80_158,r_67_133_85,r_85_80_158,0.88,-77,81,158,20
45,r_102_48_62,r_101_53_191,seq89,r_102_48_62,1.0,0,62,62,20
2,r_142_56_18,seq1,r_87_143_152,r_142_56_18,0.91,0,18,18,20
35,r_16_22_38,r_39_63_41,r_85_80_158,r_16_22_38,0.89,0,38,38,20
38,r_12_17_24,r_62_144_2,r_42_106_22,r_12_17_24,0.48,0,24,24,20
9,r_92_8_27,r_85_80_158,r_54_82_12,r_92_8_27,0.99,0,27,27,20
1,r_24_149_19,r_69_103_39,seq83,r_24_149_19,0.91,-6,13,19,20
5,r_98_81_36,r_118_35_91,seq38,r_98_81_36,0.57,-1,35,36,20
8,r_88_61_61,r_72_93_140,r_79_146_78,r_72_93_140,0.58,-45,95,140,20
20,r_72_93_140,seq140,seq19,r_72_93_140,0.57,0,140,140,20
13,r_118_35_91,seq27,r_67_133_85,r_118_35_91,0.86,0,91,91,20
79,seq137,r_122_124_196,r_6_10_55,r_6_10_55,1.0,1,56,55,20
0,r_34_96_44,r_132_71_163,r_129_90_172,r_34_96_44,1.0,1,45,44,20
27,r_0_49_48,r_92_8_27,r_33_7_46,r_0_49_48,1.0,0,48,48,20
2,r_142_56_18,r_87_143_152,seq2,r_87_143_152,0.96,1,153,152,20
0,r_34_96_44,r_129_90_172,r_109_18_51,r_129_90_172,0.43,5,177,172,20
87,seq89,r_62_144_2,r_102_48_62,r_102_48_62,1.0,1,63,62,20
31,r_42_106_22,r_47_135_179,r_12_17_24,r_42_106_22,0.5,1,23,22,20
48,r_3_116_59,r_85_80_158,r_72_93_140,r_85_80_158,0.8,-100,58,158,20
40,r_41_23_155,seq138,seq2,r_41_23_155,0.92,1,156,155,20
74,seq40,r_85_80_158,seq27,r_85_80_158,0.84,0,158,158,20
18,r_73_115_170,r_141_15_173,r_142_56_18,r_73_115_170,0.8,0,170,170,20
29,r_76_147_184,seq134,r_92_8_27,r_92_8_27,0.51,157,184,27,20
24,r_94_44_73,seq38,r_129_90_172,r_94_44_73,0.67,37,110,73,20
35,r_16_22_38,r_85_80_158,r_87_143_152,r_16_22_38,0.91,120,158,38,20
25,r_84_126_153,seq51,r_6_10_55,r_6_10_55,1.0,99,154,55,20
43,r_129_90_172,r_34_96_44,r_94_44_73,r_94_44_73,0.52,104,177,73,20
33,r_52_95_167,seq58,r_33_7_46,r_52_95_167,0.43,0,167,167,20
43,r_129_90_172,seq13,r_34_96_44,r_34_96_44,1.0,0,44,44,20
48,r_3_116_59,r_72_93_140,r_79_146_78,r_3_116_59,0.39,80,139,59,20
42,r_87_143_152,r_109_18_51,r_142_56_18,r_109_18_51,0.75,-4,47,51,20
44,r_6_10_55,r_77_78_135,seq137,r_6_10_55,1.0,0,55,55,20
42,r_87_143_152,r_142_56_18,r_16_22_38,r_87_143_152,0.98,0,152,152,20
61,seq13,r_129_90_172,r_34_96_44,r_34_96_44,1.0,115,159,44,20
32,r_99_28_143,seq38,seq43,r_99_28_143,0.98,0,143,143,20
34,r_139_68_128,seq131,seq5,r_139_68_128,1.0,0,128,128,20
7,r_33_7_46,r_114_20_182,seq51,r_33_7_46,0.99,-3,43,46,20
6,r_109_18_51,r_87_143_152,r_34_96_44,r_109_18_51,0.95,0,51,51,20
19,r_65_104_17,seq19,seq137,r_65_104_17,1.0,0,17,17,20
90,seq100,r_69_103_39,r_39_63_41,r_69_103_39,0.99,-10,29,39,20
41,r_69_103_39,seq100,r_67_133_85,r_69_103_39,0.85,0,39,39,20
81,seq59,r_114_20_182,r_42_106_22,r_42_106_22,0.88,160,182,22,20
17,r_132_71_163,seq5,r_136_50_53,r_136_50_53,1.0,110,163,53,20
10,r_136_50_53,r_94_44_73,seq45,r_136_50_53,1.0,-2,51,53,20
28,r_57_86_102,r_76_147_184,seq37,r_57_86_102,0.99,0,102,102,20
49,r_79_146_78,seq100,r_88_61_61,r_79_146_78,0.99,0,78,78,20
23,r_47_135_179,seq83,r_16_22_38,r_16_22_38,0.93,143,181,38,20
12,r_125_121_124,r_84_126_153,seq58,r_125_121_124,1.0,0,124,124,20
30,r_122_124_196,seq137,r_36_123_6,r_36_123_6,0.94,8,14,6,20
37,r_83_49_163,r_16_95_116,r_13_108_48,r_13_108_48,0.96,-1,47,48,21
8,r_97_123_94,r_70_96_119,r_93_45_100,r_93_45_100,0.98,-6,94,100,21
43,r_16_95_116,r_83_49_163,r_101_140_65,r_16_95_116,0.68,0,116,116,21
59,seq20,r_3_130_172,r_92_51_77,r_92_51_77,0.96,101,178,77,21
40,r_118_142_40,seq135,seq32,r_118_142_40,0.98,-1,39,40,21
19,r_101_140_65,r_58_29_12,r_16_95_116,r_16_95_116,1.0,40,156,116,21
39,r_46_106_167,seq69,seq30,r_46_106_167,0.47,2,169,167,21
5,r_100_141_89,seq61,r_107_67_55,r_100_141_89,0.99,0,89,89,21
46,r_131_120_134,seq33,seq5,r_131_120_134,0.82,1,135,134,21
7,r_13_108_48,r_83_49_163,r_134_66_101,r_134_66_101,0.83,63,164,101,21
45,r_144_136_122,r_78_41_156,r_93_45_100,r_144_136_122,0.91,0,122,122,21
19,r_101_140_65,r_134_66_101,r_58_29_12,r_101_140_65,0.99,0,65,65,21
6,r_107_67_55,seq20,r_78_41_156,r_107_67_55,1.0,-2,53,55,21
95,seq114,r_111_12_91,seq27,r_111_12_91,0.97,-1,90,91,21
66,seq32,r_105_65_169,r_103_86_106,r_103_86_106,0.99,63,169,106,21
41,r_103_86_106,seq23,r_59_145_58,r_103_86_106,0.99,0,106,106,21
36,r_82_31_52,seq30,seq24,r_82_31_52,1.0,1,53,52,21
89,seq87,r_26_102_168,r_82_31_52,r_82_31_52,0.78,59,111,52,21
3,r_93_45_100,r_128_14_177,r_85_149_129,r_85_149_129,1.0,28,157,129,21
10,r_111_12_91,seq114,seq90,r_111_12_91,0.95,4,95,91,21
90,seq90,seq8,r_111_12_91,r_111_12_91,0.99,1,92,91,21
20,r_35_6_174,r_88_112_82,r_115_38_161,r_35_6_174,0.65,-125,49,174,21
4,r_94_1_73,r_97_123_94,seq24,r_94_1_73,0.98,1,74,73,21
0,r_50_104_181,seq30,r_88_112_82,r_88_112_82,1.0,102,184,82,21
63,seq27,r_143_89_70,r_117_15_121,r_143_89_70,1.0,-9,61,70,21
11,r_134_66_101,r_7_21_103,r_13_108_48,r_7_21_103,0.61,-3,100,103,21
44,r_59_145_58,r_3_130_172,r_105_65_169,r_59_145_58,0.94,0,58,58,21
15,r_143_89_70,seq27,seq57,r_143_89_70,1.0,-1,69,70,21
42,r_129_116_31,r_118_142_40,seq113,r_118_142_40,0.97,-8,32,40,21
27,r_42_137_109,seq56,seq37,r_42_137_109,0.97,1,110,109,21
14,r_60_4_38,r_13_108_48,seq73,r_60_4_38,0.93,4,42,38,21
22,r_74_91_13,r_85_149_129,seq44,r_85_149_129,1.0,-43,86,129,21
2,r_115_38_161,seq19,seq37,r_115_38_161,0.6,0,161,161,21
7,r_13_108_48,r_3_130_172,r_83_49_163,r_13_108_48,0.99,-1,47,48,21
47,r_105_65_169,seq32,r_80_84_96,r_80_84_96,0.8,73,169,96,21
20,r_35_6_174,r_115_38_161,r_74_91_13,r_74_91_13,0.63,74,87,13,21
18,r_79_2_97,r_80_84_96,r_94_1_73,r_79_2_97,0.99,-1,96,97,21
29,r_7_21_103,seq37,r_94_1_73,r_7_21_103,1.0,0,103,103,21
24,r_133_98_135,seq54,r_126_34_88,r_133_98_135,0.81,0,135,135,21
34,r_85_149_129,r_74_91_13,r_93_45_100,r_85_149_129,0.8,2,131,129,21
25,r_88_112_82,r_92_51_77,seq11,r_88_112_82,0.99,-1,81,82,21
33,r_68_81_112,seq47,r_111_12_91,r_68_81_112,0.65,2,114,112,21
34,r_85_149_129,r_88_112_82,r_74_91_13,r_74_91_13,0.94,1,14,13,21
93,seq110,r_50_104_181,r_58_29_12,r_58_29_12,1.0,0,12,12,21
65,seq30,r_50_104_181,r_46_106_167,r_46_106_167,0.98,17,184,167,21
32,r_92_51_77,r_88_112_82,seq20,r_88_112_82,0.59,-4,78,82,21
26,r_58_29_12,r_128_14_177,seq110,r_58_29_12,0.67,0,12,12,21
20,r_35_6_174,r_74_91_13,r_119_122_138,r_35_6_174,0.64,-5,169,174,21
17,r_124_43_171,seq57,r_101_140_65,r_101_140_65,0.99,108,173,65,21
9,r_119_122_138,r_128_14_177,seq125,r_119_122_138,0.94,0,138,138,21
22,r_74_91_13,seq125,r_85_149_129,r_74_91_13,0.98,0,13,13,21
37,r_83_49_163,r_13_108_48,r_126_34_88,r_13_108_48,0.93,116,164,48,21
28,r_80_84_96,r_79_2_97,seq27,r_80_84_96,1.0,2,98,96,21
49,r_70_96_119,seq23,seq33,r_70_96_119,1.0,2,121,119,21
44,r_59_145_58,r_105_65_169,r_103_86_106,r_103_86_106,0.64,7,113,106,21
16,r_0_53_56,seq87,r_93_45_100,r_0_53_56,0.92,0,56,56,21
23,r_126_34_88,seq47,seq28,r_126_34_88,1.0,1,89,88,21
35,r_22_138_107,seq37,seq72,r_22_138_107,0.97,1,108,107,21
30,r_148_12_174,seq54,r_69_49_144,r_69_49_144,1.0,30,174,144,22
36,r_110_18_181,r_98_133_160,r_90_35_179,r_110_18_181,0.56,-21,160,181,22
14,r_45_87_124,r_44_124_158,r_131_81_3,r_45_87_124,0.89,0,124,124,22
8,r_140_29_172,seq16,r_44_124_158,r_44_124_158,0.52,17,175,158,22
87,seq88,r_136_139_113,r_15_105_27,r_15_105_27,0.88,21,48,27,22
86,seq86,r_99_58_136,r_15_105_27,r_15_105_27,0.84,115,142,27,22
16,r_104_116_121,seq135,r_34_32_107,r_34_32_107,0.77,29,136,107,22
39,r_61_60_169,r_90_35_179,r_143_17_118,r_143_17_118,1.0,58,176,118,22
1,r_143_17_118,r_117_23_81,seq21,r_117_23_81,0.99,0,81,81,22
46,r_134_84_190,r_33_109_192,r_34_32_107,r_34_32_107,1.0,22,129,107,22
43,r_102_26_41,seq56,seq112,r_102_26_41,1.0,-1,40,41,22
45,r_144_77_184,seq66,r_15_105_27,r_15_105_27,0.81,158,185,27,22
23,r_50_96_29,r_68_123_4,seq4,r_50_96_29,0.79,0,29,29,22
13,r_15_105_27,seq76,seq88,r_15_105_27,1.0,-1,26,27,22
17,r_13_1_117,r_44_124_158,seq119,r_44_124_158,0.72,0,158,158,22
10,r_98_133_160,r_110_18_181,r_95_51_149,r_95_51_149,0.94,11,160,149,22
3,r_113_137_30,r_45_87_124,seq146,r_113_137_30,0.94,0,30,30,22
1,r_143_17_118,seq21,r_102_26_41,r_143_17_118,0.99,0,118,118,22
26,r_95_51_149,seq94,seq16,r_95_51_149,0.94,0,149,149,22
4,r_115_8_69,r_47_70_99,seq78,r_47_70_99,0.7,-27,72,99,22
0,r_83_64_129,seq7,r_99_58_136,r_83_64_129,0.9,4,133,129,22
63,seq21,r_143_17_118,seq42,r_143_17_118,0.98,0,118,118,22
73,seq56,seq145,r_24_40_123,r_24_40_123,1.0,19,142,123,22
42,r_55_71_49,r_134_84_190,seq94,r_55_71_49,1.0,0,49,49,22
98,seq126,r_38_100_148,r_80_101_92,r_80_101_92,0.51,1,93,92,22
85,seq85,r_68_123_4,r_79_2_96,r_79_2_96,0.52,-21,75,96,22
99,seq149,r_69_49_144,seq21,r_69_49_144,0.54,1,145,144,22
32,r_82_53_15,r_44_124_158,seq145,r_82_53_15,0.78,0,15,15,22
27,r_34_32_107,seq16,r_134_84_190,r_34_32_107,0.86,0,107,107,22
6,r_111_22_50,r_104_116_121,r_113_137_30,r_113_137_30,0.49,20,50,30,22
2,r_79_2_96,seq119,r_68_123_4,r_79_2_96,0.73,-1,95,96,22
18,r_24_40_123,seq76,seq56,r_24_40_123,1.0,0,123,123,22
29,r_117_23_81,r_143_17_118,r_115_8_69,r_117_23_81,0.92,0,81,81,22
24,r_47_70_99,seq128,r_65_36_43,r_47_70_99,1.0,0,99,99,22
33,r_44_124_158,r_45_87_124,r_13_1_117,r_13_1_117,0.85,7,124,117,22
48,r_65_36_43,seq106,r_47_70_99,r_47_70_99,0.99,20,119,99,22
50,seq128,seq6,r_136_139_113,r_136_139_113,0.83,22,135,113,22
58,seq14,r_80_101_92,seq62,r_80_101_92,0.99,-11,81,92,22
33,r_44_124_158,r_13_1_117,seq97,r_44_124_158,0.94,0,158,158,22
38,r_80_101_92,seq14,seq126,r_80_101_92,1.0,1,93,92,22
34,r_38_100_148,seq126,r_143_17_118,r_143_17_118,0.99,30,148,118,22
17,r_13_1_117,r_28_27_168,r_44_124_158,r_44_124_158,0.59,-40,118,158,22
25,r_37_59_46,seq130,r_15_105_27,r_37_59_46,0.97,0,46,46,22
9,r_127_107_100,seq5,r_115_8_69,r_127_107_100,0.97,1,101,100,22
48,r_65_36_43,seq5,seq106,r_65_36_43,0.92,0,43,43,22
5,r_31_9_42,r_132_20_187,seq76,r_31_9_42,1.0,0,42,42,22
22,r_68_123_4,seq85,r_79_2_96,r_79_2_96,0.56,-1,95,96,22
28,r_90_35_179,r_61_60_169,r_99_58_136,r_99_58_136,0.56,45,181,136,22
49,r_147_10_108,r_132_20_187,r_15_105_27,r_147_10_108,0.9,0,108,108,22
44,r_108_46_109,r_140_29_172,seq42,r_108_46_109,1.0,0,109,109,22
35,r_69_49_144,seq149,seq5,r_69_49_144,0.87,1,145,144,22
84,seq78,r_0_43_157,r_115_8_69,r_0_43_157,0.58,-83,74,157,22
20,r_132_20_187,r_147_10_108,seq62,r_147_10_108,0.83,-54,54,108,22
41,r_93_62_39,r_122_69_91,r_54_18_164,r_93_62_39,0.99,6,45,39,23
30,r_94_21_110,seq140,r_17_12_108,r_94_21_110,0.51,2,112,110,23
4,r_100_80_22,seq5,seq103,r_100_80_22,0.81,7,29,22,23
14,r_122_69_91,seq145,seq79,r_122_69_91,0.53,1,92,91,23
43,r_36_72_184,seq49,r_98_84_151,r_36_72_184,0.67,0,184,184,23
83,seq79,r_14_50_144,r_16_133_132,r_14_50_144,0.65,0,144,144,23
10,r_81_105_26,r_36_72_184,seq65,r_81_105_26,1.0,0,26,26,23
86,seq90,r_2_125_175,seq37,r_2_125_175,0.85,-6,169,175,23
16,r_148_19_69,r_23_6_95,seq8,r_148_19_69,0.97,0,69,69,23
21,r_47_71_61,r_97_51_65,r_48_118_48,r_48_118_48,0.72,13,61,48,23
42,r_149_86_192,r_96_33_148,r_55_42_139,r_96_33_148,0.84,0,148,148,23
19,r_17_12_108,seq34,seq137,r_17_12_108,0.69,0,108,108,23
11,r_48_118_48,r_46_104_183,r_148_19_69,r_48_118_48,0.66,136,184,48,23
31,r_64_29_3,r_116_128_120,r_60_22_13,r_116_128_120,1.0,1,121,120,23
20,r_76_24_25,seq142,r_45_66_54,r_45_66_54,0.96,5,59,54,23
26,r_116_128_120,r_64_29_3,seq38,r_116_128_120,0.48,1,121,120,23
47,r_135_88_15,r_16_133_132,seq142,r_135_88_15,0.91,0,15,15,23
3,r_67_10_49,seq132,seq142,r_67_10_49,1.0,0,49,49,23
13,r_115_59_158,seq147,seq57,r_115_59_158,0.69,1,159,158,23
48,r_87_146_118,r_100_80_22,r_93_62_39,r_87_146_118,0.4,1,119,118,23
49,r_46_104_183,r_48_118_48,seq34,r_46_104_183,0.48,1,184,183,23
4,r_100_80_22,seq103,r_54_18_164,r_54_18_164,0.71,0,164,164,23
11,r_48_118_48,r_89_92_194,r_46_104_183,r_48_118_48,0.97,1,49,48,23
49,r_46_104_183,seq15,r_48_118_48,r_48_118_48,1.0,3,51,48,23
6,r_16_133_132,r_45_66_54,r_110_77_33,r_16_133_132,1.0,-87,45,132,23
27,r_119_9_73,r_123_102_191,seq15,r_119_9_73,1.0,0,73,73,23
41,r_93_62_39,r_54_18_164,seq132,r_54_18_164,0.93,0,164,164,23
40,r_28_107_96,seq131,seq11,r_28_107_96,0.85,0,96,96,23
18,r_2_125_175,seq90,r_96_33_148,r_2_125_175,0.47,0,175,175,23
29,r_143_106_174,seq65,r_87_146_118,r_143_106_174,0.49,1,175,174,23
9,r_101_52_42,seq130,seq138,r_101_52_42,0.94,2,44,42,23
22,r_108_4_40,r_122_69_91,seq49,r_108_4_40,1.0,0,40,40,23
70,seq32,r_55_42_139,r_43_124_6,r_55_42_139,1.0,2,141,139,23
6,r_16_133_132,r_110_77_33,r_122_69_91,r_16_133_132,0.99,1,133,132,23
39,r_83_27_12,r_3_73_198,seq138,r_83_27_12,0.64,0,12,12,23
32,r_58_56_136,seq121,r_16_133_132,r_58_56_136,0.68,1,137,136,23
77,seq57,seq0,r_115_59_158,r_115_59_158,1.0,6,164,158,23
34,r_14_50_144,seq79,seq95,r_14_50_144,0.91,0,144,144,23
69,seq31,r_14_50_144,r_20_134_10,r_14_50_144,0.76,-98,46,144,23
36,r_7_144_30,r_115_59_158,seq91,r_7_144_30,1.0,0,30,30,23
28,r_54_18_164,r_93_62_39,r_100_80_22,r_54_18_164,0.87,0,164,164,23
28,r_54_18_164,r_58_56_136,r_93_62_39,r_93_62_39,0.91,16,55,39,23
7,r_96_33_148,r_149_86_192,r_112_63_5,r_149_86_192,0.79,-44,148,192,23
23,r_98_84_151,seq137,seq44,r_98_84_151,0.98,0,151,151,23
79,seq65,r_143_106_174,r_81_105_26,r_81_105_26,0.93,149,175,26,23
12,r_126_41_1,r_96_33_148,r_55_42_139,r_96_33_148,0.82,0,148,148,23
5,r_35_40_17,seq0,seq68,r_35_40_17,0.95,-2,15,17,23
45,r_45_66_54,r_17_12_108,r_76_24_25,r_45_66_54,1.0,0,54,54,23
30,r_68_23_60,seq132,r_41_95_16,r_68_23_60,0.95,4,64,60,24
14,r_35_11_86,seq105,r_27_9_70,r_35_11_86,0.97,2,88,86,24
8,r_46_43_78,seq119,r_115_32_68,r_115_32_68,1.0,62,130,68,24
70,seq38,r_27_9_70,r_136_101_91,r_136_101_91,0.58,39,130,91,24
37,r_88_17_94,r_57_58_148,seq4,r_88_17_94,0.97,0,94,94,24
59,seq18,r_136_101_91,r_66_89_71,r_66_89_71,1.0,16,87,71,24
55,seq135,r_88_17_94,r_90_71_12,r_88_17_94,0.96,-1,93,94,24
26,r_77_98_14,seq96,seq125,r_77_98_14,0.99,2,16,14,24
39,r_70_99_122,r_87_56_151,seq8,r_70_99_122,0.99,1,123,122,24
1,r_72_84_112,r_113_51_33,r_116_111_65,r_116_111_65,0.94,2,67,65,24
5,r_107_19_89,r_110_140_118,r_141_50_18,r_141_50_18,0.76,67,85,18,24
46,r_33_15_163,r_36_76_182,r_70_99_122,r_70_99_122,0.94,42,164,122,24
32,r_20_128_177,r_5_80_15,seq61,r_5_80_15,0.42,166,181,15,24
16,r_55_108_36,r_139_25_189,seq29,r_55_108_36,1.0,2,38,36,24
41,r_113_51_33,r_87_56_151,seq75,r_113_51_33,0.78,4,37,33,24
27,r_5_80_15,r_20_128_177,r_54_16_107,r_54_16_107,1.0,40,147,107,24
44,r_57_58_148,r_122_39_183,seq132,r_57_58_148,1.0,0,148,148,24
89,seq100,r_20_128_177,r_72_84_112,r_72_84_112,0.98,14,126,112,24
3,r_116_111_65,seq42,r_72_84_112,r_116_111_65,0.99,0,65,65,24
10,r_122_39_183,r_88_17_94,r_45_1_27,r_122_39_183,0.89,-89,94,183,24
27,r_5_80_15,r_107_19_89,r_20_128_177,r_5_80_15,0.94,0,15,15,24
4,r_115_32_68,seq132,seq29,r_115_32_68,1.0,0,68,68,24
0,r_27_9_70,r_136_101_91,r_35_11_86,r_35_11_86,0.91,1,87,86,24
11,r_143_37_172,r_130_112_167,r_45_1_27,r_143_37_172,0.77,0,172,172,24
17,r_49_2_41,r_126_138_186,seq42,r_49_2_41,1.0,0,41,41,24
48,r_54_16_107,seq121,seq100,r_54_16_107,0.99,0,107,107,24
10,r_122_39_183,r_45_1_27,r_136_101_91,r_122_39_183,0.74,0,183,183,24
2,r_126_138_186,seq47,r_41_95_16,r_126_138_186,0.51,0,186,186,24
47,r_130_112_167,r_143_37_172,r_66_89_71,r_66_89_71,0.94,101,172,71,24
3,r_116_111_65,r_72_84_112,seq82,r_72_84_112,0.96,-9,103,112,24
74,seq52,r_106_102_72,seq129,r_106_102_72,1.0,-1,71,72,24
18,r_60_86_127,r_41_95_16,seq133,r_60_86_127,0.99,0,127,127,24
29,r_148_53_137,r_41_95_16,seq133,r_148_53_137,0.96,0,137,137,24
6,r_97_79_40,r_88_17_94,seq75,r_97_79_40,0.69,1,41,40,24
25,r_87_56_151,r_70_99_122,seq40,r_70_99_122,0.91,1,123,122,24
33,r_66_89_71,seq64,seq18,r_66_89_71,1.0,0,71,71,24
64,seq132,r_68_23_60,seq8,r_68_23_60,0.95,4,64,60,24
88,seq96,seq144,r_115_32_68,r_115_32_68,1.0,1,69,68,24
70,seq38,r_136_101_91,r_44_85_158,r_44_85_158,0.87,0,158,158,24
58,seq144,r_59_120_139,r_115_32_68,r_115_32_68,0.87,55,123,68,24
70,seq38,r_67_142_104,r_27_9_70,r_67_142_104,0.9,0,104,104,24
38,r_91_26_76,seq147,seq129,r_91_26_76,1.0,0,76,76,24
13,r_45_1_27,r_68_23_60,seq21,r_45_1_27,1.0,0,27,27,24
24,r_31_78_11,r_97_79_40,seq47,r_31_78_11,0.49,1,12,11,24
32,r_20_128_177,seq100,r_5_80_15,r_5_80_15,0.9,29,44,15,24
45,r_90_71_12,r_0_48_165,seq127,r_90_71_12,0.89,0,12,12,24
25,r_87_56_151,seq40,r_45_1_27,r_87_56_151,0.97,0,151,151,24
9,r_59_120_139,seq119,seq30,r_59_120_139,0.85,0,139,139,24
22,r_36_76_182,r_41_95_16,r_87_56_151,r_36_76_182,0.55,0,182,182,24
28,r_106_102_72,seq52,seq147,r_106_102_72,1.0,-1,71,72,24
49,r_117_69_188,seq75,r_106_102_72,r_106_102_72,1.0,88,160,72,24
1,r_72_84_112,r_116_111_65,seq100,r_72_84_112,0.99,0,112,112,24
12,r_141_50_18,r_143_37_172,seq133,r_141_50_18,0.72,-6,12,18,24
7,r_67_142_104,seq38,seq6,r_67_142_104,0.92,0,104,104,24
44,r_57_58_148,r_88_17_94,r_122_39_183,r_88_17_94,1.0,0,94,94,24
23,r_3_137_74,r_35_11_86,r_49_2_41,r_3_137_74,1.0,0,74,74,24
30,r_7_100_91,r_56_22_167,seq80,r_7_100_91,0.9,1,92,91,25
36,r_131_125_190,seq60,r_36_133_50,r_36_133_50,0.52,93,143,50,25
28,r_17_25_15,r_5_24_86,seq4,r_17_25_15,0.95,0,15,15,25
43,r_53_147_64,r_99_38_108,r_48_137_22,r_53_147_64,0.96,0,64,64,25
16,r_34_68_152,seq80,seq0,r_34_68_152,0.75,1,153,152,25
1,r_96_9_149,r_55_112_151,r_69_138_61,r_69_138_61,0.69,88,149,61,25
42,r_107_32_140,r_13_49_14,r_104_28_37,r_104_28_37,0.44,115,152,37,25
49,r_46_72_56,r_69_138_61,r_104_28_37,r_46_72_56,0.99,0,56,56,25
45,r_69_138_61,seq87,seq39,r_69_138_61,1.0,0,61,61,25
41,r_48_137_22,r_47_18_48,seq148,r_48_137_22,0.57,5,27,22,25
19,r_108_51_90,r_96_9_149,seq124,r_96_9_149,0.96,-58,91,149,25
48,r_104_28_37,r_83_79_168,seq76,r_104_28_37,0.67,2,39,37,25
66,seq39,r_132_6_181,r_69_138_61,r_69_138_61,1.0,30,91,61,25
31,r_113_101_95,r_128_149_97,seq52,r_113_101_95,0.96,0,95,95,25
18,r_132_6_181,r_69_138_61,r_99_38_108,r_132_6_181,0.86,0,181,181,25
89,seq105,r_114_118_123,r_71_3_93,r_71_3_93,0.82,29,122,93,25
44,r_35_145_55,r_92_115_193,seq39,r_35_145_55,0.93,2,57,55,25
3,r_13_49_14,r_107_32_140,seq140,r_13_49_14,0.35,142,156,14,25
10,r_106_40_117,r_55_112_151,r_69_138_61,r_106_40_117,0.58,1,118,117,25
26,r_146_12_128,seq16,seq20,r_146_12_128,0.98,0,128,128,25
9,r_59_42_27,r_47_18_48,r_33_62_8,r_59_42_27,0.99,0,27,27,25
4,r_85_123_185,seq87,r_144_91_5,r_85_123_185,0.35,-55,130,185,25
0,r_136_8_111,seq74,seq41,r_136_8_111,1.0,1,112,111,25
11,r_64_89_186,seq111,r_85_123_185,r_85_123_185,0.8,1,186,185,25
20,r_66_50_133,r_56_22_167,seq60,r_66_50_133,0.88,0,133,133,25
15,r_55_112_151,r_96_9_149,seq141,r_96_9_149,0.94,2,151,149,25
50,seq0,seq16,r_34_68_152,r_34_68_152,0.91,8,160,152,25
2,r_45_126_145,seq86,seq87,r_45_126_145,0.92,3,148,145,25
41,r_48_137_22,seq148,r_53_147_64,r_53_147_64,1.0,26,90,64,25
40,r_88_30_114,r_107_32_140,r_98_54_21,r_107_32_140,0.45,-26,114,140,25
18,r_132_6_181,r_77_97_163,r_69_138_61,r_69_138_61,1.0,101,162,61,25
24,r_26_78_162,seq93,r_146_12_128,r_146_12_128,1.0,36,164,128,25
25,r_99_38_108,r_57_2_132,seq87,r_99_38_108,1.0,0,108,108,25
4,r_85_123_185,r_144_91_5,r_34_68_152,r_34_68_152,0.94,22,174,152,25
61,seq16,r_146_12_128,r_29_27_11,r_146_12_128,1.0,0,128,128,25
38,r_57_2_132,seq4,r_130_121_23,r_57_2_132,0.97,1,133,132,25
34,r_128_149_97,seq39,r_29_27_11,r_128_149_97,1.0,0,97,97,25
75,seq73,seq109,r_47_18_48,r_47_18_48,1.0,78,126,48,25
81,seq86,r_45_126_145,r_33_62_8,r_45_126_145,0.98,3,148,145,25
17,r_56_22_167,seq4,seq16,r_56_22_167,0.49,0,167,167,25
39,r_36_133_50,r_47_18_48,r_131_125_190,r_47_18_48,1.0,0,48,48,25
32,r_130_121_23,r_29_27_11,seq111,r_130_121_23,1.0,0,23,23,25
35,r_71_3_93,r_128_149_97,seq15,r_71_3_93,0.87,2,95,93,25
61,seq16,r_29_27_11,r_56_22_167,r_56_22_167,0.6,14,181,167,25
12,r_63_102_170,seq141,r_144_91_5,r_63_102_170,0.63,0,170,170,25
6,r_47_18_48,r_36_133_50,seq73,r_47_18_48,1.0,0,48,48,25
62,seq17,r_21_7_2,r_149_40_20,r_149_40_20,1.0,8,28,20,26
6,r_147_22_86,r_3_148_48,r_145_6_10,r_3_148_48,0.99,-2,46,48,26
19,r_47_44_15,r_98_15_133,r_43_120_19,r_47_44_15,0.97,0,15,15,26
8,r_115_127_178,seq14,r_142_19_104,r_115_127_178,0.37,4,182,178,26
53,seq4,r_98_15_133,seq131,r_98_15_133,1.0,-29,104,133,26
54,seq129,r_25_90_184,r_108_91_118,r_25_90_184,0.86,0,184,184,26
30,r_61_107_39,r_121_117_107,seq109,r_61_107_39,0.73,0,39,39,26
16,r_38_45_181,seq130,seq137,r_38_45_181,0.38,0,181,181,26
39,r_57_92_113,seq71,r_99_140_5,r_57_92_113,0.75,0,113,113,26
1,r_98_15_133,seq4,seq12,r_98_15_133,0.85,0,133,133,26
97,seq109,seq95,r_61_107_39,r_61_107_39,0.98,63,102,39,26
42,r_101_87_173,r_25_90_184,seq130,r_25_90_184,0.54,-9,175,184,26
69,seq31,seq27,r_121_117_107,r_121_117_107,1.0,9,116,107,26
45,r_16_84_74,seq31,r_28_26_8,r_16_84_74,0.96,0,74,74,26
47,r_60_78_33,seq94,r_21_7_2,r_60_78_33,0.82,1,34,33,26
44,r_62_65_45,r_122_56_145,seq4,r_62_65_45,1.0,1,46,45,26
41,r_53_119_138,r_75_89_114,r_5_2_17,r_53_119_138,0.71,-16,122,138,26
3,r_76_81_130,r_8_72_153,seq29,r_76_81_130,0.61,2,132,130,26
46,r_5_2_17,r_98_15_133,seq39,r_5_2_17,0.99,0,17,17,26
26,r_128_55_162,seq51,r_41_10_63,r_128_55_162,0.65,0,162,162,26
4,r_86_143_4,r_123_33_149,seq137,r_123_33_149,0.88,4,153,149,26
11,r_122_56_145,seq130,seq109,r_122_56_145,0.88,1,146,145,26
46,r_5_2_17,seq39,r_53_119_138,r_5_2_17,0.46,113,130,17,26
36,r_149_40_20,r_98_15_133,seq17,r_149_40_20,1.0,0,20,20,26
15,r_0_111_61,r_121_117_107,r_108_91_118,r_0_111_61,0.93,0,61,61,26
48,r_36_50_176,r_108_91_118,r_76_81_130,r_36_50_176,0.57,1,177,176,26
34,r_125_138_109,r_142_19_104,r_76_81_130,r_142_19_104,0.54,55,159,104,26
57,seq139,r_48_133_18,r_83_23_110,r_83_23_110,0.5,2,112,110,26
28,r_43_120_19,r_48_133_18,seq95,r_43_120_19,0.75,-6,13,19,26
17,r_49_20_29,seq32,seq12,r_49_20_29,0.81,2,31,29,26
38,r_110_34_16,r_42_80_170,seq135,r_110_34_16,0.85,3,19,16,26
35,r_83_23_110,seq135,r_64_52_11,r_64_52_11,1.0,1,12,11,26
2,r_67_134_171,r_25_90_184,seq17,r_67_134_171,0.52,0,171,171,26
29,r_48_133_18,r_121_117_107,r_142_19_104,r_48_133_18,0.73,84,102,18,26
24,r_8_72_153,r_76_81_130,r_142_19_104,r_142_19_104,0.86,55,159,104,26
35,r_83_23_110,r_64_52_11,seq139,r_83_23_110,0.86,2,112,110,26
43,r_28_26_8,r_73_104_125,r_99_140_5,r_73_104_125,0.92,0,125,125,26
33,r_123_33_149,r_86_143_4,r_99_140_5,r_86_143_4,0.43,149,153,4,26
21,r_69_79_47,r_42_80_170,r_108_91_118,r_69_79_47,1.0,0,47,47,26
32,r_121_117_107,seq94,seq31,r_121_117_107,0.95,0,107,107,26
34,r_125_138_109,seq29,r_142_19_104,r_142_19_104,0.65,20,124,104,26
60,seq14,r_115_127_178,r_42_80_170,r_115_127_178,0.55,4,182,178,26
9,r_75_89_114,r_53_119_138,seq37,r_75_89_114,0.79,2,116,114,26
37,r_64_52_11,r_76_81_130,r_83_23_110,r_64_52_11,0.82,1,12,11,26
37,r_64_52_11,r_83_23_110,r_3_148_48,r_64_52_11,0.8,101,112,11,26
22,r_142_19_104,seq146,r_48_133_18,r_142_19_104,0.86,9,113,104,26
49,r_41_10_63,r_121_117_107,seq102,r_41_10_63,0.6,6,69,63,26
0,r_3_148_48,seq97,seq106,r_3_148_48,0.99,0,48,48,26
7,r_118_66_77,seq131,r_74_58_183,r_118_66_77,0.74,0,77,77,26
23,r_73_104_125,r_108_91_118,seq4,r_108_91_118,0.59,12,130,118,26
12,r_11_126_89,r_98_15_133,seq30,r_98_15_133,0.94,-44,89,133,26
14,r_107_37_29,seq2,r_97_88_14,r_107_37_29,1.0,0,29,29,27
30,r_12_8_86,seq56,seq43,r_12_8_86,1.0,0,86,86,27
8,r_145_4_138,seq134,seq1,r_145_4_138,0.86,0,138,138,27
59,seq19,seq78,r_91_66_136,r_91_66_136,1.0,26,162,136,27
21,r_91_66_136,r_147_146_189,r_12_8_86,r_91_66_136,0.63,0,136,136,27
39,r_22_21_75,seq56,r_107_37_29,r_22_21_75,1.0,0,75,75,27
1,r_34_18_87,r_145_4_138,r_135_95_37,r_34_18_87,0.65,0,87,87,27
5,r_65_47_89,seq77,seq7,r_65_47_89,1.0,0,89,89,27
42,r_89_86_105,r_41_92_71,seq53,r_41_92_71,0.99,0,71,71,27
43,r_25_114_96,seq82,seq84,r_25_114_96,1.0,0,96,96,27
45,r_59_10_116,seq96,r_142_79_111,r_59_10_116,0.55,4,120,116,27
19,r_57_140_144,seq36,seq134,r_57_140_144,0.91,0,144,144,27
31,r_76_124_60,r_52_133_106,r_32_93_46,r_76_124_60,0.5,0,60,60,27
72,seq62,r_9_15_57,seq96,r_9_15_57,1.0,0,57,57,27
15,r_16_48_51,r_24_11_69,seq78,r_16_48_51,1.0,0,51,51,27
10,r_24_11_69,seq94,seq56,r_24_11_69,1.0,0,69,69,27
33,r_136_68_13,r_12_8_86,seq90,r_136_68_13,0.97,0,13,13,27
11,r_30_116_169,seq73,r_142_79_111,r_142_79_111,0.57,59,170,111,27
9,r_64_69_32,r_39_63_164,seq5,r_64_69_32,0.87,0,32,32,27
20,r_41_92_71,r_89_86_105,r_107_37_29,r_41_92_71,0.83,0,71,71,27
62,seq43,r_121_14_194,r_12_8_86,r_12_8_86,1.0,24,110,86,27
46,r_50_38_48,r_24_11_69,seq117,r_50_38_48,1.0,0,48,48,27
36,r_9_15_57,r_132_125_122,seq80,r_132_125_122,1.0,0,122,122,27
27,r_110_6_83,seq54,r_129_111_82,r_110_6_83,0.97,1,84,83,27
2,r_141_138_184,seq99,seq128,r_141_138_184,0.55,0,184,184,27
40,r_103_45_41,seq77,r_33_26_72,r_33_26_72,1.0,59,131,72,27
74,seq130,r_23_70_162,r_135_95_37,r_135_95_37,0.74,63,100,37,27
18,r_33_26_72,r_132_125_122,r_103_45_41,r_103_45_41,0.72,31,72,41,27
29,r_129_111_82,r_20_31_85,r_110_6_83,r_129_111_82,0.83,2,84,82,27
24,r_137_87_125,seq84,seq85,r_137_87_125,0.96,0,125,125,27
36,r_9_15_57,seq62,r_132_125_122,r_9_15_57,1.0,0,57,57,27
25,r_104_115_88,r_141_138_184,seq77,r_104_115_88,0.91,0,88,88,27
88,seq101,r_25_114_96,seq13,r_25_114_96,1.0,0,96,96,27
32,r_27_29_145,r_141_138_184,seq44,r_27_29_145,0.82,0,145,145,27
47,r_32_93_46,seq78,r_35_139_11,r_32_93_46,1.0,-1,45,46,27
7,r_83_118_39,r_100_28_178,seq120,r_100_28_178,0.75,-135,43,178,27
43,r_25_114_96,seq101,seq82,r_25_114_96,0.4,-42,54,96,27
78,seq78,r_103_45_41,r_16_48_51,r_16_48_51,1.0,1,52,51,27
17,r_52_133_106,r_81_106_141,r_107_37_29,r_52_133_106,0.87,0,106,106,27
91,seq108,r_40_109_93,seq96,r_40_109_93,0.77,1,94,93,27
49,r_132_125_122,r_33_26_72,r_9_15_57,r_132_125_122,0.97,-56,66,122,27
72,seq62,seq96,r_132_125_122,r_132_125_122,1.0,43,165,122,27
44,r_81_106_141,r_110_6_83,r_9_15_57,r_81_106_141,1.0,0,141,141,27
44,r_81_106_141,r_52_133_106,r_110_6_83,r_81_106_141,0.65,-55,86,141,27
23,r_100_28_178,seq84,r_81_106_141,r_81_106_141,0.52,37,178,141,27
12,r_148_149_168,r_104_115_88,r_39_63_164,r_148_149_168,0.93,0,168,168,27
3,r_135_95_37,r_91_66_136,seq130,r_135_95_37,1.0,0,37,37,27
79,seq80,r_132_125_122,seq94,r_132_125_122,0.92,-15,107,122,27
35,r_131_75_175,seq53,seq19,r_131_75_175,0.46,0,175,175,27
34,r_144_3_18,seq7,r_60_46_131,r_144_3_18,0.99,0,18,18,27
12,r_148_149_168,r_103_45_41,r_104_115_88,r_104_115_88,1.0,30,118,88,27
49,r_132_125_122,r_9_15_57,seq2,r_132_125_122,1.0,0,122,122,27
84,seq94,r_24_11_69,seq80,r_24_11_69,1.0,0,69,69,27
30,r_22_24_89,r_59_47_99,seq19,r_59_47_99,0.87,-5,94,99,28
92,seq114,r_50_92_198,r_146_13_107,r_146_13_107,1.0,30,137,107,28
14,r_54_94_135,seq101,seq9,r_54_94_135,0.96,1,136,135,28
8,r_7_148_108,seq123,seq3,r_7_148_108,0.99,1,109,108,28
31,r_97_147_46,r_139_149_30,r_81_85_15,r_97_147_46,0.5,-31,15,46,28
16,r_48_49_94,seq2,seq30,r_48_49_94,1.0,2,96,94,28
39,r_111_44_185,seq9,r_48_49_94,r_111_44_185,0.63,0,185,185,28
1,r_21_100_104,r_111_44_185,seq23,r_21_100_104,0.53,0,104,104,28
5,r_36_138_103,r_90_27_163,seq4,r_36_138_103,1.0,1,104,103,28
46,r_8_34_144,r_122_64_192,r_17_10_25,r_122_64_192,0.86,-47,145,192,28
42,r_103_33_193,seq123,r_43_42_152,r_43_42_152,0.97,4,156,152,28
48,r_20_67_37,r_75_74_189,seq30,r_20_67_37,0.5,2,39,37,28
18,r_50_92_198,seq114,r_144_29_24,r_144_29_24,1.0,19,43,24,28
41,r_35_140_165,seq16,seq70,r_35_140_165,0.81,2,167,165,28
10,r_6_115_75,seq106,seq16,r_6_115_75,0.94,2,77,75,28
35,r_77_120_13,r_121_52_150,seq117,r_77_120_13,0.68,1,14,13,28
4,r_45_95_159,r_57_98_141,r_36_138_103,r_36_138_103,0.53,38,141,103,28
0,r_130_78_167,seq106,r_7_148_108,r_130_78_167,0.6,0,167,167,28
11,r_58_60_123,seq101,seq23,r_58_60_123,0.96,1,124,123,28
13,r_5_83_61,r_58_60_123,seq117,r_5_83_61,1.0,1,62,61,28
6,r_43_42_152,r_15_110_86,r_103_33_193,r_43_42_152,0.83,0,152,152,28
27,r_93_80_129,r_121_52_150,seq84,r_93_80_129,0.96,2,131,129,28
2,r_46_38_134,r_129_119_148,seq9,r_46_38_134,0.68,0,134,134,28
47,r_37_108_172,seq40,r_43_42_152,r_37_108_172,0.53,1,173,172,28
77,seq70,r_141_1_153,r_35_140_165,r_35_140_165,0.95,1,166,165,28
77,seq70,r_50_92_198,r_141_1_153,r_141_1_153,0.86,-48,105,153,28
40,r_12_109_175,seq11,r_5_83_61,r_5_83_61,1.0,114,175,61,28
29,r_146_13_107,r_130_78_167,seq114,r_146_13_107,1.0,0,107,107,28
24,r_124_51_131,r_122_64_192,r_50_92_198,r_124_51_131,0.98,0,131,131,28
37,r_139_149_30,r_12_109_175,seq4,r_12_109_175,0.56,-143,32,175,28
36,r_142_31_6,seq127,r_144_29_24,r_144_29_24,1.0,4,28,24,28
50,seq0,r_129_119_148,r_59_47_99,r_59_47_99,0.91,62,161,99,28
68,seq40,r_75_74_189,r_130_78_167,r_130_78_167,0.59,22,189,167,28
33,r_81_85_15,r_58_60_123,r_97_147_46,r_81_85_15,1.0,0,15,15,28
32,r_57_98_141,r_45_95_159,seq123,r_57_98_141,0.9,0,141,141,28
38,r_135_132_93,r_28_113_197,seq18,r_135_132_93,0.91,0,93,93,28
20,r_144_29_24,r_121_52_150,r_17_10_25,r_144_29_24,1.0,3,27,24,28
25,r_107_145_22,r_58_60_123,seq69,r_107_145_22,0.91,0,22,22,28
81,seq82,r_90_27_163,r_48_49_94,r_48_49_94,0.89,71,165,94,28
17,r_90_27_163,seq82,r_36_138_103,r_36_138_103,0.99,63,166,103,28
22,r_17_10_25,seq23,r_50_92_198,r_17_10_25,1.0,3,28,25,28
9,r_121_52_150,seq30,seq16,r_121_52_150,0.63,2,152,150,28
96,seq123,r_103_33_193,r_57_98_141,r_57_98_141,0.91,1,142,141,28
31,r_97_147_46,r_81_85_15,r_15_110_86,r_97_147_46,0.52,34,80,46,28
28,r_59_47_99,r_22_24_89,seq84,r_59_47_99,0.93,0,99,99,28
91,seq112,seq123,r_43_42_152,r_43_42_152,0.85,6,158,152,28
56,seq134,r_35_140_165,r_122_64_192,r_35_140_165,0.98,-26,139,165,28
23,r_79_66_142,r_121_52_150,r_17_10_25,r_79_66_142,0.98,0,142,142,28
43,r_104_56_55,r_90_27_163,seq137,r_104_56_55,1.0,0,55,55,28
12,r_39_73_119,r_129_119_148,r_142_31_6,r_39_73_119,0.99,0,119,119,28
4,r_45_95_159,r_36_138_103,seq137,r_45_95_159,0.82,2,161,159,28
30,r_76_119_73,r_19_132_103,seq78,r_76_119_73,1.0,1,74,73,29
36,r_22_46_94,seq114,r_142_129_93,r_22_46_94,0.94,4,98,94,29
32,r_43_26_43,r_76_119_73,seq32,r_43_26_43,0.98,3,46,43,29
14,r_23_99_80,seq6,r_125_52_45,r_125_52_45,0.66,35,80,45,29
43,r_40_83_177,r_127_56_140,r_141_107_62,r_141_107_62,0.85,71,133,62,29
37,r_30_113_78,seq7,seq24,r_30_113_78,0.98,1,79,78,29
3,r_128_63_26,seq114,r_30_113_78,r_30_113_78,0.98,57,135,78,29
59,seq146,r_70_102_156,r_139_61_59,r_139_61_59,0.97,51,110,59,29
16,r_148_131_185,seq124,seq95,r_148_131_185,0.25,0,185,185,29
21,r_140_144_120,seq100,seq88,r_140_144_120,0.57,-3,117,120,29
39,r_138_98_169,seq121,r_76_119_73,r_138_98_169,0.54,0,169,169,29
1,r_73_137_134,seq88,r_22_46_94,r_73_137_134,0.93,1,135,134,29
97,seq123,r_67_134_176,seq7,r_67_134_176,0.46,1,177,176,29
24,r_122_104_28,r_33_105_100,r_85_136_129,r_122_104_28,0.94,0,28,28,29
5,r_141_107_62,seq88,r_40_83_177,r_141_107_62,1.0,0,62,62,29
42,r_142_129_93,r_101_75_106,r_22_46_94,r_22_46_94,0.6,-1,93,94,29
69,seq48,r_18_49_163,r_106_92_99,r_106_92_99,1.0,65,164,99,29
45,r_67_134_176,seq123,r_106_92_99,r_106_92_99,0.8,78,177,99,29
24,r_122_104_28,r_85_136_129,r_37_2_125,r_122_104_28,0.91,101,129,28,29
11,r_59_71_181,r_0_133_119,r_140_144_120,r_59_71_181,0.83,0,181,181,29
31,r_33_105_100,seq94,r_80_93_97,r_33_105_100,0.99,0,100,100,29
41,r_135_66_137,seq16,r_81_13_20,r_135_66_137,0.97,0,137,137,29
10,r_31_51_96,r_0_133_119,seq36,r_0_133_119,0.6,-21,98,119,29
26,r_89_54_74,seq147,seq50,r_89_54_74,1.0,0,74,74,29
43,r_40_83_177,r_141_107_62,r_140_144_120,r_40_83_177,0.98,0,177,177,29
4,r_130_116_77,seq6,seq79,r_130_116_77,1.0,3,80,77,29
78,seq78,seq110,r_76_119_73,r_76_119_73,1.0,32,105,73,29
0,r_20_44_92,seq65,seq87,r_20_44_92,1.0,0,92,92,29
11,r_59_71_181,r_112_38_147,r_0_133_119,r_0_133_119,0.68,28,147,119,29
48,r_120_60_65,seq146,seq74,r_120_60_65,1.0,2,67,65,29
13,r_101_75_106,r_55_53_34,seq3,r_101_75_106,1.0,0,106,106,29
6,r_106_92_99,seq91,r_31_51_96,r_106_92_99,1.0,0,99,99,29
99,seq126,r_25_86_191,r_122_104_28,r_122_104_28,1.0,60,88,28,29
5,r_141_107_62,r_40_83_177,r_21_45_9,r_40_83_177,0.64,0,177,177,29
61,seq149,seq6,r_10_12_55,r_10_12_55,1.0,3,58,55,29
13,r_101_75_106,r_142_129_93,r_55_53_34,r_55_53_34,1.0,2,36,34,29
47,r_19_132_103,seq24,seq146,r_19_132_103,0.99,1,104,103,29
3,r_128_63_26,r_67_134_176,seq114,r_128_63_26,0.92,1,27,26,29
18,r_112_38_147,r_59_71_181,r_125_52_45,r_59_71_181,0.52,-34,147,181,29
29,r_41_9_128,seq39,seq48,r_41_9_128,0.94,0,128,128,29
20,r_10_12_55,seq78,seq149,r_10_12_55,1.0,2,57,55,29
34,r_85_136_129,r_122_104_28,r_0_133_119,r_85_136_129,0.61,0,129,129,29
25,r_0_133_119,seq97,r_59_71_181,r_0_133_119,0.95,1,120,119,29
70,seq50,seq95,r_89_54_74,r_89_54_74,1.0,0,74,74,29
7,r_81_13_20,r_30_113_78,seq32,r_81_13_20,0.82,-3,17,20,29
28,r_55_53_34,r_20_44_92,r_101_75_106,r_55_53_34,0.98,0,34,34,29
38,r_37_2_125,seq28,seq32,r_37_2_125,0.74,0,125,125,29
84,seq94,seq1,r_127_56_140,r_127_56_140,0.95,4,144,140,29
81,seq87,r_47_5_192,r_20_44_92,r_20_44_92,1.0,5,97,92,29
17,r_90_58_105,seq78,seq28,r_90_58_105,1.0,0,105,105,29
34,r_85_136_129,seq32,r_122_104_28,r_122_104_28,1.0,3,31,28,29
25,r_0_133_119,r_59_71_181,r_85_136_129,r_59_71_181,0.96,0,181,181,29
9,r_70_102_156,seq146,r_31_51_96,r_70_102_156,0.73,0,156,156,29
96,seq121,r_138_98_169,r_89_54_74,r_89_54_74,1.0,95,169,74,29
28,r_55_53_34,r_101_75_106,seq28,r_101_75_106,1.0,0,106,106,29
44,r_127_56_140,r_40_83_177,seq94,r_127_56_140,0.95,0,140,140,29
82,seq88,r_73_137_134,r_140_144_120,r_73_137_134,0.81,1,135,134,29
35,r_18_49_163,seq48,r_23_99_80,r_18_49_163,0.74,1,164,163,29
84,seq94,r_33_105_100,seq1,r_33_105_100,0.95,0,100,100,29
93,seq106,r_142_70_149,seq2,r_142_70_149,1.0,1,150,149,30
30,r_90_94_124,seq49,seq22,r_90_94_124,0.63,1,125,124,30
36,r_137_15_185,seq126,r_120_101_144,r_120_101_144,0.54,41,185,144,30
8,r_64_135_181,r_140_145_66,seq22,r_140_145_66,0.99,0,66,66,30
53,seq5,r_127_41_128,r_12_45_180,r_127_41_128,1.0,0,128,128,30
22,r_86_102_17,r_110_31_80,r_85_147_116,r_86_102_17,1.0,0,17,17,30
55,seq7,r_120_101_144,r_118_92_48,r_118_92_48,0.7,39,87,48,30
21,r_142_70_149,seq106,seq4,r_142_70_149,0.89,1,150,149,30
1,r_24_129_113,seq35,r_79_83_45,r_24_129_113,0.93,0,113,113,30
4,r_118_92_48,r_24_129_113,seq7,r_118_92_48,0.99,0,48,48,30
5,r_140_145_66,r_64_135_181,r_46_3_4,r_140_145_66,0.88,0,66,66,30
37,r_71_42_30,r_76_13_162,seq134,r_71_42_30,0.99,0,30,30,30
45,r_39_113_156,seq109,r_140_145_66,r_140_145_66,0.86,95,161,66,30
95,seq109,r_76_13_162,seq2,r_76_13_162,1.0,0,162,162,30
41,r_85_147_116,r_8_34_120,seq37,r_85_147_116,1.0,1,117,116,30
10,r_62_78_71,r_16_100_135,seq66,r_62_78_71,1.0,0,71,71,30
26,r_76_13_162,seq109,r_131_107_141,r_76_13_162,0.88,0,162,162,30
8,r_64_135_181,seq22,seq23,r_64_135_181,0.65,2,183,181,30
11,r_124_96_122,r_12_45_180,seq126,r_124_96_122,1.0,0,122,122,30
20,r_111_27_102,seq53,r_12_45_180,r_111_27_102,0.99,0,102,102,30
13,r_8_34_120,r_85_147_116,r_118_92_48,r_8_34_120,1.0,0,120,120,30
15,r_120_101_144,r_116_59_188,r_12_45_180,r_12_45_180,0.53,-35,145,180,30
48,r_16_100_135,r_62_78_71,r_69_95_51,r_16_100_135,0.66,-60,75,135,30
57,seq138,r_116_59_188,r_88_17_150,r_88_17_150,0.75,0,150,150,30
16,r_89_132_44,r_24_129_113,r_123_82_70,r_89_132_44,0.79,2,46,44,30
9,r_123_82_70,r_79_83_45,r_89_132_44,r_89_132_44,0.86,1,45,44,30
54,seq134,seq23,r_71_42_30,r_71_42_30,1.0,6,36,30,30
56,seq9,r_144_36_53,r_79_83_45,r_144_36_53,0.92,0,53,53,30
22,r_86_102_17,r_85_147_116,seq133,r_85_147_116,1.0,6,122,116,30
2,r_11_125_182,seq63,r_24_129_113,r_24_129_113,0.99,69,182,113,30
47,r_88_17_150,seq91,seq138,r_88_17_150,0.9,0,150,150,30
40,r_0_128_166,seq93,r_114_141_199,r_0_128_166,0.52,0,166,166,30
18,r_131_107_141,seq77,seq20,r_131_107_141,0.99,0,141,141,30
14,r_69_95_51,r_62_78_71,seq2,r_62_78_71,0.85,0,71,71,30
48,r_16_100_135,r_69_95_51,r_25_148_97,r_16_100_135,0.51,10,145,135,30
69,seq33,r_116_59_188,r_98_61_37,r_98_61_37,0.99,5,42,37,30
50,seq1,r_116_59_188,r_98_61_37,r_98_61_37,0.99,112,149,37,30
6,r_68_6_14,seq1,r_25_148_97,r_25_148_97,1.0,0,97,97,30
38,r_116_59_188,r_120_101_144,r_98_61_37,r_98_61_37,0.76,108,145,37,30
34,r_25_148_97,r_12_45_180,r_68_6_14,r_25_148_97,1.0,1,98,97,30
14,r_69_95_51,seq29,r_62_78_71,r_69_95_51,0.56,0,51,51,30
17,r_127_41_128,seq5,r_98_61_37,r_127_41_128,0.91,0,128,128,30
38,r_116_59_188,r_98_61_37,r_64_135_181,r_116_59_188,0.95,0,188,188,30
7,r_144_36_53,seq9,r_12_45_180,r_144_36_53,1.0,0,53,53,30
28,r_47_14_73,r_28_75_191,seq18,r_47_14_73,0.79,4,77,73,30
0,r_130_149_46,seq139,seq66,r_130_149_46,1.0,0,46,46,30
33,r_10_115_49,r_144_36_53,seq37,r_10_115_49,1.0,0,49,49,30
44,r_21_136_167,seq108,r_131_107_141,r_21_136_167,0.59,0,167,167,30
3,r_98_61_37,r_81_55_190,seq33,r_98_61_37,0.99,0,37,37,30
79,seq66,seq57,r_62_78_71,r_62_78_71,1.0,2,73,71,30
35,r_105_19_170,seq67,seq93,r_105_19_170,0.4,0,170,170,30
12,r_110_31_80,seq18,r_10_115_49,r_110_31_80,1.0,2,82,80,30
6,r_68_6_14,r_71_42_30,seq1,r_68_6_14,0.83,5,19,14,30
24,r_79_83_45,seq57,seq87,r_79_83_45,0.92,0,45,45,30
84,seq77,r_131_107_141,seq37,r_131_107_141,1.0,-53,88,141,30
36,r_121_40_145,seq113,r_35_142_9,r_35_142_9,0.81,137,146,9,31
72,seq62,r_65_39_84,r_7_136_176,r_65_39_84,1.0,-32,52,84,31
92,seq106,seq60,r_65_39_84,r_65_39_84,1.0,0,84,84,31
17,r_47_13_24,seq97,r_123_3_170,r_47_13_24,0.73,-2,22,24,31
37,r_124_98_78,r_121_40_145,r_47_13_24,r_47_13_24,0.55,58,82,24,31
6,r_102_31_113,r_36_118_65,r_52_57_93,r_102_31_113,1.0,0,113,113,31
21,r_64_147_149,r_100_112_198,seq4,r_100_112_198,0.45,-43,155,198,31
5,r_133_61_82,r_105_32_179,seq97,r_133_61_82,0.99,0,82,82,31
42,r_36_118_65,r_52_57_93,r_102_31_113,r_36_118_65,1.0,0,65,65,31
12,r_116_104_30,r_115_12_109,seq44,r_116_104_30,0.84,0,30,30,31
80,seq75,r_140_28_181,r_47_13_24,r_47_13_24,0.74,160,184,24,31
14,r_88_71_42,r_55_22_139,seq69,r_88_71_42,0.76,4,46,42,31
2,r_79_50_10,r_34_18_45,r_130_76_6,r_79_50_10,0.72,0,10,10,31
95,seq113,r_121_40_145,r_133_61_82,r_133_61_82,1.0,64,146,82,31
31,r_80_132_51,seq4,seq82,r_80_132_51,0.98,-1,50,51,31
41,r_144_83_11,r_130_76_6,r_123_3_170,r_123_3_170,0.8,-55,115,170,31
30,r_21_5_21,r_130_76_6,seq78,r_21_5_21,0.76,-1,20,21,31
10,r_126_148_106,seq109,seq10,r_126_148_106,0.7,0,106,106,31
26,r_110_49_190,r_138_141_153,r_126_148_106,r_110_49_190,0.81,-37,153,190,31
8,r_101_84_16,r_133_61_82,seq26,r_101_84_16,0.67,-1,15,16,31
11,r_115_12_109,seq125,seq109,r_115_12_109,0.97,0,109,109,31
13,r_138_141_153,r_110_49_190,r_121_40_145,r_138_141_153,0.76,0,153,153,31
49,r_52_57_93,r_34_18_45,r_79_50_10,r_52_57_93,0.99,0,93,93,31
98,seq125,r_115_12_109,seq15,r_115_12_109,1.0,0,109,109,31
15,r_59_120_95,seq11,seq68,r_59_120_95,1.0,0,95,95,31
6,r_102_31_113,r_90_99_193,r_36_118_65,r_36_118_65,1.0,-1,64,65,31
38,r_58_134_40,r_80_132_51,r_63_0_27,r_63_0_27,0.93,1,28,27,31
26,r_110_49_190,r_126_148_106,r_130_76_6,r_110_49_190,0.92,0,190,190,31
4,r_34_18_45,r_52_57_93,r_85_29_142,r_52_57_93,1.0,1,94,93,31
87,seq91,r_105_32_179,r_53_24_118,r_53_24_118,0.56,61,179,118,31
91,seq97,r_121_40_145,r_133_61_82,r_133_61_82,0.98,12,94,82,31
1,r_130_76_6,r_21_5_21,r_79_50_10,r_79_50_10,0.78,0,10,10,31
47,r_105_32_179,seq91,r_47_13_24,r_47_13_24,0.55,155,179,24,31
40,r_65_39_84,seq62,seq106,r_65_39_84,1.0,0,84,84,31
74,seq68,seq37,r_59_120_95,r_59_120_95,1.0,14,109,95,31
29,r_108_51_159,seq81,r_21_5_21,r_108_51_159,0.89,1,160,159,31
24,r_2_119_141,seq8,seq37,r_2_119_141,0.91,0,141,141,31
33,r_86_30_75,r_2_119_141,seq6,r_86_30_75,1.0,-1,74,75,31
34,r_23_117_135,seq54,r_7_136_176,r_23_117_135,0.91,0,135,135,31
82,seq78,r_131_20_178,r_21_5_21,r_21_5_21,0.6,1,22,21,31
46,r_128_67_38,r_126_148_106,seq19,r_126_148_106,0.53,-68,38,106,31
42,r_36_118_65,r_102_31_113,seq125,r_102_31_113,1.0,0,113,113,31
22,r_53_24_118,seq72,seq91,r_53_24_118,0.58,-13,105,118,31
28,r_43_107_61,r_137_92_1,seq6,r_43_107_61,1.0,0,61,61,31
9,r_63_0_27,r_33_149_192,r_58_134_40,r_63_0_27,1.0,-1,26,27,31
4,r_34_18_45,seq37,r_52_57_93,r_34_18_45,1.0,0,45,45,31
7,r_25_94_166,seq74,seq70,r_25_94_166,0.74,1,167,166,31
44,r_55_22_139,seq73,seq146,r_55_22_139,0.96,0,139,139,31
62,seq26,r_80_132_51,r_101_84_16,r_101_84_16,0.89,-1,15,16,31
49,r_52_57_93,r_36_118_65,r_34_18_45,r_52_57_93,0.54,-47,46,93,31
35,r_131_20_178,seq78,r_53_24_118,r_53_24_118,0.45,60,178,118,31
92,seq102,r_33_9_114,r_79_149_72,r_79_149_72,0.86,42,114,72,32
25,r_77_93_28,r_70_43_192,seq29,r_77_93_28,0.68,15,43,28,32
8,r_99_95_58,r_101_94_65,seq35,r_99_95_58,0.9,2,60,58,32
43,r_145_130_123,r_144_8_176,r_13_50_86,r_144_8_176,1.0,-52,124,176,32
24,r_123_111_132,r_67_114_171,seq26,r_123_111_132,1.0,0,132,132,32
3,r_132_24_34,r_131_39_111,seq36,r_132_24_34,1.0,1,35,34,32
86,seq147,seq98,r_129_81_74,r_129_81_74,1.0,36,110,74,32
16,r_88_1_183,r_28_97_5,r_41_75_157,r_88_1_183,0.5,1,184,183,32
21,r_121_10_105,r_123_111_132,seq73,r_121_10_105,1.0,0,105,105,32
39,r_2_45_154,seq86,r_148_117_22,r_2_45_154,0.72,0,154,154,32
1,r_58_142_63,r_47_54_135,seq138,r_58_142_63,1.0,2,65,63,32
46,r_129_81_74,seq138,seq147,r_129_81_74,1.0,0,74,74,32
42,r_110_56_92,r_25_40_102,r_148_117_22,r_148_117_22,1.0,71,93,22,32
34,r_128_85_15,r_79_149_72,seq71,r_128_85_15,1.0,0,15,15,32
45,r_119_118_169,r_144_8_176,seq18,r_119_118_169,0.76,0,169,169,32
19,r_25_40_102,seq36,r_148_117_22,r_25_40_102,0.99,1,103,102,32
76,seq60,seq68,r_16_17_38,r_16_17_38,1.0,48,86,38,32
31,r_13_50_86,r_82_112_91,seq133,r_13_50_86,1.0,0,86,86,32
10,r_41_75_157,seq90,r_131_39_111,r_41_75_157,0.75,0,157,157,32
26,r_79_149_72,seq60,seq102,r_79_149_72,1.0,0,72,72,32
4,r_67_114_171,seq84,seq62,r_67_114_171,0.59,0,171,171,32
73,seq48,r_105_113_185,r_13_50_86,r_13_50_86,1.0,99,185,86,32
11,r_66_89_99,r_91_63_187,seq36,r_66_89_99,1.0,0,99,99,32
20,r_144_8_176,seq7,r_58_142_63,r_58_142_63,0.74,113,176,63,32
13,r_57_55_134,seq26,seq84,r_57_55_134,0.99,0,134,134,32
15,r_106_53_57,seq90,seq62,r_106_53_57,0.63,4,61,57,32
57,seq12,r_139_51_153,r_131_39_111,r_139_51_153,0.67,1,154,153,32
0,r_80_108_45,r_107_61_120,seq76,r_80_108_45,1.0,0,45,45,32
85,seq84,r_67_114_171,r_57_55_134,r_57_55_134,0.94,37,171,134,32
27,r_20_37_73,r_64_78_138,seq140,r_20_37_73,0.72,5,78,73,32
81,seq71,r_83_46_1,r_128_85_15,r_128_85_15,1.0,6,21,15,32
87,seq86,r_2_45_154,r_132_24_34,r_132_24_34,0.69,120,154,34,32
2,r_107_61_120,r_21_87_150,seq137,r_107_61_120,0.99,3,123,120,32
47,r_136_104_173,r_91_63_187,r_83_46_1,r_136_104_173,0.84,1,174,173,32
40,r_22_72_66,r_66_89_99,seq102,r_22_72_66,1.0,0,66,66,32
18,r_127_52_172,seq126,r_77_93_28,r_77_93_28,0.65,146,174,28,32
24,r_123_111_132,r_121_10_105,r_67_114_171,r_121_10_105,0.9,0,105,105,32
33,r_105_113_185,seq48,r_82_112_91,r_82_112_91,0.81,94,185,91,32
17,r_34_32_20,seq147,seq96,r_34_32_20,0.95,-2,18,20,32
32,r_82_112_91,r_92_6_146,seq141,r_82_112_91,1.0,0,91,91,32
41,r_16_17_38,r_13_50_86,seq60,r_16_17_38,1.0,1,39,38,32
22,r_103_30_18,r_41_75_157,r_34_32_20,r_103_30_18,1.0,0,18,18,32
28,r_4_135_127,seq62,r_131_39_111,r_4_135_127,0.99,0,127,127,32
7,r_33_9_114,seq102,seq90,r_33_9_114,0.98,0,114,114,32
23,r_139_51_153,seq12,r_20_37_73,r_20_37_73,0.42,81,154,73,32
82,seq73,r_70_43_192,r_121_10_105,r_121_10_105,1.0,43,148,105,32
12,r_21_87_150,r_88_1_183,r_82_112_91,r_21_87_150,0.55,0,150,150,32
9,r_28_17_133,r_144_35_8,r_88_2_48,r_28_17_133,0.9,0,133,133,33
14,r_118_63_79,r_38_8_156,seq6,r_38_8_156,0.81,-66,90,156,33
97,seq148,r_104_76_33,r_38_8_156,r_38_8_156,0.99,-4,152,156,33
37,r_78_11_83,r_139_98_103,r_101_67_164,r_139_98_103,1.0,-18,85,103,33
26,r_81_77_47,seq149,seq6,r_81_77_47,1.0,0,47,47,33
55,seq6,r_28_17_133,r_118_63_79,r_28_17_133,0.99,-66,67,133,33
39,r_100_138_177,seq119,r_118_63_79,r_100_138_177,0.37,0,177,177,33
1,r_89_102_110,seq27,seq82,r_89_102_110,0.99,4,114,110,33
97,seq148,r_97_116_122,r_104_76_33,r_104_76_33,0.83,84,117,33,33
5,r_29_37_125,seq39,r_142_16_91,r_29_37_125,0.93,0,125,125,33
60,seq147,r_112_3_40,r_86_126_9,r_112_3_40,0.8,2,42,40,33
19,r_66_113_12,r_112_3_40,seq23,r_66_113_12,0.98,0,12,12,33
15,r_128_54_166,r_101_67_164,seq18,r_128_54_166,0.99,1,167,166,33
0,r_104_76_33,r_71_40_126,seq99,r_104_76_33,0.78,0,33,33,33
31,r_24_123_19,r_65_57_87,seq95,r_65_57_87,1.0,0,87,87,33
24,r_25_141_95,r_108_60_63,seq125,r_25_141_95,0.94,0,95,95,33
41,r_135_145_73,seq130,seq23,r_135_145_73,0.99,0,73,73,33
67,seq30,r_38_8_156,r_118_63_79,r_38_8_156,1.0,0,156,156,33
38,r_122_84_45,r_73_124_168,seq119,r_122_84_45,0.99,0,45,45,33
89,seq92,seq20,r_93_96_93,r_93_96_93,1.0,8,101,93,33
3,r_65_57_87,r_24_123_19,r_144_35_8,r_65_57_87,0.95,0,87,87,33
10,r_93_96_93,seq90,seq92,r_93_96_93,1.0,0,93,93,33
90,seq95,r_132_72_72,r_24_123_19,r_132_72_72,1.0,0,72,72,33
16,r_88_2_48,seq111,r_28_17_133,r_28_17_133,1.0,1,134,133,33
78,seq51,r_91_45_188,r_41_105_165,r_41_105_165,0.79,9,174,165,33
11,r_137_136_146,seq39,seq7,r_137_136_146,0.46,0,146,146,33
20,r_108_60_63,r_128_54_166,r_107_85_88,r_128_54_166,0.47,-15,151,166,33
98,seq125,r_1_69_197,r_25_141_95,r_25_141_95,1.0,71,166,95,33
46,r_144_35_8,r_28_17_133,r_65_57_87,r_144_35_8,0.72,125,133,8,33
15,r_128_54_166,r_140_59_89,r_101_67_164,r_140_59_89,1.0,0,89,89,33
2,r_107_85_88,r_73_124_168,r_48_13_118,r_48_13_118,1.0,7,125,118,33
48,r_87_94_151,seq68,r_131_53_10,r_87_94_151,0.86,0,151,151,33
32,r_142_16_91,r_143_79_186,r_29_37_125,r_29_37_125,0.65,5,130,125,33
12,r_73_124_168,r_107_85_88,r_24_123_19,r_24_123_19,0.73,148,167,19,33
45,r_55_117_11,seq7,r_101_67_164,r_55_117_11,0.94,0,11,11,33
27,r_120_9_136,seq82,seq147,r_120_9_136,0.84,0,136,136,33
6,r_19_12_50,r_108_60_63,r_97_116_122,r_19_12_50,1.0,0,50,50,33
2,r_107_85_88,r_142_16_91,r_73_124_168,r_107_85_88,0.95,0,88,88,33
28,r_97_116_122,r_19_12_50,r_65_57_87,r_97_116_122,1.0,1,123,122,33
18,r_42_134_86,r_97_116_122,seq130,r_42_134_86,0.99,0,86,86,33
24,r_25_141_95,r_31_83_76,r_108_60_63,r_31_83_76,0.99,-4,72,76,33
25,r_71_40_126,seq110,seq43,r_71_40_126,0.93,0,126,126,33
33,r_64_22_157,seq32,r_120_9_136,r_64_22_157,0.83,1,158,157,33
16,r_88_2_48,r_108_60_63,seq111,r_88_2_48,1.0,0,48,48,33
64,seq26,r_128_54_166,r_101_67_164,r_128_54_166,0.99,1,167,166,33
30,r_112_3_40,seq147,r_104_76_33,r_112_3_40,1.0,2,42,40,33
50,seq0,seq110,r_31_83_76,r_31_83_76,1.0,19,95,76,33
6,r_19_12_50,r_97_116_122,seq148,r_97_116_122,1.0,1,123,122,33
32,r_142_16_91,seq133,r_143_79_186,r_142_16_91,0.92,3,94,91,33
52,seq130,r_135_145_73,r_120_9_136,r_135_145_73,1.0,0,73,73,33
46,r_144_35_8,r_19_12_50,r_28_17_133,r_144_35_8,0.85,2,10,8,33
17,r_31_83_76,r_25_141_95,seq0,r_31_83_76,0.99,0,76,76,33
96,seq119,r_100_138_177,r_122_84_45,r_122_84_45,0.97,33,78,45,33
22,r_132_72_72,seq95,seq125,r_132_72_72,1.0,0,72,72,33
28,r_97_116_122,r_42_134_86,r_19_12_50,r_97_116_122,0.94,-47,75,122,33
91,seq99,r_41_105_165,r_112_3_40,r_112_3_40,0.74,101,141,40,33
8,r_46_115_56,seq34,seq21,r_46_115_56,0.97,0,56,56,33
49,r_48_13_118,seq106,r_107_85_88,r_48_13_118,0.82,0,118,118,33
7,r_143_79_186,seq27,r_137_136_146,r_137_136_146,0.61,40,186,146,33
44,r_139_98_103,r_87_94_151,seq27,r_139_98_103,1.0,0,103,103,33
23,r_140_59_89,r_128_54_166,seq34,r_140_59_89,0.98,0,89,89,33
35,r_74_103_102,seq20,r_121_14_52,r_74_103_102,1.0,0,102,102,33
12,r_73_124_168,r_139_98_103,r_107_85_88,r_73_124_168,1.0,-80,88,168,33
93,seq107,r_147_85_143,r_131_72_112,r_131_72_112,0.84,19,131,112,34
51,seq128,seq107,r_4_16_74,r_4_16_74,0.92,-10,64,74,34
8,r_87_18_124,r_52_112_131,seq37,r_87_18_124,1.0,0,124,124,34
43,r_143_132_82,seq65,seq7,r_143_132_82,0.99,0,82,82,34
37,r_115_130_187,r_100_76_175,r_79_84_92,r_79_84_92,1.0,95,187,92,34
55,seq7,r_46_51_168,seq24,r_46_51_168,0.89,-16,152,168,34
16,r_105_144_127,seq48,r_99_20_63,r_105_144_127,0.52,7,134,127,34
21,r_19_3_145,seq107,seq0,r_19_3_145,0.93,0,145,145,34
46,r_41_146_77,seq107,seq116,r_41_146_77,1.0,2,79,77,34
45,r_17_13_94,r_40_56_95,seq36,r_17_13_94,0.92,0,94,94,34
10,r_133_57_14,r_40_56_95,seq24,r_133_57_14,1.0,1,15,14,34
19,r_147_85_143,seq93,seq31,r_147_85_143,0.89,0,143,143,34
31,r_117_78_83,r_1_10_149,seq69,r_117_78_83,1.0,0,83,83,34
40,r_95_104_199,seq69,r_86_145_12,r_86_145_12,0.99,20,32,12,34
3,r_109_42_158,r_139_63_109,r_60_39_122,r_139_63_109,1.0,0,109,109,34
26,r_139_63_109,r_109_42_158,seq31,r_139_63_109,0.98,0,109,109,34
78,seq65,r_143_132_82,seq0,r_143_132_82,1.0,0,82,82,34
11,r_60_39_122,r_137_111_195,r_38_98_51,r_38_98_51,1.0,86,137,51,34
13,r_26_91_121,r_96_47_147,r_131_72_112,r_26_91_121,0.92,2,123,121,34
15,r_89_15_72,r_147_85_143,seq116,r_89_15_72,0.97,0,72,72,34
48,r_138_88_129,seq93,seq97,r_138_88_129,0.99,0,129,129,34
6,r_131_72_112,seq37,seq107,r_131_72_112,1.0,0,112,112,34
45,r_17_13_94,seq36,r_8_11_137,r_8_11_137,1.0,2,139,137,34
22,r_68_53_13,r_21_110_166,r_121_136_165,r_68_53_13,0.98,-2,11,13,34
42,r_114_83_32,r_121_136_165,seq129,r_114_83_32,1.0,0,32,32,34
27,r_100_76_175,r_115_130_187,r_68_53_13,r_100_76_175,0.56,7,182,175,34
17,r_45_126_19,r_109_42_158,seq28,r_45_126_19,0.98,0,19,19,34
22,r_68_53_13,r_121_136_165,r_127_25_161,r_121_136_165,0.99,-45,120,165,34
20,r_86_145_12,r_109_42_158,r_95_104_199,r_86_145_12,0.94,1,13,12,34
2,r_148_80_80,r_105_144_127,seq27,r_148_80_80,1.0,2,82,80,34
47,r_120_12_117,r_1_10_149,seq94,r_120_12_117,0.91,0,117,117,34
9,r_96_47_147,r_1_10_149,seq66,r_96_47_147,0.88,12,159,147,34
30,r_38_98_51,r_127_25_161,r_67_75_2,r_38_98_51,1.0,0,51,51,34
18,r_40_56_95,r_17_13_94,r_29_92_58,r_17_13_94,1.0,1,95,94,34
29,r_79_84_92,r_121_136_165,seq32,r_79_84_92,0.91,3,95,92,34
1,r_58_101_20,seq28,seq122,r_58_101_20,0.98,2,22,20,34
3,r_109_42_158,r_60_39_122,r_138_88_129,r_109_42_158,0.95,0,158,158,34
25,r_4_16_74,r_40_56_95,seq93,r_4_16_74,0.55,3,77,74,34
33,r_1_10_149,r_96_47_147,r_148_80_80,r_1_10_149,0.93,10,159,149,34
88,seq93,r_147_85_143,r_131_72_112,r_131_72_112,0.89,31,143,112,34
14,r_29_92_58,seq116,r_45_126_19,r_29_92_58,0.99,0,58,58,34
9,r_96_47_147,r_26_91_121,r_1_10_149,r_26_91_121,1.0,2,123,121,34
49,r_34_33_171,seq77,r_46_51_168,r_34_33_171,0.38,0,171,171,34
7,r_121_136_165,r_105_144_127,r_131_72_112,r_131_72_112,0.87,53,165,112,34
44,r_99_20_63,seq108,r_127_25_161,r_127_25_161,0.59,-97,64,161,34
17,r_45_126_19,seq28,r_29_92_58,r_29_92_58,1.0,47,105,58,34
35,r_59_71_163,seq22,seq129,r_59_71_163,0.5,0,163,163,34
12,r_52_112_131,seq5,r_41_146_77,r_52_112_131,1.0,0,131,131,34
32,r_118_149_42,r_29_92_58,seq61,r_118_149_42,1.0,0,42,42,34
30,r_102_104_104,seq144,seq125,r_102_104_104,1.0,0,104,104,35
19,r_64_128_36,seq67,seq56,r_64_128_36,1.0,0,36,36,35
14,r_63_108_171,seq6,r_49_119_43,r_63_108_171,0.73,1,172,171,35
43,r_127_72_151,seq56,r_58_90_49,r_58_90_49,1.0,115,164,49,35
3,r_73_88_174,r_8_16_10,seq13,r_73_88_174,0.99,0,174,174,35
15,r_75_69_38,r_102_104_104,seq135,r_102_104_104,0.53,-60,44,104,35
1,r_138_7_184,r_133_114_5,r_18_24_53,r_138_7_184,0.63,0,184,184,35
1,r_138_7_184,seq70,r_133_114_5,r_138_7_184,0.46,-96,88,184,35
37,r_131_32_23,seq38,r_86_76_126,r_131_32_23,1.0,0,23,23,35
27,r_34_105_11,r_103_111_50,seq143,r_34_105_11,0.87,-1,10,11,35
5,r_147_79_76,seq143,seq10,r_147_79_76,1.0,0,76,76,35
42,r_80_5_130,r_31_113_63,seq135,r_31_113_63,0.45,69,132,63,35
69,seq41,r_120_95_137,r_54_68_89,r_54_68_89,1.0,49,138,89,35
8,r_18_24_53,r_65_48_56,r_49_119_43,r_18_24_53,0.81,1,54,53,35
45,r_59_4_59,r_132_142_169,seq70,r_59_4_59,0.55,1,60,59,35
10,r_49_119_43,r_102_104_104,seq60,r_49_119_43,1.0,3,46,43,35
99,seq126,seq33,r_65_48_56,r_65_48_56,1.0,3,59,56,35
3,r_73_88_174,r_117_100_124,r_8_16_10,r_117_100_124,0.89,-15,109,124,35
32,r_58_90_49,seq44,seq112,r_58_90_49,1.0,0,49,49,35
0,r_117_100_124,seq60,seq33,r_117_100_124,0.99,0,124,124,35
73,seq47,seq116,r_30_37_92,r_30_37_92,1.0,6,98,92,35
11,r_31_113_63,r_80_5_130,r_61_99_134,r_31_113_63,0.51,69,132,63,35
13,r_30_37_92,r_98_87_131,seq47,r_30_37_92,0.99,2,94,92,35
48,r_77_25_102,seq39,r_140_121_3,r_77_25_102,0.55,0,102,102,35
20,r_103_111_50,r_77_25_102,seq20,r_103_111_50,1.0,2,52,50,35
46,r_61_99_134,r_148_11_80,r_31_113_63,r_148_11_80,0.75,76,156,80,35
23,r_74_136_194,seq70,r_133_114_5,r_133_114_5,0.83,8,13,5,35
2,r_110_40_98,seq70,r_64_128_36,r_110_40_98,1.0,3,101,98,35
41,r_86_76_126,r_131_32_23,seq135,r_86_76_126,1.0,0,126,126,35
47,r_148_11_80,r_31_113_63,r_61_99_134,r_148_11_80,0.39,2,82,80,35
74,seq51,r_77_25_102,r_64_128_36,r_64_128_36,0.51,24,60,36,35
18,r_45_137_74,seq38,r_21_1_47,r_21_1_47,0.48,33,80,47,35
29,r_149_35_158,seq38,seq125,r_149_35_158,0.73,2,160,158,35
24,r_132_142_169,r_123_146_176,seq13,r_132_142_169,0.74,-1,168,169,35
64,seq33,seq126,r_117_100_124,r_117_100_124,0.99,3,127,124,35
44,r_55_22_12,r_132_142_169,r_140_121_3,r_55_22_12,0.96,-2,10,12,35
68,seq39,r_77_25_102,seq0,r_77_25_102,0.78,0,102,102,35
46,r_61_99_134,seq38,r_148_11_80,r_61_99_134,0.45,-44,90,134,35
34,r_123_146_176,seq129,seq62,r_123_146_176,0.43,1,177,176,35
31,r_21_1_47,seq126,seq134,r_21_1_47,0.95,0,47,47,35
26,r_8_16_10,seq0,seq60,r_8_16_10,1.0,0,10,10,35
17,r_65_48_56,r_18_24_53,seq126,r_65_48_56,1.0,-2,54,56,35
4,r_9_91_17,r_86_76_126,seq42,r_9_91_17,1.0,0,17,17,35
41,r_86_76_126,seq53,r_131_32_23,r_131_32_23,1.0,1,24,23,35
37,r_131_32_23,r_86_76_126,seq53,r_86_76_126,0.95,0,126,126,35
22,r_54_68_89,seq81,seq41,r_54_68_89,1.0,1,90,89,35
49,r_97_145_69,seq125,seq109,r_97_145_69,1.0,0,69,69,35
35,r_19_82_60,r_59_4_59,seq107,r_19_82_60,1.0,1,61,60,35
12,r_50_96_154,seq83,seq10,r_50_96_154,0.74,0,154,154,35
30,r_90_127_141,r_49_107_117,seq48,r_90_127_141,0.78,2,143,141,36
51,seq1,r_40_54_178,r_32_24_71,r_32_24_71,1.0,1,72,71,36
14,r_111_144_60,seq48,seq103,r_111_144_60,1.0,0,60,60,36
43,r_72_43_124,r_89_50_196,seq10,r_72_43_124,0.93,0,124,124,36
54,seq132,r_105_25_108,r_87_66_8,r_105_25_108,0.68,2,110,108,36
37,r_73_67_137,seq56,r_123_36_27,r_73_67_137,0.8,0,137,137,36
44,r_68_114_165,seq46,r_16_88_13,r_16_88_13,1.0,1,14,13,36
59,seq140,seq109,r_100_110_102,r_100_110_102,1.0,6,108,102,36
86,seq80,r_63_6_188,r_77_93_76,r_63_6_188,0.63,-95,93,188,36
5,r_7_84_157,seq69,r_31_81_105,r_7_84_157,0.8,0,157,157,36
42,r_40_54_178,seq9,r_86_104_40,r_86_104_40,0.71,140,180,40,36
80,seq56,r_73_67_137,seq113,r_73_67_137,0.96,0,137,137,36
45,r_44_74_167,r_100_110_102,seq3,r_100_110_102,1.0,-9,93,102,36
99,seq125,seq99,r_86_104_40,r_86_104_40,1.0,0,40,40,36
0,r_42_75_35,r_145_136_54,r_7_84_157,r_7_84_157,0.62,-122,35,157,36
38,r_130_12_179,r_11_141_121,r_123_36_27,r_130_12_179,0.95,1,180,179,36
31,r_19_37_109,r_97_139_151,seq23,r_19_37_109,0.57,0,109,109,36
3,r_97_139_151,r_91_53_5,seq38,r_97_139_151,0.75,0,151,151,36
10,r_58_8_173,r_64_95_164,r_90_127_141,r_58_8_173,0.29,-8,165,173,36
47,r_143_120_47,r_135_33_4,r_16_88_13,r_143_120_47,0.9,0,47,47,36
75,seq39,r_76_52_25,seq9,r_76_52_25,1.0,1,26,25,36
2,r_11_141_121,r_130_12_179,r_76_52_25,r_130_12_179,0.94,1,180,179,36
26,r_98_119_116,seq125,seq9,r_98_119_116,1.0,2,118,116,36
8,r_87_66_8,r_65_18_154,r_19_37_109,r_19_37_109,0.99,32,141,109,36
4,r_64_95_164,r_58_8_173,r_97_139_151,r_97_139_151,0.58,14,165,151,36
13,r_148_62_134,r_47_124_136,r_72_43_124,r_148_62_134,0.83,1,135,134,36
16,r_86_104_40,r_111_144_60,seq125,r_86_104_40,1.0,0,40,40,36
10,r_58_8_173,r_90_127_141,r_49_107_117,r_49_107_117,0.64,58,175,117,36
0,r_42_75_35,r_7_84_157,seq69,r_7_84_157,1.0,0,157,157,36
20,r_16_88_13,seq20,seq46,r_16_88_13,0.95,1,14,13,36
12,r_76_52_25,seq39,seq118,r_76_52_25,1.0,-3,22,25,36
2,r_11_141_121,r_40_54_178,r_130_12_179,r_11_141_121,0.99,0,121,121,36
29,r_63_6_188,seq60,r_148_62_134,r_148_62_134,0.92,54,188,134,36
24,r_32_24_71,seq29,seq1,r_32_24_71,1.0,0,71,71,36
33,r_128_57_113,seq60,seq55,r_128_57_113,0.99,5,118,113,36
32,r_121_4_130,seq129,seq29,r_121_4_130,0.98,0,130,130,36
38,r_130_12_179,r_65_18_154,r_11_141_121,r_11_141_121,0.91,5,126,121,36
48,r_85_35_51,r_89_50_196,r_86_104_40,r_85_35_51,0.79,-1,50,51,36
77,seq46,r_68_114_165,r_16_88_13,r_16_88_13,1.0,0,13,13,36
45,r_44_74_167,seq3,r_7_84_157,r_7_84_157,0.97,11,168,157,36
17,r_41_34_115,r_58_8_173,seq20,r_41_34_115,1.0,0,115,115,36
34,r_61_122_33,r_135_33_4,seq21,r_61_122_33,1.0,-2,31,33,36
39,r_15_59_11,r_135_33_4,seq140,r_15_59_11,0.59,0,11,11,36
9,r_116_108_114,seq71,seq70,r_116_108_114,1.0,4,118,114,36
6,r_123_36_27,r_100_110_102,r_16_88_13,r_123_36_27,0.83,0,27,27,36
98,seq118,r_65_18_154,r_76_52_25,r_76_52_25,1.0,-3,22,25,36
22,r_49_107_117,r_90_127_141,r_145_136_54,r_145_136_54,1.0,61,115,54,36
28,r_77_93_76,r_65_18_154,seq80,r_65_18_154,0.64,-69,85,154,36
49,r_31_81_105,seq13,r_7_84_157,r_31_81_105,0.43,60,165,105,36
7,r_91_53_5,r_97_139_151,r_116_108_114,r_116_108_114,0.77,37,151,114,36
18,r_65_18_154,r_87_66_8,r_76_52_25,r_65_18_154,0.44,1,155,154,36
11,r_92_78_31,r_116_108_114,seq138,r_92_78_31,1.0,1,32,31,36
23,r_100_110_102,r_44_74_167,seq140,r_100_110_102,0.95,0,102,102,36
41,r_145_136_54,r_31_81_105,seq134,r_145_136_54,1.0,0,54,54,36
18,r_65_18_154,r_31_81_105,r_87_66_8,r_65_18_154,0.7,-114,40,154,36
28,r_77_93_76,seq80,r_105_25_108,r_77_93_76,0.72,36,112,76,36
35,r_47_124_136,r_148_62_134,r_16_88_13,r_47_124_136,0.93,1,137,136,36
84,seq70,r_97_139_151,r_116_108_114,r_116_108_114,0.84,5,119,114,36
36,r_97_1_75,r_140_58_46,seq83,r_97_1_75,0.91,1,76,75,37
20,r_110_52_163,r_51_136_101,seq13,r_110_52_163,1.0,-1,162,163,37
66,seq34,r_77_87_153,r_135_21_134,r_135_21_134,1.0,2,136,134,37
41,r_91_25_17,r_64_112_16,seq28,r_91_25_17,1.0,0,17,17,37
8,r_56_80_58,r_68_36_195,r_12_50_106,r_68_36_195,0.73,-129,66,195,37
43,r_115_134_99,r_101_96_187,seq92,r_115_134_99,1.0,0,99,99,37
88,seq98,seq128,r_74_53_32,r_74_53_32,0.94,-13,19,32,37
30,r_30_59_55,seq34,r_64_112_16,r_30_59_55,0.99,0,55,55,37
49,r_127_31_31,r_88_90_19,r_91_25_17,r_88_90_19,0.68,12,31,19,37
42,r_64_112_16,seq120,r_30_59_55,r_30_59_55,1.0,4,59,55,37
16,r_27_76_111,seq19,seq83,r_27_76_111,0.98,0,111,111,37
5,r_88_90_19,r_89_41_151,r_142_103_53,r_142_103_53,0.72,41,94,53,37
19,r_130_146_2,r_24_143_82,seq113,r_24_143_82,1.0,1,83,82,37
2,r_111_4_34,seq70,seq83,r_111_4_34,0.39,39,73,34,37
31,r_108_131_135,seq5,seq75,r_108_131_135,0.98,0,135,135,37
45,r_29_23_20,seq6,seq7,r_29_23_20,1.0,1,21,20,37
3,r_147_8_40,r_67_37_93,seq129,r_147_8_40,1.0,0,40,40,37
10,r_51_136_101,seq119,r_110_52_163,r_51_136_101,0.95,3,104,101,37
26,r_20_114_77,r_109_107_90,r_29_23_20,r_20_114_77,1.0,0,77,77,37
4,r_22_105_144,r_14_85_177,seq138,r_22_105_144,0.93,0,144,144,37
11,r_81_123_184,r_56_80_58,r_22_105_144,r_22_105_144,0.57,40,184,144,37
20,r_110_52_163,r_65_38_97,r_51_136_101,r_51_136_101,0.79,6,107,101,37
46,r_0_26_148,r_55_95_158,r_135_21_134,r_0_26_148,0.95,0,148,148,37
15,r_109_107_90,seq83,r_91_25_17,r_109_107_90,0.99,0,90,90,37
57,seq138,r_55_95_158,r_22_105_144,r_22_105_144,0.94,14,158,144,37
6,r_10_139_88,r_93_62_188,seq7,r_10_139_88,0.72,-27,61,88,37
0,r_73_61_5,r_14_85_177,seq63,r_14_85_177,0.94,0,177,177,37
77,seq66,seq47,r_46_18_35,r_46_18_35,1.0,21,56,35,37
66,seq34,r_30_59_55,r_77_87_153,r_30_59_55,0.99,1,56,55,37
48,r_46_18_35,r_109_107_90,seq66,r_46_18_35,1.0,0,35,35,37
47,r_89_41_151,r_88_90_19,r_22_105_144,r_89_41_151,0.7,0,151,151,37
40,r_104_43_182,r_101_96_187,r_22_105_144,r_22_105_144,0.89,38,182,144,37
18,r_55_95_158,seq138,r_130_146_2,r_55_95_158,0.35,0,158,158,37
29,r_135_21_134,seq70,seq34,r_135_21_134,0.9,0,134,134,37
33,r_137_124_78,r_65_38_97,r_74_53_32,r_137_124_78,1.0,0,78,78,37
10,r_51_136_101,r_110_52_163,r_22_105_144,r_51_136_101,0.73,62,163,101,37
32,r_149_100_143,seq70,seq69,r_149_100_143,0.73,1,144,143,37
38,r_132_122_70,r_51_136_101,seq79,r_132_122_70,1.0,0,70,70,37
34,r_54_84_41,r_55_95_158,seq16,r_54_84_41,1.0,0,41,41,37
42,r_64_112_16,r_91_25_17,seq120,r_64_112_16,0.98,-1,15,16,37
17,r_72_33_72,r_109_107_90,seq69,r_72_33_72,1.0,-2,70,72,37
25,r_14_85_177,r_73_61_5,r_27_76_111,r_73_61_5,0.63,172,177,5,37
24,r_102_86_54,r_10_139_88,r_30_59_55,r_10_139_88,0.99,-34,54,88,37
27,r_142_103_53,r_20_114_77,r_88_90_19,r_88_90_19,0.92,34,53,19,37
2,r_111_4_34,seq57,seq70,r_111_4_34,0.97,0,34,34,37
28,r_99_35_154,seq42,r_27_76_111,r_27_76_111,0.99,46,157,111,37
44,r_24_143_82,r_130_146_2,seq3,r_24_143_82,0.89,1,83,82,37
35,r_65_38_97,seq5,r_46_18_35,r_46_18_35,0.92,69,104,35,37
44,r_13_29_167,r_132_120_72,seq11,r_13_29_167,0.82,1,168,167,38
36,r_96_40_169,r_85_16_166,r_71_106_150,r_96_40_169,0.67,2,171,169,38
8,r_30_144_140,r_5_77_84,r_70_112_71,r_30_144_140,1.0,-79,61,140,38
89,seq102,seq14,r_126_121_23,r_126_121_23,1.0,2,25,23,38
43,r_49_124_151,r_74_58_93,r_69_24_2,r_74_58_93,1.0,0,93,93,38
37,r_2_129_77,r_49_124_151,seq73,r_2_129_77,1.0,0,77,77,38
71,seq51,r_94_43_141,seq142,r_94_43_141,0.87,1,142,141,38
21,r_94_43_141,seq51,r_114_105_147,r_94_43_141,0.89,3,144,141,38
1,r_12_79_153,seq52,seq113,r_12_79_153,0.9,0,153,153,38
97,seq116,r_85_16_166,r_133_83_97,r_133_83_97,1.0,71,168,97,38
46,r_61_28_61,seq47,seq52,r_61_28_61,0.94,7,68,61,38
45,r_136_67_75,r_141_117_129,seq18,r_136_67_75,0.82,1,76,75,38
19,r_147_109_67,seq27,seq7,r_147_109_67,1.0,1,68,67,38
33,r_132_120_72,r_13_29_167,r_71_106_150,r_71_106_150,0.98,12,162,150,38
31,r_22_130_165,r_92_127_126,r_138_82_48,r_22_130_165,0.74,-92,73,165,38
15,r_64_75_59,r_118_115_196,seq95,r_64_75_59,1.0,0,59,59,38
41,r_114_105_147,seq122,r_94_43_141,r_114_105_147,0.85,1,148,147,38
17,r_33_98_40,r_107_149_131,seq50,r_33_98_40,1.0,0,40,40,38
10,r_62_45_120,r_92_127_126,r_141_117_129,r_62_45_120,0.8,0,120,120,38
26,r_34_57_122,seq111,r_62_45_120,r_34_57_122,0.85,0,122,122,38
8,r_30_144_140,r_70_112_71,r_136_67_75,r_70_112_71,0.59,70,141,71,38
0,r_70_112_71,r_35_65_119,r_30_144_140,r_70_112_71,0.95,1,72,71,38
11,r_74_58_93,r_12_79_153,r_63_134_69,r_74_58_93,1.0,0,93,93,38
20,r_17_137_188,seq23,r_31_0_89,r_31_0_89,0.89,99,188,89,38
48,r_133_83_97,r_13_29_167,seq116,r_133_83_97,1.0,0,97,97,38
6,r_125_9_54,r_44_81_100,seq54,r_44_81_100,1.0,-40,60,100,38
7,r_89_46_43,seq142,r_78_119_17,r_89_46_43,0.93,1,44,43,38
0,r_70_112_71,r_30_144_140,r_44_81_100,r_70_112_71,0.94,70,141,71,38
27,r_31_0_89,seq20,seq110,r_31_0_89,1.0,2,91,89,38
82,seq84,r_30_144_140,r_78_119_17,r_78_119_17,0.71,7,24,17,38
87,seq99,seq111,r_72_101_106,r_72_101_106,1.0,0,106,106,38
47,r_41_90_118,r_107_149_131,r_88_3_41,r_41_90_118,0.95,0,118,118,38
40,r_63_134_69,r_44_81_100,r_78_119_17,r_78_119_17,0.99,53,70,17,38
18,r_107_149_131,r_41_90_118,r_12_79_153,r_41_90_118,0.68,0,118,118,38
24,r_71_106_150,seq111,r_132_120_72,r_71_106_150,0.91,1,151,150,38
25,r_85_16_166,r_96_40_169,seq25,r_96_40_169,0.67,-1,168,169,38
33,r_132_120_72,seq143,r_13_29_167,r_132_120_72,0.91,1,73,72,38
13,r_38_87_10,r_93_37_186,r_88_3_41,r_38_87_10,1.0,0,10,10,38
18,r_107_149_131,r_12_79_153,r_44_81_100,r_107_149_131,0.92,2,133,131,38
58,seq143,r_132_120_72,seq140,r_132_120_72,1.0,8,80,72,38
52,seq7,seq104,r_147_109_67,r_147_109_67,1.0,6,73,67,38
34,r_141_117_129,seq148,r_62_45_120,r_62_45_120,0.95,3,123,120,38
22,r_4_66_20,r_12_79_153,seq50,r_4_66_20,0.96,-2,18,20,38
29,r_138_82_48,seq18,r_22_130_165,r_138_82_48,1.0,0,48,48,38
38,r_126_121_23,seq135,seq102,r_126_121_23,0.9,0,23,23,38
4,r_78_119_17,r_62_45_120,seq84,r_78_119_17,0.98,0,17,17,38
32,r_131_42_26,seq95,seq128,r_131_42_26,0.97,0,26,26,38
9,r_39_26_137,seq80,r_34_57_122,r_39_26_137,0.77,2,139,137,38
96,seq113,seq95,r_12_79_153,r_12_79_153,0.91,6,159,153,38
31,r_22_130_165,r_138_82_48,seq142,r_22_130_165,0.96,0,165,165,38
29,r_138_82_48,r_22_130_165,r_5_77_84,r_138_82_48,0.85,117,165,48,38
28,r_35_65_119,r_71_106_150,seq8,r_35_65_119,1.0,0,119,119,38
42,r_123_48_21,r_85_16_166,seq19,r_123_48_21,1.0,0,21,21,38
49,r_5_77_84,seq84,r_138_82_48,r_5_77_84,0.71,0,84,84,38
44,r_13_29_167,r_133_83_97,r_132_120_72,r_133_83_97,0.6,0,97,97,38
23,r_139_53_62,seq8,r_125_9_54,r_139_53_62,0.76,7,69,62,38
35,r_72_101_106,r_92_127_126,seq99,r_72_101_106,0.95,0,106,106,38
12,r_92_127_126,r_22_130_165,r_2_129_77,r_22_130_165,0.99,-39,126,165,38
30,r_99_100_77,r_68_56_160,r_94_42_71,r_99_100_77,0.48,0,77,77,39
32,r_111_148_8,seq95,seq39,r_111_148_8,0.73,2,10,8,39
54,seq140,r_144_120_145,r_123_50_50,r_123_50_50,0.56,95,145,50,39
37,r_78_59_147,seq22,r_123_50_50,r_123_50_50,0.65,98,148,50,39
45,r_49_130_48,r_122_40_1,seq114,r_49_130_48,0.9,1,49,48,39
59,seq22,r_78_59_147,seq105,r_78_59_147,1.0,1,148,147,39
16,r_72_121_150,seq102,r_46_69_149,r_46_69_149,0.56,5,154,149,39
21,r_57_117_141,seq147,r_31_11_3,r_57_117_141,1.0,0,141,141,39
39,r_44_47_161,r_16_27_199,r_49_130_48,r_44_47_161,0.7,0,161,161,39
46,r_63_106_168,r_13_10_196,r_111_148_8,r_13_10_196,0.66,-28,168,196,39
42,r_116_26_176,seq39,seq76,r_116_26_176,0.4,0,176,176,39
33,r_46_69_149,r_91_87_84,seq105,r_46_69_149,0.99,0,149,149,39
61,seq24,r_31_11_3,r_119_89_44,r_119_89_44,0.8,7,51,44,39
8,r_119_89_44,r_80_118_38,seq24,r_119_89_44,0.75,1,45,44,39
76,seq65,r_91_87_84,r_21_29_54,r_21_29_54,0.66,19,73,54,39
31,r_67_134_102,seq37,seq105,r_67_134_102,0.99,1,103,102,39
29,r_103_115_16,r_91_87_84,r_129_41_192,r_103_115_16,0.96,0,16,16,39
41,r_18_20_163,r_13_10_196,r_49_130_48,r_13_10_196,0.77,-33,163,196,39
89,seq101,seq102,r_112_75_13,r_112_75_13,1.0,111,124,13,39
10,r_133_30_96,r_122_40_1,r_1_146_49,r_133_30_96,0.97,1,97,96,39
20,r_1_146_49,seq76,seq36,r_1_146_49,1.0,0,49,49,39
4,r_12_38_142,r_7_141_122,r_112_75_13,r_12_38_142,0.49,0,142,142,39
0,r_70_82_151,seq23,seq65,r_70_82_151,0.52,0,151,151,39
19,r_97_81_45,r_144_120_145,r_80_118_38,r_97_81_45,0.99,0,45,45,39
11,r_127_4_64,r_116_26_176,seq143,r_127_4_64,0.95,8,72,64,39
13,r_91_87_84,seq65,seq52,r_91_87_84,0.74,0,84,84,39
8,r_119_89_44,r_46_69_149,r_80_118_38,r_80_118_38,0.86,-4,34,38,39
15,r_66_145_126,seq28,r_0_9_119,r_66_145_126,0.97,1,127,126,39
6,r_124_15_73,r_61_58_152,seq33,r_124_15_73,1.0,0,73,73,39
99,seq126,r_61_58_152,seq76,r_61_58_152,1.0,0,152,152,39
9,r_112_75_13,r_57_117_141,seq35,r_112_75_13,0.94,0,13,13,39
27,r_68_56_160,seq109,r_61_58_152,r_68_56_160,0.85,0,160,160,39
36,r_132_96_51,r_86_45_148,seq23,r_132_96_51,1.0,0,51,51,39
2,r_7_141_122,seq74,r_127_4_64,r_127_4_64,1.0,27,91,64,39
47,r_139_108_113,r_31_11_3,seq95,r_139_108_113,0.98,0,113,113,39
57,seq19,r_2_137_47,r_116_26_176,r_2_137_47,1.0,0,47,47,39
40,r_43_113_110,seq33,seq19,r_43_113_110,0.77,0,110,110,39
24,r_94_42_71,r_144_120_145,r_99_100_77,r_94_42_71,1.0,0,71,71,39
25,r_31_11_3,r_139_108_113,seq8,r_139_108_113,1.0,0,113,113,39
33,r_46_69_149,r_67_134_102,r_91_87_84,r_67_134_102,0.98,-31,71,102,39
18,r_2_137_47,seq19,seq3,r_2_137_47,0.99,0,47,47,39
61,seq24,r_80_118_38,r_31_11_3,r_80_118_38,0.85,-1,37,38,39
68,seq37,r_67_134_102,seq54,r_67_134_102,1.0,1,103,102,39
38,r_61_58_152,seq126,seq140,r_61_58_152,0.86,0,152,152,39
52,seq8,r_14_135_103,r_17_60_78,r_14_135_103,0.98,-8,95,103,39
76,seq65,r_21_29_54,r_70_82_151,r_70_82_151,1.0,12,163,151,39
57,seq19,r_116_26_176,r_43_113_110,r_43_113_110,0.98,10,120,110,39
34,r_0_9_119,r_73_55_146,seq140,r_0_9_119,0.92,0,119,119,39
28,r_123_50_50,r_13_10_196,seq140,r_123_50_50,0.99,0,50,50,39
17,r_79_5_183,seq52,r_133_30_96,r_133_30_96,0.74,88,184,96,39
22,r_129_41_192,seq92,r_103_115_16,r_103_115_16,0.86,54,70,16,39
49,r_17_60_78,seq102,seq8,r_17_60_78,0.89,10,88,78,39
56,seq143,r_7_141_122,r_127_4_64,r_127_4_64,1.0,3,67,64,39
44,r_14_135_103,r_77_88_138,r_127_4_64,r_14_135_103,0.98,0,103,103,39
23,r_136_32_6,r_67_134_102,r_21_29_54,r_136_32_6,0.81,80,86,6,39
43,r_21_29_54,r_97_81_45,seq138,r_21_29_54,0.99,1,55,54,39
35,r_77_88_138,seq8,r_112_75_13,r_112_75_13,0.85,126,139,13,39
23,r_136_32_6,r_21_29_54,r_49_130_48,r_136_32_6,0.42,125,131,6,39
30,r_1_125_109,seq142,r_31_54_20,r_1_125_109,0.55,2,111,109,40
51,seq133,r_65_25_135,seq83,r_65_25_135,1.0,-21,114,135,40
36,r_30_134_89,r_75_101_182,seq97,r_30_134_89,0.69,-18,71,89,40
56,seq140,seq137,r_41_37_29,r_41_37_29,1.0,5,34,29,40
8,r_89_80_63,r_82_38_121,r_124_52_80,r_89_80_63,0.92,7,70,63,40
71,seq35,seq116,r_103_128_46,r_103_128_46,0.84,-13,33,46,40
37,r_0_40_141,seq16,r_1_125_109,r_1_125_109,0.99,32,141,109,40
19,r_110_136_42,r_28_88_154,seq67,r_110_136_42,0.52,121,163,42,40
55,seq10,seq116,r_31_54_20,r_31_54_20,0.95,91,111,20,40
21,r_93_76_66,r_82_38_121,seq123,r_93_76_66,1.0,-1,65,66,40
39,r_49_69_60,seq21,r_60_126_108,r_49_69_60,0.98,0,60,60,40
97,seq137,seq123,r_94_32_38,r_94_32_38,0.99,73,111,38,40
42,r_75_101_182,r_105_61_143,seq47,r_105_61_143,1.0,0,143,143,40
69,seq29,seq116,r_31_54_20,r_31_54_20,0.99,91,111,20,40
45,r_86_51_123,r_11_91_136,r_106_66_7,r_106_66_7,1.0,116,123,7,40
39,r_49_69_60,r_60_126_108,r_90_19_102,r_49_69_60,0.56,50,110,60,40
76,seq47,r_75_101_182,r_120_139_85,r_120_139_85,0.6,105,190,85,40
1,r_8_87_47,r_81_95_82,r_41_37_29,r_8_87_47,1.0,0,47,47,40
31,r_81_95_82,r_0_40_141,seq46,r_81_95_82,1.0,0,82,82,40
41,r_130_7_130,seq149,seq53,r_130_7_130,0.87,0,130,130,40
89,seq97,r_50_56_166,r_30_134_89,r_30_134_89,0.61,77,166,89,40
3,r_90_19_102,r_12_100_6,r_49_69_60,r_49_69_60,1.0,42,102,60,40
10,r_11_91_136,seq18,r_106_66_7,r_11_91_136,0.99,0,136,136,40
43,r_41_37_29,seq17,r_62_92_86,r_41_37_29,0.99,0,29,29,40
42,r_75_101_182,seq47,r_89_80_63,r_75_101_182,0.47,0,182,182,40
4,r_12_100_6,r_90_19_102,r_14_74_199,r_12_100_6,0.59,96,102,6,40
46,r_84_107_52,r_75_101_182,seq72,r_84_107_52,1.0,0,52,52,40
20,r_112_79_171,seq149,r_62_92_86,r_62_92_86,0.38,85,171,86,40
98,seq123,r_73_109_197,r_93_76_66,r_93_76_66,1.0,-1,65,66,40
46,r_84_107_52,seq72,r_122_13_169,r_122_13_169,0.92,-3,166,169,40
48,r_60_126_108,r_120_139_85,r_49_69_60,r_49_69_60,1.0,22,82,60,40
55,seq10,r_31_54_20,r_65_25_135,r_65_25_135,1.0,2,137,135,40
30,r_1_125_109,r_31_54_20,r_0_40_141,r_1_125_109,0.55,32,141,109,40
33,r_78_115_17,seq53,seq102,r_78_115_17,1.0,0,17,17,40
48,r_60_126_108,r_49_69_60,r_85_117_159,r_60_126_108,0.97,2,110,108,40
27,r_113_5_168,seq149,r_45_144_103,r_45_144_103,1.0,65,168,103,40
19,r_110_136_42,r_11_91_136,r_28_88_154,r_110_136_42,1.0,0,42,42,40
35,r_129_36_48,r_49_69_60,seq55,r_129_36_48,1.0,0,48,48,40
2,r_65_25_135,seq64,seq10,r_65_25_135,0.99,0,135,135,40
47,r_23_118_34,seq4,r_30_134_89,r_23_118_34,0.98,1,35,34,40
40,r_124_52_80,r_122_13_169,r_89_80_63,r_124_52_80,0.98,-2,78,80,40
29,r_45_144_103,seq143,seq26,r_45_144_103,1.0,0,103,103,40
43,r_41_37_29,r_62_92_86,r_8_87_47,r_8_87_47,0.62,39,86,47,40
47,r_23_118_34,r_75_101_182,r_120_139_85,r_23_118_34,0.54,146,180,34,40
34,r_106_66_7,seq57,r_86_51_123,r_86_51_123,1.0,4,127,123,40
25,r_14_74_199,r_96_20_4,r_12_100_6,r_12_100_6,0.41,73,79,6,40
15,r_94_32_38,r_30_134_89,seq137,r_94_32_38,0.95,0,38,38,40
32,r_127_121_128,r_85_117_159,seq143,r_85_117_159,0.63,-31,128,159,40
38,r_105_61_143,r_75_101_182,r_129_36_48,r_105_61_143,0.86,0,143,143,40
24,r_2_147_53,seq26,seq17,r_2_147_53,0.97,-2,51,53,40
13,r_68_99_27,r_122_13_169,seq26,r_68_99_27,0.99,0,27,27,40
47,r_23_118_34,r_30_134_89,r_75_101_182,r_23_118_34,0.71,55,89,34,40
11,r_31_54_20,r_62_92_86,seq15,r_31_54_20,1.0,0,20,20,40
17,r_28_88_154,r_96_20_4,r_110_136_42,r_110_136_42,1.0,12,54,42,40
94,seq146,seq17,r_82_38_121,r_82_38_121,0.99,12,133,121,40
9,r_114_58_116,seq26,r_12_100_6,r_12_100_6,0.35,109,115,6,40
22,r_120_139_85,r_60_126_108,seq17,r_120_139_85,0.92,0,85,85,40
49,r_33_44_77,seq116,r_85_117_159,r_33_44_77,0.99,0,77,77,40
7,r_3_27_112,seq26,seq21,r_3_27_112,1.0,0,112,112,40
23,r_122_13_169,seq132,r_84_107_52,r_84_107_52,1.0,117,169,52,40
17,r_28_88_154,r_110_136_42,r_12_100_6,r_28_88_154,0.77,1,155,154,40
12,r_85_117_159,r_127_121_128,r_33_44_77,r_85_117_159,0.91,-81,78,159,40
88,seq143,r_45_144_103,r_108_77_16,r_45_144_103,0.5,-75,28,103,40
84,seq67,r_96_20_4,r_89_80_63,r_89_80_63,0.7,80,143,63,40
30,r_98_66_145,r_132_21_194,r_104_121_176,r_132_21_194,0.86,-49,145,194,41
9,r_93_34_171,seq41,r_62_122_93,r_62_122_93,0.94,22,115,93,41
17,r_116_2_52,r_56_49_134,seq27,r_56_49_134,0.82,-77,57,134,41
14,r_106_119_80,r_146_105_101,r_114_8_62,r_114_8_62,0.6,18,80,62,41
8,r_139_67_120,seq10,r_62_122_93,r_62_122_93,1.0,29,122,93,41
83,seq82,seq36,r_57_136_92,r_57_136_92,0.84,5,97,92,41
37,r_45_110_73,r_93_34_171,seq92,r_45_110_73,1.0,0,73,73,41
16,r_144_55_77,seq27,r_94_131_159,r_144_55_77,1.0,0,77,77,41
5,r_57_136_92,r_33_87_114,seq82,r_57_136_92,0.54,0,92,92,41
11,r_58_96_30,seq30,seq117,r_58_96_30,0.71,3,33,30,41
13,r_128_24_42,r_33_87_114,seq92,r_128_24_42,0.94,0,42,42,41
89,seq92,r_128_24_42,r_45_110_73,r_45_110_73,1.0,59,132,73,41
19,r_16_113_96,seq23,r_130_52_22,r_16_113_96,1.0,1,97,96,41
33,r_94_131_159,r_144_55_77,r_99_12_13,r_94_131_159,1.0,1,160,159,41
77,seq59,seq78,r_94_131_159,r_94_131_159,0.9,6,165,159,41
9,r_93_34_171,r_62_122_93,seq91,r_93_34_171,0.99,0,171,171,41
31,r_133_20_115,r_102_80_173,seq1,r_102_80_173,0.98,-58,115,173,41
41,r_89_47_91,r_124_135_155,r_114_8_62,r_89_47_91,0.98,2,93,91,41
26,r_124_135_155,seq83,seq15,r_124_135_155,0.63,2,157,155,41
16,r_144_55_77,r_94_131_159,seq83,r_94_131_159,1.0,1,160,159,41
4,r_146_105_101,r_86_149_110,r_89_47_91,r_146_105_101,0.92,0,101,101,41
0,r_86_149_110,r_146_105_101,seq59,r_146_105_101,0.58,0,101,101,41
20,r_71_72_38,r_56_49_134,r_63_6_87,r_56_49_134,0.46,-44,90,134,41
48,r_76_147_164,seq14,r_139_67_120,r_76_147_164,0.59,0,164,164,41
49,r_62_122_93,r_99_12_13,r_93_34_171,r_62_122_93,1.0,0,93,93,41
3,r_64_0_5,r_141_127_133,r_73_43_34,r_64_0_5,0.56,29,34,5,41
74,seq53,seq9,r_86_149_110,r_86_149_110,0.87,5,115,110,41
27,r_68_17_33,seq4,seq54,r_68_17_33,1.0,0,33,33,41
43,r_99_12_13,seq15,r_94_131_159,r_94_131_159,1.0,0,159,159,41
99,seq123,r_141_127_133,r_130_52_22,r_141_127_133,1.0,0,133,133,41
9,r_93_34_171,r_100_50_170,seq41,r_93_34_171,0.52,-126,45,171,41
29,r_40_11_19,r_94_131_159,seq22,r_40_11_19,0.99,0,19,19,41
49,r_62_122_93,r_86_149_110,r_99_12_13,r_99_12_13,1.0,0,13,13,41
47,r_141_127_133,seq123,seq51,r_141_127_133,1.0,0,133,133,41
59,seq18,r_19_13_88,r_26_142_37,r_19_13_88,0.51,66,154,88,41
18,r_114_8_62,seq145,seq14,r_114_8_62,0.61,0,62,62,41
36,r_73_43_34,r_33_87_114,r_64_0_5,r_73_43_34,1.0,0,34,34,41
25,r_63_6_87,r_76_147_164,r_71_72_38,r_76_147_164,0.59,-77,87,164,41
43,r_99_12_13,r_62_122_93,seq15,r_62_122_93,1.0,0,93,93,41
33,r_94_131_159,r_124_135_155,r_144_55_77,r_144_55_77,1.0,18,95,77,41
64,seq27,r_144_55_77,r_116_2_52,r_144_55_77,0.99,-1,76,77,41
21,r_26_142_37,r_16_113_96,seq83,r_26_142_37,0.81,0,37,37,41
46,r_126_3_51,r_19_13_88,seq7,r_126_3_51,1.0,2,53,51,41
32,r_75_77_95,r_33_87_114,r_39_84_4,r_75_77_95,0.65,1,96,95,41
34,r_100_50_170,seq10,r_146_105_101,r_100_50_170,0.73,1,171,170,41
43,r_99_12_13,r_139_67_120,r_62_122_93,r_99_12_13,0.98,0,13,13,41
74,seq53,r_93_34_171,seq9,r_93_34_171,0.65,-131,40,171,41
0,r_86_149_110,seq59,seq53,r_86_149_110,0.67,2,112,110,41
35,r_102_80_173,r_129_32_196,seq9,r_102_80_173,1.0,0,173,173,41
10,r_61_46_24,r_144_55_77,seq10,r_61_46_24,0.99,-5,19,24,41
44,r_125_79_85,r_120_44_178,r_58_96_30,r_120_44_178,0.59,-91,87,178,41
49,r_62_122_93,r_93_34_171,r_139_67_120,r_93_34_171,0.66,0,171,171,41
35,r_102_80_173,r_133_20_115,r_129_32_196,r_102_80_173,0.5,-58,115,173,41
12,r_56_49_134,seq97,seq54,r_56_49_134,0.82,0,134,134,41
26,r_25_109_159,r_131_133_76,r_124_20_68,r_25_109_159,0.93,0,159,159,42
36,r_124_20_68,seq126,seq101,r_124_20_68,1.0,1,69,68,42
83,seq75,r_41_65_117,r_131_133_76,r_131_133_76,1.0,9,85,76,42
21,r_41_65_117,r_25_109_159,seq55,r_25_109_159,0.69,-42,117,159,42
39,r_142_132_179,r_44_18_12,r_12_13_24,r_12_13_24,0.67,153,177,24,42
97,seq121,r_105_9_148,r_38_49_2,r_105_9_148,1.0,-48,100,148,42
16,r_53_50_69,seq34,seq114,r_53_50_69,0.81,0,69,69,42
5,r_28_86_115,r_80_16_52,r_136_83_105,r_28_86_115,0.98,1,116,115,42
80,seq63,r_21_87_166,r_28_86_115,r_28_86_115,0.93,51,166,115,42
46,r_136_83_105,r_11_137_198,r_35_68_50,r_136_83_105,0.62,-70,35,105,42
3,r_12_13_24,seq33,r_93_127_14,r_12_13_24,1.0,0,24,24,42
19,r_105_9_148,seq4,r_140_10_146,r_105_9_148,0.93,2,150,148,42
10,r_80_16_52,seq6,r_78_70_196,r_80_16_52,0.36,44,96,52,42
26,r_25_109_159,r_41_65_117,r_131_133_76,r_131_133_76,1.0,41,117,76,42
2,r_38_49_2,r_105_9_148,r_81_14_16,r_81_14_16,0.59,0,16,16,42
4,r_79_88_61,seq2,seq32,r_79_88_61,0.78,1,62,61,42
11,r_111_90_87,r_21_87_166,r_80_16_52,r_111_90_87,0.99,8,95,87,42
13,r_22_66_138,seq98,seq56,r_22_66_138,0.77,0,138,138,42
46,r_136_83_105,r_35_68_50,r_82_74_9,r_136_83_105,1.0,0,105,105,42
48,r_21_87_166,seq63,r_117_24_7,r_21_87_166,0.62,0,166,166,42
6,r_123_141_162,seq1,r_22_66_138,r_22_66_138,0.83,25,163,138,42
99,seq126,r_124_20_68,r_135_113_21,r_124_20_68,0.95,1,69,68,42
16,r_53_50_69,seq91,seq34,r_53_50_69,0.37,-41,28,69,42
47,r_131_133_76,seq3,r_25_109_159,r_131_133_76,1.0,0,76,76,42
43,r_92_26_19,r_136_83_105,seq1,r_92_26_19,1.0,0,19,19,42
74,seq55,r_105_9_148,r_41_65_117,r_105_9_148,0.98,-48,100,148,42
29,r_140_10_146,seq7,seq138,r_140_10_146,0.62,-1,145,146,42
28,r_35_68_50,r_136_83_105,seq29,r_136_83_105,1.0,0,105,105,42
33,r_69_139_102,r_123_141_162,seq146,r_69_139_102,0.81,1,103,102,42
47,r_131_133_76,r_25_109_159,seq75,r_25_109_159,1.0,0,159,159,42
31,r_108_89_34,r_145_106_134,seq4,r_108_89_34,1.0,0,34,34,42
32,r_118_134_158,seq98,r_48_110_4,r_118_134_158,0.63,0,158,158,42
38,r_43_39_75,r_21_87_166,seq112,r_43_39_75,0.94,0,75,75,42
28,r_35_68_50,r_122_107_195,r_136_83_105,r_35_68_50,0.84,0,50,50,42
9,r_46_102_80,seq148,seq129,r_46_102_80,0.99,0,80,80,42
17,r_81_14_16,r_12_13_24,r_38_49_2,r_81_14_16,0.98,0,16,16,42
37,r_117_24_7,seq4,r_21_87_166,r_21_87_166,0.52,10,176,166,42
22,r_145_106_134,seq144,r_11_137_198,r_145_106_134,0.86,0,134,134,42
56,seq7,r_140_10_146,seq144,r_140_10_146,1.0,-1,145,146,42
7,r_72_36_67,r_38_49_2,seq51,r_72_36_67,1.0,0,67,67,42
44,r_97_99_85,r_21_87_166,seq3,r_97_99_85,1.0,0,85,85,42
35,r_67_30_71,r_19_119_193,seq61,r_67_30_71,1.0,0,71,71,42
66,seq33,r_12_13_24,seq112,r_12_13_24,0.97,-4,20,24,42
14,r_77_20_168,r_129_134_80,r_135_1_140,r_129_134_80,0.89,86,166,80,43
29,r_46_115_46,seq138,seq11,r_46_115_46,1.0,0,46,46,43
8,r_6_140_158,r_93_75_67,seq120,r_6_140_158,0.67,-88,70,158,43
59,seq148,r_44_136_185,r_26_112_21,r_26_112_21,0.88,166,187,21,43
8,r_6_140_158,r_122_32_122,r_89_51_83,r_6_140_158,0.91,-4,154,158,43
25,r_98_110_9,r_9_34_165,seq22,r_98_110_9,0.49,46,55,9,43
21,r_89_51_83,seq22,seq63,r_89_51_83,0.99,2,85,83,43
39,r_139_43_159,seq87,seq54,r_139_43_159,0.63,0,159,159,43
5,r_133_61_135,r_18_99_188,r_70_130_7,r_133_61_135,0.97,0,135,135,43
46,r_146_78_73,seq67,seq8,r_146_78_73,1.0,1,74,73,43
45,r_129_134_80,r_77_20_168,seq128,r_77_20_168,0.44,-69,99,168,43
19,r_58_4_152,seq42,seq84,r_58_4_152,0.49,1,153,152,43
73,seq138,r_46_115_46,seq91,r_46_115_46,1.0,0,46,46,43
15,r_74_107_51,r_80_65_126,r_59_117_116,r_74_107_51,0.49,69,120,51,43
31,r_93_75_67,r_6_140_158,seq128,r_93_75_67,0.99,3,70,67,43
41,r_88_25_178,seq90,seq8,r_88_25_178,0.35,0,178,178,43
3,r_59_117_116,r_30_113_90,seq0,r_30_113_90,0.59,0,90,90,43
10,r_23_73_163,seq87,r_93_75_67,r_23_73_163,0.58,0,163,163,43
90,seq103,seq126,r_132_28_96,r_132_28_96,0.72,21,117,96,43
26,r_31_66_40,seq120,r_36_41_139,r_31_66_40,0.41,99,139,40,43
4,r_135_1_140,r_123_39_175,r_133_61_135,r_123_39_175,1.0,-34,141,175,43
0,r_14_127_111,seq72,r_44_136_185,r_14_127_111,0.68,0,111,111,43
63,seq42,r_58_4_152,r_37_5_71,r_37_5_71,0.94,82,153,71,43
11,r_132_28_96,seq19,seq103,r_132_28_96,0.74,2,98,96,43
20,r_37_5_71,seq90,seq69,r_37_5_71,0.98,0,71,71,43
13,r_33_13_70,seq55,r_21_64_50,r_33_13_70,0.52,4,74,70,43
48,r_94_95_91,r_123_39_175,seq12,r_94_95_91,1.0,0,91,91,43
99,seq126,r_9_34_165,r_80_65_126,r_9_34_165,0.87,-39,126,165,43
17,r_137_124_53,r_37_5_71,seq144,r_137_124_53,1.0,0,53,53,43
27,r_44_136_185,seq148,seq121,r_44_136_185,0.27,2,187,185,43
87,seq144,r_133_61_135,r_137_124_53,r_137_124_53,0.49,34,87,53,43
0,r_14_127_111,r_44_136_185,r_37_5_71,r_14_127_111,0.56,55,166,111,43
74,seq63,r_92_76_186,r_89_51_83,r_89_51_83,1.0,92,175,83,43
18,r_18_99_188,r_133_61_135,r_129_134_80,r_133_61_135,0.99,0,135,135,43
24,r_9_34_165,seq96,r_46_115_46,r_46_115_46,0.9,119,165,46,43
8,r_6_140_158,seq120,r_122_32_122,r_6_140_158,0.73,-36,122,158,43
35,r_123_39_175,r_93_75_67,r_122_32_122,r_123_39_175,0.54,8,183,175,43
33,r_24_97_107,seq48,seq120,r_24_97_107,0.99,1,108,107,43
44,r_142_29_26,r_58_4_152,seq27,r_142_29_26,1.0,7,33,26,43
65,seq48,r_24_97_107,r_30_113_90,r_24_97_107,0.99,-17,90,107,43
47,r_38_52_14,seq8,seq63,r_38_52_14,1.0,0,14,14,43
32,r_3_15_63,r_132_28_96,r_46_115_46,r_132_28_96,0.63,-33,63,96,43
38,r_30_113_90,r_59_117_116,seq48,r_30_113_90,0.7,0,90,90,43
77,seq69,seq114,r_37_5_71,r_37_5_71,0.99,-2,69,71,43
30,r_104_143_47,seq128,seq67,r_104_143_47,1.0,1,48,47,43
15,r_74_107_51,r_133_61_135,r_80_65_126,r_74_107_51,1.0,1,52,51,43
1,r_26_112_21,r_92_76_186,seq87,r_26_112_21,0.99,0,21,21,43
9,r_47_118_64,seq114,r_132_28_96,r_47_118_64,0.54,2,66,64,43
96,seq120,r_31_66_40,r_24_97_107,r_24_97_107,0.98,1,108,107,43
28,r_62_40_102,seq8,r_109_131_193,r_62_40_102,0.98,1,103,102,43
7,r_71_2_128,seq128,r_132_28_96,r_71_2_128,0.99,4,132,128,43
23,r_79_102_134,seq67,seq22,r_79_102_134,0.53,1,135,134,43
35,r_123_39_175,r_94_95_91,r_93_75_67,r_123_39_175,1.0,-84,91,175,43
12,r_122_32_122,seq17,r_6_140_158,r_6_140_158,0.65,-37,121,158,43
12,r_122_32_122,r_6_140_158,r_123_39_175,r_122_32_122,0.64,44,166,122,43
41,r_110_67_45,seq43,seq87,r_110_67_45,1.0,0,45,45,44
30,r_55_73_106,seq35,seq92,r_55_73_106,0.86,0,106,106,44
36,r_5_45_94,seq26,r_116_94_73,r_5_45_94,0.71,0,94,94,44
8,r_21_145_156,r_126_124_193,seq23,r_21_145_156,0.87,-1,155,156,44
55,seq13,r_90_76_141,seq79,r_90_76_141,0.77,2,143,141,44
21,r_12_102_182,seq14,r_127_149_74,r_127_149_74,1.0,1,75,74,44
39,r_78_37_135,seq72,seq147,r_78_37_135,0.54,0,135,135,44
1,r_61_129_168,seq34,seq136,r_61_129_168,0.47,0,168,168,44
97,seq118,r_54_62_163,r_95_2_117,r_95_2_117,0.89,2,119,117,44
5,r_15_41_143,r_32_42_81,r_1_58_42,r_15_41_143,1.0,-61,82,143,44
46,r_31_120_111,seq137,r_32_42_81,r_31_120_111,0.63,1,112,111,44
16,r_77_27_197,r_1_58_42,r_48_10_9,r_1_58_42,0.84,-18,24,42,44
19,r_101_143_138,r_140_105_191,r_18_71_63,r_101_143_138,0.56,0,138,138,44
29,r_134_106_194,r_16_125_34,seq83,r_16_125_34,0.45,4,38,34,44
66,seq34,r_61_129_168,r_69_133_38,r_61_129_168,0.85,0,168,168,44
68,seq36,r_1_58_42,r_77_27_197,r_1_58_42,1.0,0,42,42,44
89,seq93,r_85_22_110,seq28,r_85_22_110,1.0,0,110,110,44
3,r_68_104_62,seq139,r_134_106_194,r_68_104_62,1.0,0,62,62,44
11,r_3_89_52,r_115_144_69,seq26,r_3_89_52,0.99,3,55,52,44
4,r_46_81_92,seq136,r_95_2_117,r_46_81_92,0.57,24,116,92,44
0,r_146_17_105,r_126_124_193,seq130,r_146_17_105,0.9,3,108,105,44
13,r_131_128_189,seq30,r_127_149_74,r_127_149_74,0.65,115,189,74,44
6,r_4_65_93,r_1_58_42,r_48_10_9,r_1_58_42,0.79,-18,24,42,44
15,r_108_57_187,seq141,r_116_94_73,r_116_94_73,0.95,114,187,73,44
48,r_95_2_117,r_126_124_193,seq118,r_95_2_117,0.96,0,117,117,44
14,r_25_91_48,seq29,r_126_124_193,r_25_91_48,1.0,0,48,48,44
62,seq26,r_5_45_94,r_18_71_63,r_5_45_94,1.0,0,94,94,44
21,r_12_102_182,r_127_149_74,r_61_129_168,r_12_102_182,0.33,0,182,182,44
31,r_7_40_10,seq118,seq141,r_7_40_10,0.99,0,10,10,44
29,r_134_106_194,seq83,r_68_104_62,r_68_104_62,1.0,-1,61,62,44
2,r_126_124_193,r_21_145_156,r_25_91_48,r_25_91_48,0.99,107,155,48,44
40,r_8_96_113,seq147,r_15_41_143,r_8_96_113,1.0,0,113,113,44
24,r_70_64_134,seq121,r_25_91_48,r_25_91_48,0.85,87,135,48,44
25,r_84_11_40,seq23,seq117,r_84_11_40,0.47,33,73,40,44
4,r_46_81_92,r_95_2_117,r_49_122_3,r_46_81_92,0.39,39,131,92,44
6,r_4_65_93,r_48_10_9,r_68_104_62,r_4_65_93,0.87,10,103,93,44
33,r_16_125_34,r_134_106_194,seq47,r_16_125_34,0.72,0,34,34,44
33,r_16_125_34,r_44_114_126,r_134_106_194,r_134_106_194,0.59,-179,15,194,44
38,r_54_62_163,seq38,seq36,r_54_62_163,0.69,1,164,163,44
10,r_1_58_42,seq36,r_15_41_143,r_1_58_42,1.0,0,42,42,44
34,r_127_149_74,r_9_135_76,seq14,r_127_149_74,1.0,0,74,74,44
17,r_116_94_73,r_46_81_92,r_5_45_94,r_116_94_73,0.79,1,74,73,44
9,r_39_86_149,r_126_124_193,seq80,r_39_86_149,0.84,0,149,149,44
96,seq117,r_127_149_74,r_84_11_40,r_127_149_74,1.0,-1,73,74,44
22,r_33_119_173,r_126_124_193,r_49_122_3,r_49_122_3,0.39,172,175,3,44
28,r_32_42_81,r_15_41_143,seq83,r_32_42_81,1.0,1,82,81,44
49,r_53_142_103,seq74,seq38,r_53_142_103,0.95,2,105,103,44
56,seq14,seq56,r_127_149_74,r_127_149_74,1.0,0,74,74,44
44,r_9_135_76,r_32_42_81,r_69_133_38,r_9_135_76,0.97,0,76,76,44
23,r_18_71_63,r_90_76_141,seq26,r_18_71_63,0.53,9,72,63,44
20,r_132_109_57,r_54_62_163,r_49_122_3,r_132_109_57,1.0,1,58,57,44
35,r_44_114_126,seq26,seq137,r_44_114_126,0.72,1,127,126,44
12,r_85_22_110,seq136,seq38,r_85_22_110,0.96,0,110,110,44
84,seq80,seq136,r_39_86_149,r_39_86_149,0.9,-1,148,149,44
30,r_52_95_78,r_37_67_129,seq86,r_52_95_78,0.92,0,78,78,45
36,r_124_15_126,seq20,seq56,r_124_15_126,0.83,0,126,126,45
14,r_130_4_134,r_149_63_154,seq2,r_149_63_154,0.48,2,156,154,45
8,r_142_102_12,seq20,r_34_88_77,r_34_88_77,0.35,25,102,77,45
43,r_51_48_164,r_96_87_174,seq133,r_51_48_164,0.86,3,167,164,45
22,r_116_14_49,r_142_102_12,r_77_121_37,r_77_121_37,0.99,17,54,37,45
37,r_112_103_166,seq119,r_76_108_63,r_112_103_166,0.85,0,166,166,45
16,r_92_138_119,r_101_148_192,seq2,r_92_138_119,1.0,0,119,119,45
21,r_100_94_161,seq120,r_55_111_47,r_100_94_161,0.67,0,161,161,45
39,r_64_3_125,seq12,seq29,r_64_3_125,0.52,0,125,125,45
1,r_125_23_108,r_85_22_3,seq110,r_125_23_108,0.86,0,108,108,45
46,r_90_140_110,seq123,seq110,r_90_140_110,0.92,1,111,110,45
25,r_77_121_37,r_96_87_174,r_116_14_49,r_77_121_37,1.0,0,37,37,45
31,r_32_97_138,seq69,seq75,r_32_97_138,0.61,4,142,138,45
41,r_37_67_129,seq36,r_76_108_63,r_37_67_129,0.68,1,130,129,45
17,r_55_111_47,seq13,seq28,r_55_111_47,1.0,-1,46,47,45
10,r_93_40_14,r_113_74_183,r_147_126_118,r_147_126_118,1.0,65,183,118,45
2,r_141_132_16,r_131_99_89,seq69,r_141_132_16,0.92,0,16,16,45
0,r_147_126_118,r_101_148_192,r_93_40_14,r_147_126_118,0.97,1,119,118,45
11,r_105_41_92,r_130_4_134,r_76_108_63,r_105_41_92,1.0,0,92,92,45
13,r_78_106_111,seq26,r_85_22_3,r_78_106_111,0.87,2,113,111,45
40,r_96_87_174,seq35,r_130_4_134,r_96_87_174,0.91,0,174,174,45
6,r_131_99_89,seq109,seq120,r_131_99_89,1.0,2,91,89,45
19,r_84_44_28,r_143_24_58,seq56,r_84_44_28,0.97,1,29,28,45
4,r_5_8_105,r_32_97_138,r_31_82_103,r_31_82_103,1.0,3,106,103,45
27,r_11_25_69,seq46,seq13,r_11_25_69,1.0,0,69,69,45
4,r_5_8_105,r_11_25_69,r_32_97_138,r_5_8_105,0.63,-56,49,105,45
47,r_9_39_79,seq26,seq38,r_9_39_79,0.85,-1,78,79,45
40,r_96_87_174,r_51_48_164,seq35,r_51_48_164,0.69,-37,127,164,45
18,r_98_104_153,seq10,seq35,r_98_104_153,0.93,1,154,153,45
38,r_60_59_26,r_98_104_153,seq26,r_60_59_26,0.86,4,30,26,45
33,r_34_88_77,r_85_22_3,seq28,r_34_88_77,0.78,3,80,77,45
64,seq26,r_31_82_103,r_76_108_63,r_31_82_103,0.85,-25,78,103,45
88,seq86,r_96_87_174,r_52_95_78,r_52_95_78,0.98,0,78,78,45
50,seq128,seq110,r_1_7_98,r_1_7_98,0.62,-2,96,98,45
20,r_80_43_10,r_96_87_174,r_129_62_132,r_129_62_132,0.99,15,147,132,45
32,r_145_61_115,seq122,r_114_68_62,r_145_61_115,0.94,0,115,115,45
34,r_114_68_62,seq133,r_76_108_63,r_114_68_62,0.99,6,68,62,45
9,r_76_108_63,r_71_58_73,r_114_68_62,r_114_68_62,0.96,16,78,62,45
96,seq120,r_100_94_161,r_147_126_118,r_147_126_118,0.79,43,161,118,45
91,seq109,r_131_99_89,seq17,r_131_99_89,1.0,2,91,89,45
49,r_129_62_132,r_71_58_73,r_85_22_3,r_71_58_73,0.72,3,76,73,45
7,r_101_148_192,r_92_138_119,r_71_58_73,r_92_138_119,0.75,-51,68,119,45
44,r_71_58_73,r_129_62_132,seq109,r_129_62_132,0.97,-59,73,132,45
23,r_31_82_103,seq26,r_5_8_105,r_31_82_103,1.0,2,105,103,45
20,r_80_43_10,r_105_41_92,r_96_87_174,r_80_43_10,0.84,0,10,10,45
82,seq69,r_32_97_138,r_30_79_61,r_30_79_61,1.0,81,142,61,45
35,r_30_79_61,r_101_148_192,seq69,r_30_79_61,1.0,1,62,61,45
12,r_1_7_98,r_31_82_103,r_84_44_28,r_31_82_103,0.99,-5,98,103,45
49,r_129_62_132,r_85_22_3,r_80_43_10,r_129_62_132,1.0,0,132,132,45
36,r_95_77_165,r_129_111_110,seq120,r_129_111_110,0.98,0,110,110,46
18,r_20_146_106,r_61_72_76,seq85,r_20_146_106,0.84,0,106,106,46
14,r_64_107_93,r_84_121_127,r_98_87_81,r_64_107_93,1.0,0,93,93,46
8,r_96_25_62,r_64_107_93,r_80_136_174,r_80_136_174,0.82,-112,62,174,46
43,r_116_134_95,r_55_39_185,r_62_138_30,r_62_138_30,0.62,65,95,30,46
37,r_79_123_172,seq130,r_137_93_130,r_137_93_130,0.59,43,173,130,46
86,seq85,r_35_75_166,r_20_146_106,r_20_146_106,1.0,64,170,106,46
16,r_98_87_81,r_36_40_147,r_11_143_35,r_11_143_35,1.0,57,92,35,46
42,r_62_138_30,r_13_30_86,seq19,r_62_138_30,0.91,0,30,30,46
21,r_55_39_185,r_116_134_95,r_13_30_86,r_13_30_86,0.88,9,95,86,46
1,r_103_76_43,r_84_121_127,r_56_22_83,r_103_76_43,0.85,84,127,43,46
46,r_112_53_80,r_20_146_106,r_38_140_60,r_112_53_80,1.0,0,80,80,46
9,r_90_135_31,r_20_146_106,seq14,r_90_135_31,0.66,0,31,31,46
59,seq14,r_142_92_193,r_90_135_31,r_90_135_31,1.0,0,31,31,46
45,r_4_119_181,r_139_133_196,r_137_93_130,r_137_93_130,0.84,53,183,130,46
11,r_80_136_174,r_96_25_62,r_137_93_130,r_80_136_174,0.95,0,174,174,46
31,r_13_30_86,r_63_91_97,seq120,r_13_30_86,1.0,0,86,86,46
10,r_59_117_132,seq8,seq1,r_59_117_132,0.87,0,132,132,46
8,r_96_25_62,r_80_136_174,r_81_97_6,r_80_136_174,0.99,0,174,174,46
4,r_137_93_130,r_4_119_181,r_115_141_198,r_137_93_130,0.66,0,130,130,46
0,r_47_34_87,r_12_99_134,seq0,r_47_34_87,0.99,0,87,87,46
63,seq148,seq21,r_6_57_50,r_6_57_50,1.0,10,60,50,46
5,r_144_74_40,r_26_149_191,r_62_138_30,r_144_74_40,0.96,0,40,40,46
20,r_61_72_76,seq32,r_10_109_112,r_61_72_76,1.0,0,76,76,46
15,r_35_75_166,seq85,r_36_40_147,r_36_40_147,0.36,23,170,147,46
48,r_18_124_180,r_4_119_181,r_33_16_7,r_18_124_180,0.65,0,180,180,46
57,seq8,r_59_117_132,r_38_140_60,r_38_140_60,1.0,54,114,60,46
6,r_10_109_112,seq106,r_61_72_76,r_61_72_76,1.0,18,94,76,46
21,r_55_39_185,r_13_30_86,r_33_16_7,r_13_30_86,0.68,100,186,86,46
2,r_38_140_60,r_55_39_185,seq8,r_38_140_60,1.0,0,60,60,46
47,r_100_17_33,r_61_72_76,seq19,r_100_17_33,0.82,2,35,33,46
40,r_63_91_97,seq1,r_115_141_198,r_63_91_97,0.73,24,121,97,46
18,r_20_146_106,r_112_53_80,r_61_72_76,r_20_146_106,0.78,-26,80,106,46
29,r_129_111_110,r_95_77_165,seq29,r_129_111_110,0.92,0,110,110,46
27,r_6_57_50,seq45,seq148,r_6_57_50,1.0,0,50,50,46
11,r_80_136_174,r_103_76_43,seq42,r_103_76_43,1.0,0,43,43,46
33,r_82_54_173,r_12_99_134,r_80_136_174,r_12_99_134,0.75,1,135,134,46
3,r_58_41_28,r_103_76_43,seq70,r_58_41_28,0.93,1,29,28,46
32,r_84_121_127,r_103_76_43,seq126,r_84_121_127,0.99,0,127,127,46
32,r_84_121_127,r_64_107_93,r_103_76_43,r_84_121_127,0.8,-35,92,127,46
52,seq130,r_79_123_172,r_35_75_166,r_79_123_172,0.47,1,173,172,46
41,r_78_102_27,r_13_30_86,seq9,r_13_30_86,0.97,-58,28,86,46
1,r_103_76_43,r_80_136_174,r_84_121_127,r_103_76_43,1.0,0,43,43,46
34,r_24_86_118,seq49,seq42,r_24_86_118,0.99,0,118,118,46
11,r_80_136_174,seq42,r_96_25_62,r_96_25_62,0.99,9,71,62,46
17,r_12_99_134,r_82_54_173,seq126,r_12_99_134,0.97,1,135,134,46
35,r_11_143_35,seq5,seq43,r_11_143_35,1.0,0,35,35,46
28,r_110_48_101,seq29,r_11_143_35,r_110_48_101,0.95,0,101,101,46
24,r_128_94_56,r_10_109_112,r_147_68_2,r_147_68_2,0.69,56,58,2,46
33,r_82_54_173,r_80_136_174,r_47_34_87,r_82_54_173,0.8,0,173,173,46
42,r_62_138_30,seq19,r_144_74_40,r_144_74_40,0.88,30,70,40,46
36,r_95_77_165,seq120,r_38_140_60,r_95_77_165,0.96,1,166,165,46
30,r_9_99_140,r_11_34_102,seq38,r_11_34_102,0.94,-6,96,102,47
51,seq3,r_92_1_114,seq60,r_92_1_114,1.0,1,115,114,47
14,r_39_43_122,r_105_18_164,r_87_133_56,r_87_133_56,0.86,67,123,56,47
53,seq135,r_0_62_108,r_13_106_90,r_0_62_108,0.52,1,109,108,47
43,r_81_30_170,seq136,r_13_106_90,r_13_106_90,0.87,70,160,90,47
54,seq136,r_81_30_170,seq60,r_81_30_170,0.65,5,175,170,47
37,r_85_63_129,r_13_106_90,r_140_71_62,r_85_63_129,0.51,-43,86,129,47
3,r_52_95_12,seq131,r_90_47_112,r_90_47_112,1.0,31,143,112,47
2,r_46_82_59,r_13_106_90,r_112_102_8,r_46_82_59,0.92,0,59,59,47
16,r_93_28_110,seq33,r_24_103_111,r_93_28_110,0.67,3,113,110,47
21,r_101_149_121,r_148_84_69,r_110_83_60,r_110_83_60,1.0,1,61,60,47
5,r_76_19_68,r_132_134_130,r_113_117_160,r_76_19_68,1.0,0,68,68,47
29,r_125_116_31,seq94,r_58_65_37,r_58_65_37,0.74,-4,33,37,47
7,r_110_83_60,r_101_149_121,seq127,r_101_149_121,1.0,1,122,121,47
45,r_90_47_112,seq23,seq72,r_90_47_112,1.0,1,113,112,47
22,r_87_133_56,seq88,seq86,r_87_133_56,1.0,0,56,56,47
19,r_7_6_94,r_105_18_164,seq88,r_7_6_94,0.68,0,94,94,47
76,seq56,r_50_77_165,seq26,r_50_77_165,0.75,6,171,165,47
38,r_2_66_103,r_8_27_14,seq23,r_2_66_103,0.95,2,105,103,47
38,r_2_66_103,r_76_19_68,r_8_27_14,r_2_66_103,0.39,-72,31,103,47
31,r_139_129_83,seq42,seq78,r_139_129_83,1.0,0,83,83,47
41,r_24_103_111,r_132_134_130,r_93_28_110,r_24_103_111,0.9,2,113,111,47
10,r_130_142_78,seq14,seq78,r_130_142_78,0.49,0,78,78,47
47,r_69_75_48,seq25,seq12,r_69_75_48,1.0,-1,47,48,47
11,r_0_62_108,seq135,r_147_109_19,r_0_62_108,0.99,1,109,108,47
39,r_148_84_69,r_101_149_121,seq127,r_101_149_121,0.9,-72,49,121,47
20,r_111_67_105,seq127,r_13_106_90,r_111_67_105,1.0,0,105,105,47
13,r_53_36_100,r_11_34_102,r_130_142_78,r_130_142_78,1.0,22,100,78,47
48,r_144_15_143,seq12,seq56,r_144_15_143,0.75,1,144,143,47
37,r_85_63_129,r_140_71_62,r_93_28_110,r_85_63_129,1.0,0,129,129,47
6,r_13_106_90,r_85_63_129,seq91,r_13_106_90,0.8,2,92,90,47
21,r_101_149_121,r_110_83_60,seq20,r_101_149_121,1.0,1,122,121,47
3,r_52_95_12,r_46_82_59,seq131,r_52_95_12,0.92,0,12,12,47
5,r_76_19_68,r_113_117_160,r_110_83_60,r_113_117_160,1.0,0,160,160,47
0,r_8_27_14,r_2_66_103,r_125_116_31,r_2_66_103,0.84,2,105,103,47
27,r_113_117_160,seq23,r_13_106_90,r_113_117_160,0.71,0,160,160,47
33,r_105_18_164,r_124_145_20,r_7_6_94,r_105_18_164,0.92,0,164,164,47
42,r_147_109_19,r_146_104_18,r_8_27_14,r_147_109_19,0.77,23,42,19,47
40,r_132_134_130,seq70,r_29_22_22,r_132_134_130,0.95,1,131,130,47
46,r_58_65_37,r_0_62_108,r_125_116_31,r_58_65_37,1.0,0,37,37,47
24,r_4_79_70,r_11_34_102,r_146_104_18,r_4_79_70,1.0,-3,67,70,47
18,r_124_145_20,r_81_30_170,seq42,r_81_30_170,0.71,-151,19,170,47
25,r_92_1_114,seq3,r_124_145_20,r_92_1_114,0.55,1,115,114,47
33,r_105_18_164,r_39_43_122,r_124_145_20,r_105_18_164,0.63,-37,127,164,47
42,r_147_109_19,r_8_27_14,r_0_62_108,r_147_109_19,0.58,88,107,19,47
0,r_8_27_14,r_124_145_20,r_2_66_103,r_8_27_14,0.66,0,14,14,47
9,r_64_123_95,r_115_96_126,seq119,r_64_123_95,1.0,0,95,95,47
49,r_17_89_44,seq91,r_29_22_22,r_17_89_44,0.66,-1,43,44,47
26,r_146_104_18,r_50_77_165,seq33,r_146_104_18,0.98,0,18,18,47
28,r_41_68_156,r_10_138_9,r_29_22_22,r_41_68_156,0.62,0,156,156,47
7,r_110_83_60,seq131,r_101_149_121,r_110_83_60,1.0,0,60,60,47
44,r_115_96_126,r_132_134_130,r_124_145_20,r_115_96_126,0.58,0,126,126,47
30,r_9_99_140,seq38,r_124_145_20,r_9_99_140,0.96,0,140,140,47
35,r_100_48_157,seq97,r_64_123_95,r_64_123_95,1.0,67,162,95,47
12,r_59_16_163,seq78,r_125_116_31,r_59_16_163,0.74,0,163,163,47
14,r_86_108_29,r_127_139_172,seq4,r_86_108_29,0.56,0,29,29,48
9,r_13_5_149,r_23_91_72,r_41_1_116,r_13_5_149,0.99,1,150,149,48
8,r_6_76_190,seq29,r_13_5_149,r_13_5_149,0.81,41,190,149,48
83,seq82,r_41_1_116,seq9,r_41_1_116,0.98,1,117,116,48
37,r_58_51_4,r_60_115_120,seq88,r_60_115_120,0.4,0,120,120,48
16,r_121_87_125,seq16,r_60_115_120,r_121_87_125,0.98,2,127,125,48
21,r_20_136_123,seq131,seq96,r_20_136_123,0.65,21,144,123,48
39,r_60_115_120,r_58_51_4,r_74_48_99,r_74_48_99,0.48,21,120,99,48
1,r_49_132_166,seq68,r_59_120_49,r_49_132_166,0.74,0,166,166,48
1,r_49_132_166,r_42_67_121,seq68,r_42_67_121,0.99,-26,95,121,48
13,r_50_107_15,r_121_87_125,seq61,r_50_107_15,0.84,0,15,15,48
5,r_8_94_138,seq73,seq88,r_8_94_138,0.74,2,140,138,48
46,r_23_91_72,seq30,r_13_5_149,r_23_91_72,1.0,0,72,72,48
42,r_33_99_137,seq131,seq138,r_33_99_137,0.94,0,137,137,48
32,r_59_120_49,r_111_104_75,r_49_132_166,r_49_132_166,0.97,4,170,166,48
45,r_144_45_95,r_49_132_166,seq16,r_144_45_95,1.0,0,95,95,48
10,r_126_97_64,r_65_72_84,seq78,r_65_72_84,0.93,-27,57,84,48
95,seq117,r_127_139_172,r_77_12_102,r_77_12_102,0.89,70,172,102,48
36,r_147_141_55,r_148_83_66,seq140,r_147_141_55,0.97,0,55,55,48
31,r_93_119_111,r_34_15_1,r_86_108_29,r_93_119_111,0.94,0,111,111,48
90,seq96,r_144_45_95,r_20_136_123,r_144_45_95,1.0,-19,76,95,48
44,r_57_55_19,r_59_120_49,seq30,r_57_55_19,0.91,0,19,19,48
26,r_128_80_170,r_31_129_129,r_69_14_151,r_69_14_151,0.85,21,172,151,48
2,r_130_85_20,r_148_83_66,seq9,r_130_85_20,0.67,-1,19,20,48
87,seq90,r_7_135_39,r_11_103_155,r_7_135_39,0.93,-6,33,39,48
19,r_101_102_44,seq0,r_58_51_4,r_101_102_44,1.0,1,45,44,48
46,r_23_91_72,r_13_5_149,r_124_134_13,r_13_5_149,1.0,1,150,149,48
15,r_77_12_102,r_34_15_1,seq117,r_77_12_102,0.99,-2,100,102,48
48,r_127_139_172,seq117,r_116_19_168,r_127_139_172,0.67,0,172,172,48
6,r_69_14_151,r_49_132_166,seq26,r_69_14_151,0.61,0,151,151,48
2,r_130_85_20,seq9,r_35_105_71,r_35_105_71,0.75,75,146,71,48
27,r_148_83_66,r_11_103_155,r_124_134_13,r_148_83_66,0.46,1,67,66,48
40,r_21_149_152,seq26,r_86_108_29,r_21_149_152,0.76,0,152,152,48
18,r_65_72_84,r_18_10_187,seq40,r_65_72_84,1.0,0,84,84,48
24,r_42_67_121,r_49_132_166,seq118,r_42_67_121,0.57,0,121,121,48
34,r_35_105_71,r_148_83_66,r_130_85_20,r_148_83_66,0.62,5,71,66,48
76,seq61,seq123,r_50_107_15,r_50_107_15,1.0,1,16,15,48
60,seq17,seq88,r_63_39_93,r_63_39_93,0.98,24,117,93,48
38,r_7_135_39,seq90,seq61,r_7_135_39,1.0,-2,37,39,48
9,r_13_5_149,r_37_53_105,r_23_91_72,r_13_5_149,0.88,-59,90,149,48
96,seq118,r_63_39_93,seq47,r_63_39_93,0.99,-26,67,93,48
22,r_37_53_105,r_18_10_187,r_66_114_6,r_37_53_105,1.0,0,105,105,48
28,r_63_39_93,seq118,seq17,r_63_39_93,0.9,2,95,93,48
7,r_111_104_75,r_75_38_162,seq90,r_111_104_75,0.91,-2,73,75,48
35,r_110_106_68,r_41_1_116,r_50_107_15,r_110_106_68,0.73,0,68,68,48
38,r_99_27_186,seq112,r_7_134_10,r_7_134_10,0.91,36,46,10,49
36,r_122_49_148,r_103_144_95,seq140,r_103_144_95,1.0,1,96,95,49
48,r_72_96_31,r_59_33_149,seq46,r_72_96_31,1.0,0,31,31,49
92,seq112,r_99_27_186,r_7_134_10,r_7_134_10,0.5,68,78,10,49
8,r_59_33_149,r_120_108_58,seq119,r_120_108_58,0.52,96,154,58,49
54,seq4,r_64_77_158,r_122_49_148,r_122_49_148,0.69,13,161,148,49
3,r_24_45_124,r_21_22_35,seq35,r_24_45_124,1.0,8,132,124,49
59,seq16,seq92,r_56_52_169,r_56_52_169,0.58,3,172,169,49
55,seq135,seq138,r_67_93_90,r_67_93_90,0.98,0,90,90,49
39,r_9_2_93,seq123,r_148_80_42,r_9_2_93,0.79,-4,89,93,49
1,r_117_110_153,seq32,seq138,r_117_110_153,0.63,0,153,153,49
46,r_84_3_132,seq53,seq43,r_84_3_132,0.94,0,132,132,49
5,r_57_115_100,r_38_149_192,seq102,r_57_115_100,0.73,0,100,100,49
46,r_84_3_132,r_137_6_99,seq53,r_137_6_99,0.99,0,99,99,49
42,r_146_118_79,seq46,r_148_80_42,r_146_118_79,0.98,0,79,79,49
89,seq106,r_60_61_123,r_100_65_164,r_60_61_123,0.41,39,162,123,49
19,r_26_139_190,seq119,r_24_45_124,r_24_45_124,0.89,66,190,124,49
95,seq116,r_56_52_169,r_57_115_100,r_57_115_100,0.9,69,169,100,49
38,r_99_27_186,r_7_134_10,r_137_6_99,r_137_6_99,0.97,87,186,99,49
40,r_97_74_27,seq147,seq75,r_97_74_27,0.65,5,32,27,49
84,seq92,r_36_31_49,seq16,r_36_31_49,0.78,0,49,49,49
10,r_86_55_115,r_73_79_179,seq70,r_86_55_115,0.69,1,116,115,49
26,r_137_6_99,r_84_3_132,r_120_108_58,r_137_6_99,0.93,0,99,99,49
12,r_89_47_39,seq123,seq107,r_89_47_39,0.67,12,51,39,49
4,r_127_13_89,seq4,seq46,r_127_13_89,0.76,6,95,89,49
0,r_58_145_77,seq140,seq92,r_58_145_77,0.95,0,77,77,49
63,seq32,r_117_110_153,r_137_6_99,r_137_6_99,0.79,54,153,99,49
13,r_103_144_95,r_122_49_148,r_42_20_34,r_103_144_95,0.96,1,96,95,49
6,r_130_111_135,seq48,seq76,r_130_111_135,0.8,0,135,135,49
20,r_51_62_3,r_60_61_123,r_148_80_42,r_148_80_42,0.96,6,48,42,49
23,r_21_22_35,r_59_33_149,r_18_142_101,r_21_22_35,1.0,0,35,35,49
27,r_67_93_90,seq95,seq135,r_67_93_90,1.0,0,90,90,49
68,seq48,seq53,r_28_14_26,r_28_14_26,0.69,149,175,26,49
36,r_122_49_148,seq140,seq4,r_122_49_148,1.0,1,149,148,49
17,r_141_98_17,r_133_129_151,seq114,r_141_98_17,0.89,2,19,17,49
22,r_18_142_101,r_21_22_35,seq76,r_18_142_101,1.0,3,104,101,49
41,r_37_17_51,r_67_93_90,r_97_74_27,r_37_17_51,1.0,1,52,51,49
2,r_133_129_151,seq71,seq107,r_133_129_151,0.7,1,152,151,49
47,r_120_108_58,r_57_115_100,seq128,r_57_115_100,1.0,-27,73,100,49
18,r_64_77_158,seq4,r_124_39_59,r_124_39_59,0.99,98,157,59,49
24,r_105_82_65,seq107,seq119,r_105_82_65,0.99,0,65,65,49
25,r_94_121_66,seq126,seq35,r_94_121_66,1.0,0,66,66,49
33,r_0_143_154,seq123,r_51_62_3,r_0_143_154,0.61,3,157,154,49
30,r_148_80_42,seq25,r_51_62_3,r_148_80_42,1.0,0,42,42,49
50,seq128,r_117_110_153,r_120_108_58,r_117_110_153,0.62,-55,98,153,49
22,r_18_142_101,r_94_121_66,r_21_22_35,r_18_142_101,0.98,-63,38,101,49
84,seq92,seq16,r_58_145_77,r_58_145_77,0.98,11,88,77,49
68,seq48,r_130_111_135,seq53,r_130_111_135,0.47,0,135,135,49
21,r_42_20_34,seq92,r_72_96_31,r_72_96_31,0.72,6,37,31,49
9,r_68_81_120,seq8,seq119,r_68_81_120,0.79,1,121,120,49
3,r_24_45_124,r_94_121_66,r_21_22_35,r_24_45_124,0.95,-78,46,124,49
43,r_124_39_59,seq70,seq12,r_124_39_59,1.0,-3,56,59,49
28,r_36_31_49,seq92,seq109,r_36_31_49,1.0,0,49,49,49
32,r_34_66_11,r_68_81_120,r_7_134_10,r_34_66_11,0.57,0,11,11,49
49,r_40_5_111,seq10,r_36_31_49,r_40_5_111,0.8,0,111,111,49
34,r_19_15_23,r_89_47_39,seq50,r_19_15_23,0.99,0,23,23,49
44,r_56_52_169,seq116,seq16,r_56_52_169,0.53,0,169,169,49
35,r_100_65_164,seq25,seq106,r_100_65_164,0.72,4,168,164,49
45,r_30_87_54,r_133_129_151,r_148_80_42,r_30_87_54,0.74,0,54,54,49
23,r_21_22_35,r_18_142_101,seq126,r_18_142_101,1.0,7,108,101,49
30,r_115_95_60,seq109,r_141_83_121,r_115_95_60,1.0,0,60,60,50
85,seq92,seq149,r_129_63_107,r_129_63_107,1.0,6,113,107,50
9,r_30_135_118,r_34_67_29,r_35_111_23,r_30_135_118,1.0,0,118,118,50
22,r_141_83_121,r_19_1_31,r_39_50_72,r_39_50_72,1.0,0,72,72,50
8,r_64_117_78,seq62,seq14,r_64_117_78,1.0,0,78,78,50
43,r_129_63_107,seq116,seq92,r_129_63_107,0.91,0,107,107,50
9,r_30_135_118,r_79_89_49,r_34_67_29,r_30_135_118,1.0,-84,34,118,50
54,seq14,r_120_49_181,r_64_117_78,r_64_117_78,1.0,20,98,78,50
37,r_138_127_69,seq44,seq17,r_138_127_69,1.0,2,71,69,50
10,r_47_29_162,r_147_4_73,r_130_72_92,r_47_29_162,0.81,2,164,162,50
55,seq143,r_12_97_153,r_25_145_52,r_25_145_52,0.98,103,155,52,50
16,r_60_24_87,seq44,seq134,r_60_24_87,0.97,1,88,87,50
39,r_37_52_25,r_39_50_72,r_13_15_50,r_37_52_25,1.0,35,60,25,50
1,r_114_105_68,r_36_51_131,seq23,r_114_105_68,1.0,0,68,68,50
17,r_71_27_11,r_40_32_101,r_79_89_49,r_79_89_49,1.0,15,64,49,50
5,r_39_50_72,seq125,r_115_95_60,r_39_50_72,0.84,0,72,72,50
42,r_40_32_101,seq48,seq61,r_40_32_101,0.66,1,102,101,50
21,r_19_1_31,seq59,r_141_83_121,r_19_1_31,0.98,0,31,31,50
80,seq77,r_147_4_73,seq68,r_147_4_73,1.0,2,75,73,50
3,r_104_136_56,r_130_72_92,r_147_4_73,r_147_4_73,0.78,46,119,73,50
32,r_0_132_94,r_35_111_23,seq38,r_0_132_94,1.0,1,95,94,50
19,r_36_51_131,r_12_97_153,r_129_63_107,r_36_51_131,0.92,0,131,131,50
12,r_11_8_30,r_64_117_78,seq137,r_11_8_30,1.0,1,31,30,50
26,r_18_98_128,seq44,r_140_142_47,r_140_142_47,0.98,9,56,47,50
14,r_140_142_47,r_40_32_101,r_18_98_128,r_140_142_47,1.0,2,49,47,50
3,r_104_136_56,r_39_50_72,r_47_29_162,r_104_136_56,0.88,10,66,56,50
10,r_47_29_162,r_73_107_141,r_147_4_73,r_147_4_73,0.99,34,107,73,50
2,r_34_67_29,r_57_21_134,r_30_135_118,r_34_67_29,1.0,0,29,29,50
14,r_140_142_47,r_18_98_128,r_7_26_130,r_140_142_47,1.0,84,131,47,50
66,seq46,r_16_133_106,r_2_108_20,r_2_108_20,0.78,1,21,20,50
0,r_147_4_73,seq77,r_47_29_162,r_147_4_73,0.99,2,75,73,50
73,seq62,r_64_117_78,seq103,r_64_117_78,1.0,0,78,78,50
11,r_7_26_130,seq43,r_0_132_94,r_7_26_130,0.64,0,130,130,50
46,r_84_128_43,r_141_83_121,r_13_15_50,r_141_83_121,0.87,-78,43,121,50
20,r_33_58_104,seq54,seq10,r_33_58_104,0.87,0,104,104,50
13,r_45_90_79,r_0_132_94,seq149,r_45_90_79,1.0,0,79,79,50
15,r_41_146_81,seq119,seq116,r_41_146_81,0.99,0,81,81,50
48,r_69_87_85,r_120_49_181,seq43,r_69_87_85,1.0,0,85,85,50
31,r_35_111_23,seq65,r_30_135_118,r_30_135_118,0.67,12,130,118,50
6,r_94_5_148,seq124,r_34_67_29,r_94_5_148,0.68,0,148,148,50
21,r_19_1_31,r_141_83_121,r_39_50_72,r_19_1_31,1.0,84,115,31,50
2,r_34_67_29,r_30_135_118,r_16_133_106,r_34_67_29,1.0,89,118,29,50
99,seq125,r_39_50_72,seq149,r_39_50_72,1.0,0,72,72,50
76,seq68,r_147_4_73,r_144_76_195,r_147_4_73,1.0,-19,54,73,50
0,r_147_4_73,r_47_29_162,r_12_97_153,r_12_97_153,0.66,11,164,153,50
51,seq137,r_147_4_73,r_11_8_30,r_11_8_30,0.62,0,30,30,50
31,r_35_111_23,r_140_142_47,r_0_132_94,r_35_111_23,1.0,0,23,23,50
45,r_85_106_24,r_18_98_128,seq86,r_85_106_24,1.0,1,25,24,50
22,r_141_83_121,r_84_128_43,r_19_1_31,r_141_83_121,0.87,-78,43,121,50
47,r_73_107_141,r_47_29_162,r_0_132_94,r_73_107_141,0.96,0,141,141,50
18,r_131_9_135,seq44,r_33_58_104,r_131_9_135,0.99,1,136,135,50
29,r_130_72_92,r_148_78_89,r_104_136_56,r_130_72_92,0.94,0,92,92,50
24,r_118_101_97,seq6,r_147_4_73,r_118_101_97,0.99,0,97,97,50
33,r_12_97_153,seq143,r_118_101_97,r_118_101_97,0.62,58,155,97,50
36,r_13_15_50,r_94_5_148,r_84_128_43,r_94_5_148,0.9,-98,50,148,50
22,r_141_83_121,r_39_50_72,r_34_67_29,r_141_83_121,1.0,1,122,121,50
38,r_120_49_181,seq14,r_12_97_153,r_120_49_181,0.3,1,182,181,50
41,r_126_93_33,r_47_29_162,seq43,r_126_93_33,1.0,0,33,33,50
4,r_2_108_20,r_30_135_118,seq46,r_2_108_20,0.56,0,20,20,50
44,r_79_89_49,seq56,r_71_27_11,r_79_89_49,1.0,0,49,49,50
17,r_71_27_11,r_131_9_135,r_40_32_101,r_71_27_11,0.99,0,11,11,50
3,r_104_136_56,r_47_29_162,r_130_72_92,r_130_72_92,0.73,-11,81,92,50
26,r_18_98_128,r_140_142_47,seq54,r_18_98_128,1.0,0,128,128,50
31,r_35_111_23,r_0_132_94,seq65,r_0_132_94,1.0,1,95,94,50
32,r_0_132_94,r_45_90_79,r_35_111_23,r_35_111_23,0.95,7,30,23,50
40,r_25_145_52,r_40_32_101,seq143,r_25_145_52,1.0,0,52,52,50
28,r_148_78_89,r_130_72_92,seq124,r_148_78_89,0.87,1,90,89,50
49,r_53_31_35,seq68,seq113,r_53_31_35,1.0,0,35,35,50
7,r_16_133_106,seq82,r_34_67_29,r_16_133_106,0.86,0,106,106,50
30,r_115_95_60,r_141_83_121,r_39_50_72,r_141_83_121,1.0,-6,115,121,50
29,r_130_72_92,r_104_136_56,r_47_29_162,r_130_72_92,0.61,59,151,92,50
30,r_86_147_68,seq82,seq24,r_86_147_68,0.99,1,69,68,51
8,r_103_28_161,seq115,r_53_67_88,r_103_28_161,0.84,0,161,161,51
43,r_70_32_138,r_102_18_181,seq51,r_70_32_138,0.48,1,139,138,51
70,seq47,seq44,r_138_98_12,r_138_98_12,0.98,0,12,12,51
37,r_112_111_71,seq38,seq52,r_112_111_71,1.0,0,71,71,51
19,r_25_145_80,r_126_137_149,r_91_129_139,r_126_137_149,0.83,3,152,149,51
39,r_48_8_134,seq101,r_117_46_145,r_48_8_134,0.99,1,135,134,51
32,r_126_137_149,r_120_96_62,seq17,r_120_96_62,0.74,-12,50,62,51
46,r_142_134_113,seq37,seq17,r_142_134_113,1.0,0,113,113,51
42,r_50_4_97,seq140,seq20,r_50_4_97,0.68,0,97,97,51
86,seq82,r_86_147_68,r_91_129_139,r_86_147_68,1.0,-21,47,68,51
32,r_126_137_149,r_25_145_80,r_19_123_40,r_19_123_40,0.55,112,152,40,51
40,r_128_10_29,r_102_18_181,r_138_98_12,r_128_10_29,1.0,0,29,29,51
41,r_102_18_181,seq65,r_139_90_87,r_139_90_87,1.0,94,181,87,51
89,seq94,r_79_130_168,r_74_125_93,r_79_130_168,1.0,0,168,168,51
3,r_92_87_91,r_70_32_138,seq55,r_92_87_91,0.9,0,91,91,51
10,r_136_6_175,r_122_30_186,r_106_149_90,r_122_30_186,0.24,-9,177,186,51
26,r_13_108_117,seq71,r_86_147_68,r_13_108_117,1.0,0,117,117,51
4,r_120_96_62,r_126_137_149,seq37,r_120_96_62,1.0,1,63,62,51
0,r_118_62_89,r_93_31_137,r_64_141_10,r_118_62_89,0.98,-3,86,89,51
63,seq33,r_29_43_182,r_139_90_87,r_139_90_87,1.0,95,182,87,51
15,r_19_123_40,r_142_134_113,r_85_12_7,r_19_123_40,0.99,0,40,40,51
73,seq52,r_53_67_88,r_112_111_71,r_112_111_71,0.56,0,71,71,51
33,r_16_34_5,r_128_10_29,r_131_2_24,r_16_34_5,0.88,15,20,5,51
6,r_146_23_184,seq52,r_131_2_24,r_146_23_184,0.33,1,185,184,51
16,r_138_98_12,r_25_145_80,seq47,r_138_98_12,1.0,0,12,12,51
27,r_53_67_88,seq52,r_103_28_161,r_53_67_88,0.97,75,163,88,51
22,r_85_12_7,r_81_68_92,r_19_123_40,r_85_12_7,0.95,85,92,7,51
32,r_126_137_149,seq17,r_25_145_80,r_126_137_149,0.73,-67,82,149,51
24,r_45_11_61,seq143,seq55,r_45_11_61,0.97,0,61,61,51
34,r_105_54_55,seq42,seq99,r_105_54_55,0.53,3,58,55,51
25,r_139_90_87,seq9,seq33,r_139_90_87,1.0,0,87,87,51
13,r_64_141_10,r_139_90_87,seq101,r_64_141_10,0.81,0,10,10,51
20,r_81_68_92,r_85_12_7,r_106_149_90,r_81_68_92,1.0,0,92,92,51
38,r_29_43_182,seq33,r_117_46_145,r_29_43_182,0.49,0,182,182,51
77,seq61,r_122_30_186,seq99,r_122_30_186,0.7,2,188,186,51
90,seq99,r_136_6_175,r_105_54_55,r_105_54_55,0.94,-6,49,55,51
17,r_3_110_77,seq148,r_64_141_10,r_64_141_10,0.87,60,70,10,51
9,r_39_7_136,seq20,r_25_145_80,r_39_7_136,0.39,-37,99,136,51
96,seq115,r_103_28_161,r_135_35_105,r_103_28_161,1.0,0,161,161,51
66,seq40,r_25_145_80,r_79_130_168,r_79_130_168,1.0,2,170,168,51
49,r_80_73_25,r_136_6_175,seq9,r_80_73_25,0.9,4,29,25,51
31,r_121_83_52,r_118_62_89,r_64_141_10,r_64_141_10,0.98,41,51,10,51
28,r_106_149_90,r_79_130_168,seq127,r_79_130_168,0.87,-78,90,168,51
29,r_131_2_24,seq107,r_16_34_5,r_131_2_24,1.0,0,24,24,51
7,r_66_144_122,seq38,r_117_46_145,r_66_144_122,1.0,-2,120,122,51
18,r_97_114_150,r_85_12_7,seq71,r_97_114_150,0.69,0,150,150,51
44,r_60_89_79,seq17,seq21,r_60_89_79,1.0,1,80,79,51
35,r_79_130_168,seq94,seq40,r_79_130_168,0.8,0,168,168,51
12,r_93_31_137,r_91_129_139,seq107,r_93_31_137,0.5,0,137,137,51
21,r_133_124_43,r_45_11_61,seq99,r_133_124_43,1.0,1,44,43,51
9,r_39_7_136,r_25_145_80,r_64_141_10,r_39_7_136,0.92,0,136,136,51
40,r_104_86_55,r_41_4_151,r_64_58_91,r_104_86_55,0.94,96,151,55,52
30,r_77_91_94,seq121,r_72_7_22,r_77_91_94,1.0,0,94,94,52
36,r_47_69_119,seq31,r_75_90_36,r_75_90_36,1.0,91,127,36,52
71,seq45,seq100,r_140_148_58,r_140_148_58,1.0,-2,56,58,52
14,r_89_54_139,r_16_17_180,seq57,r_89_54_139,0.89,0,139,139,52
43,r_143_106_97,seq128,seq3,r_143_106_97,1.0,0,97,97,52
80,seq79,r_29_105_157,r_82_71_9,r_82_71_9,0.88,4,13,9,52
39,r_22_60_80,seq111,r_72_7_22,r_22_60_80,1.0,0,80,80,52
1,r_12_145_138,r_137_127_193,seq123,r_12_145_138,0.93,1,139,138,52
5,r_41_4_151,r_132_110_140,r_104_86_55,r_104_86_55,1.0,71,126,55,52
46,r_78_109_172,seq40,r_56_5_154,r_78_109_172,0.71,0,172,172,52
22,r_16_17_180,seq42,r_22_60_80,r_16_17_180,0.97,0,180,180,52
50,seq128,r_67_149_101,r_122_11_125,r_122_11_125,0.82,7,132,125,52
40,r_104_86_55,r_47_69_119,r_41_4_151,r_104_86_55,1.0,1,56,55,52
31,r_122_11_125,seq107,seq128,r_122_11_125,1.0,0,125,125,52
10,r_93_87_179,seq14,r_125_114_88,r_93_87_179,0.61,1,180,179,52
0,r_125_114_88,r_132_110_140,seq121,r_125_114_88,0.78,0,88,88,52
11,r_27_74_199,r_16_17_180,r_126_115_147,r_126_115_147,0.9,3,150,147,52
20,r_64_58_91,seq50,r_104_86_55,r_64_58_91,1.0,0,91,91,52
37,r_72_7_22,r_75_90_36,r_19_103_146,r_72_7_22,0.95,0,22,22,52
15,r_70_30_186,seq134,r_41_4_151,r_70_30_186,0.61,-1,185,186,52
48,r_99_139_195,r_29_105_157,r_82_71_9,r_29_105_157,0.38,6,163,157,52
57,seq13,seq34,r_2_24_60,r_2_24_60,1.0,61,121,60,52
6,r_56_5_154,r_147_39_189,seq31,r_56_5_154,0.72,2,156,154,52
18,r_67_149_101,r_38_32_35,r_15_135_8,r_67_149_101,0.41,-79,22,101,52
13,r_28_33_42,r_37_20_33,seq111,r_28_33_42,1.0,-3,39,42,52
99,seq123,r_81_10_174,r_124_21_21,r_124_21_21,0.51,153,174,21,52
8,r_38_32_35,r_67_149_101,seq36,r_38_32_35,0.84,1,36,35,52
29,r_82_71_9,r_37_20_33,seq79,r_37_20_33,0.42,-23,10,33,52
27,r_6_61_185,seq18,r_56_5_154,r_56_5_154,0.9,27,181,154,52
41,r_129_68_52,seq13,seq88,r_129_68_52,1.0,0,52,52,52
2,r_92_49_57,seq94,seq26,r_92_49_57,0.82,5,62,57,52
47,r_102_97_182,seq63,seq51,r_102_97_182,0.34,0,182,182,52
78,seq63,r_92_49_57,r_75_90_36,r_75_90_36,1.0,15,51,36,52
35,r_15_135_8,r_67_149_101,r_62_46_31,r_15_135_8,0.8,93,101,8,52
33,r_81_10_174,seq123,r_0_112_170,r_81_10_174,0.71,0,174,174,52
85,seq88,seq146,r_129_68_52,r_129_68_52,1.0,-1,51,52,52
34,r_2_24_60,seq3,seq13,r_2_24_60,1.0,2,62,60,52
25,r_19_103_146,seq1,r_72_7_22,r_72_7_22,1.0,0,22,22,52
16,r_140_148_58,seq50,seq45,r_140_148_58,1.0,1,59,58,52
4,r_124_21_21,seq1,seq113,r_124_21_21,1.0,0,21,21,52
3,r_37_20_33,r_28_33_42,seq8,r_37_20_33,1.0,0,33,33,52
17,r_29_105_157,r_99_139_195,r_126_115_147,r_126_115_147,0.96,16,163,147,52
25,r_19_103_146,r_72_7_22,r_140_148_58,r_140_148_58,0.99,105,163,58,52
37,r_72_7_22,r_19_103_146,r_77_91_94,r_77_91_94,1.0,12,106,94,52
22,r_16_17_180,r_89_54_139,seq42,r_89_54_139,0.99,0,139,139,52
72,seq142,seq1,r_72_7_22,r_72_7_22,1.0,37,59,22,52
28,r_9_141_86,r_0_112_170,seq18,r_0_112_170,0.52,-97,73,170,52
49,r_55_52_113,seq57,seq25,r_55_52_113,1.0,1,114,113,52
74,seq50,r_140_148_58,r_76_66_17,r_140_148_58,0.95,1,59,58,52
93,seq113,r_81_10_174,r_124_21_21,r_124_21_21,0.64,30,51,21,52
7,r_126_115_147,seq14,r_29_105_157,r_126_115_147,0.98,2,149,147,52
18,r_67_149_101,r_15_135_8,seq144,r_67_149_101,0.85,0,101,101,52
23,r_0_112_170,seq133,seq130,r_0_112_170,0.74,0,170,170,52
32,r_76_66_17,r_89_54_139,seq50,r_76_66_17,0.98,0,17,17,52
19,r_62_46_31,r_77_91_94,r_15_135_8,r_62_46_31,0.98,1,32,31,52
42,r_75_90_36,r_55_52_113,seq63,r_75_90_36,1.0,1,37,36,52
5,r_41_4_151,r_104_86_55,r_132_110_140,r_41_4_151,0.79,0,151,151,52
30,r_144_117_114,r_115_4_112,seq0,r_144_117_114,1.0,1,115,114,53
6,r_63_20_34,seq55,seq46,r_63_20_34,0.76,12,46,34,53
99,seq125,r_34_104_43,r_41_5_123,r_41_5_123,1.0,9,132,123,53
37,r_139_23_116,r_122_102_127,r_34_104_43,r_34_104_43,0.99,75,118,43,53
1,r_129_65_41,r_31_91_36,seq96,r_129_65_41,0.6,5,46,41,53
59,seq13,r_67_103_168,r_51_94_44,r_51_94_44,0.99,124,168,44,53
55,seq7,seq120,r_137_140_28,r_137_140_28,0.99,32,60,28,53
39,r_29_78_82,seq3,r_53_66_52,r_29_78_82,1.0,0,82,82,53
46,r_109_124_89,r_25_121_151,r_81_8_81,r_109_124_89,0.99,0,89,89,53
42,r_41_5_123,seq26,seq125,r_41_5_123,0.99,0,123,123,53
45,r_40_74_83,r_9_27_70,seq39,r_40_74_83,1.0,1,84,83,53
21,r_77_89_32,r_81_8_81,seq99,r_77_89_32,0.97,0,32,32,53
13,r_107_24_23,r_88_22_107,r_83_116_47,r_107_24_23,0.9,-1,22,23,53
47,r_73_101_56,seq114,seq59,r_73_101_56,1.0,-4,52,56,53
66,seq26,r_41_5_123,r_83_116_47,r_41_5_123,1.0,0,123,123,53
3,r_131_33_79,r_70_110_97,seq143,r_131_33_79,0.6,0,79,79,53
10,r_69_76_173,r_122_102_127,r_2_48_199,r_122_102_127,0.55,4,131,127,53
90,seq143,r_123_36_96,r_131_33_79,r_131_33_79,0.98,19,98,79,53
80,seq59,seq143,r_73_101_56,r_73_101_56,1.0,-1,55,56,53
26,r_9_27_70,r_40_74_83,seq3,r_40_74_83,0.55,-5,78,83,53
4,r_12_45_153,seq58,r_81_8_81,r_81_8_81,0.59,74,155,81,53
78,seq57,r_47_43_189,r_67_103_168,r_67_103_168,0.73,21,189,168,53
0,r_25_121_151,r_47_43_189,r_2_48_199,r_25_121_151,0.67,1,152,151,53
20,r_119_79_128,r_12_45_153,seq60,r_12_45_153,0.77,-16,137,153,53
36,r_149_108_161,r_34_104_43,r_83_116_47,r_149_108_161,0.8,0,161,161,53
26,r_9_27_70,seq3,r_123_36_96,r_123_36_96,0.77,1,97,96,53
17,r_51_94_44,r_6_126_11,seq0,r_51_94_44,1.0,0,44,44,53
27,r_70_110_97,r_12_45_153,r_6_126_11,r_70_110_97,1.0,0,97,97,53
40,r_30_98_77,seq42,r_2_48_199,r_30_98_77,0.54,22,99,77,53
18,r_71_146_124,seq60,r_115_4_112,r_71_146_124,0.96,0,124,124,53
29,r_123_36_96,seq143,r_9_27_70,r_123_36_96,0.92,2,98,96,53
96,seq114,r_73_101_56,r_2_48_199,r_73_101_56,1.0,-2,54,56,53
34,r_34_104_43,r_149_108_161,r_139_23_116,r_34_104_43,0.93,75,118,43,53
34,r_34_104_43,r_41_5_123,r_149_108_161,r_34_104_43,0.99,0,43,43,53
33,r_81_8_81,r_30_98_77,r_109_124_89,r_109_124_89,1.0,2,91,89,53
23,r_54_93_10,r_2_48_199,r_40_74_83,r_54_93_10,1.0,0,10,10,53
10,r_69_76_173,r_2_48_199,r_119_79_128,r_69_76_173,0.49,-1,172,173,53
36,r_149_108_161,r_88_22_107,r_34_104_43,r_34_104_43,1.0,4,47,43,53
7,r_53_66_52,r_81_8_81,seq96,r_53_66_52,0.88,4,56,52,53
81,seq60,r_71_146_124,r_119_79_128,r_71_146_124,0.95,4,128,124,53
9,r_88_22_107,r_149_108_161,seq15,r_88_22_107,0.71,0,107,107,53
22,r_111_90_63,seq17,seq61,r_111_90_63,1.0,1,64,63,53
28,r_31_91_36,seq52,seq84,r_31_91_36,0.64,27,63,36,53
91,seq92,r_19_50_100,r_135_112_95,r_19_50_100,0.96,11,111,100,53
49,r_67_103_168,seq13,seq57,r_67_103_168,0.88,0,168,168,53
44,r_122_102_127,r_69_76_173,r_77_89_32,r_69_76_173,0.93,-42,131,173,53
43,r_137_140_28,r_19_50_100,seq7,r_137_140_28,1.0,0,28,28,53
12,r_68_85_86,seq125,seq82,r_68_85_86,1.0,0,86,86,53
23,r_54_93_10,r_40_74_83,r_6_126_11,r_40_74_83,1.0,1,84,83,53
21,r_74_75_53,r_103_55_2,r_131_90_63,r_74_75_53,0.49,1,54,53,54
14,r_27_113_99,r_63_111_96,seq39,r_63_111_96,0.78,-1,95,96,54
8,r_44_9_62,r_131_90_63,seq67,r_44_9_62,0.91,0,62,62,54
43,r_148_94_65,r_27_113_99,r_20_82_16,r_148_94_65,1.0,0,65,65,54
42,r_38_124_51,seq58,seq93,r_38_124_51,1.0,6,57,51,54
19,r_20_82_16,r_123_41_149,r_107_28_13,r_20_82_16,0.99,0,16,16,54
59,seq141,r_78_145_196,r_3_81_97,r_3_81_97,0.92,-4,93,97,54
39,r_128_53_84,seq68,r_100_10_82,r_128_53_84,0.98,0,84,84,54
1,r_63_111_96,r_19_88_145,r_20_82_16,r_63_111_96,0.93,0,96,96,54
5,r_106_138_157,r_114_62_165,seq142,r_106_138_157,0.52,1,158,157,54
46,r_100_10_82,r_137_85_155,seq105,r_100_10_82,0.99,0,82,82,54
69,seq39,seq34,r_130_45_111,r_130_45_111,1.0,2,113,111,54
31,r_32_80_50,r_127_31_68,seq141,r_32_80_50,1.0,2,52,50,54
9,r_107_28_13,r_131_90_63,r_20_82_16,r_107_28_13,0.96,4,17,13,54
41,r_57_46_67,seq48,seq142,r_57_46_67,1.0,10,77,67,54
44,r_72_24_54,r_26_91_80,seq29,r_72_24_54,1.0,0,54,54,54
3,r_19_88_145,r_77_36_169,r_64_126_186,r_19_88_145,0.65,0,145,145,54
10,r_2_8_87,seq18,seq135,r_2_8_87,0.85,1,88,87,54
40,r_17_129_45,r_123_41_149,seq1,r_17_129_45,0.98,0,45,45,54
27,r_49_66_52,r_123_41_149,seq93,r_49_66_52,1.0,0,52,52,54
4,r_121_23_154,seq98,seq0,r_121_23_154,0.9,0,154,154,54
20,r_22_108_74,seq141,seq58,r_22_108_74,1.0,0,74,74,54
15,r_12_122_124,seq7,seq104,r_12_122_124,0.99,1,125,124,54
48,r_137_85_155,r_100_10_82,seq95,r_100_10_82,0.99,1,83,82,54
47,r_77_36_169,r_19_88_145,r_115_70_144,r_77_36_169,0.64,-24,145,169,54
93,seq104,r_120_30_39,r_12_122_124,r_12_122_124,0.77,39,163,124,54
29,r_131_90_63,r_44_9_62,seq134,r_131_90_63,0.99,0,63,63,54
18,r_114_62_165,r_37_60_104,r_20_82_16,r_20_82_16,0.83,38,54,16,54
24,r_130_45_111,seq86,seq39,r_130_45_111,0.91,3,114,111,54
33,r_40_50_95,seq93,seq42,r_40_50_95,1.0,1,96,95,54
88,seq95,r_6_117_148,seq125,r_6_117_148,0.97,0,148,148,54
37,r_133_109_38,r_2_8_87,seq144,r_133_109_38,1.0,0,38,38,54
58,seq140,r_19_88_145,seq29,r_19_88_145,1.0,-19,126,145,54
32,r_127_31_68,seq135,seq86,r_127_31_68,0.48,0,68,68,54
0,r_120_30_39,seq93,seq104,r_120_30_39,1.0,0,39,39,54
34,r_37_60_104,r_114_62_165,seq99,r_37_60_104,0.49,0,104,104,54
21,r_74_75_53,r_78_145_196,r_137_85_155,r_137_85_155,0.5,14,169,155,54
60,seq142,seq21,r_57_46_67,r_57_46_67,1.0,17,84,67,54
17,r_123_41_149,seq105,r_19_88_145,r_123_41_149,0.87,0,149,149,54
94,seq105,r_123_41_149,r_128_53_84,r_128_53_84,0.7,65,149,84,54
21,r_74_75_53,r_131_90_63,r_78_145_196,r_131_90_63,0.9,1,64,63,54
28,r_13_87_127,seq7,seq96,r_13_87_127,0.86,0,127,127,54
49,r_92_61_71,r_64_126_186,r_49_66_52,r_49_66_52,1.0,30,82,52,54
7,r_3_81_97,seq104,seq141,r_3_81_97,0.57,4,101,97,54
18,r_114_62_165,r_20_82_16,seq125,r_114_62_165,0.7,0,165,165,54
23,r_143_14_150,r_101_102_161,seq134,r_143_14_150,0.59,0,150,150,54
47,r_77_36_169,r_115_70_144,r_19_88_145,r_77_36_169,0.94,0,169,169,54
30,r_3_42_174,r_13_107_151,seq85,r_13_107_151,0.77,23,174,151,55
6,r_8_25_31,r_29_120_124,seq123,r_8_25_31,1.0,1,32,31,55
16,r_46_137_81,r_18_5_67,r_75_22_113,r_75_22_113,0.96,0,113,113,55
81,seq90,r_55_88_197,r_82_23_128,r_82_23_128,1.0,11,139,128,55
37,r_71_67_65,r_82_23_128,r_142_10_46,r_71_67_65,0.99,5,70,65,55
16,r_46_137_81,seq115,r_18_5_67,r_46_137_81,0.86,1,82,81,55
21,r_13_107_151,seq94,seq128,r_13_107_151,0.58,0,151,151,55
5,r_39_118_140,seq85,r_18_5_67,r_39_118_140,0.72,0,140,140,55
46,r_51_63_164,r_7_9_175,r_82_23_128,r_7_9_175,0.86,-11,164,175,55
42,r_12_64_136,r_103_143_190,r_147_24_77,r_12_64_136,0.45,0,136,136,55
9,r_81_49_52,r_46_137_81,seq56,r_46_137_81,0.71,-25,56,81,55
45,r_91_73_119,r_103_143_190,r_147_24_77,r_91_73_119,0.68,2,121,119,55
31,r_113_106_97,r_98_15_165,r_70_129_74,r_113_106_97,0.66,0,97,97,55
81,seq90,r_124_112_58,r_55_88_197,r_124_112_58,1.0,0,58,58,55
41,r_21_144_139,seq101,r_103_143_190,r_21_144_139,0.64,0,139,139,55
3,r_82_23_128,seq69,seq90,r_82_23_128,0.94,0,128,128,55
10,r_147_24_77,seq135,seq104,r_147_24_77,0.87,2,79,77,55
48,r_102_95_15,seq56,seq109,r_102_95_15,1.0,0,15,15,55
26,r_111_76_181,seq97,r_147_24_77,r_111_76_181,0.47,0,181,181,55
8,r_77_44_12,r_46_137_81,r_119_134_63,r_77_44_12,1.0,57,69,12,55
0,r_28_41_39,r_98_15_165,r_18_5_67,r_28_41_39,0.71,0,39,39,55
20,r_98_15_165,r_113_106_97,r_87_72_64,r_98_15_165,0.99,-68,97,165,55
15,r_14_149_90,seq136,seq84,r_14_149_90,1.0,0,90,90,55
44,r_7_9_175,r_86_121_179,r_147_24_77,r_86_121_179,0.58,-2,177,179,55
62,seq26,r_119_134_63,r_142_10_46,r_119_134_63,0.53,0,63,63,55
27,r_37_33_153,seq43,seq54,r_37_33_153,0.79,1,154,153,55
25,r_68_116_26,seq138,seq30,r_68_116_26,0.9,3,29,26,55
39,r_65_52_41,r_18_5_67,r_8_25_31,r_65_52_41,0.97,0,41,41,55
2,r_108_96_130,r_103_143_190,r_70_129_74,r_108_96_130,0.77,0,130,130,55
47,r_75_22_113,r_55_88_197,r_46_137_81,r_75_22_113,0.89,0,113,113,55
40,r_60_58_73,r_108_96_130,r_81_49_52,r_60_58_73,0.91,1,74,73,55
24,r_119_134_63,seq26,r_77_44_12,r_119_134_63,1.0,0,63,63,55
34,r_87_72_64,r_98_15_165,r_37_33_153,r_87_72_64,0.55,101,165,64,55
33,r_140_32_99,seq101,seq138,r_140_32_99,1.0,3,102,99,55
50,seq0,r_48_17_89,seq43,r_48_17_89,1.0,1,90,89,55
58,seq138,seq26,r_140_32_99,r_140_32_99,0.93,6,105,99,55
20,r_98_15_165,r_87_72_64,r_108_96_130,r_98_15_165,0.92,0,165,165,55
68,seq43,r_37_33_153,r_18_5_67,r_37_33_153,0.92,-28,125,153,55
32,r_103_143_190,r_12_64_136,r_21_144_139,r_103_143_190,0.84,-54,136,190,55
38,r_48_17_89,seq0,r_114_45_186,r_48_17_89,0.99,1,90,89,55
34,r_87_72_64,r_119_134_63,r_98_15_165,r_87_72_64,1.0,0,64,64,55
29,r_142_10_46,seq93,seq26,r_142_10_46,0.91,2,48,46,55
0,r_28_41_39,r_13_107_151,r_98_15_165,r_98_15_165,0.56,-144,21,165,55
22,r_31_4_122,seq84,r_142_10_46,r_31_4_122,1.0,1,123,122,55
28,r_1_145_106,seq56,seq43,r_1_145_106,0.9,0,106,106,55
7,r_29_120_124,r_21_144_139,seq26,r_29_120_124,0.96,1,125,124,55
44,r_7_9_175,r_51_63_164,r_86_121_179,r_7_9_175,0.54,-11,164,175,55
23,r_83_57_80,r_108_96_130,r_6_89_71,r_108_96_130,0.82,-50,80,130,55
8,r_77_44_12,r_102_95_15,r_46_137_81,r_77_44_12,0.7,0,12,12,55
11,r_124_112_58,seq90,r_68_116_26,r_124_112_58,1.0,0,58,58,55
12,r_50_27_150,r_11_61_198,r_16_146_194,r_50_27_150,0.76,0,150,150,55
84,seq94,r_13_107_151,seq54,r_13_107_151,0.87,0,151,151,55
37,r_36_97_50,seq102,seq129,r_36_97_50,1.0,0,50,50,56
16,r_73_77_167,r_16_25_133,r_67_43_56,r_67_43_56,1.0,17,73,56,56
39,r_28_75_158,r_115_47_178,seq49,r_115_47_178,0.67,-20,158,178,56
1,r_145_108_94,seq53,seq58,r_145_108_94,0.99,1,95,94,56
42,r_144_29_124,seq12,r_56_27_82,r_144_29_124,0.96,1,125,124,56
29,r_131_62_33,r_148_80_74,seq81,r_131_62_33,1.0,0,33,33,56
9,r_67_43_56,seq122,r_73_77_167,r_67_43_56,1.0,0,56,56,56
80,seq79,r_41_88_155,r_67_43_56,r_67_43_56,0.94,101,157,56,56
18,r_134_19_55,r_123_138_189,seq135,r_134_19_55,0.84,-20,35,55,56
45,r_11_100_138,r_115_47_178,r_111_54_92,r_11_100_138,0.89,0,138,138,56
32,r_113_7_148,r_85_90_188,r_24_137_165,r_24_137_165,0.84,8,173,165,56
41,r_115_47_178,r_96_110_127,seq136,r_96_110_127,1.0,0,127,127,56
3,r_111_54_92,seq5,seq135,r_111_54_92,0.9,0,92,92,56
10,r_148_80_74,r_4_121_121,seq5,r_4_121_121,0.92,-47,74,121,56
26,r_32_33_126,seq125,r_114_2_10,r_32_33_126,0.79,0,126,126,56
0,r_120_31_117,r_93_26_42,r_56_27_82,r_56_27_82,0.71,3,85,82,56
11,r_23_6_102,seq128,r_67_43_56,r_23_6_102,0.78,1,103,102,56
15,r_16_25_133,seq125,r_36_97_50,r_36_97_50,1.0,90,140,50,56
6,r_96_110_127,r_11_100_138,r_145_108_94,r_11_100_138,0.78,-11,127,138,56
88,seq102,r_36_97_50,r_18_59_39,r_36_97_50,1.0,0,50,50,56
27,r_42_37_57,seq58,r_72_57_67,r_72_57_67,1.0,7,74,67,56
30,r_98_22_58,r_85_90_188,seq12,r_98_22_58,1.0,0,58,58,56
2,r_55_142_119,r_32_33_126,r_15_8_49,r_15_8_49,0.76,70,119,49,56
47,r_72_57_67,r_115_47_178,r_42_37_57,r_72_57_67,1.0,1,68,67,56
40,r_143_17_109,seq124,r_111_54_92,r_143_17_109,0.91,0,109,109,56
28,r_56_27_82,r_120_31_117,r_144_29_124,r_56_27_82,0.57,49,131,82,56
5,r_40_65_25,r_41_88_155,r_146_83_14,r_40_65_25,0.96,3,28,25,56
33,r_114_2_10,r_14_74_182,r_32_33_126,r_32_33_126,0.73,56,182,126,56
64,seq39,r_15_8_49,r_114_2_10,r_15_8_49,1.0,15,64,49,56
23,r_146_83_14,r_148_80_74,seq128,r_146_83_14,0.99,0,14,14,56
65,seq135,r_118_112_79,r_134_19_55,r_134_19_55,1.0,21,76,55,56
32,r_113_7_148,r_119_132_197,r_85_90_188,r_113_7_148,0.77,1,149,148,56
38,r_133_52_136,seq136,r_114_2_10,r_133_52_136,0.79,0,136,136,56
34,r_14_74_182,r_114_2_10,seq99,r_114_2_10,0.57,172,182,10,56
48,r_116_46_23,r_120_31_117,seq81,r_116_46_23,0.89,0,23,23,56
25,r_15_8_49,r_85_90_188,r_55_142_119,r_55_142_119,1.0,4,123,119,56
94,seq109,r_85_90_188,r_24_137_165,r_24_137_165,0.55,24,189,165,56
28,r_56_27_82,r_111_54_92,r_120_31_117,r_56_27_82,0.89,1,83,82,56
1,r_145_108_94,seq58,r_96_110_127,r_96_110_127,1.0,12,139,127,56
46,r_18_59_39,r_42_37_57,seq102,r_42_37_57,0.68,-16,41,57,56
49,r_87_70_168,seq50,r_93_26_42,r_93_26_42,0.42,128,170,42,56
36,r_130_139_40,seq81,seq53,r_130_139_40,0.95,0,40,40,56
56,seq136,r_115_47_178,r_4_121_121,r_4_121_121,0.98,62,183,121,56
7,r_48_61_171,seq124,seq58,r_48_61_171,0.79,0,171,171,56
44,r_34_117_108,seq5,r_130_139_40,r_34_117_108,0.96,0,108,108,56
0,r_120_31_117,r_56_27_82,seq107,r_56_27_82,0.68,49,131,82,56
12,r_119_132_197,r_113_7_148,r_116_46_23,r_119_132_197,0.75,-54,143,197,56
44,r_52_100_105,r_130_34_95,seq53,r_52_100_105,1.0,0,105,105,57
92,seq106,r_84_30_94,seq136,r_84_30_94,1.0,1,95,94,57
14,r_68_96_110,seq92,r_110_117_17,r_68_96_110,0.89,0,110,110,57
8,r_140_17_82,r_76_119_166,r_8_116_3,r_140_17_82,0.98,0,82,82,57
43,r_67_47_169,r_145_18_155,seq136,r_67_47_169,0.59,-13,156,169,57
15,r_97_86_41,r_94_127_102,seq12,r_97_86_41,0.93,-9,32,41,57
13,r_89_115_47,seq10,seq36,r_89_115_47,1.0,-2,45,47,57
16,r_9_44_142,seq81,r_89_115_47,r_9_44_142,0.95,1,143,142,57
39,r_114_128_109,seq11,seq31,r_114_128_109,0.88,0,109,109,57
46,r_1_69_190,r_131_144_124,seq136,r_131_144_124,0.9,-28,96,124,57
24,r_99_70_178,r_130_34_95,r_95_62_151,r_95_62_151,0.86,27,178,151,57
19,r_148_101_61,r_84_30_94,r_0_14_44,r_148_101_61,0.97,0,61,61,57
33,r_57_64_35,r_83_107_108,r_32_50_107,r_83_107_108,1.0,0,108,108,57
38,r_143_72_38,r_52_100_105,seq129,r_143_72_38,0.91,-3,35,38,57
33,r_57_64_35,seq141,r_83_107_108,r_57_64_35,1.0,-2,33,35,57
31,r_39_22_136,seq6,seq40,r_39_22_136,0.34,0,136,136,57
10,r_130_34_95,r_52_100_105,r_99_70_178,r_52_100_105,1.0,-21,84,105,57
25,r_54_90_39,r_71_134_173,seq121,r_54_90_39,0.86,0,39,39,57
26,r_66_149_134,r_131_144_124,r_58_147_176,r_66_149_134,0.7,-8,126,134,57
78,seq55,r_140_17_82,seq79,r_140_17_82,0.84,6,88,82,57
0,r_61_27_129,r_43_65_191,seq11,r_61_27_129,0.9,7,136,129,57
20,r_135_133_70,seq103,seq111,r_135_133_70,1.0,-2,68,70,57
46,r_1_69_190,seq136,r_145_18_155,r_145_18_155,0.59,35,190,155,57
44,r_52_100_105,r_143_72_38,r_130_34_95,r_143_72_38,0.99,-3,35,38,57
4,r_58_147_176,r_26_77_2,r_66_149_134,r_66_149_134,0.87,2,136,134,57
37,r_83_107_108,r_130_34_95,r_139_98_121,r_139_98_121,0.82,3,124,121,57
35,r_94_127_102,r_97_86_41,r_0_14_44,r_94_127_102,0.63,-63,39,102,57
6,r_78_80_130,r_26_77_2,r_54_90_39,r_54_90_39,0.73,97,136,39,57
48,r_3_41_57,r_118_82_84,seq103,r_3_41_57,0.95,2,59,57,57
10,r_130_34_95,r_99_70_178,r_28_37_177,r_130_34_95,0.43,79,174,95,57
4,r_58_147_176,r_0_14_44,r_26_77_2,r_0_14_44,0.97,-5,39,44,57
24,r_99_70_178,r_76_119_166,r_130_34_95,r_76_119_166,0.63,-69,97,166,57
37,r_83_107_108,r_21_102_59,r_57_64_35,r_83_107_108,1.0,-69,39,108,57
35,r_94_127_102,r_0_14_44,seq93,r_94_127_102,1.0,0,102,102,57
47,r_21_102_59,r_131_144_124,r_126_59_88,r_21_102_59,0.8,67,126,59,57
58,seq11,r_114_128_109,seq2,r_114_128_109,1.0,0,109,109,57
70,seq33,r_29_19_174,r_130_34_95,r_29_19_174,0.65,0,174,174,57
3,r_108_49_54,seq16,seq121,r_108_49_54,1.0,0,54,54,57
61,seq142,r_140_17_82,r_5_91_164,r_140_17_82,0.99,-15,67,82,57
32,r_32_50_107,seq16,r_57_64_35,r_57_64_35,0.74,68,103,35,57
77,seq53,seq16,r_113_120_133,r_113_120_133,1.0,3,136,133,57
34,r_76_119_166,r_99_70_178,r_29_19_174,r_76_119_166,0.46,-51,115,166,57
29,r_51_87_48,seq79,r_8_116_3,r_51_87_48,0.99,0,48,48,57
47,r_21_102_59,r_32_50_107,r_131_144_124,r_21_102_59,1.0,0,59,59,57
17,r_131_144_124,r_66_149_134,r_148_101_61,r_66_149_134,0.62,-8,126,134,57
34,r_76_119_166,r_29_19_174,r_94_127_102,r_76_119_166,0.98,1,167,166,57
9,r_95_62_151,seq125,seq10,r_95_62_151,0.71,7,158,151,57
37,r_83_107_108,r_57_64_35,r_130_34_95,r_83_107_108,0.89,0,108,108,57
22,r_46_42_80,r_8_116_3,seq121,r_46_42_80,0.97,0,80,80,57
28,r_113_120_133,r_95_62_151,seq53,r_113_120_133,1.0,0,133,133,57
49,r_84_30_94,seq106,seq81,r_84_30_94,0.9,1,95,94,57
7,r_145_18_155,r_67_47_169,seq75,r_145_18_155,0.83,0,155,155,57
57,seq10,r_89_115_47,r_26_77_2,r_89_115_47,1.0,-8,39,47,57
21,r_60_23_42,r_113_120_133,seq124,r_60_23_42,1.0,0,42,42,57
63,seq16,r_108_49_54,seq53,r_108_49_54,1.0,-5,49,54,57
2,r_0_14_44,r_94_127_102,r_148_101_61,r_94_127_102,0.72,0,102,102,57
4,r_58_147_176,r_66_149_134,r_0_14_44,r_0_14_44,0.69,134,178,44,57
12,r_126_59_88,seq15,r_21_102_59,r_126_59_88,0.98,-1,87,88,57
84,seq75,seq16,r_145_18_155,r_145_18_155,0.89,1,156,155,57
2,r_0_14_44,r_58_147_176,r_94_127_102,r_0_14_44,0.99,1,45,44,57
36,r_33_78_105,seq50,r_85_35_79,r_85_35_79,0.52,26,105,79,58
43,r_20_14_113,seq18,seq76,r_20_14_113,0.93,2,115,113,58
83,seq93,r_139_62_166,r_45_36_148,r_45_36_148,0.82,9,157,148,58
3,r_128_98_23,seq137,seq104,r_128_98_23,1.0,-1,22,23,58
16,r_54_60_98,seq107,r_118_122_89,r_54_60_98,1.0,0,98,98,58
21,r_61_149_81,seq30,seq107,r_61_149_81,1.0,0,81,81,58
39,r_1_138_158,seq42,r_135_41_116,r_1_138_158,0.77,0,158,158,58
1,r_13_67_175,r_140_8_22,r_52_72_107,r_13_67_175,0.73,0,175,175,58
32,r_77_105_162,r_58_32_51,seq83,r_77_105_162,1.0,0,162,162,58
18,r_95_22_44,r_129_69_83,r_140_8_22,r_95_22_44,0.65,1,45,44,58
45,r_139_62_166,seq93,r_117_147_33,r_139_62_166,0.9,0,166,166,58
19,r_85_35_79,r_70_39_117,r_33_78_105,r_85_35_79,0.92,-17,62,79,58
40,r_148_71_29,seq9,r_128_98_23,r_128_98_23,0.99,6,29,23,58
25,r_92_17_14,r_58_32_51,r_120_51_2,r_58_32_51,0.8,-37,14,51,58
31,r_125_19_63,r_66_65_193,r_5_43_6,r_125_19_63,1.0,0,63,63,58
41,r_45_36_148,r_34_48_103,r_86_25_104,r_34_48_103,1.0,1,104,103,58
10,r_21_101_178,seq94,seq30,r_21_101_178,0.39,2,180,178,58
20,r_123_116_59,seq26,seq57,r_123_116_59,1.0,0,59,59,58
5,r_117_147_33,r_86_25_104,seq16,r_117_147_33,1.0,0,33,33,58
8,r_58_32_51,r_77_105_162,r_45_36_148,r_58_32_51,0.98,111,162,51,58
73,seq57,r_139_62_166,r_123_116_59,r_123_116_59,1.0,2,61,59,58
28,r_140_8_22,r_135_41_116,seq108,r_140_8_22,1.0,3,25,22,58
46,r_142_88_42,r_75_89_198,seq15,r_142_88_42,1.0,1,43,42,58
15,r_96_121_112,r_12_79_191,r_128_98_23,r_96_121_112,0.67,0,112,112,58
8,r_58_32_51,seq145,r_77_105_162,r_58_32_51,1.0,0,51,51,58
6,r_135_41_116,r_120_51_2,r_118_122_89,r_120_51_2,0.79,115,117,2,58
4,r_141_91_47,r_139_62_166,r_142_88_42,r_141_91_47,1.0,2,49,47,58
29,r_87_136_132,seq103,seq30,r_87_136_132,0.99,0,132,132,58
1,r_13_67_175,r_133_131_164,r_140_8_22,r_140_8_22,1.0,0,22,22,58
24,r_133_131_164,seq108,r_58_32_51,r_58_32_51,1.0,113,164,51,58
33,r_3_0_154,r_66_65_193,seq2,r_3_0_154,0.7,0,154,154,58
63,seq26,r_123_116_59,seq146,r_123_116_59,1.0,0,59,59,58
42,r_29_143_10,r_135_41_116,seq63,r_29_143_10,0.99,0,10,10,58
32,r_77_105_162,r_31_55_124,r_58_32_51,r_58_32_51,0.91,48,99,51,58
34,r_31_55_124,r_77_105_162,seq10,r_31_55_124,0.87,0,124,124,58
81,seq83,seq30,r_77_105_162,r_77_105_162,1.0,0,162,162,58
17,r_12_79_191,r_96_121_112,seq82,r_96_121_112,0.99,0,112,112,58
91,seq108,r_133_131_164,r_140_8_22,r_140_8_22,0.97,142,164,22,58
56,seq15,seq110,r_141_91_47,r_141_91_47,1.0,8,55,47,58
7,r_64_68_66,r_52_72_107,r_123_116_59,r_52_72_107,0.96,-44,63,107,58
13,r_40_11_38,seq16,seq47,r_40_11_38,1.0,0,38,38,58
23,r_118_122_89,seq83,r_54_60_98,r_118_122_89,0.88,10,99,89,58
23,r_118_122_89,r_54_60_98,r_135_41_116,r_135_41_116,0.92,4,120,116,58
12,r_102_124_64,r_77_105_162,seq27,r_102_124_64,1.0,2,66,64,58
41,r_45_36_148,r_86_25_104,seq82,r_45_36_148,0.99,2,150,148,58
26,r_118_95_27,seq77,seq61,r_118_95_27,0.98,0,27,27,59
34,r_45_72_130,r_22_138_186,seq5,r_22_138_186,0.99,0,186,186,59
40,r_40_124_169,r_120_74_118,r_20_132_47,r_40_124_169,0.92,-111,58,169,59
36,r_26_80_133,r_13_33_72,r_118_95_27,r_26_80_133,0.71,0,133,133,59
92,seq102,r_114_41_4,r_65_14_15,r_65_14_15,0.97,1,16,15,59
6,r_106_128_52,r_7_64_78,r_91_100_20,r_106_128_52,1.0,0,52,52,59
8,r_36_69_102,seq90,r_6_1_24,r_36_69_102,0.7,0,102,102,59
53,seq134,r_66_51_128,r_130_19_100,r_66_51_128,0.91,0,128,128,59
2,r_144_146_108,r_28_58_146,r_116_32_51,r_144_146_108,0.75,-57,51,108,59
17,r_116_32_51,r_144_146_108,r_46_126_84,r_116_32_51,1.0,51,102,51,59
54,seq8,seq42,r_40_124_169,r_40_124_169,0.39,-44,125,169,59
14,r_147_135_34,seq111,seq53,r_147_135_34,1.0,0,34,34,59
49,r_4_96_37,r_67_142_79,seq99,r_4_96_37,0.58,1,38,37,59
16,r_141_119_160,r_27_88_55,seq143,r_141_119_160,0.83,0,160,160,59
21,r_7_64_78,r_68_37_94,r_13_33_72,r_7_64_78,1.0,0,78,78,59
15,r_68_37_94,r_130_19_100,r_94_125_19,r_68_37_94,0.67,0,94,94,59
1,r_130_19_100,r_139_63_95,seq134,r_139_63_95,0.9,2,97,95,59
5,r_60_16_116,seq42,seq12,r_60_16_116,0.98,1,117,116,59
42,r_25_104_122,r_0_76_136,r_68_37_94,r_25_104_122,0.81,0,122,122,59
45,r_83_121_74,r_145_89_187,r_65_14_15,r_83_121_74,1.0,0,74,74,59
19,r_78_123_61,r_93_109_149,seq71,r_93_109_149,0.7,-80,69,149,59
2,r_144_146_108,r_116_32_51,seq53,r_144_146_108,1.0,3,111,108,59
35,r_20_132_47,seq79,seq39,r_20_132_47,1.0,0,47,47,59
20,r_91_100_20,seq50,seq73,r_91_100_20,1.0,1,21,20,59
41,r_67_142_79,seq34,r_118_95_27,r_67_142_79,1.0,0,79,79,59
3,r_22_138_186,seq5,r_45_72_130,r_45_72_130,1.0,1,131,130,59
4,r_117_149_177,seq29,seq3,r_117_149_177,0.7,0,177,177,59
11,r_24_107_138,seq73,r_66_51_128,r_24_107_138,0.97,0,138,138,59
13,r_93_109_149,seq12,r_97_101_58,r_93_109_149,0.99,2,151,149,59
15,r_68_37_94,r_7_64_78,r_130_19_100,r_7_64_78,0.69,0,78,78,59
2,r_144_146_108,seq77,r_28_58_146,r_144_146_108,0.45,-67,41,108,59
27,r_139_63_95,seq3,r_65_14_15,r_65_14_15,0.62,126,141,15,59
17,r_116_32_51,r_15_35_6,r_144_146_108,r_116_32_51,0.99,1,52,51,59
10,r_6_1_24,seq23,r_36_69_102,r_36_69_102,1.0,42,144,102,59
27,r_139_63_95,r_130_19_100,seq3,r_139_63_95,0.57,8,103,95,59
75,seq53,seq48,r_147_135_34,r_147_135_34,0.85,15,49,34,59
43,r_94_125_19,seq53,seq49,r_94_125_19,1.0,-1,18,19,59
43,r_94_125_19,seq49,r_68_37_94,r_68_37_94,1.0,6,100,94,59
47,r_105_70_32,r_27_88_55,r_0_76_136,r_0_76_136,1.0,2,138,136,59
58,seq143,seq3,r_141_119_160,r_141_119_160,0.46,0,160,160,59
33,r_65_14_15,r_40_124_169,seq102,r_65_14_15,0.97,0,15,15,59
32,r_140_81_168,r_13_33_72,r_93_109_149,r_140_81_168,0.51,0,168,168,59
38,r_13_33_72,r_26_80_133,r_7_64_78,r_7_64_78,0.55,55,133,78,59
52,seq5,r_131_98_97,seq148,r_131_98_97,1.0,1,98,97,59
3,r_22_138_186,r_45_72_130,r_60_16_116,r_22_138_186,0.88,0,186,186,59
34,r_45_72_130,r_145_89_187,r_22_138_186,r_45_72_130,1.0,0,130,130,59
47,r_105_70_32,r_46_126_84,r_27_88_55,r_46_126_84,1.0,-52,32,84,59
54,seq8,r_40_124_169,r_66_51_128,r_40_124_169,0.71,7,176,169,59
31,r_55_85_59,r_139_63_95,r_106_128_52,r_55_85_59,0.46,0,59,59,59
22,r_54_86_117,r_27_88_55,r_97_101_58,r_54_86_117,1.0,5,122,117,59
28,r_66_51_128,seq134,seq42,r_66_51_128,0.97,0,128,128,59
44,r_0_76_136,seq75,r_105_70_32,r_0_76_136,0.99,0,136,136,59
23,r_97_101_58,seq23,seq57,r_97_101_58,0.95,9,67,58,59
10,r_6_1_24,r_36_69_102,seq23,r_6_1_24,1.0,0,24,24,59
12,r_120_74_118,seq108,seq9,r_120_74_118,0.83,0,118,118,59
36,r_70_77_75,seq84,r_97_16_66,r_97_16_66,1.0,0,66,66,60
92,seq100,r_112_72_130,seq15,r_112_72_130,1.0,0,130,130,60
43,r_126_65_186,r_145_3_198,r_94_129_39,r_94_129_39,0.61,147,186,39,60
30,r_121_147_13,r_145_3_198,r_106_127_3,r_121_147_13,0.94,-1,12,13,60
18,r_56_130_56,seq83,seq8,r_56_130_56,1.0,0,56,56,60
86,seq84,r_70_77_75,r_19_132_121,r_19_132_121,1.0,1,122,121,60
16,r_106_127_3,r_48_37_158,r_121_147_13,r_106_127_3,0.65,156,159,3,60
21,r_19_132_121,r_126_65_186,seq84,r_19_132_121,1.0,0,121,121,60
5,r_122_64_90,r_89_140_184,seq4,r_89_140_184,0.59,-101,83,184,60
42,r_107_98_126,seq57,seq75,r_107_98_126,0.98,0,126,126,60
69,seq40,seq71,r_81_23_61,r_81_23_61,0.95,2,63,61,60
45,r_85_80_77,r_131_33_190,r_81_23_61,r_85_80_77,1.0,-2,75,77,60
19,r_82_49_87,r_19_132_121,seq5,r_19_132_121,1.0,-33,88,121,60
8,r_108_17_27,seq95,seq26,r_108_17_27,1.0,0,27,27,60
11,r_102_118_182,r_144_25_31,r_87_124_8,r_87_124_8,0.6,179,187,8,60
76,seq63,r_112_72_130,seq15,r_112_72_130,1.0,0,130,130,60
31,r_10_55_114,seq96,r_114_113_96,r_10_55_114,1.0,0,114,114,60
41,r_9_137_59,seq20,seq30,r_9_137_59,0.96,1,60,59,60
89,seq93,r_103_46_118,r_2_142_97,r_2_142_97,0.71,19,116,97,60
11,r_102_118_182,r_1_34_181,r_144_25_31,r_144_25_31,0.72,-4,27,31,60
95,seq115,r_53_119_134,r_29_44_49,r_29_44_49,0.53,0,49,49,60
10,r_99_135_123,seq30,seq39,r_99_135_123,0.58,0,123,123,60
26,r_2_142_97,seq78,seq93,r_2_142_97,1.0,1,98,97,60
4,r_90_69_60,r_60_35_179,r_104_101_57,r_90_69_60,1.0,0,60,60,60
0,r_114_113_96,seq32,r_56_130_56,r_56_130_56,0.51,40,96,56,60
20,r_36_66_100,r_122_64_90,r_110_41_36,r_36_66_100,1.0,0,100,100,60
85,seq83,r_56_130_56,seq11,r_56_130_56,1.0,-9,47,56,60
48,r_6_148_132,seq5,r_61_92_55,r_61_92_55,0.91,77,132,55,60
6,r_97_16_66,r_131_33_190,seq116,r_97_16_66,1.0,1,67,66,60
27,r_61_92_55,r_60_35_179,seq133,r_61_92_55,1.0,0,55,55,60
40,r_42_18_53,r_81_23_61,seq32,r_42_18_53,1.0,0,53,53,60
7,r_94_129_39,r_48_37_158,seq12,r_94_129_39,1.0,0,39,39,60
2,r_145_3_198,r_126_65_186,r_114_113_96,r_114_113_96,0.96,89,185,96,60
24,r_28_31_110,seq8,r_121_147_13,r_28_31_110,0.49,0,110,110,60
90,seq95,seq75,r_43_128_192,r_43_128_192,0.63,-33,159,192,60
25,r_53_119_134,seq115,seq15,r_53_119_134,0.96,0,134,134,60
33,r_81_23_61,r_6_148_132,seq40,r_81_23_61,0.62,0,61,61,60
32,r_111_138_109,r_131_33_190,seq15,r_111_138_109,1.0,2,111,109,60
38,r_117_141_73,seq134,seq91,r_117_141_73,0.88,0,73,73,60
34,r_62_68_173,seq30,r_19_132_121,r_19_132_121,0.57,48,169,121,60
3,r_144_25_31,r_2_142_97,r_102_118_182,r_144_25_31,0.76,0,31,31,60
46,r_29_44_49,seq13,seq115,r_29_44_49,1.0,0,49,49,60
75,seq59,r_112_72_130,seq15,r_112_72_130,1.0,-57,73,130,60
47,r_104_101_57,seq133,seq134,r_104_101_57,0.78,0,57,57,60
81,seq75,seq71,r_107_98_126,r_107_98_126,1.0,17,143,126,60
9,r_89_140_184,r_122_64_90,seq38,r_122_64_90,1.0,-7,83,90,60
90,seq95,r_53_119_134,seq75,r_53_119_134,0.56,-17,117,134,60
22,r_60_35_179,seq57,r_144_25_31,r_144_25_31,0.75,155,186,31,60
28,r_103_46_118,seq93,r_61_92_55,r_61_92_55,0.63,64,119,55,60
49,r_50_47_156,r_60_35_179,seq40,r_50_47_156,0.77,0,156,156,60
23,r_48_37_158,r_106_127_3,r_61_92_55,r_61_92_55,1.0,106,161,55,60
90,seq95,r_108_17_27,r_53_119_134,r_108_17_27,0.6,0,27,27,60
35,r_112_72_130,seq63,seq76,r_112_72_130,0.99,0,130,130,60
30,r_22_136_136,seq98,seq38,r_22_136_136,0.69,0,136,136,61
9,r_39_51_14,seq101,r_78_59_83,r_78_59_83,1.0,1,84,83,61
92,seq105,r_30_53_157,r_117_33_132,r_117_33_132,0.64,25,157,132,61
14,r_48_68_153,r_96_102_163,r_24_84_12,r_24_84_12,1.0,142,154,12,61
8,r_30_53_157,seq105,r_1_118_30,r_30_53_157,0.65,0,157,157,61
49,r_124_46_178,r_62_88_45,r_82_5_40,r_82_5_40,0.95,18,58,40,61
43,r_147_42_172,r_116_111_161,r_39_51_14,r_147_42_172,0.59,-11,161,172,61
90,seq101,r_82_5_40,seq148,r_82_5_40,1.0,-3,37,40,61
3,r_34_8_15,r_96_102_163,r_108_142_75,r_108_142_75,0.99,88,163,75,61
40,r_86_139_196,r_17_114_38,r_24_84_12,r_17_114_38,0.99,1,39,38,61
86,seq89,r_140_149_142,r_36_3_119,r_36_3_119,0.61,23,142,119,61
21,r_14_115_173,seq6,r_76_56_74,r_14_115_173,0.71,1,174,173,61
46,r_117_33_132,seq64,seq105,r_117_33_132,0.89,0,132,132,61
5,r_125_128_47,seq95,seq6,r_125_128_47,1.0,1,48,47,61
42,r_106_127_77,r_16_133_133,seq110,r_106_127_77,1.0,0,77,77,61
45,r_76_56_74,seq129,seq23,r_76_56_74,1.0,0,74,74,61
19,r_52_66_121,r_27_50_148,seq29,r_27_50_148,0.98,-6,142,148,61
32,r_135_93_162,r_24_84_12,seq101,r_135_93_162,0.59,0,162,162,61
41,r_27_50_148,r_52_66_121,seq49,r_27_50_148,0.98,0,148,148,61
10,r_140_149_142,seq89,r_24_84_12,r_140_149_142,0.91,0,142,142,61
47,r_109_4_43,r_25_141_104,r_17_114_38,r_109_4_43,0.78,4,47,43,61
0,r_58_57_69,r_31_145_115,r_13_26_189,r_58_57_69,0.65,0,69,69,61
37,r_9_99_46,r_147_42_172,r_143_67_81,r_9_99_46,1.0,0,46,46,61
20,r_78_59_83,r_36_3_119,r_39_51_14,r_78_59_83,1.0,0,83,83,61
13,r_83_10_117,seq21,r_69_112_154,r_83_10_117,1.0,-1,116,117,61
15,r_16_133_133,seq148,r_81_85_3,r_16_133_133,0.98,0,133,133,61
2,r_82_5_40,seq101,seq100,r_82_5_40,1.0,0,40,40,61
49,r_124_46_178,r_82_5_40,r_14_115_173,r_14_115_173,0.39,5,178,173,61
48,r_35_94_18,seq70,seq121,r_35_94_18,0.99,0,18,18,61
0,r_58_57_69,r_13_26_189,r_82_5_40,r_13_26_189,0.45,0,189,189,61
9,r_39_51_14,r_27_50_148,seq101,r_39_51_14,0.79,-1,13,14,61
4,r_1_118_30,r_92_0_17,r_35_94_18,r_35_94_18,0.87,14,32,18,61
6,r_17_114_38,r_86_139_196,r_109_4_43,r_17_114_38,0.96,0,38,38,61
39,r_104_130_24,r_48_68_153,seq132,r_104_130_24,0.97,-1,23,24,61
25,r_32_146_25,r_62_88_45,seq2,r_32_146_25,0.99,0,25,25,61
18,r_13_26_189,r_72_97_100,r_58_57_69,r_13_26_189,0.87,-89,100,189,61
1,r_62_88_45,r_124_46_178,seq61,r_62_88_45,0.46,13,58,45,61
29,r_74_120_102,r_69_112_154,r_24_84_12,r_74_120_102,0.99,0,102,102,61
33,r_31_145_115,seq12,r_82_5_40,r_31_145_115,1.0,0,115,115,61
43,r_147_42_172,r_39_51_14,r_116_111_161,r_147_42_172,0.84,0,172,172,61
27,r_71_138_34,r_31_145_115,seq55,r_71_138_34,0.98,0,34,34,61
81,seq70,r_35_94_18,seq12,r_35_94_18,0.92,-3,15,18,61
3,r_34_8_15,r_82_5_40,r_96_102_163,r_34_8_15,1.0,0,15,15,61
75,seq55,seq61,r_71_138_34,r_71_138_34,1.0,0,34,34,61
32,r_135_93_162,r_80_91_145,r_24_84_12,r_135_93_162,0.58,-17,145,162,61
38,r_72_97_100,r_13_26_189,r_81_85_3,r_72_97_100,0.82,0,100,100,61
60,seq19,seq95,r_1_118_30,r_1_118_30,0.61,99,129,30,61
17,r_36_3_119,seq49,seq89,r_36_3_119,1.0,0,119,119,61
11,r_24_84_12,seq38,seq65,r_24_84_12,1.0,0,12,12,61
22,r_108_142_75,seq101,r_32_146_25,r_108_142_75,1.0,0,75,75,61
77,seq61,seq55,r_62_88_45,r_62_88_45,0.87,3,48,45,61
80,seq65,seq132,r_24_84_12,r_24_84_12,0.73,33,45,12,61
56,seq12,r_31_145_115,seq70,r_31_145_115,1.0,0,115,115,61
7,r_80_91_145,r_135_93_162,r_39_51_14,r_39_51_14,0.84,131,145,14,61
18,r_13_26_189,r_58_57_69,r_125_128_47,r_58_57_69,0.53,120,189,69,61
44,r_116_111_161,r_147_42_172,r_82_5_40,r_82_5_40,0.9,121,161,40,61
34,r_20_43_36,seq38,seq134,r_20_43_36,1.0,0,36,36,61
79,seq64,r_117_33_132,r_1_118_30,r_117_33_132,0.82,0,132,132,61
35,r_25_141_104,seq21,seq103,r_25_141_104,0.88,1,105,104,61
12,r_90_137_169,seq6,seq19,r_90_137_169,0.66,0,169,169,61
93,seq99,seq84,r_65_132_64,r_65_132_64,1.0,22,86,64,62
4,r_82_9_12,r_10_106_131,r_41_45_134,r_82_9_12,1.0,1,13,12,62
36,r_38_145_117,seq7,seq30,r_38_145_117,1.0,0,117,117,62
14,r_81_89_86,seq134,seq140,r_81_89_86,1.0,0,86,86,62
54,seq138,seq74,r_70_129_88,r_70_129_88,0.99,9,97,88,62
37,r_0_123_186,r_126_64_154,r_121_86_70,r_0_123_186,0.94,-73,113,186,62
21,r_70_129_88,seq72,r_82_9_12,r_82_9_12,0.93,76,88,12,62
39,r_65_132_64,seq25,seq99,r_65_132_64,1.0,0,64,64,62
1,r_115_135_75,seq117,seq23,r_115_135_75,1.0,0,75,75,62
80,seq59,r_111_93_106,r_94_104_143,r_94_104_143,1.0,5,148,143,62
46,r_118_1_83,r_66_54_108,r_8_12_177,r_8_12_177,0.56,-81,96,177,62
42,r_46_143_89,r_49_71_165,r_19_97_103,r_19_97_103,0.99,27,130,103,62
80,seq59,seq146,r_111_93_106,r_111_93_106,0.55,-20,86,106,62
32,r_85_137_79,r_20_124_178,r_2_144_42,r_20_124_178,0.92,0,178,178,62
69,seq31,seq146,r_29_21_73,r_29_21_73,1.0,14,87,73,62
25,r_55_107_40,r_51_122_138,seq114,r_55_107_40,0.69,1,41,40,62
89,seq80,seq131,r_39_112_35,r_39_112_35,1.0,4,39,35,62
24,r_41_45_134,r_82_9_12,seq131,r_41_45_134,0.98,0,134,134,62
35,r_6_139_112,r_136_109_46,r_2_144_42,r_6_139_112,1.0,-65,47,112,62
43,r_33_56_52,r_73_26_30,r_75_32_36,r_33_56_52,0.95,1,53,52,62
7,r_47_11_58,seq74,seq42,r_47_11_58,1.0,0,58,58,62
38,r_20_124_178,r_85_137_79,seq134,r_20_124_178,0.88,0,178,178,62
43,r_33_56_52,r_75_32_36,r_73_26_30,r_75_32_36,1.0,2,38,36,62
3,r_91_95_92,seq149,r_55_107_40,r_91_95_92,0.86,0,92,92,62
10,r_10_106_131,r_49_71_165,r_47_11_58,r_47_11_58,0.95,76,134,58,62
90,seq84,r_49_71_165,r_22_148_48,r_22_148_48,1.0,116,164,48,62
26,r_66_54_108,seq14,r_85_137_79,r_85_137_79,1.0,38,117,79,62
78,seq57,r_60_110_113,r_55_107_40,r_60_110_113,1.0,1,114,113,62
48,r_94_104_143,r_116_141_189,seq59,r_94_104_143,0.81,0,143,143,62
11,r_5_37_51,seq42,seq14,r_5_37_51,1.0,0,51,51,62
4,r_82_9_12,r_41_45_134,r_5_37_51,r_82_9_12,1.0,122,134,12,62
57,seq14,r_66_54_108,r_5_37_51,r_5_37_51,1.0,66,117,51,62
62,seq131,seq80,r_41_45_134,r_41_45_134,1.0,1,135,134,62
20,r_22_148_48,seq7,seq125,r_22_148_48,1.0,0,48,48,62
99,seq125,r_46_143_89,r_22_148_48,r_22_148_48,1.0,54,102,48,62
33,r_27_127_31,r_10_106_131,seq72,r_27_127_31,1.0,0,31,31,62
46,r_118_1_83,r_8_12_177,seq146,r_8_12_177,0.81,-34,143,177,62
2,r_19_97_103,seq52,r_46_143_89,r_19_97_103,1.0,0,103,103,62
40,r_111_93_106,r_66_54_108,seq59,r_111_93_106,0.95,1,107,106,62
18,r_49_71_165,seq84,seq13,r_49_71_165,0.52,-1,164,165,62
29,r_8_12_177,r_121_86_70,r_118_1_83,r_118_1_83,0.57,24,107,83,62
35,r_6_139_112,r_2_144_42,seq63,r_6_139_112,1.0,0,112,112,62
68,seq30,r_51_122_138,r_38_145_117,r_38_145_117,1.0,27,144,117,62
32,r_85_137_79,seq131,r_20_124_178,r_85_137_79,1.0,0,79,79,62
38,r_20_124_178,r_6_139_112,r_85_137_79,r_20_124_178,0.93,-93,85,178,62
34,r_116_141_189,r_50_96_194,r_2_144_42,r_2_144_42,0.95,147,189,42,62
27,r_83_147_43,r_20_124_178,r_66_54_108,r_20_124_178,0.54,-80,98,178,62
24,r_41_45_134,r_47_11_58,r_82_9_12,r_82_9_12,0.6,1,13,12,62
81,seq63,seq67,r_6_139_112,r_6_139_112,1.0,18,130,112,62
13,r_61_128_32,r_44_119_153,seq63,r_61_128_32,0.9,0,32,32,62
37,r_0_123_186,r_121_86_70,r_49_71_165,r_0_123_186,0.83,0,186,186,62
22,r_29_21_73,r_116_141_189,seq31,r_29_21_73,0.98,1,74,73,62
49,r_121_86_70,r_8_12_177,r_27_127_31,r_27_127_31,0.97,43,74,31,62
27,r_83_147_43,seq84,r_20_124_178,r_83_147_43,1.0,-1,42,43,62
23,r_120_108_188,seq58,r_44_119_153,r_120_108_188,0.18,0,188,188,62
29,r_8_12_177,r_118_1_83,r_66_54_108,r_8_12_177,0.48,-30,147,177,62
17,r_2_144_42,r_6_139_112,r_85_137_79,r_2_144_42,1.0,68,110,42,62
79,seq58,r_120_108_188,r_36_18_10,r_36_18_10,0.95,178,188,10,62
29,r_8_12_177,r_66_54_108,r_91_95_92,r_8_12_177,0.97,2,179,177,62
17,r_2_144_42,r_44_119_153,r_6_139_112,r_2_144_42,1.0,0,42,42,62
45,r_130_69_44,r_44_119_153,seq3,r_130_69_44,1.0,0,44,44,62
36,r_113_55_135,seq65,r_97_30_47,r_113_55_135,0.86,0,135,135,63
16,r_34_73_27,seq119,seq122,r_34_73_27,1.0,0,27,27,63
92,seq117,r_61_126_170,r_27_95_109,r_27_95_109,1.0,61,170,109,63
76,seq64,r_136_38_117,r_142_31_31,r_142_31_31,0.98,0,31,31,63
43,r_110_84_128,r_87_71_174,seq146,r_110_84_128,0.93,1,129,128,63
37,r_5_21_77,r_136_38_117,r_140_54_71,r_5_21_77,1.0,0,77,77,63
1,r_107_58_184,seq69,r_129_104_143,r_107_58_184,0.41,0,184,184,63
5,r_13_9_90,seq88,r_92_103_58,r_92_103_58,1.0,37,95,58,63
12,r_51_53_34,seq46,seq69,r_51_53_34,1.0,0,34,34,63
32,r_142_31_31,r_136_38_117,seq120,r_136_38_117,1.0,-13,104,117,63
7,r_129_104_143,r_1_52_177,r_144_28_108,r_144_28_108,0.75,37,145,108,63
45,r_140_54_71,r_107_58_184,seq66,r_140_54_71,1.0,1,72,71,63
19,r_1_52_177,r_76_23_124,seq117,r_76_23_124,0.94,0,124,124,63
30,r_115_80_192,seq67,r_86_19_25,r_86_19_25,1.0,21,46,25,63
27,r_114_139_18,r_144_28_108,r_77_132_191,r_144_28_108,0.96,3,111,108,63
95,seq120,seq64,r_142_31_31,r_142_31_31,1.0,36,67,31,63
24,r_14_10_41,seq24,seq131,r_14_10_41,1.0,1,42,41,63
35,r_125_83_22,r_107_58_184,r_62_135_7,r_125_83_22,0.98,0,22,22,63
41,r_18_133_138,seq37,r_35_111_100,r_18_133_138,0.94,0,138,138,63
67,seq41,seq112,r_128_29_57,r_128_29_57,1.0,28,85,57,63
89,seq109,r_13_9_90,r_138_36_45,r_138_36_45,0.99,36,81,45,63
23,r_136_38_117,r_142_31_31,r_114_139_18,r_136_38_117,0.98,0,117,117,63
26,r_99_116_141,seq131,seq56,r_99_116_141,0.89,0,141,141,63
48,r_106_45_28,seq63,seq15,r_106_45_28,1.0,0,28,28,63
78,seq66,seq118,r_140_54_71,r_140_54_71,1.0,8,79,71,63
63,seq25,r_87_71_174,r_13_9_90,r_13_9_90,1.0,66,156,90,63
25,r_144_28_108,r_27_95_109,r_114_139_18,r_114_139_18,0.99,12,30,18,63
11,r_35_111_100,seq50,seq122,r_35_111_100,0.82,0,100,100,63
29,r_92_103_58,r_62_135_7,r_72_59_67,r_92_103_58,1.0,0,58,58,63
32,r_142_31_31,r_33_101_163,r_136_38_117,r_142_31_31,0.94,1,32,31,63
13,r_87_71_174,seq25,r_14_10_41,r_14_10_41,1.0,136,177,41,63
15,r_76_23_124,r_1_52_177,r_142_31_31,r_76_23_124,0.89,0,124,124,63
2,r_86_19_25,r_129_104_143,r_115_80_192,r_86_19_25,1.0,1,26,25,63
46,r_82_134_35,r_110_84_128,seq22,r_82_134_35,0.91,1,36,35,63
69,seq46,r_51_53_34,seq25,r_51_53_34,1.0,0,34,34,63
0,r_138_36_45,r_75_42_32,seq109,r_138_36_45,1.0,0,45,45,63
33,r_62_135_7,r_92_103_58,r_125_83_22,r_92_103_58,1.0,0,58,58,63
28,r_141_16_146,r_1_52_177,r_78_74_159,r_141_16_146,0.7,31,177,146,63
6,r_27_95_109,r_77_132_191,r_124_85_194,r_27_95_109,1.0,3,112,109,63
85,seq91,r_13_9_90,r_138_36_45,r_138_36_45,0.95,16,61,45,63
8,r_128_29_57,seq37,seq41,r_128_29_57,1.0,0,57,57,63
29,r_92_103_58,r_144_28_108,r_62_135_7,r_62_135_7,0.98,3,10,7,63
31,r_60_143_23,r_136_38_117,seq47,r_60_143_23,0.91,0,23,23,63
47,r_61_126_170,seq117,seq20,r_61_126_170,0.45,0,170,170,63
40,r_98_4_175,seq22,seq148,r_98_4_175,0.74,0,175,175,63
74,seq57,r_44_48_144,r_89_6_66,r_89_6_66,0.81,78,144,66,63
18,r_72_59_67,r_129_104_143,r_92_103_58,r_92_103_58,1.0,9,67,58,63
27,r_114_139_18,r_77_132_191,r_136_38_117,r_136_38_117,0.75,18,135,117,63
27,r_114_139_18,r_60_143_23,r_144_28_108,r_114_139_18,0.99,0,18,18,63
38,r_77_132_191,r_27_95_109,r_114_139_18,r_77_132_191,0.94,-79,112,191,63
77,seq65,r_113_55_135,seq63,r_113_55_135,0.96,-55,80,135,63
34,r_94_81_155,r_107_58_184,r_89_6_66,r_107_58_184,0.52,-29,155,184,63
25,r_144_28_108,r_114_139_18,seq63,r_144_28_108,1.0,3,111,108,63
22,r_89_6_66,seq112,seq17,r_89_6_66,1.0,2,68,66,63
28,r_141_16_146,seq15,r_1_52_177,r_141_16_146,0.83,0,146,146,63
49,r_39_105_113,r_76_23_124,seq20,r_39_105_113,1.0,0,113,113,63
4,r_2_26_43,seq121,seq63,r_2_26_43,0.89,2,45,43,63
56,seq17,r_44_48_144,r_89_6_66,r_89_6_66,0.73,9,75,66,63
7,r_129_104_143,r_72_59_67,r_1_52_177,r_72_59_67,0.96,0,67,67,63
44,r_44_48_144,seq57,seq65,r_44_48_144,0.86,0,144,144,63
20,r_137_108_39,r_93_130_114,seq7,r_137_108_39,0.75,12,51,39,63
23,r_136_38_117,r_5_21_77,r_142_31_31,r_136_38_117,0.57,-40,77,117,63
91,seq147,r_13_9_90,r_138_36_45,r_138_36_45,1.0,3,48,45,63
21,r_97_30_47,seq24,seq68,r_97_30_47,0.6,-3,44,47,63
30,r_93_22_130,r_88_120_135,r_46_62_134,r_46_62_134,0.74,0,134,134,64
51,seq2,r_116_106_146,r_114_131_76,r_114_131_76,0.97,70,146,76,64
36,r_99_127_68,seq97,seq73,r_99_127_68,0.78,2,70,68,64
53,seq5,r_63_13_186,r_135_9_79,r_135_9_79,0.98,108,187,79,64
83,seq78,seq143,r_24_111_38,r_24_111_38,0.92,51,89,38,64
37,r_10_84_189,r_93_22_130,r_112_55_59,r_112_55_59,0.94,16,75,59,64
59,seq145,r_136_87_185,r_11_130_145,r_11_130_145,0.9,42,187,145,64
39,r_88_120_135,r_93_22_130,r_0_115_28,r_93_22_130,0.76,4,134,130,64
1,r_140_52_98,r_11_130_145,r_124_113_23,r_140_52_98,0.8,1,99,98,64
42,r_124_113_23,r_92_95_149,r_140_52_98,r_124_113_23,0.9,126,149,23,64
33,r_63_13_186,seq5,r_72_104_121,r_72_104_121,0.95,65,186,121,64
64,seq27,r_140_52_98,r_110_54_9,r_110_54_9,0.83,3,12,9,64
11,r_38_66_133,r_33_56_26,r_68_102_11,r_38_66_133,1.0,0,133,133,64
14,r_3_43_19,r_32_71_110,r_7_12_10,r_3_43_19,0.92,1,20,19,64
46,r_0_115_28,r_140_52_98,seq132,r_0_115_28,0.87,-8,20,28,64
31,r_74_39_138,seq20,seq25,r_74_39_138,0.74,0,138,138,64
41,r_72_104_121,seq134,r_112_55_59,r_112_55_59,0.76,2,61,59,64
89,seq91,r_114_131_76,seq141,r_114_131_76,1.0,0,76,76,64
3,r_122_35_90,r_21_50_86,seq118,r_122_35_90,1.0,1,91,90,64
10,r_135_9_79,seq82,seq134,r_135_9_79,0.97,1,80,79,64
15,r_68_102_11,r_140_52_98,seq19,r_68_102_11,0.65,0,11,11,64
4,r_21_50_86,r_122_35_90,seq70,r_21_50_86,0.97,0,86,86,64
0,r_114_131_76,seq91,r_99_127_68,r_114_131_76,1.0,0,76,76,64
5,r_59_144_53,r_149_40_84,r_33_56_26,r_59_144_53,0.87,1,54,53,64
13,r_16_105_175,seq128,r_135_9_79,r_16_105_175,0.49,1,176,175,64
48,r_108_31_57,r_63_13_186,seq26,r_108_31_57,1.0,4,61,57,64
44,r_117_139_35,r_93_22_130,seq49,r_117_139_35,0.93,0,35,35,64
2,r_33_56_26,r_93_22_130,r_38_66_133,r_33_56_26,1.0,0,26,26,64
6,r_11_130_145,seq27,seq145,r_11_130_145,0.66,0,145,145,64
2,r_33_56_26,r_38_66_133,r_59_144_53,r_38_66_133,0.94,-19,114,133,64
41,r_72_104_121,r_112_55_59,r_108_31_57,r_72_104_121,0.87,0,121,121,64
47,r_116_106_146,seq2,r_137_60_3,r_116_106_146,0.82,0,146,146,64
28,r_24_111_38,r_32_71_110,r_45_51_193,r_24_111_38,0.95,2,40,38,64
18,r_17_148_179,seq44,r_21_50_86,r_21_50_86,1.0,94,180,86,64
24,r_46_62_134,seq49,r_93_22_130,r_46_62_134,0.89,0,134,134,64
25,r_32_71_110,seq19,r_8_86_41,r_32_71_110,0.99,1,111,110,64
33,r_63_13_186,r_108_31_57,seq5,r_108_31_57,1.0,4,61,57,64
28,r_24_111_38,r_45_51_193,r_109_83_48,r_109_83_48,0.64,15,63,48,64
27,r_109_83_48,r_135_9_79,r_24_111_38,r_109_83_48,0.97,1,49,48,64
11,r_38_66_133,r_59_144_53,r_33_56_26,r_33_56_26,1.0,2,28,26,64
61,seq20,r_74_39_138,seq58,r_74_39_138,0.95,0,138,138,64
32,r_136_87_185,seq145,r_38_66_133,r_38_66_133,1.0,54,187,133,64
16,r_112_55_59,r_146_1_120,r_3_43_19,r_112_55_59,0.97,-5,54,59,64
34,r_149_40_84,seq138,r_96_18_18,r_149_40_84,1.0,0,84,84,64
17,r_92_95_149,r_124_113_23,seq48,r_92_95_149,0.8,0,149,149,64
9,r_146_1_120,r_53_15_167,seq118,r_146_1_120,0.96,4,124,120,64
22,r_53_15_167,seq34,seq90,r_53_15_167,0.78,1,168,167,64
20,r_57_4_31,r_63_13_186,r_68_102_11,r_57_4_31,0.85,0,31,31,64
7,r_28_29_77,seq85,r_114_131_76,r_28_29_77,0.97,0,77,77,64
12,r_129_79_153,seq97,r_38_66_133,r_38_66_133,1.0,21,154,133,64
36,r_91_95_146,seq78,seq18,r_91_95_146,0.78,0,146,146,65
14,r_41_56_188,r_108_117_172,r_66_70_45,r_66_70_45,0.99,87,132,45,65
8,r_10_65_97,seq23,r_51_148_83,r_10_65_97,1.0,0,97,97,65
53,seq7,seq9,r_10_65_97,r_10_65_97,1.0,29,126,97,65
43,r_1_37_50,seq42,r_107_11_139,r_1_37_50,0.47,12,62,50,65
37,r_99_48_66,r_76_137_171,seq80,r_76_137_171,0.81,-103,68,171,65
59,seq17,seq106,r_122_88_98,r_122_88_98,1.0,18,116,98,65
39,r_6_123_134,seq87,r_131_67_10,r_6_123_134,1.0,0,134,134,65
1,r_140_46_158,seq130,r_122_88_98,r_122_88_98,0.57,60,158,98,65
5,r_108_117_172,r_41_56_188,r_75_28_112,r_108_117_172,0.75,0,172,172,65
46,r_128_94_165,seq125,r_73_132_110,r_128_94_165,0.56,0,165,165,65
41,r_147_45_12,seq62,seq42,r_147_45_12,0.88,2,14,12,65
45,r_86_27_106,r_135_121_148,seq104,r_86_27_106,0.53,5,111,106,65
15,r_8_60_186,r_51_148_83,r_73_132_110,r_8_60_186,0.97,0,186,186,65
3,r_22_84_126,r_122_88_98,r_66_70_45,r_22_84_126,0.54,-58,68,126,65
10,r_136_110_48,r_25_74_195,seq87,r_136_110_48,0.5,12,60,48,65
82,seq83,r_142_127_87,seq111,r_142_127_87,0.84,-32,55,87,65
26,r_142_127_87,seq83,seq102,r_142_127_87,0.93,0,87,87,65
4,r_49_71_118,seq4,seq13,r_49_71_118,0.64,1,119,118,65
63,seq21,r_8_60_186,r_133_90_44,r_133_90_44,1.0,104,148,44,65
73,seq59,r_76_137_171,r_2_40_130,r_76_137_171,1.0,0,171,171,65
20,r_85_113_64,r_10_65_97,seq38,r_85_113_64,1.0,0,64,64,65
15,r_8_60_186,seq9,r_51_148_83,r_51_148_83,1.0,43,126,83,65
0,r_68_31_63,r_133_90_44,seq20,r_133_90_44,0.94,1,45,44,65
6,r_51_148_83,seq102,r_8_60_186,r_51_148_83,1.0,0,83,83,65
27,r_107_11_139,r_6_123_134,r_1_37_50,r_6_123_134,1.0,-74,60,134,65
9,r_66_70_45,r_47_98_60,seq130,r_66_70_45,0.99,0,45,45,65
47,r_75_28_112,seq78,r_1_37_50,r_75_28_112,0.82,1,113,112,65
38,r_97_105_22,r_109_15_65,seq111,r_97_105_22,1.0,0,22,22,65
18,r_135_121_148,seq149,r_75_28_112,r_75_28_112,1.0,46,158,112,65
24,r_126_77_162,seq125,seq138,r_126_77_162,0.59,0,162,162,65
21,r_131_67_10,r_8_60_186,seq35,r_131_67_10,0.96,0,10,10,65
25,r_44_100_145,seq87,r_85_113_64,r_85_113_64,1.0,81,145,64,65
88,seq102,r_51_148_83,r_142_127_87,r_51_148_83,0.53,0,83,83,65
50,seq130,r_14_52_179,r_66_70_45,r_66_70_45,0.99,134,179,45,65
6,r_51_148_83,r_8_60_186,r_10_65_97,r_51_148_83,0.76,103,186,83,65
14,r_41_56_188,r_66_70_45,r_133_90_44,r_41_56_188,1.0,0,188,188,65
34,r_36_30_133,seq20,seq143,r_36_30_133,1.0,0,133,133,65
32,r_133_90_44,r_68_31_63,seq78,r_133_90_44,1.0,0,44,44,65
22,r_109_15_65,seq116,r_68_31_63,r_109_15_65,1.0,0,65,65,65
91,seq106,r_8_60_186,r_5_29_71,r_5_29_71,1.0,41,112,71,65
3,r_22_84_126,r_66_70_45,seq134,r_22_84_126,1.0,0,126,126,65
7,r_129_57_92,seq138,r_25_74_195,r_129_57_92,1.0,0,92,92,65
44,r_47_98_60,seq144,r_36_30_133,r_36_30_133,1.0,8,141,133,65
23,r_43_61_102,seq55,seq87,r_43_61_102,0.8,0,102,102,65
58,seq16,r_76_137_171,r_12_26_16,r_12_26_16,0.98,6,22,16,65
35,r_73_132_110,seq78,r_97_105_22,r_73_132_110,1.0,0,110,110,65
12,r_122_88_98,seq79,seq17,r_122_88_98,1.0,0,98,98,65
30,r_134_41_143,seq6,r_23_105_55,r_23_105_55,1.0,94,149,55,66
44,r_39_149_13,r_125_59_177,seq5,r_39_149_13,0.91,0,13,13,66
14,r_67_60_180,r_40_43_109,seq145,r_40_43_109,0.88,0,109,109,66
8,r_143_120_101,r_95_96_160,seq93,r_143_120_101,1.0,0,101,101,66
43,r_125_59_177,r_47_136_5,r_97_113_90,r_47_136_5,0.72,166,171,5,66
27,r_74_123_76,seq6,seq9,r_74_123_76,0.38,57,133,76,66
37,r_3_144_56,r_80_137_155,r_10_34_70,r_10_34_70,0.82,4,74,70,66
71,seq48,seq6,r_109_85_86,r_109_85_86,1.0,3,89,86,66
16,r_10_34_70,r_86_116_104,r_3_144_56,r_3_144_56,0.83,16,72,56,66
21,r_91_49_128,r_25_92_198,r_97_113_90,r_97_113_90,0.83,48,138,90,66
39,r_117_26_120,r_71_58_153,seq100,r_117_26_120,0.98,0,120,120,66
46,r_109_85_86,seq27,seq48,r_109_85_86,1.0,0,86,86,66
80,seq70,r_95_96_160,r_97_113_90,r_97_113_90,0.91,71,161,90,66
45,r_94_29_115,r_98_115_22,r_84_102_14,r_94_29_115,0.97,0,115,115,66
31,r_11_135_38,seq93,seq57,r_11_135_38,0.63,0,38,38,66
55,seq9,r_42_133_54,r_36_56_39,r_36_56_39,0.57,15,54,39,66
41,r_22_124_164,seq104,r_23_105_55,r_23_105_55,0.98,112,167,55,66
3,r_142_66_91,seq15,seq6,r_142_66_91,0.97,0,91,91,66
9,r_106_128_42,seq57,r_129_17_48,r_129_17_48,1.0,1,49,48,66
4,r_32_2_83,seq30,seq76,r_32_2_83,0.74,2,85,83,66
0,r_80_137_155,r_146_99_179,r_83_107_64,r_83_107_64,1.0,100,164,64,66
63,seq21,seq0,r_71_58_153,r_71_58_153,0.94,0,153,153,66
73,seq54,r_119_35_172,r_80_137_155,r_119_35_172,0.72,1,173,172,66
11,r_131_101_28,seq21,r_10_34_70,r_131_101_28,0.45,91,119,28,66
17,r_129_17_48,r_86_116_104,seq7,r_129_17_48,1.0,0,48,48,66
20,r_71_58_153,r_117_26_120,r_98_115_22,r_117_26_120,0.76,-27,93,120,66
98,seq121,r_138_118_139,r_83_107_64,r_83_107_64,1.0,75,139,64,66
15,r_146_99_179,seq88,seq9,r_146_99_179,0.26,4,183,179,66
48,r_138_118_139,seq121,seq111,r_138_118_139,0.93,-2,137,139,66
54,seq7,r_32_2_83,r_129_17_48,r_129_17_48,1.0,3,51,48,66
25,r_23_105_55,seq104,seq110,r_23_105_55,1.0,1,56,55,66
19,r_55_122_17,r_50_38_94,seq37,r_55_122_17,0.95,1,18,17,66
27,r_74_123_76,seq62,seq6,r_74_123_76,0.99,0,76,76,66
2,r_97_113_90,r_140_114_199,seq61,r_97_113_90,0.98,6,96,90,66
40,r_79_31_147,seq7,r_23_105_55,r_79_31_147,0.84,0,147,147,66
18,r_18_130_65,r_50_38_94,seq75,r_18_130_65,0.94,6,71,65,66
35,r_86_116_104,r_74_123_76,r_97_113_90,r_86_116_104,0.68,0,104,104,66
33,r_46_19_189,seq72,r_50_38_94,r_50_38_94,0.79,95,189,94,66
20,r_71_58_153,r_98_115_22,seq21,r_71_58_153,1.0,0,153,153,66
61,seq145,r_148_65_118,r_67_60_180,r_148_65_118,0.99,-2,116,118,66
32,r_83_107_64,r_32_2_83,seq63,r_83_107_64,1.0,1,65,64,66
77,seq63,r_46_19_189,r_83_107_64,r_83_107_64,1.0,76,140,64,66
34,r_147_8_71,r_25_92_198,r_84_102_14,r_147_8_71,0.98,1,72,71,66
47,r_36_56_39,r_117_26_120,seq6,r_36_56_39,1.0,0,39,39,66
24,r_42_133_54,seq9,seq69,r_42_133_54,0.92,0,54,54,66
22,r_40_43_109,r_67_60_180,r_109_85_86,r_109_85_86,1.0,23,109,86,66
91,seq100,seq33,r_117_26_120,r_117_26_120,1.0,12,132,120,66
5,r_51_53_27,r_119_35_172,r_16_68_195,r_51_53_27,1.0,0,27,27,66
7,r_50_38_94,seq78,r_109_85_86,r_109_85_86,1.0,15,101,86,66
23,r_127_82_72,seq6,seq1,r_127_82_72,0.91,0,72,72,66
35,r_86_116_104,seq9,r_74_123_76,r_74_123_76,1.0,0,76,76,66
28,r_84_102_14,seq64,seq139,r_84_102_14,1.0,0,14,14,66
23,r_127_82_72,seq1,r_148_65_118,r_148_65_118,0.97,1,119,118,66
41,r_19_7_45,r_9_124_163,r_116_29_17,r_19_7_45,1.0,0,45,45,67
40,r_128_103_155,r_45_108_29,seq97,r_128_103_155,0.48,0,155,155,67
30,r_90_80_129,r_149_138_152,r_25_79_10,r_90_80_129,0.99,1,130,129,67
36,r_62_81_181,seq131,r_67_18_105,r_67_18_105,1.0,79,184,105,67
9,r_45_108_29,r_128_103_155,r_36_12_74,r_45_108_29,0.77,126,155,29,67
14,r_122_111_171,seq2,seq4,r_122_111_171,0.78,0,171,171,67
8,r_105_120_165,seq59,seq51,r_105_120_165,0.65,0,165,165,67
53,seq131,r_62_81_181,r_55_65_133,r_55_65_133,1.0,51,184,133,67
43,r_107_30_110,seq8,r_67_18_105,r_107_30_110,1.0,0,110,110,67
54,seq4,r_125_126_169,r_19_7_45,r_19_7_45,0.98,40,85,45,67
3,r_101_86_11,r_46_83_124,r_117_37_154,r_117_37_154,0.98,1,155,154,67
16,r_55_65_133,seq137,r_19_7_45,r_55_65_133,1.0,0,133,133,67
42,r_93_31_83,seq110,seq99,r_93_31_83,1.0,0,83,83,67
19,r_85_148_96,r_149_138_152,r_44_76_31,r_85_148_96,0.89,22,118,96,67
95,seq110,r_93_31_83,seq141,r_93_31_83,1.0,-11,72,83,67
22,r_112_6_70,r_117_37_154,r_32_71_109,r_112_6_70,0.94,39,109,70,67
39,r_116_29_17,r_125_126_169,r_9_124_163,r_116_29_17,0.84,152,169,17,67
31,r_74_41_88,seq42,seq141,r_74_41_88,1.0,0,88,88,67
39,r_116_29_17,r_149_138_152,r_125_126_169,r_116_29_17,0.99,0,17,17,67
29,r_96_121_21,r_61_98_37,seq27,r_96_121_21,1.0,0,21,21,67
10,r_142_58_149,r_125_126_169,r_77_130_107,r_142_58_149,0.58,0,149,149,67
26,r_68_115_143,seq27,seq35,r_68_115_143,0.9,0,143,143,67
4,r_149_138_152,r_90_80_129,r_44_76_31,r_44_76_31,0.67,99,130,31,67
11,r_117_37_154,seq144,r_101_86_11,r_117_37_154,0.97,0,154,154,67
20,r_91_84_89,r_62_81_181,r_96_121_21,r_91_84_89,1.0,1,90,89,67
13,r_43_133_172,seq118,r_68_115_143,r_68_115_143,1.0,30,173,143,67
46,r_125_126_169,r_116_29_17,r_119_53_102,r_125_126_169,0.73,0,169,169,67
21,r_25_79_10,r_134_104_170,r_90_80_129,r_90_80_129,0.95,23,152,129,67
85,seq75,r_145_10_190,r_56_3_71,r_56_3_71,1.0,4,75,71,67
3,r_101_86_11,r_20_48_199,r_149_138_152,r_101_86_11,0.71,1,12,11,67
46,r_125_126_169,seq4,r_116_29_17,r_116_29_17,0.98,23,40,17,67
27,r_32_71_109,seq135,r_112_6_70,r_32_71_109,0.96,0,109,109,67
23,r_47_60_46,r_20_48_199,seq137,r_47_60_46,1.0,0,46,46,67
47,r_5_16_92,seq0,r_43_133_172,r_5_16_92,0.86,1,93,92,67
21,r_25_79_10,r_119_53_102,r_134_104_170,r_25_79_10,0.85,0,10,10,67
25,r_77_130_107,seq51,r_5_16_92,r_77_130_107,1.0,1,108,107,67
33,r_24_64_126,seq59,r_77_130_107,r_77_130_107,0.68,20,127,107,67
24,r_129_140_26,r_36_12_74,r_92_102_194,r_129_140_26,1.0,0,26,26,67
32,r_9_124_163,seq54,r_116_29_17,r_9_124_163,0.71,1,164,163,67
38,r_67_18_105,seq73,r_107_30_110,r_67_18_105,1.0,5,110,105,67
34,r_119_53_102,seq141,seq137,r_119_53_102,1.0,0,102,102,67
3,r_101_86_11,r_149_138_152,r_46_83_124,r_149_138_152,0.58,-93,59,152,67
17,r_26_28_167,r_143_22_8,r_23_113_135,r_26_28_167,0.74,3,170,167,67
4,r_149_138_152,r_44_76_31,seq97,r_149_138_152,0.93,0,152,152,67
40,r_128_103_155,seq21,r_45_108_29,r_45_108_29,1.0,1,30,29,67
9,r_45_108_29,r_67_18_105,r_128_103_155,r_45_108_29,1.0,0,29,29,67
0,r_44_76_31,r_68_115_143,seq15,r_44_76_31,1.0,0,31,31,67
22,r_112_6_70,r_55_65_133,r_117_37_154,r_112_6_70,0.97,0,70,70,67
47,r_5_16_92,r_43_133_172,r_77_130_107,r_5_16_92,0.47,27,119,92,67
28,r_39_88_76,r_55_65_133,r_96_121_21,r_39_88_76,1.0,0,76,76,67
91,seq97,r_43_133_172,r_128_103_155,r_128_103_155,0.53,5,160,155,67
49,r_46_83_124,seq40,r_119_53_102,r_119_53_102,1.0,24,126,102,67
7,r_36_12_74,seq118,r_45_108_29,r_36_12_74,1.0,0,74,74,67
44,r_56_3_71,r_9_124_163,seq75,r_56_3_71,1.0,0,71,71,67
35,r_17_33_95,r_145_10_190,r_93_31_83,r_17_33_95,1.0,0,95,95,67
12,r_94_147_120,seq118,r_13_69_134,r_94_147_120,1.0,0,120,120,67
2,r_61_98_37,r_136_100_1,seq8,r_61_98_37,1.0,-1,36,37,67
1,r_92_102_194,r_55_65_133,r_129_140_26,r_129_140_26,0.95,0,26,26,67
36,r_36_59_159,seq138,seq40,r_36_59_159,0.72,0,159,159,68
9,r_24_106_61,r_84_96_154,r_46_140_98,r_24_106_61,0.99,64,125,61,68
14,r_61_48_100,seq117,seq63,r_61_48_100,0.95,0,100,100,68
8,r_124_145_66,seq108,r_98_142_124,r_124_145_66,1.0,0,66,66,68
53,seq6,r_74_95_162,r_18_123_76,r_18_123_76,0.67,87,163,76,68
30,r_60_147_192,r_77_27_72,r_10_128_25,r_60_147_192,0.53,-136,56,192,68
37,r_109_0_50,r_81_62_136,r_127_93_70,r_127_93_70,0.91,12,82,70,68
16,r_92_13_112,seq143,seq42,r_92_13_112,0.88,0,112,112,68
21,r_69_104_87,r_131_134_69,r_127_93_70,r_131_134_69,1.0,19,88,69,68
5,r_127_93_70,seq49,r_109_0_50,r_127_93_70,0.99,3,73,70,68
46,r_121_16_63,r_102_75_85,seq19,r_121_16_63,0.79,1,64,63,68
32,r_25_8_180,r_17_65_80,seq125,r_25_8_180,0.27,4,184,180,68
69,seq44,r_20_105_169,r_98_142_124,r_98_142_124,0.96,46,170,124,68
45,r_141_72_77,r_149_90_143,seq80,r_141_72_77,0.76,11,88,77,68
39,r_30_133_51,seq12,seq107,r_30_133_51,1.0,3,54,51,68
19,r_129_126_147,r_109_0_50,seq108,r_129_126_147,0.45,3,150,147,68
17,r_136_89_20,r_99_119_187,seq66,r_136_89_20,1.0,0,20,20,68
1,r_10_128_25,seq54,r_60_147_192,r_10_128_25,0.87,5,30,25,68
31,r_33_34_102,r_98_142_124,seq122,r_33_34_102,0.81,0,102,102,68
41,r_17_65_80,seq117,r_25_8_180,r_17_65_80,0.96,0,80,80,68
10,r_146_11_174,seq137,seq112,r_146_11_174,0.63,2,176,174,68
26,r_4_144_60,seq118,r_103_83_62,r_4_144_60,0.99,0,60,60,68
78,seq64,r_88_73_172,r_131_134_69,r_88_73_172,0.64,4,176,172,68
0,r_46_140_98,r_20_105_169,r_24_106_61,r_46_140_98,0.98,1,99,98,68
20,r_149_90_143,r_25_8_180,seq80,r_149_90_143,0.61,0,143,143,68
13,r_18_123_76,seq32,seq117,r_18_123_76,0.9,-3,73,76,68
98,seq122,r_99_119_187,r_33_34_102,r_33_34_102,0.99,34,136,102,68
48,r_98_142_124,r_33_34_102,r_124_145_66,r_124_145_66,0.89,36,102,66,68
45,r_141_72_77,seq80,r_81_62_136,r_81_62_136,0.8,-3,133,136,68
27,r_57_76_122,seq64,r_120_68_86,r_57_76_122,1.0,0,122,122,68
34,r_135_91_29,r_99_119_187,seq55,r_135_91_29,0.91,4,33,29,68
3,r_100_85_45,r_84_96_154,r_9_132_21,r_100_85_45,0.99,0,45,45,68
2,r_148_39_68,seq110,r_7_115_115,r_148_39_68,0.63,5,73,68,68
41,r_17_65_80,r_25_8_180,r_52_22_142,r_52_22_142,0.97,42,184,142,68
47,r_77_27_72,r_60_147_192,seq51,r_77_27_72,0.97,1,73,72,68
40,r_97_26_94,seq51,seq55,r_97_26_94,1.0,0,94,94,68
18,r_114_50_176,r_102_75_85,r_129_126_147,r_102_75_85,0.83,91,176,85,68
29,r_101_29_73,seq143,r_136_89_20,r_101_29_73,1.0,0,73,73,68
25,r_2_47_111,seq94,seq118,r_2_47_111,0.99,1,112,111,68
33,r_81_62_136,r_109_0_50,r_141_72_77,r_81_62_136,0.85,0,136,136,68
8,r_124_145_66,r_98_142_124,r_31_23_126,r_124_145_66,1.0,59,125,66,68
32,r_25_8_180,r_149_90_143,r_17_65_80,r_25_8_180,0.58,-100,80,180,68
43,r_9_132_21,r_61_48_100,seq67,r_9_132_21,0.86,0,21,21,68
9,r_24_106_61,seq42,r_84_96_154,r_24_106_61,1.0,1,62,61,68
49,r_74_95_162,seq6,seq32,r_74_95_162,0.49,1,163,162,68
7,r_35_116_88,seq107,r_131_134_69,r_35_116_88,0.98,2,90,88,68
44,r_7_115_115,r_31_23_126,r_148_39_68,r_31_23_126,0.86,0,126,126,68
48,r_98_142_124,r_124_145_66,seq44,r_124_145_66,0.54,58,124,66,68
35,r_31_23_126,r_102_75_85,r_124_145_66,r_102_75_85,1.0,41,126,85,68
12,r_84_96_154,r_131_134_69,r_127_93_70,r_127_93_70,0.99,85,155,70,68
30,r_126_125_64,r_71_57_63,seq77,r_126_125_64,0.87,0,64,64,69
36,r_70_49_119,seq146,seq55,r_70_49_119,1.0,1,120,119,69
8,r_99_116_176,r_14_42_146,seq55,r_14_42_146,0.98,1,147,146,69
3,r_74_78_194,r_133_13_158,r_59_107_152,r_59_107_152,0.75,16,168,152,69
59,seq147,r_51_12_171,r_18_111_93,r_51_12_171,0.5,-76,95,171,69
19,r_109_64_67,r_51_12_171,seq61,r_51_12_171,0.92,1,172,171,69
16,r_11_62_88,seq45,r_91_15_15,r_11_62_88,1.0,0,88,88,69
39,r_139_72_187,r_91_15_15,r_99_116_176,r_99_116_176,0.94,11,187,176,69
5,r_51_12_171,r_18_111_93,r_109_64_67,r_109_64_67,0.72,0,67,67,69
46,r_66_100_170,seq118,seq6,r_66_100_170,0.52,1,171,170,69
19,r_109_64_67,r_74_78_194,r_51_12_171,r_109_64_67,0.96,0,67,67,69
3,r_74_78_194,r_109_64_67,r_133_13_158,r_109_64_67,0.99,20,87,67,69
14,r_56_141_35,r_66_100_170,seq146,r_56_141_35,0.63,5,40,35,69
45,r_148_80_43,seq6,r_133_13_158,r_148_80_43,0.51,112,155,43,69
4,r_5_95_73,seq81,r_138_41_199,r_5_95_73,1.0,0,73,73,69
0,r_46_60_86,seq26,r_112_8_37,r_46_60_86,1.0,0,86,86,69
31,r_36_134_27,seq6,seq90,r_36_134_27,0.99,1,28,27,69
23,r_30_135_56,seq140,seq142,r_30_135_56,1.0,1,57,56,69
13,r_93_137_110,seq33,r_96_104_79,r_96_104_79,0.96,32,111,79,69
98,seq121,r_136_131_153,seq81,r_136_131_153,0.86,-58,95,153,69
15,r_96_104_79,r_10_123_173,r_87_108_191,r_96_104_79,1.0,0,79,79,69
49,r_71_57_63,r_37_54_147,r_0_52_89,r_37_54_147,0.48,0,147,147,69
35,r_136_131_153,r_46_60_86,r_69_19_36,r_136_131_153,1.0,0,153,153,69
6,r_59_107_152,seq65,seq38,r_59_107_152,0.79,0,152,152,69
48,r_98_130_167,r_21_25_105,r_23_24_44,r_98_130_167,0.96,-114,53,167,69
5,r_51_12_171,r_109_64_67,r_0_52_89,r_109_64_67,0.7,104,171,67,69
27,r_128_39_129,seq84,seq142,r_128_39_129,0.74,0,129,129,69
87,seq85,r_37_54_147,r_0_52_89,r_0_52_89,0.99,14,103,89,69
22,r_112_8_37,r_136_131_153,r_46_60_86,r_112_8_37,0.91,115,152,37,69
37,r_17_101_139,r_7_105_108,seq122,r_7_105_108,0.94,-64,44,108,69
40,r_21_25_105,r_98_130_167,seq75,r_21_25_105,0.99,0,105,105,69
45,r_148_80_43,r_70_49_119,r_2_149_138,r_148_80_43,1.0,3,46,43,69
43,r_2_149_138,r_148_80_43,r_69_19_36,r_2_149_138,0.78,0,138,138,69
33,r_18_111_93,seq48,seq147,r_18_111_93,0.59,1,94,93,69
48,r_98_130_167,r_23_24_44,r_133_13_158,r_23_24_44,0.66,122,166,44,69
32,r_7_105_108,seq55,r_96_104_79,r_7_105_108,1.0,0,108,108,69
38,r_14_42_146,r_99_116_176,r_103_40_1,r_14_42_146,0.95,0,146,146,69
29,r_23_24_44,r_46_60_86,r_98_130_167,r_23_24_44,1.0,0,44,44,69
34,r_87_108_191,seq89,r_96_104_79,r_96_104_79,1.0,11,90,79,69
75,seq55,r_7_105_108,r_99_116_176,r_7_105_108,1.0,0,108,108,69
45,r_148_80_43,r_2_149_138,seq6,r_2_149_138,0.55,-1,137,138,69
9,r_138_41_199,seq84,r_5_95_73,r_5_95_73,1.0,23,96,73,69
96,seq118,r_66_100_170,r_103_40_1,r_66_100_170,0.98,2,172,170,69
10,r_145_86_50,r_74_78_194,seq48,r_145_86_50,0.85,0,50,50,69
29,r_23_24_44,r_98_130_167,r_11_62_88,r_11_62_88,0.7,79,167,88,69
28,r_0_52_89,r_91_15_15,seq85,r_0_52_89,1.0,0,89,89,69
22,r_112_8_37,seq73,r_136_131_153,r_112_8_37,1.0,0,37,37,69
49,r_71_57_63,r_126_125_64,r_37_54_147,r_71_57_63,0.99,0,63,63,69
44,r_37_54_147,seq85,r_46_60_86,r_37_54_147,0.53,0,147,147,69
7,r_22_79_33,r_98_130_167,r_143_127_3,r_22_79_33,1.0,0,33,33,69
43,r_2_149_138,seq6,r_148_80_43,r_148_80_43,0.65,2,45,43,69
35,r_136_131_153,seq121,r_46_60_86,r_46_60_86,1.0,8,94,86,69
30,r_77_118_143,seq116,seq8,r_77_118_143,0.76,1,144,143,70
9,r_109_32_42,r_37_139_32,r_29_15_133,r_109_32_42,0.54,90,132,42,70
29,r_103_124_36,r_85_38_84,seq90,r_103_124_36,0.46,-9,27,36,70
8,r_137_107_104,r_106_10_144,seq27,r_137_107_104,0.63,8,112,104,70
43,r_141_13_74,seq148,seq27,r_141_13_74,0.96,0,74,74,70
37,r_102_110_100,seq71,seq148,r_102_110_100,0.96,1,101,100,70
10,r_85_38_84,r_25_24_145,r_69_56_112,r_25_24_145,0.69,0,145,145,70
55,seq138,seq111,r_66_121_98,r_66_121_98,1.0,37,135,98,70
21,r_80_76_103,r_106_10_144,r_149_58_68,r_106_10_144,0.99,-48,96,144,70
46,r_66_121_98,seq92,seq138,r_66_121_98,0.96,1,99,98,70
45,r_20_53_136,r_73_82_141,r_40_1_186,r_20_53_136,0.61,0,136,136,70
45,r_20_53_136,r_11_142_90,r_73_82_141,r_11_142_90,0.99,0,90,90,70
7,r_25_24_145,r_85_38_84,r_73_82_141,r_25_24_145,0.98,0,145,145,70
19,r_11_142_90,r_20_53_136,r_103_124_36,r_11_142_90,0.98,0,90,90,70
39,r_146_96_56,r_112_2_163,r_63_140_115,r_146_96_56,0.63,107,163,56,70
31,r_134_115_184,seq126,r_28_42_91,r_134_115_184,0.35,0,184,184,70
41,r_94_4_88,r_127_30_117,r_103_124_36,r_94_4_88,0.89,0,88,88,70
3,r_46_123_131,seq131,seq47,r_46_123_131,0.85,5,136,131,70
86,seq90,r_106_10_144,r_103_124_36,r_106_10_144,0.6,-117,27,144,70
10,r_85_38_84,seq144,r_25_24_145,r_85_38_84,0.96,4,88,84,70
20,r_79_21_47,r_122_60_132,seq71,r_79_21_47,1.0,0,47,47,70
16,r_37_139_32,seq78,r_65_86_134,r_65_86_134,0.91,-4,130,134,70
4,r_29_15_133,seq64,r_109_32_42,r_109_32_42,0.6,97,139,42,70
11,r_127_30_117,r_112_2_163,seq35,r_127_30_117,0.82,1,118,117,70
0,r_97_52_14,seq27,r_33_16_10,r_97_52_14,0.82,-2,12,14,70
13,r_40_1_186,r_45_3_165,r_122_60_132,r_45_3_165,0.91,-5,160,165,70
48,r_112_2_163,r_127_30_117,r_146_96_56,r_112_2_163,0.54,-101,62,163,70
6,r_106_10_144,r_137_107_104,r_87_100_20,r_137_107_104,0.48,8,112,104,70
27,r_17_31_45,seq144,seq75,r_17_31_45,0.99,1,46,45,70
36,r_34_7_46,r_51_9_142,seq108,r_34_7_46,1.0,-1,45,46,70
2,r_28_42_91,seq148,seq68,r_28_42_91,0.47,10,101,91,70
47,r_63_140_115,r_23_130_152,r_146_96_56,r_63_140_115,0.95,3,118,115,70
40,r_48_119_95,seq129,r_122_60_132,r_48_119_95,0.96,10,105,95,70
18,r_23_130_152,seq90,seq61,r_23_130_152,0.53,0,152,152,70
24,r_73_82_141,seq8,r_34_7_46,r_34_7_46,1.0,95,141,46,70
48,r_112_2_163,r_146_96_56,r_102_110_100,r_102_110_100,0.59,63,163,100,70
5,r_87_100_20,r_29_15_133,seq136,r_87_100_20,0.93,3,23,20,70
39,r_146_96_56,r_77_118_143,r_112_2_163,r_146_96_56,1.0,1,57,56,70
32,r_45_3_165,r_40_1_186,r_102_110_100,r_102_110_100,0.89,65,165,100,70
38,r_91_62_135,seq138,seq8,r_91_62_135,0.71,0,135,135,70
6,r_106_10_144,r_87_100_20,seq74,r_106_10_144,0.97,0,144,144,70
96,seq117,seq71,r_105_128_93,r_105_128_93,0.99,2,95,93,70
49,r_105_128_93,seq136,seq117,r_105_128_93,0.99,0,93,93,70
7,r_25_24_145,r_127_30_117,r_85_38_84,r_25_24_145,0.66,-57,88,145,70
44,r_101_67_119,seq129,seq92,r_101_67_119,0.85,3,122,119,70
23,r_51_9_142,seq74,r_33_16_10,r_51_9_142,0.66,2,144,142,70
16,r_37_139_32,r_133_113_193,seq78,r_37_139_32,0.92,-1,31,32,70
35,r_69_56_112,r_106_10_144,r_146_96_56,r_69_56_112,0.88,0,112,112,70
12,r_84_54_190,r_134_115_184,r_77_118_143,r_84_54_190,0.38,-7,183,190,70
27,r_146_100_44,r_32_134_49,r_64_14_7,r_146_100_44,1.0,0,44,44,71
92,seq107,seq124,r_142_43_123,r_142_43_123,1.0,37,160,123,71
54,seq132,r_18_116_150,r_92_144_120,r_92_144_120,0.83,18,138,120,71
37,r_9_22_80,seq91,seq108,r_9_22_80,0.99,0,80,80,71
59,seq17,r_80_62_168,seq0,r_80_62_168,0.99,0,168,168,71
40,r_63_84_47,seq66,seq27,r_63_84_47,1.0,0,47,47,71
23,r_141_147_149,seq86,r_83_76_197,r_141_147_149,0.98,0,149,149,71
28,r_105_126_24,r_127_13_51,seq123,r_105_126_24,0.99,0,24,24,71
71,seq40,seq11,r_117_98_61,r_117_98_61,1.0,68,129,61,71
15,r_51_4_29,seq56,seq8,r_51_4_29,1.0,0,29,29,71
39,r_138_33_74,seq8,seq120,r_138_33_74,1.0,5,79,74,71
1,r_16_114_184,r_45_72_26,r_125_39_172,r_45_72_26,0.73,162,188,26,71
1,r_16_114_184,r_15_121_131,r_45_72_26,r_15_121_131,0.61,-3,128,131,71
5,r_60_28_93,r_44_61_164,r_109_78_39,r_44_61_164,1.0,-71,93,164,71
42,r_85_140_129,seq0,seq24,r_85_140_129,0.35,-6,123,129,71
7,r_45_72_26,seq120,r_77_68_101,r_77_68_101,0.48,2,103,101,71
8,r_42_118_54,seq66,seq7,r_42_118_54,1.0,0,54,54,71
45,r_18_116_150,seq132,seq131,r_18_116_150,0.56,-7,143,150,71
19,r_139_57_64,r_142_43_123,r_83_76_197,r_139_57_64,0.72,0,64,64,71
93,seq108,seq123,r_9_22_80,r_9_22_80,1.0,4,84,80,71
41,r_38_1_10,r_52_106_181,seq128,r_38_1_10,0.91,1,11,10,71
95,seq111,r_6_89_182,r_136_31_86,r_6_89_182,0.79,1,183,182,71
67,seq30,r_103_26_110,seq111,r_103_26_110,0.98,0,110,110,71
7,r_45_72_26,seq108,seq120,r_45_72_26,0.94,8,34,26,71
3,r_115_12_91,r_60_28_93,r_127_13_51,r_115_12_91,0.67,0,91,91,71
26,r_77_68_101,r_16_114_184,r_45_72_26,r_45_72_26,0.57,56,82,26,71
72,seq135,r_92_144_120,seq148,r_92_144_120,0.96,0,120,120,71
16,r_127_13_51,r_85_140_129,r_115_12_91,r_115_12_91,1.0,33,124,91,71
16,r_127_13_51,r_41_90_56,r_85_140_129,r_127_13_51,1.0,0,51,51,71
73,seq48,r_44_61_164,seq66,r_44_61_164,1.0,0,164,164,71
6,r_142_43_123,r_141_147_149,seq56,r_142_43_123,0.96,1,124,123,71
98,seq123,seq108,r_105_126_24,r_105_126_24,1.0,8,32,24,71
51,seq128,r_38_1_10,r_74_101_155,r_74_101_155,0.85,10,165,155,71
87,seq86,r_125_39_172,r_45_72_26,r_45_72_26,0.86,146,172,26,71
93,seq108,r_45_72_26,seq123,r_45_72_26,0.96,2,28,26,71
49,r_3_143_25,seq11,seq49,r_3_143_25,0.99,0,25,25,71
20,r_54_110_17,r_5_104_163,seq94,r_54_110_17,0.88,-4,13,17,71
2,r_46_81_67,seq135,seq21,r_46_81_67,1.0,0,67,67,71
24,r_36_93_139,r_6_89_182,seq11,r_36_93_139,0.67,0,139,139,71
33,r_80_62_168,seq17,r_51_4_29,r_80_62_168,0.61,0,168,168,71
32,r_92_144_120,seq135,r_139_57_64,r_92_144_120,0.98,0,120,120,71
38,r_103_26_110,seq30,seq2,r_103_26_110,0.96,0,110,110,71
52,seq2,seq34,r_103_26_110,r_103_26_110,1.0,0,110,110,71
34,r_99_112_109,seq30,seq58,r_99_112_109,1.0,-4,105,109,71
17,r_5_104_163,seq119,r_45_72_26,r_5_104_163,0.74,0,163,163,71
31,r_32_134_49,seq97,seq128,r_32_134_49,1.0,2,51,49,71
56,seq7,r_87_50_195,r_42_118_54,r_42_118_54,1.0,91,145,54,71
44,r_15_121_131,r_16_114_184,r_113_149_130,r_16_114_184,1.0,-53,131,184,71
23,r_141_147_149,r_142_43_123,seq86,r_142_43_123,0.76,1,124,123,71
25,r_95_67_191,seq29,r_20_130_19,r_20_130_19,1.0,0,19,19,71
35,r_96_71_71,r_16_114_184,seq25,r_96_71_71,0.93,1,72,71,71
22,r_20_130_19,seq59,r_95_67_191,r_20_130_19,1.0,1,20,19,71
12,r_10_19_185,seq69,r_45_72_26,r_45_72_26,0.99,160,186,26,71
14,r_109_78_39,seq102,r_83_76_197,r_109_78_39,0.99,0,39,39,71
37,r_11_44_55,seq131,seq14,r_11_44_55,1.0,1,56,55,72
30,r_129_32_144,seq56,r_43_58_63,r_43_58_63,0.57,82,145,63,72
50,seq130,r_35_108_43,r_121_45_27,r_121_45_27,1.0,9,36,27,72
36,r_122_24_92,r_129_32_144,r_132_124_59,r_129_32_144,1.0,-51,93,144,72
14,r_31_0_153,seq145,r_134_144_11,r_31_0_153,0.47,4,157,153,72
61,seq146,r_48_120_7,r_33_55_35,r_33_55_35,1.0,11,46,35,72
21,r_38_66_60,r_50_115_160,seq42,r_38_66_60,0.96,0,60,60,72
1,r_52_21_165,seq9,r_132_124_59,r_132_124_59,0.91,108,167,59,72
5,r_90_76_137,seq34,seq131,r_90_76_137,0.99,0,137,137,72
42,r_73_62_118,seq116,r_49_99_40,r_73_62_118,0.98,0,118,118,72
45,r_136_125_131,r_92_1_170,seq63,r_136_125_131,0.83,2,133,131,72
39,r_10_98_18,r_72_6_167,seq7,r_10_98_18,1.0,1,19,18,72
9,r_49_99_40,r_46_87_168,seq20,r_49_99_40,1.0,0,40,40,72
15,r_12_97_66,r_13_71_191,r_133_104_127,r_133_104_127,1.0,14,141,127,72
11,r_50_115_160,r_43_58_63,r_38_66_60,r_43_58_63,0.58,97,160,63,72
66,seq28,seq102,r_132_124_59,r_132_124_59,1.0,78,137,59,72
38,r_83_2_175,r_43_58_63,r_92_1_170,r_83_2_175,0.8,-1,174,175,72
94,seq106,r_33_55_35,seq63,r_33_55_35,1.0,0,35,35,72
3,r_135_77_171,seq131,r_47_149_57,r_135_77_171,0.66,0,171,171,72
4,r_148_27_58,r_129_32_144,r_10_98_18,r_10_98_18,0.85,40,58,18,72
10,r_43_58_63,seq3,r_35_108_43,r_43_58_63,0.74,7,70,63,72
33,r_128_78_172,r_57_25_17,seq8,r_128_78_172,1.0,1,173,172,72
32,r_74_30_44,seq79,seq41,r_74_30_44,0.65,5,49,44,72
26,r_132_124_59,r_135_77_171,seq28,r_132_124_59,1.0,1,60,59,72
0,r_72_6_167,seq14,r_129_32_144,r_72_6_167,0.73,0,167,167,72
11,r_50_115_160,r_38_66_60,r_43_58_63,r_50_115_160,0.95,-100,60,160,72
13,r_93_26_119,r_128_78_172,r_110_142_31,r_93_26_119,0.83,0,119,119,72
46,r_59_81_47,r_33_55_35,r_107_113_107,r_107_113_107,1.0,3,110,107,72
46,r_59_81_47,r_50_115_160,r_33_55_35,r_50_115_160,0.68,-113,47,160,72
15,r_12_97_66,r_52_21_165,r_13_71_191,r_12_97_66,0.73,0,66,66,72
2,r_92_1_170,seq117,r_69_67_166,r_92_1_170,1.0,0,170,170,72
48,r_18_54_109,seq88,seq53,r_18_54_109,0.99,0,109,109,72
16,r_110_142_31,seq86,seq140,r_110_142_31,0.89,1,32,31,72
57,seq140,r_103_118_159,r_93_26_119,r_93_26_119,0.99,41,160,119,72
85,seq88,r_18_54_109,seq40,r_18_54_109,1.0,0,109,109,72
27,r_65_100_147,r_101_75_100,seq116,r_101_75_100,1.0,0,100,100,72
2,r_92_1_170,r_136_125_131,seq117,r_136_125_131,0.99,2,133,131,72
47,r_84_119_73,r_13_71_191,r_11_44_55,r_13_71_191,0.84,-118,73,191,72
40,r_68_70_69,seq20,seq95,r_68_70_69,1.0,0,69,69,72
24,r_103_118_159,seq140,r_48_120_7,r_103_118_159,0.81,1,160,159,72
25,r_101_75_100,r_65_100_147,seq9,r_101_75_100,0.99,0,100,100,72
33,r_128_78_172,r_109_19_116,r_57_25_17,r_128_78_172,0.47,-55,117,172,72
29,r_33_55_35,seq106,seq146,r_33_55_35,1.0,0,35,35,72
38,r_83_2_175,r_50_115_160,r_43_58_63,r_43_58_63,0.74,27,90,63,72
20,r_121_45_27,seq85,seq130,r_121_45_27,1.0,0,27,27,72
34,r_109_19_116,r_128_78_172,seq63,r_109_19_116,0.67,1,117,116,72
75,seq53,seq17,r_65_100_147,r_65_100_147,1.0,2,149,147,72
84,seq86,r_110_142_31,seq79,r_110_142_31,0.63,1,32,31,72
17,r_61_16_75,seq14,seq9,r_61_16_75,1.0,0,75,75,72
27,r_65_100_147,seq116,seq53,r_65_100_147,1.0,0,147,147,72
31,r_57_25_17,r_128_78_172,r_148_27_58,r_57_25_17,0.73,156,173,17,72
28,r_114_112_128,seq64,r_93_26_119,r_93_26_119,1.0,12,131,119,72
49,r_133_104_127,seq17,r_13_71_191,r_133_104_127,0.98,0,127,127,72
7,r_13_71_191,r_84_119_73,r_12_97_66,r_84_119_73,0.92,0,73,73,72
44,r_60_80_151,seq17,r_132_124_59,r_132_124_59,1.0,90,149,59,72
23,r_126_139_67,seq145,seq64,r_126_139_67,1.0,0,67,67,72
31,r_57_25_17,r_43_58_63,r_128_78_172,r_57_25_17,0.65,0,17,17,72
79,seq64,r_114_112_128,r_126_139_67,r_126_139_67,1.0,64,131,67,72
54,seq7,r_135_77_171,r_10_98_18,r_10_98_18,1.0,7,25,18,72
12,r_141_123_149,r_35_108_43,r_61_16_75,r_61_16_75,1.0,76,151,75,72
93,seq107,r_94_131_159,r_25_15_76,r_25_15_76,0.52,23,99,76,73
30,r_96_99_96,seq77,seq49,r_96_99_96,0.49,18,114,96,73
36,r_108_14_77,r_116_121_173,seq80,r_108_14_77,1.0,2,79,77,73
14,r_116_121_173,r_108_14_77,seq97,r_108_14_77,1.0,2,79,77,73
53,seq6,r_105_71_70,seq88,r_105_71_70,1.0,1,71,70,73
59,seq17,r_143_45_182,r_87_84_62,r_87_84_62,1.0,15,77,62,73
16,r_83_47_101,r_1_16_171,seq30,r_83_47_101,1.0,0,101,101,73
21,r_41_40_75,seq112,r_98_101_71,r_41_40_75,0.79,0,75,75,73
1,r_111_2_143,seq32,seq77,r_111_2_143,0.76,1,144,143,73
83,seq76,r_20_12_134,r_60_65_48,r_60_65_48,0.48,0,48,48,73
42,r_4_46_133,r_143_45_182,r_57_63_129,r_143_45_182,0.7,-49,133,182,73
13,r_60_65_48,seq69,seq76,r_60_65_48,1.0,0,48,48,73
10,r_143_45_182,r_55_89_47,r_124_26_78,r_143_45_182,0.97,0,182,182,73
7,r_110_127_163,r_143_45_182,r_29_90_138,r_143_45_182,0.9,-19,163,182,73
45,r_144_117_180,r_134_19_56,seq149,r_144_117_180,0.52,0,180,180,73
19,r_58_109_164,r_0_92_167,r_116_121_173,r_116_121_173,0.88,-9,164,173,73
39,r_55_89_47,r_64_8_51,r_143_45_182,r_55_89_47,1.0,0,47,47,73
41,r_94_131_159,r_42_21_39,r_113_135_174,r_94_131_159,0.58,-117,42,159,73
39,r_55_89_47,r_143_45_182,r_87_84_62,r_55_89_47,0.65,135,182,47,73
31,r_68_136_128,r_143_45_182,r_82_122_59,r_68_136_128,0.89,0,128,128,73
10,r_143_45_182,r_4_46_133,r_55_89_47,r_55_89_47,1.0,86,133,47,73
35,r_7_10_55,r_5_86_90,seq56,r_7_10_55,0.99,0,55,55,73
90,seq91,r_57_63_129,r_85_54_79,r_85_54_79,0.74,50,129,79,73
37,r_82_122_59,r_87_84_62,seq137,r_82_122_59,0.82,0,59,59,73
26,r_5_86_90,seq125,r_34_3_32,r_5_86_90,1.0,0,90,90,73
14,r_116_121_173,seq97,r_64_8_51,r_116_121_173,0.49,-14,159,173,73
78,seq70,seq69,r_124_26_78,r_124_26_78,1.0,37,115,78,73
0,r_1_16_171,seq72,r_43_139_125,r_43_139_125,0.57,46,171,125,73
63,seq23,r_98_101_71,seq88,r_98_101_71,1.0,1,72,71,73
73,seq59,r_25_15_76,seq30,r_25_15_76,1.0,0,76,76,73
11,r_28_24_135,r_132_67_152,r_7_10_55,r_28_24_135,0.89,1,136,135,73
20,r_98_101_71,seq137,seq148,r_98_101_71,1.0,1,72,71,73
15,r_33_114_108,seq97,seq73,r_33_114_108,1.0,0,108,108,73
48,r_138_147_156,r_34_3_32,r_132_67_152,r_34_3_32,0.84,128,160,32,73
25,r_146_95_68,r_116_121_173,seq107,r_116_121_173,0.56,3,176,173,73
62,seq22,r_0_92_167,seq62,r_0_92_167,0.74,0,167,167,73
85,seq78,r_43_139_125,seq22,r_43_139_125,0.94,0,125,125,73
12,r_31_100_26,r_5_86_90,seq137,r_31_100_26,1.0,0,26,26,73
33,r_115_106_46,r_29_90_138,seq66,r_115_106_46,1.0,0,46,46,73
27,r_20_12_134,r_134_19_56,seq49,r_20_12_134,0.96,1,135,134,73
4,r_42_21_39,r_94_131_159,seq130,r_42_21_39,0.99,0,39,39,73
2,r_87_84_62,seq70,seq17,r_87_84_62,1.0,0,62,62,73
47,r_105_71_70,seq6,seq78,r_105_71_70,1.0,0,70,70,73
18,r_34_3_32,r_138_147_156,seq13,r_138_147_156,0.78,4,160,156,73
29,r_124_26_78,r_20_12_134,seq70,r_124_26_78,0.64,1,79,78,73
5,r_133_36_10,r_98_101_71,r_134_19_56,r_133_36_10,0.96,0,10,10,73
24,r_85_54_79,r_29_90_138,seq91,r_85_54_79,0.96,0,79,79,73
25,r_146_95_68,seq56,r_94_131_159,r_146_95_68,0.89,1,69,68,73
32,r_134_19_56,r_144_117_180,r_83_47_101,r_83_47_101,1.0,58,159,101,73
38,r_48_103_114,r_0_92_167,r_25_15_76,r_48_103_114,0.96,-1,113,114,73
34,r_142_102_137,seq62,r_7_10_55,r_142_102_137,0.5,0,137,137,73
75,seq62,r_142_102_137,seq78,r_142_102_137,0.97,-13,124,137,73
60,seq148,r_126_145_193,r_98_101_71,r_98_101_71,1.0,56,127,71,73
41,r_94_131_159,r_113_135_174,r_146_95_68,r_146_95_68,0.75,-1,67,68,73
17,r_37_50_104,seq30,r_27_53_17,r_37_50_104,0.97,0,104,104,73
25,r_146_95_68,r_94_131_159,r_116_121_173,r_146_95_68,0.8,91,159,68,73
9,r_25_15_76,seq59,seq137,r_25_15_76,1.0,0,76,76,73
43,r_64_8_51,seq13,seq79,r_64_8_51,0.7,5,56,51,73
96,seq119,r_126_145_193,r_43_139_125,r_43_139_125,0.88,-1,124,125,73
22,r_0_92_167,seq22,seq80,r_0_92_167,0.5,0,167,167,73
7,r_110_127_163,seq148,r_143_45_182,r_110_127_163,0.36,-79,84,163,73
44,r_43_139_125,seq78,r_27_53_17,r_43_139_125,0.97,0,125,125,73
23,r_29_90_138,seq149,r_25_15_76,r_29_90_138,0.96,0,138,138,73
41,r_94_131_159,r_146_95_68,r_105_71_70,r_94_131_159,0.9,0,159,159,73
79,seq72,r_1_16_171,seq62,r_1_16_171,0.51,0,171,171,73
36,r_27_141_191,r_129_126_107,seq137,r_129_126_107,1.0,2,109,107,74
14,r_87_145_114,r_98_121_181,r_2_32_102,r_2_32_102,0.54,14,116,102,74
8,r_20_10_94,seq106,r_146_119_40,r_20_10_94,0.85,0,94,94,74
35,r_1_53_53,r_59_19_103,r_109_108_47,r_59_19_103,1.0,-5,98,103,74
37,r_147_88_167,r_13_111_34,r_40_71_39,r_147_88_167,0.99,-132,35,167,74
17,r_90_96_23,r_40_71_39,seq106,r_90_96_23,1.0,0,23,23,74
86,seq83,r_117_131_66,seq80,r_117_131_66,0.67,-5,61,66,74
42,r_75_105_78,r_102_120_136,r_40_71_39,r_75_105_78,0.97,0,78,78,74
18,r_18_69_166,r_102_120_136,r_110_135_25,r_110_135_25,1.0,4,29,25,74
45,r_35_31_175,seq57,r_12_16_92,r_35_31_175,0.47,1,176,175,74
30,r_45_42_20,r_128_21_26,seq57,r_128_21_26,0.66,-5,21,26,74
19,r_117_131_66,seq83,seq0,r_117_131_66,1.0,0,66,66,74
27,r_54_44_29,seq142,r_109_108_47,r_54_44_29,0.5,72,101,29,74
60,seq149,r_56_116_28,r_50_39_16,r_56_116_28,0.87,0,28,28,74
39,r_5_140_164,r_67_43_35,seq29,r_5_140_164,0.69,0,164,164,74
31,r_98_121_181,seq103,seq123,r_98_121_181,0.6,0,181,181,74
41,r_134_68_67,r_102_120_136,seq55,r_134_68_67,1.0,2,69,67,74
26,r_59_19_103,r_109_108_47,r_1_53_53,r_1_53_53,0.94,-4,49,53,74
3,r_102_120_136,seq48,r_50_39_16,r_102_120_136,0.54,0,136,136,74
46,r_50_39_16,r_12_16_92,seq149,r_50_39_16,0.58,1,17,16,74
11,r_13_111_34,r_147_88_167,seq130,r_13_111_34,1.0,0,34,34,74
90,seq103,r_98_121_181,r_127_100_42,r_127_100_42,0.92,139,181,42,74
20,r_110_135_25,seq29,r_18_69_166,r_110_135_25,1.0,0,25,25,74
2,r_127_100_42,seq7,seq103,r_127_100_42,1.0,0,42,42,74
46,r_50_39_16,seq149,r_102_120_136,r_102_120_136,1.0,1,137,136,74
26,r_59_19_103,r_1_53_53,r_56_116_28,r_59_19_103,1.0,0,103,103,74
15,r_12_16_92,seq73,seq137,r_12_16_92,0.99,0,92,92,74
27,r_54_44_29,r_109_108_47,r_91_22_165,r_91_22_165,0.93,5,170,165,74
49,r_146_119_40,r_2_32_102,r_20_10_94,r_146_119_40,0.71,62,102,40,74
6,r_61_64_187,seq79,seq130,r_61_64_187,0.26,0,187,187,74
21,r_132_9_168,r_33_148_37,r_58_84_65,r_33_148_37,0.69,131,168,37,74
85,seq80,r_147_88_167,r_75_105_78,r_75_105_78,1.0,8,86,78,74
5,r_40_71_39,r_147_88_167,r_118_143_112,r_118_143_112,0.96,15,127,112,74
35,r_1_53_53,seq11,r_59_19_103,r_1_53_53,0.96,1,54,53,74
27,r_54_44_29,r_33_148_37,seq142,r_54_44_29,0.53,1,30,29,74
47,r_67_43_35,r_102_120_136,r_5_140_164,r_67_43_35,1.0,0,35,35,74
40,r_15_14_85,seq78,r_23_3_6,r_15_14_85,0.95,3,88,85,74
24,r_58_84_65,seq138,seq6,r_58_84_65,1.0,0,65,65,74
48,r_38_112_110,r_94_92_38,seq29,r_94_92_38,0.65,9,47,38,74
25,r_2_32_102,r_132_9_168,seq48,r_2_32_102,0.97,0,102,102,74
48,r_38_112_110,seq29,seq66,r_38_112_110,1.0,0,110,110,74
64,seq30,r_18_69_166,r_110_135_25,r_110_135_25,0.58,60,85,25,74
47,r_67_43_35,r_5_140_164,r_127_100_42,r_5_140_164,0.97,-8,156,164,74
21,r_132_9_168,r_2_32_102,r_33_148_37,r_132_9_168,0.93,-121,47,168,74
20,r_110_135_25,r_18_69_166,seq30,r_18_69_166,0.95,-17,149,166,74
32,r_99_4_120,seq130,seq79,r_99_4_120,0.95,0,120,120,74
52,seq6,seq28,r_58_84_65,r_58_84_65,1.0,25,90,65,74
1,r_56_116_28,r_54_44_29,seq138,r_56_116_28,1.0,0,28,28,74
49,r_146_119_40,r_59_19_103,r_2_32_102,r_146_119_40,1.0,0,40,40,74
37,r_147_88_167,r_40_71_39,r_127_100_42,r_147_88_167,0.49,0,167,167,74
29,r_33_148_37,r_132_9_168,r_20_10_94,r_33_148_37,0.73,122,159,37,74
22,r_60_63_91,r_35_31_175,seq49,r_60_63_91,0.83,2,93,91,74
28,r_97_8_80,r_109_108_47,r_128_21_26,r_128_21_26,0.64,56,82,26,74
13,r_94_92_38,r_38_112_110,r_90_96_23,r_94_92_38,0.98,9,47,38,74
7,r_91_22_165,seq95,r_54_44_29,r_91_22_165,0.73,0,165,165,74
18,r_18_69_166,r_110_135_25,seq34,r_18_69_166,0.81,0,166,166,74
44,r_129_126_107,r_27_141_191,seq17,r_129_126_107,0.98,2,109,107,74
23,r_86_24_148,seq41,r_58_84_65,r_86_24_148,0.97,0,148,148,74
34,r_93_72_36,seq138,seq51,r_93_72_36,0.99,0,36,36,74
29,r_33_148_37,r_118_143_112,r_132_9_168,r_33_148_37,1.0,0,37,37,74
10,r_37_115_11,seq41,seq51,r_37_115_11,0.99,0,11,11,74
33,r_133_36_30,seq17,r_110_135_25,r_110_135_25,0.75,4,29,25,74
39,r_5_140_164,seq25,r_67_43_35,r_67_43_35,1.0,11,46,35,74
12,r_82_81_116,seq130,r_56_116_28,r_82_81_116,1.0,0,116,116,74
5,r_40_71_39,r_87_145_114,r_147_88_167,r_40_71_39,1.0,0,39,39,74
4,r_26_46_56,r_20_10_94,seq70,r_26_46_56,1.0,0,56,56,74
8,r_54_83_79,seq8,r_146_126_62,r_54_83_79,1.0,0,79,79,75
9,r_71_132_34,r_44_11_12,seq99,r_71_132_34,0.92,0,34,34,75
30,r_63_67_49,r_30_98_33,seq124,r_63_67_49,0.84,6,55,49,75
55,seq8,r_54_83_79,r_76_42_39,r_54_83_79,0.66,0,79,79,75
16,r_32_111_100,seq136,seq19,r_32_111_100,1.0,1,101,100,75
39,r_21_130_142,seq41,r_73_80_133,r_21_130_142,0.99,0,142,142,75
1,r_104_96_80,r_17_35_124,r_87_55_27,r_104_96_80,1.0,44,124,80,75
46,r_79_2_63,seq29,r_139_45_5,r_79_2_63,1.0,0,63,63,75
80,seq86,r_115_128_75,seq19,r_115_128_75,1.0,0,75,75,75
19,r_40_13_146,seq99,seq134,r_40_13_146,0.97,0,146,146,75
38,r_73_80_133,r_76_42_39,seq22,r_73_80_133,0.83,0,133,133,75
31,r_50_74_166,r_101_107_191,r_62_97_24,r_101_107_191,0.55,-24,167,191,75
21,r_87_55_27,seq72,r_104_96_80,r_87_55_27,1.0,0,27,27,75
41,r_88_34_139,seq103,r_90_119_52,r_90_119_52,1.0,87,139,52,75
67,seq41,r_21_130_142,seq117,r_21_130_142,1.0,0,142,142,75
10,r_149_116_175,r_141_59_141,r_105_5_44,r_105_5_44,0.63,34,78,44,75
43,r_62_97_24,r_21_130_142,seq92,r_62_97_24,1.0,0,24,24,75
4,r_15_66_84,r_48_57_185,seq51,r_15_66_84,1.0,0,84,84,75
0,r_81_31_98,r_4_82_190,r_15_66_84,r_15_66_84,1.0,17,101,84,75
63,seq27,r_110_148_154,seq140,r_110_148_154,0.98,0,154,154,75
20,r_17_35_124,r_104_96_80,seq29,r_17_35_124,0.99,0,124,124,75
98,seq124,r_91_95_118,r_63_67_49,r_91_95_118,0.9,-52,66,118,75
15,r_143_20_64,r_4_82_190,seq7,r_143_20_64,0.95,0,64,64,75
40,r_105_5_44,r_90_119_52,r_33_26_37,r_33_26_37,1.0,7,44,37,75
6,r_93_36_130,r_84_145_168,seq108,r_93_36_130,0.71,1,131,130,75
64,seq29,seq99,r_6_47_119,r_6_47_119,0.99,0,119,119,75
85,seq102,r_48_57_185,r_76_42_39,r_76_42_39,0.99,146,185,39,75
5,r_70_133_31,r_93_36_130,seq7,r_93_36_130,0.91,2,132,130,75
10,r_149_116_175,r_105_5_44,r_54_83_79,r_105_5_44,0.61,136,180,44,75
27,r_64_121_105,r_38_10_184,seq53,r_64_121_105,0.95,0,105,105,75
38,r_73_80_133,r_38_10_184,r_76_42_39,r_76_42_39,1.0,5,44,39,75
2,r_38_10_184,seq123,r_84_145_168,r_38_10_184,0.33,0,184,184,75
18,r_115_128_75,seq86,seq147,r_115_128_75,1.0,0,75,75,75
29,r_46_14_134,seq140,seq134,r_46_14_134,0.85,0,134,134,75
24,r_28_77_138,seq65,seq24,r_28_77_138,1.0,0,138,138,75
34,r_76_42_39,r_73_80_133,seq24,r_73_80_133,1.0,0,133,133,75
25,r_110_148_154,seq27,seq108,r_110_148_154,0.98,0,154,154,75
33,r_12_52_172,seq92,r_135_43_96,r_135_43_96,1.0,77,173,96,75
64,seq29,r_79_2_63,seq99,r_79_2_63,0.83,0,63,63,75
70,seq53,seq29,r_64_121_105,r_64_121_105,1.0,9,114,105,75
32,r_90_119_52,seq140,seq125,r_90_119_52,1.0,1,53,52,75
60,seq22,r_113_138_188,r_73_80_133,r_73_80_133,0.8,55,188,133,75
34,r_76_42_39,seq1,r_73_80_133,r_76_42_39,0.99,1,40,39,75
94,seq118,r_78_9_131,r_127_18_115,r_78_9_131,1.0,0,131,131,75
28,r_78_9_131,r_88_34_139,r_104_96_80,r_78_9_131,0.96,0,131,131,75
51,seq1,r_76_42_39,seq120,r_76_42_39,1.0,1,40,39,75
7,r_141_59_141,seq39,r_17_35_124,r_141_59_141,0.93,2,143,141,75
44,r_127_18_115,seq125,seq118,r_127_18_115,0.5,1,116,115,75
5,r_70_133_31,r_113_138_188,r_93_36_130,r_70_133_31,1.0,0,31,31,75
23,r_113_138_188,seq22,r_81_31_98,r_81_31_98,0.78,90,188,98,75
12,r_6_47_119,seq140,seq29,r_6_47_119,0.84,0,119,119,75
49,r_91_95_118,seq147,r_62_97_24,r_91_95_118,1.0,4,122,118,75
30,r_38_93_158,seq2,r_63_56_124,r_63_56_124,0.94,7,131,124,76
36,r_74_13_155,seq27,seq111,r_74_13_155,0.65,0,155,155,76
8,r_125_142_72,seq85,r_38_93_158,r_125_142_72,0.98,1,73,72,76
43,r_120_7_95,seq34,seq2,r_120_7_95,0.99,2,97,95,76
32,r_138_11_164,seq3,r_83_131_68,r_138_11_164,0.41,-119,45,164,76
16,r_46_141_98,r_109_44_172,seq6,r_46_141_98,0.97,-12,86,98,76
6,r_145_136_175,r_25_72_184,seq6,r_145_136_175,0.99,0,175,175,76
32,r_138_11_164,r_83_131_68,seq45,r_138_11_164,0.93,1,165,164,76
37,r_119_129_97,r_73_103_53,r_128_147_139,r_119_129_97,1.0,2,99,97,76
45,r_143_107_123,r_25_72_184,seq71,r_143_107_123,0.91,-1,122,123,76
9,r_78_20_10,r_125_142_72,seq39,r_78_20_10,0.6,1,11,10,76
24,r_95_105_133,r_31_4_29,r_134_30_19,r_95_105_133,0.94,2,135,133,76
15,r_16_19_41,r_25_72_184,seq92,r_16_19_41,0.86,0,41,41,76
19,r_134_30_19,r_135_5_195,seq0,r_134_30_19,1.0,0,19,19,76
30,r_38_93_158,r_63_56_124,seq27,r_38_93_158,0.75,1,159,158,76
3,r_116_59_107,seq98,r_80_133_33,r_116_59_107,0.95,0,107,107,76
26,r_65_58_83,seq28,r_135_5_195,r_65_58_83,1.0,0,83,83,76
1,r_126_50_28,r_128_147_139,seq111,r_126_50_28,1.0,-1,27,28,76
4,r_99_9_146,seq41,r_119_129_97,r_119_129_97,1.0,55,152,97,76
0,r_109_44_172,r_46_141_98,seq111,r_46_141_98,0.99,0,98,98,76
12,r_31_4_29,seq45,r_95_105_133,r_31_4_29,0.96,0,29,29,76
20,r_25_72_184,r_143_107_123,r_119_129_97,r_25_72_184,0.99,-59,125,184,76
13,r_68_84_93,r_138_11_164,r_73_103_53,r_138_11_164,1.0,-70,94,164,76
98,seq118,r_144_113_118,r_51_127_75,r_51_127_75,0.79,-5,70,75,76
48,r_83_131_68,r_77_148_180,r_135_5_195,r_83_131_68,0.5,-7,61,68,76
12,r_31_4_29,r_95_105_133,seq139,r_95_105_133,1.0,2,135,133,76
6,r_145_136_175,r_138_11_164,r_25_72_184,r_25_72_184,0.62,-53,131,184,76
18,r_87_101_22,r_95_105_133,seq52,r_87_101_22,0.9,0,22,22,76
0,r_109_44_172,seq111,seq86,r_109_44_172,0.68,0,172,172,76
39,r_73_103_53,seq3,r_15_89_112,r_73_103_53,1.0,0,53,53,76
27,r_140_130_110,seq28,seq98,r_140_130_110,0.71,1,111,110,76
21,r_70_117_163,r_51_127_75,seq139,r_51_127_75,1.0,-16,59,75,76
47,r_144_113_118,r_95_105_133,r_68_84_93,r_144_113_118,0.91,0,118,118,76
25,r_63_56_124,r_38_93_158,r_125_142_72,r_63_56_124,0.52,35,159,124,76
29,r_100_26_100,r_108_37_178,r_51_127_75,r_100_26_100,0.87,0,100,100,76
37,r_119_129_97,r_128_147_139,r_99_9_146,r_128_147_139,0.73,18,157,139,76
24,r_95_105_133,seq137,r_31_4_29,r_31_4_29,1.0,0,29,29,76
25,r_63_56_124,r_82_53_191,r_38_93_158,r_63_56_124,0.89,0,124,124,76
33,r_15_89_112,seq34,seq36,r_15_89_112,0.97,0,112,112,76
11,r_60_124_17,seq85,seq36,r_60_124_17,1.0,0,17,17,76
65,seq34,r_120_7_95,r_73_103_53,r_73_103_53,0.99,32,85,53,76
44,r_21_48_25,seq137,seq85,r_21_48_25,1.0,1,26,25,76
38,r_51_127_75,r_70_117_163,seq118,r_51_127_75,0.94,0,75,75,76
37,r_119_129_97,r_116_59_107,r_73_103_53,r_73_103_53,1.0,5,58,53,76
67,seq39,r_116_59_107,r_78_20_10,r_78_20_10,0.63,1,11,10,76
39,r_73_103_53,r_15_89_112,r_68_84_93,r_73_103_53,0.81,59,112,53,76
2,r_110_23_32,r_65_58_83,seq146,r_65_58_83,0.57,-52,31,83,76
5,r_64_55_20,seq2,r_122_104_7,r_64_55_20,0.89,0,20,20,76
20,r_25_72_184,r_119_129_97,r_31_4_29,r_25_72_184,1.0,0,184,184,76
49,r_123_8_165,r_32_12_194,seq139,r_123_8_165,0.69,3,168,165,76
7,r_54_35_145,seq98,seq88,r_54_35_145,0.73,0,145,145,76
8,r_125_142_72,r_38_93_158,r_120_7_95,r_125_142_72,0.68,44,116,72,76
23,r_128_147_139,r_145_136_175,r_116_59_107,r_116_59_107,0.9,1,108,107,76
31,r_80_133_33,seq102,seq149,r_80_133_33,0.99,0,33,33,76
30,r_138_120_89,r_20_18_124,seq143,r_20_18_124,1.0,-31,93,124,77
44,r_62_74_137,seq60,r_116_19_74,r_62_74_137,0.99,0,137,137,77
43,r_20_18_124,seq125,seq30,r_20_18_124,0.99,0,124,124,77
8,r_39_36_27,r_109_64_68,seq40,r_109_64_68,0.87,5,73,68,77
37,r_43_101_90,r_144_123_3,r_85_52_52,r_85_52_52,1.0,40,92,52,77
21,r_71_8_114,r_5_115_142,r_9_90_103,r_9_90_103,0.77,11,114,103,77
5,r_128_89_169,r_122_127_1,seq55,r_128_89_169,0.9,0,169,169,77
42,r_149_31_69,seq33,r_117_104_50,r_149_31_69,1.0,-3,66,69,77
66,seq33,r_149_31_69,r_1_26_15,r_149_31_69,0.94,-17,52,69,77
8,r_39_36_27,r_149_31_69,r_109_64_68,r_39_36_27,0.99,0,27,27,77
31,r_95_47_112,seq42,seq60,r_95_47_112,1.0,0,112,112,77
14,r_1_26_15,r_128_89_169,seq33,r_1_26_15,1.0,-1,14,15,77
41,r_75_136_79,seq135,r_122_127_1,r_75_136_79,0.82,-18,61,79,77
10,r_66_22_73,r_140_34_197,r_84_78_19,r_66_22_73,0.81,0,73,73,77
4,r_142_88_71,r_76_97_17,seq45,r_142_88_71,1.0,0,71,71,77
98,seq125,r_138_120_89,r_117_104_50,r_117_104_50,1.0,28,78,50,77
15,r_5_115_142,seq48,seq23,r_5_115_142,1.0,0,142,142,77
26,r_3_73_25,r_37_32_21,seq108,r_3_73_25,1.0,0,25,25,77
6,r_86_67_96,r_68_46_104,seq129,r_86_67_96,1.0,0,96,96,77
46,r_77_0_51,r_5_115_142,seq112,r_77_0_51,1.0,0,51,51,77
27,r_57_147_179,seq132,seq55,r_57_147_179,0.61,0,179,179,77
18,r_110_121_75,r_1_26_15,r_68_46_104,r_68_46_104,1.0,-2,102,104,77
2,r_9_90_103,seq44,seq146,r_9_90_103,1.0,1,104,103,77
47,r_116_19_74,r_114_137_108,seq41,r_116_19_74,0.88,1,75,74,77
38,r_117_104_50,seq48,seq125,r_117_104_50,1.0,0,50,50,77
40,r_102_17_130,r_2_134_187,r_86_67_96,r_2_134_187,1.0,-56,131,187,77
45,r_107_50_36,r_119_6_191,seq87,r_107_50_36,0.9,0,36,36,77
18,r_110_121_75,seq12,r_1_26_15,r_110_121_75,0.9,0,75,75,77
29,r_49_131_105,r_7_51_183,r_84_78_19,r_84_78_19,0.96,93,112,19,77
33,r_27_25_88,r_59_141_161,seq4,r_59_141_161,0.74,-68,93,161,77
65,seq30,r_69_61_189,r_86_67_96,r_86_67_96,1.0,93,189,96,77
68,seq40,seq124,r_39_36_27,r_39_36_27,0.98,44,71,27,77
34,r_83_100_133,seq14,r_9_90_103,r_9_90_103,0.82,30,133,103,77
81,seq143,r_2_134_187,r_119_6_191,r_2_134_187,0.52,0,187,187,77
22,r_53_72_118,seq45,r_86_67_96,r_86_67_96,1.0,28,124,96,77
28,r_69_61_189,seq30,r_1_26_15,r_1_26_15,0.6,174,189,15,77
49,r_68_46_104,r_62_74_137,r_110_121_75,r_68_46_104,1.0,1,105,104,77
16,r_85_52_52,seq126,r_43_101_90,r_43_101_90,0.89,8,98,90,77
19,r_37_32_21,seq23,seq125,r_37_32_21,0.8,9,30,21,77
44,r_62_74_137,r_86_67_96,seq60,r_86_67_96,0.99,0,96,96,77
16,r_85_52_52,r_49_131_105,seq126,r_85_52_52,1.0,4,56,52,77
0,r_119_6_191,r_107_50_36,r_58_65_22,r_107_50_36,0.75,0,36,36,77
23,r_114_137_108,seq21,seq126,r_114_137_108,0.82,2,110,108,77
35,r_109_64_68,seq124,r_117_104_50,r_117_104_50,1.0,14,64,50,77
12,r_105_98_82,r_57_147_179,seq87,r_105_98_82,1.0,1,83,82,77
93,seq108,seq103,r_147_9_116,r_147_9_116,1.0,6,122,116,78
47,r_146_71_15,r_80_0_90,seq5,r_146_71_15,0.5,2,17,15,78
53,seq136,r_2_113_177,r_101_4_33,r_101_4_33,1.0,144,177,33,78
55,seq13,r_36_90_169,r_134_27_111,r_134_27_111,0.98,1,112,111,78
16,r_52_73_141,seq131,r_20_81_50,r_20_81_50,1.0,109,159,50,78
1,r_48_118_2,seq133,r_36_90_169,r_48_118_2,0.21,168,170,2,78
5,r_147_9_116,r_22_26_130,seq108,r_147_9_116,1.0,0,116,116,78
46,r_36_90_169,seq47,r_48_118_2,r_36_90_169,0.54,0,169,169,78
32,r_35_53_38,r_21_69_148,r_102_61_82,r_35_53_38,0.94,110,148,38,78
32,r_35_53_38,r_122_144_121,r_21_69_148,r_35_53_38,0.99,0,38,38,78
67,seq45,r_83_128_48,r_23_109_13,r_23_109_13,0.71,1,14,13,78
18,r_134_27_111,r_20_81_50,seq13,r_134_27_111,1.0,0,111,111,78
19,r_10_11_105,r_134_27_111,seq39,r_10_11_105,1.0,0,105,105,78
43,r_44_19_53,seq148,seq79,r_44_19_53,0.99,-1,52,53,78
34,r_28_60_37,r_97_40_149,seq86,r_28_60_37,0.85,-10,27,37,78
66,seq39,r_25_1_173,r_10_11_105,r_10_11_105,1.0,68,173,105,78
41,r_80_0_90,seq58,r_23_109_13,r_80_0_90,1.0,0,90,90,78
45,r_114_107_21,r_8_54_124,seq142,r_114_107_21,1.0,0,21,21,78
3,r_33_3_159,seq142,r_134_27_111,r_33_3_159,0.95,0,159,159,78
26,r_122_144_121,seq92,seq16,r_122_144_121,1.0,0,121,121,78
72,seq58,r_80_0_90,seq93,r_80_0_90,1.0,-5,85,90,78
51,seq5,seq126,r_146_71_15,r_146_71_15,0.89,5,20,15,78
78,seq74,r_117_18_166,r_44_19_53,r_44_19_53,0.57,89,142,53,78
0,r_116_112_61,r_24_135_165,r_83_128_48,r_116_112_61,1.0,0,61,61,78
21,r_17_91_57,seq79,seq34,r_17_91_57,1.0,1,58,57,78
11,r_50_141_174,r_2_113_177,seq16,r_2_113_177,0.52,-2,175,177,78
28,r_29_99_26,seq110,seq58,r_29_99_26,1.0,0,26,26,78
20,r_129_41_65,r_78_143_160,seq142,r_129_41_65,1.0,0,65,65,78
13,r_140_120_60,r_2_113_177,seq32,r_140_120_60,0.94,0,60,60,78
15,r_102_61_82,seq38,r_35_53_38,r_102_61_82,1.0,0,82,82,78
48,r_117_18_166,seq74,seq59,r_117_18_166,0.58,0,166,166,78
4,r_20_81_50,r_134_27_111,r_52_73_141,r_134_27_111,1.0,0,111,111,78
12,r_43_88_18,r_33_3_159,seq67,r_33_3_159,0.97,-7,152,159,78
6,r_127_104_106,r_2_113_177,seq16,r_127_104_106,0.58,1,107,106,78
85,seq89,seq126,r_132_37_9,r_132_37_9,0.56,144,153,9,78
99,seq126,r_65_106_136,seq5,r_65_106_136,1.0,1,137,136,78
12,r_43_88_18,seq34,r_33_3_159,r_43_88_18,1.0,0,18,18,78
27,r_65_106_136,seq126,seq75,r_65_106_136,0.99,0,136,136,78
4,r_20_81_50,r_117_18_166,r_134_27_111,r_20_81_50,0.98,0,50,50,78
0,r_116_112_61,r_83_128_48,r_6_64_104,r_6_64_104,1.0,0,104,104,78
18,r_134_27_111,r_10_11_105,r_20_81_50,r_20_81_50,0.84,26,76,50,78
29,r_97_40_149,seq47,seq74,r_97_40_149,0.91,1,150,149,78
24,r_12_139_135,r_2_113_177,r_28_60_37,r_12_139_135,0.97,0,135,135,78
33,r_25_1_173,seq39,seq123,r_25_1_173,0.58,0,173,173,78
76,seq70,r_147_9_116,r_28_60_37,r_147_9_116,1.0,-57,59,116,78
38,r_21_69_148,r_2_113_177,r_23_109_13,r_21_69_148,0.8,0,148,148,78
9,r_6_64_104,seq142,r_116_112_61,r_6_64_104,1.0,0,104,104,78
10,r_83_128_48,r_94_85_197,seq110,r_83_128_48,1.0,2,50,48,78
49,r_121_66_67,seq98,r_23_109_13,r_121_66_67,1.0,1,68,67,78
56,seq14,r_24_135_165,seq100,r_24_135_165,0.8,0,165,165,78
7,r_2_113_177,seq136,r_132_37_9,r_2_113_177,0.41,0,177,177,78
44,r_24_135_165,seq14,r_127_104_106,r_24_135_165,0.54,0,165,165,78
23,r_87_68_175,seq39,r_8_54_124,r_87_68_175,0.66,0,175,175,78
37,r_23_109_13,r_105_119_192,seq45,r_23_109_13,0.97,0,13,13,78
8,r_101_4_33,r_33_3_159,seq63,r_101_4_33,1.0,0,33,33,78
35,r_57_82_93,seq133,seq93,r_57_82_93,0.97,0,93,93,78
31,r_42_62_19,r_57_82_93,seq75,r_42_62_19,1.0,0,19,19,78
30,r_108_146_190,r_66_144_113,r_131_35_111,r_108_146_190,1.0,-77,113,190,79
6,r_113_106_49,r_55_16_105,r_49_42_38,r_55_16_105,0.98,-53,52,105,79
14,r_109_22_156,seq142,seq8,r_109_22_156,0.94,0,156,156,79
21,r_3_103_15,r_13_91_196,seq11,r_3_103_15,0.92,0,15,15,79
31,r_117_130_32,r_100_20_20,r_118_141_68,r_118_141_68,1.0,-1,67,68,79
37,r_14_105_180,r_119_60_187,seq57,r_119_60_187,0.27,-7,180,187,79
59,seq15,r_96_41_183,r_88_121_98,r_88_121_98,0.95,2,100,98,79
55,seq9,r_96_41_183,seq143,r_96_41_183,0.82,-71,112,183,79
71,seq44,r_88_121_98,seq145,r_88_121_98,1.0,1,99,98,79
16,r_54_107_70,seq46,seq142,r_54_107_70,1.0,1,71,70,79
39,r_55_16_105,seq21,r_104_140_77,r_55_16_105,1.0,0,105,105,79
33,r_100_20_20,seq79,seq65,r_100_20_20,1.0,0,20,20,79
5,r_30_77_94,seq12,seq68,r_30_77_94,1.0,0,94,94,79
76,seq53,r_13_91_196,r_84_97_29,r_84_97_29,1.0,23,52,29,79
7,r_122_83_33,seq9,r_78_89_89,r_78_89_89,1.0,28,117,89,79
45,r_75_45_131,seq18,r_125_138_112,r_75_45_131,1.0,0,131,131,79
36,r_49_42_38,r_61_115_157,seq27,r_49_42_38,1.0,0,38,38,79
1,r_148_74_136,r_149_64_176,r_87_70_47,r_87_70_47,0.9,4,51,47,79
95,seq145,r_149_64_176,seq44,r_149_64_176,0.69,-85,91,176,79
44,r_24_67_34,r_109_22_156,seq21,r_24_67_34,1.0,0,34,34,79
30,r_108_146_190,r_61_115_157,r_86_123_165,r_108_146_190,0.81,0,190,190,79
41,r_99_26_109,seq8,seq37,r_99_26_109,0.89,1,110,109,79
7,r_122_83_33,r_82_63_18,seq9,r_122_83_33,0.54,1,34,33,79
26,r_73_4_78,r_5_10_100,r_118_141_68,r_73_4_78,0.65,0,78,78,79
8,r_84_97_29,r_6_56_99,seq53,r_6_56_99,1.0,1,100,99,79
13,r_147_98_24,r_148_74_136,r_100_20_20,r_148_74_136,0.86,-111,25,136,79
4,r_5_10_100,r_96_41_183,seq18,r_5_10_100,1.0,0,100,100,79
0,r_43_128_6,r_131_35_111,seq58,r_131_35_111,1.0,0,111,111,79
73,seq47,r_61_115_157,seq9,r_61_115_157,0.93,0,157,157,79
31,r_117_130_32,r_13_91_196,r_100_20_20,r_117_130_32,0.54,0,32,32,79
11,r_131_35_111,r_43_128_6,seq79,r_131_35_111,1.0,0,111,111,79
20,r_126_137_76,seq40,r_104_140_77,r_126_137_76,1.0,0,76,76,79
15,r_86_123_165,seq44,seq143,r_86_123_165,0.55,0,165,165,79
1,r_148_74_136,r_87_70_47,r_113_106_49,r_148_74_136,1.0,0,136,136,79
57,seq12,r_30_77_94,seq143,r_30_77_94,0.78,0,94,94,79
27,r_78_89_89,seq36,r_122_83_33,r_78_89_89,0.97,1,90,89,79
87,seq85,seq76,r_114_7_90,r_114_7_90,1.0,8,98,90,79
2,r_104_140_77,seq142,r_126_137_76,r_126_137_76,1.0,24,100,76,79
47,r_96_41_183,r_5_10_100,seq143,r_5_10_100,1.0,0,100,100,79
18,r_31_90_144,seq102,seq11,r_31_90_144,0.95,0,144,144,79
29,r_66_144_113,r_108_146_190,r_84_97_29,r_108_146_190,0.91,-77,113,190,79
8,r_84_97_29,r_78_89_89,r_6_56_99,r_84_97_29,1.0,0,29,29,79
35,r_23_0_129,r_111_139_21,seq65,r_23_0_129,0.76,0,129,129,79
25,r_125_138_112,r_81_71_139,seq12,r_81_71_139,0.82,-26,113,139,79
34,r_6_56_99,r_13_91_196,r_84_97_29,r_84_97_29,1.0,14,43,29,79
43,r_111_139_21,r_23_0_129,seq76,r_23_0_129,1.0,0,129,129,79
99,seq127,r_52_32_191,r_147_98_24,r_147_98_24,0.99,10,34,24,79
42,r_87_70_47,seq37,r_148_74_136,r_87_70_47,1.0,0,47,47,79
65,seq29,seq18,r_39_135_148,r_39_135_148,1.0,-4,144,148,79
88,seq143,r_96_41_183,seq9,r_96_41_183,0.94,-28,155,183,79
85,seq79,r_108_146_190,r_131_35_111,r_131_35_111,1.0,11,122,111,79
58,seq142,r_104_140_77,seq2,r_104_140_77,0.97,23,100,77,79
70,seq40,r_126_137_76,r_1_19_31,r_126_137_76,1.0,0,76,76,79
19,r_33_28_26,r_119_60_187,seq51,r_33_28_26,1.0,-1,25,26,79
68,seq37,r_114_7_90,seq129,r_114_7_90,0.98,3,93,90,79
42,r_87_70_47,r_148_74_136,seq44,r_148_74_136,0.97,0,136,136,79
32,r_39_135_148,seq57,seq29,r_39_135_148,0.98,0,148,148,79
38,r_114_7_90,seq37,seq85,r_114_7_90,0.97,2,92,90,79
3,r_1_19_31,r_122_83_33,seq48,r_122_83_33,0.88,-1,32,33,79
1,r_148_74_136,r_147_98_24,r_149_64_176,r_148_74_136,0.71,-108,28,136,79
75,seq51,r_13_91_196,r_33_28_26,r_33_28_26,1.0,160,186,26,79
43,r_111_139_21,r_6_56_99,r_23_0_129,r_111_139_21,0.88,0,21,21,79
34,r_6_56_99,r_84_97_29,seq34,r_6_56_99,0.99,1,100,99,79
30,r_108_146_190,r_131_35_111,r_61_115_157,r_61_115_157,0.87,12,169,157,79
60,seq17,r_81_71_139,seq129,r_81_71_139,1.0,-2,137,139,79
17,r_118_141_68,r_30_77_94,r_117_130_32,r_117_130_32,0.86,36,68,32,79
94,seq102,r_31_90_144,seq36,r_31_90_144,0.98,-3,141,144,79
22,r_88_121_98,seq44,seq15,r_88_121_98,1.0,2,100,98,79
28,r_50_112_149,r_81_71_139,seq124,r_81_71_139,0.46,0,139,139,79
24,r_62_133_14,r_131_35_111,seq48,r_62_133_14,0.84,1,15,14,79
23,r_81_71_139,r_50_112_149,seq2,r_81_71_139,0.97,0,139,139,79
12,r_61_115_157,seq47,seq57,r_61_115_157,0.68,0,157,157,79
35,r_23_0_129,r_119_60_187,r_111_139_21,r_111_139_21,1.0,0,21,21,79
80,seq65,seq29,r_100_20_20,r_100_20_20,1.0,11,31,20,79
36,r_3_81_83,seq101,seq132,r_3_81_83,1.0,1,84,83,80
14,r_104_94_61,seq2,seq74,r_104_94_61,1.0,0,61,61,80
43,r_75_137_59,r_131_22_174,seq62,r_75_137_59,1.0,2,61,59,80
4,r_46_111_53,r_18_14_166,r_131_22_174,r_46_111_53,0.98,0,53,53,80
16,r_83_113_68,r_3_81_83,seq143,r_83_113_68,0.99,0,68,68,80
39,r_53_102_103,seq36,r_90_19_192,r_53_102_103,0.96,0,103,103,80
46,r_123_77_79,seq144,r_90_19_192,r_123_77_79,1.0,0,79,79,80
42,r_71_65_168,r_0_88_70,r_133_27_21,r_133_27_21,0.48,147,168,21,80
34,r_82_107_182,r_133_27_21,r_68_142_37,r_82_107_182,0.94,1,183,182,80
19,r_69_13_148,seq23,seq130,r_69_13_148,0.8,0,148,148,80
0,r_131_22_174,r_46_111_53,r_100_63_58,r_131_22_174,0.61,2,176,174,80
33,r_6_92_36,r_149_105_108,seq144,r_6_92_36,0.77,0,36,36,80
9,r_25_34_23,seq116,seq2,r_25_34_23,1.0,0,23,23,80
0,r_131_22_174,r_72_122_131,r_46_111_53,r_46_111_53,1.0,84,137,53,80
73,seq39,r_145_9_91,r_131_22_174,r_145_9_91,0.82,3,94,91,80
11,r_60_70_92,seq114,r_136_66_93,r_136_66_93,1.0,3,96,93,80
3,r_1_56_47,seq16,seq30,r_1_56_47,1.0,2,49,47,80
13,r_136_66_93,seq24,r_60_70_92,r_136_66_93,0.97,0,93,93,80
15,r_54_29_126,r_128_117_137,seq118,r_128_117_137,0.97,-9,128,137,80
6,r_139_41_136,r_147_86_154,r_96_67_199,r_139_41_136,0.9,1,137,136,80
38,r_76_48_33,seq118,r_72_122_131,r_72_122_131,0.64,-28,103,131,80
8,r_93_64_45,r_104_94_61,r_96_67_199,r_93_64_45,0.99,0,45,45,80
2,r_149_105_108,r_69_13_148,r_148_15_44,r_148_15_44,0.49,64,108,44,80
47,r_85_84_35,seq62,r_96_67_199,r_85_84_35,1.0,0,35,35,80
18,r_72_122_131,r_131_22_174,r_76_48_33,r_131_22_174,0.6,-37,137,174,80
29,r_0_88_70,seq140,r_71_65_168,r_0_88_70,0.94,7,77,70,80
24,r_112_120_197,r_55_31_195,r_96_67_199,r_55_31_195,0.6,-124,71,195,80
59,seq16,r_1_56_47,seq143,r_1_56_47,0.69,12,59,47,80
68,seq30,r_55_31_195,r_1_56_47,r_1_56_47,0.9,26,73,47,80
32,r_128_117_137,r_54_29_126,r_90_19_192,r_128_117_137,0.9,0,137,137,80
34,r_82_107_182,r_78_125_165,r_133_27_21,r_133_27_21,0.96,144,165,21,80
80,seq58,seq39,r_100_63_58,r_100_63_58,1.0,0,58,58,80
35,r_35_103_41,r_83_113_68,r_57_11_190,r_35_103_41,0.97,0,41,41,80
7,r_8_115_55,r_76_48_33,r_25_34_23,r_8_115_55,1.0,1,56,55,80
17,r_78_125_165,r_82_107_182,r_149_105_108,r_149_105_108,0.62,57,165,108,80
29,r_0_88_70,r_71_65_168,seq32,r_71_65_168,0.98,0,168,168,80
22,r_90_19_192,seq28,r_123_77_79,r_123_77_79,1.0,28,107,79,80
38,r_76_48_33,r_8_115_55,seq118,r_8_115_55,0.57,1,56,55,80
28,r_38_10_98,r_90_19_192,seq26,r_38_10_98,0.6,2,100,98,80
49,r_145_9_91,seq39,seq97,r_145_9_91,0.85,3,94,91,80
41,r_100_63_58,r_90_19_192,seq58,r_100_63_58,1.0,0,58,58,80
10,r_68_142_37,r_90_19_192,seq140,r_68_142_37,1.0,0,37,37,80
48,r_55_31_195,seq30,r_133_27_21,r_133_27_21,0.96,21,42,21,80
44,r_126_109_186,seq140,r_46_111_53,r_46_111_53,0.99,134,187,53,80
38,r_76_48_33,r_145_9_91,r_8_115_55,r_76_48_33,0.52,0,33,33,80
82,seq62,seq50,r_75_137_59,r_75_137_59,1.0,8,67,59,80
12,r_17_135_64,r_131_22_174,seq73,r_17_135_64,1.0,0,64,64,80
30,r_38_96_181,seq119,r_0_48_37,r_0_48_37,0.94,145,182,37,81
23,r_23_65_38,r_9_122_76,r_108_138_42,r_9_122_76,0.93,-38,38,76,81
8,r_145_85_91,r_29_87_135,r_76_50_57,r_145_85_91,1.0,1,92,91,81
10,r_83_58_39,r_9_122_76,r_80_98_6,r_83_58_39,1.0,1,40,39,81
43,r_14_89_73,r_93_43_159,r_51_82_34,r_14_89_73,0.99,-7,66,73,81
36,r_72_28_24,r_101_2_41,seq126,r_72_28_24,0.98,0,24,24,81
20,r_71_147_16,r_10_115_143,r_76_50_57,r_10_115_143,0.59,-78,65,143,81
16,r_37_31_157,seq35,r_76_50_57,r_37_31_157,0.86,0,157,157,81
1,r_9_122_76,seq124,r_76_50_57,r_9_122_76,1.0,0,76,76,81
46,r_95_127_120,seq131,r_77_109_14,r_95_127_120,0.79,2,122,120,81
22,r_141_117_23,r_29_87_135,seq126,r_141_117_23,0.63,1,24,23,81
45,r_111_52_140,seq30,r_32_123_71,r_32_123_71,0.86,69,140,71,81
9,r_120_68_11,r_67_25_54,r_80_98_6,r_120_68_11,0.9,0,11,11,81
39,r_94_79_29,r_135_3_2,r_69_99_176,r_94_79_29,0.99,-1,28,29,81
11,r_10_115_143,r_71_147_16,r_80_98_6,r_10_115_143,0.68,1,144,143,81
95,seq119,r_38_96_181,r_80_98_6,r_38_96_181,0.61,1,182,181,81
97,seq124,r_51_82_34,r_29_87_135,r_29_87_135,1.0,13,148,135,81
26,r_42_132_90,r_55_139_155,seq18,r_42_132_90,0.62,1,91,90,81
37,r_51_82_34,r_9_122_76,r_14_89_73,r_9_122_76,0.98,-3,73,76,81
37,r_51_82_34,r_69_99_176,r_9_122_76,r_51_82_34,1.0,0,34,34,81
48,r_41_140_168,seq130,r_108_138_42,r_41_140_168,0.66,1,169,168,81
6,r_55_139_155,r_134_90_139,r_32_123_71,r_32_123_71,1.0,-1,70,71,81
20,r_71_147_16,r_29_87_135,r_10_115_143,r_71_147_16,1.0,2,18,16,81
87,seq143,r_76_50_57,r_13_107_35,r_13_107_35,1.0,1,36,35,81
59,seq16,r_93_43_159,r_0_48_37,r_0_48_37,1.0,1,38,37,81
14,r_76_50_57,seq143,r_71_147_16,r_71_147_16,0.99,26,42,16,81
38,r_110_129_46,r_37_31_157,r_0_48_37,r_37_31_157,1.0,-113,44,157,81
25,r_0_48_37,r_63_88_199,seq16,r_0_48_37,1.0,1,38,37,81
11,r_10_115_143,seq44,r_71_147_16,r_71_147_16,1.0,2,18,16,81
2,r_29_87_135,r_54_45_165,seq124,r_29_87_135,0.85,1,136,135,81
40,r_128_5_115,r_41_140_168,seq126,r_128_5_115,0.83,1,116,115,81
18,r_32_123_71,r_69_99_176,r_55_139_155,r_32_123_71,0.99,0,71,71,81
29,r_134_90_139,r_55_139_155,r_110_129_46,r_55_139_155,0.99,-16,139,155,81
24,r_59_148_185,seq33,r_145_85_91,r_145_85_91,1.0,95,186,91,81
33,r_113_92_124,r_59_148_185,seq36,r_113_92_124,1.0,0,124,124,81
19,r_116_149_61,r_19_114_48,r_13_107_35,r_13_107_35,1.0,21,56,35,81
13,r_67_25_54,r_142_74_166,r_108_138_42,r_142_74_166,0.68,-116,50,166,81
70,seq35,r_37_31_157,seq131,r_37_31_157,0.99,0,157,157,81
6,r_55_139_155,r_32_123_71,r_19_114_48,r_55_139_155,1.0,0,155,155,81
68,seq33,r_59_148_185,r_136_144_188,r_59_148_185,0.66,1,186,185,81
17,r_142_74_166,seq21,r_141_117_23,r_142_74_166,0.77,0,166,166,81
28,r_63_88_199,r_62_64_164,seq131,r_62_64_164,0.77,5,169,164,81
49,r_146_91_67,r_93_43_159,seq15,r_146_91_67,1.0,-1,66,67,81
18,r_32_123_71,r_55_139_155,r_111_52_140,r_32_123_71,0.68,84,155,71,81
41,r_84_8_32,r_29_87_135,seq102,r_84_8_32,0.9,0,32,32,81
35,r_62_64_164,r_63_88_199,r_93_43_159,r_93_43_159,0.93,10,169,159,81
27,r_77_109_14,r_29_87_135,seq126,r_77_109_14,0.91,0,14,14,81
93,seq108,r_107_32_148,r_4_93_11,r_107_32_148,0.96,-46,102,148,82
30,r_107_32_148,seq108,seq81,r_107_32_148,0.57,0,148,148,82
14,r_67_146_62,r_25_113_95,seq41,r_67_146_62,1.0,0,62,62,82
8,r_114_134_76,r_12_22_88,seq125,r_114_134_76,0.68,3,79,76,82
37,r_100_73_121,seq90,r_56_78_50,r_100_73_121,0.65,0,121,121,82
55,seq13,r_121_147_171,r_142_55_75,r_121_147_171,0.85,1,172,171,82
97,seq125,r_135_47_85,r_114_134_76,r_135_47_85,1.0,-22,63,85,82
5,r_142_55_75,r_137_124_79,seq13,r_137_124_79,1.0,-4,75,79,82
46,r_46_145_116,r_89_61_169,r_25_113_95,r_25_113_95,1.0,33,128,95,82
42,r_95_24_110,r_11_1_108,r_53_40_36,r_95_24_110,0.78,3,113,110,82
45,r_103_20_173,r_45_128_1,seq63,r_103_20_173,0.74,0,173,173,82
19,r_149_6_165,r_101_123_183,r_58_16_56,r_58_16_56,1.0,109,165,56,82
28,r_58_16_56,r_135_47_85,r_143_28_96,r_58_16_56,1.0,2,58,56,82
31,r_31_21_162,r_148_3_198,r_25_113_95,r_31_21_162,0.67,0,162,162,82
20,r_53_40_36,r_135_47_85,seq81,r_53_40_36,0.67,-3,33,36,82
41,r_57_10_106,r_149_6_165,r_85_8_3,r_149_6_165,0.97,-56,109,165,82
67,seq52,r_139_80_192,r_25_113_95,r_25_113_95,1.0,4,99,95,82
3,r_5_44_107,r_143_28_96,r_89_61_169,r_5_44_107,1.0,0,107,107,82
10,r_111_133_74,r_35_102_174,seq90,r_35_102_174,0.74,-98,76,174,82
18,r_143_28_96,r_5_44_107,r_58_16_56,r_143_28_96,0.77,-39,57,96,82
26,r_89_61_169,r_46_145_116,r_5_44_107,r_5_44_107,1.0,18,125,107,82
72,seq63,r_143_28_96,r_103_20_173,r_103_20_173,0.97,1,174,173,82
0,r_36_34_117,seq88,r_77_51_40,r_36_34_117,0.46,0,117,117,82
63,seq41,r_101_123_183,r_67_146_62,r_67_146_62,1.0,113,175,62,82
11,r_69_122_161,r_85_8_3,r_130_66_34,r_130_66_34,0.76,127,161,34,82
15,r_30_117_78,r_18_141_160,seq62,r_30_117_78,0.96,0,78,78,82
6,r_18_141_160,r_45_128_1,r_100_73_121,r_45_128_1,0.68,159,160,1,82
27,r_120_72_142,r_37_70_199,r_48_14_52,r_37_70_199,0.97,-57,142,199,82
47,r_121_147_171,seq13,r_56_78_50,r_56_78_50,0.99,122,172,50,82
43,r_4_93_11,r_38_116_131,seq108,r_4_93_11,0.77,0,11,11,82
40,r_17_105_90,r_69_122_161,r_96_110_32,r_69_122_161,0.97,-73,88,161,82
29,r_35_102_174,r_111_133_74,r_119_79_70,r_35_102_174,0.82,-98,76,174,82
35,r_0_74_182,r_36_34_117,r_58_16_56,r_0_74_182,0.89,1,183,182,82
42,r_95_24_110,r_53_40_36,r_76_49_139,r_76_49_139,0.62,4,143,139,82
25,r_11_1_108,r_95_24_110,seq29,r_11_1_108,1.0,0,108,108,82
33,r_45_128_1,r_103_20_173,seq50,r_103_20_173,1.0,0,173,173,82
21,r_130_66_34,r_38_116_131,seq9,r_130_66_34,0.96,-1,33,34,82
32,r_76_49_139,seq63,r_95_24_110,r_76_49_139,0.96,0,139,139,82
34,r_77_51_40,seq129,seq65,r_77_51_40,0.68,0,40,40,82
9,r_25_113_95,seq9,seq52,r_25_113_95,0.99,1,96,95,82
38,r_56_78_50,seq92,seq65,r_56_78_50,0.99,-1,49,50,82
75,seq68,r_138_144_57,r_106_7_9,r_138_144_57,0.74,-30,27,57,82
29,r_35_102_174,r_119_79_70,seq60,r_35_102_174,0.86,0,174,174,82
22,r_118_26_152,r_0_74_182,r_12_22_88,r_0_74_182,0.7,-29,153,182,82
1,r_138_144_57,seq68,seq87,r_138_144_57,1.0,0,57,57,82
44,r_137_124_79,r_142_55_75,seq87,r_137_124_79,0.98,0,79,79,82
23,r_119_79_70,seq90,r_35_102_174,r_119_79_70,0.44,1,71,70,82
12,r_48_14_52,r_5_44_107,seq19,r_48_14_52,1.0,0,52,52,82
35,r_0_74_182,r_118_26_152,r_36_34_117,r_36_34_117,0.81,36,153,117,82
23,r_119_79_70,r_35_102_174,r_135_47_85,r_35_102_174,0.97,-42,132,174,82
7,r_140_2_41,r_142_55_75,seq115,r_140_2_41,0.76,5,46,41,82
36,r_135_71_117,r_35_146_191,r_103_12_56,r_35_146_191,1.0,-74,117,191,83
43,r_74_121_92,seq104,seq148,r_74_121_92,1.0,1,93,92,83
37,r_44_137_96,seq119,seq2,r_44_137_96,1.0,1,97,96,83
16,r_7_114_167,seq15,r_112_97_2,r_7_114_167,0.75,0,167,167,83
22,r_129_8_162,r_56_50_79,r_16_136_62,r_129_8_162,0.97,1,163,162,83
18,r_56_50_79,r_129_8_162,r_21_140_83,r_129_8_162,1.0,-13,149,162,83
15,r_60_145_10,seq59,r_147_36_7,r_60_145_10,1.0,0,10,10,83
19,r_16_136_62,r_13_149_121,seq88,r_16_136_62,1.0,0,62,62,83
49,r_123_132_95,r_66_78_43,seq85,r_123_132_95,1.0,1,96,95,83
8,r_66_78_43,r_93_72_94,r_123_132_95,r_66_78_43,1.0,0,43,43,83
3,r_42_107_69,r_117_46_115,seq110,r_42_107_69,0.87,1,70,69,83
10,r_11_27_181,seq33,r_64_96_132,r_11_27_181,0.36,0,181,181,83
30,r_131_116_19,r_64_96_132,seq34,r_131_116_19,1.0,0,19,19,83
93,seq108,seq18,r_122_19_25,r_122_19_25,1.0,6,31,25,83
26,r_45_141_152,seq51,r_86_62_32,r_45_141_152,0.95,0,152,152,83
8,r_66_78_43,r_123_132_95,r_28_133_37,r_123_132_95,1.0,1,96,95,83
0,r_95_61_141,seq2,r_56_50_79,r_95_61_141,0.99,2,143,141,83
63,seq148,r_20_105_197,r_74_121_92,r_74_121_92,1.0,-1,91,92,83
20,r_21_140_83,r_63_68_108,seq85,r_21_140_83,0.84,0,83,83,83
13,r_65_81_129,r_69_115_146,seq100,r_65_81_129,0.84,2,131,129,83
48,r_69_115_146,seq119,r_112_97_2,r_69_115_146,0.58,0,146,146,83
46,r_92_128_40,r_35_146_191,seq100,r_92_128_40,1.0,0,40,40,83
42,r_86_62_32,r_64_96_132,seq94,r_64_96_132,0.83,-96,36,132,83
27,r_117_46_115,seq3,r_74_121_92,r_117_46_115,1.0,0,115,115,83
6,r_28_133_37,seq79,seq119,r_28_133_37,1.0,1,38,37,83
49,r_123_132_95,r_11_27_181,r_66_78_43,r_66_78_43,0.99,-4,39,43,83
79,seq79,r_25_58_4,r_103_12_56,r_103_12_56,0.96,11,67,56,83
47,r_84_124_170,seq100,r_42_107_69,r_84_124_170,0.41,0,170,170,83
40,r_54_75_87,seq104,r_122_19_25,r_54_75_87,1.0,0,87,87,83
17,r_76_9_55,r_16_136_62,r_28_133_37,r_76_9_55,1.0,0,55,55,83
18,r_56_50_79,seq10,r_129_8_162,r_56_50_79,0.87,18,97,79,83
29,r_63_68_108,seq88,seq31,r_63_68_108,1.0,0,108,108,83
33,r_93_72_94,seq29,r_26_53_36,r_93_72_94,0.99,0,94,94,83
38,r_138_48_65,seq33,seq37,r_138_48_65,1.0,0,65,65,83
34,r_40_22_81,seq17,r_30_101_128,r_40_22_81,1.0,0,81,81,83
9,r_64_96_132,r_111_70_186,r_65_81_129,r_64_96_132,0.99,1,133,132,83
12,r_122_19_25,r_28_133_37,seq108,r_122_19_25,1.0,0,25,25,83
22,r_129_8_162,seq85,r_56_50_79,r_56_50_79,0.89,31,110,79,83
28,r_144_73_153,seq120,seq34,r_144_73_153,0.86,0,153,153,83
7,r_125_99_156,r_35_146_191,seq47,r_35_146_191,0.67,-30,161,191,83
44,r_57_77_113,seq88,seq59,r_57_77_113,1.0,0,113,113,83
32,r_103_12_56,r_13_149_121,seq49,r_103_12_56,1.0,0,56,56,83
23,r_38_127_136,seq33,seq67,r_38_127_136,0.94,0,136,136,83
82,seq85,r_129_8_162,r_21_140_83,r_21_140_83,0.96,27,110,83,83
35,r_111_70_186,r_64_96_132,r_134_83_8,r_111_70_186,0.65,-53,133,186,83
39,r_26_53_36,seq34,seq104,r_26_53_36,1.0,0,36,36,83
14,r_135_44_134,r_20_66_158,r_9_146_51,r_135_44_134,0.99,0,134,134,84
8,r_37_31_97,r_119_82_157,seq105,r_37_31_97,0.82,0,97,97,84
59,seq145,r_48_68_145,seq107,r_48_68_145,1.0,0,145,145,84
16,r_119_82_157,seq47,r_36_61_196,r_119_82_157,0.63,2,159,157,84
21,r_56_62_168,r_77_78_166,r_116_22_139,r_77_78_166,0.99,0,166,166,84
1,r_77_78_166,r_56_62_168,r_9_146_51,r_77_78_166,0.88,0,166,166,84
80,seq69,r_26_93_174,r_116_22_139,r_26_93_174,0.88,0,174,174,84
51,seq132,r_77_78_166,r_109_59_38,r_109_59_38,0.82,13,51,38,84
45,r_2_72_64,seq115,r_4_106_83,r_2_72_64,1.0,0,64,64,84
29,r_17_136_58,r_98_111_106,seq39,r_17_136_58,1.0,0,58,58,84
19,r_116_22_139,r_26_93_174,r_109_59_38,r_109_59_38,1.0,106,144,38,84
43,r_9_146_51,r_95_1_192,r_137_126_44,r_9_146_51,0.98,1,52,51,84
31,r_118_129_120,seq8,r_84_87_98,r_118_129_120,0.9,0,120,120,84
41,r_4_106_83,r_77_78_166,r_2_72_64,r_2_72_64,0.97,29,93,64,84
35,r_95_1_192,r_9_146_51,r_139_133_32,r_95_1_192,0.73,-140,52,192,84
89,seq99,seq15,r_43_92_114,r_43_92_114,1.0,2,116,114,84
10,r_35_114_111,seq18,r_4_106_83,r_35_114_111,0.99,0,111,111,84
26,r_112_148_119,seq29,seq65,r_112_148_119,0.94,0,119,119,84
11,r_53_30_86,seq15,seq134,r_53_30_86,1.0,0,86,86,84
55,seq138,seq89,r_81_108_23,r_81_108_23,1.0,7,30,23,84
13,r_139_133_32,r_53_30_86,seq23,r_139_133_32,1.0,1,33,32,84
25,r_109_59_38,seq99,seq132,r_109_59_38,1.0,0,38,38,84
22,r_100_25_96,r_6_141_27,seq120,r_100_25_96,1.0,0,96,96,84
40,r_7_127_91,r_84_87_98,seq18,r_7_127_91,0.92,3,94,91,84
18,r_84_87_98,seq134,seq147,r_84_87_98,1.0,1,99,98,84
24,r_13_19_87,seq85,seq117,r_13_19_87,0.99,0,87,87,84
63,seq23,r_95_1_192,r_139_133_32,r_139_133_32,1.0,4,36,32,84
33,r_14_97_117,seq89,seq21,r_14_97_117,1.0,-1,116,117,84
64,seq24,r_90_149_169,r_98_111_106,r_90_149_169,0.77,0,169,169,84
20,r_6_141_27,r_100_25_96,seq79,r_100_25_96,0.92,0,96,96,84
42,r_81_108_23,r_94_122_31,seq138,r_81_108_23,0.98,0,23,23,84
32,r_144_11_115,r_112_148_119,r_17_136_58,r_112_148_119,1.0,-4,115,119,84
38,r_48_68_145,seq145,r_116_22_139,r_48_68_145,0.95,0,145,145,84
20,r_6_141_27,seq124,r_100_25_96,r_6_141_27,1.0,0,27,27,84
34,r_20_66_158,seq33,r_128_142_35,r_20_66_158,0.91,0,158,158,84
48,r_137_126_44,r_10_40_135,r_42_60_15,r_137_126_44,0.79,2,46,44,84
60,seq18,r_98_111_106,r_7_127_91,r_7_127_91,1.0,19,110,91,84
17,r_63_86_108,seq39,r_53_30_86,r_63_86_108,0.61,0,108,108,84
96,seq120,r_83_140_167,seq45,r_83_140_167,0.93,2,169,167,84
0,r_94_122_31,r_112_148_119,seq33,r_94_122_31,0.99,0,31,31,84
28,r_50_76_137,r_130_58_2,r_84_87_98,r_84_87_98,0.52,39,137,98,84
91,seq105,r_103_101_184,r_37_31_97,r_37_31_97,0.83,2,99,97,84
7,r_88_96_82,seq46,seq110,r_88_96_82,1.0,1,83,82,84
44,r_26_93_174,seq69,r_130_58_2,r_26_93_174,0.58,0,174,174,84
23,r_98_111_106,seq18,seq49,r_98_111_106,0.52,2,108,106,84
3,r_128_142_35,r_10_40_135,seq73,r_10_40_135,0.65,-98,37,135,84
22,r_100_25_96,r_84_87_98,r_6_141_27,r_6_141_27,0.99,2,29,27,84
12,r_91_32_84,r_116_22_139,seq29,r_91_32_84,1.0,0,84,84,84
6,r_27_28_48,r_98_111_106,seq55,r_27_28_48,1.0,0,48,48,84
36,r_45_53_98,seq37,seq61,r_45_53_98,0.99,0,98,98,85
14,r_121_79_188,r_3_51_184,r_40_138_117,r_40_138_117,1.0,54,171,117,85
88,seq92,r_119_89_36,r_52_24_109,r_119_89_36,0.8,1,37,36,85
37,r_3_51_184,r_121_79_188,r_117_6_64,r_117_6_64,0.76,120,184,64,85
1,r_34_124_157,seq143,r_134_135_3,r_34_124_157,0.76,0,157,157,85
5,r_117_6_64,r_56_91_135,seq92,r_117_6_64,1.0,0,64,64,85
46,r_58_114_71,seq136,seq21,r_58_114_71,1.0,0,71,71,85
42,r_8_84_89,r_112_102_92,r_133_55_17,r_8_84_89,0.99,2,91,89,85
80,seq71,r_94_67_173,r_58_114_71,r_58_114_71,1.0,95,166,71,85
61,seq17,r_15_23_196,r_74_14_40,r_74_14_40,1.0,15,55,40,85
39,r_149_26_45,r_121_79_188,r_40_138_117,r_40_138_117,1.0,72,189,117,85
41,r_144_130_100,r_62_108_123,r_149_26_45,r_144_130_100,0.88,0,100,100,85
3,r_31_76_94,seq106,r_117_6_64,r_31_76_94,0.79,2,96,94,85
26,r_52_24_109,r_27_68_193,r_116_120_38,r_52_24_109,1.0,0,109,109,85
4,r_126_0_143,seq1,r_113_22_23,r_126_0_143,0.96,1,144,143,85
6,r_133_55_17,seq146,r_16_93_103,r_133_55_17,1.0,0,17,17,85
0,r_62_108_123,r_59_35_166,r_39_110_119,r_62_108_123,0.86,29,152,123,85
39,r_149_26_45,r_98_72_116,r_121_79_188,r_149_26_45,1.0,0,45,45,85
20,r_94_67_173,seq71,r_36_19_12,r_94_67_173,0.4,0,173,173,85
13,r_56_91_135,seq25,seq106,r_56_91_135,0.93,2,137,135,85
15,r_82_87_128,seq88,seq5,r_82_87_128,0.64,1,129,128,85
48,r_27_68_193,r_52_24_109,r_36_19_12,r_52_24_109,0.79,-10,99,109,85
23,r_63_42_22,r_119_89_36,seq13,r_63_42_22,1.0,2,24,22,85
28,r_83_131_37,r_117_6_64,r_63_42_22,r_83_131_37,1.0,0,37,37,85
10,r_122_90_58,r_31_76_94,seq143,r_122_90_58,1.0,0,58,58,85
8,r_118_129_39,r_4_46_177,seq11,r_118_129_39,0.96,2,41,39,85
27,r_98_72_116,seq71,seq105,r_98_72_116,0.67,0,116,116,85
47,r_86_28_113,r_145_7_162,r_16_93_103,r_86_28_113,0.97,0,113,113,85
18,r_80_60_138,r_12_123_154,r_117_6_64,r_117_6_64,0.98,75,139,64,85
25,r_112_102_92,r_12_123_154,r_83_131_37,r_112_102_92,1.0,0,92,92,85
33,r_12_123_154,seq111,r_133_55_17,r_12_123_154,0.75,0,154,154,85
17,r_116_120_38,r_59_35_166,seq70,r_116_120_38,1.0,0,38,38,85
6,r_133_55_17,r_16_93_103,r_8_84_89,r_133_55_17,0.99,86,103,17,85
14,r_121_79_188,r_40_138_117,r_119_89_36,r_121_79_188,0.87,1,189,188,85
32,r_145_7_162,seq21,r_116_120_38,r_145_7_162,0.63,0,162,162,85
38,r_104_57_83,r_112_102_92,seq115,r_104_57_83,1.0,2,85,83,85
2,r_50_54_53,r_117_6_64,seq96,r_50_54_53,0.99,1,54,53,85
34,r_59_35_166,r_62_108_123,r_98_72_116,r_59_35_166,0.89,0,166,166,85
75,seq61,seq64,r_45_53_98,r_45_53_98,1.0,7,105,98,85
29,r_103_18_48,r_15_23_196,r_116_120_38,r_103_18_48,0.99,0,48,48,85
60,seq143,r_34_124_157,r_122_90_58,r_122_90_58,1.0,97,155,58,85
9,r_40_138_117,r_15_23_196,r_149_26_45,r_40_138_117,0.92,0,117,117,85
22,r_16_93_103,seq61,seq29,r_16_93_103,0.91,0,103,103,85
35,r_74_14_40,seq136,seq17,r_74_14_40,1.0,0,40,40,85
49,r_147_81_104,seq37,r_113_22_23,r_147_81_104,1.0,0,104,104,85
7,r_119_89_36,seq92,seq32,r_119_89_36,0.98,1,37,36,85
12,r_4_46_177,r_127_137_194,r_40_138_117,r_40_138_117,0.97,61,178,117,85
93,seq106,seq29,r_19_0_80,r_19_0_80,1.0,5,85,80,86
30,r_14_111_142,seq5,r_139_125_105,r_14_111_142,0.99,0,142,142,86
36,r_28_59_154,r_123_31_198,r_121_91_122,r_28_59_154,0.97,0,154,154,86
8,r_24_133_136,r_70_35_177,r_119_96_1,r_24_133_136,0.47,0,136,136,86
43,r_38_110_112,seq82,r_43_114_104,r_38_110_112,1.0,0,112,112,86
37,r_21_146_188,seq48,r_90_11_103,r_90_11_103,0.97,85,188,103,86
3,r_1_39_137,seq136,seq82,r_1_39_137,1.0,0,137,137,86
10,r_13_63_18,r_34_77_68,seq58,r_34_77_68,0.87,-38,30,68,86
16,r_121_91_122,r_20_45_118,seq7,r_20_45_118,1.0,0,118,118,86
21,r_147_50_153,seq76,r_137_120_126,r_147_50_153,0.23,1,154,153,86
12,r_79_30_46,r_87_25_143,seq143,r_79_30_46,1.0,3,49,46,86
1,r_3_98_22,r_137_120_126,seq129,r_137_120_126,0.95,1,127,126,86
46,r_43_114_104,r_24_133_136,r_38_110_112,r_38_110_112,1.0,14,126,112,86
4,r_124_53_12,seq106,seq102,r_124_53_12,0.73,13,25,12,86
45,r_86_131_119,seq126,r_6_40_82,r_86_131_119,0.85,0,119,119,86
19,r_89_149_61,r_34_77_68,seq126,r_89_149_61,1.0,0,61,61,86
31,r_87_25_143,seq64,seq32,r_87_25_143,0.93,1,144,143,86
41,r_41_112_157,seq58,seq29,r_41_112_157,0.76,1,158,157,86
67,seq36,r_51_148_148,r_137_120_126,r_51_148_148,0.83,-1,147,148,86
3,r_1_39_137,r_128_73_43,seq136,r_128_73_43,0.77,-3,40,43,86
26,r_51_148_148,seq36,seq82,r_51_148_148,0.99,0,148,148,86
81,seq80,r_51_148_148,seq15,r_51_148_148,0.99,-25,123,148,86
0,r_18_71_131,r_52_135_48,seq78,r_18_71_131,0.84,1,132,131,86
73,seq58,r_41_112_157,r_13_63_18,r_41_112_157,0.62,1,158,157,86
11,r_127_97_86,r_87_25_143,seq143,r_127_97_86,1.0,0,86,86,86
20,r_19_0_80,seq37,seq106,r_19_0_80,1.0,0,80,80,86
15,r_132_108_95,r_137_120_126,r_19_0_80,r_132_108_95,0.47,0,95,95,86
6,r_137_120_126,r_132_108_95,r_139_125_105,r_132_108_95,1.0,2,97,95,86
13,r_57_94_32,r_14_111_142,seq107,r_57_94_32,0.78,1,33,32,86
27,r_92_83_90,seq129,seq126,r_92_83_90,1.0,1,91,90,86
2,r_90_11_103,r_119_96_1,seq32,r_90_11_103,1.0,0,103,103,86
18,r_70_35_177,seq17,seq10,r_70_35_177,0.3,-15,162,177,86
29,r_122_141_182,seq37,r_3_98_22,r_3_98_22,0.59,160,182,22,86
24,r_139_125_105,r_67_103_190,r_137_120_126,r_67_103_190,0.77,-90,100,190,86
34,r_128_73_43,r_1_39_137,seq142,r_128_73_43,1.0,0,43,43,86
33,r_16_22_59,r_92_83_90,seq142,r_92_83_90,0.94,-28,62,90,86
32,r_74_23_75,seq88,seq136,r_74_23_75,1.0,4,79,75,86
77,seq69,r_139_125_105,r_34_77_68,r_34_77_68,1.0,24,92,68,86
48,r_27_8_55,seq143,seq2,r_27_8_55,1.0,1,56,55,86
81,seq80,r_116_66_67,r_51_148_148,r_116_66_67,0.89,0,67,67,86
17,r_6_40_82,r_18_71_131,r_95_49_16,r_6_40_82,1.0,0,82,82,86
1,r_3_98_22,r_19_0_80,r_137_120_126,r_3_98_22,0.97,-1,21,22,86
9,r_34_77_68,seq82,seq69,r_34_77_68,1.0,1,69,68,86
38,r_93_72_15,seq29,seq4,r_93_72_15,1.0,0,15,15,86
22,r_47_65_76,seq107,seq42,r_47_65_76,1.0,3,79,76,86
7,r_116_66_67,seq80,seq37,r_116_66_67,1.0,0,67,67,86
23,r_20_45_118,r_121_91_122,r_128_73_43,r_20_45_118,1.0,0,118,118,86
5,r_140_84_34,r_52_135_48,seq44,r_140_84_34,1.0,0,34,34,86
40,r_65_72_19,r_63_129_147,r_56_108_117,r_56_108_117,0.74,3,120,117,87
36,r_83_98_106,r_107_11_101,r_28_41_188,r_83_98_106,0.52,-38,68,106,87
14,r_117_10_64,r_4_67_129,r_9_43_29,r_4_67_129,0.57,-65,64,129,87
8,r_19_36_81,r_115_132_155,seq50,r_19_36_81,0.79,4,85,81,87
58,seq12,r_56_108_117,r_104_145_119,r_56_108_117,1.0,-1,116,117,87
43,r_56_108_117,seq12,r_65_72_19,r_56_108_117,0.99,-1,116,117,87
3,r_121_135_16,r_88_87_134,r_15_143_89,r_121_135_16,0.59,118,134,16,87
86,seq92,r_83_98_106,r_99_3_14,r_83_98_106,0.57,4,110,106,87
1,r_2_14_110,r_45_118_192,r_30_75_149,r_2_14_110,0.66,0,110,110,87
5,r_51_149_116,seq103,r_95_47_183,r_51_149_116,0.97,0,116,116,87
58,seq12,r_26_13_42,r_56_108_117,r_26_13_42,0.48,0,42,42,87
19,r_107_11_101,r_83_98_106,seq122,r_107_11_101,1.0,1,102,101,87
36,r_83_98_106,r_28_41_188,seq134,r_83_98_106,0.98,1,107,106,87
95,seq120,r_102_18_159,r_85_31_41,r_85_31_41,0.96,58,99,41,87
66,seq32,r_115_132_155,r_74_60_69,r_74_60_69,0.9,1,70,69,87
67,seq34,r_115_132_155,r_74_60_69,r_74_60_69,0.95,86,155,69,87
37,r_42_23_53,r_63_129_147,r_90_66_143,r_42_23_53,1.0,-5,48,53,87
10,r_130_89_133,r_114_33_169,r_5_101_128,r_114_33_169,0.72,-34,135,169,87
26,r_68_6_152,seq35,r_121_135_16,r_68_6_152,0.52,3,155,152,87
4,r_30_75_149,r_2_14_110,seq16,r_30_75_149,0.96,0,149,149,87
33,r_114_33_169,r_90_66_143,r_51_149_116,r_114_33_169,0.98,0,169,169,87
4,r_30_75_149,r_68_6_152,r_2_14_110,r_2_14_110,0.77,4,114,110,87
0,r_52_21_66,seq138,r_82_17_52,r_52_21_66,1.0,0,66,66,87
11,r_5_101_128,seq97,r_130_89_133,r_5_101_128,0.37,0,128,128,87
1,r_2_14_110,r_30_75_149,seq147,r_30_75_149,0.9,0,149,149,87
20,r_63_129_147,seq134,seq12,r_63_129_147,0.85,2,149,147,87
15,r_44_140_150,seq58,seq91,r_44_140_150,0.92,0,150,150,87
48,r_131_124_115,r_28_41_188,r_74_60_69,r_28_41_188,0.96,-73,115,188,87
6,r_4_67_129,r_61_24_131,r_26_13_42,r_4_67_129,0.97,0,129,129,87
27,r_100_141_166,seq35,seq71,r_100_141_166,0.6,2,168,166,87
3,r_121_135_16,r_52_21_66,r_88_87_134,r_121_135_16,0.87,0,16,16,87
58,seq12,r_104_145_119,r_63_129_147,r_63_129_147,0.75,14,161,147,87
17,r_26_13_42,seq12,seq64,r_26_13_42,0.73,-14,28,42,87
2,r_115_132_155,r_105_94_154,r_61_24_131,r_115_132_155,0.43,0,155,155,87
18,r_105_94_154,r_115_132_155,r_99_3_14,r_99_3_14,0.71,141,155,14,87
29,r_79_136_17,r_4_67_129,seq142,r_79_136_17,0.94,0,17,17,87
24,r_90_66_143,r_102_18_159,r_42_23_53,r_42_23_53,1.0,-3,50,53,87
33,r_114_33_169,r_130_89_133,r_90_66_143,r_114_33_169,0.5,-30,139,169,87
30,r_85_31_41,seq146,seq120,r_85_31_41,0.99,1,42,41,87
70,seq50,r_112_46_170,r_19_36_81,r_19_36_81,1.0,93,174,81,87
68,seq35,r_100_141_166,r_2_14_110,r_2_14_110,0.5,56,166,110,87
38,r_15_143_89,seq53,r_121_135_16,r_15_143_89,0.98,-7,82,89,87
77,seq71,r_45_118_192,r_100_141_166,r_100_141_166,0.84,0,166,166,87
22,r_99_3_14,r_104_145_119,r_8_20_11,r_99_3_14,0.91,0,14,14,87
34,r_112_46_170,seq50,r_44_140_150,r_44_140_150,1.0,24,174,150,87
9,r_59_69_79,seq22,seq138,r_59_69_79,0.94,0,79,79,87
31,r_88_87_134,r_121_135_16,seq142,r_88_87_134,0.92,0,134,134,87
37,r_42_23_53,r_90_66_143,r_19_36_81,r_19_36_81,1.0,75,156,81,87
28,r_74_60_69,r_130_89_133,seq32,r_74_60_69,1.0,0,69,69,87
40,r_65_72_19,r_4_67_129,r_63_129_147,r_65_72_19,0.92,2,21,19,87
49,r_39_84_112,r_44_140_150,seq73,r_39_84_112,0.99,0,112,112,87
7,r_82_17_52,r_4_67_129,r_52_21_66,r_82_17_52,0.95,13,65,52,87
23,r_110_96_92,seq76,seq86,r_110_96_92,0.99,-1,91,92,87
32,r_27_70_21,r_104_145_119,seq86,r_27_70_21,1.0,0,21,21,87
31,r_88_87_134,r_5_101_128,r_121_135_16,r_121_135_16,0.89,0,16,16,87
79,seq76,r_110_96_92,seq142,r_110_96_92,0.99,-2,90,92,87
26,r_58_28_33,r_22_62_121,seq138,r_58_28_33,0.75,12,45,33,88
70,seq36,r_71_106_141,r_45_35_40,r_45_35_40,1.0,7,47,40,88
8,r_98_111_83,seq29,seq127,r_98_111_83,0.97,0,83,83,88
37,r_48_41_70,r_59_70_155,seq66,r_48_41_70,1.0,0,70,70,88
16,r_144_132_85,r_140_129_136,seq54,r_144_132_85,1.0,0,85,85,88
1,r_5_60_145,seq64,seq38,r_5_60_145,0.91,0,145,145,88
97,seq121,r_125_47_153,r_45_35_40,r_45_35_40,0.65,113,153,40,88
38,r_115_83_43,seq134,seq18,r_115_83_43,1.0,5,48,43,88
5,r_102_72_185,r_32_119_7,r_149_94_156,r_149_94_156,0.78,23,179,156,88
42,r_142_84_68,seq53,seq136,r_142_84_68,1.0,0,68,68,88
13,r_11_103_13,r_146_79_19,seq134,r_11_103_13,1.0,0,13,13,88
19,r_63_82_115,seq145,r_133_34_159,r_63_82_115,0.91,1,116,115,88
30,r_49_26_25,r_130_10_50,r_32_119_7,r_32_119_7,0.95,20,27,7,88
31,r_81_95_139,seq86,r_98_111_83,r_81_95_139,0.6,0,139,139,88
21,r_76_15_29,r_12_46_18,r_112_1_3,r_76_15_29,0.95,-9,20,29,88
10,r_112_1_3,seq66,r_76_15_29,r_76_15_29,0.86,49,78,29,88
4,r_4_67_194,r_21_40_140,r_37_93_105,r_21_40_140,1.0,1,141,140,88
0,r_59_70_155,seq27,r_21_40_140,r_59_70_155,0.77,4,159,155,88
11,r_52_57_122,seq30,seq25,r_52_57_122,0.98,0,122,122,88
20,r_50_19_76,seq104,seq25,r_50_19_76,1.0,2,78,76,88
12,r_130_10_50,r_71_106_141,seq139,r_130_10_50,0.97,0,50,50,88
44,r_14_120_57,seq89,seq38,r_14_120_57,1.0,1,58,57,88
15,r_71_106_141,seq90,r_96_128_94,r_71_106_141,0.44,13,154,141,88
99,seq127,seq138,r_98_111_83,r_98_111_83,0.99,30,113,83,88
36,r_22_62_121,r_110_141_9,seq131,r_22_62_121,0.95,6,127,121,88
9,r_108_73_52,r_6_61_56,seq86,r_108_73_52,1.0,1,53,52,88
2,r_92_68_169,seq107,r_45_35_40,r_92_68_169,0.53,0,169,169,88
47,r_122_13_123,r_143_88_182,r_108_73_52,r_122_13_123,0.97,1,124,123,88
40,r_149_94_156,r_32_119_7,r_142_84_68,r_149_94_156,0.58,0,156,156,88
36,r_22_62_121,r_58_28_33,r_110_141_9,r_22_62_121,0.82,-111,10,121,88
29,r_2_23_134,seq27,r_147_8_47,r_2_23_134,0.75,0,134,134,88
24,r_117_56_75,seq131,seq104,r_117_56_75,1.0,0,75,75,88
25,r_21_40_140,r_4_67_194,seq138,r_21_40_140,0.69,1,141,140,88
43,r_45_35_40,r_37_93_105,seq36,r_45_35_40,1.0,4,44,40,88
17,r_12_46_18,r_76_15_29,r_55_99_65,r_12_46_18,0.98,0,18,18,88
64,seq25,seq53,r_50_19_76,r_50_19_76,1.0,4,80,76,88
50,seq0,r_22_62_121,r_110_141_9,r_22_62_121,0.91,8,129,121,88
65,seq27,r_2_23_134,r_55_99_65,r_2_23_134,0.96,0,134,134,88
28,r_78_77_32,r_149_94_156,seq64,r_78_77_32,1.0,2,34,32,88
34,r_124_97_107,seq17,seq80,r_124_97_107,1.0,0,107,107,88
32,r_146_79_19,seq20,seq54,r_146_79_19,0.98,0,19,19,88
31,r_81_95_139,r_98_111_83,seq31,r_81_95_139,0.5,38,177,139,88
22,r_133_34_159,seq131,r_110_141_9,r_133_34_159,0.68,0,159,159,88
18,r_110_141_9,r_22_62_121,seq0,r_22_62_121,0.94,6,127,121,88
23,r_125_47_153,r_96_128_94,seq29,r_125_47_153,0.69,0,153,153,88
17,r_12_46_18,r_55_99_65,r_144_132_85,r_144_132_85,1.0,45,130,85,88
79,seq66,seq86,r_48_41_70,r_48_41_70,1.0,3,73,70,88
46,r_6_61_56,r_125_47_153,r_49_26_25,r_6_61_56,0.99,0,56,56,88
35,r_96_128_94,r_125_47_153,seq131,r_125_47_153,0.84,-49,104,153,88
3,r_55_99_65,r_39_85_190,seq18,r_55_99_65,0.42,-27,38,65,88
93,seq107,r_74_7_116,seq55,r_74_7_116,1.0,1,117,116,89
24,r_34_94_99,r_138_108_172,r_106_5_126,r_106_5_126,0.81,-2,124,126,89
32,r_81_109_54,seq112,r_145_132_13,r_81_109_54,1.0,1,55,54,89
44,r_17_53_60,r_100_135_178,r_47_63_21,r_17_53_60,0.98,-1,59,60,89
18,r_14_134_37,r_129_60_163,seq65,r_14_134_37,1.0,2,39,37,89
43,r_48_72_176,seq68,r_83_131_113,r_83_131_113,0.97,63,176,113,89
30,r_115_79_56,r_34_94_99,seq112,r_34_94_99,0.68,-43,56,99,89
37,r_127_6_136,seq140,r_106_5_126,r_127_6_136,0.96,2,138,136,89
15,r_123_58_180,seq16,r_74_7_116,r_123_58_180,0.89,-78,102,180,89
46,r_117_71_25,r_138_108_172,seq2,r_117_71_25,1.0,0,25,25,89
16,r_90_122_140,seq23,r_84_73_2,r_90_122_140,0.94,0,140,140,89
39,r_111_66_148,seq78,r_145_132_13,r_111_66_148,0.61,0,148,148,89
1,r_106_5_126,r_32_91_74,r_127_6_136,r_106_5_126,0.99,3,129,126,89
42,r_139_148_80,seq0,seq133,r_139_148_80,1.0,0,80,80,89
38,r_74_7_116,r_123_58_180,seq11,r_74_7_116,0.86,24,140,116,89
68,seq39,r_85_37_79,seq88,r_85_37_79,1.0,-35,44,79,89
69,seq44,seq149,r_77_19_110,r_77_19_110,1.0,22,132,110,89
19,r_87_24_187,seq65,r_137_147_18,r_137_147_18,0.85,170,188,18,89
76,seq65,r_87_24_187,r_14_134_37,r_14_134_37,1.0,151,188,37,89
24,r_34_94_99,seq39,r_138_108_172,r_34_94_99,0.99,0,99,99,89
31,r_52_4_149,r_57_18_199,r_136_50_61,r_52_4_149,0.92,0,149,149,89
41,r_129_60_163,seq124,r_75_64_12,r_129_60_163,0.36,5,168,163,89
3,r_141_118_112,seq78,seq10,r_141_118_112,1.0,0,112,112,89
26,r_100_135_178,seq2,r_14_134_37,r_14_134_37,0.95,141,178,37,89
0,r_146_110_175,seq120,seq0,r_146_110_175,0.65,0,175,175,89
63,seq26,r_43_40_181,r_102_15_109,r_102_15_109,1.0,72,181,109,89
11,r_57_18_199,r_101_31_77,r_28_1_55,r_57_18_199,0.99,-126,73,199,89
17,r_20_38_50,r_90_122_140,seq59,r_20_38_50,0.77,-2,48,50,89
28,r_138_108_172,r_117_71_25,r_43_40_181,r_117_71_25,1.0,0,25,25,89
20,r_101_31_77,seq128,r_115_79_56,r_101_31_77,1.0,0,77,77,89
98,seq124,r_129_60_163,r_117_71_25,r_117_71_25,0.94,143,168,25,89
57,seq12,r_83_131_113,r_145_132_13,r_83_131_113,0.92,0,113,113,89
6,r_77_19_110,r_146_110_175,seq44,r_77_19_110,0.98,0,110,110,89
27,r_28_1_55,r_100_135_178,r_57_18_199,r_28_1_55,1.0,0,55,55,89
94,seq112,r_81_109_54,r_115_79_56,r_81_109_54,0.97,1,55,54,89
47,r_36_69_127,seq133,seq23,r_36_69_127,0.96,1,128,127,89
25,r_102_15_109,seq54,seq26,r_102_15_109,0.99,1,110,109,89
38,r_74_7_116,seq107,r_123_58_180,r_74_7_116,0.59,2,118,116,89
77,seq67,r_80_143_146,seq39,r_80_143_146,0.91,2,148,146,89
40,r_47_63_21,r_41_104_167,r_17_53_60,r_41_104_167,0.89,-104,63,167,89
72,seq54,r_102_15_109,seq93,r_102_15_109,0.99,-51,58,109,89
34,r_80_143_146,seq67,r_75_64_12,r_80_143_146,0.81,0,146,146,89
5,r_137_147_18,r_116_114_138,seq133,r_137_147_18,0.8,0,18,18,89
75,seq61,r_116_114_138,r_92_126_190,r_116_114_138,1.0,0,138,138,89
60,seq16,seq2,r_136_50_61,r_136_50_61,1.0,40,101,61,89
28,r_138_108_172,r_34_94_99,seq54,r_138_108_172,0.88,1,173,172,89
9,r_42_98_90,seq96,seq120,r_42_98_90,1.0,-1,89,90,89
24,r_34_94_99,r_115_79_56,seq39,r_115_79_56,0.92,-2,54,56,89
15,r_123_58_180,r_74_7_116,r_141_118_112,r_123_58_180,0.68,0,180,180,89
28,r_138_108_172,r_43_40_181,r_34_94_99,r_34_94_99,0.99,5,104,99,89
40,r_47_63_21,r_141_118_112,r_41_104_167,r_47_63_21,0.98,0,21,21,89
49,r_99_3_143,r_146_110_175,seq125,r_99_3_143,0.94,0,143,143,89
56,seq11,r_123_58_180,r_74_7_116,r_123_58_180,0.31,-76,104,180,89
23,r_43_40_181,seq26,r_145_132_13,r_43_40_181,0.56,0,181,181,89
79,seq140,r_127_6_136,r_92_126_190,r_127_6_136,0.99,2,138,136,89
35,r_41_104_167,r_45_56_155,r_101_31_77,r_41_104_167,0.72,0,167,167,89
12,r_83_131_113,seq12,seq88,r_83_131_113,0.92,0,113,113,89
8,r_145_132_13,r_80_143_146,seq46,r_145_132_13,1.0,0,13,13,89
2,r_75_64_12,r_21_9_195,seq130,r_75_64_12,0.69,-1,11,12,89
84,seq88,seq39,r_83_131_113,r_83_131_113,1.0,8,121,113,89
93,seq109,r_104_57_140,seq24,r_104_57_140,1.0,0,140,140,90
37,r_54_112_159,r_31_106_42,r_87_72_37,r_54_112_159,0.77,-112,47,159,90
14,r_129_146_102,seq33,seq130,r_129_146_102,0.96,0,102,102,90
8,r_26_143_180,seq118,r_49_85_1,r_26_143_180,0.5,0,180,180,90
16,r_116_19_74,r_132_69_104,r_82_16_13,r_82_16_13,0.91,-3,10,13,90
43,r_93_83_66,r_94_64_46,r_145_58_24,r_93_83_66,0.69,0,66,66,90
83,seq75,r_136_66_75,r_113_11_27,r_136_66_75,0.98,1,76,75,90
4,r_82_16_13,r_70_96_89,r_116_19_74,r_82_16_13,0.95,-3,10,13,90
86,seq88,r_60_65_182,r_142_122_48,r_142_122_48,1.0,134,182,48,90
1,r_70_96_89,seq147,r_7_141_29,r_70_96_89,0.88,1,90,89,90
42,r_12_137_184,seq139,r_22_77_26,r_22_77_26,0.8,159,185,26,90
39,r_145_58_24,r_70_96_89,seq27,r_145_58_24,0.92,0,24,24,90
19,r_104_57_140,seq109,r_97_78_52,r_104_57_140,0.86,0,140,140,90
6,r_97_78_52,seq148,seq86,r_97_78_52,1.0,1,53,52,90
70,seq44,seq108,r_113_11_27,r_113_11_27,0.75,26,53,27,90
11,r_35_55_177,r_82_16_13,r_41_4_94,r_35_55_177,0.66,0,177,177,90
41,r_40_74_170,seq119,r_41_4_94,r_41_4_94,0.59,76,170,94,90
26,r_37_73_128,r_32_56_80,seq68,r_32_56_80,0.53,48,128,80,90
3,r_136_66_75,seq75,r_92_76_10,r_136_66_75,1.0,0,75,75,90
26,r_37_73_128,seq10,r_32_56_80,r_37_73_128,0.29,-46,82,128,90
16,r_116_19_74,r_82_16_13,r_32_56_80,r_116_19_74,1.0,1,75,74,90
0,r_29_81_133,r_117_101_123,seq2,r_29_81_133,0.92,0,133,133,90
29,r_79_128_40,r_132_69_104,seq13,r_79_128_40,0.99,1,41,40,90
11,r_35_55_177,r_104_57_140,r_82_16_13,r_104_57_140,0.78,-49,91,140,90
48,r_89_0_95,seq24,r_87_72_37,r_89_0_95,1.0,1,96,95,90
4,r_82_16_13,r_116_19_74,r_35_55_177,r_116_19_74,0.96,1,75,74,90
20,r_94_64_46,seq15,r_34_124_43,r_34_124_43,0.59,5,48,43,90
13,r_113_11_27,r_104_57_140,seq44,r_104_57_140,0.53,-111,29,140,90
27,r_135_1_148,seq23,r_117_101_123,r_135_1_148,0.9,1,149,148,90
22,r_34_124_43,r_14_51_22,r_94_64_46,r_34_124_43,1.0,0,43,43,90
2,r_60_65_182,seq88,r_135_1_148,r_135_1_148,0.61,34,182,148,90
10,r_7_141_29,seq24,seq118,r_7_141_29,0.99,0,29,29,90
24,r_115_105_63,r_104_57_140,r_117_101_123,r_115_105_63,0.96,3,66,63,90
25,r_8_140_76,r_104_57_140,r_93_83_66,r_8_140_76,0.69,0,76,76,90
33,r_100_84_101,r_117_101_123,seq42,r_100_84_101,1.0,0,101,101,90
21,r_28_149_69,r_26_143_180,seq62,r_28_149_69,1.0,0,69,69,90
44,r_22_77_26,r_129_146_102,seq23,r_22_77_26,0.96,1,27,26,90
21,r_28_149_69,r_87_72_37,r_26_143_180,r_87_72_37,0.71,0,37,37,90
61,seq23,seq3,r_22_77_26,r_22_77_26,1.0,47,73,26,90
32,r_134_52_116,r_14_51_22,r_97_78_52,r_97_78_52,1.0,97,149,52,90
38,r_50_123_93,seq17,seq15,r_50_123_93,1.0,0,93,93,90
34,r_110_43_141,r_102_95_158,seq33,r_102_95_158,0.56,-12,146,158,90
31,r_31_106_42,r_54_112_159,seq99,r_31_106_42,0.99,5,47,42,90
45,r_87_72_37,r_54_112_159,r_89_0_95,r_89_0_95,1.0,38,133,95,90
17,r_41_4_94,r_125_21_111,r_22_77_26,r_41_4_94,0.85,0,94,94,90
94,seq111,r_6_144_176,r_132_69_104,r_132_69_104,0.99,72,176,104,90
9,r_132_69_104,r_125_21_111,r_50_123_93,r_132_69_104,0.97,0,104,104,90
43,r_93_83_66,r_145_58_24,r_8_140_76,r_8_140_76,0.93,2,78,76,90
56,seq13,seq67,r_79_128_40,r_79_128_40,1.0,-1,39,40,90
37,r_54_112_159,r_87_72_37,r_14_51_22,r_54_112_159,0.89,1,160,159,90
4,r_82_16_13,r_35_55_177,r_102_95_158,r_35_55_177,0.57,0,177,177,90
28,r_36_127_61,seq148,r_14_51_22,r_36_127_61,1.0,1,62,61,90
88,seq91,r_50_123_93,r_70_96_89,r_50_123_93,0.77,-9,84,93,90
23,r_125_21_111,seq68,r_31_106_42,r_125_21_111,1.0,0,111,111,90
35,r_18_103_146,seq33,r_49_85_1,r_18_103_146,0.97,3,149,146,90
12,r_32_56_80,r_37_73_128,r_116_19_74,r_32_56_80,0.89,30,110,80,90
36,r_142_122_48,r_104_57_140,seq88,r_142_122_48,1.0,0,48,48,90
45,r_87_72_37,r_28_149_69,r_54_112_159,r_28_149_69,0.6,-32,37,69,90
30,r_131_78_159,r_4_109_149,r_146_19_73,r_146_19_73,1.0,37,110,73,91
8,r_139_57_141,r_107_112_157,r_55_44_93,r_139_57_141,0.96,1,142,141,91
83,seq86,r_99_62_155,r_64_51_49,r_64_51_49,1.0,51,100,49,91
16,r_5_143_126,seq25,seq18,r_5_143_126,1.0,2,128,126,91
1,r_84_111_164,seq103,r_139_57_141,r_139_57_141,0.96,24,165,141,91
5,r_105_53_161,r_81_72_121,r_12_149_119,r_12_149_119,0.96,16,135,119,91
45,r_99_62_155,seq86,r_49_127_1,r_49_127_1,0.75,156,157,1,91
35,r_64_51_49,r_139_57_141,r_29_63_34,r_64_51_49,0.77,2,51,49,91
19,r_37_46_92,r_128_134_138,seq14,r_37_46_92,1.0,0,92,92,91
31,r_146_19_73,seq21,r_118_140_9,r_146_19_73,1.0,0,73,73,91
41,r_115_31_170,seq103,seq3,r_115_31_170,0.49,1,171,170,91
3,r_133_67_118,seq83,r_23_7_103,r_133_67_118,0.97,0,118,118,91
11,r_29_63_34,r_133_67_118,seq86,r_133_67_118,0.61,-84,34,118,91
10,r_92_114_96,r_85_125_116,seq25,r_92_114_96,0.99,-25,71,96,91
34,r_129_141_48,seq2,r_32_68_27,r_129_141_48,0.84,0,48,48,91
5,r_105_53_161,r_12_149_119,r_84_111_164,r_105_53_161,0.94,2,163,161,91
43,r_61_8_36,r_128_134_138,seq77,r_61_8_36,0.98,0,36,36,91
0,r_138_10_188,r_131_78_159,r_88_137_71,r_88_137_71,0.99,20,91,71,91
73,seq65,r_128_134_138,r_85_125_116,r_85_125_116,0.99,22,138,116,91
20,r_73_59_67,r_23_7_103,seq113,r_73_59_67,0.96,1,68,67,91
15,r_4_109_149,r_131_78_159,seq54,r_4_109_149,0.97,0,149,149,91
48,r_88_137_71,r_146_19_73,r_138_10_188,r_138_10_188,1.0,-117,71,188,91
36,r_76_42_17,r_24_35_153,seq124,r_76_42_17,1.0,0,17,17,91
6,r_55_44_93,seq113,seq25,r_55_44_93,0.99,-1,92,93,91
21,r_118_140_9,r_131_78_159,r_146_19_73,r_146_19_73,1.0,89,162,73,91
96,seq148,r_0_110_61,r_28_43_38,r_28_43_38,0.6,12,50,38,91
0,r_138_10_188,r_88_137_71,r_4_109_149,r_4_109_149,1.0,41,190,149,91
27,r_90_91_29,r_105_53_161,r_93_58_10,r_90_91_29,0.99,0,29,29,91
47,r_24_35_153,seq66,r_128_134_138,r_24_35_153,0.93,0,153,153,91
40,r_85_125_116,seq113,seq65,r_85_125_116,0.93,0,116,116,91
18,r_128_134_138,seq65,r_24_35_153,r_24_35_153,0.53,3,156,153,91
29,r_0_110_61,seq148,seq119,r_0_110_61,0.85,1,62,61,91
24,r_144_69_182,seq3,r_30_117_5,r_144_69_182,0.57,0,182,182,91
25,r_12_149_119,seq116,r_120_121_59,r_12_149_119,0.99,0,119,119,91
49,r_93_58_10,r_139_57_141,seq74,r_93_58_10,0.8,0,10,10,91
33,r_126_34_184,seq20,r_37_46_92,r_37_46_92,0.54,92,184,92,91
48,r_88_137_71,r_138_10_188,r_118_140_9,r_138_10_188,0.57,2,190,188,91
37,r_28_43_38,r_73_59_67,seq148,r_28_43_38,1.0,0,38,38,91
65,seq25,r_16_45_181,r_92_114_96,r_92_114_96,1.0,4,100,96,91
32,r_97_33_100,seq9,seq106,r_97_33_100,1.0,0,100,100,91
38,r_81_72_121,r_105_53_161,seq20,r_105_53_161,0.99,-26,135,161,91
42,r_32_68_27,r_29_63_34,seq14,r_32_68_27,1.0,0,27,27,91
81,seq83,r_133_67_118,r_128_134_138,r_133_67_118,0.94,-2,116,118,91
28,r_120_121_59,seq119,r_105_53_161,r_120_121_59,1.0,-3,56,59,91
17,r_107_112_157,r_139_57_141,seq135,r_139_57_141,0.58,1,142,141,91
9,r_36_38_21,r_95_27_142,seq145,r_36_38_21,1.0,0,21,21,91
30,r_131_78_159,r_146_19_73,r_129_141_48,r_131_78_159,1.0,0,159,159,91
28,r_120_121_59,r_105_53_161,r_12_149_119,r_120_121_59,0.95,102,161,59,91
7,r_136_94_44,seq17,seq116,r_136_94_44,0.99,2,46,44,91
46,r_47_46_66,r_45_94_120,r_72_143_89,r_47_46_66,0.54,47,113,66,92
14,r_132_90_147,seq32,seq137,r_132_90_147,0.94,0,147,147,92
8,r_45_94_120,seq17,seq147,r_45_94_120,0.61,16,136,120,92
0,r_76_26_180,seq32,r_14_88_91,r_76_26_180,0.96,0,180,180,92
83,seq75,seq128,r_14_88_91,r_14_88_91,1.0,6,97,91,92
3,r_134_140_15,r_18_87_167,r_9_123_124,r_134_140_15,0.6,110,125,15,92
26,r_13_124_12,r_15_6_112,seq127,r_13_124_12,0.99,1,13,12,92
55,seq10,seq128,r_14_88_91,r_14_88_91,1.0,43,134,91,92
21,r_19_112_196,r_74_53_105,r_134_140_15,r_74_53_105,0.81,-31,74,105,92
46,r_47_46_66,seq77,r_45_94_120,r_47_46_66,0.82,1,67,66,92
42,r_83_22_132,seq17,r_148_131_9,r_83_22_132,0.9,0,132,132,92
3,r_134_140_15,r_132_90_147,r_18_87_167,r_134_140_15,0.95,-1,14,15,92
45,r_11_98_150,seq137,seq32,r_11_98_150,0.85,0,150,150,92
48,r_59_139_178,r_69_105_41,seq77,r_69_105_41,0.92,-17,24,41,92
22,r_106_142_34,r_117_149_63,r_13_124_12,r_106_142_34,0.94,-3,31,34,92
65,seq31,r_84_122_93,r_56_92_10,r_84_122_93,1.0,-34,59,93,92
36,r_68_136_44,r_130_113_84,seq32,r_68_136_44,1.0,0,44,44,92
31,r_41_89_113,r_4_146_119,r_14_88_91,r_41_89_113,0.94,0,113,113,92
41,r_85_25_95,seq128,seq35,r_85_25_95,1.0,0,95,95,92
10,r_84_122_93,seq31,r_49_108_72,r_84_122_93,1.0,0,93,93,92
25,r_97_8_45,r_145_34_181,seq114,r_97_8_45,0.97,0,45,45,92
6,r_125_111_26,seq71,seq138,r_125_111_26,0.72,-9,17,26,92
0,r_76_26_180,r_83_22_132,seq32,r_83_22_132,0.95,-11,121,132,92
11,r_9_123_124,r_83_22_132,r_134_140_15,r_9_123_124,0.95,0,124,124,92
20,r_18_87_167,seq129,seq147,r_18_87_167,0.64,0,167,167,92
13,r_15_6_112,seq40,seq66,r_15_6_112,0.89,15,127,112,92
15,r_133_44_138,seq138,r_2_20_117,r_133_44_138,0.74,0,138,138,92
97,seq120,seq39,r_148_131_9,r_148_131_9,0.86,1,10,9,92
2,r_62_38_175,r_15_6_112,seq30,r_62_38_175,0.69,0,175,175,92
99,seq127,r_51_73_172,seq93,r_51_73_172,1.0,0,172,172,92
70,seq40,r_15_6_112,r_69_105_41,r_69_105_41,1.0,0,41,41,92
27,r_117_149_63,r_59_139_178,seq137,r_117_149_63,0.98,0,63,63,92
2,r_62_38_175,r_130_113_84,r_15_6_112,r_15_6_112,0.91,-6,106,112,92
18,r_102_33_140,r_2_20_117,seq91,r_102_33_140,0.83,0,140,140,92
43,r_36_115_43,seq147,r_45_94_120,r_45_94_120,0.9,2,122,120,92
19,r_69_105_41,r_59_139_178,seq40,r_69_105_41,1.0,0,41,41,92
33,r_4_146_119,r_11_98_150,r_118_119_7,r_11_98_150,0.98,-31,119,150,92
43,r_36_115_43,r_95_135_166,seq147,r_36_115_43,0.92,1,44,43,92
68,seq37,r_85_25_95,r_62_38_175,r_85_25_95,0.5,-14,81,95,92
68,seq37,r_62_38_175,seq86,r_62_38_175,0.63,-30,145,175,92
95,seq114,seq60,r_97_8_45,r_97_8_45,0.94,8,53,45,92
17,r_14_88_91,seq32,seq75,r_14_88_91,1.0,1,92,91,92
9,r_145_34_181,seq99,r_68_136_44,r_68_136_44,1.0,138,182,44,92
28,r_74_53_105,r_19_112_196,r_82_61_161,r_74_53_105,1.0,0,105,105,92
49,r_80_63_108,seq93,r_118_119_7,r_80_63_108,1.0,0,108,108,92
38,r_78_29_32,seq121,seq5,r_78_29_32,1.0,1,33,32,92
82,seq129,r_18_87_167,r_9_123_124,r_9_123_124,0.99,43,167,124,92
5,r_126_43_24,r_102_33_140,seq70,r_126_43_24,0.99,0,24,24,92
35,r_48_96_82,seq86,seq55,r_48_96_82,1.0,0,82,82,92
30,r_99_108_131,seq100,seq27,r_99_108_131,0.92,2,133,131,93
92,seq103,seq74,r_128_85_139,r_128_85_139,0.98,4,143,139,93
8,r_43_113_181,seq90,r_115_139_138,r_115_139_138,0.96,43,181,138,93
43,r_37_45_103,r_48_78_119,seq141,r_37_45_103,0.79,0,103,103,93
83,seq80,r_131_19_66,r_104_138_141,r_131_19_66,0.67,8,74,66,93
37,r_65_23_101,r_104_138_141,seq145,r_104_138_141,0.86,-25,116,141,93
39,r_122_63_79,r_5_67_196,r_111_40_74,r_5_67_196,0.78,-120,76,196,93
1,r_109_142_156,r_43_113_181,seq132,r_109_142_156,0.7,2,158,156,93
5,r_47_54_160,seq42,r_28_77_24,r_28_77_24,0.78,139,163,24,93
46,r_56_13_145,r_86_53_48,r_75_41_17,r_56_13_145,0.7,0,145,145,93
42,r_92_21_153,seq11,seq68,r_92_21_153,0.68,0,153,153,93
83,seq80,r_104_138_141,r_66_143_167,r_104_138_141,0.82,0,141,141,93
45,r_86_53_48,r_59_124_130,r_119_33_114,r_119_33_114,0.86,27,141,114,93
16,r_28_77_24,seq26,r_86_53_48,r_28_77_24,1.0,0,24,24,93
41,r_110_46_146,r_119_33_114,seq36,r_110_46_146,0.65,-119,27,146,93
15,r_119_33_114,r_131_19_66,r_86_53_48,r_119_33_114,0.9,3,117,114,93
13,r_7_84_21,seq51,seq68,r_7_84_21,1.0,0,21,21,93
66,seq27,seq101,r_99_108_131,r_99_108_131,0.97,5,136,131,93
3,r_115_139_138,seq68,r_96_60_111,r_115_139_138,0.65,0,138,138,93
90,seq101,seq27,r_96_60_111,r_96_60_111,0.83,0,111,111,93
16,r_28_77_24,r_86_53_48,r_47_54_160,r_47_54_160,0.98,0,160,160,93
4,r_38_52_80,r_125_44_176,seq141,r_38_52_80,0.82,5,85,80,93
0,r_111_40_74,r_127_17_64,seq120,r_111_40_74,1.0,0,74,74,93
73,seq42,r_47_54_160,r_94_18_81,r_94_18_81,1.0,82,163,81,93
11,r_57_9_63,seq120,seq0,r_57_9_63,0.91,0,63,63,93
20,r_48_78_119,seq62,r_75_41_17,r_48_78_119,0.84,0,119,119,93
98,seq148,r_125_44_176,seq12,r_125_44_176,0.73,-34,142,176,93
48,r_112_118_77,seq120,seq31,r_112_118_77,0.99,0,77,77,93
57,seq11,r_92_21_153,seq134,r_92_21_153,0.98,-18,135,153,93
62,seq145,r_97_76_62,r_65_23_101,r_97_76_62,0.97,-2,60,62,93
74,seq51,r_47_54_160,r_126_64_120,r_126_64_120,0.92,10,130,120,93
27,r_16_140_92,seq101,seq61,r_16_140_92,0.94,1,93,92,93
38,r_75_41_17,r_116_22_152,r_71_73_5,r_75_41_17,0.97,2,19,17,93
9,r_71_73_5,r_93_147_179,r_75_41_17,r_75_41_17,0.99,3,20,17,93
87,seq90,r_43_113_181,r_65_23_101,r_65_23_101,0.76,80,181,101,93
2,r_97_76_62,seq145,seq74,r_97_76_62,0.75,1,63,62,93
41,r_110_46_146,seq36,r_82_81_86,r_82_81_86,0.47,60,146,86,93
47,r_131_19_66,seq80,r_10_136_71,r_10_136_71,0.84,-2,69,71,93
40,r_24_95_108,r_66_143_167,r_97_76_62,r_24_95_108,0.76,0,108,108,93
18,r_10_136_71,r_43_113_181,r_131_19_66,r_10_136_71,1.0,0,71,71,93
29,r_82_81_86,seq3,seq62,r_82_81_86,0.99,0,86,86,93
24,r_125_44_176,seq148,seq145,r_125_44_176,0.6,0,176,176,93
33,r_59_124_130,r_86_53_48,r_35_129_125,r_35_129_125,1.0,34,159,125,93
32,r_126_64_120,seq123,seq51,r_126_64_120,0.51,0,120,120,93
34,r_49_88_59,r_65_23_101,r_32_69_12,r_32_69_12,0.94,48,60,12,93
17,r_35_129_125,seq83,seq34,r_35_129_125,0.88,0,125,125,93
15,r_119_33_114,seq137,r_131_19_66,r_119_33_114,0.53,-60,54,114,93
22,r_96_60_111,seq8,seq101,r_96_60_111,0.8,0,111,111,93
28,r_93_147_179,seq11,r_35_129_125,r_35_129_125,0.96,55,180,125,93
49,r_94_18_81,r_96_60_111,seq42,r_94_18_81,0.95,0,81,81,93
74,seq51,r_7_84_21,r_47_54_160,r_7_84_21,0.92,0,21,21,93
7,r_66_143_167,r_128_85_139,seq80,r_66_143_167,0.73,-26,141,167,93
44,r_104_138_141,r_65_23_101,r_128_85_139,r_104_138_141,0.76,-7,134,141,93
82,seq79,r_47_54_160,r_94_18_81,r_94_18_81,1.0,60,141,81,93
35,r_121_25_31,r_48_78_119,seq61,r_121_25_31,0.99,0,31,31,93
12,r_4_15_140,r_59_124_130,seq12,r_4_15_140,0.89,0,140,140,93
30,r_51_43_176,seq24,seq41,r_51_43_176,0.44,5,181,176,94
36,r_85_89_170,r_45_44_130,r_4_76_49,r_85_89_170,0.81,-39,131,170,94
43,r_33_26_91,seq93,seq115,r_33_26_91,1.0,0,91,91,94
83,seq82,r_119_100_184,seq132,r_119_100_184,1.0,0,184,184,94
37,r_99_2_144,r_10_125_171,seq149,r_99_2_144,0.6,5,149,144,94
45,r_4_76_49,r_25_134_85,seq54,r_4_76_49,1.0,0,49,49,94
71,seq41,r_79_124_139,r_94_114_39,r_94_114_39,1.0,65,104,39,94
21,r_28_112_179,seq146,r_87_21_135,r_87_21_135,0.53,43,178,135,94
39,r_13_141_75,r_42_105_62,seq108,r_13_141_75,0.99,2,77,75,94
2,r_111_72_28,seq56,seq148,r_111_72_28,0.89,0,28,28,94
46,r_70_130_131,seq128,r_5_122_141,r_70_130_131,0.61,2,133,131,94
69,seq146,r_61_69_88,r_29_60_13,r_61_69_88,0.34,-12,76,88,94
27,r_50_23_45,r_68_38_129,r_111_72_28,r_68_38_129,0.54,4,133,129,94
31,r_39_59_183,seq17,r_61_69_88,r_61_69_88,0.7,95,183,88,94
41,r_11_37_145,seq108,r_52_127_20,r_11_37_145,0.7,0,145,145,94
47,r_20_8_149,r_62_78_83,r_74_63_26,r_20_8_149,0.91,-121,28,149,94
4,r_10_125_171,r_99_2_144,r_85_89_170,r_99_2_144,0.48,27,171,144,94
0,r_101_64_92,r_0_96_133,seq143,r_101_64_92,1.0,0,92,92,94
16,r_47_98_57,r_119_100_184,seq17,r_47_98_57,1.0,0,57,57,94
11,r_53_49_95,r_31_6_70,r_88_32_24,r_53_49_95,0.83,0,95,95,94
5,r_68_38_129,seq19,r_50_23_45,r_68_38_129,0.54,-82,47,129,94
15,r_45_44_130,r_85_89_170,seq19,r_45_44_130,0.93,0,130,130,94
61,seq19,r_31_6_70,r_52_127_20,r_52_127_20,1.0,6,26,20,94
57,seq143,seq144,r_101_64_92,r_101_64_92,1.0,0,92,92,94
5,r_68_38_129,r_50_23_45,r_70_130_131,r_70_130_131,0.97,8,139,131,94
6,r_140_137_30,seq102,r_111_72_28,r_140_137_30,0.72,0,30,30,94
17,r_25_134_85,r_4_76_49,seq103,r_4_76_49,0.98,0,49,49,94
49,r_94_114_39,r_92_121_162,r_31_6_70,r_94_114_39,0.91,0,39,39,94
22,r_74_63_26,r_20_8_149,r_25_134_85,r_25_134_85,0.84,74,159,85,94
74,seq54,r_110_138_181,r_85_89_170,r_110_138_181,0.61,0,181,181,94
18,r_0_96_133,r_5_122_141,r_1_131_40,r_5_122_141,0.98,-8,133,141,94
24,r_61_69_88,seq18,seq86,r_61_69_88,0.84,-8,80,88,94
25,r_1_131_40,seq57,r_11_37_145,r_1_131_40,0.69,22,62,40,94
33,r_87_21_135,r_5_122_141,seq128,r_87_21_135,0.75,0,135,135,94
3,r_31_6_70,r_62_78_83,seq12,r_62_78_83,1.0,-32,51,83,94
47,r_20_8_149,r_74_63_26,r_5_122_141,r_20_8_149,0.8,10,159,149,94
27,r_50_23_45,r_36_123_3,r_68_38_129,r_50_23_45,0.9,4,49,45,94
44,r_29_60_13,r_101_64_92,seq146,r_29_60_13,0.68,-3,10,13,94
32,r_22_65_148,r_5_122_141,r_52_127_20,r_52_127_20,0.91,139,159,20,94
38,r_129_16_137,r_31_6_70,r_29_60_13,r_129_16_137,0.51,2,139,137,94
34,r_75_7_142,r_110_138_181,r_62_78_83,r_62_78_83,0.93,60,143,83,94
60,seq18,seq146,r_70_130_131,r_70_130_131,0.79,2,133,131,94
25,r_1_131_40,r_11_37_145,r_0_96_133,r_0_96_133,0.91,0,133,133,94
94,seq109,r_0_96_133,r_51_43_176,r_0_96_133,0.83,-12,121,133,94
22,r_74_63_26,r_92_121_162,r_20_8_149,r_74_63_26,0.78,2,28,26,94
9,r_5_122_141,seq149,r_20_8_149,r_5_122_141,0.66,2,143,141,94
90,seq103,r_129_16_137,r_83_120_195,r_129_16_137,0.56,48,185,137,94
28,r_136_3_121,seq144,seq90,r_136_3_121,0.61,0,121,121,94
8,r_14_139_17,r_42_105_62,seq142,r_14_139_17,0.66,3,20,17,94
7,r_62_78_83,r_31_6_70,seq102,r_62_78_83,1.0,0,83,83,94
82,seq73,r_81_58_110,seq135,r_81_58_110,0.89,1,111,110,94
17,r_25_134_85,seq103,r_74_63_26,r_25_134_85,0.98,3,88,85,94
30,r_97_53_30,seq8,seq142,r_97_53_30,0.6,43,73,30,95
43,r_78_59_74,r_19_9_189,seq51,r_78_59_74,1.0,0,74,74,95
54,seq8,r_97_53_30,r_48_136_44,r_48_136_44,1.0,37,81,44,95
37,r_91_74_70,r_119_90_186,r_113_17_167,r_91_74_70,1.0,0,70,70,95
21,r_50_134_84,r_40_72_190,seq37,r_50_134_84,1.0,0,84,84,95
5,r_47_147_80,seq142,r_61_88_5,r_47_147_80,1.0,0,80,80,95
46,r_104_75_149,seq13,r_61_88_5,r_104_75_149,0.9,0,149,149,95
15,r_113_17_167,r_91_74_70,seq108,r_113_17_167,0.99,0,167,167,95
33,r_109_30_181,r_18_93_45,r_146_24_47,r_109_30_181,0.35,0,181,181,95
36,r_48_136_44,r_105_124_78,seq54,r_48_136_44,1.0,0,44,44,95
50,seq0,r_120_87_27,r_92_32_24,r_120_87_27,0.68,0,27,27,95
10,r_23_139_184,seq60,r_100_34_146,r_23_139_184,0.54,0,184,184,95
95,seq115,r_109_30_181,r_118_133_51,r_118_133_51,1.0,3,54,51,95
40,r_18_93_45,seq77,seq121,r_18_93_45,1.0,0,45,45,95
47,r_67_35_65,seq0,r_105_124_78,r_105_124_78,0.94,44,122,78,95
4,r_123_84_103,r_98_111_105,r_18_93_45,r_123_84_103,1.0,0,103,103,95
0,r_98_111_105,r_123_84_103,seq51,r_123_84_103,1.0,1,104,103,95
73,seq52,seq110,r_125_122_69,r_125_122_69,0.58,9,78,69,95
20,r_119_90_186,r_91_74_70,seq144,r_91_74_70,1.0,0,70,70,95
13,r_82_129_155,seq130,seq60,r_82_129_155,0.99,0,155,155,95
22,r_89_64_165,seq86,r_56_94_20,r_56_94_20,1.0,12,32,20,95
15,r_113_17_167,seq21,r_91_74_70,r_91_74_70,1.0,9,79,70,95
48,r_114_79_89,seq66,seq121,r_114_79_89,1.0,0,89,89,95
62,seq22,r_146_24_47,r_14_128_19,r_146_24_47,0.47,0,47,47,95
6,r_85_4_127,seq81,seq141,r_85_4_127,0.69,0,127,127,95
33,r_109_30_181,seq115,r_18_93_45,r_18_93_45,1.0,9,54,45,95
41,r_148_96_196,r_132_131_43,seq106,r_132_131_43,0.91,3,46,43,95
42,r_92_32_24,r_78_59_74,seq0,r_92_32_24,0.93,0,24,24,95
27,r_125_122_69,seq22,seq52,r_125_122_69,0.81,11,80,69,95
22,r_89_64_165,r_56_94_20,seq31,r_89_64_165,0.9,0,165,165,95
34,r_103_49_52,r_145_28_102,seq130,r_145_28_102,0.98,-49,53,102,95
2,r_105_124_78,r_112_138_59,r_67_35_65,r_105_124_78,1.0,0,78,78,95
47,r_67_35_65,r_5_3_148,seq0,r_67_35_65,1.0,0,65,65,95
14,r_146_24_47,seq22,seq57,r_146_24_47,1.0,0,47,47,95
24,r_14_128_19,r_104_75_149,seq22,r_14_128_19,0.97,1,20,19,95
19,r_118_133_51,r_19_9_189,seq115,r_118_133_51,1.0,0,51,51,95
64,seq26,r_109_30_181,r_132_131_43,r_132_131_43,0.81,8,51,43,95
20,r_119_90_186,seq144,r_6_2_136,r_6_2_136,0.83,4,140,136,95
31,r_120_87_27,seq0,seq137,r_120_87_27,0.95,3,30,27,95
61,seq21,r_113_17_167,r_91_74_70,r_91_74_70,1.0,97,167,70,95
32,r_145_28_102,seq65,r_56_94_20,r_145_28_102,0.65,0,102,102,95
25,r_11_10_21,r_105_124_78,seq63,r_11_10_21,0.71,0,21,21,95
97,seq121,r_109_30_181,r_18_93_45,r_18_93_45,1.0,2,47,45,95
17,r_116_69_109,r_42_102_144,r_98_111_105,r_116_69_109,1.0,0,109,109,95
39,r_39_7_15,r_47_147_80,seq140,r_39_7_15,0.88,0,15,15,95
90,seq86,r_89_64_165,r_56_94_20,r_56_94_20,0.83,12,32,20,95
94,seq110,r_38_99_188,r_101_45_7,r_101_45_7,0.49,181,188,7,95
9,r_6_2_136,r_109_30_181,r_119_90_186,r_6_2_136,0.8,1,137,136,95
37,r_91_74_70,r_113_17_167,seq21,r_113_17_167,1.0,0,167,167,95
28,r_1_83_125,r_5_3_148,seq81,r_1_83_125,1.0,0,125,125,95
7,r_19_9_189,seq16,r_100_34_146,r_19_9_189,0.51,0,189,189,95
12,r_42_102_144,r_119_90_186,r_85_4_127,r_42_102_144,0.63,3,147,144,95
44,r_58_95_183,seq55,r_100_34_146,r_58_95_183,0.64,1,184,183,95
85,seq140,r_33_143_163,r_39_7_15,r_39_7_15,0.98,6,21,15,95
49,r_56_94_20,r_47_147_80,seq86,r_56_94_20,0.99,0,20,20,95
11,r_132_131_43,r_148_96_196,seq26,r_132_131_43,0.93,3,46,43,95
35,r_27_107_126,seq36,r_78_59_74,r_27_107_126,0.89,0,126,126,95
12,r_42_102_144,r_116_69_109,r_119_90_186,r_116_69_109,1.0,0,109,109,95
8,r_73_76_13,seq141,seq16,r_73_76_13,0.94,0,13,13,95
36,r_128_101_77,r_129_0_160,seq64,r_128_101_77,0.95,0,77,77,96
14,r_7_143_162,seq9,r_117_149_1,r_7_143_162,0.46,1,163,162,96
37,r_40_84_172,seq52,r_81_6_72,r_40_84_172,0.52,2,174,172,96
59,seq22,seq140,r_60_72_65,r_60_72_65,1.0,22,87,65,96
55,seq17,r_96_121_145,r_36_87_39,r_96_121_145,0.64,0,145,145,96
16,r_25_50_84,r_88_29_138,seq71,r_25_50_84,1.0,0,84,84,96
5,r_56_44_117,seq97,r_128_101_77,r_128_101_77,0.8,42,119,77,96
45,r_32_1_129,r_117_149_1,seq9,r_32_1_129,0.94,0,129,129,96
42,r_115_138_21,seq47,r_129_0_160,r_115_138_21,0.79,7,28,21,96
19,r_81_6_72,r_80_75_199,r_133_104_47,r_81_6_72,1.0,0,72,72,96
38,r_129_0_160,r_115_138_21,seq21,r_129_0_160,0.73,1,161,160,96
31,r_94_70_149,r_117_149_1,seq123,r_94_70_149,0.91,0,149,149,96
41,r_136_51_75,seq53,seq148,r_136_51_75,1.0,1,76,75,96
26,r_130_124_178,seq74,seq98,r_130_124_178,0.55,1,179,178,96
4,r_11_35_124,seq105,seq83,r_11_35_124,1.0,0,124,124,96
78,seq74,r_130_124_178,r_26_58_52,r_26_58_52,1.0,99,151,52,96
0,r_118_137_93,r_31_14_5,seq22,r_118_137_93,0.99,0,93,93,96
32,r_122_42_18,r_31_14_5,seq47,r_122_42_18,0.8,0,18,18,96
15,r_24_127_69,seq105,seq52,r_24_127_69,1.0,-1,68,69,96
48,r_65_62_152,r_88_29_138,seq47,r_88_29_138,0.63,0,138,138,96
17,r_26_58_52,seq12,seq74,r_26_58_52,1.0,0,52,52,96
33,r_125_142_48,r_88_29_138,r_133_104_47,r_125_142_48,1.0,2,50,48,96
99,seq123,seq71,r_49_4_37,r_49_4_37,1.0,23,60,37,96
27,r_132_78_146,r_111_45_184,seq97,r_132_78_146,0.53,0,146,146,96
21,r_68_93_29,r_33_126_42,seq71,r_68_93_29,1.0,0,29,29,96
2,r_88_29_138,r_65_62_152,seq135,r_65_62_152,0.79,-14,138,152,96
47,r_145_66_85,r_130_124_178,r_81_6_72,r_145_66_85,0.98,0,85,85,96
38,r_129_0_160,r_128_101_77,r_115_138_21,r_128_101_77,0.74,-34,43,77,96
40,r_85_54_102,seq30,seq37,r_85_54_102,1.0,2,104,102,96
25,r_96_121_145,seq17,seq12,r_96_121_145,0.96,0,145,145,96
30,r_133_104_47,r_33_126_42,seq97,r_133_104_47,1.0,-5,42,47,96
68,seq52,r_40_84_172,r_24_127_69,r_24_127_69,1.0,6,75,69,96
42,r_115_138_21,r_129_0_160,r_8_147_106,r_129_0_160,0.81,-7,153,160,96
52,seq9,r_7_143_162,r_20_106_130,r_20_106_130,1.0,33,163,130,96
48,r_65_62_152,seq47,seq76,r_65_62_152,0.79,2,154,152,96
75,seq64,r_141_131_170,r_128_101_77,r_128_101_77,0.97,10,87,77,96
9,r_10_3_101,r_56_44_117,r_31_14_5,r_10_3_101,1.0,0,101,101,96
43,r_19_13_55,seq52,r_125_142_48,r_19_13_55,1.0,1,56,55,96
7,r_49_4_37,r_130_124_178,seq123,r_49_4_37,1.0,1,38,37,96
22,r_60_72_65,r_10_3_101,seq22,r_60_72_65,1.0,2,67,65,96
73,seq61,r_36_87_39,r_33_126_42,r_33_126_42,1.0,0,42,42,96
44,r_117_149_1,r_32_1_129,seq103,r_32_1_129,1.0,0,129,129,96
23,r_134_27_161,seq89,seq148,r_134_27_161,0.77,0,161,161,96
76,seq71,seq123,r_68_93_29,r_68_93_29,1.0,3,32,29,96
79,seq76,r_144_5_87,seq91,r_144_5_87,0.97,12,99,87,96
35,r_20_106_130,seq98,r_32_1_129,r_20_106_130,0.94,0,130,130,96
12,r_77_67_98,seq21,r_36_87_39,r_77_67_98,1.0,0,98,98,96
8,r_36_87_39,seq61,seq17,r_36_87_39,0.87,3,42,39,96
3,r_33_126_42,r_133_104_47,seq61,r_33_126_42,1.0,0,42,42,96
51,seq134,r_129_76_165,r_59_130_104,r_59_130_104,0.99,20,124,104,97
70,seq39,r_88_64_140,r_106_61_51,r_106_61_51,1.0,0,51,51,97
43,r_42_85_145,seq28,seq43,r_42_85_145,0.7,2,147,145,97
54,seq10,r_149_32_160,r_119_15_81,r_119_15_81,0.96,80,161,81,97
83,seq86,r_3_27_174,r_119_15_81,r_119_15_81,1.0,93,174,81,97
37,r_100_125_143,r_48_68_144,seq96,r_100_125_143,0.67,0,143,143,97
86,seq96,r_54_101_106,r_100_125_143,r_100_125_143,0.96,1,144,143,97
1,r_103_82_70,r_3_27_174,seq13,r_103_82_70,1.0,0,70,70,97
5,r_22_73_136,seq12,seq114,r_22_73_136,0.61,0,136,136,97
46,r_53_93_139,seq95,r_142_78_88,r_53_93_139,0.97,0,139,139,97
48,r_131_30_23,r_88_64_140,seq46,r_88_64_140,0.59,-116,24,140,97
42,r_138_146_41,r_88_64_140,r_65_79_57,r_65_79_57,1.0,6,63,57,97
19,r_3_27_174,seq86,seq7,r_3_27_174,0.59,0,174,174,97
27,r_20_14_45,seq31,seq11,r_20_14_45,1.0,0,45,45,97
41,r_142_78_88,seq11,seq55,r_142_78_88,0.59,-4,84,88,97
3,r_148_56_171,seq114,r_138_146_41,r_138_146_41,0.65,130,171,41,97
26,r_0_77_107,seq75,seq109,r_0_77_107,1.0,0,107,107,97
0,r_21_72_154,r_138_146_41,seq67,r_138_146_41,0.93,0,41,41,97
20,r_136_143_101,seq36,r_99_116_14,r_136_143_101,0.97,0,101,101,97
13,r_17_8_172,seq115,seq144,r_17_8_172,0.61,0,172,172,97
15,r_50_71_116,r_90_118_195,r_6_127_68,r_6_127_68,0.63,51,119,68,97
6,r_63_133_183,seq126,r_141_16_31,r_63_133_183,0.57,1,184,183,97
8,r_87_122_56,r_119_15_81,seq24,r_87_122_56,1.0,1,57,56,97
0,r_21_72_154,seq67,seq43,r_21_72_154,0.99,0,154,154,97
4,r_69_44_58,r_54_101_106,seq36,r_69_44_58,1.0,-3,55,58,97
29,r_66_139_36,r_2_84_161,r_50_71_116,r_66_139_36,0.98,0,36,36,97
42,r_138_146_41,r_21_72_154,r_88_64_140,r_88_64_140,0.87,-99,41,140,97
2,r_129_76_165,seq134,r_100_125_143,r_100_125_143,0.88,22,165,143,97
25,r_141_16_31,r_41_62_182,seq134,r_141_16_31,0.99,0,31,31,97
47,r_35_18_1,r_52_4_169,r_119_15_81,r_119_15_81,1.0,88,169,81,97
40,r_128_108_166,r_54_101_106,r_106_61_51,r_54_101_106,0.69,60,166,106,97
18,r_83_104_66,r_90_118_195,r_35_18_1,r_83_104_66,1.0,0,66,66,97
24,r_112_49_117,r_149_32_160,r_119_15_81,r_119_15_81,0.98,46,127,81,97
92,seq110,r_103_82_70,r_112_49_117,r_103_82_70,0.83,-21,49,70,97
64,seq28,r_42_85_145,seq140,r_42_85_145,1.0,0,145,145,97
29,r_66_139_36,r_50_71_116,r_6_127_68,r_6_127_68,0.98,2,70,68,97
39,r_65_79_57,seq105,r_138_146_41,r_65_79_57,1.0,0,57,57,97
23,r_89_97_33,r_106_61_51,seq31,r_89_97_33,1.0,0,33,33,97
32,r_59_130_104,seq67,seq134,r_59_130_104,0.77,4,108,104,97
38,r_6_127_68,seq36,r_66_139_36,r_6_127_68,0.87,2,70,68,97
34,r_88_64_140,r_94_132_191,r_21_72_154,r_21_72_154,0.82,27,181,154,97
45,r_58_1_42,r_99_116_14,seq115,r_58_1_42,1.0,-1,41,42,97
14,r_106_61_51,seq75,seq39,r_106_61_51,1.0,0,51,51,97
36,r_19_45_13,r_119_15_81,seq107,r_19_45_13,1.0,1,14,13,97
38,r_6_127_68,r_66_139_36,r_50_71_116,r_50_71_116,0.66,9,125,116,97
33,r_74_120_12,r_21_72_154,r_90_118_195,r_74_120_12,0.97,0,12,12,97
17,r_41_62_182,r_123_51_190,r_103_82_70,r_103_82_70,1.0,112,182,70,97
9,r_119_15_81,seq113,r_35_18_1,r_119_15_81,0.96,0,81,81,97
28,r_123_51_190,seq137,r_21_72_154,r_21_72_154,0.62,36,190,154,97
91,seq109,r_119_15_81,seq31,r_119_15_81,0.88,0,81,81,97
91,seq109,seq31,r_0_77_107,r_0_77_107,0.79,29,136,107,97
89,seq105,r_65_79_57,seq25,r_65_79_57,1.0,-1,56,57,97
7,r_2_84_161,r_48_68_144,r_54_101_106,r_48_68_144,0.52,17,161,144,97
82,seq81,r_149_32_160,r_119_15_81,r_119_15_81,1.0,11,92,81,97
22,r_90_118_195,r_83_104_66,r_74_120_12,r_83_104_66,0.55,-37,29,66,97
35,r_149_32_160,seq10,r_50_71_116,r_149_32_160,0.62,0,160,160,97
24,r_68_19_35,seq43,r_5_143_22,r_68_19_35,1.0,1,36,35,98
30,r_118_131_66,r_122_123_88,seq71,r_118_131_66,1.0,0,66,66,98
44,r_57_90_97,r_95_144_159,r_10_76_110,r_95_144_159,0.89,0,159,159,98
36,r_122_123_88,seq132,r_66_46_73,r_122_123_88,0.95,0,88,88,98
8,r_53_115_98,seq49,seq4,r_53_115_98,0.97,1,99,98,98
83,seq71,seq18,r_118_131_66,r_118_131_66,1.0,18,84,66,98
16,r_146_54_148,seq140,r_116_27_126,r_146_54_148,0.87,2,150,148,98
39,r_97_91_123,r_95_144_159,r_70_103_6,r_97_91_123,0.97,4,127,123,98
1,r_101_78_137,r_128_148_112,r_57_90_97,r_101_78_137,0.97,-41,96,137,98
42,r_137_56_85,r_109_50_124,seq48,r_137_56_85,0.97,0,85,85,98
45,r_119_88_86,r_95_144_159,seq30,r_119_88_86,1.0,-2,84,86,98
2,r_84_37_18,r_35_12_156,seq14,r_84_37_18,0.98,0,18,18,98
19,r_45_55_173,seq34,r_116_27_126,r_45_55_173,0.64,3,176,173,98
58,seq14,r_104_121_89,r_84_37_18,r_84_37_18,0.95,0,18,18,98
41,r_134_7_68,r_129_98_79,seq149,r_134_7_68,1.0,-2,66,68,98
67,seq25,r_35_12_156,r_126_75_65,r_126_75_65,0.95,6,71,65,98
3,r_35_12_156,seq32,r_80_117_8,r_80_117_8,0.69,148,156,8,98
10,r_47_135_71,r_66_46_73,seq49,r_47_135_71,1.0,0,71,71,98
90,seq93,seq71,r_109_50_124,r_109_50_124,1.0,4,128,124,98
4,r_36_105_170,r_110_3_56,seq87,r_36_105_170,0.86,0,170,170,98
0,r_145_83_177,seq33,r_47_135_71,r_145_83_177,0.61,0,177,177,98
11,r_110_3_56,r_36_105_170,r_60_29_78,r_60_29_78,1.0,0,78,78,98
13,r_126_75_65,seq149,seq25,r_126_75_65,1.0,6,71,65,98
15,r_128_148_112,r_101_78_137,r_53_115_98,r_128_148_112,0.95,0,112,112,98
48,r_95_144_159,r_97_91_123,r_57_90_97,r_95_144_159,0.71,-32,127,159,98
6,r_104_121_89,seq14,seq33,r_104_121_89,0.91,4,93,89,98
22,r_73_96_13,r_120_69_171,seq61,r_73_96_13,0.97,-2,11,13,98
40,r_28_41_53,r_126_75_65,r_84_37_18,r_28_41_53,0.99,0,53,53,98
9,r_9_82_48,seq13,seq133,r_9_82_48,1.0,-2,46,48,98
27,r_39_2_109,seq140,seq6,r_39_2_109,0.99,0,109,109,98
1,r_101_78_137,r_57_90_97,seq89,r_101_78_137,1.0,0,137,137,98
48,r_95_144_159,r_57_90_97,r_47_135_71,r_95_144_159,0.97,1,160,159,98
25,r_102_64_34,r_122_123_88,seq25,r_102_64_34,0.7,0,34,34,98
18,r_51_85_129,r_35_12_156,r_84_37_18,r_35_12_156,0.86,-26,130,156,98
87,seq87,r_52_86_46,seq142,r_52_86_46,1.0,0,46,46,98
33,r_10_76_110,r_35_12_156,r_129_98_79,r_10_76_110,0.69,1,111,110,98
64,seq149,r_126_75_65,r_134_7_68,r_134_7_68,0.59,3,71,68,98
88,seq89,r_120_69_171,r_101_78_137,r_101_78_137,1.0,18,155,137,98
70,seq33,r_145_83_177,r_104_121_89,r_104_121_89,0.46,88,177,89,98
20,r_111_59_52,r_60_29_78,seq132,r_60_29_78,0.9,-40,38,78,98
32,r_66_46_73,r_57_90_97,seq140,r_66_46_73,1.0,0,73,73,98
38,r_100_79_183,seq17,r_109_50_124,r_109_50_124,0.94,59,183,124,98
34,r_72_141_100,r_35_12_156,r_53_115_98,r_35_12_156,1.0,-56,100,156,98
17,r_60_29_78,r_10_76_110,r_110_3_56,r_60_29_78,1.0,0,78,78,98
25,r_102_64_34,seq25,r_124_138_106,r_124_138_106,0.95,29,135,106,98
79,seq132,r_122_123_88,r_111_59_52,r_122_123_88,0.99,-42,46,88,98
28,r_139_136_145,r_70_103_6,seq11,r_139_136_145,0.66,4,149,145,98
49,r_129_98_79,r_134_7_68,seq1,r_134_7_68,0.87,-2,66,68,98
56,seq140,r_146_54_148,r_26_81_105,r_26_81_105,0.83,45,150,105,98
7,r_26_81_105,r_97_91_123,r_122_123_88,r_26_81_105,0.87,0,105,105,98
44,r_57_90_97,seq42,r_95_144_159,r_57_90_97,0.98,1,98,97,98
23,r_8_21_178,seq61,r_104_121_89,r_8_21_178,0.45,2,180,178,98
12,r_109_50_124,seq4,seq93,r_109_50_124,0.99,0,124,124,98
46,r_52_86_46,seq87,r_84_37_18,r_52_86_46,0.95,0,46,46,98
30,r_134_107_136,r_127_87_4,r_130_75_117,r_134_107_136,0.51,1,137,136,99
8,r_26_69_194,r_35_18_130,seq142,r_35_18_130,0.62,0,130,130,99
43,r_35_18_130,r_26_69_194,r_127_87_4,r_26_69_194,0.58,-64,130,194,99
83,seq91,r_144_6_73,seq62,r_144_6_73,0.6,7,80,73,99
37,r_111_15_190,seq14,r_130_75_117,r_111_15_190,0.37,0,190,190,99
3,r_27_82_80,seq51,r_126_36_146,r_27_82_80,0.39,75,155,80,99
15,r_50_48_44,r_123_143_98,seq84,r_50_48_44,0.7,0,44,44,99
21,r_58_109_113,seq64,r_97_60_77,r_58_109_113,0.64,-17,96,113,99
39,r_12_115_93,r_35_18_130,r_11_147_13,r_12_115_93,0.48,2,95,93,99
1,r_120_47_60,r_78_108_131,r_132_73_55,r_120_47_60,0.69,10,70,60,99
5,r_127_87_4,r_134_107_136,r_20_33_109,r_127_87_4,0.67,133,137,4,99
46,r_34_2_197,r_95_46_149,r_11_147_13,r_95_46_149,0.99,-81,68,149,99
42,r_30_42_121,seq68,r_4_128_103,r_30_42_121,0.96,0,121,121,99
35,r_103_96_45,r_120_47_60,seq122,r_103_96_45,1.0,0,45,45,99
45,r_123_143_98,seq53,seq99,r_123_143_98,0.99,0,98,98,99
19,r_78_108_131,seq51,seq19,r_78_108_131,0.93,0,131,131,99
14,r_37_92_20,r_132_73_55,seq84,r_37_92_20,0.97,0,20,20,99
36,r_132_73_55,r_111_15_190,r_120_47_60,r_132_73_55,1.0,1,56,55,99
31,r_76_133_114,r_8_148_116,r_54_24_30,r_8_148_116,0.74,0,116,116,99
41,r_97_60_77,seq110,seq88,r_97_60_77,1.0,1,78,77,99
3,r_27_82_80,r_32_57_70,seq51,r_32_57_70,1.0,0,70,70,99
4,r_117_21_58,r_139_141_159,seq17,r_117_21_58,1.0,0,58,58,99
10,r_38_80_105,seq129,seq110,r_38_80_105,0.97,0,105,105,99
79,seq84,r_149_55_119,r_37_92_20,r_37_92_20,0.54,0,20,20,99
26,r_121_39_134,seq145,seq137,r_121_39_134,0.91,0,134,134,99
0,r_149_55_119,seq138,seq64,r_149_55_119,0.93,0,119,119,99
11,r_144_6_73,seq91,seq53,r_144_6_73,1.0,4,77,73,99
13,r_4_128_103,seq19,r_103_96_45,r_4_128_103,0.85,4,107,103,99
48,r_104_22_94,r_8_148_116,r_89_29_39,r_104_22_94,0.66,1,95,94,99
6,r_44_59_108,r_79_3_196,r_120_47_60,r_44_59_108,0.49,-1,107,108,99
33,r_89_29_39,r_27_82_80,r_10_102_40,r_27_82_80,0.93,-30,50,80,99
27,r_32_57_70,r_27_82_80,seq70,r_32_57_70,1.0,0,70,70,99
87,seq145,r_121_39_134,seq5,r_121_39_134,0.99,-20,114,134,99
49,r_11_147_13,r_4_128_103,r_34_2_197,r_4_128_103,0.5,-90,13,103,99
2,r_126_36_146,r_34_2_197,r_27_82_80,r_34_2_197,0.75,-50,147,197,99
47,r_98_101_195,r_20_33_109,r_4_128_103,r_98_101_195,0.64,-86,109,195,99
29,r_31_65_86,seq68,r_11_147_13,r_31_65_86,0.92,1,87,86,99
24,r_0_49_137,r_72_71_184,r_81_41_35,r_0_49_137,0.78,8,145,137,99
25,r_25_135_154,seq17,r_127_87_4,r_127_87_4,0.56,150,154,4,99
68,seq56,seq145,r_95_46_149,r_95_46_149,0.82,11,160,149,99
17,r_100_86_71,r_95_46_149,r_81_41_35,r_100_86_71,0.99,2,73,71,99
9,r_10_102_40,r_95_46_149,r_130_75_117,r_10_102_40,0.89,111,151,40,99
22,r_95_46_149,r_10_102_40,seq56,r_10_102_40,0.52,111,151,40,99
28,r_130_75_117,seq52,r_104_22_94,r_130_75_117,0.93,0,117,117,99
44,r_9_28_132,seq17,seq137,r_9_28_132,0.95,0,132,132,99
12,r_20_33_109,r_98_101_195,r_127_87_4,r_20_33_109,0.97,0,109,109,99
