4,r_56_71_128,r_30_101_107,r_36_90_17,r_36_90_17,0.78,12,29,17,0
14,r_87_76_82,seq133,seq70,r_87_76_82,1,0,82,82,0
62,seq146,r_13_20_26,r_118_138_30,r_118_138_30,0.77,1,31,30,0
27,r_98_7_50,r_112_116_142,r_87_76_82,r_87_76_82,1,9,91,82,0
23,r_104_72_181,r_73_53_124,r_26_61_19,r_26_61_19,1,4,23,19,0
29,r_103_52_76,r_98_7_50,r_40_68_2,r_103_52_76,0.64,20,96,76,0
37,r_18_143_169,seq54,r_41_119_64,r_41_119_64,0.74,105,169,64,0
3,r_93_37_174,r_88_27_33,r_46_15_61,r_93_37_174,0.79,0,174,174,0
86,seq79,seq43,r_108_81_41,r_108_81_41,1,60,101,41,0
21,r_46_15_61,seq94,seq11,r_46_15_61,0.77,14,75,61,0
39,r_123_120_99,r_59_111_36,r_140_49_37,r_140_49_37,0.72,38,75,37,0
29,r_103_52_76,r_40_68_2,r_98_7_50,r_40_68_2,0.58,130,132,2,0
42,r_77_1_84,r_18_143_169,seq65,r_77_1_84,1,0,84,84,0
43,r_110_149_58,r_118_138_30,r_89_35_106,r_118_138_30,0.43,2,32,30,0
45,r_144_69_150,r_103_52_76,seq131,r_103_52_76,1,0,76,76,0
34,r_59_111_36,r_123_120_99,seq23,r_59_111_36,0.62,-9,27,36,0
11,r_75_55_23,r_29_91_126,r_106_139_57,r_75_55_23,0.99,104,127,23,0
38,r_12_141_179,seq54,r_93_37_174,r_12_141_179,0.98,0,179,179,0
11,r_75_55_23,r_140_49_37,r_29_91_126,r_75_55_23,0.79,0,23,23,0
25,r_36_90_17,seq62,r_145_99_14,r_36_90_17,0.99,0,17,17,0
13,r_118_138_30,r_126_124_86,r_41_119_64,r_118_138_30,1,38,68,30,0
16,r_88_27_33,seq22,r_93_37_174,r_88_27_33,0.8,3,36,33,0
27,r_98_7_50,r_87_76_82,r_103_52_76,r_98_7_50,0.37,75,125,50,0
16,r_88_27_33,r_93_37_174,seq136,r_88_27_33,0.61,133,166,33,0
36,r_58_10_43,r_89_35_106,seq16,r_58_10_43,0.96,6,49,43,0
26,r_63_109_42,r_83_0_71,seq96,r_63_109_42,1,0,42,42,0
78,seq57,r_103_52_76,seq131,r_103_52_76,0.97,-3,73,76,0
20,r_41_119_64,seq86,r_118_138_30,r_41_119_64,1,1,65,64,0
44,r_106_139_57,r_137_78_196,r_75_55_23,r_106_139_57,1,1,58,57,0
15,r_114_33_96,seq129,seq2,r_114_33_96,1,0,96,96,0
48,r_30_101_107,r_56_71_128,r_144_69_150,r_30_101_107,0.85,0,107,107,0
4,r_56_71_128,r_36_90_17,r_110_149_58,r_56_71_128,0.94,1,129,128,0
6,r_122_14_159,seq132,seq54,r_122_14_159,0.94,0,159,159,0
21,r_46_15_61,seq11,r_38_32_115,r_38_32_115,1,22,137,115,0
33,r_140_49_37,seq128,seq113,r_140_49_37,1,0,37,37,0
85,seq70,seq43,r_87_76_82,r_87_76_82,1,6,88,82,0
10,r_3_97_9,r_93_37_174,r_29_91_126,r_29_91_126,0.95,1,127,126,0
8,r_13_20_26,seq146,seq129,r_13_20_26,0.8,2,28,26,0
30,r_29_91_126,r_75_55_23,r_3_97_9,r_29_91_126,1,1,127,126,0
92,seq96,seq79,r_63_109_42,r_63_109_42,0.85,0,42,42,0
50,seq128,r_140_49_37,r_8_125_167,r_140_49_37,1,1,38,37,0
54,seq4,r_59_111_36,r_140_49_37,r_140_49_37,0.83,-1,36,37,0
47,r_85_95_164,r_40_68_2,r_75_55_23,r_85_95_164,0.62,0,164,164,0
40,r_38_32_115,seq113,r_46_15_61,r_38_32_115,0.99,0,115,115,0
29,r_103_52_76,r_144_69_150,r_98_7_50,r_103_52_76,0.9,1,77,76,0
46,r_26_61_19,seq66,r_104_72_181,r_26_61_19,1,0,19,19,0
24,r_126_124_86,r_137_78_196,seq82,r_126_124_86,0.79,0,86,86,0
58,seq136,r_93_37_174,seq117,r_93_37_174,0.51,-91,83,174,0
68,seq133,r_87_76_82,r_75_55_23,r_87_76_82,0.95,0,82,82,0
61,seq17,r_21_44_166,r_31_50_89,r_31_50_89,0.99,16,105,89,0
38,r_12_141_179,r_77_1_84,seq54,r_77_1_84,1,1,85,84,0
52,seq2,seq128,r_114_33_96,r_114_33_96,0.97,-1,95,96,0
71,seq39,seq131,r_144_69_150,r_144_69_150,0.96,-3,147,150,0
0,r_127_84_51,r_29_91_126,r_40_68_2,r_127_84_51,1,1,52,51,0
64,seq22,r_88_27_33,seq66,r_88_27_33,0.99,19,52,33,0
45,r_144_69_150,seq131,seq39,r_144_69_150,0.86,2,152,150,0
48,r_30_101_107,r_144_69_150,r_45_9_136,r_30_101_107,0.98,45,152,107,0
43,r_110_149_58,r_89_35_106,r_121_142_198,r_110_149_58,0.86,0,58,58,0
30,r_29_91_126,r_127_84_51,r_75_55_23,r_29_91_126,0.97,-101,25,126,0
9,r_74_147_78,r_21_44_166,r_140_49_37,r_74_147_78,0.99,1,79,78,0
3,r_93_37_174,seq117,r_88_27_33,r_88_27_33,0.97,13,46,33,0
1,r_108_81_41,r_89_35_106,seq79,r_108_81_41,1,0,41,41,0
28,r_45_9_136,seq24,r_30_101_107,r_45_9_136,1,0,136,136,0
58,seq136,seq117,r_88_27_33,r_88_27_33,0.67,80,113,33,0
49,r_83_0_71,seq39,r_59_111_36,r_83_0_71,1,0,71,71,0
7,r_8_125_167,seq128,r_40_68_2,r_8_125_167,0.51,0,167,167,0
17,r_89_35_106,seq34,seq6,r_89_35_106,0.93,57,163,106,0
82,seq65,seq22,r_77_1_84,r_77_1_84,0.99,3,87,84,0
32,r_145_99_14,r_104_72_181,r_36_90_17,r_145_99_14,0.86,3,17,14,0
35,r_31_50_89,seq135,seq17,r_31_50_89,1,0,89,89,0
12,r_21_44_166,seq17,r_59_111_36,r_21_44_166,0.77,2,168,166,0
17,r_89_35_106,r_58_10_43,seq34,r_58_10_43,1,-1,42,43,0
13,r_118_138_30,r_110_149_58,r_126_124_86,r_118_138_30,0.79,0,30,30,0
51,seq128,r_11_66_114,r_146_118_195,r_11_66_114,1,0,114,114,1
77,seq59,r_127_21_153,r_92_143_99,r_127_21_153,0.57,-30,123,153,1
92,seq101,r_90_80_139,r_89_141_39,r_89_141_39,0.89,102,141,39,1
14,r_95_27_108,r_126_74_136,seq67,r_95_27_108,0.66,0,108,108,1
0,r_82_93_22,seq44,seq109,r_82_93_22,0.36,57,79,22,1
37,r_36_1_43,seq101,seq0,r_36_1_43,0.99,0,43,43,1
5,r_75_26_46,r_92_143_99,seq96,r_75_26_46,1,0,46,46,1
55,seq7,seq44,r_69_135_42,r_69_135_42,1,134,176,42,1
16,r_42_120_166,r_103_34_95,r_146_118_195,r_42_120_166,0.59,0,166,166,1
21,r_57_24_165,r_103_34_95,r_117_47_111,r_117_47_111,1,6,117,111,1
47,r_92_143_99,r_87_130_96,seq59,r_92_143_99,1,0,99,99,1
42,r_32_43_66,seq59,seq76,r_32_43_66,0.78,2,68,66,1
80,seq67,r_14_136_88,r_83_30_173,r_14_136_88,1,0,88,88,1
21,r_57_24_165,r_117_47_111,r_89_141_39,r_57_24_165,0.95,0,165,165,1
48,r_102_140_28,seq115,r_41_65_71,r_41_65_71,1,10,81,71,1
0,r_82_93_22,r_54_116_176,seq44,r_82_93_22,0.67,0,22,22,1
19,r_87_130_96,seq79,seq81,r_87_130_96,0.8,0,96,96,1
34,r_16_31_52,seq109,r_89_141_39,r_16_31_52,0.73,0,52,52,1
41,r_58_71_12,r_95_27_108,r_38_9_179,r_58_71_12,1,0,12,12,1
4,r_56_104_104,r_53_4_157,seq105,r_56_104_104,0.73,1,105,104,1
76,seq49,r_52_51_184,r_103_34_95,r_103_34_95,0.95,89,184,95,1
39,r_122_139_30,r_110_131_161,seq45,r_122_139_30,0.99,-1,29,30,1
46,r_35_113_182,seq85,seq0,r_35_113_182,0.81,-162,20,182,1
31,r_38_9_179,r_53_4_157,r_58_71_12,r_38_9_179,0.84,-107,72,179,1
96,seq109,r_82_93_22,r_110_131_161,r_110_131_161,0.45,0,161,161,1
3,r_54_116_176,r_86_132_188,seq61,r_54_116_176,0.58,0,176,176,1
10,r_149_55_115,r_127_21_153,seq46,r_149_55_115,0.86,0,115,115,1
47,r_92_143_99,r_70_25_40,r_87_130_96,r_70_25_40,1,0,40,40,1
72,seq44,r_148_123_187,r_35_113_182,r_35_113_182,0.81,5,187,182,1
48,r_102_140_28,seq18,seq115,r_102_140_28,0.98,0,28,28,1
26,r_69_135_42,seq115,r_73_91_191,r_69_135_42,1,0,42,42,1
78,seq61,seq105,r_54_116_176,r_54_116_176,0.82,6,182,176,1
11,r_11_66_114,seq128,r_114_112_2,r_11_66_114,0.99,0,114,114,1
20,r_53_4_157,r_117_47_111,r_75_26_46,r_53_4_157,0.92,-61,96,157,1
13,r_14_136_88,seq67,r_127_21_153,r_14_136_88,0.98,0,88,88,1
96,seq109,r_148_123_187,r_82_93_22,r_82_93_22,0.68,13,35,22,1
46,r_35_113_182,seq0,seq44,r_35_113_182,0.6,0,182,182,1
73,seq45,r_146_118_195,r_122_139_30,r_122_139_30,1,18,48,30,1
13,r_14_136_88,r_127_21_153,r_92_143_99,r_127_21_153,0.82,0,153,153,1
6,r_41_65_71,seq147,r_102_140_28,r_41_65_71,1,0,71,71,1
33,r_117_47_111,r_57_24_165,r_103_34_95,r_57_24_165,1,0,165,165,1
27,r_28_124_122,seq0,r_148_123_187,r_28_124_122,0.86,1,123,122,1
2,r_137_6_131,seq101,seq17,r_137_6_131,0.74,0,131,131,1
41,r_58_71_12,r_38_9_179,r_75_26_46,r_75_26_46,0.76,132,178,46,1
15,r_89_141_39,seq134,seq101,r_89_141_39,0.99,0,39,39,1
40,r_148_123_187,seq44,r_28_124_122,r_148_123_187,0.34,1,188,187,1
74,seq46,seq145,r_149_55_115,r_149_55_115,1,8,123,115,1
29,r_50_60_129,seq33,r_88_63_113,r_50_60_129,0.91,0,129,129,1
35,r_83_30_173,r_95_27_108,r_144_2_6,r_83_30_173,1,0,173,173,1
25,r_126_74_136,r_95_27_108,seq97,r_95_27_108,1,0,108,108,1
33,r_117_47_111,r_53_4_157,r_57_24_165,r_117_47_111,0.95,0,111,111,1
22,r_86_132_188,seq22,seq7,r_86_132_188,0.68,0,188,188,1
70,seq39,r_54_116_176,seq22,r_54_116_176,0.95,-17,159,176,1
65,seq22,r_54_116_176,seq39,r_54_116_176,0.98,-58,118,176,1
20,r_53_4_157,r_75_26_46,seq61,r_53_4_157,0.99,0,157,157,1
42,r_32_43_66,seq76,r_50_60_129,r_50_60_129,1,5,134,129,1
32,r_110_131_161,r_73_91_191,seq109,r_73_91_191,0.58,-30,161,191,1
38,r_88_63_113,seq96,r_32_43_66,r_88_63_113,0.68,0,113,113,1
77,seq59,r_100_125_91,r_127_21_153,r_100_125_91,0.63,-4,87,91,1
18,r_73_91_191,r_110_131_161,r_69_135_42,r_69_135_42,0.89,4,46,42,1
4,r_56_104_104,seq101,r_53_4_157,r_56_104_104,0.46,-47,57,104,1
49,r_70_25_40,r_92_143_99,seq62,r_70_25_40,0.87,0,40,40,1
17,r_90_80_139,seq101,r_82_93_22,r_90_80_139,0.6,1,140,139,1
25,r_126_74_136,seq97,seq48,r_126_74_136,0.89,0,136,136,1
26,r_69_135_42,r_73_91_191,r_126_74_136,r_126_74_136,0.63,48,184,136,1
12,r_127_21_153,r_14_136_88,r_15_78_199,r_127_21_153,1,0,153,153,1
31,r_38_9_179,r_58_71_12,r_56_104_104,r_38_9_179,0.84,1,180,179,1
22,r_86_132_188,r_54_116_176,seq22,r_54_116_176,0.85,0,176,176,1
4,r_56_104_104,seq105,r_38_9_179,r_38_9_179,0.73,2,181,179,1
79,seq62,seq97,r_70_25_40,r_70_25_40,1,34,74,40,1
35,r_83_30_173,seq98,r_95_27_108,r_95_27_108,0.99,4,112,108,1
12,r_127_21_153,seq59,r_14_136_88,r_14_136_88,1,8,96,88,1
84,seq79,r_87_130_96,seq105,r_87_130_96,1,0,96,96,1
93,seq109,r_103_138_111,r_141_20_170,r_103_138_111,0.99,4,115,111,2
51,seq5,seq134,r_28_11_147,r_28_11_147,1,0,147,147,2
6,r_10_126_189,r_142_16_52,seq26,r_142_16_52,1,0,52,52,2
28,r_137_56_15,seq87,seq122,r_137_56_15,1,0,15,15,2
14,r_46_62_152,r_129_31_168,r_40_38_65,r_40_38_65,1,87,152,65,2
8,r_129_31_168,r_46_62_152,seq17,r_129_31_168,0.58,-69,99,168,2
3,r_39_92_36,r_2_107_144,seq24,r_39_92_36,0.96,-1,35,36,2
43,r_69_14_29,seq133,r_71_83_18,r_69_14_29,0.88,1,30,29,2
16,r_30_36_89,seq136,seq43,r_30_36_89,1,0,89,89,2
21,r_32_37_107,seq24,r_60_149_32,r_32_37_107,0.99,0,107,107,2
39,r_0_80_77,seq17,r_34_128_39,r_0_80_77,1,0,77,77,2
40,r_114_95_149,seq77,r_49_121_186,r_114_95_149,0.98,0,149,149,2
1,r_85_8_181,seq15,r_28_11_147,r_28_11_147,0.63,34,181,147,2
80,seq73,r_145_82_178,r_114_95_149,r_114_95_149,0.9,29,178,149,2
5,r_25_4_72,seq23,seq21,r_25_4_72,0.86,1,73,72,2
46,r_41_125_151,seq21,r_89_22_26,r_41_125_151,0.81,0,151,151,2
42,r_2_107_144,seq33,r_147_67_28,r_2_107_144,0.89,0,144,144,2
80,seq73,r_55_130_81,r_145_82_178,r_55_130_81,1,-4,77,81,2
7,r_64_48_60,r_28_11_147,seq144,r_28_11_147,0.95,2,149,147,2
45,r_55_130_81,seq73,seq72,r_55_130_81,1,0,81,81,2
11,r_28_11_147,r_64_48_60,seq5,r_28_11_147,0.99,0,147,147,2
49,r_89_22_26,seq18,r_94_59_126,r_89_22_26,0.96,1,27,26,2
38,r_143_111_47,r_142_16_52,seq96,r_143_111_47,0.99,0,47,47,2
66,seq27,seq13,r_55_130_81,r_55_130_81,0.98,24,105,81,2
40,r_114_95_149,r_49_121_186,r_91_74_187,r_114_95_149,0.8,38,187,149,2
78,seq70,r_34_128_39,r_0_80_77,r_0_80_77,0.55,60,137,77,2
31,r_112_9_169,seq3,seq109,r_112_9_169,0.69,1,170,169,2
41,r_35_106_174,seq84,r_47_120_6,r_47_120_6,0.81,168,174,6,2
47,r_147_67_28,r_66_58_153,r_29_65_129,r_147_67_28,1,0,28,28,2
10,r_29_65_129,r_101_108_104,r_147_67_28,r_29_65_129,0.56,-41,88,129,2
9,r_81_90_49,r_41_125_151,seq51,r_81_90_49,1,0,49,49,2
26,r_19_68_70,r_63_146_175,r_132_6_33,r_19_68_70,0.74,0,70,70,2
8,r_129_31_168,seq17,seq134,r_129_31_168,0.95,0,168,168,2
4,r_45_131_105,seq44,r_10_126_189,r_45_131_105,0.97,0,105,105,2
0,r_40_38_65,r_129_31_168,seq43,r_40_38_65,1,0,65,65,2
11,r_28_11_147,seq144,r_64_48_60,r_64_48_60,0.99,0,60,60,2
26,r_19_68_70,r_132_6_33,r_94_59_126,r_94_59_126,1,0,126,126,2
49,r_89_22_26,r_94_59_126,r_41_125_151,r_89_22_26,0.97,101,127,26,2
4,r_45_131_105,r_10_126_189,r_94_59_126,r_45_131_105,0.55,84,189,105,2
57,seq15,r_85_8_181,seq12,r_85_8_181,0.77,0,181,181,2
19,r_71_83_18,r_105_123_130,r_64_48_60,r_71_83_18,1,0,18,18,2
85,seq84,r_35_106_174,r_66_58_153,r_35_106_174,0.55,0,174,174,2
33,r_49_121_186,r_114_95_149,r_94_59_126,r_49_121_186,0.93,0,186,186,2
99,seq127,r_47_120_6,r_98_104_46,r_98_104_46,0.89,29,75,46,2
40,r_114_95_149,r_69_14_29,r_91_74_187,r_69_14_29,0.92,-10,19,29,2
33,r_49_121_186,r_98_104_46,seq73,r_98_104_46,1,0,46,46,2
27,r_116_86_61,seq23,seq136,r_116_86_61,0.87,0,61,61,2
25,r_139_124_51,seq135,r_91_74_187,r_139_124_51,1,0,51,51,2
69,seq43,seq110,r_40_38_65,r_40_38_65,0.87,0,65,65,2
18,r_141_20_170,seq109,seq78,r_141_20_170,0.65,0,170,170,2
79,seq72,seq13,r_55_130_81,r_55_130_81,0.94,0,81,81,2
6,r_10_126_189,r_45_131_105,r_55_130_81,r_10_126_189,0.93,0,189,189,2
48,r_42_99_5,seq75,r_103_138_111,r_103_138_111,1,1,112,111,2
47,r_147_67_28,r_29_65_129,r_2_107_144,r_147_67_28,0.98,101,129,28,2
88,seq93,r_63_146_175,r_88_117_45,r_88_117_45,1,130,175,45,2
2,r_98_104_46,r_49_121_186,seq23,r_98_104_46,1,0,46,46,2
50,seq3,r_112_9_169,r_113_115_93,r_113_115_93,0.74,6,99,93,2
70,seq44,r_45_131_105,seq43,r_45_131_105,0.65,5,110,105,2
6,r_10_126_189,seq26,r_45_131_105,r_45_131_105,0.99,36,141,105,2
10,r_29_65_129,r_147_67_28,seq133,r_29_65_129,1,0,129,129,2
65,seq26,r_10_126_189,r_132_6_33,r_132_6_33,1,43,76,33,2
37,r_88_117_45,seq122,seq93,r_88_117_45,1,0,45,45,2
68,seq33,r_2_107_144,seq144,r_2_107_144,1,2,146,144,2
32,r_113_115_93,seq136,seq3,r_113_115_93,0.94,0,93,93,2
34,r_1_79_84,r_63_146_175,r_132_6_33,r_1_79_84,0.77,0,84,84,2
44,r_142_16_52,r_10_126_189,r_105_123_130,r_142_16_52,1,0,52,52,2
19,r_71_83_18,r_64_48_60,r_69_14_29,r_64_48_60,0.88,0,60,60,2
30,r_60_149_32,seq110,seq17,r_60_149_32,1,0,32,32,2
17,r_91_74_187,r_114_95_149,seq118,r_91_74_187,0.43,-116,71,187,2
29,r_34_128_39,seq70,r_0_80_77,r_0_80_77,0.98,0,77,77,2
29,r_34_128_39,seq57,seq70,r_34_128_39,0.99,0,39,39,2
25,r_139_124_51,r_91_74_187,seq118,r_91_74_187,0.79,-86,101,187,2
22,r_101_108_104,r_29_65_129,seq5,r_101_108_104,0.97,0,104,104,2
33,r_49_121_186,r_143_111_47,r_114_95_149,r_114_95_149,0.9,0,149,149,2
79,seq72,r_81_90_49,seq13,r_81_90_49,0.99,0,49,49,2
7,r_64_48_60,r_71_83_18,r_28_11_147,r_64_48_60,1,0,60,60,2
23,r_145_82_178,seq73,r_141_20_170,r_145_82_178,0.61,0,178,178,2
17,r_91_74_187,seq118,r_114_95_149,r_114_95_149,0.95,38,187,149,2
89,seq96,r_145_82_178,r_143_111_47,r_143_111_47,0.99,0,47,47,2
78,seq70,r_35_106_174,r_34_128_39,r_34_128_39,0.79,-1,38,39,2
12,r_94_59_126,r_89_22_26,r_19_68_70,r_94_59_126,0.85,1,127,126,2
84,seq78,r_105_123_130,r_141_20_170,r_141_20_170,0.7,1,171,170,2
51,seq2,seq105,r_30_51_95,r_30_51_95,1,13,108,95,3
47,r_10_79_133,r_124_93_65,r_122_135_26,r_10_79_133,0.54,0,133,133,3
6,r_143_123_153,seq52,seq110,r_143_123_153,0.93,0,153,153,3
14,r_6_125_144,seq7,r_116_32_6,r_6_125_144,0.96,0,144,144,3
8,r_56_104_62,seq73,seq52,r_56_104_62,1,1,63,62,3
37,r_37_81_143,seq73,r_91_139_27,r_37_81_143,0.55,0,143,143,3
55,seq13,r_108_145_185,r_72_17_173,r_72_17_173,0.52,-108,65,173,3
97,seq118,r_42_95_118,r_21_117_148,r_21_117_148,0.7,3,151,148,3
46,r_18_76_181,r_21_117_148,r_31_27_103,r_18_76_181,0.56,-42,139,181,3
42,r_54_11_146,r_146_59_199,r_134_35_5,r_54_11_146,0.76,0,146,146,3
15,r_92_90_13,r_16_45_32,r_142_136_37,r_92_90_13,0.89,26,39,13,3
21,r_42_95_118,r_41_119_35,r_19_82_184,r_41_119_35,1,1,36,35,3
2,r_85_28_10,r_146_59_199,seq55,r_85_28_10,0.9,0,10,10,3
45,r_127_111_164,seq97,r_10_79_133,r_10_79_133,0.65,32,165,133,3
29,r_31_27_103,r_68_144_157,r_18_76_181,r_68_144_157,1,1,158,157,3
19,r_0_8_147,seq53,r_132_77_15,r_0_8_147,0.83,0,147,147,3
33,r_114_43_131,seq25,seq47,r_114_43_131,0.99,0,131,131,3
41,r_142_136_37,r_114_43_131,r_92_90_13,r_142_136_37,0.94,0,37,37,3
21,r_42_95_118,seq118,r_122_135_26,r_122_135_26,0.48,87,113,26,3
95,seq112,r_72_17_173,r_44_74_23,r_44_74_23,0.72,151,174,23,3
31,r_108_145_185,seq13,r_68_144_157,r_68_144_157,0.9,0,157,157,3
31,r_108_145_185,r_68_144_157,r_38_9_120,r_108_145_185,0.53,1,186,185,3
67,seq47,seq121,r_114_43_131,r_114_43_131,1,7,138,131,3
24,r_57_96_43,r_31_27_103,seq53,r_57_96_43,1,0,43,43,3
10,r_128_87_121,seq75,r_126_133_46,r_128_87_121,0.99,0,121,121,3
4,r_38_9_120,r_149_3_165,r_85_28_10,r_38_9_120,0.61,0,120,120,3
0,r_137_70_128,r_131_33_58,seq25,r_137_70_128,0.94,0,128,128,3
20,r_88_130_183,seq46,seq138,r_88_130_183,0.45,0,183,183,3
81,seq141,seq67,r_132_77_15,r_132_77_15,0.72,1,16,15,3
70,seq55,r_85_28_10,r_16_45_32,r_16_45_32,0.55,-4,28,32,3
48,r_64_61_145,seq110,seq55,r_64_61_145,0.67,0,145,145,3
27,r_68_144_157,r_31_27_103,r_108_145_185,r_68_144_157,1,0,157,157,3
79,seq75,seq13,r_68_144_157,r_68_144_157,0.68,6,163,157,3
29,r_31_27_103,r_57_96_43,seq52,r_57_96_43,0.99,0,43,43,3
33,r_114_43_131,r_142_136_37,seq25,r_142_136_37,1,0,37,37,3
15,r_92_90_13,r_114_43_131,r_16_45_32,r_92_90_13,0.94,0,13,13,3
2,r_85_28_10,seq55,r_38_9_120,r_38_9_120,1,1,121,120,3
1,r_62_89_45,seq53,seq7,r_62_89_45,1,0,45,45,3
5,r_116_32_6,seq73,r_6_125_144,r_6_125_144,0.98,0,144,144,3
55,seq13,seq75,r_68_144_157,r_68_144_157,0.63,11,168,157,3
13,r_16_45_32,r_92_90_13,seq55,r_16_45_32,1,1,33,32,3
30,r_91_139_27,r_146_59_199,r_36_5_175,r_91_139_27,0.97,2,29,27,3
28,r_132_77_15,seq120,seq97,r_132_77_15,0.79,2,17,15,3
27,r_68_144_157,r_21_117_148,r_31_27_103,r_31_27_103,0.61,4,107,103,3
30,r_91_139_27,r_36_5_175,r_37_81_143,r_37_81_143,0.74,0,143,143,3
47,r_10_79_133,r_20_113_130,r_124_93_65,r_124_93_65,1,51,116,65,3
46,r_18_76_181,r_31_27_103,r_72_17_173,r_18_76_181,0.97,1,182,181,3
34,r_84_100_19,seq98,seq1,r_84_100_19,1,0,19,19,3
38,r_29_49_50,seq60,seq71,r_29_49_50,0.95,0,50,50,3
17,r_126_133_46,seq86,seq34,r_126_133_46,0.78,9,55,46,3
25,r_124_93_65,r_99_4_71,r_20_113_130,r_124_93_65,1,0,65,65,3
50,seq1,seq58,r_84_100_19,r_84_100_19,1,0,19,19,3
35,r_20_113_130,r_124_93_65,seq65,r_20_113_130,1,-1,129,130,3
27,r_68_144_157,r_108_145_185,seq13,r_108_145_185,0.63,-1,184,185,3
25,r_124_93_65,r_20_113_130,seq115,r_124_93_65,0.6,66,131,65,3
94,seq110,r_64_61_145,seq98,r_64_61_145,0.93,-6,139,145,3
96,seq115,r_16_45_32,r_56_104_62,r_16_45_32,0.89,123,155,32,3
72,seq60,r_134_35_5,seq25,r_134_35_5,0.62,78,83,5,3
47,r_10_79_133,r_122_135_26,r_127_111_164,r_10_79_133,0.65,32,165,133,3
29,r_31_27_103,seq52,r_68_144_157,r_31_27_103,0.98,0,103,103,3
22,r_21_117_148,r_18_76_181,seq118,r_21_117_148,0.68,1,149,148,3
21,r_42_95_118,r_19_82_184,seq118,r_19_82_184,0.48,-101,83,184,3
72,seq60,r_29_49_50,r_134_35_5,r_29_49_50,0.74,0,50,50,3
49,r_41_119_35,r_42_95_118,seq94,r_41_119_35,1,0,35,35,3
44,r_30_51_95,r_18_76_181,seq2,r_30_51_95,0.87,0,95,95,3
86,seq98,r_64_61_145,seq110,r_64_61_145,0.96,-86,59,145,3
35,r_20_113_130,r_10_79_133,r_124_93_65,r_124_93_65,1,21,86,65,3
12,r_99_4_71,seq52,seq63,r_99_4_71,1,1,72,71,3
36,r_44_74_23,seq118,seq112,r_44_74_23,0.94,0,23,23,3
84,seq94,r_149_3_165,r_41_119_35,r_41_119_35,0.98,131,166,35,3
40,r_119_128_142,r_110_75_157,r_147_84_71,r_110_75_157,0.37,-55,102,157,4
30,r_21_40_184,seq45,r_69_9_30,r_69_9_30,0.67,154,184,30,4
46,r_26_73_183,seq127,r_85_33_153,r_85_33_153,0.89,1,154,153,4
14,r_1_114_72,seq91,seq52,r_1_114_72,0.93,0,72,72,4
53,seq7,seq37,r_145_25_118,r_145_25_118,1,-2,116,118,4
43,r_20_116_149,seq70,seq5,r_20_116_149,0.93,0,149,149,4
38,r_113_100_25,r_143_105_58,seq91,r_113_100_25,0.79,0,25,25,4
54,seq8,r_132_6_139,seq15,r_132_6_139,0.64,1,140,139,4
37,r_56_93_169,r_106_34_61,r_95_125_26,r_56_93_169,0.99,-134,35,169,4
52,seq134,seq42,r_115_112_36,r_115_112_36,0.76,10,46,36,4
40,r_119_128_142,r_147_84_71,r_145_25_118,r_119_128_142,0.84,0,142,142,4
71,seq38,seq2,r_61_32_47,r_61_32_47,1,67,114,47,4
16,r_85_33_153,seq17,r_26_73_183,r_85_33_153,0.73,0,153,153,4
21,r_71_39_63,seq144,seq133,r_71_39_63,1,0,63,63,4
39,r_48_50_171,seq97,seq146,r_48_50_171,0.46,0,171,171,4
46,r_26_73_183,r_3_68_108,seq127,r_3_68_108,0.7,0,108,108,4
42,r_106_34_61,r_56_93_169,r_43_131_29,r_106_34_61,0.99,2,63,61,4
4,r_95_125_26,seq37,r_56_93_169,r_95_125_26,0.96,-1,25,26,4
2,r_87_18_18,r_138_142_175,r_145_25_118,r_87_18_18,0.92,0,18,18,4
19,r_148_22_106,seq101,r_129_0_60,r_148_22_106,0.99,0,106,106,4
33,r_60_137_159,seq30,seq67,r_60_137_159,0.8,0,159,159,4
95,seq111,r_99_57_144,seq146,r_99_57_144,0.59,-1,143,144,4
76,seq55,seq8,r_124_51_179,r_124_51_179,0.71,4,183,179,4
16,r_85_33_153,r_26_73_183,seq2,r_26_73_183,0.95,0,183,183,4
31,r_94_92_132,r_76_53_178,r_60_137_159,r_94_92_132,0.66,0,132,132,4
18,r_143_105_58,r_69_9_30,seq146,r_143_105_58,1,-3,55,58,4
67,seq133,seq17,r_71_39_63,r_71_39_63,1,39,102,63,4
41,r_130_66_62,r_11_46_41,r_16_74_24,r_130_66_62,0.73,3,65,62,4
10,r_129_0_60,seq126,seq78,r_129_0_60,1,0,60,60,4
90,seq104,seq29,r_3_68_108,r_3_68_108,0.87,0,108,108,4
5,r_69_9_30,seq8,r_143_105_58,r_143_105_58,0.61,-28,30,58,4
26,r_65_31_141,r_47_59_84,r_124_51_179,r_47_59_84,1,0,84,84,4
17,r_16_74_24,r_106_34_61,r_138_142_175,r_138_142_175,0.56,-151,24,175,4
28,r_61_32_47,seq101,seq38,r_61_32_47,1,0,47,47,4
5,r_69_9_30,r_143_105_58,r_130_66_62,r_143_105_58,0.79,-2,56,58,4
0,r_4_118_166,seq17,seq79,r_4_118_166,0.48,0,166,166,4
11,r_138_142_175,seq29,r_76_53_178,r_138_142_175,0.56,-1,174,175,4
62,seq19,r_130_66_62,r_43_131_29,r_43_131_29,1,0,29,29,4
46,r_26_73_183,r_85_33_153,r_1_114_72,r_26_73_183,0.97,0,183,183,4
3,r_103_77_13,seq67,seq42,r_103_77_13,0.53,0,13,13,4
13,r_132_6_139,seq8,r_11_46_41,r_11_46_41,0.92,99,140,41,4
18,r_143_105_58,seq104,r_69_9_30,r_69_9_30,1,6,36,30,4
15,r_47_59_84,r_65_31_141,r_43_131_29,r_47_59_84,1,0,84,84,4
48,r_90_89_128,r_132_6_139,seq37,r_90_89_128,0.66,0,128,128,4
23,r_11_46_41,r_130_66_62,r_43_131_29,r_43_131_29,0.52,32,61,29,4
26,r_65_31_141,r_124_51_179,r_147_84_71,r_65_31_141,0.98,0,141,141,4
85,seq97,r_48_50_171,r_76_53_178,r_48_50_171,0.85,3,174,171,4
2,r_87_18_18,r_145_25_118,seq23,r_145_25_118,0.58,-36,82,118,4
7,r_43_131_29,r_147_84_71,seq19,r_43_131_29,0.87,0,29,29,4
27,r_147_84_71,seq49,r_65_31_141,r_65_31_141,0.91,-3,138,141,4
47,r_54_135_2,seq104,r_83_64_75,r_83_64_75,1,1,76,75,4
45,r_115_112_36,r_90_89_128,seq134,r_90_89_128,0.57,-92,36,128,4
40,r_119_128_142,r_43_131_29,r_110_75_157,r_43_131_29,0.98,-3,26,29,4
29,r_117_44_167,r_80_24_64,seq13,r_80_24_64,0.67,103,167,64,4
2,r_87_18_18,seq23,r_120_82_88,r_120_82_88,0.84,4,92,88,4
61,seq146,r_143_105_58,r_48_50_171,r_48_50_171,0.84,0,171,171,4
42,r_106_34_61,r_43_131_29,r_83_64_75,r_106_34_61,0.46,43,104,61,4
25,r_124_51_179,r_65_31_141,r_72_63_125,r_65_31_141,0.81,-16,125,141,4
89,seq102,seq91,r_72_63_125,r_72_63_125,1,3,128,125,4
41,r_130_66_62,r_138_142_175,r_11_46_41,r_11_46_41,0.9,0,41,41,4
58,seq15,r_90_89_128,seq8,r_90_89_128,1,-62,66,128,4
6,r_145_25_118,r_87_18_18,seq7,r_145_25_118,0.97,0,118,118,4
77,seq67,seq126,r_60_137_159,r_60_137_159,0.71,1,160,159,4
25,r_124_51_179,r_72_63_125,seq55,r_124_51_179,0.97,0,179,179,4
34,r_58_123_90,seq29,seq91,r_58_123_90,1,0,90,90,4
23,r_11_46_41,seq12,r_132_6_139,r_11_46_41,0.76,98,139,41,4
23,r_11_46_41,seq2,r_130_66_62,r_130_66_62,0.61,-19,43,62,4
75,seq52,seq13,r_1_114_72,r_1_114_72,1,2,74,72,4
9,r_14_28_87,r_65_31_141,seq23,r_14_28_87,0.99,0,87,87,4
61,seq146,r_99_57_144,r_143_105_58,r_143_105_58,0.84,-1,57,58,4
96,seq121,r_72_63_125,seq127,r_72_63_125,0.79,-23,102,125,4
37,r_56_93_169,r_95_125_26,r_72_63_125,r_95_125_26,0.52,143,169,26,4
22,r_80_24_64,r_117_44_167,r_145_25_118,r_145_25_118,0.78,49,167,118,4
91,seq144,r_71_39_63,seq139,r_71_39_63,1,0,63,63,4
31,r_94_92_132,r_60_137_159,seq98,r_60_137_159,1,-3,156,159,4
7,r_43_131_29,seq19,r_47_59_84,r_47_59_84,1,-1,83,84,4
44,r_83_64_75,seq37,r_54_135_2,r_83_64_75,1,-5,70,75,4
32,r_10_149_56,seq133,seq36,r_10_149_56,0.99,0,56,56,4
17,r_16_74_24,r_138_142_175,r_3_68_108,r_3_68_108,0.69,52,160,108,4
35,r_120_82_88,seq78,r_87_18_18,r_120_82_88,1,1,89,88,4
72,seq42,seq134,r_103_77_13,r_103_77_13,0.66,33,46,13,4
12,r_3_68_108,r_26_73_183,seq104,r_3_68_108,0.99,0,108,108,4
6,r_145_25_118,seq23,r_87_18_18,r_87_18_18,1,1,19,18,4
84,seq91,seq109,r_58_123_90,r_58_123_90,1,81,171,90,4
51,seq2,seq32,r_43_36_118,r_43_36_118,0.82,9,127,118,5
36,r_131_67_186,seq6,r_57_124_120,r_131_67_186,0.29,1,187,186,5
1,r_11_121_3,seq42,r_112_81_10,r_112_81_10,0.86,1,11,10,5
14,r_141_89_75,seq91,r_104_45_68,r_141_89_75,1,0,75,75,5
43,r_83_31_167,seq20,r_11_121_3,r_83_31_167,0.59,0,167,167,5
83,seq88,r_125_122_147,r_25_44_59,r_25_44_59,0.79,18,77,59,5
37,r_137_139_91,r_125_122_147,r_19_99_5,r_137_139_91,0.87,0,91,91,5
20,r_55_118_40,r_71_54_125,seq23,r_55_118_40,1,0,40,40,5
59,seq143,r_116_90_96,seq97,r_116_90_96,0.95,-1,95,96,5
15,r_38_120_155,r_144_86_56,r_130_135_61,r_38_120_155,0.75,-13,142,155,5
55,seq6,r_131_67_186,r_96_136_124,r_96_136_124,1,56,180,124,5
16,r_104_45_68,r_130_135_61,r_141_89_75,r_104_45_68,1,-6,62,68,5
21,r_96_136_124,seq100,seq6,r_96_136_124,0.96,0,124,124,5
46,r_50_69_67,seq75,r_25_44_59,r_50_69_67,1,0,67,67,5
23,r_22_14_29,r_66_16_94,seq92,r_22_14_29,0.78,-7,22,29,5
68,seq41,r_30_105_44,r_66_16_94,r_30_105_44,0.73,0,44,44,5
45,r_1_111_85,r_131_67_186,seq77,r_1_111_85,0.94,2,87,85,5
7,r_147_113_55,r_71_54_125,seq91,r_147_113_55,0.52,-1,54,55,5
33,r_66_16_94,r_116_90_96,r_125_122_147,r_125_122_147,1,3,150,147,5
68,seq41,r_66_16_94,r_144_86_56,r_144_86_56,0.46,1,57,56,5
66,seq37,seq77,r_29_46_104,r_29_46_104,1,22,126,104,5
76,seq74,seq58,r_71_54_125,r_71_54_125,1,1,126,125,5
31,r_146_8_129,r_62_140_160,r_25_44_59,r_25_44_59,0.75,73,132,59,5
41,r_12_15_189,r_71_54_125,seq80,r_71_54_125,1,-4,121,125,5
3,r_119_109_106,r_96_136_124,seq80,r_119_109_106,0.99,0,106,106,5
42,r_144_86_56,seq73,seq41,r_144_86_56,0.99,0,56,56,5
93,seq103,r_83_31_167,r_57_124_120,r_57_124_120,0.77,-57,63,120,5
4,r_28_33_115,r_40_133_114,seq95,r_28_33_115,1,0,115,115,5
2,r_84_68_38,r_55_118_40,seq94,r_84_68_38,1,0,38,38,5
0,r_29_46_104,r_129_108_188,seq37,r_29_46_104,1,0,104,104,5
63,seq24,seq27,r_18_64_146,r_18_64_146,0.8,1,147,146,5
29,r_25_44_59,r_106_72_135,seq88,r_25_44_59,1,0,59,59,5
13,r_57_124_120,r_38_120_155,r_104_45_68,r_57_124_120,0.99,0,120,120,5
98,seq126,r_119_109_106,seq10,r_119_109_106,0.97,0,106,106,5
15,r_38_120_155,r_57_124_120,r_144_86_56,r_144_86_56,0.9,64,120,56,5
48,r_116_90_96,seq143,r_66_16_94,r_116_90_96,1,1,97,96,5
64,seq27,r_47_110_187,r_116_90_96,r_116_90_96,0.87,41,137,96,5
12,r_56_148_7,r_13_82_191,seq32,r_56_148_7,0.34,171,178,7,5
6,r_125_122_147,seq88,r_66_16_94,r_125_122_147,0.98,1,148,147,5
62,seq23,seq87,r_55_118_40,r_55_118_40,0.51,11,51,40,5
93,seq103,r_57_124_120,seq27,r_57_124_120,0.56,-28,92,120,5
99,seq149,r_107_102_95,seq52,r_107_102_95,0.97,2,97,95,5
17,r_30_105_44,seq41,seq20,r_30_105_44,0.97,0,44,44,5
27,r_62_140_160,seq3,r_65_85_173,r_62_140_160,0.83,13,173,160,5
44,r_19_99_5,r_141_89_75,r_48_127_27,r_141_89_75,0.71,-43,32,75,5
22,r_47_110_187,seq27,r_63_51_137,r_47_110_187,0.46,-17,170,187,5
41,r_12_15_189,seq80,r_18_64_146,r_12_15_189,0.71,0,189,189,5
47,r_65_85_173,r_130_135_61,r_104_45_68,r_130_135_61,1,1,62,61,5
40,r_40_133_114,r_28_33_115,r_79_34_9,r_28_33_115,0.41,-1,114,115,5
24,r_106_72_135,r_145_0_144,seq80,r_106_72_135,0.96,0,135,135,5
33,r_66_16_94,r_47_110_187,r_116_90_96,r_116_90_96,0.96,9,105,96,5
47,r_65_85_173,r_104_45_68,r_62_140_160,r_65_85_173,0.64,0,173,173,5
28,r_112_81_10,r_28_33_115,r_11_121_3,r_112_81_10,0.64,0,10,10,5
32,r_71_54_125,r_12_15_189,seq74,r_71_54_125,0.93,0,125,125,5
52,seq3,r_62_140_160,seq93,r_62_140_160,0.8,5,165,160,5
40,r_40_133_114,r_79_34_9,r_29_46_104,r_79_34_9,0.68,147,156,9,5
19,r_130_135_61,r_40_133_114,seq114,r_40_133_114,1,0,114,114,5
10,r_35_9_142,r_53_61_42,seq117,r_53_61_42,0.78,0,42,42,5
34,r_26_49_175,seq142,r_35_9_142,r_26_49_175,0.69,0,175,175,5
9,r_4_17_51,r_104_45_68,seq91,r_4_17_51,1,0,51,51,5
60,seq20,r_83_31_167,r_30_105_44,r_30_105_44,0.89,123,167,44,5
94,seq114,r_40_133_114,r_130_135_61,r_130_135_61,0.55,53,114,61,5
64,seq27,r_130_135_61,r_47_110_187,r_130_135_61,0.6,1,62,61,5
22,r_47_110_187,r_66_16_94,seq27,r_47_110_187,0.49,-82,105,187,5
91,seq100,r_96_136_124,seq10,r_96_136_124,0.91,0,124,124,5
22,r_47_110_187,r_63_51_137,r_96_136_124,r_47_110_187,0.83,0,187,187,5
49,r_63_51_137,r_19_99_5,r_116_90_96,r_19_99_5,0.69,133,138,5,5
19,r_130_135_61,r_104_45_68,r_40_133_114,r_130_135_61,1,-3,58,61,5
26,r_48_127_27,r_146_8_129,r_19_99_5,r_48_127_27,0.51,5,32,27,5
8,r_53_61_42,r_35_9_142,seq142,r_53_61_42,0.99,0,42,42,5
30,r_88_118_187,r_66_52_194,r_37_142_60,r_37_142_60,1,10,70,60,6
36,r_66_52_194,r_88_118_187,r_19_60_44,r_19_60_44,1,88,132,44,6
14,r_37_142_60,seq97,r_88_118_187,r_37_142_60,1,0,60,60,6
8,r_77_141_63,r_63_112_125,seq30,r_63_112_125,0.6,-62,63,125,6
83,seq94,r_66_52_194,r_18_22_157,r_18_22_157,0.88,27,184,157,6
4,r_119_44_183,seq110,r_62_98_22,r_119_44_183,0.81,-8,175,183,6
26,r_104_132_140,r_39_83_47,r_86_67_136,r_39_83_47,0.66,0,47,47,6
34,r_71_81_23,r_19_60_44,seq75,r_71_81_23,0.88,1,24,23,6
55,seq8,r_41_106_134,seq73,r_41_106_134,0.95,0,134,134,6
71,seq64,seq36,r_143_129_74,r_143_129_74,1,53,127,74,6
16,r_89_45_105,seq78,r_147_131_46,r_89_45_105,1,1,106,105,6
21,r_28_137_126,seq108,seq9,r_28_137_126,0.52,0,126,126,6
39,r_5_144_102,r_50_17_96,seq85,r_5_144_102,1,-5,97,102,6
88,seq105,r_88_118_187,r_50_17_96,r_50_17_96,0.66,4,100,96,6
5,r_0_47_67,r_147_131_46,seq84,r_0_47_67,0.99,0,67,67,6
4,r_119_44_183,r_32_148_16,seq110,r_119_44_183,0.7,-34,149,183,6
41,r_19_60_44,seq23,r_66_52_194,r_19_60_44,1,0,44,44,6
7,r_62_98_22,r_138_42_141,r_5_144_102,r_62_98_22,0.88,119,141,22,6
11,r_86_67_136,r_138_42_141,r_32_148_16,r_32_148_16,0.95,3,19,16,6
76,seq75,seq90,r_71_81_23,r_71_81_23,1,1,24,23,6
45,r_4_117_174,seq61,r_35_33_149,r_4_117_174,0.7,0,174,174,6
95,seq120,r_68_10_57,seq90,r_68_10_57,0.61,0,57,57,6
19,r_46_40_69,r_139_101_100,r_39_83_47,r_46_40_69,1,0,69,69,6
22,r_58_12_31,seq135,r_114_38_4,r_58_12_31,1,0,31,31,6
11,r_86_67_136,r_32_148_16,seq30,r_86_67_136,0.93,2,138,136,6
67,seq36,seq64,r_143_129_74,r_143_129_74,1,10,84,74,6
43,r_32_148_16,r_71_81_23,r_86_67_136,r_32_148_16,1,0,16,16,6
3,r_139_101_100,r_46_40_69,seq84,r_46_40_69,0.95,0,69,69,6
10,r_143_129_74,seq21,r_13_65_79,r_143_129_74,1,0,74,74,6
15,r_68_10_57,r_87_96_111,r_125_53_146,r_87_96_111,0.62,-37,74,111,6
0,r_109_92_41,seq2,seq84,r_109_92_41,1,0,41,41,6
40,r_80_15_37,seq73,seq9,r_80_15_37,1,0,37,37,6
14,r_37_142_60,r_88_118_187,r_46_40_69,r_37_142_60,0.53,127,187,60,6
4,r_119_44_183,seq100,r_32_148_16,r_32_148_16,0.49,112,128,16,6
78,seq84,r_35_33_149,r_0_47_67,r_0_47_67,0.97,81,148,67,6
73,seq70,r_56_74_84,seq115,r_56_74_84,1,-1,83,84,6
20,r_59_130_73,seq102,seq78,r_59_130_73,1,2,75,73,6
13,r_50_17_96,r_5_144_102,seq105,r_50_17_96,1,0,96,96,6
60,seq23,r_19_60_44,seq123,r_19_60_44,1,0,44,44,6
48,r_87_96_111,r_63_112_125,seq124,r_87_96_111,0.7,0,111,111,6
6,r_35_33_149,seq84,seq94,r_35_33_149,0.8,0,149,149,6
56,seq9,r_62_98_22,r_80_15_37,r_80_15_37,0.99,0,37,37,6
15,r_68_10_57,r_125_53_146,r_138_42_141,r_68_10_57,0.93,84,141,57,6
62,seq27,r_5_144_102,r_122_95_199,r_5_144_102,0.79,2,104,102,6
7,r_62_98_22,seq9,r_138_42_141,r_62_98_22,0.51,3,25,22,6
9,r_149_107_13,seq110,seq72,r_149_107_13,0.49,0,13,13,6
27,r_76_14_133,r_35_33_149,seq72,r_76_14_133,0.99,0,133,133,6
30,r_88_118_187,r_37_142_60,seq124,r_37_142_60,0.61,127,187,60,6
88,seq105,r_146_140_42,r_88_118_187,r_146_140_42,0.97,-1,41,42,6
87,seq102,r_59_130_73,seq97,r_59_130_73,1,4,77,73,6
2,r_18_22_157,seq34,r_46_40_69,r_18_22_157,0.85,1,158,157,6
42,r_146_140_42,seq105,seq126,r_146_140_42,1,0,42,42,6
2,r_18_22_157,r_41_106_134,seq34,r_41_106_134,0.77,-5,129,134,6
41,r_19_60_44,r_66_52_194,r_46_40_69,r_46_40_69,0.9,85,154,69,6
47,r_11_103_97,seq3,r_56_74_84,r_11_103_97,1,1,98,97,6
29,r_39_83_47,r_104_132_140,r_127_48_179,r_39_83_47,0.86,0,47,47,6
18,r_26_79_175,seq91,r_58_12_31,r_58_12_31,1,42,73,31,6
24,r_13_65_79,r_89_45_105,r_143_129_74,r_13_65_79,1,0,79,79,6
34,r_71_81_23,seq75,r_104_132_140,r_104_132_140,1,7,147,140,6
43,r_32_148_16,r_86_67_136,seq9,r_86_67_136,0.94,4,140,136,6
33,r_55_134_87,seq30,seq120,r_55_134_87,0.98,0,87,87,6
28,r_125_53_146,seq72,seq78,r_125_53_146,1,0,146,146,6
15,r_68_10_57,seq120,r_87_96_111,r_68_10_57,0.87,0,57,57,6
38,r_41_106_134,seq8,seq70,r_41_106_134,0.99,0,134,134,6
52,seq3,r_11_103_97,seq29,r_11_103_97,0.96,6,103,97,6
44,r_147_131_46,r_0_47_67,seq61,r_147_131_46,0.65,6,52,46,6
29,r_39_83_47,r_127_48_179,r_46_40_69,r_46_40_69,0.99,2,71,69,6
17,r_127_48_179,r_66_52_194,r_46_40_69,r_46_40_69,1,1,70,69,6
26,r_104_132_140,r_86_67_136,r_71_81_23,r_104_132_140,0.66,0,140,140,6
3,r_139_101_100,seq84,seq115,r_139_101_100,0.94,1,101,100,6
28,r_125_53_146,r_54_133_86,seq72,r_54_133_86,0.96,1,87,86,6
73,seq70,seq115,r_41_106_134,r_41_106_134,1,32,166,134,6
49,r_136_51_167,seq105,seq64,r_136_51_167,0.67,0,167,167,6
75,seq73,r_80_15_37,seq8,r_80_15_37,1,0,37,37,6
18,r_26_79_175,r_58_12_31,seq25,r_26_79_175,0.75,0,175,175,6
23,r_54_133_86,r_125_53_146,r_146_140_42,r_54_133_86,1,0,86,86,6
17,r_127_48_179,r_46_40_69,r_86_67_136,r_127_48_179,0.73,0,179,179,6
71,seq64,r_143_129_74,r_136_51_167,r_136_51_167,0.86,2,169,167,6
79,seq85,seq9,r_5_144_102,r_5_144_102,1,-1,101,102,6
35,r_138_42_141,r_62_98_22,r_68_10_57,r_62_98_22,0.51,119,141,22,6
12,r_56_74_84,seq70,r_11_103_97,r_56_74_84,1,14,98,84,6
95,seq120,seq90,r_55_134_87,r_55_134_87,0.93,-2,85,87,6
34,r_94_45_185,r_138_87_7,r_62_28_122,r_94_45_185,0.97,1,186,185,7
46,r_5_126_18,r_18_68_83,seq83,r_5_126_18,0.93,0,18,18,7
36,r_114_46_67,r_29_86_182,seq121,r_114_46_67,1,0,67,67,7
9,r_37_149_58,seq112,r_79_44_116,r_79_44_116,0.99,5,121,116,7
92,seq109,r_37_149_58,r_115_74_60,r_115_74_60,0.79,0,60,60,7
14,r_105_33_149,seq35,r_89_21_115,r_89_21_115,0.56,36,151,115,7
49,r_131_135_95,r_0_97_147,seq111,r_0_97_147,0.81,0,147,147,7
8,r_89_21_115,seq91,r_102_124_76,r_102_124_76,0.59,40,116,76,7
43,r_141_146_108,r_136_100_144,seq109,r_141_146_108,1,0,108,108,7
55,seq11,r_96_93_161,r_18_68_83,r_18_68_83,0.91,78,161,83,7
86,seq101,r_71_140_188,r_136_100_144,r_136_100_144,0.86,43,187,144,7
39,r_14_1_92,seq10,r_115_74_60,r_14_1_92,0.87,-9,83,92,7
1,r_16_2_117,seq4,seq109,r_16_2_117,0.88,0,117,117,7
5,r_8_60_131,seq106,seq32,r_8_60_131,0.99,0,131,131,7
8,r_89_21_115,r_102_124_76,r_103_80_141,r_103_80_141,1,-2,139,141,7
45,r_38_19_97,seq129,r_57_61_75,r_38_19_97,0.57,30,127,97,7
95,seq112,r_24_65_176,seq108,r_24_65_176,0.98,-50,126,176,7
76,seq72,seq119,r_78_40_96,r_78_40_96,1,34,130,96,7
31,r_103_80_141,seq43,r_89_21_115,r_103_80_141,0.77,0,141,141,7
41,r_30_130_135,seq48,r_89_21_115,r_30_130_135,0.45,0,135,135,7
89,seq106,r_8_60_131,seq92,r_8_60_131,1,0,131,131,7
3,r_24_65_176,seq70,r_20_98_93,r_24_65_176,0.56,0,176,176,7
18,r_62_28_122,r_56_63_109,r_120_123_62,r_120_123_62,0.6,-50,12,62,7
4,r_136_100_144,r_77_34_78,r_39_99_50,r_136_100_144,0.94,0,144,144,7
4,r_136_100_144,r_141_146_108,r_77_34_78,r_136_100_144,0.68,-36,108,144,7
0,r_79_44_116,seq145,r_37_149_58,r_79_44_116,0.87,0,116,116,7
11,r_20_98_93,r_23_51_154,r_82_132_84,r_20_98_93,0.99,0,93,93,7
20,r_120_123_62,seq109,seq118,r_120_123_62,0.95,1,63,62,7
13,r_18_68_83,r_128_54_162,seq42,r_18_68_83,1,0,83,83,7
98,seq121,r_142_139_186,r_114_46_67,r_114_46_67,1,10,77,67,7
15,r_75_122_145,seq88,r_13_36_114,r_75_122_145,0.89,0,145,145,7
48,r_56_63_109,seq17,seq31,r_56_63_109,0.96,0,109,109,7
57,seq17,r_56_63_109,seq104,r_56_63_109,0.98,-5,104,109,7
12,r_138_87_7,r_116_15_140,seq7,r_116_15_140,1,1,141,140,7
6,r_77_34_78,r_89_21_115,r_136_100_144,r_77_34_78,1,0,78,78,7
56,seq144,r_39_99_50,seq7,r_39_99_50,1,0,50,50,7
10,r_39_99_50,seq106,r_136_100_144,r_136_100_144,1,7,151,144,7
27,r_133_76_139,seq84,seq43,r_133_76_139,0.97,0,139,139,7
49,r_131_135_95,r_89_21_115,r_0_97_147,r_131_135_95,1,0,95,95,7
42,r_9_125_13,r_82_132_84,r_22_27_171,r_9_125_13,1,0,13,13,7
29,r_137_55_23,r_39_99_50,seq31,r_137_55_23,0.94,0,23,23,7
49,r_131_135_95,seq129,r_89_21_115,r_131_135_95,0.74,-41,54,95,7
2,r_78_40_96,seq10,seq72,r_78_40_96,0.97,-1,95,96,7
40,r_26_47_68,r_20_98_93,seq10,r_26_47_68,1,8,76,68,7
24,r_0_97_147,seq95,r_131_135_95,r_131_135_95,0.86,1,96,95,7
47,r_116_15_140,r_138_87_7,r_14_1_92,r_116_15_140,0.54,1,141,140,7
39,r_14_1_92,r_115_74_60,seq91,r_14_1_92,0.47,35,127,92,7
50,seq129,r_38_19_97,r_14_1_92,r_14_1_92,1,51,143,92,7
92,seq109,r_115_74_60,r_16_2_117,r_16_2_117,0.92,0,117,117,7
6,r_77_34_78,r_136_100_144,r_56_63_109,r_77_34_78,0.54,65,143,78,7
65,seq42,seq50,r_18_68_83,r_18_68_83,1,-1,82,83,7
42,r_9_125_13,r_22_27_171,r_13_36_114,r_13_36_114,0.88,49,163,114,7
32,r_102_124_76,seq108,seq4,r_102_124_76,1,1,77,76,7
78,seq83,seq41,r_5_126_18,r_5_126_18,1,3,21,18,7
38,r_59_12_106,r_103_80_141,r_18_68_83,r_59_12_106,0.88,0,106,106,7
34,r_94_45_185,r_116_15_140,r_138_87_7,r_94_45_185,0.68,-55,130,185,7
75,seq70,r_24_65_176,seq108,r_24_65_176,0.99,0,176,176,7
60,seq25,r_128_54_162,seq69,r_128_54_162,0.69,1,163,162,7
17,r_13_36_114,r_94_45_185,r_9_125_13,r_13_36_114,0.59,0,114,114,7
94,seq111,r_115_74_60,seq107,r_115_74_60,1,0,60,60,7
10,r_39_99_50,seq144,seq106,r_39_99_50,0.98,0,50,50,7
24,r_0_97_147,r_131_135_95,seq64,r_0_97_147,1,1,148,147,7
28,r_22_27_171,r_9_125_13,r_78_40_96,r_22_27_171,0.93,0,171,171,7
35,r_115_74_60,r_131_135_95,r_14_1_92,r_115_74_60,0.9,34,94,60,7
22,r_82_132_84,seq66,seq31,r_82_132_84,0.97,3,87,84,7
28,r_22_27_171,seq48,r_9_125_13,r_9_125_13,0.92,66,79,13,7
7,r_142_139_186,seq121,r_24_65_176,r_142_139_186,0.46,0,186,186,7
18,r_62_28_122,r_120_123_62,r_6_113_79,r_62_28_122,0.62,-1,121,122,7
44,r_128_54_162,seq25,r_131_135_95,r_128_54_162,0.63,0,162,162,7
23,r_57_61_75,r_77_34_78,seq147,r_77_34_78,0.59,-3,75,78,7
47,r_116_15_140,r_94_45_185,r_138_87_7,r_138_87_7,0.98,19,26,7,7
62,seq32,seq72,r_8_60_131,r_8_60_131,0.59,0,131,131,7
79,seq84,r_133_76_139,seq66,r_133_76_139,0.99,-33,106,139,7
35,r_115_74_60,seq111,r_131_135_95,r_115_74_60,0.88,0,60,60,7
49,r_131_135_95,seq111,r_128_54_162,r_131_135_95,0.59,68,163,95,7
49,r_88_69_44,seq77,seq74,r_88_69_44,1,0,44,44,8
14,r_72_28_174,seq147,r_116_46_102,r_72_28_174,0.53,-28,146,174,8
7,r_58_131_31,r_146_33_30,seq44,r_58_131_31,1,0,31,31,8
18,r_124_128_32,r_111_6_187,r_0_96_138,r_124_128_32,0.86,0,32,32,8
37,r_130_148_124,r_81_49_15,seq25,r_130_148_124,0.98,0,124,124,8
21,r_75_61_141,seq37,seq141,r_75_61_141,0.82,0,141,141,8
39,r_116_46_102,r_35_59_161,r_124_128_32,r_116_46_102,0.77,1,103,102,8
42,r_48_132_61,seq93,r_124_128_32,r_48_132_61,1,0,61,61,8
69,seq37,r_20_60_142,r_51_27_121,r_51_27_121,0.69,21,142,121,8
45,r_99_112_93,seq1,r_144_118_143,r_99_112_93,0.74,2,95,93,8
33,r_90_38_180,r_115_78_94,r_31_97_10,r_90_38_180,0.95,0,180,180,8
44,r_16_109_70,r_140_139_47,r_135_63_20,r_16_109_70,0.79,-24,46,70,8
43,r_135_63_20,seq77,r_16_109_70,r_135_63_20,0.97,0,20,20,8
43,r_135_63_20,r_22_17_140,r_116_46_102,r_22_17_140,0.9,-1,139,140,8
26,r_26_57_81,seq127,seq77,r_26_57_81,1,0,81,81,8
52,seq4,r_115_78_94,r_0_96_138,r_0_96_138,0.66,1,139,138,8
3,r_21_45_107,seq56,r_146_33_30,r_21_45_107,0.96,0,107,107,8
14,r_72_28_174,seq25,seq147,r_72_28_174,0.54,-81,93,174,8
14,r_72_28_174,seq67,r_135_63_20,r_135_63_20,0.92,1,21,20,8
90,seq93,seq36,r_16_109_70,r_16_109_70,1,18,88,70,8
8,r_2_122_25,r_35_59_161,r_26_57_81,r_26_57_81,0.61,68,149,81,8
44,r_16_109_70,r_135_63_20,seq93,r_16_109_70,0.97,0,70,70,8
4,r_115_78_94,r_65_91_172,r_101_62_159,r_115_78_94,0.83,0,94,94,8
36,r_145_102_162,r_35_59_161,r_26_57_81,r_26_57_81,0.76,17,98,81,8
73,seq43,seq87,r_107_143_54,r_107_143_54,1,8,62,54,8
11,r_111_6_187,seq66,r_136_73_45,r_111_6_187,0.47,0,187,187,8
85,seq77,r_88_69_44,seq141,r_88_69_44,1,0,44,44,8
13,r_101_62_159,r_90_38_180,r_115_78_94,r_115_78_94,1,5,99,94,8
25,r_0_96_138,r_22_17_140,r_124_128_32,r_124_128_32,0.99,0,32,32,8
41,r_144_118_143,seq43,r_99_112_93,r_144_118_143,0.7,-84,59,143,8
4,r_115_78_94,r_101_62_159,r_35_59_161,r_115_78_94,0.89,68,162,94,8
75,seq47,r_104_85_57,seq9,r_104_85_57,1,0,57,57,8
43,r_135_63_20,r_124_128_32,r_22_17_140,r_135_63_20,0.52,74,94,20,8
13,r_101_62_159,r_115_78_94,r_31_97_10,r_101_62_159,1,0,159,159,8
6,r_121_125_183,seq80,r_2_122_25,r_121_125_183,0.32,1,184,183,8
39,r_116_46_102,r_124_128_32,r_48_132_61,r_116_46_102,0.47,24,126,102,8
47,r_23_12_79,r_31_97_10,r_95_103_42,r_31_97_10,0.8,0,10,10,8
0,r_35_59_161,r_2_122_25,r_104_85_57,r_35_59_161,0.85,0,161,161,8
99,seq127,seq7,r_136_73_45,r_136_73_45,1,11,56,45,8
8,r_2_122_25,r_123_19_156,r_35_59_161,r_2_122_25,0.95,0,25,25,8
32,r_81_49_15,r_104_85_57,r_31_97_10,r_81_49_15,0.88,0,15,15,8
27,r_140_139_47,r_16_109_70,seq25,r_140_139_47,0.94,0,47,47,8
98,seq126,r_30_142_17,r_14_70_117,r_30_142_17,0.8,0,17,17,8
26,r_26_57_81,seq7,seq127,r_26_57_81,0.57,-40,41,81,8
81,seq67,r_140_139_47,r_82_53_21,r_82_53_21,0.87,0,21,21,8
1,r_31_97_10,r_23_12_79,r_81_49_15,r_31_97_10,0.98,0,10,10,8
2,r_40_137_147,seq98,seq149,r_40_137_147,0.86,0,147,147,8
41,r_144_118_143,r_99_112_93,r_95_103_42,r_95_103_42,0.33,100,142,42,8
36,r_145_102_162,r_136_73_45,r_35_59_161,r_136_73_45,0.97,1,46,45,8
43,r_135_63_20,r_116_46_102,r_82_53_21,r_116_46_102,0.9,71,173,102,8
20,r_136_73_45,r_145_102_162,seq127,r_136_73_45,0.99,1,46,45,8
40,r_79_117_135,seq9,r_99_112_93,r_79_117_135,0.94,1,136,135,8
71,seq41,r_52_83_129,r_146_33_30,r_146_33_30,0.76,2,32,30,8
14,r_72_28_174,r_135_63_20,seq25,r_135_63_20,0.52,50,70,20,8
29,r_114_10_90,seq39,seq32,r_114_10_90,1,0,90,90,8
23,r_30_142_17,seq126,r_81_49_15,r_30_142_17,1,0,17,17,8
24,r_51_27_121,seq25,seq37,r_51_27_121,0.98,1,122,121,8
34,r_108_54_14,seq47,r_18_76_95,r_18_76_95,1,1,96,95,8
33,r_90_38_180,r_101_62_159,r_115_78_94,r_115_78_94,1,14,108,94,8
34,r_108_54_14,r_8_13_173,seq47,r_108_54_14,0.98,0,14,14,8
46,r_104_85_57,seq47,seq36,r_104_85_57,1,0,57,57,8
88,seq86,r_65_91_172,seq3,r_65_91_172,0.57,-15,157,172,8
50,seq1,r_99_112_93,r_23_12_79,r_23_12_79,0.97,16,95,79,8
22,r_82_53_21,r_111_6_187,seq67,r_82_53_21,0.96,0,21,21,8
68,seq36,seq93,r_104_85_57,r_104_85_57,1,4,61,57,8
42,r_48_132_61,r_124_128_32,r_123_19_156,r_123_19_156,0.75,2,158,156,8
14,r_72_28_174,r_116_46_102,seq7,r_72_28_174,0.78,-9,165,174,8
38,r_18_76_95,r_52_83_129,r_108_54_14,r_18_76_95,0.97,0,95,95,8
45,r_99_112_93,r_144_118_143,r_52_83_129,r_99_112_93,0.78,50,143,93,8
25,r_0_96_138,r_124_128_32,seq4,r_0_96_138,0.69,0,138,138,8
9,r_65_91_172,r_115_78_94,seq105,r_115_78_94,0.83,2,96,94,8
48,r_107_143_54,seq138,seq43,r_107_143_54,1,0,54,54,8
43,r_135_63_20,r_16_109_70,r_124_128_32,r_135_63_20,0.7,50,70,20,8
98,seq126,r_14_70_117,seq7,r_14_70_117,0.92,1,118,117,8
28,r_20_60_142,seq37,seq138,r_20_60_142,0.32,0,142,142,8
18,r_124_128_32,r_0_96_138,r_116_46_102,r_124_128_32,0.94,71,103,32,8
19,r_146_33_30,r_58_131_31,seq41,r_146_33_30,1,0,30,30,8
5,r_22_17_140,r_124_128_32,r_107_143_54,r_22_17_140,0.96,0,140,140,8
0,r_35_59_161,r_116_46_102,r_2_122_25,r_35_59_161,0.99,-104,57,161,8
72,seq42,seq86,r_120_89_190,r_120_89_190,0.43,-129,61,190,8
79,seq64,r_123_19_156,seq138,r_123_19_156,0.81,-10,146,156,8
35,r_11_129_72,r_75_61_141,seq36,r_11_129_72,1,0,72,72,8
12,r_52_83_129,seq4,r_99_112_93,r_52_83_129,0.84,-1,128,129,8
36,r_145_102_162,r_26_57_81,seq9,r_145_102_162,0.91,0,162,162,8
84,seq74,seq3,r_88_69_44,r_88_69_44,1,19,63,44,8
93,seq118,seq71,r_22_53_143,r_22_53_143,1,0,143,143,9
30,r_60_50_129,seq78,seq147,r_60_50_129,0.96,0,129,129,9
38,r_127_16_35,r_54_94_33,r_98_143_137,r_127_16_35,0.97,-1,34,35,9
38,r_127_16_35,r_98_143_137,r_88_63_69,r_88_63_69,0.53,2,71,69,9
14,r_31_59_87,r_2_149_175,seq3,r_31_59_87,1,0,87,87,9
37,r_17_128_164,r_73_25_111,seq18,r_73_25_111,1,-27,84,111,9
16,r_82_15_105,r_139_39_135,r_88_63_69,r_82_15_105,1,0,105,105,9
21,r_98_143_137,seq4,r_130_95_62,r_98_143_137,0.71,0,137,137,9
1,r_114_86_148,r_11_30_153,seq144,r_11_30_153,0.59,-4,149,153,9
42,r_6_117_167,seq119,seq64,r_6_117_167,0.57,1,168,167,9
32,r_134_129_38,seq147,seq132,r_134_129_38,1,0,38,38,9
62,seq147,r_61_97_100,seq64,r_61_97_100,0.94,-70,30,100,9
15,r_66_100_18,r_70_87_34,r_6_117_167,r_66_100_18,1,3,21,18,9
15,r_66_100_18,r_6_117_167,r_67_47_96,r_67_47_96,0.86,3,99,96,9
22,r_113_20_46,r_52_120_134,seq124,r_113_20_46,1,0,46,46,9
41,r_115_13_42,seq140,seq109,r_115_13_42,1,0,42,42,9
31,r_48_43_71,seq7,r_52_120_134,r_52_120_134,0.56,-63,71,134,9
27,r_131_37_17,r_114_86_148,seq71,r_131_37_17,0.66,0,17,17,9
3,r_52_120_134,seq71,r_81_26_67,r_52_120_134,0.99,1,135,134,9
10,r_81_26_67,seq38,r_72_135_198,r_81_26_67,0.93,0,67,67,9
68,seq36,r_22_53_143,seq12,r_22_53_143,0.96,-4,139,143,9
19,r_72_135_198,seq122,r_49_69_29,r_49_69_29,0.43,-6,23,29,9
26,r_73_25_111,seq18,seq111,r_73_25_111,1,0,111,111,9
45,r_49_69_29,r_34_1_118,r_72_135_198,r_49_69_29,0.91,-5,24,29,9
0,r_67_47_96,r_146_14_101,r_66_100_18,r_67_47_96,0.99,0,96,96,9
20,r_2_149_175,seq12,r_139_39_135,r_2_149_175,0.8,0,175,175,9
13,r_22_53_143,r_79_96_81,seq36,r_79_96_81,0.75,0,81,81,9
48,r_130_95_62,r_34_1_118,seq28,r_130_95_62,1,2,64,62,9
23,r_61_97_100,r_114_86_148,r_75_8_19,r_114_86_148,0.99,2,150,148,9
4,r_11_30_153,r_75_8_19,seq12,r_11_30_153,0.81,1,154,153,9
57,seq12,r_2_149_175,r_11_30_153,r_11_30_153,0.54,22,175,153,9
13,r_22_53_143,seq36,seq118,r_22_53_143,0.99,0,143,143,9
85,seq93,r_2_149_175,r_34_1_118,r_34_1_118,0.63,5,123,118,9
50,seq0,r_148_126_155,seq77,r_148_126_155,0.63,-56,99,155,9
10,r_81_26_67,r_72_135_198,r_52_120_134,r_52_120_134,1,21,155,134,9
87,seq102,r_139_39_135,seq121,r_139_39_135,1,0,135,135,9
4,r_11_30_153,r_114_86_148,r_75_8_19,r_75_8_19,0.79,4,23,19,9
50,seq0,seq77,r_114_86_148,r_114_86_148,0.99,7,155,148,9
47,r_23_24_83,seq85,r_48_43_71,r_23_24_83,0.99,0,83,83,9
40,r_34_1_118,seq141,seq93,r_34_1_118,0.54,0,118,118,9
74,seq64,seq147,r_6_117_167,r_6_117_167,0.97,10,177,167,9
24,r_104_57_159,seq28,r_60_50_129,r_104_57_159,0.71,0,159,159,9
33,r_58_68_120,seq36,r_48_43_71,r_58_68_120,0.95,0,120,120,9
34,r_80_101_14,r_82_15_105,seq137,r_80_101_14,1,0,14,14,9
64,seq132,seq21,r_19_35_103,r_19_35_103,1,2,105,103,9
28,r_75_8_19,seq55,r_11_30_153,r_75_8_19,0.74,0,19,19,9
58,seq141,r_34_1_118,r_49_69_29,r_34_1_118,1,0,118,118,9
68,seq36,r_58_68_120,r_22_53_143,r_22_53_143,0.62,-23,120,143,9
61,seq18,r_65_41_109,seq142,r_65_41_109,1,-14,95,109,9
52,seq4,r_98_143_137,seq45,r_98_143_137,1,-14,123,137,9
9,r_54_94_33,r_127_16_35,seq110,r_54_94_33,0.98,0,33,33,9
46,r_51_83_49,seq38,seq7,r_51_83_49,1,0,49,49,9
75,seq71,r_88_63_69,r_131_37_17,r_88_63_69,1,0,69,69,9
90,seq109,seq84,r_115_13_42,r_115_13_42,0.57,1,43,42,9
60,seq144,r_148_126_155,r_114_86_148,r_114_86_148,0.98,7,155,148,9
17,r_139_39_135,seq102,r_48_43_71,r_139_39_135,0.94,0,135,135,9
72,seq55,seq111,r_33_107_20,r_33_107_20,1,10,30,20,9
43,r_70_87_34,seq133,r_90_42_7,r_70_87_34,0.77,0,34,34,9
39,r_90_42_7,seq121,r_70_87_34,r_70_87_34,1,0,34,34,9
28,r_75_8_19,r_11_30_153,r_61_97_100,r_75_8_19,0.68,135,154,19,9
62,seq147,seq64,r_60_50_129,r_60_50_129,0.98,20,149,129,9
91,seq110,r_44_103_181,r_54_94_33,r_54_94_33,0.86,148,181,33,9
98,seq124,seq147,r_113_20_46,r_113_20_46,1,4,50,46,9
31,r_48_43_71,r_52_120_134,r_23_24_83,r_48_43_71,0.94,14,85,71,9
56,seq137,seq62,r_80_101_14,r_80_101_14,0.95,53,67,14,9
7,r_88_63_69,seq71,r_127_16_35,r_88_63_69,1,0,69,69,9
43,r_70_87_34,r_66_100_18,seq133,r_66_100_18,0.49,4,22,18,9
23,r_61_97_100,seq147,r_114_86_148,r_61_97_100,0.98,0,100,100,9
82,seq85,r_23_24_83,seq38,r_23_24_83,0.96,-14,69,83,9
49,r_19_35_103,r_51_83_49,r_106_5_8,r_51_83_49,0.87,-29,20,49,9
35,r_146_14_101,r_67_47_96,seq64,r_67_47_96,0.53,7,103,96,9
12,r_79_96_81,r_22_53_143,seq4,r_79_96_81,0.99,0,81,81,9
30,r_14_122_106,seq88,seq125,r_14_122_106,0.77,1,107,106,10
44,r_66_53_148,r_90_67_58,r_69_27_10,r_66_53_148,0.79,0,148,148,10
22,r_142_83_48,r_56_110_145,r_54_8_27,r_54_8_27,0.98,0,27,27,10
23,r_77_46_56,r_34_49_17,seq2,r_77_46_56,1,0,56,56,10
14,r_130_97_125,seq121,seq144,r_130_97_125,0.48,0,125,125,10
43,r_104_148_61,r_135_89_176,seq115,r_104_148_61,0.98,0,61,61,10
86,seq144,seq18,r_130_97_125,r_130_97_125,0.98,1,126,125,10
36,r_149_58_21,seq139,r_47_93_178,r_149_58_21,0.59,3,24,21,10
45,r_54_8_27,r_108_120_113,r_142_83_48,r_54_8_27,0.7,0,27,27,10
42,r_52_131_95,r_62_127_82,r_65_55_26,r_65_55_26,0.69,4,30,26,10
21,r_105_112_157,seq18,r_65_55_26,r_105_112_157,0.61,0,157,157,10
39,r_133_20_151,r_82_116_155,r_77_46_56,r_133_20_151,0.77,0,151,151,10
1,r_19_7_70,seq111,seq40,r_19_7_70,1,0,70,70,10
86,seq144,r_14_122_106,seq18,r_14_122_106,0.8,-48,58,106,10
19,r_6_123_53,seq91,seq35,r_6_123_53,0.56,7,60,53,10
8,r_65_55_26,seq88,r_52_131_95,r_65_55_26,0.7,1,27,26,10
33,r_147_136_28,r_74_75_156,r_87_113_90,r_147_136_28,0.73,128,156,28,10
0,r_34_49_17,r_77_46_56,r_5_33_165,r_77_46_56,0.99,0,56,56,10
34,r_28_64_98,r_87_113_90,seq3,r_87_113_90,0.98,-36,54,90,10
92,seq109,r_34_49_17,seq42,r_34_49_17,0.8,0,17,17,10
31,r_138_29_78,seq1,seq146,r_138_29_78,1,1,79,78,10
16,r_87_113_90,seq107,r_13_76_23,r_13_76_23,1,6,29,23,10
93,seq111,r_44_71_40,r_52_131_95,r_52_131_95,0.96,12,107,95,10
41,r_9_39_102,seq114,seq100,r_9_39_102,0.97,0,102,102,10
19,r_6_123_53,r_69_27_10,r_147_136_28,r_6_123_53,0.46,82,135,53,10
67,seq146,seq100,r_138_29_78,r_138_29_78,1,4,82,78,10
47,r_128_134_1,seq50,r_145_43_16,r_145_43_16,1,7,23,16,10
34,r_28_64_98,seq3,r_34_49_17,r_28_64_98,1,0,98,98,10
89,seq100,seq146,r_9_39_102,r_9_39_102,1,14,116,102,10
3,r_62_127_82,r_52_131_95,seq114,r_62_127_82,1,0,82,82,10
46,r_145_43_16,seq84,r_128_134_1,r_145_43_16,0.94,1,17,16,10
10,r_25_48_183,seq103,r_74_75_156,r_74_75_156,0.56,27,183,156,10
0,r_34_49_17,seq109,r_77_46_56,r_34_49_17,0.88,0,17,17,10
90,seq103,r_25_48_183,r_54_8_27,r_54_8_27,0.84,156,183,27,10
49,r_51_32_117,seq140,seq42,r_51_32_117,0.45,-68,49,117,10
26,r_137_119_76,seq10,seq57,r_137_119_76,0.99,1,77,76,10
8,r_65_55_26,r_52_131_95,seq42,r_52_131_95,1,-1,94,95,10
16,r_87_113_90,r_13_76_23,r_74_75_156,r_87_113_90,1,1,91,90,10
4,r_12_96_160,r_60_118_187,r_138_29_78,r_12_96_160,0.69,0,160,160,10
15,r_44_71_40,r_106_73_150,seq111,r_44_71_40,1,0,40,40,10
20,r_82_116_155,r_133_20_151,r_128_134_1,r_82_116_155,0.84,-2,153,155,10
13,r_38_17_107,r_47_93_178,seq41,r_38_17_107,0.98,0,107,107,10
98,seq125,r_13_76_23,r_101_0_9,r_13_76_23,0.99,0,23,23,10
48,r_60_118_187,r_12_96_160,r_59_68_18,r_12_96_160,0.84,3,163,160,10
57,seq141,seq126,r_19_7_70,r_19_7_70,1,37,107,70,10
5,r_13_76_23,seq107,r_5_33_165,r_5_33_165,0.96,11,176,165,10
2,r_47_93_178,r_149_58_21,seq23,r_47_93_178,0.74,1,179,178,10
5,r_13_76_23,r_87_113_90,seq107,r_87_113_90,1,1,91,90,10
6,r_74_75_156,seq24,r_147_136_28,r_147_136_28,1,0,28,28,10
22,r_142_83_48,r_54_8_27,seq126,r_142_83_48,0.99,0,48,48,10
36,r_149_58_21,r_47_93_178,r_106_73_150,r_149_58_21,0.87,157,178,21,10
87,seq98,r_92_102_85,seq11,r_92_102_85,1,-21,64,85,10
12,r_69_27_10,seq57,seq3,r_69_27_10,1,0,10,10,10
2,r_47_93_178,r_38_17_107,r_149_58_21,r_38_17_107,1,0,107,107,10
40,r_135_89_176,seq86,seq129,r_135_89_176,0.63,1,177,176,10
29,r_56_110_145,seq78,r_69_27_10,r_56_110_145,0.94,0,145,145,10
25,r_106_73_150,r_5_33_165,seq50,r_106_73_150,0.62,0,150,150,10
32,r_37_61_43,seq98,seq139,r_37_61_43,0.96,0,43,43,10
88,seq99,r_4_30_159,seq23,r_4_30_159,0.94,0,159,159,10
5,r_13_76_23,seq125,r_87_113_90,r_13_76_23,1,0,23,23,10
70,seq42,r_62_127_82,r_65_55_26,r_62_127_82,0.99,0,82,82,10
6,r_74_75_156,r_147_136_28,r_38_17_107,r_74_75_156,0.78,0,156,156,10
19,r_6_123_53,seq35,r_69_27_10,r_6_123_53,0.43,65,118,53,10
45,r_54_8_27,r_142_83_48,seq140,r_142_83_48,0.89,0,48,48,10
42,r_52_131_95,r_65_55_26,seq111,r_52_131_95,1,0,95,95,10
11,r_22_95_4,r_147_136_28,seq40,r_147_136_28,1,1,29,28,10
38,r_92_102_85,r_56_110_145,seq35,r_92_102_85,1,0,85,85,10
8,r_65_55_26,seq42,r_105_112_157,r_105_112_157,1,13,170,157,10
17,r_90_67_58,r_138_29_78,seq86,r_90_67_58,1,0,58,58,10
48,r_60_118_187,r_59_68_18,r_56_110_145,r_60_118_187,0.63,0,187,187,10
99,seq126,seq40,r_142_83_48,r_142_83_48,1,0,48,48,10
0,r_34_49_17,r_5_33_165,r_28_64_98,r_28_64_98,0.93,0,98,98,10
9,r_132_80_129,seq16,r_104_148_61,r_132_80_129,0.99,0,129,129,10
38,r_92_102_85,seq35,r_26_81_7,r_92_102_85,0.47,58,143,85,10
16,r_87_113_90,r_74_75_156,r_147_136_28,r_74_75_156,1,0,156,156,10
33,r_147_136_28,r_22_95_4,r_74_75_156,r_147_136_28,0.95,0,28,28,10
84,seq91,r_6_123_53,seq107,r_6_123_53,0.96,4,57,53,10
28,r_117_79_196,r_82_116_155,seq129,r_117_79_196,0.65,-41,155,196,10
91,seq107,r_87_113_90,seq91,r_87_113_90,0.79,1,91,90,10
72,seq50,r_145_43_16,r_106_73_150,r_106_73_150,1,7,157,150,10
56,seq140,r_92_102_85,seq11,r_92_102_85,1,0,85,85,10
7,r_108_120_113,seq23,r_101_0_9,r_108_120_113,0.99,0,113,113,10
44,r_66_53_148,r_135_89_176,r_90_67_58,r_90_67_58,1,4,62,58,10
82,seq86,r_135_89_176,r_90_67_58,r_90_67_58,1,14,72,58,10
49,r_51_32_117,r_25_48_183,r_137_119_76,r_51_32_117,0.69,-4,113,117,10
35,r_5_33_165,seq41,r_13_76_23,r_5_33_165,0.69,-1,164,165,10
23,r_77_46_56,r_4_30_159,r_34_49_17,r_34_49_17,0.99,4,21,17,10
75,seq139,seq16,r_37_61_43,r_37_61_43,0.89,4,47,43,10
93,seq109,seq53,r_129_5_39,r_129_5_39,1,85,124,39,11
51,seq128,seq109,r_129_5_39,r_129_5_39,1,66,105,39,11
36,r_24_148_91,seq22,r_77_48_180,r_24_148_91,0.99,0,91,91,11
9,r_9_121_118,r_95_8_115,r_132_75_96,r_9_121_118,0.68,0,118,118,11
92,seq107,r_79_44_101,seq14,r_79_44_101,1,-19,82,101,11
20,r_39_112_93,seq134,r_129_5_39,r_129_5_39,1,2,41,39,11
8,r_77_48_180,seq33,r_24_148_91,r_24_148_91,0.77,3,94,91,11
81,seq69,seq17,r_122_41_95,r_122_41_95,1,82,177,95,11
37,r_20_4_160,seq0,r_31_67_11,r_20_4_160,0.94,0,160,160,11
55,seq11,r_81_86_145,seq56,r_81_86_145,0.91,1,146,145,11
16,r_114_42_147,seq135,r_24_148_91,r_24_148_91,0.93,56,147,91,11
21,r_15_137_146,seq56,seq6,r_15_137_146,0.53,0,146,146,11
5,r_89_70_170,r_144_141_99,r_60_123_49,r_89_70_170,0.82,-71,99,170,11
42,r_98_65_55,r_132_75_96,seq22,r_98_65_55,1,0,55,55,11
11,r_31_67_11,r_9_121_118,seq146,r_31_67_11,1,0,11,11,11
56,seq12,seq36,r_55_13_36,r_55_13_36,1,11,47,36,11
7,r_93_87_156,seq6,r_58_100_88,r_93_87_156,0.87,0,156,156,11
69,seq36,seq12,r_39_112_93,r_39_112_93,1,24,117,93,11
24,r_81_86_145,seq11,r_129_5_39,r_81_86_145,0.96,0,145,145,11
19,r_54_40_167,r_38_59_22,r_125_102_140,r_54_40_167,0.89,0,167,167,11
43,r_78_130_58,r_71_83_175,r_140_68_48,r_78_130_58,1,0,58,58,11
45,r_38_59_22,r_63_35_81,seq138,r_38_59_22,1,1,23,22,11
95,seq113,r_21_34_149,r_58_100_88,r_58_100_88,0.41,44,132,88,11
80,seq138,seq117,r_38_59_22,r_38_59_22,1,1,23,22,11
76,seq50,r_122_41_95,r_127_1_127,r_122_41_95,0.54,-34,61,95,11
49,r_64_116_126,r_127_1_127,r_31_67_11,r_64_116_126,0.99,0,126,126,11
41,r_147_74_161,seq12,r_129_5_39,r_129_5_39,0.48,122,161,39,11
3,r_125_102_140,seq126,r_54_40_167,r_54_40_167,0.98,1,168,167,11
26,r_25_131_109,seq73,seq110,r_25_131_109,0.99,0,109,109,11
8,r_77_48_180,r_24_148_91,r_25_131_109,r_77_48_180,0.95,0,180,180,11
35,r_66_91_19,seq135,seq49,r_66_91_19,1,0,19,19,11
14,r_118_26_168,r_28_105_18,r_55_13_36,r_118_26_168,0.73,0,168,168,11
4,r_88_106_41,seq32,r_77_48_180,r_88_106_41,0.6,38,79,41,11
78,seq53,seq109,r_129_5_39,r_129_5_39,1,65,104,39,11
13,r_127_1_127,seq29,seq30,r_127_1_127,0.34,-5,122,127,11
15,r_95_8_115,seq33,seq29,r_95_8_115,0.98,2,117,115,11
2,r_3_27_26,seq17,seq135,r_3_27_26,0.94,0,26,26,11
14,r_118_26_168,r_3_27_26,r_28_105_18,r_118_26_168,0.89,-149,19,168,11
96,seq117,seq138,r_140_68_48,r_140_68_48,1,2,50,48,11
5,r_89_70_170,r_60_123_49,seq113,r_89_70_170,0.45,0,170,170,11
36,r_24_148_91,r_77_48_180,r_114_42_147,r_24_148_91,0.86,89,180,91,11
9,r_9_121_118,r_31_67_11,r_95_8_115,r_9_121_118,0.85,-105,13,118,11
10,r_28_105_18,r_118_26_168,seq92,r_118_26_168,0.88,-11,157,168,11
47,r_55_13_36,r_84_99_105,seq12,r_55_13_36,1,0,36,36,11
39,r_71_83_175,r_58_100_88,seq6,r_71_83_175,0.89,1,176,175,11
95,seq113,r_58_100_88,r_89_70_170,r_89_70_170,0.49,2,172,170,11
40,r_122_41_95,r_84_99_105,r_46_2_82,r_122_41_95,0.51,1,96,95,11
18,r_63_35_81,r_23_139_128,r_66_91_19,r_63_35_81,0.85,0,81,81,11
4,r_88_106_41,seq47,seq32,r_88_106_41,0.95,2,43,41,11
24,r_81_86_145,r_46_2_82,seq11,r_46_2_82,1,-7,75,82,11
34,r_62_52_157,r_133_136_65,r_93_87_156,r_62_52_157,0.85,1,158,157,11
25,r_43_72_135,seq101,seq134,r_43_72_135,0.88,0,135,135,11
33,r_46_2_82,r_81_86_145,seq14,r_46_2_82,1,0,82,82,11
30,r_115_119_45,r_24_148_91,seq126,r_24_148_91,1,-42,49,91,11
64,seq22,r_24_148_91,r_97_37_195,r_24_148_91,1,0,91,91,11
6,r_129_5_39,r_94_76_184,r_39_112_93,r_129_5_39,0.96,0,39,39,11
31,r_60_123_49,r_39_112_93,r_89_70_170,r_60_123_49,0.61,-3,46,49,11
65,seq29,r_132_75_96,r_127_1_127,r_132_75_96,0.98,-10,86,96,11
65,seq29,r_127_1_127,r_95_8_115,r_95_8_115,0.96,18,133,115,11
68,seq33,r_95_8_115,seq19,r_95_8_115,1,1,116,115,11
1,r_108_142_24,seq126,seq0,r_108_142_24,1,0,24,24,11
32,r_79_44_101,seq107,r_55_13_36,r_79_44_101,0.58,0,101,101,11
20,r_39_112_93,r_129_5_39,seq36,r_39_112_93,1,0,93,93,11
38,r_132_75_96,r_64_116_126,r_66_91_19,r_132_75_96,0.87,0,96,96,11
52,seq6,r_94_76_184,r_71_83_175,r_71_83_175,0.53,8,183,175,11
34,r_62_52_157,seq110,r_133_136_65,r_133_136_65,1,10,75,65,11
50,seq0,r_20_4_160,r_108_142_24,r_108_142_24,0.92,7,31,24,11
64,seq22,r_97_37_195,r_98_65_55,r_98_65_55,0.41,117,172,55,11
72,seq135,r_66_91_19,r_114_42_147,r_66_91_19,0.79,0,19,19,11
19,r_54_40_167,r_62_52_157,r_38_59_22,r_54_40_167,0.67,-124,43,167,11
18,r_63_35_81,r_66_91_19,r_84_99_105,r_84_99_105,1,0,105,105,11
31,r_60_123_49,r_89_70_170,r_63_35_81,r_89_70_170,0.56,1,171,170,11
6,r_129_5_39,r_39_112_93,seq134,r_39_112_93,1,0,93,93,11
38,r_132_75_96,r_66_91_19,r_9_121_118,r_9_121_118,0.93,1,119,118,11
28,r_23_139_128,r_63_35_81,r_31_67_11,r_23_139_128,0.99,-48,80,128,11
4,r_88_106_41,r_77_48_180,r_3_27_26,r_88_106_41,0.52,93,134,41,11
10,r_28_105_18,seq32,r_118_26_168,r_28_105_18,0.54,1,19,18,11
49,r_64_116_126,r_132_75_96,r_127_1_127,r_132_75_96,0.97,-2,94,96,11
72,seq135,r_114_42_147,r_3_27_26,r_114_42_147,0.73,-1,146,147,11
0,r_140_68_48,seq85,seq117,r_140_68_48,1,0,48,48,11
19,r_54_40_167,seq138,r_62_52_157,r_54_40_167,0.64,-137,30,167,11
44,r_21_34_149,r_58_100_88,r_98_65_55,r_21_34_149,0.58,2,151,149,11
23,r_133_136_65,seq12,seq146,r_133_136_65,1,0,65,65,11
94,seq110,seq146,r_25_131_109,r_25_131_109,1,10,119,109,11
81,seq69,r_57_61_30,seq17,r_57_61_30,1,0,30,30,11
82,seq73,r_25_131_109,seq143,r_25_131_109,1,0,109,109,11
27,r_94_76_184,r_129_5_39,seq6,r_129_5_39,1,0,39,39,11
79,seq56,r_15_137_146,seq85,r_15_137_146,0.83,0,146,146,11
12,r_144_141_99,r_89_70_170,seq143,r_144_141_99,0.97,0,99,99,11
7,r_93_87_156,r_94_76_184,seq6,r_93_87_156,0.48,-110,46,156,11
93,seq98,r_125_138_187,r_57_10_26,r_57_10_26,1,161,187,26,12
30,r_20_110_188,r_1_67_123,r_79_36_72,r_20_110_188,0.47,-105,83,188,12
51,seq129,r_33_106_129,seq55,r_33_106_129,0.64,-56,73,129,12
92,seq96,seq66,r_2_76_134,r_2_76_134,0.82,1,135,134,12
14,r_125_138_187,seq98,r_105_83_98,r_105_83_98,0.86,89,187,98,12
43,r_121_73_141,r_2_76_134,seq133,r_2_76_134,0.63,-49,85,134,12
54,seq133,r_61_145_28,r_42_32_151,r_61_145_28,0.59,125,153,28,12
71,seq45,seq43,r_17_124_48,r_17_124_48,1,26,74,48,12
16,r_42_32_151,seq80,r_94_120_3,r_42_32_151,0.42,-11,140,151,12
21,r_95_118_71,seq22,seq40,r_95_118_71,1,0,71,71,12
39,r_92_37_78,seq129,seq66,r_92_37_78,1,0,78,78,12
1,r_58_148_127,r_104_27_180,r_3_63_10,r_58_148_127,0.77,0,127,127,12
24,r_14_100_159,seq133,r_61_145_28,r_14_100_159,0.67,-131,28,159,12
25,r_135_12_15,r_33_106_129,seq0,r_135_12_15,0.99,0,15,15,12
32,r_79_36_72,r_20_110_188,r_14_100_159,r_14_100_159,0.73,30,189,159,12
2,r_3_63_10,seq41,r_89_53_164,r_3_63_10,0.9,0,10,10,12
45,r_93_35_107,r_75_72_165,seq44,r_93_35_107,1,0,107,107,12
42,r_89_53_164,seq99,r_3_63_10,r_3_63_10,0.71,18,28,10,12
24,r_14_100_159,r_61_145_28,r_79_36_72,r_14_100_159,0.92,0,159,159,12
95,seq103,r_104_27_180,r_142_119_178,r_104_27_180,0.7,0,180,180,12
66,seq34,seq51,r_39_65_124,r_39_65_124,1,1,125,124,12
31,r_137_117_189,seq140,r_5_24_119,r_137_117_189,0.39,0,189,189,12
37,r_146_122_47,seq41,r_94_120_3,r_146_122_47,0.99,1,48,47,12
3,r_104_27_180,seq0,r_61_145_28,r_104_27_180,0.53,0,180,180,12
10,r_88_85_176,seq99,r_54_132_2,r_88_85_176,0.45,0,176,176,12
18,r_142_119_178,r_137_117_189,seq103,r_142_119_178,0.98,0,178,178,12
36,r_15_101_29,seq41,r_105_83_98,r_15_101_29,0.88,0,29,29,12
26,r_33_106_129,seq129,seq126,r_33_106_129,1,-1,128,129,12
8,r_61_145_28,r_14_100_159,r_13_102_113,r_61_145_28,0.96,128,156,28,12
0,r_6_116_68,r_33_106_129,r_71_84_34,r_6_116_68,1,0,68,68,12
11,r_13_102_113,seq44,r_61_145_28,r_13_102_113,0.99,0,113,113,12
15,r_8_115_97,seq45,seq59,r_8_115_97,0.74,7,104,97,12
48,r_54_132_2,r_9_81_99,r_88_85_176,r_54_132_2,0.63,174,176,2,12
46,r_136_139_45,r_93_35_107,seq141,r_136_139_45,0.96,0,45,45,12
47,r_17_124_48,seq99,seq45,r_17_124_48,1,0,48,48,12
85,seq74,r_113_130_130,r_123_128_105,r_113_130_130,0.82,0,130,130,12
2,r_3_63_10,r_89_53_164,r_58_148_127,r_58_148_127,0.98,7,134,127,12
6,r_57_10_26,r_104_27_180,seq98,r_57_10_26,1,2,28,26,12
36,r_15_101_29,r_105_83_98,seq127,r_105_83_98,0.97,0,98,98,12
27,r_113_130_130,seq74,seq41,r_113_130_130,0.98,1,131,130,12
41,r_71_84_34,r_6_116_68,r_1_67_123,r_1_67_123,1,2,125,123,12
30,r_20_110_188,r_79_36_72,seq30,r_20_110_188,0.55,1,189,188,12
51,seq129,seq55,r_105_83_98,r_105_83_98,0.95,49,147,98,12
20,r_25_109_46,r_31_144_32,seq4,r_25_109_46,1,0,46,46,12
40,r_9_81_99,r_54_132_2,r_25_109_46,r_9_81_99,0.71,1,100,99,12
18,r_142_119_178,seq30,r_137_117_189,r_142_119_178,0.22,-37,141,178,12
43,r_121_73_141,seq133,seq87,r_121_73_141,1,1,142,141,12
8,r_61_145_28,r_90_70_101,r_14_100_159,r_61_145_28,1,1,29,28,12
33,r_82_21_158,r_123_128_105,r_60_7_13,r_123_128_105,0.88,0,105,105,12
88,seq80,r_42_32_151,seq99,r_42_32_151,0.94,-3,148,151,12
28,r_31_144_32,r_25_109_46,r_113_130_130,r_25_109_46,0.99,0,46,46,12
22,r_18_149_160,seq11,seq66,r_18_149_160,0.89,0,160,160,12
65,seq30,r_142_119_178,seq140,r_142_119_178,0.66,-29,149,178,12
17,r_105_83_98,seq68,r_15_101_29,r_15_101_29,0.54,1,30,29,12
42,r_89_53_164,r_3_63_10,r_121_73_141,r_89_53_164,0.84,-1,163,164,12
61,seq22,r_95_118_71,seq77,r_95_118_71,0.99,0,71,71,12
32,r_79_36_72,seq80,r_20_110_188,r_20_110_188,0.92,-116,72,188,12
38,r_90_70_101,seq77,seq47,r_90_70_101,0.87,1,102,101,12
34,r_1_67_123,r_18_149_160,r_71_84_34,r_1_67_123,0.86,0,123,123,12
81,seq59,seq28,r_8_115_97,r_8_115_97,0.75,1,98,97,12
94,seq99,r_88_85_176,r_58_148_127,r_58_148_127,0.84,34,161,127,12
16,r_42_32_151,r_94_120_3,r_92_37_78,r_42_32_151,0.6,0,151,151,12
28,r_31_144_32,r_113_130_130,seq74,r_113_130_130,1,0,130,130,12
22,r_18_149_160,r_112_38_143,seq11,r_112_38_143,0.62,0,143,143,12
41,r_71_84_34,seq127,r_6_116_68,r_71_84_34,0.77,34,68,34,12
49,r_112_38_143,r_18_149_160,r_113_130_130,r_18_149_160,0.59,-17,143,160,12
56,seq11,r_39_65_124,seq78,r_39_65_124,1,-1,123,124,12
7,r_75_72_165,seq131,seq66,r_75_72_165,0.72,0,165,165,12
44,r_2_76_134,r_121_73_141,seq96,r_2_76_134,0.87,0,134,134,12
23,r_39_65_124,seq11,seq34,r_39_65_124,0.99,0,124,124,12
41,r_71_84_34,seq56,seq127,r_71_84_34,0.54,20,54,34,12
68,seq41,r_3_63_10,r_146_122_47,r_3_63_10,0.61,1,11,10,12
17,r_105_83_98,r_15_101_29,seq129,r_105_83_98,0.99,0,98,98,12
82,seq66,seq96,r_92_37_78,r_92_37_78,1,11,89,78,12
35,r_123_128_105,r_82_21_158,seq74,r_123_128_105,0.64,1,106,105,12
12,r_5_24_119,seq49,r_71_84_34,r_5_24_119,0.99,0,119,119,12
27,r_111_78_116,r_50_48_67,seq4,r_111_78_116,0.99,0,116,116,13
51,seq4,seq34,r_111_78_116,r_111_78_116,1,6,122,116,13
9,r_126_133_180,seq86,r_112_84_43,r_126_133_180,0.98,0,180,180,13
54,seq7,r_130_97_50,r_9_117_168,r_130_97_50,1,0,50,50,13
14,r_12_106_178,seq116,seq7,r_12_106_178,0.57,1,179,178,13
43,r_71_20_63,r_121_8_69,r_105_134_182,r_71_20_63,1,0,63,63,13
8,r_16_113_30,r_13_79_132,r_60_23_94,r_16_113_30,0.84,1,31,30,13
37,r_58_18_164,seq118,r_33_127_27,r_58_18_164,0.49,0,164,164,13
54,seq7,r_9_117_168,r_13_79_132,r_13_79_132,0.82,36,168,132,13
10,r_83_47_167,seq27,r_128_73_17,r_128_73_17,0.9,35,52,17,13
5,r_95_24_22,seq68,r_30_11_6,r_95_24_22,1,0,22,22,13
21,r_139_35_102,seq49,r_52_122_25,r_139_35_102,1,0,102,102,13
97,seq116,r_12_106_178,seq108,r_12_106_178,0.98,-7,171,178,13
46,r_75_123_100,seq43,r_46_136_21,r_75_123_100,0.78,3,103,100,13
42,r_65_144_134,seq114,seq57,r_65_144_134,0.78,1,135,134,13
45,r_91_1_88,r_12_106_178,seq49,r_12_106_178,0.65,-89,89,178,13
11,r_101_3_187,r_16_113_30,r_92_37_172,r_92_37_172,0.5,0,172,172,13
67,seq42,seq61,r_121_8_69,r_121_8_69,1,14,83,69,13
76,seq64,r_60_23_94,r_101_3_187,r_60_23_94,0.75,1,95,94,13
28,r_69_28_59,r_139_35_102,r_32_135_64,r_69_28_59,1,-1,58,59,13
34,r_52_122_25,seq89,seq5,r_52_122_25,0.81,1,26,25,13
30,r_33_127_27,seq34,r_99_22_3,r_33_127_27,0.92,0,27,27,13
20,r_98_147_20,seq27,seq15,r_98_147_20,0.99,1,21,20,13
76,seq64,r_125_103_81,r_60_23_94,r_125_103_81,0.62,0,81,81,13
31,r_149_66_137,r_9_117_168,seq131,r_149_66_137,0.76,0,137,137,13
41,r_140_62_158,seq115,seq19,r_140_62_158,0.83,0,158,158,13
38,r_31_56_26,seq76,seq68,r_31_56_26,1,0,26,26,13
22,r_129_120_29,seq7,seq81,r_129_120_29,0.86,5,34,29,13
59,seq17,seq27,r_128_73_17,r_128_73_17,0.73,31,48,17,13
26,r_125_103_81,seq64,seq76,r_125_103_81,1,0,81,81,13
3,r_96_41_18,r_9_117_168,seq6,r_96_41_18,1,0,18,18,13
78,seq68,seq146,r_31_56_26,r_31_56_26,1,95,121,26,13
13,r_13_79_132,seq59,seq7,r_13_79_132,0.74,1,133,132,13
98,seq118,r_58_18_164,r_50_48_67,r_50_48_67,1,97,164,67,13
12,r_105_134_182,r_71_20_63,r_95_24_22,r_105_134_182,0.89,1,183,182,13
15,r_94_102_48,r_21_44_143,r_30_11_6,r_94_102_48,0.66,48,96,48,13
48,r_121_8_69,seq148,seq42,r_121_8_69,1,1,70,69,13
6,r_9_117_168,seq7,r_93_14_58,r_93_14_58,1,110,168,58,13
85,seq86,r_126_133_180,seq145,r_126_133_180,0.72,0,180,180,13
99,seq124,r_132_40_74,seq49,r_132_40_74,1,-1,73,74,13
45,r_91_1_88,seq87,r_93_14_58,r_93_14_58,0.73,118,176,58,13
10,r_83_47_167,r_128_73_17,seq6,r_83_47_167,0.94,0,167,167,13
27,r_111_78_116,r_58_18_164,r_50_48_67,r_50_48_67,1,1,68,67,13
19,r_51_26_42,seq6,seq108,r_51_26_42,1,0,42,42,13
18,r_128_73_17,seq76,seq27,r_128_73_17,0.93,0,17,17,13
0,r_93_14_58,r_99_22_3,seq138,r_93_14_58,0.96,0,58,58,13
2,r_32_135_64,seq63,r_69_28_59,r_32_135_64,1,0,64,64,13
47,r_25_55_82,seq87,r_132_40_74,r_25_55_82,0.96,0,82,82,13
96,seq115,r_140_62_158,seq88,r_140_62_158,0.76,-111,47,158,13
29,r_50_48_67,r_99_22_3,seq118,r_50_48_67,0.97,0,67,67,13
24,r_46_136_21,r_99_22_3,r_109_141_150,r_109_141_150,0.86,3,153,150,13
34,r_52_122_25,seq5,r_139_35_102,r_139_35_102,1,1,103,102,13
25,r_132_40_74,seq124,seq148,r_132_40_74,0.99,0,74,74,13
43,r_71_20_63,r_105_134_182,seq110,r_105_134_182,0.98,1,183,182,13
33,r_92_37_172,seq146,r_16_113_30,r_16_113_30,0.54,142,172,30,13
36,r_130_97_50,seq7,seq6,r_130_97_50,1,0,50,50,13
17,r_99_22_3,r_50_48_67,r_33_127_27,r_99_22_3,0.99,27,30,3,13
32,r_60_23_94,seq64,seq59,r_60_23_94,1,1,95,94,13
0,r_93_14_58,r_46_136_21,r_99_22_3,r_93_14_58,0.53,-19,39,58,13
52,seq5,r_70_119_147,r_139_35_102,r_139_35_102,0.96,45,147,102,13
8,r_16_113_30,r_101_3_187,r_140_62_158,r_140_62_158,0.75,19,177,158,13
7,r_112_84_43,r_126_133_180,seq142,r_112_84_43,1,0,43,43,13
75,seq63,r_32_135_64,r_52_122_25,r_32_135_64,0.77,0,64,64,13
8,r_16_113_30,r_60_23_94,r_101_3_187,r_60_23_94,0.55,-24,70,94,13
60,seq146,r_92_37_172,r_31_56_26,r_31_56_26,0.79,146,172,26,13
45,r_91_1_88,seq49,seq87,r_91_1_88,0.55,62,150,88,13
76,seq64,r_101_3_187,r_70_119_147,r_70_119_147,0.81,4,151,147,13
94,seq110,r_105_134_182,r_71_20_63,r_71_20_63,1,120,183,63,13
9,r_126_133_180,r_82_29_111,seq86,r_82_29_111,1,1,112,111,13
91,seq104,seq148,r_132_40_74,r_132_40_74,1,31,105,74,13
56,seq138,seq49,r_93_14_58,r_93_14_58,1,3,61,58,13
44,r_21_44_143,r_94_102_48,seq38,r_21_44_143,0.95,0,143,143,13
11,r_101_3_187,r_92_37_172,seq107,r_92_37_172,0.57,14,186,172,13
23,r_36_90_109,seq43,seq89,r_36_90_109,0.94,0,109,109,13
82,seq80,seq5,r_52_122_25,r_52_122_25,0.99,104,129,25,13
35,r_82_29_111,r_126_133_180,seq43,r_82_29_111,0.95,0,111,111,13
12,r_105_134_182,seq110,r_71_20_63,r_71_20_63,1,79,142,63,13
93,seq104,r_56_31_171,seq92,r_56_31_171,0.45,-3,168,171,14
30,r_42_22_138,seq140,seq44,r_42_22_138,1,0,138,138,14
44,r_132_81_15,r_42_22_138,r_131_45_131,r_132_81_15,0.98,115,130,15,14
51,seq130,r_51_147_195,r_95_84_112,r_95_84_112,1,41,153,112,14
36,r_90_74_71,r_58_43_151,seq78,r_90_74_71,1,0,71,71,14
8,r_75_10_136,seq149,seq97,r_75_10_136,0.72,0,136,136,14
53,seq134,seq120,r_8_16_80,r_8_16_80,1,62,142,80,14
0,r_3_28_26,seq126,r_139_88_97,r_3_28_26,1,1,27,26,14
37,r_105_21_72,r_75_10_136,r_50_87_191,r_105_21_72,0.9,-1,71,72,14
3,r_114_86_187,r_141_54_100,r_11_26_183,r_114_86_187,0.77,0,187,187,14
71,seq142,seq92,r_118_59_68,r_118_59_68,1,0,68,68,14
16,r_53_108_73,seq126,r_131_45_131,r_53_108_73,0.98,0,73,73,14
39,r_64_15_166,seq97,r_95_84_112,r_64_15_166,0.78,0,166,166,14
1,r_73_38_173,r_46_19_185,r_27_122_4,r_27_122_4,0.78,171,175,4,14
97,seq120,seq134,r_70_0_158,r_70_0_158,0.69,0,158,158,14
5,r_68_146_155,r_94_65_192,r_36_123_94,r_36_123_94,0.98,3,97,94,14
46,r_95_84_112,seq20,r_127_35_160,r_95_84_112,0.92,0,112,112,14
42,r_58_43_151,r_90_74_71,seq83,r_58_43_151,0.85,-80,71,151,14
7,r_131_45_131,r_53_108_73,r_132_81_15,r_131_45_131,1,0,131,131,14
69,seq41,r_131_45_131,seq149,r_131_45_131,0.98,-4,127,131,14
5,r_68_146_155,r_36_123_94,r_95_84_112,r_68_146_155,1,0,155,155,14
44,r_132_81_15,seq14,r_42_22_138,r_132_81_15,1,0,15,15,14
45,r_37_136_32,seq92,seq120,r_37_136_32,0.99,0,32,32,14
46,r_95_84_112,r_127_35_160,seq130,r_127_35_160,0.98,0,160,160,14
31,r_48_82_83,seq134,seq109,r_48_82_83,0.87,0,83,83,14
41,r_2_61_111,seq18,seq93,r_2_61_111,0.82,6,117,111,14
3,r_114_86_187,r_143_12_77,seq133,r_143_12_77,0.86,0,77,77,14
16,r_53_108_73,r_131_45_131,r_95_84_112,r_53_108_73,0.99,58,131,73,14
78,seq71,r_117_99_197,r_106_25_96,r_106_25_96,1,0,96,96,14
63,seq149,r_75_10_136,seq130,r_75_10_136,1,2,138,136,14
11,r_127_35_160,r_75_10_136,r_95_84_112,r_127_35_160,0.88,-50,110,160,14
20,r_7_116_133,r_117_99_197,r_55_67_189,r_7_116_133,0.55,0,133,133,14
17,r_6_101_146,seq126,r_106_25_96,r_6_101_146,0.97,3,149,146,14
49,r_36_123_94,r_68_146_155,r_94_65_192,r_68_146_155,0.99,2,157,155,14
57,seq13,r_56_31_171,r_77_135_14,r_77_135_14,0.56,157,171,14,14
3,r_114_86_187,seq133,r_141_54_100,r_141_54_100,0.78,4,104,100,14
16,r_53_108_73,r_95_84_112,r_11_26_183,r_11_26_183,0.55,4,187,183,14
62,seq20,r_95_84_112,seq89,r_95_84_112,0.94,0,112,112,14
99,seq126,r_53_108_73,seq66,r_53_108_73,0.72,0,73,73,14
36,r_90_74_71,seq78,r_46_19_185,r_90_74_71,0.55,78,149,71,14
25,r_46_19_185,r_139_88_97,seq18,r_46_19_185,0.96,0,185,185,14
27,r_8_16_80,r_46_19_185,seq134,r_8_16_80,1,0,80,80,14
64,seq23,r_29_47_109,r_119_121_6,r_29_47_109,0.75,-14,95,109,14
2,r_11_26_183,seq144,r_53_108_73,r_11_26_183,0.24,0,183,183,14
47,r_106_25_96,r_94_65_192,seq71,r_106_25_96,0.87,0,96,96,14
65,seq30,seq18,r_76_137_56,r_76_137_56,0.7,-3,53,56,14
18,r_141_54_100,r_95_84_112,r_114_86_187,r_141_54_100,0.94,0,100,100,14
29,r_94_65_192,r_34_98_119,r_119_121_6,r_34_98_119,0.64,0,119,119,14
24,r_4_9_104,seq109,seq97,r_4_9_104,0.85,0,104,104,14
25,r_46_19_185,r_73_38_173,r_139_88_97,r_73_38_173,0.75,-40,133,173,14
33,r_118_59_68,seq134,seq142,r_118_59_68,1,0,68,68,14
88,seq93,seq5,r_2_61_111,r_2_61_111,1,-4,107,111,14
70,seq44,seq39,r_42_22_138,r_42_22_138,1,2,140,138,14
10,r_128_111_44,seq145,seq103,r_128_111_44,0.74,0,44,44,14
32,r_33_32_176,seq125,seq5,r_33_32_176,0.5,0,176,176,14
38,r_143_12_77,r_114_86_187,seq97,r_143_12_77,0.87,0,77,77,14
52,seq5,seq93,r_33_32_176,r_33_32_176,0.95,10,186,176,14
36,r_90_74_71,r_46_19_185,r_129_124_70,r_129_124_70,0.37,102,172,70,14
34,r_34_98_119,r_94_65_192,r_48_82_83,r_34_98_119,0.69,0,119,119,14
40,r_77_135_14,seq5,seq13,r_77_135_14,1,0,14,14,14
75,seq62,seq78,r_113_102_45,r_113_102_45,1,75,120,45,14
11,r_127_35_160,r_95_84_112,seq145,r_127_35_160,1,0,160,160,14
13,r_113_102_45,r_4_9_104,seq78,r_113_102_45,0.98,1,46,45,14
9,r_29_47_109,seq85,seq1,r_29_47_109,0.92,0,109,109,14
22,r_63_107_67,seq1,seq125,r_63_107_67,1,1,68,67,14
28,r_115_60_61,r_56_31_171,seq130,r_115_60_61,1,0,61,61,14
84,seq85,r_119_121_6,r_36_123_94,r_119_121_6,0.42,175,181,6,14
49,r_36_123_94,r_33_32_176,r_68_146_155,r_36_123_94,0.97,0,94,94,14
7,r_131_45_131,r_127_35_160,r_53_108_73,r_131_45_131,0.79,-60,71,131,14
18,r_141_54_100,r_114_86_187,r_127_35_160,r_141_54_100,0.56,87,187,100,14
23,r_129_124_70,seq149,seq49,r_129_124_70,1,0,70,70,14
43,r_139_88_97,r_46_19_185,r_3_28_26,r_3_28_26,0.71,29,55,26,14
35,r_70_0_158,seq18,seq120,r_70_0_158,0.82,0,158,158,14
30,r_50_15_75,r_113_132_125,seq0,r_50_15_75,0.99,0,75,75,15
14,r_139_21_150,r_75_18_90,r_47_108_73,r_139_21_150,0.91,-64,86,150,15
27,r_47_108_73,r_137_89_100,r_139_21_150,r_137_89_100,0.95,0,100,100,15
53,seq6,r_33_94_70,seq68,r_33_94_70,1,2,72,70,15
54,seq8,r_4_38_143,seq31,r_4_38_143,0.91,2,145,143,15
12,r_126_128_53,seq24,r_106_101_69,r_106_101_69,1,1,70,69,15
19,r_44_83_128,r_66_52_52,r_64_86_185,r_44_83_128,0.96,0,128,128,15
26,r_66_52_52,r_126_128_53,r_44_83_128,r_66_52_52,1,0,52,52,15
16,r_3_121_95,r_59_118_63,seq49,r_3_121_95,0.86,0,95,95,15
25,r_114_74_16,seq12,seq14,r_114_74_16,0.97,0,16,16,15
5,r_40_69_108,seq109,r_126_128_53,r_40_69_108,1,0,108,108,15
42,r_116_87_139,seq30,r_41_99_74,r_116_87_139,0.65,0,139,139,15
34,r_113_132_125,r_47_108_73,seq68,r_113_132_125,1,0,125,125,15
26,r_66_52_52,seq77,r_4_38_143,r_66_52_52,0.91,93,145,52,15
66,seq26,seq76,r_22_96_38,r_22_96_38,0.53,39,77,38,15
76,seq57,r_133_36_116,seq77,r_133_36_116,0.64,1,117,116,15
41,r_138_35_141,seq37,r_82_136_27,r_138_35_141,0.9,0,141,141,15
89,seq91,r_29_127_144,r_120_142_197,r_29_127_144,0.76,-5,139,144,15
10,r_88_65_76,seq51,r_79_129_164,r_88_65_76,1,0,76,76,15
14,r_139_21_150,r_47_108_73,r_104_17_181,r_139_21_150,0.62,0,150,150,15
4,r_55_53_177,seq78,seq37,r_55_53_177,0.57,0,177,177,15
63,seq20,r_47_108_73,seq61,r_47_108_73,1,0,73,73,15
73,seq51,r_88_65_76,r_135_103_1,r_88_65_76,0.99,-1,75,76,15
11,r_135_103_1,seq51,r_123_34_147,r_123_34_147,0.59,8,155,147,15
20,r_144_28_78,seq97,seq37,r_144_28_78,1,-1,77,78,15
13,r_133_36_116,seq57,seq49,r_133_36_116,1,0,116,116,15
15,r_137_89_100,r_139_21_150,r_47_108_73,r_47_108_73,0.98,1,74,73,15
48,r_104_17_181,r_55_53_177,r_139_21_150,r_139_21_150,0.52,2,152,150,15
46,r_82_136_27,r_102_71_39,r_138_35_141,r_138_35_141,0.6,2,143,141,15
6,r_7_42_112,seq109,seq37,r_7_42_112,1,0,112,112,15
68,seq31,r_126_128_53,r_4_38_143,r_126_128_53,0.98,0,53,53,15
99,seq124,r_43_23_94,seq77,r_43_23_94,1,-5,89,94,15
19,r_44_83_128,r_107_62_17,r_66_52_52,r_66_52_52,0.62,2,54,52,15
43,r_123_34_147,r_67_90_102,seq131,r_123_34_147,0.73,-105,42,147,15
45,r_140_100_50,r_126_128_53,seq30,r_140_100_50,0.93,0,50,50,15
36,r_43_23_94,seq124,seq61,r_43_23_94,0.99,0,94,94,15
10,r_88_65_76,r_79_129_164,seq0,r_79_129_164,1,-10,154,164,15
31,r_125_117_20,seq39,seq54,r_125_117_20,0.95,0,20,20,15
27,r_47_108_73,seq20,r_137_89_100,r_47_108_73,0.98,-1,72,73,15
39,r_22_96_38,seq134,seq26,r_22_96_38,0.85,0,38,38,15
36,r_43_23_94,r_107_62_17,seq124,r_107_62_17,0.99,10,27,17,15
22,r_79_129_164,r_88_65_76,seq146,r_79_129_164,0.93,2,166,164,15
2,r_85_5_120,seq56,r_3_121_95,r_85_5_120,0.68,0,120,120,15
40,r_75_18_90,r_139_21_150,seq145,r_75_18_90,1,0,90,90,15
18,r_106_101_69,r_64_86_185,r_126_128_53,r_106_101_69,1,0,69,69,15
29,r_147_95_142,seq148,r_41_99_74,r_147_95_142,0.83,0,142,142,15
24,r_41_99_74,r_137_89_100,seq13,r_41_99_74,1,0,74,74,15
47,r_11_9_33,r_59_118_63,r_112_48_184,r_112_48_184,0.95,4,188,184,15
16,r_3_121_95,seq49,r_85_5_120,r_85_5_120,0.5,7,127,120,15
43,r_123_34_147,seq131,r_135_103_1,r_123_34_147,1,0,147,147,15
33,r_67_90_102,r_123_34_147,r_126_128_53,r_67_90_102,0.91,0,102,102,15
50,seq0,r_110_111_174,r_88_65_76,r_88_65_76,1,98,174,76,15
70,seq37,r_138_35_141,r_144_28_78,r_144_28_78,0.86,63,141,78,15
48,r_104_17_181,r_139_21_150,seq31,r_104_17_181,0.99,0,181,181,15
61,seq145,seq51,r_75_18_90,r_75_18_90,0.97,10,100,90,15
32,r_46_81_83,r_123_34_147,seq56,r_46_81_83,0.98,0,83,83,15
77,seq58,r_1_27_193,r_107_62_17,r_107_62_17,0.78,71,88,17,15
28,r_64_86_185,r_44_83_128,r_47_108_73,r_64_86_185,0.91,0,185,185,15
34,r_113_132_125,r_50_15_75,r_47_108_73,r_113_132_125,0.95,-50,75,125,15
47,r_11_9_33,r_66_52_52,seq30,r_11_9_33,0.98,-1,32,33,15
27,r_47_108_73,r_139_21_150,r_126_128_53,r_139_21_150,1,-11,139,150,15
12,r_126_128_53,seq31,seq24,r_126_128_53,0.95,0,53,53,15
46,r_82_136_27,seq77,r_102_71_39,r_102_71_39,0.97,0,39,39,15
1,r_107_62_17,r_43_23_94,r_1_27_193,r_107_62_17,1,-3,14,17,15
9,r_59_118_63,r_3_121_95,r_11_9_33,r_59_118_63,0.6,33,96,63,15
26,r_66_52_52,r_44_83_128,seq77,r_66_52_52,0.65,76,128,52,15
22,r_79_129_164,r_110_111_174,r_88_65_76,r_88_65_76,1,4,80,76,15
28,r_64_86_185,r_106_101_69,r_44_83_128,r_64_86_185,0.96,-57,128,185,15
73,seq51,r_135_103_1,r_29_127_144,r_29_127_144,1,13,157,144,15
49,r_60_149_136,seq54,seq16,r_60_149_136,0.71,3,139,136,15
58,seq14,r_40_69_108,r_114_74_16,r_114_74_16,0.53,1,17,16,15
15,r_137_89_100,r_47_108_73,r_144_28_78,r_137_89_100,0.96,3,103,100,15
14,r_139_21_150,r_104_17_181,seq78,r_104_17_181,0.67,2,183,181,15
44,r_1_27_193,seq58,r_107_62_17,r_107_62_17,0.67,129,146,17,15
35,r_33_94_70,seq6,seq130,r_33_94_70,1,2,72,70,15
46,r_82_136_27,seq49,seq77,r_82_136_27,0.8,0,27,27,15
93,seq111,seq88,r_3_84_143,r_3_84_143,0.92,10,153,143,16
40,r_110_53_72,r_137_13_183,r_16_34_82,r_110_53_72,0.37,110,182,72,16
37,r_113_50_56,r_68_25_61,seq100,r_113_50_56,0.89,0,56,56,16
51,seq6,r_147_132_125,r_85_108_11,r_147_132_125,1,1,126,125,16
58,seq20,r_69_139_17,r_27_76_189,r_27_76_189,0.87,-1,188,189,16
43,r_112_48_89,r_128_1_162,seq142,r_112_48_89,0.76,2,91,89,16
54,seq142,r_105_19_195,r_63_22_103,r_63_22_103,1,7,110,103,16
86,seq94,r_55_117_192,seq42,r_55_117_192,0.62,-33,159,192,16
16,r_66_143_62,seq47,r_136_129_8,r_66_143_62,1,0,62,62,16
2,r_69_139_17,seq12,r_140_90_155,r_69_139_17,0.59,11,28,17,16
1,r_46_145_52,seq37,r_93_74_111,r_46_145_52,0.8,62,114,52,16
5,r_73_14_180,r_30_89_166,seq83,r_30_89_166,0.7,1,167,166,16
46,r_26_122_197,seq24,r_97_98_149,r_26_122_197,0.49,-14,183,197,16
42,r_93_74_111,seq4,r_46_145_52,r_93_74_111,0.79,0,111,111,16
61,seq24,r_46_145_52,seq115,r_46_145_52,0.99,-20,32,52,16
32,r_134_149_171,r_49_54_54,r_128_1_162,r_128_1_162,0.51,9,171,162,16
19,r_131_109_138,seq43,seq82,r_131_109_138,0.44,5,143,138,16
39,r_120_148_28,seq95,seq100,r_120_148_28,0.99,0,28,28,16
15,r_38_44_29,r_27_76_189,r_10_123_163,r_10_123_163,0.89,17,180,163,16
38,r_49_54_54,r_128_1_162,seq57,r_49_54_54,1,0,54,54,16
13,r_68_25_61,r_127_35_27,r_10_123_163,r_68_25_61,0.82,-35,26,61,16
45,r_29_32_57,seq6,seq21,r_29_32_57,1,0,57,57,16
67,seq42,r_97_98_149,seq94,r_97_98_149,0.95,-1,148,149,16
14,r_39_114_23,r_56_70_123,seq118,r_39_114_23,1,-1,22,23,16
3,r_16_34_82,r_63_22_103,seq86,r_16_34_82,0.98,0,82,82,16
8,r_136_129_8,seq37,r_96_135_58,r_96_135_58,1,24,82,58,16
1,r_46_145_52,seq24,seq37,r_46_145_52,0.52,0,52,52,16
20,r_55_117_192,r_16_34_82,seq94,r_16_34_82,1,-30,52,82,16
4,r_85_108_11,r_147_132_125,seq6,r_147_132_125,1,1,126,125,16
57,seq17,r_128_1_162,r_131_109_138,r_128_1_162,0.39,-2,160,162,16
11,r_9_121_25,seq115,r_59_64_40,r_9_121_25,0.96,-4,21,25,16
2,r_69_139_17,r_140_90_155,seq82,r_140_90_155,0.95,-16,139,155,16
10,r_96_135_58,seq77,r_136_129_8,r_96_135_58,1,0,58,58,16
6,r_128_1_162,r_49_54_54,seq17,r_49_54_54,0.91,-24,30,54,16
27,r_105_19_195,seq142,r_63_22_103,r_63_22_103,1,0,103,103,16
24,r_99_5_53,seq102,r_59_64_40,r_99_5_53,1,3,56,53,16
56,seq144,seq6,r_45_28_51,r_45_28_51,1,2,53,51,16
96,seq118,seq15,r_39_114_23,r_39_114_23,0.85,-5,18,23,16
47,r_27_76_189,seq23,r_38_44_29,r_38_44_29,0.99,67,96,29,16
30,r_45_28_51,seq40,seq144,r_45_28_51,1,0,51,51,16
40,r_110_53_72,r_134_149_171,r_137_13_183,r_110_53_72,1,1,73,72,16
36,r_71_146_184,r_73_14_180,r_62_33_9,r_62_33_9,0.58,1,10,9,16
65,seq40,r_45_28_51,seq11,r_45_28_51,1,-13,38,51,16
29,r_137_13_183,seq51,r_110_53_72,r_110_53_72,1,6,78,72,16
25,r_3_84_143,r_30_89_166,seq111,r_3_84_143,0.84,0,143,143,16
43,r_112_48_89,seq142,r_138_133_152,r_138_133_152,1,2,154,152,16
33,r_8_81_136,r_30_89_166,seq4,r_8_81_136,0.97,3,139,136,16
41,r_59_64_40,r_69_139_17,r_9_121_25,r_59_64_40,0.99,1,41,40,16
47,r_27_76_189,r_38_44_29,seq20,r_27_76_189,0.44,0,189,189,16
50,seq4,r_55_117_192,r_8_81_136,r_8_81_136,0.97,-1,135,136,16
58,seq20,r_101_7_142,r_69_139_17,r_101_7_142,0.95,0,142,142,16
6,r_128_1_162,seq17,seq80,r_128_1_162,0.57,1,163,162,16
13,r_68_25_61,r_10_123_163,r_9_121_25,r_68_25_61,0.97,0,61,61,16
41,r_59_64_40,r_9_121_25,r_99_5_53,r_99_5_53,0.78,32,85,53,16
32,r_134_149_171,r_110_53_72,r_49_54_54,r_134_149_171,0.98,-98,73,171,16
77,seq78,r_2_72_173,seq6,r_2_72_173,0.77,0,173,173,16
48,r_127_35_27,r_68_25_61,seq102,r_127_35_27,1,0,27,27,16
4,r_85_108_11,r_113_50_56,r_147_132_125,r_85_108_11,0.86,0,11,11,16
15,r_38_44_29,r_2_72_173,r_27_76_189,r_38_44_29,1,-1,28,29,16
60,seq23,r_27_76_189,r_75_18_137,r_75_18_137,0.9,3,140,137,16
17,r_10_123_163,r_130_107_170,r_38_44_29,r_10_123_163,0.83,0,163,163,16
18,r_62_33_9,seq57,r_71_146_184,r_62_33_9,0.91,2,11,9,16
9,r_75_18_137,r_55_117_192,seq23,r_75_18_137,0.69,1,138,137,16
31,r_147_132_125,r_85_108_11,r_62_33_9,r_147_132_125,0.91,0,125,125,16
11,r_9_121_25,r_59_64_40,r_68_25_61,r_68_25_61,0.99,1,62,61,16
28,r_56_70_123,seq12,seq100,r_56_70_123,1,1,124,123,16
29,r_137_13_183,r_110_53_72,r_3_84_143,r_137_13_183,0.57,0,183,183,16
22,r_63_22_103,seq100,r_105_19_195,r_63_22_103,0.95,0,103,103,16
49,r_130_107_170,r_10_123_163,seq4,r_10_123_163,0.66,0,163,163,16
7,r_140_90_155,r_69_139_17,r_136_129_8,r_140_90_155,0.88,0,155,155,16
18,r_62_33_9,r_71_146_184,r_68_25_61,r_68_25_61,0.96,123,184,61,16
44,r_124_141_177,seq91,r_120_148_28,r_120_148_28,0.67,149,177,28,16
31,r_147_132_125,r_29_32_57,r_85_108_11,r_85_108_11,0.71,1,12,11,16
23,r_101_7_142,seq20,seq125,r_101_7_142,0.99,0,142,142,16
79,seq80,r_138_133_152,r_128_1_162,r_128_1_162,0.35,-9,153,162,16
35,r_2_72_173,seq78,r_38_44_29,r_38_44_29,0.99,144,173,29,16
12,r_97_98_149,r_55_117_192,seq15,r_55_117_192,0.6,-21,171,192,16
51,seq1,r_50_21_146,r_142_55_44,r_50_21_146,0.79,-20,126,146,17
36,r_86_123_90,seq121,r_109_111_193,r_86_123_90,0.78,2,92,90,17
14,r_110_47_86,seq81,r_23_94_152,r_110_47_86,0.82,0,86,86,17
43,r_37_11_188,r_134_93_189,r_103_146_6,r_37_11_188,0.46,0,188,188,17
18,r_113_97_198,r_8_136_47,r_20_64_55,r_113_97_198,0.58,-152,46,198,17
62,seq18,r_124_56_27,seq104,r_124_56_27,0.85,-7,20,27,17
28,r_91_43_21,seq40,r_126_73_20,r_91_43_21,0.93,0,21,21,17
54,seq7,r_109_111_193,r_114_79_76,r_114_79_76,1,11,87,76,17
83,seq70,r_115_30_139,seq42,r_115_30_139,1,0,139,139,17
3,r_23_94_152,r_138_4_3,r_110_47_86,r_110_47_86,0.95,17,103,86,17
86,seq75,r_63_85_158,r_103_146_6,r_63_85_158,0.86,3,161,158,17
16,r_51_5_181,seq141,seq17,r_51_5_181,0.42,6,187,181,17
21,r_100_59_102,r_115_30_139,r_144_99_174,r_100_59_102,0.79,0,102,102,17
39,r_120_143_167,seq39,r_103_146_6,r_120_143_167,0.38,1,168,167,17
46,r_38_116_128,r_118_35_170,r_134_93_189,r_38_116_128,0.98,0,128,128,17
3,r_23_94_152,r_144_99_174,r_138_4_3,r_138_4_3,0.94,21,24,3,17
1,r_34_69_38,r_67_3_50,r_134_93_189,r_34_69_38,0.75,1,39,38,17
45,r_44_83_104,seq49,r_148_130_9,r_44_83_104,0.85,0,104,104,17
2,r_67_3_50,r_107_52_132,r_34_69_38,r_107_52_132,0.9,-82,50,132,17
19,r_19_31_163,seq26,r_50_21_146,r_19_31_163,0.64,0,163,163,17
34,r_14_2_180,r_65_84_135,r_91_43_21,r_14_2_180,0.86,-126,54,180,17
8,r_66_74_14,r_8_136_47,r_50_21_146,r_66_74_14,1,0,14,14,17
44,r_102_57_28,r_61_13_45,seq12,r_102_57_28,0.64,15,43,28,17
48,r_20_64_55,seq48,r_113_97_198,r_20_64_55,1,0,55,55,17
8,r_66_74_14,r_50_21_146,seq128,r_50_21_146,1,0,146,146,17
0,r_126_73_20,r_139_29_120,r_91_43_21,r_126_73_20,0.9,100,120,20,17
11,r_58_87_147,seq26,r_8_136_47,r_58_87_147,0.97,0,147,147,17
20,r_144_99_174,r_23_94_152,r_100_59_102,r_144_99_174,0.58,-64,110,174,17
46,r_38_116_128,r_134_93_189,r_66_74_14,r_134_93_189,0.58,0,189,189,17
15,r_25_72_157,seq12,seq16,r_25_72_157,0.62,-1,156,157,17
1,r_34_69_38,r_134_93_189,r_67_3_50,r_34_69_38,0.64,14,52,38,17
13,r_50_21_146,r_66_74_14,r_118_35_170,r_50_21_146,0.67,1,147,146,17
6,r_134_93_189,r_50_21_146,r_38_116_128,r_134_93_189,0.93,-43,146,189,17
13,r_50_21_146,r_82_77_41,r_66_74_14,r_50_21_146,0.97,-132,14,146,17
27,r_119_131_85,seq105,r_124_56_27,r_119_131_85,0.59,0,85,85,17
10,r_108_147_11,r_37_11_188,r_125_96_32,r_125_96_32,1,2,34,32,17
47,r_65_84_135,r_14_2_180,seq15,r_65_84_135,0.91,0,135,135,17
4,r_8_136_47,seq104,seq121,r_8_136_47,0.99,0,47,47,17
29,r_107_52_132,seq133,r_148_130_9,r_107_52_132,0.97,0,132,132,17
24,r_115_30_139,seq70,seq0,r_115_30_139,0.86,0,139,139,17
34,r_14_2_180,r_91_43_21,r_118_35_170,r_14_2_180,0.7,0,180,180,17
3,r_23_94_152,r_110_47_86,r_124_56_27,r_23_94_152,0.72,-1,151,152,17
37,r_125_96_32,r_100_59_102,r_108_147_11,r_125_96_32,1,0,32,32,17
88,seq81,r_110_47_86,seq62,r_110_47_86,0.64,4,90,86,17
6,r_134_93_189,r_38_116_128,r_124_56_27,r_124_56_27,0.49,162,189,27,17
65,seq26,r_58_87_147,seq28,r_58_87_147,0.99,0,147,147,17
20,r_144_99_174,r_100_59_102,r_65_84_135,r_144_99_174,0.73,0,174,174,17
61,seq17,r_38_116_128,seq45,r_38_116_128,0.54,-3,125,128,17
95,seq104,r_8_136_47,seq92,r_8_136_47,0.53,3,50,47,17
14,r_110_47_86,r_23_94_152,r_138_4_3,r_23_94_152,1,-10,142,152,17
75,seq46,r_36_117_127,seq48,r_36_117_127,0.97,-46,81,127,17
30,r_61_13_45,r_102_57_28,seq71,r_61_13_45,0.91,-2,43,45,17
5,r_82_77_41,r_134_93_189,seq121,r_82_77_41,1,0,41,41,17
40,r_10_78_30,r_23_94_152,seq15,r_10_78_30,1,0,30,30,17
9,r_36_117_127,seq46,seq133,r_36_117_127,0.97,0,127,127,17
13,r_50_21_146,r_118_35_170,r_19_31_163,r_50_21_146,0.54,17,163,146,17
96,seq105,r_119_131_85,seq41,r_119_131_85,0.94,0,85,85,17
18,r_113_97_198,seq92,r_8_136_47,r_113_97_198,0.58,-170,28,198,17
22,r_138_4_3,r_23_94_152,r_110_47_86,r_110_47_86,0.61,56,142,86,17
91,seq92,r_118_35_170,seq41,r_118_35_170,1,-68,102,170,17
49,r_63_85_158,seq75,r_91_43_21,r_63_85_158,0.77,1,159,158,17
60,seq16,r_20_64_55,seq88,r_20_64_55,0.99,-7,48,55,17
21,r_100_59_102,r_144_99_174,r_138_4_3,r_144_99_174,0.91,-14,160,174,17
10,r_108_147_11,r_124_56_27,r_37_11_188,r_108_147_11,0.6,0,11,11,17
60,seq16,seq88,r_25_72_157,r_25_72_157,0.51,-11,146,157,17
35,r_114_79_76,r_142_55_44,seq7,r_114_79_76,1,0,76,76,17
12,r_137_122_89,seq89,seq49,r_137_122_89,1,0,89,89,17
17,r_129_90_35,seq41,seq7,r_129_90_35,1,1,36,35,17
30,r_123_8_178,r_63_92_117,seq23,r_63_92_117,0.59,1,118,117,18
9,r_38_43_17,r_118_81_133,r_116_125_32,r_118_81_133,0.49,-121,12,133,18
36,r_143_3_105,r_63_92_117,r_65_112_53,r_143_3_105,0.98,1,106,105,18
92,seq111,seq52,r_135_115_72,r_135_115_72,1,2,74,72,18
28,r_130_99_15,seq127,r_78_80_131,r_130_99_15,0.96,0,15,15,18
14,r_16_77_75,r_78_80_131,seq94,r_16_77_75,0.96,0,75,75,18
69,seq40,r_46_93_36,r_67_34_165,r_46_93_36,0.89,0,36,36,18
49,r_118_81_133,r_24_79_73,r_103_51_56,r_118_81_133,0.99,-1,132,133,18
17,r_86_74_34,r_11_98_177,r_28_139_54,r_28_139_54,0.56,60,114,54,18
43,r_90_102_123,seq60,seq47,r_90_102_123,0.57,0,123,123,18
31,r_5_83_60,r_11_98_177,r_86_74_34,r_86_74_34,0.6,1,35,34,18
31,r_5_83_60,r_86_74_34,seq19,r_5_83_60,0.89,1,61,60,18
37,r_134_136_187,r_18_100_169,r_126_13_35,r_126_13_35,1,134,169,35,18
22,r_24_79_73,r_118_81_133,seq95,r_24_79_73,0.59,59,132,73,18
50,seq0,r_134_136_187,r_1_50_39,r_1_50_39,1,1,40,39,18
86,seq96,r_114_32_175,seq64,r_114_32_175,0.7,1,176,175,18
24,r_144_49_146,seq95,seq76,r_144_49_146,0.51,16,162,146,18
21,r_17_82_138,seq72,r_114_32_175,r_114_32_175,0.91,1,176,175,18
19,r_119_35_120,r_10_41_189,seq7,r_119_35_120,0.61,0,120,120,18
15,r_10_41_189,r_144_49_146,seq95,r_144_49_146,0.89,11,157,146,18
17,r_86_74_34,r_28_139_54,r_11_98_177,r_86_74_34,0.55,108,142,34,18
66,seq36,r_22_61_121,seq19,r_22_61_121,0.99,1,122,121,18
27,r_2_12_45,r_10_41_189,seq27,r_2_12_45,0.99,0,45,45,18
20,r_89_101_33,r_138_57_132,r_38_43_17,r_89_101_33,0.99,0,33,33,18
79,seq72,r_65_112_53,seq9,r_65_112_53,1,-2,51,53,18
80,seq73,r_71_105_188,seq62,r_71_105_188,0.4,-43,145,188,18
1,r_116_125_32,r_17_82_138,r_89_101_33,r_116_125_32,0.99,1,33,32,18
12,r_142_140_122,r_17_82_138,seq64,r_17_82_138,1,0,138,138,18
74,seq58,seq107,r_66_137_129,r_66_137_129,0.6,1,130,129,18
34,r_75_70_30,seq4,r_53_110_164,r_53_110_164,1,2,166,164,18
22,r_24_79_73,r_75_70_30,r_118_81_133,r_24_79_73,1,0,73,73,18
0,r_138_57_132,seq95,seq96,r_138_57_132,0.89,3,135,132,18
34,r_75_70_30,r_126_13_35,r_24_79_73,r_75_70_30,1,0,30,30,18
11,r_63_92_117,r_143_3_105,seq76,r_143_3_105,0.61,1,106,105,18
15,r_10_41_189,seq95,r_71_105_188,r_10_41_189,0.65,0,189,189,18
6,r_28_139_54,r_71_105_188,seq127,r_28_139_54,1,0,54,54,18
6,r_28_139_54,r_55_6_27,r_71_105_188,r_28_139_54,0.91,-30,24,54,18
80,seq73,r_55_6_27,r_71_105_188,r_55_6_27,0.42,71,98,27,18
29,r_55_6_27,r_28_139_54,seq60,r_55_6_27,1,-1,26,27,18
48,r_42_128_97,seq148,seq122,r_42_128_97,0.95,0,97,97,18
13,r_65_112_53,seq72,seq109,r_65_112_53,1,0,53,53,18
37,r_134_136_187,r_126_13_35,r_16_77_75,r_134_136_187,0.87,-1,186,187,18
90,seq108,r_149_121_40,r_46_93_36,r_46_93_36,0.61,3,39,36,18
52,seq4,r_75_70_30,r_45_131_89,r_45_131_89,1,4,93,89,18
76,seq60,r_90_102_123,r_55_6_27,r_55_6_27,1,-1,26,27,18
9,r_38_43_17,r_116_125_32,r_89_101_33,r_89_101_33,0.83,32,65,33,18
8,r_126_13_35,r_53_110_164,seq0,r_126_13_35,0.98,0,35,35,18
30,r_123_8_178,seq23,r_132_69_141,r_132_69_141,0.81,37,178,141,18
38,r_48_25_20,seq56,seq120,r_48_25_20,1,0,20,20,18
41,r_46_93_36,seq40,seq108,r_46_93_36,0.99,0,36,36,18
34,r_75_70_30,r_24_79_73,seq4,r_24_79_73,1,2,75,73,18
22,r_24_79_73,seq4,r_75_70_30,r_75_70_30,1,3,33,30,18
73,seq56,r_48_25_20,r_123_8_178,r_48_25_20,0.76,0,20,20,18
2,r_11_98_177,seq127,seq47,r_11_98_177,0.82,0,177,177,18
47,r_132_69_141,r_149_121_40,r_85_68_62,r_85_68_62,0.9,79,141,62,18
74,seq58,seq88,r_48_25_20,r_48_25_20,0.76,8,28,20,18
35,r_53_110_164,seq117,r_75_70_30,r_53_110_164,0.59,0,164,164,18
25,r_66_137_129,seq47,seq58,r_66_137_129,0.96,0,129,129,18
33,r_22_61_121,seq36,r_45_131_89,r_22_61_121,1,0,121,121,18
20,r_89_101_33,r_38_43_17,r_116_125_32,r_116_125_32,0.28,74,106,32,18
21,r_17_82_138,r_86_74_34,seq84,r_86_74_34,0.99,-1,33,34,18
17,r_86_74_34,r_17_82_138,r_5_83_60,r_86_74_34,0.99,0,34,34,18
13,r_65_112_53,seq109,r_143_3_105,r_143_3_105,1,3,108,105,18
21,r_17_82_138,seq4,seq72,r_17_82_138,0.98,2,140,138,18
26,r_1_50_39,seq20,seq0,r_1_50_39,1,0,39,39,18
4,r_14_124_21,seq0,seq88,r_14_124_21,1,0,21,21,18
22,r_24_79_73,seq95,r_18_100_169,r_24_79_73,0.42,96,169,73,18
81,seq76,r_85_68_62,r_149_121_40,r_85_68_62,1,0,62,62,18
91,seq109,r_90_102_123,r_65_112_53,r_65_112_53,0.62,5,58,53,18
15,r_10_41_189,seq95,r_144_49_146,r_10_41_189,0.59,-135,54,189,18
28,r_130_99_15,r_78_80_131,seq20,r_78_80_131,0.98,1,132,131,18
73,seq56,r_123_8_178,r_46_93_36,r_123_8_178,0.53,-22,156,178,18
17,r_86_74_34,r_5_83_60,r_11_98_177,r_5_83_60,0.72,1,61,60,18
49,r_118_81_133,r_45_131_89,r_24_79_73,r_24_79_73,0.77,16,89,73,18
7,r_135_115_72,seq73,seq111,r_135_115_72,1,0,72,72,18
60,seq20,r_142_140_122,r_130_99_15,r_130_99_15,0.87,0,15,15,18
23,r_18_100_169,r_134_136_187,r_24_79_73,r_18_100_169,0.4,0,169,169,18
82,seq84,r_17_82_138,seq64,r_17_82_138,0.97,0,138,138,18
3,r_149_121_40,seq108,seq76,r_149_121_40,0.86,-3,37,40,18
44,r_103_51_56,r_143_3_105,r_85_68_62,r_143_3_105,0.63,-52,53,105,18
12,r_142_140_122,r_78_80_131,r_17_82_138,r_142_140_122,0.51,0,122,122,18
35,r_53_110_164,r_126_13_35,seq117,r_126_13_35,0.96,-14,21,35,18
99,seq127,r_130_99_15,r_11_98_177,r_130_99_15,0.83,0,15,15,18
47,r_132_69_141,r_85_68_62,r_123_8_178,r_123_8_178,1,-1,177,178,18
93,seq147,r_114_143_105,seq5,r_114_143_105,1,-3,102,105,19
30,r_79_142_174,r_88_74_143,r_82_92_21,r_79_142_174,0.74,-31,143,174,19
9,r_136_51_109,r_9_56_32,r_109_25_41,r_136_51_109,0.92,1,110,109,19
15,r_80_37_188,r_9_56_32,r_54_58_58,r_80_37_188,0.47,0,188,188,19
13,r_7_103_24,r_135_45_125,r_133_3_165,r_7_103_24,1,0,24,24,19
34,r_91_6_31,r_54_58_58,r_130_78_52,r_91_6_31,0.85,27,58,31,19
14,r_89_140_191,r_113_72_78,seq98,r_113_72_78,1,0,78,78,19
46,r_109_25_41,seq40,seq41,r_109_25_41,0.74,1,42,41,19
43,r_76_14_84,seq49,seq53,r_76_14_84,1,0,84,84,19
91,seq110,r_136_51_109,r_119_108_62,r_119_108_62,0.66,25,87,62,19
37,r_75_62_182,r_135_45_125,seq47,r_135_45_125,0.85,3,128,125,19
19,r_113_72_78,r_83_95_168,seq47,r_83_95_168,0.98,1,169,168,19
86,seq98,r_89_140_191,r_115_33_42,r_115_33_42,1,31,73,42,19
16,r_83_95_168,seq47,r_113_72_78,r_113_72_78,1,29,107,78,19
21,r_86_71_146,seq118,r_127_11_82,r_86_71_146,0.66,0,146,146,19
42,r_88_74_143,r_79_142_174,r_132_12_43,r_88_74_143,0.64,0,143,143,19
33,r_9_56_32,seq5,r_136_51_109,r_9_56_32,0.92,0,32,32,19
1,r_66_15_71,r_77_138_14,r_145_69_6,r_66_15_71,1,0,71,71,19
45,r_94_107_169,r_43_122_187,r_7_103_24,r_94_107_169,0.77,0,169,169,19
19,r_113_72_78,r_89_140_191,r_83_95_168,r_113_72_78,0.99,0,78,78,19
33,r_9_56_32,r_136_51_109,r_80_37_188,r_136_51_109,0.71,1,110,109,19
22,r_87_139_29,r_132_12_43,seq117,r_87_139_29,0.96,2,31,29,19
8,r_82_92_21,r_75_62_182,seq19,r_82_92_21,1,0,21,21,19
76,seq47,r_83_95_168,r_113_72_78,r_113_72_78,1,93,171,78,19
31,r_114_143_105,seq147,r_124_73_194,r_114_143_105,1,1,106,105,19
41,r_129_70_166,seq123,seq41,r_129_70_166,0.46,1,167,166,19
4,r_54_58_58,r_99_131_7,r_132_12_43,r_54_58_58,0.53,10,68,58,19
10,r_124_73_194,r_43_122_187,r_114_143_105,r_114_143_105,1,13,118,105,19
30,r_79_142_174,r_82_92_21,seq123,r_79_142_174,0.99,0,174,174,19
26,r_93_121_87,seq19,seq53,r_93_121_87,1,0,87,87,19
16,r_83_95_168,r_113_72_78,r_136_51_109,r_83_95_168,0.8,1,169,168,19
15,r_80_37_188,seq0,r_119_108_62,r_80_37_188,0.67,-103,85,188,19
0,r_135_45_125,r_75_62_182,seq5,r_135_45_125,0.93,4,129,125,19
38,r_26_126_55,r_133_3_165,seq146,r_26_126_55,1,0,55,55,19
9,r_136_51_109,seq0,r_9_56_32,r_136_51_109,0.73,-77,32,109,19
46,r_109_25_41,seq41,r_136_51_109,r_136_51_109,0.6,1,110,109,19
15,r_80_37_188,r_136_51_109,seq0,r_80_37_188,0.41,-124,64,188,19
48,r_52_64_172,seq24,seq117,r_52_64_172,0.61,0,172,172,19
57,seq13,seq24,r_127_11_82,r_127_11_82,1,22,104,82,19
13,r_7_103_24,r_133_3_165,r_94_107_169,r_7_103_24,0.54,149,173,24,19
6,r_4_67_163,seq20,r_114_143_105,r_4_67_163,0.83,2,165,163,19
18,r_1_61_151,seq13,r_119_108_62,r_1_61_151,0.92,0,151,151,19
5,r_133_3_165,r_7_103_24,r_75_62_182,r_7_103_24,0.39,165,189,24,19
29,r_29_36_30,r_90_149_89,seq146,r_29_36_30,0.86,1,31,30,19
2,r_81_34_110,seq22,seq123,r_81_34_110,0.88,1,111,110,19
37,r_75_62_182,seq47,r_133_3_165,r_75_62_182,0.87,0,182,182,19
40,r_127_11_82,r_46_96_145,seq13,r_127_11_82,0.99,2,84,82,19
18,r_1_61_151,r_93_121_87,seq13,r_93_121_87,0.67,-43,44,87,19
24,r_77_138_14,r_66_15_71,seq28,r_66_15_71,1,0,71,71,19
49,r_101_63_104,r_94_107_169,seq32,r_101_63_104,0.95,0,104,104,19
25,r_46_96_145,r_127_11_82,r_119_108_62,r_46_96_145,1,-63,82,145,19
64,seq22,r_81_34_110,seq112,r_81_34_110,0.96,0,110,110,19
47,r_132_12_43,seq20,r_88_74_143,r_88_74_143,0.89,21,164,143,19
65,seq24,r_52_64_172,seq13,r_52_64_172,0.71,0,172,172,19
20,r_35_120_186,r_145_69_6,r_48_97_92,r_48_97_92,1,94,186,92,19
32,r_2_39_25,seq128,seq98,r_2_39_25,0.98,0,25,25,19
15,r_80_37_188,r_119_108_62,r_9_56_32,r_119_108_62,0.63,70,132,62,19
24,r_77_138_14,seq16,r_66_15_71,r_77_138_14,0.78,0,14,14,19
1,r_66_15_71,seq28,r_77_138_14,r_77_138_14,0.34,14,28,14,19
36,r_111_85_37,seq146,seq102,r_111_85_37,0.99,0,37,37,19
11,r_130_78_52,r_127_11_82,r_91_6_31,r_130_78_52,1,1,53,52,19
34,r_91_6_31,r_4_67_163,r_54_58_58,r_91_6_31,0.9,0,31,31,19
25,r_46_96_145,r_119_108_62,seq21,r_46_96_145,0.9,0,145,145,19
94,seq116,seq146,r_29_36_30,r_29_36_30,0.79,78,108,30,19
63,seq21,r_75_62_182,r_46_96_145,r_46_96_145,0.93,4,149,145,19
29,r_29_36_30,seq146,seq116,r_29_36_30,0.46,87,117,30,19
4,r_54_58_58,r_132_12_43,r_80_37_188,r_54_58_58,0.5,130,188,58,19
91,seq110,r_130_78_52,r_136_51_109,r_130_78_52,0.79,-5,47,52,19
49,r_101_63_104,r_48_97_92,r_94_107_169,r_48_97_92,0.73,0,92,92,19
47,r_132_12_43,r_124_73_194,seq20,r_132_12_43,0.98,1,44,43,19
27,r_115_33_42,r_135_45_125,seq98,r_115_33_42,0.96,0,42,42,19
7,r_48_97_92,r_101_63_104,seq100,r_48_97_92,0.95,0,92,92,19
44,r_90_149_89,seq53,seq41,r_90_149_89,0.73,0,89,89,19
23,r_43_122_187,r_124_73_194,r_93_121_87,r_43_122_187,0.51,0,187,187,19
17,r_145_69_6,r_35_120_186,r_66_15_71,r_66_15_71,1,115,186,71,19
95,seq117,seq32,r_87_139_29,r_87_139_29,0.9,-3,26,29,19
35,r_106_84_173,r_133_3_165,seq22,r_106_84_173,0.79,0,173,173,19
12,r_119_108_62,seq134,r_133_3_165,r_119_108_62,0.97,0,62,62,19
95,seq117,r_87_139_29,r_52_64_172,r_52_64_172,0.74,2,174,172,19
5,r_133_3_165,r_26_126_55,r_7_103_24,r_26_126_55,0.85,0,55,55,19
84,seq141,seq16,r_114_143_105,r_114_143_105,1,53,158,105,19
93,seq116,r_19_52_89,r_112_49_132,r_19_52_89,0.99,0,89,89,20
30,r_55_115_161,r_90_99_172,r_137_84_63,r_137_84_63,1,5,68,63,20
36,r_76_4_101,r_112_49_132,seq1,r_76_4_101,0.99,0,101,101,20
38,r_85_142_149,r_6_3_75,r_93_118_159,r_6_3_75,0.77,-37,38,75,20
8,r_133_33_163,r_5_94_119,r_64_10_105,r_133_33_163,0.71,1,164,163,20
54,seq8,r_57_15_148,r_30_0_70,r_30_0_70,0.98,78,148,70,20
83,seq80,r_24_28_102,seq130,r_24_28_102,0.44,6,108,102,20
37,r_129_46_141,seq79,r_35_60_49,r_129_46_141,0.69,-2,139,141,20
10,r_120_17_52,seq42,seq116,r_120_17_52,0.9,0,52,52,20
71,seq61,r_30_0_70,r_26_21_30,r_30_0_70,0.62,-1,69,70,20
16,r_108_88_146,seq72,seq139,r_108_88_146,0.59,0,146,146,20
21,r_112_49_132,r_76_4_101,seq116,r_76_4_101,0.84,-1,100,101,20
39,r_31_62_187,r_64_10_105,seq25,r_64_10_105,0.58,1,106,105,20
1,r_39_23_160,seq18,r_35_60_49,r_39_23_160,0.84,0,160,160,20
5,r_58_56_182,seq61,r_128_53_179,r_128_53_179,0.47,3,182,179,20
42,r_134_67_143,seq38,seq74,r_134_67_143,0.73,0,143,143,20
24,r_117_103_78,r_39_23_160,r_34_104_11,r_34_104_11,0.67,0,11,11,20
24,r_117_103_78,r_34_104_11,seq146,r_117_103_78,1,0,78,78,20
24,r_117_103_78,seq146,r_41_111_32,r_117_103_78,0.56,41,119,78,20
15,r_34_104_11,r_117_103_78,r_47_106_13,r_117_103_78,0.82,0,78,78,20
19,r_69_27_19,seq96,seq72,r_69_27_19,0.98,0,19,19,20
2,r_35_60_49,r_95_91_162,r_22_87_152,r_35_60_49,0.99,0,49,49,20
11,r_22_87_152,r_35_60_49,seq130,r_22_87_152,0.76,2,154,152,20
33,r_44_98_53,r_37_45_127,seq140,r_37_45_127,0.86,-32,95,127,20
39,r_31_62_187,seq25,seq1,r_31_62_187,0.7,0,187,187,20
29,r_125_100_135,r_6_3_75,r_101_51_10,r_125_100_135,0.84,-119,16,135,20
67,seq38,r_134_67_143,seq68,r_134_67_143,0.94,0,143,143,20
45,r_40_70_87,r_22_87_152,seq63,r_40_70_87,0.51,-71,16,87,20
15,r_34_104_11,r_35_60_49,r_117_103_78,r_34_104_11,1,0,11,11,20
4,r_81_32_157,r_102_48_180,seq61,r_81_32_157,0.95,0,157,157,20
26,r_47_106_13,r_57_15_148,seq78,r_47_106_13,0.94,1,14,13,20
0,r_30_0_70,seq61,seq8,r_30_0_70,1,0,70,70,20
31,r_41_111_32,seq42,seq146,r_41_111_32,0.98,0,32,32,20
13,r_102_48_180,r_81_32_157,r_65_50_156,r_102_48_180,0.74,-23,157,180,20
46,r_59_131_7,seq13,seq78,r_59_131_7,0.47,63,70,7,20
48,r_137_84_63,r_108_88_146,r_55_115_161,r_137_84_63,1,0,63,63,20
46,r_59_131_7,seq78,seq13,r_59_131_7,0.45,123,130,7,20
57,seq12,r_24_28_102,seq130,r_24_28_102,0.48,5,107,102,20
62,seq145,r_121_54_186,seq127,r_121_54_186,0.98,-40,146,186,20
2,r_35_60_49,r_22_87_152,r_129_46_141,r_35_60_49,0.85,100,149,49,20
93,seq116,r_114_97_35,r_95_91_162,r_95_91_162,0.64,0,162,162,20
25,r_65_50_156,r_47_106_13,r_39_23_160,r_47_106_13,0.72,137,150,13,20
10,r_120_17_52,seq116,r_129_46_141,r_120_17_52,0.36,85,137,52,20
30,r_55_115_161,r_137_84_63,seq124,r_55_115_161,0.93,0,161,161,20
47,r_9_86_84,r_19_52_89,seq79,r_9_86_84,0.88,1,85,84,20
40,r_113_73_94,seq143,r_117_103_78,r_113_73_94,1,1,95,94,20
74,seq68,seq38,r_85_142_149,r_85_142_149,0.99,0,149,149,20
18,r_93_118_159,seq74,r_113_73_94,r_93_118_159,0.62,0,159,159,20
34,r_64_10_105,seq138,r_133_33_163,r_133_33_163,0.96,6,169,163,20
48,r_137_84_63,r_55_115_161,seq18,r_55_115_161,0.98,8,169,161,20
43,r_114_97_35,r_128_53_179,seq43,r_114_97_35,1,2,37,35,20
33,r_44_98_53,seq110,r_37_45_127,r_44_98_53,1,0,53,53,20
50,seq1,seq96,r_76_4_101,r_76_4_101,1,14,115,101,20
38,r_85_142_149,seq141,seq68,r_85_142_149,0.98,0,149,149,20
20,r_101_51_10,r_125_100_135,seq139,r_125_100_135,0.62,0,135,135,20
21,r_112_49_132,seq116,seq2,r_112_49_132,0.99,6,138,132,20
12,r_147_83_165,r_66_109_128,r_64_10_105,r_147_83_165,0.82,0,165,165,20
13,r_102_48_180,r_65_50_156,seq42,r_102_48_180,0.93,0,180,180,20
34,r_64_10_105,r_31_62_187,seq138,r_64_10_105,1,1,106,105,20
91,seq146,r_22_87_152,r_41_111_32,r_41_111_32,0.52,1,33,32,20
60,seq143,r_113_73_94,seq77,r_113_73_94,1,0,94,94,20
45,r_40_70_87,seq63,r_30_0_70,r_30_0_70,1,97,167,70,20
17,r_57_15_148,seq8,seq77,r_57_15_148,0.9,0,148,148,20
9,r_36_29_95,r_24_28_102,seq71,r_36_29_95,1,-1,94,95,20
14,r_26_21_30,seq74,seq61,r_26_21_30,0.95,1,31,30,20
96,seq122,r_95_91_162,seq14,r_95_91_162,0.98,-26,136,162,20
15,r_34_104_11,r_47_106_13,r_137_84_63,r_137_84_63,0.34,102,165,63,20
31,r_41_111_32,seq146,r_113_73_94,r_113_73_94,1,23,117,94,20
29,r_125_100_135,r_101_51_10,r_30_0_70,r_125_100_135,0.99,0,135,135,20
22,r_19_52_89,r_9_86_84,r_5_94_119,r_19_52_89,1,0,89,89,20
11,r_22_87_152,r_121_54_186,r_35_60_49,r_35_60_49,0.9,7,56,49,20
49,r_66_109_128,r_102_48_180,r_147_83_165,r_66_109_128,0.52,0,128,128,20
7,r_5_94_119,r_133_33_163,r_19_52_89,r_19_52_89,0.93,17,106,89,20
44,r_128_53_179,seq82,seq12,r_128_53_179,0.52,0,179,179,20
32,r_126_92_23,r_64_10_105,r_24_28_102,r_126_92_23,0.92,0,23,23,20
23,r_24_28_102,r_36_29_95,r_126_92_23,r_24_28_102,0.7,-14,88,102,20
20,r_101_51_10,r_81_32_157,r_125_100_135,r_101_51_10,0.66,0,10,10,20
49,r_66_109_128,r_147_83_165,seq25,r_147_83_165,0.96,-7,158,165,20
82,seq79,r_129_46_141,seq63,r_129_46_141,1,-2,139,141,20
81,seq78,seq148,r_47_106_13,r_47_106_13,1,1,14,13,20
35,r_95_91_162,seq122,seq116,r_95_91_162,0.72,-1,161,162,20
12,r_147_83_165,seq140,r_66_109_128,r_147_83_165,0.45,-36,129,165,20
23,r_109_119_22,seq65,r_70_49_153,r_70_49_153,0.75,0,153,153,21
44,r_44_126_199,seq65,seq145,r_44_126_199,0.59,-75,124,199,21
64,seq38,r_71_132_174,r_63_149_15,r_63_149_15,1,1,16,15,21
36,r_66_25_178,seq98,r_41_89_105,r_66_25_178,0.36,1,179,178,21
70,seq57,r_56_102_85,r_36_58_128,r_36_58_128,1,11,139,128,21
43,r_96_43_133,r_45_127_114,seq57,r_45_127_114,0.31,-5,109,114,21
17,r_61_26_23,r_2_15_104,r_121_48_21,r_61_26_23,1,0,23,23,21
13,r_134_77_45,seq1,r_92_9_12,r_134_77_45,0.99,0,45,45,21
16,r_104_115_94,r_92_9_12,seq1,r_104_115_94,1,-9,85,94,21
21,r_37_103_90,seq3,seq125,r_37_103_90,1,1,91,90,21
1,r_18_24_102,r_120_135_77,r_78_138_168,r_18_24_102,0.83,-25,77,102,21
97,seq117,r_7_131_192,r_120_135_77,r_120_135_77,1,1,78,77,21
5,r_2_15_104,r_75_28_175,r_12_17_51,r_75_28_175,1,-71,104,175,21
46,r_45_127_114,r_96_43_133,r_19_69_92,r_19_69_92,1,18,110,92,21
27,r_23_35_26,seq110,seq91,r_23_35_26,0.77,-2,24,26,21
34,r_63_149_15,r_18_24_102,seq38,r_63_149_15,1,0,15,15,21
32,r_53_29_66,r_45_127_114,r_123_30_150,r_123_30_150,0.82,0,150,150,21
69,seq51,r_60_84_69,r_121_48_21,r_60_84_69,0.93,-4,65,69,21
45,r_41_89_105,seq139,r_47_59_76,r_41_89_105,0.97,0,105,105,21
19,r_123_30_150,seq113,r_53_29_66,r_123_30_150,0.69,0,150,150,21
33,r_70_49_153,r_148_80_109,r_41_89_105,r_70_49_153,0.79,-47,106,153,21
9,r_120_135_77,r_109_119_22,r_18_24_102,r_109_119_22,0.59,1,23,22,21
31,r_75_28_175,r_2_15_104,seq22,r_2_15_104,1,0,104,104,21
41,r_19_69_92,seq100,seq118,r_19_69_92,1,0,92,92,21
3,r_78_138_168,seq112,r_92_9_12,r_78_138_168,0.95,0,168,168,21
40,r_116_8_144,seq65,r_14_32_171,r_14_32_171,0.81,7,178,171,21
26,r_124_11_89,r_54_79_172,r_92_9_12,r_124_11_89,1,0,89,89,21
46,r_45_127_114,r_19_69_92,seq146,r_19_69_92,0.55,71,163,92,21
0,r_4_111_68,seq34,seq114,r_4_111_68,1,0,68,68,21
63,seq34,r_4_111_68,seq46,r_4_111_68,0.93,0,68,68,21
39,r_142_97_47,r_21_27_56,r_81_128_46,r_142_97_47,1,2,49,47,21
33,r_70_49_153,seq146,r_148_80_109,r_148_80_109,0.66,-84,25,109,21
98,seq118,seq57,r_19_69_92,r_19_69_92,1,2,94,92,21
66,seq42,r_21_27_56,seq140,r_21_27_56,1,-6,50,56,21
48,r_60_84_69,seq51,seq98,r_60_84_69,1,0,69,69,21
70,seq57,r_45_127_114,r_56_102_85,r_56_102_85,0.69,0,85,85,21
20,r_31_136_24,seq113,seq62,r_31_136_24,0.99,0,24,24,21
12,r_52_108_122,r_121_48_21,r_92_9_12,r_52_108_122,1,0,122,122,21
42,r_86_33_67,seq74,seq100,r_86_33_67,1,0,67,67,21
13,r_134_77_45,r_92_9_12,r_124_11_89,r_124_11_89,1,70,159,89,21
6,r_56_102_85,r_71_132_174,seq57,r_56_102_85,0.99,0,85,85,21
22,r_0_106_83,r_53_29_66,r_109_119_22,r_109_119_22,0.59,0,22,22,21
99,seq125,r_116_8_144,r_13_39_43,r_13_39_43,0.91,85,128,43,21
29,r_95_93_189,seq40,seq5,r_95_93_189,0.54,0,189,189,21
24,r_141_143_55,r_19_69_92,seq101,r_141_143_55,0.99,1,56,55,21
12,r_52_108_122,seq51,r_121_48_21,r_121_48_21,1,-1,20,21,21
87,seq98,r_66_25_178,r_60_84_69,r_60_84_69,1,111,180,69,21
30,r_21_27_56,seq42,seq82,r_21_27_56,0.99,2,58,56,21
35,r_92_9_12,r_104_115_94,r_134_77_45,r_134_77_45,0.51,1,46,45,21
80,seq82,r_71_132_174,r_21_27_56,r_21_27_56,0.61,3,59,56,21
22,r_0_106_83,r_109_119_22,seq72,r_0_106_83,1,0,83,83,21
2,r_47_59_76,seq130,r_70_49_153,r_47_59_76,0.67,0,76,76,21
47,r_71_132_174,r_56_102_85,r_63_149_15,r_56_102_85,0.67,0,85,85,21
40,r_116_8_144,seq125,seq65,r_116_8_144,0.72,0,144,144,21
33,r_70_49_153,r_41_89_105,r_109_119_22,r_70_49_153,0.98,1,154,153,21
18,r_6_55_93,seq114,seq144,r_6_55_93,1,1,94,93,21
29,r_95_93_189,r_14_32_171,seq40,r_95_93_189,0.54,-18,171,189,21
92,seq107,seq114,r_2_15_104,r_2_15_104,0.92,43,147,104,21
88,seq99,seq147,r_18_24_102,r_18_24_102,1,40,142,102,21
50,seq1,seq105,r_104_115_94,r_104_115_94,1,0,94,94,21
65,seq40,r_95_93_189,r_4_111_68,r_4_111_68,1,121,189,68,21
32,r_53_29_66,seq145,r_45_127_114,r_53_29_66,1,0,66,66,21
38,r_121_48_21,r_52_108_122,r_61_26_23,r_121_48_21,0.85,101,122,21,21
1,r_18_24_102,r_78_138_168,seq99,r_18_24_102,1,0,102,102,21
35,r_92_9_12,seq91,r_104_115_94,r_92_9_12,0.98,1,13,12,21
9,r_120_135_77,r_18_24_102,seq117,r_120_135_77,1,0,77,77,21
35,r_92_9_12,r_134_77_45,r_52_108_122,r_52_108_122,1,2,124,122,21
84,seq91,seq146,r_23_35_26,r_23_35_26,1,1,27,26,21
25,r_54_79_172,seq101,r_18_24_102,r_54_79_172,0.83,0,172,172,21
2,r_47_59_76,r_70_49_153,r_41_89_105,r_47_59_76,0.78,38,114,76,21
1,r_18_24_102,r_63_149_15,r_120_135_77,r_63_149_15,0.63,-1,14,15,21
45,r_41_89_105,r_47_59_76,r_66_25_178,r_66_25_178,0.48,10,188,178,21
43,r_96_43_133,seq57,r_23_35_26,r_96_43_133,0.35,28,161,133,21
94,seq112,r_78_138_168,seq110,r_78_138_168,0.99,0,168,168,21
26,r_124_11_89,r_92_9_12,r_134_77_45,r_124_11_89,0.56,70,159,89,21
96,seq114,r_6_55_93,r_10_88_166,r_6_55_93,1,-31,62,93,21
71,seq62,seq67,r_31_136_24,r_31_136_24,1,6,30,24,21
28,r_14_32_171,r_95_93_189,r_116_8_144,r_14_32_171,0.63,0,171,171,21
73,seq65,r_109_119_22,r_116_8_144,r_116_8_144,0.68,-1,143,144,21
11,r_13_39_43,r_70_49_153,seq144,r_13_39_43,0.95,-7,36,43,21
49,r_36_58_128,seq73,seq57,r_36_58_128,0.93,0,128,128,21
7,r_148_80_109,r_70_49_153,r_120_135_77,r_148_80_109,0.98,0,109,109,21
8,r_81_128_46,seq76,r_142_97_47,r_81_128_46,1,0,46,46,21
82,seq85,r_54_79_172,seq101,r_54_79_172,0.7,-74,98,172,21
23,r_109_119_22,r_120_135_77,r_0_106_83,r_109_119_22,0.98,-1,21,22,21
95,seq113,r_123_30_150,r_12_17_51,r_12_17_51,0.69,7,58,51,21
23,r_109_119_22,r_0_106_83,seq65,r_0_106_83,0.96,1,84,83,21
40,r_11_111_102,r_20_58_18,r_55_72_149,r_55_72_149,0.45,-46,103,149,22
36,r_130_50_126,r_140_123_181,r_139_75_121,r_130_50_126,0.99,0,126,126,22
9,r_20_58_18,r_11_111_102,r_89_3_94,r_20_58_18,1,75,93,18,22
8,r_132_142_165,seq117,seq102,r_132_142_165,0.79,0,165,165,22
54,seq7,seq70,r_148_149_86,r_148_149_86,1,1,87,86,22
10,r_8_129_31,seq141,seq86,r_8_129_31,0.97,0,31,31,22
39,r_85_43_160,seq118,r_127_28_1,r_85_43_160,0.72,1,161,160,22
97,seq120,r_82_119_187,r_115_22_45,r_115_22_45,1,129,174,45,22
5,r_134_54_136,seq133,seq26,r_134_54_136,0.92,0,136,136,22
46,r_78_59_81,seq102,seq79,r_78_59_81,1,0,81,81,22
80,seq76,r_25_91_139,r_57_31_55,r_57_31_55,1,44,99,55,22
42,r_95_116_54,seq76,r_82_119_187,r_95_116_54,0.44,48,102,54,22
32,r_94_34_34,seq87,seq61,r_94_34_34,1,0,34,34,22
19,r_45_56_83,r_98_73_119,seq87,r_45_56_83,0.99,0,83,83,22
69,seq41,r_105_137_4,seq100,r_105_137_4,0.58,153,157,4,22
44,r_74_110_39,seq120,r_127_28_1,r_74_110_39,0.95,0,39,39,22
24,r_42_62_53,seq81,r_23_109_47,r_42_62_53,0.7,26,79,53,22
16,r_10_84_164,r_103_144_116,seq117,r_10_84_164,0.99,0,164,164,22
31,r_80_114_132,seq136,r_139_75_121,r_80_114_132,0.97,0,132,132,22
3,r_57_31_55,r_36_1_60,seq76,r_57_31_55,1,0,55,55,22
20,r_18_107_162,seq64,r_93_147_33,r_93_147_33,0.95,0,33,33,22
90,seq101,r_99_125_148,seq146,r_99_125_148,0.56,0,148,148,22
41,r_52_90_65,r_139_75_121,seq35,r_52_90_65,0.72,4,69,65,22
15,r_98_73_119,r_99_125_148,r_11_111_102,r_99_125_148,0.56,-29,119,148,22
26,r_17_128_110,seq35,seq87,r_17_128_110,0.97,0,110,110,22
16,r_10_84_164,seq76,r_103_144_116,r_103_144_116,1,25,141,116,22
12,r_122_15_51,seq35,seq141,r_122_15_51,1,0,51,51,22
78,seq70,r_96_104_100,r_46_66_11,r_96_104_100,0.98,-6,94,100,22
15,r_98_73_119,r_45_56_83,r_99_125_148,r_45_56_83,0.92,0,83,83,22
4,r_82_119_187,r_115_22_45,r_122_15_51,r_122_15_51,0.73,136,187,51,22
57,seq12,seq37,r_55_72_149,r_55_72_149,0.86,0,149,149,22
74,seq61,seq135,r_94_34_34,r_94_34_34,1,4,38,34,22
6,r_55_72_149,seq124,seq12,r_55_72_149,0.85,0,149,149,22
16,r_10_84_164,r_82_119_187,seq76,r_10_84_164,0.6,-118,46,164,22
23,r_115_22_45,seq5,r_82_119_187,r_115_22_45,1,0,45,45,22
99,seq126,seq102,r_60_49_125,r_60_49_125,0.98,26,151,125,22
24,r_42_62_53,r_23_109_47,r_96_104_100,r_42_62_53,0.5,53,106,53,22
41,r_52_90_65,seq53,r_139_75_121,r_139_75_121,0.68,-75,46,121,22
40,r_11_111_102,r_52_90_65,r_20_58_18,r_11_111_102,0.49,-83,19,102,22
27,r_148_149_86,seq40,seq7,r_148_149_86,1,0,86,86,22
87,seq92,r_96_104_100,r_46_66_11,r_96_104_100,0.93,-6,94,100,22
22,r_36_1_60,r_55_72_149,r_25_91_139,r_36_1_60,0.93,70,130,60,22
42,r_95_116_54,r_82_119_187,seq76,r_95_116_54,0.53,-9,45,54,22
2,r_139_75_121,seq14,r_23_109_47,r_139_75_121,0.92,0,121,121,22
47,r_103_144_116,seq102,r_57_31_55,r_103_144_116,0.5,1,117,116,22
18,r_140_123_181,seq136,r_127_28_1,r_140_123_181,0.43,1,182,181,22
29,r_33_27_105,seq124,seq133,r_33_27_105,1,0,105,105,22
58,seq141,seq48,r_122_15_51,r_122_15_51,1,1,52,51,22
43,r_93_147_33,r_18_107_162,seq77,r_18_107_162,0.96,-3,159,162,22
33,r_60_49_125,seq146,seq102,r_60_49_125,0.9,0,125,125,22
64,seq133,r_16_38_154,r_33_27_105,r_33_27_105,0.9,36,141,105,22
30,r_127_28_1,seq70,r_74_110_39,r_74_110_39,0.73,0,39,39,22
37,r_4_67_38,r_78_59_81,seq124,r_4_67_38,0.99,0,38,38,22
20,r_18_107_162,r_93_147_33,seq76,r_18_107_162,0.61,0,162,162,22
42,r_95_116_54,r_82_119_187,r_18_107_162,r_95_116_54,0.85,115,169,54,22
40,r_11_111_102,r_55_72_149,r_98_73_119,r_11_111_102,0.9,17,119,102,22
38,r_112_19_142,seq86,seq146,r_112_19_142,0.71,1,143,142,22
25,r_46_66_11,r_82_119_187,seq92,r_46_66_11,0.98,0,11,11,22
4,r_82_119_187,seq120,r_115_22_45,r_115_22_45,1,9,54,45,22
48,r_24_32_43,r_13_131_182,seq108,r_24_32_43,0.82,1,44,43,22
2,r_139_75_121,r_23_109_47,r_130_50_126,r_23_109_47,0.77,123,170,47,22
84,seq86,seq117,r_8_129_31,r_8_129_31,1,5,36,31,22
17,r_121_68_124,seq146,seq97,r_121_68_124,0.95,0,124,124,22
24,r_42_62_53,seq2,seq81,r_42_62_53,0.81,1,54,53,22
22,r_36_1_60,r_57_31_55,r_55_72_149,r_57_31_55,0.98,7,62,55,22
28,r_44_143_175,seq124,r_25_91_139,r_25_91_139,0.71,37,176,139,22
47,r_103_144_116,r_57_31_55,seq135,r_103_144_116,0.5,14,130,116,22
49,r_89_3_94,seq87,r_20_58_18,r_89_3_94,0.92,0,94,94,22
34,r_51_9_35,r_57_31_55,seq136,r_51_9_35,0.99,0,35,35,22
43,r_93_147_33,r_55_72_149,r_18_107_162,r_93_147_33,1,0,33,33,22
91,seq102,seq126,r_60_49_125,r_60_49_125,0.67,22,147,125,22
9,r_20_58_18,r_4_67_38,r_11_111_102,r_20_58_18,0.91,0,18,18,22
35,r_69_29_118,seq26,seq136,r_69_29_118,0.98,1,119,118,22
93,seq147,r_77_17_113,seq93,r_77_17_113,0.99,-1,112,113,23
40,r_83_87_140,r_2_68_61,seq135,r_83_87_140,1,0,140,140,23
30,r_47_25_75,seq36,seq106,r_47_25_75,0.99,0,75,75,23
44,r_14_38_158,r_112_113_21,seq4,r_14_38_158,0.75,0,158,158,23
92,seq111,r_33_105_116,r_44_64_3,r_33_105_116,1,3,119,116,23
8,r_53_101_197,r_13_145_107,seq132,r_13_145_107,1,-1,106,107,23
14,r_143_109_167,seq4,seq36,r_143_109_167,0.8,2,169,167,23
43,r_139_8_19,r_149_110_182,r_31_48_173,r_31_48_173,0.75,9,182,173,23
0,r_51_97_74,r_40_131_133,seq132,r_40_131_133,1,0,133,133,23
54,seq5,seq119,r_9_108_114,r_9_108_114,1,11,125,114,23
37,r_40_131_133,seq132,r_51_97_74,r_51_97_74,0.93,11,85,74,23
55,seq134,r_82_63_162,seq117,r_82_63_162,0.79,0,162,162,23
86,seq96,r_125_85_160,r_44_64_3,r_44_64_3,0.53,157,160,3,23
39,r_27_7_101,seq36,seq117,r_27_7_101,0.99,2,103,101,23
1,r_112_113_21,r_14_38_158,r_56_80_121,r_56_80_121,0.94,37,158,121,23
5,r_21_37_163,seq106,seq111,r_21_37_163,0.82,0,163,163,23
42,r_86_130_154,seq72,seq124,r_86_130_154,0.96,0,154,154,23
45,r_104_35_57,r_128_114_89,seq39,r_128_114_89,1,1,90,89,23
83,seq93,r_60_45_53,seq147,r_60_45_53,0.95,-28,25,53,23
95,seq118,r_121_52_119,r_116_1_30,r_116_1_30,0.99,-5,25,30,23
19,r_33_105_116,seq111,seq118,r_33_105_116,0.96,1,117,116,23
1,r_112_113_21,r_116_1_30,r_14_38_158,r_112_113_21,1,-2,19,21,23
11,r_32_42_2,r_67_46_24,r_77_17_113,r_77_17_113,1,1,114,113,23
49,r_60_45_53,r_2_68_61,seq62,r_60_45_53,1,0,53,53,23
66,seq132,r_40_131_133,r_53_101_197,r_40_131_133,1,-23,110,133,23
76,seq70,r_137_10_143,seq132,r_137_10_143,0.82,4,147,143,23
31,r_67_46_24,r_14_38_158,r_32_42_2,r_67_46_24,0.9,2,26,24,23
89,seq102,r_9_108_114,seq36,r_9_108_114,0.92,1,115,114,23
11,r_32_42_2,seq81,r_67_46_24,r_67_46_24,0.96,3,27,24,23
3,r_84_142_92,r_83_87_140,r_32_42_2,r_84_142_92,1,1,93,92,23
44,r_14_38_158,r_67_46_24,r_112_113_21,r_14_38_158,0.99,-139,19,158,23
25,r_79_71_39,seq111,r_138_123_104,r_79_71_39,0.97,0,39,39,23
14,r_143_109_167,seq92,r_149_110_182,r_143_109_167,0.46,-82,85,167,23
4,r_69_140_176,seq29,r_133_146_68,r_133_146_68,0.94,108,176,68,23
52,seq3,r_120_89_55,r_104_35_57,r_120_89_55,0.57,0,55,55,23
0,r_51_97_74,seq70,r_40_131_133,r_51_97_74,1,0,74,74,23
63,seq148,seq0,r_121_52_119,r_121_52_119,1,4,123,119,23
73,seq50,seq91,r_66_55_152,r_66_55_152,0.86,0,152,152,23
98,seq126,r_31_48_173,r_2_68_61,r_2_68_61,1,112,173,61,23
15,r_77_17_113,seq147,r_32_42_2,r_77_17_113,0.84,0,113,113,23
48,r_31_48_173,seq126,r_139_8_19,r_139_8_19,0.71,154,173,19,23
34,r_120_89_55,seq3,seq19,r_120_89_55,1,0,55,55,23
6,r_88_90_70,r_125_85_160,seq94,r_88_90_70,0.48,-1,69,70,23
62,seq19,r_28_58_165,r_120_89_55,r_120_89_55,1,110,165,55,23
46,r_133_146_68,seq11,seq43,r_133_146_68,0.55,-17,51,68,23
13,r_59_6_29,seq141,seq26,r_59_6_29,0.97,0,29,29,23
87,seq98,seq11,r_20_99_94,r_20_99_94,1,1,95,94,23
79,seq76,seq81,r_28_58_165,r_28_58_165,0.7,8,173,165,23
37,r_40_131_133,r_51_97_74,seq4,r_40_131_133,1,0,133,133,23
2,r_9_108_114,seq102,seq5,r_9_108_114,0.95,0,114,114,23
47,r_128_114_89,r_104_35_57,r_78_73_142,r_128_114_89,0.98,0,89,89,23
67,seq26,seq106,r_59_6_29,r_59_6_29,0.95,0,29,29,23
40,r_83_87_140,seq141,r_2_68_61,r_2_68_61,1,13,74,61,23
18,r_13_145_107,r_53_101_197,r_116_1_30,r_13_145_107,1,-1,106,107,23
29,r_41_34_98,seq148,seq106,r_41_34_98,0.98,3,101,98,23
92,seq111,r_44_64_3,r_21_37_163,r_21_37_163,1,-2,161,163,23
24,r_125_85_160,seq96,seq5,r_125_85_160,0.58,0,160,160,23
27,r_49_115_49,r_40_131_133,seq29,r_49_115_49,0.99,1,50,49,23
10,r_122_57_22,r_107_65_196,seq124,r_122_57_22,0.98,0,22,22,23
33,r_61_23_84,seq22,seq100,r_61_23_84,1,1,85,84,23
70,seq36,r_78_73_142,seq102,r_78_73_142,0.98,1,143,142,23
64,seq22,r_61_23_84,seq126,r_61_23_84,1,2,86,84,23
70,seq36,r_47_25_75,r_78_73_142,r_47_25_75,1,-4,71,75,23
65,seq24,r_44_64_3,r_133_146_68,r_133_146_68,1,0,68,68,23
20,r_18_74_10,seq98,seq11,r_18_74_10,0.72,158,168,10,23
68,seq29,r_69_140_176,r_49_115_49,r_49_115_49,0.92,127,176,49,23
14,r_143_109_167,r_18_74_10,seq92,r_18_74_10,0.87,0,10,10,23
77,seq72,r_86_130_154,r_60_45_53,r_60_45_53,0.91,101,154,53,23
75,seq62,seq72,r_60_45_53,r_60_45_53,1,30,83,53,23
26,r_149_110_182,r_15_16_97,r_139_8_19,r_139_8_19,0.6,3,22,19,23
9,r_116_1_30,r_21_37_163,seq118,r_116_1_30,1,0,30,30,23
46,r_133_146_68,seq43,seq24,r_133_146_68,0.59,-5,63,68,23
60,seq141,r_83_87_140,r_2_68_61,r_2_68_61,0.65,10,71,61,23
17,r_20_99_94,seq106,seq98,r_20_99_94,1,0,94,94,23
25,r_79_71_39,r_138_123_104,r_18_74_10,r_79_71_39,0.8,60,99,39,23
26,r_149_110_182,r_139_8_19,r_56_80_121,r_149_110_182,0.49,0,182,182,23
16,r_138_123_104,r_79_71_39,seq76,r_138_123_104,0.97,-4,100,104,23
28,r_78_73_142,seq36,r_128_114_89,r_78_73_142,0.9,1,143,142,23
91,seq106,r_21_37_163,r_47_25_75,r_47_25_75,0.91,88,163,75,23
35,r_15_16_97,r_121_52_119,r_13_145_107,r_121_52_119,1,3,122,119,23
14,r_143_109_167,r_149_110_182,seq4,r_143_109_167,0.34,-49,118,167,23
7,r_82_63_162,seq134,seq3,r_82_63_162,0.65,0,162,162,23
20,r_18_74_10,r_143_109_167,seq98,r_18_74_10,1,0,10,10,23
35,r_15_16_97,seq92,r_121_52_119,r_15_16_97,0.96,0,97,97,23
95,seq118,r_116_1_30,r_33_105_116,r_33_105_116,1,11,127,116,23
84,seq94,seq117,r_88_90_70,r_88_90_70,1,0,70,70,23
93,seq112,r_18_95_118,r_142_146_164,r_18_95_118,0.96,-43,75,118,24
51,seq1,r_5_65_113,r_63_104_18,r_5_65_113,0.74,-1,112,113,24
36,r_48_145_97,seq34,seq44,r_48_145_97,0.99,0,97,97,24
6,r_96_124_74,seq15,r_55_42_134,r_55_42_134,1,-3,131,134,24
14,r_133_10_170,seq57,r_51_27_37,r_133_10_170,0.65,0,170,170,24
8,r_131_36_183,seq44,r_54_4_117,r_131_36_183,0.49,0,183,183,24
43,r_32_64_72,seq93,r_14_132_19,r_32_64_72,0.98,0,72,72,24
86,seq93,r_23_53_29,r_90_83_139,r_90_83_139,0.95,0,139,139,24
83,seq87,r_18_95_118,r_142_146_164,r_18_95_118,1,0,118,118,24
37,r_18_95_118,seq87,seq86,r_18_95_118,0.98,0,118,118,24
40,r_126_46_14,r_39_97_181,r_94_107_15,r_126_46_14,0.95,1,15,14,24
86,seq93,r_32_64_72,r_23_53_29,r_32_64_72,0.77,0,72,72,24
16,r_5_65_113,seq1,r_81_62_6,r_5_65_113,0.98,-1,112,113,24
39,r_68_17_132,seq40,seq123,r_68_17_132,0.98,2,134,132,24
1,r_3_61_128,seq141,seq120,r_3_61_128,0.8,0,128,128,24
97,seq120,r_89_129_169,r_3_61_128,r_3_61_128,0.76,39,167,128,24
5,r_90_83_139,seq130,seq93,r_90_83_139,0.68,1,140,139,24
33,r_142_146_164,seq87,r_81_62_6,r_142_146_164,1,0,164,164,24
80,seq141,r_3_61_128,seq109,r_3_61_128,1,1,129,128,24
32,r_37_29_161,r_9_111_17,r_39_97_181,r_37_29_161,0.94,0,161,161,24
69,seq45,seq16,r_92_117_24,r_92_117_24,1,82,106,24,24
24,r_63_104_18,seq73,r_143_26_121,r_63_104_18,1,0,18,18,24
24,r_63_104_18,r_143_26_121,seq1,r_143_26_121,0.94,1,122,121,24
30,r_59_8_159,r_72_140_58,seq34,r_72_140_58,0.95,1,59,58,24
11,r_74_100_180,r_126_46_14,seq98,r_74_100_180,0.52,0,180,180,24
17,r_143_26_121,seq76,r_63_104_18,r_63_104_18,1,2,20,18,24
31,r_66_103_83,seq15,r_23_53_29,r_23_53_29,0.5,54,83,29,24
46,r_9_111_17,r_133_10_170,r_37_29_161,r_9_111_17,1,0,17,17,24
92,seq109,r_3_61_128,r_14_132_19,r_14_132_19,0.53,3,22,19,24
26,r_54_4_117,seq86,seq123,r_54_4_117,0.79,0,117,117,24
72,seq56,seq13,r_12_108_80,r_12_108_80,1,88,168,80,24
60,seq30,seq130,r_138_75_30,r_138_75_30,1,0,30,30,24
4,r_77_22_92,seq135,seq24,r_77_22_92,1,0,92,92,24
78,seq79,r_11_49_168,seq41,r_11_49_168,0.78,-51,117,168,24
0,r_12_108_80,seq45,seq56,r_12_108_80,1,0,80,80,24
63,seq35,seq70,r_143_26_121,r_143_26_121,0.68,43,164,121,24
11,r_74_100_180,r_148_110_156,r_126_46_14,r_126_46_14,0.99,0,14,14,24
12,r_82_149_66,r_74_100_180,r_23_53_29,r_23_53_29,1,0,29,29,24
99,seq123,seq130,r_68_17_132,r_68_17_132,1,3,135,132,24
79,seq80,r_92_117_24,r_33_88_64,r_92_117_24,0.87,0,24,24,24
20,r_39_97_181,seq101,r_37_29_161,r_37_29_161,0.85,2,163,161,24
98,seq121,seq115,r_143_26_121,r_143_26_121,0.89,12,133,121,24
46,r_9_111_17,r_37_29_161,r_20_58_78,r_20_58_78,0.96,83,161,78,24
32,r_37_29_161,seq35,r_9_111_17,r_9_111_17,0.74,1,18,17,24
15,r_89_129_169,seq120,seq80,r_89_129_169,0.74,1,170,169,24
57,seq147,seq15,r_82_149_66,r_82_149_66,0.85,2,68,66,24
90,seq101,seq71,r_51_27_37,r_51_27_37,1,2,39,37,24
6,r_96_124_74,r_32_64_72,seq15,r_32_64_72,0.82,-3,69,72,24
62,seq34,r_48_145_97,r_59_8_159,r_48_145_97,1,-1,96,97,24
21,r_127_78_158,r_134_114_7,r_96_124_74,r_127_78_158,0.88,1,159,158,24
83,seq87,r_142_146_164,seq112,r_142_146_164,0.99,-5,159,164,24
85,seq135,r_77_22_92,seq47,r_77_22_92,0.71,2,94,92,24
29,r_23_53_29,r_122_118_67,r_82_149_66,r_23_53_29,1,0,29,29,24
29,r_23_53_29,r_82_149_66,r_122_118_67,r_122_118_67,0.85,1,68,67,24
12,r_82_149_66,r_23_53_29,seq147,r_82_149_66,0.93,2,68,66,24
27,r_67_60_154,seq101,seq86,r_67_60_154,0.82,0,154,154,24
30,r_59_8_159,seq34,r_51_27_37,r_51_27_37,0.91,101,138,37,24
87,seq130,seq30,r_139_69_160,r_139_69_160,1,0,160,160,24
2,r_148_110_156,seq40,seq24,r_148_110_156,0.56,4,160,156,24
93,seq112,r_142_146_164,seq87,r_142_146_164,1,0,164,164,24
18,r_139_69_160,seq15,r_138_75_30,r_139_69_160,0.71,0,160,160,24
7,r_122_118_67,r_23_53_29,seq144,r_23_53_29,0.51,-1,28,29,24
82,seq86,seq109,r_14_132_19,r_14_132_19,0.92,18,37,19,24
35,r_20_58_78,r_37_29_161,r_9_111_17,r_37_29_161,1,0,161,161,24
33,r_142_146_164,r_18_95_118,seq87,r_18_95_118,1,0,118,118,24
13,r_14_132_19,seq15,seq86,r_14_132_19,1,0,19,19,24
59,seq24,seq7,r_77_22_92,r_77_22_92,0.98,8,100,92,24
34,r_33_88_64,r_90_83_139,seq31,r_33_88_64,0.54,11,75,64,24
50,seq128,seq45,r_102_136_112,r_102_136_112,0.82,1,113,112,24
65,seq40,r_148_110_156,r_116_106_48,r_116_106_48,0.87,30,78,48,24
21,r_127_78_158,r_133_10_170,r_134_114_7,r_134_114_7,0.98,4,11,7,24
68,seq44,r_131_36_183,r_48_145_97,r_48_145_97,1,44,141,97,24
61,seq31,r_0_25_153,r_33_88_64,r_33_88_64,0.95,60,124,64,24
38,r_55_42_134,seq7,r_96_124_74,r_55_42_134,0.99,-1,133,134,24
45,r_50_6_36,r_67_60_154,seq15,r_50_6_36,0.9,2,38,36,24
34,r_33_88_64,seq80,r_90_83_139,r_33_88_64,0.74,0,64,64,24
41,r_125_137_39,r_18_95_118,seq144,r_125_137_39,1,0,39,39,24
44,r_116_106_48,seq123,seq40,r_116_106_48,1,1,49,48,24
85,seq135,seq47,r_0_25_153,r_0_25_153,1,0,153,153,24
9,r_138_75_30,seq105,seq30,r_138_75_30,1,0,30,30,24
47,r_72_140_58,r_59_8_159,seq101,r_72_140_58,0.37,1,59,58,24
91,seq105,r_11_49_168,seq120,r_11_49_168,0.93,-22,146,168,24
22,r_51_27_37,seq80,seq101,r_51_27_37,1,0,37,37,24
49,r_0_25_153,seq31,seq135,r_0_25_153,0.84,0,153,153,24
3,r_99_85_56,seq21,seq71,r_99_85_56,0.99,0,56,56,24
17,r_143_26_121,r_63_104_18,seq121,r_143_26_121,1,1,122,121,24
10,r_92_117_24,seq80,seq45,r_92_117_24,1,0,24,24,24
29,r_23_53_29,r_122_118_67,r_66_103_83,r_23_53_29,0.68,71,100,29,24
35,r_20_58_78,seq2,r_37_29_161,r_20_58_78,0.99,0,78,78,24
23,r_134_114_7,r_127_78_158,seq43,r_127_78_158,0.97,1,159,158,24
93,seq105,r_79_61_94,r_96_66_163,r_79_61_94,0.89,-5,89,94,25
44,r_140_4_130,r_73_77_28,seq97,r_140_4_130,0.72,-7,123,130,25
8,r_60_98_48,r_67_55_157,r_117_48_126,r_60_98_48,0.92,0,48,48,25
36,r_63_74_91,r_99_120_182,seq51,r_63_74_91,0.92,0,91,91,25
17,r_147_53_47,seq35,seq25,r_147_53_47,1,0,47,47,25
14,r_43_146_108,seq89,seq3,r_43_146_108,0.99,1,109,108,25
37,r_26_141_93,r_57_5_172,r_6_102_95,r_26_141_93,1,0,93,93,25
59,seq17,r_143_80_144,r_130_118_175,r_143_80_144,0.66,-71,73,144,25
50,seq0,seq65,r_130_118_175,r_130_118_175,0.57,-106,69,175,25
21,r_36_131_168,r_8_47_114,r_79_61_94,r_36_131_168,0.99,-72,96,168,25
1,r_148_81_174,r_67_55_157,seq24,r_67_55_157,0.82,0,157,157,25
45,r_143_80_144,r_139_115_124,r_33_128_159,r_33_128_159,0.77,11,170,159,25
46,r_100_46_138,seq18,seq3,r_100_46_138,0.8,1,139,138,25
75,seq52,r_16_44_38,r_113_142_80,r_16_44_38,1,1,39,38,25
30,r_108_88_192,r_114_54_191,r_2_107_140,r_2_107_140,0.99,9,149,140,25
18,r_116_59_122,seq21,r_13_30_35,r_13_30_35,1,0,35,35,25
7,r_96_66_163,seq105,seq0,r_96_66_163,0.86,0,163,163,25
45,r_143_80_144,seq17,r_130_118_175,r_130_118_175,0.69,-102,73,175,25
47,r_49_38_107,r_138_122_155,r_82_32_41,r_138_122_155,1,0,155,155,25
32,r_22_124_188,r_116_59_122,seq45,r_22_124_188,0.79,2,190,188,25
39,r_2_107_140,r_99_120_182,r_16_44_38,r_16_44_38,0.58,5,43,38,25
41,r_13_30_35,seq119,seq97,r_13_30_35,0.57,131,166,35,25
44,r_140_4_130,seq21,r_73_77_28,r_73_77_28,1,6,34,28,25
11,r_84_69_14,seq0,seq136,r_84_69_14,0.86,1,15,14,25
39,r_2_107_140,r_16_44_38,r_139_115_124,r_139_115_124,0.98,1,125,124,25
89,seq95,seq83,r_113_142_80,r_113_142_80,1,5,85,80,25
15,r_11_149_19,r_22_124_188,r_82_32_41,r_11_149_19,1,1,20,19,25
3,r_34_68_116,seq110,seq136,r_34_68_116,0.9,4,120,116,25
27,r_39_111_31,seq0,seq25,r_39_111_31,1,0,31,31,25
49,r_90_58_26,seq10,r_15_112_46,r_15_112_46,0.95,3,49,46,25
26,r_106_37_109,seq51,seq65,r_106_37_109,1,0,109,109,25
16,r_16_44_38,r_2_107_140,r_139_115_124,r_16_44_38,0.96,102,140,38,25
78,seq65,seq14,r_106_37_109,r_106_37_109,1,0,109,109,25
0,r_67_55_157,r_148_81_174,r_2_107_140,r_67_55_157,0.77,0,157,157,25
20,r_99_120_182,seq31,r_117_48_126,r_99_120_182,0.51,0,182,182,25
13,r_7_127_83,seq20,seq123,r_7_127_83,1,0,83,83,25
48,r_82_32_41,r_138_122_155,r_11_149_19,r_11_149_19,0.76,10,29,19,25
8,r_60_98_48,r_108_88_192,r_8_47_114,r_8_47_114,0.82,10,124,114,25
30,r_108_88_192,r_13_30_35,r_84_69_14,r_108_88_192,0.76,-161,31,192,25
21,r_36_131_168,r_79_61_94,seq101,r_36_131_168,0.96,0,168,168,25
5,r_135_86_32,r_114_54_191,r_130_118_175,r_130_118_175,1,3,178,175,25
6,r_15_112_46,seq9,r_90_58_26,r_15_112_46,1,-1,45,46,25
4,r_114_54_191,seq132,r_135_86_32,r_135_86_32,0.91,0,32,32,25
5,r_135_86_32,r_2_107_140,r_114_54_191,r_135_86_32,0.92,0,32,32,25
16,r_16_44_38,seq52,r_2_107_140,r_16_44_38,0.63,1,39,38,25
2,r_8_47_114,r_36_131_168,r_60_98_48,r_36_131_168,1,-52,116,168,25
41,r_13_30_35,r_116_59_122,seq119,r_116_59_122,1,1,123,122,25
47,r_49_38_107,r_6_102_95,r_138_122_155,r_49_38_107,0.99,0,107,107,25
54,seq136,seq132,r_84_69_14,r_84_69_14,0.92,27,41,14,25
59,seq17,r_130_118_175,r_15_112_46,r_130_118_175,0.75,2,177,175,25
84,seq87,seq105,r_1_133_21,r_1_133_21,0.93,0,21,21,25
29,r_104_78_86,seq42,r_1_133_21,r_104_78_86,0.99,0,86,86,25
24,r_64_29_132,seq50,seq101,r_64_29_132,0.99,0,132,132,25
10,r_76_129_22,r_138_122_155,seq51,r_76_129_22,0.97,0,22,22,25
25,r_79_61_94,r_96_66_163,r_36_131_168,r_79_61_94,0.98,0,94,94,25
43,r_73_77_28,r_140_4_130,r_26_141_93,r_26_141_93,1,30,123,93,25
33,r_113_142_80,seq110,seq95,r_113_142_80,1,0,80,80,25
69,seq40,r_1_133_21,seq45,r_1_133_21,0.97,-1,20,21,25
88,seq94,r_33_128_159,seq17,r_33_128_159,0.93,0,159,159,25
6,r_15_112_46,r_90_58_26,seq17,r_15_112_46,0.16,135,181,46,25
50,seq0,r_130_118_175,r_96_66_163,r_96_66_163,0.84,0,163,163,25
38,r_91_23_115,seq70,r_6_102_95,r_91_23_115,0.98,0,115,115,25
41,r_13_30_35,r_108_88_192,r_116_59_122,r_13_30_35,1,0,35,35,25
34,r_85_12_165,seq35,seq134,r_85_12_165,0.38,1,166,165,25
50,seq0,r_39_111_31,seq65,r_39_111_31,0.86,0,31,31,25
39,r_2_107_140,r_139_115_124,r_108_88_192,r_2_107_140,0.74,0,140,140,25
60,seq18,r_100_46_138,seq136,r_100_46_138,0.92,1,139,138,25
45,r_143_80_144,r_130_118_175,r_139_115_124,r_143_80_144,0.99,1,145,144,25
31,r_117_48_126,seq27,r_113_142_80,r_117_48_126,0.98,0,126,126,25
25,r_79_61_94,r_36_131_168,r_85_12_165,r_79_61_94,0.78,73,167,94,25
94,seq109,seq35,r_126_41_88,r_126_41_88,1,0,88,88,25
9,r_57_5_172,seq72,seq110,r_57_5_172,0.85,1,173,172,25
8,r_60_98_48,r_117_48_126,r_108_88_192,r_60_98_48,0.61,21,69,48,25
1,r_148_81_174,seq24,seq50,r_148_81_174,0.85,1,175,174,25
30,r_108_88_192,r_84_69_14,r_114_54_191,r_114_54_191,0.4,-111,80,191,25
35,r_139_115_124,r_2_107_140,r_16_44_38,r_2_107_140,0.93,0,140,140,25
75,seq52,r_113_142_80,seq121,r_113_142_80,0.8,4,84,80,25
22,r_130_118_175,seq17,r_135_86_32,r_135_86_32,0.66,145,177,32,25
28,r_6_102_95,r_49_38_107,r_26_141_93,r_6_102_95,1,0,95,95,25
91,seq101,seq121,r_64_29_132,r_64_29_132,1,7,139,132,25
7,r_96_66_163,r_79_61_94,seq105,r_79_61_94,0.82,0,94,94,25
18,r_116_59_122,r_13_30_35,r_22_124_188,r_116_59_122,1,1,123,122,25
23,r_138_122_155,r_82_32_41,r_49_38_107,r_49_38_107,1,1,108,107,25
79,seq70,r_91_23_115,seq45,r_91_23_115,0.93,0,115,115,25
35,r_139_115_124,seq110,r_2_107_140,r_139_115_124,0.35,0,124,124,25
43,r_73_77_28,r_139_115_124,r_140_4_130,r_73_77_28,1,0,28,28,25
12,r_126_41_88,seq24,seq109,r_126_41_88,0.99,0,88,88,25
19,r_1_133_21,seq40,seq87,r_1_133_21,1,0,21,21,25
23,r_138_122_155,r_49_38_107,seq51,r_138_122_155,1,0,155,155,25
51,seq1,r_104_48_158,r_147_12_52,r_147_12_52,0.98,109,161,52,26
36,r_5_61_152,r_43_136_76,r_110_73_4,r_5_61_152,0.98,-76,76,152,26
49,r_147_12_52,r_138_63_28,r_104_48_158,r_147_12_52,0.98,0,52,52,26
37,r_75_107_60,seq66,seq93,r_75_107_60,1,0,60,60,26
87,seq92,r_7_133_74,r_104_48_158,r_7_133_74,0.75,-22,52,74,26
86,seq88,seq14,r_141_95_137,r_141_95_137,1,12,149,137,26
39,r_57_28_133,seq135,seq59,r_57_28_133,0.52,0,133,133,26
15,r_67_83_101,seq38,r_106_89_37,r_67_83_101,0.99,0,101,101,26
16,r_85_64_44,r_79_126_56,seq72,r_85_64_44,1,0,44,44,26
46,r_34_10_187,r_69_80_77,seq18,r_69_80_77,1,0,77,77,26
12,r_82_29_190,r_102_46_66,r_76_33_126,r_82_29_190,0.46,-40,150,190,26
87,seq92,r_104_48_158,r_146_125_87,r_146_125_87,1,5,92,87,26
14,r_119_74_45,r_67_83_101,seq122,r_119_74_45,0.57,1,46,45,26
69,seq37,r_26_6_184,r_98_91_140,r_98_91_140,0.91,5,145,140,26
45,r_47_101_142,seq68,r_54_143_192,r_47_101_142,0.85,0,142,142,26
34,r_138_63_28,r_75_107_60,r_147_12_52,r_138_63_28,0.67,1,29,28,26
24,r_76_33_126,r_82_29_190,seq22,r_82_29_190,0.63,0,190,190,26
19,r_98_91_140,r_82_29_190,seq37,r_98_91_140,0.78,0,140,140,26
27,r_127_20_16,seq31,r_106_89_37,r_127_20_16,0.64,22,38,16,26
34,r_138_63_28,r_147_12_52,r_100_130_24,r_147_12_52,1,0,52,52,26
66,seq24,r_102_46_66,r_69_80_77,r_69_80_77,0.96,11,88,77,26
31,r_69_80_77,r_34_10_187,seq24,r_69_80_77,1,0,77,77,26
41,r_104_48_158,seq1,r_71_105_57,r_104_48_158,0.63,0,158,158,26
27,r_127_20_16,r_129_86_160,seq31,r_127_20_16,0.8,1,17,16,26
3,r_120_30_83,r_11_2_179,seq122,r_120_30_83,1,1,84,83,26
10,r_35_142_181,seq15,r_110_73_4,r_110_73_4,0.55,177,181,4,26
54,seq135,r_79_126_56,seq108,r_79_126_56,1,0,56,56,26
72,seq41,seq114,r_13_123_93,r_13_123_93,1,2,95,93,26
4,r_102_46_66,seq24,r_27_3_51,r_27_3_51,1,22,73,51,26
78,seq59,r_11_2_179,r_57_28_133,r_57_28_133,1,46,179,133,26
63,seq21,seq53,r_4_97_68,r_4_97_68,1,18,86,68,26
11,r_4_97_68,seq135,seq21,r_4_97_68,1,0,68,68,26
20,r_16_55_108,seq108,seq19,r_16_55_108,0.78,0,108,108,26
13,r_129_86_160,r_32_118_145,seq115,r_32_118_145,0.48,0,145,145,26
62,seq19,r_139_148_178,r_16_55_108,r_16_55_108,0.75,70,178,108,26
85,seq87,seq149,r_62_90_155,r_62_90_155,1,1,156,155,26
29,r_134_84_107,r_36_116_26,r_102_46_66,r_36_116_26,0.76,3,29,26,26
42,r_100_130_24,r_11_2_179,r_44_56_172,r_100_130_24,0.99,0,24,24,26
8,r_36_116_26,r_134_84_107,seq0,r_36_116_26,1,2,28,26,26
49,r_147_12_52,r_44_56_172,r_138_63_28,r_138_63_28,0.9,0,28,28,26
92,seq111,seq137,r_51_113_15,r_51_113_15,0.72,19,34,15,26
98,seq124,r_129_86_160,r_144_78_198,r_129_86_160,0.66,-139,21,160,26
22,r_44_56_172,r_100_130_24,r_45_50_148,r_44_56_172,0.53,1,173,172,26
47,r_43_136_76,r_5_61_152,seq131,r_43_136_76,0.9,0,76,76,26
40,r_32_118_145,r_129_86_160,seq145,r_32_118_145,0.97,0,145,145,26
18,r_146_125_87,seq72,seq92,r_146_125_87,1,0,87,87,26
35,r_71_105_57,r_67_83_101,seq66,r_71_105_57,1,0,57,57,26
33,r_54_143_192,seq0,r_47_101_142,r_47_101_142,0.89,8,150,142,26
48,r_110_73_4,r_26_6_184,seq23,r_110_73_4,0.37,106,110,4,26
90,seq145,seq0,r_32_118_145,r_32_118_145,0.75,1,146,145,26
7,r_70_58_23,r_76_33_126,seq0,r_70_58_23,0.99,0,23,23,26
88,seq93,seq49,r_75_107_60,r_75_107_60,1,1,61,60,26
70,seq38,r_94_99_166,r_119_74_45,r_94_99_166,0.54,1,167,166,26
15,r_67_83_101,r_71_105_57,seq38,r_71_105_57,1,0,57,57,26
6,r_27_3_51,r_102_46_66,r_94_99_166,r_27_3_51,0.48,129,180,51,26
25,r_112_8_42,seq66,r_7_133_74,r_7_133_74,1,1,75,74,26
12,r_82_29_190,r_76_33_126,seq0,r_82_29_190,0.67,0,190,190,26
38,r_141_95_137,r_109_103_146,seq88,r_141_95_137,0.97,0,137,137,26
25,r_112_8_42,seq149,seq66,r_112_8_42,0.96,0,42,42,26
6,r_27_3_51,r_39_81_183,r_102_46_66,r_27_3_51,1,0,51,51,26
60,seq17,r_71_105_57,r_7_133_74,r_7_133_74,0.98,8,82,74,26
94,seq115,r_129_86_160,seq60,r_129_86_160,0.65,-1,159,160,26
0,r_106_89_37,r_141_95_137,r_127_20_16,r_106_89_37,0.99,0,37,37,26
9,r_7_133_74,seq92,r_112_8_42,r_7_133_74,0.98,0,74,74,26
96,seq121,r_39_81_183,r_45_50_148,r_45_50_148,0.96,35,183,148,26
29,r_134_84_107,r_102_46_66,r_146_125_87,r_134_84_107,0.92,0,107,107,26
28,r_45_50_148,seq128,seq121,r_45_50_148,0.95,0,148,148,26
91,seq108,r_16_55_108,seq18,r_16_55_108,1,-8,100,108,26
44,r_62_90_155,r_39_81_183,seq87,r_62_90_155,0.94,0,155,155,26
32,r_79_126_56,seq135,seq68,r_79_126_56,1,0,56,56,26
13,r_129_86_160,seq115,r_110_73_4,r_129_86_160,0.47,0,160,160,26
49,r_147_12_52,r_104_48_158,r_11_2_179,r_104_48_158,0.89,1,159,158,26
82,seq68,r_47_101_142,seq131,r_47_101_142,0.85,0,142,142,26
22,r_44_56_172,r_147_12_52,r_100_130_24,r_44_56_172,0.85,-149,23,172,26
12,r_82_29_190,r_98_91_140,r_102_46_66,r_102_46_66,0.62,72,138,66,26
97,seq122,r_94_99_166,r_119_74_45,r_119_74_45,0.8,1,46,45,26
7,r_126_42_18,seq91,seq6,r_126_42_18,0.87,0,18,18,27
30,r_94_18_172,seq135,r_147_144_70,r_94_18_172,0.81,0,172,172,27
51,seq2,r_146_67_61,r_13_119_82,r_146_67_61,1,1,62,61,27
36,r_75_12_106,seq69,seq100,r_75_12_106,0.99,0,106,106,27
14,r_114_61_124,seq4,r_110_85_37,r_114_61_124,0.99,0,124,124,27
43,r_149_37_84,seq25,seq33,r_149_37_84,1,1,85,84,27
83,seq84,seq92,r_57_136_164,r_57_136_164,0.51,13,177,164,27
46,r_35_1_24,r_103_78_86,seq148,r_35_1_24,0.99,1,25,24,27
1,r_97_46_126,r_110_85_37,seq34,r_97_46_126,1,1,127,126,27
5,r_8_134_159,seq29,seq9,r_8_134_159,0.61,0,159,159,27
42,r_146_67_61,seq2,r_24_133_117,r_146_67_61,1,0,61,61,27
33,r_125_140_31,seq50,seq25,r_125_140_31,0.38,1,32,31,27
15,r_103_78_86,r_28_95_111,r_71_86_55,r_71_86_55,0.94,3,58,55,27
34,r_102_45_49,r_114_61_124,r_74_3_107,r_102_45_49,1,0,49,49,27
24,r_38_109_190,r_70_88_65,r_74_3_107,r_74_3_107,0.97,81,188,107,27
19,r_118_65_182,seq23,r_41_138_130,r_118_65_182,0.44,0,182,182,27
99,seq127,seq72,r_15_10_52,r_15_10_52,0.93,0,52,52,27
1,r_97_46_126,r_129_44_198,r_110_85_37,r_110_85_37,0.93,10,47,37,27
35,r_28_95_111,r_103_78_86,seq9,r_103_78_86,0.78,-28,58,86,27
31,r_111_145_120,seq83,seq60,r_111_145_120,1,0,120,120,27
41,r_0_5_156,seq148,r_80_122_97,r_80_122_97,0.97,59,156,97,27
42,r_146_67_61,r_24_133_117,seq132,r_24_133_117,0.99,0,117,117,27
39,r_48_14_17,r_93_115_174,seq4,r_48_14_17,0.89,0,17,17,27
3,r_81_31_145,seq135,seq132,r_81_31_145,0.97,0,145,145,27
10,r_70_88_65,seq107,r_82_54_132,r_70_88_65,1,0,65,65,27
48,r_71_86_55,r_114_61_124,r_103_78_86,r_71_86_55,1,0,55,55,27
16,r_76_16_40,r_93_115_174,r_56_64_109,r_56_64_109,1,59,168,109,27
18,r_15_10_52,r_57_136_164,seq127,r_15_10_52,1,0,52,52,27
35,r_28_95_111,seq9,seq128,r_28_95_111,1,-3,108,111,27
57,seq11,r_89_142_194,r_53_49_8,r_89_142_194,0.77,-177,17,194,27
78,seq72,seq127,r_15_10_52,r_15_10_52,0.98,12,64,52,27
63,seq29,r_8_134_159,r_106_62_114,r_106_62_114,0.69,6,120,114,27
48,r_71_86_55,r_103_78_86,seq9,r_103_78_86,1,0,86,86,27
20,r_143_108_99,r_17_105_197,r_125_140_31,r_143_108_99,1,0,99,99,27
13,r_79_139_2,r_57_136_164,r_97_46_126,r_79_139_2,0.73,162,164,2,27
98,seq135,r_94_18_172,r_149_37_84,r_149_37_84,1,88,172,84,27
49,r_93_115_174,r_76_16_40,seq127,r_93_115_174,0.78,2,176,174,27
16,r_76_16_40,r_111_145_120,r_93_115_174,r_76_16_40,1,0,40,40,27
6,r_74_3_107,r_82_54_132,seq69,r_74_3_107,0.99,0,107,107,27
62,seq25,r_149_37_84,r_125_140_31,r_149_37_84,1,1,85,84,27
23,r_27_21_16,seq77,seq52,r_27_21_16,0.94,0,16,16,27
34,r_102_45_49,r_74_3_107,seq66,r_74_3_107,1,-4,103,107,27
10,r_70_88_65,r_82_54_132,r_38_109_190,r_82_54_132,0.97,1,133,132,27
27,r_24_133_117,r_106_62_114,r_146_67_61,r_146_67_61,1,2,63,61,27
87,seq100,r_32_36_176,r_75_12_106,r_75_12_106,0.93,70,176,106,27
91,seq112,r_41_138_130,r_15_10_52,r_41_138_130,0.79,2,132,130,27
44,r_82_54_132,r_70_88_65,seq4,r_82_54_132,1,1,133,132,27
2,r_56_64_109,r_17_105_197,r_76_16_40,r_56_64_109,0.85,0,109,109,27
21,r_59_51_59,seq92,seq83,r_59_51_59,0.99,0,59,59,27
47,r_41_138_130,seq112,r_17_105_197,r_17_105_197,0.65,-65,132,197,27
77,seq69,r_68_98_60,r_74_3_107,r_74_3_107,1,3,110,107,27
10,r_70_88_65,r_38_109_190,r_102_45_49,r_38_109_190,0.62,-25,165,190,27
97,seq123,seq7,r_20_124_45,r_20_124_45,1,10,55,45,27
29,r_68_98_60,r_17_105_197,seq69,r_68_98_60,0.99,0,60,60,27
27,r_24_133_117,r_146_67_61,r_20_124_45,r_24_133_117,1,1,118,117,27
24,r_38_109_190,seq30,r_70_88_65,r_70_88_65,1,4,69,65,27
25,r_106_62_114,seq50,seq29,r_106_62_114,0.99,0,114,114,27
50,seq128,r_90_137_6,r_28_95_111,r_28_95_111,1,1,112,111,27
61,seq23,r_118_65_182,r_75_12_106,r_75_12_106,0.86,76,182,106,27
32,r_96_19_175,seq22,r_125_140_31,r_96_19_175,0.39,0,175,175,27
38,r_110_85_37,r_97_46_126,r_114_61_124,r_110_85_37,0.52,90,127,37,27
77,seq69,r_75_12_106,r_68_98_60,r_68_98_60,1,18,78,60,27
28,r_20_124_45,seq112,seq123,r_20_124_45,1,0,45,45,27
9,r_80_122_97,seq33,r_103_78_86,r_80_122_97,0.99,0,97,97,27
28,r_20_124_45,seq123,r_24_133_117,r_24_133_117,1,22,139,117,27
22,r_57_136_164,seq34,seq84,r_57_136_164,0.74,0,164,164,27
49,r_93_115_174,seq116,r_76_16_40,r_76_16_40,0.84,20,60,40,27
74,seq60,seq9,r_118_65_182,r_118_65_182,0.56,-123,59,182,27
15,r_103_78_86,r_71_86_55,seq63,r_103_78_86,0.8,1,87,86,27
18,r_15_10_52,seq127,seq72,r_15_10_52,0.34,102,154,52,27
59,seq148,r_147_144_70,r_35_1_24,r_35_1_24,1,18,42,24,27
44,r_82_54_132,r_74_3_107,r_70_88_65,r_70_88_65,0.8,42,107,65,27
91,seq112,r_20_124_45,r_41_138_130,r_20_124_45,0.98,0,45,45,27
15,r_103_78_86,seq63,r_80_122_97,r_80_122_97,0.74,13,110,97,27
82,seq83,seq43,r_59_51_59,r_59_51_59,1,2,61,59,27
56,seq9,r_75_12_106,r_8_134_159,r_8_134_159,1,0,159,159,27
47,r_41_138_130,r_17_105_197,r_118_65_182,r_41_138_130,0.91,52,182,130,27
93,seq110,seq121,r_55_42_154,r_55_42_154,0.4,-6,148,154,28
30,r_12_9_97,r_25_141_143,r_2_86_69,r_12_9_97,0.99,0,97,97,28
58,seq10,r_7_14_101,r_13_115_172,r_13_115_172,0.75,0,172,172,28
51,seq128,r_55_42_154,seq81,r_55_42_154,0.98,1,155,154,28
36,r_43_99_168,seq101,r_41_108_131,r_41_108_131,0.66,0,131,131,28
95,seq112,r_11_135_40,seq64,r_11_135_40,0.98,1,41,40,28
41,r_83_107_6,r_95_37_136,r_30_79_32,r_83_107_6,0.47,30,36,6,28
14,r_17_62_183,seq128,r_20_33_53,r_20_33_53,0.99,130,183,53,28
20,r_59_140_102,r_41_108_131,r_106_114_158,r_41_108_131,0.98,-2,129,131,28
8,r_44_96_165,seq8,r_55_42_154,r_44_96_165,0.67,1,166,165,28
53,seq131,r_70_119_178,r_43_99_168,r_43_99_168,0.92,15,183,168,28
43,r_16_38_128,seq19,r_7_14_101,r_16_38_128,0.99,0,128,128,28
27,r_136_142_13,r_35_147_104,r_63_67_100,r_136_142_13,0.98,-1,12,13,28
37,r_70_119_178,seq131,r_11_135_40,r_70_119_178,0.32,3,181,178,28
3,r_4_82_18,seq39,r_25_141_143,r_25_141_143,0.96,4,147,143,28
10,r_133_118_31,r_35_147_104,seq34,r_133_118_31,0.83,0,31,31,28
28,r_106_114_158,r_59_140_102,r_26_29_50,r_106_114_158,0.82,0,158,158,28
55,seq134,r_25_141_143,seq126,r_25_141_143,0.94,0,143,143,28
86,seq91,r_13_115_172,r_144_69_117,r_144_69_117,0.48,-9,108,117,28
39,r_57_3_138,r_143_89_171,r_120_127_59,r_120_127_59,1,84,143,59,28
42,r_56_46_81,seq19,seq45,r_56_46_81,1,0,81,81,28
4,r_120_127_59,r_7_14_101,r_57_3_138,r_120_127_59,1,0,59,59,28
12,r_41_108_131,r_43_99_168,r_80_48_164,r_41_108_131,0.86,38,169,131,28
18,r_6_146_29,seq45,seq23,r_6_146_29,0.9,0,29,29,28
45,r_109_117_73,seq19,seq75,r_109_117_73,1,0,73,73,28
23,r_98_92_120,r_124_102_49,r_35_147_104,r_124_102_49,1,-5,44,49,28
19,r_2_86_69,r_35_147_104,seq18,r_2_86_69,1,0,69,69,28
33,r_149_24_46,r_53_47_166,seq139,r_149_24_46,0.83,120,166,46,28
9,r_144_69_117,r_55_42_154,r_28_90_135,r_144_69_117,0.66,28,145,117,28
12,r_41_108_131,r_85_1_96,r_43_99_168,r_41_108_131,1,0,131,131,28
27,r_136_142_13,r_63_67_100,seq93,r_63_67_100,0.93,-2,98,100,28
76,seq60,r_7_14_101,r_80_48_164,r_7_14_101,0.98,3,104,101,28
7,r_7_14_101,r_22_129_130,r_16_38_128,r_7_14_101,1,29,130,101,28
31,r_28_90_135,seq31,r_144_69_117,r_28_90_135,0.78,0,135,135,28
63,seq23,seq139,r_6_146_29,r_6_146_29,0.43,-1,28,29,28
3,r_4_82_18,r_72_138_72,seq39,r_4_82_18,0.99,0,18,18,28
72,seq51,seq66,r_83_107_6,r_83_107_6,0.53,137,143,6,28
48,r_77_32_52,r_120_127_59,seq66,r_77_32_52,0.97,0,52,52,28
33,r_149_24_46,r_72_138_72,r_53_47_166,r_149_24_46,1,2,48,46,28
0,r_53_47_166,r_149_24_46,r_106_114_158,r_106_114_158,0.41,8,166,158,28
17,r_85_1_96,r_41_108_131,r_59_140_102,r_41_108_131,0.89,0,131,131,28
20,r_59_140_102,seq73,r_41_108_131,r_41_108_131,0.34,-29,102,131,28
13,r_113_122_194,r_76_15_155,seq134,r_113_122_194,0.33,-6,188,194,28
20,r_59_140_102,r_106_114_158,r_85_1_96,r_106_114_158,0.84,1,159,158,28
98,seq125,r_94_5_145,seq93,r_94_5_145,1,-58,87,145,28
46,r_145_40_77,seq64,r_98_92_120,r_145_40_77,0.5,43,120,77,28
15,r_143_89_171,r_57_3_138,seq87,r_57_3_138,0.84,7,145,138,28
28,r_106_114_158,r_26_29_50,r_53_47_166,r_106_114_158,0.67,10,168,158,28
4,r_120_127_59,r_57_3_138,r_22_129_130,r_22_129_130,1,15,145,130,28
6,r_55_42_154,seq128,seq110,r_55_42_154,0.58,1,155,154,28
24,r_22_129_130,r_7_14_101,r_120_127_59,r_22_129_130,0.97,0,130,130,28
68,seq39,r_143_89_171,r_4_82_18,r_4_82_18,0.69,4,22,18,28
69,seq45,seq139,r_56_46_81,r_56_46_81,1,5,86,81,28
2,r_80_48_164,r_120_127_59,seq60,r_120_127_59,0.87,-15,44,59,28
49,r_116_97_54,seq130,seq0,r_116_97_54,0.99,0,54,54,28
40,r_72_138_72,r_70_119_178,r_68_78_57,r_70_119_178,0.66,-106,72,178,28
36,r_43_99_168,r_41_108_131,seq131,r_43_99_168,0.92,0,168,168,28
24,r_22_129_130,seq10,r_7_14_101,r_7_14_101,0.98,0,101,101,28
64,seq27,r_74_148_124,seq19,r_74_148_124,0.86,2,126,124,28
46,r_145_40_77,r_72_138_72,seq64,r_72_138_72,0.43,-15,57,72,28
58,seq10,r_22_129_130,r_7_14_101,r_7_14_101,0.66,29,130,101,28
70,seq49,seq66,r_20_33_53,r_20_33_53,1,59,112,53,28
21,r_11_135_40,seq112,r_70_119_178,r_11_135_40,0.8,-3,37,40,28
61,seq19,r_16_38_128,seq27,r_16_38_128,0.87,0,128,128,28
32,r_13_115_172,seq91,seq10,r_13_115_172,0.48,0,172,172,28
38,r_63_67_100,seq132,seq121,r_63_67_100,0.96,0,100,100,28
52,seq130,seq87,r_22_129_130,r_22_129_130,0.99,30,160,130,28
76,seq60,r_80_48_164,r_12_9_97,r_80_48_164,0.98,1,165,164,28
34,r_74_148_124,seq27,r_20_33_53,r_74_148_124,0.78,0,124,124,28
60,seq18,r_80_48_164,r_2_86_69,r_2_86_69,0.92,0,69,69,28
45,r_109_117_73,seq75,r_35_147_104,r_35_147_104,0.95,40,144,104,28
11,r_20_33_53,seq58,seq49,r_20_33_53,0.98,0,53,53,28
17,r_85_1_96,r_98_92_120,r_41_108_131,r_98_92_120,0.6,-24,96,120,28
9,r_144_69_117,seq121,r_55_42_154,r_144_69_117,0.92,0,117,117,28
96,seq121,r_144_69_117,seq21,r_144_69_117,1,0,117,117,28
22,r_35_147_104,r_98_92_120,r_109_117_73,r_35_147_104,0.94,0,104,104,28
28,r_106_114_158,r_41_108_131,r_59_140_102,r_59_140_102,0.77,10,112,102,28
1,r_68_78_57,seq50,seq73,r_68_78_57,1,0,57,57,28
56,seq8,r_44_96_165,r_20_33_53,r_20_33_53,0.95,112,165,53,28
7,r_7_14_101,seq60,r_22_129_130,r_7_14_101,0.83,0,101,101,28
44,r_25_141_143,seq134,r_4_82_18,r_25_141_143,0.91,0,143,143,28
26,r_30_79_32,seq10,seq123,r_30_79_32,1,0,32,32,28
82,seq75,seq54,r_109_117_73,r_109_117_73,1,0,73,73,28
16,r_124_102_49,r_98_92_120,seq93,r_124_102_49,1,0,49,49,28
12,r_41_108_131,r_106_114_158,r_85_1_96,r_85_1_96,0.86,3,99,96,28
30,r_112_28_60,seq32,seq55,r_112_28_60,1,0,60,60,29
36,r_91_19_104,r_1_76_175,r_33_24_147,r_91_19_104,0.86,0,104,104,29
14,r_144_43_196,r_115_62_159,r_44_42_81,r_44_42_81,0.98,16,97,81,29
43,r_46_146_66,r_139_111_164,r_29_57_161,r_46_146_66,0.93,0,66,66,29
38,r_6_108_25,r_27_17_78,r_16_92_7,r_6_108_25,1,0,25,25,29
10,r_101_149_91,seq142,r_67_4_183,r_101_149_91,0.86,4,95,91,29
54,seq8,r_143_26_186,seq22,r_143_26_186,0.62,0,186,186,29
37,r_87_148_139,r_29_57_161,seq32,r_87_148_139,0.99,0,139,139,29
3,r_79_103_190,r_144_43_196,seq145,r_144_43_196,0.49,-6,190,196,29
59,seq145,r_80_132_65,r_101_149_91,r_80_132_65,0.96,5,70,65,29
71,seq49,r_29_57_161,r_33_24_147,r_33_24_147,0.77,21,168,147,29
16,r_33_24_147,r_7_104_88,r_91_19_104,r_91_19_104,0.47,0,104,104,29
21,r_13_96_80,seq100,r_125_14_128,r_13_96_80,0.84,-1,79,80,29
39,r_56_50_92,seq73,seq60,r_56_50_92,0.99,0,92,92,29
1,r_67_4_183,seq145,r_101_149_91,r_67_4_183,0.54,-115,68,183,29
42,r_115_62_159,r_144_43_196,r_112_28_60,r_115_62_159,0.74,1,160,159,29
10,r_101_149_91,r_99_34_18,seq23,r_99_34_18,0.59,0,18,18,29
45,r_74_10_178,r_63_127_140,r_25_82_37,r_25_82_37,1,56,93,37,29
24,r_121_11_94,r_1_76_175,seq147,r_1_76_175,0.96,0,175,175,29
19,r_141_86_112,seq53,r_74_10_178,r_141_86_112,0.83,0,112,112,29
31,r_80_132_65,seq145,seq147,r_80_132_65,0.99,1,66,65,29
41,r_1_76_175,r_91_19_104,r_121_11_94,r_1_76_175,0.99,-71,104,175,29
3,r_79_103_190,r_128_129_93,r_144_43_196,r_128_129_93,1,1,94,93,29
46,r_27_17_78,r_144_43_196,seq89,r_27_17_78,0.99,0,78,78,29
4,r_41_117_103,r_29_57_161,seq30,r_41_117_103,1,1,104,103,29
0,r_143_26_186,seq8,r_94_0_99,r_94_0_99,0.36,87,186,99,29
34,r_118_122_30,r_45_126_64,seq30,r_118_122_30,0.99,0,30,30,29
11,r_7_104_88,seq138,seq30,r_7_104_88,1,0,88,88,29
21,r_13_96_80,r_125_14_128,r_6_108_25,r_13_96_80,0.83,39,119,80,29
15,r_18_110_121,seq66,seq75,r_18_110_121,0.98,1,122,121,29
13,r_25_82_37,seq53,r_74_10_178,r_25_82_37,1,0,37,37,29
57,seq12,seq102,r_1_76_175,r_1_76_175,0.8,4,179,175,29
13,r_25_82_37,r_74_10_178,r_141_86_112,r_141_86_112,1,62,174,112,29
6,r_125_14_128,r_45_126_64,r_13_96_80,r_125_14_128,0.81,-54,74,128,29
10,r_101_149_91,r_67_4_183,r_94_0_99,r_67_4_183,0.84,0,183,183,29
36,r_91_19_104,r_33_24_147,seq32,r_33_24_147,0.76,0,147,147,29
27,r_45_126_64,r_125_14_128,seq8,r_45_126_64,0.57,-1,63,64,29
2,r_139_111_164,seq147,r_64_98_49,r_139_111_164,0.73,0,164,164,29
41,r_1_76_175,r_121_11_94,seq12,r_1_76_175,0.97,0,175,175,29
40,r_44_42_81,seq119,r_144_43_196,r_44_42_81,0.98,0,81,81,29
18,r_54_35_158,seq114,seq102,r_54_35_158,0.63,0,158,158,29
29,r_94_0_99,seq37,seq145,r_94_0_99,0.8,0,99,99,29
24,r_121_11_94,r_56_50_92,r_1_76_175,r_121_11_94,1,-1,93,94,29
25,r_105_83_79,seq89,r_99_34_18,r_105_83_79,0.99,0,79,79,29
70,seq40,r_74_10_178,r_141_86_112,r_141_86_112,0.98,62,174,112,29
27,r_45_126_64,r_118_122_30,r_125_14_128,r_118_122_30,1,4,34,30,29
68,seq37,r_94_0_99,seq147,r_94_0_99,1,0,99,99,29
32,r_51_68_63,seq142,r_124_48_1,r_51_68_63,1,0,63,63,29
48,r_47_2_27,seq71,seq72,r_47_2_27,0.83,0,27,27,29
64,seq23,r_101_149_91,seq106,r_101_149_91,0.76,42,133,91,29
19,r_141_86_112,r_74_10_178,r_133_95_149,r_141_86_112,0.81,42,154,112,29
60,seq147,r_139_111_164,seq37,r_139_111_164,0.89,0,164,164,29
45,r_74_10_178,r_25_82_37,r_101_149_91,r_74_10_178,0.78,1,179,178,29
17,r_128_129_93,r_79_103_190,seq138,r_79_103_190,0.69,-97,93,190,29
9,r_15_93_129,seq88,r_29_57_161,r_15_93_129,0.86,0,129,129,29
47,r_16_92_7,r_58_137_6,r_6_108_25,r_6_108_25,1,10,35,25,29
26,r_99_34_18,seq36,r_105_83_79,r_105_83_79,0.99,0,79,79,29
26,r_99_34_18,r_101_149_91,seq36,r_101_149_91,0.95,-73,18,91,29
6,r_125_14_128,r_13_96_80,r_29_57_161,r_125_14_128,1,0,128,128,29
29,r_94_0_99,seq145,r_101_149_91,r_101_149_91,0.4,85,176,91,29
22,r_124_48_1,r_18_110_121,r_51_68_63,r_124_48_1,0.82,90,91,1,29
28,r_63_127_140,r_74_10_178,seq114,r_63_127_140,0.63,0,140,140,29
91,seq100,r_13_96_80,seq89,r_13_96_80,1,1,81,80,29
46,r_27_17_78,r_116_3_123,r_144_43_196,r_27_17_78,0.37,-37,41,78,29
35,r_52_107_40,seq84,seq89,r_52_107_40,1,0,40,40,29
49,r_29_57_161,seq49,r_112_28_60,r_112_28_60,1,108,168,60,29
7,r_123_31_135,r_29_57_161,seq89,r_123_31_135,0.99,-2,133,135,29
44,r_133_95_149,r_143_26_186,r_141_86_112,r_133_95_149,0.9,1,150,149,29
23,r_39_65_134,seq97,seq109,r_39_65_134,0.94,2,136,134,29
16,r_33_24_147,r_91_19_104,seq49,r_33_24_147,0.81,0,147,147,29
5,r_64_98_49,r_124_48_1,seq119,r_64_98_49,0.99,0,49,49,29
82,seq75,r_69_90_152,r_18_110_121,r_18_110_121,0.84,32,153,121,29
58,seq142,r_51_68_63,seq106,r_51_68_63,1,-5,58,63,29
12,r_136_134_182,seq119,r_118_122_30,r_118_122_30,0.39,152,182,30,29
30,r_66_80_91,seq15,r_141_106_162,r_66_80_91,1,1,92,91,30
20,r_4_33_44,seq12,r_83_138_161,r_4_33_44,0.88,1,45,44,30
14,r_6_56_123,seq124,seq130,r_6_56_123,0.79,0,123,123,30
43,r_73_59_171,r_111_55_191,r_41_13_59,r_73_59_171,0.61,0,171,171,30
37,r_99_61_57,r_11_146_185,r_83_138_161,r_83_138_161,0.88,21,182,161,30
59,seq15,r_98_8_147,seq39,r_98_8_147,1,0,147,147,30
34,r_42_18_24,r_4_33_44,seq117,r_42_18_24,0.97,0,24,24,30
71,seq48,r_71_92_176,r_95_147_75,r_95_147_75,0.97,0,75,75,30
39,r_71_92_176,seq39,r_5_139_9,r_5_139_9,0.67,167,176,9,30
5,r_111_55_191,r_73_59_171,r_95_147_75,r_95_147_75,0.9,96,171,75,30
35,r_83_138_161,seq116,r_90_30_68,r_90_30_68,0.95,3,71,68,30
23,r_41_13_59,r_5_139_9,seq2,r_41_13_59,0.97,0,59,59,30
41,r_40_145_66,r_34_10_139,r_86_50_188,r_40_145_66,0.58,122,188,66,30
45,r_109_82_126,r_68_88_193,r_110_36_83,r_110_36_83,1,19,102,83,30
68,seq38,r_46_77_194,seq64,r_46_77_194,0.99,-23,171,194,30
76,seq64,r_17_21_73,r_22_51_11,r_17_21_73,1,0,73,73,30
45,r_109_82_126,r_110_36_83,r_7_53_70,r_109_82_126,0.91,0,126,126,30
7,r_7_53_70,seq58,r_109_82_126,r_109_82_126,0.94,0,126,126,30
3,r_47_81_100,r_46_77_194,r_103_76_5,r_47_81_100,0.96,0,100,100,30
10,r_44_93_196,r_34_10_139,r_99_61_57,r_99_61_57,0.9,18,75,57,30
44,r_134_26_43,seq43,r_125_91_4,r_134_26_43,0.99,0,43,43,30
36,r_133_29_26,seq62,seq114,r_133_29_26,0.98,0,26,26,30
26,r_90_30_68,seq87,r_83_138_161,r_90_30_68,0.98,0,68,68,30
8,r_23_72_34,r_115_20_109,r_31_14_45,r_115_20_109,0.71,0,109,109,30
16,r_115_20_109,r_23_72_34,seq57,r_115_20_109,0.7,0,109,109,30
15,r_143_19_19,seq65,seq101,r_143_19_19,1,0,19,19,30
4,r_32_79_149,r_141_106_162,r_35_16_190,r_32_79_149,0.57,2,151,149,30
0,r_74_49_124,seq144,seq62,r_74_49_124,0.82,0,124,124,30
73,seq57,seq85,r_115_20_109,r_115_20_109,1,18,127,109,30
11,r_46_77_194,r_47_81_100,seq128,r_47_81_100,0.99,0,100,100,30
8,r_23_72_34,r_99_61_57,r_115_20_109,r_23_72_34,0.95,0,34,34,30
46,r_103_76_5,r_89_121_112,r_47_81_100,r_47_81_100,1,12,112,100,30
21,r_5_139_9,r_41_13_59,seq148,r_41_13_59,1,0,59,59,30
13,r_89_121_112,r_103_76_5,r_90_30_68,r_90_30_68,0.88,48,116,68,30
6,r_136_127_103,seq43,seq123,r_136_127_103,0.94,0,103,103,30
23,r_41_13_59,seq100,r_5_139_9,r_41_13_59,0.34,-43,16,59,30
96,seq117,seq62,r_42_18_24,r_42_18_24,1,4,28,24,30
85,seq87,r_90_30_68,r_35_16_190,r_90_30_68,1,0,68,68,30
80,seq70,r_41_13_59,seq148,r_41_13_59,0.62,-30,29,59,30
1,r_31_14_45,r_35_16_190,r_23_72_34,r_31_14_45,1,0,45,45,30
16,r_115_20_109,r_89_121_112,r_23_72_34,r_115_20_109,0.75,-75,34,109,30
29,r_141_106_162,r_66_80_91,r_109_82_126,r_141_106_162,0.78,0,162,162,30
86,seq135,r_41_13_59,seq148,r_41_13_59,0.97,-20,39,59,30
27,r_86_50_188,seq119,r_40_145_66,r_40_145_66,0.61,122,188,66,30
19,r_35_16_190,r_31_14_45,seq87,r_31_14_45,1,1,46,45,30
30,r_66_80_91,r_141_106_162,r_42_18_24,r_141_106_162,0.73,0,162,162,30
37,r_99_61_57,seq112,r_11_146_185,r_99_61_57,0.84,0,57,57,30
30,r_66_80_91,r_42_18_24,r_34_10_139,r_34_10_139,0.59,34,173,139,30
2,r_63_122_146,r_73_59_171,seq140,r_63_122_146,0.96,0,146,146,30
18,r_110_36_83,r_109_82_126,seq119,r_109_82_126,1,1,127,126,30
40,r_131_0_106,seq124,r_4_33_44,r_131_0_106,1,0,106,106,30
74,seq58,r_110_36_83,r_7_53_70,r_110_36_83,0.9,5,88,83,30
18,r_110_36_83,seq58,r_109_82_126,r_110_36_83,1,0,83,83,30
29,r_141_106_162,r_32_79_149,r_66_80_91,r_66_80_91,1,60,151,91,30
24,r_113_52_173,r_22_51_11,r_6_56_123,r_6_56_123,0.62,50,173,123,30
25,r_132_118_184,r_98_8_147,r_17_21_73,r_98_8_147,0.56,37,184,147,30
37,r_99_61_57,r_23_72_34,seq112,r_99_61_57,0.41,-19,38,57,30
85,seq87,r_35_16_190,seq57,r_35_16_190,0.54,-19,171,190,30
14,r_6_56_123,seq130,r_113_52_173,r_113_52_173,0.86,0,173,173,30
20,r_4_33_44,r_83_138_161,r_131_0_106,r_131_0_106,0.91,19,125,106,30
68,seq38,r_22_51_11,r_46_77_194,r_46_77_194,0.79,-69,125,194,30
32,r_105_94_131,r_68_88_193,seq140,r_105_94_131,0.9,0,131,131,30
38,r_11_146_185,r_44_93_196,r_115_20_109,r_115_20_109,0.6,76,185,109,30
35,r_83_138_161,r_90_30_68,r_99_61_57,r_83_138_161,0.36,0,161,161,30
21,r_5_139_9,seq148,r_34_10_139,r_34_10_139,1,1,140,139,30
17,r_17_21_73,seq64,r_133_29_26,r_17_21_73,1,0,73,73,30
41,r_40_145_66,seq70,r_66_80_91,r_66_80_91,0.62,27,118,91,30
9,r_95_147_75,r_7_53_70,seq48,r_95_147_75,1,0,75,75,30
26,r_90_30_68,r_83_138_161,r_89_121_112,r_90_30_68,0.98,86,154,68,30
49,r_125_91_4,r_103_76_5,r_134_26_43,r_134_26_43,0.75,0,43,43,30
28,r_54_102_160,seq149,r_32_79_149,r_32_79_149,0.58,12,161,149,30
7,r_7_53_70,r_95_147_75,seq58,r_95_147_75,0.77,0,75,75,30
12,r_34_10_139,r_44_93_196,r_5_139_9,r_34_10_139,0.93,0,139,139,30
4,r_32_79_149,r_35_16_190,r_54_102_160,r_35_16_190,0.71,-19,171,190,30
84,seq85,seq57,r_115_20_109,r_115_20_109,1,12,121,109,30
93,seq119,seq98,r_17_129_70,r_17_129_70,1,47,117,70,31
40,r_52_5_122,r_17_129_70,r_146_37_24,r_146_37_24,0.69,98,122,24,31
30,r_80_7_129,r_28_78_2,r_65_31_32,r_80_7_129,0.74,0,129,129,31
13,r_84_133_158,seq2,seq11,r_84_133_158,0.91,0,158,158,31
44,r_149_6_30,seq109,r_50_93_3,r_149_6_30,0.71,0,30,30,31
63,seq25,r_72_61_41,seq123,r_72_61_41,0.76,2,43,41,31
98,seq125,r_26_148_43,seq21,r_26_148_43,1,0,43,43,31
54,seq12,seq27,r_38_9_15,r_38_9_15,1,2,17,15,31
43,r_82_136_79,seq11,seq32,r_82_136_79,0.97,2,81,79,31
17,r_90_85_37,r_75_105_45,r_63_4_185,r_90_85_37,0.54,148,185,37,31
83,seq98,seq119,r_17_129_70,r_17_129_70,1,10,80,70,31
16,r_29_86_111,seq11,r_115_51_39,r_29_86_111,0.63,0,111,111,31
1,r_79_77_177,seq15,r_116_132_31,r_79_77_177,0.3,0,177,177,31
5,r_0_60_171,seq14,seq22,r_0_60_171,0.77,-1,170,171,31
11,r_95_19_25,r_82_136_79,r_128_108_191,r_95_19_25,1,0,25,25,31
2,r_113_42_9,r_107_147_65,seq41,r_113_42_9,0.97,1,10,9,31
13,r_84_133_158,seq137,r_57_130_77,r_84_133_158,0.61,-136,22,158,31
19,r_116_132_31,seq104,r_8_142_13,r_116_132_31,0.81,0,31,31,31
64,seq27,seq12,r_56_135_33,r_56_135_33,1,8,41,33,31
11,r_95_19_25,r_128_108_191,r_96_143_149,r_96_143_149,0.94,0,149,149,31
22,r_72_61_41,r_64_92_53,r_126_70_87,r_72_61_41,0.57,16,57,41,31
41,r_107_147_65,seq13,r_96_143_149,r_107_147_65,0.99,0,65,65,31
27,r_26_148_43,seq125,seq137,r_26_148_43,1,0,43,43,31
3,r_66_112_162,seq11,seq124,r_66_112_162,0.39,0,162,162,31
90,seq114,r_63_4_185,seq117,r_63_4_185,0.63,0,185,185,31
0,r_50_93_3,r_89_48_179,r_149_6_30,r_149_6_30,1,0,30,30,31
26,r_126_70_87,seq14,r_72_61_41,r_126_70_87,0.99,0,87,87,31
14,r_33_30_22,seq2,r_146_37_24,r_33_30_22,0.96,2,24,22,31
32,r_75_105_45,r_64_92_53,seq110,r_75_105_45,0.99,-13,32,45,31
20,r_17_129_70,r_57_130_77,seq98,r_17_129_70,0.96,0,70,70,31
46,r_134_47_151,r_8_142_13,r_0_60_171,r_134_47_151,0.66,0,151,151,31
17,r_90_85_37,seq109,r_75_105_45,r_90_85_37,0.35,119,156,37,31
15,r_131_58_104,r_96_143_149,seq91,r_131_58_104,0.97,0,104,104,31
48,r_96_143_149,r_131_58_104,r_107_147_65,r_107_147_65,0.85,21,86,65,31
17,r_90_85_37,seq32,r_75_105_45,r_90_85_37,0.95,0,37,37,31
57,seq15,r_79_77_177,r_65_31_32,r_65_31_32,0.98,82,114,32,31
31,r_8_142_13,r_3_102_196,r_56_135_33,r_8_142_13,0.58,0,13,13,31
7,r_146_37_24,r_74_53_152,r_33_30_22,r_146_37_24,0.86,0,24,24,31
85,seq103,r_36_18_61,seq59,r_36_18_61,0.84,4,65,61,31
62,seq24,r_56_135_33,r_8_142_13,r_8_142_13,0.94,14,27,13,31
4,r_120_1_50,seq10,seq21,r_120_1_50,1,0,50,50,31
29,r_56_135_33,r_134_47_151,seq27,r_56_135_33,0.79,3,36,33,31
39,r_64_92_53,r_75_105_45,r_72_61_41,r_64_92_53,0.78,-12,41,53,31
41,r_107_147_65,r_96_143_149,r_35_34_82,r_96_143_149,0.76,-2,147,149,31
47,r_57_130_77,seq69,r_116_132_31,r_57_130_77,1,0,77,77,31
74,seq69,r_57_130_77,r_84_133_158,r_57_130_77,0.96,-1,76,77,31
22,r_72_61_41,seq25,r_64_92_53,r_72_61_41,0.92,0,41,41,31
37,r_115_51_39,seq41,seq20,r_115_51_39,0.72,0,39,39,31
25,r_106_40_124,seq76,r_17_129_70,r_106_40_124,0.8,0,124,124,31
13,r_84_133_158,r_72_61_41,seq2,r_84_133_158,0.53,-21,137,158,31
33,r_36_18_61,seq103,seq76,r_36_18_61,1,1,62,61,31
48,r_96_143_149,r_107_147_65,r_95_19_25,r_96_143_149,1,0,149,149,31
82,seq97,r_64_92_53,seq13,r_64_92_53,0.36,87,140,53,31
58,seq20,seq71,r_115_51_39,r_115_51_39,0.99,53,92,39,31
45,r_38_9_15,seq21,seq12,r_38_9_15,1,0,15,15,31
13,r_84_133_158,r_57_130_77,r_0_60_171,r_57_130_77,0.71,-20,57,77,31
65,seq32,r_35_34_82,r_82_136_79,r_35_34_82,0.67,-8,74,82,31
13,r_84_133_158,r_0_60_171,r_72_61_41,r_84_133_158,0.58,-57,101,158,31
17,r_90_85_37,r_75_105_45,seq109,r_90_85_37,0.53,48,85,37,31
44,r_149_6_30,seq110,seq109,r_149_6_30,0.51,-14,16,30,31
24,r_54_141_19,r_80_7_129,seq104,r_54_141_19,0.99,0,19,19,31
39,r_64_92_53,r_107_147_65,seq97,r_107_147_65,0.67,-2,63,65,31
77,seq76,r_106_40_124,r_36_18_61,r_36_18_61,1,4,65,61,31
75,seq71,seq20,r_73_144_6,r_73_144_6,0.74,153,159,6,31
9,r_28_78_2,r_80_7_129,r_113_42_9,r_80_7_129,0.82,0,129,129,31
34,r_65_31_32,seq137,seq123,r_65_31_32,1,0,32,32,31
28,r_3_102_196,r_131_58_104,r_107_147_65,r_3_102_196,0.61,-92,104,196,31
46,r_134_47_151,r_0_60_171,r_66_112_162,r_134_47_151,0.96,15,166,151,31
49,r_35_34_82,seq91,r_107_147_65,r_35_34_82,1,0,82,82,31
23,r_67_99_159,seq124,seq69,r_67_99_159,0.44,15,174,159,31
35,r_145_44_121,r_89_48_179,seq69,r_145_44_121,0.99,0,121,121,31
12,r_49_39_175,seq91,r_134_47_151,r_49_39_175,0.88,0,175,175,31
39,r_64_92_53,r_72_61_41,r_107_147_65,r_64_92_53,0.97,0,53,53,31
46,r_134_47_151,r_56_135_33,r_8_142_13,r_8_142_13,0.95,14,27,13,31
31,r_8_142_13,r_56_135_33,r_116_132_31,r_116_132_31,0.92,5,36,31,31
44,r_28_104_126,r_58_83_16,seq84,r_28_104_126,0.67,0,126,126,32
77,seq54,seq137,r_22_120_48,r_22_120_48,0.83,9,57,48,32
26,r_75_132_44,seq32,r_114_31_6,r_75_132_44,0.94,2,46,44,32
36,r_134_11_87,r_99_5_150,seq139,r_134_11_87,0.69,-10,77,87,32
20,r_140_76_40,seq126,seq92,r_140_76_40,0.98,1,41,40,32
43,r_146_34_183,r_9_135_168,r_64_29_34,r_146_34_183,0.61,-13,170,183,32
3,r_55_7_139,r_63_130_24,r_28_104_126,r_55_7_139,0.97,0,139,139,32
14,r_64_29_34,seq136,seq66,r_64_29_34,0.99,0,34,34,32
28,r_59_48_95,r_134_11_87,r_105_14_43,r_59_48_95,0.47,32,127,95,32
68,seq40,r_65_52_11,r_36_62_56,r_36_62_56,0.98,0,56,56,32
59,seq16,r_58_83_16,seq115,r_58_83_16,1,0,16,16,32
16,r_45_20_63,r_90_89_193,r_67_106_22,r_45_20_63,1,0,63,63,32
21,r_90_89_193,r_143_68_180,r_123_43_170,r_90_89_193,0.39,-13,180,193,32
1,r_80_94_163,r_117_87_122,r_61_70_68,r_80_94_163,0.73,0,163,163,32
26,r_75_132_44,r_114_31_6,r_112_103_93,r_112_103_93,0.73,5,98,93,32
43,r_146_34_183,r_64_29_34,r_123_43_170,r_146_34_183,0.45,0,183,183,32
46,r_58_83_16,seq16,r_28_104_126,r_58_83_16,1,0,16,16,32
45,r_9_135_168,r_146_34_183,seq27,r_9_135_168,0.72,-2,166,168,32
70,seq42,r_21_138_144,r_61_70_68,r_21_138_144,1,0,144,144,32
47,r_1_73_33,seq92,r_117_87_122,r_1_73_33,0.99,1,34,33,32
77,seq54,r_22_120_48,r_144_127_179,r_144_127_179,0.48,0,179,179,32
31,r_38_2_54,r_117_87_122,seq101,r_38_2_54,1,0,54,54,32
99,seq126,r_140_76_40,r_129_107_99,r_140_76_40,0.98,0,40,40,32
38,r_24_49_137,r_51_3_47,r_1_73_33,r_24_49_137,1,0,137,137,32
12,r_129_107_99,seq126,r_65_52_11,r_129_107_99,1,0,99,99,32
62,seq148,r_108_96_160,r_64_29_34,r_108_96_160,0.87,-3,157,160,32
89,seq97,r_112_103_93,seq40,r_112_103_93,0.9,3,96,93,32
27,r_105_14_43,r_123_43_170,seq136,r_105_14_43,1,0,43,43,32
10,r_39_74_72,seq102,r_140_76_40,r_39_74_72,1,0,72,72,32
3,r_55_7_139,r_119_26_187,r_63_130_24,r_63_130_24,0.5,6,30,24,32
15,r_142_60_36,r_28_104_126,seq101,r_142_60_36,1,0,36,36,32
11,r_22_120_48,r_134_11_87,seq54,r_22_120_48,0.85,0,48,48,32
4,r_61_70_68,seq50,r_91_72_172,r_61_70_68,1,0,68,68,32
0,r_112_103_93,seq97,r_75_132_44,r_112_103_93,1,0,93,93,32
30,r_63_130_24,r_147_111_67,r_55_7_139,r_147_111_67,0.69,-41,26,67,32
13,r_21_138_144,seq42,seq98,r_21_138_144,0.92,0,144,144,32
33,r_124_149_39,seq77,seq116,r_124_149_39,0.97,0,39,39,32
46,r_58_83_16,r_28_104_126,r_64_29_34,r_58_83_16,0.57,110,126,16,32
48,r_57_78_117,r_133_125_159,seq88,r_57_78_117,0.72,0,117,117,32
4,r_61_70_68,r_91_72_172,r_80_94_163,r_61_70_68,0.85,100,168,68,32
57,seq13,seq102,r_82_81_89,r_82_81_89,0.79,2,91,89,32
37,r_119_26_187,seq92,r_9_135_168,r_119_26_187,0.96,0,187,187,32
6,r_69_37_166,seq44,r_24_49_137,r_69_37_166,0.65,0,166,166,32
8,r_67_106_22,seq128,seq93,r_67_106_22,0.96,0,22,22,32
44,r_28_104_126,seq84,r_55_7_139,r_28_104_126,0.74,17,143,126,32
85,seq88,seq116,r_57_78_117,r_57_78_117,0.99,3,120,117,32
30,r_63_130_24,r_55_7_139,r_140_76_40,r_55_7_139,0.46,1,140,139,32
87,seq93,seq116,r_67_106_22,r_67_106_22,1,87,109,22,32
29,r_33_19_111,seq30,r_122_110_13,r_122_110_13,0.98,5,18,13,32
22,r_51_3_47,r_24_49_137,seq27,r_24_49_137,1,0,137,137,32
2,r_91_72_172,r_21_138_144,r_61_70_68,r_61_70_68,0.79,0,68,68,32
40,r_143_68_180,r_90_89_193,r_51_3_47,r_90_89_193,0.34,-13,180,193,32
24,r_85_71_97,seq101,seq131,r_85_71_97,0.89,0,97,97,32
35,r_147_111_67,r_133_125_159,r_108_96_160,r_147_111_67,0.76,92,159,67,32
88,seq95,seq30,r_113_4_84,r_113_4_84,1,3,87,84,32
62,seq148,r_9_135_168,r_108_96_160,r_9_135_168,0.68,-61,107,168,32
70,seq42,r_59_48_95,r_21_138_144,r_59_48_95,0.98,-1,94,95,32
44,r_28_104_126,r_142_60_36,r_58_83_16,r_28_104_126,0.61,-90,36,126,32
42,r_108_96_160,seq148,r_147_111_67,r_108_96_160,0.69,0,160,160,32
32,r_133_125_159,r_57_78_117,r_147_111_67,r_147_111_67,0.54,50,117,67,32
52,seq131,seq102,r_85_71_97,r_85_71_97,1,3,100,97,32
25,r_65_52_11,r_108_96_160,seq40,r_65_52_11,0.77,0,11,11,32
17,r_113_4_84,r_129_107_99,seq95,r_113_4_84,0.99,1,85,84,32
25,r_65_52_11,seq40,r_129_107_99,r_129_107_99,0.98,1,100,99,32
9,r_82_81_89,seq47,seq13,r_82_81_89,1,0,89,89,32
18,r_122_110_13,seq13,r_33_19_111,r_122_110_13,0.94,0,13,13,32
29,r_33_19_111,r_122_110_13,seq136,r_122_110_13,0.56,98,111,13,32
28,r_59_48_95,seq42,r_134_11_87,r_59_48_95,0.59,0,95,95,32
49,r_117_87_122,r_80_94_163,r_1_73_33,r_117_87_122,0.96,-52,70,122,32
32,r_133_125_159,r_147_111_67,r_129_107_99,r_133_125_159,0.95,0,159,159,32
7,r_99_5_150,r_134_11_87,seq15,r_99_5_150,0.52,-23,127,150,32
18,r_122_110_13,r_33_19_111,seq30,r_33_19_111,1,0,111,111,32
23,r_25_109_198,r_91_72_172,r_61_70_68,r_61_70_68,1,39,107,68,32
68,seq40,r_112_103_93,r_65_52_11,r_65_52_11,0.95,0,11,11,32
35,r_147_111_67,seq116,r_133_125_159,r_147_111_67,1,10,77,67,32
38,r_24_49_137,seq27,r_51_3_47,r_51_3_47,1,11,58,47,32
22,r_51_3_47,r_85_71_97,r_24_49_137,r_51_3_47,0.97,0,47,47,32
12,r_129_107_99,r_113_4_84,seq126,r_113_4_84,0.43,-20,64,84,32
19,r_36_62_56,seq32,seq40,r_36_62_56,1,1,57,56,32
30,r_18_10_166,seq85,r_125_122_6,r_18_10_166,0.63,2,168,166,33
44,r_15_35_120,r_38_145_42,seq5,r_15_35_120,0.96,1,121,120,33
9,r_51_88_56,seq149,r_37_46_123,r_37_46_123,1,-4,119,123,33
14,r_59_76_75,r_132_72_92,r_83_49_1,r_59_76_75,1,1,76,75,33
0,r_132_72_92,seq52,r_31_79_74,r_132_72_92,0.91,0,92,92,33
54,seq6,r_56_68_180,r_38_145_42,r_38_145_42,0.98,147,189,42,33
83,seq85,r_18_10_166,r_144_73_141,r_18_10_166,0.48,2,168,166,33
37,r_138_28_62,seq136,seq111,r_138_28_62,1,0,62,62,33
59,seq13,r_67_87_156,r_50_117_37,r_50_117_37,0.78,119,156,37,33
19,r_19_98_148,r_147_89_51,seq113,r_19_98_148,0.86,0,148,148,33
55,seq129,r_53_12_182,seq70,r_53_12_182,0.36,0,182,182,33
71,seq136,r_138_28_62,r_104_108_2,r_138_28_62,1,0,62,62,33
16,r_43_94_183,seq3,r_47_143_31,r_47_143_31,1,154,185,31,33
21,r_37_46_123,seq71,r_51_88_56,r_37_46_123,1,0,123,123,33
1,r_74_9_79,r_83_49_1,r_51_88_56,r_74_9_79,0.73,1,80,79,33
46,r_23_45_53,seq58,r_36_142_122,r_36_142_122,0.66,0,122,122,33
47,r_7_109_26,seq40,r_130_27_144,r_130_27_144,0.96,-1,143,144,33
42,r_140_90_127,r_2_118_145,seq119,r_140_90_127,0.63,1,128,127,33
12,r_47_143_31,r_7_109_26,seq141,r_47_143_31,0.95,0,31,31,33
9,r_51_88_56,seq70,seq149,r_51_88_56,1,0,56,56,33
74,seq58,r_50_117_37,r_83_49_1,r_50_117_37,1,-2,35,37,33
77,seq66,r_67_87_156,r_125_122_6,r_125_122_6,0.61,6,12,6,33
32,r_128_82_14,seq52,r_144_73_141,r_144_73_141,0.72,25,166,141,33
95,seq119,r_110_54_199,r_24_4_49,r_24_4_49,1,21,70,49,33
66,seq149,r_22_131_192,r_51_88_56,r_51_88_56,0.95,4,60,56,33
32,r_128_82_14,r_18_10_166,seq52,r_128_82_14,0.41,36,50,14,33
31,r_93_126_65,seq42,seq70,r_93_126_65,1,0,65,65,33
41,r_32_105_158,seq17,r_147_89_51,r_32_105_158,0.76,0,158,158,33
67,seq33,seq129,r_25_39_39,r_25_39_39,0.52,136,175,39,33
13,r_95_112_107,r_2_118_145,seq71,r_2_118_145,0.95,1,146,145,33
44,r_15_35_120,r_25_39_39,r_38_145_42,r_15_35_120,0.97,-77,43,120,33
26,r_130_27_144,seq29,r_7_109_26,r_130_27_144,0.98,0,144,144,33
20,r_24_4_49,r_36_142_122,seq119,r_24_4_49,1,0,49,49,33
72,seq52,r_132_72_92,seq85,r_132_72_92,0.87,0,92,92,33
4,r_144_73_141,seq92,seq52,r_144_73_141,0.97,0,141,141,33
84,seq92,r_106_65_23,r_44_34_33,r_44_34_33,0.52,138,171,33,33
0,r_132_72_92,r_59_76_75,seq52,r_59_76_75,0.97,1,76,75,33
38,r_2_118_145,r_95_112_107,r_50_117_37,r_2_118_145,0.62,0,145,145,33
13,r_95_112_107,seq60,r_2_118_145,r_95_112_107,0.95,1,108,107,33
48,r_20_86_85,r_32_105_158,seq70,r_20_86_85,0.98,0,85,85,33
88,seq101,seq0,r_26_69_34,r_26_69_34,1,1,35,34,33
18,r_106_65_23,seq137,r_26_69_34,r_26_69_34,0.57,-11,23,34,33
62,seq17,r_32_105_158,r_41_91_63,r_41_91_63,1,95,158,63,33
19,r_19_98_148,seq137,r_147_89_51,r_147_89_51,1,4,55,51,33
27,r_83_49_1,seq58,r_59_76_75,r_59_76_75,1,1,76,75,33
39,r_116_61_38,r_32_105_158,seq42,r_116_61_38,0.99,0,38,38,33
72,seq52,seq85,r_144_73_141,r_144_73_141,0.84,0,141,141,33
22,r_44_34_33,r_106_65_23,r_53_12_182,r_53_12_182,0.7,1,183,182,33
22,r_44_34_33,r_83_49_1,r_106_65_23,r_44_34_33,0.99,0,33,33,33
2,r_67_87_156,seq13,r_7_109_26,r_67_87_156,0.69,0,156,156,33
40,r_81_100_96,seq70,seq60,r_81_100_96,1,0,96,96,33
33,r_121_30_11,r_44_34_33,seq42,r_121_30_11,0.86,0,11,11,33
29,r_31_79_74,r_147_89_51,r_132_72_92,r_147_89_51,0.98,50,101,51,33
1,r_74_9_79,r_22_131_192,r_51_88_56,r_74_9_79,0.43,85,164,79,33
34,r_38_145_42,r_15_35_120,r_50_117_37,r_15_35_120,0.65,0,120,120,33
25,r_36_142_122,seq123,r_23_45_53,r_36_142_122,1,0,122,122,33
34,r_38_145_42,r_132_72_92,r_15_35_120,r_38_145_42,0.99,1,43,42,33
64,seq21,seq139,r_19_98_148,r_19_98_148,0.88,39,187,148,33
65,seq29,r_130_27_144,seq8,r_130_27_144,0.99,-37,107,144,33
38,r_2_118_145,r_140_90_127,r_95_112_107,r_95_112_107,0.95,25,132,107,33
12,r_47_143_31,r_135_78_8,r_7_109_26,r_47_143_31,0.47,-12,19,31,33
87,seq99,seq48,r_50_117_37,r_50_117_37,1,10,47,37,33
6,r_84_57_15,r_26_69_34,seq11,r_84_57_15,1,0,15,15,33
58,seq11,seq29,r_84_57_15,r_84_57_15,1,10,25,15,33
43,r_26_69_34,seq92,seq101,r_26_69_34,0.87,0,34,34,33
49,r_75_103_117,r_18_10_166,seq11,r_75_103_117,0.98,0,117,117,33
18,r_106_65_23,r_26_69_34,r_44_34_33,r_106_65_23,0.99,11,34,23,33
43,r_26_69_34,r_84_57_15,seq92,r_26_69_34,0.5,-12,22,34,33
23,r_41_91_63,seq42,seq17,r_41_91_63,1,0,63,63,33
28,r_135_78_8,r_25_39_39,seq99,r_25_39_39,1,-1,38,39,33
11,r_25_39_39,r_15_35_120,seq70,r_25_39_39,0.91,0,39,39,33
32,r_128_82_14,r_53_12_182,r_18_10_166,r_128_82_14,0.7,3,17,14,33
82,seq141,seq114,r_47_143_31,r_47_143_31,1,0,31,31,33
45,r_50_117_37,seq58,seq99,r_50_117_37,1,0,37,37,33
84,seq92,r_144_73_141,r_106_65_23,r_106_65_23,0.51,118,141,23,33
93,seq113,seq119,r_32_76_52,r_32_76_52,1,13,65,52,34
21,r_92_66_54,r_133_140_99,seq2,r_92_66_54,0.98,0,54,54,34
48,r_25_48_48,r_30_115_94,seq119,r_25_48_48,1,0,48,48,34
14,r_33_27_110,seq29,r_94_139_32,r_33_27_110,1,0,110,110,34
9,r_96_51_34,seq23,r_143_100_116,r_143_100_116,1,7,123,116,34
87,seq91,r_16_7_109,r_24_99_26,r_24_99_26,0.86,2,28,26,34
8,r_146_80_147,r_69_65_130,r_67_118_155,r_69_65_130,0.63,1,131,130,34
43,r_141_104_121,seq22,seq9,r_141_104_121,0.98,0,121,121,34
26,r_120_89_47,r_85_129_44,r_96_51_34,r_96_51_34,0.92,3,37,34,34
9,r_96_51_34,r_135_97_50,r_120_89_47,r_96_51_34,0.95,0,34,34,34
81,seq78,r_85_129_44,r_93_35_93,r_93_35_93,0.98,31,124,93,34
30,r_83_17_53,seq54,seq70,r_83_17_53,0.99,0,53,53,34
25,r_45_26_9,r_108_34_146,r_135_97_50,r_135_97_50,0.93,5,55,50,34
71,seq55,r_90_4_168,r_85_129_44,r_85_129_44,0.96,60,104,44,34
16,r_44_50_76,seq79,seq149,r_44_50_76,1,0,76,76,34
39,r_130_10_91,r_142_101_138,seq22,r_130_10_91,0.92,0,91,91,34
1,r_142_101_138,r_130_10_91,seq147,r_130_10_91,0.88,0,91,91,34
97,seq136,r_81_64_112,seq114,r_81_64_112,1,0,112,112,34
46,r_133_140_99,r_41_11_133,r_44_50_76,r_133_140_99,0.84,0,99,99,34
1,r_142_101_138,seq147,r_143_100_116,r_142_101_138,0.9,1,139,138,34
64,seq37,seq86,r_137_20_49,r_137_20_49,0.98,0,49,49,34
24,r_0_98_20,r_41_11_133,seq71,r_41_11_133,1,0,133,133,34
76,seq68,r_124_18_122,r_61_15_88,r_124_18_122,0.61,68,190,122,34
26,r_120_89_47,r_96_51_34,r_108_34_146,r_120_89_47,0.93,0,47,47,34
80,seq77,r_122_75_128,r_21_46_11,r_21_46_11,0.53,0,11,11,34
95,seq117,r_30_115_94,r_124_18_122,r_30_115_94,0.97,-1,93,94,34
76,seq68,r_133_140_99,r_85_129_44,r_85_129_44,0.82,56,100,44,34
9,r_96_51_34,r_120_89_47,seq23,r_120_89_47,0.97,2,49,47,34
41,r_90_4_168,seq55,r_53_131_153,r_53_131_153,0.66,15,168,153,34
90,seq109,seq3,r_127_88_37,r_127_88_37,0.96,53,90,37,34
4,r_53_131_153,seq40,seq145,r_53_131_153,0.83,0,153,153,34
0,r_67_118_155,r_57_125_136,seq136,r_57_125_136,0.9,0,136,136,34
31,r_94_139_32,r_116_1_179,seq38,r_94_139_32,1,0,32,32,34
13,r_61_15_88,seq29,r_25_48_48,r_61_15_88,0.95,0,88,88,34
15,r_19_5_106,seq29,seq149,r_19_5_106,0.87,2,108,106,34
44,r_21_46_11,r_19_5_106,seq77,r_21_46_11,0.91,0,11,11,34
6,r_122_75_128,r_57_125_136,seq59,r_122_75_128,0.99,0,128,128,34
62,seq23,r_57_125_136,seq114,r_57_125_136,1,-74,62,136,34
85,seq86,seq37,r_30_115_94,r_30_115_94,1,0,94,94,34
99,seq126,r_36_121_172,r_110_105_148,r_110_105_148,0.99,13,161,148,34
5,r_103_144_19,seq58,r_130_10_91,r_130_10_91,1,1,92,91,34
36,r_108_34_146,r_120_89_47,seq113,r_108_34_146,0.97,0,146,146,34
27,r_143_100_116,seq6,r_96_51_34,r_143_100_116,1,0,116,116,34
34,r_135_97_50,seq78,r_45_26_9,r_135_97_50,1,0,50,50,34
29,r_137_20_49,r_124_18_122,seq37,r_137_20_49,0.96,0,49,49,34
0,r_67_118_155,seq136,r_57_125_136,r_67_118_155,0.62,0,155,155,34
84,seq84,r_138_12_198,r_83_17_53,r_83_17_53,0.86,3,56,53,34
2,r_134_60_113,seq71,seq86,r_134_60_113,1,2,115,113,34
47,r_43_28_191,r_53_131_153,seq40,r_53_131_153,0.99,-20,133,153,34
30,r_83_17_53,seq70,seq84,r_83_17_53,0.51,27,80,53,34
18,r_14_31_83,seq54,seq2,r_14_31_83,0.91,0,83,83,34
61,seq22,seq58,r_130_10_91,r_130_10_91,1,6,97,91,34
24,r_0_98_20,seq147,r_41_11_133,r_0_98_20,0.99,0,20,20,34
36,r_108_34_146,r_32_76_52,r_120_89_47,r_108_34_146,0.93,-94,52,146,34
28,r_124_18_122,r_137_20_49,seq117,r_137_20_49,1,-1,48,49,34
33,r_30_115_94,seq117,seq86,r_30_115_94,0.97,0,94,94,34
61,seq22,r_127_88_37,seq58,r_127_88_37,0.97,0,37,37,34
70,seq54,r_14_31_83,seq8,r_14_31_83,0.97,1,84,83,34
45,r_47_102_15,r_67_118_155,seq106,r_47_102_15,0.81,0,15,15,34
20,r_85_129_44,r_120_89_47,seq78,r_85_129_44,0.98,0,44,44,34
8,r_146_80_147,r_67_118_155,r_0_98_20,r_146_80_147,0.86,1,148,147,34
32,r_93_35_93,r_116_1_179,seq78,r_93_35_93,1,0,93,93,34
38,r_39_74_62,seq149,seq128,r_39_74_62,1,0,62,62,34
71,seq55,r_85_129_44,r_116_1_179,r_116_1_179,0.96,3,182,179,34
37,r_41_11_133,r_134_60_113,r_0_98_20,r_0_98_20,1,0,20,20,34
19,r_24_99_26,seq82,seq91,r_24_99_26,1,0,26,26,34
60,seq149,r_44_50_76,r_19_5_106,r_19_5_106,0.97,0,106,106,34
17,r_81_64_112,seq136,seq147,r_81_64_112,0.59,0,112,112,34
94,seq114,r_57_125_136,seq136,r_57_125_136,1,0,136,136,34
96,seq119,seq113,r_25_48_48,r_25_48_48,1,31,79,48,34
59,seq147,r_0_98_20,r_142_101_138,r_0_98_20,0.87,0,20,20,34
37,r_41_11_133,r_0_98_20,seq3,r_41_11_133,0.98,0,133,133,34
28,r_124_18_122,seq117,r_0_98_20,r_124_18_122,0.91,0,122,122,34
5,r_103_144_19,r_67_118_155,seq58,r_103_144_19,0.96,0,19,19,34
42,r_127_88_37,seq22,seq109,r_127_88_37,0.97,-2,35,37,34
49,r_107_72_103,seq38,seq123,r_107_72_103,0.94,0,103,103,34
82,seq79,r_90_4_168,r_124_18_122,r_90_4_168,0.35,-43,125,168,34
76,seq68,r_85_129_44,r_124_18_122,r_85_129_44,0.5,88,132,44,34
56,seq9,seq112,r_141_104_121,r_141_104_121,1,0,121,121,34
26,r_120_89_47,r_108_34_146,r_135_97_50,r_108_34_146,0.62,-1,145,146,34
23,r_110_105_148,seq6,seq132,r_110_105_148,0.89,0,148,148,34
35,r_69_65_130,r_146_80_147,seq73,r_69_65_130,0.89,3,133,130,34
79,seq73,seq77,r_24_99_26,r_24_99_26,0.94,16,42,26,34
12,r_138_12_198,seq70,seq84,r_138_12_198,0.41,-23,175,198,34
30,r_148_8_74,r_121_82_187,seq99,r_148_8_74,1,2,76,74,35
36,r_5_134_131,r_27_57_148,seq76,r_5_134_131,0.63,0,131,131,35
53,seq4,r_113_117_90,r_136_108_125,r_113_117_90,0.97,-5,85,90,35
43,r_72_55_154,seq29,seq38,r_72_55_154,0.65,0,154,154,35
22,r_106_23_54,seq42,seq22,r_106_23_54,1,0,54,54,35
37,r_109_111_153,seq19,seq138,r_109_111_153,0.85,0,153,153,35
59,seq142,seq64,r_66_94_60,r_66_94_60,1,11,71,60,35
23,r_129_49_56,seq4,r_74_110_105,r_129_49_56,0.82,38,94,56,35
71,seq43,r_17_79_94,r_80_20_7,r_17_79_94,1,-3,91,94,35
16,r_80_20_7,r_54_34_138,seq43,r_54_34_138,0.91,0,138,138,35
1,r_10_140_170,seq9,r_96_1_93,r_10_140_170,0.43,0,170,170,35
5,r_54_34_138,r_80_20_7,seq81,r_54_34_138,0.79,0,138,138,35
46,r_36_53_73,seq38,seq141,r_36_53_73,0.84,1,74,73,35
9,r_21_71_149,r_77_58_31,seq99,r_21_71_149,0.95,1,150,149,35
7,r_120_98_6,r_63_40_174,r_67_68_113,r_67_68_113,0.96,15,128,113,35
83,seq84,seq16,r_66_94_60,r_66_94_60,0.56,113,173,60,35
35,r_128_41_139,r_66_94_60,r_15_47_51,r_128_41_139,0.92,-88,51,139,35
89,seq104,r_95_92_21,r_128_41_139,r_128_41_139,0.95,6,145,139,35
25,r_27_57_148,r_80_20_7,r_93_116_114,r_27_57_148,0.73,0,148,148,35
27,r_113_117_90,r_63_40_174,r_103_7_42,r_63_40_174,0.92,-20,154,174,35
66,seq29,r_72_55_154,seq124,r_72_55_154,0.99,0,154,154,35
39,r_15_47_51,r_128_41_139,r_52_48_50,r_128_41_139,0.97,0,139,139,35
41,r_37_127_115,r_63_40_174,seq0,r_37_127_115,0.99,0,115,115,35
89,seq104,seq65,r_95_92_21,r_95_92_21,0.98,59,80,21,35
31,r_3_44_55,seq59,r_33_105_123,r_3_44_55,0.99,0,55,55,35
3,r_67_68_113,r_93_116_114,r_120_98_6,r_67_68_113,1,0,113,113,35
14,r_121_82_187,r_148_8_74,r_95_92_21,r_121_82_187,0.7,-166,21,187,35
8,r_33_105_123,r_3_44_55,r_136_108_125,r_33_105_123,1,1,124,123,35
14,r_121_82_187,r_95_92_21,r_66_94_60,r_66_94_60,0.53,127,187,60,35
0,r_93_116_114,r_67_68_113,seq122,r_67_68_113,1,-21,92,113,35
63,seq149,r_143_51_71,r_6_130_11,r_143_51_71,0.93,0,71,71,35
11,r_89_107_143,seq22,seq137,r_89_107_143,0.97,0,143,143,35
20,r_96_1_93,seq4,r_143_51_71,r_143_51_71,1,1,72,71,35
15,r_147_32_167,r_139_83_171,r_3_44_55,r_147_32_167,0.76,0,167,167,35
48,r_70_101_88,seq59,seq149,r_70_101_88,0.99,0,88,88,35
45,r_6_130_11,r_52_48_50,seq149,r_6_130_11,1,0,11,11,35
27,r_113_117_90,seq4,r_63_40_174,r_113_117_90,0.99,1,91,90,35
2,r_132_31_124,seq18,r_26_91_3,r_132_31_124,0.87,0,124,124,35
47,r_63_40_174,r_37_127_115,r_113_117_90,r_63_40_174,0.55,-66,108,174,35
40,r_74_110_105,r_63_40_174,r_129_49_56,r_74_110_105,1,0,105,105,35
18,r_139_83_171,seq22,r_109_111_153,r_139_83_171,0.58,0,171,171,35
29,r_145_88_130,seq99,r_96_1_93,r_145_88_130,1,0,130,130,35
24,r_24_50_112,seq115,seq104,r_24_50_112,1,0,112,112,35
13,r_77_58_31,seq141,seq22,r_77_58_31,1,0,31,31,35
35,r_128_41_139,r_15_47_51,seq104,r_128_41_139,0.99,0,139,139,35
25,r_27_57_148,r_5_134_131,r_80_20_7,r_5_134_131,0.59,0,131,131,35
33,r_17_79_94,seq43,seq114,r_17_79_94,0.94,0,94,94,35
64,seq22,r_89_107_143,r_106_23_54,r_106_23_54,0.84,89,143,54,35
47,r_63_40_174,r_113_117_90,r_80_20_7,r_63_40_174,1,0,174,174,35
57,seq138,r_52_48_50,seq59,r_52_48_50,0.82,0,50,50,35
16,r_80_20_7,seq43,r_63_40_174,r_80_20_7,0.56,170,177,7,35
50,seq0,seq81,r_37_127_115,r_37_127_115,1,1,116,115,35
42,r_95_92_21,r_121_82_187,seq86,r_121_82_187,0.6,-16,171,187,35
38,r_143_51_71,seq149,r_96_1_93,r_143_51_71,1,0,71,71,35
19,r_52_48_50,seq138,seq18,r_52_48_50,1,0,50,50,35
53,seq4,r_136_108_125,r_96_1_93,r_136_108_125,0.98,0,125,125,35
21,r_11_46_182,r_129_49_56,seq35,r_129_49_56,1,0,56,56,35
34,r_28_125_13,seq64,seq75,r_28_125_13,0.92,0,13,13,35
10,r_103_7_42,seq97,seq38,r_103_7_42,1,0,42,42,35
39,r_15_47_51,seq76,r_128_41_139,r_15_47_51,1,0,51,51,35
81,seq141,seq35,r_36_53_73,r_36_53_73,1,28,101,73,35
94,seq115,r_24_50_112,seq64,r_24_50_112,1,0,112,112,35
9,r_21_71_149,r_5_134_131,r_77_58_31,r_77_58_31,0.61,90,121,31,35
31,r_3_44_55,r_33_105_123,seq87,r_33_105_123,1,1,124,123,35
28,r_30_119_77,r_72_55_154,r_56_102_17,r_30_119_77,0.76,1,78,77,35
42,r_95_92_21,seq64,r_121_82_187,r_95_92_21,0.88,0,21,21,35
8,r_33_105_123,seq42,r_3_44_55,r_3_44_55,1,1,56,55,35
49,r_66_94_60,seq126,seq142,r_66_94_60,1,1,61,60,35
4,r_62_85_33,r_143_51_71,seq126,r_62_85_33,1,0,33,33,35
74,seq59,r_3_44_55,r_26_91_3,r_3_44_55,0.99,-6,49,55,35
44,r_78_14_104,seq60,seq38,r_78_14_104,1,3,107,104,35
23,r_129_49_56,r_11_46_182,seq4,r_129_49_56,0.77,13,69,56,35
32,r_56_102_17,r_17_79_94,seq39,r_56_102_17,1,0,17,17,35
79,seq75,seq60,r_28_125_13,r_28_125_13,0.71,29,42,13,35
12,r_12_61_156,seq45,seq76,r_12_61_156,0.42,2,158,156,35
83,seq84,r_24_50_112,seq16,r_24_50_112,0.73,-78,34,112,35
14,r_80_8_29,seq127,r_58_31_77,r_80_8_29,0.97,0,29,29,36
8,r_22_124_129,seq113,seq122,r_22_124_129,1,0,129,129,36
43,r_73_60_172,seq142,r_36_86_122,r_73_60_172,0.83,0,172,172,36
37,r_10_116_18,r_41_141_192,r_17_3_21,r_10_116_18,0.51,-1,17,18,36
54,seq136,seq57,r_120_90_76,r_120_90_76,1,31,107,76,36
83,seq93,r_131_77_161,r_21_129_48,r_21_129_48,1,113,161,48,36
14,r_80_8_29,r_58_31_77,seq83,r_58_31_77,1,0,77,77,36
16,r_120_90_76,r_103_29_144,seq136,r_120_90_76,1,1,77,76,36
21,r_130_105_164,r_24_97_71,seq139,r_24_97_71,0.97,3,74,71,36
39,r_70_85_67,r_73_60_172,r_17_3_21,r_70_85_67,1,0,67,67,36
1,r_23_9_150,seq18,seq62,r_23_9_150,0.62,0,150,150,36
42,r_112_56_2,r_61_20_126,r_59_144_17,r_112_56_2,0.67,15,17,2,36
45,r_67_125_99,r_50_132_50,seq113,r_67_125_99,1,0,99,99,36
5,r_15_44_43,seq6,r_131_77_161,r_15_44_43,0.79,0,43,43,36
7,r_114_4_100,r_34_74_167,r_61_20_126,r_34_74_167,0.93,0,167,167,36
19,r_41_141_192,r_10_116_18,r_112_56_2,r_41_141_192,0.72,-123,69,192,36
27,r_117_134_34,r_79_39_184,r_36_86_122,r_36_86_122,1,20,142,122,36
66,seq43,r_101_81_168,r_24_97_71,r_24_97_71,1,37,108,71,36
31,r_50_132_50,r_114_4_100,r_67_125_99,r_50_132_50,0.98,0,50,50,36
41,r_108_147_142,r_34_74_167,seq104,r_108_147_142,0.91,0,142,142,36
67,seq45,seq7,r_12_69_80,r_12_69_80,1,0,80,80,36
10,r_131_77_161,seq93,r_58_31_77,r_58_31_77,0.89,84,161,77,36
26,r_35_84_180,seq119,r_101_81_168,r_35_84_180,0.42,0,180,180,36
4,r_12_69_80,seq49,seq45,r_12_69_80,1,2,82,80,36
25,r_58_31_77,seq83,r_80_8_29,r_80_8_29,1,1,30,29,36
15,r_24_97_71,r_61_20_126,seq43,r_24_97_71,1,0,71,71,36
48,r_118_71_127,r_48_30_145,seq140,r_118_71_127,0.96,0,127,127,36
90,seq104,r_55_65_85,r_108_147_142,r_108_147_142,1,21,163,142,36
44,r_48_30_145,r_75_5_116,r_149_51_105,r_75_5_116,0.52,29,145,116,36
21,r_130_105_164,seq139,r_13_89_110,r_130_105_164,0.58,0,164,164,36
20,r_21_129_48,seq57,r_15_44_43,r_21_129_48,1,0,48,48,36
85,seq96,r_145_46_186,r_11_33_62,r_11_33_62,1,4,66,62,36
49,r_34_74_167,r_114_4_100,r_0_16_28,r_34_74_167,1,0,167,167,36
79,seq83,r_58_31_77,r_80_8_29,r_80_8_29,0.52,1,30,29,36
45,r_67_125_99,r_72_138_179,r_50_132_50,r_50_132_50,1,0,50,50,36
17,r_0_16_28,r_12_69_80,r_17_3_21,r_0_16_28,0.9,0,28,28,36
2,r_13_89_110,r_36_86_122,seq62,r_13_89_110,0.7,0,110,110,36
47,r_103_29_144,seq137,r_41_141_192,r_103_29_144,0.85,0,144,144,36
40,r_11_33_62,seq88,seq96,r_11_33_62,1,0,62,62,36
24,r_55_65_85,seq64,seq104,r_55_65_85,1,0,85,85,36
31,r_50_132_50,r_67_125_99,r_58_31_77,r_67_125_99,0.85,0,99,99,36
64,seq40,r_72_138_179,r_58_31_77,r_58_31_77,0.88,16,93,77,36
46,r_78_68_32,r_34_74_167,seq7,r_78_68_32,0.95,0,32,32,36
58,seq142,r_73_60_172,seq52,r_73_60_172,0.89,0,172,172,36
70,seq52,r_72_138_179,seq142,r_72_138_179,0.39,1,180,179,36
27,r_117_134_34,r_131_77_161,r_79_39_184,r_117_134_34,0.99,0,34,34,36
38,r_14_63_151,r_36_86_122,seq18,r_14_63_151,0.65,-30,121,151,36
34,r_79_39_184,seq102,r_13_89_110,r_79_39_184,0.55,0,184,184,36
19,r_41_141_192,r_112_56_2,r_103_29_144,r_41_141_192,0.6,-79,113,192,36
5,r_15_44_43,r_131_77_161,r_21_129_48,r_15_44_43,0.58,10,53,43,36
25,r_58_31_77,r_80_8_29,r_50_132_50,r_58_31_77,1,0,77,77,36
9,r_75_5_116,seq53,seq64,r_75_5_116,0.93,0,116,116,36
3,r_59_144_17,r_13_89_110,r_112_56_2,r_59_144_17,1,0,17,17,36
36,r_27_26_30,r_78_68_32,r_0_16_28,r_27_26_30,1,0,30,30,36
22,r_61_20_126,seq47,seq38,r_61_20_126,0.93,0,126,126,36
35,r_82_2_140,seq40,r_22_124_129,r_82_2_140,0.86,-13,127,140,36
28,r_72_138_179,seq52,seq98,r_72_138_179,0.38,0,179,179,36
91,seq109,seq93,r_111_19_118,r_111_19_118,0.69,1,119,118,36
17,r_0_16_28,r_17_3_21,r_27_26_30,r_0_16_28,0.6,27,55,28,36
49,r_34_74_167,r_108_147_142,r_114_4_100,r_114_4_100,0.94,19,119,100,36
7,r_114_4_100,r_79_39_184,r_34_74_167,r_114_4_100,0.91,0,100,100,36
44,r_48_30_145,r_118_71_127,r_75_5_116,r_75_5_116,0.65,11,127,116,36
23,r_32_106_14,seq47,r_17_3_21,r_17_3_21,1,104,125,21,36
35,r_82_2_140,r_73_60_172,seq40,r_82_2_140,0.53,-33,107,140,36
12,r_111_19_118,seq7,seq109,r_111_19_118,0.96,0,118,118,36
93,seq103,seq6,r_28_35_38,r_28_35_38,0.99,98,136,38,37
30,r_29_138_123,r_69_20_90,seq54,r_69_20_90,1,4,94,90,37
33,r_83_50_133,r_46_53_127,r_71_119_50,r_71_119_50,0.74,1,51,50,37
36,r_27_85_107,seq61,seq142,r_27_85_107,0.95,0,107,107,37
64,seq22,seq5,r_43_118_42,r_43_118_42,1,1,43,42,37
14,r_94_68_77,r_18_133_113,seq36,r_94_68_77,1,1,78,77,37
26,r_62_23_35,r_66_7_52,seq89,r_62_23_35,0.96,2,37,35,37
28,r_87_17_32,r_84_145_110,r_107_2_26,r_87_17_32,1,0,32,32,37
3,r_55_121_190,r_72_91_48,r_30_148_74,r_55_121_190,0.43,0,190,190,37
59,seq12,seq136,r_120_88_58,r_120_88_58,0.77,16,74,58,37
19,r_46_53_127,seq102,r_69_20_90,r_46_53_127,0.98,0,127,127,37
37,r_71_119_50,seq19,r_83_50_133,r_71_119_50,0.97,0,50,50,37
39,r_25_26_188,seq37,r_70_76_43,r_70_76_43,1,18,61,43,37
1,r_31_96_36,r_126_65_150,seq54,r_126_65_150,0.88,0,150,150,37
97,seq116,r_55_121_190,r_72_91_48,r_72_91_48,0.62,142,190,48,37
46,r_44_16_177,seq33,seq67,r_44_16_177,0.55,0,177,177,37
42,r_34_112_73,r_110_108_106,seq114,r_34_112_73,1,0,73,73,37
45,r_107_2_26,seq102,r_87_17_32,r_87_17_32,0.73,6,38,32,37
1,r_31_96_36,seq5,r_126_65_150,r_31_96_36,1,0,36,36,37
32,r_30_148_74,r_57_14_142,seq93,r_57_14_142,1,1,143,142,37
43,r_115_144_184,r_110_108_106,seq39,r_115_144_184,0.96,0,184,184,37
18,r_110_108_106,seq6,r_90_129_56,r_110_108_106,0.95,0,106,106,37
6,r_126_65_150,r_69_20_90,r_31_96_36,r_126_65_150,0.89,-115,35,150,37
47,r_130_45_168,r_126_65_150,r_28_35_38,r_130_45_168,0.95,0,168,168,37
24,r_141_106_164,r_101_63_176,seq114,r_101_63_176,0.54,-13,163,176,37
33,r_83_50_133,r_71_119_50,seq47,r_83_50_133,0.92,0,133,133,37
66,seq33,r_11_137_157,seq128,r_11_137_157,0.93,0,157,157,37
76,seq61,r_117_74_163,seq122,r_117_74_163,1,0,163,163,37
38,r_70_76_43,r_25_26_188,seq37,r_25_26_188,0.59,-3,185,188,37
39,r_25_26_188,r_70_76_43,r_58_0_67,r_58_0_67,0.73,121,188,67,37
31,r_84_145_110,seq47,r_28_35_38,r_84_145_110,1,0,110,110,37
75,seq54,seq135,r_31_96_36,r_31_96_36,0.58,115,151,36,37
67,seq36,r_24_143_160,r_94_68_77,r_94_68_77,0.93,83,160,77,37
41,r_146_125_13,r_25_26_188,seq147,r_25_26_188,0.75,-175,13,188,37
45,r_107_2_26,r_59_123_171,seq102,r_107_2_26,0.76,0,26,26,37
10,r_104_56_186,seq21,r_43_118_42,r_104_56_186,0.55,0,186,186,37
90,seq98,seq132,r_3_60_87,r_3_60_87,1,3,90,87,37
72,seq41,seq139,r_9_8_71,r_9_8_71,0.91,17,88,71,37
4,r_11_137_157,seq33,seq67,r_11_137_157,0.95,0,157,157,37
0,r_15_109_155,r_117_74_163,r_75_42_82,r_75_42_82,0.58,73,155,82,37
63,seq21,r_18_133_113,r_58_0_67,r_58_0_67,0.57,46,113,67,37
73,seq47,r_84_145_110,seq147,r_84_145_110,1,0,110,110,37
44,r_90_129_56,seq54,seq10,r_90_129_56,1,0,56,56,37
13,r_101_63_176,r_3_60_87,r_141_106_164,r_3_60_87,1,0,87,87,37
15,r_9_8_71,seq38,seq41,r_9_8_71,0.94,-1,70,71,37
48,r_120_88_58,seq142,seq67,r_120_88_58,0.76,5,63,58,37
49,r_59_123_171,seq67,seq40,r_59_123_171,0.53,0,171,171,37
12,r_75_42_82,r_87_17_32,r_15_109_155,r_15_109_155,0.9,5,160,155,37
17,r_66_7_52,seq132,seq124,r_66_7_52,0.99,0,52,52,37
13,r_101_63_176,r_141_106_164,seq22,r_101_63_176,0.42,-8,168,176,37
2,r_57_14_142,r_30_148_74,seq100,r_57_14_142,0.99,0,142,142,37
55,seq135,r_69_20_90,r_126_65_150,r_69_20_90,0.72,-59,31,90,37
73,seq47,seq147,r_83_50_133,r_83_50_133,0.98,22,155,133,37
27,r_69_20_90,r_29_138_123,r_90_129_56,r_29_138_123,1,-33,90,123,37
49,r_59_123_171,r_107_2_26,seq67,r_107_2_26,0.99,-1,25,26,37
22,r_72_91_48,r_55_121_190,seq116,r_72_91_48,0.59,142,190,48,37
2,r_57_14_142,r_44_16_177,r_30_148_74,r_30_148_74,1,0,74,74,37
47,r_130_45_168,r_115_144_184,r_126_65_150,r_126_65_150,0.76,0,150,150,37
38,r_70_76_43,seq78,r_25_26_188,r_70_76_43,1,0,43,43,37
18,r_110_108_106,r_34_112_73,seq6,r_34_112_73,0.63,-2,71,73,37
29,r_3_60_87,r_141_106_164,seq98,r_3_60_87,0.93,0,87,87,37
22,r_72_91_48,seq5,r_55_121_190,r_72_91_48,0.74,-7,41,48,37
24,r_141_106_164,r_3_60_87,r_101_63_176,r_3_60_87,1,0,87,87,37
35,r_127_82_185,seq92,r_24_143_160,r_24_143_160,0.68,1,161,160,37
25,r_49_113_60,seq10,seq134,r_49_113_60,0.96,1,61,60,37
43,r_115_144_184,seq10,r_110_108_106,r_110_108_106,0.82,19,125,106,37
19,r_46_53_127,r_43_118_42,seq102,r_43_118_42,0.91,-1,41,42,37
92,seq102,r_87_17_32,r_48_99_137,r_48_99_137,0.69,21,158,137,37
71,seq40,seq81,r_59_123_171,r_59_123_171,0.59,0,171,171,37
6,r_126_65_150,r_31_96_36,r_130_45_168,r_126_65_150,0.81,0,150,150,37
68,seq37,r_25_26_188,r_43_118_42,r_43_118_42,0.83,146,188,42,37
32,r_30_148_74,r_127_82_185,r_57_14_142,r_30_148_74,1,0,74,74,37
52,seq4,seq134,r_49_113_60,r_49_113_60,1,44,104,60,37
77,seq134,seq4,r_49_113_60,r_49_113_60,1,13,73,60,37
34,r_48_99_137,r_15_109_155,seq92,r_48_99_137,0.37,-32,105,137,37
43,r_115_144_184,r_130_45_168,seq10,r_115_144_184,0.67,-125,59,184,37
59,seq12,r_120_88_58,r_84_145_110,r_84_145_110,0.98,14,124,110,37
3,r_55_121_190,seq116,r_72_91_48,r_72_91_48,0.89,-7,41,48,37
34,r_48_99_137,seq92,seq102,r_48_99_137,0.99,0,137,137,37
94,seq111,seq139,r_94_68_77,r_94_68_77,0.89,56,133,77,37
30,r_29_138_123,r_127_82_185,seq61,r_127_82_185,0.52,-16,169,185,37
37,r_71_119_50,r_83_50_133,seq102,r_71_119_50,0.71,84,134,50,37
91,seq100,seq147,r_57_14_142,r_57_14_142,0.94,1,143,142,37
56,seq136,seq12,r_28_35_38,r_28_35_38,1,17,55,38,37
7,r_18_133_113,seq21,seq142,r_18_133_113,1,0,113,113,37
21,r_43_118_42,r_46_53_127,seq22,r_43_118_42,1,0,42,42,37
23,r_58_0_67,r_15_109_155,seq21,r_58_0_67,1,2,69,67,37
82,seq78,r_70_76_43,r_86_149_3,r_70_76_43,1,0,43,43,37
88,seq93,r_57_14_142,r_11_137_157,r_57_14_142,0.66,-104,38,142,37
35,r_127_82_185,r_30_148_74,seq92,r_30_148_74,1,2,76,74,37
61,seq142,seq6,r_18_133_113,r_18_133_113,1,6,119,113,37
12,r_75_42_82,seq40,r_87_17_32,r_75_42_82,0.81,0,82,82,37
93,seq105,r_76_58_185,r_56_81_128,r_56_81_128,1,4,132,128,38
30,r_119_28_151,seq144,seq142,r_119_28_151,0.94,0,151,151,38
51,seq130,r_94_62_131,seq16,r_94_62_131,0.94,2,133,131,38
9,r_110_137_191,seq107,r_98_114_23,r_98_114_23,0.93,20,43,23,38
57,seq142,r_9_129_55,r_128_97_104,r_9_129_55,0.86,0,55,55,38
57,seq142,r_128_97_104,seq105,r_128_97_104,0.92,-16,88,104,38
14,r_106_59_126,seq117,seq6,r_106_59_126,1,0,126,126,38
43,r_85_26_85,seq47,seq60,r_85_26_85,1,3,88,85,38
32,r_141_124_4,r_4_86_41,seq41,r_4_86_41,0.81,0,41,41,38
54,seq136,r_49_126_149,seq99,r_49_126_149,0.93,1,150,149,38
15,r_37_104_34,r_132_55_181,seq116,r_37_104_34,0.97,0,34,34,38
19,r_145_74_169,r_68_70_12,r_65_15_127,r_68_70_12,0.63,157,169,12,38
21,r_95_140_158,seq16,seq99,r_95_140_158,0.94,0,158,158,38
1,r_75_17_118,seq16,seq50,r_75_17_118,0.92,2,120,118,38
97,seq117,r_106_59_126,seq138,r_106_59_126,1,0,126,126,38
5,r_49_126_149,seq136,seq16,r_49_126_149,0.94,1,150,149,38
46,r_33_61_109,seq144,seq138,r_33_61_109,1,3,112,109,38
80,seq67,r_143_89_146,r_3_10_94,r_3_10_94,0.61,52,146,94,38
45,r_14_63_82,seq35,seq99,r_14_63_82,1,1,83,82,38
7,r_71_8_87,r_82_120_29,r_127_111_52,r_71_8_87,1,0,87,87,38
33,r_77_54_69,r_76_58_185,r_143_89_146,r_143_89_146,0.97,0,146,146,38
11,r_68_70_12,r_145_74_169,seq41,r_145_74_169,0.51,-4,165,169,38
95,seq108,r_53_27_134,seq46,r_53_27_134,1,0,134,134,38
38,r_78_43_163,r_9_129_55,r_2_38_145,r_78_43_163,0.87,0,163,163,38
94,seq107,r_36_113_56,seq35,r_36_113_56,1,-7,49,56,38
12,r_82_120_29,seq35,r_135_24_135,r_135_24_135,0.8,28,163,135,38
48,r_9_129_55,seq142,r_78_43_163,r_9_129_55,1,0,55,55,38
26,r_131_79_120,seq50,seq35,r_131_79_120,1,0,120,120,38
16,r_20_87_54,r_121_123_187,r_30_112_24,r_20_87_54,0.58,112,166,54,38
0,r_98_114_23,r_75_17_118,r_110_137_191,r_98_114_23,1,0,23,23,38
17,r_121_123_187,seq107,r_30_112_24,r_30_112_24,0.41,0,24,24,38
32,r_141_124_4,seq41,r_127_111_52,r_141_124_4,0.6,63,67,4,38
4,r_94_62_131,seq130,r_96_109_45,r_94_62_131,0.92,1,132,131,38
63,seq29,r_128_97_104,r_65_15_127,r_128_97_104,0.99,0,104,104,38
12,r_82_120_29,seq142,r_71_8_87,r_82_120_29,0.99,0,29,29,38
20,r_3_10_94,seq13,seq44,r_3_10_94,0.88,0,94,94,38
8,r_127_111_52,r_14_63_82,seq19,r_127_111_52,1,1,53,52,38
96,seq116,seq39,r_37_104_34,r_37_104_34,0.78,2,36,34,38
6,r_132_55_181,seq21,r_30_112_24,r_132_55_181,0.58,0,181,181,38
62,seq25,r_134_7_130,r_118_48_47,r_134_7_130,0.85,0,130,130,38
57,seq142,seq105,r_119_28_151,r_119_28_151,0.87,4,155,151,38
0,r_98_114_23,r_110_137_191,r_83_88_66,r_83_88_66,0.99,6,72,66,38
10,r_30_112_24,r_121_123_187,r_132_55_181,r_132_55_181,0.8,6,187,181,38
27,r_147_18_68,r_131_79_120,seq5,r_147_18_68,0.94,0,68,68,38
22,r_149_91_71,r_36_113_56,r_128_97_104,r_128_97_104,1,54,158,104,38
49,r_36_113_56,seq107,seq93,r_36_113_56,0.99,-2,54,56,38
47,r_128_97_104,seq29,r_149_91_71,r_128_97_104,0.98,0,104,104,38
40,r_22_133_137,seq0,seq72,r_22_133_137,0.94,1,138,137,38
18,r_56_81_128,r_2_38_145,seq105,r_56_81_128,0.81,0,128,128,38
29,r_134_7_130,seq25,seq107,r_134_7_130,0.88,0,130,130,38
1,r_75_17_118,r_98_114_23,seq16,r_98_114_23,1,-1,22,23,38
41,r_4_86_41,r_145_74_169,r_141_124_4,r_141_124_4,0.99,6,10,4,38
25,r_115_12_3,r_78_43_163,r_9_129_55,r_9_129_55,1,34,89,55,38
33,r_77_54_69,seq93,r_76_58_185,r_77_54_69,1,0,69,69,38
48,r_9_129_55,r_78_43_163,r_115_12_3,r_78_43_163,0.7,-21,142,163,38
42,r_66_57_38,r_106_59_126,seq50,r_66_57_38,0.92,0,38,38,38
60,seq19,r_68_70_12,r_127_111_52,r_127_111_52,1,1,53,52,38
50,seq0,r_22_133_137,r_148_23_48,r_22_133_137,0.97,-8,129,137,38
12,r_82_120_29,r_71_8_87,seq35,r_71_8_87,0.92,0,87,87,38
61,seq21,r_132_55_181,r_148_23_48,r_148_23_48,0.95,133,181,48,38
38,r_78_43_163,r_83_88_66,r_9_129_55,r_78_43_163,1,-97,66,163,38
52,seq5,r_101_139_138,r_147_18_68,r_147_18_68,0.99,70,138,68,38
16,r_20_87_54,r_3_10_94,r_121_123_187,r_20_87_54,1,0,54,54,38
28,r_96_109_45,r_145_74_169,r_98_114_23,r_96_109_45,1,0,45,45,38
34,r_143_89_146,seq67,r_77_54_69,r_143_89_146,0.83,0,146,146,38
7,r_71_8_87,r_121_123_187,r_82_120_29,r_82_120_29,0.87,1,30,29,38
28,r_96_109_45,r_98_114_23,r_94_62_131,r_94_62_131,0.99,2,133,131,38
22,r_149_91_71,r_94_62_131,r_36_113_56,r_149_91_71,1,0,71,71,38
41,r_4_86_41,r_141_124_4,seq42,r_4_86_41,1,0,41,41,38
23,r_83_88_66,r_78_43_163,r_98_114_23,r_78_43_163,0.58,-97,66,163,38
94,seq107,seq35,r_134_7_130,r_134_7_130,1,9,139,130,38
17,r_121_123_187,r_30_112_24,seq42,r_121_123_187,0.38,0,187,187,38
10,r_30_112_24,r_77_54_69,r_121_123_187,r_30_112_24,0.98,0,24,24,38
9,r_1_82_5,r_79_127_73,r_62_111_190,r_79_127_73,1,0,73,73,39
22,r_96_147_39,seq106,r_130_50_181,r_96_147_39,1,0,39,39,39
38,r_93_42_53,seq75,r_29_88_7,r_93_42_53,1,0,53,53,39
9,r_1_82_5,r_62_111_190,r_86_123_83,r_62_111_190,0.69,-34,156,190,39
8,r_37_44_136,seq131,seq41,r_37_44_136,0.83,1,137,136,39
49,r_6_18_103,seq114,r_90_0_143,r_90_0_143,0.63,19,162,143,39
43,r_30_83_129,r_8_34_80,r_68_128_45,r_30_83_129,0.96,-49,80,129,39
4,r_19_16_171,r_138_25_107,r_2_94_29,r_2_94_29,0.93,24,53,29,39
37,r_51_89_155,r_73_32_137,r_60_59_1,r_73_32_137,0.59,0,137,137,39
91,seq106,r_96_147_39,seq64,r_96_147_39,0.49,4,43,39,39
37,r_51_89_155,r_60_59_1,seq137,r_51_89_155,0.69,0,155,155,39
19,r_149_76_20,r_63_91_187,seq38,r_63_91_187,0.55,-91,96,187,39
55,seq10,seq45,r_53_61_139,r_53_61_139,1,21,160,139,39
71,seq40,r_6_18_103,r_70_87_6,r_6_18_103,1,1,104,103,39
86,seq98,seq132,r_81_20_76,r_81_20_76,1,19,95,76,39
16,r_7_116_101,seq23,seq3,r_7_116_101,0.98,0,101,101,39
21,r_73_32_137,r_51_89_155,seq64,r_73_32_137,0.64,0,137,137,39
39,r_117_9_118,seq41,r_96_147_39,r_117_9_118,0.49,0,118,118,39
42,r_15_119_110,r_73_32_137,r_7_116_101,r_15_119_110,0.98,0,110,110,39
93,seq113,seq137,r_35_126_31,r_35_126_31,0.66,5,36,31,39
80,seq64,seq106,r_73_32_137,r_73_32_137,0.55,0,137,137,39
1,r_112_144_72,seq41,r_2_94_29,r_112_144_72,0.9,2,74,72,39
32,r_21_139_8,r_90_0_143,seq104,r_21_139_8,0.53,104,112,8,39
11,r_63_91_187,r_149_76_20,r_19_16_171,r_63_91_187,0.45,0,187,187,39
66,seq31,r_47_105_168,r_81_20_76,r_81_20_76,1,71,147,76,39
31,r_24_107_142,r_51_89_155,seq141,r_24_107_142,0.97,0,142,142,39
41,r_90_0_143,seq95,seq141,r_90_0_143,0.96,1,144,143,39
10,r_66_103_161,seq137,r_74_124_79,r_66_103_161,0.84,0,161,161,39
30,r_26_65_97,seq39,r_29_88_7,r_29_88_7,0.89,12,19,7,39
26,r_136_92_41,r_6_18_103,r_108_129_17,r_136_92_41,0.56,-24,17,41,39
72,seq41,r_117_9_118,seq140,r_117_9_118,1,0,118,118,39
28,r_85_48_26,seq98,r_46_72_138,r_85_48_26,0.81,0,26,26,39
33,r_55_146_183,r_63_91_187,r_145_134_158,r_145_134_158,0.61,-33,125,158,39
46,r_79_127_73,r_1_82_5,seq104,r_79_127_73,1,1,74,73,39
15,r_133_13_74,r_90_0_143,seq3,r_133_13_74,1,0,74,74,39
4,r_19_16_171,r_2_94_29,seq140,r_2_94_29,0.63,142,171,29,39
35,r_143_78_37,r_7_116_101,r_80_109_193,r_143_78_37,0.99,2,39,37,39
62,seq23,r_7_116_101,seq114,r_7_116_101,0.8,-17,84,101,39
3,r_108_129_17,r_74_124_79,r_136_92_41,r_108_129_17,0.94,26,43,17,39
0,r_130_50_181,seq125,r_96_147_39,r_96_147_39,0.94,1,40,39,39
5,r_138_25_107,r_11_115_195,r_2_94_29,r_11_115_195,0.54,-12,183,195,39
19,r_149_76_20,r_19_16_171,r_63_91_187,r_149_76_20,1,0,20,20,39
12,r_100_142_18,seq148,seq98,r_100_142_18,0.94,0,18,18,39
6,r_86_123_83,r_71_49_167,r_1_82_5,r_71_49_167,1,0,167,167,39
0,r_130_50_181,r_96_147_39,r_108_129_17,r_96_147_39,0.72,143,182,39,39
30,r_26_65_97,r_29_88_7,seq99,r_26_65_97,1,0,97,97,39
87,seq99,r_11_115_195,r_145_134_158,r_145_134_158,1,14,172,158,39
27,r_2_94_29,seq140,seq36,r_2_94_29,1,1,30,29,39
22,r_96_147_39,r_130_50_181,r_117_9_118,r_117_9_118,0.96,63,181,118,39
2,r_8_34_80,r_30_83_129,r_85_48_26,r_8_34_80,1,0,80,80,39
47,r_145_134_158,r_55_146_183,seq99,r_145_134_158,0.65,1,159,158,39
48,r_68_128_45,r_145_134_158,seq121,r_68_128_45,1,0,45,45,39
18,r_53_61_139,seq56,seq10,r_53_61_139,0.96,0,139,139,39
29,r_81_20_76,seq135,seq98,r_81_20_76,1,1,77,76,39
24,r_46_72_138,seq58,seq137,r_46_72_138,0.93,0,138,138,39
33,r_55_146_183,r_145_134_158,r_63_91_187,r_145_134_158,0.7,8,166,158,39
25,r_71_49_167,r_37_44_136,r_86_123_83,r_86_123_83,0.8,13,96,83,39
33,r_55_146_183,r_145_134_158,r_63_91_187,r_55_146_183,0.35,-72,111,183,39
88,seq101,r_74_124_79,r_136_92_41,r_74_124_79,0.63,0,79,79,39
50,seq3,r_53_61_139,r_133_13_74,r_133_13_74,0.62,10,84,74,39
58,seq14,r_51_89_155,seq28,r_51_89_155,0.67,0,155,155,39
20,r_35_126_31,r_112_144_72,seq113,r_35_126_31,1,1,32,31,39
68,seq36,r_138_25_107,r_2_94_29,r_2_94_29,0.59,77,106,29,39
61,seq148,seq52,r_74_124_79,r_74_124_79,1,63,142,79,39
77,seq56,r_53_61_139,r_74_124_79,r_74_124_79,0.69,60,139,79,39
75,seq52,seq3,r_77_12_36,r_77_12_36,1,26,62,36,39
1,r_112_144_72,r_35_126_31,seq41,r_35_126_31,0.95,0,31,31,39
45,r_29_88_7,r_26_65_97,r_93_42_53,r_29_88_7,1,90,97,7,39
17,r_80_109_193,r_47_105_168,r_143_78_37,r_143_78_37,1,132,169,37,39
25,r_71_49_167,r_86_123_83,r_53_61_139,r_71_49_167,0.92,2,169,167,39
3,r_108_129_17,r_19_16_171,r_74_124_79,r_108_129_17,0.88,0,17,17,39
6,r_86_123_83,seq52,r_71_49_167,r_86_123_83,1,0,83,83,39
28,r_85_48_26,r_46_72_138,r_8_34_80,r_85_48_26,0.96,66,92,26,39
49,r_6_18_103,seq40,seq114,r_6_18_103,0.92,20,123,103,39
43,r_30_83_129,r_68_128_45,r_79_127_73,r_30_83_129,0.98,0,129,129,39
82,seq75,r_93_42_53,r_47_105_168,r_93_42_53,0.98,-1,52,53,39
7,r_47_105_168,r_80_109_193,seq27,r_47_105_168,0.71,2,170,168,39
44,r_74_124_79,seq101,seq148,r_74_124_79,1,0,79,79,39
11,r_63_91_187,seq38,r_149_76_20,r_149_76_20,0.95,19,39,20,39
34,r_77_12_36,r_37_44_136,seq52,r_77_12_36,1,0,36,36,39
33,r_55_146_183,r_63_91_187,r_60_59_1,r_55_146_183,0.78,0,183,183,39
23,r_69_22_11,seq33,seq84,r_69_22_11,0.77,0,11,11,39
37,r_118_8_47,seq105,r_14_120_14,r_118_8_47,0.97,0,47,47,40
30,r_24_41_157,r_145_0_77,r_67_141_74,r_24_41_157,0.86,-79,78,157,40
44,r_67_141_74,r_24_41_157,seq140,r_24_41_157,0.74,0,157,157,40
51,seq132,r_142_20_124,r_143_40_86,r_142_20_124,0.72,0,124,124,40
43,r_18_116_188,seq11,r_46_43_68,r_46_43_68,0.99,3,71,68,40
83,seq71,r_95_68_163,seq55,r_95_68_163,0.97,0,163,163,40
3,r_79_114_101,r_66_102_29,r_128_49_194,r_79_114_101,0.81,1,102,101,40
59,seq15,r_133_60_103,r_84_73_185,r_133_60_103,0.73,-3,100,103,40
21,r_39_85_66,r_109_101_98,seq83,r_39_85_66,0.57,0,66,66,40
1,r_144_131_131,r_124_54_73,r_139_113_51,r_144_131_131,1,-57,74,131,40
46,r_93_22_32,seq103,r_89_97_91,r_89_97_91,0.98,0,91,91,40
42,r_121_1_114,r_19_106_104,seq87,r_19_106_104,0.96,-22,82,104,40
32,r_119_63_58,r_80_135_190,r_125_69_50,r_125_69_50,0.72,140,190,50,40
69,seq28,r_82_42_182,r_24_41_157,r_24_41_157,0.99,26,183,157,40
45,r_35_51_95,seq25,seq61,r_35_51_95,1,0,95,95,40
89,seq92,seq13,r_109_101_98,r_109_101_98,0.96,62,160,98,40
19,r_36_115_130,r_67_141_74,seq98,r_67_141_74,1,0,74,74,40
0,r_137_57_48,r_67_141_74,r_18_116_188,r_137_57_48,0.91,2,50,48,40
15,r_77_59_169,r_14_120_14,seq5,r_14_120_14,0.28,156,170,14,40
76,seq50,r_99_65_193,r_4_100_90,r_4_100_90,1,90,180,90,40
89,seq92,r_62_29_83,seq13,r_62_29_83,1,-17,66,83,40
10,r_111_23_198,r_144_131_131,r_139_113_51,r_139_113_51,0.55,22,73,51,40
15,r_77_59_169,r_122_9_165,r_14_120_14,r_14_120_14,0.91,9,23,14,40
26,r_62_29_83,seq13,seq86,r_62_29_83,1,2,85,83,40
8,r_14_120_14,r_77_59_169,r_3_47_34,r_14_120_14,0.51,98,112,14,40
4,r_142_20_124,seq132,seq48,r_142_20_124,0.95,0,124,124,40
11,r_38_129_115,seq130,r_89_97_91,r_38_129_115,0.91,-1,114,115,40
63,seq147,r_80_135_190,r_125_69_50,r_125_69_50,0.96,34,84,50,40
8,r_14_120_14,seq83,r_77_59_169,r_14_120_14,0.89,1,15,14,40
11,r_38_129_115,r_109_101_98,seq130,r_109_101_98,0.75,0,98,98,40
0,r_137_57_48,r_18_116_188,r_46_43_68,r_46_43_68,0.99,0,68,68,40
20,r_4_100_90,r_133_60_103,r_39_85_66,r_39_85_66,0.69,24,90,66,40
48,r_122_9_165,r_77_59_169,seq25,r_122_9_165,0.56,0,165,165,40
98,seq126,r_144_131_131,r_139_113_51,r_139_113_51,0.97,7,58,51,40
7,r_109_101_98,r_39_85_66,r_38_129_115,r_39_85_66,0.98,-18,48,66,40
1,r_144_131_131,r_139_113_51,seq55,r_144_131_131,1,0,131,131,40
13,r_66_102_29,r_79_114_101,r_88_30_78,r_79_114_101,0.5,0,101,101,40
6,r_89_97_91,r_117_74_109,r_93_22_32,r_93_22_32,0.94,60,92,32,40
62,seq146,r_6_70_168,seq91,r_6_70_168,0.83,-2,166,168,40
7,r_109_101_98,r_38_129_115,r_123_136_40,r_109_101_98,0.99,0,98,98,40
16,r_3_47_34,r_145_0_77,r_14_120_14,r_3_47_34,1,0,34,34,40
27,r_80_135_190,seq147,r_119_63_58,r_119_63_58,1,26,84,58,40
30,r_24_41_157,r_67_141_74,seq28,r_24_41_157,0.98,0,157,157,40
22,r_96_149_134,r_78_81_16,r_142_20_124,r_96_149_134,0.99,0,134,134,40
47,r_133_60_103,r_4_100_90,seq15,r_133_60_103,0.45,-13,90,103,40
40,r_145_0_77,r_24_41_157,seq105,r_24_41_157,0.53,-62,95,157,40
74,seq45,r_138_76_145,seq146,r_138_76_145,0.75,1,146,145,40
29,r_88_30_78,seq11,seq55,r_88_30_78,0.97,-1,77,78,40
24,r_138_76_145,seq45,seq16,r_138_76_145,0.56,1,146,145,40
18,r_125_69_50,r_96_149_134,seq147,r_125_69_50,0.8,-31,19,50,40
13,r_66_102_29,seq10,r_79_114_101,r_66_102_29,0.93,2,31,29,40
25,r_75_64_129,seq7,r_38_129_115,r_75_64_129,0.89,0,129,129,40
43,r_18_116_188,r_46_43_68,r_119_63_58,r_18_116_188,0.48,0,188,188,40
33,r_82_42_182,seq28,r_144_131_131,r_144_131_131,1,52,183,131,40
70,seq31,seq48,r_46_43_68,r_46_43_68,0.98,53,121,68,40
32,r_119_63_58,r_77_59_169,r_80_135_190,r_119_63_58,1,0,58,58,40
22,r_96_149_134,seq83,r_78_81_16,r_78_81_16,0.7,0,16,16,40
12,r_123_136_40,r_89_97_91,seq13,r_123_136_40,0.99,-3,37,40,40
39,r_34_110_52,r_75_64_129,r_78_81_16,r_34_110_52,1,0,52,52,40
81,seq61,seq104,r_35_51_95,r_35_51_95,1,46,141,95,40
9,r_46_43_68,r_19_106_104,r_137_57_48,r_46_43_68,1,0,68,68,40
17,r_78_81_16,r_18_116_188,r_96_149_134,r_78_81_16,0.96,0,16,16,40
28,r_128_49_194,r_84_73_185,r_79_114_101,r_128_49_194,0.77,-121,73,194,40
91,seq98,r_36_115_130,seq7,r_36_115_130,0.57,-7,123,130,40
49,r_95_68_163,seq71,r_133_60_103,r_95_68_163,0.87,0,163,163,40
44,r_67_141_74,r_36_115_130,r_24_41_157,r_67_141_74,1,0,74,74,40
23,r_124_54_73,r_144_131_131,r_133_60_103,r_144_131_131,0.71,-58,73,131,40
17,r_78_81_16,r_96_149_134,r_34_110_52,r_78_81_16,0.96,118,134,16,40
3,r_79_114_101,seq71,r_66_102_29,r_66_102_29,0.7,13,42,29,40
47,r_133_60_103,r_78_81_16,r_95_68_163,r_95_68_163,0.99,1,164,163,40
84,seq83,seq50,r_39_85_66,r_39_85_66,0.98,0,66,66,40
30,r_81_62_140,seq22,r_70_72_81,r_81_62_140,0.99,0,140,140,41
44,r_103_86_183,r_100_101_44,r_138_24_70,r_100_101_44,0.84,139,183,44,41
36,r_2_63_166,seq17,seq44,r_2_63_166,0.52,1,167,166,41
37,r_115_26_16,r_131_49_185,r_106_74_179,r_115_26_16,0.96,0,16,16,41
88,seq95,r_112_19_38,seq129,r_112_19_38,1,-1,37,38,41
39,r_125_45_177,r_110_118_143,r_106_74_179,r_106_74_179,0.77,3,182,179,41
34,r_105_71_45,seq102,r_100_101_44,r_105_71_45,1,0,45,45,41
3,r_85_145_184,seq117,seq146,r_85_145_184,1,-1,183,184,41
43,r_140_60_14,seq127,r_90_143_2,r_140_60_14,0.93,0,14,14,41
59,seq17,r_2_63_166,r_27_120_89,r_27_120_89,0.99,77,166,89,41
71,seq41,r_25_136_129,seq17,r_25_136_129,0.81,3,132,129,41
21,r_77_119_134,r_137_147_161,r_38_99_125,r_77_119_134,0.73,2,136,134,41
91,seq104,r_3_65_50,seq13,r_3_65_50,1,6,56,50,41
5,r_70_72_81,seq29,seq13,r_70_72_81,0.97,0,81,81,41
46,r_38_99_125,seq79,seq29,r_38_99_125,0.96,0,125,125,41
38,r_112_19_38,seq95,r_148_37_191,r_112_19_38,1,1,39,38,41
14,r_35_94_141,r_67_59_15,seq13,r_67_59_15,0.94,0,15,15,41
45,r_8_33_1,r_125_45_177,r_139_108_147,r_8_33_1,0.57,151,152,1,41
82,seq79,seq102,r_56_16_180,r_56_16_180,0.97,1,181,180,41
19,r_10_78_102,seq28,r_124_32_13,r_10_78_102,0.49,1,103,102,41
95,seq117,r_137_147_161,r_25_136_129,r_25_136_129,0.99,32,161,129,41
76,seq57,r_107_83_175,r_116_21_159,r_116_21_159,0.84,14,173,159,41
39,r_125_45_177,r_68_46_152,r_110_118_143,r_125_45_177,0.91,-25,152,177,41
31,r_48_113_186,r_7_14_97,seq149,r_48_113_186,0.38,4,190,186,41
65,seq29,r_64_4_188,r_38_99_125,r_38_99_125,1,0,125,125,41
3,r_85_145_184,r_77_119_134,seq117,r_77_119_134,0.87,-12,122,134,41
90,seq102,r_66_87_63,seq79,r_66_87_63,1,4,67,63,41
26,r_128_93_149,seq97,seq88,r_128_93_149,0.78,2,151,149,41
27,r_67_59_15,r_35_94_141,seq127,r_67_59_15,0.82,0,15,15,41
14,r_35_94_141,seq13,seq69,r_35_94_141,0.6,0,141,141,41
4,r_23_30_113,r_131_49_185,r_91_141_46,r_23_30_113,0.96,0,113,113,41
0,r_116_21_159,seq121,seq57,r_116_21_159,0.86,0,159,159,41
63,seq22,r_81_62_140,seq39,r_81_62_140,0.58,0,140,140,41
11,r_110_118_143,seq9,r_125_45_177,r_110_118_143,0.88,0,143,143,41
13,r_124_32_13,seq41,r_10_78_102,r_124_32_13,0.89,90,103,13,41
29,r_42_98_26,r_90_143_2,seq109,r_42_98_26,1,0,26,26,41
15,r_66_87_63,seq102,seq121,r_66_87_63,1,4,67,63,41
48,r_137_147_161,seq117,seq97,r_137_147_161,0.63,0,161,161,41
49,r_64_4_188,seq29,r_38_99_125,r_38_99_125,1,33,158,125,41
19,r_10_78_102,r_124_32_13,r_73_122_123,r_73_122_123,1,0,123,123,41
6,r_90_143_2,r_55_12_3,r_140_60_14,r_140_60_14,0.92,69,83,14,41
1,r_100_101_44,r_110_118_143,r_105_71_45,r_100_101_44,1,1,45,44,41
56,seq13,seq104,r_70_72_81,r_70_72_81,0.61,0,81,81,41
5,r_70_72_81,seq13,r_81_62_140,r_81_62_140,1,4,144,140,41
2,r_91_141_46,r_107_83_175,r_23_30_113,r_23_30_113,0.95,0,113,113,41
2,r_91_141_46,r_7_14_97,r_107_83_175,r_91_141_46,0.76,15,61,46,41
47,r_73_122_123,r_148_37_191,r_10_78_102,r_73_122_123,0.93,0,123,123,41
40,r_43_51_131,seq127,r_25_136_129,r_43_51_131,0.57,0,131,131,41
18,r_138_24_70,r_64_4_188,seq15,r_138_24_70,0.99,0,70,70,41
24,r_56_16_180,seq15,seq79,r_56_16_180,0.55,0,180,180,41
25,r_25_136_129,seq41,r_43_51_131,r_25_136_129,0.68,2,131,129,41
33,r_80_135_87,seq129,seq5,r_80_135_87,1,0,87,87,41
64,seq28,r_10_78_102,r_8_33_1,r_10_78_102,1,0,102,102,41
50,seq129,r_80_135_87,seq9,r_80_135_87,1,0,87,87,41
92,seq109,r_48_113_186,r_42_98_26,r_42_98_26,0.95,-1,25,26,41
65,seq29,r_70_72_81,r_64_4_188,r_70_72_81,1,-1,80,81,41
42,r_106_74_179,r_115_26_16,r_125_45_177,r_106_74_179,0.56,0,179,179,41
61,seq20,r_142_40_73,r_64_4_188,r_142_40_73,0.98,2,75,73,41
32,r_27_120_89,seq146,r_112_19_38,r_27_120_89,0.99,0,89,89,41
38,r_112_19_38,r_148_37_191,r_27_120_89,r_27_120_89,1,0,89,89,41
67,seq133,seq76,r_3_65_50,r_3_65_50,0.99,5,55,50,41
60,seq146,r_27_120_89,seq52,r_27_120_89,0.98,-29,60,89,41
9,r_139_108_147,r_134_96_195,r_8_33_1,r_139_108_147,1,0,147,147,41
17,r_142_40_73,seq20,r_7_14_97,r_142_40_73,1,0,73,73,41
96,seq121,r_116_21_159,seq50,r_116_21_159,0.61,-11,148,159,41
41,r_3_65_50,seq104,seq133,r_3_65_50,1,1,51,50,41
37,r_115_26_16,r_106_74_179,seq50,r_115_26_16,0.61,163,179,16,41
99,seq127,seq121,r_67_59_15,r_67_59_15,1,29,44,15,41
22,r_47_0_98,seq44,seq5,r_47_0_98,0.65,-43,55,98,41
28,r_18_1_151,seq75,r_67_59_15,r_18_1_151,0.88,0,151,151,41
49,r_64_4_188,r_138_24_70,seq29,r_138_24_70,0.98,0,70,70,41
44,r_103_86_183,r_77_119_134,r_100_101_44,r_100_101_44,0.93,31,75,44,41
82,seq79,r_38_99_125,seq102,r_38_99_125,0.96,0,125,125,41
42,r_106_74_179,seq50,r_115_26_16,r_115_26_16,1,2,18,16,41
60,seq146,seq52,r_85_145_184,r_85_145_184,0.56,1,185,184,41
12,r_148_37_191,r_73_122_123,r_27_120_89,r_27_120_89,0.9,34,123,89,41
22,r_47_0_98,seq5,seq121,r_47_0_98,0.69,0,98,98,41
32,r_77_16_115,r_29_40_138,seq43,r_77_16_115,0.76,-2,113,115,42
92,seq107,r_147_6_58,seq119,r_147_6_58,0.6,4,62,58,42
14,r_133_76_127,r_130_149_175,r_120_21_147,r_133_76_127,0.7,0,127,127,42
8,r_15_2_103,r_35_61_67,r_74_68_163,r_35_61_67,1,0,67,67,42
43,r_92_22_148,seq42,seq134,r_92_22_148,0.61,-81,67,148,42
3,r_37_100_13,r_0_46_160,r_97_66_30,r_0_46_160,0.48,3,163,160,42
19,r_35_61_67,r_11_112_122,r_77_16_115,r_35_61_67,0.86,62,129,67,42
55,seq134,r_115_39_181,seq87,r_115_39_181,0.65,-45,136,181,42
39,r_131_86_97,r_130_149_175,seq106,r_131_86_97,0.88,0,97,97,42
69,seq47,seq128,r_101_8_39,r_101_8_39,0.73,120,159,39,42
45,r_33_52_183,seq94,seq107,r_33_52_183,0.63,-1,182,183,42
24,r_115_39_181,seq140,r_64_34_23,r_115_39_181,0.94,0,181,181,42
19,r_35_61_67,r_15_2_103,r_11_112_122,r_35_61_67,0.95,0,67,67,42
4,r_0_46_160,r_24_82_4,r_37_100_13,r_37_100_13,0.67,2,15,13,42
95,seq117,r_7_1_145,r_44_132_151,r_44_132_151,0.91,1,152,151,42
26,r_93_84_33,r_146_123_62,r_115_39_181,r_146_123_62,1,0,62,62,42
31,r_60_139_104,seq83,r_126_148_22,r_60_139_104,0.43,-23,81,104,42
41,r_44_132_151,seq5,seq117,r_44_132_151,0.61,-56,95,151,42
30,r_146_123_62,r_27_118_128,r_93_84_33,r_93_84_33,0.66,0,33,33,42
5,r_31_110_14,seq85,r_45_13_46,r_45_13_46,1,3,49,46,42
37,r_105_102_15,seq98,r_109_36_126,r_105_102_15,0.93,0,15,15,42
42,r_145_138_52,r_27_118_128,seq90,r_145_138_52,1,2,54,52,42
15,r_69_30_146,seq17,seq117,r_69_30_146,0.96,0,146,146,42
44,r_126_148_22,r_120_21_147,seq83,r_126_148_22,0.92,0,22,22,42
72,seq53,seq94,r_109_36_126,r_109_36_126,0.65,1,127,126,42
16,r_29_40_138,r_79_26_179,r_11_112_122,r_29_40_138,0.98,0,138,138,42
78,seq63,r_81_116_188,seq128,r_81_116_188,0.65,-1,187,188,42
73,seq54,r_73_78_177,r_146_123_62,r_146_123_62,1,8,70,62,42
3,r_37_100_13,seq134,r_0_46_160,r_37_100_13,1,0,13,13,42
20,r_147_6_58,seq107,seq113,r_147_6_58,0.98,4,62,58,42
5,r_31_110_14,seq12,seq85,r_31_110_14,0.81,0,14,14,42
13,r_72_70_137,seq113,seq137,r_72_70_137,0.52,1,138,137,42
15,r_69_30_146,seq4,seq62,r_69_30_146,0.36,-91,55,146,42
48,r_88_58_78,seq106,seq3,r_88_58_78,1,0,78,78,42
26,r_93_84_33,seq85,r_146_123_62,r_93_84_33,0.9,-2,31,33,42
4,r_0_46_160,r_37_100_13,seq106,r_0_46_160,0.99,0,160,160,42
6,r_143_65_86,seq83,seq129,r_143_65_86,0.88,0,86,86,42
17,r_111_49_182,r_44_132_151,r_74_68_163,r_111_49_182,0.97,0,182,182,42
30,r_146_123_62,r_93_84_33,seq54,r_146_123_62,1,1,63,62,42
10,r_97_66_30,r_24_82_4,seq41,r_97_66_30,0.81,28,58,30,42
27,r_20_136_105,r_11_112_122,seq17,r_20_136_105,0.96,1,106,105,42
29,r_91_80_31,seq42,r_31_110_14,r_91_80_31,1,0,31,31,42
91,seq106,r_131_86_97,r_0_46_160,r_0_46_160,0.99,1,161,160,42
69,seq47,r_101_8_39,r_20_136_105,r_101_8_39,0.61,145,184,39,42
2,r_32_59_112,r_73_78_177,seq117,r_32_59_112,0.97,0,112,112,42
93,seq108,seq57,r_64_34_23,r_64_34_23,1,1,24,23,42
18,r_73_78_177,seq54,seq43,r_73_78_177,0.64,0,177,177,42
24,r_115_39_181,r_27_118_128,seq140,r_27_118_128,1,-20,108,128,42
43,r_92_22_148,seq134,r_24_82_4,r_24_82_4,0.61,90,94,4,42
22,r_11_112_122,r_35_61_67,r_93_84_33,r_11_112_122,0.9,-5,117,122,42
86,seq90,seq25,r_145_138_52,r_145_138_52,0.76,2,54,52,42
0,r_101_8_39,r_45_13_46,seq128,r_101_8_39,1,0,39,39,42
8,r_15_2_103,r_74_68_163,seq129,r_15_2_103,1,0,103,103,42
34,r_71_104_81,seq56,r_11_112_122,r_71_104_81,1,0,81,81,42
47,r_24_82_4,r_97_66_30,seq67,r_97_66_30,0.75,2,32,30,42
40,r_64_34_23,seq83,seq108,r_64_34_23,0.99,0,23,23,42
23,r_120_21_147,r_126_148_22,r_133_76_127,r_120_21_147,0.98,-127,20,147,42
90,seq103,seq85,r_51_124_41,r_51_124_41,1,8,49,41,42
17,r_111_49_182,seq117,r_44_132_151,r_44_132_151,0.42,-23,128,151,42
25,r_144_95_9,seq53,r_109_36_126,r_109_36_126,1,13,139,126,42
9,r_114_9_59,seq113,seq57,r_114_9_59,0.99,1,60,59,42
1,r_51_124_41,seq83,r_91_80_31,r_51_124_41,0.97,0,41,41,42
22,r_11_112_122,r_20_136_105,r_35_61_67,r_35_61_67,1,38,105,67,42
28,r_27_118_128,r_115_39_181,seq113,r_27_118_128,0.97,0,128,128,42
34,r_71_104_81,r_11_112_122,seq43,r_11_112_122,0.95,0,122,122,42
49,r_109_36_126,r_105_102_15,seq53,r_109_36_126,0.96,0,126,126,42
35,r_45_13_46,r_101_8_39,r_31_110_14,r_45_13_46,1,-3,43,46,42
26,r_93_84_33,r_115_39_181,r_11_112_122,r_93_84_33,0.7,90,123,33,42
82,seq83,r_143_65_86,r_126_148_22,r_143_65_86,0.95,1,87,86,42
12,r_130_149_175,r_133_76_127,seq121,r_133_76_127,0.96,0,127,127,42
84,seq87,r_115_39_181,seq134,r_115_39_181,0.48,0,181,181,42
31,r_60_139_104,r_126_148_22,r_51_124_41,r_60_139_104,1,0,104,104,42
12,r_130_149_175,seq121,seq50,r_130_149_175,0.98,0,175,175,42
40,r_63_118_27,r_142_135_155,seq87,r_63_118_27,0.9,4,31,27,43
30,r_42_125_65,seq34,seq78,r_42_125_65,0.63,12,77,65,43
44,r_56_55_77,seq121,r_142_135_155,r_142_135_155,0.97,15,170,155,43
46,r_26_71_18,seq59,r_6_45_8,r_26_71_18,0.87,0,18,18,43
43,r_0_9_171,seq3,seq70,r_0_9_171,0.67,0,171,171,43
23,r_93_15_61,seq67,r_22_64_78,r_22_64_78,0.63,3,81,78,43
83,seq82,r_52_66_92,seq120,r_52_66_92,0.97,0,92,92,43
37,r_47_19_126,r_52_66_92,seq100,r_52_66_92,0.83,-32,60,92,43
21,r_146_140_144,r_40_27_108,seq78,r_146_140_144,0.95,0,144,144,43
71,seq54,r_48_131_137,seq120,r_48_131_137,0.7,-19,118,137,43
86,seq88,seq58,r_116_21_115,r_116_21_115,1,12,127,115,43
16,r_33_148_114,seq75,seq144,r_33_148_114,0.99,1,115,114,43
21,r_146_140_144,r_99_20_125,r_40_27_108,r_40_27_108,0.88,17,125,108,43
28,r_6_45_8,r_84_30_82,r_26_71_18,r_6_45_8,0.82,12,20,8,43
1,r_5_145_66,r_83_149_173,seq18,r_5_145_66,1,0,66,66,43
5,r_13_65_2,seq58,r_28_111_68,r_28_111_68,1,80,148,68,43
42,r_142_135_155,seq94,r_56_55_77,r_142_135_155,0.92,0,155,155,43
80,seq78,r_42_125_65,r_146_140_144,r_146_140_144,0.94,9,153,144,43
45,r_99_20_125,r_146_140_144,seq100,r_99_20_125,0.96,0,125,125,43
19,r_92_24_87,seq18,r_105_89_62,r_92_24_87,1,3,90,87,43
41,r_31_141_105,r_5_145_66,r_37_11_11,r_31_141_105,0.84,-94,11,105,43
41,r_31_141_105,seq58,r_60_79_147,r_60_79_147,1,1,148,147,43
31,r_126_86_165,seq75,r_17_12_127,r_126_86_165,0.8,0,165,165,43
89,seq97,r_123_124_176,r_101_137_106,r_101_137_106,0.79,71,177,106,43
3,r_91_122_90,seq138,seq3,r_91_122_90,0.95,0,90,90,43
26,r_109_43_123,seq128,r_28_111_68,r_109_43_123,0.87,0,123,123,43
14,r_37_11_11,r_31_141_105,r_83_149_173,r_31_141_105,0.49,5,110,105,43
0,r_116_21_115,r_83_149_173,seq88,r_116_21_115,1,0,115,115,43
73,seq59,r_132_25_185,r_105_89_62,r_105_89_62,1,123,185,62,43
11,r_50_136_140,seq121,seq36,r_50_136_140,0.73,0,140,140,43
20,r_22_64_78,seq58,r_93_15_61,r_22_64_78,0.98,0,78,78,43
13,r_28_111_68,seq59,r_13_65_2,r_28_111_68,0.99,0,68,68,43
15,r_73_104_64,seq147,seq128,r_73_104_64,1,0,64,64,43
48,r_60_79_147,seq35,r_31_141_105,r_31_141_105,0.25,42,147,105,43
57,seq14,r_130_115_110,r_90_113_17,r_130_115_110,0.53,0,110,110,43
36,r_83_149_173,r_5_145_66,r_116_21_115,r_5_145_66,1,-12,54,66,43
14,r_37_11_11,seq103,r_31_141_105,r_37_11_11,0.98,0,11,11,43
99,seq121,r_50_136_140,r_56_55_77,r_56_55_77,0.99,63,140,77,43
36,r_83_149_173,r_116_21_115,seq75,r_116_21_115,1,0,115,115,43
65,seq36,r_127_2_30,seq80,r_127_2_30,0.54,1,31,30,43
41,r_31_141_105,r_37_11_11,seq58,r_31_141_105,0.97,0,105,105,43
18,r_108_119_158,seq44,r_142_135_155,r_108_119_158,0.93,0,158,158,43
24,r_132_25_185,seq59,r_48_131_137,r_48_131_137,0.5,48,185,137,43
25,r_84_30_82,r_142_135_155,seq88,r_84_30_82,1,0,82,82,43
33,r_101_137_106,r_126_86_165,seq34,r_101_137_106,0.9,0,106,106,43
64,seq35,seq4,r_52_66_92,r_52_66_92,1,1,93,92,43
65,seq36,seq80,r_50_136_140,r_50_136_140,0.89,0,140,140,43
2,r_68_134_48,r_0_9_171,seq70,r_68_134_48,1,0,48,48,43
68,seq44,r_108_119_158,r_7_129_63,r_7_129_63,1,1,64,63,43
38,r_40_27_108,seq144,seq87,r_40_27_108,1,0,108,108,43
56,seq138,seq41,r_74_57_141,r_74_57_141,1,2,143,141,43
34,r_105_89_62,seq67,seq59,r_105_89_62,1,0,62,62,43
17,r_52_66_92,seq82,seq35,r_52_66_92,1,0,92,92,43
94,seq112,seq67,r_22_64_78,r_22_64_78,0.97,18,96,78,43
9,r_48_131_137,seq54,r_22_64_78,r_48_131_137,0.44,0,137,137,43
37,r_47_19_126,seq100,r_10_61_124,r_47_19_126,0.51,1,127,126,43
22,r_10_61_124,seq77,r_47_19_126,r_10_61_124,0.98,6,130,124,43
4,r_46_95_35,seq112,seq94,r_46_95_35,0.77,0,35,35,43
49,r_130_115_110,seq14,r_105_89_62,r_105_89_62,0.86,53,115,62,43
44,r_56_55_77,seq58,seq121,r_56_55_77,1,2,79,77,43
32,r_29_69_23,r_42_125_65,seq39,r_29_69_23,0.99,0,23,23,43
23,r_93_15_61,r_28_111_68,seq67,r_93_15_61,0.94,0,61,61,43
10,r_90_113_17,seq35,seq85,r_90_113_17,1,-1,16,17,43
37,r_47_19_126,r_10_61_124,r_28_111_68,r_28_111_68,0.44,92,160,68,43
9,r_48_131_137,r_22_64_78,r_132_25_185,r_132_25_185,0.81,1,186,185,43
35,r_74_57_141,seq128,seq138,r_74_57_141,1,0,141,141,43
12,r_17_12_127,seq138,seq94,r_17_12_127,0.91,0,127,127,43
51,seq128,r_21_50_166,seq40,r_21_50_166,0.6,0,166,166,44
28,r_96_70_152,seq55,seq108,r_96_70_152,0.68,0,152,152,44
98,seq115,r_127_25_192,r_107_114_77,r_107_114_77,0.72,-1,76,77,44
14,r_143_68_92,r_141_11_146,seq54,r_143_68_92,0.98,0,92,92,44
8,r_79_112_113,r_96_70_152,seq144,r_79_112_113,0.99,0,113,113,44
43,r_21_50_166,seq128,seq67,r_21_50_166,0.81,0,166,166,44
37,r_133_77_34,seq28,seq100,r_133_77_34,0.97,1,35,34,44
39,r_58_86_20,seq78,seq146,r_58_86_20,0.74,1,21,20,44
59,seq144,r_21_50_166,r_79_112_113,r_79_112_113,0.9,31,144,113,44
98,seq115,r_105_2_46,r_127_25_192,r_105_2_46,0.5,0,46,46,44
5,r_105_2_46,seq115,r_123_90_136,r_105_2_46,1,0,46,46,44
82,seq67,r_5_74_54,r_87_23_95,r_5_74_54,0.75,-1,53,54,44
21,r_107_114_77,seq61,seq115,r_107_114_77,0.87,-1,76,77,44
1,r_123_90_136,r_105_2_46,seq54,r_123_90_136,0.95,0,136,136,44
42,r_117_20_86,seq103,r_17_80_7,r_117_20_86,1,0,86,86,44
45,r_82_92_114,seq34,r_48_109_159,r_48_109_159,1,5,164,159,44
7,r_41_42_17,seq66,r_126_142_33,r_126_142_33,0.59,94,127,33,44
45,r_82_92_114,r_65_22_133,seq34,r_82_92_114,0.87,-1,113,114,44
15,r_131_132_157,seq88,r_107_114_77,r_107_114_77,0.69,10,87,77,44
15,r_131_132_157,r_107_114_77,r_97_85_138,r_131_132_157,0.56,0,157,157,44
33,r_32_76_178,r_17_80_7,r_118_106_14,r_32_76_178,0.5,0,178,178,44
76,seq55,r_130_37_167,r_97_85_138,r_97_85_138,0.65,29,167,138,44
41,r_73_45_186,r_104_69_81,seq55,r_73_45_186,0.96,0,186,186,44
26,r_99_19_25,r_82_92_114,r_138_121_3,r_99_19_25,0.97,-2,23,25,44
41,r_73_45_186,r_3_71_130,r_104_69_81,r_73_45_186,0.89,-58,128,186,44
3,r_16_111_156,seq62,seq75,r_16_111_156,0.67,2,158,156,44
10,r_13_52_104,seq100,r_46_89_196,r_13_52_104,0.96,0,104,104,44
1,r_123_90_136,r_141_11_146,r_105_2_46,r_105_2_46,1,6,52,46,44
16,r_1_36_52,r_5_74_54,seq53,r_1_36_52,0.93,5,57,52,44
11,r_97_85_138,seq51,seq149,r_97_85_138,0.98,0,138,138,44
76,seq55,r_97_85_138,r_73_45_186,r_73_45_186,0.61,2,188,186,44
13,r_48_109_159,r_46_89_196,r_82_92_114,r_48_109_159,0.95,0,159,159,44
20,r_126_142_33,r_81_122_88,seq66,r_126_142_33,0.7,-3,30,33,44
29,r_118_106_14,r_1_36_52,r_24_31_176,r_118_106_14,0.88,0,14,14,44
19,r_5_74_54,r_1_36_52,seq18,r_5_74_54,1,1,55,54,44
5,r_105_2_46,r_123_90_136,r_141_11_146,r_123_90_136,0.68,0,136,136,44
27,r_39_10_70,seq12,seq43,r_39_10_70,1,0,70,70,44
49,r_65_22_133,r_82_92_114,r_81_122_88,r_65_22_133,0.83,-117,16,133,44
12,r_4_64_40,seq38,seq66,r_4_64_40,0.99,1,41,40,44
40,r_125_120_82,r_21_50_166,r_118_106_14,r_125_120_82,1,0,82,82,44
18,r_130_37_167,seq55,seq28,r_130_37_167,0.77,0,167,167,44
24,r_102_147_154,r_24_31_176,seq101,r_102_147_154,0.69,2,156,154,44
34,r_104_69_81,r_73_45_186,r_105_2_46,r_104_69_81,0.39,101,182,81,44
33,r_32_76_178,r_83_140_115,r_17_80_7,r_83_140_115,0.87,1,116,115,44
7,r_41_42_17,r_91_95_168,seq66,r_41_42_17,0.47,-1,16,17,44
30,r_49_119_42,seq7,seq62,r_49_119_42,1,0,42,42,44
50,seq0,r_104_69_81,seq26,r_104_69_81,1,0,81,81,44
65,seq27,seq54,r_33_93_62,r_33_93_62,1,5,67,62,44
61,seq18,seq55,r_5_74_54,r_5_74_54,1,12,66,54,44
32,r_33_93_62,seq43,seq27,r_33_93_62,1,0,62,62,44
10,r_13_52_104,r_46_89_196,r_141_11_146,r_141_11_146,0.98,0,146,146,44
38,r_3_71_130,r_73_45_186,r_35_137_93,r_73_45_186,0.62,-55,131,186,44
77,seq60,r_16_111_156,r_35_137_93,r_35_137_93,0.64,1,94,93,44
39,r_58_86_20,seq146,r_81_122_88,r_58_86_20,0.43,58,78,20,44
17,r_24_31_176,r_102_147_154,r_118_106_14,r_24_31_176,0.81,-142,34,176,44
34,r_104_69_81,seq0,r_73_45_186,r_104_69_81,0.86,1,82,81,44
56,seq12,r_58_86_20,seq30,r_58_86_20,0.49,82,102,20,44
75,seq54,seq27,r_123_90_136,r_123_90_136,0.99,1,137,136,44
69,seq38,r_4_64_40,seq0,r_4_64_40,1,5,45,40,44
81,seq66,seq139,r_4_64_40,r_4_64_40,0.98,5,45,40,44
94,seq108,r_96_70_152,r_24_31_176,r_96_70_152,0.95,26,178,152,44
9,r_91_95_168,seq62,r_35_137_93,r_35_137_93,0.95,76,169,93,44
0,r_56_57_120,seq116,r_9_124_132,r_9_124_132,0.75,1,133,132,44
63,seq149,seq55,r_97_85_138,r_97_85_138,1,0,138,138,44
50,seq0,seq26,r_138_121_3,r_138_121_3,0.75,142,145,3,44
29,r_118_106_14,r_24_31_176,r_125_120_82,r_125_120_82,1,0,82,82,44
5,r_105_2_46,r_141_11_146,seq34,r_141_11_146,0.73,0,146,146,44
22,r_46_89_196,r_56_57_120,r_13_52_104,r_46_89_196,0.82,-76,120,196,44
23,r_141_11_146,r_105_2_46,r_13_52_104,r_141_11_146,1,0,146,146,44
28,r_96_70_152,r_79_112_113,seq55,r_79_112_113,0.88,0,113,113,44
56,seq12,r_39_10_70,r_58_86_20,r_39_10_70,0.44,0,70,70,44
44,r_136_47_135,seq101,r_17_80_7,r_136_47_135,0.55,11,146,135,44
23,r_141_11_146,r_143_68_92,r_105_2_46,r_141_11_146,0.86,-54,92,146,44
17,r_24_31_176,r_118_106_14,seq108,r_24_31_176,0.47,0,176,176,44
6,r_138_121_3,r_4_64_40,r_99_19_25,r_138_121_3,0.97,20,23,3,44
79,seq62,r_91_95_168,seq103,r_91_95_168,0.83,-69,99,168,44
35,r_83_140_115,r_32_76_178,seq62,r_83_140_115,0.97,0,115,115,44
71,seq43,seq116,r_39_10_70,r_39_10_70,0.62,4,74,70,44
22,r_46_89_196,r_13_52_104,r_141_11_146,r_46_89_196,0.43,-33,163,196,44
93,seq111,r_84_42_142,r_113_103_119,r_113_103_119,0.89,1,120,119,45
51,seq128,r_107_73_86,seq110,r_107_73_86,0.98,0,86,86,45
36,r_18_71_173,seq41,r_106_53_99,r_106_53_99,1,21,120,99,45
4,r_117_105_16,r_119_8_100,r_130_21_67,r_117_105_16,1,57,73,16,45
18,r_2_66_42,seq121,seq97,r_2_66_42,1,2,44,42,45
8,r_65_123_79,seq74,seq142,r_65_123_79,1,2,81,79,45
37,r_147_62_181,seq81,r_80_127_26,r_80_127_26,0.7,155,181,26,45
59,seq143,seq87,r_84_42_142,r_84_42_142,0.91,5,147,142,45
71,seq41,r_18_71_173,r_106_53_99,r_106_53_99,1,6,105,99,45
21,r_119_8_100,seq110,r_15_136_85,r_119_8_100,1,0,100,100,45
39,r_106_53_99,r_88_120_170,r_18_71_173,r_106_53_99,1,0,99,99,45
1,r_107_73_86,seq128,seq22,r_107_73_86,1,0,86,86,45
73,seq45,r_19_50_187,r_89_101_19,r_89_101_19,0.99,10,29,19,45
30,r_72_90_87,r_60_7_51,r_56_54_13,r_72_90_87,1,0,87,87,45
7,r_88_120_170,r_82_32_82,r_135_9_95,r_88_120_170,0.9,0,170,170,45
30,r_72_90_87,r_80_127_26,r_60_7_51,r_60_7_51,1,-1,50,51,45
38,r_23_14_47,r_29_5_161,r_80_127_26,r_23_14_47,0.99,0,47,47,45
66,seq31,r_40_137_134,seq59,r_40_137_134,0.98,-19,115,134,45
38,r_23_14_47,r_80_127_26,r_148_85_118,r_148_85_118,1,20,138,118,45
13,r_15_136_85,r_100_122_177,r_119_8_100,r_15_136_85,0.89,33,118,85,45
97,seq121,seq38,r_1_102_148,r_1_102_148,1,0,148,148,45
39,r_106_53_99,r_18_71_173,r_109_132_3,r_106_53_99,0.57,74,173,99,45
31,r_146_48_154,seq59,seq25,r_146_48_154,0.97,0,154,154,45
41,r_84_42_142,seq111,seq143,r_84_42_142,0.72,0,142,142,45
15,r_58_75_46,r_46_149_66,seq69,r_46_149_66,0.62,0,66,66,45
90,seq98,r_113_103_119,seq78,r_113_103_119,0.99,1,120,119,45
26,r_39_99_135,seq87,seq141,r_39_99_135,0.9,0,135,135,45
2,r_89_101_19,seq34,seq45,r_89_101_19,1,0,19,19,45
0,r_109_132_3,r_51_24_153,seq41,r_51_24_153,0.7,-28,125,153,45
63,seq22,seq34,r_107_73_86,r_107_73_86,1,3,89,86,45
11,r_148_85_118,seq64,r_23_14_47,r_148_85_118,0.95,1,119,118,45
40,r_80_127_26,r_72_90_87,r_23_14_47,r_72_90_87,0.68,-10,77,87,45
47,r_27_55_190,seq0,r_117_105_16,r_27_55_190,0.74,0,190,190,45
13,r_15_136_85,r_146_48_154,r_100_122_177,r_15_136_85,0.53,0,85,85,45
25,r_40_137_134,seq31,seq59,r_40_137_134,0.42,-101,33,134,45
12,r_133_12_45,r_77_28_138,seq64,r_77_28_138,0.43,-2,136,138,45
23,r_56_54_13,r_119_8_100,r_29_5_161,r_56_54_13,1,0,13,13,45
6,r_104_140_96,seq87,seq78,r_104_140_96,1,2,98,96,45
62,seq20,r_43_67_188,r_88_120_170,r_88_120_170,0.62,19,189,170,45
99,seq126,r_82_32_82,r_4_6_191,r_82_32_82,1,0,82,82,45
87,seq87,r_19_50_187,r_124_95_30,r_124_95_30,1,6,36,30,45
27,r_19_50_187,seq87,r_51_24_153,r_51_24_153,0.72,34,187,153,45
53,seq134,seq78,r_13_61_179,r_13_61_179,0.83,6,185,179,45
36,r_18_71_173,r_106_53_99,seq87,r_18_71_173,0.89,0,173,173,45
47,r_27_55_190,r_1_102_148,seq0,r_1_102_148,0.73,0,148,148,45
43,r_68_96_14,r_119_8_100,seq0,r_68_96_14,0.98,1,15,14,45
88,seq94,r_147_62_181,seq78,r_147_62_181,0.57,-122,59,181,45
40,r_80_127_26,seq121,r_72_90_87,r_80_127_26,0.99,0,26,26,45
29,r_130_21_67,r_46_149_66,r_117_105_16,r_117_105_16,1,80,96,16,45
24,r_26_93_68,seq97,r_109_132_3,r_26_93_68,1,1,69,68,45
64,seq25,r_13_61_179,r_146_48_154,r_146_48_154,0.57,26,180,154,45
70,seq38,r_84_42_142,seq121,r_84_42_142,0.5,-61,81,142,45
3,r_131_76_54,seq141,seq64,r_131_76_54,0.83,0,54,54,45
32,r_82_32_82,seq126,seq69,r_82_32_82,1,0,82,82,45
77,seq59,r_146_48_154,seq31,r_146_48_154,0.96,-1,153,154,45
10,r_60_7_51,r_72_90_87,r_80_127_26,r_72_90_87,0.98,0,87,87,45
57,seq141,r_124_95_30,r_49_35_189,r_124_95_30,1,1,31,30,45
57,seq141,r_49_35_189,r_100_122_177,r_100_122_177,0.46,11,188,177,45
28,r_77_28_138,seq70,r_133_12_45,r_133_12_45,0.9,0,45,45,45
34,r_29_5_161,seq83,r_77_28_138,r_29_5_161,0.81,0,161,161,45
15,r_58_75_46,seq52,r_46_149_66,r_58_75_46,0.94,0,46,46,45
60,seq16,r_92_112_171,r_15_136_85,r_15_136_85,0.99,54,139,85,45
25,r_40_137_134,seq59,seq34,r_40_137_134,0.99,0,134,134,45
4,r_117_105_16,r_58_75_46,r_119_8_100,r_117_105_16,1,1,17,16,45
9,r_135_9_95,r_43_67_188,r_88_120_170,r_88_120_170,0.59,1,171,170,45
10,r_60_7_51,seq115,r_72_90_87,r_60_7_51,1,-1,50,51,45
15,r_58_75_46,seq69,r_49_35_189,r_49_35_189,0.55,1,190,189,45
16,r_139_145_35,seq94,seq0,r_139_145_35,1,0,35,35,45
12,r_133_12_45,seq16,r_77_28_138,r_133_12_45,1,0,45,45,45
28,r_77_28_138,r_133_12_45,seq63,r_77_28_138,0.94,0,138,138,45
22,r_51_24_153,r_109_132_3,seq11,r_51_24_153,0.5,0,153,153,45
49,r_118_91_175,r_13_61_179,r_40_137_134,r_13_61_179,0.69,-2,177,179,45
7,r_88_120_170,r_106_53_99,r_82_32_82,r_82_32_82,0.58,17,99,82,45
19,r_124_95_30,seq141,seq45,r_124_95_30,0.97,0,30,30,45
44,r_1_102_148,r_27_55_190,seq121,r_1_102_148,0.95,0,148,148,45
79,seq64,r_148_85_118,r_131_76_54,r_131_76_54,0.74,65,119,54,45
35,r_113_103_119,seq98,seq111,r_113_103_119,0.88,0,119,119,45
23,r_56_54_13,r_29_5_161,seq83,r_29_5_161,0.83,-57,104,161,45
23,r_73_36_52,r_93_134_142,r_119_138_188,r_73_36_52,0.99,0,52,52,46
26,r_144_48_90,r_87_66_110,r_96_149_27,r_96_149_27,1,-1,26,27,46
12,r_47_28_143,r_99_121_72,r_9_40_17,r_47_28_143,0.63,-96,47,143,46
17,r_140_64_45,seq15,seq92,r_140_64_45,1,0,45,45,46
51,seq130,seq12,r_104_107_168,r_104_107_168,0.63,-6,162,168,46
9,r_27_35_43,seq12,seq113,r_27_35_43,1,0,43,43,46
14,r_145_120_165,seq83,r_127_141_48,r_127_141_48,1,120,168,48,46
1,r_115_38_50,seq23,seq136,r_115_38_50,1,0,50,50,46
43,r_45_0_191,seq113,r_68_97_161,r_68_97_161,0.58,29,190,161,46
22,r_21_137_59,seq56,seq69,r_21_137_59,0.97,0,59,59,46
83,seq86,r_84_53_95,r_68_97_161,r_84_53_95,0.93,2,97,95,46
37,r_111_3_78,seq75,seq98,r_111_3_78,1,0,78,78,46
28,r_104_107_168,r_139_135_91,seq130,r_104_107_168,0.75,0,168,168,46
19,r_4_103_185,r_1_148_109,r_84_53_95,r_4_103_185,0.65,0,185,185,46
94,seq113,seq5,r_27_35_43,r_27_35_43,1,0,43,43,46
56,seq10,r_115_38_50,r_58_94_167,r_58_94_167,0.82,1,168,167,46
21,r_76_41_130,seq56,seq23,r_76_41_130,0.94,0,130,130,46
39,r_60_24_88,seq23,r_6_20_154,r_60_24_88,1,1,89,88,46
97,seq122,r_139_135_91,r_57_101_171,r_139_135_91,0.58,1,92,91,46
5,r_108_17_183,r_74_25_96,r_9_40_17,r_108_17_183,0.69,-87,96,183,46
46,r_44_117_112,seq39,r_57_101_171,r_44_117_112,0.7,0,112,112,46
42,r_74_25_96,r_108_17_183,seq142,r_74_25_96,0.94,0,96,96,46
32,r_119_138_188,r_73_36_52,seq26,r_73_36_52,0.4,136,188,52,46
41,r_143_54_177,r_119_138_188,r_65_18_20,r_65_18_20,1,10,30,20,46
19,r_4_103_185,seq105,r_1_148_109,r_1_148_109,0.77,4,113,109,46
15,r_9_40_17,r_47_28_143,r_108_17_183,r_47_28_143,0.99,-6,137,143,46
45,r_16_62_23,seq30,r_110_50_197,r_16_62_23,0.97,0,23,23,46
77,seq75,seq15,r_85_29_174,r_85_29_174,0.98,12,186,174,46
46,r_44_117_112,r_57_101_171,r_77_2_106,r_57_101_171,0.97,-11,160,171,46
2,r_14_13_7,r_47_28_143,r_108_17_183,r_14_13_7,0.59,83,90,7,46
83,seq86,r_68_97_161,seq83,r_68_97_161,0.91,-6,155,161,46
27,r_123_51_175,r_52_70_100,seq83,r_123_51_175,0.99,0,175,175,46
95,seq114,seq132,r_91_102_139,r_91_102_139,0.58,1,140,139,46
97,seq122,r_57_101_171,r_77_2_106,r_57_101_171,0.72,-18,153,171,46
31,r_106_22_113,seq10,r_73_36_52,r_106_22_113,0.99,0,113,113,46
3,r_77_2_106,seq142,seq122,r_77_2_106,0.67,0,106,106,46
88,seq98,r_123_51_175,r_111_3_78,r_111_3_78,0.99,1,79,78,46
15,r_9_40_17,seq125,r_47_28_143,r_9_40_17,1,-2,15,17,46
8,r_6_20_154,seq26,r_60_24_88,r_60_24_88,1,3,91,88,46
4,r_81_124_187,seq146,r_131_19_144,r_131_19_144,0.63,43,187,144,46
63,seq26,r_123_51_175,r_52_70_100,r_52_70_100,1,39,139,100,46
48,r_139_135_91,seq122,r_131_19_144,r_139_135_91,1,0,91,91,46
7,r_127_141_48,seq42,seq67,r_127_141_48,1,0,48,48,46
35,r_57_101_171,seq122,r_44_117_112,r_44_117_112,1,1,113,112,46
12,r_47_28_143,r_9_40_17,r_139_135_91,r_47_28_143,0.9,0,143,143,46
13,r_96_149_27,r_144_48_90,r_99_121_72,r_96_149_27,0.66,63,90,27,46
6,r_99_121_72,r_47_28_143,r_72_71_15,r_99_121_72,1,0,72,72,46
62,seq23,r_60_24_88,seq109,r_60_24_88,0.94,2,90,88,46
5,r_108_17_183,r_9_40_17,seq86,r_108_17_183,0.75,0,183,183,46
35,r_57_101_171,r_44_117_112,r_47_28_143,r_57_101_171,0.99,1,172,171,46
0,r_65_18_20,r_143_54_177,r_73_36_52,r_65_18_20,0.66,146,166,20,46
34,r_1_148_109,r_68_97_161,r_4_103_185,r_1_148_109,1,0,109,109,46
10,r_72_71_15,seq30,r_99_121_72,r_99_121_72,1,13,85,72,46
28,r_104_107_168,seq59,r_46_116_131,r_104_107_168,0.53,-151,17,168,46
27,r_123_51_175,seq26,r_52_70_100,r_52_70_100,1,2,102,100,46
41,r_143_54_177,r_65_18_20,seq146,r_143_54_177,0.61,2,179,177,46
47,r_131_19_144,seq32,r_139_135_91,r_139_135_91,1,16,107,91,46
40,r_84_53_95,seq86,seq39,r_84_53_95,0.99,2,97,95,46
74,seq63,r_91_102_139,seq113,r_91_102_139,0.92,0,139,139,46
18,r_52_70_100,r_128_34_108,r_123_51_175,r_52_70_100,0.99,0,100,100,46
29,r_58_94_167,r_104_107_168,seq10,r_104_107_168,0.47,-1,167,168,46
24,r_91_102_139,seq63,seq114,r_91_102_139,0.84,0,139,139,46
25,r_43_61_66,seq79,r_140_64_45,r_43_61_66,1,0,66,66,46
34,r_1_148_109,r_84_53_95,r_68_97_161,r_1_148_109,0.62,-58,51,109,46
33,r_93_134_142,seq49,seq42,r_93_134_142,1,0,142,142,46
58,seq142,r_77_2_106,seq7,r_77_2_106,1,0,106,106,46
65,seq31,r_110_50_197,r_87_66_110,r_87_66_110,0.92,46,156,110,46
61,seq147,seq55,r_72_71_15,r_72_71_15,0.49,64,79,15,46
32,r_119_138_188,r_143_54_177,r_73_36_52,r_73_36_52,0.76,30,82,52,46
10,r_72_71_15,seq59,seq30,r_72_71_15,0.74,-1,14,15,46
77,seq75,r_111_3_78,seq15,r_111_3_78,1,1,79,78,46
2,r_14_13_7,r_65_18_20,r_47_28_143,r_65_18_20,0.62,2,22,20,46
8,r_6_20_154,r_60_24_88,r_111_3_78,r_6_20_154,0.61,1,155,154,46
2,r_14_13_7,r_108_17_183,r_9_40_17,r_108_17_183,0.56,-43,140,183,46
13,r_96_149_27,seq5,r_144_48_90,r_96_149_27,1,0,27,27,46
86,seq92,seq132,r_140_64_45,r_140_64_45,1,5,50,45,46
60,seq146,r_81_124_187,r_21_137_59,r_21_137_59,0.9,128,187,59,46
45,r_16_62_23,r_110_50_197,r_87_66_110,r_87_66_110,0.97,13,123,110,46
59,seq15,r_140_64_45,seq55,r_140_64_45,1,-2,43,45,46
0,r_65_18_20,r_14_13_7,r_143_54_177,r_65_18_20,0.97,1,21,20,46
26,r_144_48_90,r_96_149_27,seq129,r_144_48_90,1,0,90,90,46
38,r_11_133_49,r_115_38_50,seq69,r_11_133_49,0.99,0,49,49,46
71,seq55,r_140_64_45,seq75,r_140_64_45,0.98,-15,30,45,46
28,r_104_107_168,r_46_116_131,r_139_135_91,r_139_135_91,1,43,134,91,46
62,seq23,seq109,r_76_41_130,r_76_41_130,0.86,24,154,130,46
49,r_90_37_111,seq42,seq129,r_90_37_111,1,0,111,111,46
18,r_52_70_100,r_123_51_175,seq26,r_123_51_175,1,0,175,175,46
44,r_46_116_131,r_131_19_144,r_73_36_52,r_73_36_52,0.46,77,129,52,46
82,seq83,r_145_120_165,r_123_51_175,r_123_51_175,0.85,0,175,175,46
15,r_9_40_17,r_108_17_183,r_14_13_7,r_108_17_183,0.82,-6,177,183,46
23,r_73_36_52,r_119_138_188,r_106_22_113,r_106_22_113,1,75,188,113,46
50,seq129,r_144_48_90,r_90_37_111,r_90_37_111,0.95,31,142,111,46
51,seq3,seq97,r_91_110_58,r_91_110_58,1,14,72,58,47
54,seq7,r_11_74_79,seq5,r_11_74_79,1,-2,77,79,47
37,r_79_64_64,r_83_15_73,seq24,r_79_64_64,1,0,64,64,47
3,r_29_88_23,r_63_144_4,r_124_37_155,r_124_37_155,0.99,1,156,155,47
19,r_63_144_4,r_146_9_135,r_100_85_130,r_63_144_4,0.97,131,135,4,47
34,r_132_133_124,r_76_20_25,seq5,r_76_20_25,0.98,0,25,25,47
29,r_52_111_138,r_73_60_32,r_2_130_11,r_73_60_32,0.64,106,138,32,47
32,r_2_130_11,r_83_15_73,r_52_111_138,r_2_130_11,0.58,63,74,11,47
3,r_29_88_23,r_76_20_25,r_63_144_4,r_29_88_23,0.91,1,24,23,47
45,r_35_147_137,seq16,seq55,r_35_147_137,0.83,3,140,137,47
40,r_123_109_101,seq112,r_72_127_77,r_72_127_77,0.58,3,80,77,47
15,r_134_56_109,r_63_144_4,seq31,r_134_56_109,0.78,2,111,109,47
41,r_126_19_10,r_134_56_109,seq14,r_126_19_10,0.98,2,12,10,47
76,seq55,r_17_47_5,r_132_133_124,r_132_133_124,1,1,125,124,47
31,r_106_42_92,r_93_4_115,seq80,r_106_42_92,1,0,92,92,47
20,r_146_9_135,r_134_56_109,r_63_144_4,r_146_9_135,0.58,-110,25,135,47
26,r_148_22_169,seq3,r_115_141_49,r_148_22_169,0.59,0,169,169,47
72,seq46,r_100_85_130,seq108,r_100_85_130,0.96,1,131,130,47
63,seq21,seq54,r_96_129_51,r_96_129_51,1,97,148,51,47
11,r_100_85_130,seq46,r_63_144_4,r_100_85_130,0.97,0,130,130,47
13,r_107_45_116,r_52_111_138,r_99_12_75,r_107_45_116,0.99,0,116,116,47
44,r_91_110_58,seq14,seq3,r_91_110_58,1,0,58,58,47
48,r_34_98_172,seq43,seq54,r_34_98_172,0.67,0,172,172,47
4,r_73_60_32,r_52_111_138,r_96_129_51,r_52_111_138,0.77,1,139,138,47
36,r_48_70_146,r_115_141_49,seq41,r_48_70_146,0.98,0,146,146,47
27,r_124_37_155,seq54,r_29_88_23,r_124_37_155,0.98,0,155,155,47
5,r_149_59_197,seq16,r_99_12_75,r_149_59_197,0.45,-65,132,197,47
88,seq82,seq33,r_62_30_48,r_62_30_48,1,7,55,48,47
22,r_99_12_75,r_63_144_4,seq128,r_99_12_75,1,0,75,75,47
20,r_146_9_135,r_13_138_174,seq65,r_13_138_174,0.82,0,174,174,47
36,r_48_70_146,r_96_129_51,r_115_141_49,r_48_70_146,0.62,-101,45,146,47
2,r_72_127_77,seq108,r_123_109_101,r_72_127_77,0.85,1,78,77,47
14,r_36_116_20,seq44,r_51_113_36,r_36_116_20,0.99,7,27,20,47
24,r_39_119_17,r_99_12_75,seq142,r_39_119_17,1,0,17,17,47
40,r_123_109_101,r_103_102_63,seq112,r_103_102_63,0.58,-2,61,63,47
29,r_52_111_138,r_107_45_116,r_73_60_32,r_52_111_138,0.59,-31,107,138,47
34,r_132_133_124,seq5,seq55,r_132_133_124,1,0,124,124,47
25,r_103_102_63,r_123_109_101,r_139_1_145,r_103_102_63,0.66,0,63,63,47
43,r_93_4_115,r_115_141_49,seq145,r_93_4_115,0.98,0,115,115,47
33,r_117_120_131,seq145,r_107_45_116,r_117_120_131,0.99,0,131,131,47
16,r_62_30_48,seq114,seq82,r_62_30_48,1,0,48,48,47
64,seq24,seq80,r_79_64_64,r_79_64_64,1,1,65,64,47
46,r_23_0_57,seq49,seq97,r_23_0_57,0.97,0,57,57,47
5,r_149_59_197,r_148_22_169,r_32_25_2,r_148_22_169,0.36,-125,44,169,47
90,seq142,seq10,r_39_119_17,r_39_119_17,1,4,21,17,47
50,seq128,seq57,r_99_12_75,r_99_12_75,1,2,77,75,47
58,seq14,seq75,r_125_104_61,r_125_104_61,1,107,168,61,47
20,r_146_9_135,r_63_144_4,r_13_138_174,r_146_9_135,0.87,0,135,135,47
42,r_38_27_161,seq66,r_89_94_117,r_38_27_161,0.55,0,161,161,47
38,r_89_94_117,seq71,seq16,r_89_94_117,0.98,0,117,117,47
52,seq5,r_132_133_124,seq7,r_132_133_124,0.99,0,124,124,47
97,seq114,r_62_30_48,seq78,r_62_30_48,1,0,48,48,47
8,r_51_113_36,r_58_121_199,r_36_116_20,r_51_113_36,1,1,37,36,47
81,seq69,r_89_94_117,r_11_74_79,r_11_74_79,0.81,38,117,79,47
17,r_125_104_61,seq128,seq14,r_125_104_61,1,0,61,61,47
69,seq41,r_11_74_79,r_48_70_146,r_48_70_146,0.96,2,148,146,47
94,seq97,seq3,r_23_0_57,r_23_0_57,1,15,72,57,47
21,r_68_8_46,r_38_27_161,seq77,r_68_8_46,0.96,0,46,46,47
96,seq112,r_123_109_101,r_72_127_77,r_72_127_77,0.58,24,101,77,47
2,r_72_127_77,r_123_109_101,seq112,r_123_109_101,0.98,0,101,101,47
18,r_115_141_49,seq28,r_93_4_115,r_115_141_49,0.97,4,53,49,47
40,r_123_109_101,r_72_127_77,seq137,r_123_109_101,0.92,4,105,101,47
32,r_2_130_11,r_48_70_146,r_83_15_73,r_2_130_11,0.89,0,11,11,47
98,seq118,seq10,r_123_109_101,r_123_109_101,1,61,162,101,47
12,r_76_20_25,r_132_133_124,r_83_15_73,r_76_20_25,0.73,0,25,25,47
18,r_115_141_49,r_48_70_146,r_148_22_169,r_115_141_49,0.84,97,146,49,47
28,r_11_74_79,seq7,seq71,r_11_74_79,1,0,79,79,47
43,r_93_4_115,r_96_129_51,r_115_141_49,r_93_4_115,0.81,-69,46,115,47
4,r_73_60_32,seq5,r_52_111_138,r_73_60_32,0.75,1,33,32,47
56,seq137,seq118,r_123_109_101,r_123_109_101,1,10,111,101,47
18,r_115_141_49,r_93_4_115,r_48_70_146,r_93_4_115,1,0,115,115,47
0,r_96_129_51,r_93_4_115,seq21,r_96_129_51,1,0,51,51,47
23,r_26_95_133,seq90,r_99_12_75,r_26_95_133,0.91,0,133,133,47
5,r_149_59_197,r_32_25_2,seq16,r_149_59_197,0.38,-98,99,197,47
12,r_76_20_25,r_83_15_73,seq53,r_76_20_25,0.62,45,70,25,47
84,seq77,r_135_87_195,r_68_8_46,r_68_8_46,1,47,93,46,47
79,seq73,r_86_149_34,r_45_76_131,r_45_76_131,1,13,144,131,48
30,r_1_143_160,r_23_82_106,r_101_33_195,r_23_82_106,1,0,106,106,48
36,r_43_92_140,seq110,r_131_65_56,r_131_65_56,1,11,67,56,48
9,r_55_124_173,r_102_144_40,seq125,r_102_144_40,0.37,133,173,40,48
14,r_67_3_90,r_140_28_181,r_31_11_179,r_67_3_90,1,0,90,90,48
8,r_45_76_131,seq25,seq73,r_45_76_131,0.96,2,133,131,48
53,seq136,r_135_83_70,seq70,r_135_83_70,0.82,0,70,70,48
85,seq89,r_120_111_147,r_50_97_141,r_50_97_141,1,1,142,141,48
37,r_132_113_74,r_69_34_199,seq48,r_132_113_74,1,0,74,74,48
54,seq137,seq98,r_59_134_178,r_59_134_178,0.85,-1,177,178,48
45,r_17_79_19,r_100_52_68,r_139_91_125,r_17_79_19,0.99,0,19,19,48
16,r_6_39_103,r_140_28_181,seq63,r_6_39_103,1,3,106,103,48
21,r_142_61_76,seq60,seq54,r_142_61_76,1,0,76,76,48
39,r_9_2_91,seq89,r_86_149_34,r_9_2_91,0.96,0,91,91,48
1,r_23_82_106,r_126_68_148,r_140_28_181,r_23_82_106,0.68,75,181,106,48
1,r_23_82_106,r_1_143_160,r_126_68_148,r_23_82_106,1,0,106,106,48
97,seq121,r_139_91_125,r_17_79_19,r_139_91_125,0.68,-14,111,125,48
5,r_58_90_121,seq16,r_131_65_56,r_131_65_56,0.45,67,123,56,48
46,r_29_75_187,seq121,r_13_119_41,r_29_75_187,0.37,0,187,187,48
42,r_126_68_148,r_100_52_68,r_12_99_119,r_100_52_68,0.81,0,68,68,48
11,r_131_65_56,r_102_144_40,seq146,r_131_65_56,0.46,-23,33,56,48
13,r_102_144_40,r_122_103_17,seq146,r_122_103_17,0.47,24,41,17,48
69,seq51,r_45_76_131,seq14,r_45_76_131,0.71,-31,100,131,48
11,r_131_65_56,r_43_92_140,r_58_90_121,r_131_65_56,1,85,141,56,48
2,r_20_15_49,r_118_8_153,seq32,r_20_15_49,0.65,32,81,49,48
19,r_59_134_178,seq95,seq137,r_59_134_178,0.4,1,179,178,48
2,r_20_15_49,seq32,r_120_111_147,r_20_15_49,0.41,135,184,49,48
2,r_20_15_49,seq66,r_118_8_153,r_20_15_49,0.71,2,51,49,48
42,r_126_68_148,r_23_82_106,r_128_26_139,r_126_68_148,1,0,148,148,48
3,r_118_8_153,r_21_47_194,r_67_3_90,r_118_8_153,0.78,0,153,153,48
90,seq105,r_4_127_182,r_56_80_73,r_56_80_73,1,57,130,73,48
11,r_131_65_56,seq146,r_43_92_140,r_131_65_56,0.91,3,59,56,48
26,r_69_34_199,r_132_113_74,seq14,r_132_113_74,1,0,74,74,48
74,seq66,r_20_15_49,r_40_64_198,r_20_15_49,0.91,2,51,49,48
14,r_67_3_90,r_31_11_179,r_118_8_153,r_118_8_153,0.97,26,179,153,48
49,r_139_91_125,r_17_79_19,seq25,r_139_91_125,1,0,125,125,48
0,r_0_104_110,seq112,seq108,r_0_104_110,0.66,0,110,110,48
73,seq63,seq148,r_6_39_103,r_6_39_103,1,11,114,103,48
20,r_53_7_142,r_93_44_85,r_140_28_181,r_93_44_85,1,0,85,85,48
15,r_40_64_198,r_50_97_141,seq108,r_50_97_141,0.81,0,141,141,48
48,r_21_47_194,r_118_8_153,r_1_143_160,r_21_47_194,0.49,-34,160,194,48
6,r_12_99_119,seq116,r_49_36_123,r_12_99_119,1,2,121,119,48
85,seq89,r_9_2_91,r_120_111_147,r_9_2_91,1,0,91,91,48
29,r_128_26_139,seq125,r_126_68_148,r_126_68_148,0.95,1,149,148,48
36,r_43_92_140,r_131_65_56,r_56_80_73,r_43_92_140,0.9,1,141,140,48
28,r_122_103_17,r_109_114_67,r_102_144_40,r_109_114_67,0.99,-50,17,67,48
27,r_109_114_67,seq62,seq112,r_109_114_67,1,1,68,67,48
88,seq96,r_140_28_181,r_13_119_41,r_13_119_41,0.77,0,41,41,48
87,seq95,r_59_134_178,seq74,r_59_134_178,0.58,3,181,178,48
18,r_4_127_182,r_56_80_73,r_1_143_160,r_4_127_182,0.54,1,183,182,48
47,r_93_44_85,r_53_7_142,r_120_111_147,r_93_44_85,0.99,0,85,85,48
18,r_4_127_182,seq105,r_56_80_73,r_56_80_73,1,56,129,73,48
24,r_49_36_123,r_69_34_199,r_12_99_119,r_49_36_123,0.77,0,123,123,48
25,r_100_52_68,r_126_68_148,r_140_28_181,r_100_52_68,1,0,68,68,48
33,r_56_80_73,r_9_2_91,seq105,r_56_80_73,0.99,1,74,73,48
41,r_13_119_41,seq74,seq96,r_13_119_41,1,0,41,41,48
30,r_1_143_160,r_101_33_195,r_21_47_194,r_1_143_160,1,0,160,160,48
44,r_37_77_36,r_13_119_41,r_120_111_147,r_37_77_36,1,0,36,36,48
31,r_86_149_34,seq110,seq73,r_86_149_34,1,0,34,34,48
68,seq48,seq146,r_132_113_74,r_132_113_74,0.99,2,76,74,48
32,r_38_107_172,r_140_28_181,r_45_76_131,r_38_107_172,0.53,0,172,172,48
38,r_50_97_141,r_40_64_198,seq89,r_50_97_141,0.99,0,141,141,48
34,r_101_33_195,r_1_143_160,seq98,r_1_143_160,0.63,0,160,160,48
43,r_106_18_13,r_109_114_67,seq25,r_109_114_67,0.76,-54,13,67,48
99,seq125,r_142_61_76,seq117,r_142_61_76,0.93,-35,41,76,48
45,r_17_79_19,r_139_91_125,seq121,r_139_91_125,1,0,125,125,48
25,r_100_52_68,r_140_28_181,seq108,r_140_28_181,1,-33,148,181,48
9,r_55_124_173,r_131_65_56,r_102_144_40,r_131_65_56,0.96,5,61,56,48
20,r_53_7_142,r_140_28_181,seq133,r_53_7_142,1,2,144,142,48
7,r_57_24_185,seq27,r_5_84_189,r_57_24_185,0.42,-132,53,185,48
22,r_135_83_70,seq136,seq41,r_135_83_70,1,1,71,70,48
91,seq108,r_30_22_174,r_0_104_110,r_0_104_110,0.98,65,175,110,48
74,seq66,r_40_64_198,r_88_141_63,r_88_141_63,0.54,2,65,63,48
49,r_139_91_125,seq121,r_17_79_19,r_17_79_19,0.91,51,70,19,48
23,r_31_11_179,seq138,r_67_3_90,r_67_3_90,1,1,91,90,48
62,seq25,seq14,r_106_18_13,r_106_18_13,1,2,15,13,48
42,r_126_68_148,r_12_99_119,r_23_82_106,r_126_68_148,0.67,-40,108,148,48
35,r_30_22_174,seq108,r_13_119_41,r_13_119_41,0.93,135,176,41,48
12,r_140_28_181,seq108,r_23_82_106,r_23_82_106,0.58,75,181,106,48
23,r_31_11_179,r_67_3_90,seq63,r_67_3_90,0.6,89,179,90,48
40,r_67_52_84,r_88_83_149,r_4_19_89,r_88_83_149,1,0,149,149,49
33,r_88_83_149,r_67_52_84,r_63_12_148,r_88_83_149,0.99,0,149,149,49
17,r_33_13_29,seq100,seq25,r_33_13_29,1,0,29,29,49
14,r_51_138_61,seq45,r_89_71_78,r_51_138_61,1,0,61,61,49
8,r_149_36_138,seq115,r_141_126_76,r_149_36_138,0.68,0,138,138,49
53,seq131,r_21_41_95,seq45,r_21_41_95,1,-7,88,95,49
86,seq98,r_65_35_30,r_81_48_104,r_81_48_104,0.84,70,174,104,49
37,r_75_134_96,r_21_41_95,seq0,r_75_134_96,1,0,96,96,49
16,r_4_19_89,seq113,seq30,r_4_19_89,0.93,1,90,89,49
42,r_46_10_31,r_16_57_56,r_97_9_8,r_46_10_31,0.99,-1,30,31,49
21,r_89_71_78,r_118_101_144,r_51_138_61,r_51_138_61,1,17,78,61,49
39,r_28_144_65,seq115,r_46_10_31,r_28_144_65,1,0,65,65,49
20,r_81_48_104,r_141_126_76,r_53_73_13,r_81_48_104,1,0,104,104,49
5,r_1_132_115,r_111_95_67,seq100,r_1_132_115,0.99,0,115,115,49
46,r_111_95_67,r_1_132_115,seq145,r_1_132_115,0.49,-17,98,115,49
49,r_65_35_30,r_59_93_49,seq98,r_65_35_30,0.66,14,44,30,49
80,seq79,r_118_101_144,r_75_134_96,r_75_134_96,1,18,114,96,49
32,r_16_57_56,r_70_148_181,seq11,r_70_148_181,0.71,-5,176,181,49
45,r_106_68_184,r_133_119_179,seq105,r_133_119_179,0.54,8,187,179,49
48,r_141_126_76,r_133_119_179,r_149_36_138,r_141_126_76,0.46,64,140,76,49
36,r_139_66_38,seq55,seq76,r_139_66_38,1,0,38,38,49
71,seq50,seq40,r_2_86_35,r_2_86_35,1,12,47,35,49
15,r_80_32_10,seq87,seq90,r_80_32_10,1,0,10,10,49
13,r_62_29_124,seq20,r_63_12_148,r_63_12_148,0.98,0,148,148,49
1,r_120_74_60,r_128_38_160,seq77,r_120_74_60,1,-5,55,60,49
95,seq113,r_67_52_84,seq122,r_67_52_84,1,0,84,84,49
38,r_118_101_144,seq0,seq42,r_118_101_144,0.71,2,146,144,49
41,r_21_41_95,r_75_134_96,r_85_15_36,r_21_41_95,0.92,0,95,95,49
30,r_85_15_36,r_118_101_144,r_21_41_95,r_85_15_36,0.92,0,36,36,49
3,r_23_94_58,seq105,seq96,r_23_94_58,0.96,0,58,58,49
89,seq102,r_62_29_124,seq115,r_62_29_124,0.67,2,126,124,49
44,r_54_60_24,seq105,seq130,r_54_60_24,0.65,0,24,24,49
10,r_39_109_69,r_141_126_76,seq146,r_141_126_76,1,0,76,76,49
26,r_14_5_118,r_97_9_8,r_128_38_160,r_128_38_160,0.48,-47,113,160,49
0,r_49_114_120,r_88_83_149,seq96,r_88_83_149,0.47,-27,122,149,49
11,r_142_56_155,seq103,r_97_9_8,r_142_56_155,0.48,0,155,155,49
7,r_59_93_49,r_65_35_30,seq76,r_59_93_49,0.98,0,49,49,49
20,r_81_48_104,r_106_68_184,r_141_126_76,r_141_126_76,0.89,0,76,76,49
88,seq100,r_33_13_29,seq108,r_33_13_29,1,0,29,29,49
48,r_141_126_76,r_39_109_69,r_81_48_104,r_141_126_76,0.69,0,76,76,49
44,r_54_60_24,seq130,seq61,r_54_60_24,0.4,44,68,24,49
92,seq105,seq113,r_110_6_44,r_110_6_44,0.58,132,176,44,49
18,r_137_47_23,seq64,r_125_124_126,r_137_47_23,0.93,0,23,23,49
62,seq30,r_49_114_120,r_4_19_89,r_4_19_89,0.85,14,103,89,49
85,seq96,r_107_135_196,r_49_114_120,r_49_114_120,0.8,51,171,120,49
2,r_128_38_160,seq145,r_14_5_118,r_14_5_118,0.93,20,138,118,49
99,seq123,r_63_12_148,seq43,r_63_12_148,1,0,148,148,49
23,r_2_86_35,seq25,seq50,r_2_86_35,0.9,0,35,35,49
7,r_59_93_49,seq146,r_65_35_30,r_65_35_30,0.46,-1,29,30,49
2,r_128_38_160,r_14_5_118,r_81_48_104,r_128_38_160,0.86,0,160,160,49
78,seq77,seq115,r_120_74_60,r_120_74_60,1,-5,55,60,49
48,r_141_126_76,r_81_48_104,r_133_119_179,r_81_48_104,0.95,0,104,104,49
25,r_53_73_13,r_81_48_104,r_27_84_132,r_27_84_132,1,2,134,132,49
26,r_14_5_118,r_128_38_160,r_7_3_140,r_7_3_140,0.48,0,140,140,49
2,r_128_38_160,r_120_74_60,seq145,r_120_74_60,0.69,11,71,60,49
60,seq25,r_2_86_35,seq69,r_2_86_35,1,0,35,35,49
40,r_67_52_84,r_4_19_89,r_88_83_149,r_88_83_149,1,-65,84,149,49
25,r_53_73_13,r_107_135_196,seq146,r_53_73_13,0.61,0,13,13,49
34,r_125_124_126,r_137_47_23,seq99,r_125_124_126,0.99,0,126,126,49
33,r_88_83_149,r_49_114_120,r_67_52_84,r_67_52_84,0.92,21,105,84,49
64,seq34,r_133_119_179,r_51_138_61,r_133_119_179,0.81,-54,125,179,49
32,r_16_57_56,r_17_44_194,r_70_148_181,r_16_57_56,1,1,57,56,49
50,seq0,r_27_84_132,r_75_134_96,r_75_134_96,0.76,36,132,96,49
70,seq136,r_106_68_184,r_149_36_138,r_149_36_138,0.75,45,183,138,49
92,seq105,r_137_47_23,seq113,r_137_47_23,0.78,135,158,23,49
38,r_118_101_144,r_89_71_78,seq0,r_89_71_78,0.91,0,78,78,49
92,seq105,r_23_94_58,seq145,r_23_94_58,0.98,1,59,58,49
34,r_125_124_126,seq115,r_137_47_23,r_137_47_23,1,8,31,23,49
25,r_53_73_13,seq146,r_81_48_104,r_81_48_104,0.84,2,106,104,49
9,r_133_119_179,r_106_68_184,seq40,r_133_119_179,0.48,2,181,179,49
28,r_70_148_181,r_16_57_56,r_18_91_178,r_70_148_181,0.62,0,181,181,49
49,r_65_35_30,r_16_57_56,r_59_93_49,r_65_35_30,0.73,0,30,30,49
22,r_116_143_161,seq99,r_97_9_8,r_116_143_161,0.7,5,166,161,49
28,r_70_148_181,seq96,r_16_57_56,r_16_57_56,1,6,62,56,49
43,r_110_6_44,seq98,seq37,r_110_6_44,1,2,46,44,49
18,r_137_47_23,r_125_124_126,seq22,r_125_124_126,0.92,2,128,126,49
82,seq87,seq42,r_51_138_61,r_51_138_61,1,45,106,61,49
79,seq78,r_39_109_69,seq130,r_39_109_69,0.68,47,116,69,49
35,r_63_12_148,seq123,r_88_83_149,r_63_12_148,0.67,1,149,148,49
12,r_7_3_140,r_88_83_149,r_14_5_118,r_7_3_140,0.6,1,141,140,49
30,r_111_6_91,seq38,r_118_147_120,r_111_6_91,1,-1,90,91,50
9,r_7_62_21,seq27,r_58_56_159,r_58_56_159,1,1,160,159,50
14,r_139_50_129,seq143,r_107_85_43,r_139_50_129,0.94,0,129,129,50
53,seq4,seq60,r_106_98_40,r_106_98_40,0.88,44,84,40,50
43,r_82_24_151,seq87,r_8_127_143,r_82_24_151,0.55,0,151,151,50
59,seq142,r_51_5_152,r_43_17_101,r_43_17_101,1,29,130,101,50
24,r_52_140_59,r_58_56_159,seq38,r_52_140_59,1,0,59,59,50
86,seq78,seq100,r_72_148_88,r_72_148_88,1,26,114,88,50
97,seq123,r_120_46_174,seq9,r_120_46_174,0.53,1,175,174,50
1,r_106_98_40,seq60,r_121_18_79,r_121_18_79,1,4,83,79,50
15,r_3_102_16,r_103_80_66,r_126_105_196,r_3_102_16,0.98,0,16,16,50
5,r_96_114_28,seq40,r_133_95_74,r_96_114_28,0.71,1,29,28,50
11,r_12_99_136,seq54,seq9,r_12_99_136,0.9,0,136,136,50
11,r_12_99_136,seq77,seq54,r_12_99_136,0.58,-121,15,136,50
39,r_64_68_57,r_58_56_159,r_139_50_129,r_139_50_129,0.63,11,140,129,50
41,r_69_71_184,seq35,seq149,r_69_71_184,0.18,0,184,184,50
67,seq32,seq60,r_104_73_97,r_104_73_97,1,9,106,97,50
3,r_94_113_140,seq124,seq40,r_94_113_140,0.74,0,140,140,50
26,r_118_147_120,seq59,r_111_6_91,r_111_6_91,0.76,36,127,91,50
4,r_58_56_159,r_72_148_88,r_64_68_57,r_58_56_159,0.87,-72,87,159,50
35,r_43_17_101,seq110,r_144_138_68,r_43_17_101,0.72,-31,70,101,50
0,r_104_73_97,seq54,r_53_37_45,r_53_37_45,0.98,33,78,45,50
63,seq25,seq141,r_108_88_102,r_108_88_102,1,1,103,102,50
19,r_53_37_45,seq100,seq57,r_53_37_45,1,0,45,45,50
13,r_83_14_77,seq54,r_20_19_19,r_83_14_77,1,0,77,77,50
10,r_133_95_74,r_137_66_22,r_96_114_28,r_96_114_28,0.63,0,28,28,50
48,r_11_89_139,seq141,seq87,r_11_89_139,0.57,0,139,139,50
4,r_58_56_159,r_64_68_57,r_7_62_21,r_58_56_159,1,0,159,159,50
17,r_86_1_48,r_43_17_101,seq34,r_86_1_48,1,3,51,48,50
5,r_96_114_28,seq122,r_94_113_140,r_94_113_140,0.94,30,170,140,50
56,seq9,seq143,r_103_80_66,r_103_80_66,0.45,103,169,66,50
95,seq117,r_58_56_159,r_144_138_68,r_144_138_68,0.96,49,117,68,50
27,r_8_127_143,seq97,r_82_24_151,r_8_127_143,0.54,0,143,143,50
35,r_43_17_101,r_86_1_48,seq110,r_86_1_48,0.91,0,48,48,50
87,seq79,r_82_24_151,r_116_91_105,r_82_24_151,0.98,-18,133,151,50
0,r_104_73_97,r_53_37_45,seq32,r_104_73_97,0.92,0,97,97,50
22,r_107_85_43,r_58_56_159,r_139_50_129,r_139_50_129,0.69,2,131,129,50
22,r_107_85_43,seq125,r_58_56_159,r_107_85_43,0.97,0,43,43,50
2,r_47_131_158,seq38,r_11_89_139,r_47_131_158,0.4,0,158,158,50
47,r_121_18_79,seq77,r_106_98_40,r_121_18_79,1,0,79,79,50
35,r_43_17_101,r_144_138_68,seq142,r_43_17_101,0.93,1,102,101,50
40,r_137_66_22,r_82_24_151,seq125,r_137_66_22,0.93,4,26,22,50
18,r_72_148_88,r_58_56_159,seq78,r_72_148_88,1,0,88,88,50
29,r_144_138_68,seq57,seq122,r_144_138_68,1,0,68,68,50
8,r_21_146_10,r_23_93_92,seq124,r_21_146_10,0.98,0,10,10,50
25,r_70_90_80,seq134,r_74_28_23,r_70_90_80,0.91,0,80,80,50
33,r_119_15_83,r_111_6_91,seq97,r_119_15_83,1,0,83,83,50
37,r_136_92_11,r_74_28_23,seq31,r_136_92_11,0.97,0,11,11,50
7,r_74_28_23,r_64_68_57,seq0,r_74_28_23,0.78,0,23,23,50
58,seq141,r_11_89_139,r_108_88_102,r_108_88_102,0.94,19,121,102,50
80,seq60,seq9,r_106_98_40,r_106_98_40,0.77,1,41,40,50
21,r_41_67_37,seq44,seq45,r_41_67_37,1,0,37,37,50
39,r_64_68_57,seq34,r_58_56_159,r_64_68_57,1,0,57,57,50
32,r_20_19_19,seq143,r_83_14_77,r_83_14_77,1,-1,76,77,50
38,r_23_93_92,seq122,seq54,r_23_93_92,0.99,1,93,92,50
52,seq132,seq143,r_103_80_66,r_103_80_66,0.91,-2,64,66,50
95,seq117,r_144_138_68,r_64_68_57,r_144_138_68,0.98,64,132,68,50
75,seq48,r_103_80_66,seq128,r_103_80_66,1,0,66,66,50
60,seq143,r_108_88_102,r_20_19_19,r_108_88_102,0.94,0,102,102,50
46,r_2_81_103,r_133_95_74,seq110,r_2_81_103,0.99,-80,23,103,50
94,seq110,seq149,r_2_81_103,r_2_81_103,1,4,107,103,50
9,r_7_62_21,seq38,seq27,r_7_62_21,1,0,21,21,50
95,seq117,r_64_68_57,r_118_147_120,r_118_147_120,0.46,44,164,120,50
49,r_112_16_134,seq135,seq128,r_112_16_134,0.82,0,134,134,50
44,r_108_88_102,seq143,seq25,r_108_88_102,0.98,0,102,102,50
10,r_133_95_74,r_96_114_28,seq142,r_133_95_74,1,0,74,74,50
23,r_103_80_66,seq48,seq132,r_103_80_66,0.99,0,66,66,50
6,r_126_105_196,seq76,r_3_102_16,r_3_102_16,1,7,23,16,50
79,seq59,r_118_147_120,r_33_115_181,r_118_147_120,0.99,2,122,120,50
5,r_96_114_28,r_133_95_74,seq122,r_96_114_28,0.49,46,74,28,50
1,r_106_98_40,seq142,seq60,r_106_98_40,0.92,0,40,40,50
93,seq102,r_108_89_94,seq136,r_108_89_94,1,0,94,94,51
16,r_91_1_16,seq0,seq57,r_91_1_16,1,0,16,16,51
36,r_139_24_75,seq57,r_119_36_128,r_139_24_75,1,1,76,75,51
92,seq101,r_104_120_147,r_65_134_84,r_65_134_84,0.95,64,148,84,51
8,r_137_77_123,seq44,seq78,r_137_77_123,0.95,0,123,123,51
43,r_65_134_84,r_114_128_159,seq101,r_65_134_84,0.83,0,84,84,51
83,seq82,r_56_122_112,seq12,r_56_122_112,0.81,2,114,112,51
37,r_142_97_83,seq7,r_123_28_175,r_142_97_83,0.78,0,83,83,51
19,r_118_70_146,r_67_90_30,r_52_23_100,r_118_70_146,0.97,1,147,146,51
21,r_148_94_101,r_76_17_136,seq44,r_148_94_101,1,0,101,101,51
39,r_147_124_90,seq3,r_111_100_39,r_111_100_39,0.8,48,87,39,51
46,r_40_116_130,r_76_17_136,r_93_35_38,r_40_116_130,0.98,0,130,130,51
69,seq44,r_129_115_191,r_148_94_101,r_148_94_101,1,54,155,101,51
15,r_74_10_106,r_49_105_40,seq135,r_49_105_40,0.95,1,41,40,51
15,r_74_10_106,seq135,seq51,r_74_10_106,0.92,0,106,106,51
33,r_114_128_159,r_60_18_49,seq7,r_60_18_49,0.77,110,159,49,51
27,r_32_140_174,r_133_50_8,seq102,r_32_140_174,0.97,0,174,174,51
20,r_123_28_175,r_148_94_101,r_69_6_41,r_123_28_175,0.84,-132,43,175,51
95,seq112,r_52_23_100,seq20,r_52_23_100,1,-1,99,100,51
14,r_66_64_20,seq86,seq33,r_66_64_20,0.98,0,20,20,51
30,r_67_90_30,r_9_42_56,r_118_70_146,r_67_90_30,1,0,30,30,51
24,r_119_36_128,r_139_24_75,seq7,r_119_36_128,0.96,0,128,128,51
0,r_39_38_115,seq132,r_114_128_159,r_114_128_159,0.41,-129,30,159,51
26,r_56_122_112,seq82,seq98,r_56_122_112,0.93,9,121,112,51
14,r_66_64_20,seq33,seq59,r_66_64_20,0.49,155,175,20,51
66,seq31,r_56_122_112,r_5_85_59,r_5_85_59,0.92,2,61,59,51
4,r_141_146_60,seq12,seq127,r_141_146_60,1,1,61,60,51
36,r_139_24_75,r_119_36_128,r_143_22_107,r_139_24_75,0.58,53,128,75,51
78,seq68,seq126,r_62_75_177,r_62_75_177,0.53,4,181,177,51
73,seq48,r_143_22_107,seq30,r_143_22_107,0.88,0,107,107,51
11,r_11_41_105,r_79_63_195,seq31,r_11_41_105,0.77,0,105,105,51
13,r_121_107_96,r_108_89_94,seq138,r_121_107_96,0.99,-2,94,96,51
48,r_76_17_136,seq98,r_34_110_6,r_76_17_136,0.83,0,136,136,51
57,seq12,r_141_146_60,seq82,r_141_146_60,1,1,61,60,51
6,r_73_19_110,r_32_140_174,seq130,r_73_19_110,0.71,0,110,110,51
67,seq33,r_66_64_20,r_87_72_79,r_87_72_79,0.67,8,87,79,51
67,seq33,seq59,r_66_64_20,r_66_64_20,0.89,21,41,20,51
86,seq86,r_66_64_20,r_88_53_118,r_66_64_20,0.71,0,20,20,51
0,r_39_38_115,r_114_128_159,r_60_18_49,r_39_38_115,0.34,-44,71,115,51
34,r_60_18_49,r_25_117_114,seq130,r_25_117_114,1,-55,59,114,51
18,r_133_50_8,r_32_140_174,r_103_80_7,r_32_140_174,0.63,0,174,174,51
27,r_32_140_174,r_73_19_110,r_133_50_8,r_32_140_174,0.81,-64,110,174,51
41,r_93_35_38,r_118_70_146,seq132,r_93_35_38,1,0,38,38,51
30,r_67_90_30,r_118_70_146,seq106,r_118_70_146,1,0,146,146,51
75,seq57,r_139_24_75,r_91_1_16,r_139_24_75,0.95,-26,49,75,51
41,r_93_35_38,seq132,r_40_116_130,r_40_116_130,1,13,143,130,51
47,r_104_120_147,seq101,seq144,r_104_120_147,0.69,1,148,147,51
40,r_143_22_107,seq48,seq112,r_143_22_107,0.79,0,107,107,51
42,r_49_105_40,r_74_10_106,r_111_100_39,r_74_10_106,0.72,-66,40,106,51
74,seq51,r_8_149_182,r_74_10_106,r_74_10_106,0.99,77,183,106,51
24,r_119_36_128,r_52_23_100,r_139_24_75,r_119_36_128,0.7,-48,80,128,51
25,r_108_89_94,seq102,seq99,r_108_89_94,1,0,94,94,51
33,r_114_128_159,r_65_134_84,r_60_18_49,r_65_134_84,0.99,0,84,84,51
64,seq26,seq20,r_43_54_161,r_43_54_161,0.39,1,162,161,51
3,r_5_85_59,r_43_54_161,seq31,r_5_85_59,1,0,59,59,51
68,seq135,seq57,r_52_23_100,r_52_23_100,1,2,102,100,51
32,r_87_72_79,seq130,seq33,r_87_72_79,1,0,79,79,51
28,r_43_54_161,r_5_85_59,seq99,r_5_85_59,1,0,59,59,51
31,r_34_110_6,r_95_131_186,r_67_90_30,r_34_110_6,0.64,170,176,6,51
28,r_43_54_161,seq99,seq26,r_43_54_161,0.88,0,161,161,51
22,r_25_117_114,seq132,seq0,r_25_117_114,0.73,2,116,114,51
1,r_88_53_118,seq92,seq86,r_88_53_118,0.98,0,118,118,51
49,r_52_23_100,seq112,seq135,r_52_23_100,0.97,0,100,100,51
56,seq138,seq16,r_121_107_96,r_121_107_96,1,27,123,96,51
18,r_133_50_8,r_73_19_110,r_32_140_174,r_73_19_110,0.99,0,110,110,51
38,r_69_6_41,seq130,r_123_28_175,r_69_6_41,1,0,41,41,51
0,r_39_38_115,r_60_18_49,r_111_100_39,r_39_38_115,1,0,115,115,51
35,r_4_21_178,seq44,seq113,r_4_21_178,0.48,0,178,178,51
12,r_95_131_186,seq113,r_34_110_6,r_95_131_186,0.29,-83,103,186,51
19,r_118_70_146,seq106,r_67_90_30,r_67_90_30,0.99,27,57,30,51
51,seq1,r_98_48_36,r_11_28_66,r_11_28_66,1,0,66,66,52
65,seq36,r_132_27_52,seq87,r_132_27_52,1,0,52,52,52
37,r_63_37_83,r_101_4_176,r_135_35_35,r_63_37_83,0.95,1,84,83,52
40,r_98_48_36,seq14,r_79_100_1,r_79_100_1,0.91,38,39,1,52
86,seq102,r_5_148_85,r_71_53_100,r_5_148_85,0.68,1,86,85,52
16,r_16_64_151,r_68_77_149,seq72,r_16_64_151,0.83,-1,150,151,52
1,r_90_136_180,seq140,seq107,r_90_136_180,0.41,0,180,180,52
5,r_89_13_97,seq144,r_6_65_138,r_89_13_97,0.62,-1,96,97,52
42,r_60_104_79,r_5_148_85,r_52_55_61,r_60_104_79,1,0,79,79,52
88,seq105,seq103,r_112_34_161,r_112_34_161,1,1,162,161,52
45,r_145_128_169,seq29,r_143_78_29,r_145_128_169,0.59,2,171,169,52
9,r_132_27_52,seq36,seq138,r_132_27_52,0.93,0,52,52,52
73,seq56,r_61_84_68,seq0,r_61_84_68,1,-19,49,68,52
9,r_132_27_52,seq138,r_5_148_85,r_5_148_85,0.57,2,87,85,52
31,r_41_8_134,seq106,r_3_83_24,r_41_8_134,0.84,0,134,134,52
41,r_45_20_197,r_3_83_24,r_130_115_12,r_3_83_24,0.42,67,91,24,52
24,r_79_100_1,r_91_12_55,r_129_2_53,r_79_100_1,0.98,54,55,1,52
89,seq106,r_41_8_134,r_52_55_61,r_52_55_61,0.9,73,134,61,52
3,r_75_108_166,seq109,seq121,r_75_108_166,0.61,0,166,166,52
15,r_122_116_64,r_130_115_12,seq111,r_122_116_64,1,3,67,64,52
14,r_61_84_68,seq0,r_133_30_39,r_61_84_68,0.98,0,68,68,52
2,r_71_53_100,seq107,r_41_8_134,r_71_53_100,0.37,-62,38,100,52
78,seq70,r_98_48_36,r_11_28_66,r_11_28_66,0.97,8,74,66,52
0,r_18_81_90,seq36,seq23,r_18_81_90,1,0,90,90,52
63,seq149,r_6_65_138,seq21,r_6_65_138,0.99,0,138,138,52
25,r_93_119_30,r_135_35_35,r_88_44_7,r_93_119_30,0.99,0,30,30,52
11,r_86_126_101,r_94_99_194,r_3_83_24,r_86_126_101,0.97,0,101,101,52
32,r_133_30_39,seq23,seq15,r_133_30_39,1,0,39,39,52
20,r_11_28_66,seq10,seq1,r_11_28_66,0.99,0,66,66,52
13,r_5_148_85,seq102,seq39,r_5_148_85,1,0,85,85,52
30,r_88_44_7,r_93_119_30,r_91_12_55,r_91_12_55,0.99,10,65,55,52
6,r_101_4_176,seq121,seq87,r_101_4_176,0.59,0,176,176,52
62,seq29,r_145_128_169,r_124_22_185,r_124_22_185,0.54,0,185,185,52
48,r_129_2_53,seq111,r_79_100_1,r_129_2_53,1,0,53,53,52
21,r_3_83_24,r_54_142_188,r_41_8_134,r_41_8_134,1,28,162,134,52
19,r_143_78_29,r_98_48_36,seq82,r_143_78_29,0.9,0,29,29,52
30,r_88_44_7,r_54_142_188,r_93_119_30,r_93_119_30,1,7,37,30,52
41,r_45_20_197,r_130_115_12,seq0,r_45_20_197,0.48,-88,109,197,52
23,r_146_58_59,r_97_46_45,seq9,r_97_46_45,0.99,0,45,45,52
35,r_80_147_89,r_122_116_64,r_68_77_149,r_68_77_149,0.51,1,150,149,52
5,r_89_13_97,r_6_65_138,r_52_55_61,r_52_55_61,0.58,112,173,61,52
46,r_130_115_12,r_143_78_29,r_122_116_64,r_130_115_12,0.96,0,12,12,52
27,r_17_31_76,r_90_136_180,seq134,r_17_31_76,1,0,76,76,52
9,r_132_27_52,r_5_148_85,seq138,r_132_27_52,0.72,87,139,52,52
47,r_6_65_138,seq149,r_52_55_61,r_6_65_138,0.78,0,138,138,52
17,r_91_12_55,r_79_100_1,r_88_44_7,r_91_12_55,1,0,55,55,52
15,r_122_116_64,seq117,r_130_115_12,r_122_116_64,0.59,-46,18,64,52
33,r_19_26_196,r_92_62_123,r_146_58_59,r_19_26_196,0.93,-73,123,196,52
35,r_80_147_89,r_90_136_180,r_122_116_64,r_80_147_89,0.68,38,127,89,52
88,seq105,r_16_64_151,seq103,r_16_64_151,0.77,-57,94,151,52
61,seq23,r_133_30_39,r_41_8_134,r_133_30_39,1,0,39,39,52
50,seq0,r_61_84_68,seq56,r_61_84_68,1,1,69,68,52
68,seq43,r_67_32_150,r_146_58_59,r_146_58_59,0.49,92,151,59,52
52,seq134,r_41_8_134,r_17_31_76,r_17_31_76,0.77,1,77,76,52
77,seq66,r_49_123_82,r_94_99_194,r_49_123_82,0.97,-6,76,82,52
9,r_132_27_52,seq138,seq39,r_132_27_52,0.56,134,186,52,52
46,r_130_115_12,r_122_116_64,seq38,r_122_116_64,1,3,67,64,52
2,r_71_53_100,seq107,r_94_99_194,r_71_53_100,0.84,-5,95,100,52
34,r_112_34_161,r_98_48_36,seq105,r_112_34_161,0.64,0,161,161,52
2,r_71_53_100,r_41_8_134,seq107,r_71_53_100,0.58,-30,70,100,52
94,seq114,r_124_22_185,r_139_69_70,r_139_69_70,1,115,185,70,52
21,r_3_83_24,r_135_35_35,r_54_142_188,r_3_83_24,0.94,1,25,24,52
29,r_54_142_188,r_3_83_24,r_112_34_161,r_112_34_161,0.9,27,188,161,52
22,r_52_55_61,r_68_77_149,seq106,r_52_55_61,1,0,61,61,52
28,r_139_69_70,r_101_4_176,seq114,r_139_69_70,1,0,70,70,52
91,seq109,r_75_108_166,seq33,r_75_108_166,0.76,0,166,166,52
29,r_54_142_188,r_122_116_64,r_3_83_24,r_3_83_24,0.88,0,24,24,52
49,r_92_62_123,r_19_26_196,seq14,r_92_62_123,0.99,1,124,123,52
14,r_61_84_68,seq56,seq0,r_61_84_68,0.48,-33,35,68,52
56,seq141,r_42_7_170,seq149,r_42_7_170,0.7,0,170,170,52
7,r_68_77_149,r_16_64_151,r_80_147_89,r_68_77_149,0.86,0,149,149,52
44,r_49_123_82,r_86_126_101,seq1,r_49_123_82,0.99,0,82,82,52
23,r_146_58_59,seq9,r_19_26_196,r_146_58_59,0.97,1,60,59,52
79,seq72,seq114,r_16_64_151,r_16_64_151,0.87,1,152,151,52
43,r_97_46_45,r_146_58_59,seq47,r_97_46_45,0.96,0,45,45,52
35,r_80_147_89,r_98_48_36,r_90_136_180,r_98_48_36,0.74,56,92,36,52
12,r_94_99_194,r_86_126_101,r_71_53_100,r_94_99_194,0.72,-95,99,194,52
93,seq105,r_8_143_73,r_117_12_169,r_8_143_73,1,0,73,73,53
51,seq3,r_15_134_94,r_0_9_128,r_15_134_94,0.99,0,94,94,53
36,r_0_9_128,seq3,r_6_97_116,r_0_9_128,0.98,0,128,128,53
92,seq100,r_104_130_171,r_40_103_109,r_40_103_109,0.93,47,156,109,53
26,r_20_144_120,r_39_62_181,r_124_98_146,r_124_98_146,1,12,158,146,53
43,r_40_103_109,seq77,r_104_130_171,r_104_130_171,0.65,-62,109,171,53
18,r_16_145_31,seq19,seq26,r_16_145_31,1,1,32,31,53
60,seq22,r_2_21_21,r_37_30_89,r_2_21_21,0.95,-2,19,21,53
54,seq129,seq65,r_137_107_159,r_137_107_159,0.59,0,159,159,53
83,seq141,seq100,r_91_36_100,r_91_36_100,0.98,83,183,100,53
3,r_38_119_33,seq92,r_66_120_149,r_38_119_33,1,2,35,33,53
37,r_102_75_115,r_149_50_176,r_64_85_51,r_102_75_115,1,0,115,115,53
3,r_38_119_33,r_66_120_149,r_43_106_85,r_43_106_85,1,65,150,85,53
39,r_2_21_21,seq22,seq26,r_2_21_21,0.99,0,21,21,53
55,seq11,r_37_30_89,r_148_53_70,r_37_30_89,0.99,-8,81,89,53
71,seq58,seq19,r_149_50_176,r_149_50_176,0.54,8,184,176,53
86,seq84,r_74_31_63,seq105,r_74_31_63,1,0,63,63,53
16,r_15_134_94,seq3,r_149_50_176,r_15_134_94,1,0,94,94,53
21,r_104_130_171,seq100,r_40_103_109,r_40_103_109,1,32,141,109,53
1,r_117_12_169,r_10_25_153,seq105,r_10_25_153,0.83,-19,134,153,53
21,r_104_130_171,r_40_103_109,r_44_142_93,r_104_130_171,0.92,1,172,171,53
5,r_7_34_175,r_137_107_159,r_66_120_149,r_7_34_175,0.42,-22,153,175,53
6,r_55_67_49,seq71,seq35,r_55_67_49,0.98,0,49,49,53
49,r_6_97_116,seq92,r_27_118_6,r_27_118_6,0.77,42,48,6,53
32,r_64_85_51,r_2_21_21,r_102_75_115,r_102_75_115,1,-1,114,115,53
45,r_57_42_134,r_66_120_149,seq70,r_57_42_134,0.92,0,134,134,53
24,r_149_50_176,r_15_134_94,seq58,r_149_50_176,0.5,0,176,176,53
95,seq114,seq1,r_111_125_142,r_111_125_142,0.91,0,142,142,53
66,seq135,r_57_42_134,r_43_106_85,r_43_106_85,0.76,5,90,85,53
0,r_108_41_34,r_137_107_159,seq18,r_108_41_34,0.98,1,35,34,53
39,r_2_21_21,seq26,r_44_142_93,r_44_142_93,1,11,104,93,53
31,r_24_48_76,seq45,r_137_107_159,r_24_48_76,1,2,78,76,53
41,r_43_106_85,seq121,seq135,r_43_106_85,0.98,0,85,85,53
10,r_66_120_149,r_38_119_33,r_24_48_76,r_66_120_149,0.66,1,150,149,53
30,r_83_87_72,r_32_122_24,seq1,r_83_87_72,1,0,72,72,53
89,seq92,r_111_125_142,seq5,r_111_125_142,0.82,0,142,142,53
30,r_83_87_72,r_23_113_75,r_32_122_24,r_32_122_24,0.93,9,33,24,53
10,r_66_120_149,r_57_42_134,r_38_119_33,r_38_119_33,0.92,101,134,33,53
20,r_128_52_59,seq59,r_138_51_4,r_128_52_59,1,0,59,59,53
72,seq59,r_128_52_59,seq11,r_128_52_59,1,-19,40,59,53
26,r_20_144_120,r_137_107_159,r_39_62_181,r_20_144_120,0.98,0,120,120,53
16,r_15_134_94,r_149_50_176,seq147,r_149_50_176,0.68,1,177,176,53
17,r_32_122_24,r_99_69_122,seq26,r_32_122_24,0.96,0,24,24,53
4,r_124_98_146,seq65,r_20_144_120,r_124_98_146,0.93,0,146,146,53
91,seq94,seq59,r_20_144_120,r_20_144_120,0.97,20,140,120,53
73,seq60,seq72,r_128_52_59,r_128_52_59,1,69,128,59,53
11,r_131_54_162,seq81,seq135,r_131_54_162,0.94,0,162,162,53
13,r_91_36_100,r_112_17_138,r_8_143_73,r_91_36_100,1,1,101,100,53
46,r_127_61_185,r_136_76_39,r_66_120_149,r_127_61_185,0.64,0,185,185,53
49,r_6_97_116,r_27_118_6,seq90,r_6_97_116,0.98,0,116,116,53
46,r_127_61_185,r_55_67_49,r_136_76_39,r_127_61_185,0.92,-140,45,185,53
5,r_7_34_175,r_66_120_149,seq147,r_66_120_149,0.76,26,175,149,53
1,r_117_12_169,seq105,seq3,r_117_12_169,0.92,0,169,169,53
42,r_95_101_36,seq72,r_148_53_70,r_95_101_36,1,0,36,36,53
27,r_14_82_143,seq90,seq18,r_14_82_143,0.93,0,143,143,53
0,r_108_41_34,seq18,r_88_56_68,r_88_56_68,1,3,71,68,53
79,seq72,r_138_51_4,r_128_52_59,r_128_52_59,0.83,85,144,59,53
2,r_112_17_138,r_149_50_176,seq80,r_112_17_138,0.49,0,138,138,53
47,r_23_113_75,r_24_48_76,r_27_118_6,r_23_113_75,1,0,75,75,53
93,seq105,r_117_12_169,seq84,r_117_12_169,0.94,0,169,169,53
40,r_126_146_65,seq1,r_74_31_63,r_126_146_65,1,0,65,65,53
29,r_37_30_89,seq115,r_32_122_24,r_37_30_89,1,0,89,89,53
24,r_149_50_176,r_91_36_100,r_15_134_94,r_149_50_176,0.78,-84,92,176,53
25,r_10_25_153,r_117_12_169,seq4,r_10_25_153,0.99,0,153,153,53
43,r_40_103_109,r_104_130_171,seq100,r_104_130_171,1,1,172,171,53
33,r_137_107_159,r_7_34_175,seq129,r_137_107_159,0.9,0,159,159,53
48,r_27_118_6,seq92,r_23_113_75,r_23_113_75,1,9,84,75,53
58,seq18,seq140,r_14_82_143,r_14_82_143,1,3,146,143,53
65,seq35,seq59,r_55_67_49,r_55_67_49,0.94,11,60,49,53
68,seq46,seq100,r_8_143_73,r_8_143_73,0.95,0,73,73,53
59,seq19,r_16_145_31,seq58,r_16_145_31,1,2,33,31,53
34,r_8_143_73,seq105,r_104_130_171,r_8_143_73,0.79,0,73,73,53
34,r_8_143_73,r_104_130_171,r_91_36_100,r_8_143_73,0.74,28,101,73,53
19,r_28_79_18,seq1,seq133,r_28_79_18,0.93,-1,17,18,53
15,r_138_51_4,seq72,r_128_52_59,r_128_52_59,1,2,61,59,53
75,seq65,r_124_98_146,seq45,r_124_98_146,0.48,0,146,146,53
87,seq89,r_148_53_70,seq22,r_148_53_70,0.38,112,182,70,53
63,seq133,r_7_34_175,r_28_79_18,r_28_79_18,0.7,-1,17,18,53
96,seq115,r_148_53_70,r_39_62_181,r_148_53_70,0.86,20,90,70,53
31,r_24_48_76,r_137_107_159,r_66_120_149,r_24_48_76,0.79,83,159,76,53
22,r_74_31_63,seq84,seq121,r_74_31_63,1,0,63,63,53
28,r_88_56_68,r_57_42_134,r_108_41_34,r_88_56_68,0.99,0,68,68,53
91,seq94,r_37_30_89,seq59,r_37_30_89,0.99,0,89,89,53
56,seq140,seq18,r_108_41_34,r_108_41_34,1,50,84,34,53
7,r_148_53_70,seq115,seq11,r_148_53_70,0.75,11,81,70,53
32,r_64_85_51,seq84,r_2_21_21,r_64_85_51,1,1,52,51,53
44,r_99_69_122,seq77,seq47,r_99_69_122,0.92,0,122,122,53
79,seq72,r_95_101_36,r_138_51_4,r_95_101_36,0.9,0,36,36,53
35,r_44_142_93,seq123,r_2_21_21,r_44_142_93,0.98,0,93,93,53
23,r_136_76_39,r_111_125_142,seq63,r_136_76_39,0.97,0,39,39,53
87,seq89,r_55_67_49,r_148_53_70,r_55_67_49,0.9,96,145,49,53
30,r_79_2_153,seq141,r_83_18_53,r_79_2_153,0.92,0,153,153,54
14,r_117_22_117,r_3_24_2,seq50,r_117_22_117,1,0,117,117,54
8,r_94_35_60,r_147_72_132,seq46,r_94_35_60,1,0,60,60,54
51,seq131,r_76_58_58,seq133,r_76_58_58,1,0,58,58,54
24,r_81_69_123,seq146,r_84_73_98,r_81_69_123,0.94,3,126,123,54
61,seq145,seq141,r_84_73_98,r_84_73_98,0.98,0,98,98,54
54,seq135,r_29_80_102,seq120,r_29_80_102,0.89,0,102,102,54
36,r_98_128_18,seq54,seq138,r_98_128_18,0.97,0,18,18,54
54,seq135,seq120,r_32_68_125,r_32_68_125,0.82,39,164,125,54
5,r_77_137_22,seq126,r_149_66_196,r_77_137_22,0.93,0,22,22,54
16,r_48_23_64,r_17_87_197,seq139,r_48_23_64,1,0,64,64,54
42,r_29_80_102,seq135,r_140_122_63,r_29_80_102,1,0,102,102,54
21,r_88_136_50,seq103,seq111,r_88_136_50,0.4,-27,23,50,54
45,r_106_63_163,seq139,r_110_97_28,r_110_97_28,0.7,136,164,28,54
19,r_90_39_172,seq56,r_4_113_152,r_90_39_172,0.4,0,172,172,54
41,r_148_14_37,seq42,seq139,r_148_14_37,0.49,0,37,37,54
48,r_142_123_95,seq102,seq139,r_142_123_95,0.46,59,154,95,54
31,r_4_113_152,seq99,seq144,r_4_113_152,0.95,0,152,152,54
67,seq42,r_148_14_37,r_142_123_95,r_142_123_95,0.82,2,97,95,54
96,seq120,seq146,r_91_82_93,r_91_82_93,1,25,118,93,54
3,r_16_118_85,r_147_72_132,seq54,r_16_118_85,1,1,86,85,54
4,r_21_28_137,seq120,seq61,r_21_28_137,0.7,0,137,137,54
25,r_83_18_53,r_149_66_196,r_129_20_194,r_83_18_53,0.93,1,54,53,54
78,seq61,seq36,r_21_28_137,r_21_28_137,0.95,2,139,137,54
0,r_101_78_101,seq138,seq74,r_101_78_101,0.87,0,101,101,54
73,seq54,r_32_68_125,r_16_118_85,r_16_118_85,0.55,3,88,85,54
11,r_13_6_127,seq50,seq111,r_13_6_127,0.76,0,127,127,54
13,r_3_24_2,r_117_22_117,r_140_122_63,r_117_22_117,1,0,117,117,54
39,r_76_58_58,r_101_78_101,seq126,r_101_78_101,0.52,-25,76,101,54
48,r_142_123_95,seq144,seq102,r_142_123_95,0.7,2,97,95,54
46,r_53_130_115,r_91_82_93,r_140_122_63,r_53_130_115,0.78,-57,58,115,54
96,seq120,r_119_95_41,seq146,r_119_95_41,0.99,0,41,41,54
1,r_8_108_157,seq43,r_119_95_41,r_119_95_41,0.77,7,48,41,54
23,r_37_125_46,r_16_118_85,r_77_137_22,r_37_125_46,0.99,-1,45,46,54
6,r_129_20_194,seq144,r_110_97_28,r_110_97_28,0.56,0,28,28,54
2,r_32_68_125,seq51,seq120,r_32_68_125,0.73,0,125,125,54
47,r_116_40_164,seq103,r_140_122_63,r_116_40_164,0.62,0,164,164,54
39,r_76_58_58,seq131,r_101_78_101,r_76_58_58,0.9,0,58,58,54
40,r_91_82_93,r_53_130_115,seq120,r_91_82_93,1,0,93,93,54
74,seq56,r_90_39_172,r_25_47_146,r_25_47_146,0.61,0,146,146,54
18,r_62_41_155,r_107_1_182,seq139,r_62_41_155,0.84,0,155,155,54
29,r_27_109_84,r_81_69_123,r_34_5_105,r_27_109_84,0.95,21,105,84,54
24,r_81_69_123,seq67,seq146,r_81_69_123,0.32,-24,99,123,54
44,r_119_95_41,seq120,r_88_136_50,r_119_95_41,1,0,41,41,54
34,r_149_66_196,r_83_18_53,r_77_137_22,r_149_66_196,0.96,-153,43,196,54
43,r_140_122_63,r_53_130_115,r_29_80_102,r_140_122_63,0.98,52,115,63,54
39,r_76_58_58,seq126,r_98_128_18,r_76_58_58,0.64,91,149,58,54
70,seq46,seq133,r_94_35_60,r_94_35_60,1,6,66,60,54
32,r_147_72_132,seq57,r_77_137_22,r_147_72_132,0.55,2,134,132,54
38,r_112_124_134,r_149_66_196,seq102,r_149_66_196,0.63,-68,128,196,54
20,r_85_89_26,seq46,r_107_1_182,r_85_89_26,0.97,1,27,26,54
75,seq57,r_147_72_132,seq139,r_147_72_132,0.69,1,133,132,54
60,seq144,r_142_123_95,seq9,r_142_123_95,0.41,-6,89,95,54
17,r_107_1_182,r_62_41_155,r_85_89_26,r_107_1_182,0.89,-27,155,182,54
25,r_83_18_53,r_129_20_194,r_79_2_153,r_79_2_153,1,0,153,153,54
94,seq114,r_12_26_179,r_29_80_102,r_29_80_102,1,78,180,102,54
9,r_25_47_146,seq121,seq56,r_25_47_146,0.94,0,146,146,54
22,r_84_73_98,r_140_122_63,seq145,r_84_73_98,0.94,0,98,98,54
28,r_34_5_105,seq141,r_27_109_84,r_34_5_105,0.99,1,106,105,54
35,r_110_97_28,r_107_1_182,r_129_20_194,r_110_97_28,0.79,0,28,28,54
49,r_49_44_99,seq15,seq67,r_49_44_99,0.99,0,99,99,54
7,r_64_19_129,seq141,seq96,r_64_19_129,0.94,0,129,129,54
43,r_140_122_63,r_117_22_117,r_53_130_115,r_53_130_115,0.64,-60,55,115,54
46,r_53_130_115,r_140_122_63,r_27_109_84,r_53_130_115,1,0,115,115,54
60,seq144,seq9,r_4_113_152,r_4_113_152,1,0,152,152,54
12,r_12_26_179,seq114,r_142_123_95,r_142_123_95,0.54,84,179,95,54
26,r_93_55_198,r_91_82_93,r_140_122_63,r_91_82_93,1,-35,58,93,54
30,r_58_29_195,r_118_37_93,seq83,r_118_37_93,0.83,-8,85,93,55
51,seq2,seq124,r_79_75_22,r_79_75_22,0.69,54,76,22,55
36,r_123_117_82,seq119,r_54_80_141,r_123_117_82,0.99,0,82,82,55
14,r_115_87_144,seq96,r_19_84_10,r_115_87_144,0.95,0,144,144,55
8,r_70_74_101,seq119,r_58_29_195,r_70_74_101,0.93,0,101,101,55
8,r_70_74_101,r_58_29_195,r_108_34_143,r_108_34_143,1,4,147,143,55
36,r_123_117_82,r_54_80_141,seq23,r_54_80_141,1,0,141,141,55
4,r_19_84_10,r_114_52_186,r_110_99_178,r_19_84_10,1,0,10,10,55
37,r_39_144_66,r_25_9_182,r_49_60_56,r_39_144_66,0.94,3,69,66,55
71,seq55,r_25_9_182,r_40_73_77,r_40_73_77,1,4,81,77,55
16,r_118_37_93,r_58_29_195,seq142,r_58_29_195,0.64,-101,94,195,55
21,r_148_97_173,seq76,seq0,r_148_97_173,0.67,0,173,173,55
1,r_68_149_133,seq124,seq16,r_68_149_133,0.96,0,133,133,55
97,seq120,r_108_34_143,seq0,r_108_34_143,0.78,0,143,143,55
46,r_20_44_64,r_40_73_77,r_14_32_18,r_20_44_64,1,0,64,64,55
42,r_103_57_147,seq63,r_135_51_36,r_103_57_147,0.66,1,148,147,55
24,r_92_139_29,r_104_48_111,r_126_72_67,r_92_139_29,0.99,-2,27,29,55
69,seq136,r_4_10_138,seq91,r_4_10_138,1,0,138,138,55
10,r_85_69_48,seq55,seq59,r_85_69_48,0.96,0,48,48,55
15,r_25_9_182,r_40_73_77,seq23,r_40_73_77,0.43,106,183,77,55
27,r_54_80_141,r_123_117_82,r_49_60_56,r_54_80_141,0.96,0,141,141,55
41,r_127_101_157,seq63,seq55,r_127_101_157,0.56,0,157,157,55
67,seq43,r_104_48_111,seq76,r_104_48_111,0.98,-34,77,111,55
89,seq100,r_45_6_163,r_118_37_93,r_45_6_163,0.94,-2,161,163,55
49,r_104_48_111,r_92_139_29,seq43,r_92_139_29,0.97,-7,22,29,55
17,r_138_18_46,seq142,seq94,r_138_18_46,1,0,46,46,55
3,r_64_129_136,seq95,seq91,r_64_129_136,0.91,0,136,136,55
38,r_133_122_137,r_7_5_60,seq102,r_133_122_137,0.69,-29,108,137,55
26,r_40_73_77,r_133_122_137,r_25_9_182,r_40_73_77,1,0,77,77,55
72,seq56,seq131,r_147_35_78,r_147_35_78,1,2,80,78,55
95,seq112,seq8,r_28_105_25,r_28_105_25,1,5,30,25,55
78,seq76,r_137_46_170,r_4_10_138,r_4_10_138,0.82,32,170,138,55
0,r_45_6_163,seq100,r_123_117_82,r_45_6_163,0.69,-1,162,163,55
33,r_28_105_25,seq131,seq112,r_28_105_25,0.97,0,25,25,55
73,seq59,seq146,r_85_69_48,r_85_69_48,1,2,50,48,55
20,r_4_10_138,seq136,seq76,r_4_10_138,0.94,0,138,138,55
13,r_61_21_98,seq63,seq8,r_61_21_98,0.99,0,98,98,55
15,r_25_9_182,seq55,r_40_73_77,r_40_73_77,1,5,82,77,55
40,r_135_51_36,r_123_117_82,seq95,r_135_51_36,0.99,0,36,36,55
48,r_140_12_99,seq88,seq106,r_140_12_99,0.98,0,99,99,55
49,r_104_48_111,seq43,r_30_53_21,r_104_48_111,1,1,112,111,55
4,r_19_84_10,r_110_99_178,r_115_87_144,r_19_84_10,0.57,158,168,10,55
45,r_49_60_56,seq66,seq36,r_49_60_56,1,0,56,56,55
6,r_33_121_153,seq102,r_19_84_10,r_33_121_153,0.51,1,154,153,55
99,seq125,r_3_128_167,r_1_17_63,r_3_128_167,0.48,2,169,167,55
43,r_79_75_22,seq38,r_58_29_195,r_79_75_22,0.64,4,26,22,55
87,seq95,r_64_129_136,r_135_51_36,r_135_51_36,0.98,0,36,36,55
27,r_54_80_141,seq23,r_123_117_82,r_123_117_82,1,0,82,82,55
51,seq2,r_79_75_22,r_67_98_130,r_67_98_130,0.85,37,167,130,55
44,r_126_72_67,r_92_139_29,seq112,r_126_72_67,0.96,0,67,67,55
32,r_145_134_189,seq47,r_30_53_21,r_30_53_21,0.93,1,22,21,55
18,r_26_113_17,seq38,r_67_98_130,r_26_113_17,0.96,0,17,17,55
29,r_137_46_170,r_148_97_173,r_67_98_130,r_137_46_170,0.42,0,170,170,55
44,r_126_72_67,seq65,r_92_139_29,r_92_139_29,0.58,12,41,29,55
25,r_108_34_143,seq120,r_70_74_101,r_108_34_143,0.67,1,144,143,55
23,r_110_99_178,r_7_5_60,r_19_84_10,r_19_84_10,0.74,0,10,10,55
31,r_15_11_47,r_40_73_77,r_145_134_189,r_15_11_47,0.98,-1,46,47,55
38,r_133_122_137,seq102,seq111,r_133_122_137,0.53,-10,127,137,55
50,seq0,seq120,r_148_97_173,r_148_97_173,0.98,0,173,173,55
58,seq146,r_114_52_186,r_85_69_48,r_85_69_48,1,139,187,48,55
70,seq50,seq109,r_42_77_140,r_42_77_140,1,0,140,140,55
68,seq47,r_145_134_189,r_7_5_60,r_7_5_60,1,11,71,60,55
38,r_133_122_137,r_40_73_77,r_7_5_60,r_133_122_137,0.87,-61,76,137,55
22,r_14_32_18,seq27,r_20_44_64,r_20_44_64,0.83,10,74,64,55
24,r_92_139_29,r_126_72_67,seq65,r_126_72_67,1,0,67,67,55
34,r_78_116_183,seq106,r_26_113_17,r_78_116_183,0.42,0,183,183,55
75,seq65,r_126_72_67,r_92_139_29,r_126_72_67,0.7,0,67,67,55
22,r_14_32_18,r_7_5_60,seq27,r_14_32_18,0.98,0,18,18,55
60,seq23,r_54_80_141,seq65,r_54_80_141,0.87,-45,96,141,55
81,seq83,r_42_77_140,r_58_29_195,r_58_29_195,0.48,-107,88,195,55
94,seq111,seq136,r_133_122_137,r_133_122_137,0.66,5,142,137,55
9,r_7_5_60,r_110_99_178,r_15_11_47,r_7_5_60,0.97,0,60,60,55
26,r_40_73_77,r_25_9_182,r_127_101_157,r_127_101_157,1,31,188,157,55
47,r_30_53_21,r_1_17_63,r_145_134_189,r_30_53_21,0.59,0,21,21,55
96,seq119,r_123_117_82,seq16,r_123_117_82,1,-6,76,82,55
28,r_67_98_130,r_26_113_17,r_104_48_111,r_67_98_130,0.81,1,131,130,55
91,seq106,r_89_143_199,r_140_12_99,r_140_12_99,1,38,137,99,55
32,r_145_134_189,r_30_53_21,r_15_11_47,r_15_11_47,1,18,65,47,55
7,r_147_35_78,seq120,seq56,r_147_35_78,1,1,79,78,55
18,r_26_113_17,r_67_98_130,r_78_116_183,r_26_113_17,0.85,113,130,17,55
86,seq94,seq31,r_138_18_46,r_138_18_46,1,13,59,46,55
5,r_13_86_23,seq41,seq96,r_13_86_23,1,1,24,23,55
35,r_42_77_140,r_58_29_195,seq50,r_42_77_140,0.94,0,140,140,55
12,r_1_17_63,seq50,seq27,r_1_17_63,0.76,-25,38,63,55
23,r_110_99_178,r_19_84_10,r_135_51_36,r_110_99_178,0.59,0,178,178,55
30,r_61_2_115,seq148,seq16,r_61_2_115,1,0,115,115,56
44,r_76_50_12,seq0,r_127_55_143,r_127_55_143,0.38,-60,83,143,56
36,r_145_30_78,r_97_82_191,seq96,r_145_30_78,1,0,78,78,56
14,r_118_81_155,seq114,r_147_20_69,r_118_81_155,0.68,0,155,155,56
32,r_83_35_4,r_111_102_173,r_105_64_31,r_105_64_31,1,0,31,31,56
83,seq73,r_5_104_89,seq25,r_5_104_89,1,0,89,89,56
37,r_5_104_89,seq73,r_127_55_143,r_5_104_89,0.86,0,89,89,56
54,seq140,seq86,r_91_133_41,r_91_133_41,0.29,77,118,41,56
59,seq148,r_61_2_115,seq36,r_61_2_115,1,0,115,115,56
71,seq43,seq59,r_112_60_87,r_112_60_87,1,2,89,87,56
21,r_129_144_149,r_120_28_176,r_132_47_119,r_129_144_149,0.8,0,149,149,56
1,r_103_90_32,seq11,r_87_48_183,r_103_90_32,0.46,149,181,32,56
16,r_19_108_76,r_63_70_52,r_120_28_176,r_19_108_76,0.87,-32,44,76,56
42,r_37_122_189,r_138_13_153,r_83_35_4,r_37_122_189,0.68,-36,153,189,56
33,r_141_33_38,seq14,r_100_135_180,r_141_33_38,0.98,0,38,38,56
19,r_115_17_103,r_62_51_88,r_132_47_119,r_62_51_88,0.93,-11,77,88,56
43,r_91_133_41,seq84,seq46,r_91_133_41,1,0,41,41,56
33,r_141_33_38,r_100_135_180,r_138_13_153,r_141_33_38,0.54,143,181,38,56
27,r_9_79_171,r_80_22_77,seq29,r_9_79_171,0.55,4,175,171,56
78,seq65,r_53_67_1,r_110_143_164,r_110_143_164,1,1,165,164,56
31,r_45_8_110,seq65,r_132_47_119,r_45_8_110,0.99,0,110,110,56
41,r_110_143_164,r_9_79_171,seq65,r_9_79_171,0.46,-7,164,171,56
3,r_23_128_80,r_112_60_87,seq27,r_23_128_80,0.93,0,80,80,56
8,r_119_24_23,r_61_2_115,seq43,r_119_24_23,1,0,23,23,56
42,r_37_122_189,r_83_35_4,r_5_104_89,r_37_122_189,0.74,0,189,189,56
4,r_42_72_142,r_9_79_171,seq27,r_42_72_142,0.93,0,142,142,56
78,seq65,r_45_8_110,r_53_67_1,r_45_8_110,1,0,110,110,56
0,r_94_101_112,r_69_89_178,r_115_17_103,r_94_101_112,0.94,0,112,112,56
63,seq27,r_57_107_177,r_42_72_142,r_42_72_142,0.94,2,144,142,56
7,r_120_28_176,r_88_4_101,r_99_123_90,r_120_28_176,0.8,1,177,176,56
46,r_63_70_52,r_19_108_76,seq92,r_63_70_52,1,0,52,52,56
39,r_105_64_31,seq44,r_83_35_4,r_105_64_31,1,0,31,31,56
20,r_80_22_77,r_45_8_110,r_9_79_171,r_80_22_77,1,1,78,77,56
13,r_57_107_177,seq27,seq39,r_57_107_177,0.5,0,177,177,56
73,seq46,seq146,r_91_133_41,r_91_133_41,1,3,44,41,56
44,r_76_50_12,seq77,seq0,r_76_50_12,0.74,0,12,12,56
44,r_76_50_12,r_127_55_143,r_94_101_112,r_76_50_12,0.86,110,122,12,56
15,r_62_51_88,seq71,r_21_40_48,r_62_51_88,0.99,0,88,88,56
2,r_132_47_119,seq71,r_45_8_110,r_45_8_110,1,4,114,110,56
49,r_88_4_101,r_120_28_176,seq52,r_120_28_176,0.95,1,177,176,56
57,seq16,seq68,r_61_2_115,r_61_2_115,0.99,0,115,115,56
37,r_5_104_89,r_127_55_143,r_7_12_125,r_5_104_89,1,46,135,89,56
6,r_138_13_153,r_37_122_189,r_131_75_97,r_138_13_153,0.8,0,153,153,56
62,seq26,r_117_18_195,r_19_108_76,r_19_108_76,1,0,76,76,56
1,r_103_90_32,r_69_89_178,seq11,r_103_90_32,1,16,48,32,56
27,r_9_79_171,r_110_143_164,r_80_22_77,r_80_22_77,1,3,80,77,56
40,r_127_55_143,r_115_17_103,r_147_20_69,r_127_55_143,1,0,143,143,56
35,r_112_60_87,seq29,seq43,r_112_60_87,1,0,87,87,56
84,seq74,seq139,r_21_40_48,r_21_40_48,1,2,50,48,56
2,r_132_47_119,r_62_51_88,seq71,r_62_51_88,0.96,-11,77,88,56
47,r_3_124_108,seq142,r_115_17_103,r_115_17_103,0.72,5,108,103,56
40,r_127_55_143,r_32_98_64,seq6,r_127_55_143,0.54,-79,64,143,56
19,r_115_17_103,r_132_47_119,r_127_55_143,r_115_17_103,0.79,0,103,103,56
29,r_7_12_125,seq149,r_5_104_89,r_7_12_125,0.9,0,125,125,56
25,r_69_89_178,r_131_75_97,seq96,r_131_75_97,1,-3,94,97,56
16,r_19_108_76,r_120_28_176,seq26,r_19_108_76,1,0,76,76,56
64,seq29,r_112_60_87,seq39,r_112_60_87,0.98,0,87,87,56
66,seq34,r_21_40_48,seq125,r_21_40_48,0.95,0,48,48,56
65,seq31,r_117_18_195,seq148,r_117_18_195,0.66,-134,61,195,56
20,r_80_22_77,r_9_79_171,seq68,r_80_22_77,0.54,98,175,77,56
38,r_53_67_1,r_80_22_77,seq65,r_80_22_77,1,1,78,77,56
40,r_127_55_143,seq6,r_115_17_103,r_127_55_143,0.63,-37,106,143,56
34,r_131_75_97,r_69_89_178,seq25,r_131_75_97,0.71,0,97,97,56
45,r_100_135_180,r_5_104_89,r_141_33_38,r_100_135_180,0.8,-139,41,180,56
64,seq29,seq39,r_9_79_171,r_9_79_171,0.75,0,171,171,56
34,r_131_75_97,seq25,r_138_13_153,r_138_13_153,0.94,-1,152,153,56
60,seq149,seq78,r_147_20_69,r_147_20_69,1,0,69,69,56
45,r_100_135_180,r_141_33_38,r_69_89_178,r_100_135_180,0.4,1,181,180,56
17,r_99_123_90,r_57_107_177,r_63_70_52,r_99_123_90,1,1,91,90,56
9,r_58_116_65,r_132_47_119,seq136,r_58_116_65,0.8,0,65,65,56
22,r_87_48_183,seq93,r_103_90_32,r_103_90_32,0.54,151,183,32,56
28,r_147_20_69,r_5_104_89,seq149,r_147_20_69,0.98,0,69,69,56
91,seq93,r_87_48_183,r_145_30_78,r_145_30_78,0.64,108,186,78,56
49,r_88_4_101,seq95,r_120_28_176,r_88_4_101,0.96,0,101,101,56
72,seq44,seq125,r_7_12_125,r_7_12_125,0.36,21,146,125,56
19,r_115_17_103,r_127_55_143,r_3_124_108,r_127_55_143,0.67,-24,119,143,56
23,r_21_40_48,seq34,seq74,r_21_40_48,1,0,48,48,56
7,r_120_28_176,r_129_144_149,r_88_4_101,r_120_28_176,0.51,-27,149,176,56
82,seq71,r_62_51_88,seq41,r_62_51_88,1,0,88,88,56
72,seq44,r_7_12_125,seq0,r_7_12_125,0.58,52,177,125,56
35,r_112_60_87,r_23_128_80,seq29,r_23_128_80,0.66,-20,60,80,56
12,r_134_137_168,seq11,seq25,r_134_137_168,0.54,1,169,168,56
93,seq118,r_52_144_122,seq0,r_52_144_122,1,0,122,122,57
97,seq122,r_34_42_183,r_132_61_55,r_132_61_55,1,3,58,55,57
15,r_101_102_89,seq112,r_52_144_122,r_52_144_122,0.97,-1,121,122,57
36,r_27_48_65,r_123_66_110,r_12_22_20,r_27_48_65,0.98,0,65,65,57
8,r_76_58_174,seq79,seq98,r_76_58_174,0.59,0,174,174,57
30,r_14_3_22,seq86,r_125_26_53,r_125_26_53,1,11,64,53,57
43,r_135_71_115,seq37,r_142_87_151,r_142_87_151,1,7,158,151,57
37,r_123_66_110,r_47_68_172,r_5_46_194,r_123_66_110,0.77,0,110,110,57
71,seq51,seq37,r_140_67_128,r_140_67_128,0.99,9,137,128,57
21,r_64_78_140,seq80,seq43,r_64_78_140,0.63,0,140,140,57
39,r_130_75_102,seq112,seq114,r_130_75_102,0.93,1,103,102,57
1,r_19_81_30,r_49_41_18,seq149,r_19_81_30,0.32,90,120,30,57
80,seq91,seq114,r_97_95_171,r_97_95_171,1,4,175,171,57
5,r_88_138_114,seq127,seq10,r_88_138_114,0.89,0,114,114,57
46,r_25_133_68,seq51,r_45_137_51,r_25_133_68,1,0,68,68,57
42,r_113_55_196,r_74_39_168,r_96_92_31,r_113_55_196,0.64,-28,168,196,57
80,seq91,r_83_11_105,seq114,r_83_11_105,1,0,105,105,57
69,seq43,r_117_57_178,seq127,r_117_57_178,0.69,-107,71,178,57
45,r_47_68_172,seq139,seq134,r_47_68_172,0.67,0,172,172,57
35,r_44_72_50,seq23,seq38,r_44_72_50,1,1,51,50,57
30,r_14_3_22,r_16_147_71,seq86,r_14_3_22,0.97,0,22,22,57
19,r_17_2_123,seq79,r_88_138_114,r_17_2_123,0.97,0,123,123,57
34,r_89_21_52,seq119,r_12_22_20,r_89_21_52,1,0,52,52,57
47,r_45_137_51,seq107,r_64_78_140,r_45_137_51,0.94,1,52,51,57
76,seq79,r_17_2_123,r_76_58_174,r_17_2_123,0.98,0,123,123,57
1,r_19_81_30,seq98,r_49_41_18,r_19_81_30,0.99,0,30,30,57
41,r_108_15_83,seq116,seq53,r_108_15_83,1,2,85,83,57
76,seq79,r_76_58_174,r_142_87_151,r_76_58_174,0.97,0,174,174,57
3,r_140_67_128,r_64_78_140,r_25_133_68,r_25_133_68,1,3,71,68,57
90,seq114,r_18_141_141,r_70_8_129,r_18_141_141,0.82,0,141,141,57
3,r_140_67_128,r_25_133_68,seq51,r_140_67_128,1,0,128,128,57
26,r_74_39_168,r_113_55_196,seq139,r_74_39_168,0.57,0,168,168,57
78,seq86,r_31_56_153,r_125_26_53,r_125_26_53,1,100,153,53,57
0,r_97_95_171,r_47_68_172,seq91,r_47_68_172,0.48,-1,171,172,57
11,r_4_136_125,seq79,r_83_11_105,r_4_136_125,0.99,0,125,125,57
20,r_82_93_186,r_5_46_194,r_125_26_53,r_82_93_186,0.51,1,187,186,57
15,r_101_102_89,r_1_85_1,seq112,r_101_102_89,0.92,7,96,89,57
48,r_70_8_129,r_142_87_151,seq114,r_142_87_151,0.67,-1,150,151,57
58,seq145,r_16_147_71,r_31_56_153,r_31_56_153,0.95,2,155,153,57
62,seq24,r_99_36_36,seq7,r_99_36_36,1,0,36,36,57
70,seq50,seq37,r_89_21_52,r_89_21_52,0.99,0,52,52,57
33,r_83_11_105,r_108_15_83,r_4_136_125,r_4_136_125,0.97,12,137,125,57
14,r_99_36_36,seq24,seq38,r_99_36_36,1,0,36,36,57
6,r_18_141_141,seq114,r_1_85_1,r_18_141_141,0.98,0,141,141,57
2,r_6_29_70,seq145,seq120,r_6_29_70,0.54,28,98,70,57
99,seq127,seq43,r_9_100_137,r_9_100_137,1,1,138,137,57
10,r_69_84_19,r_82_93_186,seq7,r_69_84_19,0.47,103,122,19,57
94,seq119,seq98,r_117_57_178,r_117_57_178,0.69,3,181,178,57
9,r_49_41_18,r_6_29_70,seq149,r_49_41_18,1,2,20,18,57
98,seq126,seq128,r_96_92_31,r_96_92_31,0.99,1,32,31,57
25,r_148_62_100,seq145,r_31_56_153,r_31_56_153,1,4,157,153,57
29,r_12_22_20,seq50,r_89_21_52,r_89_21_52,1,0,52,52,57
24,r_31_56_153,seq86,r_148_62_100,r_31_56_153,0.64,0,153,153,57
13,r_96_92_31,seq106,seq126,r_96_92_31,0.96,0,31,31,57
25,r_148_62_100,seq38,seq145,r_148_62_100,0.94,0,100,100,57
33,r_83_11_105,seq91,r_108_15_83,r_83_11_105,0.89,0,105,105,57
47,r_45_137_51,r_64_78_140,r_25_133_68,r_45_137_51,0.91,20,71,51,57
85,seq106,seq115,r_17_2_123,r_17_2_123,0.96,33,156,123,57
2,r_6_29_70,r_49_41_18,seq145,r_6_29_70,0.8,-48,22,70,57
32,r_65_54_169,seq37,seq109,r_65_54_169,0.53,0,169,169,57
23,r_125_26_53,r_9_100_137,r_14_3_22,r_125_26_53,1,0,53,53,57
38,r_13_60_136,r_1_85_1,seq109,r_13_60_136,0.8,-1,135,136,57
77,seq80,r_64_78_140,r_25_133_68,r_25_133_68,0.8,16,84,68,57
17,r_9_100_137,seq119,seq127,r_9_100_137,0.94,1,138,137,57
10,r_69_84_19,seq24,r_82_93_186,r_69_84_19,0.5,22,41,19,57
29,r_12_22_20,r_19_81_30,seq50,r_12_22_20,0.95,0,20,20,57
22,r_146_111_124,r_113_55_196,seq33,r_146_111_124,0.89,0,124,124,57
28,r_142_87_151,r_70_8_129,r_135_71_115,r_142_87_151,0.84,0,151,151,57
10,r_69_84_19,r_65_54_169,seq24,r_69_84_19,0.71,0,19,19,57
49,r_16_147_71,seq53,seq145,r_16_147_71,0.99,0,71,71,57
7,r_1_85_1,r_13_60_136,seq77,r_13_60_136,0.99,0,136,136,57
44,r_52_144_122,seq118,r_101_102_89,r_52_144_122,0.95,0,122,122,57
12,r_117_57_178,seq43,seq119,r_117_57_178,0.5,0,178,178,57
30,r_99_68_171,seq95,seq64,r_99_68_171,0.49,0,171,171,58
44,r_32_120_187,r_11_131_100,seq31,r_32_120_187,0.62,0,187,187,58
36,r_49_6_116,seq37,seq140,r_49_6_116,1,0,116,116,58
26,r_86_48_43,seq148,r_27_142_128,r_86_48_43,1,2,45,43,58
20,r_73_96_61,seq77,r_44_91_92,r_44_91_92,1,0,92,92,58
14,r_94_103_90,r_14_41_127,seq122,r_94_103_90,1,1,91,90,58
8,r_55_128_107,r_40_42_149,seq57,r_55_128_107,1,0,107,107,58
54,seq9,seq24,r_12_92_129,r_12_92_129,0.97,2,131,129,58
37,r_23_104_60,r_12_92_129,seq36,r_23_104_60,1,0,60,60,58
59,seq16,r_71_112_182,r_46_133_64,r_46_133_64,1,118,182,64,58
10,r_27_142_128,r_86_48_43,seq97,r_27_142_128,1,0,128,128,58
71,seq38,seq58,r_69_5_71,r_69_5_71,1,-6,65,71,58
21,r_114_19_124,r_43_84_134,r_14_41_127,r_114_19_124,0.98,-1,123,124,58
39,r_69_5_71,seq138,seq38,r_69_5_71,1,-3,68,71,58
5,r_34_0_180,seq134,r_45_107_154,r_45_107_154,0.5,26,180,154,58
46,r_52_50_76,seq100,r_49_6_116,r_49_6_116,0.63,-40,76,116,58
42,r_11_131_100,seq135,r_32_120_187,r_11_131_100,0.77,-1,99,100,58
33,r_89_51_37,seq13,seq95,r_89_51_37,0.95,1,38,37,58
46,r_52_50_76,r_49_6_116,r_2_61_85,r_52_50_76,0.53,18,94,76,58
45,r_143_62_165,seq116,r_82_60_135,r_143_62_165,0.73,0,165,165,58
19,r_43_84_134,seq140,seq138,r_43_84_134,0.52,3,137,134,58
34,r_149_124_89,r_94_103_90,r_2_61_85,r_149_124_89,0.86,2,91,89,58
38,r_109_98_54,r_45_107_154,seq97,r_109_98_54,1,0,54,54,58
34,r_149_124_89,r_94_103_90,r_82_60_135,r_149_124_89,0.53,-67,22,89,58
28,r_74_10_31,r_130_102_53,r_118_26_173,r_118_26_173,0.54,1,174,173,58
10,r_27_142_128,r_66_54_113,r_86_48_43,r_86_48_43,0.85,30,73,43,58
9,r_22_83_38,r_45_107_154,seq138,r_22_83_38,1,0,38,38,58
32,r_59_85_40,seq57,seq79,r_59_85_40,1,0,40,40,58
4,r_12_92_129,r_23_104_60,seq117,r_23_104_60,0.99,0,60,60,58
16,r_25_78_57,seq13,seq56,r_25_78_57,1,0,57,57,58
11,r_72_65_84,seq138,seq122,r_72_65_84,0.99,0,84,84,58
20,r_73_96_61,seq138,seq77,r_73_96_61,0.97,0,61,61,58
13,r_44_91_92,seq57,r_73_96_61,r_44_91_92,1,0,92,92,58
25,r_1_15_12,r_32_120_187,seq134,r_32_120_187,0.57,-154,33,187,58
15,r_146_20_109,seq38,seq4,r_146_20_109,0.89,0,109,109,58
48,r_46_133_64,r_49_6_116,seq16,r_46_133_64,0.97,1,65,64,58
4,r_12_92_129,seq117,seq9,r_12_92_129,1,0,129,129,58
34,r_149_124_89,r_82_60_135,r_94_103_90,r_149_124_89,0.46,-18,71,89,58
74,seq57,seq4,r_55_128_107,r_55_128_107,1,0,107,107,58
85,seq100,r_52_50_76,seq88,r_52_50_76,1,-7,69,76,58
1,r_70_28_195,seq115,seq31,r_70_28_195,0.38,-105,90,195,58
27,r_82_60_135,r_21_106_141,r_59_85_40,r_21_106_141,0.57,-6,135,141,58
84,seq97,seq58,r_109_98_54,r_109_98_54,1,2,56,54,58
2,r_7_110_98,seq115,seq56,r_7_110_98,1,1,99,98,58
47,r_71_112_182,seq16,seq100,r_71_112_182,0.35,0,182,182,58
40,r_3_30_66,seq53,seq134,r_3_30_66,0.73,-1,65,66,58
18,r_81_39_123,r_18_129_130,seq132,r_81_39_123,0.83,0,123,123,58
24,r_80_126_78,seq77,r_105_76_65,r_80_126_78,1,0,78,78,58
43,r_137_47_30,seq108,seq115,r_137_47_30,1,1,31,30,58
1,r_70_28_195,seq31,r_137_47_30,r_70_28_195,0.5,-65,130,195,58
85,seq100,seq88,r_71_112_182,r_71_112_182,0.56,7,189,182,58
6,r_113_8_157,seq132,r_105_76_65,r_113_8_157,0.54,0,157,157,58
42,r_11_131_100,r_32_120_187,r_21_106_141,r_11_131_100,0.62,62,162,100,58
52,seq135,r_11_131_100,seq141,r_11_131_100,0.91,-1,99,100,58
19,r_43_84_134,seq138,r_67_90_160,r_67_90_160,1,2,162,160,58
74,seq57,r_59_85_40,seq4,r_59_85_40,1,0,40,40,58
1,r_70_28_195,r_89_51_37,seq115,r_89_51_37,0.98,-6,31,37,58
67,seq33,r_113_8_157,seq132,r_113_8_157,0.7,-102,55,157,58
81,seq141,seq101,r_46_133_64,r_46_133_64,0.88,86,150,64,58
17,r_66_54_113,r_27_142_128,r_59_85_40,r_27_142_128,0.6,-15,113,128,58
26,r_86_48_43,r_27_142_128,seq17,r_27_142_128,0.98,0,128,128,58
31,r_18_129_130,r_74_10_31,seq135,r_18_129_130,0.88,0,130,130,58
28,r_74_10_31,r_18_129_130,r_130_102_53,r_74_10_31,0.76,99,130,31,58
22,r_14_41_127,r_94_103_90,r_114_19_124,r_14_41_127,1,-36,91,127,58
28,r_74_10_31,seq38,r_18_129_130,r_74_10_31,0.99,0,31,31,58
49,r_2_61_85,seq56,r_52_50_76,r_2_61_85,1,0,85,85,58
72,seq53,r_93_87_34,r_45_107_154,r_45_107_154,0.66,-3,151,154,58
0,r_130_102_53,seq16,r_74_10_31,r_130_102_53,1,0,53,53,58
31,r_18_129_130,r_105_76_65,r_74_10_31,r_74_10_31,0.99,0,31,31,58
44,r_32_120_187,seq125,r_11_131_100,r_11_131_100,1,-1,99,100,58
58,seq13,r_89_51_37,r_82_60_135,r_89_51_37,1,1,38,37,58
52,seq135,seq141,r_18_129_130,r_18_129_130,0.88,2,132,130,58
30,r_35_73_119,seq140,seq127,r_35_73_119,1,0,119,119,59
36,r_76_27_170,seq106,r_48_128_102,r_76_27_170,0.45,1,171,170,59
3,r_104_102_64,seq70,r_131_25_164,r_131_25_164,1,7,171,164,59
55,seq8,r_90_5_177,seq137,r_90_5_177,0.53,-10,167,177,59
81,seq68,seq32,r_55_105_44,r_55_105_44,1,0,44,44,59
16,r_41_4_68,r_117_9_174,seq64,r_41_4_68,1,0,68,68,59
1,r_62_126_138,r_1_96_129,r_71_43_147,r_1_96_129,0.35,-5,124,129,59
42,r_77_108_146,seq28,r_88_101_65,r_88_101_65,1,2,67,65,59
32,r_54_149_38,r_71_43_147,r_104_102_64,r_54_149_38,0.74,109,147,38,59
32,r_54_149_38,r_50_29_101,r_71_43_147,r_54_149_38,1,0,38,38,59
50,seq0,seq63,r_109_86_31,r_109_86_31,1,27,58,31,59
19,r_129_112_127,r_90_5_177,seq125,r_129_112_127,0.74,-2,125,127,59
33,r_88_101_65,r_77_108_146,r_62_126_138,r_88_101_65,0.88,82,147,65,59
38,r_6_60_54,r_1_96_129,r_98_85_14,r_6_60_54,0.97,0,54,54,59
95,seq116,seq92,r_103_49_114,r_103_49_114,0.99,5,119,114,59
22,r_119_145_172,seq78,seq12,r_119_145_172,0.91,0,172,172,59
76,seq136,r_90_5_177,seq137,r_90_5_177,0.72,0,177,177,59
31,r_90_5_177,seq136,seq31,r_90_5_177,0.67,0,177,177,59
41,r_142_59_188,seq15,r_71_43_147,r_71_43_147,0.6,41,188,147,59
89,seq84,r_103_49_114,seq64,r_103_49_114,1,1,115,114,59
90,seq91,seq124,r_75_20_10,r_75_20_10,1,0,10,10,59
3,r_104_102_64,r_7_16_75,seq70,r_104_102_64,0.93,0,64,64,59
17,r_82_57_5,seq125,r_94_17_77,r_82_57_5,0.88,82,87,5,59
4,r_95_146_63,seq64,r_110_66_39,r_95_146_63,0.99,0,63,63,59
0,r_131_25_164,seq78,r_104_102_64,r_131_25_164,0.68,0,164,164,59
63,seq19,seq10,r_45_87_62,r_45_87_62,0.99,5,67,62,59
11,r_98_85_14,r_42_26_190,seq143,r_98_85_14,0.85,0,14,14,59
13,r_7_16_75,r_82_57_5,r_30_39_51,r_7_16_75,0.92,2,77,75,59
98,seq125,seq124,r_129_112_127,r_129_112_127,0.87,1,128,127,59
15,r_61_107_37,r_35_73_119,r_133_141_4,r_61_107_37,1,0,37,37,59
94,seq106,r_76_27_170,r_30_39_51,r_30_39_51,1,4,55,51,59
21,r_1_96_129,r_62_126_138,r_129_112_127,r_1_96_129,0.64,-1,128,129,59
99,seq127,seq22,r_35_73_119,r_35_73_119,1,12,131,119,59
10,r_71_43_147,r_54_149_38,r_138_72_133,r_54_149_38,1,109,147,38,59
87,seq80,r_24_147_99,r_119_145_172,r_24_147_99,0.94,0,99,99,59
2,r_24_147_99,seq80,r_30_39_51,r_24_147_99,0.98,0,99,99,59
47,r_48_128_102,seq143,seq99,r_48_128_102,0.99,0,102,102,59
40,r_103_49_114,seq84,seq116,r_103_49_114,0.95,1,115,114,59
18,r_2_69_84,r_117_9_174,seq130,r_2_69_84,1,1,85,84,59
29,r_121_100_131,r_119_145_172,seq37,r_121_100_131,0.82,0,131,131,59
45,r_110_66_39,seq78,seq10,r_110_66_39,0.99,0,39,39,59
35,r_117_9_174,r_104_102_64,seq93,r_117_9_174,0.48,3,177,174,59
25,r_58_89_107,seq70,seq10,r_58_89_107,1,0,107,107,59
48,r_133_141_4,r_42_26_190,r_61_107_37,r_61_107_37,1,140,177,37,59
87,seq80,r_119_145_172,r_118_111_120,r_118_111_120,0.67,5,125,120,59
58,seq139,seq52,r_50_29_101,r_50_29_101,1,-1,100,101,59
20,r_55_105_44,r_45_87_62,seq68,r_55_105_44,1,0,44,44,59
42,r_77_108_146,r_88_101_65,seq132,r_77_108_146,0.98,0,146,146,59
61,seq15,r_142_59_188,r_122_97_162,r_122_97_162,0.62,26,188,162,59
21,r_1_96_129,r_6_60_54,r_62_126_138,r_6_60_54,0.99,2,56,54,59
26,r_50_29_101,r_54_149_38,r_74_53_110,r_54_149_38,0.98,0,38,38,59
33,r_88_101_65,seq78,r_77_108_146,r_88_101_65,0.92,-21,44,65,59
10,r_71_43_147,r_138_72_133,r_54_149_38,r_54_149_38,1,0,38,38,59
6,r_30_39_51,r_62_126_138,seq106,r_30_39_51,0.97,0,51,51,59
17,r_82_57_5,r_7_16_75,seq125,r_82_57_5,0.61,71,76,5,59
46,r_115_21_23,r_61_107_37,seq123,r_115_21_23,1,0,23,23,59
9,r_94_17_77,seq22,r_82_57_5,r_94_17_77,0.77,1,78,77,59
26,r_50_29_101,r_74_53_110,seq139,r_50_29_101,1,0,101,101,59
96,seq123,r_118_111_120,seq52,r_118_111_120,1,-1,119,120,59
57,seq10,seq125,r_110_66_39,r_110_66_39,0.98,5,44,39,59
22,r_119_145_172,r_121_100_131,seq78,r_121_100_131,0.99,2,133,131,59
28,r_118_111_120,seq123,seq80,r_118_111_120,0.94,0,120,120,59
1,r_62_126_138,r_71_43_147,seq124,r_62_126_138,0.67,-3,135,138,59
56,seq137,r_129_112_127,seq136,r_129_112_127,0.91,-28,99,127,59
7,r_45_87_62,r_1_96_129,seq19,r_45_87_62,0.98,0,62,62,59
43,r_75_20_10,r_118_111_120,seq91,r_75_20_10,0.99,0,10,10,59
27,r_134_13_45,r_76_27_170,seq93,r_134_13_45,0.94,-6,39,45,59
35,r_117_9_174,r_2_69_84,r_104_102_64,r_117_9_174,0.9,-81,93,174,59
24,r_109_86_31,seq68,seq0,r_109_86_31,0.55,0,31,31,59
23,r_138_72_133,seq31,r_71_43_147,r_71_43_147,0.64,15,162,147,59
40,r_31_49_16,r_53_108_89,r_118_141_23,r_53_108_89,0.97,0,89,89,60
30,r_97_83_105,seq148,r_110_143_54,r_97_83_105,0.67,1,106,105,60
20,r_91_65_12,seq44,seq105,r_91_65_12,0.98,0,12,12,60
9,r_77_132_154,r_144_129_85,r_5_24_124,r_77_132_154,1,0,154,154,60
14,r_39_115_72,r_47_127_182,seq30,r_39_115_72,1,1,73,72,60
43,r_3_75_159,r_20_90_138,seq9,r_20_90_138,0.99,0,138,138,60
86,seq95,r_102_82_112,r_135_146_120,r_102_82_112,0.99,27,139,112,60
43,r_3_75_159,seq9,seq130,r_3_75_159,0.95,0,159,159,60
83,seq73,r_88_137_71,seq46,r_88_137_71,0.99,0,71,71,60
18,r_56_61_70,seq124,r_7_109_75,r_56_61_70,0.76,23,93,70,60
19,r_100_8_18,r_35_114_155,seq59,r_35_114_155,0.99,-1,154,155,60
39,r_40_149_170,seq2,r_39_115_72,r_40_149_170,0.71,0,170,170,60
91,seq112,r_26_22_113,seq120,r_26_22_113,0.92,-61,52,113,60
97,seq124,seq131,r_7_109_75,r_7_109_75,1,6,81,75,60
5,r_10_104_188,seq32,r_136_51_166,r_136_51_166,0.74,22,188,166,60
46,r_33_122_83,seq93,r_88_137_71,r_33_122_83,0.59,1,84,83,60
80,seq67,r_77_132_154,r_144_129_85,r_144_129_85,0.47,41,126,85,60
69,seq42,r_136_51_166,r_20_90_138,r_20_90_138,0.61,28,166,138,60
45,r_128_18_157,seq17,r_100_8_18,r_128_18_157,0.71,0,157,157,60
8,r_53_108_89,r_7_109_75,r_31_49_16,r_31_49_16,0.75,5,21,16,60
66,seq32,r_10_104_188,r_71_89_164,r_71_89_164,0.75,23,187,164,60
10,r_5_24_124,seq43,r_77_132_154,r_77_132_154,0.92,6,160,154,60
26,r_118_141_23,r_84_63_24,seq111,r_118_141_23,0.8,0,23,23,60
67,seq34,r_97_83_105,r_84_63_24,r_84_63_24,0.77,58,82,24,60
38,r_45_138_32,r_60_28_67,r_142_92_45,r_45_138_32,1,13,45,32,60
3,r_116_14_160,seq148,r_79_16_29,r_116_14_160,0.54,0,160,160,60
10,r_5_24_124,r_106_81_177,seq43,r_5_24_124,0.49,0,124,124,60
90,seq111,r_56_61_70,r_118_141_23,r_56_61_70,1,0,70,70,60
8,r_53_108_89,r_31_49_16,seq148,r_53_108_89,1,0,89,89,60
0,r_84_63_24,r_118_141_23,r_107_69_193,r_84_63_24,0.87,-1,23,24,60
4,r_136_51_166,seq42,r_35_114_155,r_136_51_166,0.45,0,166,166,60
12,r_123_66_135,r_106_81_177,r_145_96_21,r_145_96_21,0.99,0,21,21,60
48,r_41_29_110,r_35_114_155,seq17,r_41_29_110,0.98,0,110,110,60
49,r_110_143_54,r_107_69_193,r_84_63_24,r_107_69_193,0.7,-6,187,193,60
12,r_123_66_135,r_145_96_21,seq93,r_123_66_135,0.96,3,138,135,60
13,r_26_22_113,r_86_36_4,seq73,r_26_22_113,0.99,0,113,113,60
1,r_142_92_45,r_97_83_105,r_45_138_32,r_142_92_45,1,0,45,45,60
89,seq105,seq72,r_91_65_12,r_91_65_12,1,1,13,12,60
0,r_84_63_24,r_107_69_193,r_110_143_54,r_110_143_54,0.99,76,130,54,60
36,r_145_96_21,r_123_66_135,seq85,r_123_66_135,0.98,1,136,135,60
41,r_107_69_193,r_116_14_160,r_84_63_24,r_84_63_24,0.61,2,26,24,60
27,r_88_137_71,seq73,seq9,r_88_137_71,1,0,71,71,60
7,r_113_27_41,seq95,r_80_37_126,r_113_27_41,1,0,41,41,60
42,r_135_146_120,r_60_28_67,r_142_92_45,r_135_146_120,0.79,-75,45,120,60
49,r_110_143_54,seq21,r_107_69_193,r_110_143_54,1,0,54,54,60
11,r_60_28_67,r_142_92_45,r_128_18_157,r_60_28_67,0.83,0,67,67,60
2,r_15_121_76,seq42,seq58,r_15_121_76,0.98,0,76,76,60
41,r_107_69_193,r_84_63_24,r_110_143_54,r_110_143_54,0.99,58,112,54,60
47,r_71_89_164,seq23,seq32,r_71_89_164,0.58,0,164,164,60
40,r_31_49_16,r_60_28_67,r_53_108_89,r_31_49_16,0.98,0,16,16,60
84,seq85,r_106_81_177,r_145_96_21,r_145_96_21,1,0,21,21,60
18,r_56_61_70,seq111,seq124,r_56_61_70,0.93,0,70,70,60
24,r_144_129_85,seq58,seq67,r_144_129_85,0.98,3,88,85,60
25,r_47_127_182,r_39_115_72,r_50_103_178,r_39_115_72,1,5,77,72,60
33,r_102_82_112,seq19,r_135_146_120,r_102_82_112,0.99,2,114,112,60
85,seq93,r_94_78_26,r_123_66_135,r_123_66_135,0.87,8,143,135,60
50,seq1,seq72,r_50_103_178,r_50_103_178,0.74,0,178,178,60
6,r_86_36_4,r_26_22_113,seq112,r_26_22_113,1,0,113,113,60
65,seq30,r_50_103_178,r_39_115_72,r_39_115_72,1,-4,68,72,60
42,r_135_146_120,r_142_92_45,r_102_82_112,r_135_146_120,0.96,0,120,120,60
36,r_145_96_21,r_60_28_67,r_123_66_135,r_145_96_21,0.99,0,21,21,60
17,r_6_54_163,seq134,r_123_66_135,r_6_54_163,0.6,0,163,163,60
25,r_47_127_182,r_50_103_178,r_116_14_160,r_50_103_178,0.5,12,190,178,60
32,r_79_16_29,seq67,seq25,r_79_16_29,0.99,0,29,29,60
7,r_113_27_41,r_80_37_126,seq99,r_80_37_126,0.64,-45,81,126,60
9,r_77_132_154,seq67,r_144_129_85,r_144_129_85,0.98,2,87,85,60
31,r_35_114_155,r_100_8_18,r_144_129_85,r_100_8_18,0.6,137,155,18,60
16,r_94_78_26,seq23,seq93,r_94_78_26,0.65,9,35,26,60
28,r_87_4_169,seq52,r_145_96_21,r_87_4_169,0.51,0,169,169,60
44,r_20_90_138,r_3_75_159,seq42,r_20_90_138,0.98,0,138,138,60
11,r_60_28_67,r_101_13_125,r_142_92_45,r_142_92_45,0.59,7,52,45,60
23,r_101_13_125,seq43,seq2,r_101_13_125,0.65,-1,124,125,60
79,seq64,r_80_37_126,r_7_109_75,r_7_109_75,0.7,50,125,75,60
31,r_35_114_155,seq59,r_100_8_18,r_100_8_18,1,1,19,18,60
42,r_41_56_62,r_2_58_3,seq136,r_41_56_62,1,0,62,62,61
30,r_133_50_172,r_104_91_186,seq27,r_104_91_186,0.55,-89,97,186,61
44,r_117_130_28,r_5_43_118,r_30_107_76,r_117_130_28,0.98,90,118,28,61
77,seq57,r_34_25_51,seq53,r_34_25_51,0.85,-17,34,51,61
42,r_41_56_62,r_51_124_59,r_2_58_3,r_41_56_62,0.47,-28,34,62,61
36,r_100_12_85,r_81_64_108,r_30_107_76,r_100_12_85,0.95,0,85,85,61
53,seq134,seq39,r_99_115_154,r_99_115_154,0.98,3,157,154,61
31,r_5_43_118,r_30_107_76,seq49,r_5_43_118,0.9,0,118,118,61
78,seq60,r_89_19_135,seq27,r_89_19_135,0.93,0,135,135,61
59,seq15,r_142_119_189,r_46_95_117,r_46_95_117,0.99,-1,116,117,61
10,r_141_69_80,r_144_126_91,seq35,r_141_69_80,1,0,80,80,61
23,r_105_26_145,seq77,r_110_123_88,r_105_26_145,0.95,0,145,145,61
21,r_113_22_149,seq146,r_86_87_22,r_113_22_149,0.93,0,149,149,61
43,r_140_52_26,r_141_69_80,seq83,r_140_52_26,1,1,27,26,61
1,r_11_93_77,r_104_91_186,r_80_84_49,r_11_93_77,0.98,0,77,77,61
28,r_34_25_51,seq57,seq53,r_34_25_51,0.72,0,51,51,61
5,r_144_126_91,r_5_43_118,seq3,r_144_126_91,1,1,92,91,61
46,r_46_95_117,seq103,seq15,r_46_95_117,1,0,117,117,61
13,r_55_31_47,seq53,r_145_71_11,r_55_31_47,1,1,48,47,61
45,r_78_76_168,r_6_66_165,seq67,r_6_66_165,0.87,0,165,165,61
52,seq4,r_105_26_145,r_80_84_49,r_105_26_145,0.77,-18,127,145,61
56,seq9,seq134,r_86_87_22,r_86_87_22,1,4,26,22,61
8,r_97_29_69,r_51_124_59,r_2_58_3,r_97_29_69,0.59,-10,59,69,61
95,seq111,r_104_91_186,r_97_29_69,r_97_29_69,0.95,28,97,69,61
8,r_97_29_69,r_2_58_3,seq111,r_97_29_69,0.51,1,70,69,61
39,r_99_115_154,seq77,seq134,r_99_115_154,0.53,1,155,154,61
31,r_5_43_118,r_144_126_91,r_30_107_76,r_5_43_118,0.54,-26,92,118,61
4,r_108_28_182,r_147_88_38,r_131_62_50,r_108_28_182,0.89,0,182,182,61
26,r_142_119_189,seq15,r_63_85_169,r_63_85_169,0.68,3,172,169,61
72,seq48,r_30_107_76,seq35,r_30_107_76,0.99,0,76,76,61
22,r_16_73_73,seq103,r_38_1_114,r_38_1_114,1,18,132,114,61
48,r_75_102_36,seq44,r_145_71_11,r_145_71_11,0.9,17,28,11,61
9,r_81_64_108,seq134,r_116_72_109,r_81_64_108,0.98,-1,107,108,61
78,seq60,r_38_1_114,r_89_19_135,r_38_1_114,0.86,0,114,114,61
0,r_148_70_150,r_105_26_145,r_129_114_20,r_148_70_150,0.72,-3,147,150,61
11,r_143_94_121,seq136,seq54,r_143_94_121,0.78,0,121,121,61
72,seq48,seq35,r_110_123_88,r_110_123_88,0.61,20,108,88,61
98,seq136,r_143_94_121,r_41_56_62,r_41_56_62,0.97,59,121,62,61
17,r_89_19_135,r_63_85_169,seq53,r_63_85_169,1,1,170,169,61
82,seq68,r_108_28_182,r_147_88_38,r_147_88_38,1,6,44,38,61
33,r_63_85_169,r_89_19_135,r_142_119_189,r_63_85_169,0.92,0,169,169,61
19,r_86_87_22,seq112,seq9,r_86_87_22,0.97,0,22,22,61
99,seq127,seq77,r_138_18_132,r_138_18_132,0.97,22,154,132,61
6,r_23_120_16,r_133_50_172,r_97_29_69,r_133_50_172,0.86,0,172,172,61
49,r_37_32_12,r_131_62_50,seq7,r_37_32_12,0.97,0,12,12,61
27,r_110_123_88,seq47,seq48,r_110_123_88,0.88,0,88,88,61
90,seq96,r_0_33_19,r_14_139_71,r_0_33_19,0.92,3,22,19,61
30,r_133_50_172,seq27,r_46_95_117,r_133_50_172,0.67,0,172,172,61
16,r_80_84_49,seq13,r_11_93_77,r_11_93_77,0.97,-1,76,77,61
90,seq96,r_14_139_71,seq103,r_14_139_71,0.97,-5,66,71,61
39,r_99_115_154,r_23_120_16,seq77,r_23_120_16,0.89,0,16,16,61
12,r_129_114_20,r_108_28_182,seq49,r_129_114_20,1,2,22,20,61
2,r_116_72_109,seq54,r_81_64_108,r_116_72_109,0.97,0,109,109,61
57,seq10,r_38_1_114,seq7,r_38_1_114,0.98,-67,47,114,61
40,r_104_91_186,r_133_50_172,r_97_29_69,r_97_29_69,0.98,103,172,69,61
87,seq83,seq49,r_140_52_26,r_140_52_26,0.95,13,39,26,61
18,r_40_121_120,r_105_26_145,seq3,r_40_121_120,1,0,120,120,61
29,r_6_66_165,seq67,r_78_76_168,r_6_66_165,0.31,-89,76,165,61
24,r_135_24_183,seq17,r_63_85_169,r_63_85_169,0.76,14,183,169,61
25,r_14_139_71,seq96,r_80_84_49,r_14_139_71,1,0,71,71,61
33,r_63_85_169,seq53,r_89_19_135,r_89_19_135,0.88,2,137,135,61
48,r_75_102_36,r_145_71_11,r_6_66_165,r_6_66_165,0.65,1,166,165,61
3,r_51_124_59,r_97_29_69,seq146,r_51_124_59,1,0,59,59,61
52,seq4,r_14_139_71,r_105_26_145,r_105_26_145,0.47,-28,117,145,61
6,r_23_120_16,r_37_32_12,r_133_50_172,r_23_120_16,0.38,95,111,16,61
65,seq35,seq101,r_141_69_80,r_141_69_80,1,8,88,80,61
61,seq146,r_113_22_149,r_51_124_59,r_51_124_59,0.93,84,143,59,61
32,r_30_107_76,seq48,r_117_130_28,r_30_107_76,1,0,76,76,61
38,r_138_18_132,seq61,seq127,r_138_18_132,0.48,1,133,132,61
73,seq49,seq83,r_129_114_20,r_129_114_20,0.89,23,43,20,61
75,seq54,r_116_72_109,r_20_98_198,r_116_72_109,0.52,0,109,109,61
44,r_117_130_28,seq127,r_5_43_118,r_117_130_28,0.97,1,29,28,61
81,seq67,r_6_66_165,r_78_76_168,r_6_66_165,0.94,-26,139,165,61
9,r_81_64_108,r_100_12_85,seq134,r_100_12_85,0.89,0,85,85,61
6,r_23_120_16,r_99_115_154,r_37_32_12,r_23_120_16,0.97,0,16,16,61
34,r_21_125_32,r_110_123_88,seq92,r_21_125_32,0.97,0,32,32,61
26,r_142_119_189,r_63_85_169,r_30_107_76,r_142_119_189,0.57,1,190,189,61
29,r_6_66_165,r_78_76_168,r_75_102_36,r_6_66_165,1,0,165,165,61
22,r_16_73_73,r_143_94_121,seq103,r_16_73_73,1,0,73,73,61
33,r_63_85_169,r_142_119_189,r_135_24_183,r_142_119_189,0.51,1,190,189,61
7,r_131_62_50,seq48,seq47,r_131_62_50,0.98,0,50,50,61
73,seq49,r_129_114_20,r_5_43_118,r_5_43_118,1,0,118,118,61
40,r_104_91_186,r_97_29_69,r_131_62_50,r_97_29_69,0.72,117,186,69,61
4,r_108_28_182,seq68,seq137,r_108_28_182,0.43,-149,33,182,61
66,seq36,seq79,r_145_71_11,r_145_71_11,0.68,1,12,11,61
75,seq54,r_20_98_198,r_143_94_121,r_143_94_121,0.88,-1,120,121,61
23,r_105_26_145,r_40_121_120,seq77,r_40_121_120,0.86,0,120,120,61
10,r_141_69_80,r_140_52_26,r_144_126_91,r_140_52_26,1,1,27,26,61
35,r_38_1_114,seq60,r_16_73_73,r_38_1_114,1,0,114,114,61
97,seq118,r_51_124_59,r_2_58_3,r_51_124_59,1,-25,34,59,61
16,r_80_84_49,seq112,seq13,r_80_84_49,0.86,0,49,49,61
37,r_0_33_19,seq96,seq128,r_0_33_19,1,-1,18,19,61
14,r_147_88_38,seq79,seq68,r_147_88_38,0.9,1,39,38,61
36,r_67_43_72,r_50_101_106,r_29_105_107,r_67_43_72,0.97,0,72,72,62
19,r_88_26_36,r_25_113_73,seq1,r_88_26_36,0.99,0,36,36,62
92,seq103,seq114,r_19_73_69,r_19_73_69,0.56,38,107,69,62
53,seq134,seq131,r_29_105_107,r_29_105_107,1,45,152,107,62
43,r_41_75_58,r_140_133_188,seq61,r_41_75_58,1,5,63,58,62
37,r_139_34_168,seq35,r_33_16_91,r_33_16_91,0.81,77,168,91,62
55,seq8,r_118_58_192,r_136_76_121,r_136_76_121,0.86,15,136,121,62
21,r_66_20_198,r_62_65_119,r_132_13_31,r_62_65_119,0.51,0,119,119,62
39,r_121_21_97,seq100,seq99,r_121_21_97,0.96,0,97,97,62
97,seq119,seq146,r_50_101_106,r_50_101_106,1,6,112,106,62
28,r_4_87_51,r_19_73_69,r_96_124_126,r_4_87_51,0.95,0,51,51,62
5,r_144_40_159,seq0,seq137,r_144_40_159,0.87,1,160,159,62
42,r_80_86_115,seq117,r_4_87_51,r_80_86_115,0.97,3,118,115,62
45,r_56_48_59,seq28,seq35,r_56_48_59,1,1,60,59,62
33,r_77_72_171,r_116_74_114,seq28,r_77_72_171,0.75,0,171,171,62
34,r_95_18_63,seq89,seq55,r_95_18_63,0.99,0,63,63,62
95,seq114,seq103,r_19_73_69,r_19_73_69,0.87,-1,68,69,62
66,seq145,seq137,r_81_5_86,r_81_5_86,1,2,88,86,62
16,r_106_148_30,r_118_58_192,seq24,r_106_148_30,0.99,0,30,30,62
0,r_49_138_33,seq44,seq91,r_49_138_33,1,0,33,33,62
38,r_33_16_91,seq61,r_139_34_168,r_139_34_168,0.94,0,168,168,62
31,r_140_133_188,seq55,seq63,r_140_133_188,0.39,1,189,188,62
3,r_68_122_71,seq30,r_45_10_132,r_68_122_71,0.96,0,71,71,62
10,r_2_69_147,r_90_39_149,r_31_6_29,r_2_69_147,0.89,1,148,147,62
26,r_25_113_73,seq64,seq123,r_25_113_73,1,0,73,73,62
72,seq54,r_23_120_24,r_22_3_40,r_22_3_40,0.5,20,60,40,62
4,r_128_93_123,r_96_124_126,r_140_133_188,r_128_93_123,0.62,25,148,123,62
8,r_31_6_29,r_141_9_53,seq64,r_31_6_29,0.99,1,30,29,62
63,seq30,r_68_122_71,r_106_148_30,r_68_122_71,0.57,0,71,71,62
73,seq55,r_140_133_188,r_95_18_63,r_95_18_63,1,2,65,63,62
20,r_29_105_107,seq52,seq24,r_29_105_107,1,0,107,107,62
13,r_136_76_121,r_94_71_138,seq8,r_136_76_121,0.67,2,123,121,62
98,seq123,seq17,r_25_113_73,r_25_113_73,1,33,106,73,62
48,r_23_120_24,seq84,seq44,r_23_120_24,0.79,5,29,24,62
15,r_45_10_132,seq63,r_68_122_71,r_68_122_71,0.97,4,75,71,62
49,r_62_65_119,r_66_20_198,r_115_126_83,r_66_20_198,0.96,-79,119,198,62
6,r_116_74_114,seq57,seq64,r_116_74_114,0.48,-2,112,114,62
62,seq28,r_94_71_138,seq129,r_94_71_138,0.89,1,139,138,62
85,seq89,r_95_18_63,seq131,r_95_18_63,0.54,0,63,63,62
41,r_19_73_69,seq91,seq114,r_19_73_69,0.48,0,69,69,62
72,seq54,r_22_3_40,r_23_120_24,r_23_120_24,0.44,95,119,24,62
61,seq24,r_37_135_60,r_106_148_30,r_37_135_60,0.91,-2,58,60,62
27,r_37_135_60,seq24,r_11_38_9,r_37_135_60,1,1,61,60,62
1,r_141_9_53,seq146,seq0,r_141_9_53,0.88,0,53,53,62
2,r_90_39_149,r_2_69_147,r_11_38_9,r_11_38_9,0.57,143,152,9,62
49,r_62_65_119,r_115_126_83,r_66_20_198,r_115_126_83,0.63,-38,45,83,62
40,r_81_5_86,r_77_72_171,seq145,r_81_5_86,0.96,1,87,86,62
18,r_27_46_150,seq91,r_68_122_71,r_27_46_150,0.91,0,150,150,62
29,r_142_107_50,seq83,seq64,r_142_107_50,0.67,24,74,50,62
25,r_32_78_102,seq60,r_68_122_71,r_32_78_102,0.96,0,102,102,62
35,r_147_12_5,seq97,seq1,r_147_12_5,0.36,133,138,5,62
25,r_32_78_102,seq114,seq60,r_32_78_102,0.65,-18,84,102,62
46,r_132_13_31,r_144_40_159,seq52,r_132_13_31,0.88,0,31,31,62
33,r_77_72_171,r_81_5_86,r_116_74_114,r_81_5_86,1,0,86,86,62
12,r_70_47_39,r_37_135_60,seq99,r_70_47_39,0.82,0,39,39,62
36,r_67_43_72,r_29_105_107,r_92_111_87,r_29_105_107,0.82,-14,93,107,62
29,r_142_107_50,seq64,r_115_126_83,r_115_126_83,0.76,35,118,83,62
15,r_45_10_132,r_68_122_71,seq85,r_45_10_132,0.93,0,132,132,62
65,seq36,r_118_58_192,r_92_111_87,r_92_111_87,0.96,13,100,87,62
32,r_112_14_85,r_90_39_149,seq131,r_112_14_85,1,-2,83,85,62
38,r_33_16_91,seq102,seq61,r_33_16_91,0.94,0,91,91,62
52,seq131,seq134,r_112_14_85,r_112_14_85,1,4,89,85,62
51,seq1,seq82,r_88_26_36,r_88_26_36,1,5,41,36,62
75,seq60,r_140_133_188,r_41_75_58,r_41_75_58,1,128,186,58,62
78,seq64,r_31_6_29,r_116_74_114,r_116_74_114,0.9,-10,104,114,62
17,r_96_124_126,r_128_93_123,seq137,r_96_124_126,0.98,0,126,126,62
34,r_95_18_63,r_22_3_40,seq89,r_22_3_40,0.99,0,40,40,62
9,r_94_71_138,r_136_76_121,seq28,r_94_71_138,0.44,-15,123,138,62
3,r_68_122_71,r_45_10_132,r_32_78_102,r_68_122_71,0.77,32,103,71,62
41,r_19_73_69,r_4_87_51,seq91,r_4_87_51,0.94,0,51,51,62
28,r_4_87_51,r_96_124_126,r_80_86_115,r_4_87_51,0.85,69,120,51,62
22,r_92_111_87,seq129,r_67_43_72,r_67_43_72,0.81,22,94,72,62
7,r_130_110_100,r_136_76_121,seq117,r_130_110_100,1,0,100,100,62
44,r_50_101_106,seq61,seq119,r_50_101_106,0.96,0,106,106,62
9,r_94_71_138,seq28,seq35,r_94_71_138,0.76,1,139,138,62
30,r_22_3_40,r_95_18_63,seq44,r_22_3_40,0.99,1,41,40,62
2,r_90_39_149,r_11_38_9,seq149,r_90_39_149,0.5,14,163,149,62
84,seq85,seq15,r_45_10_132,r_45_10_132,0.95,26,158,132,62
30,r_72_143_180,seq89,r_62_43_131,r_62_43_131,0.86,49,180,131,63
36,r_33_147_102,r_142_104_88,r_136_122_23,r_136_122_23,0.53,66,89,23,63
37,r_112_139_132,r_119_141_55,r_7_0_41,r_112_139_132,0.97,-77,55,132,63
43,r_124_91_194,seq100,r_136_122_23,r_136_122_23,0.75,43,66,23,63
54,seq5,seq9,r_86_99_66,r_86_99_66,1,0,66,66,63
3,r_113_111_172,r_31_137_37,r_44_37_79,r_44_37_79,0.95,94,173,79,63
3,r_113_111_172,r_95_83_22,r_31_137_37,r_113_111_172,0.89,-150,22,172,63
55,seq9,r_116_4_94,r_8_65_171,r_116_4_94,1,5,99,94,63
71,seq53,r_123_125_184,seq105,r_123_125_184,0.41,-61,123,184,63
21,r_110_131_145,r_77_11_91,seq120,r_77_11_91,0.98,-8,83,91,63
39,r_145_58_124,seq20,seq63,r_145_58_124,1,0,124,124,63
1,r_108_133_148,seq21,r_28_129_191,r_108_133_148,0.67,0,148,148,63
5,r_62_43_131,r_8_65_171,r_44_37_79,r_62_43_131,0.99,0,131,131,63
32,r_136_122_23,r_142_104_88,r_82_34_82,r_136_122_23,1,66,89,23,63
45,r_52_56_53,r_23_146_8,seq73,r_52_56_53,0.99,0,53,53,63
32,r_136_122_23,r_82_34_82,seq120,r_136_122_23,0.54,160,183,23,63
24,r_30_42_52,r_80_121_182,r_82_34_82,r_82_34_82,1,101,183,82,63
19,r_90_13_141,seq89,r_23_146_8,r_90_13_141,0.82,0,141,141,63
78,seq70,r_145_58_124,r_59_29_17,r_59_29_17,0.89,0,17,17,63
22,r_142_104_88,r_45_66_135,r_14_16_48,r_45_66_135,0.77,-3,132,135,63
14,r_31_137_37,seq51,r_113_111_172,r_31_137_37,0.99,0,37,37,63
67,seq47,seq118,r_82_34_82,r_82_34_82,1,1,83,82,63
89,seq100,r_110_131_145,seq120,r_110_131_145,0.93,-23,122,145,63
10,r_24_69_122,seq3,r_96_114_2,r_24_69_122,0.8,0,122,122,63
7,r_95_83_22,r_113_111_172,seq20,r_95_83_22,0.95,0,22,22,63
72,seq54,r_86_99_66,seq132,r_86_99_66,1,0,66,66,63
83,seq84,r_119_141_55,seq2,r_119_141_55,1,0,55,55,63
4,r_126_74_9,r_15_107_146,r_93_6_90,r_93_6_90,1,60,150,90,63
20,r_8_65_171,r_33_147_102,r_96_114_2,r_8_65_171,0.96,0,171,171,63
6,r_45_66_135,r_59_29_17,seq101,r_59_29_17,0.83,0,17,17,63
0,r_116_4_94,seq9,r_119_141_55,r_116_4_94,1,1,95,94,63
73,seq55,r_19_18_142,r_77_11_91,r_77_11_91,0.51,51,142,91,63
20,r_8_65_171,r_62_43_131,r_33_147_102,r_33_147_102,0.63,25,127,102,63
13,r_44_37_79,seq85,seq21,r_44_37_79,0.96,0,79,79,63
98,seq148,seq36,r_112_139_132,r_112_139_132,1,5,137,132,63
15,r_80_121_182,r_30_42_52,r_15_107_146,r_30_42_52,0.13,131,183,52,63
48,r_94_39_139,seq105,seq98,r_94_39_139,0.79,0,139,139,63
13,r_44_37_79,seq21,r_62_43_131,r_62_43_131,1,8,139,131,63
47,r_14_16_48,r_15_107_146,seq101,r_14_16_48,1,0,48,48,63
21,r_110_131_145,seq120,seq9,r_110_131_145,1,0,145,145,63
90,seq101,seq50,r_14_16_48,r_14_16_48,1,0,48,48,63
79,seq73,seq46,r_52_56_53,r_52_56_53,1,1,54,53,63
70,seq51,r_31_137_37,seq63,r_31_137_37,0.99,-10,27,37,63
33,r_59_29_17,r_45_66_135,seq70,r_59_29_17,1,0,17,17,63
27,r_77_11_91,r_110_131_145,seq55,r_77_11_91,1,0,91,91,63
31,r_7_0_41,r_128_57_198,r_112_139_132,r_7_0_41,0.99,0,41,41,63
6,r_45_66_135,r_142_104_88,r_23_146_8,r_45_66_135,1,0,135,135,63
24,r_30_42_52,r_22_71_160,r_80_121_182,r_30_42_52,0.51,-28,24,52,63
22,r_142_104_88,r_136_122_23,r_45_66_135,r_142_104_88,1,1,89,88,63
40,r_88_27_57,r_110_131_145,seq89,r_88_27_57,0.71,0,57,57,63
2,r_68_48_77,r_67_87_162,seq3,r_68_48_77,1,0,77,77,63
45,r_52_56_53,r_93_6_90,r_23_146_8,r_52_56_53,0.51,-17,36,53,63
18,r_15_107_146,r_126_74_9,r_134_109_30,r_134_109_30,0.76,117,147,30,63
29,r_93_6_90,r_40_81_136,r_15_107_146,r_93_6_90,0.97,1,91,90,63
25,r_135_25_86,seq102,seq78,r_135_25_86,0.84,2,88,86,63
6,r_45_66_135,seq101,r_142_104_88,r_142_104_88,0.62,0,88,88,63
61,seq21,seq97,r_44_37_79,r_44_37_79,1,0,79,79,63
38,r_22_71_160,r_30_42_52,seq100,r_22_71_160,0.78,3,163,160,63
52,seq3,r_24_69_122,r_68_48_77,r_68_48_77,1,45,122,77,63
77,seq64,r_8_65_171,seq79,r_8_65_171,0.65,-2,169,171,63
34,r_40_81_136,r_93_6_90,r_44_37_79,r_40_81_136,0.84,-46,90,136,63
36,r_33_147_102,r_136_122_23,r_8_65_171,r_33_147_102,0.79,0,102,102,63
58,seq130,r_136_122_23,seq103,r_136_122_23,0.89,-3,20,23,63
81,seq78,seq46,r_135_25_86,r_135_25_86,1,0,86,86,63
17,r_67_87_162,r_68_48_77,r_123_125_184,r_68_48_77,1,-10,67,77,63
26,r_134_109_30,r_135_25_86,r_136_122_23,r_134_109_30,1,3,33,30,63
26,r_134_109_30,r_136_122_23,r_15_107_146,r_136_122_23,0.41,125,148,23,63
96,seq118,r_22_71_160,r_82_34_82,r_82_34_82,1,45,127,82,63
16,r_23_146_8,seq97,r_90_13_141,r_90_13_141,1,0,141,141,63
31,r_7_0_41,r_112_139_132,seq84,r_112_139_132,1,-1,131,132,63
37,r_112_139_132,r_7_0_41,seq148,r_112_139_132,1,0,132,132,63
49,r_86_99_66,seq54,seq5,r_86_99_66,1,0,66,66,63
16,r_23_146_8,r_52_56_53,seq97,r_52_56_53,1,-3,50,53,63
32,r_136_122_23,seq130,r_142_104_88,r_136_122_23,1,0,23,23,63
23,r_82_34_82,r_72_143_180,seq47,r_82_34_82,1,0,82,82,63
17,r_67_87_162,r_123_125_184,r_52_56_53,r_123_125_184,0.49,-22,162,184,63
41,r_119_141_55,seq84,seq117,r_119_141_55,1,0,55,55,63
22,r_142_104_88,r_33_147_102,r_136_122_23,r_136_122_23,1,0,23,23,63
35,r_38_144_96,r_126_74_9,seq85,r_38_144_96,0.47,4,100,96,63
12,r_96_114_2,seq35,r_24_69_122,r_96_114_2,0.53,113,115,2,63
36,r_33_147_102,r_8_65_171,seq79,r_8_65_171,1,0,171,171,63
29,r_93_6_90,r_15_107_146,r_19_18_142,r_19_18_142,0.64,8,150,142,63
84,seq85,r_44_37_79,seq60,r_44_37_79,0.99,0,79,79,63
51,seq130,r_52_38_110,r_125_131_69,r_125_131_69,0.98,25,94,69,64
92,seq99,r_100_132_188,r_97_43_145,r_97_43_145,0.71,42,187,145,64
14,r_125_131_69,seq84,seq130,r_125_131_69,0.74,1,70,69,64
53,seq6,r_1_30_60,seq148,r_1_30_60,1,0,60,60,64
43,r_64_47_111,seq126,r_15_119_91,r_64_47_111,0.93,0,111,111,64
16,r_44_20_43,seq74,r_19_149_138,r_44_20_43,1,0,43,43,64
37,r_81_63_174,r_69_106_133,r_125_131_69,r_125_131_69,1,69,138,69,64
3,r_97_43_145,r_66_94_52,seq53,r_97_43_145,0.97,0,145,145,64
32,r_33_121_45,seq12,r_59_93_186,r_33_121_45,1,0,45,45,64
55,seq138,r_110_39_195,r_10_78_49,r_10_78_49,1,130,179,49,64
39,r_40_26_124,seq84,seq0,r_40_26_124,0.53,1,125,124,64
1,r_68_109_78,seq12,r_7_2_8,r_68_109_78,1,0,78,78,64
46,r_128_32_187,seq133,r_125_131_69,r_128_32_187,0.41,0,187,187,64
47,r_17_147_161,r_40_26_124,seq62,r_17_147_161,0.98,0,161,161,64
32,r_33_121_45,r_59_93_186,r_27_71_70,r_33_121_45,0.92,93,138,45,64
7,r_144_98_176,r_122_45_63,seq75,r_144_98_176,0.77,0,176,176,64
27,r_129_92_149,seq48,r_137_60_53,r_137_60_53,1,1,54,53,64
19,r_69_106_133,r_81_63_174,seq88,r_69_106_133,0.46,0,133,133,64
27,r_129_92_149,r_137_60_53,seq75,r_129_92_149,0.93,0,149,149,64
78,seq62,seq36,r_17_147_161,r_17_147_161,0.97,0,161,161,64
31,r_19_149_138,seq148,seq51,r_19_149_138,0.83,0,138,138,64
41,r_100_132_188,seq99,r_144_98_176,r_100_132_188,0.45,0,188,188,64
67,seq41,r_91_116_7,r_66_94_52,r_66_94_52,0.89,52,104,52,64
3,r_97_43_145,r_122_45_63,r_66_94_52,r_97_43_145,0.8,-79,66,145,64
33,r_136_82_109,r_4_55_20,seq102,r_136_82_109,0.6,0,109,109,64
10,r_105_77_160,seq58,seq133,r_105_77_160,0.64,0,160,160,64
90,seq95,r_15_119_91,r_4_55_20,r_15_119_91,0.52,-1,90,91,64
86,seq84,r_40_26_124,r_66_94_52,r_66_94_52,1,0,52,52,64
48,r_137_60_53,seq36,r_129_92_149,r_137_60_53,1,2,55,53,64
8,r_4_55_20,seq95,r_124_24_120,r_124_24_120,0.99,18,138,120,64
29,r_7_2_8,seq62,r_68_109_78,r_68_109_78,0.95,2,80,78,64
72,seq51,r_27_71_70,seq115,r_27_71_70,0.87,3,73,70,64
16,r_44_20_43,r_19_149_138,seq148,r_19_149_138,1,-1,137,138,64
78,seq62,r_143_37_94,seq36,r_143_37_94,0.96,0,94,94,64
0,r_124_24_120,seq107,r_4_55_20,r_124_24_120,0.96,0,120,120,64
63,seq133,r_128_32_187,r_105_77_160,r_105_77_160,0.63,27,187,160,64
73,seq53,r_59_93_186,r_33_121_45,r_33_121_45,1,90,135,45,64
11,r_27_71_70,seq51,r_33_121_45,r_27_71_70,1,0,70,70,64
20,r_34_114_136,r_3_104_199,r_87_46_44,r_87_46_44,0.6,21,65,44,64
30,r_23_9_25,r_143_37_94,seq146,r_23_9_25,1,1,26,25,64
13,r_143_37_94,seq62,r_4_55_20,r_143_37_94,0.99,0,94,94,64
42,r_10_78_49,seq70,r_110_39_195,r_10_78_49,0.98,0,49,49,64
15,r_56_139_153,seq102,r_125_131_69,r_56_139_153,0.61,0,153,153,64
6,r_86_76_165,r_67_65_181,seq42,r_67_65_181,0.52,-16,165,181,64
4,r_66_94_52,r_69_106_133,seq84,r_66_94_52,1,0,52,52,64
45,r_59_93_186,seq53,r_33_121_45,r_33_121_45,1,5,50,45,64
37,r_81_63_174,r_125_131_69,r_67_65_181,r_81_63_174,0.99,1,175,174,64
68,seq42,r_33_121_45,r_86_76_165,r_86_76_165,0.72,2,167,165,64
87,seq88,seq22,r_69_106_133,r_69_106_133,0.5,0,133,133,64
67,seq41,r_17_147_161,r_91_116_7,r_91_116_7,0.46,8,15,7,64
47,r_17_147_161,seq0,r_40_26_124,r_17_147_161,0.25,-23,138,161,64
40,r_118_101_67,seq96,r_14_73_3,r_118_101_67,1,0,67,67,64
18,r_21_31_73,seq79,seq42,r_21_31_73,0.87,0,73,73,64
24,r_67_65_181,r_86_76_165,r_18_29_118,r_18_29_118,0.69,44,162,118,64
25,r_87_46_44,seq72,seq28,r_87_46_44,1,0,44,44,64
2,r_145_11_30,r_64_47_111,seq102,r_145_11_30,0.97,0,30,30,64
33,r_136_82_109,r_15_119_91,r_4_55_20,r_136_82_109,0.77,-18,91,109,64
48,r_137_60_53,r_129_92_149,seq123,r_129_92_149,0.96,0,149,149,64
50,seq0,r_17_147_161,r_40_26_124,r_17_147_161,0.57,-20,141,161,64
53,seq6,seq148,r_52_38_110,r_52_38_110,0.68,-1,109,110,64
20,r_34_114_136,r_87_46_44,r_14_73_3,r_34_114_136,1,0,136,136,64
68,seq42,r_59_93_186,r_33_121_45,r_33_121_45,1,94,139,45,64
42,r_10_78_49,r_110_39_195,seq138,r_10_78_49,0.59,131,180,49,64
38,r_141_16_108,seq58,r_67_65_181,r_141_16_108,0.99,0,108,108,64
77,seq61,r_52_38_110,r_125_131_69,r_125_131_69,0.97,36,105,69,64
45,r_59_93_186,r_33_121_45,seq58,r_59_93_186,0.82,1,187,186,64
17,r_1_30_60,seq6,r_137_60_53,r_1_30_60,1,0,60,60,64
9,r_15_119_91,r_17_147_161,r_64_47_111,r_15_119_91,0.85,18,109,91,64
26,r_85_108_33,seq115,seq79,r_85_108_33,0.41,94,127,33,64
79,seq70,r_10_78_49,seq72,r_10_78_49,1,0,49,49,64
28,r_122_45_63,r_97_43_145,seq96,r_122_45_63,0.94,3,66,63,64
8,r_4_55_20,r_52_38_110,seq95,r_4_55_20,1,0,20,20,64
49,r_18_29_118,seq90,r_67_65_181,r_18_29_118,0.99,0,118,118,64
7,r_144_98_176,r_118_101_67,r_122_45_63,r_144_98_176,0.93,-113,63,176,64
44,r_80_13_148,seq75,seq54,r_80_13_148,0.97,0,148,148,64
23,r_52_38_110,seq61,seq6,r_52_38_110,0.96,1,111,110,64
26,r_85_108_33,seq42,seq115,r_85_108_33,0.95,-1,32,33,64
5,r_91_116_7,seq96,seq41,r_91_116_7,0.42,29,36,7,64
12,r_112_120_130,seq142,r_68_109_78,r_112_120_130,0.5,0,130,130,64
93,seq101,r_76_64_76,seq144,r_76_64_76,0.98,0,76,76,65
30,r_106_110_65,seq61,seq128,r_106_110_65,1,0,65,65,65
2,r_30_53_66,r_81_63_18,seq79,r_30_53_66,0.98,0,66,66,65
14,r_89_7_139,seq92,r_106_110_65,r_89_7_139,0.96,0,139,139,65
43,r_54_28_130,seq56,seq22,r_54_28_130,0.95,0,130,130,65
22,r_93_133_52,r_66_50_184,seq129,r_93_133_52,1,0,52,52,65
36,r_81_63_18,r_11_78_91,r_30_53_66,r_81_63_18,0.95,0,18,18,65
81,seq69,r_66_50_184,r_102_16_120,r_102_16_120,0.99,-3,117,120,65
37,r_13_124_166,seq34,seq84,r_13_124_166,0.68,0,166,166,65
28,r_138_40_74,r_66_50_184,r_62_12_172,r_138_40_74,1,0,74,74,65
26,r_0_75_14,seq69,r_86_33_158,r_0_75_14,0.97,-1,13,14,65
55,seq8,r_27_14_186,r_113_100_183,r_113_100_183,0.55,-9,174,183,65
86,seq79,seq143,r_30_53_66,r_30_53_66,1,7,73,66,65
1,r_137_121_69,seq77,r_43_91_177,r_137_121_69,1,0,69,69,65
5,r_131_60_185,r_29_99_85,r_120_88_6,r_29_99_85,0.97,1,86,85,65
46,r_102_16_120,r_54_28_130,seq69,r_102_16_120,0.95,2,122,120,65
81,seq69,r_138_40_74,r_66_50_184,r_138_40_74,0.85,-33,41,74,65
42,r_76_64_76,seq101,seq47,r_76_64_76,1,0,76,76,65
18,r_31_95_26,r_66_50_184,seq32,r_31_95_26,0.98,0,26,26,65
16,r_19_135_7,r_105_85_97,r_111_10_46,r_111_10_46,0.94,-1,45,46,65
1,r_137_121_69,r_43_91_177,seq122,r_43_91_177,0.78,-74,103,177,65
7,r_66_50_184,r_49_83_44,r_30_53_66,r_49_83_44,0.5,140,184,44,65
20,r_2_36_90,r_149_41_22,r_45_132_140,r_149_41_22,0.54,-2,20,22,65
31,r_45_132_140,r_142_59_39,r_2_36_90,r_142_59_39,0.94,3,42,39,65
35,r_24_96_178,r_86_33_158,r_0_75_14,r_86_33_158,0.45,-125,33,158,65
2,r_30_53_66,r_17_65_35,r_81_63_18,r_17_65_35,0.65,0,35,35,65
41,r_149_41_22,r_2_36_90,r_131_60_185,r_149_41_22,0.93,0,22,22,65
92,seq98,r_15_123_16,seq79,r_15_123_16,0.9,1,17,16,65
3,r_130_58_175,r_131_60_185,r_120_88_6,r_120_88_6,0.77,142,148,6,65
28,r_138_40_74,seq69,r_66_50_184,r_138_40_74,0.37,-32,42,74,65
10,r_27_14_186,seq8,seq73,r_27_14_186,0.36,-1,185,186,65
31,r_45_132_140,r_2_36_90,r_37_90_103,r_45_132_140,0.89,-53,87,140,65
90,seq94,r_125_35_181,r_126_148_132,r_126_148_132,0.92,46,178,132,65
13,r_134_146_73,seq72,r_108_68_163,r_134_146_73,0.82,0,73,73,65
41,r_149_41_22,r_131_60_185,r_115_74_45,r_149_41_22,0.77,52,74,22,65
17,r_29_99_85,r_105_85_97,r_19_135_7,r_105_85_97,0.82,8,105,97,65
48,r_108_68_163,seq139,r_134_146_73,r_134_146_73,0.99,0,73,73,65
4,r_105_85_97,r_19_135_7,seq94,r_105_85_97,0.57,-13,84,97,65
88,seq84,r_130_58_175,r_131_60_185,r_130_58_175,0.71,-140,35,175,65
3,r_130_58_175,r_120_88_6,seq128,r_130_58_175,0.8,0,175,175,65
13,r_134_146_73,r_108_68_163,seq127,r_108_68_163,0.91,-3,160,163,65
6,r_126_148_132,r_113_100_183,r_105_85_97,r_126_148_132,0.66,0,132,132,65
62,seq18,seq67,r_138_40_74,r_138_40_74,1,43,117,74,65
21,r_120_88_6,r_131_60_185,seq84,r_131_60_185,0.55,-23,162,185,65
99,seq127,seq140,r_134_146_73,r_134_146_73,0.99,31,104,73,65
5,r_131_60_185,r_120_88_6,r_105_85_97,r_120_88_6,0.58,179,185,6,65
8,r_15_123_16,seq98,seq80,r_15_123_16,0.71,0,16,16,65
27,r_46_55_188,r_6_112_1,r_105_85_97,r_6_112_1,0.53,186,187,1,65
30,r_106_110_65,seq128,r_89_7_139,r_89_7_139,1,19,158,139,65
20,r_2_36_90,r_0_75_14,r_24_96_178,r_24_96_178,0.54,-66,112,178,65
87,seq80,r_113_100_183,r_15_123_16,r_15_123_16,0.77,87,103,16,65
47,r_37_90_103,r_113_100_183,r_145_147_95,r_37_90_103,0.99,0,103,103,65
34,r_119_42_19,r_125_35_181,r_6_112_1,r_119_42_19,0.98,0,19,19,65
15,r_142_59_39,r_45_132_140,seq44,r_142_59_39,1,0,39,39,65
93,seq101,seq144,r_145_147_95,r_145_147_95,1,9,104,95,65
40,r_87_117_98,r_113_100_183,seq44,r_87_117_98,0.76,0,98,98,65
68,seq26,r_11_78_91,seq79,r_11_78_91,0.69,-39,52,91,65
74,seq47,seq61,r_76_64_76,r_76_64_76,1,14,90,76,65
35,r_24_96_178,r_0_75_14,r_2_36_90,r_2_36_90,1,13,103,90,65
25,r_43_91_177,seq122,r_49_83_44,r_43_91_177,0.46,0,177,177,65
48,r_108_68_163,r_134_146_73,r_81_63_18,r_108_68_163,1,-3,160,163,65
65,seq22,seq4,r_54_28_130,r_54_28_130,1,2,132,130,65
92,seq98,seq79,r_49_83_44,r_49_83_44,0.83,43,87,44,65
70,seq34,r_13_124_166,seq80,r_13_124_166,0.85,0,166,166,65
20,r_2_36_90,r_45_132_140,r_0_75_14,r_2_36_90,0.67,0,90,90,65
32,r_52_82_146,seq9,r_6_112_1,r_52_82_146,0.89,1,147,146,65
77,seq56,r_54_28_130,seq79,r_54_28_130,0.72,0,130,130,65
33,r_70_116_25,r_30_53_66,seq57,r_70_116_25,0.94,-1,24,25,65
31,r_45_132_140,r_37_90_103,seq98,r_45_132_140,0.74,-5,135,140,65
45,r_49_83_44,r_66_50_184,r_43_91_177,r_49_83_44,0.55,140,184,44,65
17,r_29_99_85,r_131_60_185,r_105_85_97,r_29_99_85,0.73,0,85,85,65
84,seq73,seq129,r_93_133_52,r_93_133_52,1,7,59,52,65
54,seq129,seq73,r_93_133_52,r_93_133_52,1,7,59,52,65
9,r_6_112_1,r_46_55_188,r_52_82_146,r_52_82_146,0.91,29,175,146,65
26,r_0_75_14,r_86_33_158,r_24_96_178,r_86_33_158,0.81,0,158,158,65
36,r_81_63_18,r_30_53_66,r_93_133_52,r_81_63_18,0.98,48,66,18,65
29,r_86_33_158,r_0_75_14,seq25,r_86_33_158,0.93,0,158,158,65
4,r_105_85_97,seq94,r_126_148_132,r_126_148_132,1,26,158,132,65
11,r_17_65_35,r_30_53_66,r_15_123_16,r_17_65_35,1,1,36,35,65
44,r_145_147_95,seq57,seq101,r_145_147_95,1,1,96,95,65
23,r_11_78_91,seq56,seq77,r_11_78_91,1,0,91,91,65
49,r_111_10_46,r_66_50_184,r_19_135_7,r_111_10_46,1,0,46,46,65
29,r_86_33_158,r_49_83_44,r_0_75_14,r_86_33_158,0.99,-147,11,158,65
36,r_81_63_18,r_93_133_52,r_108_68_163,r_108_68_163,0.9,18,181,163,65
7,r_66_50_184,r_111_10_46,r_49_83_44,r_66_50_184,1,-138,46,184,65
24,r_115_74_45,seq118,r_149_41_22,r_115_74_45,1,0,45,45,65
45,r_49_83_44,r_86_33_158,r_66_50_184,r_49_83_44,1,0,44,44,65
3,r_75_107_60,r_2_144_180,seq119,r_75_107_60,0.99,0,60,60,66
30,r_40_122_194,seq147,r_96_9_151,r_96_9_151,0.86,1,152,151,66
9,r_30_95_177,r_0_25_100,r_90_128_148,r_30_95_177,0.98,0,177,177,66
37,r_44_51_16,r_136_120_1,seq6,r_44_51_16,0.95,0,16,16,66
14,r_110_16_130,seq135,r_88_19_37,r_110_16_130,0.96,1,131,130,66
8,r_93_73_129,seq48,r_90_128_148,r_90_128_148,0.36,-55,93,148,66
56,seq14,r_116_52_145,r_141_8_84,r_116_52_145,0.58,-118,27,145,66
54,seq139,r_146_86_123,seq33,r_146_86_123,1,1,124,123,66
81,seq68,r_45_132_125,r_30_95_177,r_30_95_177,0.78,-82,95,177,66
21,r_141_8_84,seq14,r_23_47_9,r_141_8_84,0.74,0,84,84,66
59,seq18,r_131_76_162,r_11_92_35,r_11_92_35,0.4,55,90,35,66
20,r_106_94_26,seq32,seq135,r_106_94_26,0.98,0,26,26,66
55,seq13,seq129,r_26_57_67,r_26_57_67,1,89,156,67,66
16,r_97_62_165,seq28,seq99,r_97_62_165,0.52,0,165,165,66
39,r_117_49_136,r_90_128_148,seq54,r_117_49_136,0.89,0,136,136,66
1,r_26_57_67,seq129,seq13,r_26_57_67,0.38,104,171,67,66
1,r_26_57_67,seq17,seq129,r_26_57_67,1,1,68,67,66
97,seq115,r_117_49_136,r_90_128_148,r_117_49_136,0.42,-49,87,136,66
46,r_35_10_132,seq55,r_106_94_26,r_35_10_132,0.93,1,133,132,66
88,seq99,r_140_103_5,r_88_19_37,r_88_19_37,1,63,100,37,66
32,r_23_47_9,r_3_64_174,seq66,r_3_64_174,0.5,-1,173,174,66
45,r_84_78_86,r_2_144_180,r_106_94_26,r_84_78_86,0.99,0,86,86,66
19,r_46_113_108,seq15,seq41,r_46_113_108,0.98,0,108,108,66
31,r_58_50_38,seq59,seq22,r_58_50_38,1,0,38,38,66
94,seq108,r_123_5_193,r_124_43_49,r_124_43_49,0.94,1,50,49,66
66,seq32,seq104,r_100_114_124,r_100_114_124,0.99,29,153,124,66
76,seq60,r_131_76_162,seq65,r_131_76_162,0.97,-1,161,162,66
7,r_100_114_124,seq102,r_116_52_145,r_116_52_145,0.66,8,153,145,66
41,r_136_120_1,seq1,r_21_137_135,r_21_137_135,1,0,135,135,66
10,r_116_52_145,seq85,r_100_114_124,r_116_52_145,0.81,0,145,145,66
26,r_29_79_96,seq63,seq112,r_29_79_96,0.98,8,104,96,66
34,r_133_126_20,r_100_114_124,r_53_74_95,r_53_74_95,0.55,5,100,95,66
38,r_96_9_151,r_40_122_194,seq147,r_96_9_151,0.73,35,186,151,66
0,r_109_20_153,seq31,seq145,r_109_20_153,0.9,1,154,153,66
73,seq55,r_35_10_132,r_2_144_180,r_35_10_132,0.71,0,132,132,66
11,r_36_38_74,seq13,r_143_127_31,r_36_38_74,0.99,0,74,74,66
12,r_124_43_49,r_53_74_95,seq108,r_124_43_49,0.83,1,50,49,66
13,r_146_86_123,seq139,seq48,r_146_86_123,0.97,0,123,123,66
59,seq18,r_11_92_35,seq60,r_11_92_35,0.51,108,143,35,66
71,seq48,r_93_73_129,r_61_89_48,r_61_89_48,0.91,1,49,48,66
49,r_42_4_8,r_97_62_165,r_136_120_1,r_42_4_8,0.46,68,76,8,66
57,seq15,r_46_113_108,seq121,r_46_113_108,1,0,108,108,66
62,seq22,r_97_62_165,r_58_50_38,r_58_50_38,0.99,9,47,38,66
33,r_88_19_37,r_143_127_31,r_133_126_20,r_133_126_20,0.79,1,21,20,66
36,r_3_64_174,r_23_47_9,r_21_137_135,r_3_64_174,0.82,0,174,174,66
27,r_118_98_141,r_109_20_153,seq115,r_118_98_141,0.98,0,141,141,66
34,r_133_126_20,r_88_19_37,r_100_114_124,r_88_19_37,0.92,1,38,37,66
21,r_141_8_84,r_125_24_33,seq14,r_125_24_33,0.76,-4,29,33,66
22,r_90_128_148,r_12_39_57,r_42_4_8,r_90_128_148,0.98,2,150,148,66
56,seq14,r_141_8_84,seq6,r_141_8_84,0.66,2,86,84,66
47,r_91_134_184,seq138,seq148,r_91_134_184,0.47,0,184,184,66
40,r_71_72_161,seq54,r_106_94_26,r_71_72_161,0.9,0,161,161,66
18,r_2_144_180,r_84_78_86,seq55,r_84_78_86,0.99,0,86,86,66
29,r_0_25_100,seq54,r_30_95_177,r_0_25_100,0.96,0,100,100,66
28,r_12_39_57,r_35_10_132,r_90_128_148,r_12_39_57,1,0,57,57,66
36,r_3_64_174,r_82_70_167,r_23_47_9,r_23_47_9,1,22,31,9,66
64,seq28,r_97_62_165,seq27,r_97_62_165,0.73,0,165,165,66
70,seq142,seq1,r_136_120_1,r_136_120_1,0.39,110,111,1,66
8,r_93_73_129,r_90_128_148,seq55,r_93_73_129,0.95,2,131,129,66
65,seq31,r_109_20_153,seq148,r_109_20_153,1,1,154,153,66
20,r_106_94_26,seq135,r_84_78_86,r_84_78_86,1,3,89,86,66
68,seq41,r_96_9_151,r_46_113_108,r_46_113_108,0.85,43,151,108,66
38,r_96_9_151,seq41,r_40_122_194,r_96_9_151,0.85,0,151,151,66
17,r_21_137_135,r_30_95_177,r_136_120_1,r_21_137_135,1,0,135,135,66
43,r_53_74_95,r_124_43_49,seq119,r_124_43_49,1,1,50,49,66
42,r_125_24_33,r_149_37_199,r_130_7_116,r_125_24_33,0.96,0,33,33,66
9,r_30_95_177,r_21_137_135,r_0_25_100,r_30_95_177,0.96,-73,104,177,66
34,r_133_126_20,r_40_122_194,r_88_19_37,r_88_19_37,0.86,-16,21,37,66
28,r_12_39_57,r_90_128_148,r_118_98_141,r_12_39_57,0.98,90,147,57,66
22,r_90_128_148,r_117_49_136,r_12_39_57,r_12_39_57,0.97,5,62,57,66
81,seq68,r_30_95_177,seq55,r_30_95_177,0.86,-63,114,177,66
33,r_88_19_37,r_133_126_20,seq63,r_88_19_37,0.69,0,37,37,66
23,r_61_89_48,seq129,seq48,r_61_89_48,0.95,0,48,48,66
7,r_100_114_124,seq67,seq102,r_100_114_124,0.83,0,124,124,66
44,r_82_70_167,seq66,seq41,r_82_70_167,0.49,2,169,167,66
5,r_143_127_31,r_100_114_124,r_36_38_74,r_143_127_31,1,0,31,31,66
94,seq108,r_124_43_49,r_45_132_125,r_45_132_125,1,12,137,125,66
73,seq55,r_2_144_180,r_93_73_129,r_2_144_180,0.8,-11,169,180,66
49,r_42_4_8,r_136_120_1,r_90_128_148,r_42_4_8,0.58,131,139,8,66
43,r_53_74_95,seq119,r_133_126_20,r_53_74_95,1,0,95,95,66
4,r_92_143_90,r_56_120_41,r_128_34_9,r_92_143_90,0.76,-68,22,90,67
30,r_84_67_3,r_79_83_144,r_103_40_63,r_103_40_63,0.96,65,128,63,67
20,r_144_73_11,r_63_29_86,r_60_14_53,r_144_73_11,0.92,1,12,11,67
36,r_31_32_158,seq107,seq68,r_31_32_158,0.92,0,158,158,67
14,r_54_95_25,r_144_73_11,r_82_28_163,r_54_95_25,0.99,0,25,25,67
49,r_26_48_46,r_23_87_104,seq107,r_23_87_104,0.81,-60,44,104,67
92,seq102,r_103_40_63,seq15,r_103_40_63,0.72,2,65,63,67
43,r_118_111_159,seq86,r_56_120_41,r_118_111_159,0.73,0,159,159,67
0,r_113_104_32,r_16_148_178,r_43_69_68,r_113_104_32,0.95,35,67,32,67
37,r_123_135_170,r_82_28_163,r_113_104_32,r_123_135_170,0.62,-8,162,170,67
86,seq90,seq105,r_23_87_104,r_23_87_104,1,5,109,104,67
21,r_46_145_141,seq137,seq13,r_46_145_141,0.96,1,142,141,67
39,r_63_29_86,seq17,seq33,r_63_29_86,1,1,87,86,67
1,r_53_106_121,r_82_28_163,seq107,r_53_106_121,0.98,2,123,121,67
5,r_131_19_111,seq138,r_27_129_186,r_131_19_111,0.84,2,113,111,67
42,r_3_74_154,r_27_129_186,r_113_104_32,r_113_104_32,0.81,122,154,32,67
32,r_128_34_9,r_92_143_90,r_1_72_14,r_92_143_90,1,0,90,90,67
89,seq94,r_123_135_170,r_54_95_25,r_54_95_25,0.97,14,39,25,67
32,r_128_34_9,r_1_72_14,r_82_28_163,r_82_28_163,1,3,166,163,67
24,r_88_25_67,r_75_97_187,r_115_98_85,r_88_25_67,0.72,120,187,67,67
19,r_147_149_75,r_53_106_121,r_60_14_53,r_147_149_75,1,-1,74,75,67
27,r_109_11_19,seq7,seq17,r_109_11_19,1,0,19,19,67
27,r_109_11_19,seq17,r_110_61_74,r_110_61_74,1,28,102,74,67
0,r_113_104_32,seq8,r_16_148_178,r_113_104_32,1,1,33,32,67
16,r_5_62_29,r_131_19_111,seq77,r_5_62_29,0.86,0,29,29,67
41,r_134_136_62,seq78,r_26_48_46,r_134_136_62,0.48,2,64,62,67
10,r_75_97_187,r_142_126_119,r_88_25_67,r_88_25_67,0.69,33,100,67,67
95,seq114,r_110_61_74,r_60_14_53,r_60_14_53,0.98,1,54,53,67
41,r_134_136_62,r_26_48_46,r_12_101_96,r_12_101_96,1,9,105,96,67
25,r_82_28_163,r_53_106_121,r_54_95_25,r_82_28_163,0.54,-133,30,163,67
11,r_103_40_63,seq102,r_84_67_3,r_103_40_63,1,0,63,63,67
13,r_65_21_81,seq125,seq8,r_65_21_81,1,0,81,81,67
98,seq122,r_12_101_96,seq35,r_12_101_96,1,-3,93,96,67
15,r_12_101_96,seq122,r_134_136_62,r_12_101_96,1,0,96,96,67
8,r_60_14_53,r_79_83_144,seq114,r_60_14_53,1,0,53,53,67
4,r_92_143_90,r_128_34_9,seq117,r_92_143_90,1,0,90,90,67
57,seq139,r_46_145_141,seq137,r_46_145_141,1,-58,83,141,67
29,r_1_72_14,r_10_50_66,seq38,r_1_72_14,0.96,0,14,14,67
62,seq20,r_119_36_184,r_88_25_67,r_88_25_67,1,118,185,67,67
69,seq38,r_88_25_67,r_1_72_14,r_88_25_67,1,-15,52,67,67
74,seq51,r_109_11_19,r_23_87_104,r_23_87_104,1,19,123,104,67
99,seq125,r_65_21_81,r_52_30_8,r_65_21_81,0.75,-51,30,81,67
10,r_75_97_187,r_88_25_67,r_46_145_141,r_75_97_187,0.85,0,187,187,67
2,r_43_69_68,seq37,r_113_104_32,r_43_69_68,1,1,69,68,67
47,r_142_126_119,r_75_97_187,seq86,r_75_97_187,0.54,-66,121,187,67
3,r_85_133_51,seq122,seq17,r_85_133_51,0.86,1,52,51,67
24,r_88_25_67,seq38,r_75_97_187,r_88_25_67,1,0,67,67,67
94,seq107,r_31_32_158,r_26_48_46,r_26_48_46,0.59,-4,42,46,67
20,r_144_73_11,r_60_14_53,r_84_67_3,r_60_14_53,1,-4,49,53,67
7,r_146_57_17,r_79_83_144,seq51,r_146_57_17,0.92,3,20,17,67
33,r_79_83_144,r_84_67_3,r_56_120_41,r_79_83_144,0.72,0,144,144,67
14,r_54_95_25,r_82_28_163,r_119_36_184,r_54_95_25,0.59,139,164,25,67
68,seq37,seq121,r_88_25_67,r_88_25_67,1,94,161,67,67
14,r_54_95_25,seq100,r_144_73_11,r_144_73_11,0.87,-1,10,11,67
40,r_56_120_41,r_92_143_90,r_79_83_144,r_56_120_41,0.99,0,41,41,67
38,r_16_148_178,seq68,r_140_112_37,r_16_148_178,0.65,0,178,178,67
34,r_80_42_82,seq51,seq141,r_80_42_82,0.89,0,82,82,67
20,r_144_73_11,r_84_67_3,r_92_143_90,r_92_143_90,0.66,71,161,90,67
75,seq137,r_46_145_141,seq139,r_46_145_141,1,-39,102,141,67
17,r_23_87_104,r_26_48_46,seq90,r_23_87_104,1,-3,101,104,67
25,r_82_28_163,r_54_95_25,r_128_34_9,r_82_28_163,0.93,0,163,163,67
9,r_115_98_85,seq33,r_130_127_142,r_115_98_85,1,0,85,85,67
96,seq117,seq100,r_92_143_90,r_92_143_90,1,6,96,90,67
7,r_146_57_17,seq51,seq6,r_146_57_17,0.41,57,74,17,67
56,seq138,r_131_19_111,seq9,r_131_19_111,0.68,2,113,111,67
44,r_110_61_74,seq114,r_109_11_19,r_110_61_74,0.98,0,74,74,67
23,r_10_50_66,seq132,seq141,r_10_50_66,0.73,0,66,66,67
94,seq107,r_26_48_46,r_53_106_121,r_53_106_121,1,2,123,121,67
82,seq141,seq37,r_80_42_82,r_80_42_82,0.98,22,104,82,67
35,r_64_44_98,seq37,r_63_29_86,r_64_44_98,0.69,0,98,98,67
73,seq49,r_134_136_62,seq78,r_134_136_62,0.64,-51,11,62,67
30,r_91_145_153,r_141_33_6,r_62_110_123,r_141_33_6,0.77,117,123,6,68
55,seq8,r_55_81_116,r_107_65_17,r_107_65_17,0.52,-1,16,17,68
14,r_10_67_69,seq25,r_62_110_123,r_10_67_69,0.77,2,71,69,68
8,r_139_80_78,seq128,seq16,r_139_80_78,1,0,78,78,68
83,seq74,r_28_113_141,r_48_137_90,r_48_137_90,0.86,38,128,90,68
37,r_95_31_74,r_62_110_123,seq124,r_95_31_74,0.98,0,74,74,68
1,r_54_98_46,seq144,r_131_103_189,r_54_98_46,0.43,0,46,46,68
54,seq7,seq9,r_72_126_136,r_72_126_136,0.98,4,140,136,68
23,r_62_110_123,r_36_129_20,r_95_31_74,r_36_129_20,0.94,-1,19,20,68
33,r_36_129_20,r_62_110_123,seq18,r_36_129_20,0.97,0,20,20,68
5,r_149_125_64,seq42,seq124,r_149_125_64,1,0,64,64,68
46,r_140_119_150,seq74,seq45,r_140_119_150,0.92,0,150,150,68
42,r_115_24_80,seq66,seq78,r_115_24_80,1,0,80,80,68
27,r_75_83_128,r_27_112_84,r_111_94_25,r_111_94_25,0.9,-2,23,25,68
80,seq66,r_115_24_80,seq47,r_115_24_80,0.98,-15,65,80,68
45,r_68_135_51,seq52,seq9,r_68_135_51,0.9,0,51,51,68
51,seq3,r_90_85_50,r_82_147_24,r_90_85_50,0.86,1,51,50,68
39,r_111_94_25,seq105,r_75_83_128,r_111_94_25,1,-1,24,25,68
23,r_62_110_123,r_95_31_74,r_10_67_69,r_62_110_123,0.89,-56,67,123,68
94,seq105,r_101_57_1,r_116_136_43,r_116_136_43,0.67,1,44,43,68
27,r_75_83_128,r_111_94_25,seq47,r_75_83_128,0.98,0,128,128,68
95,seq109,seq13,r_55_81_116,r_55_81_116,1,2,118,116,68
66,seq25,r_10_67_69,r_82_147_24,r_10_67_69,0.66,2,71,69,68
39,r_111_94_25,r_75_83_128,r_71_96_61,r_111_94_25,0.7,103,128,25,68
10,r_120_38_93,seq22,r_143_130_62,r_143_130_62,0.98,47,109,62,68
44,r_17_0_4,r_116_136_43,seq40,r_116_136_43,1,0,43,43,68
90,seq89,r_87_11_77,seq109,r_87_11_77,1,0,77,77,68
26,r_53_4_132,r_141_33_6,r_101_57_1,r_53_4_132,0.54,0,132,132,68
72,seq42,r_149_125_64,r_101_57_1,r_149_125_64,1,0,64,64,68
32,r_46_106_101,r_121_58_30,r_2_29_138,r_46_106_101,0.51,70,171,101,68
4,r_37_30_49,seq66,r_51_12_105,r_51_12_105,0.86,-56,49,105,68
0,r_55_81_116,seq117,seq109,r_55_81_116,1,1,117,116,68
25,r_121_58_30,r_68_135_51,seq19,r_121_58_30,0.61,0,30,30,68
11,r_131_103_189,seq66,r_62_110_123,r_62_110_123,0.71,66,189,123,68
20,r_27_112_84,r_75_83_128,r_55_81_116,r_27_112_84,0.84,0,84,84,68
98,seq123,r_92_122_198,r_27_112_84,r_27_112_84,1,53,137,84,68
7,r_43_59_26,seq77,seq34,r_43_59_26,1,0,26,26,68
15,r_93_100_129,r_56_146_115,seq45,r_56_146_115,0.65,0,115,115,68
48,r_71_96_61,r_51_12_105,r_2_29_138,r_71_96_61,1,0,61,61,68
28,r_148_60_37,seq7,seq15,r_148_60_37,1,0,37,37,68
6,r_143_130_62,seq49,r_120_38_93,r_143_130_62,0.97,0,62,62,68
85,seq77,r_43_59_26,seq76,r_43_59_26,0.92,0,26,26,68
20,r_27_112_84,r_55_81_116,r_51_12_105,r_27_112_84,0.78,24,108,84,68
99,seq124,seq79,r_149_125_64,r_149_125_64,1,31,95,64,68
17,r_51_12_105,r_71_96_61,r_37_30_49,r_51_12_105,0.99,-46,59,105,68
15,r_93_100_129,seq45,seq109,r_93_100_129,0.92,1,130,129,68
14,r_10_67_69,r_62_110_123,r_37_30_49,r_62_110_123,0.98,0,123,123,68
45,r_68_135_51,r_121_58_30,seq52,r_68_135_51,0.39,-26,25,51,68
16,r_107_65_17,seq132,seq8,r_107_65_17,1,0,17,17,68
2,r_87_11_77,seq89,r_141_33_6,r_87_11_77,0.97,0,77,77,68
47,r_142_26_85,seq45,seq21,r_142_26_85,0.96,0,85,85,68
40,r_6_127_144,seq9,seq49,r_6_127_144,0.82,0,144,144,68
74,seq47,seq66,r_75_83_128,r_75_83_128,0.74,9,137,128,68
18,r_2_29_138,r_149_125_64,r_71_96_61,r_2_29_138,1,-74,64,138,68
29,r_134_114_146,seq9,r_143_130_62,r_134_114_146,0.9,0,146,146,68
24,r_88_5_110,r_56_146_115,r_91_145_153,r_88_5_110,0.93,1,111,110,68
54,seq7,r_148_60_37,seq9,r_148_60_37,1,-6,31,37,68
53,seq133,seq69,r_82_147_24,r_82_147_24,1,1,25,24,68
34,r_116_136_43,r_17_0_4,seq105,r_116_136_43,1,0,43,43,68
43,r_141_33_6,r_53_4_132,r_87_11_77,r_87_11_77,0.81,0,77,77,68
48,r_71_96_61,r_2_29_138,r_101_57_1,r_2_29_138,1,0,138,138,68
6,r_143_130_62,r_120_38_93,r_134_114_146,r_134_114_146,1,-1,145,146,68
65,seq22,r_120_38_93,r_143_130_62,r_143_130_62,0.99,63,125,62,68
19,r_82_147_24,r_71_96_61,seq133,r_82_147_24,0.97,1,25,24,68
32,r_46_106_101,seq22,seq19,r_46_106_101,0.74,0,101,101,68
38,r_28_113_141,r_140_119_150,r_75_83_128,r_28_113_141,1,0,141,141,68
36,r_72_126_136,r_92_122_198,seq7,r_72_126_136,0.99,-103,33,136,68
23,r_62_110_123,r_10_67_69,r_91_145_153,r_62_110_123,0.93,0,123,123,68
17,r_51_12_105,r_37_30_49,r_27_112_84,r_51_12_105,1,0,105,105,68
75,seq49,r_23_97_177,r_6_127_144,r_6_127_144,0.69,34,178,144,68
21,r_90_85_50,r_10_67_69,seq144,r_90_85_50,1,-1,49,50,68
22,r_108_70_137,seq32,r_82_147_24,r_108_70_137,0.83,0,137,137,68
73,seq45,seq123,r_140_119_150,r_140_119_150,0.88,3,153,150,68
91,seq144,seq132,r_90_85_50,r_90_85_50,1,-3,47,50,68
56,seq9,r_134_114_146,r_68_135_51,r_68_135_51,0.77,95,146,51,68
18,r_2_29_138,r_71_96_61,seq21,r_2_29_138,1,0,138,138,68
4,r_37_30_49,r_51_12_105,r_10_67_69,r_51_12_105,0.75,0,105,105,68
14,r_10_67_69,r_37_30_49,r_23_97_177,r_23_97_177,0.96,1,178,177,68
35,r_48_137_90,r_92_122_198,seq74,r_48_137_90,1,0,90,90,68
99,seq123,r_147_54_67,r_99_114_197,r_147_54_67,1,-25,42,67,69
30,r_57_66_128,r_113_90_132,r_115_13_127,r_57_66_128,0.99,0,128,128,69
36,r_109_83_179,seq141,r_46_7_84,r_109_83_179,0.5,2,181,179,69
92,seq106,r_144_134_140,seq33,r_144_134_140,1,1,141,140,69
14,r_62_20_135,r_17_76_173,r_67_130_104,r_62_20_135,0.99,0,135,135,69
12,r_9_25_42,r_40_137_176,r_35_97_195,r_9_25_42,0.96,0,42,42,69
16,r_11_79_61,r_17_76_173,seq21,r_11_79_61,1,0,61,61,69
39,r_73_15_59,r_115_13_127,seq138,r_73_15_59,0.96,1,60,59,69
1,r_47_84_71,r_110_89_138,seq30,r_110_89_138,1,0,138,138,69
1,r_47_84_71,r_41_148_83,r_110_89_138,r_47_84_71,1,2,73,71,69
5,r_60_100_100,seq133,seq53,r_60_100_100,1,0,100,100,69
42,r_131_119_188,seq68,r_88_108_7,r_88_108_7,0.9,181,188,7,69
22,r_67_130_104,r_94_146_40,seq70,r_67_130_104,0.99,0,104,104,69
0,r_56_5_130,r_74_149_180,r_125_127_36,r_74_149_180,1,0,180,180,69
31,r_91_31_52,seq48,r_112_12_35,r_91_31_52,0.99,0,52,52,69
15,r_110_89_138,r_47_84_71,seq141,r_110_89_138,1,0,138,138,69
66,seq30,r_17_76_173,r_47_84_71,r_47_84_71,0.82,102,173,71,69
24,r_63_122_107,r_46_7_84,seq0,r_63_122_107,0.91,0,107,107,69
41,r_129_132_134,r_99_114_197,r_142_98_19,r_129_132_134,0.98,0,134,134,69
8,r_143_27_50,seq77,r_58_3_37,r_143_27_50,1,0,50,50,69
26,r_95_23_92,r_35_97_195,seq48,r_95_23_92,0.98,0,92,92,69
4,r_99_114_197,r_129_132_134,seq123,r_129_132_134,1,0,134,134,69
0,r_56_5_130,seq105,r_74_149_180,r_56_5_130,0.91,0,130,130,69
11,r_41_148_83,seq55,r_9_25_42,r_41_148_83,0.97,1,84,83,69
20,r_49_38_78,r_35_97_195,seq55,r_49_38_78,1,0,78,78,69
13,r_46_7_84,seq64,r_63_122_107,r_46_7_84,0.97,0,84,84,69
46,r_74_149_180,r_125_127_36,r_88_108_7,r_88_108_7,0.45,165,172,7,69
15,r_110_89_138,r_17_76_173,r_47_84_71,r_47_84_71,1,7,78,71,69
21,r_86_16_194,r_147_54_67,r_91_31_52,r_86_16_194,1,-141,53,194,69
46,r_74_149_180,seq116,r_125_127_36,r_125_127_36,0.91,0,36,36,69
28,r_58_3_37,r_99_114_197,r_144_134_140,r_58_3_37,0.88,0,37,37,69
2,r_125_127_36,r_74_149_180,r_56_5_130,r_56_5_130,1,50,180,130,69
27,r_113_90_132,seq120,r_46_7_84,r_113_90_132,0.73,0,132,132,69
40,r_45_69_113,r_59_28_160,r_6_96_89,r_6_96_89,0.51,71,160,89,69
10,r_112_12_35,r_147_54_67,r_91_31_52,r_112_12_35,0.97,19,54,35,69
24,r_63_122_107,seq116,r_46_7_84,r_46_7_84,0.92,0,84,84,69
18,r_142_98_19,r_60_100_100,seq34,r_142_98_19,1,0,19,19,69
35,r_115_13_127,seq140,r_57_66_128,r_115_13_127,1,2,129,127,69
25,r_40_137_176,seq48,r_131_119_188,r_40_137_176,0.62,-65,111,176,69
33,r_52_65_115,r_109_83_179,seq70,r_52_65_115,0.93,-2,113,115,69
13,r_46_7_84,seq111,r_113_90_132,r_46_7_84,0.65,48,132,84,69
58,seq141,r_109_83_179,r_110_89_138,r_110_89_138,0.96,15,153,138,69
3,r_85_104_47,r_115_13_127,r_4_78_192,r_85_104_47,1,0,47,47,69
61,seq19,r_124_126_64,seq135,r_124_126_64,0.96,0,64,64,69
32,r_59_28_160,r_45_69_113,seq48,r_59_28_160,0.66,0,160,160,69
38,r_144_134_140,seq106,r_57_66_128,r_144_134_140,0.91,0,140,140,69
77,seq138,seq103,r_73_15_59,r_73_15_59,1,12,71,59,69
13,r_46_7_84,r_63_122_107,seq111,r_63_122_107,0.8,0,107,107,69
34,r_6_96_89,r_67_130_104,seq10,r_6_96_89,0.83,-1,88,89,69
28,r_58_3_37,r_144_134_140,r_143_27_50,r_58_3_37,0.92,17,54,37,69
43,r_50_51_21,seq140,seq133,r_50_51_21,0.99,0,21,21,69
10,r_112_12_35,r_4_78_192,r_147_54_67,r_112_12_35,0.97,0,35,35,69
25,r_40_137_176,r_131_119_188,r_85_104_47,r_40_137_176,0.92,0,176,176,69
9,r_35_97_195,r_49_38_78,r_9_25_42,r_35_97_195,0.65,-117,78,195,69
22,r_67_130_104,r_6_96_89,r_94_146_40,r_94_146_40,0.81,49,89,40,69
48,r_4_78_192,r_112_12_35,r_85_104_47,r_4_78_192,1,-160,32,192,69
56,seq10,r_45_69_113,r_6_96_89,r_6_96_89,1,28,117,89,69
7,r_92_139_114,seq30,seq42,r_92_139_114,0.98,0,114,114,69
18,r_142_98_19,seq34,r_129_132_134,r_129_132_134,1,33,167,134,69
44,r_124_126_64,seq19,seq141,r_124_126_64,1,0,64,64,69
53,seq133,seq107,r_50_51_21,r_50_51_21,1,2,23,21,69
23,r_147_54_67,r_86_16_194,seq81,r_147_54_67,1,0,67,67,69
35,r_115_13_127,r_73_15_59,seq140,r_73_15_59,0.99,1,60,59,69
2,r_125_127_36,r_147_54_67,r_74_149_180,r_125_127_36,0.93,0,36,36,69
74,seq48,r_91_31_52,r_67_130_104,r_91_31_52,0.66,-9,43,52,69
93,seq112,r_136_14_109,seq2,r_136_14_109,0.99,-2,107,109,70
30,r_83_49_195,r_37_13_147,r_87_119_25,r_83_49_195,0.65,-70,125,195,70
64,seq41,r_55_141_63,r_18_104_31,r_18_104_31,0.85,1,32,31,70
19,r_70_66_36,seq143,seq28,r_70_66_36,1,0,36,36,70
20,r_8_50_90,r_83_49_195,seq143,r_8_50_90,0.41,16,106,90,70
53,seq133,r_72_32_171,r_146_57_37,r_146_57_37,1,88,125,37,70
38,r_37_13_147,seq118,seq92,r_37_13_147,0.96,0,147,147,70
58,seq143,r_8_50_90,r_148_122_150,r_148_122_150,1,6,156,150,70
43,r_4_44_136,r_55_141_63,seq120,r_55_141_63,1,4,67,63,70
6,r_108_31_157,r_40_98_96,r_101_26_73,r_108_31_157,0.92,0,157,157,70
83,seq90,r_142_77_156,r_121_85_81,r_121_85_81,0.82,76,157,81,70
28,r_135_124_24,seq92,seq61,r_135_124_24,0.84,0,24,24,70
16,r_134_139_185,seq61,r_132_95_15,r_132_95_15,0.97,94,109,15,70
1,r_55_141_63,r_4_44_136,seq16,r_55_141_63,1,0,63,63,70
5,r_69_88_129,seq12,seq59,r_69_88_129,0.91,1,130,129,70
46,r_21_114_75,r_129_149_92,seq39,r_21_114_75,1,0,75,75,70
42,r_76_79_104,seq16,r_135_124_24,r_76_79_104,0.96,0,104,104,70
21,r_18_104_31,r_70_66_36,seq41,r_18_104_31,1,0,31,31,70
88,seq96,r_53_100_29,r_25_71_122,r_25_71_122,0.97,6,128,122,70
45,r_84_116_149,seq78,seq115,r_84_116_149,0.94,0,149,149,70
39,r_110_9_19,seq74,seq92,r_110_9_19,0.56,0,19,19,70
15,r_136_14_109,r_127_107_180,r_24_65_6,r_136_14_109,0.66,70,179,109,70
29,r_105_5_53,seq46,seq56,r_105_5_53,0.99,1,54,53,70
97,seq120,r_4_44_136,r_33_19_39,r_4_44_136,0.51,0,136,136,70
10,r_89_6_123,seq74,seq103,r_89_6_123,0.32,0,123,123,70
26,r_72_32_171,seq133,r_42_36_60,r_42_36_60,1,2,62,60,70
16,r_134_139_185,r_132_95_15,r_42_36_60,r_134_139_185,0.65,0,185,185,70
48,r_113_29_52,r_52_99_183,seq12,r_113_29_52,1,0,52,52,70
13,r_87_119_25,seq59,r_37_13_147,r_87_119_25,1,0,25,25,70
71,seq58,r_20_144_186,r_53_100_29,r_53_100_29,1,14,43,29,70
0,r_42_36_60,r_37_13_147,r_72_32_171,r_42_36_60,1,2,62,60,70
63,seq39,r_43_81_62,r_84_116_149,r_43_81_62,0.77,0,62,62,70
11,r_142_77_156,seq90,r_8_50_90,r_142_77_156,0.81,0,156,156,70
20,r_8_50_90,seq61,r_83_49_195,r_8_50_90,0.5,0,90,90,70
15,r_136_14_109,seq112,r_127_107_180,r_136_14_109,0.93,0,109,109,70
79,seq74,r_110_9_19,r_89_6_123,r_110_9_19,0.82,-1,18,19,70
57,seq12,r_69_88_129,r_113_29_52,r_113_29_52,0.79,24,76,52,70
9,r_22_106_55,seq7,r_138_60_5,r_22_106_55,0.99,0,55,55,70
98,seq123,r_70_66_36,r_89_6_123,r_70_66_36,0.59,149,185,36,70
13,r_87_119_25,r_37_13_147,r_15_82_131,r_87_119_25,0.85,108,133,25,70
6,r_108_31_157,r_25_71_122,r_40_98_96,r_40_98_96,0.92,10,106,96,70
97,seq120,r_51_102_23,r_4_44_136,r_51_102_23,0.77,-2,21,23,70
99,seq125,r_108_31_157,r_11_80_97,r_11_80_97,0.99,-2,95,97,70
0,r_42_36_60,r_72_32_171,r_146_57_37,r_72_32_171,0.98,-1,170,171,70
4,r_138_60_5,r_11_80_97,r_22_106_55,r_138_60_5,0.57,50,55,5,70
27,r_11_80_97,seq64,seq125,r_11_80_97,1,0,97,97,70
3,r_68_23_16,seq59,seq86,r_68_23_16,1,0,16,16,70
82,seq86,seq61,r_68_23_16,r_68_23_16,0.87,0,16,16,70
36,r_132_95_15,r_51_102_23,seq140,r_132_95_15,1,0,15,15,70
2,r_129_149_92,r_21_114_75,r_134_139_185,r_21_114_75,1,0,75,75,70
47,r_121_85_81,r_38_3_56,seq90,r_121_85_81,1,1,82,81,70
40,r_27_131_70,r_30_35_199,r_110_9_19,r_27_131_70,1,0,70,70,70
63,seq39,r_84_116_149,r_21_114_75,r_84_116_149,0.81,-43,106,149,70
18,r_52_99_183,seq111,r_108_31_157,r_52_99_183,0.21,0,183,183,70
24,r_53_100_29,r_22_106_55,seq58,r_53_100_29,0.72,0,29,29,70
25,r_101_26_73,r_40_98_96,seq48,r_40_98_96,1,-6,90,96,70
43,r_4_44_136,seq120,r_69_88_129,r_4_44_136,0.84,1,137,136,70
12,r_33_19_39,r_40_98_96,seq41,r_33_19_39,1,0,39,39,70
37,r_146_57_37,r_148_122_150,seq133,r_146_57_37,1,1,38,37,70
88,seq96,r_126_34_193,r_53_100_29,r_53_100_29,1,15,44,29,70
38,r_37_13_147,seq0,seq118,r_37_13_147,0.52,-27,120,147,70
52,seq2,seq112,r_45_17_65,r_45_17_65,1,1,66,65,70
39,r_110_9_19,seq92,r_27_131_70,r_27_131_70,0.98,6,76,70,70
75,seq63,seq16,r_43_81_62,r_43_81_62,1,0,62,62,70
85,seq92,r_135_124_24,seq47,r_135_124_24,1,0,24,24,70
62,seq28,seq62,r_70_66_36,r_70_66_36,1,2,38,36,70
81,seq78,r_84_116_149,seq56,r_84_116_149,1,0,149,149,70
17,r_127_107_180,seq145,r_136_14_109,r_136_14_109,1,1,110,109,70
26,r_72_32_171,r_42_36_60,r_108_31_157,r_72_32_171,0.71,0,171,171,70
9,r_22_106_55,r_53_100_29,seq7,r_53_100_29,0.91,0,29,29,70
20,r_8_50_90,seq143,r_142_77_156,r_142_77_156,1,0,156,156,70
33,r_51_102_23,seq120,seq147,r_51_102_23,0.63,0,23,23,70
28,r_135_124_24,seq61,seq140,r_135_124_24,0.58,120,144,24,70
22,r_148_122_150,seq109,seq143,r_148_122_150,0.61,0,150,150,70
2,r_129_149_92,r_134_139_185,seq140,r_129_149_92,0.69,11,103,92,70
49,r_20_144_186,seq58,r_42_36_60,r_42_36_60,0.68,126,186,60,70
7,r_25_71_122,r_108_31_157,seq96,r_25_71_122,0.7,0,122,122,70
44,r_15_82_131,seq59,r_87_119_25,r_87_119_25,0.58,106,131,25,70
23,r_40_98_96,r_101_26_73,r_108_31_157,r_40_98_96,1,1,97,96,70
17,r_127_107_180,r_136_14_109,r_148_122_150,r_127_107_180,0.89,0,180,180,70
31,r_38_3_56,r_121_85_81,seq118,r_121_85_81,1,-24,57,81,70
35,r_43_81_62,seq39,seq63,r_43_81_62,1,0,62,62,70
23,r_40_98_96,r_108_31_157,seq125,r_108_31_157,0.91,2,159,157,70
64,seq41,r_18_104_31,r_33_19_39,r_33_19_39,0.96,6,45,39,70
30,r_34_50_65,seq119,seq135,r_34_50_65,1,0,65,65,71
1,r_77_141_86,r_26_94_20,r_53_140_180,r_77_141_86,0.52,-47,39,86,71
8,r_84_20_76,r_101_8_103,r_104_149_151,r_84_20_76,1,1,77,76,71
43,r_96_113_186,seq143,r_57_2_107,r_57_2_107,1,8,115,107,71
86,seq87,r_132_73_30,r_33_49_54,r_33_49_54,0.47,116,170,54,71
32,r_71_61_144,r_10_81_117,r_106_137_69,r_71_61_144,1,0,144,144,71
29,r_85_62_73,r_27_82_92,r_114_102_157,r_85_62_73,0.55,19,92,73,71
37,r_35_92_68,seq48,seq3,r_35_92_68,1,0,68,68,71
36,r_128_45_11,r_35_92_68,seq119,r_128_45_11,0.99,0,11,11,71
23,r_65_121_139,seq31,r_122_131_39,r_65_121_139,0.99,0,139,139,71
19,r_124_25_81,r_93_90_179,r_26_94_20,r_93_90_179,0.9,0,179,179,71
51,seq3,seq4,r_35_92_68,r_35_92_68,1,14,82,68,71
21,r_114_102_157,seq23,r_85_62_73,r_114_102_157,0.57,0,157,157,71
39,r_63_30_125,seq19,r_114_102_157,r_63_30_125,0.91,0,125,125,71
5,r_88_79_24,r_101_8_103,r_89_134_16,r_88_79_24,0.72,78,102,24,71
46,r_112_108_88,seq83,seq47,r_112_108_88,1,0,88,88,71
42,r_93_90_179,r_136_64_187,r_96_113_186,r_96_113_186,0.7,-5,181,186,71
1,r_77_141_86,r_53_140_180,seq52,r_77_141_86,0.99,-13,73,86,71
19,r_124_25_81,seq133,r_93_90_179,r_124_25_81,1,1,82,81,71
11,r_122_131_39,r_99_142_176,r_147_97_7,r_122_131_39,0.44,126,165,39,71
24,r_104_149_151,seq23,r_84_20_76,r_84_20_76,0.81,5,81,76,71
14,r_55_107_22,seq135,r_115_37_184,r_55_107_22,1,-2,20,22,71
31,r_100_91_137,r_96_113_186,seq56,r_96_113_186,0.42,-113,73,186,71
31,r_100_91_137,r_132_73_30,r_136_64_187,r_136_64_187,0.87,0,187,187,71
89,seq144,r_57_2_107,seq116,r_57_2_107,1,-42,65,107,71
12,r_7_58_100,r_148_13_15,r_98_18_119,r_98_18_119,0.86,4,123,119,71
10,r_14_111_64,seq29,r_148_13_15,r_14_111_64,1,1,65,64,71
9,r_89_134_16,seq52,r_88_79_24,r_89_134_16,0.9,0,16,16,71
4,r_101_8_103,r_88_79_24,seq16,r_101_8_103,0.96,0,103,103,71
2,r_148_13_15,seq4,seq9,r_148_13_15,0.88,4,19,15,71
16,r_27_82_92,r_118_32_56,seq42,r_27_82_92,0.57,-35,57,92,71
73,seq48,r_35_92_68,seq135,r_35_92_68,1,-8,60,68,71
15,r_38_95_112,seq31,r_138_69_45,r_38_95_112,0.65,56,168,112,71
13,r_78_80_77,r_65_121_139,seq119,r_78_80_77,0.99,1,78,77,71
15,r_38_95_112,seq66,seq31,r_38_95_112,0.71,1,113,112,71
48,r_117_72_181,seq52,r_75_12_115,r_117_72_181,0.33,0,181,181,71
49,r_118_32_56,seq21,r_5_103_116,r_5_103_116,1,8,124,116,71
39,r_63_30_125,r_114_102_157,seq59,r_114_102_157,0.99,0,157,157,71
92,seq110,r_145_40_58,seq83,r_145_40_58,0.96,0,58,58,71
2,r_148_13_15,seq9,r_7_58_100,r_7_58_100,1,13,113,100,71
61,seq21,seq17,r_118_32_56,r_118_32_56,1,2,58,56,71
49,r_118_32_56,r_27_82_92,seq21,r_118_32_56,0.99,1,57,56,71
6,r_138_69_45,r_112_108_88,seq4,r_138_69_45,0.72,0,45,45,71
27,r_106_137_69,seq76,r_138_69_45,r_106_137_69,1,0,69,69,71
16,r_27_82_92,seq42,r_85_62_73,r_85_62_73,0.89,-2,71,73,71
16,r_27_82_92,r_85_62_73,r_65_121_139,r_27_82_92,0.9,0,92,92,71
35,r_115_37_184,seq139,r_55_107_22,r_55_107_22,1,2,24,22,71
47,r_70_86_113,seq139,r_128_45_11,r_70_86_113,1,0,113,113,71
28,r_99_142_176,seq54,r_122_131_39,r_122_131_39,1,1,40,39,71
24,r_104_149_151,r_26_94_20,seq23,r_26_94_20,1,2,22,20,71
33,r_145_40_58,seq110,seq39,r_145_40_58,1,0,58,58,71
29,r_85_62_73,r_7_58_100,r_27_82_92,r_85_62_73,0.93,0,73,73,71
18,r_33_49_54,r_75_12_115,r_132_73_30,r_33_49_54,1,0,54,54,71
8,r_84_20_76,r_104_149_151,r_75_12_115,r_84_20_76,0.93,53,129,76,71
34,r_26_94_20,r_136_64_187,r_124_25_81,r_124_25_81,0.99,37,118,81,71
35,r_115_37_184,r_55_107_22,r_75_12_115,r_75_12_115,1,19,134,115,71
25,r_57_2_107,seq144,r_96_113_186,r_57_2_107,1,0,107,107,71
88,seq135,seq22,r_34_50_65,r_34_50_65,1,6,71,65,71
50,seq1,seq4,r_35_92_68,r_35_92_68,0.9,3,71,68,71
32,r_71_61_144,r_98_18_119,r_10_81_117,r_71_61_144,0.44,-37,107,144,71
38,r_98_18_119,r_71_61_144,r_7_58_100,r_98_18_119,0.93,0,119,119,71
45,r_0_28_29,r_6_146_62,seq143,r_0_28_29,1,1,30,29,71
3,r_6_146_62,r_0_28_29,r_112_108_88,r_6_146_62,0.72,-31,31,62,71
75,seq52,r_117_72_181,seq125,r_117_72_181,0.88,0,181,181,71
60,seq19,r_63_30_125,seq74,r_63_30_125,1,-1,124,125,71
17,r_75_12_115,r_33_49_54,r_98_18_119,r_33_49_54,1,0,54,54,71
24,r_104_149_151,r_84_20_76,seq48,r_104_149_151,0.96,1,152,151,71
31,r_100_91_137,seq56,r_132_73_30,r_100_91_137,0.94,0,137,137,71
6,r_138_69_45,seq4,r_106_137_69,r_106_137_69,1,0,69,69,71
34,r_26_94_20,r_104_149_151,r_136_64_187,r_26_94_20,0.97,1,21,20,71
3,r_6_146_62,r_112_108_88,r_89_134_16,r_6_146_62,0.99,1,63,62,71
73,seq48,seq135,r_104_149_151,r_104_149_151,1,5,156,151,71
51,seq3,r_93_90_179,seq4,r_93_90_179,0.84,-150,29,179,71
41,r_132_73_30,r_55_107_22,seq133,r_132_73_30,0.78,-14,16,30,71
7,r_5_103_116,seq116,r_118_32_56,r_5_103_116,0.74,0,116,116,71
18,r_33_49_54,r_132_73_30,seq87,r_33_49_54,0.3,131,185,54,71
23,r_65_121_139,r_7_58_100,seq31,r_7_58_100,1,1,101,100,71
11,r_122_131_39,r_124_25_81,r_99_142_176,r_122_131_39,0.99,0,39,39,71
17,r_75_12_115,r_98_18_119,r_115_37_184,r_75_12_115,1,0,115,115,71
16,r_27_82_92,r_65_121_139,seq47,r_27_82_92,0.66,29,121,92,71
22,r_60_44_23,r_55_107_22,seq9,r_60_44_23,0.51,0,23,23,71
79,seq66,r_38_95_112,seq24,r_38_95_112,0.96,-1,111,112,71
12,r_7_58_100,r_65_121_139,r_148_13_15,r_7_58_100,0.92,0,100,100,71
84,seq83,r_112_108_88,seq110,r_112_108_88,0.92,1,89,88,71
30,r_31_99_118,seq136,r_79_65_48,r_31_99_118,1,0,118,118,72
12,r_61_108_57,r_137_105_79,seq117,r_61_108_57,1,0,57,57,72
36,r_27_139_111,seq7,seq110,r_27_139_111,0.88,2,113,111,72
16,r_71_125_27,seq44,seq74,r_71_125_27,1,0,27,27,72
92,seq113,r_28_63_153,r_94_107_8,r_28_63_153,0.95,1,154,153,72
53,seq6,seq19,r_93_12_80,r_93_12_80,1,47,127,80,72
43,r_142_114_85,r_97_16_106,r_112_57_58,r_97_16_106,0.92,-20,86,106,72
37,r_141_37_199,seq87,r_148_85_60,r_148_85_60,0.98,19,79,60,72
71,seq51,r_138_115_119,seq0,r_138_115_119,1,-2,117,119,72
5,r_46_64_157,seq44,r_61_108_57,r_46_64_157,0.82,0,157,157,72
46,r_8_52_68,r_109_75_74,r_20_5_194,r_8_52_68,1,0,68,68,72
42,r_67_144_184,r_90_34_169,r_82_50_136,r_82_50_136,0.89,8,144,136,72
31,r_39_55_97,seq29,seq143,r_39_55_97,0.38,89,186,97,72
0,r_122_58_25,r_39_55_97,r_111_4_176,r_39_55_97,0.52,35,132,97,72
15,r_82_50_136,r_33_53_16,r_133_2_115,r_82_50_136,0.99,0,136,136,72
35,r_104_88_11,r_112_57_58,r_35_86_180,r_104_88_11,1,0,11,11,72
17,r_20_5_194,r_21_42_15,r_8_52_68,r_20_5_194,0.83,-125,69,194,72
7,r_146_121_147,seq69,seq92,r_146_121_147,0.59,-9,138,147,72
31,r_39_55_97,r_80_68_3,r_119_101_145,r_39_55_97,0.97,0,97,97,72
41,r_109_75_74,r_8_52_68,r_1_13_196,r_109_75_74,1,0,74,74,72
10,r_149_25_158,r_111_4_176,seq129,r_149_25_158,0.58,0,158,158,72
19,r_123_128_24,seq0,seq54,r_123_128_24,1,0,24,24,72
14,r_22_62_21,r_90_34_169,r_21_42_15,r_22_62_21,0.92,3,24,21,72
4,r_45_32_186,r_133_2_115,r_94_107_8,r_133_2_115,0.98,1,116,115,72
63,seq29,r_111_4_176,r_82_50_136,r_82_50_136,0.96,45,181,136,72
15,r_82_50_136,seq102,r_33_53_16,r_33_53_16,0.95,24,40,16,72
13,r_132_98_91,r_35_86_180,r_104_88_11,r_35_86_180,0.99,3,183,180,72
48,r_28_63_153,seq113,r_79_65_48,r_28_63_153,0.75,2,155,153,72
8,r_40_140_53,seq129,r_80_68_3,r_40_140_53,1,0,53,53,72
4,r_45_32_186,r_94_107_8,r_33_53_16,r_45_32_186,0.58,1,187,186,72
65,seq36,r_71_125_27,r_78_91_65,r_71_125_27,0.56,93,120,27,72
45,r_119_101_145,r_20_5_194,seq143,r_119_101_145,0.71,-119,26,145,72
18,r_112_57_58,r_20_5_194,seq30,r_112_57_58,1,0,58,58,72
21,r_43_81_9,seq19,r_127_70_154,r_127_70_154,0.92,31,185,154,72
85,seq143,r_90_34_169,r_82_50_136,r_90_34_169,0.34,-14,155,169,72
34,r_33_53_16,r_96_103_64,r_82_50_136,r_33_53_16,0.86,0,16,16,72
0,r_122_58_25,r_97_16_106,r_39_55_97,r_122_58_25,0.84,85,110,25,72
20,r_35_86_180,r_21_42_15,r_104_88_11,r_35_86_180,0.98,-166,14,180,72
17,r_20_5_194,r_112_57_58,r_21_42_15,r_20_5_194,0.66,-135,59,194,72
27,r_1_13_196,seq38,r_109_75_74,r_109_75_74,1,4,78,74,72
59,seq17,r_9_26_44,seq110,r_9_26_44,0.72,3,47,44,72
72,seq54,r_146_121_147,r_123_128_24,r_123_128_24,1,1,25,24,72
41,r_109_75_74,r_1_13_196,r_138_115_119,r_138_115_119,0.76,69,188,119,72
47,r_80_68_3,r_39_55_97,r_40_140_53,r_80_68_3,0.99,74,77,3,72
43,r_142_114_85,r_112_57_58,r_78_91_65,r_78_91_65,0.64,67,132,65,72
40,r_90_34_169,r_67_144_184,r_133_2_115,r_133_2_115,0.94,-2,113,115,72
24,r_97_16_106,r_122_58_25,seq134,r_122_58_25,0.53,85,110,25,72
24,r_97_16_106,r_142_114_85,r_122_58_25,r_97_16_106,0.64,-33,73,106,72
34,r_33_53_16,r_82_50_136,seq102,r_82_50_136,1,0,136,136,72
45,r_119_101_145,seq143,r_39_55_97,r_39_55_97,1,2,99,97,72
35,r_104_88_11,r_35_86_180,r_132_98_91,r_132_98_91,1,88,179,91,72
33,r_127_70_154,seq118,r_43_81_9,r_127_70_154,0.81,0,154,154,72
9,r_9_26_44,seq17,seq0,r_9_26_44,1,0,44,44,72
88,seq102,r_82_50_136,r_56_130_7,r_82_50_136,0.67,-19,117,136,72
96,seq118,seq44,r_1_13_196,r_1_13_196,0.97,-70,126,196,72
20,r_35_86_180,r_104_88_11,r_132_98_91,r_132_98_91,1,12,103,91,72
3,r_21_42_15,r_35_86_180,r_22_62_21,r_21_42_15,0.55,0,15,15,72
38,r_111_4_176,seq29,r_122_58_25,r_122_58_25,0.59,159,184,25,72
64,seq30,seq106,r_112_57_58,r_112_57_58,1,1,59,58,72
20,r_35_86_180,r_132_98_91,r_90_34_169,r_35_86_180,0.76,3,183,180,72
6,r_137_105_79,r_59_131_134,r_8_52_68,r_137_105_79,0.98,0,79,79,72
81,seq83,r_35_86_180,r_132_98_91,r_132_98_91,1,50,141,91,72
45,r_119_101_145,r_39_55_97,r_82_50_136,r_82_50_136,0.96,9,145,136,72
40,r_90_34_169,r_133_2_115,seq44,r_90_34_169,1,0,169,169,72
0,r_122_58_25,r_27_139_111,r_97_16_106,r_122_58_25,0.99,0,25,25,72
29,r_49_11_166,seq84,seq38,r_49_11_166,0.57,0,166,166,72
28,r_133_2_115,r_45_32_186,r_90_34_169,r_133_2_115,0.79,1,116,115,72
49,r_138_115_119,seq51,seq3,r_138_115_119,0.99,0,119,119,72
39,r_79_65_48,r_1_13_196,seq129,r_79_65_48,1,0,48,48,72
44,r_148_85_60,r_1_13_196,r_141_37_199,r_148_85_60,1,0,60,60,72
23,r_78_91_65,seq92,seq36,r_78_91_65,1,1,66,65,72
42,r_67_144_184,r_82_50_136,seq136,r_67_144_184,0.78,0,184,184,72
6,r_137_105_79,r_61_108_57,r_59_131_134,r_137_105_79,0.54,-22,57,79,72
28,r_133_2_115,r_90_34_169,r_82_50_136,r_90_34_169,1,0,169,169,72
31,r_39_55_97,r_119_101_145,seq29,r_39_55_97,0.56,50,147,97,72
61,seq25,r_14_138_32,r_141_19_58,r_141_19_58,1,15,73,58,73
40,r_147_63_190,r_15_42_15,r_149_33_94,r_147_63_190,0.43,0,190,190,73
23,r_128_109_92,r_58_37_157,seq41,r_58_37_157,0.98,-4,153,157,73
6,r_14_138_32,seq16,seq25,r_14_138_32,1,0,32,32,73
38,r_58_37_157,r_18_35_82,r_128_109_92,r_128_109_92,0.97,1,93,92,73
14,r_26_72_62,seq130,seq120,r_26_72_62,1,0,62,62,73
8,r_32_12_191,seq114,r_70_17_145,r_70_17_145,1,0,145,145,73
19,r_11_30_181,r_146_121_84,seq104,r_11_30_181,0.85,0,181,181,73
77,seq67,r_23_38_65,seq130,r_23_38_65,0.44,49,114,65,73
55,seq10,r_8_56_159,seq65,r_8_56_159,0.99,0,159,159,73
21,r_24_106_104,r_11_30_181,r_14_138_32,r_24_106_104,0.75,1,105,104,73
39,r_108_3_102,r_118_144_125,seq16,r_108_3_102,1,0,102,102,73
5,r_81_101_63,r_61_64_78,seq21,r_81_101_63,0.99,0,63,63,73
46,r_86_110_170,seq27,r_100_66_49,r_86_110_170,0.41,0,170,170,73
45,r_20_136_161,seq1,r_58_37_157,r_20_136_161,0.75,0,161,161,73
19,r_11_30_181,r_24_106_104,r_146_121_84,r_11_30_181,0.97,-75,106,181,73
30,r_0_31_12,seq25,seq114,r_0_31_12,0.99,1,13,12,73
33,r_143_113_156,r_73_75_41,r_92_13_137,r_143_113_156,0.42,0,156,156,73
66,seq40,r_143_113_156,seq130,r_143_113_156,0.63,-46,110,156,73
61,seq25,r_9_119_103,r_14_138_32,r_14_138_32,0.82,15,47,32,73
41,r_8_56_159,seq10,seq76,r_8_56_159,0.83,0,159,159,73
26,r_100_66_49,r_7_94_199,r_118_144_125,r_100_66_49,1,0,49,49,73
3,r_141_19_58,r_137_52_61,seq25,r_141_19_58,1,0,58,58,73
11,r_140_5_33,r_127_139_69,seq1,r_140_5_33,1,1,34,33,73
10,r_99_54_172,seq114,seq22,r_99_54_172,0.4,2,174,172,73
63,seq29,seq6,r_111_36_27,r_111_36_27,1,1,28,27,73
16,r_2_103_11,r_145_83_7,seq82,r_2_103_11,0.36,105,116,11,73
40,r_147_63_190,r_73_75_41,r_15_42_15,r_147_63_190,0.62,-173,17,190,73
89,seq89,seq53,r_123_46_44,r_123_46_44,1,1,45,44,73
78,seq68,seq132,r_61_64_78,r_61_64_78,1,21,99,78,73
23,r_128_109_92,r_2_103_11,r_58_37_157,r_128_109_92,0.83,0,92,92,73
73,seq53,seq89,r_118_144_125,r_118_144_125,1,3,128,125,73
73,seq53,r_92_13_137,seq89,r_92_13_137,0.44,-52,85,137,73
20,r_146_121_84,seq6,seq126,r_146_121_84,1,0,84,84,73
13,r_127_139_69,r_128_109_92,r_28_115_47,r_127_139_69,0.99,0,69,69,73
56,seq142,r_129_116_175,r_92_13_137,r_92_13_137,0.86,15,152,137,73
15,r_4_112_123,seq39,r_108_3_102,r_4_112_123,0.88,2,125,123,73
48,r_45_78_179,r_108_3_102,r_100_66_49,r_45_78_179,0.88,-77,102,179,73
57,seq16,r_149_33_94,seq47,r_149_33_94,0.98,2,96,94,73
90,seq90,seq40,r_23_38_65,r_23_38_65,0.91,0,65,65,73
85,seq82,r_23_38_65,r_2_103_11,r_23_38_65,1,0,65,65,73
12,r_50_62_26,r_111_36_27,seq132,r_50_62_26,0.99,0,26,26,73
31,r_28_115_47,r_4_112_123,r_58_37_157,r_28_115_47,0.94,1,48,47,73
99,seq126,r_11_30_181,r_146_121_84,r_146_121_84,1,0,84,84,73
0,r_85_133_89,seq6,seq87,r_85_133_89,1,-2,87,89,73
87,seq87,seq122,r_85_133_89,r_85_133_89,1,6,95,89,73
22,r_73_75_41,r_143_113_156,r_58_37_157,r_73_75_41,0.73,116,157,41,73
34,r_97_34_51,r_7_94_199,r_135_117_45,r_97_34_51,1,2,53,51,73
2,r_61_64_78,r_81_101_63,seq142,r_81_101_63,0.88,0,63,63,73
49,r_49_125_168,r_135_117_45,seq21,r_49_125_168,1,-123,45,168,73
43,r_15_42_15,r_85_133_89,r_147_63_190,r_15_42_15,1,0,15,15,73
18,r_95_59_101,seq48,seq131,r_95_59_101,0.71,2,103,101,73
23,r_128_109_92,r_127_139_69,r_2_103_11,r_127_139_69,0.96,-14,55,69,73
22,r_73_75_41,seq44,r_143_113_156,r_73_75_41,1,0,41,41,73
24,r_91_93_74,seq114,seq84,r_91_93_74,1,0,74,74,73
0,r_85_133_89,r_15_42_15,seq6,r_15_42_15,0.75,0,15,15,73
67,seq41,r_58_37_157,r_28_115_47,r_28_115_47,0.76,24,71,47,73
25,r_70_17_145,seq134,r_32_12_191,r_70_17_145,0.76,0,145,145,73
26,r_100_66_49,r_45_78_179,r_86_110_170,r_100_66_49,0.97,123,172,49,73
43,r_15_42_15,r_147_63_190,r_91_93_74,r_91_93_74,1,116,190,74,73
48,r_45_78_179,r_100_66_49,r_145_83_7,r_100_66_49,0.5,130,179,49,73
64,seq134,r_70_17_145,r_149_33_94,r_149_33_94,0.99,4,98,94,73
47,r_92_13_137,seq148,seq142,r_92_13_137,0.99,2,139,137,73
4,r_135_117_45,r_147_63_190,r_97_34_51,r_97_34_51,0.86,32,83,51,73
38,r_58_37_157,r_128_109_92,seq130,r_58_37_157,0.75,0,157,157,73
32,r_80_96_124,seq21,seq41,r_80_96_124,0.94,0,124,124,73
77,seq67,seq40,r_23_38_65,r_23_38_65,0.62,29,94,65,73
2,r_61_64_78,seq142,seq68,r_61_64_78,0.89,0,78,78,73
33,r_143_113_156,r_26_72_62,r_73_75_41,r_143_113_156,0.99,-112,44,156,73
29,r_123_46_44,r_11_30_181,seq89,r_123_46_44,1,0,44,44,73
42,r_111_36_27,r_50_62_26,seq29,r_111_36_27,1,0,27,27,73
60,seq22,r_11_30_181,seq126,r_11_30_181,0.39,-102,79,181,73
81,seq74,seq89,r_123_46_44,r_123_46_44,1,41,85,44,73
28,r_118_144_125,r_108_3_102,r_100_66_49,r_100_66_49,0.97,7,56,49,73
17,r_149_33_94,seq16,seq134,r_149_33_94,1,0,94,94,73
9,r_137_52_61,seq71,seq6,r_137_52_61,0.97,0,61,61,73
26,r_100_66_49,r_118_144_125,r_45_78_179,r_118_144_125,0.99,0,125,125,73
16,r_2_103_11,r_4_112_123,r_145_83_7,r_2_103_11,0.92,0,11,11,73
37,r_145_83_7,r_128_109_92,seq82,r_128_109_92,1,0,92,92,73
28,r_118_144_125,r_100_66_49,seq53,r_118_144_125,1,0,125,125,73
31,r_28_115_47,r_58_37_157,r_127_139_69,r_127_139_69,0.8,3,72,69,73
4,r_135_117_45,r_49_125_168,r_147_63_190,r_135_117_45,0.97,0,45,45,73
56,seq142,r_61_64_78,r_129_116_175,r_61_64_78,1,0,78,78,73
44,r_23_38_65,seq82,seq90,r_23_38_65,1,0,65,65,73
82,seq76,seq84,r_8_56_159,r_8_56_159,0.92,0,159,159,73
35,r_9_119_103,seq25,seq16,r_9_119_103,1,0,103,103,73
93,seq120,r_75_36_120,r_31_91_77,r_31_91_77,0.47,0,77,77,74
30,r_27_28_88,r_12_96_119,r_140_130_60,r_12_96_119,0.54,-29,90,119,74
51,seq129,r_69_52_194,r_140_130_60,r_140_130_60,1,0,60,60,74
36,r_18_16_188,seq43,r_48_98_91,r_48_98_91,0.72,97,188,91,74
14,r_31_91_77,r_61_76_178,seq120,r_31_91_77,1,0,77,77,74
43,r_92_40_163,r_146_109_111,r_10_90_184,r_92_40_163,0.32,-98,65,163,74
31,r_1_15_35,r_26_81_156,seq66,r_1_15_35,1,0,35,35,74
98,seq126,r_11_14_58,seq101,r_11_14_58,1,-1,57,58,74
37,r_45_82_74,r_6_145_171,seq89,r_45_82_74,0.99,0,74,74,74
2,r_42_139_59,r_8_117_138,r_85_100_11,r_42_139_59,1,0,59,59,74
59,seq131,seq89,r_30_87_168,r_30_87_168,0.8,2,170,168,74
55,seq137,seq3,r_58_95_139,r_58_95_139,1,-1,138,139,74
86,seq93,seq123,r_34_41_90,r_34_41_90,1,1,91,90,74
21,r_146_109_111,r_136_53_169,r_10_90_184,r_136_53_169,0.9,-11,158,169,74
1,r_113_74_100,r_103_73_152,r_71_88_61,r_71_88_61,0.77,7,68,61,74
83,seq147,r_51_112_48,r_61_76_178,r_51_112_48,1,0,48,48,74
32,r_105_110_16,r_113_74_100,seq77,r_105_110_16,1,0,16,16,74
5,r_10_90_184,seq143,r_7_5_157,r_7_5_157,0.99,28,185,157,74
46,r_142_19_94,seq131,seq128,r_142_19_94,0.99,1,95,94,74
69,seq43,r_18_16_188,r_39_134_86,r_39_134_86,1,102,188,86,74
45,r_75_36_120,seq29,r_69_52_194,r_75_36_120,0.73,-1,119,120,74
10,r_46_106_43,seq137,r_10_90_184,r_46_106_43,0.83,0,43,43,74
70,seq47,seq129,r_119_38_137,r_119_38_137,0.97,2,139,137,74
19,r_69_52_194,r_48_98_91,r_140_130_60,r_69_52_194,1,-103,91,194,74
9,r_51_112_48,seq147,seq4,r_51_112_48,1,0,48,48,74
33,r_26_81_156,r_85_100_11,seq35,r_26_81_156,0.67,0,156,156,74
4,r_83_67_49,seq3,r_12_96_119,r_83_67_49,0.99,2,51,49,74
66,seq33,r_27_28_88,seq116,r_27_28_88,1,2,90,88,74
41,r_149_144_136,r_18_16_188,r_125_62_29,r_149_144_136,0.78,2,138,136,74
25,r_71_88_61,r_7_5_157,seq23,r_7_5_157,0.8,-12,145,157,74
3,r_48_98_91,r_69_52_194,seq101,r_48_98_91,1,0,91,91,74
26,r_0_104_126,seq101,r_56_72_46,r_0_104_126,0.95,0,126,126,74
8,r_56_72_46,r_61_76_178,r_0_104_126,r_0_104_126,0.91,52,178,126,74
72,seq50,r_133_54_104,r_107_111_67,r_107_111_67,1,93,160,67,74
0,r_140_130_60,seq4,seq129,r_140_130_60,0.97,0,60,60,74
73,seq55,r_136_53_169,r_99_97_83,r_99_97_83,1,61,144,83,74
11,r_132_21_2,r_146_109_111,r_99_97_83,r_99_97_83,1,2,85,83,74
20,r_119_38_137,seq77,seq47,r_119_38_137,0.87,-2,135,137,74
13,r_103_73_152,seq23,seq101,r_103_73_152,0.56,0,152,152,74
17,r_44_9_166,r_125_62_29,seq114,r_44_9_166,0.89,1,167,166,74
15,r_99_97_83,seq89,r_132_21_2,r_99_97_83,1,0,83,83,74
48,r_136_53_169,seq55,r_133_54_104,r_136_53_169,0.42,0,169,169,74
4,r_83_67_49,r_12_96_119,seq116,r_12_96_119,1,0,119,119,74
6,r_34_41_90,seq126,seq93,r_34_41_90,1,0,90,90,74
62,seq23,r_103_73_152,r_71_88_61,r_71_88_61,1,95,156,61,74
85,seq89,r_99_97_83,seq131,r_99_97_83,1,-2,81,83,74
27,r_78_2_150,r_8_117_138,r_51_112_48,r_51_112_48,1,90,138,48,74
22,r_125_62_29,seq4,r_149_144_136,r_149_144_136,1,1,137,136,74
34,r_12_96_119,r_27_28_88,r_83_67_49,r_83_67_49,0.68,4,53,49,74
40,r_6_145_171,seq101,r_42_139_59,r_42_139_59,0.37,112,171,59,74
18,r_7_5_157,r_103_73_152,r_71_88_61,r_71_88_61,1,7,68,61,74
29,r_58_95_139,seq13,seq137,r_58_95_139,0.87,0,139,139,74
34,r_12_96_119,r_83_67_49,seq120,r_12_96_119,1,0,119,119,74
35,r_61_76_178,r_56_72_46,seq63,r_61_76_178,0.91,-1,177,178,74
25,r_71_88_61,r_99_97_83,r_113_74_100,r_71_88_61,0.96,0,61,61,74
43,r_92_40_163,r_10_90_184,r_56_72_46,r_92_40_163,0.86,0,163,163,74
88,seq101,r_0_104_126,r_6_145_171,r_0_104_126,0.97,0,126,126,74
70,seq47,r_48_98_91,r_149_144_136,r_48_98_91,0.6,-53,38,91,74
50,seq128,r_58_95_139,r_142_19_94,r_142_19_94,0.44,16,110,94,74
65,seq29,seq86,r_11_14_58,r_11_14_58,1,8,66,58,74
42,r_85_100_11,r_27_28_88,r_26_81_156,r_85_100_11,1,0,11,11,74
17,r_44_9_166,seq4,seq50,r_44_9_166,0.46,-136,30,166,74
42,r_85_100_11,r_26_81_156,r_42_139_59,r_42_139_59,0.75,97,156,59,74
77,seq66,r_18_16_188,r_39_134_86,r_39_134_86,1,56,142,86,74
27,r_78_2_150,r_51_112_48,r_56_72_46,r_78_2_150,0.56,0,150,150,74
33,r_26_81_156,r_1_15_35,r_85_100_11,r_26_81_156,1,-144,12,156,74
81,seq80,r_149_144_136,r_69_52_194,r_149_144_136,0.88,11,147,136,74
10,r_46_106_43,r_10_90_184,seq114,r_46_106_43,0.48,13,56,43,74
28,r_20_17_30,r_108_60_173,seq59,r_20_17_30,0.92,1,31,30,74
49,r_107_111_67,r_27_28_88,seq59,r_107_111_67,1,0,67,67,74
7,r_79_65_73,seq22,r_85_100_11,r_79_65_73,0.84,-8,65,73,74
8,r_56_72_46,seq138,r_61_76_178,r_56_72_46,1,0,46,46,74
18,r_7_5_157,r_71_88_61,r_10_90_184,r_7_5_157,0.8,-2,155,157,74
25,r_71_88_61,r_113_74_100,r_7_5_157,r_113_74_100,1,0,100,100,74
23,r_39_134_86,seq59,seq66,r_39_134_86,1,0,86,86,74
17,r_44_9_166,seq50,r_125_62_29,r_125_62_29,0.35,73,102,29,74
35,r_61_76_178,r_31_91_77,r_56_72_46,r_61_76_178,0.81,-101,77,178,74
12,r_8_117_138,r_78_2_150,seq86,r_8_117_138,0.84,0,138,138,74
84,seq86,seq29,r_8_117_138,r_8_117_138,1,4,142,138,74
38,r_11_14_58,seq126,seq29,r_11_14_58,1,-1,57,58,74
36,r_54_88_33,r_26_3_13,seq132,r_54_88_33,1,-1,32,33,75
51,seq131,seq33,r_124_87_42,r_124_87_42,1,117,159,42,75
4,r_52_136_29,r_115_8_30,r_26_3_13,r_26_3_13,0.6,16,29,13,75
9,r_19_56_5,r_14_28_182,r_125_149_156,r_125_149_156,0.62,24,180,156,75
14,r_48_138_100,seq105,r_17_24_47,r_48_138_100,0.99,0,100,100,75
58,seq148,r_45_141_2,r_18_90_89,r_18_90_89,1,18,107,89,75
43,r_15_126_93,r_85_107_4,r_127_31_10,r_15_126_93,0.97,1,94,93,75
29,r_26_3_13,r_54_88_33,r_52_136_29,r_54_88_33,0.66,-1,32,33,75
54,seq9,seq77,r_68_59_119,r_68_59_119,1,3,122,119,75
83,seq91,seq99,r_44_23_99,r_44_23_99,1,54,153,99,75
37,r_72_35_83,seq71,seq7,r_72_35_83,1,0,83,83,75
19,r_10_50_70,r_95_112_172,r_98_83_23,r_95_112_172,0.92,-19,153,172,75
16,r_101_120_196,r_78_135_167,r_76_21_59,r_76_21_59,1,2,61,59,75
39,r_20_66_96,r_80_129_170,r_60_73_122,r_20_66_96,0.65,0,96,96,75
29,r_26_3_13,seq139,r_54_88_33,r_26_3_13,0.7,0,13,13,75
5,r_44_23_99,r_39_69_165,seq91,r_44_23_99,0.99,0,99,99,75
24,r_127_31_10,seq86,r_20_66_96,r_127_31_10,0.56,30,40,10,75
7,r_98_83_23,r_127_31_10,r_17_24_47,r_17_24_47,0.96,39,86,47,75
94,seq110,r_54_88_33,r_124_87_42,r_54_88_33,0.5,121,154,33,75
45,r_95_112_172,r_80_129_170,r_72_35_83,r_95_112_172,0.53,-2,170,172,75
47,r_104_55_108,seq97,seq118,r_104_55_108,0.96,0,108,108,75
19,r_10_50_70,seq46,r_95_112_172,r_10_50_70,1,0,70,70,75
95,seq111,seq7,r_63_5_90,r_63_5_90,1,6,96,90,75
76,seq74,r_68_59_119,seq97,r_68_59_119,0.96,-1,118,119,75
31,r_57_144_129,seq109,seq111,r_57_144_129,0.88,0,129,129,75
41,r_116_96_181,seq93,r_119_1_16,r_116_96_181,0.31,0,181,181,75
25,r_18_90_89,seq97,seq148,r_18_90_89,0.98,0,89,89,75
17,r_121_30_185,r_54_88_33,r_26_3_13,r_54_88_33,0.98,-1,32,33,75
10,r_61_117_66,r_18_90_89,seq91,r_61_117_66,1,0,66,66,75
26,r_75_147_145,seq99,r_48_138_100,r_75_147_145,0.55,0,145,145,75
14,r_48_138_100,r_17_24_47,r_75_147_145,r_75_147_145,0.92,20,165,145,75
94,seq110,r_76_21_59,r_130_34_115,r_76_21_59,1,0,59,59,75
73,seq64,r_4_137_183,seq36,r_4_137_183,0.58,3,186,183,75
20,r_84_47_155,seq82,seq41,r_84_47_155,0.81,0,155,155,75
13,r_45_141_2,r_32_53_190,r_18_90_89,r_18_90_89,1,101,190,89,75
98,seq118,seq9,r_130_34_115,r_130_34_115,1,3,118,115,75
15,r_145_13_131,r_0_142_132,r_10_50_70,r_0_142_132,0.63,-1,131,132,75
94,seq110,r_130_34_115,r_54_88_33,r_130_34_115,0.79,0,115,115,75
49,r_14_28_182,r_19_56_5,r_44_23_99,r_19_56_5,0.37,177,182,5,75
6,r_130_34_115,seq110,seq118,r_130_34_115,0.92,0,115,115,75
94,seq110,r_124_87_42,r_57_144_129,r_124_87_42,0.69,140,182,42,75
85,seq93,r_116_96_181,seq105,r_116_96_181,0.4,0,181,181,75
72,seq62,seq113,r_119_1_16,r_119_1_16,1,1,17,16,75
27,r_146_134_110,r_68_59_119,seq29,r_146_134_110,0.98,0,110,110,75
87,seq97,r_61_117_66,r_104_55_108,r_61_117_66,1,-6,60,66,75
2,r_78_135_167,r_101_120_196,r_60_73_122,r_78_135_167,0.63,2,169,167,75
47,r_104_55_108,r_61_117_66,seq97,r_61_117_66,1,-6,60,66,75
40,r_51_11_153,seq37,r_98_83_23,r_51_11_153,0.74,0,153,153,75
34,r_39_69_165,seq43,r_98_83_23,r_39_69_165,0.99,1,166,165,75
25,r_18_90_89,r_61_117_66,seq97,r_61_117_66,0.98,-6,60,66,75
24,r_127_31_10,r_20_66_96,r_15_126_93,r_127_31_10,1,84,94,10,75
33,r_63_5_90,seq91,seq111,r_63_5_90,1,0,90,90,75
48,r_85_107_4,r_15_126_93,seq97,r_15_126_93,0.75,0,93,93,75
48,r_85_107_4,seq97,r_60_73_122,r_60_73_122,0.98,1,123,122,75
7,r_98_83_23,seq148,r_127_31_10,r_98_83_23,0.96,0,23,23,75
18,r_17_24_47,seq36,r_98_83_23,r_17_24_47,1,0,47,47,75
70,seq49,seq82,r_122_40_37,r_122_40_37,0.97,68,105,37,75
42,r_119_1_16,seq97,seq62,r_119_1_16,0.96,0,16,16,75
0,r_25_12_18,r_14_28_182,seq9,r_25_12_18,0.79,1,19,18,75
87,seq97,r_104_55_108,r_85_107_4,r_104_55_108,1,0,108,108,75
68,seq43,r_39_69_165,seq7,r_39_69_165,0.96,2,167,165,75
38,r_80_129_170,r_95_112_172,seq97,r_95_112_172,0.57,-2,170,172,75
76,seq74,seq97,r_121_30_185,r_121_30_185,0.58,-1,184,185,75
34,r_39_69_165,r_44_23_99,seq43,r_44_23_99,1,0,99,99,75
81,seq86,r_80_129_170,r_127_31_10,r_127_31_10,0.38,13,23,10,75
75,seq71,r_72_35_83,r_19_56_5,r_72_35_83,1,2,85,83,75
69,seq46,r_10_50_70,seq70,r_10_50_70,0.66,-25,45,70,75
87,seq97,r_85_107_4,r_80_129_170,r_80_129_170,0.85,10,180,170,75
24,r_127_31_10,r_10_50_70,seq86,r_127_31_10,0.82,0,10,10,75
15,r_145_13_131,r_10_50_70,r_98_83_23,r_145_13_131,0.55,43,174,131,75
39,r_20_66_96,r_60_73_122,r_0_142_132,r_20_66_96,0.99,26,122,96,75
52,seq132,seq111,r_54_88_33,r_54_88_33,0.69,-1,32,33,75
46,r_76_21_59,seq110,r_101_120_196,r_76_21_59,1,0,59,59,75
22,r_16_67_159,seq29,seq27,r_16_67_159,0.84,0,159,159,75
28,r_106_65_175,seq38,r_26_3_13,r_106_65_175,0.46,3,178,175,75
91,seq105,r_48_138_100,seq93,r_48_138_100,0.73,0,100,100,75
81,seq86,r_127_31_10,r_98_83_23,r_98_83_23,0.45,-146,23,169,75
44,r_32_53_190,r_45_141_2,r_57_144_129,r_57_144_129,0.98,61,190,129,75
21,r_2_102_45,r_124_87_42,r_119_1_16,r_2_102_45,0.52,-3,42,45,75
23,r_125_149_156,seq33,r_19_56_5,r_19_56_5,0.56,151,156,5,75
3,r_122_40_37,seq143,seq89,r_122_40_37,1,0,37,37,75
75,seq71,r_19_56_5,seq81,r_19_56_5,0.36,177,182,5,75
79,seq81,r_72_35_83,seq77,r_72_35_83,0.97,-12,71,83,75
35,r_60_73_122,r_20_66_96,r_85_107_4,r_60_73_122,0.79,0,122,122,75
12,r_0_142_132,r_145_13_131,r_20_66_96,r_0_142_132,0.99,0,132,132,75
32,r_124_87_42,r_2_102_45,seq131,r_124_87_42,1,0,42,42,75
36,r_54_88_33,r_121_30_185,r_26_3_13,r_26_3_13,0.8,0,13,13,75
78,seq79,r_52_136_29,r_76_21_59,r_52_136_29,0.53,158,187,29,75
93,seq112,seq15,r_100_59_86,r_100_59_86,0.98,5,91,86,76
92,seq109,seq143,r_96_31_61,r_96_31_61,0.98,4,65,61,76
42,r_78_123_57,seq137,seq14,r_78_123_57,1,0,57,57,76
46,r_58_68_11,r_51_94_105,r_88_110_170,r_58_68_11,0.73,0,11,11,76
37,r_38_82_91,r_120_36_55,r_126_138_39,r_38_82_91,0.95,-41,50,91,76
30,r_126_138_39,r_52_6_180,r_38_82_91,r_126_138_39,0.89,0,39,39,76
71,seq56,r_40_1_125,r_91_72_42,r_91_72_42,0.59,82,124,42,76
34,r_80_93_41,r_120_36_55,r_53_144_18,r_120_36_55,0.54,-13,42,55,76
1,r_51_94_105,seq125,seq99,r_51_94_105,0.96,0,105,105,76
5,r_81_116_88,seq5,r_100_59_86,r_81_116_88,0.99,1,89,88,76
37,r_38_82_91,r_126_138_39,seq45,r_38_82_91,1,0,91,91,76
7,r_13_44_4,r_18_108_112,r_145_34_109,r_13_44_4,0.98,108,112,4,76
14,r_64_32_153,seq20,r_29_133_159,r_64_32_153,0.53,-107,46,153,76
45,r_75_147_77,r_4_0_197,r_54_2_134,r_75_147_77,1,0,77,77,76
45,r_75_147_77,r_54_2_134,seq122,r_54_2_134,1,2,136,134,76
24,r_91_72_42,r_40_1_125,r_18_108_112,r_91_72_42,0.94,83,125,42,76
19,r_22_74_119,seq134,r_115_146_108,r_22_74_119,0.92,2,121,119,76
21,r_142_16_29,seq143,r_58_68_11,r_142_16_29,0.94,1,30,29,76
33,r_118_73_175,seq79,seq71,r_118_73_175,0.83,3,178,175,76
8,r_53_144_18,r_80_93_41,seq76,r_53_144_18,0.71,0,18,18,76
66,seq41,seq66,r_90_101_64,r_90_101_64,1,28,92,64,76
36,r_102_39_164,seq66,r_86_9_40,r_86_9_40,1,4,44,40,76
31,r_121_135_111,r_115_146_108,seq63,r_121_135_111,0.44,-20,91,111,76
67,seq45,seq46,r_38_82_91,r_38_82_91,1,11,102,91,76
24,r_91_72_42,r_55_7_104,r_40_1_125,r_91_72_42,1,1,43,42,76
61,seq20,r_141_132_196,r_148_42_17,r_148_42_17,0.63,11,28,17,76
30,r_126_138_39,r_38_82_91,r_65_85_53,r_38_82_91,0.97,0,91,91,76
80,seq76,r_40_1_125,r_53_144_18,r_53_144_18,0.88,21,39,18,76
10,r_114_30_80,r_54_2_134,r_142_16_29,r_114_30_80,1,0,80,80,76
90,seq104,r_100_59_86,seq87,r_100_59_86,0.98,1,87,86,76
14,r_64_32_153,r_29_133_159,r_38_82_91,r_64_32_153,0.82,0,153,153,76
0,r_145_34_109,r_98_37_161,r_23_17_69,r_98_37_161,0.82,-52,109,161,76
73,seq61,r_23_17_69,seq113,r_23_17_69,1,0,69,69,76
11,r_40_1_125,seq46,seq10,r_40_1_125,0.9,0,125,125,76
8,r_53_144_18,seq76,r_80_93_41,r_80_93_41,1,8,49,41,76
13,r_54_2_134,r_114_30_80,r_75_147_77,r_54_2_134,1,-54,80,134,76
46,r_58_68_11,r_88_110_170,r_114_30_80,r_114_30_80,1,86,166,80,76
48,r_23_17_69,seq61,r_13_44_4,r_23_17_69,0.98,0,69,69,76
49,r_86_9_40,r_102_39_164,seq41,r_102_39_164,0.93,-1,163,164,76
4,r_88_110_170,r_58_68_11,r_126_138_39,r_58_68_11,0.57,159,170,11,76
43,r_95_70_79,r_120_36_55,seq103,r_95_70_79,0.91,0,79,79,76
6,r_98_37_161,r_4_0_197,r_75_147_77,r_75_147_77,1,84,161,77,76
21,r_142_16_29,r_58_68_11,r_114_30_80,r_114_30_80,1,45,125,80,76
20,r_148_42_17,seq12,seq20,r_148_42_17,0.88,1,18,17,76
31,r_121_135_111,seq63,seq87,r_121_135_111,0.95,1,112,111,76
9,r_130_21_199,r_96_31_61,r_117_35_185,r_96_31_61,1,-2,59,61,76
36,r_102_39_164,r_86_9_40,r_78_123_57,r_102_39_164,0.94,0,164,164,76
47,r_120_36_55,r_95_70_79,seq137,r_95_70_79,0.95,1,80,79,76
13,r_54_2_134,r_75_147_77,r_23_17_69,r_54_2_134,0.97,0,134,134,76
35,r_11_97_24,r_145_34_109,seq129,r_11_97_24,1,0,24,24,76
2,r_84_139_163,seq60,seq113,r_84_139_163,0.88,0,163,163,76
17,r_149_43_20,seq143,r_53_144_18,r_149_43_20,0.72,35,55,20,76
47,r_120_36_55,seq137,r_105_140_168,r_105_140_168,0.55,9,177,168,76
25,r_90_101_64,seq26,seq41,r_90_101_64,1,1,65,64,76
48,r_23_17_69,r_13_44_4,r_145_34_109,r_145_34_109,1,27,136,109,76
43,r_95_70_79,r_107_27_37,r_78_123_57,r_107_27_37,0.68,0,37,37,76
50,seq128,r_52_6_180,r_55_7_104,r_55_7_104,1,77,181,104,76
70,seq50,seq62,r_65_85_53,r_65_85_53,1,11,64,53,76
32,r_4_0_197,r_75_147_77,seq124,r_75_147_77,1,0,77,77,76
38,r_115_146_108,r_121_135_111,seq67,r_115_146_108,1,0,108,108,76
77,seq67,seq49,r_115_146_108,r_115_146_108,1,17,125,108,76
15,r_8_19_12,seq77,seq5,r_8_19_12,0.94,0,12,12,76
18,r_141_132_196,seq20,r_84_139_163,r_141_132_196,0.6,-150,46,196,76
83,seq83,r_117_35_185,r_29_133_159,r_117_35_185,0.48,-77,108,185,76
4,r_88_110_170,r_91_72_42,r_58_68_11,r_88_110_170,0.68,-159,11,170,76
47,r_120_36_55,r_38_82_91,r_95_70_79,r_120_36_55,0.98,0,55,55,76
49,r_86_9_40,r_18_108_112,r_102_39_164,r_86_9_40,1,0,40,40,76
94,seq113,r_55_7_104,seq87,r_55_7_104,0.99,1,105,104,76
83,seq83,seq12,r_117_35_185,r_117_35_185,0.56,-111,74,185,76
29,r_18_108_112,r_13_44_4,r_91_72_42,r_18_108_112,0.96,0,112,112,76
28,r_100_59_86,seq104,seq112,r_100_59_86,0.86,0,86,86,76
43,r_95_70_79,r_78_123_57,r_120_36_55,r_120_36_55,0.6,0,55,55,76
18,r_141_132_196,r_84_139_163,seq20,r_84_139_163,0.86,-39,124,163,76
44,r_55_7_104,seq113,seq128,r_55_7_104,0.93,0,104,104,76
41,r_65_85_53,seq10,seq50,r_65_85_53,1,0,53,53,76
23,r_96_31_61,r_130_21_199,seq109,r_96_31_61,1,0,61,61,76
94,seq113,seq87,r_84_139_163,r_84_139_163,0.94,6,169,163,76
82,seq79,r_105_140_168,seq26,r_105_140_168,0.95,0,168,168,76
79,seq71,r_117_35_185,r_118_73_175,r_117_35_185,0.78,-25,160,185,76
12,r_52_6_180,seq128,r_86_9_40,r_52_6_180,0.62,0,180,180,76
49,r_86_9_40,seq41,r_52_6_180,r_52_6_180,0.8,1,181,180,76
51,seq3,r_116_136_176,r_89_134_12,r_89_134_12,0.64,165,177,12,77
36,r_102_99_152,r_135_119_180,seq46,r_135_119_180,0.35,-26,154,180,77
25,r_83_104_18,r_57_1_194,r_32_107_143,r_57_1_194,0.88,-166,28,194,77
28,r_20_58_16,r_121_147_155,seq74,r_20_58_16,0.8,-1,15,16,77
14,r_143_92_62,r_133_66_85,r_117_44_65,r_143_92_62,1,3,65,62,77
53,seq5,r_55_124_160,seq25,r_55_124_160,0.99,0,160,160,77
43,r_71_35_91,r_48_62_124,seq45,r_71_35_91,1,0,91,91,77
54,seq6,r_29_79_154,r_91_53_45,r_91_53_45,0.98,109,154,45,77
71,seq45,seq27,r_71_35_91,r_71_35_91,1,3,94,91,77
39,r_34_41_112,seq139,r_106_138_31,r_34_41_112,1,0,112,112,77
5,r_117_44_65,r_116_136_176,r_143_92_62,r_117_44_65,1,0,65,65,77
46,r_39_128_109,seq94,r_135_119_180,r_39_128_109,0.98,1,110,109,77
90,seq94,r_106_138_31,r_89_134_12,r_106_138_31,1,-8,23,31,77
22,r_49_144_158,r_40_4_74,seq52,r_40_4_74,0.94,-18,56,74,77
24,r_135_119_180,seq15,r_83_104_18,r_135_119_180,0.96,0,180,180,77
40,r_10_96_51,r_148_64_137,seq51,r_10_96_51,0.99,0,51,51,77
19,r_133_66_85,r_143_92_62,r_121_147_155,r_143_92_62,0.82,0,62,62,77
41,r_82_141_106,seq129,seq38,r_82_141_106,1,0,106,106,77
3,r_17_111_142,seq73,seq52,r_17_111_142,0.81,0,142,142,77
10,r_40_4_74,r_54_114_197,seq146,r_40_4_74,0.92,-4,70,74,77
26,r_30_16_120,seq122,seq93,r_30_16_120,0.93,0,120,120,77
0,r_148_64_137,r_10_96_51,seq11,r_10_96_51,0.98,12,63,51,77
73,seq47,r_60_7_129,r_57_1_194,r_60_7_129,1,-12,117,129,77
11,r_90_130_190,seq140,r_121_147_155,r_121_147_155,0.88,2,157,155,77
20,r_108_61_6,r_84_103_178,seq24,r_108_61_6,0.48,174,180,6,77
13,r_137_80_167,seq129,r_39_128_109,r_137_80_167,0.76,0,167,167,77
46,r_39_128_109,r_135_119_180,r_137_80_167,r_39_128_109,0.83,71,180,109,77
30,r_113_76_100,r_28_68_186,seq100,r_113_76_100,0.53,-89,11,100,77
33,r_67_0_41,seq115,seq100,r_67_0_41,0.76,0,41,41,77
15,r_48_62_124,seq88,r_116_136_176,r_48_62_124,0.78,1,125,124,77
57,seq13,seq75,r_109_12_81,r_109_12_81,1,0,81,81,77
15,r_48_62_124,r_116_136_176,r_65_131_173,r_48_62_124,0.98,49,173,124,77
6,r_9_126_132,seq115,r_28_68_186,r_9_126_132,0.79,-20,112,132,77
99,seq123,seq93,r_50_69_63,r_50_69_63,1,31,94,63,77
0,r_148_64_137,seq11,r_83_104_18,r_148_64_137,0.99,0,137,137,77
27,r_109_12_81,r_143_92_62,seq13,r_109_12_81,0.89,0,81,81,77
30,r_113_76_100,seq100,seq132,r_113_76_100,0.99,0,100,100,77
22,r_49_144_158,seq52,r_39_128_109,r_39_128_109,1,30,139,109,77
74,seq51,seq142,r_10_96_51,r_10_96_51,1,49,100,51,77
29,r_84_103_178,r_108_61_6,r_9_126_132,r_9_126_132,0.58,46,178,132,77
38,r_120_23_30,seq132,seq85,r_120_23_30,1,0,30,30,77
35,r_21_59_136,seq24,seq93,r_21_59_136,0.86,0,136,136,77
11,r_90_130_190,r_121_147_155,seq72,r_121_147_155,0.59,35,190,155,77
47,r_29_79_154,seq6,r_91_53_45,r_91_53_45,1,6,51,45,77
19,r_133_66_85,r_121_147_155,r_9_126_132,r_133_66_85,1,0,85,85,77
50,seq129,r_137_80_167,seq74,r_137_80_167,1,0,167,167,77
6,r_9_126_132,r_28_68_186,r_55_124_160,r_55_124_160,0.81,26,186,160,77
65,seq25,r_101_127_140,seq5,r_101_127_140,1,-10,130,140,77
64,seq24,seq77,r_21_59_136,r_21_59_136,0.82,-109,27,136,77
32,r_121_147_155,r_90_130_190,seq140,r_90_130_190,0.96,0,190,190,77
32,r_121_147_155,seq5,r_90_130_190,r_121_147_155,0.48,0,155,155,77
52,seq132,r_18_31_165,r_113_76_100,r_113_76_100,0.88,64,164,100,77
21,r_54_114_197,r_40_4_74,seq52,r_40_4_74,0.99,-18,56,74,77
34,r_18_31_165,seq132,r_34_41_112,r_18_31_165,0.69,0,165,165,77
64,seq24,r_21_59_136,r_108_61_6,r_21_59_136,0.92,-23,113,136,77
75,seq52,r_40_4_74,seq88,r_40_4_74,0.94,-13,61,74,77
1,r_106_138_31,seq94,seq122,r_106_138_31,0.81,0,31,31,77
81,seq75,seq13,r_109_12_81,r_109_12_81,1,0,81,81,77
55,seq11,r_48_62_124,seq47,r_48_62_124,0.69,60,184,124,77
17,r_105_2_94,r_18_31_165,seq100,r_105_2_94,0.99,-2,92,94,77
25,r_83_104_18,r_32_107_143,r_148_64_137,r_83_104_18,0.74,117,135,18,77
72,seq46,seq110,r_102_99_152,r_102_99_152,0.45,26,178,152,77
35,r_21_59_136,r_84_103_178,seq24,r_21_59_136,0.46,-101,35,136,77
37,r_65_131_173,r_28_68_186,r_48_62_124,r_65_131_173,0.87,0,173,173,77
23,r_28_68_186,r_9_126_132,seq36,r_28_68_186,0.69,1,187,186,77
49,r_50_69_63,seq85,seq123,r_50_69_63,1,0,63,63,77
56,seq140,r_90_130_190,r_108_61_6,r_90_130_190,0.54,-1,189,190,77
23,r_28_68_186,r_65_131_173,r_9_126_132,r_28_68_186,0.62,-53,133,186,77
75,seq52,seq88,r_17_111_142,r_17_111_142,1,2,144,142,77
79,seq73,r_17_111_142,seq77,r_17_111_142,0.5,1,143,142,77
84,seq81,r_135_119_180,seq146,r_135_119_180,0.62,-47,133,180,77
30,r_122_96_114,seq144,seq78,r_122_96_114,0.93,1,115,114,78
44,r_49_61_172,r_56_65_31,r_120_126_161,r_120_126_161,0.95,-11,150,161,78
69,seq38,r_114_7_62,r_17_147_21,r_114_7_62,0.88,-11,51,62,78
66,seq133,seq10,r_31_106_128,r_31_106_128,1,0,128,128,78
14,r_137_146_134,r_62_125_23,r_16_140_190,r_137_146_134,0.52,0,134,134,78
49,r_118_39_78,seq78,r_2_11_98,r_118_39_78,0.64,0,78,78,78
8,r_56_65_31,r_104_34_193,r_49_61_172,r_56_65_31,1,0,31,31,78
87,seq78,seq127,r_86_108_145,r_86_108_145,0.46,-116,29,145,78
54,seq5,r_149_141_112,seq102,r_149_141_112,1,0,112,112,78
37,r_16_140_190,r_49_61_172,r_56_65_31,r_56_65_31,0.92,29,60,31,78
59,seq12,r_53_73_108,seq66,r_53_73_108,1,1,109,108,78
21,r_98_88_194,r_77_25_152,r_94_99_29,r_98_88_194,0.74,-37,157,194,78
1,r_9_92_85,r_24_42_196,r_95_135_27,r_9_92_85,1,0,85,85,78
5,r_114_7_62,seq38,r_3_129_60,r_114_7_62,0.99,0,62,62,78
46,r_115_145_186,seq0,seq10,r_115_145_186,0.47,0,186,186,78
31,r_94_99_29,seq13,r_98_88_194,r_94_99_29,0.98,0,29,29,78
49,r_118_39_78,r_2_11_98,seq133,r_2_11_98,0.72,1,99,98,78
45,r_76_48_178,seq93,r_86_108_145,r_76_48_178,0.65,0,178,178,78
19,r_101_123_141,r_104_34_193,seq144,r_101_123_141,0.58,0,141,141,78
44,r_49_61_172,r_16_140_190,r_56_65_31,r_56_65_31,0.67,15,46,31,78
66,seq133,r_3_129_60,seq10,r_3_129_60,1,0,60,60,78
41,r_113_138_136,r_24_42_196,r_60_44_130,r_113_138_136,0.58,-3,133,136,78
18,r_2_11_98,r_137_146_134,r_53_73_108,r_2_11_98,0.8,11,109,98,78
10,r_104_34_193,r_101_123_141,r_3_129_60,r_3_129_60,1,81,141,60,78
36,r_19_63_32,seq57,r_75_45_149,r_19_63_32,0.99,-3,29,32,78
26,r_112_33_156,seq36,r_81_14_84,r_112_33_156,0.55,0,156,156,78
8,r_56_65_31,r_49_61_172,r_120_126_161,r_56_65_31,0.79,115,146,31,78
4,r_95_135_27,seq37,r_9_92_85,r_95_135_27,0.98,58,85,27,78
49,r_118_39_78,seq133,r_86_108_145,r_86_108_145,0.75,21,166,145,78
62,seq144,seq68,r_101_123_141,r_101_123_141,0.95,10,151,141,78
0,r_35_71_153,seq119,r_77_25_152,r_77_25_152,0.81,4,156,152,78
11,r_1_121_124,seq124,seq117,r_1_121_124,0.71,0,124,124,78
15,r_69_97_158,seq51,seq22,r_69_97_158,0.63,0,158,158,78
57,seq10,r_81_14_84,seq139,r_81_14_84,1,-14,70,84,78
12,r_32_85_81,seq89,r_75_45_149,r_75_45_149,1,36,185,149,78
6,r_47_128_101,r_109_103_191,seq55,r_47_128_101,1,1,102,101,78
44,r_49_61_172,r_120_126_161,r_2_11_98,r_49_61_172,0.96,1,173,172,78
62,seq144,r_122_96_114,seq68,r_122_96_114,0.57,0,114,114,78
76,seq54,r_81_14_84,seq70,r_81_14_84,0.87,-54,30,84,78
85,seq72,r_81_14_84,r_142_79_164,r_81_14_84,0.93,-7,77,84,78
2,r_75_45_149,r_19_63_32,seq89,r_75_45_149,0.77,0,149,149,78
36,r_19_63_32,r_75_45_149,seq139,r_75_45_149,0.96,1,150,149,78
27,r_18_52_68,r_53_73_108,seq64,r_18_52_68,1,0,68,68,78
18,r_2_11_98,r_118_39_78,r_137_146_134,r_2_11_98,0.94,0,98,98,78
47,r_31_106_128,seq84,seq133,r_31_106_128,0.72,1,129,128,78
40,r_3_129_60,seq133,r_104_34_193,r_3_129_60,1,0,60,60,78
14,r_137_146_134,r_16_140_190,r_56_65_31,r_16_140_190,0.86,-7,183,190,78
18,r_2_11_98,seq139,r_118_39_78,r_118_39_78,0.48,-1,77,78,78
29,r_77_25_152,r_98_88_194,r_80_100_199,r_77_25_152,0.88,0,152,152,78
24,r_149_141_112,seq5,r_53_73_108,r_149_141_112,0.89,0,112,112,78
43,r_30_91_8,r_17_147_21,r_83_67_75,r_83_67_75,1,37,112,75,78
2,r_75_45_149,seq54,r_19_63_32,r_19_63_32,1,-2,30,32,78
33,r_81_14_84,seq10,seq6,r_81_14_84,0.98,1,85,84,78
50,seq0,r_115_145_186,seq50,r_115_145_186,0.87,0,186,186,78
61,seq15,r_60_44_130,seq130,r_60_44_130,1,0,130,130,78
32,r_4_82_179,r_120_126_161,seq74,r_4_82_179,0.51,-17,162,179,78
52,seq131,r_104_34_193,r_4_82_179,r_4_82_179,0.61,0,179,179,78
77,seq55,r_20_107_118,seq38,r_20_107_118,1,0,118,118,78
34,r_109_103_191,r_47_128_101,seq59,r_47_128_101,0.91,0,101,101,78
37,r_16_140_190,r_137_146_134,seq66,r_16_140_190,0.8,0,190,190,78
75,seq51,r_69_97_158,seq119,r_69_97_158,0.94,2,160,158,78
25,r_62_125_23,seq70,r_137_146_134,r_62_125_23,0.87,0,23,23,78
81,seq64,seq38,r_18_52_68,r_18_52_68,1,30,98,68,78
17,r_60_44_130,seq15,r_113_138_136,r_60_44_130,0.97,0,130,130,78
25,r_62_125_23,r_137_146_134,r_53_73_108,r_62_125_23,0.94,85,108,23,78
78,seq57,r_109_103_191,seq59,r_109_103_191,0.55,-8,183,191,78
9,r_53_73_108,seq12,r_2_11_98,r_53_73_108,0.97,1,109,108,78
96,seq117,seq43,r_1_121_124,r_1_121_124,0.97,1,125,124,78
31,r_94_99_29,r_98_88_194,r_116_29_182,r_94_99_29,0.32,154,183,29,78
37,r_16_140_190,r_56_65_31,r_137_146_134,r_137_146_134,1,12,146,134,78
22,r_20_107_118,seq55,r_53_73_108,r_20_107_118,0.97,0,118,118,78
28,r_83_67_75,seq36,r_30_91_8,r_83_67_75,0.94,0,75,75,78
91,seq93,r_76_48_178,seq84,r_76_48_178,0.86,0,178,178,78
42,r_17_147_21,seq38,r_30_91_8,r_30_91_8,0.91,13,21,8,78
7,r_116_29_182,r_104_34_193,r_94_99_29,r_116_29_182,0.37,0,182,182,78
35,r_120_126_161,r_4_82_179,r_56_65_31,r_56_65_31,0.57,130,161,31,78
12,r_32_85_81,seq93,seq89,r_32_85_81,0.99,0,81,81,78
40,r_13_21_156,r_137_101_29,seq65,r_13_21_156,0.79,0,156,156,79
30,r_20_76_69,r_13_21_156,r_90_17_19,r_20_76_69,1,0,69,69,79
35,r_53_43_151,r_121_27_95,seq4,r_53_43_151,0.96,1,152,151,79
25,r_123_23_48,seq132,r_137_101_29,r_123_23_48,1,0,48,48,79
14,r_77_30_128,seq15,seq62,r_77_30_128,0.54,0,128,128,79
8,r_109_81_93,seq145,r_56_87_148,r_109_81_93,0.93,0,93,93,79
43,r_19_126_137,r_53_43_151,r_100_66_150,r_53_43_151,0.44,-13,138,151,79
43,r_19_126_137,seq94,seq145,r_19_126_137,0.64,36,173,137,79
37,r_40_42_125,seq4,seq38,r_40_42_125,0.98,0,125,125,79
19,r_100_66_150,seq96,seq97,r_100_66_150,1,0,150,150,79
16,r_41_34_61,seq82,r_6_22_185,r_41_34_61,1,0,61,61,79
21,r_115_130_165,r_69_78_102,r_121_27_95,r_115_130_165,0.99,-63,102,165,79
1,r_60_9_68,r_121_27_95,seq3,r_60_9_68,1,0,68,68,79
52,seq3,r_60_9_68,r_133_131_81,r_133_131_81,1,6,87,81,79
3,r_144_148_116,r_1_142_96,r_140_89_97,r_144_148_116,0.85,-18,98,116,79
46,r_106_18_16,seq55,r_140_89_97,r_106_18_16,0.47,0,16,16,79
83,seq72,seq105,r_77_30_128,r_77_30_128,0.75,59,187,128,79
45,r_99_86_172,seq113,r_40_42_125,r_40_42_125,0.95,47,172,125,79
8,r_109_81_93,r_56_87_148,seq49,r_56_87_148,1,0,148,148,79
19,r_100_66_150,r_73_75_83,seq96,r_73_75_83,0.89,1,84,83,79
17,r_121_27_95,r_53_43_151,r_93_50_114,r_53_43_151,0.91,1,152,151,79
33,r_136_64_46,r_32_91_152,r_98_138_17,r_136_64_46,0.62,105,151,46,79
11,r_12_58_47,seq59,r_32_91_152,r_32_91_152,0.97,3,155,152,79
27,r_134_108_10,r_39_143_119,r_98_138_17,r_39_143_119,1,0,119,119,79
66,seq38,seq70,r_99_86_172,r_99_86_172,0.36,-81,91,172,79
43,r_19_126_137,r_100_66_150,seq94,r_19_126_137,0.5,16,153,137,79
38,r_137_101_29,r_13_21_156,r_123_23_48,r_137_101_29,0.87,127,156,29,79
39,r_118_68_57,seq79,r_124_146_120,r_124_146_120,1,55,175,120,79
31,r_125_5_79,seq111,seq48,r_125_5_79,1,0,79,79,79
86,seq82,r_41_34_61,seq112,r_41_34_61,1,-9,52,61,79
88,seq84,r_85_92_100,r_115_130_165,r_115_130_165,0.85,1,166,165,79
26,r_116_141_140,seq97,r_125_5_79,r_116_141_140,0.74,1,141,140,79
72,seq55,seq79,r_118_68_57,r_118_68_57,1,14,71,57,79
23,r_104_28_91,r_1_142_96,r_144_148_116,r_144_148_116,0.75,-82,34,116,79
11,r_12_58_47,r_115_130_165,seq59,r_12_58_47,1,1,48,47,79
4,r_36_120_122,seq46,r_102_95_20,r_36_120_122,1,0,122,122,79
0,r_74_29_60,seq3,r_52_114_187,r_74_29_60,1,0,60,60,79
38,r_137_101_29,seq94,r_13_21_156,r_137_101_29,1,0,29,29,79
20,r_26_103_189,seq111,r_53_43_151,r_53_43_151,0.58,38,189,151,79
48,r_6_22_185,seq94,r_41_34_61,r_41_34_61,1,99,160,61,79
13,r_32_91_152,r_136_64_46,r_12_58_47,r_32_91_152,0.93,1,153,152,79
6,r_133_131_81,seq128,seq3,r_133_131_81,1,0,81,81,79
21,r_115_130_165,r_121_27_95,seq84,r_115_130_165,0.96,0,165,165,79
46,r_106_18_16,r_140_89_97,r_137_101_29,r_106_18_16,0.96,19,35,16,79
99,seq122,seq2,r_109_81_93,r_109_81_93,0.95,95,188,93,79
94,seq111,r_26_103_189,r_102_95_20,r_102_95_20,0.82,25,45,20,79
81,seq70,r_134_108_10,seq38,r_134_108_10,0.57,0,10,10,79
33,r_136_64_46,r_93_50_114,r_32_91_152,r_32_91_152,0.89,-106,46,152,79
22,r_93_50_114,seq84,r_121_27_95,r_93_50_114,0.77,0,114,114,79
36,r_139_54_45,r_85_92_100,seq45,r_139_54_45,1,0,45,45,79
40,r_13_21_156,r_20_76_69,r_137_101_29,r_13_21_156,0.74,-87,69,156,79
29,r_8_31_70,seq59,r_52_114_187,r_8_31_70,0.98,0,70,70,79
15,r_90_17_19,r_77_30_128,seq132,r_90_17_19,0.92,-1,18,19,79
24,r_102_95_20,r_93_50_114,seq111,r_102_95_20,0.99,0,20,20,79
5,r_135_51_28,r_124_146_120,seq94,r_135_51_28,0.68,0,28,28,79
23,r_104_28_91,r_144_148_116,seq149,r_104_28_91,1,-2,89,91,79
64,seq35,seq67,r_73_75_83,r_73_75_83,1,1,84,83,79
47,r_39_143_119,r_134_108_10,seq62,r_39_143_119,0.97,0,119,119,79
90,seq96,r_100_66_150,seq147,r_100_66_150,0.66,-1,149,150,79
7,r_98_138_17,seq35,r_134_108_10,r_98_138_17,0.55,0,17,17,79
39,r_118_68_57,r_39_143_119,seq79,r_118_68_57,0.98,0,57,57,79
42,r_0_44_18,r_56_87_148,r_109_81_93,r_109_81_93,0.84,37,130,93,79
32,r_56_87_148,seq132,seq94,r_56_87_148,0.72,0,148,148,79
52,seq3,r_74_29_60,r_60_9_68,r_60_9_68,0.53,0,68,68,79
34,r_140_89_97,seq117,r_125_5_79,r_140_89_97,1,1,98,97,79
91,seq97,r_1_142_96,r_100_66_150,r_100_66_150,0.99,2,152,150,79
47,r_39_143_119,r_118_68_57,r_134_108_10,r_118_68_57,1,0,57,57,79
17,r_121_27_95,seq11,r_53_43_151,r_121_27_95,1,0,95,95,79
13,r_32_91_152,r_125_5_79,r_136_64_46,r_32_91_152,0.98,-106,46,152,79
18,r_124_146_120,r_135_51_28,seq112,r_135_51_28,0.94,0,28,28,79
95,seq112,r_41_34_61,seq82,r_41_34_61,1,-30,31,61,79
28,r_73_75_83,r_100_66_150,seq35,r_73_75_83,1,0,83,83,79
91,seq97,r_116_141_140,r_1_142_96,r_1_142_96,0.98,38,134,96,79
49,r_52_114_187,seq117,r_8_31_70,r_8_31_70,1,3,73,70,79
3,r_144_148_116,r_69_78_102,r_1_142_96,r_1_142_96,0.45,-40,56,96,79
18,r_124_146_120,seq112,r_118_68_57,r_124_146_120,0.75,1,121,120,79
42,r_0_44_18,seq62,r_56_87_148,r_0_44_18,0.91,0,18,18,79
35,r_53_43_151,r_19_126_137,r_121_27_95,r_121_27_95,1,36,131,95,79
3,r_144_148_116,r_140_89_97,seq112,r_144_148_116,0.98,0,116,116,79
22,r_93_50_114,r_102_95_20,seq84,r_102_95_20,0.78,0,20,20,79
12,r_69_78_102,r_115_130_165,r_53_43_151,r_53_43_151,0.53,-84,67,151,79
95,seq112,seq82,r_144_148_116,r_144_148_116,1,5,121,116,79
93,seq117,seq83,r_12_91_73,r_12_91_73,1,3,76,73,80
44,r_99_93_95,r_90_8_158,r_137_128_151,r_99_93_95,1,63,158,95,80
36,r_14_11_143,seq55,r_76_61_152,r_76_61_152,0.47,-83,69,152,80
14,r_62_126_138,seq22,r_51_102_35,r_62_126_138,0.73,0,138,138,80
43,r_23_56_103,seq46,r_76_61_152,r_23_56_103,0.95,0,103,103,80
54,seq132,r_37_92_84,seq60,r_37_92_84,1,3,87,84,80
83,seq86,seq121,r_104_134_86,r_104_134_86,1,38,124,86,80
94,seq118,r_111_35_18,r_116_133_41,r_116_133_41,0.89,0,41,41,80
1,r_148_26_117,seq15,seq97,r_148_26_117,0.5,-71,46,117,80
55,seq7,r_45_146_127,r_50_17_50,r_50_17_50,0.93,12,62,50,80
21,r_57_115_96,seq82,r_99_93_95,r_99_93_95,0.71,1,96,95,80
39,r_39_67_169,r_99_93_95,seq82,r_99_93_95,0.97,0,95,95,80
1,r_148_26_117,seq97,r_81_59_77,r_148_26_117,0.99,-1,116,117,80
5,r_85_143_99,seq142,r_34_103_45,r_85_143_99,0.99,1,100,99,80
46,r_81_59_77,seq2,r_148_26_117,r_148_26_117,0.62,0,117,117,80
80,seq82,r_39_67_169,r_96_21_22,r_96_21_22,0.94,147,169,22,80
69,seq46,r_23_56_103,seq88,r_23_56_103,1,0,103,103,80
45,r_45_146_127,seq7,seq60,r_45_146_127,0.86,1,128,127,80
11,r_90_8_158,r_99_93_95,seq139,r_90_8_158,0.95,0,158,158,80
66,seq32,r_137_128_151,seq101,r_137_128_151,0.93,0,151,151,80
39,r_39_67_169,seq82,seq44,r_39_67_169,0.94,0,169,169,80
31,r_41_5_122,r_138_27_199,r_34_103_45,r_41_5_122,0.76,0,122,122,80
88,seq97,r_37_92_84,r_112_135_136,r_112_135_136,0.9,13,149,136,80
3,r_30_6_71,r_147_75_87,seq47,r_30_6_71,0.63,1,72,71,80
8,r_34_103_45,seq19,r_41_5_122,r_41_5_122,0.6,4,126,122,80
72,seq54,seq82,r_114_64_145,r_114_64_145,1,8,153,145,80
0,r_9_120_116,r_137_128_151,seq125,r_9_120_116,0.91,1,117,116,80
11,r_90_8_158,r_53_40_101,r_99_93_95,r_90_8_158,0.96,-60,98,158,80
12,r_50_17_50,seq15,seq7,r_50_17_50,1,0,50,50,80
13,r_53_40_101,r_90_8_158,r_36_119_146,r_90_8_158,0.59,-57,101,158,80
59,seq15,r_148_26_117,seq97,r_148_26_117,1,-13,104,117,80
15,r_76_61_152,r_49_42_173,r_81_59_77,r_81_59_77,0.99,76,153,77,80
18,r_112_135_136,seq141,seq123,r_112_135_136,0.54,-18,118,136,80
48,r_77_10_72,r_138_27_199,r_28_108_7,r_77_10_72,1,0,72,72,80
4,r_51_102_35,r_111_35_18,r_62_126_138,r_62_126_138,0.92,3,141,138,80
7,r_107_68_21,seq144,seq2,r_107_68_21,1,3,24,21,80
8,r_34_103_45,seq55,seq19,r_34_103_45,1,0,45,45,80
36,r_14_11_143,r_76_61_152,seq70,r_76_61_152,0.9,-4,148,152,80
2,r_114_64_145,r_129_58_193,seq54,r_114_64_145,0.83,0,145,145,80
29,r_49_42_173,r_23_56_103,seq132,r_49_42_173,0.92,0,173,173,80
40,r_104_134_86,r_112_135_136,seq86,r_104_134_86,1,0,86,86,80
18,r_112_135_136,r_104_134_86,seq141,r_112_135_136,0.84,-50,86,136,80
29,r_49_42_173,r_76_61_152,r_23_56_103,r_23_56_103,0.99,38,141,103,80
24,r_12_91_73,r_23_56_103,seq117,r_12_91_73,1,0,73,73,80
25,r_79_20_106,seq141,seq83,r_79_20_106,0.99,0,106,106,80
30,r_116_133_41,seq65,seq118,r_116_133_41,0.97,1,42,41,80
88,seq97,r_147_75_87,r_148_26_117,r_147_75_87,0.68,0,87,87,80
58,seq142,r_85_143_99,r_28_108_7,r_85_143_99,0.98,1,100,99,80
70,seq47,seq22,r_30_6_71,r_30_6_71,1,0,71,71,80
18,r_112_135_136,seq123,seq97,r_112_135_136,1,0,136,136,80
59,seq15,r_50_17_50,r_148_26_117,r_50_17_50,1,1,51,50,80
42,r_96_21_22,r_113_43_34,seq82,r_96_21_22,0.89,1,23,22,80
61,seq145,r_66_69_180,r_51_102_35,r_51_102_35,0.99,135,170,35,80
38,r_149_94_123,seq124,r_13_3_196,r_149_94_123,0.48,-33,90,123,80
4,r_51_102_35,seq82,r_111_35_18,r_51_102_35,0.99,9,44,35,80
34,r_28_108_7,r_85_143_99,r_77_10_72,r_28_108_7,0.99,65,72,7,80
46,r_81_59_77,r_148_26_117,r_76_61_152,r_76_61_152,0.61,15,167,152,80
41,r_136_80_43,seq22,r_28_108_7,r_136_80_43,0.99,0,43,43,80
81,seq83,seq117,r_79_20_106,r_79_20_106,1,1,107,106,80
17,r_127_24_76,seq124,seq125,r_127_24_76,1,0,76,76,80
63,seq22,r_106_73_56,r_36_119_146,r_36_119_146,1,2,148,146,80
43,r_23_56_103,r_76_61_152,seq144,r_76_61_152,0.81,1,153,152,80
37,r_111_35_18,seq145,r_51_102_35,r_51_102_35,0.88,47,82,35,80
22,r_66_69_180,seq145,r_148_26_117,r_66_69_180,0.4,3,183,180,80
28,r_98_74_68,r_66_69_180,seq60,r_98_74_68,0.98,1,69,68,80
91,seq109,seq97,r_37_92_84,r_37_92_84,1,6,90,84,80
38,r_149_94_123,r_13_3_196,r_140_100_2,r_149_94_123,1,0,123,123,80
49,r_137_128_151,seq32,r_99_93_95,r_137_128_151,0.76,0,151,151,80
9,r_130_18_23,seq88,seq110,r_130_18_23,1,3,26,23,80
44,r_99_93_95,r_39_67_169,r_90_8_158,r_99_93_95,1,0,95,95,80
16,r_106_73_56,seq83,seq22,r_106_73_56,1,0,56,56,80
23,r_37_92_84,seq132,seq109,r_37_92_84,1,3,87,84,80
92,seq110,seq7,r_130_18_23,r_130_18_23,0.99,5,28,23,80
52,seq2,r_81_59_77,r_107_68_21,r_107_68_21,0.65,20,41,21,80
37,r_111_35_18,seq118,seq145,r_111_35_18,0.68,0,18,18,80
51,seq3,seq109,r_82_104_55,r_82_104_55,0.92,8,63,55,81
92,seq106,r_53_105_100,seq59,r_53_105_100,1,1,101,100,81
5,r_70_8_176,r_149_35_116,r_60_37_24,r_60_37_24,0.87,2,26,24,81
76,seq58,r_80_23_21,r_70_8_176,r_80_23_21,0.54,112,133,21,81
18,r_73_51_108,r_39_77_51,r_67_98_11,r_39_77_51,0.98,0,51,51,81
54,seq7,r_135_97_193,r_128_21_42,r_128_21_42,0.92,107,149,42,81
22,r_108_123_16,r_144_99_161,r_68_27_163,r_108_123_16,0.82,1,17,16,81
86,seq86,seq40,r_128_21_42,r_128_21_42,1,25,67,42,81
16,r_79_94_152,r_147_143_157,r_78_122_70,r_147_143_157,0.73,-5,152,157,81
97,seq115,seq137,r_127_116_110,r_127_116_110,1,7,117,110,81
46,r_81_5_59,r_44_22_115,r_68_27_163,r_81_5_59,1,2,61,59,81
7,r_30_91_156,r_145_87_54,r_76_92_18,r_30_91_156,0.62,0,156,156,81
30,r_80_23_21,r_145_87_54,seq14,r_80_23_21,0.9,0,21,21,81
24,r_12_31_98,r_144_99_161,r_28_65_112,r_144_99_161,0.83,0,161,161,81
19,r_20_74_63,seq115,r_76_92_18,r_20_74_63,1,1,64,63,81
15,r_76_92_18,r_136_90_94,r_20_74_63,r_76_92_18,1,76,94,18,81
76,seq58,r_149_35_116,r_80_23_21,r_80_23_21,0.48,97,118,21,81
45,r_144_99_161,r_148_119_53,r_12_31_98,r_144_99_161,0.76,-65,96,161,81
3,r_147_143_157,r_79_94_152,r_128_21_42,r_128_21_42,1,60,102,42,81
43,r_60_37_24,seq96,r_70_8_176,r_60_37_24,1,0,24,24,81
48,r_100_83_120,seq14,r_80_23_21,r_80_23_21,0.8,34,55,21,81
22,r_108_123_16,r_68_27_163,r_81_5_59,r_81_5_59,0.73,17,76,59,81
40,r_95_85_14,r_145_87_54,seq61,r_95_85_14,0.83,3,17,14,81
14,r_52_117_10,r_19_84_76,r_124_9_131,r_52_117_10,0.96,65,75,10,81
4,r_132_111_96,seq4,seq72,r_132_111_96,0.99,0,96,96,81
6,r_68_27_163,r_26_15_15,r_108_123_16,r_68_27_163,0.57,-146,17,163,81
78,seq61,r_53_105_100,seq137,r_53_105_100,0.98,-26,74,100,81
0,r_33_107_186,seq129,r_44_22_115,r_44_22_115,0.58,71,186,115,81
99,seq121,r_19_84_76,seq96,r_19_84_76,0.51,90,166,76,81
46,r_81_5_59,r_68_27_163,r_108_123_16,r_68_27_163,0.63,1,164,163,81
44,r_39_77_51,r_73_51_108,seq71,r_39_77_51,0.99,0,51,51,81
13,r_148_119_53,seq66,r_128_21_42,r_148_119_53,0.97,0,53,53,81
27,r_110_2_67,seq17,r_54_57_190,r_54_57_190,0.46,-3,187,190,81
90,seq96,r_60_37_24,r_73_51_108,r_60_37_24,0.91,0,24,24,81
36,r_36_103_17,seq115,seq131,r_36_103_17,0.98,0,17,17,81
45,r_144_99_161,r_12_31_98,seq10,r_144_99_161,0.99,0,161,161,81
10,r_145_87_54,r_12_31_98,r_134_29_62,r_134_29_62,0.54,-29,33,62,81
5,r_70_8_176,r_60_37_24,seq58,r_70_8_176,0.66,0,176,176,81
6,r_68_27_163,r_81_5_59,seq102,r_68_27_163,0.95,2,165,163,81
10,r_145_87_54,r_30_91_156,seq69,r_30_91_156,0.86,-29,127,156,81
27,r_110_2_67,seq140,r_44_22_115,r_110_2_67,1,0,67,67,81
87,seq88,r_127_116_110,seq69,r_127_116_110,1,-12,98,110,81
91,seq102,seq146,r_68_27_163,r_68_27_163,0.93,3,166,163,81
2,r_124_9_131,seq63,seq46,r_124_9_131,0.93,0,131,131,81
47,r_135_97_193,seq7,r_41_49_101,r_41_49_101,0.66,2,103,101,81
6,r_68_27_163,r_108_123_16,r_81_5_59,r_81_5_59,1,5,64,59,81
74,seq55,seq66,r_130_38_89,r_130_38_89,1,6,95,89,81
29,r_1_16_2,seq121,r_149_35_116,r_149_35_116,0.94,1,117,116,81
15,r_76_92_18,seq3,r_136_90_94,r_76_92_18,0.98,0,18,18,81
24,r_12_31_98,seq121,r_144_99_161,r_12_31_98,0.92,0,98,98,81
20,r_82_104_55,seq72,seq3,r_82_104_55,1,0,55,55,81
25,r_11_64_77,seq140,seq141,r_11_64_77,1,0,77,77,81
43,r_60_37_24,r_70_8_176,r_11_64_77,r_11_64_77,0.7,106,183,77,81
33,r_53_105_100,seq106,seq40,r_53_105_100,1,2,102,100,81
48,r_100_83_120,r_80_23_21,r_132_111_96,r_100_83_120,1,0,120,120,81
64,seq24,r_126_42_159,r_145_87_54,r_145_87_54,0.99,105,159,54,81
88,seq89,r_101_32_151,r_44_22_115,r_44_22_115,0.99,38,153,115,81
60,seq14,r_100_83_120,r_80_23_21,r_100_83_120,0.63,-67,53,120,81
61,seq17,seq142,r_43_75_45,r_43_75_45,1,55,100,45,81
14,r_52_117_10,r_132_111_96,r_19_84_76,r_52_117_10,0.95,0,10,10,81
32,r_28_65_112,seq138,r_12_31_98,r_28_65_112,1,0,112,112,81
38,r_126_42_159,seq24,seq59,r_126_42_159,0.63,0,159,159,81
52,seq4,r_132_111_96,seq89,r_132_111_96,1,0,96,96,81
77,seq59,seq106,r_126_42_159,r_126_42_159,0.87,3,162,159,81
3,r_147_143_157,r_128_21_42,r_82_104_55,r_147_143_157,0.99,0,157,157,81
34,r_118_125_189,r_30_91_156,seq69,r_30_91_156,0.78,-28,128,156,81
10,r_145_87_54,r_134_29_62,r_30_91_156,r_145_87_54,0.97,0,54,54,81
27,r_110_2_67,r_44_22_115,seq17,r_44_22_115,0.79,3,118,115,81
81,seq66,r_148_119_53,seq55,r_148_119_53,1,0,53,53,81
18,r_73_51_108,r_67_98_11,seq45,r_73_51_108,1,0,108,108,81
17,r_136_90_94,r_28_65_112,r_12_31_98,r_12_31_98,1,-2,96,98,81
9,r_101_32_151,seq89,r_13_133_4,r_13_133_4,0.78,140,144,4,81
1,r_26_15_15,r_68_27_163,seq140,r_26_15_15,0.85,0,15,15,81
15,r_76_92_18,r_20_74_63,r_30_91_156,r_30_91_156,1,0,156,156,81
83,seq71,r_76_92_18,r_39_77_51,r_39_77_51,0.72,0,51,51,81
98,seq120,r_147_143_157,r_148_119_53,r_148_119_53,0.56,32,85,53,81
28,r_67_98_11,seq120,r_73_51_108,r_67_98_11,0.97,1,12,11,81
28,r_67_98_11,r_73_51_108,seq96,r_73_51_108,1,1,109,108,81
11,r_43_75_45,seq34,seq17,r_43_75_45,1,0,45,45,81
58,seq140,seq46,r_26_15_15,r_26_15_15,1,18,33,15,81
49,r_149_35_116,seq58,r_1_16_2,r_149_35_116,0.99,0,116,116,81
83,seq71,seq25,r_76_92_18,r_76_92_18,0.5,21,39,18,81
7,r_30_91_156,r_127_116_110,r_145_87_54,r_30_91_156,0.68,-66,90,156,81
23,r_127_116_110,r_30_91_156,seq115,r_127_116_110,0.99,0,110,110,81
35,r_130_38_89,seq50,seq55,r_130_38_89,0.94,0,89,89,81
12,r_78_122_70,r_149_35_116,r_79_94_152,r_78_122_70,1,0,70,70,81
45,r_144_99_161,r_108_123_16,seq7,r_108_123_16,0.88,2,18,16,81
8,r_128_21_42,seq50,seq86,r_128_21_42,1,0,42,42,81
39,r_44_22_115,r_110_2_67,seq4,r_44_22_115,1,0,115,115,81
30,r_85_138_158,r_53_66_195,seq56,r_85_138_158,0.82,0,158,158,82
44,r_28_136_141,r_141_74_39,r_42_18_81,r_28_136_141,0.95,0,141,141,82
36,r_39_65_115,r_92_103_174,seq87,r_39_65_115,0.94,0,115,115,82
6,r_84_97_32,seq0,seq55,r_84_97_32,1,0,32,32,82
20,r_92_103_174,seq2,seq131,r_92_103_174,0.94,0,174,174,82
14,r_42_18_81,seq69,seq44,r_42_18_81,0.99,0,81,81,82
4,r_50_20_160,r_145_68_187,seq9,r_145_68_187,0.41,-161,26,187,82
1,r_127_81_85,seq5,seq129,r_127_81_85,0.9,1,86,85,82
5,r_14_140_188,r_142_107_60,r_147_70_20,r_147_70_20,0.77,168,188,20,82
46,r_143_100_80,seq110,seq0,r_143_100_80,0.99,1,81,80,82
32,r_30_121_91,seq5,r_19_10_147,r_19_10_147,0.9,24,171,147,82
45,r_119_111_71,seq49,seq52,r_119_111_71,1,0,71,71,82
15,r_62_7_112,r_3_63_185,r_130_11_87,r_62_7_112,0.81,-54,58,112,82
24,r_126_48_132,r_144_148_9,r_42_18_81,r_126_48_132,0.97,0,132,132,82
19,r_149_118_94,r_79_41_138,r_42_18_81,r_149_118_94,1,0,94,94,82
33,r_96_35_139,seq49,r_32_102_90,r_96_35_139,0.99,0,139,139,82
16,r_147_70_20,seq106,r_93_36_144,r_147_70_20,1,0,20,20,82
39,r_60_109_14,r_98_132_129,r_141_74_39,r_60_109_14,0.65,115,129,14,82
31,r_3_63_185,seq61,r_126_48_132,r_3_63_185,0.38,1,186,185,82
3,r_130_11_87,seq104,r_62_7_112,r_130_11_87,0.68,-15,72,87,82
10,r_139_13_2,seq104,r_130_11_87,r_139_13_2,0.66,100,102,2,82
90,seq91,seq23,r_42_18_81,r_42_18_81,1,27,108,81,82
41,r_37_108_10,seq55,seq73,r_37_108_10,0.65,67,77,10,82
72,seq49,r_119_111_71,r_133_134_12,r_119_111_71,1,1,72,71,82
16,r_147_70_20,r_93_36_144,r_90_125_82,r_147_70_20,0.77,77,97,20,82
3,r_130_11_87,r_62_7_112,r_137_54_25,r_130_11_87,0.5,25,112,87,82
74,seq55,seq58,r_84_97_32,r_84_97_32,1,1,33,32,82
78,seq61,r_3_63_185,r_123_120_54,r_123_120_54,0.65,131,185,54,82
63,seq29,r_19_10_147,seq52,r_19_10_147,0.98,-42,105,147,82
39,r_60_109_14,r_86_105_191,r_98_132_129,r_60_109_14,0.76,0,14,14,82
20,r_92_103_174,r_39_65_115,seq2,r_39_65_115,0.67,4,119,115,82
13,r_101_82_117,seq71,seq34,r_101_82_117,0.99,0,117,117,82
33,r_96_35_139,r_141_74_39,seq49,r_141_74_39,0.98,0,39,39,82
57,seq9,r_19_10_147,seq52,r_19_10_147,1,-8,139,147,82
2,r_51_15_31,r_86_105_191,r_53_66_195,r_86_105_191,0.72,-80,111,191,82
21,r_133_134_12,seq69,seq49,r_133_134_12,0.53,0,12,12,82
8,r_137_54_25,seq131,seq64,r_137_54_25,0.98,0,25,25,82
48,r_93_36_144,seq58,r_147_70_20,r_147_70_20,0.61,14,34,20,82
35,r_1_21_140,r_39_65_115,r_27_135_163,r_1_21_140,0.75,-91,49,140,82
48,r_93_36_144,r_90_125_82,r_143_100_80,r_93_36_144,1,0,144,144,82
47,r_79_41_138,seq110,r_144_148_9,r_79_41_138,0.7,0,138,138,82
18,r_24_25_119,seq46,r_90_125_82,r_24_25_119,0.65,0,119,119,82
29,r_53_66_195,r_85_138_158,seq106,r_85_138_158,0.71,0,158,158,82
23,r_32_102_90,seq87,r_96_35_139,r_96_35_139,1,7,146,139,82
37,r_141_74_39,r_96_35_139,r_28_136_141,r_141_74_39,0.99,0,39,39,82
25,r_90_125_82,seq128,r_93_36_144,r_90_125_82,0.66,0,82,82,82
43,r_144_148_9,r_126_48_132,r_79_41_138,r_144_148_9,0.98,123,132,9,82
24,r_126_48_132,r_28_136_141,r_144_148_9,r_126_48_132,0.64,-106,26,132,82
88,seq87,seq47,r_98_132_129,r_98_132_129,1,0,129,129,82
70,seq46,r_24_25_119,seq34,r_24_25_119,1,0,119,119,82
65,seq33,r_30_121_91,r_94_95_8,r_30_121_91,0.99,0,91,91,82
68,seq44,seq23,r_42_18_81,r_42_18_81,1,27,108,81,82
32,r_30_121_91,seq33,seq5,r_30_121_91,0.9,0,91,91,82
38,r_19_10_147,seq9,r_30_121_91,r_19_10_147,0.81,0,147,147,82
95,seq112,r_119_111_71,r_133_134_12,r_119_111_71,0.99,-21,50,71,82
52,seq2,seq128,r_88_6_165,r_88_6_165,1,7,172,165,82
34,r_115_38_146,seq23,r_53_66_195,r_115_38_146,0.95,0,146,146,82
75,seq56,seq23,r_85_138_158,r_85_138_158,0.99,1,159,158,82
17,r_86_105_191,r_113_26_159,seq122,r_113_26_159,0.99,0,159,159,82
2,r_51_15_31,r_123_120_54,r_86_105_191,r_51_15_31,0.96,6,37,31,82
37,r_141_74_39,r_28_136_141,r_144_148_9,r_141_74_39,0.69,102,141,39,82
22,r_113_26_159,r_86_105_191,seq71,r_113_26_159,0.85,0,159,159,82
28,r_123_120_54,r_4_57_11,seq61,r_123_120_54,0.87,7,61,54,82
44,r_28_136_141,r_126_48_132,r_141_74_39,r_141_74_39,0.98,5,44,39,82
49,r_98_132_129,r_60_109_14,seq87,r_98_132_129,0.7,0,129,129,82
25,r_90_125_82,r_93_36_144,r_24_25_119,r_90_125_82,0.99,36,118,82,82
7,r_43_17_157,seq58,r_53_66_195,r_53_66_195,0.76,-37,158,195,82
23,r_32_102_90,r_86_105_191,seq87,r_32_102_90,1,0,90,90,82
11,r_4_57_11,r_123_120_54,seq71,r_123_120_54,1,4,58,54,82
48,r_93_36_144,r_147_70_20,r_90_125_82,r_90_125_82,1,0,82,82,82
30,r_6_76_136,seq91,seq88,r_6_76_136,0.62,0,136,136,83
51,seq3,r_8_25_141,seq133,r_8_25_141,1,0,141,141,83
9,r_121_48_128,r_128_82_64,r_32_142_67,r_121_48_128,0.85,2,130,128,83
5,r_101_11_60,r_105_4_61,r_120_137_41,r_101_11_60,1,-4,56,60,83
14,r_131_43_161,seq54,seq27,r_131_43_161,0.85,-2,159,161,83
8,r_114_39_129,seq87,seq53,r_114_39_129,0.89,0,129,129,83
53,seq133,r_103_106_176,seq3,r_103_106_176,0.97,1,177,176,83
43,r_34_35_102,seq141,seq69,r_34_35_102,0.91,0,102,102,83
28,r_89_13_119,r_33_127_144,r_80_134_87,r_89_13_119,1,0,119,119,83
54,seq135,seq41,r_66_85_91,r_66_85_91,1,5,96,91,83
44,r_119_12_47,r_92_146_153,seq104,r_119_12_47,1,0,47,47,83
19,r_61_130_146,r_125_72_5,seq17,r_61_130_146,0.77,0,146,146,83
71,seq57,r_47_118_184,r_32_142_67,r_32_142_67,0.99,29,96,67,83
42,r_36_139_86,r_120_137_41,r_80_134_87,r_36_139_86,0.97,4,90,86,83
16,r_103_106_176,seq133,r_115_59_35,r_103_106_176,0.75,1,177,176,83
58,seq17,r_49_24_6,r_61_130_146,r_61_130_146,0.83,2,148,146,83
86,seq88,r_136_44_27,r_6_76_136,r_6_76_136,1,4,140,136,83
0,r_120_137_41,r_36_139_86,r_101_11_60,r_120_137_41,0.97,23,64,41,83
45,r_2_9_164,seq27,seq10,r_2_9_164,0.73,0,164,164,83
58,seq17,r_61_130_146,seq45,r_61_130_146,0.56,38,184,146,83
27,r_107_38_189,seq74,r_112_21_154,r_107_38_189,0.61,-35,154,189,83
35,r_56_7_33,r_120_137_41,r_47_118_184,r_56_7_33,1,0,33,33,83
40,r_84_143_24,r_67_93_68,seq64,r_84_143_24,0.97,0,24,24,83
19,r_61_130_146,r_145_26_97,r_125_72_5,r_145_26_97,0.92,-36,61,97,83
9,r_121_48_128,r_31_83_34,r_128_82_64,r_121_48_128,0.99,-88,40,128,83
98,seq123,seq63,r_22_81_26,r_22_81_26,0.78,15,41,26,83
38,r_147_108_1,seq69,r_136_44_27,r_147_108_1,0.31,178,179,1,83
31,r_28_68_89,seq29,r_115_59_35,r_28_68_89,0.86,0,89,89,83
41,r_67_93_68,r_32_142_67,seq123,r_67_93_68,0.97,3,71,68,83
3,r_105_4_61,seq29,r_136_44_27,r_105_4_61,1,0,61,61,83
24,r_80_134_87,r_33_127_144,r_75_50_42,r_75_50_42,0.97,11,53,42,83
90,seq97,r_92_146_153,r_80_134_87,r_80_134_87,0.77,62,149,87,83
23,r_75_50_42,r_112_21_154,seq87,r_75_50_42,0.8,0,42,42,83
95,seq111,r_32_142_67,r_49_24_6,r_32_142_67,0.97,-37,30,67,83
34,r_117_37_13,r_32_142_67,r_121_48_128,r_121_48_128,0.84,47,175,128,83
78,seq69,r_112_21_154,r_34_35_102,r_34_35_102,0.87,52,154,102,83
26,r_115_59_35,seq52,seq18,r_115_59_35,0.93,0,35,35,83
42,r_36_139_86,r_22_81_26,r_120_137_41,r_120_137_41,0.44,5,46,41,83
11,r_140_55_195,r_79_0_197,r_116_90_124,r_116_90_124,0.81,0,124,124,83
99,seq126,r_31_83_34,r_145_26_97,r_145_26_97,0.92,7,104,97,83
46,r_23_5_147,seq126,r_32_142_67,r_23_5_147,0.84,0,147,147,83
10,r_136_44_27,r_112_21_154,seq42,r_136_44_27,0.71,1,28,27,83
48,r_66_85_91,seq78,seq135,r_66_85_91,1,0,91,91,83
21,r_47_118_184,r_131_43_161,r_56_7_33,r_47_118_184,0.67,-134,50,184,83
17,r_129_51_52,seq126,r_75_50_42,r_129_51_52,1,0,52,52,83
13,r_145_26_97,r_117_37_13,seq126,r_145_26_97,1,0,97,97,83
6,r_128_82_64,seq126,r_121_48_128,r_128_82_64,0.99,0,64,64,83
62,seq29,r_105_4_61,seq30,r_105_4_61,1,0,61,61,83
21,r_47_118_184,r_56_7_33,seq27,r_47_118_184,0.48,-1,183,184,83
24,r_80_134_87,seq97,r_89_13_119,r_89_13_119,0.98,0,119,119,83
42,r_36_139_86,r_80_134_87,seq91,r_36_139_86,0.72,51,137,86,83
87,seq91,r_6_76_136,seq132,r_6_76_136,0.95,2,138,136,83
2,r_16_20_84,r_89_13_119,seq78,r_16_20_84,0.98,0,84,84,83
24,r_80_134_87,r_75_50_42,seq97,r_80_134_87,0.99,1,88,87,83
96,seq113,seq41,r_66_85_91,r_66_85_91,0.92,9,100,91,83
18,r_148_99_137,seq86,r_75_50_42,r_148_99_137,0.82,1,138,137,83
27,r_107_38_189,seq71,seq74,r_107_38_189,0.58,-90,99,189,83
34,r_117_37_13,r_145_26_97,r_32_142_67,r_117_37_13,0.94,86,99,13,83
35,r_56_7_33,r_47_118_184,r_92_146_153,r_92_146_153,0.92,11,164,153,83
25,r_32_142_67,seq111,seq70,r_32_142_67,1,4,71,67,83
33,r_112_21_154,seq69,r_107_38_189,r_112_21_154,0.85,0,154,154,83
34,r_117_37_13,r_129_51_52,r_145_26_97,r_117_37_13,0.9,1,14,13,83
37,r_109_73_10,r_16_20_84,seq64,r_109_73_10,0.84,1,11,10,83
70,seq54,r_131_43_161,r_92_146_153,r_92_146_153,0.52,1,154,153,83
6,r_128_82_64,r_121_48_128,r_119_12_47,r_121_48_128,0.9,0,128,128,83
32,r_46_15_130,r_2_9_164,r_116_90_124,r_46_15_130,0.95,0,130,130,83
9,r_121_48_128,r_32_142_67,r_117_37_13,r_121_48_128,0.54,50,178,128,83
52,seq132,r_6_76_136,r_36_139_86,r_36_139_86,0.55,7,93,86,83
39,r_31_83_34,r_121_48_128,seq126,r_31_83_34,1,0,34,34,83
86,seq88,r_147_108_1,r_136_44_27,r_147_108_1,0.85,91,92,1,83
12,r_58_144_15,seq1,seq29,r_58_144_15,0.99,0,15,15,83
28,r_89_13_119,r_16_20_84,r_33_127_144,r_16_20_84,0.99,0,84,84,83
13,r_145_26_97,seq70,r_117_37_13,r_145_26_97,0.54,-80,17,97,83
49,r_116_90_124,seq64,r_140_55_195,r_116_90_124,0.96,0,124,124,83
7,r_33_127_144,seq87,r_67_93_68,r_67_93_68,0.69,78,146,68,83
47,r_22_81_26,r_116_90_124,seq123,r_22_81_26,1,0,26,26,83
79,seq70,seq1,r_32_142_67,r_32_142_67,1,1,68,67,83
38,r_147_108_1,seq88,seq69,r_147_108_1,0.61,26,27,1,83
40,r_138_129_45,r_116_43_172,r_135_136_86,r_135_136_86,0.8,81,167,86,84
83,seq87,r_141_40_113,r_142_5_135,r_142_5_135,0.99,3,138,135,84
92,seq103,r_10_92_139,seq35,r_10_92_139,0.7,-4,135,139,84
44,r_78_128_59,r_54_149_134,r_134_145_51,r_78_128_59,0.95,0,59,59,84
8,r_1_55_68,r_60_0_151,seq63,r_1_55_68,0.98,0,68,68,84
58,seq16,r_132_91_32,r_139_117_111,r_139_117_111,0.95,18,129,111,84
18,r_144_93_79,r_131_89_187,seq143,r_144_93_79,0.58,58,137,79,84
28,r_132_91_32,seq83,r_135_136_86,r_132_91_32,0.95,0,32,32,84
26,r_90_9_38,r_101_17_89,r_105_72_144,r_105_72_144,0.69,2,146,144,84
37,r_113_14_152,seq25,r_78_128_59,r_78_128_59,1,45,104,59,84
3,r_116_43_172,r_138_129_45,seq146,r_116_43_172,0.99,0,172,172,84
46,r_21_104_25,r_59_22_92,seq97,r_21_104_25,0.94,0,25,25,84
25,r_4_70_102,r_135_136_86,r_132_91_32,r_132_91_32,0.55,23,55,32,84
39,r_34_125_67,seq16,seq79,r_34_125_67,1,0,67,67,84
1,r_61_52_136,seq35,seq73,r_61_52_136,0.63,1,137,136,84
97,seq121,seq140,r_75_88_96,r_75_88_96,1,32,128,96,84
5,r_131_89_187,r_24_29_53,r_45_67_137,r_45_67_137,0.95,1,138,137,84
29,r_105_72_144,r_75_88_96,r_90_9_38,r_105_72_144,0.99,0,144,144,84
22,r_134_145_51,r_113_14_152,r_78_128_59,r_134_145_51,0.78,15,66,51,84
10,r_47_46_177,r_18_110_98,r_132_91_32,r_47_46_177,0.92,0,177,177,84
25,r_4_70_102,seq66,r_32_7_125,r_32_7_125,0.69,4,129,125,84
45,r_45_67_137,r_60_0_151,r_131_89_187,r_45_67_137,0.76,0,137,137,84
16,r_141_40_113,r_45_67_137,r_90_9_38,r_90_9_38,1,4,42,38,84
84,seq143,r_12_126_154,r_114_69_41,r_114_69_41,0.75,6,47,41,84
0,r_98_48_64,r_34_125_67,seq20,r_98_48_64,1,0,64,64,84
32,r_118_80_109,r_71_13_157,r_59_22_92,r_71_13_157,1,1,158,157,84
45,r_45_67_137,r_131_89_187,seq83,r_131_89_187,1,0,187,187,84
31,r_18_110_98,r_106_120_140,r_47_46_177,r_18_110_98,0.98,0,98,98,84
38,r_106_120_140,r_123_41_42,r_4_70_102,r_106_120_140,0.66,3,143,140,84
3,r_116_43_172,r_118_80_109,r_138_129_45,r_116_43_172,0.99,-64,108,172,84
10,r_47_46_177,r_101_17_89,r_81_50_153,r_101_17_89,0.98,0,89,89,84
40,r_138_129_45,r_75_88_96,r_116_43_172,r_138_129_45,1,0,45,45,84
72,seq56,r_54_149_134,seq3,r_54_149_134,0.69,0,134,134,84
16,r_141_40_113,r_90_9_38,seq87,r_141_40_113,1,0,113,113,84
4,r_60_0_151,r_1_55_68,r_45_67_137,r_1_55_68,1,0,68,68,84
73,seq57,r_71_13_157,r_118_80_109,r_118_80_109,0.89,49,158,109,84
22,r_134_145_51,r_12_126_154,r_113_14_152,r_134_145_51,0.79,0,51,51,84
99,seq124,r_54_149_134,r_12_126_154,r_12_126_154,0.94,19,173,154,84
20,r_85_82_129,seq109,r_34_125_67,r_85_82_129,0.79,0,129,129,84
17,r_114_69_41,r_123_41_42,seq143,r_114_69_41,1,0,41,41,84
13,r_75_88_96,seq63,seq119,r_75_88_96,1,0,96,96,84
98,seq122,r_142_5_135,seq64,r_142_5_135,1,-1,134,135,84
5,r_131_89_187,r_45_67_137,r_47_46_177,r_131_89_187,1,0,187,187,84
49,r_59_22_92,r_26_33_23,r_71_13_157,r_59_22_92,0.96,0,92,92,84
23,r_135_136_86,r_4_70_102,r_132_91_32,r_132_91_32,0.56,18,50,32,84
10,r_47_46_177,r_81_50_153,r_18_110_98,r_47_46_177,0.52,-55,122,177,84
4,r_60_0_151,r_45_67_137,seq96,r_45_67_137,0.66,-32,105,137,84
12,r_74_23_18,r_26_33_23,seq62,r_74_23_18,0.98,0,18,18,84
27,r_139_117_111,seq124,r_132_91_32,r_139_117_111,0.92,0,111,111,84
49,r_59_22_92,r_21_104_25,r_26_33_23,r_59_22_92,0.88,-67,25,92,84
80,seq76,r_127_86_37,seq140,r_127_86_37,0.94,0,37,37,84
37,r_113_14_152,r_78_128_59,seq76,r_113_14_152,1,0,152,152,84
82,seq83,r_132_91_32,r_24_29_53,r_132_91_32,1,0,32,32,84
35,r_26_33_23,seq107,seq25,r_26_33_23,1,1,24,23,84
2,r_81_50_153,r_47_46_177,r_34_125_67,r_34_125_67,0.58,87,154,67,84
67,seq37,r_44_77_46,seq94,r_44_77_46,1,0,46,46,84
18,r_144_93_79,r_65_53_190,r_131_89_187,r_144_93_79,0.97,0,79,79,84
29,r_105_72_144,seq121,r_75_88_96,r_75_88_96,1,17,113,96,84
24,r_19_108_61,seq16,seq35,r_19_108_61,0.99,0,61,61,84
19,r_99_84_12,r_44_77_46,r_75_88_96,r_99_84_12,0.78,-1,11,12,84
33,r_101_17_89,r_47_46_177,seq37,r_101_17_89,0.99,0,89,89,84
48,r_123_41_42,r_106_120_140,r_75_88_96,r_123_41_42,0.96,98,140,42,84
23,r_135_136_86,r_98_48_64,r_4_70_102,r_135_136_86,0.63,-72,14,86,84
47,r_44_77_46,seq37,r_65_53_190,r_44_77_46,0.69,0,46,46,84
6,r_54_149_134,seq56,seq124,r_54_149_134,1,0,134,134,84
65,seq35,r_61_52_136,seq103,r_61_52_136,0.73,0,136,136,84
21,r_127_86_37,seq76,r_2_112_196,r_127_86_37,1,0,37,37,84
42,r_12_126_154,seq143,seq124,r_12_126_154,0.92,0,154,154,84
32,r_118_80_109,r_116_43_172,r_71_13_157,r_118_80_109,0.89,0,109,109,84
28,r_132_91_32,seq16,r_139_117_111,r_139_117_111,0.76,20,131,111,84
38,r_106_120_140,r_18_110_98,r_123_41_42,r_106_120_140,0.98,-42,98,140,84
25,r_4_70_102,r_132_91_32,seq66,r_4_70_102,0.95,1,103,102,84
26,r_90_9_38,r_123_41_42,r_141_40_113,r_90_9_38,1,0,38,38,84
34,r_32_7_125,r_42_27_133,r_4_70_102,r_32_7_125,1,0,125,125,84
6,r_54_149_134,r_78_128_59,seq56,r_78_128_59,0.99,-8,51,59,84
43,r_11_115_22,seq28,seq121,r_11_115_22,0.9,-1,21,22,84
19,r_99_84_12,r_75_88_96,seq28,r_99_84_12,0.56,41,53,12,84
36,r_2_112_196,seq66,r_127_86_37,r_127_86_37,0.99,0,37,37,84
9,r_10_92_139,seq103,r_134_145_51,r_10_92_139,0.72,0,139,139,84
26,r_90_9_38,r_141_40_113,r_101_17_89,r_90_9_38,0.96,75,113,38,84
96,seq119,seq121,r_75_88_96,r_75_88_96,1,1,97,96,84
7,r_65_53_190,r_81_50_153,r_18_110_98,r_65_53_190,0.82,-57,133,190,84
31,r_18_110_98,r_47_46_177,r_65_53_190,r_47_46_177,0.72,-1,176,177,84
18,r_144_93_79,seq143,r_45_67_137,r_144_93_79,0.45,89,168,79,84
56,seq140,seq121,r_75_88_96,r_75_88_96,1,17,113,96,84
7,r_65_53_190,r_144_93_79,r_81_50_153,r_144_93_79,0.94,-1,78,79,84
48,r_123_41_42,r_114_69_41,r_106_120_140,r_123_41_42,1,0,42,42,84
49,r_59_22_92,r_71_13_157,r_118_80_109,r_71_13_157,0.57,1,158,157,84
94,seq109,r_85_82_129,seq73,r_85_82_129,0.77,-91,38,129,84
28,r_132_91_32,r_135_136_86,seq16,r_135_136_86,1,0,86,86,84
42,r_12_126_154,r_134_145_51,seq143,r_134_145_51,1,0,51,51,84
23,r_135_136_86,r_132_91_32,seq133,r_135_136_86,1,0,86,86,84
33,r_122_7_106,seq142,r_75_63_44,r_75_63_44,1,1,45,44,85
28,r_1_100_127,seq114,r_52_141_7,r_1_100_127,0.99,0,127,127,85
27,r_75_63_44,r_58_18_158,r_122_7_106,r_75_63_44,1,0,44,44,85
36,r_61_115_115,seq130,seq29,r_61_115_115,0.87,0,115,115,85
9,r_31_95_22,r_138_101_197,r_6_120_80,r_6_120_80,1,95,175,80,85
32,r_60_83_47,seq79,r_31_95_22,r_60_83_47,0.57,-1,46,47,85
14,r_50_133_71,r_62_76_130,r_108_146_183,r_50_133_71,1,0,71,71,85
43,r_136_53_134,seq43,r_41_103_83,r_136_53_134,0.89,0,134,134,85
22,r_35_55_26,r_131_46_64,seq142,r_131_46_64,0.79,-38,26,64,85
83,seq85,seq80,r_135_38_73,r_135_38_73,0.98,11,84,73,85
37,r_6_120_80,seq74,r_124_64_60,r_6_120_80,1,0,80,80,85
26,r_93_88_13,seq113,seq34,r_93_88_13,0.98,0,13,13,85
55,seq12,seq23,r_89_110_11,r_89_110_11,0.55,108,119,11,85
86,seq98,r_116_19_62,seq99,r_116_19_62,1,0,62,62,85
16,r_128_97_139,seq84,r_135_38_73,r_128_97_139,0.76,0,139,139,85
39,r_45_82_166,r_52_141_7,r_50_133_71,r_50_133_71,0.88,96,167,71,85
1,r_116_19_62,r_0_28_3,r_145_92_91,r_145_92_91,1,59,150,91,85
1,r_116_19_62,seq98,r_0_28_3,r_116_19_62,1,0,62,62,85
97,seq148,r_10_54_111,r_87_57_2,r_10_54_111,0.99,-1,110,111,85
5,r_62_76_130,r_50_133_71,r_140_94_112,r_50_133_71,0.68,0,71,71,85
19,r_39_40_167,seq84,r_58_18_158,r_39_40_167,0.73,0,167,167,85
21,r_37_132_30,r_32_69_196,r_86_16_124,r_37_132_30,0.98,0,30,30,85
33,r_122_7_106,r_75_63_44,seq26,r_122_7_106,0.92,0,106,106,85
84,seq90,r_31_95_22,r_131_46_64,r_131_46_64,0.57,69,133,64,85
27,r_75_63_44,r_122_7_106,seq142,r_122_7_106,1,0,106,106,85
76,seq72,r_128_97_139,r_71_112_88,r_71_112_88,0.63,51,139,88,85
18,r_71_112_88,seq12,r_89_110_11,r_89_110_11,0.72,1,12,11,85
38,r_108_146_183,r_50_133_71,r_140_94_112,r_108_146_183,0.63,1,184,183,85
31,r_41_103_83,r_8_9_188,seq125,r_41_103_83,1,0,83,83,85
41,r_144_107_168,seq36,r_50_133_71,r_50_133_71,1,100,171,71,85
67,seq36,r_144_107_168,r_3_77_65,r_3_77_65,1,106,171,65,85
10,r_138_101_197,r_31_95_22,r_124_64_60,r_124_64_60,1,13,73,60,85
3,r_140_94_112,r_62_76_130,r_30_15_8,r_140_94_112,0.97,0,112,112,85
28,r_1_100_127,r_30_15_8,seq114,r_1_100_127,0.57,-34,93,127,85
14,r_50_133_71,r_108_146_183,r_39_40_167,r_39_40_167,0.54,2,169,167,85
4,r_56_81_85,seq43,seq80,r_56_81_85,0.74,0,85,85,85
0,r_8_9_188,r_41_103_83,r_129_121_45,r_8_9_188,0.72,-124,64,188,85
5,r_62_76_130,r_140_94_112,r_89_110_11,r_140_94_112,0.81,-4,108,112,85
11,r_124_64_60,r_147_33_107,r_138_101_197,r_124_64_60,1,0,60,60,85
20,r_24_96_98,r_147_33_107,seq142,r_24_96_98,0.85,0,98,98,85
20,r_24_96_98,seq23,r_75_63_44,r_24_96_98,0.56,73,171,98,85
98,seq125,r_128_97_139,r_41_103_83,r_41_103_83,0.94,0,83,83,85
10,r_138_101_197,seq106,r_31_95_22,r_31_95_22,0.71,6,28,22,85
15,r_135_38_73,seq109,seq85,r_135_38_73,1,0,73,73,85
48,r_147_33_107,seq73,seq67,r_147_33_107,0.99,0,107,107,85
57,seq14,seq42,r_126_111_70,r_126_111_70,1,3,73,70,85
46,r_129_121_45,seq114,r_8_9_188,r_129_121_45,1,0,45,45,85
13,r_139_47_100,r_30_15_8,seq99,r_139_47_100,0.9,0,100,100,85
6,r_10_54_111,seq148,seq13,r_10_54_111,0.99,0,111,111,85
62,seq23,r_62_76_130,r_89_110_11,r_62_76_130,0.58,-28,102,130,85
21,r_37_132_30,r_86_16_124,r_116_19_62,r_116_19_62,0.76,51,113,62,85
85,seq130,r_61_115_115,seq78,r_61_115_115,0.92,5,120,115,85
42,r_25_137_43,seq70,seq43,r_25_137_43,1,0,43,43,85
22,r_35_55_26,seq142,seq12,r_35_55_26,0.46,134,160,26,85
2,r_145_92_91,seq90,r_116_19_62,r_145_92_91,1,0,91,91,85
47,r_68_17_93,seq27,seq29,r_68_17_93,0.92,0,93,93,85
5,r_62_76_130,r_89_110_11,r_131_46_64,r_62_76_130,0.81,0,130,130,85
93,seq114,r_30_15_8,r_86_16_124,r_86_16_124,1,7,131,124,85
40,r_58_18_158,seq104,r_50_133_71,r_58_18_158,0.52,0,158,158,85
24,r_126_111_70,seq27,seq14,r_126_111_70,0.68,0,70,70,85
34,r_30_15_8,r_139_47_100,seq114,r_139_47_100,0.7,1,101,100,85
25,r_52_141_7,r_45_82_166,r_1_100_127,r_1_100_127,0.94,28,155,127,85
93,seq114,r_129_121_45,r_30_15_8,r_129_121_45,1,-1,44,45,85
64,seq27,r_60_83_47,r_131_46_64,r_131_46_64,1,2,66,64,85
92,seq113,r_39_40_167,r_131_46_64,r_131_46_64,0.86,10,74,64,85
58,seq143,r_39_40_167,seq125,r_39_40_167,0.8,-84,83,167,85
38,r_108_146_183,seq36,r_50_133_71,r_50_133_71,1,0,71,71,85
77,seq73,r_147_33_107,seq105,r_147_33_107,1,-1,106,107,85
45,r_48_49_31,r_122_7_106,seq5,r_48_49_31,0.69,0,31,31,85
92,seq113,r_131_46_64,seq125,r_131_46_64,0.73,23,87,64,85
23,r_89_110_11,seq23,r_59_91_143,r_59_91_143,1,0,143,143,85
17,r_3_77_65,seq44,seq36,r_3_77_65,1,0,65,65,85
94,seq117,seq21,r_123_102_40,r_123_102_40,1,97,137,40,85
9,r_31_95_22,seq134,r_138_101_197,r_31_95_22,0.89,0,22,22,85
91,seq109,r_86_16_124,seq134,r_86_16_124,1,1,125,124,85
49,r_0_28_3,r_41_103_83,r_116_19_62,r_0_28_3,0.96,59,62,3,85
18,r_71_112_88,r_89_110_11,seq84,r_71_112_88,1,2,90,88,85
44,r_131_46_64,seq21,seq27,r_131_46_64,0.99,0,64,64,85
34,r_30_15_8,seq114,r_140_94_112,r_140_94_112,0.97,0,112,112,85
82,seq84,r_128_97_139,r_71_112_88,r_71_112_88,0.58,51,139,88,85
29,r_123_102_40,r_129_121_45,seq117,r_123_102_40,1,0,40,40,85
35,r_59_91_143,seq20,r_89_110_11,r_59_91_143,0.97,0,143,143,85
23,r_89_110_11,r_35_55_26,r_71_112_88,r_89_110_11,0.72,0,11,11,85
23,r_89_110_11,r_71_112_88,seq23,r_71_112_88,0.92,0,88,88,85
30,r_51_113_101,seq134,seq131,r_51_113_101,1,0,101,101,86
47,r_14_86_22,seq84,r_95_137_106,r_14_86_22,0.96,0,22,22,86
14,r_120_65_188,seq125,r_67_115_30,r_67_115_30,0.98,158,188,30,86
8,r_81_18_95,r_66_104_198,seq118,r_81_18_95,0.66,4,99,95,86
54,seq9,r_25_10_195,r_136_127_56,r_136_127_56,1,95,151,56,86
37,r_38_28_134,seq17,r_40_140_36,r_40_140_36,0.94,-1,35,36,86
41,r_33_78_20,r_38_28_134,seq84,r_33_78_20,0.78,-2,18,20,86
71,seq52,r_97_80_147,seq26,r_97_80_147,0.94,-12,135,147,86
21,r_135_62_79,seq131,seq149,r_135_62_79,0.95,-1,78,79,86
39,r_88_82_81,r_35_63_175,seq124,r_88_82_81,1,0,81,81,86
50,seq131,r_128_59_152,r_51_113_101,r_51_113_101,0.93,4,105,101,86
1,r_87_79_148,seq69,r_13_45_18,r_87_79_148,0.72,2,150,148,86
5,r_31_74_168,seq149,seq93,r_31_74_168,0.81,0,168,168,86
46,r_47_24_66,seq131,r_99_76_193,r_47_24_66,1,0,66,66,86
42,r_111_73_158,seq122,r_130_110_116,r_111_73_158,0.74,0,158,158,86
22,r_43_143_43,r_72_39_96,seq147,r_72_39_96,1,0,96,96,86
32,r_35_63_175,seq75,r_31_74_168,r_35_63_175,0.96,0,175,175,86
45,r_99_76_193,seq148,r_47_24_66,r_47_24_66,1,7,73,66,86
10,r_13_45_18,r_32_48_124,seq90,r_13_45_18,0.91,2,20,18,86
41,r_33_78_20,seq84,r_27_132_46,r_27_132_46,1,0,46,46,86
24,r_53_126_33,r_37_107_141,seq122,r_37_107_141,1,0,141,141,86
19,r_15_12_104,seq109,seq149,r_15_12_104,1,0,104,104,86
27,r_72_39_96,r_43_143_43,seq69,r_72_39_96,1,0,96,96,86
3,r_66_104_198,r_43_143_43,r_81_18_95,r_43_143_43,1,0,43,43,86
38,r_95_137_106,r_14_86_22,r_105_145_74,r_95_137_106,1,0,106,106,86
43,r_0_8_80,r_50_129_37,seq83,r_0_8_80,0.62,-42,38,80,86
31,r_11_106_130,seq108,seq68,r_11_106_130,0.85,0,130,130,86
18,r_136_127_56,r_116_71_185,seq9,r_136_127_56,1,1,57,56,86
90,seq108,r_11_106_130,r_103_44_71,r_103_44_71,0.92,59,130,71,86
3,r_66_104_198,r_81_18_95,r_22_20_12,r_81_18_95,1,5,100,95,86
48,r_55_89_53,seq101,seq54,r_55_89_53,1,2,55,53,86
23,r_105_145_74,r_3_123_42,seq109,r_3_123_42,0.99,0,42,42,86
26,r_3_123_42,r_105_145_74,r_50_129_37,r_3_123_42,0.99,0,42,42,86
43,r_0_8_80,seq83,r_146_1_50,r_0_8_80,0.93,2,82,80,86
84,seq92,r_136_127_56,r_120_65_188,r_136_127_56,0.74,-34,22,56,86
78,seq75,r_32_48_124,r_35_63_175,r_32_48_124,0.95,0,124,124,86
38,r_95_137_106,r_116_71_185,r_14_86_22,r_14_86_22,1,7,29,22,86
21,r_135_62_79,seq149,r_6_56_113,r_6_56_113,0.98,5,118,113,86
20,r_97_80_147,seq9,seq124,r_97_80_147,0.43,0,147,147,86
13,r_41_4_94,seq26,seq54,r_41_4_94,1,1,95,94,86
15,r_103_44_71,seq84,seq108,r_103_44_71,1,-3,68,71,86
6,r_37_107_141,seq122,r_105_145_74,r_37_107_141,0.97,0,141,141,86
80,seq84,r_14_86_22,r_103_44_71,r_14_86_22,0.71,0,22,22,86
16,r_27_132_46,seq7,seq84,r_27_132_46,1,0,46,46,86
27,r_72_39_96,seq147,r_43_143_43,r_43_143_43,0.72,21,64,43,86
87,seq100,seq138,r_146_1_50,r_146_1_50,0.88,76,126,50,86
22,r_43_143_43,r_66_104_198,r_72_39_96,r_43_143_43,0.99,0,43,43,86
23,r_105_145_74,seq109,r_51_113_101,r_105_145_74,0.94,0,74,74,86
36,r_146_1_50,seq100,r_0_8_80,r_0_8_80,0.56,1,81,80,86
25,r_42_2_155,seq102,seq69,r_42_2_155,0.81,0,155,155,86
2,r_67_115_30,r_116_71_185,r_70_119_196,r_67_115_30,0.99,0,30,30,86
33,r_96_58_161,seq83,r_105_145_74,r_105_145_74,0.44,87,161,74,86
47,r_14_86_22,r_95_137_106,seq61,r_95_137_106,1,0,106,106,86
88,seq101,r_55_89_53,seq34,r_55_89_53,1,7,60,53,86
50,seq131,r_47_24_66,r_128_59_152,r_47_24_66,1,0,66,66,86
36,r_146_1_50,seq125,seq100,r_146_1_50,0.94,0,50,50,86
32,r_35_63_175,r_88_82_81,seq75,r_88_82_81,1,0,81,81,86
77,seq69,r_87_79_148,r_72_39_96,r_72_39_96,0.99,54,150,96,86
34,r_30_112_112,seq148,seq23,r_30_112_112,1,0,112,112,86
78,seq75,r_35_63_175,seq46,r_35_63_175,1,0,175,175,86
24,r_53_126_33,r_135_62_79,r_37_107_141,r_53_126_33,0.98,0,33,33,86
4,r_98_5_17,seq68,seq102,r_98_5_17,1,0,17,17,86
40,r_70_119_196,seq147,r_67_115_30,r_67_115_30,1,0,30,30,86
23,r_105_145_74,r_51_113_101,r_95_137_106,r_105_145_74,0.89,32,106,74,86
96,seq122,r_111_73_158,r_53_126_33,r_53_126_33,0.66,126,159,33,86
37,r_38_28_134,r_40_140_36,seq138,r_40_140_36,0.7,98,134,36,86
28,r_32_48_124,seq75,r_51_113_101,r_32_48_124,0.99,0,124,124,86
84,seq92,r_120_65_188,r_14_86_22,r_120_65_188,0.48,-59,129,188,86
79,seq83,r_96_58_161,r_130_110_116,r_130_110_116,0.93,7,123,116,86
12,r_130_110_116,seq90,seq83,r_130_110_116,0.96,0,116,116,86
29,r_22_20_12,r_38_28_134,r_66_104_198,r_22_20_12,0.74,3,15,12,86
98,seq124,r_97_5_117,seq62,r_97_5_117,0.56,-32,85,117,87
28,r_14_84_43,seq93,r_71_42_27,r_14_84_43,1,0,43,43,87
30,r_101_47_78,seq93,seq82,r_101_47_78,1,0,78,78,87
44,r_126_108_39,seq78,r_28_105_65,r_28_105_65,1,33,98,65,87
51,seq129,r_10_83_175,r_19_9_36,r_19_9_36,0.96,46,82,36,87
36,r_1_86_97,seq139,r_87_46_20,r_1_86_97,0.99,0,97,97,87
8,r_145_137_152,r_117_91_163,r_110_23_84,r_110_23_84,0.46,68,152,84,87
43,r_138_2_64,seq81,r_126_108_39,r_138_2_64,0.97,0,64,64,87
37,r_116_76_108,seq56,r_114_120_190,r_116_76_108,0.74,-1,107,108,87
64,seq29,r_18_55_179,seq139,r_18_55_179,0.5,0,179,179,87
55,seq139,r_1_86_97,seq29,r_1_86_97,1,-27,70,97,87
86,seq81,r_138_2_64,seq48,r_138_2_64,1,1,65,64,87
16,r_117_91_163,r_145_137_152,seq26,r_145_137_152,0.72,0,152,152,87
39,r_89_144_118,seq79,r_92_111_85,r_89_144_118,1,0,118,118,87
1,r_67_31_113,seq56,seq130,r_67_31_113,0.99,2,115,113,87
46,r_28_105_65,seq102,r_126_108_39,r_28_105_65,1,0,65,65,87
42,r_140_15_186,seq106,seq130,r_140_15_186,0.65,-73,113,186,87
11,r_40_132_24,r_71_42_27,r_10_83_175,r_40_132_24,0.9,1,25,24,87
80,seq66,seq58,r_14_84_43,r_14_84_43,0.99,116,159,43,87
45,r_134_68_193,r_107_17_124,seq59,r_107_17_124,0.95,0,124,124,87
9,r_45_50_17,r_145_137_152,seq74,r_45_50_17,0.99,0,17,17,87
19,r_73_90_146,seq44,r_100_99_13,r_73_90_146,0.84,0,146,146,87
77,seq59,r_134_68_193,seq141,r_134_68_193,0.85,-4,189,193,87
12,r_4_61_37,seq62,r_97_5_117,r_97_5_117,0.61,10,127,117,87
21,r_54_25_19,r_118_70_130,seq81,r_54_25_19,1,0,19,19,87
10,r_71_42_27,seq58,r_14_84_43,r_14_84_43,0.93,20,63,43,87
14,r_122_60_33,r_138_2_64,r_134_68_193,r_122_60_33,0.99,0,33,33,87
31,r_114_120_190,r_110_23_84,seq30,r_110_23_84,0.89,0,84,84,87
89,seq88,seq82,r_77_69_114,r_77_69_114,1,8,122,114,87
34,r_100_99_13,r_146_115_154,r_73_90_146,r_73_90_146,0.53,-3,143,146,87
20,r_3_27_122,r_94_64_109,r_100_99_13,r_100_99_13,1,15,28,13,87
26,r_143_98_42,seq81,seq74,r_143_98_42,1,0,42,42,87
0,r_72_20_77,seq141,seq75,r_72_20_77,0.88,0,77,77,87
63,seq26,r_117_91_163,seq79,r_117_91_163,0.95,-16,147,163,87
35,r_32_7_91,r_138_2_64,r_125_123_131,r_32_7_91,0.84,40,131,91,87
13,r_92_111_85,seq85,r_103_136_171,r_92_111_85,0.99,0,85,85,87
15,r_107_17_124,seq59,seq0,r_107_17_124,0.71,0,124,124,87
48,r_109_113_151,seq29,r_110_23_84,r_109_113_151,0.61,0,151,151,87
35,r_32_7_91,seq62,r_4_61_37,r_4_61_37,1,0,37,37,87
0,r_72_20_77,seq129,seq22,r_72_20_77,0.61,99,176,77,87
13,r_92_111_85,r_103_136_171,r_13_131_101,r_92_111_85,0.5,86,171,85,87
6,r_118_70_130,r_57_38_143,r_125_123_131,r_118_70_130,0.95,1,131,130,87
62,seq22,seq129,r_19_9_36,r_19_9_36,1,86,122,36,87
21,r_54_25_19,seq81,seq85,r_54_25_19,0.39,115,134,19,87
0,r_72_20_77,seq75,seq129,r_72_20_77,0.32,41,118,77,87
14,r_122_60_33,r_134_68_193,seq59,r_122_60_33,0.35,58,91,33,87
98,seq124,seq62,r_77_69_114,r_77_69_114,0.89,28,142,114,87
27,r_57_38_143,r_118_70_130,r_19_9_36,r_19_9_36,1,94,130,36,87
97,seq121,seq141,r_10_83_175,r_10_83_175,0.77,3,178,175,87
5,r_24_41_50,r_140_15_186,seq88,r_24_41_50,0.95,3,53,50,87
31,r_114_120_190,r_37_135_63,seq104,r_114_120_190,0.78,-31,159,190,87
41,r_87_46_20,r_89_144_118,seq78,r_87_46_20,1,3,23,20,87
87,seq82,r_97_5_117,r_101_47_78,r_101_47_78,0.77,41,119,78,87
22,r_94_64_109,r_100_99_13,r_65_53_87,r_100_99_13,0.78,96,109,13,87
2,r_65_53_87,r_89_144_118,seq102,r_65_53_87,1,0,87,87,87
40,r_146_115_154,seq49,seq112,r_146_115_154,0.62,0,154,154,87
18,r_52_119_188,seq16,r_71_42_27,r_52_119_188,0.3,0,188,188,87
29,r_10_83_175,seq129,seq0,r_10_83_175,0.78,1,176,175,87
24,r_21_133_99,r_103_136_171,seq56,r_21_133_99,0.98,2,101,99,87
27,r_57_38_143,r_19_9_36,seq34,r_57_38_143,0.98,0,143,143,87
34,r_100_99_13,r_94_64_109,r_3_27_122,r_94_64_109,0.79,0,109,109,87
25,r_97_5_117,seq82,r_4_61_37,r_4_61_37,0.57,82,119,37,87
33,r_77_69_114,r_103_136_171,seq88,r_77_69_114,0.97,0,114,114,87
64,seq29,r_109_113_151,r_18_55_179,r_109_113_151,0.95,0,151,151,87
88,seq85,r_92_111_85,seq81,r_92_111_85,0.99,0,85,85,87
88,seq85,r_54_25_19,r_140_15_186,r_140_15_186,0.82,1,187,186,87
20,r_3_27_122,r_100_99_13,r_65_53_87,r_100_99_13,0.94,109,122,13,87
68,seq35,r_103_136_171,r_13_131_101,r_13_131_101,0.75,35,136,101,87
53,seq6,r_71_42_27,seq121,r_71_42_27,0.88,28,55,27,87
42,r_140_15_186,seq130,seq85,r_140_15_186,0.78,1,187,186,87
32,r_110_23_84,r_114_120_190,seq30,r_110_23_84,0.99,9,93,84,87
12,r_4_61_37,r_10_83_175,r_32_7_91,r_4_61_37,0.96,0,37,37,87
38,r_13_131_101,seq34,seq35,r_13_131_101,0.98,1,102,101,87
77,seq59,r_107_17_124,r_134_68_193,r_107_17_124,0.93,0,124,124,87
34,r_100_99_13,r_118_70_130,r_94_64_109,r_100_99_13,0.97,0,13,13,87
22,r_94_64_109,r_3_27_122,r_100_99_13,r_100_99_13,1,5,18,13,87
4,r_19_9_36,seq142,r_40_132_24,r_19_9_36,0.99,0,36,36,87
66,seq33,r_126_108_39,seq63,r_126_108_39,0.77,-1,38,39,87
17,r_125_123_131,seq36,r_118_70_130,r_125_123_131,0.83,0,131,131,87
34,r_100_99_13,r_3_27_122,r_146_115_154,r_100_99_13,0.71,109,122,13,87
16,r_117_91_163,seq26,r_67_31_113,r_117_91_163,0.69,0,163,163,87
11,r_40_132_24,r_10_83_175,r_19_9_36,r_19_9_36,0.57,10,46,36,87
53,seq6,r_72_20_77,r_71_42_27,r_71_42_27,0.82,8,35,27,87
31,r_114_120_190,seq30,r_37_135_63,r_37_135_63,0.37,86,149,63,87
97,seq121,r_107_17_124,seq141,r_107_17_124,0.74,47,171,124,87
37,r_116_76_108,r_114_120_190,r_103_136_171,r_116_76_108,0.8,63,171,108,87
12,r_4_61_37,r_32_7_91,seq62,r_32_7_91,1,0,91,91,87
56,seq141,r_72_20_77,seq59,r_72_20_77,0.88,1,78,77,87
7,r_37_135_63,seq80,seq74,r_37_135_63,0.99,1,64,63,87
23,r_11_128_18,r_57_38_143,r_19_9_36,r_11_128_18,0.72,125,143,18,87
76,seq58,seq66,r_71_42_27,r_71_42_27,1,5,32,27,87
35,r_32_7_91,r_4_61_37,r_138_2_64,r_32_7_91,1,0,91,91,87
44,r_126_108_39,seq33,seq78,r_126_108_39,0.97,-1,38,39,87
93,seq108,r_98_37_69,seq93,r_98_37_69,1,0,69,69,88
97,seq121,r_51_46_124,seq82,r_51_46_124,0.9,-72,52,124,88
30,r_99_50_149,seq135,r_11_115_50,r_99_50_149,0.86,0,149,149,88
51,seq2,seq80,r_27_123_62,r_27_123_62,1,48,110,62,88
36,r_19_30_67,seq107,seq14,r_19_30_67,1,0,67,67,88
19,r_38_90_130,seq108,r_61_127_32,r_61_127_32,0.75,4,36,32,88
25,r_100_149_18,r_113_140_105,seq134,r_100_149_18,0.99,0,18,18,88
92,seq107,r_19_30_67,seq138,r_19_30_67,1,0,67,67,88
0,r_148_56_14,seq146,r_75_68_60,r_75_68_60,1,11,71,60,88
96,seq118,r_11_115_50,r_4_94_28,r_11_115_50,0.6,-8,42,50,88
37,r_13_139_154,seq137,seq14,r_13_139_154,0.74,-1,153,154,88
24,r_136_119_49,r_11_115_50,seq7,r_136_119_49,1,0,49,49,88
40,r_16_79_38,r_96_128_131,r_84_74_1,r_16_79_38,1,1,39,38,88
91,seq106,seq146,r_148_56_14,r_148_56_14,0.73,29,43,14,88
31,r_92_109_15,seq137,r_105_104_191,r_92_109_15,0.94,0,15,15,88
33,r_120_26_110,r_136_119_49,r_28_31_121,r_120_26_110,0.79,11,121,110,88
19,r_38_90_130,r_61_127_32,seq133,r_38_90_130,0.96,0,130,130,88
55,seq137,r_13_139_154,seq103,r_13_139_154,0.64,-1,153,154,88
86,seq135,r_99_50_149,r_58_81_88,r_58_81_88,0.62,56,144,88,88
21,r_27_123_62,seq1,seq80,r_27_123_62,1,0,62,62,88
39,r_45_117_101,r_113_140_105,r_8_76_122,r_45_117_101,0.74,0,101,101,88
1,r_15_53_109,r_105_104_191,seq141,r_15_53_109,0.79,0,109,109,88
5,r_77_59_141,seq41,r_51_46_124,r_77_59_141,0.91,0,141,141,88
14,r_126_72_163,r_11_115_50,seq118,r_11_115_50,1,0,50,50,88
80,seq80,seq2,r_27_123_62,r_27_123_62,1,48,110,62,88
7,r_11_115_50,r_8_76_122,r_99_50_149,r_11_115_50,0.51,102,152,50,88
69,seq43,r_83_0_133,seq7,r_83_0_133,0.92,0,133,133,88
45,r_75_68_60,seq66,r_148_56_14,r_75_68_60,1,0,60,60,88
27,r_112_10_150,seq107,r_45_117_101,r_45_117_101,0.98,26,127,101,88
47,r_145_36_155,r_131_18_161,r_98_37_69,r_145_36_155,0.6,0,155,155,88
3,r_51_46_124,seq121,r_105_104_191,r_51_46_124,0.85,0,124,124,88
76,seq64,seq43,r_98_37_69,r_98_37_69,0.8,33,102,69,88
38,r_105_104_191,r_15_53_109,r_92_109_15,r_15_53_109,1,-1,108,109,88
41,r_35_97_107,r_51_46_124,r_8_76_122,r_35_97_107,0.8,1,108,107,88
89,seq102,seq24,r_83_0_133,r_83_0_133,1,4,137,133,88
3,r_51_46_124,r_35_97_107,seq121,r_51_46_124,0.64,-17,107,124,88
90,seq103,r_78_60_146,seq137,r_78_60_146,0.67,0,146,146,88
44,r_84_74_1,seq102,r_89_67_20,r_89_67_20,0.52,2,22,20,88
26,r_78_60_146,seq103,r_132_144_12,r_78_60_146,0.84,1,147,146,88
4,r_52_22_90,seq95,seq121,r_52_22_90,0.99,1,91,90,88
78,seq66,r_75_68_60,seq85,r_75_68_60,1,0,60,60,88
38,r_105_104_191,seq146,r_15_53_109,r_105_104_191,0.55,-162,29,191,88
20,r_83_0_133,seq43,seq102,r_83_0_133,0.81,0,133,133,88
44,r_84_74_1,r_89_67_20,r_16_79_38,r_16_79_38,0.91,1,39,38,88
12,r_89_67_20,r_84_74_1,r_39_21_97,r_39_21_97,1,7,104,97,88
66,seq134,seq146,r_100_149_18,r_100_149_18,1,18,36,18,88
13,r_61_127_32,r_38_90_130,r_113_140_105,r_61_127_32,0.99,74,106,32,88
23,r_132_144_12,r_8_76_122,seq85,r_132_144_12,0.81,1,13,12,88
48,r_25_5_53,seq54,seq41,r_25_5_53,1,0,53,53,88
27,r_112_10_150,r_40_142_74,seq107,r_40_142_74,0.98,-18,56,74,88
3,r_51_46_124,r_105_104_191,r_77_59_141,r_51_46_124,0.91,29,153,124,88
12,r_89_67_20,seq64,r_84_74_1,r_89_67_20,0.8,0,20,20,88
87,seq93,seq108,r_61_127_32,r_61_127_32,0.76,64,96,32,88
91,seq106,r_148_56_14,seq146,r_148_56_14,0.51,144,158,14,88
22,r_49_116_79,seq91,r_78_60_146,r_78_60_146,1,32,178,146,88
2,r_96_128_131,seq82,r_71_69_2,r_96_128_131,0.72,0,131,131,88
47,r_145_36_155,r_130_55_143,r_131_18_161,r_130_55_143,0.56,0,143,143,88
18,r_113_140_105,r_34_88_195,r_61_127_32,r_113_140_105,1,0,105,105,88
29,r_40_142_74,r_112_10_150,seq134,r_40_142_74,1,0,74,74,88
28,r_8_76_122,r_112_10_150,r_11_115_50,r_11_115_50,1,7,57,50,88
27,r_112_10_150,r_45_117_101,seq85,r_112_10_150,0.82,5,155,150,88
33,r_120_26_110,seq135,r_136_119_49,r_120_26_110,0.51,0,110,110,88
58,seq14,seq129,r_13_139_154,r_13_139_154,0.69,-1,153,154,88
70,seq44,seq82,r_9_73_91,r_9_73_91,0.76,4,95,91,88
42,r_28_31_121,seq93,r_120_26_110,r_28_31_121,0.89,2,123,121,88
32,r_9_73_91,seq103,seq44,r_9_73_91,1,0,91,91,88
34,r_34_88_195,r_113_140_105,r_23_110_136,r_113_140_105,1,0,105,105,88
0,r_148_56_14,r_51_46_124,seq146,r_148_56_14,0.93,0,14,14,88
17,r_71_69_2,seq111,r_96_128_131,r_96_128_131,0.91,13,144,131,88
13,r_61_127_32,seq57,r_38_90_130,r_61_127_32,0.96,0,32,32,88
9,r_98_37_69,seq108,seq64,r_98_37_69,0.55,33,102,69,88
31,r_92_109_15,r_105_104_191,seq106,r_92_109_15,0.58,158,173,15,88
28,r_8_76_122,r_11_115_50,r_45_117_101,r_45_117_101,0.93,20,121,101,88
22,r_49_116_79,seq6,seq91,r_49_116_79,0.93,1,80,79,88
7,r_11_115_50,r_126_72_163,r_8_76_122,r_11_115_50,1,0,50,50,88
49,r_130_55_143,r_145_36_155,r_136_119_49,r_130_55_143,0.79,0,143,143,88
35,r_39_21_97,seq43,r_89_67_20,r_39_21_97,0.74,0,97,97,88
54,seq7,seq54,r_136_119_49,r_136_119_49,1,6,55,49,88
41,r_35_97_107,r_8_76_122,r_132_144_12,r_35_97_107,0.51,47,154,107,88
30,r_138_72_57,r_62_85_136,seq96,r_62_85_136,0.62,-1,135,136,89
51,seq129,seq0,r_112_119_105,r_112_119_105,0.64,3,108,105,89
36,r_23_64_70,r_80_121_148,r_103_58_199,r_103_58_199,0.61,-127,72,199,89
16,r_52_16_188,r_63_74_116,r_6_102_28,r_52_16_188,0.89,-161,27,188,89
92,seq109,r_130_51_168,seq98,r_130_51_168,0.47,0,168,168,89
8,r_93_84_138,seq65,seq108,r_93_84_138,0.93,0,138,138,89
37,r_112_119_105,seq21,seq129,r_112_119_105,1,1,106,105,89
42,r_143_5_52,r_50_118_172,seq0,r_143_5_52,1,0,52,52,89
39,r_14_35_196,seq82,seq81,r_14_35_196,0.45,-108,88,196,89
1,r_144_7_14,seq76,r_95_57_147,r_144_7_14,0.42,133,147,14,89
5,r_48_105_80,r_136_45_124,seq65,r_48_105_80,1,0,80,80,89
46,r_122_127_145,seq10,seq43,r_122_127_145,0.93,0,145,145,89
12,r_3_41_30,seq70,r_133_92_190,r_3_41_30,0.48,0,30,30,89
41,r_1_33_44,seq20,r_103_58_199,r_1_33_44,1,0,44,44,89
14,r_69_88_198,r_44_67_46,seq108,r_44_67_46,1,0,46,46,89
69,seq146,r_133_92_190,r_3_41_30,r_3_41_30,0.68,160,190,30,89
45,r_47_40_137,seq34,seq137,r_47_40_137,0.96,0,137,137,89
91,seq108,r_69_88_198,r_73_38_8,r_73_38_8,0.94,2,10,8,89
23,r_103_58_199,r_4_25_66,r_1_33_44,r_103_58_199,0.97,-155,44,199,89
19,r_136_45_124,seq142,seq126,r_136_45_124,1,0,124,124,89
15,r_44_67_46,r_31_132_126,seq10,r_31_132_126,1,1,127,126,89
12,r_3_41_30,r_78_27_45,r_104_141_77,r_104_141_77,1,8,85,77,89
66,seq30,seq108,r_62_85_136,r_62_85_136,1,5,141,136,89
64,seq26,r_29_32_68,r_14_35_196,r_14_35_196,0.83,-185,11,196,89
61,seq20,r_1_33_44,seq46,r_1_33_44,0.97,-10,34,44,89
40,r_89_135_76,seq17,seq106,r_89_135_76,0.99,0,76,76,89
67,seq34,r_47_40_137,seq9,r_47_40_137,0.97,2,139,137,89
64,seq26,r_39_61_152,r_14_35_196,r_39_61_152,0.46,-77,75,152,89
28,r_12_124_29,seq13,seq101,r_12_124_29,0.99,0,29,29,89
3,r_115_147_94,seq98,r_87_128_132,r_115_147_94,0.98,1,95,94,89
10,r_29_32_68,seq82,r_50_118_172,r_29_32_68,1,1,69,68,89
90,seq106,seq109,r_89_135_76,r_89_135_76,1,1,77,76,89
25,r_78_27_45,seq20,r_3_41_30,r_78_27_45,0.96,0,45,45,89
26,r_15_91_151,seq101,seq13,r_15_91_151,0.78,1,152,151,89
72,seq46,r_131_22_135,r_31_132_126,r_31_132_126,1,16,142,126,89
16,r_52_16_188,r_6_102_28,seq30,r_6_102_28,0.44,160,188,28,89
78,seq70,r_116_19_20,seq59,r_116_19_20,0.42,67,87,20,89
14,r_69_88_198,seq108,r_62_85_136,r_62_85_136,1,0,136,136,89
4,r_55_56_141,seq24,r_148_36_90,r_55_56_141,0.87,0,141,141,89
0,r_94_107_170,seq65,seq24,r_94_107_170,0.76,0,170,170,89
11,r_130_51_168,seq109,r_112_119_105,r_130_51_168,0.31,0,168,168,89
73,seq137,r_103_58_199,r_47_40_137,r_47_40_137,0.91,0,137,137,89
20,r_133_92_190,seq146,r_63_74_116,r_133_92_190,0.25,0,190,190,89
48,r_87_128_132,seq126,r_115_147_94,r_115_147_94,0.83,1,95,94,89
49,r_31_132_126,r_44_67_46,seq46,r_31_132_126,1,0,126,126,89
85,seq90,r_50_118_172,r_29_32_68,r_29_32_68,1,89,157,68,89
64,seq26,r_14_35_196,r_122_127_145,r_122_127_145,0.64,5,150,145,89
10,r_29_32_68,r_50_118_172,seq90,r_50_118_172,1,0,172,172,89
13,r_50_118_172,r_29_32_68,r_39_61_152,r_50_118_172,0.99,0,172,172,89
91,seq108,r_73_38_8,r_93_84_138,r_93_84_138,1,4,142,138,89
2,r_95_57_147,seq65,r_144_7_14,r_95_57_147,0.8,0,147,147,89
47,r_49_83_154,seq0,seq43,r_49_83_154,0.86,0,154,154,89
13,r_50_118_172,seq90,r_29_32_68,r_29_32_68,0.83,40,108,68,89
18,r_39_61_152,r_148_36_90,seq82,r_148_36_90,1,-2,88,90,89
29,r_71_11_84,seq59,seq113,r_71_11_84,1,0,84,84,89
27,r_100_2_31,seq76,seq98,r_100_2_31,0.99,1,32,31,89
52,seq134,seq68,r_12_124_29,r_12_124_29,1,0,29,29,89
33,r_80_121_148,r_131_22_135,r_136_45_124,r_80_121_148,0.76,0,148,148,89
36,r_23_64_70,r_103_58_199,r_148_36_90,r_23_64_70,0.84,23,93,70,89
50,seq0,r_49_83_154,r_143_5_52,r_143_5_52,0.92,30,82,52,89
58,seq142,r_136_45_124,seq9,r_136_45_124,1,-4,120,124,89
6,r_97_77_6,seq106,r_111_53_112,r_111_53_112,1,2,114,112,89
68,seq37,r_52_16_188,r_6_102_28,r_52_16_188,0.5,-118,70,188,89
1,r_144_7_14,r_71_11_84,seq76,r_71_11_84,0.48,-60,24,84,89
32,r_54_139_67,r_47_40_137,r_100_2_31,r_54_139_67,0.99,0,67,67,89
38,r_62_85_136,r_138_72_57,r_69_88_198,r_62_85_136,0.66,0,136,136,89
34,r_104_141_77,r_115_147_94,r_3_41_30,r_104_141_77,0.97,6,83,77,89
15,r_44_67_46,r_69_88_198,r_31_132_126,r_44_67_46,1,0,46,46,89
40,r_89_135_76,seq129,r_145_125_7,r_145_125_7,0.95,16,23,7,89
80,seq76,r_100_2_31,r_144_7_14,r_100_2_31,0.64,-3,28,31,89
60,seq18,r_4_25_66,seq28,r_4_25_66,1,0,66,66,89
81,seq79,seq68,r_12_124_29,r_12_124_29,1,68,97,29,89
17,r_63_74_116,seq126,r_12_124_29,r_63_74_116,0.75,0,116,116,89
22,r_6_102_28,r_31_132_126,r_52_16_188,r_6_102_28,0.94,0,28,28,89
21,r_116_19_20,seq18,r_145_125_7,r_116_19_20,1,1,21,20,89
40,r_89_135_76,r_145_125_7,seq17,r_145_125_7,0.81,54,61,7,89
13,r_50_118_172,r_143_5_52,seq90,r_143_5_52,1,-3,49,52,89
12,r_3_41_30,r_133_92_190,r_78_27_45,r_3_41_30,0.59,19,49,30,89
7,r_111_53_112,seq137,r_97_77_6,r_111_53_112,0.85,0,112,112,89
18,r_39_61_152,seq82,seq66,r_39_61_152,0.53,7,159,152,89
44,r_148_36_90,r_39_61_152,r_23_64_70,r_148_36_90,1,0,90,90,89
3,r_115_147_94,r_87_128_132,r_136_45_124,r_87_128_132,0.66,6,138,132,89
48,r_87_128_132,r_115_147_94,r_136_45_124,r_87_128_132,0.7,3,135,132,89
43,r_145_125_7,seq0,r_116_19_20,r_145_125_7,0.42,36,43,7,89
49,r_31_132_126,r_122_127_145,r_44_67_46,r_44_67_46,1,0,46,46,89
35,r_4_25_66,seq18,seq65,r_4_25_66,1,0,66,66,89
36,r_103_57_119,seq37,r_147_94_45,r_147_94_45,1,42,87,45,90
36,r_103_57_119,r_147_94_45,r_81_22_196,r_147_94_45,0.47,75,120,45,90
14,r_141_127_64,r_32_42_81,seq144,r_141_127_64,1,1,65,64,90
29,r_129_142_46,seq134,seq90,r_129_142_46,1,0,46,46,90
8,r_4_52_169,seq135,r_45_84_10,r_45_84_10,0.97,168,178,10,90
43,r_29_19_109,r_71_39_145,r_64_75_88,r_71_39_145,1,-11,134,145,90
54,seq8,r_139_44_99,seq130,r_139_44_99,1,1,100,99,90
37,r_36_56_106,r_114_72_170,seq35,r_36_56_106,1,0,106,106,90
59,seq144,r_67_38_160,r_141_127_64,r_141_127_64,1,17,81,64,90
71,seq51,r_126_121_90,seq88,r_126_121_90,1,2,92,90,90
21,r_12_65_165,seq123,r_36_56_106,r_12_65_165,0.8,0,165,165,90
39,r_40_46_154,r_64_75_88,seq69,r_40_46_154,0.88,0,154,154,90
5,r_5_15_125,seq111,seq135,r_5_15_125,0.79,0,125,125,90
42,r_132_33_176,seq50,r_29_19_109,r_29_19_109,0.6,67,176,109,90
33,r_54_83_68,r_147_94_45,r_25_82_56,r_25_82_56,0.48,45,101,56,90
69,seq48,seq35,r_11_76_105,r_11_76_105,1,0,105,105,90
2,r_45_84_10,r_132_33_176,seq96,r_45_84_10,0.95,0,10,10,90
33,r_54_83_68,r_146_143_131,r_98_110_188,r_98_110_188,0.57,0,188,188,90
19,r_41_145_112,r_40_46_154,seq6,r_41_145_112,0.87,0,112,112,90
2,r_45_84_10,r_4_52_169,r_67_38_160,r_67_38_160,1,0,160,160,90
66,seq35,seq120,r_36_56_106,r_36_56_106,1,0,106,106,90
76,seq69,r_114_72_170,r_40_46_154,r_114_72_170,0.64,0,170,170,90
31,r_66_3_100,seq17,r_128_28_62,r_66_3_100,0.95,0,100,100,90
12,r_53_86_4,r_97_23_22,r_132_33_176,r_53_86_4,0.89,18,22,4,90
51,seq130,r_25_82_56,seq35,r_25_82_56,0.98,-11,45,56,90
12,r_53_86_4,r_139_44_99,r_102_49_60,r_53_86_4,0.35,177,181,4,90
3,r_136_117_185,r_71_39_145,r_64_75_88,r_71_39_145,1,-11,134,145,90
90,seq108,r_67_38_160,r_141_127_64,r_141_127_64,0.97,81,145,64,90
16,r_147_94_45,r_103_57_119,seq37,r_103_57_119,1,0,119,119,90
78,seq74,seq109,r_41_145_112,r_41_145_112,1,15,127,112,90
0,r_137_89_86,seq8,seq124,r_137_89_86,0.99,0,86,86,90
20,r_131_115_186,seq17,r_80_10_58,r_80_10_58,1,18,76,58,90
13,r_101_92_32,seq34,r_47_73_63,r_47_73_63,1,-2,61,63,90
98,seq123,r_12_65_165,r_126_121_90,r_126_121_90,0.97,5,95,90,90
48,r_71_39_145,r_136_117_185,seq51,r_71_39_145,0.94,0,145,145,90
93,seq118,seq91,r_133_63_76,r_133_63_76,0.67,3,79,76,90
49,r_47_73_63,seq34,r_79_68_102,r_79_68_102,1,37,139,102,90
9,r_125_27_55,seq7,seq91,r_125_27_55,1,0,55,55,90
83,seq90,r_5_15_125,r_129_142_46,r_129_142_46,0.78,0,46,46,90
6,r_128_28_62,seq119,r_98_110_188,r_128_28_62,1,1,63,62,90
2,r_45_84_10,seq96,r_4_52_169,r_45_84_10,0.47,62,72,10,90
99,seq124,seq7,r_137_89_86,r_137_89_86,1,25,111,86,90
55,seq9,r_137_89_86,r_131_115_186,r_131_115_186,0.69,0,186,186,90
27,r_32_42_81,r_141_127_64,r_126_121_90,r_141_127_64,0.79,0,64,64,90
84,seq91,r_16_93_190,r_125_27_55,r_125_27_55,1,0,55,55,90
47,r_139_44_99,seq8,r_53_86_4,r_139_44_99,0.89,1,100,99,90
40,r_85_21_95,r_79_68_102,r_80_10_58,r_85_21_95,0.86,0,95,95,90
16,r_147_94_45,r_79_68_102,r_103_57_119,r_147_94_45,0.63,0,45,45,90
18,r_98_110_188,seq96,r_128_28_62,r_128_28_62,1,3,65,62,90
11,r_97_23_22,r_53_86_4,seq24,r_97_23_22,0.95,0,22,22,90
25,r_113_30_139,r_71_39_145,seq104,r_113_30_139,0.5,0,139,139,90
33,r_54_83_68,seq140,r_147_94_45,r_54_83_68,1,0,68,68,90
47,r_139_44_99,r_53_86_4,r_102_49_60,r_53_86_4,0.53,179,183,4,90
50,seq0,r_132_33_176,r_43_107_8,r_43_107_8,0.46,131,139,8,90
58,seq14,r_47_73_63,seq118,r_47_73_63,1,0,63,63,90
70,seq50,r_132_33_176,r_114_72_170,r_132_33_176,0.37,0,176,176,90
6,r_128_28_62,r_98_110_188,r_66_3_100,r_66_3_100,0.95,88,188,100,90
33,r_54_83_68,r_25_82_56,r_146_143_131,r_25_82_56,0.56,55,111,56,90
12,r_53_86_4,r_132_33_176,r_102_49_60,r_102_49_60,0.8,4,64,60,90
20,r_131_115_186,r_80_10_58,seq9,r_131_115_186,0.56,0,186,186,90
68,seq135,r_4_52_169,r_5_15_125,r_5_15_125,1,32,157,125,90
61,seq18,r_116_31_101,seq148,r_116_31_101,1,-18,83,101,90
32,r_67_38_160,seq108,r_45_84_10,r_67_38_160,0.92,0,160,160,90
38,r_64_75_88,r_40_46_154,r_29_19_109,r_40_46_154,1,0,154,154,90
34,r_2_61_159,seq109,r_11_76_105,r_2_61_159,0.49,0,159,159,90
17,r_80_10_58,seq9,r_131_115_186,r_80_10_58,1,0,58,58,90
29,r_129_142_46,seq90,r_32_42_81,r_32_42_81,1,0,81,81,90
12,r_53_86_4,r_102_49_60,r_139_44_99,r_139_44_99,0.71,9,108,99,90
81,seq87,seq48,r_36_56_106,r_36_56_106,1,36,142,106,90
28,r_25_82_56,seq130,seq123,r_25_82_56,0.89,0,56,56,90
94,seq119,r_128_28_62,r_149_58_2,r_128_28_62,1,1,63,62,90
73,seq59,r_102_49_60,seq51,r_102_49_60,1,-3,57,60,90
96,seq148,r_133_63_76,seq18,r_133_63_76,1,1,77,76,90
3,r_136_117_185,r_64_75_88,seq74,r_136_117_185,0.97,0,185,185,90
28,r_25_82_56,seq123,r_146_143_131,r_25_82_56,0.49,123,179,56,90
22,r_11_76_105,r_136_117_185,seq48,r_11_76_105,0.98,0,105,105,90
49,r_47_73_63,seq14,seq34,r_47_73_63,1,0,63,63,90
41,r_102_49_60,seq59,r_53_86_4,r_102_49_60,0.8,-2,58,60,90
27,r_32_42_81,r_126_121_90,r_129_142_46,r_32_42_81,0.93,-3,78,81,90
56,seq140,r_54_83_68,seq13,r_54_83_68,0.99,1,69,68,90
7,r_79_68_102,r_85_21_95,r_47_73_63,r_79_68_102,0.94,-7,95,102,90
18,r_98_110_188,r_128_28_62,r_54_83_68,r_98_110_188,0.7,0,188,188,90
44,r_146_143_131,r_132_33_176,r_54_83_68,r_132_33_176,0.91,-45,131,176,90
23,r_126_121_90,seq51,seq123,r_126_121_90,0.98,1,91,90,90
17,r_80_10_58,r_131_115_186,r_85_21_95,r_85_21_95,1,91,186,95,90
35,r_133_63_76,seq148,seq118,r_133_63_76,0.99,1,77,76,90
55,seq9,seq7,r_137_89_86,r_137_89_86,1,11,97,86,90
30,r_45_13_118,seq0,r_20_102_106,r_45_13_118,0.97,0,118,118,91
44,r_26_115_182,r_19_105_7,seq136,r_26_115_182,0.62,0,182,182,91
8,r_60_18_72,r_77_110_49,r_140_66_147,r_60_18_72,0.97,-25,47,72,91
39,r_64_135_61,r_48_93_23,seq143,r_64_135_61,0.95,0,61,61,91
43,r_142_61_192,seq121,r_129_8_73,r_129_8_73,1,0,73,73,91
37,r_138_113_155,seq116,r_48_93_23,r_138_113_155,0.81,1,156,155,91
5,r_92_111_196,seq32,r_65_27_22,r_65_27_22,1,0,22,22,91
21,r_125_4_85,seq0,seq70,r_125_4_85,1,4,89,85,91
1,r_90_12_71,seq143,r_14_79_81,r_90_12_71,0.66,0,71,71,91
97,seq121,r_89_104_193,r_144_50_121,r_144_50_121,0.99,12,133,121,91
42,r_147_132_78,seq56,seq141,r_147_132_78,1,0,78,78,91
35,r_94_106_46,r_21_134_134,seq76,r_94_106_46,0.94,5,51,46,91
45,r_14_79_81,r_90_12_71,r_65_27_22,r_14_79_81,0.92,0,81,81,91
19,r_109_17_126,seq47,seq28,r_109_17_126,0.94,0,126,126,91
27,r_108_83_60,r_64_135_61,r_15_33_133,r_108_83_60,0.79,72,132,60,91
95,seq116,r_138_113_155,seq28,r_138_113_155,1,-16,139,155,91
48,r_48_93_23,r_64_135_61,r_75_42_91,r_64_135_61,0.73,0,61,61,91
45,r_14_79_81,r_109_17_126,r_90_12_71,r_14_79_81,0.55,-10,71,81,91
38,r_19_105_7,r_26_115_182,r_39_107_24,r_19_105_7,0.82,164,171,7,91
31,r_38_85_162,seq143,seq54,r_38_85_162,0.82,2,164,162,91
3,r_127_72_125,seq46,r_99_133_39,r_127_72_125,0.79,9,134,125,91
10,r_86_55_184,seq118,seq24,r_86_55_184,0.34,0,184,184,91
26,r_75_42_91,r_123_69_175,r_48_93_23,r_75_42_91,0.63,6,97,91,91
18,r_77_110_49,r_60_18_72,seq23,r_77_110_49,0.82,0,49,49,91
4,r_21_134_134,seq118,seq95,r_21_134_134,0.97,0,134,134,91
32,r_99_133_39,r_11_80_89,seq70,r_99_133_39,1,2,41,39,91
0,r_120_97_86,r_38_85_162,r_94_106_46,r_120_97_86,0.66,2,88,86,91
63,seq23,seq122,r_77_110_49,r_77_110_49,1,56,105,49,91
22,r_20_102_106,r_108_83_60,r_45_13_118,r_20_102_106,0.73,12,118,106,91
73,seq46,r_127_72_125,seq62,r_127_72_125,0.99,2,127,125,91
11,r_119_10_178,seq51,r_21_134_134,r_119_10_178,0.39,0,178,178,91
39,r_64_135_61,seq126,r_48_93_23,r_48_93_23,1,8,31,23,91
16,r_82_149_82,r_94_106_46,r_148_57_76,r_82_149_82,1,0,82,82,91
20,r_144_50_121,seq51,seq121,r_144_50_121,0.96,0,121,121,91
13,r_140_66_147,seq46,seq51,r_140_66_147,0.86,1,148,147,91
46,r_35_73_40,seq141,seq67,r_35_73_40,0.31,93,133,40,91
1,r_90_12_71,seq1,r_123_69_175,r_90_12_71,0.45,114,185,71,91
85,seq141,seq67,r_35_73_40,r_35_73_40,1,29,69,40,91
46,r_35_73_40,r_89_104_193,seq141,r_35_73_40,0.99,0,40,40,91
45,r_14_79_81,seq91,r_109_17_126,r_14_79_81,0.66,-34,47,81,91
27,r_108_83_60,seq2,r_64_135_61,r_108_83_60,1,1,61,60,91
47,r_44_30_68,r_100_5_132,seq101,r_44_30_68,1,0,68,68,91
74,seq47,r_109_17_126,seq131,r_109_17_126,1,0,126,126,91
29,r_41_114_97,seq122,r_63_22_52,r_41_114_97,0.89,0,97,97,91
34,r_52_124_112,seq122,seq130,r_52_124_112,0.93,0,112,112,91
25,r_63_22_52,r_82_149_82,seq2,r_63_22_52,0.95,20,72,52,91
33,r_11_80_89,seq98,seq0,r_11_80_89,1,0,89,89,91
16,r_82_149_82,r_63_22_52,r_94_106_46,r_82_149_82,0.78,-34,48,82,91
29,r_41_114_97,r_63_22_52,r_144_50_121,r_144_50_121,0.47,20,141,121,91
1,r_90_12_71,r_14_79_81,seq1,r_14_79_81,0.59,0,81,81,91
6,r_84_3_54,seq112,seq25,r_84_3_54,1,0,54,54,91
48,r_48_93_23,r_75_42_91,seq126,r_48_93_23,0.41,56,79,23,91
50,seq0,r_45_13_118,r_11_80_89,r_11_80_89,0.65,29,118,89,91
68,seq31,seq145,r_82_149_82,r_82_149_82,0.99,11,93,82,91
41,r_71_59_28,r_127_72_125,seq122,r_71_59_28,1,0,28,28,91
2,r_39_107_24,r_20_102_106,r_19_105_7,r_39_107_24,0.98,1,25,24,91
40,r_65_27_22,seq70,r_92_111_196,r_65_27_22,0.99,1,23,22,91
75,seq51,r_119_10_178,r_140_66_147,r_140_66_147,0.86,31,178,147,91
48,r_48_93_23,r_45_13_118,r_64_135_61,r_48_93_23,0.97,0,23,23,91
4,r_21_134_134,seq95,r_119_10_178,r_119_10_178,0.52,2,180,178,91
81,seq67,seq141,r_35_73_40,r_35_73_40,1,93,133,40,91
17,r_129_8_73,r_125_4_85,r_142_61_192,r_129_8_73,1,0,73,73,91
96,seq118,r_21_134_134,r_86_55_184,r_21_134_134,1,0,134,134,91
22,r_20_102_106,r_119_10_178,r_108_83_60,r_108_83_60,0.85,47,107,60,91
28,r_34_16_136,seq46,seq68,r_34_16_136,0.88,0,136,136,91
91,seq98,r_11_80_89,seq130,r_11_80_89,1,-27,62,89,91
99,seq126,r_123_69_175,r_48_93_23,r_48_93_23,0.75,20,43,23,91
56,seq136,r_58_96_188,r_26_115_182,r_26_115_182,0.54,6,188,182,91
23,r_123_69_175,seq112,r_90_12_71,r_123_69_175,0.5,0,175,175,91
96,seq118,r_86_55_184,seq9,r_86_55_184,0.75,1,185,184,91
79,seq56,r_147_132_78,seq43,r_147_132_78,1,0,78,78,91
12,r_117_49_83,seq141,seq122,r_117_49_83,0.92,0,83,83,91
75,seq53,r_49_105_110,r_58_5_118,r_49_105_110,0.79,59,169,110,92
17,r_149_130_114,seq85,r_69_78_43,r_69_78_43,0.99,2,45,43,92
36,r_19_38_92,r_90_2_154,r_34_55_13,r_19_38_92,1,2,94,92,92
2,r_1_46_27,seq8,r_27_133_65,r_1_46_27,0.88,0,27,27,92
14,r_10_50_182,seq118,r_88_119_174,r_10_50_182,0.45,0,182,182,92
8,r_124_6_120,seq29,seq137,r_124_6_120,1,0,120,120,92
43,r_121_112_159,r_36_142_70,seq139,r_36_142_70,1,0,70,70,92
54,seq139,r_121_112_159,seq72,r_121_112_159,0.92,0,159,159,92
83,seq73,seq131,r_110_0_162,r_110_0_162,0.62,-13,149,162,92
59,seq20,r_94_96_158,seq57,r_94_96_158,0.89,0,158,158,92
6,r_21_9_72,seq7,seq24,r_21_9_72,0.56,41,113,72,92
5,r_90_2_154,r_19_38_92,seq71,r_19_38_92,0.87,2,94,92,92
46,r_134_39_191,r_49_105_110,r_116_115_68,r_134_39_191,0.85,-81,110,191,92
52,seq8,r_1_46_27,seq72,r_1_46_27,0.71,0,27,27,92
32,r_126_22_17,seq43,r_52_104_48,r_52_104_48,1,49,97,48,92
7,r_52_104_48,seq43,r_126_22_17,r_126_22_17,0.5,100,117,17,92
66,seq31,seq93,r_149_130_114,r_149_130_114,1,3,117,114,92
20,r_3_62_21,r_111_114_89,seq43,r_3_62_21,0.75,0,21,21,92
73,seq43,seq137,r_52_104_48,r_52_104_48,1,1,49,48,92
41,r_135_143_123,seq41,seq59,r_135_143_123,0.99,0,123,123,92
91,seq95,seq87,r_83_106_77,r_83_106_77,0.47,59,136,77,92
10,r_140_47_167,seq102,r_11_26_73,r_140_47_167,0.56,0,167,167,92
90,seq93,r_88_119_174,r_149_130_114,r_149_130_114,0.79,61,175,114,92
35,r_34_55_13,r_140_47_167,r_97_129_146,r_34_55_13,0.89,1,14,13,92
26,r_91_89_188,seq28,r_10_50_182,r_91_89_188,0.41,0,188,188,92
72,seq42,r_15_64_149,r_37_101_169,r_15_64_149,0.71,-30,119,149,92
4,r_148_65_82,r_63_82_128,r_86_54_18,r_148_65_82,0.68,3,85,82,92
78,seq60,seq33,r_132_100_54,r_132_100_54,1,6,60,54,92
0,r_116_115_68,seq41,r_134_39_191,r_116_115_68,1,-1,67,68,92
11,r_97_129_146,r_34_55_13,r_27_133_65,r_97_129_146,0.69,0,146,146,92
3,r_127_138_49,seq107,seq17,r_127_138_49,1,0,49,49,92
13,r_125_13_85,seq70,r_86_54_18,r_125_13_85,1,0,85,85,92
98,seq118,r_10_50_182,r_16_67_58,r_16_67_58,0.55,124,182,58,92
15,r_111_114_89,seq107,seq85,r_111_114_89,1,0,89,89,92
48,r_122_99_64,r_140_47_167,r_83_106_77,r_140_47_167,0.45,-90,77,167,92
7,r_52_104_48,seq33,seq43,r_52_104_48,0.99,0,48,48,92
57,seq18,seq109,r_128_45_67,r_128_45_67,1,2,69,67,92
6,r_21_9_72,seq98,seq7,r_21_9_72,0.87,0,72,72,92
95,seq107,r_27_133_65,r_88_119_174,r_88_119_174,0.99,7,181,174,92
52,seq8,seq72,r_68_76_79,r_68_76_79,0.96,31,110,79,92
45,r_94_96_158,r_69_78_43,seq20,r_69_78_43,1,2,45,43,92
28,r_27_133_65,seq44,r_1_46_27,r_1_46_27,0.71,11,38,27,92
27,r_83_106_77,seq103,r_122_99_64,r_83_106_77,0.59,78,155,77,92
95,seq107,r_111_114_89,r_27_133_65,r_111_114_89,0.72,0,89,89,92
2,r_1_46_27,seq66,seq44,r_1_46_27,0.59,74,101,27,92
49,r_63_82_128,r_11_26_73,r_86_54_18,r_63_82_128,0.97,3,131,128,92
47,r_68_76_79,seq147,seq25,r_68_76_79,1,0,79,79,92
40,r_15_64_149,seq42,seq107,r_15_64_149,0.98,3,152,149,92
18,r_37_101_169,r_15_64_149,seq42,r_15_64_149,0.65,-30,119,149,92
29,r_79_123_74,seq33,r_11_26_73,r_79_123_74,1,0,74,74,92
24,r_128_45_67,seq84,seq18,r_128_45_67,1,0,67,67,92
35,r_34_55_13,r_97_129_146,r_19_38_92,r_19_38_92,0.93,54,146,92,92
25,r_16_67_58,seq17,seq118,r_16_67_58,0.81,4,62,58,92
21,r_136_75_153,seq23,r_144_108_14,r_144_108_14,0.9,12,26,14,92
48,r_122_99_64,r_83_106_77,r_12_48_161,r_12_48_161,0.99,13,174,161,92
42,r_117_145_47,seq109,seq103,r_117_145_47,1,0,47,47,92
88,seq85,seq80,r_111_114_89,r_111_114_89,1,5,94,89,92
37,r_69_78_43,r_94_96_158,r_149_130_114,r_69_78_43,1,2,45,43,92
68,seq33,r_79_123_74,seq60,r_79_123_74,1,-4,70,74,92
95,seq107,r_127_138_49,r_111_114_89,r_127_138_49,1,1,50,49,92
77,seq59,seq146,r_135_143_123,r_135_143_123,0.97,3,126,123,92
34,r_58_5_118,seq80,seq53,r_58_5_118,0.99,0,118,118,92
5,r_90_2_154,seq71,seq66,r_90_2_154,0.94,-6,148,154,92
30,r_144_108_14,seq43,r_136_75_153,r_144_108_14,0.95,1,15,14,92
75,seq53,seq147,r_49_105_110,r_49_105_110,0.67,0,110,110,92
2,r_1_46_27,r_27_133_65,seq66,r_27_133_65,1,0,65,65,92
45,r_94_96_158,seq20,r_3_62_21,r_94_96_158,0.87,0,158,158,92
28,r_27_133_65,seq107,r_97_129_146,r_97_129_146,1,3,149,146,92
94,seq103,r_83_106_77,r_117_145_47,r_117_145_47,0.98,21,68,47,92
22,r_11_26_73,r_63_82_128,r_79_123_74,r_63_82_128,1,2,130,128,92
62,seq25,seq72,r_68_76_79,r_68_76_79,0.74,2,81,79,92
72,seq42,r_37_101_169,r_116_115_68,r_37_101_169,0.98,0,169,169,92
16,r_4_56_11,r_1_46_27,seq29,r_4_56_11,0.6,0,11,11,92
37,r_69_78_43,r_149_130_114,seq85,r_149_130_114,0.97,0,114,114,92
22,r_11_26_73,seq146,r_63_82_128,r_11_26_73,0.84,0,73,73,92
49,r_63_82_128,r_148_65_82,r_11_26_73,r_63_82_128,0.94,-46,82,128,92
74,seq44,r_27_133_65,seq66,r_27_133_65,0.98,-16,49,65,92
56,seq17,r_16_67_58,r_127_138_49,r_127_138_49,0.9,13,62,49,92
44,r_49_105_110,r_134_39_191,r_58_5_118,r_49_105_110,0.95,9,119,110,92
9,r_86_54_18,seq25,seq113,r_86_54_18,0.99,0,18,18,92
23,r_12_48_161,seq29,r_122_99_64,r_12_48_161,0.59,2,163,161,92
28,r_27_133_65,r_1_46_27,seq107,r_27_133_65,0.86,0,65,65,92
17,r_149_130_114,r_69_78_43,seq31,r_149_130_114,1,0,114,114,92
35,r_34_55_13,r_19_38_92,r_37_101_169,r_37_101_169,0.81,2,171,169,92
32,r_126_22_17,r_68_76_79,seq43,r_126_22_17,1,0,17,17,92
12,r_110_0_162,r_134_39_191,r_128_45_67,r_110_0_162,0.61,1,163,162,92
18,r_37_101_169,seq42,r_34_55_13,r_37_101_169,0.94,1,170,169,92
9,r_147_95_136,seq29,r_111_65_41,r_147_95_136,0.85,-1,135,136,93
92,seq103,r_106_69_110,seq84,r_106_69_110,1,1,111,110,93
45,r_60_31_23,r_21_2_94,r_106_69_110,r_106_69_110,0.74,2,112,110,93
86,seq84,r_133_54_60,seq103,r_133_54_60,0.58,108,168,60,93
54,seq7,seq28,r_136_18_132,r_136_18_132,1,18,150,132,93
37,r_135_114_146,seq40,r_147_95_136,r_135_114_146,0.6,0,146,146,93
3,r_97_75_42,r_77_138_108,r_96_143_48,r_77_138_108,0.95,0,108,108,93
59,seq24,r_83_61_135,r_119_128_61,r_119_128_61,0.96,72,133,61,93
21,r_12_32_81,r_20_120_123,seq7,r_12_32_81,1,0,81,81,93
1,r_42_26_169,seq86,r_77_138_108,r_42_26_169,0.84,0,169,169,93
5,r_133_54_60,seq0,seq98,r_133_54_60,1,0,60,60,93
18,r_6_15_28,r_136_18_132,seq37,r_6_15_28,1,1,29,28,93
43,r_91_47_91,r_106_69_110,r_14_125_74,r_14_125_74,0.47,2,76,74,93
19,r_46_13_104,r_146_25_161,seq38,r_46_13_104,0.99,0,104,104,93
11,r_44_23_22,r_147_95_136,seq0,r_44_23_22,0.99,0,22,22,93
66,seq38,seq30,r_46_13_104,r_46_13_104,0.99,6,110,104,93
15,r_146_25_161,r_35_93_198,r_55_73_137,r_146_25_161,1,2,163,161,93
78,seq71,r_94_130_181,r_117_108_175,r_94_130_181,0.58,-3,178,181,93
35,r_63_5_145,r_137_142_188,seq88,r_63_5_145,1,0,145,145,93
46,r_111_65_41,r_60_31_23,r_77_138_108,r_60_31_23,0.84,-3,20,23,93
9,r_147_95_136,r_44_23_22,seq29,r_44_23_22,0.54,1,23,22,93
31,r_119_128_61,r_113_121_199,r_83_61_135,r_119_128_61,1,0,61,61,93
41,r_102_90_68,seq71,r_116_127_59,r_102_90_68,0.98,0,68,68,93
6,r_11_141_31,seq80,seq3,r_11_141_31,0.96,0,31,31,93
10,r_14_125_74,r_33_45_196,r_19_110_173,r_14_125_74,0.77,14,88,74,93
39,r_53_101_115,r_55_73_137,r_6_15_28,r_53_101_115,0.98,-75,40,115,93
4,r_33_45_196,r_14_125_74,seq98,r_14_125_74,0.66,9,83,74,93
44,r_16_149_171,r_119_128_61,r_136_18_132,r_16_149_171,0.99,0,171,171,93
45,r_60_31_23,r_111_65_41,seq56,r_60_31_23,0.83,1,24,23,93
45,r_60_31_23,seq56,r_137_142_188,r_60_31_23,0.67,44,67,23,93
78,seq71,r_102_90_68,r_94_130_181,r_102_90_68,1,0,68,68,93
0,r_136_18_132,seq74,seq7,r_136_18_132,0.93,0,132,132,93
45,r_60_31_23,r_137_142_188,r_21_2_94,r_60_31_23,0.67,65,88,23,93
13,r_51_36_101,seq3,r_139_107_189,r_51_36_101,1,0,101,101,93
48,r_43_4_47,r_48_79_29,r_113_121_199,r_48_79_29,0.53,0,29,29,93
15,r_146_25_161,r_46_13_104,r_35_93_198,r_46_13_104,1,0,104,104,93
46,r_111_65_41,seq66,r_147_95_136,r_147_95_136,0.93,0,136,136,93
49,r_49_144_63,r_63_5_145,r_55_73_137,r_49_144_63,0.95,82,145,63,93
57,seq131,r_139_107_189,r_41_10_58,r_41_10_58,1,4,62,58,93
33,r_21_2_94,r_145_87_38,r_60_31_23,r_21_2_94,0.93,0,94,94,93
10,r_14_125_74,r_19_110_173,r_140_122_153,r_14_125_74,0.96,79,153,74,93
27,r_85_22_92,r_106_69_110,seq86,r_85_22_92,1,2,94,92,93
33,r_21_2_94,seq57,r_145_87_38,r_145_87_38,1,2,40,38,93
87,seq86,r_42_26_169,r_113_121_199,r_42_26_169,0.98,0,169,169,93
30,r_41_10_58,seq98,seq131,r_41_10_58,1,0,58,58,93
42,r_77_138_108,r_111_65_41,r_97_75_42,r_77_138_108,0.99,-67,41,108,93
40,r_116_127_59,seq39,r_102_90_68,r_116_127_59,0.71,12,71,59,93
2,r_20_120_123,seq124,seq67,r_20_120_123,0.89,0,123,123,93
47,r_112_17_85,r_139_107_189,r_35_93_198,r_112_17_85,0.99,0,85,85,93
24,r_19_110_173,seq148,r_96_143_48,r_19_110_173,0.5,1,174,173,93
25,r_94_130_181,seq71,seq39,r_94_130_181,0.47,0,181,181,93
43,r_91_47_91,seq105,r_106_69_110,r_91_47_91,0.56,-57,34,91,93
48,r_43_4_47,r_113_121_199,r_6_15_28,r_43_4_47,0.87,1,48,47,93
35,r_63_5_145,r_49_144_63,r_137_142_188,r_137_142_188,0.81,-76,112,188,93
88,seq88,r_83_61_135,r_119_128_61,r_119_128_61,1,65,126,61,93
43,r_91_47_91,r_14_125_74,r_52_70_2,r_91_47_91,0.91,2,93,91,93
50,seq0,r_133_54_60,r_44_23_22,r_133_54_60,1,0,60,60,93
68,seq40,r_135_114_146,seq8,r_135_114_146,0.97,2,148,146,93
33,r_21_2_94,r_106_69_110,r_83_61_135,r_83_61_135,0.97,21,156,135,93
42,r_77_138_108,r_97_75_42,seq34,r_77_138_108,1,0,108,108,93
32,r_137_142_188,r_63_5_145,r_55_73_137,r_55_73_137,0.97,8,145,137,93
38,r_123_78_124,seq62,seq9,r_123_78_124,1,0,124,124,93
52,seq3,r_51_36_101,r_11_141_31,r_51_36_101,0.63,-19,82,101,93
77,seq67,r_52_70_2,r_20_120_123,r_20_120_123,0.99,13,136,123,93
14,r_145_87_38,r_21_2_94,seq76,r_21_2_94,1,0,94,94,93
34,r_134_68_77,r_20_120_123,seq62,r_134_68_77,1,0,77,77,93
33,r_21_2_94,r_60_31_23,r_106_69_110,r_106_69_110,0.82,1,111,110,93
29,r_96_143_48,r_113_121_199,seq74,r_96_143_48,1,0,48,48,93
17,r_55_73_137,r_53_101_115,r_49_144_63,r_55_73_137,0.98,0,137,137,93
88,seq88,r_119_128_61,r_63_5_145,r_63_5_145,1,0,145,145,93
31,r_119_128_61,r_83_61_135,seq88,r_83_61_135,1,-3,132,135,93
46,r_111_65_41,r_77_138_108,seq66,r_111_65_41,0.9,0,41,41,93
28,r_140_122_153,r_146_25_161,r_14_125_74,r_140_122_153,0.83,-1,152,153,93
22,r_106_69_110,seq103,r_21_2_94,r_106_69_110,0.6,1,111,110,93
28,r_140_122_153,seq56,r_146_25_161,r_140_122_153,0.53,-92,61,153,93
32,r_137_142_188,r_55_73_137,r_14_125_74,r_137_142_188,0.98,0,188,188,93
49,r_49_144_63,seq34,r_63_5_145,r_49_144_63,0.98,1,64,63,93
21,r_12_32_81,seq7,r_123_78_124,r_123_78_124,1,4,128,124,93
7,r_83_61_135,r_16_149_171,r_21_2_94,r_83_61_135,0.88,0,135,135,93
44,r_16_149_171,r_83_61_135,r_119_128_61,r_119_128_61,0.99,78,139,61,93
20,r_48_79_29,r_43_4_47,seq29,r_48_79_29,1,0,29,29,93
23,r_35_93_198,r_146_25_161,r_112_17_85,r_112_17_85,1,7,92,85,93
35,r_63_5_145,r_137_142_188,r_49_144_63,r_49_144_63,1,25,88,63,93
14,r_145_87_38,seq1,r_21_2_94,r_145_87_38,0.64,0,38,38,93
36,r_89_100_44,r_111_65_41,seq1,r_89_100_44,0.77,130,174,44,93
3,r_97_75_42,seq27,r_77_138_108,r_97_75_42,1,0,42,42,93
36,r_105_45_61,seq51,r_146_57_188,r_105_45_61,1,0,61,61,94
14,r_127_70_60,seq0,seq104,r_127_70_60,0.91,0,60,60,94
43,r_146_57_188,seq50,r_105_45_61,r_105_45_61,1,78,139,61,94
54,seq132,seq6,r_148_35_39,r_148_35_39,0.99,128,167,39,94
83,seq68,r_81_22_117,seq59,r_81_22_117,1,0,117,117,94
37,r_15_91_79,r_98_31_155,r_44_111_5,r_15_91_79,1,0,79,79,94
19,r_80_47_144,r_73_9_38,r_119_99_22,r_80_47_144,0.67,0,144,144,94
86,seq76,r_118_82_143,r_48_96_65,r_48_96_65,0.92,32,97,65,94
1,r_46_136_66,r_61_41_193,seq37,r_46_136_66,1,1,67,66,94
42,r_118_82_143,seq76,r_127_70_60,r_118_82_143,0.99,0,143,143,94
22,r_44_111_5,seq3,r_15_91_79,r_44_111_5,0.64,123,128,5,94
31,r_74_110_29,seq55,r_89_122_101,r_74_110_29,0.97,0,29,29,94
7,r_30_125_48,seq133,r_21_101_7,r_30_125_48,0.94,1,49,48,94
30,r_119_99_22,r_123_128_85,seq0,r_119_99_22,0.86,0,22,22,94
15,r_100_145_42,r_105_45_61,seq144,r_100_145_42,0.98,0,42,42,94
95,seq113,r_84_97_140,r_112_86_111,r_112_86_111,1,4,115,111,94
67,seq26,r_43_32_185,r_148_35_39,r_148_35_39,1,146,185,39,94
3,r_42_36_115,r_89_122_101,r_74_110_29,r_74_110_29,0.57,67,96,29,94
10,r_102_79_158,seq113,seq8,r_102_79_158,0.66,0,158,158,94
26,r_27_103_146,seq13,r_60_135_192,r_60_135_192,0.51,-102,90,192,94
8,r_143_85_14,seq10,r_149_1_75,r_149_1_75,1,18,93,75,94
72,seq37,seq64,r_46_136_66,r_46_136_66,1,2,68,66,94
4,r_149_1_75,r_66_83_106,r_143_85_14,r_149_1_75,0.96,0,75,75,94
59,seq11,r_106_95_55,r_147_140_72,r_106_95_55,0.63,0,55,55,94
8,r_143_85_14,seq23,seq10,r_143_85_14,0.95,1,15,14,94
73,seq49,r_131_67_176,r_89_122_101,r_89_122_101,1,23,124,101,94
20,r_98_31_155,seq78,seq54,r_98_31_155,0.58,1,156,155,94
13,r_43_32_185,seq26,seq121,r_43_32_185,0.41,-4,181,185,94
46,r_89_122_101,r_74_110_29,seq49,r_89_122_101,1,0,101,101,94
48,r_4_69_107,r_24_114_124,r_102_79_158,r_4_69_107,0.94,0,107,107,94
26,r_27_103_146,r_60_135_192,r_17_72_69,r_27_103_146,1,0,146,146,94
19,r_80_47_144,r_123_128_85,r_73_9_38,r_123_128_85,1,-26,59,85,94
45,r_65_137_45,r_80_47_144,r_130_115_63,r_130_115_63,0.69,0,63,63,94
31,r_74_110_29,r_146_57_188,r_62_20_110,r_74_110_29,0.83,87,116,29,94
6,r_56_109_129,seq2,r_149_1_75,r_56_109_129,0.9,7,136,129,94
48,r_4_69_107,r_102_79_158,r_112_86_111,r_102_79_158,1,0,158,158,94
2,r_106_95_55,r_30_125_48,r_139_39_151,r_139_39_151,0.99,2,153,151,94
99,seq124,seq25,r_73_9_38,r_73_9_38,0.39,69,107,38,94
45,r_65_137_45,r_21_101_7,r_80_47_144,r_80_47_144,0.5,-99,45,144,94
36,r_105_45_61,r_146_57_188,seq50,r_146_57_188,0.9,-24,164,188,94
27,r_139_39_151,seq55,r_106_95_55,r_139_39_151,0.83,1,152,151,94
30,r_119_99_22,seq0,r_80_47_144,r_80_47_144,0.73,0,144,144,94
25,r_73_9_38,seq104,r_80_47_144,r_73_9_38,0.78,0,38,38,94
87,seq78,r_98_31_155,r_147_140_72,r_98_31_155,0.73,0,155,155,94
47,r_81_22_117,seq68,seq2,r_81_22_117,1,0,117,117,94
40,r_87_90_91,r_81_22_117,seq11,r_87_90_91,1,0,91,91,94
74,seq50,r_146_57_188,r_105_45_61,r_105_45_61,1,89,150,61,94
18,r_24_114_124,seq11,seq10,r_24_114_124,0.98,0,124,124,94
29,r_123_128_85,seq25,r_44_111_5,r_123_128_85,0.99,0,85,85,94
24,r_58_38_59,r_21_101_7,seq19,r_21_101_7,0.71,107,114,7,94
33,r_48_96_65,seq121,seq76,r_48_96_65,1,0,65,65,94
64,seq19,r_58_38_59,r_84_97_140,r_58_38_59,0.56,102,161,59,94
3,r_42_36_115,r_74_110_29,seq28,r_42_36_115,0.94,0,115,115,94
21,r_117_5_11,seq54,seq37,r_117_5_11,0.89,0,11,11,94
38,r_66_83_106,seq76,seq28,r_66_83_106,0.95,0,106,106,94
92,seq104,r_73_9_38,r_18_77_127,r_73_9_38,0.96,0,38,38,94
75,seq51,r_105_45_61,r_27_103_146,r_105_45_61,0.83,0,61,61,94
17,r_147_140_72,r_98_31_155,seq11,r_147_140_72,0.94,0,72,72,94
43,r_146_57_188,r_105_45_61,r_112_86_111,r_146_57_188,0.98,-1,187,188,94
25,r_73_9_38,r_80_47_144,seq124,r_80_47_144,0.89,-9,135,144,94
9,r_17_72_69,seq55,seq104,r_17_72_69,1,0,69,69,94
31,r_74_110_29,r_89_122_101,r_146_57_188,r_89_122_101,0.75,-5,96,101,94
22,r_44_111_5,r_149_1_75,seq3,r_149_1_75,1,0,75,75,94
14,r_127_70_60,seq104,r_130_115_63,r_127_70_60,0.7,28,88,60,94
28,r_62_20_110,seq144,r_74_110_29,r_62_20_110,1,0,110,110,94
46,r_89_122_101,r_146_57_188,r_74_110_29,r_74_110_29,1,-1,28,29,94
49,r_16_7_138,seq108,r_148_35_39,r_148_35_39,0.94,101,140,39,94
2,r_106_95_55,seq11,r_30_125_48,r_106_95_55,0.99,0,55,55,94
44,r_131_67_176,seq49,seq53,r_131_67_176,0.31,0,176,176,94
14,r_127_70_60,r_130_115_63,r_118_82_143,r_118_82_143,1,0,143,143,94
60,seq12,r_30_125_48,r_58_38_59,r_30_125_48,0.43,83,131,48,94
30,r_123_125_180,r_63_145_181,r_113_18_80,r_113_18_80,1,5,85,80,95
12,r_39_109_192,seq16,r_29_74_55,r_29_74_55,1,2,57,55,95
36,r_8_58_72,seq4,r_39_109_192,r_8_58_72,0.87,0,72,72,95
25,r_69_1_39,seq45,r_113_18_80,r_69_1_39,0.9,4,43,39,95
14,r_121_11_156,seq129,r_53_80_135,r_121_11_156,0.8,0,156,156,95
8,r_132_33_187,r_53_80_135,r_15_38_42,r_15_38_42,0.7,20,62,42,95
53,seq4,r_8_58_72,seq2,r_8_58_72,1,-4,68,72,95
43,r_130_82_133,seq131,r_120_21_81,r_130_82_133,0.79,0,133,133,95
0,r_93_101_92,r_123_125_180,seq40,r_93_101_92,0.63,8,100,92,95
1,r_15_38_42,seq59,r_132_33_187,r_15_38_42,1,0,42,42,95
83,seq87,r_57_68_173,seq72,r_57_68_173,0.95,-61,112,173,95
3,r_113_18_80,r_121_11_156,r_123_125_180,r_113_18_80,0.98,0,80,80,95
42,r_28_56_52,r_141_117_147,seq98,r_28_56_52,1,0,52,52,95
3,r_113_18_80,r_123_125_180,r_27_138_171,r_27_138_171,0.77,10,181,171,95
59,seq17,r_6_55_177,r_7_137_84,r_7_137_84,0.92,93,177,84,95
55,seq140,seq81,r_30_67_29,r_30_67_29,0.91,43,72,29,95
16,r_76_23_40,r_130_82_133,seq36,r_76_23_40,1,1,41,40,95
21,r_102_148_148,r_14_99_189,r_93_101_92,r_102_148_148,0.87,0,148,148,95
1,r_15_38_42,r_132_33_187,r_120_21_81,r_120_21_81,0.94,106,187,81,95
5,r_141_117_147,seq25,r_12_134_71,r_141_117_147,0.73,0,147,147,95
31,r_75_47_115,r_14_99_189,r_65_94_159,r_75_47_115,0.94,54,169,115,95
45,r_37_61_176,seq84,r_29_74_55,r_37_61_176,0.54,0,176,176,95
73,seq59,r_15_38_42,seq108,r_15_38_42,1,-2,40,42,95
19,r_42_111_76,seq105,seq77,r_42_111_76,1,0,76,76,95
46,r_30_67_29,r_135_100_22,seq90,r_30_67_29,0.75,0,29,29,95
2,r_126_62_30,r_75_47_115,seq77,r_126_62_30,1,2,32,30,95
41,r_14_99_189,r_102_148_148,r_75_47_115,r_14_99_189,0.49,-73,116,189,95
98,seq124,r_135_100_22,r_93_101_92,r_93_101_92,0.47,-55,37,92,95
0,r_93_101_92,seq40,r_102_148_148,r_93_101_92,0.6,59,151,92,95
24,r_136_5_53,seq41,seq142,r_136_5_53,1,0,53,53,95
26,r_88_107_144,r_37_61_176,seq95,r_37_61_176,0.63,-32,144,176,95
8,r_132_33_187,r_15_38_42,seq40,r_132_33_187,0.53,0,187,187,95
72,seq52,r_35_139_109,seq127,r_35_139_109,1,2,111,109,95
0,r_93_101_92,r_13_51_60,r_123_125_180,r_13_51_60,0.87,2,62,60,95
11,r_120_21_81,r_75_47_115,seq25,r_120_21_81,0.97,0,81,81,95
13,r_63_145_181,r_123_125_180,r_0_146_145,r_63_145_181,0.42,0,181,181,95
15,r_128_24_172,seq41,seq92,r_128_24_172,0.64,-79,93,172,95
48,r_110_79_77,seq103,seq4,r_110_79_77,0.99,1,78,77,95
62,seq25,r_141_117_147,r_120_21_81,r_120_21_81,0.72,5,86,81,95
84,seq89,r_69_1_39,r_35_139_109,r_69_1_39,0.62,74,113,39,95
3,r_113_18_80,r_39_109_192,r_121_11_156,r_113_18_80,0.51,-68,12,80,95
32,r_71_144_179,r_7_137_84,r_65_94_159,r_65_94_159,0.41,-108,51,159,95
88,seq95,r_9_96_88,r_88_107_144,r_88_107_144,0.94,1,145,144,95
27,r_135_100_22,r_63_145_181,r_113_18_80,r_113_18_80,1,101,181,80,95
33,r_49_149_43,seq64,seq45,r_49_149_43,1,-3,40,43,95
36,r_8_58_72,r_39_109_192,r_119_22_126,r_119_22_126,0.95,-1,125,126,95
30,r_123_125_180,r_113_18_80,seq124,r_123_125_180,0.73,1,181,180,95
41,r_14_99_189,r_75_47_115,seq131,r_14_99_189,0.86,0,189,189,95
47,r_12_134_71,r_37_61_176,seq112,r_12_134_71,1,0,71,71,95
40,r_0_146_145,seq106,seq4,r_0_146_145,0.77,0,145,145,95
18,r_13_51_60,r_93_101_92,r_29_74_55,r_13_51_60,1,0,60,60,95
29,r_44_32_188,seq131,r_128_24_172,r_128_24_172,0.75,16,188,172,95
17,r_53_80_135,seq64,r_121_11_156,r_121_11_156,0.99,4,160,156,95
88,seq95,seq17,r_9_96_88,r_9_96_88,0.88,0,88,88,95
25,r_69_1_39,r_113_18_80,r_8_58_72,r_69_1_39,0.94,38,77,39,95
37,r_118_54_41,r_113_18_80,r_83_66_5,r_118_54_41,0.99,1,42,41,95
31,r_75_47_115,r_126_62_30,seq133,r_126_62_30,0.65,0,30,30,95
32,r_71_144_179,r_65_94_159,seq4,r_65_94_159,0.58,-73,86,159,95
10,r_83_66_5,seq46,r_118_54_41,r_118_54_41,1,6,47,41,95
38,r_9_96_88,seq90,seq95,r_9_96_88,0.95,0,88,88,95
34,r_35_139_109,seq52,seq89,r_35_139_109,1,0,109,109,95
39,r_29_74_55,r_35_139_109,r_39_109_192,r_29_74_55,1,0,55,55,95
17,r_53_80_135,r_132_33_187,seq64,r_53_80_135,0.76,0,135,135,95
28,r_34_43_23,seq64,r_121_11_156,r_121_11_156,0.97,15,171,156,95
9,r_119_22_126,seq17,r_8_58_72,r_119_22_126,0.98,0,126,126,95
28,r_34_43_23,r_88_107_144,seq133,r_34_43_23,0.99,0,23,23,95
31,r_75_47_115,seq133,r_14_99_189,r_75_47_115,0.71,12,127,115,95
22,r_97_70_118,seq142,seq92,r_97_70_118,0.99,0,118,118,95
84,seq89,r_121_11_156,r_69_1_39,r_121_11_156,0.61,-57,99,156,95
49,r_27_138_171,seq16,r_113_18_80,r_113_18_80,0.97,91,171,80,95
98,seq124,r_93_101_92,r_123_125_180,r_93_101_92,0.88,-1,91,92,95
32,r_71_144_179,seq4,r_13_51_60,r_71_144_179,0.79,-36,143,179,95
7,r_57_68_173,seq87,r_63_145_181,r_57_68_173,0.68,1,174,173,95
44,r_7_137_84,seq31,r_9_96_88,r_7_137_84,0.96,4,88,84,95
65,seq36,r_73_3_152,r_76_23_40,r_76_23_40,0.69,3,43,40,95
23,r_65_94_159,seq2,r_75_47_115,r_65_94_159,0.99,0,159,159,95
93,seq105,seq21,r_28_17_87,r_28_17_87,1,7,94,87,96
31,r_31_112_74,r_1_53_39,r_129_125_77,r_1_53_39,0.73,83,122,39,96
36,r_7_102_79,seq85,seq143,r_7_102_79,1,0,79,79,96
26,r_75_25_139,seq58,r_61_74_27,r_61_74_27,0.43,18,45,27,96
43,r_73_80_151,seq117,r_18_142_192,r_73_80_151,0.83,0,151,151,96
83,seq81,r_89_110_96,r_12_101_169,r_89_110_96,0.92,4,100,96,96
37,r_35_136_76,seq91,r_135_145_181,r_35_136_76,1,0,76,76,96
59,seq143,seq122,r_7_102_79,r_7_102_79,1,6,85,79,96
86,seq86,r_92_87_178,r_146_3_109,r_146_3_109,0.99,10,119,109,96
21,r_0_30_70,seq66,seq85,r_0_30_70,1,0,70,70,96
1,r_15_118_186,seq4,r_68_67_48,r_68_67_48,1,138,186,48,96
46,r_126_29_132,seq77,r_49_120_35,r_126_29_132,0.69,0,132,132,96
80,seq71,r_12_101_169,seq81,r_12_101_169,0.83,-30,139,169,96
44,r_98_121_144,seq144,seq16,r_98_121_144,1,0,144,144,96
69,seq44,r_1_53_39,r_72_119_82,r_72_119_82,1,20,102,82,96
45,r_88_109_162,seq50,r_106_65_46,r_88_109_162,0.51,0,162,162,96
65,seq33,seq11,r_113_62_49,r_113_62_49,1,-2,47,49,96
49,r_139_90_67,seq59,r_60_128_125,r_60_128_125,1,3,128,125,96
75,seq57,seq93,r_123_64_5,r_123_64_5,0.96,5,10,5,96
39,r_79_108_44,seq132,r_9_26_182,r_79_108_44,1,3,47,44,96
4,r_135_145_181,seq59,r_35_136_76,r_35_136_76,1,0,76,76,96
46,r_126_29_132,r_49_120_35,r_135_145_181,r_126_29_132,0.88,48,180,132,96
27,r_12_101_169,seq81,r_123_64_5,r_12_101_169,0.96,0,169,169,96
95,seq115,r_124_137_145,seq69,r_124_137_145,0.95,0,145,145,96
78,seq66,r_92_87_178,r_75_25_139,r_75_25_139,0.77,1,140,139,96
38,r_92_87_178,r_146_3_109,seq127,r_92_87_178,0.97,0,178,178,96
39,r_79_108_44,r_9_26_182,r_114_83_9,r_9_26_182,0.75,1,183,182,96
31,r_31_112_74,r_124_137_145,r_1_53_39,r_31_112_74,1,1,75,74,96
41,r_18_142_192,r_52_96_166,r_73_80_151,r_18_142_192,0.45,-26,166,192,96
67,seq38,r_72_119_82,seq140,r_72_119_82,1,0,82,82,96
89,seq95,r_37_20_163,seq32,r_37_20_163,0.86,0,163,163,96
3,r_129_125_77,seq144,r_89_110_96,r_89_110_96,0.6,2,98,96,96
58,seq140,r_113_62_49,seq38,r_113_62_49,1,0,49,49,96
72,seq50,r_88_109_162,seq6,r_88_109_162,0.99,0,162,162,96
18,r_113_62_49,seq140,seq33,r_113_62_49,1,0,49,49,96
92,seq100,r_70_22_52,r_1_53_39,r_70_22_52,1,2,54,52,96
78,seq66,r_0_30_70,r_92_87_178,r_0_30_70,1,0,70,70,96
63,seq132,r_124_137_145,seq69,r_124_137_145,1,-47,98,145,96
83,seq81,r_12_101_169,seq71,r_12_101_169,1,-23,146,169,96
33,r_149_24_28,r_1_53_39,seq6,r_1_53_39,0.75,-14,25,39,96
14,r_49_120_35,r_104_2_91,seq11,r_104_2_91,1,1,92,91,96
20,r_37_20_163,seq95,seq132,r_37_20_163,0.8,0,163,163,96
30,r_141_63_24,seq21,seq10,r_141_63_24,1,2,26,24,96
8,r_70_22_52,seq100,seq34,r_70_22_52,1,0,52,52,96
15,r_60_128_125,seq122,r_139_90_67,r_60_128_125,0.69,0,125,125,96
48,r_72_119_82,seq38,seq44,r_72_119_82,1,0,82,82,96
6,r_147_56_72,seq10,seq127,r_147_56_72,1,0,72,72,96
9,r_27_14_31,r_135_145_181,seq127,r_27_14_31,0.56,6,37,31,96
21,r_0_30_70,seq85,r_52_96_166,r_52_96_166,0.97,0,166,166,96
10,r_61_74_27,r_75_25_139,r_104_2_91,r_61_74_27,0.91,102,129,27,96
5,r_94_41_53,r_124_137_145,seq34,r_94_41_53,1,0,53,53,96
42,r_1_53_39,seq44,r_129_125_77,r_1_53_39,0.67,6,45,39,96
47,r_9_26_182,r_146_3_109,r_79_108_44,r_9_26_182,1,-97,85,182,96
40,r_138_76_165,seq32,r_1_53_39,r_138_76_165,0.67,0,165,165,96
24,r_89_110_96,seq81,r_129_125_77,r_89_110_96,0.96,4,100,96,96
25,r_124_137_145,seq115,seq127,r_124_137_145,0.94,0,145,145,96
64,seq32,r_138_76_165,seq91,r_138_76_165,0.94,0,165,165,96
92,seq100,r_1_53_39,r_104_2_91,r_104_2_91,0.81,30,121,91,96
47,r_9_26_182,r_79_108_44,r_134_23_136,r_9_26_182,0.79,0,182,182,96
32,r_134_23_136,seq82,seq133,r_134_23_136,0.96,0,136,136,96
10,r_61_74_27,r_149_24_28,r_75_25_139,r_75_25_139,0.66,-125,14,139,96
38,r_92_87_178,seq86,r_146_3_109,r_146_3_109,0.99,4,113,109,96
29,r_68_67_48,r_135_145_181,seq82,r_68_67_48,1,4,52,48,96
77,seq59,r_135_145_181,r_60_128_125,r_60_128_125,1,0,125,125,96
34,r_84_103_194,r_138_76_165,r_106_65_46,r_106_65_46,0.99,18,64,46,96
99,seq127,seq44,r_27_14_31,r_27_14_31,0.77,14,45,31,96
81,seq77,r_126_29_132,seq10,r_126_29_132,0.99,0,132,132,96
17,r_146_3_109,r_9_26_182,r_92_87_178,r_146_3_109,1,0,109,109,96
94,seq107,seq131,r_45_39_62,r_45_39_62,1,12,74,62,96
26,r_75_25_139,r_61_74_27,seq66,r_75_25_139,0.56,0,139,139,96
37,r_35_136_76,r_135_145_181,r_60_128_125,r_60_128_125,0.88,56,181,125,96
28,r_36_97_61,r_92_87_178,r_75_25_139,r_75_25_139,0.95,6,145,139,96
22,r_45_39_62,seq58,seq107,r_45_39_62,0.9,0,62,62,96
4,r_135_145_181,r_35_136_76,r_126_29_132,r_135_145_181,0.48,0,181,181,96
28,r_36_97_61,seq107,r_92_87_178,r_36_97_61,1,1,62,61,96
0,r_106_65_46,seq11,r_84_103_194,r_106_65_46,0.95,0,46,46,96
49,r_139_90_67,r_129_125_77,seq59,r_139_90_67,0.78,4,71,67,96
14,r_49_120_35,r_7_102_79,r_104_2_91,r_49_120_35,1,0,35,35,96
7,r_28_17_87,r_146_3_109,seq105,r_28_17_87,1,0,87,87,96
44,r_98_121_144,seq58,seq144,r_98_121_144,0.32,-58,86,144,96
23,r_148_55_122,r_138_76_165,seq131,r_138_76_165,0.72,-43,122,165,96
17,r_146_3_109,r_92_87_178,seq86,r_92_87_178,0.98,1,179,178,96
35,r_52_96_166,r_18_142_192,r_0_30_70,r_0_30_70,0.52,96,166,70,96
12,r_104_2_91,seq33,r_61_74_27,r_104_2_91,0.98,0,91,91,96
4,r_135_145_181,r_27_14_31,seq59,r_27_14_31,0.86,6,37,31,96
84,seq82,r_134_23_136,seq69,r_134_23_136,0.99,0,136,136,96
30,r_42_145_76,seq3,seq105,r_42_145_76,0.96,0,76,76,97
2,r_135_17_71,r_83_8_121,seq140,r_83_8_121,0.65,-9,112,121,97
36,r_116_88_181,seq45,r_15_139_94,r_116_88_181,0.29,0,181,181,97
38,r_142_11_147,seq114,r_34_37_114,r_34_37_114,0.61,4,118,114,97
92,seq103,r_60_81_68,seq105,r_60_81_68,0.89,0,68,68,97
8,r_31_92_122,seq76,seq133,r_31_92_122,0.87,0,122,122,97
93,seq105,r_16_6_55,r_130_72_189,r_16_6_55,1,-5,50,55,97
43,r_57_20_174,r_87_73_4,seq136,r_57_20_174,0.53,0,174,174,97
83,seq84,seq9,r_33_148_77,r_33_148_77,1,61,138,77,97
38,r_142_11_147,r_34_37_114,r_122_70_185,r_142_11_147,0.85,0,147,147,97
3,r_67_24_157,seq105,r_65_43_51,r_67_24_157,0.91,0,157,157,97
86,seq94,seq59,r_124_55_67,r_124_55_67,1,3,70,67,97
39,r_4_75_171,seq141,r_58_113_83,r_58_113_83,1,32,115,83,97
1,r_50_149_156,seq134,r_31_92_122,r_50_149_156,0.48,0,156,156,97
46,r_83_8_121,seq140,r_135_17_71,r_135_17_71,0.93,3,74,71,97
42,r_34_37_114,seq89,r_142_11_147,r_34_37_114,0.98,0,114,114,97
80,seq141,r_4_75_171,r_61_93_96,r_61_93_96,0.89,68,164,96,97
88,seq98,r_38_71_66,r_68_49_137,r_68_49_137,0.99,1,138,137,97
32,r_115_137_170,r_54_97_22,r_64_78_101,r_64_78_101,1,6,107,101,97
69,seq51,r_41_121_95,seq59,r_41_121_95,0.84,-15,80,95,97
45,r_10_90_109,seq59,r_33_148_77,r_10_90_109,0.99,0,109,109,97
32,r_115_137_170,r_64_78_101,seq63,r_115_137_170,0.97,0,170,170,97
19,r_127_22_169,seq96,seq25,r_127_22_169,0.55,2,171,169,97
95,seq146,r_115_137_170,r_64_78_101,r_64_78_101,1,17,118,101,97
76,seq69,seq52,r_129_125_97,r_129_125_97,1,0,97,97,97
37,r_91_46_29,r_95_104_60,seq74,r_91_46_29,1,0,29,29,97
41,r_144_128_130,seq134,r_110_36_69,r_110_36_69,1,68,137,69,97
93,seq105,r_130_72_189,r_42_145_76,r_42_145_76,0.98,17,93,76,97
10,r_41_121_95,seq59,r_60_81_68,r_41_121_95,0.91,0,95,95,97
5,r_27_32_34,r_50_149_156,r_117_147_151,r_27_32_34,0.99,-1,33,34,97
26,r_110_36_69,r_58_113_83,seq96,r_110_36_69,1,-1,68,69,97
78,seq76,r_31_92_122,seq108,r_31_92_122,0.87,0,122,122,97
73,seq59,r_41_121_95,r_10_90_109,r_41_121_95,0.89,0,95,95,97
11,r_129_125_97,r_122_70_185,seq69,r_129_125_97,1,0,97,97,97
3,r_67_24_157,r_130_72_189,seq105,r_67_24_157,0.45,-108,49,157,97
13,r_111_109_143,seq29,r_42_145_76,r_111_109_143,0.89,2,145,143,97
44,r_65_43_51,seq133,seq53,r_65_43_51,0.96,0,51,51,97
15,r_0_100_70,seq123,seq63,r_0_100_70,0.99,0,70,70,97
57,seq13,seq89,r_28_21_158,r_28_21_158,0.87,5,163,158,97
0,r_118_119_13,r_129_125_97,seq89,r_118_119_13,0.89,0,13,13,97
12,r_117_147_151,r_27_32_34,r_31_92_122,r_117_147_151,0.97,0,151,151,97
15,r_0_100_70,seq63,seq44,r_0_100_70,0.61,48,118,70,97
49,r_124_55_67,seq26,seq94,r_124_55_67,0.72,-20,47,67,97
35,r_58_113_83,r_87_73_4,r_4_75_171,r_58_113_83,0.98,0,83,83,97
85,seq89,r_34_37_114,r_118_119_13,r_34_37_114,0.99,0,114,114,97
5,r_27_32_34,r_117_147_151,r_91_46_29,r_117_147_151,0.53,0,151,151,97
4,r_120_66_54,seq59,r_65_43_51,r_120_66_54,0.97,1,55,54,97
27,r_61_93_96,seq98,r_58_113_83,r_61_93_96,1,0,96,96,97
30,r_42_145_76,seq105,r_111_109_143,r_111_109_143,1,0,143,143,97
48,r_54_97_22,r_31_92_122,r_115_137_170,r_54_97_22,1,0,22,22,97
87,seq96,r_127_22_169,r_110_36_69,r_110_36_69,1,8,77,69,97
46,r_83_8_121,r_135_17_71,r_129_125_97,r_83_8_121,1,0,121,121,97
21,r_95_104_60,r_91_46_29,seq18,r_91_46_29,0.51,0,29,29,97
2,r_135_17_71,seq105,r_83_8_121,r_135_17_71,0.54,0,71,71,97
23,r_102_2_36,r_130_72_189,r_28_21_158,r_102_2_36,0.96,1,37,36,97
40,r_60_81_68,seq103,seq101,r_60_81_68,1,0,68,68,97
74,seq62,seq112,r_35_86_106,r_35_86_106,1,10,116,106,97
18,r_23_12_72,seq26,r_16_6_55,r_23_12_72,1,0,72,72,97
29,r_14_107_155,r_31_92_122,seq108,r_31_92_122,0.52,-26,96,122,97
24,r_132_30_110,seq63,seq59,r_132_30_110,1,0,110,110,97
39,r_4_75_171,r_58_113_83,seq63,r_4_75_171,0.92,0,171,171,97
25,r_33_148_77,seq52,seq3,r_33_148_77,1,0,77,77,97
28,r_79_138_48,seq19,seq133,r_79_138_48,1,0,48,48,97
33,r_38_71_66,seq52,seq98,r_38_71_66,1,-1,65,66,97
48,r_54_97_22,r_115_137_170,r_15_139_94,r_15_139_94,1,6,100,94,97
47,r_28_21_158,r_102_2_36,seq13,r_102_2_36,0.63,122,158,36,97
88,seq98,seq126,r_38_71_66,r_38_71_66,1,-1,65,66,97
70,seq52,r_38_71_66,seq69,r_38_71_66,1,-1,65,66,97
21,r_95_104_60,seq18,seq7,r_95_104_60,1,1,61,60,97
14,r_16_6_55,seq7,r_23_12_72,r_16_6_55,0.52,17,72,55,97
65,seq44,r_64_78_101,seq19,r_64_78_101,1,0,101,101,97
79,seq77,r_129_125_97,r_35_86_106,r_35_86_106,0.5,11,117,106,97
38,r_142_11_147,r_15_139_94,seq114,r_142_11_147,0.5,-66,81,147,97
52,seq134,r_144_128_130,seq136,r_144_128_130,0.62,8,138,130,97
47,r_28_21_158,seq40,r_102_2_36,r_102_2_36,0.96,6,42,36,97
35,r_58_113_83,r_4_75_171,r_61_93_96,r_4_75_171,0.99,-7,164,171,97
77,seq74,seq56,r_91_46_29,r_91_46_29,1,1,30,29,97
34,r_35_86_106,seq63,seq62,r_35_86_106,1,0,106,106,97
75,seq63,r_35_86_106,seq44,r_35_86_106,1,0,106,106,97
60,seq25,r_15_139_94,seq131,r_15_139_94,0.68,0,94,94,97
6,r_130_72_189,r_102_2_36,seq105,r_102_2_36,1,-3,33,36,97
32,r_115_137_170,seq146,r_54_97_22,r_54_97_22,1,4,26,22,97
9,r_15_139_94,seq25,r_54_97_22,r_15_139_94,1,0,94,94,97
29,r_14_107_155,seq108,r_142_11_147,r_14_107_155,0.83,2,157,155,97
22,r_143_1_140,seq146,seq7,r_143_1_140,0.94,-1,139,140,97
91,seq101,r_122_70_185,r_60_81_68,r_60_81_68,1,62,130,68,97
7,r_64_78_101,seq44,r_15_139_94,r_64_78_101,0.98,0,101,101,97
14,r_16_6_55,seq105,seq7,r_16_6_55,0.83,-1,54,55,97
89,seq99,seq69,r_35_86_106,r_35_86_106,1,10,116,106,97
42,r_34_37_114,r_142_11_147,seq25,r_142_11_147,1,0,147,147,97
12,r_117_147_151,seq74,r_27_32_34,r_27_32_34,0.81,18,52,34,97
79,seq77,seq112,r_129_125_97,r_129_125_97,0.55,-1,96,97,97
35,r_58_113_83,r_110_36_69,r_87_73_4,r_110_36_69,0.71,-1,68,69,97
23,r_102_2_36,r_28_21_158,seq26,r_28_21_158,0.95,0,158,158,97
40,r_29_131_25,r_85_2_113,seq103,r_85_2_113,1,0,113,113,98
30,r_11_40_179,r_110_130_125,r_129_59_79,r_129_59_79,0.52,25,104,79,98
34,r_6_34_30,seq124,r_132_61_68,r_132_61_68,0.89,18,86,68,98
36,r_14_128_184,r_106_140_110,r_148_98_37,r_106_140_110,0.73,-49,61,110,98
16,r_123_22_26,r_73_82_141,r_53_83_163,r_123_22_26,0.95,1,27,26,98
14,r_96_30_134,r_56_84_21,seq3,r_96_30_134,0.45,0,134,134,98
8,r_54_70_63,seq15,seq138,r_54_70_63,0.83,0,63,63,98
43,r_137_44_189,seq58,seq138,r_137_44_189,0.49,0,189,189,98
35,r_115_72_74,r_93_41_51,r_112_28_72,r_115_72_74,0.98,0,74,74,98
37,r_43_10_130,seq38,r_110_130_125,r_43_10_130,0.94,3,133,130,98
39,r_110_130_125,r_143_111_132,seq87,r_110_130_125,0.8,0,125,125,98
1,r_52_47_98,r_85_2_113,seq79,r_52_47_98,0.99,0,98,98,98
42,r_26_33_135,r_88_7_138,seq55,r_26_33_135,0.89,0,135,135,98
35,r_115_72_74,r_6_34_30,r_93_41_51,r_115_72_74,0.91,-44,30,74,98
32,r_106_140_110,seq124,r_5_67_102,r_106_140_110,1,1,111,110,98
45,r_108_89_154,seq51,seq49,r_108_89_154,0.74,2,156,154,98
29,r_60_92_58,r_12_27_161,r_143_111_132,r_60_92_58,0.93,0,58,58,98
82,seq79,seq74,r_52_47_98,r_52_47_98,1,0,98,98,98
32,r_106_140_110,r_139_50_33,seq124,r_139_50_33,0.9,1,34,33,98
20,r_77_135_53,seq55,r_93_41_51,r_77_135_53,0.99,0,53,53,98
15,r_63_144_166,r_5_67_102,seq122,r_63_144_166,0.96,0,166,166,98
33,r_53_83_163,r_123_22_26,r_106_140_110,r_106_140_110,0.47,53,163,110,98
13,r_56_84_21,r_148_98_37,r_96_30_134,r_56_84_21,0.99,0,21,21,98
10,r_4_75_122,r_77_135_53,r_105_86_45,r_77_135_53,0.59,118,171,53,98
41,r_42_24_66,r_110_130_125,r_77_135_53,r_77_135_53,0.93,16,69,53,98
10,r_4_75_122,r_91_119_129,r_73_82_141,r_4_75_122,0.55,5,127,122,98
16,r_123_22_26,r_53_83_163,r_25_76_162,r_25_76_162,0.77,0,162,162,98
0,r_112_28_72,seq68,r_115_72_74,r_112_28_72,0.88,1,73,72,98
34,r_6_34_30,r_115_72_74,seq124,r_6_34_30,0.98,0,30,30,98
73,seq58,r_137_44_189,r_129_59_79,r_129_59_79,0.99,110,189,79,98
28,r_73_82_141,r_123_22_26,r_1_81_172,r_123_22_26,0.88,0,26,26,98
82,seq79,r_109_102_39,seq74,r_109_102_39,0.56,3,42,39,98
46,r_105_86_45,r_4_75_122,seq37,r_4_75_122,0.97,-13,109,122,98
46,r_105_86_45,seq122,r_4_75_122,r_105_86_45,1,2,47,45,98
15,r_63_144_166,seq55,r_5_67_102,r_5_67_102,0.81,1,103,102,98
28,r_73_82_141,r_129_59_79,r_4_75_122,r_73_82_141,0.4,-17,124,141,98
57,seq15,r_54_70_63,r_90_57_164,r_54_70_63,1,0,63,63,98
21,r_143_111_132,r_60_92_58,r_91_119_129,r_60_92_58,0.97,74,132,58,98
5,r_85_2_113,r_29_131_25,seq9,r_85_2_113,1,0,113,113,98
52,seq134,seq99,r_52_47_98,r_52_47_98,0.48,67,165,98,98
36,r_14_128_184,r_148_98_37,r_90_57_164,r_90_57_164,0.37,20,184,164,98
5,r_85_2_113,r_52_47_98,r_29_131_25,r_29_131_25,0.92,7,32,25,98
19,r_0_48_87,seq74,r_52_47_98,r_0_48_87,0.69,26,113,87,98
28,r_73_82_141,r_4_75_122,seq133,r_73_82_141,0.71,0,141,141,98
2,r_12_27_161,r_60_92_58,seq18,r_60_92_58,0.79,12,70,58,98
47,r_25_76_162,seq145,r_123_22_26,r_25_76_162,0.62,0,162,162,98
67,seq37,r_5_67_102,r_146_125_41,r_5_67_102,1,-56,46,102,98
2,r_12_27_161,r_104_45_62,seq147,r_12_27_161,1,0,161,161,98
18,r_132_61_68,seq23,r_6_34_30,r_132_61_68,0.99,0,68,68,98
28,r_73_82_141,r_139_50_33,r_129_59_79,r_139_50_33,0.78,67,100,33,98
9,r_109_102_39,seq79,seq8,r_109_102_39,0.9,2,41,39,98
10,r_4_75_122,r_73_82_141,r_77_135_53,r_4_75_122,0.4,19,141,122,98
31,r_139_50_33,r_106_140_110,r_4_75_122,r_139_50_33,0.98,1,34,33,98
61,seq19,r_88_7_138,seq8,r_88_7_138,1,2,140,138,98
38,r_129_59_79,r_4_75_122,seq78,r_129_59_79,0.86,18,97,79,98
21,r_143_111_132,r_110_130_125,r_60_92_58,r_60_92_58,0.97,-2,56,58,98
75,seq64,r_118_126_187,seq49,r_118_126_187,0.5,0,187,187,98
33,r_53_83_163,seq16,r_123_22_26,r_123_22_26,0.67,1,27,26,98
40,r_29_131_25,seq9,r_85_2_113,r_29_131_25,1,0,25,25,98
11,r_93_41_51,r_91_119_129,r_77_135_53,r_93_41_51,1,2,53,51,98
81,seq78,r_110_130_125,r_129_59_79,r_129_59_79,0.64,37,116,79,98
97,seq122,r_105_86_45,seq51,r_105_86_45,1,2,47,45,98
3,r_146_125_41,r_91_119_129,seq37,r_91_119_129,0.93,-88,41,129,98
31,r_139_50_33,r_4_75_122,r_149_114_83,r_139_50_33,0.81,67,100,33,98
29,r_60_92_58,r_143_111_132,seq78,r_143_111_132,0.98,0,132,132,98
49,r_13_94_145,seq55,r_29_131_25,r_13_94_145,0.94,0,145,145,98
7,r_88_7_138,seq19,seq16,r_88_7_138,0.99,2,140,138,98
44,r_149_114_83,seq117,r_139_50_33,r_149_114_83,1,0,83,83,98
23,r_91_119_129,r_4_75_122,r_143_111_132,r_91_119_129,0.96,3,132,129,98
28,r_73_82_141,r_1_81_172,r_139_50_33,r_73_82_141,0.69,-88,53,141,98
2,r_12_27_161,seq18,r_104_45_62,r_12_27_161,0.48,-49,112,161,98
27,r_148_98_37,r_56_84_21,seq23,r_148_98_37,0.98,0,37,37,98
84,seq87,r_1_81_172,r_110_130_125,r_110_130_125,0.88,6,131,125,98
30,r_123_12_80,r_71_147_167,r_36_141_28,r_123_12_80,0.91,0,80,80,99
51,seq130,r_11_63_184,r_48_115_183,r_48_115_183,0.83,1,184,183,99
14,r_85_100_109,r_112_105_163,seq146,r_85_100_109,0.98,0,109,109,99
8,r_112_105_163,r_85_100_109,r_71_147_167,r_85_100_109,0.99,2,111,109,99
43,r_83_134_121,r_99_56_172,seq146,r_83_134_121,0.92,0,121,121,99
54,seq129,seq111,r_5_61_149,r_5_61_149,0.98,3,152,149,99
37,r_68_125_86,r_42_49_186,seq3,r_68_125_86,1,0,86,86,99
6,r_47_116_88,r_45_51_51,seq110,r_47_116_88,0.99,0,88,88,99
55,seq136,r_99_56_172,r_143_2_59,r_143_2_59,1,43,102,59,99
16,r_17_16_187,r_102_132_105,r_57_46_141,r_102_132_105,0.97,-1,104,105,99
39,r_20_72_173,r_23_138_159,r_43_35_123,r_43_35_123,0.97,36,159,123,99
5,r_5_61_149,seq31,seq129,r_5_61_149,0.87,0,149,149,99
42,r_84_53_185,r_57_46_141,r_88_77_130,r_84_53_185,0.95,-48,137,185,99
32,r_65_52_81,seq70,r_23_138_159,r_23_138_159,0.71,21,180,159,99
69,seq27,r_99_56_172,r_143_2_59,r_143_2_59,1,18,77,59,99
45,r_113_98_153,r_34_119_90,r_123_12_80,r_113_98_153,0.99,-63,90,153,99
48,r_106_142_24,seq79,r_21_6_165,r_106_142_24,1,0,24,24,99
19,r_50_32_145,r_84_53_185,r_29_120_43,r_50_32_145,0.72,0,145,145,99
8,r_112_105_163,seq118,r_84_53_185,r_84_53_185,0.39,3,188,185,99
66,seq24,seq30,r_86_97_135,r_86_97_135,0.98,12,147,135,99
38,r_7_55_164,r_90_140_76,r_34_119_90,r_7_55_164,0.96,0,164,164,99
58,seq14,r_66_37_39,seq149,r_66_37_39,0.51,99,138,39,99
41,r_34_119_90,r_113_98_153,seq24,r_34_119_90,0.95,0,90,90,99
3,r_36_141_28,seq93,seq148,r_36_141_28,0.91,12,40,28,99
26,r_101_39_113,r_42_49_186,seq33,r_101_39_113,1,1,114,113,99
8,r_112_105_163,r_71_147_167,seq118,r_112_105_163,0.86,5,168,163,99
72,seq31,r_5_61_149,r_29_120_43,r_29_120_43,0.66,32,75,43,99
42,r_84_53_185,r_88_77_130,r_112_105_163,r_84_53_185,0.43,1,186,185,99
44,r_90_140_76,r_7_55_164,r_102_132_105,r_102_132_105,0.98,4,109,105,99
78,seq59,seq126,r_87_139_64,r_87_139_64,1,34,98,64,99
0,r_88_77_130,seq30,r_84_53_185,r_88_77_130,0.92,0,130,130,99
73,seq33,seq110,r_71_147_167,r_71_147_167,1,11,178,167,99
11,r_21_6_165,r_86_97_135,seq149,r_86_97_135,0.7,2,137,135,99
46,r_29_120_43,r_65_52_81,seq31,r_29_120_43,0.89,0,43,43,99
13,r_96_44_196,seq104,seq129,r_96_44_196,0.39,-113,83,196,99
25,r_143_2_59,seq110,seq27,r_143_2_59,1,0,59,59,99
46,r_29_120_43,seq31,r_50_32_145,r_50_32_145,1,1,146,145,99
36,r_64_8_197,r_66_37_39,r_127_69_134,r_64_8_197,0.58,-42,155,197,99
15,r_40_92_93,r_128_75_198,seq22,r_40_92_93,0.99,1,94,93,99
49,r_95_145_60,r_21_6_165,seq149,r_21_6_165,0.85,-24,141,165,99
4,r_66_37_39,r_43_35_123,seq38,r_43_35_123,0.69,0,123,123,99
12,r_42_49_186,r_123_12_80,seq74,r_42_49_186,0.42,0,186,186,99
1,r_41_81_1,seq133,r_121_89_44,r_121_89_44,1,10,54,44,99
56,seq9,r_7_55_164,seq104,r_7_55_164,1,-127,37,164,99
10,r_43_35_123,r_23_138_159,r_20_72_173,r_23_138_159,1,0,159,159,99
85,seq80,r_122_137_154,r_117_10_53,r_117_10_53,0.73,73,126,53,99
7,r_121_89_44,r_117_10_53,r_41_81_1,r_121_89_44,1,0,44,44,99
35,r_45_51_51,r_42_49_186,r_47_116_88,r_45_51_51,1,3,54,51,99
67,seq25,r_57_46_141,r_66_37_39,r_57_46_141,0.66,-51,90,141,99
16,r_17_16_187,r_127_69_134,seq9,r_17_16_187,0.98,0,187,187,99
16,r_17_16_187,r_57_46_141,r_127_69_134,r_17_16_187,1,-50,137,187,99
10,r_43_35_123,r_66_37_39,r_23_138_159,r_43_35_123,0.62,0,123,123,99
27,r_57_46_141,r_84_53_185,seq27,r_57_46_141,0.96,0,141,141,99
10,r_43_35_123,r_117_10_53,r_66_37_39,r_43_35_123,0.96,-69,54,123,99
0,r_88_77_130,r_84_53_185,r_127_69_134,r_84_53_185,0.72,1,186,185,99
18,r_23_138_159,r_43_35_123,r_36_141_28,r_23_138_159,1,0,159,159,99
4,r_66_37_39,seq15,r_43_35_123,r_66_37_39,1,0,39,39,99
41,r_34_119_90,seq24,r_7_55_164,r_7_55_164,0.94,5,169,164,99
47,r_102_132_105,r_17_16_187,r_90_140_76,r_102_132_105,0.99,-1,104,105,99
40,r_0_76_112,seq110,r_96_44_196,r_0_76_112,1,0,112,112,99
18,r_23_138_159,r_20_72_173,r_43_35_123,r_43_35_123,0.81,3,126,123,99
29,r_127_69_134,seq74,r_17_16_187,r_127_69_134,0.38,0,134,134,99
24,r_48_115_183,r_41_81_1,seq22,r_48_115_183,0.4,-122,61,183,99
33,r_11_63_184,seq3,r_47_116_88,r_47_116_88,0.71,96,184,88,99
48,r_106_142_24,r_21_6_165,seq149,r_21_6_165,1,-30,135,165,99
63,seq148,seq67,r_36_141_28,r_36_141_28,0.78,12,40,28,99
64,seq149,r_86_97_135,r_95_145_60,r_95_145_60,0.76,21,81,60,99
9,r_117_10_53,r_121_89_44,seq80,r_117_10_53,0.99,-9,44,53,99
88,seq93,r_36_141_28,r_99_56_172,r_99_56_172,0.54,4,176,172,99
65,seq22,seq118,r_40_92_93,r_40_92_93,1,1,94,93,99
2,r_108_18_22,r_143_2_59,seq13,r_108_18_22,0.83,0,22,22,99
32,r_65_52_81,seq30,seq70,r_65_52_81,1,0,81,81,99
38,r_7_55_164,seq9,r_90_140_76,r_90_140_76,1,1,77,76,99
52,seq3,r_11_63_184,r_68_125_86,r_68_125_86,1,4,90,86,99
34,r_122_137_154,seq80,seq67,r_122_137_154,0.68,0,154,154,99
58,seq14,r_64_8_197,r_66_37_39,r_66_37_39,0.64,76,115,39,99
45,r_113_98_153,r_123_12_80,seq3,r_113_98_153,1,0,153,153,99
58,seq14,r_117_10_53,r_64_8_197,r_117_10_53,0.38,39,92,53,99
17,r_99_56_172,seq27,seq93,r_99_56_172,0.55,0,172,172,99
96,seq114,r_71_147_167,seq58,r_71_147_167,0.59,0,167,167,99
11,r_21_6_165,seq149,r_7_55_164,r_21_6_165,0.95,1,166,165,99
24,r_48_115_183,seq129,seq130,r_48_115_183,0.99,0,183,183,99
28,r_103_73_67,r_0_76_112,seq70,r_103_73_67,1,1,68,67,99
49,r_95_145_60,r_112_105_163,r_21_6_165,r_95_145_60,1,0,60,60,99
13,r_96_44_196,seq129,r_0_76_112,r_96_44_196,0.7,-84,112,196,99
44,r_90_140_76,r_42_49_186,r_7_55_164,r_90_140_76,0.97,1,77,76,99
23,r_87_139_64,r_65_52_81,seq59,r_87_139_64,1,0,64,64,99
29,r_127_69_134,r_17_16_187,r_88_77_130,r_17_16_187,1,0,187,187,99
12,r_42_49_186,r_101_39_113,r_123_12_80,r_42_49_186,0.98,-72,114,186,99
6,r_47_116_88,r_127_69_134,r_45_51_51,r_47_116_88,0.64,-40,48,88,99
84,seq79,r_113_98_153,r_36_141_28,r_113_98_153,0.9,-7,146,153,99