30,r_66_80_273,seq117,seq86,r_66_80_273,0.45,1,274,273,0
36,r_3_74_89,seq61,seq117,r_3_74_89,0.76,19,108,89,0
57,seq17,r_22_96_272,r_130_1_37,r_130_1_37,0.9,6,43,37,0
8,r_134_9_255,r_81_78_107,r_105_21_31,r_81_78_107,0.65,2,109,107,0
53,seq136,seq142,r_121_144_13,r_121_144_13,0.73,55,68,13,0
43,r_135_119_59,seq56,r_3_74_89,r_135_119_59,1.0,1,60,59,0
37,r_67_138_263,r_33_29_78,seq122,r_33_29_78,1.0,4,82,78,0
86,seq98,r_101_31_258,r_121_144_13,r_101_31_258,0.65,0,258,258,0
16,r_33_29_78,r_67_138_263,seq14,r_33_29_78,1.0,0,78,78,0
21,r_23_83_199,seq39,r_115_19_105,r_115_19_105,0.62,98,203,105,0
39,r_112_72_271,seq90,r_6_75_19,r_6_75_19,0.79,253,272,19,0
1,r_70_131_121,r_67_138_263,r_114_76_98,r_114_76_98,0.92,23,121,98,0
5,r_69_64_282,r_107_95_212,r_16_128_137,r_16_128_137,0.85,5,142,137,0
32,r_105_21_31,r_134_9_255,r_55_92_155,r_55_92_155,0.99,0,155,155,0
45,r_99_145_109,r_55_92_155,r_12_111_50,r_99_145_109,0.59,1,110,109,0
32,r_105_21_31,r_107_95_212,r_134_9_255,r_107_95_212,0.53,-179,33,212,0
27,r_32_148_257,seq142,r_100_143_164,r_100_143_164,1.0,20,184,164,0
31,r_104_149_118,seq39,seq14,r_104_149_118,0.92,7,125,118,0
41,r_55_92_155,seq41,r_105_21_31,r_55_92_155,0.99,0,155,155,0
3,r_103_77_192,seq126,seq48,r_103_77_192,0.45,0,192,192,0
8,r_134_9_255,r_105_21_31,r_54_36_215,r_54_36_215,0.53,36,251,215,0
78,seq68,seq89,r_82_91_82,r_82_91_82,1.0,30,112,82,0
20,r_81_78_107,r_134_9_255,seq62,r_81_78_107,0.99,2,109,107,0
13,r_114_76_98,seq86,seq108,r_114_76_98,1.0,0,98,98,0
56,seq14,r_130_1_37,r_104_149_118,r_104_149_118,0.64,79,197,118,0
15,r_88_50_168,r_66_80_273,r_141_25_44,r_66_80_273,0.46,-104,169,273,0
27,r_32_148_257,r_100_143_164,r_115_19_105,r_32_148_257,1.0,1,258,257,0
49,r_100_143_164,r_32_148_257,r_34_24_193,r_32_148_257,0.86,0,257,257,0
17,r_12_111_50,r_129_35_221,seq28,r_12_111_50,0.79,1,51,50,0
6,r_7_79_85,r_44_65_101,seq71,r_7_79_85,0.77,3,88,85,0
34,r_44_65_101,r_106_53_104,r_135_119_59,r_44_65_101,0.88,0,101,101,0
5,r_69_64_282,r_16_128_137,r_30_85_77,r_30_85_77,0.62,207,284,77,0
42,r_73_93_17,r_30_85_77,seq132,r_73_93_17,0.95,0,17,17,0
27,r_32_148_257,r_115_19_105,seq142,r_115_19_105,1.0,-6,99,105,0
4,r_6_75_19,r_67_138_263,seq39,r_6_75_19,1.0,0,19,19,0
9,r_137_46_28,r_8_13_100,r_4_27_69,r_137_46_28,1.0,45,73,28,0
47,r_54_36_215,r_22_96_272,seq51,r_54_36_215,0.82,0,215,215,0
40,r_82_91_82,r_55_92_155,seq68,r_82_91_82,1.0,0,82,82,0
74,seq61,r_2_15_283,r_135_119_59,r_135_119_59,1.0,225,284,59,0
18,r_129_35_221,seq139,seq42,r_129_35_221,0.62,1,222,221,0
29,r_30_85_77,r_88_50_168,r_67_138_263,r_30_85_77,1.0,0,77,77,0
25,r_4_27_69,seq62,r_137_46_28,r_4_27_69,1.0,-1,68,69,0
43,r_135_119_59,r_3_74_89,r_44_65_101,r_44_65_101,1.0,43,144,101,0
64,seq39,r_104_149_118,r_5_84_66,r_5_84_66,0.85,59,125,66,0
61,seq28,r_47_57_224,r_12_111_50,r_12_111_50,0.7,178,228,50,0
38,r_34_24_193,seq122,r_100_143_164,r_34_24_193,0.6,0,193,193,0
26,r_121_144_13,r_6_75_19,seq136,r_6_75_19,0.79,-7,12,19,0
34,r_44_65_101,r_7_79_85,r_106_53_104,r_7_79_85,0.77,3,88,85,0
24,r_141_25_44,r_114_76_98,seq126,r_141_25_44,1.0,0,44,44,0
75,seq62,r_4_27_69,r_67_138_263,r_4_27_69,0.97,1,70,69,0
60,seq26,r_18_124_182,r_106_53_104,r_18_124_182,1.0,1,183,182,0
81,seq86,seq41,r_66_80_273,r_66_80_273,0.68,-5,268,273,0
9,r_137_46_28,r_23_83_199,r_8_13_100,r_137_46_28,0.93,1,29,28,0
15,r_88_50_168,r_141_25_44,r_18_124_182,r_18_124_182,0.86,11,193,182,0
29,r_30_85_77,r_67_138_263,seq139,r_67_138_263,0.85,-89,174,263,0
22,r_115_19_105,r_32_148_257,seq116,r_115_19_105,1.0,0,105,105,0
28,r_10_20_159,r_134_9_255,seq139,r_10_20_159,0.77,0,159,159,0
49,r_100_143_164,seq52,r_32_148_257,r_100_143_164,0.61,0,164,164,0
56,seq14,seq11,r_130_1_37,r_130_1_37,1.0,32,69,37,0
44,r_5_84_66,r_18_124_182,r_6_75_19,r_5_84_66,1.0,0,66,66,0
23,r_8_13_100,r_134_9_255,r_69_64_282,r_8_13_100,0.58,-3,97,100,0
75,seq62,r_67_138_263,r_81_78_107,r_81_78_107,0.71,24,131,107,0
14,r_130_1_37,seq132,seq17,r_130_1_37,1.0,1,38,37,0
12,r_18_124_182,seq26,r_88_50_168,r_18_124_182,0.96,1,183,182,0
51,seq132,r_130_1_37,r_73_93_17,r_130_1_37,0.97,1,38,37,0
23,r_8_13_100,r_69_64_282,r_16_128_137,r_16_128_137,1.0,29,166,137,0
40,r_82_55_40,seq128,seq25,r_82_55_40,1.0,3,43,40,1
14,r_45_133_206,seq29,seq61,r_45_133_206,0.94,0,206,206,1
8,r_2_41_233,r_49_142_123,r_125_78_50,r_49_142_123,0.96,0,123,123,1
53,seq136,r_58_73_225,r_22_86_75,r_22_86_75,0.78,23,98,75,1
43,r_8_149_72,r_63_15_237,seq97,r_8_149_72,1.0,0,72,72,1
37,r_85_57_129,seq129,seq61,r_85_57_129,0.95,1,130,129,1
86,seq97,seq48,r_8_149_72,r_8_149_72,1.0,3,75,72,1
21,r_89_36_182,r_52_96_207,r_117_5_112,r_52_96_207,0.94,1,208,207,1
5,r_63_15_237,r_9_70_143,seq18,r_9_70_143,1.0,-76,67,143,1
13,r_105_4_56,seq126,r_2_41_233,r_105_4_56,1.0,0,56,56,1
45,r_11_6_127,r_35_21_194,r_8_149_72,r_11_6_127,0.91,1,128,127,1
16,r_47_94_41,r_120_118_68,r_148_132_8,r_47_94_41,1.0,1,42,41,1
15,r_35_21_194,r_66_64_19,seq68,r_35_21_194,1.0,0,194,194,1
19,r_66_64_19,seq48,seq93,r_66_64_19,0.91,0,19,19,1
41,r_72_1_37,r_34_33_289,r_116_138_243,r_72_1_37,1.0,0,37,37,1
23,r_17_13_59,r_120_118_68,r_95_103_55,r_17_13_59,0.98,-4,55,59,1
36,r_95_103_55,seq62,r_17_13_59,r_95_103_55,1.0,0,55,55,1
31,r_144_38_163,r_59_134_236,seq88,r_144_38_163,0.88,0,163,163,1
3,r_22_86_75,seq79,seq136,r_22_86_75,1.0,0,75,75,1
26,r_9_70_143,r_63_15_237,r_66_64_19,r_9_70_143,0.93,0,143,143,1
8,r_2_41_233,r_125_78_50,r_49_142_123,r_2_41_233,1.0,0,233,233,1
4,r_117_5_112,r_11_6_127,r_89_36_182,r_11_6_127,1.0,-12,115,127,1
0,r_52_96_207,seq143,r_17_13_59,r_52_96_207,0.81,1,208,207,1
63,seq29,r_45_133_206,seq69,r_45_133_206,1.0,0,206,206,1
11,r_49_142_123,r_2_41_233,seq145,r_49_142_123,0.97,0,123,123,1
15,r_35_21_194,r_11_6_127,r_66_64_19,r_35_21_194,0.54,-66,128,194,1
48,r_146_32_278,seq84,r_7_100_201,r_7_100_201,0.79,77,278,201,1
12,r_107_139_81,r_65_80_265,r_2_41_233,r_65_80_265,0.78,-101,164,265,1
13,r_105_4_56,r_2_41_233,r_125_78_50,r_2_41_233,1.0,-5,228,233,1
62,seq27,r_116_138_243,r_72_1_37,r_72_1_37,0.54,62,99,37,1
23,r_17_13_59,r_47_94_41,r_120_118_68,r_47_94_41,0.78,-25,16,41,1
5,r_63_15_237,seq18,seq42,r_63_15_237,0.89,0,237,237,1
9,r_148_132_8,seq113,r_47_94_41,r_47_94_41,0.82,1,42,41,1
87,seq101,r_104_81_118,seq68,r_104_81_118,1.0,0,118,118,1
6,r_116_138_243,seq27,r_72_1_37,r_72_1_37,1.0,13,50,37,1
2,r_74_16_100,seq48,seq79,r_74_16_100,0.75,13,113,100,1
41,r_72_1_37,r_116_138_243,r_59_134_236,r_72_1_37,0.7,199,236,37,1
47,r_59_134_236,r_77_39_246,r_72_1_37,r_59_134_236,0.62,1,237,236,1
18,r_3_91_234,seq37,seq18,r_3_91_234,0.63,0,234,234,1
29,r_98_130_149,seq145,seq12,r_98_130_149,0.93,1,150,149,1
24,r_120_118_68,seq110,r_87_19_284,r_120_118_68,0.96,1,69,68,1
34,r_58_73_225,r_22_86_75,r_75_106_33,r_58_73_225,0.78,0,225,225,1
20,r_125_78_50,r_117_5_112,r_28_109_26,r_125_78_50,0.6,5,55,50,1
64,seq30,r_65_80_265,seq121,r_65_80_265,0.81,1,266,265,1
42,r_56_99_38,r_95_103_55,r_35_21_194,r_56_99_38,0.85,0,38,38,1
58,seq18,r_20_83_275,r_63_15_237,r_63_15_237,0.46,-88,149,237,1
6,r_116_138_243,r_72_1_37,seq114,r_116_138_243,0.47,1,244,243,1
1,r_135_67_28,seq141,seq51,r_135_67_28,1.0,1,29,28,1
10,r_75_106_33,r_104_81_118,seq113,r_75_106_33,0.97,-1,32,33,1
42,r_56_99_38,r_35_21_194,seq37,r_35_21_194,0.99,0,194,194,1
38,r_24_122_80,r_3_91_234,r_8_149_72,r_24_122_80,1.0,0,80,80,1
77,seq68,r_7_100_201,r_35_21_194,r_7_100_201,0.54,0,201,201,1
34,r_58_73_225,seq61,r_22_86_75,r_22_86_75,1.0,31,106,75,1
81,seq79,r_22_86_75,seq124,r_22_86_75,1.0,-10,65,75,1
28,r_7_100_201,seq68,seq121,r_7_100_201,0.94,0,201,201,1
49,r_0_137_244,r_65_80_265,seq129,r_65_80_265,0.52,-21,244,265,1
92,seq113,r_87_19_284,r_75_106_33,r_75_106_33,1.0,3,36,33,1
35,r_54_46_162,seq114,r_87_19_284,r_54_46_162,0.98,0,162,162,1
72,seq51,seq23,r_135_67_28,r_135_67_28,0.99,18,46,28,1
12,r_107_139_81,r_111_147_181,r_65_80_265,r_111_147_181,0.6,-88,93,181,1
36,r_11_91_187,r_13_82_137,r_14_30_101,r_11_91_187,1.0,0,187,187,2
14,r_8_58_185,seq12,seq84,r_8_58_185,0.9,0,185,185,2
43,r_99_145_162,r_70_146_298,seq2,r_99_145_162,0.77,0,162,162,2
37,r_56_80_17,r_0_17_75,r_134_23_261,r_56_80_17,0.51,0,17,17,2
16,r_31_133_238,seq76,seq54,r_31_133_238,0.64,0,238,238,2
21,r_129_96_85,seq108,r_13_82_137,r_129_96_85,1.0,3,88,85,2
39,r_39_10_224,r_43_3_230,seq111,r_39_10_224,0.6,1,225,224,2
1,r_0_17_75,seq27,seq12,r_0_17_75,1.0,0,75,75,2
46,r_74_93_93,r_126_87_219,seq76,r_74_93_93,0.47,2,95,93,2
42,r_95_63_255,r_13_82_137,r_42_41_43,r_95_63_255,0.72,0,255,255,2
69,seq52,seq46,r_14_30_101,r_14_30_101,1.0,17,118,101,2
30,r_42_41_43,seq143,r_37_22_140,r_42_41_43,1.0,1,44,43,2
19,r_126_87_219,r_106_21_292,r_15_120_126,r_106_21_292,0.87,-73,219,292,2
25,r_19_38_36,seq110,seq104,r_19_38_36,1.0,0,36,36,2
76,seq75,r_13_82_137,seq6,r_13_82_137,0.5,117,254,137,2
31,r_49_94_253,seq111,r_90_130_112,r_49_94_253,0.59,1,254,253,2
41,r_138_44_272,seq76,r_14_30_101,r_14_30_101,0.95,171,272,101,2
67,seq46,r_131_66_227,seq26,r_131_66_227,0.96,0,227,227,2
3,r_100_114_297,seq101,r_74_93_93,r_74_93_93,0.66,63,156,93,2
27,r_48_144_31,r_134_23_261,seq84,r_48_144_31,1.0,0,31,31,2
10,r_148_78_110,r_135_24_146,r_77_7_153,r_148_78_110,0.9,0,110,110,2
10,r_148_78_110,r_77_7_153,seq136,r_77_7_153,1.0,-3,150,153,2
26,r_124_55_132,r_115_149_226,r_57_5_3,r_124_55_132,1.0,0,132,132,2
0,r_71_64_71,r_15_120_126,r_132_116_34,r_71_64_71,1.0,0,71,71,2
20,r_20_128_168,seq122,seq46,r_20_128_168,0.66,8,176,168,2
13,r_90_130_112,seq102,seq34,r_90_130_112,0.53,0,112,112,2
49,r_77_7_153,r_148_78_110,r_74_93_93,r_77_7_153,1.0,1,154,153,2
15,r_40_29_179,r_53_147_270,seq125,r_40_29_179,0.95,0,179,179,2
40,r_28_123_239,r_13_82_137,seq46,r_28_123_239,0.89,0,239,239,2
48,r_70_146_298,r_99_145_162,r_15_120_126,r_70_146_298,1.0,-136,162,298,2
12,r_98_67_207,r_31_133_238,r_51_142_80,r_98_67_207,0.92,2,209,207,2
6,r_107_72_210,seq46,r_47_65_120,r_47_65_120,1.0,90,210,120,2
62,seq27,r_0_17_75,seq46,r_0_17_75,1.0,-11,64,75,2
21,r_129_96_85,r_13_82_137,r_0_17_75,r_13_82_137,0.51,139,276,137,2
30,r_42_41_43,r_37_22_140,seq73,r_37_22_140,1.0,-8,132,140,2
4,r_92_33_49,r_71_64_71,r_56_80_17,r_92_33_49,0.73,0,49,49,2
96,seq117,r_20_128_168,r_132_116_34,r_132_116_34,1.0,0,34,34,2
2,r_15_120_126,r_1_103_246,r_70_146_298,r_15_120_126,0.98,0,126,126,2
47,r_1_103_246,r_15_120_126,seq46,r_15_120_126,1.0,1,127,126,2
40,r_28_123_239,r_121_85_208,r_13_82_137,r_121_85_208,0.71,1,209,208,2
29,r_14_30_101,seq104,seq52,r_14_30_101,1.0,0,101,101,2
24,r_134_23_261,seq86,seq113,r_134_23_261,0.83,0,261,261,2
33,r_135_24_146,r_98_67_207,seq111,r_98_67_207,0.72,-58,149,207,2
64,seq34,seq89,r_90_130_112,r_90_130_112,1.0,0,112,112,2
32,r_51_142_80,r_13_82_137,seq34,r_51_142_80,1.0,1,81,80,2
34,r_37_22_140,seq73,r_90_130_112,r_37_22_140,0.68,0,140,140,2
17,r_121_85_208,r_28_123_239,r_99_145_162,r_121_85_208,0.54,1,209,208,2
9,r_131_66_227,seq46,r_51_142_80,r_131_66_227,0.79,0,227,227,2
37,r_56_80_17,r_134_23_261,r_92_33_49,r_92_33_49,0.73,29,78,49,2
29,r_14_30_101,seq52,r_11_91_187,r_11_91_187,1.0,9,196,187,2
22,r_47_65_120,seq139,r_107_72_210,r_47_65_120,1.0,0,120,120,2
28,r_53_147_270,seq2,r_115_149_226,r_115_149_226,0.54,46,272,226,2
49,r_77_7_153,seq136,r_148_78_110,r_148_78_110,1.0,2,112,110,2
56,seq12,r_8_58_185,r_0_17_75,r_0_17_75,0.54,110,185,75,2
7,r_13_82_137,r_11_91_187,r_129_96_85,r_13_82_137,0.66,3,140,137,2
44,r_115_149_226,r_13_82_137,seq109,r_115_149_226,0.47,0,226,226,2
35,r_16_68_61,seq113,r_57_5_3,r_16_68_61,1.0,1,62,61,2
12,r_98_67_207,r_135_24_146,r_31_133_238,r_135_24_146,0.79,-28,118,146,2
36,r_147_42_84,r_116_96_98,r_124_34_74,r_116_96_98,1.0,-13,85,98,3
92,seq104,r_128_33_109,r_23_102_5,r_128_33_109,1.0,0,109,109,3
82,seq75,r_126_49_177,seq89,r_126_49_177,0.97,-119,58,177,3
43,r_16_51_163,r_2_78_231,r_141_144_47,r_16_51_163,0.96,0,163,163,3
34,r_107_137_45,r_7_86_199,r_14_148_32,r_107_137_45,0.96,0,45,45,3
37,r_2_78_231,r_16_51_163,r_11_122_93,r_11_122_93,0.84,70,163,93,3
86,seq84,r_129_110_35,r_109_70_156,r_109_70_156,1.0,8,164,156,3
16,r_19_9_68,r_30_1_279,seq0,r_19_9_68,0.96,-5,63,68,3
39,r_100_91_216,seq90,r_109_70_156,r_100_91_216,0.61,0,216,216,3
1,r_68_108_114,seq15,r_127_29_293,r_68_108_114,1.0,3,117,114,3
46,r_94_65_116,seq113,r_128_33_109,r_94_65_116,1.0,2,118,116,3
69,seq43,r_7_86_199,seq79,r_7_86_199,1.0,2,201,199,3
45,r_54_10_232,seq93,r_127_29_293,r_54_10_232,0.54,0,232,232,3
19,r_116_96_98,r_147_42_84,r_126_49_177,r_147_42_84,0.81,1,85,84,3
38,r_31_45_144,r_98_83_80,seq89,r_98_83_80,0.57,69,149,80,3
6,r_136_119_251,seq43,seq46,r_136_119_251,0.99,-2,249,251,3
10,r_13_27_100,r_120_71_294,seq18,r_13_27_100,1.0,1,101,100,3
40,r_60_56_43,r_126_49_177,seq3,r_60_56_43,1.0,2,45,43,3
29,r_4_123_263,r_88_40_66,r_14_148_32,r_4_123_263,0.7,-204,59,263,3
73,seq53,r_109_70_156,seq38,r_109_70_156,0.99,1,157,156,3
11,r_28_112_181,seq89,r_52_67_21,r_28_112_181,0.65,2,183,181,3
15,r_135_41_236,seq63,r_19_9_68,r_19_9_68,0.76,171,239,68,3
48,r_11_122_93,seq24,seq75,r_11_122_93,0.95,1,94,93,3
12,r_126_49_177,r_87_25_259,r_14_148_32,r_126_49_177,1.0,0,177,177,3
6,r_136_119_251,r_5_99_119,r_85_80_194,r_5_99_119,0.77,-1,118,119,3
99,seq125,seq38,r_101_143_212,r_101_143_212,0.97,42,254,212,3
0,r_14_148_32,r_4_123_263,r_7_86_199,r_7_86_199,0.84,60,259,199,3
27,r_128_33_109,seq104,r_19_9_68,r_128_33_109,0.99,0,109,109,3
87,seq89,r_28_112_181,seq75,r_28_112_181,0.61,2,183,181,3
2,r_7_86_199,seq43,r_14_148_32,r_7_86_199,0.74,2,201,199,3
24,r_32_62_235,seq146,r_11_122_93,r_11_122_93,0.8,146,239,93,3
25,r_98_83_80,seq77,r_31_45_144,r_98_83_80,1.0,0,80,80,3
48,r_11_122_93,seq75,r_32_62_235,r_32_62_235,0.71,23,258,235,3
88,seq90,r_100_91_216,seq3,r_100_91_216,0.85,0,216,216,3
50,seq0,r_149_21_269,r_135_41_236,r_135_41_236,0.98,33,269,236,3
58,seq12,r_13_27_100,seq57,r_13_27_100,0.98,-21,79,100,3
70,seq44,seq142,r_13_27_100,r_13_27_100,1.0,8,108,100,3
6,r_136_119_251,r_85_80_194,seq43,r_85_80_194,0.95,5,199,194,3
32,r_139_61_76,r_126_49_177,seq15,r_139_61_76,0.91,3,79,76,3
38,r_31_45_144,r_81_111_130,r_98_83_80,r_98_83_80,0.66,0,80,80,3
31,r_141_144_47,r_136_119_251,seq138,r_141_144_47,0.89,0,47,47,3
4,r_52_67_21,seq72,seq64,r_52_67_21,0.81,0,21,21,3
19,r_116_96_98,r_126_49_177,seq35,r_116_96_98,1.0,0,98,98,3
25,r_98_83_80,r_31_45_144,seq6,r_31_45_144,0.79,20,164,144,3
9,r_109_70_156,seq53,seq84,r_109_70_156,0.81,1,157,156,3
0,r_14_148_32,r_7_86_199,r_4_123_263,r_4_123_263,0.58,-231,32,263,3
29,r_4_123_263,r_14_148_32,r_124_34_74,r_4_123_263,0.48,-1,262,263,3
22,r_97_66_141,r_136_119_251,r_129_110_35,r_97_66_141,0.95,1,142,141,3
91,seq103,seq140,r_88_40_66,r_88_40_66,1.0,23,89,66,3
84,seq77,r_141_144_47,r_81_111_130,r_81_111_130,0.99,10,140,130,3
7,r_88_40_66,r_4_123_263,seq103,r_88_40_66,1.0,0,66,66,3
23,r_81_111_130,seq6,seq77,r_81_111_130,0.98,1,131,130,3
12,r_126_49_177,r_139_61_76,r_87_25_259,r_139_61_76,0.99,4,80,76,3
55,seq6,r_98_83_80,r_2_78_231,r_2_78_231,0.77,-24,207,231,3
30,r_30_78_286,seq17,r_42_16_33,r_42_16_33,1.0,106,139,33,4
9,r_21_88_174,r_46_117_55,r_133_64_292,r_21_88_174,0.6,0,174,174,4
9,r_21_88_174,r_133_64_292,r_47_70_249,r_21_88_174,0.7,82,256,174,4
54,seq5,r_128_71_156,seq138,r_128_71_156,1.0,1,157,156,4
26,r_90_131_52,r_98_23_112,r_2_24_205,r_90_131_52,1.0,0,52,52,4
16,r_47_70_249,seq41,r_21_88_174,r_21_88_174,0.98,77,251,174,4
39,r_73_40_199,r_65_36_209,r_46_117_55,r_46_117_55,1.0,149,204,55,4
1,r_61_105_166,r_9_141_176,r_67_11_140,r_9_141_176,1.0,-10,166,176,4
46,r_123_34_220,seq43,r_61_105_166,r_61_105_166,0.97,11,177,166,4
7,r_120_137_172,seq92,seq27,r_120_137_172,0.51,-42,130,172,4
69,seq28,seq72,r_101_108_170,r_101_108_170,0.99,6,176,170,4
14,r_112_62_41,r_44_96_271,seq149,r_112_62_41,0.99,0,41,41,4
45,r_116_49_80,r_128_71_156,r_0_87_45,r_116_49_80,1.0,0,80,80,4
36,r_32_6_75,r_113_39_28,r_75_91_14,r_113_39_28,0.82,0,28,28,4
19,r_139_146_87,r_21_88_174,seq22,r_139_146_87,0.99,1,88,87,4
15,r_13_148_21,r_52_59_251,seq114,r_13_148_21,0.99,0,21,21,4
31,r_63_132_63,r_58_124_109,r_113_39_28,r_63_132_63,1.0,1,64,63,4
41,r_65_36_209,seq4,r_46_117_55,r_65_36_209,0.82,1,210,209,4
43,r_142_100_17,r_75_91_14,r_0_87_45,r_0_87_45,1.0,4,49,45,4
10,r_128_71_156,r_116_49_80,seq5,r_116_49_80,1.0,0,80,80,4
90,seq97,r_94_93_79,seq74,r_94_93_79,1.0,-19,60,79,4
8,r_42_16_33,r_30_78_286,r_2_24_205,r_2_24_205,0.95,81,286,205,4
14,r_112_62_41,seq149,r_128_71_156,r_128_71_156,0.99,17,173,156,4
29,r_113_39_28,r_32_6_75,seq130,r_113_39_28,1.0,0,28,28,4
4,r_85_37_102,seq114,seq38,r_85_37_102,1.0,0,102,102,4
0,r_136_125_104,seq27,r_75_91_14,r_136_125_104,0.75,0,104,104,4
11,r_140_79_121,seq43,seq99,r_140_79_121,1.0,0,121,121,4
20,r_104_126_153,r_73_40_199,r_56_19_142,r_104_126_153,0.91,0,153,153,4
98,seq122,r_44_96_271,r_106_15_134,r_106_15_134,0.99,137,271,134,4
48,r_101_108_170,seq17,seq28,r_101_108_170,0.93,3,173,170,4
27,r_26_118_253,r_52_59_251,seq147,r_52_59_251,0.64,-46,205,251,4
6,r_106_15_134,seq149,seq107,r_106_15_134,0.98,0,134,134,4
62,seq18,r_52_59_251,seq8,r_52_59_251,1.0,0,251,251,4
21,r_75_91_14,r_123_34_220,r_67_11_140,r_67_11_140,1.0,80,220,140,4
42,r_33_12_24,r_0_87_45,seq41,r_33_12_24,1.0,0,24,24,4
21,r_75_91_14,seq3,r_123_34_220,r_75_91_14,0.99,0,14,14,4
10,r_128_71_156,seq5,r_112_62_41,r_128_71_156,1.0,0,156,156,4
27,r_26_118_253,r_2_24_205,r_52_59_251,r_52_59_251,0.4,-96,155,251,4
30,r_30_78_286,r_42_16_33,r_29_68_69,r_29_68_69,0.48,217,286,69,4
51,seq130,seq3,r_113_39_28,r_113_39_28,0.96,-2,26,28,4
47,r_67_11_140,seq28,r_123_34_220,r_67_11_140,0.91,0,140,140,4
46,r_123_34_220,r_61_105_166,r_135_45_48,r_123_34_220,0.98,0,220,220,4
3,r_54_84_53,r_119_110_162,r_1_53_83,r_54_84_53,1.0,0,53,53,4
40,r_29_68_69,seq76,seq3,r_29_68_69,1.0,1,70,69,4
17,r_46_117_55,seq14,seq66,r_46_117_55,0.99,0,55,55,4
74,seq43,r_98_23_112,seq97,r_98_23_112,1.0,-15,97,112,4
18,r_58_124_109,seq41,r_13_148_21,r_58_124_109,0.81,-1,108,109,4
24,r_1_53_83,seq149,r_94_93_79,r_94_93_79,1.0,9,88,79,4
34,r_9_141_176,r_50_95_246,seq138,r_9_141_176,0.92,0,176,176,4
43,r_142_100_17,r_61_105_166,r_75_91_14,r_142_100_17,0.89,1,18,17,4
47,r_67_11_140,r_123_34_220,r_61_105_166,r_67_11_140,0.95,80,220,140,4
2,r_135_45_48,seq66,seq144,r_135_45_48,1.0,0,48,48,4
37,r_0_87_45,seq144,r_142_100_17,r_0_87_45,1.0,0,45,45,4
32,r_56_19_142,seq109,seq122,r_56_19_142,0.62,0,142,142,4
38,r_119_110_162,seq41,r_75_91_14,r_119_110_162,0.96,1,163,162,4
34,r_9_141_176,r_61_105_166,r_50_95_246,r_61_105_166,0.43,0,166,166,4
72,seq38,seq145,r_85_37_102,r_85_37_102,0.78,3,105,102,4
81,seq76,seq17,r_32_6_75,r_32_6_75,1.0,51,126,75,4
36,r_32_6_75,r_75_91_14,seq76,r_32_6_75,1.0,0,75,75,4
94,seq109,r_56_19_142,seq27,r_56_19_142,0.94,0,142,142,4
9,r_21_88_174,r_139_146_87,r_46_117_55,r_21_88_174,0.98,-104,70,174,4
26,r_90_131_52,r_2_24_205,r_94_93_79,r_90_131_52,0.99,82,134,52,4
7,r_120_137_172,seq27,r_85_37_102,r_120_137_172,0.99,-1,171,172,4
7,r_120_137_172,seq10,seq92,r_120_137_172,0.52,-134,38,172,4
22,r_98_23_112,seq43,seq122,r_98_23_112,0.51,1,113,112,4
28,r_2_24_205,seq66,seq17,r_2_24_205,0.96,0,205,205,4
91,seq99,seq66,r_140_79_121,r_140_79_121,1.0,13,134,121,4
49,r_102_134_283,seq80,r_106_15_134,r_106_15_134,0.94,149,283,134,4
44,r_89_60_132,seq147,r_85_37_102,r_89_60_132,0.93,1,133,132,4
23,r_50_95_246,seq72,seq149,r_50_95_246,0.55,2,248,246,4
8,r_42_16_33,r_128_71_156,r_30_78_286,r_42_16_33,1.0,0,33,33,4
79,seq72,r_50_95_246,r_101_108_170,r_101_108_170,0.68,74,244,170,4
12,r_69_121_145,seq14,seq41,r_69_121_145,1.0,0,145,145,4
30,r_63_5_194,seq115,r_127_76_124,r_127_76_124,0.87,4,128,124,5
36,r_16_14_170,seq111,r_82_124_131,r_16_14_170,0.6,16,186,170,5
14,r_86_7_283,seq28,r_138_146_50,r_86_7_283,0.33,0,283,283,5
8,r_118_91_171,seq107,r_141_139_48,r_118_91_171,1.0,0,171,171,5
43,r_10_126_103,seq135,seq28,r_10_126_103,0.85,1,104,103,5
54,seq9,r_35_65_143,seq0,r_35_65_143,0.99,-53,90,143,5
37,r_37_52_218,r_35_65_143,r_125_133_90,r_35_65_143,0.99,-53,90,143,5
3,r_141_139_48,r_99_116_14,r_118_91_171,r_118_91_171,1.0,0,171,171,5
86,seq90,r_17_22_166,r_47_96_79,r_47_96_79,1.0,15,94,79,5
21,r_72_97_109,seq113,seq44,r_72_97_109,0.51,18,127,109,5
39,r_6_3_273,r_140_117_141,seq69,r_140_117_141,1.0,-1,140,141,5
1,r_127_76_124,seq114,r_63_5_194,r_127_76_124,0.88,5,129,124,5
97,seq114,r_127_76_124,r_59_25_108,r_59_25_108,0.78,25,133,108,5
42,r_144_119_179,seq111,r_88_32_65,r_144_119_179,1.0,0,179,179,5
6,r_70_77_41,r_141_139_48,seq142,r_70_77_41,0.88,1,42,41,5
45,r_132_48_120,r_23_129_153,seq142,r_132_48_120,0.99,0,120,120,5
19,r_109_84_298,seq104,r_137_128_85,r_137_128_85,1.0,8,93,85,5
34,r_138_146_50,r_29_123_285,seq136,r_138_146_50,0.98,4,54,50,5
76,seq57,seq94,r_88_32_65,r_88_32_65,1.0,5,70,65,5
38,r_122_79_275,r_59_25_108,r_141_139_48,r_59_25_108,0.54,167,275,108,5
31,r_33_95_220,r_17_22_166,r_82_124_131,r_33_95_220,0.71,-53,167,220,5
89,seq94,seq57,r_144_119_179,r_144_119_179,1.0,12,191,179,5
3,r_141_139_48,r_86_7_283,r_99_116_14,r_141_139_48,0.6,36,84,48,5
26,r_59_25_108,seq44,r_122_79_275,r_59_25_108,0.76,4,112,108,5
4,r_66_71_269,seq46,seq8,r_66_71_269,0.41,0,269,269,5
0,r_137_128_85,r_127_76_124,r_109_84_298,r_137_128_85,1.0,1,86,85,5
31,r_33_95_220,r_82_124_131,seq87,r_33_95_220,1.0,0,220,220,5
13,r_82_124_131,seq114,seq90,r_82_124_131,0.77,2,133,131,5
15,r_47_96_79,seq19,seq90,r_47_96_79,1.0,0,79,79,5
10,r_134_11_57,r_66_71_269,r_106_64_18,r_134_11_57,1.0,-1,56,57,5
48,r_120_98_145,seq49,seq93,r_120_98_145,1.0,1,146,145,5
33,r_23_129_153,seq103,seq85,r_23_129_153,1.0,0,153,153,5
27,r_140_117_141,r_6_3_273,seq85,r_140_117_141,0.83,-1,140,141,5
30,r_63_5_194,r_127_76_124,r_125_133_90,r_63_5_194,0.75,5,199,194,5
2,r_89_50_202,seq90,r_120_98_145,r_89_50_202,0.79,1,203,202,5
40,r_4_20_178,r_37_52_218,seq15,r_37_52_218,0.79,-43,175,218,5
74,seq55,r_86_7_283,r_121_100_54,r_121_100_54,1.0,70,124,54,5
18,r_29_123_285,seq135,r_12_60_104,r_12_60_104,0.96,181,285,104,5
29,r_12_60_104,seq24,seq107,r_12_60_104,1.0,0,104,104,5
24,r_45_53_62,r_120_98_145,seq57,r_45_53_62,1.0,0,62,62,5
11,r_73_21_43,r_29_123_285,seq49,r_73_21_43,0.99,0,43,43,5
33,r_23_129_153,r_132_48_120,seq103,r_132_48_120,0.55,1,121,120,5
51,seq1,r_61_39_154,r_108_131_193,r_108_131_193,0.66,0,193,193,5
88,seq93,seq46,r_120_98_145,r_120_98_145,1.0,4,149,145,5
50,seq0,r_35_65_143,seq115,r_35_65_143,1.0,-53,90,143,5
32,r_88_32_65,seq107,seq57,r_88_32_65,1.0,0,65,65,5
38,r_122_79_275,r_29_123_285,r_59_25_108,r_59_25_108,0.96,8,116,108,5
60,seq24,r_12_60_104,r_106_64_18,r_12_60_104,0.91,0,104,104,5
9,r_108_131_193,seq107,seq1,r_108_131_193,0.61,0,193,193,5
26,r_59_25_108,r_122_79_275,seq114,r_122_79_275,0.59,0,275,275,5
50,seq0,seq115,r_127_76_124,r_127_76_124,0.55,110,234,124,5
24,r_45_53_62,seq57,r_130_51_87,r_130_51_87,1.0,28,115,87,5
37,r_37_52_218,r_125_133_90,r_137_128_85,r_37_52_218,0.98,0,218,218,5
28,r_125_133_90,r_37_52_218,r_63_5_194,r_37_52_218,1.0,0,218,218,5
28,r_125_133_90,r_10_126_103,r_37_52_218,r_10_126_103,1.0,-13,90,103,5
12,r_68_58_177,seq115,r_13_105_231,r_13_105_231,0.96,3,234,231,5
49,r_143_42_138,seq1,seq135,r_143_42_138,0.96,0,138,138,5
7,r_130_51_87,r_59_25_108,r_45_53_62,r_130_51_87,1.0,0,87,87,5
23,r_35_65_143,r_37_52_218,seq57,r_35_65_143,1.0,0,143,143,5
41,r_121_100_54,r_88_32_65,seq55,r_121_100_54,1.0,3,57,54,5
25,r_106_64_18,seq69,seq24,r_106_64_18,0.98,1,19,18,5
79,seq69,r_6_3_273,seq40,r_6_3_273,0.7,1,274,273,5
5,r_99_116_14,seq142,r_141_139_48,r_99_116_14,0.78,1,15,14,5
30,r_34_96_186,r_110_71_236,seq92,r_34_96_186,0.99,0,186,186,6
51,seq5,r_43_85_208,seq74,r_43_85_208,1.0,0,208,208,6
36,r_89_126_140,seq63,r_73_32_19,r_73_32_19,0.76,122,141,19,6
14,r_128_60_92,r_110_71_236,seq133,r_128_60_92,1.0,0,92,92,6
8,r_37_112_239,seq22,seq11,r_37_112_239,0.92,1,240,239,6
43,r_70_35_149,r_45_4_280,seq81,r_70_35_149,0.98,0,149,149,6
86,seq92,r_7_30_213,r_34_96_186,r_34_96_186,1.0,6,192,186,6
24,r_12_131_48,r_132_113_247,seq130,r_12_131_48,1.0,1,49,48,6
86,seq92,seq125,r_7_30_213,r_7_30_213,0.38,-125,88,213,6
16,r_45_4_280,r_70_35_149,r_80_15_127,r_45_4_280,0.91,-130,150,280,6
21,r_52_46_193,seq130,r_40_103_42,r_52_46_193,0.99,0,193,193,6
1,r_145_23_222,seq114,seq22,r_145_23_222,0.95,1,223,222,6
97,seq122,r_18_16_289,r_45_4_280,r_45_4_280,0.57,10,290,280,6
5,r_142_108_206,seq118,r_12_131_48,r_142_108_206,1.0,0,206,206,6
46,r_33_106_288,r_91_116_219,r_94_39_82,r_94_39_82,1.0,18,100,82,6
42,r_62_55_287,seq44,r_88_138_299,r_88_138_299,0.97,-12,287,299,6
7,r_43_85_208,r_45_4_280,r_31_136_224,r_45_4_280,0.59,3,283,280,6
69,seq44,r_62_55_287,r_31_136_224,r_31_136_224,0.96,63,287,224,6
31,r_80_15_127,seq83,seq44,r_80_15_127,0.94,1,128,127,6
19,r_7_30_213,seq20,r_78_58_70,r_78_58_70,0.99,143,213,70,6
33,r_94_39_82,r_33_106_288,r_132_113_247,r_132_113_247,0.99,40,287,247,6
76,seq63,r_89_126_140,r_19_2_68,r_19_2_68,1.0,74,142,68,6
31,r_80_15_127,r_41_10_112,seq83,r_41_10_112,0.84,0,112,112,6
41,r_41_10_112,r_80_15_127,seq38,r_41_10_112,0.74,1,113,112,6
67,seq133,seq87,r_128_60_92,r_128_60_92,1.0,35,127,92,6
89,seq98,seq100,r_137_102_174,r_137_102_174,1.0,10,184,174,6
10,r_3_42_90,r_62_55_287,seq83,r_3_42_90,0.84,0,90,90,6
16,r_45_4_280,r_80_15_127,seq122,r_45_4_280,0.49,3,283,280,6
4,r_86_9_134,seq100,r_144_64_81,r_86_9_134,1.0,0,134,134,6
0,r_149_129_102,seq127,r_104_117_63,r_149_129_102,1.0,0,102,102,6
11,r_50_13_217,seq119,r_3_42_90,r_50_13_217,0.96,0,217,217,6
17,r_68_72_47,r_3_42_90,r_18_16_289,r_68_72_47,1.0,1,48,47,6
13,r_31_136_224,seq74,r_80_15_127,r_31_136_224,0.94,1,225,224,6
46,r_33_106_288,r_94_39_82,r_67_148_173,r_67_148_173,0.92,114,287,173,6
15,r_104_117_63,seq76,seq135,r_104_117_63,0.98,1,64,63,6
48,r_120_84_198,seq69,r_80_15_127,r_120_84_198,0.98,0,198,198,6
6,r_132_113_247,r_88_138_299,r_37_112_239,r_37_112_239,0.92,12,251,239,6
10,r_3_42_90,seq83,r_50_13_217,r_50_13_217,1.0,8,225,217,6
87,seq95,r_120_84_198,seq51,r_120_84_198,0.88,-17,181,198,6
2,r_19_2_68,r_37_112_239,seq63,r_19_2_68,1.0,0,68,68,6
41,r_41_10_112,seq38,r_67_148_173,r_67_148_173,1.0,0,173,173,6
47,r_0_36_279,seq11,r_88_138_299,r_0_36_279,0.2,0,279,279,6
34,r_73_32_19,r_78_58_70,seq57,r_73_32_19,1.0,0,19,19,6
40,r_134_123_144,r_24_25_258,seq20,r_134_123_144,1.0,0,144,144,6
18,r_18_16_289,seq122,r_68_72_47,r_68_72_47,1.0,14,61,47,6
29,r_79_75_264,r_48_139_296,r_88_138_299,r_88_138_299,0.66,-35,264,299,6
25,r_144_64_81,r_33_106_288,seq127,r_144_64_81,0.97,0,81,81,6
33,r_94_39_82,seq118,r_33_106_288,r_94_39_82,1.0,2,84,82,6
70,seq47,r_132_113_247,r_90_109_189,r_90_109_189,0.95,-1,188,189,6
65,seq28,seq83,r_124_1_75,r_124_1_75,1.0,12,87,75,6
68,seq38,r_66_99_121,seq47,r_66_99_121,1.0,-12,109,121,6
61,seq20,r_7_30_213,r_134_123_144,r_134_123_144,1.0,27,171,144,6
32,r_66_99_121,r_132_113_247,seq87,r_66_99_121,1.0,0,121,121,6
38,r_24_25_258,seq14,seq17,r_24_25_258,0.54,0,258,258,6
45,r_40_103_42,r_50_13_217,seq14,r_40_103_42,1.0,0,42,42,6
22,r_61_27_96,seq6,r_144_64_81,r_144_64_81,1.0,26,107,81,6
28,r_107_140_254,seq54,seq122,r_107_140_254,0.47,1,255,254,6
15,r_104_117_63,seq135,r_149_129_102,r_149_129_102,1.0,2,104,102,6
49,r_90_109_189,seq14,seq47,r_90_109_189,0.92,0,189,189,6
7,r_43_85_208,seq5,r_45_4_280,r_43_85_208,0.94,0,208,208,6
18,r_18_16_289,r_68_72_47,r_88_138_299,r_88_138_299,0.78,-9,290,299,6
44,r_110_71_236,seq54,seq51,r_110_71_236,0.92,0,236,236,6
23,r_88_138_299,r_132_113_247,r_90_109_189,r_90_109_189,0.93,62,251,189,6
17,r_68_72_47,r_18_16_289,seq122,r_18_16_289,0.51,-12,277,289,6
82,seq81,seq69,r_70_35_149,r_70_35_149,1.0,16,165,149,6
79,seq74,r_31_136_224,seq5,r_31_136_224,1.0,1,225,224,6
35,r_124_1_75,seq69,seq28,r_124_1_75,1.0,1,76,75,6
12,r_78_58_70,r_48_139_296,seq118,r_78_58_70,0.94,0,70,70,6
84,seq83,seq28,r_124_1_75,r_124_1_75,1.0,0,75,75,6
36,r_13_28_83,seq42,seq133,r_13_28_83,1.0,0,83,83,7
2,r_143_11_16,r_108_68_14,r_103_61_283,r_143_11_16,0.82,-1,15,16,7
20,r_111_112_79,r_81_71_225,r_83_46_116,r_111_112_79,1.0,-1,78,79,7
14,r_10_91_258,seq109,seq78,r_10_91_258,0.49,0,258,258,7
8,r_141_76_213,seq18,r_8_106_44,r_141_76_213,0.94,0,213,213,7
86,seq70,r_8_106_44,r_81_71_225,r_81_71_225,1.0,2,227,225,7
54,seq135,r_89_134_208,seq107,r_89_134_208,0.92,0,208,208,7
82,seq63,r_20_116_141,r_45_1_47,r_45_1_47,1.0,-1,46,47,7
56,seq9,r_21_24_133,r_140_84_6,r_140_84_6,0.99,17,23,6,7
23,r_79_130_56,r_17_86_298,r_89_134_208,r_79_130_56,1.0,-2,54,56,7
71,seq146,r_20_116_141,r_80_30_58,r_80_30_58,1.0,6,64,58,7
86,seq70,r_54_120_186,r_8_106_44,r_8_106_44,0.99,58,102,44,7
21,r_100_90_177,r_141_76_213,seq75,r_100_90_177,0.87,0,177,177,7
39,r_74_127_149,r_54_120_186,seq55,r_74_127_149,0.94,0,149,149,7
1,r_54_120_186,r_89_134_208,r_21_24_133,r_54_120_186,0.9,0,186,186,7
84,seq66,seq73,r_53_15_110,r_53_15_110,0.88,15,125,110,7
5,r_99_69_234,seq145,r_142_41_61,r_99_69_234,0.78,0,234,234,7
42,r_47_87_113,seq144,r_111_112_79,r_47_87_113,0.5,1,114,113,7
6,r_104_25_46,r_80_30_58,seq49,r_104_25_46,0.99,-2,44,46,7
45,r_36_5_81,r_17_86_298,r_102_33_147,r_36_5_81,0.5,8,89,81,7
19,r_128_122_117,seq65,seq51,r_128_122_117,0.99,1,118,117,7
45,r_36_5_81,r_102_33_147,seq137,r_102_33_147,1.0,0,147,147,7
31,r_8_106_44,seq50,r_89_134_208,r_8_106_44,1.0,0,44,44,7
11,r_108_68_14,r_99_69_234,r_27_38_151,r_27_38_151,0.94,83,234,151,7
41,r_101_7_66,r_98_110_101,seq148,r_101_7_66,1.0,0,66,66,7
47,r_26_12_23,r_54_120_186,r_140_84_6,r_140_84_6,0.85,17,23,6,7
3,r_80_30_58,r_47_87_113,seq146,r_80_30_58,0.55,0,58,58,7
26,r_114_35_160,r_17_86_298,r_27_38_151,r_114_35_160,0.99,0,160,160,7
11,r_108_68_14,r_143_11_16,r_99_69_234,r_108_68_14,0.99,0,14,14,7
73,seq42,r_13_28_83,r_94_147_194,r_13_28_83,1.0,-3,80,83,7
15,r_59_105_168,r_113_19_171,r_123_88_114,r_59_105_168,0.86,1,169,168,7
16,r_96_62_43,r_8_106_44,seq109,r_8_106_44,1.0,-12,32,44,7
62,seq148,seq49,r_101_7_66,r_101_7_66,1.0,103,169,66,7
20,r_111_112_79,r_83_46_116,r_47_87_113,r_47_87_113,1.0,5,118,113,7
28,r_149_115_37,seq43,seq22,r_149_115_37,1.0,1,38,37,7
27,r_121_131_153,seq56,r_104_25_46,r_121_131_153,0.59,0,153,153,7
87,seq73,r_81_71_225,r_53_15_110,r_53_15_110,0.6,16,126,110,7
40,r_44_77_182,r_17_86_298,seq78,r_44_77_182,0.97,0,182,182,7
74,seq43,seq2,r_123_88_114,r_123_88_114,1.0,21,135,114,7
18,r_81_71_225,seq73,seq70,r_81_71_225,0.66,-1,224,225,7
29,r_102_33_147,r_36_5_81,r_8_106_44,r_36_5_81,1.0,66,147,81,7
24,r_113_19_171,seq14,r_142_41_61,r_142_41_61,1.0,110,171,61,7
25,r_27_38_151,r_54_120_186,seq145,r_27_38_151,0.99,0,151,151,7
43,r_89_134_208,r_8_106_44,r_98_110_101,r_8_106_44,0.99,165,209,44,7
38,r_92_48_206,seq14,r_45_1_47,r_92_48_206,0.77,0,206,206,7
77,seq51,seq32,r_128_122_117,r_128_122_117,1.0,15,132,117,7
37,r_119_52_293,r_80_30_58,seq66,r_80_30_58,0.64,66,124,58,7
37,r_119_52_293,r_3_72_100,seq51,r_119_52_293,0.43,-273,20,293,7
60,seq145,r_99_69_234,r_27_38_151,r_27_38_151,0.94,83,234,151,7
81,seq60,seq93,r_98_110_101,r_98_110_101,1.0,93,194,101,7
31,r_8_106_44,r_89_134_208,r_102_33_147,r_8_106_44,0.69,164,208,44,7
22,r_53_15_110,seq63,seq73,r_53_15_110,0.96,0,110,110,7
43,r_89_134_208,r_54_120_186,r_8_106_44,r_8_106_44,1.0,2,46,44,7
49,r_123_88_114,r_54_120_186,seq43,r_123_88_114,1.0,0,114,114,7
67,seq29,seq132,r_58_40_31,r_58_40_31,1.0,14,45,31,7
20,r_111_112_79,r_58_40_31,r_81_71_225,r_111_112_79,0.73,-56,23,79,7
44,r_125_82_136,r_10_91_258,r_140_84_6,r_125_82_136,0.97,0,136,136,7
32,r_34_64_25,r_54_120_186,seq63,r_54_120_186,0.61,-163,23,186,7
35,r_98_110_101,seq132,seq60,r_98_110_101,1.0,0,101,101,7
12,r_94_147_194,seq42,r_80_30_58,r_94_147_194,0.69,1,195,194,7
37,r_119_52_293,seq66,seq97,r_119_52_293,0.49,-117,176,293,7
23,r_79_130_56,r_89_134_208,r_138_0_203,r_79_130_56,0.95,152,208,56,7
7,r_45_1_47,r_141_76_213,seq63,r_45_1_47,1.0,-1,46,47,7
84,seq66,r_3_72_100,seq73,r_3_72_100,0.95,-3,97,100,7
30,r_101_44_210,r_141_116_211,r_17_99_96,r_17_99_96,1.0,29,125,96,8
43,r_19_81_73,r_107_45_239,r_135_56_95,r_19_81_73,1.0,0,73,73,8
42,r_20_31_57,r_128_68_190,seq18,r_20_31_57,1.0,0,57,57,8
83,seq75,r_61_12_285,seq35,r_61_12_285,0.57,0,285,285,8
37,r_30_98_244,r_58_86_232,r_113_142_173,r_113_142_173,0.97,59,232,173,8
3,r_17_99_96,r_101_44_210,r_9_39_4,r_101_44_210,1.0,0,210,210,8
93,seq115,r_129_144_39,r_14_114_32,r_14_114_32,1.0,27,59,32,8
71,seq55,r_132_133_297,r_48_80_184,r_48_80_184,1.0,56,240,184,8
16,r_128_68_190,r_30_98_244,seq134,r_128_68_190,0.96,0,190,190,8
39,r_54_79_264,r_136_92_295,r_131_91_294,r_54_79_264,0.48,1,265,264,8
1,r_61_12_285,seq75,r_128_68_190,r_128_68_190,0.56,95,285,190,8
5,r_137_37_258,r_58_86_232,r_29_83_145,r_58_86_232,0.73,-77,155,232,8
46,r_77_105_175,seq13,r_113_142_173,r_77_105_175,0.96,1,176,175,8
63,seq134,seq7,r_128_68_190,r_128_68_190,1.0,2,192,190,8
69,seq50,r_94_145_72,seq57,r_94_145_72,0.99,0,72,72,8
45,r_70_34_169,r_16_112_241,r_102_1_63,r_70_34_169,0.99,1,170,169,8
21,r_14_114_32,r_111_88_192,seq115,r_14_114_32,0.99,0,32,32,8
37,r_30_98_244,r_113_142_173,r_143_126_166,r_30_98_244,0.86,1,245,244,8
31,r_106_24_158,seq134,seq82,r_106_24_158,1.0,0,158,158,8
41,r_107_45_239,seq18,seq134,r_107_45_239,0.85,0,239,239,8
3,r_17_99_96,r_143_126_166,r_101_44_210,r_17_99_96,0.82,0,96,96,8
9,r_46_4_11,r_32_66_165,seq57,r_46_4_11,0.79,13,24,11,8
14,r_29_83_145,r_137_37_258,r_148_103_247,r_29_83_145,1.0,113,258,145,8
0,r_76_96_129,seq38,seq71,r_76_96_129,1.0,0,129,129,8
63,seq134,r_106_24_158,seq7,r_106_24_158,0.59,0,158,158,8
73,seq59,r_33_120_234,r_136_92_295,r_33_120_234,1.0,0,234,234,8
11,r_108_124_86,r_104_47_250,seq78,r_108_124_86,1.0,0,86,86,8
55,seq10,r_51_21_52,r_113_142_173,r_51_21_52,1.0,1,53,52,8
20,r_113_142_173,seq84,r_32_66_165,r_113_142_173,1.0,1,174,173,8
15,r_62_109_123,seq119,seq10,r_62_109_123,0.62,-1,122,123,8
48,r_102_1_63,r_113_142_173,seq73,r_113_142_173,1.0,-102,71,173,8
17,r_41_23_51,r_17_99_96,r_9_39_4,r_9_39_4,1.0,47,51,4,8
57,seq13,r_77_105_175,seq18,r_77_105_175,1.0,1,176,175,8
12,r_143_126_166,r_94_145_72,r_9_39_4,r_143_126_166,0.99,0,166,166,8
62,seq35,r_60_110_217,seq97,r_60_110_217,0.84,1,218,217,8
19,r_8_125_22,r_136_92_295,seq18,r_8_125_22,1.0,0,22,22,8
85,seq82,r_111_88_192,r_9_39_4,r_111_88_192,0.91,0,192,192,8
5,r_137_37_258,r_29_83_145,r_94_145_72,r_29_83_145,0.65,113,258,145,8
27,r_111_88_192,seq82,seq40,r_111_88_192,1.0,0,192,192,8
30,r_101_44_210,r_17_99_96,r_14_114_32,r_101_44_210,0.96,0,210,210,8
22,r_36_5_42,r_136_92_295,r_141_116_211,r_141_116_211,0.98,6,217,211,8
2,r_140_22_134,r_104_47_250,seq72,r_140_22_134,1.0,1,135,134,8
47,r_16_112_241,r_70_34_169,seq134,r_70_34_169,0.98,1,170,169,8
18,r_104_47_250,r_140_22_134,seq115,r_140_22_134,0.77,1,135,134,8
29,r_129_144_39,r_58_86_232,r_29_83_145,r_58_86_232,0.92,0,232,232,8
24,r_60_110_217,seq35,r_8_125_22,r_8_125_22,0.82,196,218,22,8
22,r_36_5_42,seq90,r_136_92_295,r_36_5_42,1.0,3,45,42,8
43,r_19_81_73,r_135_56_95,r_9_39_4,r_9_39_4,0.55,211,215,4,8
33,r_33_120_234,seq59,r_29_83_145,r_33_120_234,0.97,0,234,234,8
36,r_53_2_138,r_140_22_134,seq57,r_53_2_138,0.49,-70,68,138,8
64,seq38,r_76_96_129,seq3,r_76_96_129,1.0,0,129,129,8
47,r_16_112_241,seq134,r_104_47_250,r_16_112_241,0.95,3,244,241,8
70,seq52,seq13,r_17_99_96,r_17_99_96,0.91,187,283,96,8
32,r_141_116_211,r_9_39_4,r_36_5_42,r_9_39_4,0.97,209,213,4,8
38,r_48_80_184,seq139,seq55,r_48_80_184,0.99,0,184,184,8
36,r_53_2_138,seq118,r_140_22_134,r_140_22_134,0.82,-92,42,134,8
34,r_87_26_151,seq27,seq74,r_87_26_151,0.99,1,152,151,8
64,seq38,seq3,r_58_86_232,r_58_86_232,1.0,7,239,232,8
96,seq119,r_62_109_123,r_132_133_297,r_62_109_123,0.92,-1,122,123,8
40,r_51_21_52,seq10,seq28,r_51_21_52,1.0,0,52,52,8
28,r_58_86_232,r_30_98_244,seq38,r_58_86_232,0.69,0,232,232,8
49,r_9_39_4,r_141_116_211,r_17_99_96,r_17_99_96,0.83,117,213,96,8
56,seq139,r_29_83_145,r_127_15_69,r_127_15_69,1.0,85,154,69,8
7,r_127_15_69,seq73,seq139,r_127_15_69,1.0,0,69,69,8
18,r_104_47_250,seq115,r_16_112_241,r_104_47_250,0.68,0,250,250,8
44,r_32_66_165,seq72,seq115,r_32_66_165,1.0,0,165,165,8
23,r_94_145_72,seq50,seq27,r_94_145_72,0.98,0,72,72,8
79,seq71,r_25_95_104,r_76_96_129,r_25_95_104,0.69,25,129,104,8
35,r_25_95_104,r_107_45_239,seq71,r_25_95_104,0.94,0,104,104,8
12,r_143_126_166,r_17_99_96,r_94_145_72,r_143_126_166,0.68,-70,96,166,8
51,seq129,r_126_75_260,r_19_73_173,r_19_73_173,1.0,95,268,173,9
92,seq97,r_41_34_188,r_16_78_86,r_16_78_86,1.0,99,185,86,9
14,r_94_61_107,seq33,seq57,r_94_61_107,1.0,3,110,107,9
43,r_128_114_77,seq2,r_62_58_12,r_128_114_77,0.96,1,78,77,9
37,r_35_65_68,seq11,r_41_34_188,r_35_65_68,1.0,0,68,68,9
30,r_62_58_12,r_19_73_173,r_113_148_266,r_62_58_12,0.96,0,12,12,9
71,seq42,seq146,r_29_1_193,r_29_1_193,1.0,32,225,193,9
16,r_19_73_173,seq131,seq12,r_19_73_173,1.0,0,173,173,9
21,r_30_147_162,seq5,r_105_28_44,r_30_147_162,0.78,2,164,162,9
39,r_66_136_284,seq59,r_30_147_162,r_30_147_162,0.74,123,285,162,9
1,r_108_106_272,seq55,r_19_73_173,r_19_73_173,0.92,99,272,173,9
46,r_43_122_285,seq138,r_39_27_46,r_39_27_46,0.95,240,286,46,9
45,r_116_13_211,seq135,r_70_109_276,r_116_13_211,0.73,1,212,211,9
9,r_87_133_23,r_140_3_99,seq55,r_87_133_23,0.96,-6,17,23,9
15,r_39_27_46,r_21_22_203,r_36_52_154,r_36_52_154,0.62,37,191,154,9
33,r_113_148_266,r_90_40_14,r_120_118_116,r_120_118_116,0.61,148,264,116,9
95,seq146,seq42,r_112_6_139,r_112_6_139,1.0,10,149,139,9
38,r_70_109_276,r_35_65_68,r_116_13_211,r_116_13_211,0.86,6,217,211,9
31,r_80_47_268,r_21_22_203,r_39_27_46,r_39_27_46,0.99,157,203,46,9
41,r_36_52_154,r_77_98_295,r_39_27_46,r_39_27_46,0.51,106,152,46,9
3,r_37_149_113,r_41_34_188,r_140_3_99,r_37_149_113,0.88,1,114,113,9
19,r_145_117_19,seq48,seq12,r_145_117_19,0.95,5,24,19,9
26,r_16_78_86,seq101,r_144_123_17,r_144_123_17,1.0,0,17,17,9
8,r_121_95_6,r_107_64_227,r_102_86_95,r_102_86_95,0.7,132,227,95,9
5,r_144_123_17,r_90_40_14,r_16_78_86,r_144_123_17,0.98,0,17,17,9
0,r_130_142_161,r_29_1_193,seq134,r_130_142_161,1.0,3,164,161,9
11,r_14_38_183,r_76_60_253,seq84,r_14_38_183,0.99,0,183,183,9
20,r_112_6_139,seq96,seq146,r_112_6_139,1.0,0,139,139,9
13,r_120_118_116,r_80_47_268,seq82,r_120_118_116,0.75,3,119,116,9
48,r_100_26_298,r_80_47_268,r_83_72_159,r_83_72_159,0.97,9,168,159,9
57,seq135,r_116_13_211,seq0,r_116_13_211,1.0,1,212,211,9
5,r_144_123_17,r_16_78_86,seq101,r_16_78_86,1.0,0,86,86,9
27,r_23_124_93,seq42,seq81,r_23_124_93,1.0,0,93,93,9
30,r_62_58_12,r_113_148_266,r_128_114_77,r_128_114_77,1.0,25,102,77,9
22,r_41_34_188,r_35_65_68,r_92_9_200,r_35_65_68,0.99,135,203,68,9
40,r_110_50_225,r_68_17_299,r_37_149_113,r_37_149_113,0.89,112,225,113,9
24,r_76_60_253,r_14_38_183,seq10,r_14_38_183,0.71,0,183,183,9
47,r_105_28_44,seq63,r_30_147_162,r_30_147_162,1.0,49,211,162,9
25,r_83_72_159,seq63,r_105_28_44,r_105_28_44,1.0,27,71,44,9
6,r_90_40_14,r_68_17_299,seq32,r_90_40_14,0.97,11,25,14,9
47,r_105_28_44,r_83_72_159,seq63,r_83_72_159,1.0,-31,128,159,9
38,r_70_109_276,r_116_13_211,r_30_147_162,r_70_109_276,0.99,0,276,276,9
61,seq11,r_35_65_68,seq134,r_35_65_68,1.0,0,68,68,9
38,r_70_109_276,r_102_86_95,r_35_65_68,r_70_109_276,1.0,-203,73,276,9
52,seq2,r_107_64_227,r_102_86_95,r_102_86_95,0.6,29,124,95,9
77,seq55,r_108_106_272,r_87_133_23,r_87_133_23,0.95,222,245,23,9
15,r_39_27_46,seq44,r_21_22_203,r_39_27_46,0.99,0,46,46,9
45,r_116_13_211,r_70_109_276,r_62_58_12,r_70_109_276,0.99,0,276,276,9
81,seq138,r_43_122_285,r_102_86_95,r_102_86_95,1.0,191,286,95,9
17,r_126_75_260,seq129,r_16_78_86,r_16_78_86,1.0,182,268,86,9
25,r_83_72_159,r_105_28_44,seq8,r_83_72_159,0.99,-1,158,159,9
94,seq101,r_16_78_86,r_144_123_17,r_16_78_86,0.99,0,86,86,9
26,r_16_78_86,r_144_123_17,r_35_65_68,r_16_78_86,0.91,0,86,86,9
31,r_80_47_268,r_39_27_46,r_130_142_161,r_80_47_268,0.77,1,269,268,9
37,r_35_65_68,r_41_34_188,r_103_7_156,r_35_65_68,0.97,120,188,68,9
22,r_41_34_188,r_37_149_113,r_35_65_68,r_35_65_68,0.63,46,114,68,9
28,r_74_132_103,r_37_149_113,seq55,r_37_149_113,0.75,-2,111,113,9
49,r_29_1_193,r_80_47_268,seq42,r_29_1_193,1.0,1,194,193,9
47,r_105_28_44,r_35_65_68,r_83_72_159,r_105_28_44,1.0,0,44,44,9
7,r_140_3_99,r_116_13_211,seq8,r_140_3_99,1.0,1,100,99,9
44,r_71_31_157,seq45,r_121_95_6,r_121_95_6,0.57,152,158,6,9
26,r_16_78_86,r_35_65_68,seq97,r_16_78_86,0.46,99,185,86,9
23,r_103_7_156,r_43_122_285,r_35_65_68,r_103_7_156,0.97,4,160,156,9
12,r_102_86_95,r_126_75_260,seq2,r_102_86_95,1.0,0,95,95,9
33,r_113_148_266,seq32,r_90_40_14,r_90_40_14,1.0,8,22,14,9
93,seq112,r_82_36_229,r_126_19_117,r_126_19_117,1.0,112,229,117,10
37,r_131_34_47,seq100,r_74_107_167,r_131_34_47,1.0,0,47,47,10
40,r_5_56_33,r_11_32_190,r_23_127_193,r_5_56_33,0.77,157,190,33,10
30,r_74_107_167,r_38_4_272,seq120,r_74_107_167,0.92,1,168,167,10
44,r_33_119_243,r_76_10_52,r_24_48_154,r_76_10_52,0.64,198,250,52,10
36,r_146_39_132,seq69,seq58,r_146_39_132,0.98,0,132,132,10
14,r_38_4_272,seq113,r_91_116_184,r_91_116_184,0.8,98,282,184,10
8,r_126_19_117,r_35_44_270,r_134_102_63,r_134_102_63,0.98,57,120,63,10
43,r_23_127_193,r_61_105_95,r_5_56_33,r_23_127_193,0.87,0,193,193,10
17,r_139_40_53,seq138,seq57,r_139_40_53,1.0,3,56,53,10
59,seq143,r_103_70_165,r_22_98_64,r_22_98_64,0.99,104,168,64,10
16,r_18_122_226,seq69,r_49_2_130,r_49_2_130,0.97,100,230,130,10
39,r_65_68_206,r_38_4_272,r_23_127_193,r_23_127_193,0.55,13,206,193,10
97,seq120,r_128_60_202,r_74_107_167,r_74_107_167,0.55,29,196,167,10
5,r_64_95_101,seq59,seq45,r_64_95_101,1.0,0,101,101,10
46,r_46_114_177,r_111_110_231,seq67,r_46_114_177,0.69,1,178,177,10
42,r_24_48_154,r_81_125_204,r_126_19_117,r_24_48_154,0.9,0,154,154,10
45,r_115_53_116,r_26_62_2,r_137_132_297,r_137_132_297,0.51,-156,141,297,10
19,r_91_116_184,r_11_32_190,seq100,r_91_116_184,0.99,1,185,184,10
95,seq140,r_111_110_231,seq145,r_111_110_231,0.99,-45,186,231,10
38,r_76_10_52,r_33_119_243,seq86,r_33_119_243,0.84,7,250,243,10
41,r_41_51_194,seq88,r_144_142_56,r_41_51_194,0.87,2,196,194,10
40,r_5_56_33,r_131_34_47,r_11_32_190,r_5_56_33,1.0,-1,32,33,10
3,r_141_1_74,r_71_25_192,r_131_34_47,r_141_1_74,1.0,0,74,74,10
6,r_111_110_231,r_78_130_149,seq124,r_111_110_231,0.99,0,231,231,10
4,r_82_36_229,seq112,r_46_114_177,r_82_36_229,0.78,0,229,229,10
11,r_128_60_202,seq84,r_64_95_101,r_128_60_202,0.93,0,202,202,10
20,r_15_108_216,r_82_36_229,r_46_114_177,r_46_114_177,0.85,37,214,177,10
13,r_78_130_149,r_15_108_216,r_111_110_231,r_78_130_149,0.8,-1,148,149,10
44,r_33_119_243,seq86,r_76_10_52,r_76_10_52,1.0,-1,51,52,10
38,r_76_10_52,seq28,r_33_119_243,r_76_10_52,1.0,0,52,52,10
10,r_35_44_270,r_133_121_30,r_126_19_117,r_35_44_270,0.52,-242,28,270,10
15,r_6_117_162,seq88,seq135,r_6_117_162,0.98,0,162,162,10
48,r_30_31_68,r_11_32_190,seq77,r_30_31_68,1.0,0,68,68,10
13,r_78_130_149,r_111_110_231,r_71_25_192,r_78_130_149,1.0,82,231,149,10
6,r_111_110_231,r_46_114_177,r_78_130_149,r_78_130_149,0.92,29,178,149,10
10,r_35_44_270,r_141_1_74,r_126_19_117,r_35_44_270,0.83,6,276,270,10
10,r_35_44_270,r_65_68_206,r_141_1_74,r_65_68_206,0.76,6,212,206,10
10,r_35_44_270,r_126_19_117,r_65_68_206,r_126_19_117,0.45,14,131,117,10
27,r_80_7_127,seq69,r_144_142_56,r_80_7_127,1.0,4,131,127,10
29,r_149_43_21,r_38_4_272,seq96,r_149_43_21,1.0,2,23,21,10
2,r_144_142_56,seq124,r_61_105_95,r_144_142_56,0.63,18,74,56,10
47,r_49_2_130,r_103_70_165,r_85_3_293,r_85_3_293,0.95,-163,130,293,10
18,r_103_70_165,seq143,r_85_3_293,r_103_70_165,0.77,3,168,165,10
24,r_71_25_192,r_15_108_216,seq145,r_71_25_192,0.49,0,192,192,10
25,r_79_90_258,seq77,r_146_39_132,r_79_90_258,0.52,0,258,258,10
87,seq96,r_21_27_220,r_149_43_21,r_149_43_21,1.0,3,24,21,10
32,r_89_147_119,r_6_117_162,seq58,r_89_147_119,0.95,0,119,119,10
34,r_66_42_124,seq58,r_139_40_53,r_66_42_124,0.95,0,124,124,10
75,seq69,r_18_122_226,r_50_37_183,r_50_37_183,1.0,47,230,183,10
81,seq84,r_128_60_202,r_74_107_167,r_74_107_167,0.62,35,202,167,10
1,r_97_92_23,r_128_60_202,seq83,r_97_92_23,0.56,0,23,23,10
22,r_133_121_30,r_35_44_270,seq67,r_133_121_30,0.99,-2,28,30,10
9,r_104_123_91,seq100,r_97_92_23,r_104_123_91,1.0,0,91,91,10
96,seq118,r_50_37_183,r_5_56_33,r_5_56_33,0.91,159,192,33,10
37,r_131_34_47,r_74_107_167,r_141_1_74,r_131_34_47,0.55,68,115,47,10
49,r_85_3_293,r_21_27_220,r_103_70_165,r_103_70_165,0.91,55,220,165,10
56,seq12,r_128_60_202,r_85_3_293,r_128_60_202,0.47,-117,85,202,10
7,r_21_27_220,r_85_3_293,r_115_53_116,r_115_53_116,0.49,104,220,116,10
23,r_11_32_190,r_91_116_184,seq59,r_11_32_190,0.78,0,190,190,10
17,r_139_40_53,seq57,r_66_42_124,r_66_42_124,1.0,8,132,124,10
82,seq86,r_33_119_243,r_76_10_52,r_76_10_52,0.99,198,250,52,10
12,r_22_98_64,seq45,seq143,r_22_98_64,1.0,0,64,64,10
84,seq88,r_6_117_162,seq67,r_6_117_162,1.0,0,162,162,10
30,r_108_18_227,r_141_129_101,r_31_3_102,r_108_18_227,1.0,-124,103,227,11
51,seq128,seq75,r_108_18_227,r_108_18_227,0.97,-5,222,227,11
36,r_107_112_94,seq114,seq123,r_107_112_94,1.0,0,94,94,11
17,r_66_126_277,r_148_10_73,r_68_27_33,r_148_10_73,0.92,-44,29,73,11
8,r_143_4_134,r_140_81_198,r_28_92_229,r_143_4_134,0.96,1,135,134,11
37,r_28_92_229,r_110_13_64,r_33_97_118,r_33_97_118,0.48,1,119,118,11
71,seq49,r_140_81_198,r_76_15_95,r_76_15_95,1.0,151,246,95,11
5,r_26_71_248,seq104,r_69_117_52,r_69_117_52,1.0,7,59,52,11
86,seq95,r_144_98_186,seq12,r_144_98_186,0.94,0,186,186,11
16,r_110_13_64,r_28_92_229,seq64,r_110_13_64,1.0,4,68,64,11
21,r_33_97_118,seq60,r_28_92_229,r_33_97_118,0.94,0,118,118,11
1,r_39_67_60,r_144_98_186,seq29,r_144_98_186,1.0,-83,103,186,11
46,r_109_61_262,seq78,seq75,r_109_61_262,0.49,1,263,262,11
32,r_116_124_108,seq89,r_2_41_55,r_2_41_55,0.38,149,204,55,11
69,seq42,r_99_58_162,r_133_44_96,r_99_58_162,0.97,0,162,162,11
19,r_76_15_95,r_96_94_226,seq20,r_76_15_95,1.0,0,95,95,11
27,r_146_51_242,r_76_15_95,r_86_16_45,r_146_51_242,0.95,0,242,242,11
15,r_145_8_85,seq50,r_144_98_186,r_144_98_186,1.0,33,219,186,11
33,r_69_117_52,r_26_71_248,r_47_36_1,r_26_71_248,1.0,0,248,248,11
38,r_147_84_267,r_137_56_164,r_133_44_96,r_147_84_267,0.98,0,267,267,11
43,r_2_41_55,r_86_16_45,r_147_84_267,r_147_84_267,1.0,2,269,267,11
43,r_2_41_55,r_145_8_85,r_77_34_7,r_145_8_85,1.0,1,86,85,11
3,r_19_115_141,r_82_72_180,seq106,r_19_115_141,1.0,0,141,141,11
11,r_68_27_33,r_110_13_64,r_66_126_277,r_68_27_33,0.58,1,34,33,11
10,r_140_81_198,seq49,seq102,r_140_81_198,0.6,-11,187,198,11
26,r_82_72_180,r_85_1_214,seq123,r_82_72_180,0.96,0,180,180,11
72,seq50,seq132,r_145_8_85,r_145_8_85,1.0,1,86,85,11
78,seq70,r_66_126_277,r_28_92_229,r_28_92_229,0.5,6,235,229,11
0,r_99_58_162,seq42,r_134_121_21,r_99_58_162,0.8,0,162,162,11
20,r_137_56_164,r_96_94_226,seq7,r_96_94_226,0.89,0,226,226,11
13,r_31_3_102,seq24,r_108_18_227,r_31_3_102,1.0,2,104,102,11
42,r_45_25_49,seq105,seq123,r_45_25_49,1.0,0,49,49,11
15,r_145_8_85,r_109_61_262,seq50,r_145_8_85,1.0,0,85,85,11
13,r_31_3_102,r_108_18_227,seq23,r_108_18_227,0.91,0,227,227,11
6,r_43_59_241,seq17,r_139_9_13,r_43_59_241,0.51,0,241,241,11
18,r_134_121_21,r_90_79_74,seq0,r_90_79_74,0.77,-52,22,74,11
43,r_2_41_55,r_77_34_7,r_86_16_45,r_2_41_55,0.48,105,160,55,11
5,r_26_71_248,r_69_117_52,r_146_51_242,r_69_117_52,0.78,196,248,52,11
36,r_107_112_94,seq123,r_38_6_145,r_38_6_145,1.0,91,236,145,11
27,r_146_51_242,r_83_74_219,r_76_15_95,r_76_15_95,1.0,126,221,95,11
30,r_108_18_227,r_31_3_102,seq11,r_108_18_227,0.67,0,227,227,11
40,r_38_6_145,seq17,r_107_112_94,r_38_6_145,1.0,0,145,145,11
74,seq57,r_66_126_277,r_68_27_33,r_66_126_277,0.67,-137,140,277,11
24,r_96_94_226,r_147_84_267,seq120,r_96_94_226,0.91,0,226,226,11
25,r_30_73_206,seq75,seq12,r_30_73_206,0.67,5,211,206,11
32,r_116_124_108,seq119,seq89,r_116_124_108,0.98,0,108,108,11
38,r_147_84_267,r_96_94_226,r_137_56_164,r_147_84_267,0.64,-64,203,267,11
11,r_68_27_33,r_66_126_277,r_149_138_88,r_149_138_88,1.0,3,91,88,11
90,seq105,r_45_25_49,r_54_100_32,r_45_25_49,0.98,0,49,49,11
14,r_54_100_32,r_19_115_141,seq105,r_54_100_32,0.65,0,32,32,11
33,r_69_117_52,r_93_63_151,r_26_71_248,r_69_117_52,1.0,0,52,52,11
37,r_28_92_229,r_33_97_118,seq70,r_28_92_229,0.49,3,232,229,11
22,r_148_10_73,r_66_126_277,r_134_121_21,r_148_10_73,1.0,0,73,73,11
28,r_90_79_74,seq130,r_77_34_7,r_90_79_74,1.0,0,74,74,11
7,r_53_48_50,r_19_115_141,seq91,r_53_48_50,1.0,0,50,50,11
91,seq106,seq17,r_19_115_141,r_19_115_141,1.0,4,145,141,11
49,r_144_98_186,seq95,r_145_8_85,r_144_98_186,0.93,0,186,186,11
72,seq50,r_145_8_85,r_83_74_219,r_83_74_219,1.0,45,264,219,11
44,r_101_113_98,seq89,r_53_48_50,r_101_113_98,1.0,0,98,98,11
23,r_149_138_88,seq114,r_68_27_33,r_149_138_88,1.0,0,88,88,11
17,r_66_126_277,r_68_27_33,r_53_48_50,r_68_27_33,0.58,244,277,33,11
43,r_2_41_55,r_110_13_64,r_145_8_85,r_2_41_55,1.0,0,55,55,11
35,r_83_74_219,r_146_51_242,seq50,r_83_74_219,0.98,2,221,219,11
12,r_141_129_101,r_108_18_227,seq103,r_141_129_101,0.97,2,103,101,11
30,r_52_115_101,seq20,seq9,r_52_115_101,0.99,0,101,101,12
36,r_18_54_226,r_91_12_285,r_77_135_72,r_77_135_72,1.0,34,106,72,12
31,r_50_21_33,r_43_47_158,seq20,r_50_21_33,0.81,2,35,33,12
34,r_84_126_44,seq11,r_91_12_285,r_84_126_44,1.0,1,45,44,12
81,seq81,seq20,r_28_120_199,r_28_120_199,1.0,40,239,199,12
37,r_111_23_275,r_133_146_196,r_82_62_56,r_82_62_56,1.0,5,61,56,12
59,seq15,seq3,r_45_41_116,r_45_41_116,1.0,28,144,116,12
40,r_26_101_47,r_141_143_240,seq75,r_26_101_47,1.0,0,47,47,12
19,r_93_73_233,r_110_140_76,r_26_101_47,r_93_73_233,1.0,0,233,233,12
16,r_29_44_84,seq6,seq67,r_29_44_84,0.98,0,84,84,12
21,r_72_39_121,seq116,seq9,r_72_39_121,0.96,1,122,121,12
39,r_77_135_72,seq63,r_18_54_226,r_77_135_72,1.0,0,72,72,12
2,r_112_35_28,r_141_143_240,seq6,r_112_35_28,0.97,0,28,28,12
5,r_87_103_214,seq96,seq20,r_87_103_214,0.49,-2,212,214,12
42,r_78_46_70,r_118_38_188,seq105,r_78_46_70,0.99,0,70,70,12
45,r_37_51_265,r_40_132_138,seq125,r_40_132_138,1.0,0,138,138,12
19,r_93_73_233,r_28_120_199,r_110_140_76,r_110_140_76,1.0,69,145,76,12
47,r_65_119_39,r_61_14_174,seq138,r_65_119_39,1.0,2,41,39,12
39,r_77_135_72,r_18_54_226,r_83_42_152,r_77_135_72,0.74,154,226,72,12
41,r_110_140_76,r_60_130_171,r_93_73_233,r_110_140_76,1.0,0,76,76,12
67,seq33,r_89_16_60,seq15,r_89_16_60,1.0,0,60,60,12
14,r_82_62_56,seq81,r_111_23_275,r_82_62_56,1.0,0,56,56,12
10,r_24_55_59,r_52_115_101,seq129,r_52_115_101,1.0,-22,79,101,12
44,r_104_124_18,r_61_14_174,seq4,r_104_124_18,1.0,1,19,18,12
26,r_89_16_60,seq33,seq11,r_89_16_60,0.96,0,60,60,12
8,r_145_134_57,seq147,r_87_103_214,r_145_134_57,0.22,114,171,57,12
14,r_82_62_56,r_111_23_275,r_133_146_196,r_111_23_275,0.9,-3,272,275,12
0,r_36_49_216,r_0_13_103,r_145_134_57,r_0_13_103,0.96,114,217,103,12
11,r_95_113_145,seq148,r_144_58_9,r_95_113_145,0.85,1,146,145,12
20,r_128_90_164,seq20,r_144_58_9,r_128_90_164,1.0,1,165,164,12
13,r_43_47_158,seq31,r_0_13_103,r_43_47_158,0.96,0,158,158,12
15,r_48_107_205,seq70,r_24_55_59,r_48_107_205,0.76,7,212,205,12
48,r_76_25_89,r_36_49_216,seq20,r_76_25_89,1.0,0,89,89,12
1,r_2_30_51,seq66,seq106,r_2_30_51,0.99,3,54,51,12
85,seq96,r_87_103_214,seq129,r_87_103_214,0.59,3,217,214,12
8,r_145_134_57,r_95_113_145,seq147,r_145_134_57,1.0,0,57,57,12
36,r_18_54_226,r_77_135_72,r_34_94_223,r_18_54_226,0.97,0,226,226,12
10,r_24_55_59,seq129,r_48_107_205,r_48_107_205,0.72,-7,198,205,12
41,r_110_140_76,r_93_73_233,seq63,r_93_73_233,0.63,0,233,233,12
43,r_142_123_19,seq9,seq75,r_142_123_19,1.0,0,19,19,12
74,seq67,r_85_64_243,r_133_146_196,r_85_64_243,0.97,1,244,243,12
29,r_61_14_174,seq75,seq66,r_61_14_174,0.89,0,174,174,12
24,r_28_120_199,r_93_73_233,seq81,r_28_120_199,0.95,0,199,199,12
81,seq81,r_82_62_56,seq20,r_82_62_56,1.0,0,56,56,12
46,r_102_69_31,r_72_39_121,seq108,r_102_69_31,1.0,0,31,31,12
33,r_40_132_138,r_37_51_265,r_144_58_9,r_40_132_138,0.93,0,138,138,12
50,seq1,r_87_103_214,seq129,r_87_103_214,0.4,3,217,214,12
58,seq11,seq138,r_89_16_60,r_89_16_60,1.0,22,82,60,12
70,seq56,seq3,r_117_8_68,r_117_8_68,1.0,23,91,68,12
42,r_78_46_70,seq105,r_61_14_174,r_61_14_174,1.0,1,175,174,12
63,seq149,r_18_54_226,r_84_126_44,r_84_126_44,0.95,-2,42,44,12
38,r_118_38_188,seq79,seq15,r_118_38_188,0.97,1,189,188,12
75,seq70,r_48_107_205,r_60_130_171,r_48_107_205,1.0,7,212,205,12
27,r_32_99_16,seq109,seq106,r_32_99_16,0.98,0,16,16,12
8,r_145_134_57,r_87_103_214,r_36_49_216,r_36_49_216,1.0,1,217,216,12
37,r_111_23_275,r_82_62_56,r_37_51_265,r_111_23_275,0.57,0,275,275,12
28,r_59_139_224,seq22,r_112_35_28,r_59_139_224,0.92,1,225,224,12
49,r_117_8_68,seq81,seq56,r_117_8_68,1.0,0,68,68,12
7,r_68_5_183,r_60_130_171,r_24_55_59,r_68_5_183,0.77,6,189,183,12
23,r_83_42_152,seq4,r_84_126_44,r_83_42_152,0.95,0,152,152,12
35,r_141_143_240,seq121,r_112_35_28,r_112_35_28,0.76,217,245,28,12
12,r_45_41_116,seq4,seq15,r_45_41_116,1.0,2,118,116,12
30,r_30_124_107,r_46_79_256,seq22,r_30_124_107,0.9,3,110,107,13
44,r_32_66_166,seq80,r_69_42_250,r_32_66_166,1.0,1,167,166,13
26,r_107_144_44,seq106,seq120,r_107_144_44,0.85,1,45,44,13
28,r_93_21_177,seq80,r_62_118_206,r_62_118_206,1.0,-1,205,206,13
14,r_83_102_167,seq45,seq15,r_83_102_167,1.0,0,167,167,13
8,r_148_98_255,seq52,r_30_124_107,r_148_98_255,0.57,0,255,255,13
1,r_38_142_258,r_40_72_40,r_86_133_72,r_38_142_258,0.9,-208,50,258,13
90,seq92,r_12_65_112,r_82_76_37,r_82_76_37,1.0,0,37,37,13
59,seq140,r_122_9_163,seq101,r_122_9_163,0.84,3,166,163,13
16,r_59_119_120,seq120,seq56,r_59_119_120,1.0,0,120,120,13
21,r_113_105_196,r_132_96_227,seq106,r_132_96_227,0.79,-31,196,227,13
1,r_38_142_258,r_86_133_72,r_69_42_250,r_69_42_250,0.77,8,258,250,13
5,r_58_149_140,seq0,seq5,r_58_149_140,1.0,0,140,140,13
42,r_123_8_92,seq6,seq3,r_123_8_92,1.0,1,93,92,13
45,r_23_89_238,seq101,seq10,r_23_89_238,0.43,0,238,238,13
19,r_115_13_289,seq85,r_148_98_255,r_148_98_255,0.72,34,289,255,13
15,r_69_42_250,seq43,r_32_66_166,r_32_66_166,1.0,7,173,166,13
31,r_68_41_218,seq80,r_134_14_234,r_68_41_218,0.43,62,280,218,13
29,r_99_35_39,r_1_64_187,r_93_21_177,r_99_35_39,0.99,-1,38,39,13
39,r_60_111_247,r_28_84_151,r_110_125_13,r_60_111_247,0.91,-222,25,247,13
39,r_60_111_247,r_110_125_13,r_46_79_256,r_60_111_247,0.93,1,248,247,13
31,r_68_41_218,seq0,seq80,r_68_41_218,0.54,32,250,218,13
41,r_57_47_106,seq3,seq7,r_57_47_106,1.0,0,106,106,13
3,r_132_96_227,r_113_105_196,r_103_55_118,r_113_105_196,0.98,0,196,196,13
10,r_139_116_228,seq7,seq49,r_139_116_228,0.79,0,228,228,13
37,r_128_11_19,r_50_117_261,r_110_125_13,r_50_117_261,0.57,-242,19,261,13
4,r_103_55_118,r_46_79_256,r_132_96_227,r_46_79_256,0.53,-90,166,256,13
78,seq52,r_148_98_255,seq143,r_148_98_255,0.76,0,255,255,13
0,r_18_130_183,r_24_20_251,seq43,r_18_130_183,1.0,2,185,183,13
73,seq39,r_2_87_200,seq6,r_2_87_200,1.0,2,202,200,13
11,r_1_64_187,seq22,r_44_131_89,r_44_131_89,1.0,99,188,89,13
20,r_28_84_151,r_48_104_149,seq106,r_28_84_151,0.7,0,151,151,13
98,seq126,r_48_104_149,r_110_125_13,r_48_104_149,0.73,1,150,149,13
15,r_69_42_250,r_57_47_106,seq43,r_57_47_106,0.98,-51,55,106,13
48,r_24_20_251,r_18_130_183,r_48_104_149,r_24_20_251,0.89,-68,183,251,13
6,r_82_76_37,r_69_42_250,seq92,r_82_76_37,1.0,0,37,37,13
13,r_134_14_234,seq43,seq136,r_134_14_234,0.94,0,234,234,13
85,seq80,seq31,r_128_11_19,r_128_11_19,0.99,82,101,19,13
2,r_46_79_256,r_122_9_163,r_60_111_247,r_60_111_247,0.97,11,258,247,13
94,seq106,r_107_144_44,seq136,r_107_144_44,1.0,1,45,44,13
28,r_93_21_177,r_115_13_289,r_99_35_39,r_99_35_39,1.0,-1,38,39,13
13,r_134_14_234,r_82_76_37,seq43,r_82_76_37,1.0,-4,33,37,13
27,r_4_145_171,seq16,r_59_119_120,r_4_145_171,0.53,1,172,171,13
30,r_30_124_107,seq22,r_148_98_255,r_148_98_255,1.0,0,255,255,13
51,seq129,r_107_144_44,r_132_96_227,r_132_96_227,0.55,29,256,227,13
49,r_70_109_15,seq26,seq121,r_70_109_15,0.98,1,16,15,13
2,r_46_79_256,r_103_55_118,r_122_9_163,r_122_9_163,0.81,28,191,163,13
47,r_100_147_266,seq10,seq37,r_100_147_266,0.37,7,273,266,13
74,seq43,r_75_63_271,r_18_130_183,r_18_130_183,0.99,39,222,183,13
18,r_97_19_99,r_100_147_266,seq17,r_97_19_99,1.0,0,99,99,13
36,r_40_72_40,r_38_142_258,seq112,r_40_72_40,0.96,-6,34,40,13
34,r_122_9_163,r_46_79_256,seq95,r_46_79_256,0.79,2,258,256,13
35,r_44_131_89,seq78,r_1_64_187,r_1_64_187,0.99,1,188,187,13
25,r_12_65_112,seq92,seq0,r_12_65_112,0.87,4,116,112,13
48,r_24_20_251,r_48_104_149,seq95,r_24_20_251,0.98,1,252,251,13
85,seq80,r_128_11_19,r_93_21_177,r_93_21_177,1.0,-1,176,177,13
58,seq10,r_100_147_266,r_86_133_72,r_86_133_72,0.89,54,126,72,13
92,seq95,r_132_96_227,r_108_135_29,r_108_135_29,0.55,-4,25,29,13
32,r_48_104_149,r_60_111_247,seq16,r_48_104_149,1.0,1,150,149,13
38,r_62_118_206,seq121,r_93_21_177,r_62_118_206,0.53,0,206,206,13
34,r_122_9_163,seq140,r_46_79_256,r_122_9_163,0.67,-5,158,163,13
40,r_108_135_29,seq146,seq95,r_108_135_29,0.58,-4,25,29,13
9,r_61_54_70,r_59_119_120,seq31,r_61_54_70,1.0,0,70,70,13
17,r_110_125_13,r_58_149_140,r_60_111_247,r_110_125_13,0.99,0,13,13,13
15,r_69_42_250,r_32_66_166,r_107_144_44,r_69_42_250,0.97,0,250,250,13
28,r_93_21_177,r_99_35_39,seq80,r_93_21_177,0.82,0,177,177,13
29,r_99_35_39,r_93_21_177,seq85,r_93_21_177,1.0,-36,141,177,13
22,r_138_36_190,seq129,seq3,r_138_36_190,0.99,1,191,190,13
7,r_75_63_271,seq43,r_46_79_256,r_46_79_256,0.8,11,267,256,13
44,r_32_66_166,r_44_131_89,seq80,r_44_131_89,1.0,-15,74,89,13
23,r_86_133_72,r_115_13_289,r_91_67_5,r_86_133_72,1.0,-1,71,72,13
94,seq106,seq136,r_28_84_151,r_28_84_151,1.0,7,158,151,13
17,r_110_125_13,r_60_111_247,r_128_11_19,r_110_125_13,0.59,235,248,13,13
79,seq56,seq45,r_59_119_120,r_59_119_120,1.0,3,123,120,13
44,r_32_66_166,r_69_42_250,r_58_149_140,r_69_42_250,1.0,0,250,250,13
35,r_44_131_89,seq31,seq78,r_44_131_89,1.0,0,89,89,13
12,r_53_27_93,seq22,seq85,r_53_27_93,0.99,0,93,93,13
84,seq78,seq29,r_44_131_89,r_44_131_89,1.0,0,89,89,13
93,seq118,seq142,r_57_34_116,r_57_34_116,1.0,25,141,116,14
40,r_125_87_45,r_92_61_142,seq35,r_92_61_142,1.0,0,142,142,14
92,seq111,seq123,r_147_78_223,r_147_78_223,1.0,48,271,223,14
14,r_68_74_60,r_60_85_150,seq126,r_68_74_60,1.0,1,61,60,14
8,r_30_139_252,seq3,seq140,r_30_139_252,0.67,0,252,252,14
53,seq3,r_30_139_252,r_49_15_86,r_49_15_86,0.81,34,120,86,14
54,seq132,seq69,r_11_17_105,r_11_17_105,1.0,4,109,105,14
86,seq98,seq133,r_124_47_58,r_124_47_58,1.0,99,157,58,14
16,r_57_34_116,seq31,seq118,r_57_34_116,1.0,0,116,116,14
21,r_1_45_277,r_60_85_150,r_83_39_87,r_1_45_277,0.58,-125,152,277,14
39,r_97_117_125,r_112_50_129,r_49_15_86,r_97_117_125,0.98,0,125,125,14
1,r_99_108_173,seq35,seq134,r_99_108_173,0.85,0,173,173,14
38,r_37_22_48,seq0,r_77_52_20,r_37_22_48,1.0,0,48,48,14
5,r_101_33_71,seq140,seq35,r_101_33_71,1.0,0,71,71,14
46,r_114_86_72,r_138_7_253,seq31,r_114_86_72,0.9,0,72,72,14
45,r_124_47_58,r_42_9_134,seq98,r_124_47_58,0.96,0,58,58,14
80,seq67,r_138_7_253,seq29,r_138_7_253,0.98,-36,217,253,14
0,r_64_82_78,seq149,r_120_32_103,r_120_32_103,0.99,25,128,103,14
37,r_53_131_41,seq21,seq31,r_53_131_41,1.0,0,41,41,14
31,r_144_56_54,r_93_8_295,seq141,r_144_56_54,1.0,0,54,54,14
41,r_90_89_282,r_1_45_277,r_83_39_87,r_83_39_87,0.99,116,203,87,14
10,r_63_48_66,r_60_85_150,seq26,r_63_48_66,1.0,0,66,66,14
26,r_95_116_294,r_49_15_86,seq135,r_49_15_86,0.99,0,86,86,14
4,r_49_15_86,r_95_116_294,seq3,r_49_15_86,1.0,0,86,86,14
0,r_64_82_78,r_102_43_183,seq149,r_64_82_78,1.0,0,78,78,14
73,seq35,r_99_108_173,r_101_33_71,r_101_33_71,0.99,102,173,71,14
11,r_96_38_94,r_28_24_214,seq25,r_96_38_94,0.99,0,94,94,14
20,r_120_32_103,seq134,r_64_82_78,r_120_32_103,1.0,0,103,103,14
13,r_60_85_150,r_1_45_277,seq109,r_60_85_150,0.92,2,152,150,14
98,seq126,seq123,r_68_74_60,r_68_74_60,1.0,57,117,60,14
15,r_75_12_117,r_54_104_138,r_53_131_41,r_54_104_138,0.83,-21,117,138,14
48,r_51_73_170,r_1_45_277,seq69,r_51_73_170,1.0,0,170,170,14
57,seq135,seq106,r_95_116_294,r_95_116_294,0.58,-85,209,294,14
12,r_79_10_108,r_138_7_253,seq67,r_138_7_253,1.0,-19,234,253,14
6,r_147_78_223,seq130,seq111,r_147_78_223,0.73,0,223,223,14
21,r_1_45_277,r_83_39_87,seq141,r_83_39_87,0.85,191,278,87,14
74,seq134,seq118,r_99_108_173,r_99_108_173,1.0,2,175,173,14
10,r_63_48_66,seq26,r_13_66_137,r_13_66_137,1.0,15,152,137,14
27,r_65_91_107,r_57_34_116,seq84,r_57_34_116,0.6,-9,107,116,14
49,r_143_23_16,r_93_8_295,seq130,r_143_23_16,1.0,0,16,16,14
22,r_77_52_20,r_112_50_129,r_37_22_48,r_77_52_20,0.95,109,129,20,14
2,r_92_61_142,r_81_110_198,r_125_87_45,r_125_87_45,0.86,40,85,45,14
47,r_83_39_87,seq123,r_1_45_277,r_83_39_87,1.0,0,87,87,14
74,seq134,r_120_32_103,seq118,r_120_32_103,1.0,-1,102,103,14
18,r_46_19_267,r_80_18_288,r_13_66_137,r_13_66_137,1.0,130,267,137,14
29,r_102_43_183,r_93_8_295,r_90_89_282,r_93_8_295,0.44,-52,243,295,14
24,r_138_7_253,seq67,r_79_10_108,r_79_10_108,1.0,38,146,108,14
40,r_125_87_45,seq109,r_92_61_142,r_125_87_45,0.88,-5,40,45,14
25,r_28_24_214,seq41,seq44,r_28_24_214,0.55,0,214,214,14
47,r_83_39_87,r_1_45_277,r_96_38_94,r_83_39_87,0.75,191,278,87,14
32,r_80_18_288,r_46_19_267,r_99_108_173,r_99_108_173,1.0,112,285,173,14
57,seq135,r_95_116_294,seq106,r_95_116_294,0.91,-9,285,294,14
34,r_112_50_129,r_97_117_125,r_75_12_117,r_112_50_129,0.97,-2,127,129,14
22,r_77_52_20,r_93_8_295,r_112_50_129,r_77_52_20,1.0,-2,18,20,14
36,r_103_76_14,r_101_33_71,seq148,r_103_76_14,0.66,0,14,14,14
30,r_70_4_43,r_13_66_137,r_46_19_267,r_70_4_43,1.0,0,43,43,14
81,seq69,seq132,r_51_73_170,r_51_73_170,1.0,20,190,170,14
17,r_42_9_134,seq6,seq26,r_42_9_134,1.0,0,134,134,14
28,r_54_104_138,r_75_12_117,r_144_56_54,r_144_56_54,0.99,60,114,54,14
91,seq109,seq84,r_60_85_150,r_60_85_150,0.98,6,156,150,14
28,r_54_104_138,r_144_56_54,r_20_94_5,r_54_104_138,0.95,6,144,138,14
2,r_92_61_142,r_125_87_45,r_49_15_86,r_92_61_142,1.0,0,142,142,14
35,r_40_115_121,seq146,seq105,r_40_115_121,0.94,3,124,121,14
12,r_79_10_108,r_145_113_232,r_138_7_253,r_79_10_108,1.0,1,109,108,14
15,r_75_12_117,r_53_131_41,r_16_58_153,r_16_58_153,1.0,15,168,153,14
8,r_69_144_39,seq16,seq82,r_69_144_39,1.0,0,39,39,15
30,r_67_88_267,seq42,r_147_124_104,r_67_88_267,0.47,0,267,267,15
36,r_140_12_288,seq16,r_3_96_156,r_3_96_156,0.91,14,170,156,15
9,r_13_68_268,r_9_57_82,r_90_70_12,r_9_57_82,0.77,186,268,82,15
14,r_118_45_117,seq2,r_132_5_119,r_118_45_117,1.0,2,119,117,15
53,seq8,r_20_138_174,seq38,r_20_138_174,0.56,-1,173,174,15
43,r_19_15_147,r_17_1_78,seq95,r_17_1_78,1.0,-1,77,78,15
16,r_125_109_224,r_67_88_267,r_80_143_77,r_67_88_267,0.87,-41,226,267,15
21,r_71_146_237,r_13_68_268,r_97_129_150,r_71_146_237,0.53,0,237,237,15
39,r_130_72_160,seq134,seq42,r_130_72_160,0.94,-3,157,160,15
1,r_86_54_72,seq79,seq120,r_86_54_72,1.0,-1,71,72,15
46,r_136_26_98,r_13_68_268,seq121,r_136_26_98,1.0,0,98,98,15
42,r_92_123_79,seq134,seq16,r_92_123_79,1.0,0,79,79,15
7,r_77_116_71,r_13_68_268,r_18_91_221,r_77_116_71,0.37,142,213,71,15
45,r_113_137_139,r_117_127_76,r_7_111_6,r_113_137_139,0.55,-52,87,139,15
24,r_135_84_153,r_61_105_238,r_147_124_104,r_61_105_238,0.59,6,244,238,15
11,r_80_143_77,r_128_34_88,r_125_109_224,r_125_109_224,1.0,2,226,224,15
66,seq31,r_147_124_104,seq82,r_147_124_104,1.0,0,104,104,15
31,r_4_32_123,seq139,r_9_57_82,r_4_32_123,1.0,0,123,123,15
41,r_64_63_169,seq11,seq95,r_64_63_169,0.98,0,169,169,15
3,r_49_33_140,r_99_94_282,seq95,r_49_33_140,1.0,0,140,140,15
90,seq104,r_99_94_282,r_61_105_238,r_61_105_238,0.84,44,282,238,15
26,r_131_66_250,r_7_111_6,r_97_129_150,r_97_129_150,1.0,4,154,150,15
4,r_48_53_66,r_97_129_150,r_22_46_222,r_48_53_66,1.0,0,66,66,15
0,r_27_6_226,seq41,r_101_149_184,r_27_6_226,0.48,0,226,226,15
11,r_80_143_77,r_40_73_178,r_128_34_88,r_80_143_77,1.0,10,87,77,15
20,r_61_105_238,r_44_55_97,r_87_28_231,r_44_55_97,0.86,2,99,97,15
13,r_3_96_156,seq106,r_140_12_288,r_3_96_156,0.59,-1,155,156,15
15,r_132_5_119,seq120,r_118_45_117,r_132_5_119,1.0,0,119,119,15
48,r_145_93_145,r_22_46_222,seq21,r_145_93_145,0.88,0,145,145,15
4,r_48_53_66,r_22_46_222,r_20_138_174,r_48_53_66,0.84,156,222,66,15
57,seq14,seq95,r_19_15_147,r_19_15_147,0.38,-2,145,147,15
81,seq76,seq23,r_99_94_282,r_99_94_282,0.54,0,282,282,15
6,r_22_46_222,r_145_93_145,r_48_53_66,r_48_53_66,0.59,79,145,66,15
10,r_78_100_5,r_22_46_222,r_101_149_184,r_78_100_5,0.99,202,207,5,15
27,r_44_55_97,r_61_105_238,seq14,r_44_55_97,1.0,1,98,97,15
87,seq95,r_19_15_147,r_49_33_140,r_49_33_140,1.0,5,145,140,15
79,seq139,r_126_59_271,seq106,r_126_59_271,0.69,0,271,271,15
91,seq106,r_3_96_156,r_40_73_178,r_40_73_178,1.0,4,182,178,15
47,r_98_0_1,r_20_138_174,r_65_114_129,r_65_114_129,1.0,46,175,129,15
18,r_65_114_129,r_62_107_294,r_98_0_1,r_65_114_129,1.0,2,131,129,15
29,r_97_129_150,seq21,r_131_66_250,r_97_129_150,1.0,0,150,150,15
24,r_135_84_153,seq120,r_61_105_238,r_135_84_153,0.78,0,153,153,15
35,r_9_57_82,r_13_68_268,r_4_32_123,r_4_32_123,1.0,145,268,123,15
25,r_101_149_184,r_87_28_231,r_78_100_5,r_101_149_184,0.97,0,184,184,15
50,seq2,r_118_45_117,seq30,r_118_45_117,1.0,-1,116,117,15
58,seq16,r_140_12_288,r_92_123_79,r_92_123_79,1.0,66,145,79,15
6,r_22_46_222,r_48_53_66,seq148,r_22_46_222,0.98,0,222,222,15
61,seq23,seq103,r_60_50_155,r_60_50_155,0.43,1,156,155,15
32,r_147_124_104,seq31,seq75,r_147_124_104,1.0,0,104,104,15
20,r_61_105_238,r_135_84_153,seq104,r_61_105_238,1.0,0,238,238,15
60,seq21,r_97_129_150,seq36,r_97_129_150,0.99,0,150,150,15
17,r_17_1_78,r_19_15_147,seq133,r_17_1_78,1.0,0,78,78,15
9,r_13_68_268,r_136_26_98,r_9_57_82,r_13_68_268,1.0,-170,98,268,15
26,r_131_66_250,r_97_129_150,seq41,r_131_66_250,0.74,0,250,250,15
96,seq119,seq14,r_113_137_139,r_113_137_139,1.0,7,146,139,15
29,r_97_129_150,r_131_66_250,r_7_111_6,r_131_66_250,0.96,0,250,250,15
22,r_40_73_178,seq108,seq106,r_40_73_178,1.0,0,178,178,15
34,r_90_70_12,seq76,seq42,r_90_70_12,0.93,0,12,12,15
28,r_128_34_88,r_118_45_117,r_80_143_77,r_128_34_88,1.0,0,88,88,15
91,seq106,r_77_116_71,r_3_96_156,r_77_116_71,1.0,-4,67,71,15
20,r_61_105_238,r_87_28_231,r_135_84_153,r_135_84_153,0.99,0,153,153,15
49,r_74_43_278,seq47,r_65_114_129,r_65_114_129,0.86,155,284,129,15
7,r_77_116_71,seq106,r_13_68_268,r_77_116_71,1.0,0,71,71,15
44,r_117_127_76,r_113_137_139,seq141,r_113_137_139,0.83,-52,87,139,15
23,r_20_138_174,r_98_0_1,r_90_70_12,r_90_70_12,0.84,163,175,12,15
45,r_113_137_139,r_7_111_6,seq119,r_113_137_139,1.0,0,139,139,15
79,seq139,r_4_32_123,r_126_59_271,r_4_32_123,1.0,-1,122,123,15
35,r_9_57_82,seq82,r_13_68_268,r_9_57_82,1.0,0,82,82,15
12,r_87_28_231,seq30,r_92_123_79,r_87_28_231,0.58,2,233,231,15
30,r_71_144_99,r_74_45_149,seq143,r_71_144_99,0.99,-1,98,99,16
44,r_117_50_54,r_103_118_261,r_83_46_205,r_83_46_205,0.76,69,274,205,16
51,seq2,r_26_87_47,r_59_93_62,r_59_93_62,1.0,52,114,62,16
36,r_100_28_71,seq104,seq86,r_100_28_71,0.95,-1,70,71,16
92,seq112,r_0_102_236,r_135_51_280,r_0_102_236,0.99,0,236,236,16
14,r_82_106_190,r_0_102_236,seq3,r_82_106_190,0.88,1,191,190,16
8,r_69_94_207,r_97_23_170,r_99_68_173,r_97_23_170,0.98,1,171,170,16
43,r_83_46_205,seq107,r_103_118_261,r_83_46_205,0.62,3,208,205,16
54,seq6,r_145_110_150,r_69_94_207,r_145_110_150,1.0,0,150,150,16
83,seq73,r_139_56_260,r_54_29_93,r_54_29_93,1.0,-1,92,93,16
55,seq7,r_44_127_268,r_0_102_236,r_0_102_236,0.68,32,268,236,16
16,r_74_45_149,seq9,seq64,r_74_45_149,0.89,0,149,149,16
5,r_135_51_280,seq112,r_145_110_150,r_145_110_150,0.86,131,281,150,16
42,r_18_77_223,seq141,r_59_93_62,r_59_93_62,0.98,161,223,62,16
54,seq6,r_69_94_207,r_67_91_48,r_69_94_207,1.0,-2,205,207,16
32,r_128_5_199,r_111_131_86,r_146_113_17,r_128_5_199,1.0,1,200,199,16
45,r_80_70_160,seq133,seq112,r_80_70_160,1.0,3,163,160,16
11,r_111_131_86,r_128_5_199,r_20_92_117,r_111_131_86,0.98,114,200,86,16
27,r_84_43_293,r_100_28_71,r_85_34_155,r_85_34_155,1.0,6,161,155,16
31,r_59_93_62,r_108_75_255,seq2,r_59_93_62,1.0,0,62,62,16
41,r_103_118_261,r_55_41_239,r_83_46_205,r_103_118_261,0.52,-53,208,261,16
10,r_146_113_17,r_49_62_189,r_12_140_12,r_146_113_17,0.9,0,17,17,16
67,seq36,seq38,r_97_23_170,r_97_23_170,1.0,2,172,170,16
3,r_88_121_139,seq142,r_76_35_35,r_88_121_139,0.87,0,139,139,16
90,seq105,r_99_68_173,r_67_91_48,r_67_91_48,1.0,151,199,48,16
4,r_49_62_189,seq141,seq129,r_49_62_189,0.95,0,189,189,16
0,r_4_27_224,seq52,seq64,r_4_27_224,0.91,0,224,224,16
11,r_111_131_86,seq129,r_128_5_199,r_111_131_86,0.8,0,86,86,16
20,r_97_23_170,r_69_94_207,seq36,r_97_23_170,0.85,1,171,170,16
13,r_0_102_236,seq112,seq52,r_0_102_236,0.75,0,236,236,16
98,seq124,r_15_58_61,seq129,r_15_58_61,1.0,0,61,61,16
15,r_145_110_150,seq6,seq124,r_145_110_150,1.0,0,150,150,16
49,r_108_75_255,r_101_19_82,seq42,r_108_75_255,0.91,0,255,255,16
6,r_15_58_61,seq124,seq64,r_15_58_61,0.75,0,61,61,16
62,seq16,seq13,r_24_95_66,r_24_95_66,1.0,19,85,66,16
2,r_101_19_82,r_108_75_255,r_10_125_185,r_10_125_185,0.5,27,212,185,16
52,seq3,seq89,r_82_106_190,r_82_106_190,0.95,18,208,190,16
41,r_103_118_261,r_83_46_205,r_111_131_86,r_103_118_261,0.88,0,261,261,16
57,seq9,r_109_78_21,r_39_30_172,r_39_30_172,0.87,8,180,172,16
27,r_84_43_293,r_128_5_199,r_100_28_71,r_100_28_71,0.96,15,86,71,16
43,r_83_46_205,r_103_118_261,r_117_50_54,r_103_118_261,0.84,6,267,261,16
2,r_101_19_82,r_61_40_281,r_108_75_255,r_101_19_82,1.0,1,83,82,16
47,r_20_92_117,r_108_75_255,seq120,r_20_92_117,1.0,0,117,117,16
40,r_137_14_169,r_69_94_207,seq126,r_137_14_169,0.97,0,169,169,16
18,r_44_127_268,seq7,r_24_95_66,r_44_127_268,0.75,0,268,268,16
29,r_32_81_227,r_0_102_236,r_100_28_71,r_32_81_227,0.88,0,227,227,16
24,r_138_17_263,seq42,r_59_93_62,r_59_93_62,1.0,201,263,62,16
34,r_76_35_35,seq126,r_88_121_139,r_88_121_139,1.0,68,207,139,16
25,r_33_132_120,seq38,r_146_113_17,r_146_113_17,1.0,117,134,17,16
33,r_147_31_153,r_0_102_236,r_111_131_86,r_147_31_153,0.82,1,154,153,16
64,seq149,r_139_56_260,seq73,r_139_56_260,0.82,-16,244,260,16
58,seq11,seq8,r_71_144_99,r_71_144_99,1.0,32,131,99,16
70,seq42,r_138_17_263,r_108_75_255,r_108_75_255,0.61,8,263,255,16
44,r_117_50_54,r_80_70_160,r_103_118_261,r_117_50_54,0.94,1,55,54,16
32,r_128_5_199,seq126,r_111_131_86,r_111_131_86,0.99,44,130,86,16
38,r_139_56_260,seq149,seq136,r_139_56_260,0.42,1,261,260,16
52,seq3,r_24_95_66,seq89,r_24_95_66,1.0,5,71,66,16
8,r_69_94_207,r_99_68_173,r_37_66_127,r_69_94_207,0.99,0,207,207,16
17,r_54_29_93,r_10_125_185,seq73,r_54_29_93,1.0,-1,92,93,16
1,r_109_78_21,r_99_68_173,seq142,r_109_78_21,0.98,0,21,21,16
9,r_85_34_155,seq129,r_84_43_293,r_85_34_155,0.8,2,157,155,16
96,seq120,r_61_40_281,r_111_131_86,r_111_131_86,0.97,195,281,86,16
22,r_37_66_127,r_49_62_189,seq107,r_37_66_127,0.98,0,127,127,16
28,r_39_30_172,r_4_27_224,seq9,r_39_30_172,0.99,0,172,172,16
49,r_108_75_255,r_20_92_117,r_101_19_82,r_108_75_255,1.0,-170,85,255,16
34,r_76_35_35,seq52,seq126,r_76_35_35,1.0,0,35,35,16
7,r_24_95_66,seq3,seq16,r_24_95_66,1.0,0,66,66,16
39,r_67_91_48,r_24_95_66,seq141,r_67_91_48,1.0,0,48,48,16
35,r_99_68_173,seq105,seq63,r_99_68_173,0.23,8,181,173,16
12,r_119_123_83,r_18_77_223,seq107,r_119_123_83,1.0,0,83,83,16
23,r_79_134_39,r_138_17_263,seq107,r_79_134_39,0.98,0,39,39,16
30,r_147_42_147,r_33_34_289,r_0_32_32,r_0_32_32,0.98,117,149,32,17
26,r_6_123_44,r_109_40_108,r_22_64_257,r_6_123_44,0.93,2,46,44,17
14,r_80_103_216,seq93,r_108_110_54,r_80_103_216,0.99,2,218,216,17
43,r_62_96_262,seq59,r_146_53_124,r_146_53_124,0.69,138,262,124,17
18,r_0_32_32,seq66,seq112,r_0_32_32,1.0,0,32,32,17
21,r_77_148_122,seq31,r_74_44_90,r_74_44_90,0.65,32,122,90,17
39,r_27_60_175,r_88_115_183,seq2,r_27_60_175,0.9,8,183,175,17
1,r_37_14_285,r_22_64_257,r_55_104_227,r_55_104_227,0.64,30,257,227,17
5,r_58_120_79,r_51_118_291,seq52,r_58_120_79,0.97,-1,78,79,17
42,r_3_21_99,seq116,seq26,r_3_21_99,0.79,0,99,99,17
2,r_35_48_43,seq16,r_100_68_73,r_100_68_73,1.0,24,97,73,17
21,r_77_148_122,r_74_44_90,seq66,r_74_44_90,0.54,74,164,90,17
28,r_89_132_176,r_5_114_258,seq10,r_5_114_258,0.97,-33,225,258,17
76,seq66,r_0_32_32,r_23_84_293,r_0_32_32,0.83,-8,24,32,17
45,r_145_70_133,seq2,seq59,r_145_70_133,0.53,2,135,133,17
19,r_49_119_272,r_139_99_125,r_134_41_264,r_134_41_264,0.6,9,273,264,17
29,r_105_128_30,r_125_63_39,seq135,r_105_128_30,1.0,0,30,30,17
66,seq30,r_55_104_227,r_142_1_101,r_142_1_101,0.99,126,227,101,17
37,r_127_113_28,r_80_103_216,seq126,r_127_113_28,1.0,1,29,28,17
31,r_133_140_113,seq12,r_33_34_289,r_133_140_113,0.61,0,113,113,17
41,r_33_34_289,r_147_42_147,r_133_140_113,r_133_140_113,1.0,36,149,113,17
7,r_86_136_33,r_149_25_1,seq12,r_86_136_33,0.49,1,34,33,17
17,r_125_63_39,r_6_123_44,r_86_136_33,r_6_123_44,0.66,-4,40,44,17
10,r_72_50_91,seq12,seq82,r_72_50_91,0.98,-1,90,91,17
72,seq52,seq10,r_58_120_79,r_58_120_79,1.0,53,132,79,17
0,r_55_104_227,seq130,r_6_123_44,r_55_104_227,0.72,0,227,227,17
11,r_138_102_69,seq97,seq66,r_138_102_69,1.0,0,69,69,17
2,r_35_48_43,seq131,seq16,r_35_48_43,0.76,0,43,43,17
20,r_94_137_235,r_91_81_269,r_145_70_133,r_145_70_133,0.86,102,235,133,17
15,r_74_44_90,seq73,r_139_99_125,r_74_44_90,0.97,1,91,90,17
48,r_22_64_257,r_37_14_285,r_35_48_43,r_37_14_285,0.64,-28,257,285,17
6,r_57_101_136,r_54_39_168,seq29,r_57_101_136,0.95,2,138,136,17
99,seq126,r_55_104_227,r_142_1_101,r_142_1_101,1.0,54,155,101,17
82,seq135,seq29,r_105_128_30,r_105_128_30,1.0,17,47,30,17
36,r_5_114_258,r_89_132_176,r_24_56_18,r_5_114_258,0.85,0,258,258,17
27,r_109_40_108,seq52,seq46,r_109_40_108,1.0,-1,107,108,17
47,r_98_144_178,r_37_14_285,r_0_32_32,r_98_144_178,0.73,0,178,178,17
40,r_142_1_101,seq61,seq126,r_142_1_101,1.0,0,101,101,17
4,r_24_56_18,r_57_101_136,seq130,r_24_56_18,0.7,0,18,18,17
24,r_91_81_269,r_94_137_235,seq29,r_91_81_269,0.65,-34,235,269,17
25,r_83_8_112,seq117,seq93,r_83_8_112,1.0,0,112,112,17
33,r_146_53_124,r_149_25_1,seq28,r_146_53_124,1.0,1,125,124,17
88,seq93,r_80_103_216,r_83_8_112,r_83_8_112,0.69,106,218,112,17
1,r_37_14_285,r_55_104_227,seq13,r_37_14_285,0.89,0,285,285,17
32,r_87_47_89,r_57_101_136,seq76,r_87_47_89,1.0,0,89,89,17
38,r_54_39_168,r_57_101_136,seq143,r_57_101_136,0.83,-8,128,136,17
38,r_54_39_168,seq143,seq43,r_54_39_168,0.98,0,168,168,17
24,r_91_81_269,seq29,r_125_63_39,r_91_81_269,0.69,0,269,269,17
9,r_100_68_73,r_37_14_285,r_35_48_43,r_100_68_73,0.99,0,73,73,17
26,r_6_123_44,r_22_64_257,r_55_104_227,r_55_104_227,0.45,30,257,227,17
96,seq117,r_83_8_112,seq67,r_83_8_112,1.0,0,112,112,17
46,r_108_110_54,r_33_34_289,seq97,r_108_110_54,1.0,0,54,54,17
49,r_122_129_70,r_109_40_108,r_79_45_17,r_122_129_70,0.82,0,70,70,17
18,r_0_32_32,seq112,r_147_42_147,r_147_42_147,0.79,2,149,147,17
44,r_139_99_125,r_23_84_293,r_74_44_90,r_74_44_90,1.0,129,219,90,17
23,r_88_115_183,seq116,r_125_63_39,r_125_63_39,0.78,144,183,39,17
76,seq66,r_23_84_293,r_138_102_69,r_138_102_69,1.0,0,69,69,17
51,seq6,r_4_140_248,r_123_101_183,r_4_140_248,0.61,0,248,248,18
36,r_116_89_65,r_15_1_297,seq79,r_116_89_65,0.98,5,70,65,18
92,seq107,r_132_32_238,r_133_105_98,r_133_105_98,0.98,140,238,98,18
8,r_97_59_73,r_91_93_90,seq8,r_97_59_73,1.0,0,73,73,18
89,seq92,seq39,r_84_131_202,r_84_131_202,1.0,2,204,202,18
14,r_30_106_207,r_137_146_226,r_96_68_6,r_96_68_6,0.88,39,45,6,18
86,seq86,r_37_38_113,r_129_63_256,r_129_63_256,1.0,0,256,256,18
3,r_80_100_37,r_44_73_193,r_40_26_55,r_80_100_37,0.69,156,193,37,18
71,seq50,r_19_136_270,r_145_5_60,r_145_5_60,0.98,211,271,60,18
86,seq86,r_46_99_196,r_37_38_113,r_37_38_113,1.0,83,196,113,18
16,r_0_139_116,r_57_98_94,r_46_99_196,r_57_98_94,0.48,0,94,94,18
21,r_91_93_90,seq25,r_116_89_65,r_91_93_90,0.65,1,91,90,18
97,seq113,r_129_63_256,r_70_69_44,r_70_69_44,1.0,204,248,44,18
80,seq74,seq112,r_130_3_210,r_130_3_210,0.93,1,211,210,18
5,r_13_144_262,seq55,r_96_68_6,r_13_144_262,0.6,1,263,262,18
42,r_84_131_202,seq108,seq92,r_84_131_202,0.63,0,202,202,18
27,r_28_18_24,r_133_105_98,r_148_45_236,r_28_18_24,0.83,0,24,24,18
35,r_58_71_58,r_97_59_73,r_28_18_24,r_58_71_58,0.99,1,59,58,18
45,r_21_134_109,seq112,seq17,r_21_134_109,1.0,0,109,109,18
11,r_96_68_6,r_30_106_207,seq20,r_30_106_207,0.98,-5,202,207,18
27,r_28_18_24,r_148_45_236,r_58_71_58,r_28_18_24,0.76,213,237,24,18
16,r_0_139_116,r_46_99_196,seq142,r_0_139_116,0.95,-3,113,116,18
38,r_95_65_41,r_80_100_37,seq92,r_80_100_37,0.7,71,108,37,18
15,r_34_118_28,r_124_75_64,r_33_27_254,r_34_118_28,0.68,2,30,28,18
31,r_133_105_98,seq72,seq107,r_133_105_98,1.0,0,98,98,18
89,seq92,r_7_52_161,seq39,r_7_52_161,0.96,0,161,161,18
10,r_121_103_172,r_148_45_236,r_33_27_254,r_121_103_172,0.97,0,172,172,18
26,r_37_38_113,seq87,seq50,r_37_38_113,1.0,0,113,113,18
14,r_30_106_207,r_96_68_6,seq36,r_30_106_207,0.99,2,209,207,18
0,r_119_56_251,seq142,r_120_114_140,r_120_114_140,1.0,113,253,140,18
20,r_120_114_140,r_119_56_251,seq10,r_120_114_140,0.97,6,146,140,18
46,r_44_73_193,r_80_100_37,seq36,r_44_73_193,0.87,0,193,193,18
48,r_141_147_12,seq72,r_85_14_154,r_85_14_154,1.0,2,156,154,18
57,seq142,r_15_1_297,r_0_139_116,r_0_139_116,1.0,164,280,116,18
13,r_70_69_44,r_129_63_256,seq113,r_129_63_256,1.0,-8,248,256,18
99,seq122,r_111_47_267,r_40_26_55,r_40_26_55,1.0,48,103,55,18
46,r_44_73_193,r_24_53_263,r_80_100_37,r_80_100_37,1.0,2,39,37,18
36,r_116_89_65,seq79,r_91_93_90,r_91_93_90,0.74,81,171,90,18
10,r_121_103_172,r_33_27_254,r_24_53_263,r_24_53_263,0.98,0,263,263,18
2,r_49_104_96,seq11,r_124_75_64,r_49_104_96,0.98,2,98,96,18
41,r_88_62_163,r_130_3_210,r_116_89_65,r_116_89_65,0.82,97,162,65,18
39,r_127_66_51,r_23_90_296,r_34_118_28,r_127_66_51,0.99,7,58,51,18
15,r_34_118_28,r_33_27_254,r_127_66_51,r_127_66_51,1.0,2,53,51,18
18,r_85_14_154,seq79,r_141_147_12,r_85_14_154,0.9,0,154,154,18
24,r_145_5_60,seq6,seq50,r_145_5_60,0.94,1,61,60,18
25,r_137_146_226,seq108,seq41,r_137_146_226,0.61,-22,204,226,18
33,r_130_3_210,seq138,seq74,r_130_3_210,0.57,1,211,210,18
88,seq143,r_24_53_263,seq117,r_24_53_263,1.0,0,263,263,18
50,seq2,r_128_42_168,seq31,r_128_42_168,1.0,0,168,168,18
44,r_40_26_55,r_88_62_163,seq122,r_40_26_55,1.0,0,55,55,18
38,r_95_65_41,seq92,r_128_42_168,r_128_42_168,0.99,2,170,168,18
32,r_132_32_238,seq107,r_95_65_41,r_132_32_238,0.68,0,238,238,18
52,seq135,seq11,r_81_83_176,r_81_83_176,0.73,-3,173,176,18
34,r_4_140_248,seq6,r_22_126_33,r_4_140_248,0.54,0,248,248,18
13,r_70_69_44,r_49_104_96,r_129_63_256,r_70_69_44,1.0,0,44,44,18
17,r_148_45_236,r_121_103_172,r_28_18_24,r_121_103_172,0.84,-38,134,172,18
96,seq112,r_21_134_109,seq31,r_21_134_109,1.0,1,110,109,18
22,r_46_99_196,seq86,seq64,r_46_99_196,1.0,0,196,196,18
28,r_81_83_176,seq36,seq135,r_81_83_176,0.86,-10,166,176,18
50,seq2,seq31,r_130_3_210,r_130_3_210,0.72,12,222,210,18
49,r_9_115_170,seq92,seq142,r_9_115_170,0.96,0,170,170,18
43,r_22_126_33,r_23_90_296,seq87,r_22_126_33,1.0,0,33,33,18
7,r_129_63_256,seq113,seq86,r_129_63_256,0.59,0,256,256,18
23,r_124_75_64,seq74,r_88_62_163,r_124_75_64,0.96,0,64,64,18
17,r_148_45_236,r_28_18_24,seq25,r_148_45_236,0.64,1,237,236,18
41,r_88_62_163,r_40_26_55,r_130_3_210,r_40_26_55,1.0,0,55,55,18
38,r_95_65_41,r_119_56_251,r_80_100_37,r_95_65_41,0.92,0,41,41,18
3,r_80_100_37,seq8,r_44_73_193,r_80_100_37,0.97,0,37,37,18
23,r_124_75_64,r_88_62_163,r_49_104_96,r_124_75_64,1.0,83,147,64,18
9,r_92_4_25,r_134_135_262,r_55_41_242,r_55_41_242,0.61,20,262,242,19
16,r_71_111_27,r_10_76_158,seq51,r_71_111_27,1.0,0,27,27,19
8,r_119_35_244,seq0,r_128_66_119,r_128_66_119,0.77,125,244,119,19
53,seq132,r_72_54_138,seq7,r_72_54_138,1.0,0,138,138,19
4,r_9_64_26,r_17_110_115,seq137,r_9_64_26,0.91,0,26,26,19
83,seq83,r_45_68_281,r_53_99_84,r_53_99_84,1.0,104,188,84,19
37,r_18_46_236,r_45_68_281,r_53_99_84,r_53_99_84,1.0,72,156,84,19
19,r_53_99_84,r_18_46_236,r_120_114_176,r_53_99_84,0.86,152,236,84,19
30,r_28_13_98,r_10_76_158,r_81_117_279,r_81_117_279,0.41,-267,12,279,19
46,r_81_117_279,seq93,r_44_108_95,r_81_117_279,0.33,0,279,279,19
42,r_32_100_207,seq26,r_52_77_82,r_32_100_207,0.89,1,208,207,19
80,seq75,r_61_47_131,seq7,r_61_47_131,1.0,0,131,131,19
25,r_29_126_36,r_60_43_72,seq0,r_29_126_36,1.0,1,37,36,19
32,r_128_66_119,r_143_123_238,r_119_35_244,r_128_66_119,0.89,119,238,119,19
19,r_53_99_84,r_81_117_279,r_18_46_236,r_53_99_84,0.96,1,85,84,19
31,r_50_133_87,r_81_117_279,r_29_126_36,r_50_133_87,0.87,1,88,87,19
67,seq26,r_32_100_207,seq36,r_32_100_207,0.99,1,208,207,19
3,r_60_43_72,r_29_126_36,r_109_34_298,r_60_43_72,1.0,-2,70,72,19
26,r_57_30_112,r_72_54_138,seq27,r_57_30_112,0.95,0,112,112,19
9,r_92_4_25,r_87_37_188,r_134_135_262,r_92_4_25,1.0,0,25,25,19
78,seq129,r_55_41_242,r_8_148_152,r_55_41_242,0.64,2,244,242,19
73,seq42,seq98,r_78_31_90,r_78_31_90,1.0,39,129,90,19
11,r_106_58_93,seq138,seq105,r_106_58_93,1.0,2,95,93,19
6,r_5_22_128,r_120_114_176,r_72_54_138,r_5_22_128,0.87,12,140,128,19
20,r_143_123_238,seq42,r_128_66_119,r_128_66_119,1.0,3,122,119,19
13,r_16_149_223,seq80,seq96,r_16_149_223,0.65,3,226,223,19
98,seq125,r_109_34_298,r_48_2_124,r_48_2_124,1.0,33,157,124,19
15,r_21_63_88,seq88,r_45_68_281,r_21_63_88,1.0,0,88,88,19
48,r_134_135_262,r_109_34_298,r_92_4_25,r_92_4_25,0.93,36,61,25,19
32,r_128_66_119,r_38_147_57,r_143_123_238,r_128_66_119,1.0,0,119,119,19
57,seq138,seq39,r_17_110_115,r_17_110_115,1.0,121,236,115,19
6,r_5_22_128,r_81_117_279,r_120_114_176,r_5_22_128,0.47,0,128,128,19
86,seq88,r_28_13_98,r_62_24_233,r_62_24_233,0.81,35,268,233,19
99,seq127,r_45_68_281,r_44_108_95,r_44_108_95,1.0,85,180,95,19
52,seq3,r_102_85_53,r_62_24_233,r_62_24_233,0.9,3,236,233,19
27,r_118_12_280,seq138,r_60_43_72,r_60_43_72,0.93,208,280,72,19
30,r_28_13_98,r_81_117_279,r_103_89_42,r_28_13_98,1.0,1,99,98,19
39,r_67_95_41,seq7,seq70,r_67_95_41,1.0,0,41,41,19
2,r_130_79_99,seq26,seq90,r_130_79_99,1.0,0,99,99,19
41,r_38_147_57,r_128_66_119,r_45_68_281,r_128_66_119,1.0,0,119,119,19
47,r_45_68_281,r_18_46_236,r_21_63_88,r_21_63_88,1.0,58,146,88,19
14,r_102_85_53,seq59,seq3,r_102_85_53,1.0,4,57,53,19
40,r_17_110_115,seq145,seq138,r_17_110_115,1.0,0,115,115,19
18,r_44_108_95,r_55_41_242,seq127,r_44_108_95,0.85,1,96,95,19
24,r_72_54_138,seq132,r_5_22_128,r_72_54_138,0.98,0,138,138,19
10,r_91_101_37,r_49_86_122,seq15,r_91_101_37,1.0,-1,36,37,19
33,r_49_86_122,seq97,seq36,r_49_86_122,0.99,0,122,122,19
48,r_134_135_262,r_92_4_25,r_102_85_53,r_92_4_25,0.57,237,262,25,19
88,seq93,r_81_117_279,r_9_64_26,r_9_64_26,0.99,254,280,26,19
20,r_143_123_238,r_128_66_119,r_6_144_33,r_143_123_238,0.99,0,238,238,19
68,seq27,r_52_77_82,seq14,r_52_77_82,1.0,0,82,82,19
61,seq15,r_10_76_158,r_121_146_70,r_121_146_70,1.0,8,78,70,19
32,r_128_66_119,seq127,r_38_147_57,r_38_147_57,1.0,9,66,57,19
38,r_52_77_82,seq27,seq1,r_52_77_82,1.0,0,82,82,19
52,seq3,r_134_135_262,r_102_85_53,r_102_85_53,0.96,8,61,53,19
34,r_55_41_242,seq129,r_92_4_25,r_92_4_25,0.84,219,244,25,19
81,seq80,r_16_149_223,r_94_112_22,r_16_149_223,0.98,3,226,223,19
17,r_62_24_233,seq0,seq3,r_62_24_233,0.82,0,233,233,19
26,r_57_30_112,seq27,r_10_76_158,r_57_30_112,0.54,66,178,112,19
37,r_18_46_236,r_53_99_84,r_17_110_115,r_18_46_236,0.99,0,236,236,19
22,r_78_31_90,seq39,r_67_95_41,r_78_31_90,1.0,1,91,90,19
28,r_61_47_131,seq75,seq129,r_61_47_131,1.0,0,131,131,19
49,r_11_19_34,seq51,seq70,r_11_19_34,0.96,2,36,34,19
43,r_6_144_33,r_53_99_84,seq140,r_6_144_33,0.85,0,33,33,19
7,r_10_76_158,seq96,r_57_30_112,r_57_30_112,1.0,66,178,112,19
44,r_121_146_70,r_18_46_236,seq15,r_121_146_70,1.0,0,70,70,19
21,r_103_89_42,r_61_47_131,seq140,r_103_89_42,1.0,0,42,42,19
23,r_109_34_298,r_134_135_262,r_60_43_72,r_60_43_72,1.0,1,73,72,19
41,r_38_147_57,r_81_117_279,r_128_66_119,r_38_147_57,1.0,0,57,57,19
35,r_56_124_155,seq131,r_9_64_26,r_56_124_155,0.99,1,156,155,19
12,r_48_2_124,seq14,seq125,r_48_2_124,1.0,0,124,124,19
9,r_30_68_215,r_86_10_10,seq102,r_30_68_215,0.9,0,215,215,20
6,r_147_39_46,r_100_89_256,r_116_90_36,r_147_39_46,1.0,0,46,46,20
14,r_104_45_173,seq1,r_80_20_136,r_80_20_136,0.98,4,140,136,20
97,seq120,r_46_65_187,r_58_141_217,r_46_65_187,0.96,0,187,187,20
27,r_49_79_12,seq146,seq72,r_49_79_12,1.0,0,12,12,20
83,seq70,r_41_40_257,r_8_64_67,r_8_64_67,1.0,11,78,67,20
3,r_67_129_165,seq142,r_66_105_198,r_66_105_198,1.0,50,248,198,20
55,seq136,r_85_0_196,r_88_3_171,r_88_3_171,0.65,25,196,171,20
16,r_35_109_98,r_30_68_215,r_38_32_143,r_35_109_98,0.86,7,105,98,20
21,r_34_48_192,seq70,r_36_130_132,r_36_130_132,1.0,65,197,132,20
39,r_112_15_119,r_11_92_230,seq9,r_112_15_119,0.99,0,119,119,20
5,r_98_5_164,r_46_65_187,seq146,r_98_5_164,1.0,0,164,164,20
46,r_111_57_77,seq13,seq2,r_111_57_77,1.0,0,77,77,20
42,r_52_101_101,seq93,seq136,r_52_101_101,1.0,0,101,101,20
45,r_54_28_148,r_106_140_205,r_82_83_93,r_106_140_205,1.0,-58,147,205,20
2,r_8_64_67,seq27,r_117_131_49,r_117_131_49,0.98,1,50,49,20
19,r_82_83_93,r_11_92_230,r_54_28_148,r_11_92_230,1.0,-82,148,230,20
66,seq21,seq60,r_49_79_12,r_49_79_12,0.89,155,167,12,20
10,r_78_7_156,r_112_15_119,seq145,r_78_7_156,0.74,0,156,156,20
76,seq50,seq71,r_149_81_97,r_149_81_97,1.0,17,114,97,20
97,seq120,r_112_15_119,r_46_65_187,r_112_15_119,1.0,58,177,119,20
31,r_56_135_282,r_111_57_77,seq93,r_111_57_77,1.0,-1,76,77,20
41,r_80_20_136,seq60,r_104_45_173,r_80_20_136,0.97,0,136,136,20
89,seq93,r_52_101_101,seq142,r_52_101_101,1.0,0,101,101,20
3,r_67_129_165,seq139,seq142,r_67_129_165,0.98,1,166,165,20
10,r_78_7_156,r_24_99_141,r_112_15_119,r_112_15_119,0.53,22,141,119,20
14,r_104_45_173,r_80_20_136,r_49_79_12,r_104_45_173,1.0,0,173,173,20
26,r_46_65_187,seq2,seq138,r_46_65_187,0.97,0,187,187,20
34,r_106_140_205,r_122_76_270,seq9,r_122_76_270,1.0,-1,269,270,20
35,r_117_131_49,seq13,seq19,r_117_131_49,1.0,4,53,49,20
4,r_100_89_256,r_127_18_127,r_80_20_136,r_100_89_256,1.0,-124,132,256,20
78,seq55,r_97_95_144,r_38_32_143,r_97_95_144,0.99,2,146,144,20
11,r_127_18_127,r_100_89_256,r_12_31_53,r_127_18_127,1.0,0,127,127,20
15,r_69_73_134,r_97_95_144,seq134,r_97_95_144,1.0,-1,143,144,20
48,r_38_32_143,r_36_130_132,r_35_109_98,r_36_130_132,0.71,-18,114,132,20
13,r_116_90_36,seq72,seq114,r_116_90_36,0.91,1,37,36,20
4,r_100_89_256,r_80_20_136,r_117_131_49,r_100_89_256,0.87,0,256,256,20
31,r_56_135_282,r_67_129_165,r_78_7_156,r_56_135_282,0.55,0,282,282,20
99,seq123,r_16_144_160,r_14_115_149,r_16_144_160,0.85,14,174,160,20
34,r_106_140_205,r_69_73_134,r_122_76_270,r_106_140_205,1.0,0,205,205,20
41,r_80_20_136,r_104_45_173,seq1,r_104_45_173,1.0,0,173,173,20
18,r_11_92_230,seq145,r_98_5_164,r_11_92_230,0.94,0,230,230,20
29,r_107_121_75,seq23,seq71,r_107_121_75,1.0,0,75,75,20
24,r_88_3_171,seq6,seq136,r_88_3_171,0.83,0,171,171,20
36,r_12_31_53,seq47,seq128,r_12_31_53,0.68,4,57,53,20
25,r_94_126_117,seq114,r_97_95_144,r_97_95_144,0.77,9,153,144,20
33,r_91_110_96,seq128,seq142,r_91_110_96,1.0,0,96,96,20
50,seq128,r_91_110_96,r_12_31_53,r_91_110_96,1.0,0,96,96,20
65,seq134,r_106_140_205,r_69_73_134,r_106_140_205,1.0,-68,137,205,20
68,seq137,r_74_63_188,r_24_99_141,r_24_99_141,1.0,6,147,141,20
32,r_16_144_160,seq123,r_69_73_134,r_16_144_160,0.96,1,161,160,20
52,seq2,seq26,r_111_57_77,r_111_57_77,1.0,42,119,77,20
77,seq51,r_125_53_265,seq27,r_125_53_265,0.87,0,265,265,20
35,r_117_131_49,r_14_115_149,r_100_89_256,r_100_89_256,0.76,3,259,256,20
34,r_106_140_205,r_54_28_148,r_69_73_134,r_54_28_148,0.67,-1,147,148,20
63,seq146,r_49_79_12,r_104_45_173,r_49_79_12,0.89,0,12,12,20
17,r_97_95_144,r_69_73_134,r_94_126_117,r_97_95_144,0.93,-1,143,144,20
40,r_42_33_30,r_98_5_164,seq137,r_42_33_30,1.0,0,30,30,20
9,r_30_68_215,r_35_109_98,r_86_10_10,r_30_68_215,0.51,-114,101,215,20
31,r_56_135_282,seq93,r_67_129_165,r_67_129_165,1.0,1,166,165,20
22,r_124_87_233,r_122_76_270,r_127_18_127,r_124_87_233,0.54,0,233,233,20
28,r_22_133_151,seq51,seq6,r_22_133_151,0.97,0,151,151,20
2,r_8_64_67,r_117_131_49,seq70,r_8_64_67,0.97,1,68,67,20
49,r_29_119_90,r_36_130_132,seq139,r_36_130_132,0.84,-40,92,132,20
7,r_149_81_97,seq132,seq50,r_149_81_97,1.0,2,99,97,20
12,r_122_76_270,r_106_140_205,r_8_64_67,r_122_76_270,0.72,1,271,270,20
44,r_61_17_63,seq21,seq134,r_61_17_63,0.86,3,66,63,20
23,r_36_130_132,seq136,seq6,r_36_130_132,0.66,2,134,132,20
12,r_122_76_270,r_124_87_233,r_106_140_205,r_122_76_270,0.43,-37,233,270,20
23,r_36_130_132,seq6,r_34_48_192,r_34_48_192,0.44,10,202,192,20
84,seq71,seq13,r_107_121_75,r_107_121_75,1.0,1,76,75,20
30,r_135_129_267,r_67_81_222,r_7_113_103,r_7_113_103,0.99,123,226,103,21
36,r_52_53_67,r_66_85_146,r_80_122_252,r_52_53_67,0.5,1,68,67,21
8,r_16_9_80,r_94_36_244,r_95_10_31,r_16_9_80,0.95,0,80,80,21
54,seq8,r_134_23_239,r_22_51_41,r_22_51_41,1.0,199,240,41,21
81,seq64,seq65,r_140_26_263,r_140_26_263,0.82,0,263,263,21
16,r_7_113_103,seq47,r_14_87_9,r_7_113_103,1.0,1,104,103,21
21,r_120_21_271,seq39,r_147_6_265,r_147_6_265,0.73,6,271,265,21
39,r_35_89_95,r_15_128_242,r_52_53_67,r_35_89_95,0.99,0,95,95,21
97,seq119,seq28,r_7_113_103,r_7_113_103,1.0,1,104,103,21
25,r_42_124_16,r_56_1_202,seq60,r_42_124_16,0.96,0,16,16,21
46,r_103_50_204,seq60,seq61,r_103_50_204,0.98,3,207,204,21
42,r_33_13_68,r_125_132_288,seq11,r_33_13_68,1.0,0,68,68,21
81,seq64,r_22_51_41,seq65,r_22_51_41,1.0,1,42,41,21
32,r_146_84_4,r_80_122_252,seq116,r_80_122_252,0.35,-119,133,252,21
7,r_14_87_9,r_67_81_222,r_7_113_103,r_7_113_103,1.0,123,226,103,21
69,seq39,r_120_21_271,r_3_104_248,r_3_104_248,0.58,23,271,248,21
40,r_134_23_239,r_115_86_270,r_46_32_29,r_134_23_239,0.5,17,256,239,21
32,r_146_84_4,seq116,r_147_6_265,r_147_6_265,0.85,3,268,265,21
19,r_102_126_157,seq136,seq90,r_102_126_157,1.0,0,157,157,21
43,r_22_51_41,seq64,seq71,r_22_51_41,1.0,0,41,41,21
33,r_15_128_242,r_17_117_90,r_38_25_142,r_17_117_90,0.31,157,247,90,21
45,r_46_32_29,seq144,seq136,r_46_32_29,1.0,3,32,29,21
11,r_80_122_252,r_52_53_67,r_7_113_103,r_80_122_252,0.81,0,252,252,21
27,r_115_86_270,r_67_81_222,r_134_23_239,r_134_23_239,0.58,3,242,239,21
66,seq30,r_112_127_109,r_38_25_142,r_112_127_109,1.0,0,109,109,21
31,r_77_133_272,seq27,r_67_81_222,r_77_133_272,0.45,-125,147,272,21
41,r_29_70_251,r_105_2_292,seq27,r_105_2_292,0.75,-40,252,292,21
15,r_68_99_20,r_107_123_216,seq37,r_68_99_20,0.6,0,20,20,21
10,r_38_25_142,r_140_26_263,seq30,r_38_25_142,0.63,26,168,142,21
26,r_149_48_75,seq30,seq145,r_149_48_75,1.0,0,75,75,21
4,r_76_138_71,r_112_127_109,seq139,r_76_138_71,0.98,0,71,71,21
78,seq61,seq20,r_103_50_204,r_103_50_204,0.95,6,210,204,21
11,r_80_122_252,seq109,r_52_53_67,r_52_53_67,1.0,9,76,67,21
13,r_17_117_90,r_102_126_157,r_15_128_242,r_17_117_90,0.87,1,91,90,21
48,r_66_85_146,seq18,seq61,r_66_85_146,1.0,0,146,146,21
13,r_17_117_90,r_15_128_242,r_38_25_142,r_17_117_90,0.39,162,252,90,21
2,r_67_81_222,r_77_133_272,r_80_122_252,r_77_133_272,0.6,1,273,272,21
27,r_115_86_270,seq27,r_67_81_222,r_115_86_270,0.5,-173,97,270,21
87,seq90,seq74,r_102_126_157,r_102_126_157,1.0,6,163,157,21
2,r_67_81_222,r_135_129_267,r_77_133_272,r_67_81_222,0.43,4,226,222,21
18,r_19_58_139,r_15_128_242,r_35_89_95,r_15_128_242,1.0,-103,139,242,21
29,r_96_69_284,seq5,r_68_99_20,r_68_99_20,0.81,264,284,20,21
53,seq5,r_96_69_284,r_82_114_52,r_82_114_52,0.98,1,53,52,21
24,r_107_123_216,seq131,r_34_73_7,r_107_123_216,0.57,2,218,216,21
27,r_115_86_270,r_134_23_239,r_16_9_80,r_115_86_270,0.96,0,270,270,21
33,r_15_128_242,r_35_89_95,r_17_117_90,r_15_128_242,0.94,-147,95,242,21
37,r_95_10_31,seq43,seq5,r_95_10_31,1.0,1,32,31,21
90,seq98,r_134_23_239,r_22_51_41,r_22_51_41,1.0,1,42,41,21
44,r_44_141_27,r_111_110_89,seq57,r_44_141_27,0.82,0,27,27,21
38,r_112_127_109,seq30,seq39,r_112_127_109,1.0,0,109,109,21
34,r_79_45_150,r_134_23_239,r_16_9_80,r_16_9_80,0.7,71,151,80,21
75,seq57,r_94_36_244,seq0,r_94_36_244,0.92,0,244,244,21
60,seq145,seq27,r_149_48_75,r_149_48_75,1.0,72,147,75,21
45,r_46_32_29,seq136,r_7_113_103,r_7_113_103,1.0,124,227,103,21
17,r_56_1_202,seq12,r_79_45_150,r_56_1_202,0.67,5,207,202,21
9,r_83_121_287,seq39,r_80_122_252,r_80_122_252,0.69,35,287,252,21
31,r_77_133_272,r_67_81_222,r_16_9_80,r_77_133_272,0.59,0,272,272,21
37,r_95_10_31,seq5,r_16_9_80,r_16_9_80,1.0,44,124,80,21
36,r_52_53_67,r_80_122_252,r_35_89_95,r_35_89_95,1.0,1,96,95,21
28,r_88_4_175,seq20,seq43,r_88_4_175,1.0,0,175,175,21
23,r_93_75_133,r_55_78_17,r_38_25_142,r_93_75_133,1.0,0,133,133,21
35,r_54_137_129,r_38_25_142,r_82_114_52,r_38_25_142,1.0,-12,130,142,21
12,r_3_104_248,seq37,r_112_127_109,r_3_104_248,0.51,1,249,248,21
84,seq71,r_147_6_265,r_22_51_41,r_22_51_41,1.0,224,265,41,21
30,r_15_108_254,r_45_21_188,seq61,r_45_21_188,0.75,-34,154,188,22
33,r_125_14_51,seq10,seq146,r_125_14_51,0.99,0,51,51,22
4,r_96_114_190,seq33,r_55_65_21,r_55_65_21,1.0,8,29,21,22
36,r_52_135_154,seq2,r_40_46_106,r_52_135_154,0.98,0,154,154,22
14,r_149_62_193,seq24,r_30_58_149,r_149_62_193,0.46,1,194,193,22
43,r_120_12_224,seq61,seq22,r_120_12_224,0.84,1,225,224,22
37,r_31_17_31,r_23_35_291,r_19_95_127,r_31_17_31,0.92,4,35,31,22
16,r_36_115_251,seq81,r_40_46_106,r_36_115_251,0.55,0,251,251,22
21,r_39_111_164,seq85,seq142,r_39_111_164,0.82,0,164,164,22
1,r_100_84_152,seq2,r_137_124_9,r_100_84_152,0.95,0,152,152,22
5,r_118_139_78,seq83,seq10,r_118_139_78,1.0,0,78,78,22
42,r_86_93_2,r_8_102_183,seq99,r_8_102_183,1.0,-49,134,183,22
32,r_129_48_272,r_20_107_59,seq91,r_20_107_59,0.53,213,272,59,22
19,r_26_51_145,r_149_62_193,seq81,r_26_51_145,1.0,0,145,145,22
2,r_55_65_21,r_117_69_198,r_96_114_190,r_55_65_21,1.0,0,21,21,22
45,r_141_18_29,seq25,seq145,r_141_18_29,1.0,0,29,29,22
31,r_116_126_95,seq132,seq81,r_116_126_95,0.66,28,123,95,22
41,r_30_58_149,seq143,seq42,r_30_58_149,0.69,28,177,149,22
20,r_76_90_22,r_19_95_127,seq3,r_76_90_22,0.91,0,22,22,22
3,r_130_47_61,r_37_105_184,seq24,r_130_47_61,1.0,1,62,61,22
10,r_16_109_255,seq101,r_37_105_184,r_37_105_184,0.83,9,193,184,22
26,r_68_89_147,seq61,seq81,r_68_89_147,0.89,0,147,147,22
8,r_137_124_9,r_23_35_291,r_100_84_152,r_100_84_152,0.91,103,255,152,22
78,seq70,seq110,r_125_14_51,r_125_14_51,1.0,142,193,51,22
0,r_34_148_159,r_16_109_255,seq99,r_34_148_159,0.64,1,160,159,22
73,seq43,seq75,r_1_4_89,r_1_4_89,1.0,11,100,89,22
11,r_13_6_99,r_149_62_193,seq25,r_13_6_99,1.0,0,99,99,22
13,r_117_69_198,seq54,seq11,r_117_69_198,0.97,0,198,198,22
48,r_37_105_184,seq44,r_8_102_183,r_37_105_184,0.55,0,184,184,22
15,r_103_66_36,r_96_114_190,seq10,r_103_66_36,0.82,1,37,36,22
22,r_71_82_11,r_8_102_183,seq5,r_71_82_11,0.89,-1,10,11,22
4,r_96_114_190,r_55_65_21,seq10,r_96_114_190,0.91,0,190,190,22
54,seq5,r_73_78_88,r_71_82_11,r_73_78_88,1.0,-40,48,88,22
62,seq145,r_45_21_188,r_141_18_29,r_141_18_29,1.0,7,36,29,22
2,r_55_65_21,r_96_114_190,r_39_111_164,r_39_111_164,0.66,26,190,164,22
99,seq127,r_87_106_259,r_125_14_51,r_125_14_51,1.0,208,259,51,22
17,r_20_107_59,r_8_102_183,r_129_48_272,r_20_107_59,1.0,0,59,59,22
10,r_16_109_255,r_37_105_184,r_116_126_95,r_16_109_255,0.89,0,255,255,22
27,r_77_53_109,seq10,seq28,r_77_53_109,0.99,3,112,109,22
30,r_15_108_254,seq61,r_30_58_149,r_15_108_254,0.87,-5,249,254,22
9,r_40_46_106,r_130_47_61,r_52_135_154,r_52_135_154,1.0,1,155,154,22
40,r_134_38_249,seq101,r_57_0_8,r_134_38_249,0.71,5,254,249,22
18,r_1_4_89,r_23_35_291,seq43,r_1_4_89,0.96,-4,85,89,22
29,r_59_63_240,seq91,r_32_64_65,r_32_64_65,1.0,12,77,65,22
24,r_7_144_140,seq132,seq97,r_7_144_140,0.49,1,141,140,22
34,r_19_95_127,r_31_17_31,r_125_14_51,r_19_95_127,1.0,0,127,127,22
25,r_147_27_81,seq146,seq33,r_147_27_81,1.0,0,81,81,22
65,seq24,r_149_62_193,r_130_47_61,r_130_47_61,1.0,133,194,61,22
32,r_129_48_272,r_39_111_164,r_20_107_59,r_20_107_59,1.0,22,81,59,22
38,r_45_21_188,seq113,r_20_107_59,r_20_107_59,0.97,129,188,59,22
9,r_40_46_106,seq140,r_130_47_61,r_130_47_61,1.0,50,111,61,22
37,r_31_17_31,r_19_95_127,seq11,r_19_95_127,1.0,0,127,127,22
28,r_50_92_296,r_37_105_184,r_119_80_151,r_50_92_296,0.99,-132,164,296,22
29,r_59_63_240,r_32_64_65,r_7_144_140,r_32_64_65,0.46,175,240,65,22
28,r_50_92_296,r_73_78_88,r_37_105_184,r_73_78_88,1.0,-1,87,88,22
91,seq101,r_134_38_249,r_8_102_183,r_8_102_183,0.99,71,254,183,22
49,r_119_80_151,seq91,r_50_92_296,r_119_80_151,0.98,0,151,151,22
34,r_19_95_127,seq43,r_31_17_31,r_31_17_31,0.96,4,35,31,22
7,r_73_78_88,r_50_92_296,r_32_64_65,r_50_92_296,1.0,-208,88,296,22
23,r_32_64_65,seq43,r_59_63_240,r_32_64_65,1.0,0,65,65,22
17,r_20_107_59,r_129_48_272,seq85,r_129_48_272,0.66,-80,192,272,22
57,seq10,r_125_14_51,r_103_66_36,r_125_14_51,0.6,0,51,51,22
12,r_8_102_183,seq9,seq101,r_8_102_183,1.0,0,183,183,22
23,r_32_64_65,r_59_63_240,r_73_78_88,r_32_64_65,0.88,175,240,65,22
84,seq83,r_118_139_78,r_94_60_63,r_118_139_78,1.0,-1,77,78,22
93,seq104,r_147_123_288,r_115_7_271,r_115_7_271,0.82,17,288,271,23
30,r_42_146_128,seq65,seq26,r_42_146_128,0.83,3,131,128,23
36,r_116_97_96,seq10,seq21,r_116_97_96,1.0,0,96,96,23
9,r_82_77_280,r_39_131_6,r_90_70_136,r_90_70_136,0.94,144,280,136,23
14,r_36_25_121,seq107,r_58_5_63,r_36_25_121,0.49,4,125,121,23
8,r_58_5_63,r_100_55_241,r_143_68_23,r_58_5_63,1.0,0,63,63,23
17,r_80_93_56,r_118_48_214,seq50,r_80_93_56,1.0,0,56,56,23
54,seq10,r_116_97_96,seq65,r_116_97_96,1.0,0,96,96,23
83,seq74,seq113,r_76_20_30,r_76_20_30,1.0,105,135,30,23
3,r_44_133_12,r_137_130_235,seq46,r_44_133_12,0.6,200,212,12,23
19,r_87_138_151,r_29_91_286,r_36_25_121,r_87_138_151,0.65,-10,141,151,23
16,r_90_70_136,seq2,r_84_149_7,r_90_70_136,0.75,0,136,136,23
21,r_110_0_167,r_75_111_158,seq3,r_75_111_158,1.0,0,158,158,23
39,r_100_55_241,r_88_47_172,r_84_149_7,r_88_47_172,0.84,-78,94,172,23
1,r_124_30_45,r_43_117_15,r_99_69_72,r_99_69_72,1.0,118,190,72,23
46,r_59_128_110,seq85,r_39_131_6,r_59_128_110,1.0,0,110,110,23
42,r_99_69_72,r_100_55_241,r_124_30_45,r_99_69_72,1.0,1,73,72,23
49,r_118_48_214,r_80_93_56,r_76_20_30,r_118_48_214,0.99,-158,56,214,23
88,seq94,r_43_117_15,r_11_64_180,r_11_64_180,1.0,10,190,180,23
32,r_41_8_13,r_118_48_214,r_76_20_30,r_41_8_13,0.87,202,215,13,23
7,r_39_131_6,r_82_77_280,r_59_128_110,r_59_128_110,1.0,69,179,110,23
69,seq33,seq103,r_27_73_85,r_27_73_85,1.0,2,87,85,23
45,r_88_47_172,r_100_55_241,r_76_20_30,r_88_47_172,1.0,0,172,172,23
19,r_87_138_151,r_61_19_59,r_29_91_286,r_61_19_59,1.0,2,61,59,23
19,r_87_138_151,r_36_25_121,seq74,r_36_25_121,0.53,129,250,121,23
22,r_76_20_30,r_135_9_232,r_31_49_166,r_76_20_30,0.99,1,31,30,23
3,r_44_133_12,seq46,r_116_97_96,r_116_97_96,0.42,163,259,96,23
39,r_100_55_241,r_84_149_7,seq85,r_84_149_7,0.41,232,239,7,23
31,r_38_136_191,seq141,r_59_128_110,r_38_136_191,0.98,0,191,191,23
41,r_147_123_288,seq104,r_39_131_6,r_147_123_288,0.28,1,289,288,23
88,seq94,seq142,r_43_117_15,r_43_117_15,0.91,0,15,15,23
73,seq46,r_44_133_12,r_135_9_232,r_135_9_232,0.77,25,257,232,23
26,r_137_130_235,seq21,seq141,r_137_130_235,0.37,2,237,235,23
8,r_58_5_63,r_143_68_23,r_36_25_121,r_36_25_121,1.0,7,128,121,23
72,seq45,seq3,r_106_63_161,r_106_63_161,0.79,9,170,161,23
4,r_60_37_202,r_129_35_236,r_108_109_95,r_129_35_236,1.0,-34,202,236,23
0,r_115_7_271,seq2,seq62,r_115_7_271,0.63,0,271,271,23
20,r_81_83_179,seq15,seq121,r_81_83_179,0.99,0,179,179,23
13,r_4_144_176,seq140,seq139,r_4_144_176,0.93,2,178,176,23
25,r_61_19_59,seq2,r_105_148_73,r_61_19_59,1.0,0,59,59,23
15,r_17_71_184,seq140,seq21,r_17_71_184,0.91,1,185,184,23
72,seq45,r_106_63_161,r_80_93_56,r_80_93_56,0.66,150,206,56,23
49,r_118_48_214,r_76_20_30,seq14,r_118_48_214,0.66,5,219,214,23
6,r_105_148_73,seq65,r_61_19_59,r_61_19_59,1.0,15,74,59,23
1,r_124_30_45,seq26,r_43_117_15,r_124_30_45,1.0,0,45,45,23
5,r_43_117_15,seq94,r_124_30_45,r_124_30_45,1.0,44,89,45,23
27,r_1_13_61,seq23,seq33,r_1_13_61,1.0,0,61,61,23
22,r_76_20_30,r_31_49_166,r_41_8_13,r_31_49_166,1.0,1,167,166,23
2,r_106_63_161,r_81_83_179,seq45,r_106_63_161,0.81,2,163,161,23
40,r_75_111_158,r_110_0_167,seq104,r_75_111_158,0.99,0,158,158,23
29,r_135_9_232,seq33,seq21,r_135_9_232,0.7,0,232,232,23
24,r_53_32_242,seq121,r_31_49_166,r_53_32_242,0.62,1,243,242,23
32,r_41_8_13,r_59_128_110,r_118_48_214,r_41_8_13,0.49,0,13,13,23
35,r_108_109_95,r_143_68_23,r_60_37_202,r_60_37_202,1.0,22,224,202,23
48,r_31_49_166,r_76_20_30,r_66_52_298,r_31_49_166,0.68,1,167,166,23
47,r_84_149_7,r_11_64_180,r_90_70_136,r_84_149_7,1.0,164,171,7,23
48,r_31_49_166,r_66_52_298,r_53_32_242,r_53_32_242,0.97,2,244,242,23
3,r_44_133_12,r_4_144_176,r_137_130_235,r_44_133_12,0.65,3,15,12,23
38,r_27_73_85,seq107,seq33,r_27_73_85,0.99,1,86,85,23
52,seq142,r_112_132_135,r_125_96_21,r_112_132_135,0.48,0,135,135,23
12,r_129_35_236,seq6,seq65,r_129_35_236,0.79,-4,232,236,23
2,r_106_63_161,seq45,r_134_79_211,r_134_79_211,1.0,1,212,211,23
18,r_11_64_180,r_58_5_63,r_84_149_7,r_58_5_63,1.0,-15,48,63,23
96,seq119,r_108_109_95,seq6,r_108_109_95,1.0,0,95,95,23
28,r_143_68_23,seq74,r_125_96_21,r_143_68_23,0.81,0,23,23,23
10,r_125_96_21,seq24,seq40,r_125_96_21,0.99,0,21,21,23
11,r_54_127_44,r_58_5_63,seq6,r_54_127_44,0.99,1,45,44,23
74,seq50,seq51,r_80_93_56,r_80_93_56,1.0,3,59,56,23
33,r_114_120_296,seq94,r_143_68_23,r_143_68_23,0.99,20,43,23,23
48,r_31_49_166,r_80_93_56,r_76_20_30,r_31_49_166,0.84,-124,42,166,23
18,r_11_64_180,r_84_149_7,seq94,r_11_64_180,1.0,0,180,180,23
44,r_112_132_135,seq40,r_1_13_61,r_1_13_61,0.86,74,135,61,23
23,r_134_79_211,seq6,r_106_63_161,r_134_79_211,0.74,0,211,211,23
82,seq140,r_4_144_176,seq101,r_4_144_176,1.0,2,178,176,23
79,seq65,r_105_148_73,seq10,r_105_148_73,0.51,38,111,73,23
35,r_108_109_95,seq119,r_143_68_23,r_108_109_95,1.0,0,95,95,23
12,r_129_35_236,r_60_37_202,seq6,r_60_37_202,0.61,0,202,202,23
5,r_43_117_15,seq46,seq94,r_43_117_15,0.54,0,15,15,23
84,seq85,r_59_128_110,r_105_148_73,r_59_128_110,1.0,0,110,110,23
30,r_140_132_60,seq122,seq68,r_140_132_60,0.99,0,60,60,24
51,seq1,seq40,r_65_117_118,r_65_117_118,1.0,33,151,118,24
12,r_92_108_33,r_85_131_264,seq112,r_92_108_33,1.0,0,33,33,24
36,r_23_90_24,r_138_100_223,r_36_145_221,r_23_90_24,1.0,0,24,24,24
83,seq75,r_56_98_220,r_71_87_58,r_71_87_58,1.0,139,197,58,24
37,r_113_55_169,r_121_133_211,seq45,r_113_55_169,0.91,0,169,169,24
43,r_103_33_14,r_54_32_122,seq37,r_103_33_14,0.97,0,14,14,24
10,r_44_61_26,r_110_30_75,seq60,r_44_61_26,0.98,0,26,26,24
86,seq84,r_13_86_188,r_110_30_75,r_110_30_75,1.0,29,104,75,24
16,r_73_78_285,seq66,r_114_146_34,r_73_78_285,0.16,1,286,285,24
21,r_47_19_81,r_35_143_102,seq15,r_47_19_81,1.0,0,81,81,24
39,r_121_133_211,r_114_146_34,seq77,r_121_133_211,0.91,1,212,211,24
1,r_56_98_220,seq75,r_83_21_21,r_56_98_220,0.7,0,220,220,24
97,seq122,seq125,r_53_141_129,r_53_141_129,1.0,20,149,129,24
13,r_27_64_15,r_140_132_60,seq112,r_27_64_15,0.83,0,15,15,24
5,r_124_18_80,seq60,r_80_119_28,r_124_18_80,0.75,4,84,80,24
46,r_13_86_188,seq84,r_103_33_14,r_103_33_14,0.99,172,186,14,24
42,r_59_7_265,seq58,seq142,r_59_7_265,0.58,1,266,265,24
45,r_71_87_58,seq99,seq75,r_71_87_58,1.0,0,58,58,24
19,r_109_127_151,seq75,seq0,r_109_127_151,0.98,0,151,151,24
15,r_16_149_246,r_26_123_56,seq126,r_26_123_56,0.86,193,249,56,24
38,r_82_46_147,r_36_145_221,r_111_105_91,r_82_46_147,0.98,3,150,147,24
0,r_36_145_221,r_16_149_246,r_23_90_24,r_23_90_24,0.98,11,35,24,24
31,r_22_94_77,seq45,seq112,r_22_94_77,1.0,0,77,77,24
3,r_85_131_264,seq118,seq40,r_85_131_264,0.47,0,264,264,24
26,r_31_42_84,seq1,seq28,r_31_42_84,0.89,1,85,84,24
78,seq67,seq104,r_3_102_85,r_3_102_85,1.0,1,86,85,24
11,r_25_88_69,r_54_32_122,seq17,r_25_88_69,0.99,0,69,69,24
20,r_111_105_91,r_120_14_94,seq67,r_111_105_91,0.99,0,91,91,24
15,r_16_149_246,r_36_145_221,r_26_123_56,r_16_149_246,0.68,-183,63,246,24
35,r_110_30_75,r_44_61_26,r_3_102_85,r_110_30_75,0.69,-59,16,75,24
35,r_110_30_75,r_3_102_85,seq84,r_110_30_75,0.69,0,75,75,24
6,r_26_123_56,seq122,r_16_149_246,r_26_123_56,0.97,6,62,56,24
62,seq17,r_13_86_188,r_25_88_69,r_25_88_69,1.0,12,81,69,24
5,r_124_18_80,r_80_119_28,r_103_33_14,r_124_18_80,0.49,108,188,80,24
0,r_36_145_221,r_23_90_24,r_109_127_151,r_36_145_221,0.94,0,221,221,24
36,r_23_90_24,r_36_145_221,r_26_123_56,r_36_145_221,0.98,-7,214,221,24
27,r_54_32_122,seq107,seq128,r_54_32_122,1.0,0,122,122,24
2,r_43_48_184,r_24_2_287,r_97_34_295,r_43_48_184,1.0,0,184,184,24
18,r_65_117_118,r_56_98_220,seq1,r_65_117_118,1.0,0,118,118,24
29,r_137_134_62,r_3_102_85,r_140_132_60,r_137_134_62,1.0,2,64,62,24
7,r_80_119_28,seq135,r_103_33_14,r_80_119_28,0.96,0,28,28,24
25,r_24_2_287,seq8,r_47_19_81,r_47_19_81,1.0,206,287,81,24
33,r_38_81_212,seq72,r_148_130_11,r_38_81_212,0.78,0,212,212,24
50,seq0,r_115_9_296,r_109_127_151,r_109_127_151,1.0,19,170,151,24
6,r_26_123_56,r_16_149_246,r_23_90_24,r_16_149_246,1.0,3,249,246,24
61,seq15,r_56_98_220,r_47_19_81,r_47_19_81,1.0,5,86,81,24
38,r_82_46_147,r_35_143_102,r_36_145_221,r_35_143_102,0.54,-15,87,102,24
52,seq4,r_138_100_223,r_11_62_176,r_138_100_223,0.58,-37,186,223,24
77,seq66,r_73_78_285,r_35_143_102,r_35_143_102,0.93,77,179,102,24
4,r_83_21_21,r_31_42_84,seq135,r_83_21_21,1.0,0,21,21,24
17,r_147_89_196,seq135,r_25_88_69,r_147_89_196,0.62,0,196,196,24
9,r_3_102_85,r_115_9_296,seq67,r_3_102_85,1.0,0,85,85,24
96,seq118,r_85_131_264,r_56_98_220,r_56_98_220,0.75,44,264,220,24
22,r_53_141_129,seq106,seq122,r_53_141_129,1.0,1,130,129,24
28,r_95_29_143,seq72,seq135,r_95_29_143,0.96,0,143,143,24
49,r_120_14_94,seq136,seq58,r_120_14_94,0.91,0,94,94,24
44,r_35_143_102,r_82_46_147,seq66,r_35_143_102,0.57,1,103,102,24
23,r_97_34_295,seq63,r_43_48_184,r_43_48_184,1.0,7,191,184,24
84,seq77,seq99,r_121_133_211,r_121_133_211,0.97,8,219,211,24
23,r_122_68_72,seq132,r_12_138_210,r_122_68_72,0.34,127,199,72,25
36,r_3_97_281,seq14,r_143_90_77,r_143_90_77,0.61,204,281,77,25
14,r_39_15_69,r_76_34_68,seq95,r_39_15_69,0.35,33,102,69,25
8,r_87_81_84,r_128_27_160,seq58,r_87_81_84,0.93,0,84,84,25
23,r_122_68_72,r_102_1_99,seq132,r_102_1_99,1.0,0,99,99,25
43,r_66_49_246,seq44,r_37_57_39,r_66_49_246,0.65,0,246,246,25
54,seq11,r_16_62_233,r_143_90_77,r_143_90_77,0.99,7,84,77,25
76,seq71,seq117,r_134_135_196,r_134_135_196,1.0,12,208,196,25
37,r_114_80_42,seq117,r_37_57_39,r_114_80_42,0.99,1,43,42,25
19,r_16_62_233,seq11,r_28_32_44,r_16_62_233,0.79,0,233,233,25
55,seq140,r_115_89_167,r_20_145_66,r_20_145_66,1.0,101,167,66,25
71,seq60,r_146_75_243,r_109_5_61,r_109_5_61,1.0,157,218,61,25
86,seq93,r_129_42_257,r_148_64_122,r_148_64_122,1.0,15,137,122,25
5,r_137_51_150,r_104_70_209,seq131,r_104_70_209,1.0,-53,156,209,25
46,r_115_89_167,seq140,r_85_103_146,r_115_89_167,1.0,0,167,167,25
42,r_19_127_111,r_119_23_231,r_54_98_53,r_119_23_231,0.96,-119,112,231,25
69,seq58,seq71,r_87_81_84,r_87_81_84,1.0,31,115,84,25
45,r_104_70_209,r_137_51_150,r_85_103_146,r_104_70_209,1.0,0,209,209,25
76,seq71,r_54_98_53,seq58,r_54_98_53,1.0,0,53,53,25
19,r_16_62_233,r_133_94_60,seq11,r_133_94_60,1.0,0,60,60,25
31,r_40_91_38,r_33_125_270,seq31,r_40_91_38,1.0,0,38,38,25
97,seq123,r_120_106_268,r_40_91_38,r_40_91_38,0.86,139,177,38,25
67,seq50,r_120_106_268,r_29_26_294,r_120_106_268,0.95,1,269,268,25
3,r_72_43_218,seq10,r_128_27_160,r_72_43_218,0.98,0,218,218,25
10,r_119_23_231,seq63,seq142,r_119_23_231,0.62,1,232,231,25
8,r_87_81_84,seq58,seq71,r_87_81_84,0.44,65,149,84,25
4,r_139_17_126,r_66_49_246,seq141,r_66_49_246,0.51,-120,126,246,25
11,r_79_84_191,seq126,seq86,r_79_84_191,0.94,0,191,191,25
15,r_4_7_278,seq67,r_137_51_150,r_137_51_150,0.84,128,278,150,25
48,r_136_35_20,r_137_51_150,r_133_94_60,r_133_94_60,1.0,4,64,60,25
6,r_143_90_77,seq131,seq11,r_143_90_77,1.0,0,77,77,25
21,r_36_82_35,seq14,r_20_145_66,r_20_145_66,1.0,44,110,66,25
99,seq126,r_79_84_191,seq52,r_79_84_191,0.98,0,191,191,25
27,r_24_149_179,seq132,seq117,r_24_149_179,0.91,0,179,179,25
1,r_54_98_53,seq71,seq25,r_54_98_53,0.96,0,53,53,25
69,seq58,r_87_81_84,r_134_135_196,r_134_135_196,1.0,81,277,196,25
2,r_129_42_257,seq93,seq67,r_129_42_257,0.46,0,257,257,25
47,r_102_1_99,r_99_88_239,seq69,r_102_1_99,0.99,0,99,99,25
40,r_148_64_122,seq116,seq93,r_148_64_122,1.0,0,122,122,25
74,seq67,r_4_7_278,r_85_103_146,r_85_103_146,1.0,30,176,146,25
18,r_109_5_61,seq69,seq121,r_109_5_61,1.0,0,61,61,25
29,r_85_103_146,r_128_27_160,seq67,r_85_103_146,1.0,0,146,146,25
95,seq117,r_114_80_42,seq71,r_114_80_42,0.78,1,43,42,25
25,r_12_138_210,seq121,r_122_68_72,r_122_68_72,1.0,138,210,72,25
33,r_134_135_196,seq101,seq71,r_134_135_196,0.9,0,196,196,25
63,seq41,r_3_97_281,r_28_32_44,r_28_32_44,0.98,-4,40,44,25
61,seq31,r_21_55_254,r_40_91_38,r_40_91_38,1.0,95,133,38,25
38,r_147_9_264,r_21_55_254,r_120_106_268,r_21_55_254,0.67,1,255,254,25
64,seq44,r_66_49_246,r_96_65_59,r_96_65_59,1.0,0,59,59,25
8,r_87_81_84,seq71,seq58,r_87_81_84,0.54,141,225,84,25
34,r_146_75_243,seq60,seq52,r_146_75_243,0.25,19,262,243,25
24,r_28_32_44,seq22,seq41,r_28_32_44,1.0,0,44,44,25
75,seq69,r_109_5_61,seq11,r_109_5_61,0.96,0,61,61,25
57,seq14,r_3_97_281,r_36_82_35,r_36_82_35,1.0,3,38,35,25
21,r_36_82_35,r_137_51_150,seq14,r_36_82_35,0.94,0,35,35,25
17,r_105_100_11,r_87_81_84,seq30,r_105_100_11,1.0,0,11,11,25
75,seq69,seq11,r_102_1_99,r_102_1_99,0.96,4,103,99,25
97,seq123,r_40_91_38,r_102_1_99,r_40_91_38,0.79,230,268,38,25
22,r_20_145_66,seq83,r_36_82_35,r_20_145_66,1.0,0,66,66,25
7,r_21_55_254,r_147_9_264,r_6_118_291,r_21_55_254,0.5,1,255,254,25
44,r_133_94_60,r_16_62_233,r_136_35_20,r_133_94_60,1.0,0,60,60,25
23,r_122_68_72,seq86,r_102_1_99,r_122_68_72,0.98,0,72,72,25
55,seq140,r_20_145_66,r_144_48_266,r_20_145_66,0.67,134,200,66,25
12,r_99_88_239,seq111,seq140,r_99_88_239,0.69,1,240,239,25
95,seq117,seq71,r_24_149_179,r_24_149_179,0.78,-1,178,179,25
84,seq86,seq77,r_79_84_191,r_79_84_191,0.81,55,246,191,25
30,r_109_115_83,r_100_114_293,seq7,r_109_115_83,0.98,2,85,83,26
36,r_31_77_173,r_134_146_193,seq50,r_31_77_173,0.76,0,173,173,26
92,seq104,seq45,r_143_32_93,r_143_32_93,1.0,105,198,93,26
14,r_126_42_176,seq59,r_31_77_173,r_126_42_176,0.86,0,176,176,26
8,r_148_26_141,seq45,r_0_51_70,r_0_51_70,0.86,73,143,70,26
43,r_44_118_268,r_11_24_266,r_53_65_111,r_53_65_111,1.0,147,258,111,26
54,seq6,r_53_65_111,seq40,r_53_65_111,0.65,2,113,111,26
37,r_12_69_216,seq25,r_20_81_211,r_12_69_216,0.88,0,216,216,26
59,seq140,r_94_135_106,r_98_107_13,r_94_135_106,1.0,0,106,106,26
71,seq45,r_148_26_141,r_143_32_93,r_143_32_93,0.93,50,143,93,26
16,r_62_9_4,r_11_24_266,r_53_65_111,r_53_65_111,1.0,155,266,111,26
21,r_99_19_290,seq90,seq104,r_99_19_290,0.2,0,290,290,26
1,r_11_24_266,r_62_9_4,seq17,r_11_24_266,0.42,0,266,266,26
5,r_20_81_211,r_11_24_266,r_12_69_216,r_20_81_211,0.69,8,219,211,26
46,r_30_63_72,r_116_18_218,seq132,r_30_63_72,0.95,0,72,72,26
42,r_52_103_234,r_60_2_249,seq66,r_52_103_234,0.63,0,234,234,26
69,seq41,r_75_131_1,seq58,r_75_131_1,0.29,114,115,1,26
45,r_108_129_87,seq130,r_55_101_19,r_108_129_87,1.0,0,87,87,26
19,r_116_18_218,r_39_48_198,seq72,r_39_48_198,0.61,0,198,198,26
76,seq58,r_46_67_98,r_75_131_1,r_46_67_98,1.0,0,98,98,26
26,r_60_2_249,r_145_64_66,r_55_101_19,r_60_2_249,0.99,-226,23,249,26
15,r_128_74_30,seq132,seq43,r_128_74_30,1.0,0,30,30,26
3,r_122_5_189,seq132,seq136,r_122_5_189,0.9,0,189,189,26
10,r_94_135_106,seq140,r_8_127_47,r_94_135_106,0.79,0,106,106,26
72,seq47,r_21_96_233,seq7,r_21_96_233,0.95,0,233,233,26
28,r_8_127_47,r_134_146_193,seq83,r_8_127_47,1.0,0,47,47,26
4,r_53_65_111,seq6,seq59,r_53_65_111,0.98,0,111,111,26
20,r_39_48_198,r_116_18_218,r_30_63_72,r_30_63_72,1.0,126,198,72,26
13,r_125_13_212,seq79,seq7,r_125_13_212,0.61,0,212,212,26
35,r_98_107_13,seq3,r_94_135_106,r_98_107_13,0.53,3,16,13,26
57,seq10,r_80_123_202,r_0_51_70,r_0_51_70,1.0,104,174,70,26
19,r_116_18_218,seq72,seq106,r_116_18_218,0.81,0,218,218,26
6,r_86_73_117,seq106,seq92,r_86_73_117,0.98,0,117,117,26
29,r_97_36_14,r_21_96_233,seq79,r_97_36_14,0.99,0,14,14,26
27,r_82_93_55,r_0_51_70,seq43,r_82_93_55,1.0,1,56,55,26
0,r_55_101_19,r_60_2_249,r_108_129_87,r_108_129_87,1.0,159,246,87,26
53,seq4,seq10,r_86_73_117,r_86_73_117,0.56,83,200,117,26
87,seq90,r_99_19_290,r_126_42_176,r_126_42_176,1.0,114,290,176,26
2,r_37_29_62,r_70_113_243,r_15_133_294,r_37_29_62,1.0,0,62,62,26
47,r_23_57_167,seq14,r_62_9_4,r_23_57_167,0.82,2,169,167,26
40,r_15_133_294,r_112_38_280,r_37_29_62,r_37_29_62,1.0,0,62,62,26
35,r_98_107_13,r_94_135_106,seq140,r_94_135_106,1.0,0,106,106,26
25,r_143_32_93,seq43,seq45,r_143_32_93,1.0,0,93,93,26
33,r_27_137_67,seq147,seq130,r_27_137_67,0.99,0,67,67,26
0,r_55_101_19,r_128_74_30,r_60_2_249,r_55_101_19,1.0,0,19,19,26
77,seq59,r_126_42_176,r_61_121_39,r_126_42_176,0.81,0,176,176,26
57,seq10,r_0_51_70,r_70_113_243,r_70_113_243,1.0,0,243,243,26
34,r_46_67_98,seq58,seq117,r_46_67_98,1.0,0,98,98,26
24,r_33_91_23,seq68,seq147,r_33_91_23,0.98,0,23,23,26
17,r_112_38_280,seq71,r_8_127_47,r_8_127_47,0.64,233,280,47,26
9,r_145_64_66,seq56,seq110,r_145_64_66,1.0,-1,65,66,26
26,r_60_2_249,r_55_101_19,seq7,r_60_2_249,0.74,0,249,249,26
96,seq117,seq106,r_46_67_98,r_46_67_98,1.0,23,121,98,26
28,r_8_127_47,seq83,r_94_135_106,r_94_135_106,1.0,4,110,106,26
22,r_85_142_230,seq3,r_12_69_216,r_12_69_216,0.86,10,226,216,26
49,r_34_84_286,seq3,r_85_142_230,r_85_142_230,0.6,56,286,230,26
23,r_0_51_70,r_12_69_216,seq10,r_0_51_70,1.0,0,70,70,26
53,seq4,r_86_73_117,seq14,r_86_73_117,0.91,130,247,117,26
41,r_61_121_39,r_23_57_167,seq59,r_61_121_39,0.91,1,40,39,26
12,r_70_113_243,seq28,seq10,r_70_113_243,0.84,0,243,243,26
32,r_138_88_42,r_109_115_83,seq117,r_138_88_42,0.99,0,42,42,26
23,r_0_51_70,seq10,r_148_26_141,r_148_26_141,0.99,73,214,141,26
30,r_88_57_113,r_139_149_284,seq106,r_88_57_113,0.96,0,113,113,27
51,seq128,r_79_78_274,r_54_87_161,r_54_87_161,0.98,113,274,161,27
27,r_67_37_42,seq39,seq110,r_67_37_42,0.99,2,44,42,27
36,r_89_142_151,seq34,r_127_17_1,r_89_142_151,0.96,2,153,151,27
9,r_144_53_76,r_3_15_149,r_38_122_83,r_3_15_149,1.0,1,150,149,27
92,seq110,seq27,r_67_37_42,r_67_37_42,1.0,66,108,42,27
14,r_86_8_70,r_1_146_188,r_14_61_256,r_86_8_70,1.0,0,70,70,27
43,r_139_149_284,r_88_57_113,r_60_11_72,r_60_11_72,0.87,41,113,72,27
83,seq90,r_1_146_188,seq51,r_1_146_188,1.0,0,188,188,27
37,r_3_15_149,r_16_137_289,r_38_122_83,r_38_122_83,1.0,10,93,83,27
59,seq143,r_66_24_104,r_80_2_222,r_66_24_104,1.0,-1,103,104,27
16,r_62_112_69,r_83_132_150,r_127_17_1,r_62_112_69,1.0,0,69,69,27
21,r_109_126_267,r_79_78_274,r_25_59_79,r_109_126_267,0.6,2,269,267,27
39,r_79_78_274,seq128,r_70_77_125,r_79_78_274,0.27,1,275,274,27
1,r_14_61_256,r_86_8_70,r_29_100_31,r_14_61_256,0.56,0,256,256,27
1,r_14_61_256,seq30,r_86_8_70,r_86_8_70,1.0,10,80,70,27
97,seq121,r_101_18_136,seq148,r_101_18_136,0.81,-4,132,136,27
5,r_33_36_109,seq81,seq123,r_33_36_109,1.0,0,109,109,27
54,seq6,r_98_140_285,r_29_100_31,r_29_100_31,0.89,15,46,31,27
46,r_70_77_125,r_98_140_285,seq10,r_70_77_125,1.0,0,125,125,27
42,r_54_87_161,r_127_17_1,seq21,r_54_87_161,1.0,0,161,161,27
80,seq141,r_80_2_222,r_116_111_128,r_116_111_128,0.97,9,137,128,27
7,r_80_2_222,r_136_68_158,seq6,r_80_2_222,0.73,0,222,222,27
45,r_116_111_128,r_50_95_168,seq141,r_116_111_128,1.0,0,128,128,27
19,r_129_9_245,seq106,r_144_53_76,r_129_9_245,0.71,0,245,245,27
15,r_19_134_287,r_66_24_104,r_45_133_219,r_66_24_104,0.43,183,287,104,27
34,r_94_28_26,r_40_105_35,seq27,r_94_28_26,1.0,0,26,26,27
95,seq118,r_45_133_219,r_88_57_113,r_88_57_113,0.45,-25,88,113,27
66,seq32,seq76,r_25_59_79,r_25_59_79,1.0,76,155,79,27
38,r_101_18_136,r_45_133_219,seq92,r_101_18_136,0.54,90,226,136,27
0,r_29_100_31,r_127_17_1,seq6,r_29_100_31,1.0,4,35,31,27
41,r_46_102_164,r_38_122_83,seq148,r_38_122_83,1.0,0,83,83,27
67,seq34,r_89_142_151,seq73,r_89_142_151,1.0,4,155,151,27
10,r_64_23_241,seq143,r_147_119_10,r_64_23_241,0.51,0,241,241,27
90,seq106,r_129_9_245,r_33_36_109,r_33_36_109,1.0,71,180,109,27
26,r_22_108_123,r_72_84_200,r_38_122_83,r_22_108_123,1.0,2,125,123,27
14,r_86_8_70,r_14_61_256,r_52_49_259,r_86_8_70,0.73,186,256,70,27
4,r_93_43_286,seq81,seq76,r_93_43_286,0.37,-3,283,286,27
11,r_65_31_91,r_50_95_168,seq20,r_65_31_91,0.97,0,91,91,27
20,r_52_49_259,r_79_78_274,seq42,r_79_78_274,0.46,-15,259,274,27
13,r_1_146_188,seq90,r_55_97_81,r_1_146_188,0.9,0,188,188,27
98,seq123,seq106,r_33_36_109,r_33_36_109,1.0,37,146,109,27
15,r_19_134_287,seq0,r_66_24_104,r_66_24_104,1.0,7,111,104,27
40,r_40_105_35,seq5,seq20,r_40_105_35,1.0,1,36,35,27
48,r_50_95_168,seq107,seq82,r_50_95_168,0.84,0,168,168,27
6,r_72_84_200,seq90,seq125,r_72_84_200,0.87,1,201,200,27
62,seq21,r_109_126_267,r_54_87_161,r_54_87_161,0.84,23,184,161,27
37,r_3_15_149,r_38_122_83,seq128,r_3_15_149,1.0,1,150,149,27
87,seq148,r_101_18_136,seq121,r_101_18_136,0.81,21,157,136,27
2,r_25_59_79,seq12,seq32,r_25_59_79,1.0,0,79,79,27
41,r_46_102_164,seq148,seq7,r_46_102_164,1.0,0,164,164,27
47,r_138_56_172,seq7,seq92,r_138_56_172,1.0,0,172,172,27
29,r_124_63_176,seq7,seq107,r_124_63_176,0.99,0,176,176,27
24,r_47_117_132,r_136_68_158,r_86_8_70,r_47_117_132,0.88,1,133,132,27
35,r_66_24_104,r_19_134_287,seq0,r_66_24_104,0.53,183,287,104,27
25,r_45_133_219,seq91,seq121,r_45_133_219,0.39,6,225,219,27
43,r_139_149_284,r_60_11_72,r_72_84_200,r_139_149_284,0.47,0,284,284,27
33,r_127_17_1,r_54_87_161,seq113,r_54_87_161,1.0,0,161,161,27
50,seq0,r_19_134_287,r_62_112_69,r_62_112_69,1.0,214,283,69,27
65,seq30,r_14_61_256,seq42,r_14_61_256,1.0,-42,214,256,27
68,seq35,r_41_135_260,seq130,r_41_135_260,0.66,1,261,260,27
61,seq20,seq145,r_65_31_91,r_65_31_91,1.0,16,107,91,27
38,r_101_18_136,r_46_102_164,r_45_133_219,r_46_102_164,0.83,-15,149,164,27
60,seq145,r_98_140_285,r_40_105_35,r_40_105_35,0.98,112,147,35,27
81,seq81,r_93_43_286,r_41_135_260,r_93_43_286,0.38,-4,282,286,27
9,r_144_53_76,seq76,r_3_15_149,r_144_53_76,1.0,0,76,76,27
18,r_147_119_10,r_80_2_222,seq120,r_80_2_222,0.86,-212,10,222,27
22,r_136_68_158,seq76,r_116_111_128,r_136_68_158,1.0,0,158,158,27
28,r_83_132_150,seq96,seq75,r_83_132_150,1.0,0,150,150,27
7,r_80_2_222,seq141,r_136_68_158,r_136_68_158,0.99,-2,156,158,27
44,r_60_11_72,r_54_87_161,r_139_149_284,r_60_11_72,0.96,0,72,72,27
23,r_38_122_83,r_46_102_164,r_3_15_149,r_38_122_83,0.99,0,83,83,27
82,seq82,seq12,r_50_95_168,r_50_95_168,1.0,1,169,168,27
35,r_66_24_104,seq143,r_19_134_287,r_66_24_104,1.0,-1,103,104,27
12,r_16_137_289,r_3_15_149,r_144_53_76,r_16_137_289,1.0,-166,123,289,27
23,r_38_122_83,r_3_15_149,r_144_53_76,r_3_15_149,1.0,1,150,149,27
40,r_142_115_152,r_60_125_62,seq82,r_60_125_62,0.72,90,152,62,28
30,r_81_83_76,r_38_53_213,seq129,r_81_83_76,0.85,1,77,76,28
51,seq2,r_54_107_230,r_75_131_205,r_54_107_230,0.81,0,230,230,28
53,seq5,r_123_11_217,r_59_110_98,r_59_110_98,1.0,2,100,98,28
31,r_67_36_15,r_56_88_273,seq92,r_67_36_15,0.74,0,15,15,28
16,r_16_95_251,r_132_71_199,r_21_122_178,r_16_95_251,0.56,-48,203,251,28
21,r_40_121_69,r_149_4_194,seq51,r_40_121_69,1.0,0,69,69,28
39,r_55_78_221,r_75_131_205,seq108,r_55_78_221,0.99,0,221,221,28
1,r_41_143_119,r_26_47_147,r_43_114_53,r_41_143_119,0.94,1,120,119,28
5,r_64_28_106,seq12,seq63,r_64_28_106,0.92,0,106,106,28
42,r_60_125_62,seq104,r_142_115_152,r_60_125_62,0.84,34,96,62,28
7,r_46_58_256,r_65_74_22,r_37_105_150,r_46_58_256,0.62,-201,55,256,28
45,r_27_13_102,seq25,r_59_110_98,r_59_110_98,0.36,4,102,98,28
24,r_137_141_16,seq80,r_60_125_62,r_137_141_16,1.0,2,18,16,28
19,r_66_101_186,seq52,r_26_47_147,r_66_101_186,0.98,0,186,186,28
33,r_134_23_162,seq104,r_46_58_256,r_134_23_162,1.0,0,162,162,28
29,r_33_19_38,r_66_101_186,seq35,r_33_19_38,1.0,0,38,38,28
66,seq30,r_54_107_230,r_75_131_205,r_54_107_230,0.8,0,230,230,28
0,r_17_0_33,seq15,seq97,r_17_0_33,1.0,0,33,33,28
41,r_75_131_205,r_55_78_221,seq50,r_55_78_221,0.54,-11,210,221,28
14,r_116_133_26,r_130_127_212,seq12,r_116_133_26,1.0,0,26,26,28
42,r_60_125_62,r_142_115_152,seq86,r_142_115_152,1.0,0,152,152,28
3,r_62_103_65,r_134_23_162,seq9,r_134_23_162,0.88,-97,65,162,28
10,r_139_145_200,seq44,r_134_23_162,r_134_23_162,1.0,42,204,162,28
26,r_31_57_11,seq9,r_38_53_213,r_38_53_213,0.95,3,216,213,28
72,seq50,r_130_127_212,r_75_131_205,r_130_127_212,0.76,0,212,212,28
11,r_38_53_213,r_102_112_207,r_31_57_11,r_38_53_213,1.0,0,213,213,28
13,r_21_122_178,seq86,r_116_133_26,r_21_122_178,0.6,0,178,178,28
30,r_81_83_76,seq129,r_31_57_11,r_81_83_76,0.69,33,109,76,28
15,r_56_88_273,seq97,r_41_143_119,r_41_143_119,0.72,154,273,119,28
40,r_142_115_152,r_89_96_34,r_60_125_62,r_89_96_34,1.0,2,36,34,28
57,seq10,r_102_112_207,seq69,r_102_112_207,0.69,6,213,207,28
6,r_132_71_199,r_16_95_251,seq18,r_132_71_199,0.95,0,199,199,28
7,r_46_58_256,r_37_105_150,r_132_71_199,r_37_105_150,1.0,-45,105,150,28
40,r_142_115_152,seq82,r_38_53_213,r_142_115_152,0.78,128,280,152,28
46,r_90_93_48,r_24_45_286,seq73,r_90_93_48,1.0,0,48,48,28
20,r_100_111_14,r_91_148_277,seq135,r_100_111_14,0.81,0,14,14,28
36,r_89_96_34,r_123_11_217,r_34_49_121,r_34_49_121,0.88,8,129,121,28
27,r_77_136_209,seq51,seq144,r_77_136_209,0.7,5,214,209,28
9,r_79_119_267,r_27_13_102,r_24_45_286,r_27_13_102,0.8,-57,45,102,28
79,seq73,seq35,r_90_93_48,r_90_93_48,1.0,0,48,48,28
2,r_37_105_150,seq3,seq97,r_37_105_150,0.97,1,151,150,28
47,r_54_107_230,seq30,seq1,r_54_107_230,0.57,0,230,230,28
36,r_89_96_34,r_142_115_152,r_123_11_217,r_89_96_34,1.0,0,34,34,28
25,r_59_110_98,seq2,seq5,r_59_110_98,0.99,0,98,98,28
33,r_134_23_162,r_62_103_65,seq104,r_62_103_65,1.0,0,65,65,28
64,seq25,r_27_13_102,seq144,r_27_13_102,0.98,1,103,102,28
70,seq135,r_149_4_194,r_100_111_14,r_149_4_194,0.85,0,194,194,28
37,r_43_114_53,r_72_32_245,seq84,r_43_114_53,0.51,1,54,53,28
7,r_46_58_256,r_132_71_199,r_134_23_162,r_134_23_162,1.0,9,171,162,28
34,r_34_49_121,r_48_22_105,r_89_96_34,r_34_49_121,0.65,-16,105,121,28
33,r_134_23_162,r_46_58_256,r_139_145_200,r_46_58_256,1.0,-6,250,256,28
16,r_16_95_251,r_21_122_178,r_41_143_119,r_16_95_251,0.87,4,255,251,28
17,r_147_61_233,seq15,r_48_22_105,r_48_22_105,0.48,125,230,105,28
22,r_48_22_105,r_34_49_121,seq51,r_48_22_105,0.81,-1,104,105,28
7,r_46_58_256,r_134_23_162,r_90_93_48,r_46_58_256,0.97,0,256,256,28
28,r_102_112_207,seq10,seq15,r_102_112_207,0.42,2,209,207,28
91,seq104,r_60_125_62,seq113,r_60_125_62,0.89,46,108,62,28
49,r_149_4_194,seq135,r_34_49_121,r_149_4_194,0.75,0,194,194,28
56,seq9,seq129,r_62_103_65,r_62_103_65,0.98,6,71,65,28
23,r_72_32_245,seq1,r_37_105_150,r_37_105_150,0.8,95,245,150,28
35,r_130_127_212,seq50,seq80,r_130_127_212,0.87,0,212,212,28
12,r_42_70_174,r_132_71_199,r_59_110_98,r_42_70_174,0.97,0,174,174,28
93,seq107,r_22_69_250,r_79_112_96,r_79_112_96,0.96,10,106,96,29
30,r_25_128_210,r_6_139_189,seq78,r_6_139_189,0.84,0,189,189,29
27,r_48_96_43,r_115_56_241,seq12,r_48_96_43,0.99,1,44,43,29
36,r_17_21_264,seq14,r_88_142_15,r_88_142_15,0.88,252,267,15,29
14,r_146_145_109,r_25_128_210,seq138,r_146_145_109,1.0,3,112,109,29
8,r_18_101_173,seq71,r_105_63_95,r_105_63_95,0.97,79,174,95,29
54,seq134,r_60_52_94,r_40_132_52,r_60_52_94,1.0,27,121,94,29
37,r_5_0_276,seq12,r_48_96_43,r_48_96_43,1.0,153,196,43,29
16,r_32_53_91,r_72_55_159,seq46,r_32_53_91,0.95,1,92,91,29
39,r_72_55_159,r_31_36_275,r_59_1_296,r_72_55_159,0.99,2,161,159,29
1,r_126_135_63,r_114_7_280,seq23,r_126_135_63,1.0,2,65,63,29
5,r_6_139_189,r_25_128_210,r_110_91_26,r_6_139_189,0.97,0,189,189,29
46,r_136_20_191,seq127,r_118_89_196,r_136_20_191,0.9,3,194,191,29
42,r_108_137_107,r_27_51_284,seq143,r_108_137_107,0.95,0,107,107,29
45,r_60_52_94,r_148_15_169,seq61,r_60_52_94,0.85,12,106,94,29
10,r_88_142_15,r_6_139_189,r_60_52_94,r_88_142_15,0.96,0,15,15,29
31,r_47_76_86,r_118_89_196,seq61,r_47_76_86,0.97,0,86,86,29
41,r_86_57_157,seq98,seq85,r_86_57_157,0.77,7,164,157,29
3,r_50_30_79,r_148_15_169,seq14,r_50_30_79,0.92,1,80,79,29
0,r_123_75_288,r_120_8_5,r_24_65_237,r_123_75_288,0.5,0,288,288,29
0,r_123_75_288,r_31_36_275,r_120_8_5,r_31_36_275,0.56,-2,273,275,29
11,r_79_112_96,seq138,seq107,r_79_112_96,1.0,1,97,96,29
20,r_105_63_95,seq12,r_67_43_47,r_105_63_95,0.88,0,95,95,29
13,r_82_10_179,r_115_56_241,r_114_7_280,r_115_56_241,0.34,-88,153,241,29
29,r_110_91_26,r_125_147_181,seq99,r_110_91_26,1.0,0,26,26,29
15,r_83_74_233,seq26,seq90,r_83_74_233,0.94,1,234,233,29
57,seq130,r_114_7_280,r_79_112_96,r_79_112_96,0.99,184,280,96,29
13,r_82_10_179,r_114_7_280,r_122_3_110,r_82_10_179,1.0,0,179,179,29
6,r_38_13_201,seq99,r_122_3_110,r_122_3_110,1.0,19,129,110,29
99,seq127,r_136_20_191,seq71,r_136_20_191,1.0,0,191,191,29
10,r_88_142_15,r_60_52_94,r_40_132_52,r_60_52_94,1.0,27,121,94,29
2,r_22_69_250,seq107,r_120_8_5,r_120_8_5,0.64,245,250,5,29
47,r_113_45_192,seq14,r_82_10_179,r_113_45_192,0.94,3,195,192,29
18,r_40_132_52,r_148_15_169,r_88_142_15,r_148_15_169,0.72,1,170,169,29
24,r_115_56_241,seq90,r_41_28_11,r_115_56_241,0.77,0,241,241,29
40,r_54_94_40,seq143,seq4,r_54_94_40,1.0,0,40,40,29
33,r_81_49_216,seq61,r_106_35_151,r_106_35_151,0.75,70,221,151,29
58,seq14,r_17_21_264,r_50_30_79,r_50_30_79,1.0,188,267,79,29
6,r_38_13_201,r_122_3_110,seq84,r_38_13_201,1.0,0,201,201,29
65,seq34,r_122_3_110,seq104,r_122_3_110,1.0,0,110,110,29
20,r_105_63_95,r_67_43_47,r_18_101_173,r_18_101_173,0.94,9,182,173,29
68,seq46,seq64,r_32_53_91,r_32_53_91,1.0,3,94,91,29
38,r_33_73_281,seq107,r_118_89_196,r_118_89_196,0.9,85,281,196,29
25,r_41_28_11,r_17_21_264,seq2,r_41_28_11,1.0,0,11,11,29
44,r_9_97_29,seq34,seq92,r_9_97_29,0.99,0,29,29,29
32,r_67_43_47,seq100,seq124,r_67_43_47,0.52,6,53,47,29
21,r_80_102_35,r_38_13_201,r_67_43_47,r_80_102_35,0.97,0,35,35,29
9,r_148_15_169,r_40_132_52,seq138,r_148_15_169,0.95,1,170,169,29
37,r_5_0_276,r_48_96_43,r_122_3_110,r_5_0_276,0.46,2,278,276,29
28,r_59_1_296,seq23,r_72_55_159,r_72_55_159,1.0,30,189,159,29
49,r_118_89_196,seq77,r_136_20_191,r_136_20_191,0.93,24,215,191,29
7,r_116_149_209,seq103,seq70,r_116_149_209,0.64,6,215,209,29
23,r_122_3_110,seq34,r_38_13_201,r_122_3_110,0.97,0,110,110,29
35,r_125_147_181,seq61,r_106_35_151,r_125_147_181,0.45,2,183,181,29
12,r_27_51_284,seq70,r_82_10_179,r_82_10_179,0.86,105,284,179,29
23,r_122_3_110,r_38_13_201,r_82_10_179,r_122_3_110,0.99,91,201,110,29
40,r_36_48_234,r_69_21_65,seq33,r_36_48_234,0.51,1,235,234,30
30,r_81_80_226,r_76_146_295,seq70,r_81_80_226,0.89,0,226,226,30
44,r_51_117_238,r_44_42_195,seq145,r_44_42_195,0.85,1,196,195,30
36,r_50_98_187,r_36_48_234,r_11_79_156,r_36_48_234,0.92,-47,187,234,30
14,r_9_95_72,seq2,r_82_52_32,r_9_95_72,1.0,-1,71,72,30
8,r_71_19_59,seq62,r_49_43_134,r_71_19_59,1.0,1,60,59,30
49,r_134_3_58,seq31,r_125_106_211,r_134_3_58,1.0,0,58,58,30
37,r_90_99_148,r_93_6_262,seq60,r_90_99_148,1.0,1,149,148,30
19,r_46_104_133,r_58_61_254,r_105_147_128,r_58_61_254,0.94,2,256,254,30
55,seq130,r_17_74_285,r_0_83_204,r_0_83_204,0.83,73,277,204,30
71,seq59,r_11_79_156,r_82_52_32,r_11_79_156,0.9,-1,155,156,30
16,r_49_43_134,seq89,seq31,r_49_43_134,1.0,1,135,134,30
39,r_0_83_204,r_125_106_211,seq126,r_0_83_204,0.87,7,211,204,30
5,r_58_61_254,r_23_102_143,r_46_104_133,r_58_61_254,0.98,-117,137,254,30
46,r_7_22_137,seq10,seq60,r_7_22_137,0.91,0,137,137,30
80,seq73,r_128_131_228,r_69_21_65,r_69_21_65,1.0,114,179,65,30
7,r_128_131_228,seq73,r_32_35_20,r_128_131_228,0.95,0,228,228,30
45,r_119_24_167,seq54,r_82_52_32,r_119_24_167,1.0,1,168,167,30
19,r_46_104_133,r_137_12_34,r_58_61_254,r_46_104_133,0.99,0,133,133,30
89,seq144,r_13_97_229,seq86,r_13_97_229,1.0,1,230,229,30
3,r_29_53_124,r_58_61_254,seq39,r_58_61_254,0.74,-127,127,254,30
10,r_8_135_177,r_76_146_295,r_129_30_91,r_129_30_91,1.0,63,154,91,30
44,r_51_117_238,r_129_30_91,r_44_42_195,r_129_30_91,0.63,-70,21,91,30
11,r_5_133_289,r_125_106_211,r_28_103_241,r_5_133_289,1.0,1,290,289,30
26,r_75_87_286,seq68,r_69_21_65,r_69_21_65,1.0,221,286,65,30
8,r_71_19_59,r_49_43_134,r_41_94_102,r_71_19_59,1.0,64,123,59,30
72,seq60,seq55,r_90_99_148,r_90_99_148,1.0,34,182,148,30
4,r_69_21_65,r_41_94_102,r_36_48_234,r_36_48_234,1.0,-170,64,234,30
0,r_125_106_211,r_0_83_204,r_5_133_289,r_125_106_211,0.88,0,211,211,30
73,seq62,r_71_19_59,r_137_12_34,r_71_19_59,1.0,1,60,59,30
11,r_5_133_289,r_28_103_241,r_125_106_211,r_5_133_289,0.9,-58,231,289,30
20,r_123_101_278,seq68,r_116_110_205,r_123_101_278,0.43,0,278,278,30
13,r_138_115_275,seq63,r_51_117_238,r_138_115_275,0.52,0,275,275,30
15,r_23_102_143,r_58_61_254,r_7_22_137,r_23_102_143,0.98,3,146,143,30
49,r_134_3_58,r_125_106_211,r_34_47_151,r_34_47_151,0.71,61,212,151,30
4,r_69_21_65,r_36_48_234,seq73,r_36_48_234,0.83,1,235,234,30
12,r_32_35_20,r_14_111_227,r_128_131_228,r_32_35_20,0.53,208,228,20,30
6,r_127_124_9,r_76_146_295,r_129_30_91,r_129_30_91,1.0,194,285,91,30
62,seq31,seq63,r_49_43_134,r_49_43_134,1.0,1,135,134,30
5,r_58_61_254,r_46_104_133,seq56,r_58_61_254,0.8,2,256,254,30
52,seq10,seq4,r_28_103_241,r_28_103_241,0.99,-2,239,241,30
0,r_125_106_211,r_5_133_289,r_128_131_228,r_5_133_289,0.92,1,290,289,30
41,r_84_37_26,r_5_133_289,r_114_77_206,r_84_37_26,1.0,0,26,26,30
27,r_41_94_102,r_14_111_227,r_71_19_59,r_41_94_102,0.96,1,103,102,30
31,r_114_77_206,seq91,r_84_37_26,r_84_37_26,0.98,15,41,26,30
12,r_32_35_20,r_49_43_134,r_14_111_227,r_32_35_20,1.0,0,20,20,30
41,r_84_37_26,r_114_77_206,r_148_142_142,r_84_37_26,0.4,190,216,26,30
47,r_17_74_285,seq130,r_69_21_65,r_69_21_65,0.98,221,286,65,30
40,r_36_48_234,r_50_98_187,r_69_21_65,r_69_21_65,1.0,10,75,65,30
74,seq63,r_138_115_275,r_49_43_134,r_49_43_134,1.0,141,275,134,30
18,r_129_30_91,r_93_6_262,r_8_135_177,r_129_30_91,1.0,0,91,91,30
24,r_15_27_283,seq145,r_41_94_102,r_41_94_102,0.56,181,283,102,30
33,r_13_97_229,seq144,seq89,r_13_97_229,0.93,1,230,229,30
50,seq2,r_9_95_72,seq143,r_9_95_72,1.0,-1,71,72,30
32,r_11_79_156,seq59,seq68,r_11_79_156,1.0,-1,155,156,30
38,r_136_141_126,seq55,seq25,r_136_141_126,1.0,2,128,126,30
52,seq10,r_7_22_137,seq4,r_7_22_137,0.93,0,137,137,30
2,r_82_52_32,seq33,seq59,r_82_52_32,0.86,7,39,32,30
17,r_28_103_241,r_5_133_289,seq10,r_28_103_241,0.91,0,241,241,30
9,r_148_142_142,r_34_47_151,seq4,r_34_47_151,0.74,1,152,151,30
22,r_118_149_85,r_128_131_228,r_137_12_34,r_118_149_85,0.99,0,85,85,30
43,r_26_45_33,r_125_106_211,r_127_124_9,r_26_45_33,1.0,0,33,33,30
7,r_128_131_228,r_118_149_85,seq73,r_118_149_85,1.0,0,85,85,30
23,r_14_111_227,r_41_94_102,r_32_35_20,r_14_111_227,0.74,-124,103,227,30
35,r_34_47_151,r_148_142_142,r_134_3_58,r_148_142_142,0.95,11,153,142,30
23,r_14_111_227,r_32_35_20,r_82_52_32,r_14_111_227,0.97,1,228,227,30
30,r_96_124_40,r_112_116_202,r_75_126_88,r_75_126_88,0.51,87,175,88,31
8,r_90_107_134,seq60,r_56_102_236,r_90_107_134,0.83,0,134,134,31
43,r_38_18_63,r_91_148_283,seq9,r_38_18_63,1.0,0,63,63,31
86,seq94,r_4_123_278,r_35_45_114,r_35_45_114,1.0,0,114,114,31
39,r_6_132_156,r_19_41_289,seq59,r_6_132_156,1.0,1,157,156,31
46,r_39_144_133,seq142,seq2,r_39_144_133,0.99,0,133,133,31
42,r_77_14_178,seq78,r_42_98_30,r_77_14_178,0.89,0,178,178,31
6,r_30_61_268,seq26,r_65_3_227,r_65_3_227,0.9,7,234,227,31
45,r_101_117_242,r_145_50_1,seq36,r_145_50_1,0.42,246,247,1,31
9,r_57_133_17,r_112_116_202,r_118_70_16,r_57_133_17,1.0,0,17,17,31
19,r_86_74_121,seq53,r_57_133_17,r_57_133_17,0.98,118,135,17,31
27,r_118_70_16,r_65_3_227,r_86_74_121,r_118_70_16,0.55,211,227,16,31
12,r_65_3_227,r_30_61_268,r_17_103_280,r_30_61_268,1.0,0,268,268,31
67,seq31,r_35_45_114,seq20,r_35_45_114,1.0,-3,111,114,31
10,r_23_81_70,seq78,seq32,r_23_81_70,1.0,0,70,70,31
8,r_90_107_134,r_56_102_236,r_149_58_161,r_90_107_134,0.77,106,240,134,31
4,r_1_119_221,seq46,seq21,r_1_119_221,0.75,0,221,221,31
0,r_27_71_117,seq147,seq20,r_27_71_117,0.93,0,117,117,31
15,r_140_13_254,seq125,r_27_71_117,r_27_71_117,0.76,138,255,117,31
48,r_22_34_285,seq142,r_0_44_212,r_0_44_212,1.0,12,224,212,31
12,r_65_3_227,r_118_70_16,r_30_61_268,r_65_3_227,0.61,0,227,227,31
18,r_62_67_31,seq85,r_87_130_295,r_62_67_31,1.0,0,31,31,31
62,seq16,seq32,r_15_43_71,r_15_43_71,0.92,59,130,71,31
99,seq127,r_105_97_81,r_25_47_9,r_105_97_81,0.96,-8,73,81,31
79,seq76,r_42_98_30,seq10,r_42_98_30,1.0,0,30,30,31
13,r_73_136_34,r_140_13_254,seq68,r_73_136_34,0.97,-1,33,34,31
47,r_15_43_71,r_101_117_242,seq16,r_15_43_71,0.74,-1,70,71,31
40,r_19_41_289,seq128,r_33_55_57,r_33_55_57,1.0,232,289,57,31
74,seq54,seq84,r_72_146_130,r_72_146_130,0.46,0,130,130,31
29,r_145_50_1,r_28_64_204,r_112_116_202,r_112_116_202,0.56,2,204,202,31
38,r_42_98_30,seq76,seq7,r_42_98_30,1.0,0,30,30,31
24,r_109_66_153,seq115,r_39_144_133,r_39_144_133,0.94,36,169,133,31
25,r_135_113_138,r_65_3_227,seq94,r_135_113_138,0.99,0,138,138,31
33,r_37_24_273,seq2,r_49_139_187,r_37_24_273,0.24,3,276,273,31
48,r_22_34_285,r_0_44_212,r_105_97_81,r_22_34_285,0.98,0,285,285,31
70,seq46,r_1_119_221,seq16,r_1_119_221,0.96,0,221,221,31
68,seq32,r_75_126_88,r_23_81_70,r_23_81_70,0.93,0,70,70,31
61,seq143,r_91_148_283,r_112_116_202,r_112_116_202,0.79,81,283,202,31
52,seq2,r_37_24_273,r_39_144_133,r_39_144_133,1.0,143,276,133,31
12,r_65_3_227,r_25_47_9,r_118_70_16,r_118_70_16,0.74,3,19,16,31
21,r_138_88_51,r_87_130_295,r_145_50_1,r_138_88_51,1.0,0,51,51,31
34,r_105_97_81,seq127,seq80,r_105_97_81,0.75,0,81,81,31
84,seq85,r_62_67_31,r_112_116_202,r_62_67_31,0.78,-5,26,31,31
32,r_40_83_44,r_87_130_295,seq10,r_40_83_44,0.93,0,44,44,31
13,r_73_136_34,seq68,r_33_55_57,r_33_55_57,0.86,32,89,57,31
60,seq142,r_39_144_133,r_22_34_285,r_39_144_133,1.0,-38,95,133,31
26,r_100_51_10,r_4_123_278,seq95,r_100_51_10,0.73,0,10,10,31
17,r_0_44_212,seq121,r_22_34_285,r_0_44_212,0.92,0,212,212,31
27,r_118_70_16,r_109_66_153,r_65_3_227,r_118_70_16,1.0,0,16,16,31
94,seq115,r_109_66_153,seq26,r_109_66_153,0.67,25,178,153,31
87,seq95,r_92_82_42,r_100_51_10,r_92_82_42,0.97,-31,11,42,31
31,r_106_8_276,r_118_70_16,r_4_123_278,r_4_123_278,0.93,4,282,278,31
22,r_75_126_88,seq32,r_96_124_40,r_75_126_88,1.0,-2,86,88,31
28,r_112_116_202,seq7,r_145_50_1,r_112_116_202,0.73,1,203,202,31
49,r_35_45_114,seq31,seq94,r_35_45_114,0.98,0,114,114,31
2,r_33_55_57,r_6_132_156,r_73_136_34,r_33_55_57,1.0,-2,55,57,31
7,r_149_58_161,seq63,r_90_107_134,r_149_58_161,0.96,0,161,161,31
44,r_28_64_204,r_145_50_1,seq32,r_28_64_204,0.48,0,204,204,31
17,r_0_44_212,r_22_34_285,seq142,r_22_34_285,0.95,0,285,285,31
6,r_30_61_268,r_65_3_227,r_118_70_16,r_30_61_268,0.74,0,268,268,31
31,r_106_8_276,r_92_82_42,r_118_70_16,r_106_8_276,0.7,-240,36,276,31
60,seq142,r_22_34_285,r_0_44_212,r_0_44_212,1.0,73,285,212,31
35,r_49_139_187,seq114,r_38_18_63,r_38_18_63,0.97,128,191,63,31
56,seq7,r_112_116_202,r_42_98_30,r_42_98_30,1.0,0,30,30,31
58,seq10,seq76,r_40_83_44,r_40_83_44,1.0,1,45,44,31
30,r_75_86_110,seq34,r_31_134_74,r_75_86_110,0.99,0,110,110,32
36,r_102_43_199,seq80,seq117,r_102_43_199,0.98,0,199,199,32
92,seq108,r_142_110_141,r_52_128_140,r_52_128_140,1.0,12,152,140,32
14,r_52_128_140,r_79_30_253,r_130_133_40,r_52_128_140,1.0,0,140,140,32
17,r_42_101_178,r_123_114_188,r_56_45_50,r_56_45_50,1.0,6,56,50,32
37,r_139_36_231,seq25,seq76,r_139_36_231,0.75,0,231,231,32
16,r_60_51_89,seq34,seq54,r_60_51_89,1.0,-1,88,89,32
39,r_85_33_261,seq55,r_106_37_105,r_106_37_105,0.46,156,261,105,32
1,r_40_84_79,r_147_132_282,seq55,r_40_84_79,0.99,-8,71,79,32
97,seq117,r_147_132_282,r_102_43_199,r_102_43_199,1.0,1,200,199,32
46,r_145_131_90,r_32_103_170,r_123_114_188,r_123_114_188,0.95,10,198,188,32
42,r_4_122_173,r_35_140_243,seq93,r_4_122_173,0.5,12,185,173,32
19,r_6_125_233,seq77,r_31_134_74,r_6_125_233,0.75,0,233,233,32
43,r_56_45_50,r_142_110_141,r_42_101_178,r_56_45_50,1.0,-1,49,50,32
31,r_62_53_277,seq96,r_119_141_241,r_119_141_241,0.78,19,260,241,32
41,r_68_94_108,seq78,seq16,r_68_94_108,0.71,0,108,108,32
26,r_135_137_73,r_139_36_231,seq47,r_135_137_73,0.63,1,74,73,32
4,r_2_59_165,r_35_140_243,seq14,r_2_59_165,0.67,5,170,165,32
78,seq77,r_6_125_233,r_126_49_168,r_6_125_233,1.0,0,233,233,32
0,r_74_115_68,seq81,seq116,r_74_115_68,1.0,1,69,68,32
11,r_123_114_188,r_111_29_263,r_145_131_90,r_123_114_188,0.77,1,189,188,32
20,r_111_29_263,r_123_114_188,seq116,r_123_114_188,0.75,1,189,188,32
13,r_46_70_217,seq121,seq34,r_46_70_217,0.7,0,217,217,32
98,seq121,r_46_70_217,seq25,r_46_70_217,1.0,0,217,217,32
15,r_142_110_141,seq108,r_3_41_114,r_3_41_114,0.99,38,152,114,32
48,r_24_5_245,r_147_132_282,seq78,r_24_5_245,0.61,1,246,245,32
62,seq26,r_119_141_241,seq66,r_119_141_241,0.99,2,243,241,32
27,r_44_99_201,r_95_124_84,seq112,r_44_99_201,0.69,-52,149,201,32
87,seq93,seq72,r_4_122_173,r_4_122_173,0.71,-101,72,173,32
47,r_149_146_71,seq8,seq83,r_149_146_71,1.0,0,71,71,32
40,r_100_144_232,seq77,r_40_84_79,r_100_144_232,0.79,1,233,232,32
18,r_31_134_74,r_44_99_201,seq48,r_31_134_74,0.76,5,79,74,32
24,r_23_148_133,r_147_132_282,seq7,r_23_148_133,0.95,5,138,133,32
25,r_106_37_105,r_2_59_165,seq96,r_2_59_165,0.68,-70,95,165,32
43,r_56_45_50,r_42_101_178,seq116,r_42_101_178,1.0,0,178,178,32
64,seq34,r_75_86_110,seq77,r_75_86_110,1.0,0,110,110,32
20,r_111_29_263,seq116,seq18,r_111_29_263,0.66,9,272,263,32
68,seq50,r_10_64_127,r_107_63_86,r_107_63_86,1.0,0,86,86,32
32,r_58_61_207,r_35_140_243,seq65,r_35_140_243,0.83,-36,207,243,32
38,r_79_30_253,seq65,r_138_57_249,r_79_30_253,0.78,0,253,253,32
77,seq76,seq80,r_139_36_231,r_139_36_231,0.82,13,244,231,32
34,r_95_124_84,r_44_99_201,r_87_15_95,r_95_124_84,0.67,52,136,84,32
64,seq34,seq77,r_46_70_217,r_46_70_217,1.0,0,217,217,32
75,seq72,seq93,r_87_15_95,r_87_15_95,0.62,61,156,95,32
81,seq81,r_74_115_68,seq91,r_74_115_68,1.0,1,69,68,32
94,seq112,seq93,r_44_99_201,r_44_99_201,0.38,-57,144,201,32
9,r_107_63_86,seq11,seq50,r_107_63_86,1.0,0,86,86,32
96,seq116,r_123_114_188,r_74_115_68,r_74_115_68,0.93,103,171,68,32
28,r_119_141_241,seq26,r_87_15_95,r_119_141_241,0.76,0,241,241,32
35,r_130_133_40,r_143_90_259,seq108,r_130_133_40,0.88,0,40,40,32
49,r_3_41_114,seq83,r_142_110_141,r_3_41_114,0.97,1,115,114,32
7,r_143_90_259,seq88,r_135_137_73,r_143_90_259,0.37,2,261,259,32
44,r_9_27_270,seq109,r_52_128_140,r_52_128_140,0.97,137,277,140,32
23,r_10_64_127,seq50,r_56_45_50,r_56_45_50,1.0,87,137,50,32
17,r_42_101_178,r_56_45_50,r_23_148_133,r_42_101_178,1.0,0,178,178,32
79,seq78,r_68_94_108,r_31_134_74,r_68_94_108,0.45,0,108,108,32
12,r_118_89_265,seq66,r_31_134_74,r_118_89_265,0.58,1,266,265,32
40,r_7_110_48,r_133_2_176,seq74,r_133_2_176,1.0,1,177,176,33
30,r_23_4_191,seq93,seq88,r_23_4_191,0.97,0,191,191,33
51,seq130,seq117,r_135_83_64,r_135_83_64,1.0,62,126,64,33
36,r_15_122_127,r_129_138_211,r_109_118_77,r_15_122_127,1.0,0,127,127,33
43,r_98_21_224,r_41_50_288,r_134_18_179,r_98_21_224,0.88,0,224,224,33
86,seq86,seq74,r_99_47_265,r_99_47_265,0.95,2,267,265,33
37,r_124_1_274,r_77_76_249,r_119_34_70,r_119_34_70,1.0,179,249,70,33
42,r_112_62_129,r_145_36_148,r_71_146_136,r_112_62_129,0.71,15,144,129,33
86,seq86,r_42_78_25,seq74,r_42_78_25,0.42,171,196,25,33
16,r_129_138_211,r_135_83_64,seq81,r_135_83_64,0.99,8,72,64,33
21,r_55_22_80,r_53_107_261,r_123_139_204,r_55_22_80,1.0,2,82,80,33
1,r_99_47_265,r_87_137_69,seq86,r_99_47_265,0.56,0,265,265,33
1,r_99_47_265,seq70,r_87_137_69,r_87_137_69,1.0,5,74,69,33
46,r_43_111_202,r_145_36_148,r_71_146_136,r_43_111_202,0.59,-54,148,202,33
5,r_0_75_50,r_87_137_69,r_42_78_25,r_0_75_50,0.98,-2,48,50,33
42,r_112_62_129,seq94,r_145_36_148,r_112_62_129,0.57,0,129,129,33
80,seq70,seq132,r_87_137_69,r_87_137_69,1.0,28,97,69,33
45,r_52_121_122,seq130,seq9,r_52_121_122,1.0,0,122,122,33
2,r_85_72_33,r_148_127_280,seq143,r_85_72_33,1.0,2,35,33,33
19,r_66_114_137,r_40_10_157,seq81,r_40_10_157,0.95,-12,145,157,33
11,r_133_2_176,r_7_110_48,r_17_60_164,r_17_60_164,0.78,13,177,164,33
95,seq102,r_71_146_136,seq89,r_71_146_136,1.0,0,136,136,33
66,seq28,r_40_10_157,r_135_83_64,r_40_10_157,0.92,1,158,157,33
76,seq59,r_148_127_280,r_115_49_222,r_148_127_280,0.36,0,280,280,33
31,r_53_107_261,seq80,r_133_2_176,r_53_107_261,0.54,0,261,261,33
3,r_119_34_70,seq16,seq132,r_119_34_70,1.0,0,70,70,33
38,r_37_30_235,r_71_146_136,seq102,r_37_30_235,1.0,0,235,235,33
16,r_129_138_211,seq81,seq94,r_129_138_211,0.91,0,211,211,33
26,r_25_12_42,r_145_36_148,r_125_105_31,r_25_12_42,0.84,0,42,42,33
4,r_40_10_157,seq28,seq16,r_40_10_157,0.61,1,158,157,33
0,r_135_83_64,r_129_138_211,seq130,r_129_138_211,0.88,-139,72,211,33
11,r_133_2_176,seq74,r_7_110_48,r_133_2_176,0.52,-98,78,176,33
20,r_126_144_158,r_77_76_249,seq79,r_126_144_158,1.0,0,158,158,33
13,r_71_146_136,seq102,r_112_62_129,r_71_146_136,1.0,0,136,136,33
15,r_92_82_99,seq9,seq64,r_92_82_99,0.99,1,100,99,33
48,r_106_142_81,seq5,seq117,r_106_142_81,1.0,0,81,81,33
44,r_134_18_179,seq149,r_98_21_224,r_98_21_224,0.99,-1,223,224,33
57,seq13,r_136_68_112,seq149,r_136_68_112,1.0,0,112,112,33
85,seq81,r_129_138_211,r_66_114_137,r_129_138_211,0.87,-68,143,211,33
5,r_0_75_50,r_42_78_25,seq58,r_0_75_50,0.63,89,139,50,33
87,seq88,seq14,r_23_4_191,r_23_4_191,1.0,1,192,191,33
91,seq94,r_92_82_99,r_129_138_211,r_129_138_211,1.0,0,211,211,33
40,r_7_110_48,seq58,r_133_2_176,r_7_110_48,0.41,7,55,48,33
18,r_87_137_69,seq33,r_99_47_265,r_87_137_69,1.0,0,69,69,33
24,r_77_76_249,r_124_1_274,r_17_60_164,r_77_76_249,0.74,0,249,249,33
25,r_17_60_164,seq79,seq93,r_17_60_164,0.97,0,164,164,33
33,r_109_118_77,seq44,seq20,r_109_118_77,1.0,0,77,77,33
88,seq89,r_63_35_189,seq102,r_63_35_189,1.0,0,189,189,33
38,r_37_30_235,r_43_111_202,r_71_146_136,r_71_146_136,0.93,67,203,136,33
46,r_43_111_202,r_71_146_136,r_109_118_77,r_43_111_202,1.0,1,203,202,33
34,r_108_51_160,r_125_105_31,seq45,r_108_51_160,0.59,0,160,160,33
37,r_124_1_274,r_119_34_70,r_52_121_122,r_124_1_274,0.45,0,274,274,33
60,seq16,r_119_34_70,seq5,r_119_34_70,1.0,0,70,70,33
81,seq73,r_101_24_184,seq19,r_101_24_184,0.98,-15,169,184,33
17,r_8_120_102,seq6,seq45,r_8_120_102,1.0,0,102,102,33
9,r_125_105_31,r_108_51_160,r_25_12_42,r_125_105_31,1.0,129,160,31,33
56,seq9,r_97_57_27,r_52_121_122,r_52_121_122,1.0,-1,121,122,33
49,r_97_57_27,seq81,seq9,r_97_57_27,1.0,3,30,27,33
22,r_141_104_226,seq69,seq94,r_141_104_226,0.91,0,226,226,33
28,r_100_38_133,seq94,r_123_139_204,r_100_38_133,1.0,0,133,133,33
56,seq9,r_92_82_99,r_97_57_27,r_97_57_27,0.59,73,100,27,33
7,r_63_35_189,seq89,seq132,r_63_35_189,1.0,0,189,189,33
18,r_87_137_69,r_99_47_265,seq70,r_99_47_265,0.85,0,265,265,33
44,r_134_18_179,r_141_104_226,seq149,r_134_18_179,0.7,0,179,179,33
23,r_41_50_288,seq64,seq3,r_41_50_288,0.39,0,288,288,33
82,seq74,r_133_2_176,r_7_110_48,r_133_2_176,0.56,-86,90,176,33
79,seq69,r_141_104_226,seq32,r_141_104_226,1.0,0,226,226,33
60,seq16,seq5,r_40_10_157,r_40_10_157,1.0,0,157,157,33
35,r_136_68_112,seq13,seq69,r_136_68_112,1.0,0,112,112,33
12,r_84_61_217,seq14,seq5,r_84_61_217,0.94,0,217,217,33
84,seq80,r_53_107_261,r_40_10_157,r_40_10_157,0.67,104,261,157,33
93,seq107,r_20_57_12,seq95,r_20_57_12,0.41,112,124,12,34
30,r_122_12_263,seq1,r_127_93_254,r_122_12_263,0.53,0,263,263,34
36,r_14_86_107,r_75_74_248,seq58,r_14_86_107,1.0,0,107,107,34
92,seq145,seq83,r_100_117_124,r_100_117_124,1.0,0,124,124,34
14,r_131_124_103,r_100_117_124,r_4_84_62,r_131_124_103,1.0,0,103,103,34
8,r_21_133_141,r_126_33_247,r_5_38_89,r_21_133_141,1.0,0,141,141,34
53,seq8,r_75_74_248,seq110,r_75_74_248,0.96,-41,207,248,34
43,r_136_76_221,r_36_70_169,seq27,r_36_70_169,0.58,-62,107,169,34
37,r_102_48_108,r_100_117_124,seq121,r_102_48_108,1.0,1,109,108,34
3,r_78_134_154,r_85_138_25,r_5_38_89,r_78_134_154,0.45,83,237,154,34
26,r_105_114_14,r_96_7_104,seq121,r_105_114_14,0.99,-1,13,14,34
86,seq88,r_100_117_124,seq140,r_100_117_124,1.0,0,124,124,34
39,r_35_141_148,r_36_70_169,seq50,r_35_141_148,0.62,11,159,148,34
65,seq37,seq87,r_89_139_44,r_89_139_44,1.0,0,44,44,34
5,r_128_99_232,seq69,r_39_54_1,r_128_99_232,0.67,3,235,232,34
46,r_42_146_266,seq82,seq8,r_42_146_266,0.51,0,266,266,34
45,r_18_11_163,seq68,seq92,r_18_11_163,1.0,0,163,163,34
19,r_6_46_278,seq98,r_128_99_232,r_6_46_278,0.44,1,279,278,34
15,r_144_63_164,r_127_93_254,r_32_59_43,r_127_93_254,1.0,0,254,254,34
33,r_39_54_1,r_102_48_108,r_5_38_89,r_39_54_1,0.78,206,207,1,34
76,seq68,r_18_11_163,seq81,r_18_11_163,1.0,-8,155,163,34
38,r_125_43_19,r_130_112_256,seq19,r_130_112_256,0.57,3,259,256,34
41,r_109_66_98,seq3,seq22,r_109_66_98,1.0,0,98,98,34
47,r_130_112_256,seq19,r_125_43_19,r_125_43_19,1.0,4,23,19,34
3,r_78_134_154,r_13_147_252,r_85_138_25,r_78_134_154,0.88,1,155,154,34
10,r_61_97_193,seq22,r_20_57_12,r_61_97_193,0.52,2,195,193,34
90,seq95,r_20_57_12,seq107,r_20_57_12,0.58,112,124,12,34
0,r_100_117_124,seq88,seq145,r_100_117_124,0.99,0,124,124,34
13,r_20_57_12,seq95,r_61_97_193,r_61_97_193,0.99,36,229,193,34
15,r_144_63_164,seq88,r_127_93_254,r_144_63_164,0.88,0,164,164,34
48,r_36_70_169,r_35_141_148,r_102_48_108,r_36_70_169,1.0,0,169,169,34
9,r_55_77_55,r_56_10_196,r_5_38_89,r_55_77_55,0.93,0,55,55,34
57,seq19,r_130_112_256,r_100_117_124,r_100_117_124,1.0,12,136,124,34
6,r_96_7_104,r_4_84_62,seq87,r_96_7_104,1.0,0,104,104,34
85,seq87,seq137,r_96_7_104,r_96_7_104,1.0,35,139,104,34
2,r_127_93_254,r_144_63_164,seq22,r_127_93_254,0.99,0,254,254,34
99,seq121,r_56_10_196,r_102_48_108,r_102_48_108,0.82,26,134,108,34
27,r_40_31_146,r_4_84_62,r_123_26_49,r_4_84_62,0.99,87,149,62,34
2,r_127_93_254,seq52,r_144_63_164,r_144_63_164,0.89,0,164,164,34
40,r_13_147_252,seq67,seq80,r_13_147_252,0.56,1,253,252,34
18,r_149_2_122,seq53,seq145,r_149_2_122,1.0,0,122,122,34
29,r_56_10_196,seq121,r_123_26_49,r_56_10_196,0.92,2,198,196,34
24,r_47_135_77,r_85_138_25,seq51,r_47_135_77,1.0,-1,76,77,34
35,r_4_84_62,r_40_31_146,r_131_124_103,r_4_84_62,0.99,87,149,62,34
43,r_136_76_221,seq27,seq22,r_136_76_221,1.0,0,221,221,34
33,r_39_54_1,r_104_62_64,r_102_48_108,r_102_48_108,0.99,19,127,108,34
16,r_123_26_49,r_96_7_104,seq69,r_123_26_49,0.96,-1,48,49,34
28,r_148_142_26,r_6_46_278,seq3,r_148_142_26,0.88,4,30,26,34
47,r_130_112_256,r_125_43_19,seq41,r_130_112_256,0.64,3,259,256,34
58,seq22,r_61_97_193,seq80,r_61_97_193,0.96,2,195,193,34
77,seq69,r_128_99_232,r_123_26_49,r_123_26_49,0.94,85,134,49,34
4,r_89_139_44,r_75_74_248,seq37,r_89_139_44,1.0,0,44,44,34
57,seq19,r_100_117_124,r_125_43_19,r_125_43_19,0.47,247,266,19,34
34,r_79_116_226,r_85_138_25,r_109_66_98,r_109_66_98,0.49,128,226,98,34
17,r_113_25_270,seq110,r_85_138_25,r_113_25_270,0.58,0,270,270,34
96,seq115,r_126_33_247,seq41,r_126_33_247,1.0,0,247,247,34
9,r_55_77_55,r_5_38_89,r_4_84_62,r_5_38_89,0.81,0,89,89,34
22,r_49_132_189,r_75_74_248,r_47_135_77,r_49_132_189,0.93,0,189,189,34
91,seq98,r_6_46_278,r_130_112_256,r_130_112_256,0.75,23,279,256,34
90,seq95,seq107,r_20_57_12,r_20_57_12,0.75,165,177,12,34
49,r_143_15_222,r_34_103_225,r_96_7_104,r_96_7_104,1.0,118,222,104,34
56,seq17,r_42_146_266,r_32_59_43,r_32_59_43,0.97,22,65,43,34
7,r_5_38_89,seq107,r_104_62_64,r_5_38_89,1.0,0,89,89,34
23,r_44_16_101,seq8,r_100_117_124,r_44_16_101,0.56,32,133,101,34
35,r_4_84_62,r_96_7_104,r_40_31_146,r_96_7_104,1.0,-34,70,104,34
38,r_125_43_19,r_100_117_124,r_130_112_256,r_130_112_256,0.76,-238,18,256,34
12,r_104_62_64,seq29,seq72,r_104_62_64,0.58,5,69,64,34
23,r_44_16_101,r_100_117_124,seq19,r_44_16_101,0.85,127,228,101,34
40,r_62_73_158,r_86_33_293,r_84_134_284,r_86_33_293,0.63,-8,285,293,35
44,r_19_51_153,r_23_0_6,seq124,r_19_51_153,1.0,0,153,153,35
36,r_91_21_166,seq58,seq128,r_91_21_166,1.0,0,166,166,35
92,seq145,r_54_24_258,r_60_96_10,r_60_96_10,0.85,250,260,10,35
8,r_139_30_184,r_86_33_293,seq65,r_139_30_184,0.95,0,184,184,35
43,r_34_94_173,seq136,seq117,r_34_94_173,1.0,0,173,173,35
37,r_59_141_217,seq64,seq88,r_59_141_217,0.44,9,226,217,35
55,seq136,r_76_3_155,r_60_96_10,r_76_3_155,0.91,0,155,155,35
71,seq48,r_53_38_154,seq117,r_53_38_154,1.0,-12,142,154,35
16,r_16_5_59,r_86_33_293,r_75_47_63,r_16_5_59,1.0,1,60,59,35
21,r_63_82_176,r_129_78_290,r_49_140_141,r_49_140_141,1.0,43,184,141,35
39,r_126_132_96,r_49_140_141,r_112_52_106,r_126_132_96,0.9,0,96,96,35
1,r_75_47_63,seq22,r_16_5_59,r_16_5_59,1.0,22,81,59,35
27,r_60_96_10,r_75_47_63,seq145,r_60_96_10,0.98,0,10,10,35
5,r_49_140_141,seq1,seq64,r_49_140_141,0.76,0,141,141,35
46,r_135_14_87,seq70,seq128,r_135_14_87,0.66,7,94,87,35
80,seq67,seq128,r_32_93_97,r_32_93_97,0.99,62,159,97,35
30,r_77_4_21,r_83_37_208,seq31,r_77_4_21,1.0,1,22,21,35
22,r_69_7_56,r_54_24_258,seq128,r_69_7_56,1.0,0,56,56,35
13,r_148_8_276,r_34_94_173,seq25,r_148_8_276,0.99,0,276,276,35
19,r_103_131_52,r_28_104_237,seq13,r_103_131_52,1.0,0,52,52,35
76,seq58,r_91_21_166,seq56,r_91_21_166,0.6,1,167,166,35
61,seq147,r_123_71_297,r_114_99_45,r_114_99_45,0.94,0,45,45,35
31,r_32_93_97,seq149,seq67,r_32_93_97,0.81,0,97,97,35
41,r_36_80_48,r_53_38_154,seq117,r_53_38_154,1.0,-12,142,154,35
10,r_53_38_154,r_148_8_276,seq92,r_53_38_154,1.0,1,155,154,35
90,seq101,r_19_51_153,r_23_0_6,r_19_51_153,0.99,-69,84,153,35
26,r_111_81_274,r_28_104_237,r_86_33_293,r_28_104_237,0.48,1,238,237,35
72,seq50,seq107,r_106_9_243,r_106_9_243,0.9,0,243,243,35
4,r_100_40_204,seq116,r_69_7_56,r_69_7_56,1.0,155,211,56,35
0,r_95_11_278,seq41,r_103_131_52,r_95_11_278,0.36,0,278,278,35
11,r_18_79_281,seq31,seq97,r_18_79_281,0.46,0,281,281,35
20,r_127_119_248,seq136,r_126_132_96,r_126_132_96,0.95,151,247,96,35
13,r_148_8_276,r_53_38_154,r_36_80_48,r_53_38_154,0.99,1,155,154,35
98,seq117,r_53_38_154,r_36_80_48,r_53_38_154,1.0,1,155,154,35
15,r_54_24_258,seq145,r_45_27_249,r_45_27_249,0.73,11,260,249,35
48,r_120_125_239,seq136,r_29_98_159,r_120_125_239,0.38,1,240,239,35
13,r_148_8_276,r_36_80_48,r_34_94_173,r_34_94_173,0.97,52,225,173,35
6,r_138_142_134,r_45_27_249,r_86_33_293,r_138_142_134,1.0,1,135,134,35
2,r_86_33_293,r_139_30_184,r_138_142_134,r_138_142_134,0.83,8,142,134,35
34,r_146_105_42,r_75_47_63,seq41,r_146_105_42,0.94,2,44,42,35
29,r_115_121_49,r_91_21_166,seq31,r_115_121_49,0.84,0,49,49,35
3,r_114_99_45,r_75_47_63,seq147,r_114_99_45,0.96,0,45,45,35
2,r_86_33_293,r_16_5_59,r_139_30_184,r_16_5_59,1.0,1,60,59,35
47,r_2_44_131,r_138_142_134,seq1,r_2_44_131,0.85,0,131,131,35
93,seq107,r_62_73_158,r_106_9_243,r_106_9_243,0.73,23,266,243,35
40,r_62_73_158,r_112_52_106,r_86_33_293,r_62_73_158,0.96,0,158,158,35
74,seq56,r_83_37_208,seq97,r_83_37_208,0.89,0,208,208,35
24,r_15_20_162,r_91_21_166,r_69_7_56,r_69_7_56,0.77,106,162,56,35
25,r_106_9_243,seq57,seq50,r_106_9_243,0.79,0,243,243,35
26,r_111_81_274,r_86_33_293,r_75_47_63,r_111_81_274,0.8,-6,268,274,35
33,r_26_122_149,seq107,r_69_7_56,r_26_122_149,1.0,2,151,149,35
50,seq128,r_100_40_204,r_91_21_166,r_91_21_166,1.0,-1,165,166,35
65,seq31,seq137,r_115_121_49,r_115_121_49,1.0,68,117,49,35
32,r_28_104_237,r_111_81_274,r_53_38_154,r_28_104_237,0.8,1,238,237,35
38,r_83_37_208,seq56,r_139_30_184,r_83_37_208,0.68,0,208,208,35
77,seq64,r_59_141_217,r_49_140_141,r_49_140_141,1.0,85,226,141,35
76,seq58,seq56,r_87_90_250,r_87_90_250,0.97,6,256,250,35
71,seq48,seq117,r_34_94_173,r_34_94_173,0.92,60,233,173,35
75,seq57,r_106_9_243,seq74,r_106_9_243,0.99,0,243,243,35
39,r_126_132_96,r_112_52_106,r_76_3_155,r_76_3_155,1.0,0,155,155,35
17,r_12_110_252,seq66,seq85,r_12_110_252,0.5,2,254,252,35
31,r_32_93_97,seq67,r_103_131_52,r_103_131_52,0.55,216,268,52,35
7,r_87_90_250,seq88,seq58,r_87_90_250,0.84,0,250,250,35
18,r_23_0_6,r_19_51_153,seq101,r_19_51_153,1.0,0,153,153,35
44,r_19_51_153,seq101,r_23_0_6,r_23_0_6,0.84,56,62,6,35
23,r_112_52_106,r_62_73_158,seq109,r_62_73_158,1.0,-21,137,158,35
35,r_45_27_249,seq25,r_53_38_154,r_45_27_249,0.55,0,249,249,35
84,seq74,r_106_9_243,seq57,r_106_9_243,1.0,0,243,243,35
93,seq103,r_116_16_176,r_82_84_77,r_116_16_176,0.79,-37,139,176,36
22,r_82_84_77,r_116_16_176,r_61_49_11,r_82_84_77,0.73,-33,44,77,36
30,r_63_92_226,seq13,r_130_89_295,r_63_92_226,0.8,3,229,226,36
51,seq128,seq42,r_1_126_205,r_1_126_205,0.63,52,257,205,36
32,r_93_108_179,r_26_60_292,seq147,r_93_108_179,0.6,50,229,179,36
28,r_141_27_177,seq29,seq83,r_141_27_177,0.96,2,179,177,36
6,r_100_37_249,seq10,r_87_45_19,r_87_45_19,0.86,33,52,19,36
14,r_50_122_112,seq78,r_63_92_226,r_50_122_112,0.96,2,114,112,36
53,seq3,r_145_70_193,r_120_135_127,r_120_135_127,0.82,67,194,127,36
43,r_129_132_131,r_94_140_21,seq9,r_129_132_131,0.99,0,131,131,36
15,r_121_58_32,r_31_142_235,seq80,r_121_58_32,0.8,0,32,32,36
83,seq76,r_110_66_200,r_54_21_86,r_54_21_86,0.98,113,199,86,36
37,r_115_56_110,seq78,seq14,r_115_56_110,0.92,2,112,110,36
71,seq46,r_96_119_208,seq137,r_96_119_208,0.7,-143,65,208,36
16,r_96_119_208,seq33,seq106,r_96_119_208,0.84,3,211,208,36
21,r_54_21_86,r_44_105_143,seq76,r_54_21_86,0.56,2,88,86,36
39,r_124_11_181,seq85,seq80,r_124_11_181,0.91,5,186,181,36
5,r_31_142_235,seq86,seq73,r_31_142_235,0.72,0,235,235,36
46,r_95_109_140,r_141_27_177,seq114,r_95_109_140,1.0,0,140,140,36
42,r_18_12_109,r_130_89_295,r_82_84_77,r_18_12_109,0.97,1,110,109,36
45,r_40_35_172,r_1_126_205,seq2,r_1_126_205,0.29,-75,130,205,36
24,r_143_41_88,r_7_65_151,seq14,r_7_65_151,1.0,1,152,151,36
19,r_62_131_101,seq14,seq86,r_62_131_101,1.0,5,106,101,36
12,r_133_15_10,r_144_38_190,seq83,r_133_15_10,0.56,7,17,10,36
11,r_7_65_151,r_143_41_88,seq73,r_7_65_151,1.0,7,158,151,36
66,seq33,r_96_119_208,seq34,r_96_119_208,0.92,-20,188,208,36
38,r_112_127_269,r_116_16_176,r_18_12_109,r_18_12_109,0.72,155,264,109,36
31,r_110_66_200,seq76,seq83,r_110_66_200,0.7,-1,199,200,36
89,seq86,r_31_142_235,r_62_131_101,r_62_131_101,0.83,134,235,101,36
3,r_1_126_205,r_40_35_172,seq67,r_40_35_172,0.75,-9,163,172,36
14,r_50_122_112,r_63_92_226,r_1_126_205,r_50_122_112,0.6,117,229,112,36
4,r_75_69_242,seq83,r_23_71_191,r_75_69_242,0.65,0,242,242,36
0,r_130_89_295,r_30_59_234,r_63_92_226,r_63_92_226,0.78,4,230,226,36
11,r_7_65_151,seq14,r_143_41_88,r_143_41_88,0.98,1,89,88,36
20,r_149_17_108,seq10,seq73,r_149_17_108,0.99,2,110,108,36
13,r_25_53_245,seq64,r_82_84_77,r_82_84_77,0.58,169,246,77,36
48,r_77_99_168,r_100_37_249,r_19_118_53,r_77_99_168,0.78,1,169,168,36
41,r_87_45_19,r_31_142_235,r_100_37_249,r_87_45_19,0.97,1,20,19,36
29,r_4_51_15,r_44_105_143,seq139,r_4_51_15,0.81,-1,14,15,36
10,r_19_118_53,seq72,r_77_99_168,r_77_99_168,0.87,2,170,168,36
27,r_94_140_21,r_23_71_191,r_40_35_172,r_94_140_21,0.99,170,191,21,36
2,r_44_105_143,r_54_21_86,r_121_58_32,r_54_21_86,0.67,2,88,86,36
41,r_87_45_19,r_100_37_249,seq34,r_100_37_249,0.49,0,249,249,36
47,r_91_104_272,seq14,r_62_131_101,r_62_131_101,1.0,171,272,101,36
40,r_81_102_84,r_1_126_205,seq0,r_81_102_84,0.95,0,84,84,36
18,r_23_71_191,r_94_140_21,seq114,r_23_71_191,0.97,0,191,191,36
24,r_143_41_88,seq139,r_7_65_151,r_143_41_88,0.99,0,88,88,36
25,r_98_88_134,seq2,seq73,r_98_88_134,0.99,2,136,134,36
33,r_120_135_127,r_91_104_272,seq3,r_120_135_127,0.97,0,127,127,36
65,seq29,seq42,r_116_16_176,r_116_16_176,0.53,93,269,176,36
50,seq0,r_145_70_193,r_81_102_84,r_81_102_84,0.84,31,115,84,36
58,seq10,seq137,r_144_38_190,r_144_38_190,1.0,29,219,190,36
70,seq43,r_26_60_292,r_50_122_112,r_50_122_112,1.0,91,203,112,36
6,r_100_37_249,r_87_45_19,r_115_56_110,r_115_56_110,0.99,139,249,110,36
32,r_93_108_179,r_96_119_208,r_26_60_292,r_93_108_179,0.55,0,179,179,36
38,r_112_127_269,r_40_35_172,r_116_16_176,r_112_127_269,0.54,-90,179,269,36
52,seq2,r_98_88_134,r_40_35_172,r_98_88_134,0.68,2,136,134,36
77,seq64,r_25_53_245,r_107_22_157,r_107_22_157,0.97,83,240,157,36
34,r_36_134_133,r_110_66_200,seq78,r_36_134_133,0.93,0,133,133,36
75,seq55,seq13,r_50_122_112,r_50_122_112,1.0,91,203,112,36
45,r_40_35_172,seq2,r_94_140_21,r_40_35_172,0.66,0,172,172,36
81,seq73,seq72,r_98_88_134,r_98_88_134,1.0,58,192,134,36
17,r_144_38_190,r_31_142_235,seq10,r_144_38_190,0.74,0,190,190,36
9,r_107_22_157,r_63_92_226,seq64,r_107_22_157,0.9,3,160,157,36
84,seq78,seq103,r_36_134_133,r_36_134_133,0.99,9,142,133,36
96,seq114,seq148,r_95_109_140,r_95_109_140,0.43,0,140,140,36
1,r_28_32_44,r_98_88_134,seq10,r_28_32_44,0.97,0,44,44,36
28,r_141_27_177,r_95_109_140,seq29,r_95_109_140,1.0,0,140,140,36
49,r_146_20_253,seq136,seq147,r_146_20_253,0.53,0,253,253,36
7,r_116_16_176,r_8_125_243,seq2,r_116_16_176,0.85,0,176,176,36
44,r_113_138_278,seq86,r_36_134_133,r_36_134_133,0.74,145,278,133,36
23,r_61_49_11,r_8_125_243,r_82_84_77,r_82_84_77,0.64,111,188,77,36
3,r_1_126_205,seq67,r_50_122_112,r_1_126_205,0.64,1,206,205,36
10,r_19_118_53,r_145_70_193,seq72,r_19_118_53,0.95,0,53,53,36
2,r_44_105_143,r_121_58_32,r_28_32_44,r_44_105_143,0.99,2,145,143,36
35,r_30_59_234,seq73,r_40_35_172,r_40_35_172,0.97,62,234,172,36
84,seq78,r_115_56_110,seq103,r_115_56_110,0.89,2,112,110,36
30,r_49_19_90,seq7,r_50_127_299,r_49_19_90,1.0,0,90,90,37
36,r_28_124_124,seq120,r_149_26_26,r_28_124_124,1.0,0,124,124,37
8,r_0_135_130,seq7,seq139,r_0_135_130,0.99,0,130,130,37
43,r_66_25_296,seq65,r_61_134_89,r_61_134_89,0.93,66,155,89,37
37,r_21_67_127,r_9_22_137,r_106_63_40,r_106_63_40,1.0,87,127,40,37
14,r_93_34_132,r_38_41_59,seq52,r_38_41_59,1.0,0,59,59,37
16,r_76_87_184,seq37,r_80_90_79,r_76_87_184,1.0,0,184,184,37
40,r_13_8_50,r_21_67_127,r_38_41_59,r_13_8_50,0.77,22,72,50,37
21,r_83_96_249,r_100_54_4,r_28_124_124,r_28_124_124,1.0,126,250,124,37
1,r_5_18_243,seq37,r_21_67_127,r_5_18_243,0.64,0,243,243,37
46,r_50_127_299,r_61_134_89,r_49_19_90,r_49_19_90,1.0,0,90,90,37
42,r_103_95_76,seq120,seq136,r_103_95_76,1.0,-1,75,76,37
4,r_38_41_59,r_93_34_132,r_114_70_186,r_38_41_59,1.0,0,59,59,37
88,seq143,seq139,r_91_107_220,r_91_107_220,1.0,2,222,220,37
69,seq37,r_76_87_184,r_44_24_104,r_44_24_104,0.5,80,184,104,37
19,r_9_22_137,seq143,r_106_63_40,r_9_22_137,0.71,0,137,137,37
33,r_140_53_235,r_20_146_52,r_13_8_50,r_140_53_235,0.97,0,235,235,37
40,r_13_8_50,r_51_6_205,r_21_67_127,r_13_8_50,0.89,0,50,50,37
22,r_123_1_19,r_100_54_4,seq2,r_123_1_19,1.0,0,19,19,37
95,seq116,r_23_79_216,seq52,r_23_79_216,1.0,0,216,216,37
38,r_80_90_79,r_91_107_220,r_76_87_184,r_80_90_79,0.9,136,215,79,37
97,seq119,seq130,r_5_18_243,r_5_18_243,0.91,32,275,243,37
31,r_86_57_250,r_117_94_265,r_56_145_57,r_56_145_57,1.0,196,253,57,37
3,r_56_145_57,seq7,seq45,r_56_145_57,1.0,-2,55,57,37
67,seq31,r_108_14_260,r_10_101_69,r_10_101_69,1.0,191,260,69,37
23,r_149_26_26,r_10_101_69,seq29,r_149_26_26,1.0,0,26,26,37
10,r_147_36_115,r_62_35_177,seq129,r_62_35_177,0.74,-55,122,177,37
26,r_55_64_293,seq7,r_149_26_26,r_149_26_26,1.0,143,169,26,37
72,seq45,seq84,r_56_145_57,r_56_145_57,1.0,35,92,57,37
14,r_93_34_132,seq52,r_113_68_253,r_93_34_132,1.0,0,132,132,37
78,seq65,r_66_25_296,r_61_134_89,r_61_134_89,0.99,146,235,89,37
11,r_10_101_69,seq144,seq31,r_10_101_69,1.0,0,69,69,37
20,r_32_71_99,r_138_125_42,seq74,r_32_71_99,0.87,0,99,99,37
13,r_109_81_185,seq120,seq58,r_109_81_185,0.98,0,185,185,37
44,r_126_112_11,seq15,seq137,r_126_112_11,1.0,0,11,11,37
6,r_23_79_216,seq116,r_85_78_72,r_23_79_216,0.99,0,216,216,37
40,r_13_8_50,r_38_41_59,r_140_53_235,r_140_53_235,0.79,0,235,235,37
36,r_28_124_124,r_149_26_26,r_83_96_249,r_83_96_249,0.5,1,250,249,37
27,r_108_14_260,seq31,r_123_1_19,r_108_14_260,0.55,0,260,260,37
30,r_49_19_90,r_50_127_299,r_98_121_245,r_98_121_245,0.98,29,274,245,37
2,r_91_107_220,seq104,seq143,r_91_107_220,0.87,0,220,220,37
47,r_113_68_253,seq144,r_93_34_132,r_93_34_132,1.0,1,133,132,37
29,r_117_94_265,r_86_57_250,seq148,r_86_57_250,0.53,-88,162,250,37
25,r_44_24_104,seq131,seq37,r_44_24_104,1.0,0,104,104,37
33,r_140_53_235,seq72,r_20_146_52,r_20_146_52,0.98,22,74,52,37
48,r_20_146_52,r_140_53_235,r_85_78_72,r_20_146_52,0.65,183,235,52,37
64,seq148,r_12_77_273,r_117_94_265,r_12_77_273,0.6,-162,111,273,37
47,r_113_68_253,r_93_34_132,r_9_22_137,r_113_68_253,0.65,0,253,253,37
88,seq143,r_21_67_127,seq139,r_21_67_127,1.0,0,127,127,37
70,seq39,r_51_6_205,r_43_40_36,r_43_40_36,0.94,169,205,36,37
14,r_93_34_132,r_113_68_253,r_99_97_13,r_93_34_132,0.56,121,253,132,37
32,r_85_78_72,seq2,r_20_146_52,r_85_78_72,0.98,7,79,72,37
38,r_80_90_79,r_10_101_69,r_91_107_220,r_10_101_69,1.0,-2,67,69,37
34,r_4_30_135,seq131,seq15,r_4_30_135,1.0,1,136,135,37
75,seq58,seq7,r_109_81_185,r_109_81_185,1.0,0,185,185,37
17,r_114_70_186,seq74,r_38_41_59,r_38_41_59,0.97,1,60,59,37
9,r_61_134_89,r_50_127_299,r_66_25_296,r_61_134_89,0.88,1,90,89,37
48,r_20_146_52,r_51_6_205,r_140_53_235,r_20_146_52,0.95,2,54,52,37
24,r_106_63_40,r_12_77_273,r_138_125_42,r_12_77_273,0.52,-233,40,273,37
49,r_12_77_273,seq148,seq74,r_12_77_273,0.42,0,273,273,37
7,r_51_6_205,seq39,seq148,r_51_6_205,0.74,0,205,205,37
66,seq29,seq7,r_149_26_26,r_149_26_26,1.0,28,54,26,37
35,r_62_35_177,r_147_36_115,seq84,r_62_35_177,0.52,0,177,177,37
12,r_98_121_245,seq27,r_49_19_90,r_49_19_90,1.0,159,249,90,37
39,r_43_40_36,r_28_124_124,r_46_16_248,r_43_40_36,0.99,0,36,36,37
30,r_143_100_284,r_32_147_286,r_26_131_112,r_26_131_112,1.0,0,112,112,38
44,r_72_92_12,r_142_45_172,seq86,r_142_45_172,0.99,0,172,172,38
51,seq1,r_89_128_222,seq126,r_89_128_222,0.85,-5,217,222,38
36,r_138_82_272,seq124,r_108_65_21,r_108_65_21,0.97,251,272,21,38
12,r_34_98_212,r_112_110_190,r_103_50_15,r_103_50_15,0.6,31,46,15,38
14,r_21_7_208,seq79,r_103_50_15,r_103_50_15,0.85,198,213,15,38
8,r_46_97_83,seq115,seq66,r_46_97_83,0.99,0,83,83,38
53,seq4,seq81,r_144_14_91,r_144_14_91,1.0,2,93,91,38
21,r_103_50_15,r_113_117_92,r_34_98_212,r_34_98_212,0.91,-197,15,212,38
39,r_71_148_48,r_105_88_100,seq63,r_105_88_100,1.0,0,100,100,38
83,seq79,r_21_7_208,r_85_8_82,r_21_7_208,0.95,5,213,208,38
37,r_127_67_85,r_19_12_98,r_52_109_207,r_52_109_207,0.59,25,232,207,38
29,r_56_3_52,r_28_76_158,seq63,r_56_3_52,0.59,-1,51,52,38
86,seq84,r_26_131_112,r_90_58_27,r_26_131_112,0.92,1,113,112,38
1,r_15_78_203,seq2,r_55_23_37,r_55_23_37,0.88,166,203,37,38
5,r_13_125_280,r_119_40_102,r_59_91_93,r_13_125_280,0.89,-178,102,280,38
46,r_59_91_93,seq140,r_13_125_280,r_59_91_93,1.0,0,93,93,38
42,r_26_131_112,seq84,r_143_100_284,r_26_131_112,1.0,1,113,112,38
7,r_120_37_287,r_105_88_100,r_22_129_165,r_22_129_165,0.58,122,287,165,38
45,r_137_35_245,seq48,seq11,r_137_35_245,0.63,1,246,245,38
10,r_104_17_274,r_71_148_48,seq80,r_71_148_48,1.0,0,48,48,38
19,r_57_139_66,r_32_147_286,seq39,r_57_139_66,1.0,0,66,66,38
43,r_105_88_100,r_112_110_190,r_71_148_48,r_71_148_48,1.0,1,49,48,38
22,r_55_23_37,seq86,r_15_78_203,r_15_78_203,1.0,11,214,203,38
66,seq25,seq20,r_119_40_102,r_119_40_102,1.0,32,134,102,38
31,r_132_33_246,seq69,r_113_117_92,r_113_117_92,0.96,154,246,92,38
43,r_105_88_100,r_71_148_48,r_120_37_287,r_105_88_100,1.0,0,100,100,38
41,r_28_76_158,r_83_53_173,r_77_134_228,r_77_134_228,0.68,-69,159,228,38
12,r_34_98_212,r_113_117_92,r_19_12_98,r_34_98_212,1.0,0,212,212,38
3,r_22_129_165,seq48,seq6,r_22_129_165,0.88,-2,163,165,38
26,r_64_111_141,r_36_38_127,r_142_45_172,r_64_111_141,0.45,-13,128,141,38
8,r_46_97_83,seq66,r_64_111_141,r_64_111_141,1.0,49,190,141,38
0,r_83_53_173,r_28_76_158,seq11,r_28_76_158,0.68,-50,108,158,38
73,seq48,r_137_35_245,r_10_62_124,r_10_62_124,0.99,122,246,124,38
20,r_121_60_101,r_15_78_203,seq81,r_121_60_101,1.0,1,102,101,38
13,r_52_109_207,seq86,r_127_67_85,r_127_67_85,0.81,134,219,85,38
98,seq124,r_138_82_272,r_22_129_165,r_22_129_165,0.98,107,272,165,38
44,r_72_92_12,r_32_147_286,r_142_45_172,r_72_92_12,0.97,0,12,12,38
46,r_59_91_93,r_13_125_280,seq11,r_13_125_280,0.69,-83,197,280,38
15,r_42_44_282,r_85_8_82,seq11,r_85_8_82,0.28,203,285,82,38
48,r_89_128_222,seq1,r_28_76_158,r_28_76_158,1.0,66,224,158,38
49,r_102_27_1,r_19_12_98,r_106_136_258,r_102_27_1,0.27,266,267,1,38
62,seq145,r_113_117_92,seq80,r_113_117_92,1.0,0,92,92,38
21,r_103_50_15,r_34_98_212,r_21_7_208,r_103_50_15,0.88,197,212,15,38
33,r_108_65_21,r_15_78_203,seq140,r_108_65_21,1.0,0,21,21,38
85,seq81,seq4,r_121_60_101,r_121_60_101,1.0,14,115,101,38
43,r_105_88_100,r_120_37_287,r_112_110_190,r_112_110_190,1.0,100,290,190,38
5,r_13_125_280,r_59_91_93,r_15_78_203,r_59_91_93,0.54,187,280,93,38
0,r_83_53_173,seq11,r_41_118_67,r_83_53_173,1.0,0,173,173,38
25,r_41_118_67,seq141,r_83_53_173,r_83_53_173,1.0,1,174,173,38
25,r_41_118_67,r_19_12_98,seq141,r_19_12_98,0.5,13,111,98,38
10,r_104_17_274,seq80,r_21_7_208,r_104_17_274,0.47,0,274,274,38
27,r_36_38_127,r_64_111_141,r_113_117_92,r_64_111_141,0.92,-13,128,141,38
87,seq86,r_52_109_207,r_55_23_37,r_55_23_37,1.0,34,71,37,38
22,r_55_23_37,r_64_111_141,seq86,r_64_111_141,0.99,0,141,141,38
40,r_99_24_57,seq126,seq95,r_99_24_57,0.55,0,57,57,38
2,r_122_123_123,seq135,seq63,r_122_123_123,1.0,0,123,123,38
47,r_61_5_241,r_99_24_57,seq135,r_99_24_57,0.41,21,78,57,38
18,r_119_40_102,r_13_125_280,seq25,r_119_40_102,1.0,0,102,102,38
26,r_64_111_141,r_142_45_172,r_46_97_83,r_64_111_141,0.68,0,141,141,38
25,r_41_118_67,seq6,r_19_12_98,r_41_118_67,1.0,0,67,67,38
47,r_61_5_241,seq135,seq74,r_61_5_241,0.56,-43,198,241,38
6,r_142_45_172,r_72_92_12,seq39,r_142_45_172,0.99,0,172,172,38
42,r_26_131_112,r_143_100_284,r_105_88_100,r_143_100_284,0.35,5,289,284,38
32,r_106_136_258,seq25,r_102_27_1,r_106_136_258,0.2,10,268,258,38
38,r_101_73_3,r_26_131_112,r_90_58_27,r_26_131_112,0.93,-48,64,112,38
34,r_10_62_124,seq84,seq48,r_10_62_124,1.0,1,125,124,38
75,seq51,r_77_134_228,seq2,r_77_134_228,0.72,1,229,228,38
17,r_113_117_92,seq145,r_34_98_212,r_113_117_92,1.0,0,92,92,38
28,r_19_12_98,r_102_27_1,r_34_98_212,r_34_98_212,1.0,55,267,212,38
12,r_34_98_212,r_103_50_15,r_113_117_92,r_113_117_92,1.0,1,93,92,38
28,r_19_12_98,seq126,r_102_27_1,r_19_12_98,0.98,13,111,98,38
22,r_55_23_37,r_137_35_245,r_64_111_141,r_55_23_37,1.0,0,37,37,38
41,r_28_76_158,r_77_134_228,r_89_128_222,r_28_76_158,0.64,60,218,158,38
49,r_102_27_1,r_106_136_258,r_19_12_98,r_19_12_98,0.7,10,108,98,38
7,r_120_37_287,r_143_100_284,r_105_88_100,r_105_88_100,1.0,0,100,100,38
39,r_71_148_48,r_104_17_274,r_105_88_100,r_71_148_48,0.96,0,48,48,38
23,r_144_14_91,seq9,seq81,r_144_14_91,1.0,0,91,91,38
17,r_113_117_92,r_34_98_212,r_36_38_127,r_113_117_92,0.96,120,212,92,38
16,r_90_58_27,r_55_23_37,r_101_73_3,r_90_58_27,0.82,4,31,27,38
82,seq74,r_130_75_275,r_61_5_241,r_130_75_275,0.41,0,275,275,38
6,r_142_45_172,r_130_75_275,r_72_92_12,r_72_92_12,0.96,0,12,12,38
40,r_27_7_191,r_5_23_36,seq25,r_27_7_191,1.0,0,191,191,39
30,r_90_85_260,r_56_67_42,r_14_45_146,r_56_67_42,0.67,109,151,42,39
51,seq2,r_4_117_153,seq110,r_4_117_153,1.0,-41,112,153,39
36,r_61_139_235,r_53_57_239,r_135_87_127,r_53_57_239,0.77,0,239,239,39
9,r_129_94_253,r_98_48_10,r_59_102_203,r_98_48_10,0.94,244,254,10,39
43,r_39_68_62,seq9,seq84,r_39_68_62,1.0,2,64,62,39
37,r_21_10_125,seq54,r_100_42_185,r_21_10_125,1.0,0,125,125,39
86,seq93,r_60_104_246,r_52_44_163,r_60_104_246,0.86,0,246,246,39
16,r_52_44_163,r_53_57_239,r_136_138_20,r_52_44_163,0.67,7,170,163,39
39,r_143_106_168,seq13,seq43,r_143_106_168,0.61,11,179,168,39
1,r_100_42_185,r_21_10_125,seq125,r_100_42_185,0.94,5,190,185,39
1,r_100_42_185,seq125,r_21_10_125,r_21_10_125,0.99,0,125,125,39
5,r_135_87_127,r_53_57_239,seq8,r_53_57_239,0.8,-108,131,239,39
46,r_72_58_61,seq92,seq0,r_72_58_61,1.0,0,61,61,39
42,r_82_121_94,r_55_95_75,r_61_139_235,r_82_121_94,1.0,1,95,94,39
6,r_56_67_42,r_90_85_260,r_11_101_226,r_56_67_42,0.59,0,42,42,39
21,r_5_23_36,r_86_51_107,r_27_7_191,r_5_23_36,1.0,0,36,36,39
45,r_55_95_75,r_82_121_94,seq105,r_82_121_94,1.0,-6,88,94,39
38,r_11_101_226,r_56_67_42,seq92,r_11_101_226,0.84,1,227,226,39
3,r_66_141_190,r_129_94_253,seq8,r_129_94_253,0.65,-55,198,253,39
10,r_142_111_155,seq127,r_134_38_45,r_134_38_45,1.0,114,159,45,39
90,seq105,r_27_7_191,r_55_95_75,r_27_7_191,1.0,-111,80,191,39
0,r_18_146_218,seq28,seq107,r_18_146_218,0.92,0,218,218,39
11,r_17_114_171,seq120,seq12,r_17_114_171,0.94,2,173,171,39
20,r_1_112_150,seq148,seq8,r_1_112_150,0.91,0,150,150,39
13,r_70_108_241,seq125,seq6,r_70_108_241,0.94,0,241,241,39
98,seq125,r_70_108_241,r_100_42_185,r_70_108_241,0.57,-48,193,241,39
15,r_53_57_239,r_61_139_235,seq3,r_53_57_239,0.75,0,239,239,39
48,r_60_104_246,seq93,r_70_108_241,r_60_104_246,0.79,0,246,246,39
8,r_145_78_50,r_39_68_62,seq103,r_145_78_50,1.0,1,51,50,39
62,seq28,r_18_146_218,seq46,r_18_146_218,1.0,-23,195,218,39
21,r_5_23_36,r_27_7_191,r_4_117_153,r_5_23_36,1.0,155,191,36,39
19,r_136_138_20,r_66_141_190,seq29,r_136_138_20,0.66,2,22,20,39
85,seq92,r_72_58_61,seq12,r_72_58_61,1.0,0,61,61,39
27,r_19_147_60,seq13,seq15,r_19_147_60,1.0,0,60,60,39
30,r_90_85_260,r_14_45_146,r_145_78_50,r_145_78_50,0.49,177,227,50,39
2,r_128_37_228,r_61_139_235,r_18_146_218,r_128_37_228,0.84,1,229,228,39
41,r_98_48_10,r_129_94_253,r_130_35_222,r_98_48_10,0.72,244,254,10,39
47,r_24_89_103,seq8,seq20,r_24_89_103,0.99,0,103,103,39
40,r_27_7_191,seq105,r_5_23_36,r_5_23_36,1.0,44,80,36,39
18,r_4_117_153,r_62_69_265,r_5_23_36,r_4_117_153,0.64,0,153,153,39
29,r_59_102_203,r_61_139_235,r_39_68_62,r_59_102_203,0.67,0,203,203,39
89,seq103,r_14_45_146,r_145_78_50,r_145_78_50,1.0,2,52,50,39
41,r_98_48_10,r_145_78_50,r_129_94_253,r_98_48_10,0.98,0,10,10,39
24,r_62_69_265,r_4_117_153,seq110,r_4_117_153,0.97,-11,142,153,39
33,r_14_45_146,r_11_101_226,seq0,r_11_101_226,0.68,-78,148,226,39
64,seq32,r_4_117_153,seq110,r_4_117_153,1.0,-11,142,153,39
50,seq0,seq63,r_14_45_146,r_14_45_146,0.62,6,152,146,39
44,r_65_31_55,r_135_87_127,seq148,r_65_31_55,1.0,0,55,55,39
6,r_56_67_42,r_11_101_226,seq28,r_11_101_226,0.98,0,226,226,39
42,r_82_121_94,r_61_139_235,r_52_44_163,r_61_139_235,0.99,2,237,235,39
32,r_99_132_167,seq25,r_14_45_146,r_99_132_167,1.0,0,167,167,39
38,r_11_101_226,r_14_45_146,r_56_67_42,r_14_45_146,0.54,-71,75,146,39
34,r_144_109_157,seq15,seq2,r_144_109_157,0.99,1,158,157,39
26,r_26_16_23,seq3,seq84,r_26_16_23,1.0,1,24,23,39
31,r_134_38_45,seq0,seq148,r_134_38_45,1.0,0,45,45,39
9,r_129_94_253,r_66_141_190,r_98_48_10,r_129_94_253,0.58,-100,153,253,39
22,r_79_140_240,seq88,r_47_30_101,r_79_140_240,0.94,2,242,240,39
30,r_90_85_260,r_145_78_50,r_70_108_241,r_70_108_241,0.63,21,262,241,39
56,seq12,seq92,r_24_89_103,r_24_89_103,1.0,15,118,103,39
7,r_86_51_107,seq125,seq25,r_86_51_107,1.0,1,108,107,39
23,r_22_124_256,seq84,seq2,r_22_124_256,0.72,0,256,256,39
17,r_131_133_25,seq103,seq25,r_131_133_25,1.0,0,25,25,39
82,seq84,r_22_124_256,r_39_68_62,r_39_68_62,1.0,32,94,62,39
35,r_34_119_3,r_130_35_222,r_61_139_235,r_34_119_3,0.35,244,247,3,39
12,r_47_30_101,r_1_112_150,r_122_77_290,r_1_112_150,0.85,-44,106,150,39
36,r_13_0_239,seq72,r_52_25_15,r_13_0_239,0.62,1,240,239,40
14,r_148_21_135,r_144_14_216,seq70,r_148_21_135,0.95,0,135,135,40
43,r_63_130_75,seq129,seq70,r_63_130_75,1.0,0,75,75,40
4,r_114_12_265,r_97_123_53,seq70,r_97_123_53,1.0,0,53,53,40
37,r_26_47_220,seq124,seq37,r_26_47_220,0.61,2,222,220,40
16,r_67_83_148,r_49_71_184,seq134,r_67_83_148,0.98,2,150,148,40
39,r_107_33_269,seq5,r_148_21_135,r_148_21_135,1.0,146,281,135,40
97,seq119,r_81_75_6,r_85_93_72,r_85_93_72,0.98,18,90,72,40
25,r_52_25_15,seq50,seq129,r_52_25_15,0.59,0,15,15,40
5,r_54_145_113,r_74_106_177,r_90_133_98,r_54_145_113,1.0,0,113,113,40
46,r_42_135_224,r_24_43_208,seq110,r_42_135_224,0.38,-147,77,224,40
7,r_108_139_27,r_24_43_208,r_17_11_164,r_108_139_27,0.96,181,208,27,40
24,r_126_31_43,r_77_79_251,r_114_12_265,r_77_79_251,0.37,-10,241,251,40
19,r_17_11_164,r_109_115_285,r_108_139_27,r_17_11_164,1.0,0,164,164,40
13,r_122_51_22,r_49_71_184,seq124,r_122_51_22,1.0,0,22,22,40
31,r_117_41_182,r_98_132_237,r_74_106_177,r_117_41_182,0.74,1,183,182,40
41,r_23_60_86,seq29,seq113,r_23_60_86,1.0,1,87,86,40
67,seq46,seq88,r_62_120_243,r_62_120_243,0.93,6,249,243,40
26,r_40_53_157,seq44,seq118,r_40_53_157,0.97,0,157,157,40
78,seq70,r_114_12_265,r_131_4_65,r_131_4_65,1.0,29,94,65,40
0,r_109_115_285,r_17_11_164,seq86,r_17_11_164,1.0,0,164,164,40
11,r_3_8_161,seq39,seq73,r_3_8_161,0.79,2,163,161,40
20,r_77_79_251,r_149_143_100,r_126_31_43,r_77_79_251,0.73,-144,107,251,40
98,seq124,r_26_47_220,r_87_137_48,r_87_137_48,0.92,51,99,48,40
46,r_42_135_224,seq110,r_34_91_159,r_42_135_224,0.93,0,224,224,40
15,r_76_2_247,seq38,seq105,r_76_2_247,0.58,1,248,247,40
48,r_30_80_232,seq78,r_108_139_27,r_30_80_232,0.53,0,232,232,40
57,seq16,r_49_71_184,r_7_57_174,r_49_71_184,1.0,1,185,184,40
12,r_49_71_184,seq16,seq129,r_49_71_184,1.0,0,184,184,40
21,r_24_43_208,r_108_139_27,seq112,r_24_43_208,0.89,0,208,208,40
17,r_97_123_53,r_114_12_265,seq65,r_97_123_53,1.0,0,53,53,40
27,r_64_32_146,seq99,r_7_57_174,r_64_32_146,1.0,14,160,146,40
2,r_74_106_177,seq35,r_117_41_182,r_74_106_177,0.53,5,182,177,40
47,r_94_138_117,r_49_71_184,seq1,r_94_138_117,0.99,2,119,117,40
40,r_20_10_114,r_127_18_156,seq65,r_20_10_114,0.99,0,114,114,40
74,seq134,seq99,r_67_83_148,r_67_83_148,1.0,22,170,148,40
29,r_131_4_65,seq105,seq70,r_131_4_65,1.0,3,68,65,40
88,seq99,r_98_132_237,seq105,r_98_132_237,1.0,-8,229,237,40
21,r_24_43_208,r_42_135_224,r_108_139_27,r_108_139_27,1.0,12,39,27,40
50,seq1,seq58,r_94_138_117,r_94_138_117,1.0,9,126,117,40
70,seq55,r_34_91_159,seq95,r_34_91_159,1.0,0,159,159,40
65,seq44,r_40_53_157,r_9_61_152,r_40_53_157,0.61,0,157,157,40
20,r_77_79_251,r_126_31_43,r_24_43_208,r_24_43_208,0.55,43,251,208,40
32,r_90_133_98,r_147_68_292,r_87_137_48,r_90_133_98,1.0,0,98,98,40
38,r_19_102_125,seq95,seq29,r_19_102_125,0.71,1,126,125,40
77,seq69,r_127_18_156,seq141,r_127_18_156,1.0,-16,140,156,40
34,r_85_93_72,r_136_140_245,seq119,r_85_93_72,0.91,3,75,72,40
59,seq29,r_23_60_86,seq35,r_23_60_86,1.0,-29,57,86,40
60,seq35,r_74_106_177,seq29,r_74_106_177,0.97,5,182,177,40
30,r_87_137_48,r_9_61_152,seq124,r_87_137_48,1.0,0,48,48,40
96,seq118,seq38,r_40_53_157,r_40_53_157,1.0,1,158,157,40
22,r_128_121_263,seq113,r_85_93_72,r_85_93_72,0.53,191,263,72,40
28,r_149_143_100,r_77_79_251,seq141,r_149_143_100,0.83,7,107,100,40
91,seq105,r_136_140_245,seq99,r_136_140_245,0.98,-41,204,245,40
49,r_136_140_245,seq105,seq5,r_136_140_245,0.58,1,246,245,40
44,r_34_91_159,seq55,seq69,r_34_91_159,1.0,0,159,159,40
7,r_108_139_27,seq6,r_24_43_208,r_108_139_27,1.0,0,27,27,40
23,r_9_61_152,r_7_57_174,seq92,r_9_61_152,0.8,1,153,152,40
82,seq84,r_144_14_216,seq86,r_144_14_216,0.75,0,216,216,40
35,r_7_57_174,r_9_61_152,r_64_32_146,r_64_32_146,0.77,15,161,146,40
12,r_49_71_184,r_94_138_117,seq16,r_94_138_117,0.97,2,119,117,40
24,r_126_31_43,r_9_61_152,r_77_79_251,r_126_31_43,0.94,2,45,43,40
54,seq137,r_11_27_91,r_60_140_175,r_60_140_175,1.0,41,216,175,41
40,r_76_37_51,r_77_6_126,r_114_141_119,r_77_6_126,0.99,0,126,126,41
30,r_2_9_265,seq147,r_74_29_218,r_2_9_265,0.75,0,265,265,41
4,r_7_109_30,r_14_104_159,seq125,r_7_109_30,0.79,-1,29,30,41
36,r_20_102_279,r_1_57_221,r_88_149_135,r_88_149_135,0.96,15,150,135,41
64,seq34,r_73_66_192,r_123_56_31,r_123_56_31,0.99,1,32,31,41
14,r_139_23_100,r_145_99_146,r_71_135_64,r_71_135_64,0.74,-1,63,64,41
53,seq134,r_114_141_119,r_70_43_82,r_70_43_82,1.0,37,119,82,41
43,r_88_149_135,seq95,r_15_45_105,r_88_149_135,1.0,1,136,135,41
3,r_60_140_175,r_14_104_159,seq137,r_60_140_175,0.96,0,175,175,41
55,seq138,r_24_121_117,seq28,r_24_121_117,0.9,25,142,117,41
16,r_117_90_98,seq125,seq50,r_117_90_98,1.0,0,98,98,41
21,r_89_86_280,seq107,r_61_96_71,r_61_96_71,1.0,209,280,71,41
39,r_119_63_63,r_61_96_71,seq81,r_119_63_63,1.0,0,63,63,41
1,r_61_96_71,r_113_31_232,r_98_4_154,r_98_4_154,0.98,92,246,154,41
1,r_61_96_71,r_15_45_105,r_113_31_232,r_61_96_71,0.98,0,71,71,41
97,seq147,r_2_9_265,r_124_47_87,r_124_47_87,1.0,178,265,87,41
40,r_76_37_51,r_79_122_293,r_77_6_126,r_76_37_51,1.0,0,51,51,41
19,r_21_129_94,seq108,seq78,r_21_129_94,1.0,0,94,94,41
95,seq111,r_145_99_146,seq39,r_145_99_146,1.0,1,147,146,41
66,seq36,r_54_120_131,r_145_99_146,r_145_99_146,0.57,0,146,146,41
76,seq64,seq46,r_91_12_59,r_91_12_59,1.0,64,123,59,41
38,r_113_31_232,r_61_96_71,r_115_42_89,r_113_31_232,0.33,-10,222,232,41
31,r_71_135_64,r_85_17_203,r_139_23_100,r_71_135_64,0.96,0,64,64,41
3,r_60_140_175,r_124_47_87,r_14_104_159,r_124_47_87,1.0,0,87,87,41
10,r_115_42_89,seq106,r_118_105_1,r_115_42_89,1.0,6,95,89,41
90,seq106,r_58_68_177,r_14_104_159,r_14_104_159,0.77,20,179,159,41
26,r_24_121_117,seq36,seq75,r_24_121_117,0.99,1,118,117,41
8,r_14_104_159,r_60_140_175,seq106,r_14_104_159,1.0,0,159,159,41
72,seq50,seq26,r_117_90_98,r_117_90_98,1.0,45,143,98,41
0,r_124_47_87,r_60_140_175,seq125,r_124_47_87,1.0,0,87,87,41
73,seq51,r_15_45_105,seq48,r_15_45_105,0.98,-1,104,105,41
11,r_54_120_131,seq36,r_115_42_89,r_54_120_131,0.89,8,139,131,41
90,seq106,r_14_104_159,r_74_29_218,r_74_29_218,0.99,13,231,218,41
20,r_62_22_76,r_8_16_289,r_113_31_232,r_62_22_76,1.0,1,77,76,41
98,seq116,seq50,r_130_38_152,r_130_38_152,1.0,3,155,152,41
15,r_145_99_146,seq111,seq36,r_145_99_146,1.0,1,147,146,41
48,r_70_43_82,seq18,seq134,r_70_43_82,1.0,0,82,82,41
12,r_15_45_105,r_20_102_279,r_88_149_135,r_88_149_135,1.0,148,283,135,41
41,r_30_0_20,seq137,seq41,r_30_0_20,0.89,0,20,20,41
6,r_98_4_154,seq52,r_61_96_71,r_98_4_154,0.59,1,155,154,41
40,r_76_37_51,r_114_141_119,r_91_12_59,r_76_37_51,0.51,239,290,51,41
99,seq125,seq67,r_124_47_87,r_124_47_87,1.0,64,151,87,41
36,r_20_102_279,r_88_149_135,r_2_9_265,r_2_9_265,0.81,9,274,265,41
27,r_72_49_294,seq133,r_127_44_21,r_127_44_21,1.0,50,71,21,41
94,seq110,r_7_109_30,r_124_47_87,r_124_47_87,0.84,18,105,87,41
37,r_87_59_49,r_143_103_133,seq148,r_87_59_49,0.59,0,49,49,41
47,r_74_29_218,seq84,seq106,r_74_29_218,0.57,4,222,218,41
18,r_58_68_177,seq106,r_145_99_146,r_145_99_146,0.95,33,179,146,41
29,r_32_128_149,seq94,seq144,r_32_128_149,1.0,0,149,149,41
8,r_14_104_159,r_7_109_30,r_60_140_175,r_7_109_30,1.0,-1,29,30,41
25,r_143_103_133,seq83,seq131,r_143_103_133,1.0,-1,132,133,41
33,r_126_92_209,seq18,seq107,r_126_92_209,0.82,0,209,209,41
70,seq46,r_8_16_289,r_76_37_51,r_76_37_51,0.54,224,275,51,41
54,seq137,r_30_0_20,seq146,r_30_0_20,0.89,0,20,20,41
58,seq18,r_126_92_209,seq40,r_126_92_209,0.97,-46,163,209,41
20,r_62_22_76,r_113_31_232,r_98_4_154,r_98_4_154,0.95,6,160,154,41
31,r_71_135_64,r_139_23_100,seq111,r_139_23_100,0.95,0,100,100,41
32,r_8_16_289,seq46,r_77_6_126,r_77_6_126,1.0,162,288,126,41
38,r_113_31_232,r_85_17_203,r_61_96_71,r_61_96_71,1.0,18,89,71,41
34,r_55_5_69,r_143_103_133,seq69,r_55_5_69,1.0,0,69,69,41
14,r_139_23_100,r_71_135_64,r_11_27_91,r_139_23_100,1.0,0,100,100,41
5,r_127_44_21,r_89_86_280,r_72_49_294,r_127_44_21,1.0,0,21,21,41
60,seq148,seq34,r_87_59_49,r_87_59_49,1.0,13,62,49,41
2,r_123_56_31,r_82_10_230,seq34,r_123_56_31,1.0,0,31,31,41
81,seq78,r_73_66_192,r_21_129_94,r_21_129_94,0.96,99,193,94,41
17,r_114_141_119,seq134,r_76_37_51,r_76_37_51,1.0,65,116,51,41
9,r_82_10_230,seq134,r_87_59_49,r_82_10_230,0.96,0,230,230,41
23,r_91_12_59,r_119_63_63,seq64,r_91_12_59,1.0,0,59,59,41
22,r_13_100_106,r_114_141_119,seq75,r_13_100_106,1.0,1,107,106,41
28,r_130_38_152,seq134,seq69,r_130_38_152,1.0,0,152,152,41
91,seq107,r_89_86_280,r_126_92_209,r_126_92_209,0.92,43,252,209,41
49,r_136_33_156,seq144,r_145_99_146,r_136_33_156,1.0,0,156,156,41
7,r_77_6_126,seq64,seq94,r_77_6_126,1.0,0,126,126,41
44,r_73_66_192,seq78,r_117_90_98,r_117_90_98,0.91,95,193,98,41
79,seq69,seq26,r_55_5_69,r_55_5_69,1.0,16,85,69,41
35,r_1_57_221,r_20_102_279,seq146,r_20_102_279,0.5,-58,221,279,41
12,r_15_45_105,seq51,r_20_102_279,r_15_45_105,1.0,0,105,105,41
51,seq1,r_111_107_128,seq105,r_111_107_128,1.0,0,128,128,42
14,r_111_107_128,seq1,seq127,r_111_107_128,1.0,0,128,128,42
8,r_93_12_160,seq115,seq15,r_93_12_160,0.98,1,161,160,42
43,r_65_20_121,r_83_22_75,seq123,r_65_20_121,0.97,4,125,121,42
37,r_116_128_235,seq55,seq149,r_116_128_235,0.8,0,235,235,42
16,r_37_62_101,seq129,seq95,r_37_62_101,1.0,0,101,101,42
21,r_38_122_90,r_132_43_246,r_111_107_128,r_111_107_128,1.0,118,246,128,42
39,r_59_106_107,seq69,r_11_8_124,r_11_8_124,1.0,4,128,124,42
42,r_16_125_221,seq95,r_90_99_151,r_16_125_221,0.64,0,221,221,42
80,seq69,r_59_106_107,seq63,r_59_106_107,0.83,-1,106,107,42
45,r_19_119_105,seq149,seq109,r_19_119_105,1.0,0,105,105,42
19,r_25_147_226,seq109,seq133,r_25_147_226,0.76,0,226,226,42
89,seq95,r_16_125_221,r_37_62_101,r_37_62_101,0.96,120,221,101,42
3,r_11_8_124,seq133,r_59_106_107,r_11_8_124,1.0,1,125,124,42
10,r_57_3_150,seq113,seq60,r_57_3_150,0.99,0,150,150,42
33,r_42_91_69,seq6,r_56_10_112,r_56_10_112,0.85,0,112,112,42
26,r_9_24_76,seq21,seq109,r_9_24_76,1.0,0,76,76,42
84,seq79,r_13_117_15,seq1,r_13_117_15,0.97,7,22,15,42
11,r_56_10_112,r_29_140_289,r_42_91_69,r_42_91_69,0.8,59,128,69,42
20,r_138_46_82,r_83_22_75,r_40_92_48,r_138_46_82,0.95,2,84,82,42
98,seq123,r_145_82_53,r_65_20_121,r_65_20_121,0.46,-8,113,121,42
96,seq113,seq81,r_110_71_71,r_110_71_71,0.64,131,202,71,42
30,r_31_136_31,seq44,seq36,r_31_136_31,1.0,0,31,31,42
6,r_86_141_158,seq135,r_7_66_280,r_86_141_158,0.89,0,158,158,42
62,seq149,r_19_119_105,r_142_121_277,r_19_119_105,0.97,1,106,105,42
48,r_110_71_71,r_145_82_53,r_124_98_278,r_110_71_71,0.73,-18,53,71,42
0,r_40_92_48,r_88_89_215,r_138_46_82,r_40_92_48,1.0,68,116,48,42
27,r_130_50_276,r_41_48_269,seq115,r_130_50_276,0.44,-7,269,276,42
34,r_72_28_47,seq79,r_85_97_29,r_72_28_47,0.98,0,47,47,42
2,r_126_101_127,seq36,r_38_122_90,r_126_101_127,0.9,0,127,127,42
47,r_45_96_159,seq69,r_38_122_90,r_45_96_159,0.97,0,159,159,42
36,r_87_34_46,seq129,seq15,r_87_34_46,1.0,0,46,46,42
40,r_114_103_169,seq113,seq15,r_114_103_169,0.6,0,169,169,42
18,r_90_99_151,seq74,seq73,r_90_99_151,0.99,0,151,151,42
28,r_132_43_246,r_76_23_143,r_38_122_90,r_76_23_143,0.87,-86,57,143,42
24,r_41_48_269,r_130_50_276,r_40_92_48,r_40_92_48,0.75,221,269,48,42
25,r_76_23_143,seq127,seq30,r_76_23_143,0.99,1,144,143,42
90,seq100,r_64_137_196,r_13_117_15,r_13_117_15,0.74,2,17,15,42
33,r_42_91_69,seq135,seq6,r_42_91_69,0.87,0,69,69,42
64,seq35,r_124_98_278,r_17_144_34,r_17_144_34,0.98,245,279,34,42
35,r_85_97_29,r_17_144_34,r_75_53_248,r_85_97_29,0.98,0,29,29,42
61,seq30,seq74,r_76_23_143,r_76_23_143,1.0,17,160,143,42
32,r_148_33_200,r_75_53_248,r_13_117_15,r_148_33_200,0.97,0,200,200,42
23,r_145_82_53,r_110_71_71,seq36,r_145_82_53,1.0,0,53,53,42
38,r_64_137_196,seq63,seq21,r_64_137_196,0.96,2,198,196,42
75,seq60,seq44,r_77_26_237,r_77_26_237,0.46,-127,110,237,42
0,r_40_92_48,r_19_119_105,r_88_89_215,r_40_92_48,0.94,-1,47,48,42
48,r_110_71_71,r_124_98_278,seq80,r_110_71_71,0.8,1,72,71,42
81,seq73,seq133,r_90_99_151,r_90_99_151,1.0,0,151,151,42
17,r_70_14_176,seq102,r_59_106_107,r_70_14_176,0.96,0,176,176,42
96,seq113,r_57_3_150,seq81,r_57_3_150,1.0,0,150,150,42
28,r_132_43_246,r_38_122_90,r_56_10_112,r_56_10_112,0.58,134,246,112,42
22,r_88_89_215,seq67,seq44,r_88_89_215,0.54,0,215,215,42
62,seq149,r_142_121_277,r_116_128_235,r_116_128_235,0.85,10,245,235,42
84,seq79,seq1,r_86_141_158,r_86_141_158,0.98,74,232,158,42
49,r_77_26_237,seq60,r_31_136_31,r_31_136_31,0.94,206,237,31,42
44,r_47_118_170,r_64_137_196,r_120_5_5,r_47_118_170,0.96,2,172,170,42
5,r_75_53_248,r_148_33_200,r_85_97_29,r_85_97_29,0.76,2,31,29,42
7,r_17_144_34,r_76_23_143,seq84,r_17_144_34,1.0,-1,33,34,42
31,r_13_117_15,r_88_89_215,seq100,r_13_117_15,0.98,2,17,15,42
12,r_4_146_211,seq78,r_65_20_121,r_4_146_211,0.75,3,214,211,42
30,r_11_45_178,r_51_81_281,r_53_70_3,r_11_45_178,0.78,12,190,178,43
18,r_120_29_20,r_98_84_133,seq145,r_120_29_20,1.0,0,20,20,43
36,r_7_142_65,r_62_72_64,seq71,r_7_142_65,1.0,3,68,65,43
54,seq6,r_103_18_258,r_16_121_19,r_103_18_258,0.72,-213,45,258,43
14,r_2_43_219,seq33,seq149,r_2_43_219,0.95,0,219,219,43
8,r_111_93_167,seq47,r_7_142_65,r_111_93_167,1.0,0,167,167,43
59,seq139,r_51_81_281,r_53_70_3,r_53_70_3,0.58,276,279,3,43
28,r_112_134_127,r_63_144_141,r_69_119_132,r_112_134_127,0.68,33,160,127,43
71,seq47,r_111_93_167,seq117,r_111_93_167,1.0,0,167,167,43
16,r_63_144_141,r_103_18_258,r_98_84_133,r_98_84_133,0.97,126,259,133,43
21,r_69_119_132,seq57,r_98_84_133,r_69_119_132,0.94,2,134,132,43
39,r_107_39_231,r_109_65_297,r_120_29_20,r_107_39_231,0.52,0,231,231,43
1,r_126_79_226,seq145,seq59,r_126_79_226,0.83,3,229,226,43
5,r_52_74_261,seq68,r_38_9_115,r_38_9_115,1.0,157,272,115,43
46,r_19_136_66,seq101,seq57,r_19_136_66,0.92,1,67,66,43
80,seq68,r_52_74_261,r_143_115_201,r_143_115_201,1.0,24,225,201,43
69,seq40,r_112_134_127,r_41_110_25,r_112_134_127,1.0,1,128,127,43
7,r_104_35_52,r_95_116_290,seq94,r_104_35_52,1.0,2,54,52,43
33,r_118_124_41,seq25,r_55_12_147,r_55_12_147,1.0,10,157,147,43
19,r_16_121_19,r_17_44_232,seq6,r_16_121_19,0.81,0,19,19,43
76,seq59,r_146_61_105,seq92,r_146_61_105,1.0,0,105,105,43
41,r_100_5_212,seq13,seq88,r_100_5_212,0.97,1,213,212,43
3,r_143_115_201,seq66,seq108,r_143_115_201,0.8,0,201,201,43
10,r_17_44_232,seq88,seq149,r_17_44_232,0.87,0,232,232,43
26,r_146_61_105,seq59,r_122_27_98,r_146_61_105,1.0,0,105,105,43
43,r_114_102_34,seq149,r_109_65_297,r_114_102_34,0.95,2,36,34,43
4,r_38_9_115,seq128,r_52_74_261,r_38_9_115,1.0,0,115,115,43
0,r_122_27_98,seq10,seq97,r_122_27_98,1.0,0,98,98,43
20,r_20_64_121,r_51_81_281,r_3_113_46,r_3_113_46,0.68,76,122,46,43
13,r_130_147_67,r_103_18_258,seq97,r_130_147_67,1.0,0,67,67,43
33,r_118_124_41,r_69_119_132,seq25,r_118_124_41,0.97,0,41,41,43
15,r_0_60_179,seq82,seq21,r_0_60_179,1.0,0,179,179,43
48,r_48_96_90,seq106,seq80,r_48_96_90,0.64,14,104,90,43
58,seq10,seq1,r_140_83_285,r_140_83_285,0.69,4,289,285,43
6,r_51_81_281,r_20_64_121,seq139,r_20_64_121,0.96,1,122,121,43
99,seq149,seq123,r_17_44_232,r_17_44_232,1.0,12,244,232,43
42,r_141_133_32,seq123,seq128,r_141_133_32,1.0,0,32,32,43
27,r_53_70_3,seq123,r_11_45_178,r_11_45_178,0.57,12,190,178,43
23,r_3_113_46,seq68,seq57,r_3_113_46,0.98,0,46,46,43
2,r_30_99_163,seq117,r_41_110_25,r_30_99_163,0.98,0,163,163,43
47,r_109_65_297,r_78_28_265,r_114_102_34,r_114_102_34,0.69,191,225,34,43
29,r_50_129_108,seq57,seq33,r_50_129_108,1.0,0,108,108,43
24,r_62_72_64,r_7_142_65,seq66,r_7_142_65,1.0,3,68,65,43
25,r_34_148_79,r_143_115_201,r_7_142_65,r_143_115_201,1.0,-122,79,201,43
85,seq82,r_69_119_132,r_30_99_163,r_30_99_163,0.47,106,269,163,43
50,seq128,r_38_9_115,r_141_133_32,r_38_9_115,0.54,-41,74,115,43
6,r_51_81_281,seq139,seq42,r_51_81_281,0.42,0,281,281,43
68,seq33,r_2_43_219,r_50_129_108,r_50_129_108,1.0,54,162,108,43
32,r_90_89_171,seq123,seq71,r_90_89_171,0.76,0,171,171,43
76,seq59,seq92,r_126_79_226,r_126_79_226,0.99,0,226,226,43
71,seq47,seq117,r_26_22_263,r_26_22_263,0.75,3,266,263,43
34,r_132_46_89,r_0_60_179,r_41_110_25,r_132_46_89,1.0,1,90,89,43
81,seq71,seq24,r_7_142_65,r_7_142_65,1.0,0,65,65,43
17,r_55_12_147,seq54,r_118_124_41,r_118_124_41,1.0,109,150,41,43
25,r_34_148_79,r_7_142_65,seq1,r_7_142_65,0.47,93,158,65,43
94,seq106,r_48_96_90,r_55_12_147,r_48_96_90,0.83,59,149,90,43
9,r_127_85_224,seq86,seq57,r_127_85_224,0.73,1,225,224,43
22,r_37_36_217,seq131,r_130_147_67,r_130_147_67,1.0,153,220,67,43
28,r_112_134_127,seq40,r_63_144_141,r_112_134_127,0.58,1,128,127,43
91,seq94,r_14_75_271,r_104_35_52,r_104_35_52,1.0,55,107,52,43
49,r_103_18_258,r_63_144_141,r_0_60_179,r_103_18_258,0.49,0,258,258,43
44,r_77_56_146,r_0_60_179,r_141_133_32,r_77_56_146,1.0,2,148,146,43
12,r_98_84_133,seq32,r_63_144_141,r_98_84_133,0.95,0,133,133,43
23,r_3_113_46,seq57,r_20_64_121,r_20_64_121,1.0,1,122,121,43
36,r_80_59_153,r_106_88_256,r_126_53_110,r_106_88_256,0.55,-101,155,256,44
92,seq100,seq49,r_13_55_107,r_13_55_107,1.0,47,154,107,44
14,r_98_131_95,seq83,seq5,r_98_131_95,0.94,0,95,95,44
58,seq142,r_79_132_211,r_124_12_167,r_124_12_167,0.67,4,171,167,44
37,r_95_137_103,seq138,seq93,r_95_137_103,0.77,0,103,103,44
59,seq143,r_120_82_286,seq87,r_120_82_286,0.6,-28,258,286,44
86,seq87,seq143,r_29_114_72,r_29_114_72,1.0,48,120,72,44
16,r_124_12_167,seq113,seq142,r_124_12_167,0.96,0,167,167,44
21,r_13_55_107,seq36,seq100,r_13_55_107,1.0,0,107,107,44
42,r_32_46_207,seq136,r_124_12_167,r_32_46_207,0.92,2,209,207,44
80,seq75,r_118_31_124,r_96_0_23,r_96_0_23,0.85,167,190,23,44
46,r_116_50_16,r_110_20_230,seq26,r_116_50_16,0.95,0,16,16,44
69,seq39,r_10_40_277,r_24_14_117,r_24_14_117,1.0,6,123,117,44
34,r_25_65_238,r_80_59_153,r_101_37_14,r_25_65_238,1.0,-3,235,238,44
31,r_15_64_60,r_10_40_277,seq149,r_15_64_60,0.33,173,233,60,44
89,seq93,r_58_105_234,r_95_137_103,r_95_137_103,0.71,135,238,103,44
10,r_126_53_110,r_11_33_177,r_25_65_238,r_11_33_177,0.7,-66,111,177,44
72,seq43,r_11_33_177,seq93,r_11_33_177,1.0,-4,173,177,44
28,r_147_38_47,r_80_59_153,seq83,r_147_38_47,0.68,0,47,47,44
4,r_110_20_230,seq36,seq138,r_110_20_230,0.8,1,231,230,44
39,r_134_66_226,r_30_21_42,seq39,r_30_21_42,0.95,3,45,42,44
11,r_101_37_14,r_110_20_230,seq123,r_101_37_14,0.97,0,14,14,44
20,r_70_52_91,r_22_128_200,seq45,r_70_52_91,0.98,0,91,91,44
13,r_73_44_122,seq75,r_140_119_44,r_140_119_44,0.69,24,68,44,44
98,seq115,seq4,r_17_102_33,r_17_102_33,0.99,198,231,33,44
15,r_121_71_184,seq77,seq49,r_121_71_184,0.98,1,185,184,44
6,r_146_139_108,r_97_133_297,seq129,r_146_139_108,1.0,0,108,108,44
48,r_117_57_11,seq4,seq93,r_117_57_11,0.99,-1,10,11,44
45,r_140_119_44,seq47,r_118_31_124,r_140_119_44,0.94,1,45,44,44
10,r_126_53_110,r_25_65_238,r_147_38_47,r_25_65_238,1.0,-19,219,238,44
27,r_9_74_228,seq129,seq104,r_9_74_228,0.35,1,229,228,44
30,r_30_21_42,r_25_65_238,r_126_53_110,r_126_53_110,0.62,125,235,110,44
2,r_135_8_170,r_58_105_234,seq94,r_135_8_170,0.79,7,177,170,44
40,r_141_108_217,r_118_31_124,r_24_14_117,r_141_108_217,0.52,1,218,217,44
18,r_127_60_129,r_106_88_256,seq76,r_127_60_129,0.9,2,131,129,44
29,r_63_16_252,seq77,r_124_12_167,r_63_16_252,0.52,1,253,252,44
24,r_79_132_211,seq142,r_1_54_67,r_79_132_211,0.76,0,211,211,44
35,r_23_48_40,seq62,r_11_33_177,r_11_33_177,0.58,-3,174,177,44
25,r_29_114_72,seq89,seq87,r_29_114_72,1.0,0,72,72,44
33,r_10_40_277,r_15_64_60,r_116_50_16,r_116_50_16,0.93,262,278,16,44
50,seq129,r_9_74_228,r_146_139_108,r_146_139_108,1.0,4,112,108,44
68,seq36,r_110_20_230,r_124_12_167,r_124_12_167,0.88,63,230,167,44
23,r_17_102_33,r_135_8_170,r_91_78_26,r_17_102_33,0.82,0,33,33,44
61,seq19,seq115,r_17_102_33,r_17_102_33,1.0,80,113,33,44
32,r_145_148_276,r_106_88_256,r_95_137_103,r_145_148_276,0.63,-20,256,276,44
38,r_68_144_104,r_1_54_67,r_22_128_200,r_68_144_104,0.99,0,104,104,44
34,r_25_65_238,seq99,r_80_59_153,r_80_59_153,0.64,23,176,153,44
13,r_73_44_122,r_140_119_44,r_126_53_110,r_73_44_122,0.98,1,123,122,44
22,r_96_0_23,r_15_64_60,seq75,r_96_0_23,0.9,-5,18,23,44
30,r_30_21_42,r_134_66_226,r_25_65_238,r_30_21_42,0.94,1,43,42,44
17,r_118_31_124,seq75,r_140_119_44,r_140_119_44,0.98,66,110,44,44
63,seq26,r_3_107_255,r_116_50_16,r_116_50_16,0.97,1,17,16,44
9,r_106_88_256,r_145_148_276,seq83,r_145_148_276,0.61,-20,256,276,44
58,seq142,r_23_48_40,r_79_132_211,r_23_48_40,0.83,-5,35,40,44
49,r_24_14_117,r_22_128_200,seq39,r_24_14_117,1.0,3,120,117,44
35,r_23_48_40,seq142,seq62,r_23_48_40,0.61,3,43,40,44
12,r_3_107_255,seq75,seq56,r_3_107_255,0.31,-4,251,255,44
7,r_1_54_67,seq99,seq138,r_1_54_67,0.57,-27,40,67,44
5,r_85_69_59,seq123,seq93,r_85_69_59,0.76,-4,55,59,44
30,r_28_86_152,seq131,r_40_128_155,r_28_86_152,1.0,3,155,152,45
9,r_116_4_142,seq54,seq32,r_116_4_142,0.99,0,142,142,45
8,r_82_67_292,r_45_41_281,r_26_69_12,r_26_69_12,0.57,273,285,12,45
53,seq131,r_28_86_152,seq17,r_28_86_152,1.0,-2,150,152,45
43,r_126_77_111,seq54,seq108,r_126_77_111,0.96,2,113,111,45
83,seq92,r_9_91_224,r_104_138_137,r_104_138_137,0.75,72,209,137,45
86,seq98,r_147_51_252,r_105_13_190,r_105_13_190,0.64,59,249,190,45
16,r_142_79_17,r_58_63_246,r_15_10_76,r_58_63_246,0.8,2,248,246,45
21,r_93_99_35,seq2,r_16_71_14,r_16_71_14,0.8,187,201,14,45
5,r_3_19_134,r_81_1_81,seq68,r_3_19_134,0.96,2,136,134,45
46,r_53_124_253,seq17,r_101_117_146,r_53_124_253,0.75,0,253,253,45
42,r_104_138_137,seq54,seq92,r_104_138_137,1.0,0,137,137,45
7,r_16_71_14,r_64_113_269,r_115_59_61,r_115_59_61,0.86,208,269,61,45
69,seq46,seq108,r_74_102_107,r_74_102_107,1.0,21,128,107,45
73,seq54,r_105_13_190,seq145,r_105_13_190,0.58,-19,171,190,45
45,r_137_123_164,r_80_25_235,seq78,r_137_123_164,0.75,6,170,164,45
41,r_45_41_281,r_80_25_235,r_136_20_248,r_45_41_281,0.6,2,283,281,45
12,r_64_113_269,r_84_8_25,r_16_71_14,r_16_71_14,0.67,9,23,14,45
19,r_101_117_146,seq145,seq111,r_101_117_146,1.0,0,146,146,45
41,r_45_41_281,r_82_67_292,r_26_69_12,r_26_69_12,0.61,0,12,12,45
94,seq114,r_81_1_81,r_107_148_48,r_107_148_48,1.0,2,50,48,45
67,seq42,r_6_21_201,seq145,r_6_21_201,0.98,0,201,201,45
3,r_61_70_58,r_101_117_146,seq17,r_61_70_58,1.0,0,58,58,45
67,seq42,seq145,r_136_20_248,r_136_20_248,0.74,25,273,248,45
10,r_139_125_202,seq66,r_112_43_135,r_112_43_135,1.0,10,145,135,45
90,seq108,r_72_135_194,r_120_149_129,r_120_149_129,1.0,29,158,129,45
26,r_115_59_61,seq78,r_16_71_14,r_115_59_61,0.88,0,61,61,45
24,r_80_25_235,r_45_41_281,r_26_69_12,r_45_41_281,1.0,2,283,281,45
0,r_37_34_163,r_103_55_291,seq56,r_37_34_163,0.97,2,165,163,45
20,r_40_128_155,seq127,r_28_86_152,r_40_128_155,0.99,0,155,155,45
13,r_109_36_271,r_27_132_219,seq32,r_109_36_271,0.27,-48,223,271,45
15,r_81_1_81,seq146,r_83_88_92,r_83_88_92,0.95,28,120,92,45
48,r_48_57_94,seq5,r_26_69_12,r_48_57_94,0.96,0,94,94,45
4,r_136_20_248,r_38_14_63,seq42,r_136_20_248,0.59,4,252,248,45
12,r_64_113_269,r_16_71_14,seq32,r_64_113_269,0.51,0,269,269,45
6,r_9_91_224,seq92,seq108,r_9_91_224,0.67,0,224,224,45
13,r_109_36_271,seq32,seq49,r_109_36_271,0.99,1,272,271,45
2,r_26_69_12,r_45_41_281,r_48_57_94,r_48_57_94,1.0,28,122,94,45
99,seq127,r_40_128_155,seq60,r_40_128_155,0.99,-57,98,155,45
10,r_139_125_202,r_112_43_135,seq89,r_139_125_202,0.96,4,206,202,45
27,r_73_144_176,r_53_124_253,r_37_34_163,r_73_144_176,0.95,0,176,176,45
74,seq56,seq141,r_37_34_163,r_37_34_163,1.0,4,167,163,45
87,seq100,r_80_25_235,r_24_11_8,r_80_25_235,0.87,2,237,235,45
41,r_45_41_281,r_26_69_12,r_80_25_235,r_80_25_235,0.63,2,237,235,45
47,r_22_140_180,seq133,seq146,r_22_140_180,0.95,0,180,180,45
29,r_147_51_252,seq98,r_116_4_142,r_116_4_142,0.54,109,251,142,45
24,r_80_25_235,seq100,r_45_41_281,r_80_25_235,0.66,2,237,235,45
33,r_6_21_201,seq42,seq85,r_6_21_201,0.75,0,201,201,45
31,r_65_130_169,seq141,seq106,r_65_130_169,1.0,0,169,169,45
65,seq133,r_22_140_180,r_103_55_291,r_22_140_180,1.0,0,180,180,45
4,r_136_20_248,r_15_10_76,r_38_14_63,r_136_20_248,0.61,-194,54,248,45
2,r_26_69_12,r_136_20_248,r_45_41_281,r_26_69_12,0.73,0,12,12,45
7,r_16_71_14,r_23_95_88,r_64_113_269,r_16_71_14,0.98,0,14,14,45
34,r_105_13_190,seq54,seq5,r_105_13_190,0.72,-2,188,190,45
17,r_87_90_250,seq145,seq31,r_87_90_250,0.41,2,252,250,45
18,r_38_14_63,r_139_125_202,r_136_20_248,r_139_125_202,0.71,-149,53,202,45
22,r_27_132_219,r_109_36_271,seq60,r_27_132_219,0.63,0,219,219,45
28,r_15_10_76,seq108,r_142_79_17,r_15_10_76,0.63,-6,70,76,45
49,r_83_88_92,r_23_95_88,r_81_1_81,r_83_88_92,0.91,4,96,92,45
18,r_38_14_63,r_136_20_248,r_15_10_76,r_38_14_63,0.47,189,252,63,45
44,r_35_52_130,seq50,r_38_14_63,r_35_52_130,0.89,0,130,130,45
23,r_112_43_135,seq121,r_139_125_202,r_112_43_135,1.0,1,136,135,45
35,r_75_94_181,seq50,r_142_79_17,r_75_94_181,0.86,0,181,181,45
23,r_112_43_135,r_139_125_202,seq31,r_139_125_202,0.72,4,206,202,45
40,r_121_120_203,seq8,r_1_60_111,r_1_60_111,1.0,0,111,111,46
40,r_121_120_203,seq69,seq8,r_121_120_203,0.5,-160,43,203,46
36,r_18_47_261,seq140,seq63,r_18_47_261,0.38,1,262,261,46
9,r_1_60_111,r_121_120_203,r_146_117_159,r_1_60_111,0.82,92,203,111,46
26,r_149_116_44,r_93_2_284,seq69,r_149_116_44,1.0,0,44,44,46
14,r_145_105_132,seq142,seq31,r_145_105_132,0.98,0,132,132,46
53,seq133,seq8,r_137_91_130,r_137_91_130,1.0,-1,129,130,46
40,r_121_120_203,r_55_61_212,r_41_103_62,r_55_61_212,0.64,13,225,212,46
4,r_54_21_51,r_138_148_217,r_29_62_53,r_29_62_53,1.0,0,53,53,46
54,seq6,r_46_135_221,r_52_64_191,r_52_64_191,0.79,16,207,191,46
83,seq78,r_73_3_144,seq39,r_73_3_144,1.0,0,144,144,46
59,seq17,r_14_23_260,r_108_59_93,r_108_59_93,1.0,134,227,93,46
55,seq8,seq133,r_146_117_159,r_146_117_159,1.0,1,160,159,46
71,seq48,r_5_71_201,r_86_53_79,r_86_53_79,1.0,25,104,79,46
16,r_86_53_79,r_138_148_217,seq48,r_86_53_79,1.0,1,80,79,46
21,r_11_147_188,seq39,seq66,r_11_147_188,0.99,1,189,188,46
1,r_30_126_94,seq39,seq65,r_30_126_94,1.0,1,95,94,46
42,r_108_59_93,seq81,r_14_23_260,r_108_59_93,1.0,0,93,93,46
58,seq16,r_28_94_21,r_129_13_148,r_129_13_148,1.0,1,149,148,46
24,r_14_23_260,r_108_59_93,r_124_45_26,r_14_23_260,0.58,0,260,260,46
33,r_104_125_73,r_112_10_293,r_29_62_53,r_29_62_53,0.7,171,224,53,46
49,r_29_62_53,seq100,seq95,r_29_62_53,1.0,0,53,53,46
41,r_119_92_193,seq100,r_83_70_84,r_119_92_193,0.92,0,193,193,46
67,seq38,seq27,r_41_103_62,r_41_103_62,1.0,29,91,62,46
3,r_33_77_206,seq130,r_129_13_148,r_33_77_206,1.0,0,206,206,46
89,seq88,r_119_92_193,r_124_45_26,r_124_45_26,0.85,2,28,26,46
0,r_129_13_148,seq144,seq16,r_129_13_148,1.0,1,149,148,46
11,r_41_103_62,r_89_141_45,seq38,r_41_103_62,1.0,0,62,62,46
13,r_134_26_225,seq27,seq40,r_134_26_225,0.82,-1,224,225,46
90,seq95,seq81,r_29_62_53,r_29_62_53,1.0,3,56,53,46
15,r_0_12_80,seq39,seq6,r_0_12_80,1.0,0,80,80,46
48,r_56_82_255,r_18_47_261,r_137_91_130,r_137_91_130,1.0,126,256,130,46
6,r_46_135_221,seq6,seq79,r_46_135_221,0.96,0,221,221,46
40,r_121_120_203,r_1_60_111,r_55_61_212,r_121_120_203,0.58,0,203,203,46
31,r_123_143_48,seq79,r_33_77_206,r_123_143_48,1.0,0,48,48,46
99,seq127,r_111_68_271,r_106_9_262,r_106_9_262,0.71,9,271,262,46
43,r_124_45_26,r_118_80_242,seq88,r_124_45_26,1.0,0,26,26,46
27,r_4_15_133,seq16,seq36,r_4_15_133,0.98,0,133,133,46
2,r_22_90_227,r_18_47_261,r_83_70_84,r_22_90_227,0.66,1,228,227,46
28,r_114_102_41,r_73_3_144,seq100,r_114_102_41,1.0,-1,40,41,46
29,r_51_96_60,r_20_107_291,r_138_148_217,r_51_96_60,0.99,0,60,60,46
24,r_14_23_260,seq17,r_108_59_93,r_108_59_93,1.0,25,118,93,46
25,r_83_70_84,seq85,r_51_96_60,r_51_96_60,1.0,43,103,60,46
33,r_104_125_73,r_46_135_221,r_112_10_293,r_104_125_73,1.0,0,73,73,46
82,seq76,r_30_126_94,r_5_71_201,r_5_71_201,0.87,43,244,201,46
58,seq16,r_4_15_133,r_28_94_21,r_28_94_21,0.87,112,133,21,46
65,seq36,seq75,r_4_15_133,r_4_15_133,1.0,42,175,133,46
42,r_108_59_93,r_14_23_260,seq17,r_14_23_260,0.88,-12,248,260,46
61,seq25,r_139_131_247,r_30_126_94,r_30_126_94,0.95,100,194,94,46
32,r_146_117_159,seq128,seq8,r_146_117_159,0.99,2,161,159,46
38,r_137_91_130,r_22_90_227,seq133,r_137_91_130,0.93,1,131,130,46
34,r_52_64_191,seq99,seq6,r_52_64_191,0.58,2,193,191,46
9,r_1_60_111,seq49,r_121_120_203,r_1_60_111,0.7,0,111,111,46
31,r_123_143_48,r_33_77_206,r_73_3_144,r_123_143_48,0.99,107,155,48,46
29,r_51_96_60,r_138_148_217,r_22_90_227,r_22_90_227,1.0,7,234,227,46
45,r_42_34_46,seq36,seq79,r_42_34_46,0.79,7,53,46,46
22,r_5_71_201,seq44,seq76,r_5_71_201,0.85,1,202,201,46
56,seq140,r_18_47_261,seq132,r_18_47_261,0.85,1,262,261,46
44,r_112_10_293,seq81,r_104_125_73,r_104_125_73,1.0,15,88,73,46
82,seq76,r_58_113_23,r_30_126_94,r_30_126_94,0.75,43,137,94,46
35,r_139_131_247,seq25,seq115,r_139_131_247,0.52,1,248,247,46
23,r_28_94_21,r_54_21_51,seq16,r_28_94_21,0.96,0,21,21,46
12,r_110_98_150,r_139_131_247,seq6,r_110_98_150,1.0,0,150,150,46
84,seq79,seq63,r_42_34_46,r_42_34_46,0.98,66,112,46,46
30,r_121_14_190,seq21,seq24,r_121_14_190,0.84,2,192,190,47
51,seq4,seq135,r_111_45_151,r_111_45_151,0.98,8,159,151,47
14,r_74_114_129,seq99,seq125,r_74_114_129,0.92,2,131,129,47
93,seq109,r_85_42_49,r_108_39_259,r_85_42_49,1.0,1,50,49,47
1,r_94_7_32,r_52_81_296,seq32,r_94_7_32,0.75,0,32,32,47
37,r_1_113_68,r_6_70_217,seq119,r_1_113_68,1.0,0,68,68,47
16,r_62_72_278,seq56,r_126_133_267,r_126_133_267,0.98,13,280,267,47
42,r_130_50_30,seq125,seq16,r_130_50_30,1.0,0,30,30,47
21,r_89_138_76,r_0_54_145,seq125,r_89_138_76,0.99,4,80,76,47
39,r_3_128_163,seq125,seq25,r_3_128_163,0.99,0,163,163,47
5,r_126_133_267,seq27,r_139_142_191,r_126_133_267,0.55,0,267,267,47
46,r_12_22_274,seq148,r_40_49_96,r_40_49_96,1.0,20,116,96,47
80,seq76,r_145_118_213,r_141_78_103,r_141_78_103,1.0,18,121,103,47
68,seq32,r_102_34_104,r_94_7_32,r_94_7_32,0.86,12,44,32,47
45,r_33_55_67,r_66_58_216,r_147_11_14,r_33_55_67,0.99,0,67,67,47
19,r_51_65_4,r_117_131_233,seq82,r_117_131_233,0.99,0,233,233,47
95,seq119,r_102_34_104,r_1_113_68,r_1_113_68,0.99,37,105,68,47
66,seq27,r_126_133_267,r_129_5_82,r_129_5_82,1.0,185,267,82,47
31,r_40_49_96,seq16,r_12_22_274,r_40_49_96,1.0,0,96,96,47
41,r_43_13_176,r_108_39_259,seq82,r_43_13_176,0.51,-70,106,176,47
89,seq99,r_74_114_129,seq17,r_74_114_129,1.0,2,131,129,47
3,r_57_88_180,r_147_11_14,seq16,r_57_88_180,0.99,0,180,180,47
10,r_41_63_269,seq36,r_121_14_190,r_121_14_190,0.8,79,269,190,47
90,seq100,r_141_78_103,r_116_26_210,r_141_78_103,0.56,0,103,103,47
26,r_110_53_110,seq75,r_94_7_32,r_110_53_110,0.68,0,110,110,47
72,seq44,r_19_73_158,seq17,r_19_73_158,0.92,3,161,158,47
0,r_61_90_219,r_60_31_215,seq76,r_61_90_219,0.98,-1,218,219,47
11,r_116_26_210,seq84,seq86,r_116_26_210,0.9,0,210,210,47
20,r_139_142_191,r_62_72_278,r_83_38_92,r_83_38_92,0.92,100,192,92,47
13,r_66_58_216,r_33_55_67,r_9_127_143,r_33_55_67,0.7,0,67,67,47
46,r_12_22_274,r_40_49_96,r_61_90_219,r_61_90_219,0.98,64,283,219,47
15,r_60_31_215,r_61_90_219,r_108_39_259,r_61_90_219,1.0,-1,218,219,47
48,r_18_112_102,r_102_34_104,r_52_81_296,r_18_112_102,0.88,0,102,102,47
4,r_79_105_17,r_52_81_296,r_61_90_219,r_61_90_219,0.99,24,243,219,47
57,seq143,seq84,r_102_34_104,r_102_34_104,1.0,100,204,104,47
13,r_66_58_216,r_9_127_143,r_74_114_129,r_9_127_143,0.52,2,145,143,47
6,r_120_46_78,r_141_78_103,seq21,r_120_46_78,0.98,0,78,78,47
21,r_89_138_76,seq125,r_74_114_129,r_74_114_129,1.0,101,230,129,47
2,r_102_34_104,r_116_26_210,seq143,r_116_26_210,1.0,-5,205,210,47
27,r_134_103_98,seq76,seq97,r_134_103_98,0.91,-3,95,98,47
8,r_85_42_49,seq109,seq148,r_85_42_49,1.0,0,49,49,47
2,r_102_34_104,seq119,r_116_26_210,r_102_34_104,0.83,1,105,104,47
40,r_19_73_158,seq44,seq10,r_19_73_158,0.96,3,161,158,47
18,r_117_131_233,r_51_65_4,seq100,r_117_131_233,0.64,0,233,233,47
29,r_68_8_223,r_144_104_294,r_57_88_180,r_144_104_294,0.95,-71,223,294,47
24,r_67_77_239,r_144_104_294,seq30,r_144_104_294,0.43,-49,245,294,47
48,r_18_112_102,r_52_81_296,r_61_90_219,r_61_90_219,1.0,21,240,219,47
65,seq25,seq137,r_3_128_163,r_3_128_163,1.0,0,163,163,47
88,seq97,seq148,r_134_103_98,r_134_103_98,0.94,17,115,98,47
72,seq44,seq17,r_66_58_216,r_66_58_216,0.75,2,218,216,47
58,seq16,r_80_71_162,r_130_50_30,r_130_50_30,1.0,41,71,30,47
70,seq36,r_41_63_269,r_57_88_180,r_57_88_180,0.95,89,269,180,47
38,r_123_106_94,r_126_133_267,r_33_55_67,r_123_106_94,0.6,0,94,94,47
77,seq64,r_12_22_274,r_15_98_211,r_15_98_211,0.49,6,217,211,47
34,r_15_98_211,seq2,seq64,r_15_98_211,0.72,1,212,211,47
45,r_33_55_67,r_147_11_14,r_123_106_94,r_123_106_94,0.96,58,152,94,47
81,seq82,r_61_90_219,r_51_65_4,r_61_90_219,0.94,0,219,219,47
17,r_129_5_82,r_121_14_190,seq27,r_129_5_82,1.0,0,82,82,47
94,seq115,r_57_88_180,r_123_106_94,r_123_106_94,0.98,1,95,94,47
96,seq122,r_6_70_217,r_147_11_14,r_6_70_217,1.0,-13,204,217,47
31,r_40_49_96,r_12_22_274,r_126_133_267,r_126_133_267,0.81,16,283,267,47
22,r_6_70_217,seq122,seq37,r_6_70_217,0.98,0,217,217,47
28,r_141_78_103,seq100,seq76,r_141_78_103,1.0,0,103,103,47
49,r_145_118_213,seq76,seq148,r_145_118_213,0.46,0,213,213,47
4,r_79_105_17,r_61_90_219,r_52_81_296,r_79_105_17,1.0,-1,16,17,47
44,r_83_38_92,r_68_8_223,seq97,r_83_38_92,0.91,0,92,92,47
23,r_9_127_143,r_61_90_219,seq100,r_9_127_143,0.9,0,143,143,47
7,r_52_81_296,r_94_7_32,r_79_105_17,r_94_7_32,0.65,0,32,32,47
32,r_20_29_33,seq148,seq2,r_20_29_33,0.55,4,37,33,47
35,r_111_45_151,seq24,seq4,r_111_45_151,0.8,0,151,151,47
51,seq3,r_97_54_288,r_145_68_146,r_145_68_146,1.0,2,148,146,48
36,r_86_111_66,r_43_9_93,r_99_53_59,r_43_9_93,1.0,-27,66,93,48
8,r_24_113_156,r_131_61_181,r_7_96_21,r_24_113_156,1.0,2,158,156,48
53,seq135,r_139_127_194,r_95_26_295,r_139_127_194,0.46,-100,94,194,48
43,r_97_54_288,seq116,r_59_73_109,r_59_73_109,0.53,179,288,109,48
37,r_114_110_261,r_104_83_255,r_129_1_134,r_129_1_134,1.0,39,173,134,48
16,r_7_96_21,seq122,r_88_66_2,r_7_96_21,1.0,0,21,21,48
71,seq52,seq42,r_99_53_59,r_99_53_59,1.0,81,140,59,48
86,seq94,r_86_111_66,r_27_50_35,r_86_111_66,1.0,0,66,66,48
39,r_59_73_109,r_98_134_251,seq123,r_59_73_109,1.0,0,109,109,48
12,r_15_64_166,r_6_63_119,r_2_51_196,r_6_63_119,0.77,-70,49,119,48
1,r_146_48_203,seq28,seq78,r_146_48_203,0.64,0,203,203,48
97,seq123,r_84_16_191,r_59_73_109,r_59_73_109,0.94,6,115,109,48
5,r_6_63_119,seq78,seq92,r_6_63_119,1.0,0,119,119,48
46,r_131_61_181,seq69,r_46_40_280,r_131_61_181,0.98,0,181,181,48
42,r_43_9_93,seq94,seq69,r_43_9_93,1.0,0,93,93,48
45,r_108_18_204,seq138,r_95_26_295,r_108_18_204,0.71,2,206,204,48
19,r_19_132_90,seq116,seq12,r_19_132_90,1.0,2,92,90,48
9,r_8_120_41,r_146_48_203,seq106,r_8_120_41,0.98,-1,40,41,48
76,seq72,r_84_16_191,r_59_73_109,r_59_73_109,0.95,82,191,109,48
7,r_99_53_59,seq142,r_86_111_66,r_86_111_66,0.83,44,110,66,48
62,seq28,r_129_1_134,seq116,r_129_1_134,0.84,124,258,134,48
31,r_139_127_194,seq106,seq55,r_139_127_194,0.92,0,194,194,48
33,r_143_109_56,seq90,seq106,r_143_109_56,1.0,1,57,56,48
41,r_88_66_2,r_129_1_134,r_91_58_287,r_129_1_134,0.93,-52,82,134,48
67,seq41,r_2_51_196,seq117,r_2_51_196,0.87,0,196,196,48
3,r_29_10_120,r_84_16_191,seq12,r_29_10_120,1.0,1,121,120,48
10,r_137_149_201,seq42,r_56_62_40,r_56_62_40,1.0,22,62,40,48
64,seq32,r_137_149_201,r_56_62_40,r_56_62_40,1.0,-1,39,40,48
26,r_37_87_58,r_129_1_134,seq115,r_37_87_58,0.95,5,63,58,48
4,r_79_71_225,r_25_107_292,r_43_9_93,r_79_71_225,0.91,0,225,225,48
0,r_23_39_94,seq92,seq3,r_23_39_94,1.0,0,94,94,48
11,r_46_40_280,r_44_82_299,r_139_127_194,r_139_127_194,0.87,87,281,194,48
20,r_129_1_134,r_88_66_2,r_114_110_261,r_129_1_134,0.98,0,134,134,48
13,r_121_38_217,r_95_26_295,seq102,r_121_38_217,0.57,0,217,217,48
46,r_131_61_181,r_46_40_280,r_98_134_251,r_98_134_251,0.53,30,281,251,48
15,r_84_16_191,seq72,seq81,r_84_16_191,0.93,0,191,191,48
48,r_67_0_213,seq55,r_70_11_177,r_67_0_213,0.85,0,213,213,48
17,r_4_36_37,r_145_68_146,seq124,r_4_36_37,0.77,0,37,37,48
12,r_15_64_166,r_2_51_196,seq125,r_15_64_166,0.89,0,166,166,48
6,r_119_77_268,seq33,r_24_113_156,r_24_113_156,0.72,114,270,156,48
62,seq28,r_146_48_203,r_143_109_56,r_143_109_56,1.0,147,203,56,48
14,r_57_93_19,seq101,seq125,r_57_93_19,1.0,0,19,19,48
21,r_145_68_146,r_56_62_40,seq3,r_145_68_146,1.0,0,146,146,48
85,seq92,r_23_39_94,r_79_71_225,r_23_39_94,0.95,0,94,94,48
99,seq125,r_74_30_293,r_15_64_166,r_15_64_166,1.0,15,181,166,48
0,r_23_39_94,seq3,r_2_51_196,r_2_51_196,1.0,11,207,196,48
10,r_137_149_201,r_56_62_40,r_103_133_36,r_137_149_201,0.98,0,201,201,48
53,seq135,r_95_26_295,r_114_110_261,r_114_110_261,0.5,0,261,261,48
21,r_145_68_146,r_4_36_37,r_56_62_40,r_56_62_40,0.71,0,40,40,48
2,r_98_134_251,seq60,r_131_61_181,r_98_134_251,0.92,0,251,251,48
41,r_88_66_2,r_91_58_287,r_70_11_177,r_70_11_177,1.0,27,204,177,48
18,r_130_13_219,seq128,seq12,r_130_13_219,0.97,0,219,219,48
25,r_95_26_295,r_22_34_188,r_108_18_204,r_95_26_295,0.67,-106,189,295,48
50,seq128,seq33,r_103_133_36,r_103_133_36,1.0,50,86,36,48
20,r_129_1_134,r_114_110_261,r_23_39_94,r_129_1_134,0.48,146,280,134,48
38,r_70_11_177,seq128,r_88_66_2,r_70_11_177,1.0,0,177,177,48
96,seq122,r_145_68_146,r_21_118_289,r_145_68_146,1.0,-98,48,146,48
34,r_44_82_299,r_46_40_280,r_98_134_251,r_98_134_251,0.9,30,281,251,48
75,seq69,r_131_61_181,r_43_9_93,r_43_9_93,0.51,88,181,93,48
29,r_21_118_289,r_145_68_146,r_56_62_40,r_21_118_289,0.54,-241,48,289,48
68,seq42,r_137_149_201,r_56_62_40,r_56_62_40,0.83,8,48,40,48
81,seq81,r_25_107_292,r_84_16_191,r_84_16_191,0.94,0,191,191,48
37,r_114_110_261,r_129_1_134,seq135,r_114_110_261,0.95,0,261,261,48
84,seq90,r_143_109_56,seq55,r_143_109_56,1.0,1,57,56,48
29,r_21_118_289,r_56_62_40,seq122,r_56_62_40,0.56,172,212,40,48
28,r_91_58_287,r_88_66_2,r_137_149_201,r_137_149_201,0.73,88,289,201,48
22,r_103_133_36,r_6_63_119,seq128,r_103_133_36,0.94,1,37,36,48
49,r_2_51_196,seq41,r_23_39_94,r_2_51_196,0.97,0,196,196,48
23,r_22_34_188,r_95_26_295,r_27_50_35,r_95_26_295,0.84,-106,189,295,48
79,seq78,r_6_63_119,r_67_0_213,r_6_63_119,1.0,0,119,119,48
35,r_104_83_255,r_114_110_261,r_56_62_40,r_114_110_261,0.85,-6,255,261,48
44,r_27_50_35,seq31,seq94,r_27_50_35,0.99,3,38,35,48
36,r_52_73_155,seq93,seq54,r_52_73_155,0.72,0,155,155,49
14,r_32_46_72,r_106_65_178,seq87,r_32_46_72,1.0,1,73,72,49
8,r_36_35_12,r_58_53_261,r_104_110_17,r_36_35_12,0.61,170,182,12,49
53,seq133,r_42_81_171,r_126_20_283,r_42_81_171,1.0,-9,162,171,49
43,r_138_1_152,seq15,seq128,r_138_1_152,0.99,0,152,152,49
54,seq6,r_95_39_82,r_71_27_67,r_71_27_67,0.83,4,71,67,49
81,seq79,r_49_139_47,r_78_127_50,r_78_127_50,0.33,162,212,50,49
37,r_119_69_68,seq90,r_84_7_70,r_119_69_68,1.0,3,71,68,49
54,seq6,r_71_27_67,r_9_80_188,r_9_80_188,1.0,0,188,188,49
86,seq90,r_125_123_237,r_106_65_178,r_106_65_178,0.88,59,237,178,49
21,r_84_7_70,r_56_61_278,r_119_69_68,r_119_69_68,0.75,5,73,68,49
39,r_98_145_123,r_26_100_266,seq128,r_98_145_123,1.0,0,123,123,49
5,r_74_143_62,r_16_92_234,seq90,r_74_143_62,1.0,0,62,62,49
46,r_4_41_167,seq109,seq75,r_4_41_167,0.96,2,169,167,49
80,seq76,r_77_114_284,r_50_14_265,r_50_14_265,0.88,19,284,265,49
32,r_106_65_178,seq146,seq90,r_106_65_178,1.0,1,179,178,49
24,r_11_94_114,r_89_38_277,r_71_27_67,r_89_38_277,1.0,-13,264,277,49
19,r_58_53_261,seq22,seq33,r_58_53_261,0.55,0,261,261,49
33,r_3_85_267,seq33,r_43_57_238,r_3_85_267,0.44,0,267,267,49
95,seq115,r_50_14_265,r_2_117_107,r_2_117_107,1.0,-1,106,107,49
38,r_108_17_149,r_74_143_62,seq142,r_108_17_149,1.0,0,149,149,49
31,r_60_62_102,r_58_53_261,r_103_67_42,r_103_67_42,1.0,81,123,42,49
3,r_5_24_210,seq86,seq33,r_5_24_210,0.76,2,212,210,49
10,r_95_39_82,seq6,r_28_66_118,r_95_39_82,0.96,1,83,82,49
23,r_103_67_42,r_113_107_76,r_60_62_102,r_113_107_76,1.0,0,76,76,49
26,r_18_120_156,r_111_64_294,r_131_37_90,r_18_120_156,0.99,0,156,156,49
72,seq45,r_28_66_118,r_113_107_76,r_113_107_76,1.0,42,118,76,49
23,r_103_67_42,r_131_37_90,r_113_107_76,r_103_67_42,0.94,0,42,42,49
4,r_71_27_67,r_3_85_267,seq6,r_71_27_67,1.0,0,67,67,49
0,r_89_38_277,seq6,r_11_94_114,r_11_94_114,0.71,43,157,114,49
11,r_137_44_285,r_130_141_145,seq142,r_130_141_145,0.85,0,145,145,49
20,r_43_57_238,r_48_83_186,r_119_69_68,r_43_57_238,0.99,-45,193,238,49
13,r_28_66_118,seq149,r_95_39_82,r_95_39_82,0.99,11,93,82,49
15,r_113_107_76,r_23_116_229,seq45,r_113_107_76,1.0,0,76,76,49
48,r_135_118_103,seq112,seq86,r_135_118_103,1.0,1,104,103,49
57,seq140,r_131_37_90,r_3_85_267,r_131_37_90,1.0,0,90,90,49
6,r_77_114_284,seq76,r_74_143_62,r_74_143_62,0.94,222,284,62,49
30,r_104_110_17,r_138_1_152,r_36_35_12,r_104_110_17,1.0,0,17,17,49
7,r_16_92_234,seq54,r_119_69_68,r_119_69_68,1.0,24,92,68,49
5,r_74_143_62,seq90,r_23_116_229,r_23_116_229,1.0,0,229,229,49
0,r_89_38_277,r_11_94_114,r_101_63_263,r_89_38_277,0.78,0,277,277,49
27,r_42_81_171,seq133,seq82,r_42_81_171,0.92,0,171,171,49
53,seq133,r_126_20_283,r_12_30_180,r_126_20_283,0.71,0,283,283,49
47,r_125_123_237,seq90,seq140,r_125_123_237,0.96,0,237,237,49
40,r_48_83_186,r_43_57_238,seq140,r_48_83_186,0.98,0,186,186,49
18,r_51_70_215,seq97,seq132,r_51_70_215,0.99,0,215,215,49
24,r_11_94_114,seq115,r_89_38_277,r_89_38_277,0.76,-161,116,277,49
25,r_50_14_265,seq115,seq75,r_50_14_265,0.47,0,265,265,49
42,r_78_127_50,r_23_116_229,seq147,r_78_127_50,1.0,-3,47,50,49
68,seq33,r_3_85_267,r_58_53_261,r_58_53_261,0.69,2,263,261,49
61,seq144,r_23_116_229,seq124,r_23_116_229,1.0,0,229,229,49
7,r_16_92_234,r_119_69_68,r_29_10_203,r_119_69_68,1.0,164,232,68,49
32,r_106_65_178,r_32_46_72,seq146,r_32_46_72,1.0,-8,64,72,49
38,r_108_17_149,r_119_69_68,r_74_143_62,r_108_17_149,0.99,-81,68,149,49
33,r_3_85_267,r_71_27_67,seq33,r_71_27_67,1.0,-23,44,67,49
57,seq140,r_3_85_267,r_48_83_186,r_48_83_186,0.95,2,188,186,49
9,r_49_139_47,r_29_10_203,seq75,r_49_139_47,1.0,3,50,47,49
34,r_130_141_145,r_137_44_285,r_131_37_90,r_130_141_145,0.95,0,145,145,49
7,r_16_92_234,r_74_143_62,seq54,r_74_143_62,0.6,-19,43,62,49
75,seq54,seq97,r_52_73_155,r_52_73_155,0.84,1,156,155,49
81,seq79,r_111_64_294,r_49_139_47,r_49_139_47,0.99,23,70,47,49
17,r_19_68_250,seq133,r_16_92_234,r_19_68_250,0.72,2,252,250,49
22,r_131_37_90,seq140,seq115,r_131_37_90,1.0,0,90,90,49
28,r_56_61_278,seq102,seq0,r_56_61_278,0.47,0,278,278,49
91,seq102,r_56_61_278,seq8,r_56_61_278,0.54,0,278,278,49
49,r_29_10_203,seq97,r_56_61_278,r_29_10_203,0.65,1,204,203,49
35,r_2_117_107,r_106_65_178,seq115,r_2_117_107,1.0,0,107,107,49
12,r_101_63_263,seq146,seq140,r_101_63_263,0.67,0,263,263,49
49,r_29_10_203,r_56_61_278,r_16_92_234,r_29_10_203,0.86,51,254,203,49
84,seq87,seq121,r_32_46_72,r_32_46_72,1.0,3,75,72,49
51,seq2,r_18_33_168,seq25,r_18_33_168,0.97,3,171,168,50
36,r_54_78_92,seq53,seq81,r_54_78_92,1.0,0,92,92,50
14,r_74_93_151,seq73,seq36,r_74_93_151,0.81,1,152,151,50
43,r_88_50_227,seq45,r_5_106_220,r_5_106_220,0.83,8,228,220,50
83,seq81,seq131,r_54_78_92,r_54_78_92,1.0,50,142,92,50
59,seq145,seq128,r_122_97_90,r_122_97_90,1.0,2,92,90,50
55,seq135,r_43_143_193,r_136_35_59,r_43_143_193,1.0,1,194,193,50
71,seq45,r_88_50_227,r_133_107_47,r_133_107_47,0.99,172,219,47,50
39,r_85_142_89,seq75,seq131,r_85_142_89,0.59,-15,74,89,50
1,r_77_132_34,seq37,r_54_78_92,r_54_78_92,1.0,11,103,92,50
97,seq121,r_76_9_231,r_117_65_66,r_117_65_66,1.0,25,91,66,50
5,r_5_106_220,seq55,seq71,r_5_106_220,0.93,0,220,220,50
46,r_32_48_172,r_99_7_137,r_29_14_17,r_99_7_137,0.7,0,137,137,50
18,r_27_15_26,r_54_78_92,r_30_87_197,r_30_87_197,0.7,-171,26,197,50
8,r_12_13_199,seq25,r_96_140_35,r_96_140_35,0.95,19,54,35,50
45,r_147_111_183,seq94,seq120,r_147_111_183,0.73,5,188,183,50
15,r_29_14_17,r_51_141_93,r_39_112_14,r_51_141_93,0.99,-77,16,93,50
19,r_40_68_100,seq10,seq63,r_40_68_100,1.0,1,101,100,50
1,r_77_132_34,r_26_52_4,seq37,r_77_132_34,1.0,0,34,34,50
16,r_108_148_20,r_96_140_35,seq4,r_108_148_20,0.84,0,20,20,50
4,r_80_118_12,r_41_100_234,seq98,r_80_118_12,1.0,0,12,12,50
31,r_28_69_84,r_46_149_208,seq146,r_28_69_84,0.84,7,91,84,50
67,seq36,r_136_35_59,r_74_93_151,r_74_93_151,0.99,-5,146,151,50
37,r_133_107_47,r_30_87_197,r_88_50_227,r_133_107_47,0.99,1,48,47,50
10,r_76_9_231,seq121,r_27_15_26,r_27_15_26,0.99,65,91,26,50
90,seq103,r_67_113_213,r_66_116_275,r_66_116_275,0.68,8,283,275,50
26,r_58_11_198,r_41_100_234,r_40_68_100,r_58_11_198,0.53,0,198,198,50
8,r_12_13_199,r_96_140_35,r_110_59_179,r_12_13_199,0.97,1,200,199,50
78,seq63,r_129_89_284,r_40_68_100,r_40_68_100,1.0,1,101,100,50
0,r_99_7_137,r_32_48_172,seq49,r_99_7_137,0.64,0,137,137,50
73,seq49,seq86,r_99_7_137,r_99_7_137,0.94,-13,124,137,50
11,r_117_65_66,r_40_68_100,seq121,r_117_65_66,1.0,0,66,66,50
20,r_95_60_170,r_76_9_231,seq22,r_95_60_170,0.87,0,170,170,50
13,r_43_143_193,seq135,seq94,r_43_143_193,1.0,1,194,193,50
2,r_41_100_234,r_108_148_20,seq145,r_41_100_234,0.87,1,235,234,50
48,r_125_124_68,seq2,seq131,r_125_124_68,0.99,-1,67,68,50
17,r_44_92_37,seq22,r_27_15_26,r_44_92_37,0.94,0,37,37,50
6,r_90_82_146,seq101,r_133_107_47,r_90_82_146,1.0,0,146,146,50
10,r_76_9_231,r_27_15_26,r_134_17_33,r_76_9_231,0.97,2,233,231,50
27,r_67_113_213,seq103,r_44_92_37,r_44_92_37,1.0,166,203,37,50
61,seq19,r_67_113_213,seq103,r_67_113_213,0.54,-67,146,213,50
2,r_41_100_234,r_58_11_198,r_108_148_20,r_41_100_234,0.67,-36,198,234,50
41,r_134_17_33,seq22,r_76_9_231,r_76_9_231,0.85,15,246,231,50
47,r_122_97_90,r_51_141_93,seq145,r_122_97_90,0.98,0,90,90,50
40,r_139_24_209,seq23,r_44_92_37,r_44_92_37,1.0,186,223,37,50
74,seq53,r_54_78_92,seq145,r_54_78_92,1.0,0,92,92,50
35,r_102_3_6,seq53,r_133_107_47,r_133_107_47,0.57,123,170,47,50
33,r_0_61_222,seq57,seq25,r_0_61_222,0.85,0,222,222,50
64,seq23,r_139_24_209,r_29_14_17,r_29_14_17,0.69,230,247,17,50
68,seq37,r_32_48_172,r_84_79_286,r_32_48_172,0.92,0,172,172,50
42,r_96_140_35,r_12_13_199,seq25,r_12_13_199,1.0,-28,171,199,50
61,seq19,r_130_70_192,r_67_113_213,r_130_70_192,0.4,-89,103,192,50
32,r_129_89_284,seq57,r_110_59_179,r_110_59_179,0.79,105,284,179,50
38,r_110_59_179,seq16,seq8,r_110_59_179,1.0,1,180,179,50
41,r_134_17_33,r_43_143_193,seq22,r_134_17_33,1.0,0,33,33,50
60,seq146,seq8,r_28_69_84,r_28_69_84,1.0,51,135,84,50
12,r_62_109_16,seq25,seq6,r_62_109_16,1.0,0,16,16,50
9,r_46_149_208,r_137_21_262,seq37,r_46_149_208,0.97,0,208,208,50
53,seq4,r_41_100_234,r_108_148_20,r_108_148_20,0.8,0,20,20,50
37,r_133_107_47,r_88_50_227,r_90_82_146,r_90_82_146,1.0,2,148,146,50
29,r_30_87_197,r_27_15_26,seq71,r_30_87_197,0.74,0,197,197,50
28,r_130_70_192,r_139_24_209,seq128,r_130_70_192,0.93,0,192,192,50
91,seq104,r_12_13_199,seq25,r_12_13_199,1.0,1,200,199,50
42,r_96_140_35,seq131,r_12_13_199,r_96_140_35,0.94,0,35,35,50
56,seq8,seq146,r_110_59_179,r_110_59_179,1.0,2,181,179,50
18,r_27_15_26,r_30_87_197,r_117_65_66,r_27_15_26,0.49,171,197,26,50
44,r_51_141_93,r_147_111_183,seq47,r_51_141_93,1.0,0,93,93,50
23,r_144_127_178,r_43_143_193,r_39_112_14,r_144_127_178,0.94,0,178,178,50
17,r_44_92_37,r_27_15_26,r_67_113_213,r_67_113_213,1.0,-3,210,213,50
82,seq75,r_85_142_89,r_39_112_14,r_39_112_14,0.85,60,74,14,50
29,r_30_87_197,r_76_9_231,r_27_15_26,r_27_15_26,1.0,11,37,26,50
35,r_102_3_6,r_88_50_227,seq53,r_102_3_6,0.46,58,64,6,50
46,r_32_48_172,r_29_14_17,r_108_148_20,r_29_14_17,0.82,155,172,17,50
93,seq100,r_66_129_255,r_37_128_132,r_37_128_132,0.97,137,269,132,51
37,r_25_57_251,r_69_72_110,r_94_78_3,r_69_72_110,1.0,-63,47,110,51
36,r_7_117_288,r_107_63_173,r_93_116_104,r_107_63_173,0.67,1,174,173,51
48,r_110_32_31,r_52_108_217,seq59,r_110_32_31,1.0,0,31,31,51
14,r_107_63_173,r_7_117_288,seq46,r_107_63_173,0.96,2,175,173,51
8,r_69_72_110,r_25_57_251,seq149,r_69_72_110,1.0,0,110,110,51
3,r_105_23_47,r_12_98_220,r_7_117_288,r_7_117_288,0.84,-125,163,288,51
22,r_95_1_16,seq19,seq15,r_95_1_16,1.0,1,17,16,51
55,seq11,r_33_80_291,r_126_130_85,r_126_130_85,1.0,71,156,85,51
39,r_93_116_104,r_29_109_115,r_7_117_288,r_93_116_104,0.61,-6,98,104,51
1,r_141_138_283,seq24,r_21_2_202,r_141_138_283,0.27,1,284,283,51
46,r_94_78_3,r_25_57_251,seq90,r_25_57_251,0.68,-5,246,251,51
42,r_12_98_220,r_36_67_236,r_132_53_136,r_36_67_236,0.92,-16,220,236,51
45,r_37_128_132,r_66_129_255,seq121,r_37_128_132,0.77,0,132,132,51
19,r_126_130_85,r_34_85_234,seq56,r_126_130_85,1.0,0,85,85,51
95,seq112,r_134_49_94,r_148_143_179,r_134_49_94,1.0,-12,82,94,51
38,r_58_83_56,r_12_98_220,r_105_23_47,r_12_98_220,0.86,1,221,220,51
39,r_93_116_104,r_7_117_288,r_103_54_74,r_103_54_74,0.61,214,288,74,51
31,r_104_89_130,seq48,r_134_49_94,r_104_89_130,0.94,0,130,130,51
41,r_137_5_95,seq51,r_110_32_31,r_137_5_95,0.93,-1,94,95,51
38,r_58_83_56,r_105_23_47,r_77_122_257,r_58_83_56,0.8,208,264,56,51
10,r_16_18_80,seq6,seq147,r_16_18_80,1.0,0,80,80,51
90,seq90,r_52_108_217,seq51,r_52_108_217,0.91,0,217,217,51
26,r_131_0_183,seq70,seq26,r_131_0_183,0.68,0,183,183,51
4,r_81_22_61,r_148_143_179,r_13_55_15,r_81_22_61,1.0,0,61,61,51
78,seq56,r_141_138_283,r_126_130_85,r_126_130_85,1.0,9,94,85,51
0,r_77_122_257,seq15,r_58_83_56,r_77_122_257,0.41,0,257,257,51
63,seq26,r_71_82_159,r_119_39_32,r_119_39_32,0.73,129,161,32,51
11,r_66_129_255,seq100,r_148_143_179,r_148_143_179,1.0,76,255,179,51
32,r_119_39_32,r_148_143_179,seq30,r_119_39_32,1.0,0,32,32,51
20,r_148_143_179,seq79,seq60,r_148_143_179,0.97,-1,178,179,51
63,seq26,r_119_39_32,r_131_0_183,r_131_0_183,1.0,9,192,183,51
13,r_132_53_136,seq6,seq59,r_132_53_136,0.95,0,136,136,51
6,r_34_85_234,seq135,r_69_72_110,r_69_72_110,1.0,127,237,110,51
62,seq24,r_141_138_283,r_126_130_85,r_126_130_85,1.0,199,284,85,51
36,r_7_117_288,r_93_116_104,seq51,r_93_116_104,0.63,185,289,104,51
87,seq147,r_21_2_202,r_102_17_58,r_102_17_58,1.0,147,205,58,51
13,r_132_53_136,seq59,r_12_98_220,r_12_98_220,1.0,1,221,220,51
38,r_58_83_56,r_34_85_234,r_12_98_220,r_58_83_56,0.99,0,56,56,51
70,seq41,r_65_145_39,seq133,r_65_145_39,1.0,-3,36,39,51
47,r_125_124_149,seq99,r_66_129_255,r_125_124_149,0.97,3,152,149,51
40,r_113_97_240,seq20,r_132_53_136,r_132_53_136,0.6,104,240,136,51
18,r_36_67_236,r_12_98_220,r_58_83_56,r_58_83_56,0.99,165,221,56,51
25,r_91_62_206,seq20,seq48,r_91_62_206,0.95,0,206,206,51
33,r_134_49_94,seq112,seq20,r_134_49_94,1.0,0,94,94,51
88,seq86,r_43_106_148,seq90,r_43_106_148,1.0,2,150,148,51
18,r_36_67_236,r_58_83_56,r_139_88_17,r_36_67_236,0.51,0,236,236,51
58,seq15,r_77_122_257,r_95_1_16,r_95_1_16,0.8,241,257,16,51
3,r_105_23_47,r_34_85_234,r_12_98_220,r_105_23_47,0.89,0,47,47,51
27,r_102_17_58,r_75_144_2,seq147,r_102_17_58,0.93,0,58,58,51
34,r_21_2_202,seq147,r_131_0_183,r_131_0_183,1.0,22,205,183,51
60,seq20,r_91_62_206,r_134_49_94,r_134_49_94,1.0,112,206,94,51
13,r_132_53_136,r_61_111_55,seq6,r_61_111_55,1.0,-11,44,55,51
5,r_139_88_17,r_148_143_179,seq45,r_139_88_17,0.49,3,20,17,51
9,r_52_108_217,seq90,seq92,r_52_108_217,0.85,0,217,217,51
29,r_65_145_39,seq41,seq46,r_65_145_39,1.0,0,39,39,51
37,r_25_57_251,r_94_78_3,seq64,r_25_57_251,0.71,0,251,251,51
28,r_71_82_159,seq26,seq112,r_71_82_159,1.0,0,159,159,51
24,r_13_55_15,seq115,seq8,r_13_55_15,1.0,0,15,15,51
49,r_114_42_273,seq133,r_10_142_226,r_10_142_226,0.87,50,276,226,51
72,seq46,seq59,r_65_145_39,r_65_145_39,1.0,10,49,39,51
56,seq140,r_146_9_238,seq135,r_146_9_238,1.0,-30,208,238,51
7,r_127_44_256,seq133,r_103_54_74,r_103_54_74,1.0,0,74,74,51
44,r_10_142_226,seq70,seq135,r_10_142_226,0.73,0,226,226,51
23,r_103_54_74,seq64,r_127_44_256,r_103_54_74,1.0,0,74,74,51
3,r_105_23_47,r_7_117_288,r_58_83_56,r_105_23_47,0.42,135,182,47,51
43,r_61_111_55,r_132_53_136,r_110_32_31,r_110_32_31,1.0,24,55,31,51
35,r_123_96_297,seq31,r_3_74_4,r_3_74_4,0.79,146,150,4,51
12,r_29_109_115,seq45,seq50,r_29_109_115,0.73,0,115,115,51
93,seq108,r_12_44_253,r_135_36_121,r_135_36_121,0.72,7,128,121,52
36,r_7_9_65,r_95_49_64,r_84_136_272,r_7_9_65,1.0,0,65,65,52
1,r_19_149_13,r_53_39_187,seq108,r_19_149_13,0.99,-2,11,13,52
48,r_105_140_30,r_86_101_130,seq29,r_105_140_30,0.98,1,31,30,52
92,seq103,r_66_117_90,r_50_27_203,r_50_27_203,1.0,19,222,203,52
14,r_139_60_235,seq111,r_19_149_13,r_139_60_235,0.86,0,235,235,52
43,r_106_131_165,seq1,seq58,r_106_131_165,0.95,0,165,165,52
37,r_74_38_112,r_8_61_212,r_7_9_65,r_7_9_65,0.51,64,129,65,52
78,seq65,r_30_22_230,r_121_126_16,r_121_126_16,0.75,6,22,16,52
16,r_93_0_167,seq25,r_128_62_91,r_93_0_167,1.0,0,167,167,52
21,r_5_77_244,r_146_85_3,seq92,r_146_85_3,0.41,241,244,3,52
39,r_76_63_200,r_145_69_251,r_109_99_38,r_145_69_251,0.71,-51,200,251,52
1,r_19_149_13,seq108,r_139_60_235,r_139_60_235,0.76,2,237,235,52
5,r_135_36_121,seq102,seq108,r_135_36_121,0.99,3,124,121,52
35,r_144_107_18,r_30_22_230,seq51,r_144_107_18,1.0,0,18,18,52
15,r_129_41_49,r_80_26_119,seq4,r_129_41_49,0.88,1,50,49,52
7,r_84_136_272,r_7_9_65,r_14_91_94,r_84_136_272,0.55,0,272,272,52
45,r_113_55_143,r_53_39_187,r_14_91_94,r_113_55_143,1.0,0,143,143,52
10,r_80_26_119,r_119_2_298,r_7_9_65,r_80_26_119,1.0,0,119,119,52
26,r_43_104_191,seq25,r_135_36_121,r_43_104_191,0.96,0,191,191,52
8,r_86_101_130,seq108,seq1,r_86_101_130,0.98,1,131,130,52
4,r_13_16_128,r_43_104_191,r_135_36_121,r_135_36_121,0.87,7,128,121,52
0,r_30_22_230,seq65,seq54,r_30_22_230,0.97,1,231,230,52
20,r_34_72_61,r_11_33_275,seq64,r_34_72_61,1.0,0,61,61,52
13,r_14_91_94,r_18_143_175,seq3,r_14_91_94,1.0,0,94,94,52
46,r_109_99_38,r_53_39_187,r_76_63_200,r_76_63_200,0.97,1,201,200,52
6,r_95_49_64,r_88_147_269,r_24_46_14,r_95_49_64,1.0,1,65,64,52
62,seq21,r_5_77_244,r_56_32_50,r_56_32_50,0.7,27,77,50,52
85,seq89,r_42_87_185,r_128_62_91,r_128_62_91,0.78,21,112,91,52
36,r_7_9_65,r_84_136_272,r_80_26_119,r_80_26_119,1.0,142,261,119,52
27,r_148_23_71,seq17,seq47,r_148_23_71,1.0,0,71,71,52
47,r_128_62_91,r_53_39_187,seq89,r_128_62_91,1.0,0,91,91,52
74,seq58,r_78_57_240,r_14_91_94,r_14_91_94,0.77,146,240,94,52
18,r_53_39_187,r_113_55_143,seq1,r_113_55_143,1.0,0,143,143,52
29,r_98_115_259,seq3,r_56_32_50,r_98_115_259,0.7,0,259,259,52
24,r_18_143_175,r_67_124_223,r_121_126_16,r_121_126_16,0.92,173,189,16,52
25,r_81_137_173,seq111,r_86_101_130,r_81_137_173,0.88,0,173,173,52
64,seq28,r_116_110_169,r_53_39_187,r_116_110_169,1.0,-106,63,169,52
3,r_56_32_50,r_67_124_223,seq21,r_56_32_50,0.94,1,51,50,52
6,r_95_49_64,r_24_46_14,r_116_110_169,r_116_110_169,1.0,16,185,169,52
32,r_42_87_185,seq89,seq90,r_42_87_185,0.96,0,185,185,52
38,r_116_110_169,seq54,r_95_49_64,r_116_110_169,0.99,0,169,169,52
34,r_70_31_68,r_93_0_167,seq142,r_70_31_68,1.0,0,68,68,52
64,seq28,r_53_39_187,r_145_69_251,r_145_69_251,0.75,4,255,251,52
60,seq17,r_148_23_71,seq90,r_148_23_71,1.0,0,71,71,52
46,r_109_99_38,r_34_72_61,r_53_39_187,r_109_99_38,1.0,0,38,38,52
17,r_141_112_125,r_11_33_275,seq79,r_141_112_125,0.48,0,125,125,52
94,seq111,r_139_60_235,seq52,r_139_60_235,0.89,6,241,235,52
22,r_145_69_251,seq51,r_78_57_240,r_145_69_251,0.75,0,251,251,52
28,r_8_61_212,seq122,seq17,r_8_61_212,0.86,0,212,212,52
91,seq102,r_135_36_121,r_127_71_188,r_135_36_121,0.91,3,124,121,52
49,r_50_27_203,seq97,seq103,r_50_27_203,0.91,0,203,203,52
41,r_121_126_16,seq15,seq65,r_121_126_16,0.99,0,16,16,52
56,seq10,r_84_136_272,r_7_9_65,r_7_9_65,1.0,14,79,65,52
7,r_84_136_272,seq10,r_7_9_65,r_7_9_65,1.0,14,79,65,52
44,r_12_44_253,seq108,seq25,r_12_44_253,0.71,0,253,253,52
23,r_11_33_275,r_127_71_188,r_14_91_94,r_127_71_188,0.29,87,275,188,52
30,r_78_57_240,r_30_22_230,r_145_69_251,r_145_69_251,0.74,6,257,251,52
8,r_86_101_130,r_105_140_30,seq108,r_105_140_30,1.0,3,33,30,52
60,seq17,seq90,r_8_61_212,r_8_61_212,1.0,24,236,212,52
12,r_88_147_269,seq58,r_105_140_30,r_105_140_30,1.0,239,269,30,52
20,r_126_147_30,seq69,seq13,r_126_147_30,0.77,5,35,30,53
36,r_103_50_192,seq49,seq132,r_103_50_192,0.97,0,192,192,53
14,r_143_149_271,r_37_21_233,seq46,r_37_21_233,1.0,0,233,233,53
8,r_94_101_2,r_0_19_297,r_30_31_71,r_30_31_71,1.0,2,73,71,53
53,seq5,seq63,r_91_110_245,r_91_110_245,0.84,10,255,245,53
43,r_100_130_134,seq81,r_111_55_83,r_100_130_134,0.99,0,134,134,53
83,seq141,r_26_1_279,r_28_23_31,r_28_23_31,0.97,249,280,31,53
37,r_138_60_280,r_62_45_267,r_97_17_149,r_97_17_149,1.0,118,267,149,53
26,r_70_84_41,seq13,seq69,r_70_84_41,0.8,6,47,41,53
71,seq51,r_111_55_83,seq93,r_111_55_83,1.0,0,83,83,53
39,r_127_61_90,seq4,seq53,r_127_61_90,1.0,0,90,90,53
5,r_16_146_81,seq4,r_62_45_267,r_16_146_81,1.0,0,81,81,53
46,r_29_14_56,r_91_110_245,r_76_39_106,r_76_39_106,0.68,139,245,106,53
45,r_26_1_279,seq141,seq13,r_26_1_279,0.37,1,280,279,53
19,r_0_19_297,r_35_72_156,r_94_101_2,r_35_72_156,0.62,4,160,156,53
16,r_6_115_17,r_126_147_30,r_144_44_296,r_6_115_17,0.78,3,20,17,53
31,r_123_119_218,r_144_44_296,seq57,r_123_119_218,0.67,0,218,218,53
41,r_11_121_185,r_34_109_197,seq132,r_11_121_185,0.96,0,185,185,53
67,seq46,r_37_21_233,seq88,r_37_21_233,0.99,-38,195,233,53
3,r_24_79_60,r_117_133_292,seq81,r_24_79_60,1.0,0,60,60,53
10,r_67_142_287,r_56_71_261,r_91_110_245,r_91_110_245,0.52,42,287,245,53
90,seq88,r_37_21_233,seq46,r_37_21_233,1.0,0,233,233,53
72,seq53,seq20,r_40_89_93,r_40_89_93,1.0,13,106,93,53
16,r_6_115_17,r_144_44_296,r_15_3_127,r_15_3_127,0.99,2,129,127,53
0,r_97_17_149,seq88,r_16_146_81,r_97_17_149,0.89,0,149,149,53
11,r_10_90_183,r_144_44_296,seq7,r_10_90_183,0.9,0,183,183,53
7,r_64_52_52,r_144_44_296,seq141,r_64_52_52,1.0,0,52,52,53
15,r_62_45_267,r_138_60_280,r_135_85_258,r_138_60_280,0.61,-13,267,280,53
6,r_112_32_265,r_108_8_167,seq13,r_108_8_167,1.0,0,167,167,53
48,r_41_25_53,r_56_71_261,r_28_23_31,r_41_25_53,0.6,0,53,53,53
85,seq81,r_100_130_134,r_24_79_60,r_24_79_60,0.71,35,95,60,53
99,seq122,seq83,r_40_89_93,r_40_89_93,1.0,10,103,93,53
5,r_16_146_81,r_62_45_267,r_97_17_149,r_97_17_149,1.0,77,226,149,53
27,r_118_65_171,seq58,seq49,r_118_65_171,0.43,66,237,171,53
37,r_138_60_280,r_97_17_149,r_56_71_261,r_138_60_280,0.82,2,282,280,53
2,r_144_44_296,r_10_90_183,seq48,r_10_90_183,1.0,0,183,183,53
74,seq57,seq12,r_123_119_218,r_123_119_218,0.99,0,218,218,53
18,r_34_109_197,seq87,seq53,r_34_109_197,0.51,4,201,197,53
29,r_40_89_93,seq63,seq122,r_40_89_93,1.0,-1,92,93,53
24,r_108_8_167,r_112_32_265,r_97_17_149,r_108_8_167,1.0,0,167,167,53
25,r_91_110_245,r_29_14_56,seq5,r_91_110_245,0.58,0,245,245,53
33,r_139_73_184,r_62_45_267,seq107,r_139_73_184,1.0,0,184,184,53
4,r_28_23_31,r_118_65_171,seq141,r_28_23_31,1.0,0,31,31,53
80,seq69,seq42,r_70_84_41,r_70_84_41,0.97,0,41,41,53
14,r_143_149_271,seq46,r_112_32_265,r_143_149_271,0.92,0,271,271,53
21,r_30_31_71,r_11_121_185,r_94_101_2,r_30_31_71,0.66,-38,33,71,53
32,r_15_3_127,r_0_19_297,r_6_115_17,r_15_3_127,0.99,2,129,127,53
38,r_111_55_83,seq51,seq136,r_111_55_83,0.98,0,83,83,53
34,r_104_77_97,r_37_21_233,seq42,r_104_77_97,1.0,-1,96,97,53
13,r_27_129_26,r_131_38_24,r_144_44_296,r_27_129_26,0.53,1,27,26,53
9,r_120_114_29,r_28_23_31,seq42,r_28_23_31,1.0,-1,30,31,53
28,r_18_105_163,r_139_73_184,seq57,r_18_105_163,1.0,2,165,163,53
49,r_37_21_233,r_143_149_271,r_97_17_149,r_97_17_149,0.8,84,233,149,53
72,seq53,r_40_89_93,r_34_109_197,r_34_109_197,0.55,-3,194,197,53
56,seq136,r_29_14_56,r_111_55_83,r_111_55_83,1.0,11,94,83,53
44,r_124_22_222,seq4,r_118_65_171,r_124_22_222,0.85,1,223,222,53
23,r_76_39_106,r_112_32_265,r_111_55_83,r_111_55_83,1.0,34,117,83,53
35,r_35_72_156,r_0_19_297,r_111_55_83,r_111_55_83,0.95,73,156,83,53
17,r_116_125_42,r_144_44_296,seq122,r_116_125_42,1.0,0,42,42,53
28,r_57_83_285,r_73_65_101,r_146_102_27,r_57_83_285,0.76,-258,27,285,54
53,seq5,seq120,r_49_8_157,r_49_8_157,0.88,3,160,157,54
43,r_16_148_120,r_94_139_15,seq132,r_16_148_120,0.55,0,120,120,54
43,r_16_148_120,seq132,r_4_11_130,r_4_11_130,1.0,11,141,130,54
37,r_6_129_44,seq45,r_7_113_1,r_6_129_44,1.0,-1,43,44,54
86,seq86,r_4_11_130,r_2_116_69,r_4_11_130,0.96,-36,94,130,54
16,r_38_60_260,r_46_44_191,r_78_135_135,r_38_60_260,0.93,-69,191,260,54
21,r_104_19_73,seq14,seq141,r_104_19_73,0.99,0,73,73,54
5,r_42_126_110,r_119_41_112,r_142_13_43,r_42_126_110,0.57,2,112,110,54
42,r_119_41_112,r_42_126_110,seq35,r_42_126_110,0.81,1,111,110,54
95,seq118,r_31_3_279,r_27_99_23,r_27_99_23,0.89,4,27,23,54
23,r_64_77_20,r_103_10_181,r_7_113_1,r_64_77_20,0.95,2,22,20,54
80,seq63,r_90_117_282,r_134_21_172,r_134_21_172,0.94,115,287,172,54
45,r_85_121_266,r_33_75_183,r_145_81_35,r_145_81_35,0.84,154,189,35,54
0,r_43_98_74,r_130_115_161,r_72_79_83,r_43_98_74,0.63,14,88,74,54
19,r_111_93_134,seq0,seq32,r_111_93_134,0.74,1,135,134,54
34,r_34_101_22,r_89_25_144,r_78_135_135,r_34_101_22,0.99,0,22,22,54
31,r_33_75_183,r_85_121_266,seq63,r_85_121_266,0.83,-86,180,266,54
89,seq96,r_61_12_281,r_142_13_43,r_142_13_43,1.0,31,74,43,54
3,r_49_8_157,seq35,seq5,r_49_8_157,0.99,0,157,157,54
17,r_108_87_164,r_51_23_205,seq144,r_51_23_205,0.97,3,208,205,54
26,r_73_65_101,r_57_83_285,r_46_44_191,r_73_65_101,0.94,0,101,101,54
8,r_78_135_135,r_34_101_22,r_6_129_44,r_78_135_135,1.0,0,135,135,54
16,r_38_60_260,r_78_135_135,r_74_1_248,r_38_60_260,0.56,-2,258,260,54
47,r_48_88_114,r_134_21_172,r_9_128_168,r_134_21_172,0.61,0,172,172,54
14,r_146_102_27,r_57_83_285,seq0,r_57_83_285,0.52,2,287,285,54
78,seq55,r_90_117_282,r_103_10_181,r_103_10_181,0.93,61,242,181,54
0,r_43_98_74,seq15,r_130_115_161,r_130_115_161,0.79,-87,74,161,54
73,seq40,r_74_1_248,r_43_98_74,r_43_98_74,1.0,175,249,74,54
92,seq106,r_112_137_88,seq109,r_112_137_88,1.0,-42,46,88,54
11,r_112_137_88,seq106,r_72_79_83,r_112_137_88,0.57,0,88,88,54
20,r_130_115_161,r_74_1_248,r_142_13_43,r_130_115_161,0.61,1,162,161,54
13,r_89_25_144,seq58,seq0,r_89_25_144,0.94,-1,143,144,54
48,r_30_138_95,seq91,r_80_36_62,r_30_138_95,1.0,0,95,95,54
46,r_62_17_195,seq147,r_6_129_44,r_6_129_44,1.0,7,51,44,54
24,r_80_36_62,r_42_126_110,r_30_138_95,r_80_36_62,0.98,44,106,62,54
8,r_78_135_135,r_61_12_281,r_34_101_22,r_34_101_22,0.97,22,44,22,54
36,r_145_81_35,r_85_121_266,r_80_36_62,r_145_81_35,0.36,235,270,35,54
27,r_143_56_138,seq32,r_78_135_135,r_143_56_138,0.89,0,138,138,54
9,r_7_113_1,r_62_17_195,r_6_129_44,r_6_129_44,1.0,1,45,44,54
2,r_47_107_84,r_73_65_101,seq118,r_47_107_84,0.99,0,84,84,54
47,r_48_88_114,r_89_25_144,r_134_21_172,r_48_88_114,0.98,1,115,114,54
14,r_146_102_27,r_130_115_161,r_57_83_285,r_146_102_27,0.98,0,27,27,54
18,r_46_44_191,r_38_60_260,r_43_98_74,r_38_60_260,0.89,-69,191,260,54
24,r_80_36_62,r_111_93_134,r_42_126_110,r_80_36_62,0.92,1,63,62,54
34,r_34_101_22,r_78_135_135,r_142_13_43,r_34_101_22,0.74,91,113,22,54
33,r_51_23_205,seq82,r_64_77_20,r_51_23_205,0.61,3,208,205,54
32,r_2_116_69,seq84,seq86,r_2_116_69,0.74,0,69,69,54
45,r_85_121_266,r_145_81_35,r_78_135_135,r_85_121_266,0.78,-4,262,266,54
30,r_142_13_43,seq132,seq96,r_142_13_43,1.0,0,43,43,54
81,seq67,r_59_66_143,seq140,r_59_66_143,1.0,0,143,143,54
17,r_108_87_164,seq22,r_51_23_205,r_108_87_164,0.74,1,165,164,54
1,r_27_99_23,seq110,seq118,r_27_99_23,1.0,0,23,23,54
26,r_73_65_101,r_46_44_191,r_134_21_172,r_73_65_101,1.0,90,191,101,54
28,r_57_83_285,r_146_102_27,r_134_21_172,r_134_21_172,0.75,115,287,172,54
22,r_70_100_67,r_47_107_84,seq32,r_70_100_67,0.76,0,67,67,54
91,seq105,seq63,r_103_10_181,r_103_10_181,0.98,12,193,181,54
49,r_90_117_282,seq63,r_111_93_134,r_111_93_134,0.58,153,287,134,54
7,r_114_76_124,seq50,seq35,r_114_76_124,0.99,2,126,124,54
44,r_9_128_168,seq37,r_48_88_114,r_48_88_114,0.86,57,171,114,54
36,r_145_81_35,r_4_11_130,r_85_121_266,r_145_81_35,1.0,0,35,35,54
39,r_20_95_47,r_134_21_172,seq32,r_20_95_47,1.0,-1,46,47,54
35,r_59_66_143,seq67,seq86,r_59_66_143,1.0,0,143,143,54
12,r_103_10_181,seq141,seq105,r_103_10_181,0.86,2,183,181,54
93,seq146,r_107_74_84,r_31_17_177,r_107_74_84,1.0,-1,83,84,55
30,r_115_77_75,r_71_14_117,seq86,r_115_77_75,1.0,1,76,75,55
44,r_11_118_31,r_102_22_287,r_95_69_120,r_95_69_120,1.0,164,284,120,55
23,r_101_37_38,r_115_77_75,seq99,r_101_37_38,0.87,0,38,38,55
51,seq9,r_20_116_93,r_10_110_85,r_20_116_93,0.65,1,94,93,55
36,r_6_82_140,seq122,seq146,r_6_82_140,0.99,0,140,140,55
92,seq106,seq86,r_26_54_118,r_26_54_118,1.0,3,121,118,55
14,r_90_134_279,r_121_0_289,r_59_53_244,r_121_0_289,0.42,-10,279,289,55
53,seq130,seq25,r_89_36_95,r_89_36_95,1.0,19,114,95,55
43,r_28_113_157,r_49_73_275,seq38,r_28_113_157,1.0,0,157,157,55
37,r_10_110_85,seq19,seq9,r_10_110_85,0.89,1,86,85,55
16,r_16_35_81,seq80,seq63,r_16_35_81,1.0,0,81,81,55
21,r_124_60_79,seq96,seq56,r_124_60_79,1.0,1,80,79,55
39,r_100_105_2,r_95_69_120,r_71_14_117,r_100_105_2,0.91,118,120,2,55
26,r_71_14_117,r_107_74_84,r_100_105_2,r_71_14_117,1.0,1,118,117,55
1,r_20_116_93,seq9,seq67,r_20_116_93,0.94,1,94,93,55
97,seq122,r_6_82_140,r_7_147_11,r_6_82_140,0.98,0,140,140,55
80,seq80,seq142,r_87_24_148,r_87_24_148,1.0,-2,146,148,55
5,r_95_69_120,r_100_105_2,r_11_118_31,r_95_69_120,0.86,0,120,120,55
46,r_46_66_141,seq96,r_95_69_120,r_46_66_141,0.93,1,142,141,55
42,r_89_36_95,r_71_14_117,seq130,r_89_36_95,1.0,0,95,95,55
3,r_107_74_84,r_71_14_117,seq122,r_71_14_117,1.0,1,118,117,55
80,seq80,r_16_35_81,seq142,r_16_35_81,1.0,-2,79,81,55
45,r_148_128_87,seq145,seq117,r_148_128_87,1.0,0,87,87,55
33,r_129_3_69,r_30_47_261,seq81,r_30_47_261,0.68,-206,55,261,55
95,seq117,seq76,r_148_128_87,r_148_128_87,1.0,7,94,87,55
66,seq40,r_68_138_216,r_125_13_76,r_125_13_76,1.0,140,216,76,55
31,r_31_17_177,seq25,seq63,r_31_17_177,0.57,1,178,177,55
3,r_107_74_84,seq146,r_71_14_117,r_107_74_84,0.78,0,84,84,55
10,r_27_8_190,r_30_47_261,seq67,r_27_8_190,0.84,0,190,190,55
19,r_141_91_24,r_133_112_270,seq19,r_141_91_24,1.0,0,24,24,55
26,r_71_14_117,r_89_36_95,r_107_74_84,r_71_14_117,0.89,-32,85,117,55
8,r_59_53_244,r_42_75_277,r_94_32_298,r_59_53_244,0.77,1,245,244,55
4,r_30_47_261,seq48,r_31_17_177,r_30_47_261,0.46,0,261,261,55
63,seq29,r_87_24_148,r_133_112_270,r_87_24_148,1.0,0,148,148,55
11,r_4_57_131,r_1_140_235,r_94_32_298,r_1_140_235,0.98,0,235,235,55
55,seq15,r_30_47_261,r_78_132_17,r_78_132_17,0.73,0,17,17,55
28,r_108_85_25,seq38,seq25,r_108_85_25,1.0,1,26,25,55
13,r_135_72_71,seq33,seq48,r_135_72_71,1.0,0,71,71,55
15,r_62_5_110,seq84,seq15,r_62_5_110,1.0,0,110,110,55
57,seq145,seq98,r_103_55_217,r_103_55_217,0.77,47,264,217,55
12,r_42_75_277,r_119_127_143,r_148_128_87,r_42_75_277,0.46,0,277,277,55
6,r_12_114_239,r_100_105_2,r_79_136_187,r_100_105_2,0.63,239,241,2,55
44,r_11_118_31,r_133_112_270,r_102_22_287,r_11_118_31,1.0,0,31,31,55
2,r_49_73_275,r_101_37_38,r_7_147_11,r_49_73_275,0.49,0,275,275,55
40,r_7_147_11,r_16_35_81,seq122,r_7_147_11,0.98,-1,10,11,55
2,r_49_73_275,r_34_137_247,r_101_37_38,r_101_37_38,0.84,158,196,38,55
47,r_68_138_216,seq40,seq76,r_68_138_216,0.8,0,216,216,55
93,seq146,r_31_17_177,r_6_82_140,r_6_82_140,1.0,4,144,140,55
24,r_78_132_17,r_87_24_148,seq15,r_78_132_17,0.99,0,17,17,55
18,r_26_54_118,seq18,seq106,r_26_54_118,1.0,1,119,118,55
29,r_119_127_143,seq19,r_42_75_277,r_119_127_143,0.96,0,143,143,55
25,r_50_149_80,r_4_57_131,seq44,r_50_149_80,1.0,0,80,80,55
70,seq48,r_30_47_261,r_135_72_71,r_135_72_71,1.0,172,243,71,55
32,r_109_70_97,r_62_5_110,r_115_77_75,r_109_70_97,0.98,0,97,97,55
38,r_102_22_287,r_11_118_31,r_135_72_71,r_11_118_31,0.2,256,287,31,55
34,r_45_39_73,seq67,seq84,r_45_39_73,1.0,2,75,73,55
17,r_1_140_235,r_4_57_131,r_27_8_190,r_1_140_235,0.98,0,235,235,55
9,r_87_24_148,seq29,seq80,r_87_24_148,1.0,0,148,148,55
37,r_10_110_85,seq9,r_79_136_187,r_79_136_187,1.0,0,187,187,55
29,r_119_127_143,r_42_75_277,seq144,r_42_75_277,0.82,-5,272,277,55
22,r_125_13_76,r_45_39_73,seq81,r_125_13_76,1.0,0,76,76,55
49,r_79_136_187,seq96,r_10_110_85,r_79_136_187,0.89,1,188,187,55
7,r_34_137_247,r_49_73_275,r_141_91_24,r_34_137_247,0.45,0,247,247,55
79,seq76,seq65,r_68_138_216,r_68_138_216,1.0,6,222,216,55
35,r_88_131_188,seq120,r_141_91_24,r_88_131_188,0.76,2,190,188,55
12,r_42_75_277,r_88_131_188,r_119_127_143,r_42_75_277,0.9,-121,156,277,55
5,r_95_69_120,r_11_118_31,r_46_66_141,r_46_66_141,0.63,34,175,141,55
84,seq86,seq51,r_115_77_75,r_115_77_75,1.0,2,77,75,55
30,r_42_134_219,seq74,r_92_33_86,r_42_134_219,0.63,0,219,219,56
36,r_65_57_98,r_127_18_253,seq46,r_65_57_98,0.97,-1,97,98,56
27,r_32_36_20,r_121_21_197,seq116,r_32_36_20,1.0,0,20,20,56
37,r_81_67_35,seq38,r_84_51_125,r_81_67_35,1.0,0,35,35,56
16,r_79_110_272,seq106,seq2,r_79_110_272,0.47,0,272,272,56
39,r_137_136_252,r_6_61_126,r_91_24_100,r_91_24_100,1.0,16,116,100,56
1,r_5_17_256,seq46,r_50_122_186,r_5_17_256,0.73,1,257,256,56
97,seq147,r_6_61_126,r_137_136_252,r_6_61_126,0.73,-9,117,126,56
5,r_140_120_111,seq106,seq15,r_140_120_111,0.76,0,111,111,56
2,r_84_51_125,seq28,r_81_67_35,r_81_67_35,1.0,0,35,35,56
19,r_78_49_172,r_5_17_256,seq9,r_78_49_172,0.99,0,172,172,56
15,r_149_119_159,r_143_29_31,r_14_98_228,r_14_98_228,1.0,10,238,228,56
11,r_127_18_253,seq72,seq144,r_127_18_253,0.95,0,253,253,56
88,seq90,r_83_124_56,r_7_53_106,r_7_53_106,1.0,0,106,106,56
38,r_143_29_31,seq105,r_149_119_159,r_149_119_159,0.98,2,161,159,56
38,r_143_29_31,r_92_33_86,seq105,r_143_29_31,1.0,0,31,31,56
45,r_138_63_57,seq128,r_86_60_238,r_138_63_57,0.64,0,57,57,56
97,seq147,r_137_136_252,r_121_21_197,r_121_21_197,1.0,9,206,197,56
39,r_137_136_252,r_91_24_100,r_42_134_219,r_42_134_219,1.0,13,232,219,56
31,r_26_133_218,seq89,r_6_61_126,r_6_61_126,0.36,91,217,126,56
41,r_139_107_230,r_6_61_126,r_92_33_86,r_139_107_230,0.83,-123,107,230,56
14,r_83_124_56,seq70,seq90,r_83_124_56,1.0,0,56,56,56
3,r_7_53_106,r_10_102_141,seq90,r_7_53_106,0.99,0,106,106,56
10,r_22_93_127,r_80_131_7,seq70,r_22_93_127,0.95,0,127,127,56
61,seq145,r_14_98_228,r_140_120_111,r_14_98_228,0.7,1,229,228,56
26,r_66_123_182,r_58_148_275,seq71,r_58_148_275,0.52,-93,182,275,56
14,r_83_124_56,seq90,r_31_111_110,r_31_111_110,1.0,7,117,110,56
4,r_92_33_86,seq89,r_139_107_230,r_92_33_86,0.83,2,88,86,56
83,seq141,r_132_142_49,r_20_54_295,r_132_142_49,0.99,-2,47,49,56
11,r_127_18_253,r_65_57_98,seq72,r_65_57_98,0.9,5,103,98,56
20,r_48_68_99,r_127_18_253,r_92_33_86,r_48_68_99,1.0,0,99,99,56
98,seq116,r_58_148_275,r_86_60_238,r_86_60_238,0.6,10,248,238,56
46,r_132_142_49,seq141,seq46,r_132_142_49,1.0,-2,47,49,56
48,r_35_104_271,r_86_60_238,r_91_24_100,r_91_24_100,1.0,172,272,100,56
4,r_92_33_86,r_139_107_230,r_42_134_219,r_92_33_86,0.72,136,222,86,56
12,r_86_60_238,r_138_63_57,r_32_36_20,r_86_60_238,0.29,24,262,238,56
6,r_39_115_247,seq101,r_10_102_141,r_39_115_247,0.78,-3,244,247,56
85,seq85,r_75_114_250,r_55_94_286,r_75_114_250,0.53,2,252,250,56
2,r_84_51_125,r_81_67_35,seq146,r_84_51_125,0.99,0,125,125,56
87,seq89,r_26_133_218,r_97_1_240,r_97_1_240,0.97,-3,237,240,56
87,seq89,r_92_33_86,r_26_133_218,r_92_33_86,0.93,2,88,86,56
12,r_86_60_238,r_35_104_271,r_138_63_57,r_138_63_57,0.88,-1,56,57,56
41,r_139_107_230,r_92_33_86,seq64,r_139_107_230,0.96,-2,228,230,56
40,r_118_87_254,seq69,r_91_24_100,r_91_24_100,0.89,154,254,100,56
74,seq46,r_5_17_256,r_65_57_98,r_65_57_98,0.66,159,257,98,56
18,r_97_1_240,seq135,seq89,r_97_1_240,0.66,1,241,240,56
29,r_34_59_109,r_113_99_258,seq37,r_34_59_109,1.0,0,109,109,56
25,r_50_122_186,seq145,seq28,r_50_122_186,0.64,5,191,186,56
33,r_75_114_250,seq85,seq144,r_75_114_250,0.78,0,250,250,56
88,seq90,seq41,r_83_124_56,r_83_124_56,0.82,12,68,56,56
32,r_10_102_141,r_7_53_106,r_56_12_22,r_10_102_141,0.83,-39,102,141,56
77,seq69,r_118_87_254,seq41,r_118_87_254,0.99,0,254,254,56
24,r_56_12_22,r_149_119_159,seq105,r_56_12_22,0.52,1,23,22,56
60,seq144,r_121_21_197,seq30,r_121_21_197,1.0,1,198,197,56
17,r_25_77_280,seq40,r_143_29_31,r_25_77_280,0.38,0,280,280,56
94,seq106,r_79_110_272,seq41,r_79_110_272,0.98,0,272,272,56
9,r_6_61_126,r_139_107_230,r_34_59_109,r_6_61_126,0.91,2,128,126,56
26,r_66_123_182,seq71,seq4,r_66_123_182,0.39,68,250,182,56
96,seq112,r_6_61_126,r_48_68_99,r_48_68_99,0.98,107,206,99,56
37,r_81_67_35,r_84_51_125,seq28,r_84_51_125,1.0,0,125,125,56
28,r_125_3_227,r_140_120_111,r_132_142_49,r_125_3_227,0.97,0,227,227,56
22,r_14_98_228,seq145,r_149_119_159,r_149_119_159,0.57,69,228,159,56
28,r_125_3_227,r_34_59_109,r_140_120_111,r_34_59_109,0.99,3,112,109,56
49,r_121_21_197,seq144,seq147,r_121_21_197,0.56,1,198,197,56
23,r_91_24_100,seq135,r_137_136_252,r_91_24_100,0.99,0,100,100,56
82,seq74,r_42_134_219,r_96_100_42,r_42_134_219,1.0,-42,177,219,56
32,r_10_102_141,r_56_12_22,r_92_33_86,r_10_102_141,0.96,0,141,141,56
79,seq71,r_80_131_7,r_66_123_182,r_66_123_182,0.81,32,214,182,56
35,r_47_76_166,r_66_123_182,seq106,r_66_123_182,1.0,-14,168,182,56
23,r_91_24_100,r_137_136_252,r_118_87_254,r_118_87_254,0.95,4,258,254,56
84,seq82,r_66_123_182,r_86_60_238,r_66_123_182,1.0,-6,176,182,56
30,r_14_30_94,seq82,r_34_116_44,r_14_30_94,1.0,1,95,94,57
36,r_92_25_165,seq51,seq6,r_92_25_165,0.96,0,165,165,57
14,r_36_129_182,r_47_109_164,r_75_57_88,r_75_57_88,1.0,39,127,88,57
83,seq84,seq139,r_114_83_156,r_114_83_156,1.0,33,189,156,57
37,r_47_109_164,seq77,r_61_13_54,r_47_109_164,0.83,4,168,164,57
71,seq52,seq145,r_28_126_179,r_28_126_179,1.0,7,186,179,57
86,seq94,r_11_72_103,seq67,r_11_72_103,0.99,4,107,103,57
21,r_43_103_157,seq64,seq117,r_43_103_157,0.94,2,159,157,57
39,r_21_29_205,r_121_144_212,seq108,r_21_29_205,0.58,0,205,205,57
1,r_56_40_244,r_11_72_103,seq64,r_56_40_244,0.77,3,247,244,57
1,r_56_40_244,r_78_70_3,r_11_72_103,r_11_72_103,0.8,6,109,103,57
38,r_61_13_54,r_134_54_148,r_104_132_159,r_61_13_54,1.0,-6,48,54,57
5,r_58_101_268,r_118_89_266,r_136_107_118,r_136_107_118,1.0,150,268,118,57
46,r_137_85_163,r_134_54_148,seq82,r_134_54_148,0.78,3,151,148,57
42,r_10_149_154,seq97,r_60_71_31,r_10_149_154,0.93,0,154,154,57
45,r_111_17_218,seq67,r_36_129_182,r_111_17_218,0.72,1,219,218,57
47,r_114_83_156,r_147_80_35,seq84,r_114_83_156,1.0,0,156,156,57
19,r_79_22_259,r_88_120_281,r_12_100_49,r_88_120_281,0.59,-22,259,281,57
38,r_61_13_54,r_104_132_159,r_47_109_164,r_61_13_54,0.86,108,162,54,57
31,r_66_106_250,seq122,r_125_20_5,r_125_20_5,0.62,245,250,5,57
44,r_19_143_55,seq68,seq4,r_19_143_55,1.0,-1,54,55,57
89,seq98,r_8_42_271,seq86,r_8_42_271,0.99,-60,211,271,57
96,seq117,r_43_103_157,r_133_15_197,r_43_103_157,0.58,130,287,157,57
3,r_75_57_88,r_1_148_137,seq77,r_75_57_88,1.0,1,89,88,57
10,r_133_15_197,seq117,r_14_30_94,r_14_30_94,1.0,106,200,94,57
7,r_44_73_57,r_38_91_90,r_78_70_3,r_78_70_3,0.49,54,57,3,57
34,r_34_116_44,r_12_100_49,r_14_30_94,r_14_30_94,1.0,119,213,94,57
41,r_104_132_159,r_11_72_103,r_61_13_54,r_61_13_54,0.69,2,56,54,57
14,r_36_129_182,r_75_57_88,seq122,r_36_129_182,0.59,10,192,182,57
4,r_1_148_137,r_8_42_271,r_104_132_159,r_1_148_137,0.65,25,162,137,57
0,r_99_48_221,seq108,r_11_72_103,r_99_48_221,0.95,0,221,221,57
11,r_123_2_108,r_10_149_154,r_118_89_266,r_123_2_108,0.98,0,108,108,57
20,r_11_72_103,seq94,r_81_142_109,r_11_72_103,0.97,4,107,103,57
13,r_16_65_96,r_121_144_212,seq3,r_121_144_212,0.7,-112,100,212,57
15,r_95_5_98,r_104_132_159,seq115,r_95_5_98,0.98,0,98,98,57
48,r_46_23_95,r_58_101_268,seq39,r_46_23_95,1.0,3,98,95,57
6,r_45_141_81,r_16_65_96,seq39,r_45_141_81,0.79,0,81,81,57
27,r_138_128_274,r_78_70_3,r_21_29_205,r_78_70_3,0.31,271,274,3,57
30,r_14_30_94,r_34_116_44,r_12_100_49,r_34_116_44,0.32,206,250,44,57
22,r_12_100_49,r_34_116_44,r_133_15_197,r_133_15_197,0.7,23,220,197,57
24,r_88_120_281,r_92_25_165,seq27,r_88_120_281,0.61,4,285,281,57
2,r_37_87_193,seq82,seq26,r_37_87_193,0.99,1,194,193,57
41,r_104_132_159,r_61_13_54,r_1_148_137,r_104_132_159,0.98,1,160,159,57
47,r_114_83_156,r_81_142_109,r_147_80_35,r_147_80_35,0.83,74,109,35,57
40,r_8_42_271,seq41,r_1_148_137,r_1_148_137,1.0,134,271,137,57
18,r_110_59_181,seq135,r_69_9_119,r_110_59_181,0.89,0,181,181,57
29,r_136_107_118,r_58_101_268,r_147_80_35,r_136_107_118,0.95,3,121,118,57
24,r_88_120_281,r_79_22_259,r_92_25_165,r_92_25_165,1.0,94,259,165,57
50,seq0,seq3,r_125_20_5,r_125_20_5,0.88,10,15,5,57
25,r_28_126_179,r_99_48_221,seq52,r_28_126_179,0.42,0,179,179,57
43,r_147_80_35,r_114_83_156,r_136_107_118,r_147_80_35,0.57,122,157,35,57
33,r_78_70_3,r_138_128_274,r_44_73_57,r_44_73_57,1.0,217,274,57,57
88,seq97,r_10_149_154,seq27,r_10_149_154,0.99,0,154,154,57
26,r_38_91_90,seq26,seq145,r_38_91_90,1.0,1,91,90,57
58,seq18,r_8_42_271,seq86,r_8_42_271,0.69,-54,217,271,57
68,seq135,r_110_59_181,r_123_2_108,r_123_2_108,0.99,78,186,108,57
32,r_81_142_109,r_114_83_156,r_11_72_103,r_81_142_109,0.75,0,109,109,57
77,seq67,r_111_17_218,seq140,r_111_17_218,0.61,-37,181,218,57
22,r_12_100_49,seq27,r_34_116_44,r_12_100_49,0.95,0,49,49,57
26,r_38_91_90,r_44_73_57,seq26,r_44_73_57,0.99,0,57,57,57
17,r_49_113_190,seq39,seq82,r_49_113_190,0.85,3,193,190,57
43,r_147_80_35,r_123_2_108,r_114_83_156,r_147_80_35,0.74,0,35,35,57
96,seq117,r_133_15_197,r_43_103_157,r_43_103_157,0.76,42,199,157,57
29,r_136_107_118,r_147_80_35,r_58_101_268,r_58_101_268,0.68,0,268,268,57
49,r_69_9_119,r_49_113_190,seq51,r_69_9_119,0.84,0,119,119,57
23,r_131_90_144,r_10_149_154,seq119,r_131_90_144,1.0,0,144,144,57
78,seq68,r_49_113_190,r_60_71_31,r_60_71_31,1.0,0,31,31,57
35,r_60_71_31,seq53,seq68,r_60_71_31,1.0,0,31,31,57
12,r_134_54_148,r_137_85_163,seq76,r_134_54_148,0.9,3,151,148,57
30,r_97_110_127,r_62_85_43,seq96,r_62_85_43,0.61,125,168,43,58
30,r_97_110_127,r_107_43_110,r_62_85_43,r_62_85_43,0.51,68,111,43,58
51,seq131,r_139_138_102,r_2_99_81,r_2_99_81,1.0,21,102,81,58
36,r_83_93_184,r_144_26_262,seq19,r_83_93_184,0.93,2,186,184,58
14,r_33_69_69,r_122_8_163,seq23,r_122_8_163,0.97,-99,64,163,58
58,seq19,r_115_15_74,r_83_93_184,r_83_93_184,1.0,-1,183,184,58
23,r_4_58_150,r_39_114_103,seq82,r_4_58_150,1.0,0,150,150,58
16,r_55_133_136,seq140,seq17,r_55_133_136,1.0,1,137,136,58
39,r_76_129_101,seq13,seq67,r_76_129_101,0.98,0,101,101,58
1,r_28_6_125,r_4_58_150,r_136_125_5,r_136_125_5,0.47,120,125,5,58
97,seq124,seq67,r_74_101_104,r_74_101_104,1.0,113,217,104,58
46,r_145_142_234,seq73,r_148_128_147,r_145_142_234,0.93,0,234,234,58
42,r_148_128_147,r_16_64_237,seq47,r_148_128_147,1.0,0,147,147,58
45,r_122_8_163,r_33_69_69,r_78_137_77,r_78_137_77,1.0,-2,75,77,58
41,r_30_92_27,seq67,seq17,r_30_92_27,1.0,0,27,27,58
15,r_134_60_75,seq117,r_21_113_225,r_21_113_225,1.0,23,248,225,58
43,r_20_121_182,r_62_85_43,seq105,r_62_85_43,0.8,-23,20,43,58
34,r_72_102_71,r_0_80_193,r_62_85_43,r_62_85_43,0.99,11,54,43,58
31,r_3_88_73,r_16_64_237,seq118,r_3_88_73,0.88,-9,64,73,58
33,r_95_100_178,seq105,seq56,r_95_100_178,0.56,50,228,178,58
10,r_21_113_225,r_38_130_29,r_134_60_75,r_38_130_29,0.95,197,226,29,58
26,r_2_99_81,seq45,seq131,r_2_99_81,1.0,0,81,81,58
8,r_59_9_8,r_139_138_102,r_10_149_45,r_10_149_45,0.98,46,91,45,58
4,r_39_114_103,seq17,seq25,r_39_114_103,1.0,1,104,103,58
0,r_11_94_285,seq126,r_57_54_41,r_57_54_41,0.9,244,285,41,58
11,r_35_143_118,r_38_130_29,seq126,r_35_143_118,1.0,0,118,118,58
20,r_90_91_89,seq37,seq19,r_90_91_89,1.0,0,89,89,58
98,seq126,r_119_66_245,r_48_29_92,r_48_29_92,1.0,154,246,92,58
48,r_144_26_262,r_83_93_184,r_57_54_41,r_144_26_262,0.68,-76,186,262,58
12,r_78_137_77,r_122_8_163,seq127,r_122_8_163,1.0,5,168,163,58
25,r_41_5_21,r_57_54_41,r_147_51_15,r_41_5_21,1.0,-1,20,21,58
43,r_20_121_182,seq56,seq42,r_20_121_182,1.0,-6,176,182,58
27,r_40_53_60,seq23,seq47,r_40_53_60,1.0,0,60,60,58
19,r_10_149_45,r_35_143_118,r_59_9_8,r_10_149_45,1.0,1,46,45,58
7,r_57_54_41,r_95_100_178,seq63,r_57_54_41,1.0,0,41,41,58
47,r_16_64_237,r_148_128_147,seq84,r_148_128_147,0.84,0,147,147,58
29,r_48_29_92,r_28_6_125,seq126,r_48_29_92,1.0,4,96,92,58
17,r_62_85_43,r_20_121_182,seq13,r_62_85_43,0.99,0,43,43,58
24,r_75_98_88,seq56,seq1,r_75_98_88,1.0,0,88,88,58
48,r_144_26_262,r_57_54_41,r_38_130_29,r_144_26_262,1.0,0,262,262,58
13,r_135_112_35,r_20_121_182,seq23,r_135_112_35,0.96,0,35,35,58
47,r_16_64_237,seq84,r_48_29_92,r_16_64_237,0.53,2,239,237,58
58,seq19,r_145_142_234,r_115_15_74,r_115_15_74,1.0,77,151,74,58
32,r_115_15_74,seq1,seq19,r_115_15_74,1.0,-1,73,74,58
38,r_79_89_94,seq65,seq1,r_79_89_94,0.84,13,107,94,58
77,seq67,seq127,r_76_129_101,r_76_129_101,1.0,1,102,101,58
56,seq17,seq56,r_55_133_136,r_55_133_136,1.0,18,154,136,58
75,seq63,r_83_93_184,seq42,r_83_93_184,1.0,-22,162,184,58
60,seq23,r_40_53_60,r_33_69_69,r_40_53_60,0.97,0,60,60,58
45,r_122_8_163,r_78_137_77,r_38_130_29,r_122_8_163,1.0,0,163,163,58
94,seq117,r_33_69_69,r_134_60_75,r_134_60_75,1.0,0,75,75,58
9,r_119_66_245,seq126,r_95_100_178,r_119_66_245,0.56,1,246,245,58
6,r_50_61_16,r_139_138_102,seq73,r_50_61_16,0.98,0,16,16,58
22,r_70_111_172,seq71,seq37,r_70_111_172,0.94,0,172,172,58
28,r_139_138_102,seq131,seq37,r_139_138_102,0.7,-17,85,102,58
49,r_74_101_104,seq37,seq124,r_74_101_104,0.99,3,107,104,58
56,seq17,r_39_114_103,seq56,r_39_114_103,1.0,1,104,103,58
18,r_136_125_5,r_0_80_193,r_28_6_125,r_28_6_125,1.0,69,194,125,58
23,r_4_58_150,r_28_6_125,r_39_114_103,r_39_114_103,0.83,22,125,103,58
79,seq71,r_70_111_172,seq84,r_70_111_172,0.71,3,175,172,58
33,r_95_100_178,seq56,r_119_66_245,r_119_66_245,0.97,1,246,245,58
35,r_107_43_110,r_97_110_127,seq24,r_107_43_110,0.92,1,111,110,58
12,r_78_137_77,r_119_66_245,r_122_8_163,r_78_137_77,0.79,0,77,77,58
84,seq82,r_38_130_29,r_4_58_150,r_4_58_150,1.0,34,184,150,58
93,seq114,seq60,r_149_10_60,r_149_10_60,0.67,5,65,60,59
36,r_45_25_157,seq114,seq7,r_45_25_157,1.0,1,158,157,59
14,r_99_77_256,r_102_125_239,r_13_24_222,r_99_77_256,0.74,0,256,256,59
53,seq7,r_59_132_78,r_54_57_23,r_59_132_78,0.91,0,78,78,59
43,r_123_11_169,r_0_76_212,seq80,r_123_11_169,0.84,0,169,169,59
83,seq86,r_55_2_265,seq1,r_55_2_265,0.93,0,265,265,59
37,r_68_92_145,r_21_136_94,seq1,r_21_136_94,1.0,-9,85,94,59
71,seq137,r_13_24_222,seq115,r_13_24_222,0.83,0,222,222,59
16,r_5_70_197,r_51_110_63,r_0_76_212,r_51_110_63,1.0,-1,62,63,59
21,r_124_104_227,r_17_67_111,r_37_91_101,r_124_104_227,0.56,-117,110,227,59
39,r_51_110_63,r_5_70_197,r_149_10_60,r_51_110_63,1.0,0,63,63,59
1,r_13_24_222,seq137,seq148,r_13_24_222,0.65,0,222,222,59
5,r_149_10_60,seq18,seq114,r_149_10_60,0.77,22,82,60,59
42,r_37_91_101,seq69,r_124_104_227,r_37_91_101,1.0,0,101,101,59
69,seq46,r_64_138_126,r_128_29_242,r_64_138_126,1.0,-1,125,126,59
45,r_106_42_82,r_5_70_197,seq80,r_106_42_82,1.0,0,82,82,59
16,r_5_70_197,r_0_76_212,seq89,r_5_70_197,0.53,-88,109,197,59
19,r_84_32_206,seq65,r_123_11_169,r_123_11_169,0.99,58,227,169,59
2,r_17_67_111,r_118_142_248,r_38_85_51,r_118_142_248,0.81,-35,213,248,59
27,r_38_85_51,r_50_19_188,r_17_67_111,r_38_85_51,0.56,78,129,51,59
76,seq63,r_61_22_216,seq18,r_61_22_216,1.0,-4,212,216,59
31,r_0_76_212,seq112,seq1,r_0_76_212,0.54,0,212,212,59
3,r_72_87_129,r_50_19_188,seq140,r_72_87_129,0.98,0,129,129,59
10,r_118_142_248,seq135,seq43,r_118_142_248,0.85,0,248,248,59
35,r_49_31_55,r_82_66_245,seq112,r_49_31_55,1.0,0,55,55,59
90,seq111,r_16_52_165,seq108,r_16_52_165,0.99,0,165,165,59
85,seq135,r_118_142_248,r_38_85_51,r_118_142_248,1.0,-16,232,248,59
11,r_121_144_25,r_13_24_222,seq69,r_121_144_25,0.88,1,26,25,59
4,r_82_66_245,seq73,r_21_136_94,r_21_136_94,1.0,34,128,94,59
0,r_50_19_188,seq135,seq127,r_50_19_188,1.0,0,188,188,59
13,r_102_125_239,r_99_77_256,r_28_15_232,r_99_77_256,1.0,-2,254,256,59
46,r_107_96_151,r_50_19_188,r_17_67_111,r_17_67_111,0.54,5,116,111,59
29,r_134_90_24,seq100,seq112,r_134_90_24,0.99,2,26,24,59
15,r_147_130_290,seq62,r_13_24_222,r_13_24_222,0.8,68,290,222,59
2,r_17_67_111,r_107_96_151,r_118_142_248,r_107_96_151,0.9,0,151,151,59
27,r_38_85_51,r_17_67_111,r_128_29_242,r_38_85_51,0.3,194,245,51,59
4,r_82_66_245,r_21_136_94,r_49_31_55,r_82_66_245,1.0,2,247,245,59
66,seq41,r_94_74_124,r_75_88_13,r_94_74_124,0.94,-66,58,124,59
21,r_124_104_227,r_37_91_101,seq131,r_124_104_227,1.0,0,227,227,59
85,seq135,r_50_19_188,r_118_142_248,r_50_19_188,0.99,0,188,188,59
99,seq127,seq43,r_50_19_188,r_50_19_188,1.0,10,198,188,59
51,seq131,r_49_31_55,r_124_104_227,r_124_104_227,1.0,2,229,227,59
46,r_107_96_151,r_17_67_111,r_68_92_145,r_107_96_151,1.0,0,151,151,59
69,seq46,r_128_29_242,seq27,r_128_29_242,0.5,4,246,242,59
2,r_17_67_111,seq140,r_107_96_151,r_17_67_111,0.87,3,114,111,59
47,r_71_139_211,seq35,seq145,r_71_139_211,0.98,0,211,211,59
40,r_3_109_132,r_82_66_245,seq81,r_82_66_245,0.69,-110,135,245,59
25,r_59_132_78,seq7,seq30,r_59_132_78,1.0,0,78,78,59
33,r_133_8_114,r_82_66_245,r_143_20_79,r_133_8_114,0.79,11,125,114,59
64,seq35,r_71_139_211,r_146_129_42,r_146_129_42,0.64,169,211,42,59
9,r_146_129_42,seq1,seq35,r_146_129_42,1.0,2,44,42,59
7,r_54_57_23,r_84_32_206,seq7,r_54_57_23,1.0,0,23,23,59
18,r_116_103_47,r_49_31_55,r_143_20_79,r_49_31_55,0.97,-8,47,55,59
58,seq18,r_149_10_60,seq63,r_149_10_60,0.5,22,82,60,59
70,seq53,seq80,r_5_70_197,r_5_70_197,0.96,3,200,197,59
16,r_5_70_197,r_94_74_124,seq53,r_5_70_197,1.0,0,197,197,59
42,r_37_91_101,r_124_104_227,r_4_48_187,r_37_91_101,0.97,126,227,101,59
32,r_33_83_115,r_94_74_124,r_116_103_47,r_94_74_124,0.96,-9,115,124,59
38,r_128_29_242,seq46,r_38_85_51,r_38_85_51,0.77,190,241,51,59
24,r_75_88_13,r_124_104_227,seq41,r_75_88_13,0.99,1,14,13,59
45,r_106_42_82,seq80,r_13_24_222,r_13_24_222,0.63,50,272,222,59
81,seq80,seq53,r_123_11_169,r_123_11_169,1.0,31,200,169,59
17,r_94_74_124,r_33_83_115,r_5_70_197,r_94_74_124,0.98,0,124,124,59
46,r_107_96_151,seq111,r_50_19_188,r_107_96_151,0.51,-128,23,151,59
27,r_38_85_51,r_99_77_256,r_50_19_188,r_38_85_51,0.88,6,57,51,59
37,r_68_92_145,seq1,seq69,r_68_92_145,1.0,0,145,145,59
22,r_61_22_216,seq63,seq86,r_61_22_216,0.84,1,217,216,59
16,r_5_70_197,seq89,r_94_74_124,r_94_74_124,0.53,13,137,124,59
28,r_16_52_165,seq111,seq7,r_16_52_165,0.99,0,165,165,59
91,seq112,r_0_76_212,r_49_31_55,r_49_31_55,1.0,157,212,55,59
18,r_116_103_47,r_143_20_79,r_33_83_115,r_33_83_115,0.78,11,126,115,59
44,r_34_126_160,seq53,seq108,r_34_126_160,0.99,0,160,160,59
23,r_21_136_94,r_68_92_145,r_82_66_245,r_21_136_94,0.52,0,94,94,59
17,r_94_74_124,r_5_70_197,seq112,r_5_70_197,1.0,0,197,197,59
82,seq81,seq148,r_3_109_132,r_3_109_132,0.68,26,158,132,59
12,r_64_138_126,seq46,seq9,r_64_138_126,1.0,0,126,126,59
23,r_21_136_94,r_82_66_245,r_13_24_222,r_82_66_245,0.98,4,249,245,59
99,seq125,r_61_59_112,r_66_43_42,r_66_43_42,0.84,0,42,42,60
40,r_116_119_73,r_105_107_229,seq145,r_105_107_229,0.87,0,229,229,60
30,r_45_127_219,seq37,seq142,r_45_127_219,0.84,1,220,219,60
36,r_139_140_254,r_69_71_3,r_141_8_121,r_139_140_254,0.46,0,254,254,60
14,r_74_96_215,seq24,r_116_119_73,r_74_96_215,0.55,0,215,215,60
43,r_10_13_240,seq83,r_93_39_114,r_10_13_240,0.85,0,240,240,60
0,r_149_123_204,r_116_119_73,r_128_65_22,r_149_123_204,0.68,-177,27,204,60
2,r_4_6_181,r_45_127_219,r_79_29_191,r_4_6_181,0.68,14,195,181,60
59,seq145,r_147_38_211,seq40,r_147_38_211,1.0,1,212,211,60
19,r_54_85_129,r_146_80_50,seq125,r_54_85_129,1.0,0,129,129,60
21,r_48_120_122,seq26,seq11,r_48_120_122,0.99,2,124,122,60
39,r_61_59_112,seq125,seq89,r_61_59_112,1.0,0,112,112,60
1,r_84_58_116,seq25,seq26,r_84_58_116,1.0,0,116,116,60
42,r_12_63_158,seq27,r_92_138_85,r_12_63_158,1.0,0,158,158,60
27,r_49_32_24,r_91_109_225,seq134,r_49_32_24,1.0,1,25,24,60
33,r_146_80_50,r_54_85_129,r_10_13_240,r_54_85_129,1.0,0,129,129,60
16,r_128_65_22,r_147_38_211,r_91_109_225,r_91_109_225,1.0,-1,224,225,60
11,r_92_138_85,r_90_103_273,r_12_63_158,r_12_63_158,0.98,4,162,158,60
66,seq25,r_74_96_215,r_72_67_119,r_72_67_119,0.57,21,140,119,60
19,r_54_85_129,r_56_117_152,r_146_80_50,r_146_80_50,1.0,2,52,50,60
31,r_131_62_187,r_69_71_3,r_4_6_181,r_131_62_187,0.95,0,187,187,60
41,r_1_108_235,r_36_73_269,r_129_94_206,r_1_108_235,0.61,-3,232,235,60
3,r_141_8_121,seq89,seq27,r_141_8_121,1.0,0,121,121,60
10,r_105_107_229,seq87,r_116_119_73,r_116_119_73,1.0,21,94,73,60
45,r_31_76_16,seq24,r_143_82_193,r_31_76_16,1.0,0,16,16,60
26,r_137_144_267,seq41,r_72_67_119,r_72_67_119,0.64,148,267,119,60
23,r_66_43_42,r_48_120_122,seq125,r_66_43_42,1.0,0,42,42,60
16,r_128_65_22,r_149_123_204,r_147_38_211,r_149_123_204,0.58,0,204,204,60
8,r_121_126_29,r_131_62_187,seq134,r_121_126_29,1.0,1,30,29,60
16,r_128_65_22,seq148,r_149_123_204,r_128_65_22,1.0,0,22,22,60
73,seq37,r_45_127_219,r_61_59_112,r_61_59_112,1.0,108,220,112,60
11,r_92_138_85,r_84_58_116,r_90_103_273,r_84_58_116,0.99,-49,67,116,60
99,seq125,r_66_43_42,r_54_85_129,r_54_85_129,1.0,31,160,129,60
20,r_102_110_278,seq134,r_111_55_274,r_102_110_278,0.41,2,280,278,60
13,r_129_94_206,seq3,seq24,r_129_94_206,0.8,0,206,206,60
15,r_98_113_192,r_147_38_211,r_130_16_8,r_98_113_192,0.94,0,192,192,60
12,r_135_51_166,r_130_16_8,seq41,r_135_51_166,0.4,34,200,166,60
6,r_147_38_211,r_98_113_192,r_116_119_73,r_116_119_73,0.97,119,192,73,60
33,r_146_80_50,r_12_63_158,r_54_85_129,r_146_80_50,1.0,0,50,50,60
5,r_17_42_49,r_91_109_225,r_149_123_204,r_17_42_49,0.99,164,213,49,60
0,r_149_123_204,r_128_65_22,r_17_42_49,r_149_123_204,0.93,0,204,204,60
10,r_105_107_229,r_116_119_73,seq132,r_105_107_229,0.92,0,229,229,60
79,seq52,r_66_43_42,r_143_82_193,r_143_82_193,1.0,24,217,193,60
2,r_4_6_181,r_111_55_274,r_45_127_219,r_45_127_219,0.68,-37,182,219,60
47,r_0_28_161,seq89,seq35,r_0_28_161,1.0,0,161,161,60
40,r_116_119_73,seq22,r_105_107_229,r_116_119_73,0.98,5,78,73,60
18,r_77_70_125,r_143_82_193,seq75,r_77_70_125,1.0,0,125,125,60
29,r_93_39_114,r_137_144_267,seq46,r_93_39_114,1.0,0,114,114,60
24,r_143_82_193,r_129_94_206,seq52,r_143_82_193,0.94,0,193,193,60
33,r_146_80_50,r_10_13_240,r_4_6_181,r_146_80_50,0.99,133,183,50,60
58,seq15,r_88_57_265,r_141_8_121,r_141_8_121,1.0,144,265,121,60
25,r_78_86_58,r_74_96_215,r_31_76_16,r_78_86_58,0.98,0,58,58,60
38,r_56_117_152,seq14,r_69_71_3,r_56_117_152,1.0,0,152,152,60
75,seq41,r_137_144_267,r_135_51_166,r_137_144_267,1.0,-67,200,267,60
45,r_31_76_16,r_143_82_193,r_78_86_58,r_31_76_16,0.98,177,193,16,60
81,seq64,r_36_73_269,seq133,r_36_73_269,0.95,0,269,269,60
17,r_91_109_225,seq47,r_17_42_49,r_17_42_49,1.0,33,82,49,60
9,r_69_71_3,r_131_62_187,r_56_117_152,r_69_71_3,1.0,152,155,3,60
22,r_72_67_119,seq27,seq25,r_72_67_119,1.0,2,121,119,60
28,r_36_73_269,seq64,r_61_59_112,r_36_73_269,0.66,0,269,269,60
6,r_147_38_211,r_116_119_73,seq22,r_147_38_211,0.53,1,212,211,60
7,r_111_55_274,r_4_6_181,seq132,r_4_6_181,1.0,1,182,181,60
5,r_17_42_49,r_84_58_116,r_91_109_225,r_17_42_49,1.0,0,49,49,60
17,r_91_109_225,r_17_42_49,r_128_65_22,r_91_109_225,0.72,0,225,225,60
79,seq52,seq125,r_66_43_42,r_66_43_42,1.0,0,42,42,60
30,r_7_119_154,r_109_117_278,seq29,r_7_119_154,0.55,0,154,154,61
51,seq128,r_69_136_216,r_42_52_105,r_42_52_105,0.86,2,107,105,61
36,r_138_102_168,seq53,seq22,r_138_102_168,1.0,0,168,168,61
14,r_104_78_296,r_32_20_273,r_144_6_85,r_144_6_85,1.0,189,274,85,61
8,r_30_133_162,seq63,seq148,r_30_133_162,1.0,0,162,162,61
43,r_91_94_165,r_132_2_67,seq4,r_91_94_165,0.97,0,165,165,61
37,r_100_90_265,r_144_6_85,seq26,r_144_6_85,1.0,3,88,85,61
19,r_55_80_17,seq29,seq58,r_55_80_17,0.6,212,229,17,61
16,r_109_117_278,r_5_141_298,r_138_102_168,r_138_102_168,1.0,119,287,168,61
21,r_62_38_250,r_120_17_285,r_144_6_85,r_144_6_85,1.0,15,100,85,61
39,r_145_47_184,r_21_110_185,r_116_126_92,r_145_47_184,0.99,1,185,184,61
1,r_32_20_273,r_104_78_296,r_70_28_136,r_32_20_273,0.53,1,274,273,61
97,seq121,r_135_8_252,seq66,r_135_8_252,0.8,0,252,252,61
46,r_87_71_242,r_34_118_268,seq66,r_87_71_242,0.75,1,243,242,61
42,r_77_85_208,seq29,r_132_2_67,r_77_85_208,0.85,1,209,208,61
80,seq68,seq115,r_108_45_47,r_108_45_47,1.0,40,87,47,61
41,r_64_112_27,seq121,seq131,r_64_112_27,0.95,0,27,27,61
33,r_13_134_241,r_72_97_147,seq76,r_13_134_241,0.71,2,243,241,61
38,r_144_6_85,r_62_38_250,seq89,r_62_38_250,0.98,0,250,250,61
67,seq43,r_93_123_229,seq148,r_93_123_229,1.0,2,231,229,61
3,r_42_52_105,seq68,seq128,r_42_52_105,1.0,1,106,105,61
10,r_116_126_92,seq26,seq143,r_116_126_92,0.96,1,93,92,61
47,r_54_86_43,seq128,seq51,r_54_86_43,0.86,4,47,43,61
72,seq53,r_138_102_168,r_104_78_296,r_138_102_168,1.0,0,168,168,61
7,r_65_88_57,r_48_61_234,seq51,r_65_88_57,1.0,0,57,57,61
4,r_135_8_252,seq121,seq89,r_135_8_252,0.57,0,252,252,61
78,seq63,r_37_98_116,seq146,r_37_98_116,0.86,1,117,116,61
0,r_106_67_215,r_70_28_136,r_144_6_85,r_106_67_215,0.71,-2,213,215,61
63,seq29,r_77_85_208,seq58,r_77_85_208,0.96,1,209,208,61
20,r_72_97_147,seq22,r_13_134_241,r_72_97_147,0.54,0,147,147,61
13,r_93_123_229,seq43,r_113_114_294,r_93_123_229,0.91,2,231,229,61
15,r_23_14_144,r_132_2_67,r_70_28_136,r_23_14_144,0.57,10,154,144,61
48,r_35_10_75,r_72_97_147,r_13_134_241,r_13_134_241,0.67,-184,57,241,61
6,r_125_1_152,r_37_98_116,seq26,r_125_1_152,1.0,1,153,152,61
21,r_62_38_250,r_144_6_85,seq59,r_62_38_250,0.66,0,250,250,61
10,r_116_126_92,seq143,r_145_47_184,r_145_47_184,1.0,3,187,184,61
27,r_16_31_282,r_39_137_277,r_11_3_34,r_11_3_34,0.97,248,282,34,61
2,r_120_17_285,seq89,r_21_110_185,r_120_17_285,0.29,2,287,285,61
40,r_69_136_216,seq128,r_99_73_159,r_69_136_216,0.86,1,217,216,61
18,r_48_61_234,seq0,r_149_83_46,r_48_61_234,0.9,0,234,234,61
5,r_140_122_10,r_120_17_285,seq4,r_140_122_10,0.77,0,10,10,61
61,seq25,r_139_49_291,r_75_129_158,r_75_129_158,1.0,3,161,158,61
24,r_27_33_210,r_21_110_185,r_125_1_152,r_27_33_210,1.0,0,210,210,61
25,r_75_129_158,r_13_134_241,seq25,r_75_129_158,0.73,2,160,158,61
33,r_13_134_241,r_75_129_158,r_72_97_147,r_75_129_158,0.98,0,158,158,61
48,r_35_10_75,r_13_134_241,r_72_97_147,r_72_97_147,0.56,96,243,147,61
88,seq89,r_120_17_285,r_144_6_85,r_144_6_85,1.0,122,207,85,61
52,seq131,r_72_97_147,r_64_112_27,r_64_112_27,0.91,22,49,27,61
20,r_72_97_147,r_13_134_241,r_35_10_75,r_13_134_241,0.84,2,243,241,61
38,r_144_6_85,r_100_90_265,r_62_38_250,r_144_6_85,1.0,1,86,85,61
34,r_39_137_277,seq22,r_30_133_162,r_30_133_162,1.0,122,284,162,61
19,r_55_80_17,seq142,seq29,r_55_80_17,0.98,0,17,17,61
26,r_11_3_34,r_125_1_152,seq56,r_11_3_34,0.99,0,34,34,61
29,r_108_45_47,r_106_67_215,seq68,r_108_45_47,1.0,1,48,47,61
9,r_34_118_268,r_132_2_67,r_64_112_27,r_132_2_67,0.47,201,268,67,61
26,r_11_3_34,seq56,r_18_92_89,r_18_92_89,0.97,6,95,89,61
22,r_21_110_185,r_27_33_210,seq44,r_27_33_210,0.58,-23,187,210,61
49,r_99_73_159,r_13_134_241,seq147,r_99_73_159,0.48,0,159,159,61
56,seq146,r_125_1_152,seq63,r_125_1_152,1.0,-10,142,152,61
44,r_70_28_136,r_106_67_215,r_23_14_144,r_106_67_215,0.74,-2,213,215,61
23,r_9_130_78,r_42_52_105,seq66,r_9_130_78,1.0,0,78,78,61
79,seq66,seq101,r_9_130_78,r_9_130_78,1.0,23,101,78,61
35,r_18_92_89,seq101,r_11_3_34,r_18_92_89,0.99,0,89,89,61
30,r_7_119_154,seq29,r_55_80_17,r_55_80_17,0.82,110,127,17,61
12,r_95_12_200,r_27_33_210,seq58,r_95_12_200,0.67,1,201,200,61
93,seq110,r_137_68_144,r_19_109_125,r_19_109_125,0.62,25,150,125,62
30,r_4_6_78,r_11_123_87,seq43,r_4_6_78,1.0,1,79,78,62
36,r_104_49_85,r_124_87_119,r_21_29_218,r_104_49_85,0.54,2,87,85,62
17,r_3_103_47,r_38_61_183,seq65,r_3_103_47,1.0,0,47,47,62
92,seq108,r_21_29_218,r_93_73_155,r_93_73_155,1.0,7,162,155,62
14,r_122_143_71,r_137_68_144,seq89,r_122_143_71,0.6,43,114,71,62
8,r_53_30_160,seq130,seq36,r_53_30_160,0.86,3,163,160,62
43,r_124_87_119,seq89,seq79,r_124_87_119,1.0,0,119,119,62
40,r_20_92_11,r_42_129_101,seq60,r_20_92_11,0.53,1,12,11,62
83,seq81,r_134_67_197,r_50_18_63,r_50_18_63,0.98,116,179,63,62
37,r_64_71_154,seq81,r_50_18_63,r_50_18_63,1.0,16,79,63,62
3,r_147_52_137,r_15_7_36,r_69_76_10,r_147_52_137,0.98,0,137,137,62
59,seq17,r_13_26_237,r_51_57_172,r_51_57_172,0.86,65,237,172,62
5,r_9_41_277,r_94_135_203,r_56_37_16,r_56_37_16,0.85,0,16,16,62
21,r_88_144_281,seq146,r_122_143_71,r_122_143_71,0.85,210,281,71,62
39,r_82_40_179,seq75,r_64_71_154,r_64_71_154,1.0,26,180,154,62
1,r_132_28_121,r_94_135_203,seq23,r_132_28_121,0.96,0,121,121,62
97,seq120,seq81,r_136_12_52,r_136_12_52,1.0,33,85,52,62
46,r_106_8_102,seq138,r_9_41_277,r_106_8_102,0.94,0,102,102,62
42,r_83_113_140,r_13_26_237,seq130,r_83_113_140,1.0,1,141,140,62
45,r_149_31_233,r_13_26_237,r_137_68_144,r_137_68_144,0.94,89,233,144,62
15,r_56_37_16,seq121,r_9_41_277,r_56_37_16,0.63,0,16,16,62
19,r_58_5_93,seq45,seq60,r_58_5_93,1.0,1,94,93,62
15,r_56_37_16,r_9_41_277,r_112_127_37,r_112_127_37,0.88,240,277,37,62
33,r_107_33_45,r_94_135_203,r_112_127_37,r_94_135_203,0.82,-1,202,203,62
27,r_50_18_63,r_64_71_154,r_11_123_87,r_64_71_154,0.99,0,154,154,62
41,r_142_115_247,seq14,r_112_127_37,r_142_115_247,0.63,0,247,247,62
67,seq36,r_38_61_183,r_53_30_160,r_38_61_183,1.0,-40,143,183,62
96,seq118,seq24,r_111_10_211,r_111_10_211,1.0,0,211,211,62
26,r_93_73_155,seq148,seq108,r_93_73_155,1.0,0,155,155,62
33,r_107_33_45,r_111_10_211,r_94_135_203,r_107_33_45,0.77,3,48,45,62
0,r_111_10_211,seq148,seq118,r_111_10_211,0.61,0,211,211,62
38,r_126_72_55,seq25,seq130,r_126_72_55,1.0,0,55,55,62
63,seq23,seq105,r_132_28_121,r_132_28_121,1.0,50,171,121,62
73,seq54,seq43,r_122_143_71,r_122_143_71,0.37,127,198,71,62
11,r_38_61_183,r_21_29_218,seq43,r_38_61_183,0.98,0,183,183,62
7,r_136_12_52,r_93_73_155,seq120,r_136_12_52,1.0,0,52,52,62
20,r_11_123_87,seq131,r_50_18_63,r_50_18_63,0.98,27,90,63,62
13,r_13_26_237,seq17,r_147_52_137,r_13_26_237,0.8,0,237,237,62
98,seq121,seq128,r_74_77_33,r_74_77_33,1.0,28,61,33,62
46,r_106_8_102,r_9_41_277,seq116,r_9_41_277,0.8,-11,266,277,62
48,r_48_2_236,seq47,r_137_68_144,r_48_2_236,0.93,1,237,236,62
6,r_86_55_169,seq138,r_83_113_140,r_86_55_169,1.0,1,170,169,62
85,seq89,r_124_87_119,r_122_143_71,r_124_87_119,1.0,0,119,119,62
5,r_9_41_277,r_56_37_16,seq131,r_9_41_277,0.6,0,277,277,62
10,r_15_7_36,seq148,r_149_31_233,r_149_31_233,0.95,12,245,233,62
36,r_104_49_85,r_21_29_218,seq0,r_21_29_218,0.42,-31,187,218,62
10,r_15_7_36,r_147_52_137,seq148,r_147_52_137,0.6,48,185,137,62
27,r_50_18_63,seq43,r_64_71_154,r_50_18_63,1.0,0,63,63,62
18,r_51_57_172,seq62,seq17,r_51_57_172,1.0,0,172,172,62
24,r_16_32_146,seq0,seq14,r_16_32_146,1.0,3,149,146,62
25,r_78_140_150,seq116,r_34_96_3,r_78_140_150,1.0,0,150,150,62
10,r_15_7_36,r_16_32_146,r_147_52_137,r_15_7_36,1.0,0,36,36,62
64,seq24,seq118,r_94_135_203,r_94_135_203,0.57,8,211,203,62
58,seq14,r_142_115_247,r_16_32_146,r_16_32_146,1.0,101,247,146,62
68,seq39,seq60,r_137_68_144,r_137_68_144,0.89,6,150,144,62
61,seq148,r_111_10_211,seq22,r_111_10_211,0.98,-22,189,211,62
32,r_84_101_107,seq63,seq75,r_84_101_107,0.98,0,107,107,62
52,seq130,r_53_30_160,r_83_113_140,r_83_113_140,0.98,23,163,140,62
77,seq62,r_51_57_172,r_122_143_71,r_51_57_172,0.96,0,172,172,62
34,r_69_76_10,r_95_119_17,r_147_52_137,r_147_52_137,1.0,12,149,137,62
75,seq60,seq39,r_58_5_93,r_58_5_93,1.0,57,150,93,62
60,seq146,r_88_144_281,r_78_140_150,r_78_140_150,1.0,131,281,150,62
81,seq79,seq0,r_124_87_119,r_124_87_119,1.0,32,151,119,62
2,r_112_127_37,r_38_61_183,seq45,r_112_127_37,1.0,0,37,37,62
96,seq118,r_42_129_101,seq24,r_42_129_101,1.0,-18,83,101,62
98,seq121,r_74_77_33,r_134_67_197,r_134_67_197,1.0,10,207,197,62
37,r_64_71_154,r_50_18_63,r_82_40_179,r_64_71_154,1.0,0,154,154,62
28,r_137_68_144,seq110,seq39,r_137_68_144,0.63,6,150,144,62
44,r_97_66_212,seq130,r_51_57_172,r_51_57_172,0.6,40,212,172,62
23,r_94_135_203,seq91,seq24,r_94_135_203,0.71,-5,198,203,62
31,r_74_77_33,r_48_2_236,seq121,r_74_77_33,1.0,0,33,33,62
12,r_95_119_17,r_69_76_10,seq75,r_95_119_17,0.31,180,197,17,62
36,r_104_49_85,seq0,r_86_55_169,r_86_55_169,0.53,94,263,169,62
3,r_147_52_137,r_51_57_172,r_15_7_36,r_15_7_36,0.98,2,38,36,62
44,r_21_136_52,r_90_117_46,r_63_73_202,r_63_73_202,1.0,0,202,202,63
18,r_29_5_58,seq142,seq123,r_29_5_58,1.0,1,59,58,63
36,r_82_97_223,seq22,r_75_34_228,r_82_97_223,0.49,1,224,223,63
6,r_90_117_46,r_30_26_229,r_140_99_121,r_90_117_46,1.0,0,46,46,63
14,r_2_32_138,seq138,r_65_43_127,r_2_32_138,1.0,0,138,138,63
8,r_140_99_121,r_89_77_128,r_90_117_46,r_90_117_46,1.0,14,60,46,63
43,r_50_42_178,seq46,seq10,r_50_42_178,0.55,1,179,178,63
37,r_28_85_238,r_30_26_229,r_132_40_142,r_132_40_142,1.0,21,163,142,63
51,seq131,r_107_93_260,r_45_14_11,r_45_14_11,0.85,1,12,11,63
55,seq11,r_55_147_245,r_4_121_179,r_4_121_179,0.99,66,245,179,63
71,seq41,r_96_20_265,r_33_58_68,r_33_58_68,1.0,197,265,68,63
86,seq86,seq142,r_87_88_91,r_87_88_91,1.0,4,95,91,63
39,r_146_100_102,r_55_147_245,r_52_8_160,r_146_100_102,1.0,1,103,102,63
1,r_55_147_245,seq11,r_72_25_222,r_55_147_245,0.61,0,245,245,63
27,r_129_116_59,r_55_147_245,r_72_25_222,r_129_116_59,1.0,0,59,59,63
80,seq69,r_55_147_245,r_2_32_138,r_2_32_138,0.43,90,228,138,63
42,r_94_60_212,r_125_120_252,seq98,r_94_60_212,0.98,0,212,212,63
21,r_44_0_45,r_23_128_40,seq19,r_44_0_45,1.0,0,45,45,63
19,r_54_80_92,seq76,seq103,r_54_80_92,1.0,0,92,92,63
27,r_129_116_59,r_72_25_222,r_143_59_119,r_143_59_119,0.95,3,122,119,63
32,r_125_120_252,seq46,seq84,r_125_120_252,1.0,0,252,252,63
31,r_111_83_95,r_125_120_252,seq53,r_125_120_252,0.98,-168,84,252,63
41,r_122_39_161,r_78_105_181,seq66,r_122_39_161,0.58,2,163,161,63
84,seq81,r_28_85_238,seq84,r_28_85_238,0.7,-189,49,238,63
90,seq98,r_96_20_265,r_33_58_68,r_33_58_68,1.0,14,82,68,63
26,r_87_88_91,r_65_43_127,seq86,r_87_88_91,1.0,0,91,91,63
8,r_140_99_121,r_90_117_46,seq49,r_140_99_121,1.0,0,121,121,63
4,r_52_8_160,seq79,r_146_100_102,r_146_100_102,1.0,17,119,102,63
0,r_56_70_221,seq123,seq84,r_56_70_221,0.51,4,225,221,63
73,seq49,r_30_26_229,r_140_99_121,r_140_99_121,1.0,33,154,121,63
11,r_72_25_222,seq61,seq119,r_72_25_222,0.77,2,224,222,63
20,r_104_51_126,r_30_26_229,seq137,r_104_51_126,0.98,1,127,126,63
13,r_78_105_181,seq36,seq76,r_78_105_181,0.47,0,181,181,63
2,r_106_71_198,seq24,r_87_88_91,r_87_88_91,0.92,107,198,91,63
47,r_135_101_80,seq16,r_33_58_68,r_135_101_80,0.99,-4,76,80,63
40,r_89_77_128,r_140_99_121,r_21_136_52,r_21_136_52,1.0,65,117,52,63
29,r_33_58_68,seq108,seq98,r_33_58_68,1.0,0,68,68,63
24,r_63_73_202,r_92_133_194,r_21_136_52,r_63_73_202,0.76,0,202,202,63
25,r_143_59_119,r_56_70_221,r_129_116_59,r_143_59_119,1.0,0,119,119,63
33,r_65_43_127,seq130,r_2_32_138,r_2_32_138,1.0,40,178,138,63
40,r_89_77_128,r_21_136_52,seq110,r_89_77_128,0.98,0,128,128,63
30,r_12_68_49,seq138,seq38,r_12_68_49,0.99,0,49,49,63
4,r_52_8_160,r_146_100_102,seq36,r_52_8_160,1.0,1,161,160,63
6,r_90_117_46,r_140_99_121,r_21_136_52,r_140_99_121,1.0,0,121,121,63
32,r_125_120_252,r_94_60_212,seq46,r_94_60_212,0.48,0,212,212,63
38,r_115_64_211,seq137,seq79,r_115_64_211,0.98,1,212,211,63
34,r_132_40_142,seq36,seq84,r_132_40_142,1.0,0,142,142,63
44,r_21_136_52,r_96_20_265,r_90_117_46,r_21_136_52,1.0,0,52,52,63
75,seq138,r_2_32_138,seq11,r_2_32_138,1.0,-54,84,138,63
39,r_146_100_102,r_52_8_160,seq79,r_52_8_160,1.0,2,162,160,63
92,seq108,r_33_58_68,seq11,r_33_58_68,1.0,-9,59,68,63
96,seq119,r_23_128_40,r_17_1_42,r_17_1_42,0.72,1,43,42,63
94,seq110,r_92_133_194,r_89_77_128,r_89_77_128,1.0,22,150,128,63
35,r_124_47_37,r_107_93_260,seq18,r_124_47_37,0.96,-2,35,37,63
37,r_28_85_238,r_132_40_142,seq61,r_28_85_238,0.83,0,238,238,63
22,r_114_141_150,r_6_134_244,seq24,r_114_141_150,0.99,1,151,150,63
28,r_48_139_220,seq49,r_17_1_42,r_48_139_220,0.89,2,222,220,63
49,r_145_3_111,seq142,r_92_133_194,r_145_3_111,0.69,13,124,111,63
7,r_30_26_229,seq49,seq13,r_30_26_229,0.61,5,234,229,63
23,r_4_121_179,seq81,seq11,r_4_121_179,0.99,0,179,179,63
82,seq76,r_54_80_92,seq15,r_54_80_92,0.97,0,92,92,63
10,r_45_14_11,r_72_25_222,seq38,r_45_14_11,0.91,0,11,11,63
12,r_75_34_228,seq103,r_82_97_223,r_75_34_228,0.58,1,229,228,63
30,r_11_118_4,r_81_65_296,r_38_2_139,r_38_2_139,1.0,0,139,139,64
44,r_41_5_245,r_33_10_22,r_34_133_52,r_41_5_245,0.95,0,245,245,64
51,seq132,r_79_6_138,r_108_89_174,r_79_6_138,0.86,13,151,138,64
6,r_33_10_22,r_56_14_292,r_41_5_245,r_33_10_22,0.98,0,22,22,64
36,r_127_51_239,seq135,r_34_133_52,r_34_133_52,0.99,187,239,52,64
38,r_105_82_155,r_37_103_186,seq132,r_37_103_186,0.98,-133,53,186,64
14,r_90_91_187,r_127_51_239,seq75,r_90_91_187,0.69,0,187,187,64
43,r_56_14_292,r_8_110_229,r_34_133_52,r_34_133_52,1.0,177,229,52,64
37,r_113_45_110,r_37_103_186,seq71,r_113_45_110,0.67,1,111,110,64
3,r_97_46_84,r_53_143_170,seq109,r_53_143_170,0.99,0,170,170,64
16,r_124_128_218,seq98,seq29,r_124_128_218,0.86,2,220,218,64
39,r_140_20_175,seq121,seq98,r_140_20_175,0.83,0,175,175,64
1,r_130_102_63,seq80,seq136,r_130_102_63,0.87,0,63,63,64
42,r_55_72_161,r_116_114_177,r_108_89_174,r_108_89_174,0.96,-9,165,174,64
45,r_111_68_99,seq121,r_0_76_23,r_111_68_99,0.64,-1,98,99,64
5,r_34_133_52,seq123,seq121,r_34_133_52,1.0,0,52,52,64
76,seq57,r_3_64_214,seq25,r_3_64_214,0.78,13,227,214,64
31,r_30_16_277,seq99,seq17,r_30_16_277,0.31,0,277,277,64
47,r_0_76_23,r_3_64_214,seq62,r_0_76_23,0.91,0,23,23,64
3,r_97_46_84,r_124_128_218,r_53_143_170,r_97_46_84,0.95,1,85,84,64
10,r_144_52_136,seq21,seq98,r_144_52_136,0.99,0,136,136,64
90,seq98,r_87_28_253,r_36_61_243,r_87_28_253,0.68,0,253,253,64
44,r_41_5_245,r_35_1_190,r_33_10_22,r_33_10_22,0.5,0,22,22,64
26,r_126_24_93,r_38_2_139,seq120,r_126_24_93,1.0,0,93,93,64
3,r_97_46_84,seq109,r_35_1_190,r_35_1_190,0.68,17,207,190,64
4,r_9_63_91,r_85_22_176,seq44,r_85_22_176,0.92,-86,90,176,64
63,seq23,r_60_48_142,seq139,r_60_48_142,0.97,0,142,142,64
11,r_93_95_68,seq99,seq66,r_93_95_68,1.0,3,71,68,64
20,r_108_89_174,seq13,r_55_72_161,r_55_72_161,0.94,80,241,161,64
15,r_116_114_177,r_67_47_280,r_108_89_174,r_116_114_177,0.73,1,178,177,64
48,r_119_58_116,r_124_128_218,r_97_46_84,r_124_128_218,1.0,-102,116,218,64
49,r_35_1_190,r_81_65_296,r_97_46_84,r_35_1_190,0.83,1,191,190,64
34,r_149_88_34,r_81_65_296,seq146,r_149_88_34,0.95,0,34,34,64
0,r_138_101_18,r_144_52_136,seq80,r_138_101_18,0.87,0,18,18,64
2,r_38_2_139,seq104,r_11_118_4,r_38_2_139,0.99,0,139,139,64
40,r_67_47_280,seq40,r_30_16_277,r_30_16_277,0.55,3,280,277,64
29,r_79_6_138,seq132,seq75,r_79_6_138,0.86,1,139,138,64
24,r_60_48_142,seq23,seq135,r_60_48_142,1.0,0,142,142,64
25,r_87_28_253,seq98,r_3_64_214,r_87_28_253,0.43,0,253,253,64
33,r_8_110_229,r_56_14_292,r_124_128_218,r_8_110_229,0.6,0,229,229,64
47,r_0_76_23,seq62,r_111_68_99,r_111_68_99,1.0,40,139,99,64
88,seq84,r_7_141_232,r_34_133_52,r_34_133_52,0.94,180,232,52,64
6,r_33_10_22,r_41_5_245,r_37_103_186,r_37_103_186,0.69,59,245,186,64
18,r_78_96_47,r_81_65_296,seq146,r_78_96_47,1.0,-1,46,47,64
81,seq71,seq59,r_113_45_110,r_113_45_110,0.99,6,116,110,64
17,r_53_143_170,seq109,r_97_46_84,r_97_46_84,0.86,4,88,84,64
9,r_70_115_101,r_79_6_138,seq146,r_70_115_101,0.63,0,101,101,64
96,seq120,seq99,r_126_24_93,r_126_24_93,1.0,13,106,93,64
28,r_147_142_255,seq109,r_78_96_47,r_78_96_47,0.69,210,257,47,64
91,seq99,r_30_16_277,r_126_24_93,r_126_24_93,1.0,110,203,93,64
49,r_35_1_190,r_41_5_245,r_81_65_296,r_41_5_245,0.63,-166,79,245,64
7,r_81_65_296,r_4_92_252,r_11_118_4,r_4_92_252,0.97,1,253,252,64
17,r_53_143_170,r_97_46_84,r_113_45_110,r_53_143_170,1.0,0,170,170,64
35,r_4_92_252,r_81_65_296,r_122_42_8,r_4_92_252,0.61,1,253,252,64
12,r_7_141_232,seq84,r_53_143_170,r_7_141_232,0.81,0,232,232,64
30,r_48_129_105,seq128,seq112,r_48_129_105,0.85,2,107,105,65
51,seq128,seq43,r_6_46_246,r_6_46_246,0.41,1,247,246,65
36,r_106_32_242,seq65,r_145_110_163,r_145_110_163,0.85,79,242,163,65
14,r_23_61_172,r_104_102_241,seq4,r_23_61_172,0.82,0,172,172,65
8,r_134_37_141,r_133_66_192,seq141,r_134_37_141,0.95,0,141,141,65
43,r_83_21_111,r_58_63_152,r_44_70_75,r_58_63_152,1.0,-41,111,152,65
59,seq14,r_27_139_177,seq74,r_27_139_177,1.0,0,177,177,65
44,r_105_81_45,seq4,r_26_120_157,r_105_81_45,0.88,1,46,45,65
86,seq92,r_29_11_215,r_17_57_148,r_17_57_148,0.57,5,153,148,65
24,r_135_18_15,r_96_19_95,seq76,r_135_18_15,1.0,1,16,15,65
21,r_56_132_222,r_114_8_249,seq117,r_56_132_222,0.66,0,222,222,65
39,r_89_35_98,r_125_97_280,seq78,r_89_35_98,1.0,0,98,98,65
1,r_146_3_90,seq94,r_49_136_110,r_49_136_110,0.99,59,169,110,65
1,r_146_3_90,r_84_130_142,seq94,r_146_3_90,1.0,0,90,90,65
46,r_58_63_152,seq93,seq113,r_58_63_152,0.9,0,152,152,65
42,r_10_123_182,r_73_72_217,r_30_38_97,r_30_38_97,1.0,0,97,97,65
80,seq79,r_29_11_215,seq92,r_29_11_215,1.0,-17,198,215,65
7,r_91_109_238,r_36_100_123,r_68_51_113,r_91_109_238,0.83,0,238,238,65
45,r_28_143_167,r_90_34_230,r_105_81_45,r_90_34_230,0.53,-62,168,230,65
19,r_77_39_223,r_40_121_278,seq113,r_40_121_278,0.85,-55,223,278,65
15,r_67_116_158,r_146_3_90,r_149_95_184,r_149_95_184,0.71,58,242,184,65
67,seq41,r_145_110_163,seq78,r_145_110_163,0.99,-8,155,163,65
3,r_45_1_169,seq131,r_44_70_75,r_45_1_169,0.6,1,170,169,65
10,r_96_19_95,r_125_97_280,r_114_8_249,r_96_19_95,1.0,0,95,95,65
20,r_114_8_249,seq131,r_89_35_98,r_114_8_249,1.0,0,249,249,65
0,r_145_110_163,seq41,r_26_120_157,r_145_110_163,0.93,0,163,163,65
73,seq60,r_77_39_223,r_53_62_131,r_53_62_131,1.0,18,149,131,65
11,r_6_46_246,seq140,seq128,r_6_46_246,0.58,1,247,246,65
40,r_133_66_192,seq15,r_75_124_6,r_133_66_192,0.98,0,192,192,65
20,r_114_8_249,r_56_132_222,seq131,r_56_132_222,0.81,-12,210,222,65
13,r_36_100_123,seq24,r_91_109_238,r_36_100_123,0.65,-2,121,123,65
98,seq122,r_73_72_217,seq138,r_73_72_217,0.71,3,220,217,65
15,r_67_116_158,r_27_139_177,r_146_3_90,r_146_3_90,0.99,76,166,90,65
48,r_84_130_142,r_146_3_90,r_125_97_280,r_146_3_90,1.0,0,90,90,65
12,r_104_102_241,seq69,r_29_11_215,r_104_102_241,0.99,0,241,241,65
13,r_36_100_123,r_91_109_238,seq112,r_91_109_238,1.0,0,238,238,65
6,r_47_5_137,r_104_102_241,r_105_81_45,r_47_5_137,0.88,1,138,137,65
62,seq147,seq25,r_119_103_168,r_119_103_168,1.0,20,188,168,65
85,seq88,r_22_7_256,r_59_52_181,r_59_52_181,0.86,78,259,181,65
2,r_26_120_157,r_105_81_45,seq118,r_26_120_157,1.0,0,157,157,65
99,seq127,r_68_51_113,r_22_7_256,r_68_51_113,0.88,0,113,113,65
10,r_96_19_95,r_114_8_249,r_104_102_241,r_96_19_95,0.94,154,249,95,65
27,r_75_124_6,seq0,r_133_66_192,r_133_66_192,0.88,8,200,192,65
48,r_84_130_142,r_125_97_280,seq118,r_84_130_142,1.0,0,142,142,65
87,seq93,r_58_63_152,r_67_116_158,r_58_63_152,1.0,0,152,152,65
40,r_133_66_192,r_134_37_141,seq15,r_134_37_141,0.95,0,141,141,65
74,seq65,r_106_32_242,seq78,r_106_32_242,0.61,0,242,242,65
18,r_90_34_230,seq112,r_49_136_110,r_90_34_230,0.92,0,230,230,65
29,r_44_70_75,seq108,seq140,r_44_70_75,1.0,0,75,75,65
25,r_148_64_262,seq118,r_89_35_98,r_89_35_98,0.98,164,262,98,65
33,r_53_62_131,r_47_5_137,seq60,r_53_62_131,0.99,0,131,131,65
4,r_107_98_30,r_67_116_158,seq112,r_107_98_30,1.0,1,31,30,65
44,r_105_81_45,seq113,seq4,r_105_81_45,0.57,-19,26,45,65
42,r_10_123_182,r_30_38_97,r_26_120_157,r_10_123_182,0.81,-1,181,182,65
32,r_80_87_289,seq76,r_59_52_181,r_59_52_181,0.93,108,289,181,65
38,r_30_38_97,r_71_101_271,seq122,r_30_38_97,1.0,1,98,97,65
34,r_119_103_168,seq42,seq147,r_119_103_168,1.0,1,169,168,65
81,seq141,r_125_97_280,r_115_31_29,r_115_31_29,1.0,252,281,29,65
17,r_27_139_177,seq14,seq69,r_27_139_177,0.84,0,177,177,65
94,seq113,seq76,r_58_63_152,r_58_63_152,1.0,-1,151,152,65
9,r_59_52_181,r_67_116_158,r_23_61_172,r_59_52_181,1.0,0,181,181,65
96,seq118,r_148_64_262,r_26_120_157,r_26_120_157,1.0,88,245,157,65
22,r_149_95_184,seq117,r_67_116_158,r_149_95_184,0.73,0,184,184,65
28,r_40_121_278,seq60,r_90_34_230,r_90_34_230,0.79,48,278,230,65
91,seq108,r_44_70_75,r_67_116_158,r_44_70_75,1.0,1,76,75,65
49,r_49_136_110,r_104_102_241,r_146_3_90,r_104_102_241,1.0,-131,110,241,65
41,r_115_31_29,r_68_51_113,seq86,r_115_31_29,1.0,0,29,29,65
7,r_91_109_238,r_90_34_230,r_36_100_123,r_36_100_123,0.62,1,124,123,65
78,seq76,r_80_87_289,r_135_18_15,r_135_18_15,1.0,1,16,15,65
23,r_17_57_148,seq140,seq92,r_17_57_148,0.93,0,148,148,65
44,r_105_81_45,r_26_120_157,r_47_5_137,r_105_81_45,0.98,112,157,45,65
35,r_29_11_215,seq79,seq13,r_29_11_215,0.89,0,215,215,65
12,r_104_102_241,r_49_136_110,seq69,r_49_136_110,1.0,0,110,110,65
84,seq86,r_71_101_271,r_115_31_29,r_115_31_29,1.0,242,271,29,65
2,r_26_120_157,r_45_1_169,r_105_81_45,r_105_81_45,0.56,0,45,45,65
93,seq101,r_140_25_218,seq8,r_140_25_218,0.88,0,218,218,66
30,r_108_6_237,r_105_19_231,r_24_68_188,r_24_68_188,1.0,3,191,188,66
36,r_140_25_218,seq101,r_4_46_195,r_140_25_218,0.88,0,218,218,66
30,r_108_6_237,r_24_68_188,seq88,r_108_6_237,1.0,1,238,237,66
17,r_121_78_47,r_28_29_245,r_106_71_277,r_121_78_47,1.0,0,47,47,66
8,r_5_0_137,r_4_46_195,r_93_58_3,r_5_0_137,1.0,0,137,137,66
43,r_38_139_178,seq62,seq30,r_38_139_178,1.0,0,178,178,66
37,r_52_7_88,r_14_32_117,seq15,r_52_7_88,0.89,1,89,88,66
16,r_24_68_188,r_113_51_200,r_108_6_237,r_24_68_188,0.64,0,188,188,66
21,r_57_82_251,seq23,r_18_143_198,r_57_82_251,0.62,1,252,251,66
39,r_74_138_104,seq10,r_52_7_88,r_74_138_104,1.0,0,104,104,66
29,r_28_29_245,r_37_131_55,r_54_41_189,r_28_29_245,0.8,-59,186,245,66
1,r_129_48_66,seq127,r_34_60_49,r_129_48_66,0.58,0,66,66,66
5,r_84_120_190,seq99,r_54_41_189,r_84_120_190,0.89,1,191,190,66
46,r_53_56_122,seq65,r_4_46_195,r_53_56_122,0.54,9,131,122,66
42,r_49_95_135,seq63,seq70,r_49_95_135,0.99,1,136,135,66
22,r_141_64_155,r_145_118_58,r_34_60_49,r_141_64_155,1.0,-97,58,155,66
15,r_47_39_48,seq126,seq36,r_47_39_48,1.0,0,48,48,66
45,r_104_109_173,seq42,r_4_46_195,r_104_109_173,0.86,0,173,173,66
19,r_113_51_200,r_24_68_188,r_4_46_195,r_24_68_188,1.0,0,188,188,66
76,seq67,seq59,r_141_64_155,r_141_64_155,1.0,26,181,155,66
2,r_34_60_49,seq43,r_141_64_155,r_34_60_49,1.0,2,51,49,66
31,r_105_19_231,r_108_6_237,r_21_94_157,r_105_19_231,0.86,0,231,231,66
41,r_21_94_157,seq2,seq55,r_21_94_157,0.84,1,158,157,66
67,seq40,r_124_115_209,seq65,r_124_115_209,1.0,0,209,209,66
3,r_90_114_176,seq98,seq79,r_90_114_176,0.99,0,176,176,66
4,r_145_118_58,r_141_64_155,seq42,r_145_118_58,1.0,0,58,58,66
10,r_54_41_189,seq125,r_84_120_190,r_84_120_190,0.88,0,190,190,66
48,r_37_131_55,r_141_64_155,seq97,r_37_131_55,1.0,0,55,55,66
26,r_106_71_277,r_110_80_118,r_121_78_47,r_106_71_277,1.0,-200,77,277,66
72,seq59,r_20_26_177,r_119_117_239,r_119_117_239,0.78,-62,177,239,66
78,seq70,seq10,r_49_95_135,r_49_95_135,1.0,1,136,135,66
0,r_133_116_274,seq13,seq132,r_133_116_274,0.47,-3,271,274,66
63,seq30,r_12_130_261,r_38_139_178,r_38_139_178,1.0,93,271,178,66
28,r_123_111_24,r_113_51_200,seq126,r_123_111_24,0.71,1,25,24,66
20,r_14_32_117,seq132,r_129_48_66,r_14_32_117,1.0,0,117,117,66
13,r_142_66_97,r_21_94_157,r_119_117_239,r_142_66_97,1.0,0,97,97,66
13,r_142_66_97,r_119_117_239,r_124_115_209,r_142_66_97,0.94,142,239,97,66
6,r_128_45_199,r_136_87_128,r_37_131_55,r_128_45_199,0.71,-71,128,199,66
2,r_34_60_49,r_141_64_155,r_14_32_117,r_34_60_49,1.0,107,156,49,66
99,seq127,r_129_48_66,seq8,r_129_48_66,0.99,0,66,66,66
52,seq132,seq31,r_17_149_169,r_17_149_169,1.0,22,191,169,66
27,r_135_33_80,seq70,r_18_143_198,r_135_33_80,0.73,22,102,80,66
22,r_141_64_155,r_34_60_49,seq67,r_141_64_155,1.0,1,156,155,66
29,r_28_29_245,r_121_78_47,seq42,r_121_78_47,1.0,0,47,47,66
74,seq63,seq31,r_17_149_169,r_17_149_169,1.0,22,191,169,66
18,r_119_117_239,seq103,r_142_66_97,r_142_66_97,0.99,0,97,97,66
37,r_52_7_88,seq15,r_74_138_104,r_74_138_104,0.97,36,140,104,66
24,r_147_22_102,r_128_45_199,seq86,r_147_22_102,1.0,0,102,102,66
25,r_110_80_118,seq23,seq30,r_110_80_118,1.0,0,118,118,66
98,seq126,r_47_39_48,r_123_111_24,r_47_39_48,1.0,0,48,48,66
69,seq43,r_34_60_49,seq63,r_34_60_49,1.0,-7,42,49,66
58,seq15,r_108_6_237,r_74_138_104,r_74_138_104,0.99,14,118,104,66
66,seq36,seq69,r_47_39_48,r_47_39_48,1.0,0,48,48,66
6,r_128_45_199,r_37_131_55,seq67,r_128_45_199,1.0,0,199,199,66
29,r_28_29_245,r_54_41_189,seq67,r_28_29_245,0.98,0,245,245,66
32,r_112_102_170,seq31,seq65,r_112_102_170,0.99,0,170,170,66
52,seq132,r_14_32_117,seq31,r_14_32_117,1.0,0,117,117,66
77,seq69,r_93_58_3,r_89_144_39,r_89_144_39,1.0,55,94,39,66
34,r_17_149_169,r_104_109_173,seq63,r_17_149_169,1.0,1,170,169,66
47,r_89_144_39,r_90_114_176,seq69,r_89_144_39,1.0,0,39,39,66
9,r_12_130_261,seq30,r_108_6_237,r_108_6_237,0.75,34,271,237,66
26,r_106_71_277,r_121_78_47,seq31,r_121_78_47,0.57,232,279,47,66
16,r_24_68_188,r_108_6_237,r_74_138_104,r_108_6_237,0.99,1,238,237,66
29,r_28_29_245,seq42,r_37_131_55,r_37_131_55,0.8,95,150,55,66
49,r_124_115_209,seq40,seq59,r_124_115_209,0.94,0,209,209,66
7,r_136_87_128,r_128_45_199,r_129_48_66,r_136_87_128,0.98,0,128,128,66
18,r_119_117_239,r_142_66_97,r_14_32_117,r_142_66_97,0.74,142,239,97,66
44,r_100_134_141,r_12_130_261,seq55,r_100_134_141,0.99,0,141,141,66
17,r_121_78_47,r_106_71_277,r_90_114_176,r_90_114_176,0.96,101,277,176,66
35,r_16_3_79,seq9,seq10,r_16_3_79,1.0,1,80,79,66
12,r_18_143_198,seq10,seq35,r_18_143_198,0.25,0,198,198,66
93,seq97,seq72,r_87_25_152,r_87_25_152,1.0,22,174,152,67
30,r_41_143_146,seq96,r_21_113_123,r_41_143_146,1.0,0,146,146,67
44,r_135_47_176,r_21_113_123,seq84,r_135_47_176,1.0,0,176,176,67
14,r_50_29_114,r_79_34_264,seq51,r_50_29_114,0.98,5,119,114,67
53,seq5,r_126_118_83,r_15_107_19,r_126_118_83,1.0,0,83,83,67
43,r_61_68_227,r_31_129_212,seq88,r_61_68_227,0.92,1,228,227,67
6,r_21_113_123,r_135_47_176,r_41_143_146,r_135_47_176,0.95,0,176,176,67
37,r_23_30_94,r_61_68_227,seq137,r_23_30_94,1.0,0,94,94,67
3,r_13_108_37,r_94_73_162,r_121_119_273,r_13_108_37,0.7,244,281,37,67
19,r_78_77_68,r_130_49_223,r_14_74_235,r_14_74_235,0.99,1,236,235,67
86,seq84,r_93_52_282,r_70_101_20,r_70_101_20,1.0,262,282,20,67
21,r_69_104_274,seq54,r_145_110_275,r_69_104_274,0.48,0,274,274,67
39,r_31_129_212,r_61_68_227,r_109_81_229,r_61_68_227,1.0,1,228,227,67
5,r_76_58_188,seq92,seq6,r_76_58_188,0.99,0,188,188,67
46,r_149_65_243,r_32_12_284,seq42,r_149_65_243,0.63,2,245,243,67
42,r_70_101_20,seq106,seq84,r_70_101_20,1.0,-1,19,20,67
45,r_93_52_282,seq84,r_76_58_188,r_76_58_188,0.64,94,282,188,67
19,r_78_77_68,r_64_3_111,r_130_49_223,r_78_77_68,0.7,0,68,68,67
27,r_112_123_277,r_35_39_195,r_125_18_99,r_35_39_195,0.92,82,277,195,67
31,r_128_102_214,r_14_74_235,seq20,r_14_74_235,0.85,-21,214,235,67
41,r_116_91_199,r_109_81_229,r_4_127_9,r_4_127_9,0.8,191,200,9,67
10,r_8_2_289,seq66,r_4_127_9,r_4_127_9,0.86,280,289,9,67
34,r_130_49_223,r_78_77_68,r_147_144_136,r_147_144_136,0.47,87,223,136,67
4,r_35_39_195,r_86_133_2,r_112_123_277,r_35_39_195,0.99,0,195,195,67
11,r_87_25_152,r_135_47_176,seq97,r_87_25_152,0.99,-1,151,152,67
3,r_13_108_37,r_147_144_136,r_94_73_162,r_13_108_37,1.0,-1,36,37,67
15,r_16_138_122,seq54,r_63_26_213,r_16_138_122,1.0,0,122,122,67
48,r_67_71_170,seq7,r_147_144_136,r_67_71_170,0.62,32,202,170,67
4,r_35_39_195,r_112_123_277,r_83_140_26,r_112_123_277,1.0,-3,274,277,67
2,r_147_144_136,seq27,r_86_133_2,r_147_144_136,0.57,7,143,136,67
0,r_4_127_9,r_79_34_264,r_116_91_199,r_79_34_264,0.99,-48,216,264,67
27,r_112_123_277,r_9_37_283,r_35_39_195,r_35_39_195,0.94,1,196,195,67
24,r_44_136_87,r_41_143_146,r_130_49_223,r_41_143_146,0.63,-126,20,146,67
25,r_125_18_99,seq0,seq96,r_125_18_99,1.0,0,99,99,67
34,r_130_49_223,seq5,r_50_29_114,r_130_49_223,0.46,-180,43,223,67
33,r_121_119_273,seq28,r_13_108_37,r_13_108_37,0.78,236,273,37,67
65,seq27,r_79_34_264,r_64_3_111,r_64_3_111,1.0,6,117,111,67
20,r_94_73_162,r_13_108_37,seq99,r_13_108_37,0.67,132,169,37,67
20,r_94_73_162,r_149_65_243,r_13_108_37,r_13_108_37,1.0,1,38,37,67
77,seq54,r_16_138_122,seq53,r_16_138_122,1.0,-7,115,122,67
34,r_130_49_223,r_50_29_114,r_78_77_68,r_130_49_223,0.98,-159,64,223,67
32,r_15_107_19,r_50_29_114,seq5,r_50_29_114,0.99,-70,44,114,67
49,r_103_38_21,r_76_58_188,seq99,r_76_58_188,0.74,-165,23,188,67
81,seq60,r_8_2_289,r_11_1_100,r_11_1_100,0.63,13,113,100,67
17,r_114_111_217,seq17,seq75,r_114_111_217,0.77,0,217,217,67
94,seq99,r_32_12_284,r_94_73_162,r_32_12_284,0.34,0,284,284,67
22,r_64_3_111,r_78_77_68,r_69_104_274,r_78_77_68,1.0,0,68,68,67
28,r_62_142_129,r_145_110_275,r_15_107_19,r_62_142_129,1.0,0,129,129,67
44,r_135_47_176,r_87_25_152,r_21_113_123,r_87_25_152,0.73,-42,110,152,67
23,r_126_118_83,seq5,seq46,r_126_118_83,1.0,0,83,83,67
16,r_80_89_51,r_41_143_146,r_109_81_229,r_80_89_51,0.54,1,52,51,67
35,r_14_74_235,r_8_2_289,r_78_77_68,r_14_74_235,0.93,3,238,235,67
12,r_148_19_263,seq75,r_4_127_9,r_4_127_9,0.82,255,264,9,67
2,r_147_144_136,r_13_108_37,seq27,r_13_108_37,1.0,-1,36,37,67
22,r_64_3_111,r_69_104_274,seq27,r_64_3_111,1.0,0,111,111,67
84,seq75,r_148_19_263,seq132,r_148_19_263,0.98,1,264,263,67
51,seq1,r_3_100_165,r_8_115_241,r_3_100_165,0.8,1,166,165,68
9,r_64_90_29,r_69_120_111,seq83,r_69_120_111,1.0,0,111,111,68
8,r_60_104_259,r_75_78_2,seq106,r_60_104_259,0.55,0,259,259,68
53,seq6,r_66_7_145,r_9_108_288,r_66_7_145,0.77,1,146,145,68
43,r_22_84_73,seq96,r_127_77_271,r_22_84_73,1.0,1,74,73,68
54,seq145,r_119_136_216,seq93,r_119_136_216,0.75,-17,199,216,68
55,seq10,seq110,r_4_98_25,r_4_98_25,1.0,41,66,25,68
86,seq83,r_86_92_256,r_64_90_29,r_64_90_29,0.95,227,256,29,68
16,r_66_7_145,seq6,r_49_11_40,r_49_11_40,0.96,106,146,40,68
39,r_86_92_256,seq83,r_53_12_220,r_86_92_256,0.65,0,256,256,68
1,r_149_74_56,r_112_45_212,r_119_136_216,r_112_45_212,0.47,2,214,212,68
46,r_36_89_135,r_8_115_241,r_18_14_98,r_36_89_135,0.88,1,136,135,68
69,seq128,r_8_115_241,r_81_76_150,r_81_76_150,0.61,74,224,150,68
42,r_133_121_148,r_69_120_111,r_64_90_29,r_64_90_29,0.66,29,58,29,68
27,r_49_11_40,r_99_55_142,r_66_7_145,r_49_11_40,0.76,104,144,40,68
95,seq106,r_142_37_247,seq0,r_142_37_247,1.0,0,247,247,68
45,r_29_5_170,r_48_63_18,r_18_14_98,r_29_5_170,0.57,-90,80,170,68
18,r_42_39_174,r_109_107_118,r_124_116_24,r_42_39_174,1.0,2,176,174,68
31,r_44_79_254,seq0,r_102_135_49,r_44_79_254,0.64,1,255,254,68
24,r_18_14_98,r_119_136_216,r_36_89_135,r_18_14_98,0.83,39,137,98,68
41,r_35_131_265,seq103,r_9_108_288,r_9_108_288,0.51,-23,265,288,68
25,r_88_72_17,r_50_125_262,seq51,r_88_72_17,0.59,0,17,17,68
27,r_49_11_40,seq97,r_99_55_142,r_49_11_40,1.0,3,43,40,68
3,r_40_62_160,r_142_37_247,seq96,r_40_62_160,0.99,0,160,160,68
11,r_82_111_34,r_20_25_248,seq59,r_82_111_34,1.0,0,34,34,68
10,r_137_15_128,r_142_37_247,r_4_98_25,r_137_15_128,0.82,0,128,128,68
26,r_112_45_212,r_109_107_118,seq147,r_109_107_118,1.0,0,118,118,68
5,r_48_63_18,r_19_16_60,seq122,r_48_63_18,1.0,-1,17,18,68
0,r_8_115_241,seq128,r_75_78_2,r_8_115_241,0.79,0,241,241,68
96,seq110,r_50_125_262,r_4_98_25,r_4_98_25,1.0,19,44,25,68
28,r_124_116_24,seq85,seq80,r_124_116_24,0.99,1,25,24,68
13,r_75_78_2,r_60_104_259,r_8_115_241,r_8_115_241,0.59,18,259,241,68
48,r_81_76_150,seq70,seq128,r_81_76_150,0.98,4,154,150,68
49,r_127_77_271,r_22_84_73,r_42_39_174,r_42_39_174,0.82,100,274,174,68
4,r_69_120_111,r_64_90_29,r_102_135_49,r_69_120_111,0.87,0,111,111,68
57,seq140,r_50_125_262,r_4_98_25,r_4_98_25,0.95,238,263,25,68
6,r_19_16_60,seq57,r_71_26_21,r_19_16_60,0.98,2,62,60,68
10,r_137_15_128,r_149_74_56,r_81_76_150,r_149_74_56,0.52,222,278,56,68
37,r_99_55_142,r_52_117_133,r_49_11_40,r_49_11_40,1.0,9,49,40,68
2,r_142_37_247,seq106,r_48_63_18,r_142_37_247,0.75,0,247,247,68
47,r_52_117_133,r_99_55_142,seq56,r_52_117_133,0.9,3,136,133,68
93,seq97,r_18_14_98,r_95_113_105,r_95_113_105,0.93,2,107,105,68
36,r_71_26_21,seq24,r_19_16_60,r_71_26_21,0.52,35,56,21,68
18,r_42_39_174,r_53_12_220,r_109_107_118,r_109_107_118,1.0,3,121,118,68
24,r_18_14_98,r_81_76_150,r_119_136_216,r_18_14_98,0.55,16,114,98,68
45,r_29_5_170,r_18_14_98,seq54,r_29_5_170,0.95,0,170,170,68
43,r_22_84_73,r_127_77_271,r_60_104_259,r_22_84_73,0.56,189,262,73,68
33,r_109_107_118,r_112_45_212,r_114_146_37,r_112_45_212,0.66,-94,118,212,68
30,r_102_135_49,r_95_113_105,seq144,r_102_135_49,0.91,0,49,49,68
64,seq23,r_20_25_248,r_133_121_148,r_133_121_148,1.0,64,212,148,68
14,r_4_98_25,r_94_132_246,seq10,r_4_98_25,1.0,0,25,25,68
70,seq32,r_35_131_265,r_99_55_142,r_99_55_142,1.0,24,166,142,68
42,r_133_121_148,r_64_90_29,seq23,r_133_121_148,1.0,1,149,148,68
38,r_129_33_57,r_22_84_73,seq27,r_22_84_73,1.0,-13,60,73,68
22,r_114_146_37,seq21,r_34_105_86,r_34_105_86,1.0,7,93,86,68
36,r_71_26_21,r_8_115_241,seq24,r_71_26_21,0.87,0,21,21,68
34,r_101_38_210,seq130,seq24,r_101_38_210,0.5,3,213,210,68
45,r_29_5_170,r_43_46_43,r_48_63_18,r_29_5_170,0.85,-140,30,170,68
75,seq54,seq144,r_29_5_170,r_29_5_170,1.0,18,188,170,68
93,seq97,r_49_11_40,r_18_14_98,r_49_11_40,0.96,3,43,40,68
60,seq144,r_94_132_246,r_102_135_49,r_102_135_49,1.0,133,182,49,68
17,r_3_100_165,seq1,r_49_11_40,r_3_100_165,0.98,1,166,165,68
94,seq103,r_35_131_265,r_99_55_142,r_99_55_142,0.99,123,265,142,68
26,r_112_45_212,seq147,seq21,r_112_45_212,0.98,0,212,212,68
9,r_64_90_29,r_66_7_145,r_69_120_111,r_64_90_29,1.0,0,29,29,68
1,r_149_74_56,r_50_125_262,r_112_45_212,r_149_74_56,0.89,-15,41,56,68
37,r_99_55_142,r_49_11_40,seq32,r_99_55_142,0.97,2,144,142,68
91,seq130,r_101_38_210,seq138,r_101_38_210,0.93,3,213,210,68
22,r_114_146_37,seq87,seq21,r_114_146_37,1.0,0,37,37,68
49,r_127_77_271,seq23,r_22_84_73,r_22_84_73,1.0,3,76,73,68
4,r_69_120_111,r_133_121_148,r_64_90_29,r_64_90_29,1.0,16,45,29,68
44,r_53_12_220,seq21,seq1,r_53_12_220,0.95,3,223,220,68
21,r_43_46_43,r_29_5_170,seq13,r_43_46_43,1.0,-1,42,43,68
10,r_137_15_128,r_4_98_25,r_149_74_56,r_149_74_56,0.83,124,180,56,68
85,seq80,r_58_148_284,r_124_116_24,r_124_116_24,1.0,-3,21,24,68
35,r_94_132_246,seq144,r_19_16_60,r_94_132_246,0.58,2,248,246,68
78,seq59,seq96,r_82_111_34,r_82_111_34,1.0,4,38,34,68
12,r_95_113_105,seq57,seq97,r_95_113_105,1.0,0,105,105,68
30,r_56_51_93,seq79,seq106,r_56_51_93,0.94,1,94,93,69
36,r_30_128_141,seq92,seq52,r_30_128_141,1.0,2,143,141,69
28,r_5_116_15,r_124_122_65,r_138_7_201,r_5_116_15,0.78,0,15,15,69
43,r_85_74_170,r_15_35_117,r_84_132_114,r_84_132_114,0.62,4,118,114,69
83,seq79,r_28_146_197,r_75_34_66,r_75_34_66,0.85,1,67,66,69
37,r_140_110_92,r_22_77_233,r_13_91_263,r_140_110_92,1.0,-1,91,92,69
3,r_2_123_4,seq92,r_15_35_117,r_15_35_117,0.86,36,153,117,69
16,r_15_35_117,r_85_74_170,r_2_123_4,r_15_35_117,0.82,6,123,117,69
21,r_84_132_114,r_97_120_83,r_63_142_292,r_97_120_83,0.99,-14,69,83,69
39,r_113_3_179,seq48,seq71,r_113_3_179,0.54,19,198,179,69
1,r_131_43_283,r_117_111_97,r_119_1_223,r_131_43_283,0.44,0,283,283,69
97,seq121,seq94,r_98_46_191,r_98_46_191,0.99,23,214,191,69
5,r_136_109_262,r_59_80_298,r_97_120_83,r_97_120_83,0.89,180,263,83,69
46,r_16_93_238,seq79,r_140_110_92,r_140_110_92,0.99,147,239,92,69
38,r_44_141_39,r_98_46_191,seq130,r_44_141_39,1.0,0,39,39,69
45,r_67_23_126,seq139,r_86_10_14,r_67_23_126,0.96,2,128,126,69
19,r_96_21_189,r_13_91_263,r_30_128_141,r_13_91_263,0.73,-74,189,263,69
27,r_61_20_243,r_97_120_83,r_138_7_201,r_97_120_83,0.56,162,245,83,69
95,seq107,r_60_49_276,r_36_17_101,r_36_17_101,1.0,144,245,101,69
10,r_97_120_83,seq92,r_136_109_262,r_97_120_83,0.81,180,263,83,69
76,seq55,r_103_8_199,seq31,r_103_8_199,0.95,0,199,199,69
18,r_115_137_12,r_6_83_127,seq88,r_115_137_12,0.87,0,12,12,69
31,r_129_125_219,seq19,r_59_80_298,r_129_125_219,0.58,0,219,219,69
41,r_114_24_237,r_22_77_233,seq139,r_114_24_237,0.62,0,237,237,69
8,r_36_17_101,r_131_43_283,seq0,r_36_17_101,0.78,-13,88,101,69
10,r_97_120_83,r_84_132_114,r_61_20_243,r_61_20_243,0.77,-160,83,243,69
26,r_134_9_142,r_96_21_189,seq27,r_134_9_142,0.82,4,146,142,69
94,seq106,r_113_3_179,r_124_122_65,r_113_3_179,0.5,-126,53,179,69
0,r_98_46_191,seq127,r_86_10_14,r_98_46_191,0.99,1,192,191,69
11,r_39_105_149,r_101_133_271,seq19,r_39_105_149,1.0,0,149,149,69
20,r_124_122_65,r_119_1_223,seq106,r_119_1_223,1.0,-146,77,223,69
13,r_75_34_66,seq62,seq79,r_75_34_66,0.99,1,67,66,69
15,r_119_1_223,seq73,seq89,r_119_1_223,0.81,0,223,223,69
48,r_32_65_81,r_96_21_189,seq42,r_32_65_81,0.73,-2,79,81,69
4,r_138_7_201,r_5_116_15,seq31,r_138_7_201,0.82,0,201,201,69
12,r_13_91_263,r_140_110_92,r_81_70_193,r_13_91_263,0.43,2,265,263,69
6,r_100_118_175,r_129_125_219,seq37,r_100_118_175,0.97,0,175,175,69
10,r_97_120_83,r_61_20_243,seq92,r_61_20_243,0.43,-2,241,243,69
27,r_61_20_243,r_144_18_139,r_97_120_83,r_61_20_243,1.0,-103,140,243,69
2,r_147_102_67,r_13_91_263,seq33,r_147_102_67,1.0,0,67,67,69
47,r_78_64_177,r_129_125_219,r_15_35_117,r_78_64_177,0.69,0,177,177,69
40,r_117_111_97,r_131_43_283,r_13_91_263,r_13_91_263,0.75,20,283,263,69
43,r_85_74_170,r_84_132_114,r_5_116_15,r_85_74_170,0.68,5,175,170,69
25,r_81_70_193,seq88,r_117_111_97,r_81_70_193,0.57,3,196,193,69
90,seq94,seq121,r_86_10_14,r_86_10_14,0.8,3,17,14,69
33,r_144_18_139,r_61_20_243,seq89,r_144_18_139,1.0,1,140,139,69
42,r_86_10_14,r_147_102_67,seq94,r_86_10_14,0.67,0,14,14,69
70,seq42,r_112_54_278,r_32_65_81,r_32_65_81,1.0,5,86,81,69
42,r_86_10_14,seq94,r_67_23_126,r_67_23_126,1.0,8,134,126,69
44,r_68_72_37,r_112_54_278,seq71,r_68_72_37,0.99,0,37,37,69
34,r_22_77_233,r_114_24_237,r_138_7_201,r_22_77_233,0.7,0,233,233,69
24,r_53_25_26,r_144_18_139,seq106,r_53_25_26,0.69,-3,23,26,69
8,r_36_17_101,r_28_146_197,r_131_43_283,r_36_17_101,0.46,-43,58,101,69
17,r_59_80_298,r_136_109_262,r_129_125_219,r_59_80_298,0.55,-52,246,298,69
4,r_138_7_201,r_147_102_67,r_5_116_15,r_138_7_201,0.67,-184,17,201,69
37,r_140_110_92,r_13_91_263,r_16_93_238,r_16_93_238,0.83,27,265,238,69
28,r_5_116_15,r_138_7_201,r_103_8_199,r_5_116_15,0.78,186,201,15,69
80,seq71,r_15_35_117,r_68_72_37,r_68_72_37,0.77,8,45,37,69
49,r_60_49_276,seq107,r_147_102_67,r_147_102_67,0.87,216,283,67,69
7,r_103_8_199,seq55,r_5_116_15,r_103_8_199,0.82,0,199,199,69
21,r_84_132_114,r_63_142_292,seq71,r_84_132_114,1.0,0,114,114,69
79,seq139,r_67_23_126,r_101_133_271,r_67_23_126,1.0,3,129,126,69
35,r_112_54_278,r_63_142_292,r_147_102_67,r_112_54_278,0.31,0,278,278,69
12,r_13_91_263,r_134_9_142,r_140_110_92,r_140_110_92,1.0,54,146,92,69
30,r_136_127_252,seq31,r_135_19_1,r_136_127_252,0.78,0,252,252,70
36,r_99_37_241,seq74,seq12,r_99_37_241,0.83,0,241,241,70
14,r_123_96_267,r_58_64_226,r_50_92_182,r_50_92_182,0.68,44,226,182,70
8,r_30_78_149,r_41_1_123,r_73_20_4,r_30_78_149,0.5,-50,99,149,70
53,seq132,r_40_82_212,r_146_4_134,r_146_4_134,0.99,80,214,134,70
43,r_128_144_89,r_11_85_288,seq46,r_128_144_89,1.0,1,90,89,70
83,seq74,r_99_37_241,r_129_65_54,r_129_65_54,0.87,187,241,54,70
37,r_55_101_243,seq23,r_128_144_89,r_55_101_243,0.69,0,243,243,70
59,seq12,seq102,r_99_37_241,r_99_37_241,0.84,12,253,241,70
16,r_143_67_280,r_11_85_288,seq149,r_11_85_288,0.36,-7,281,288,70
21,r_97_139_146,r_99_37_241,r_22_81_129,r_99_37_241,0.94,-95,146,241,70
39,r_116_126_90,seq21,seq17,r_116_126_90,1.0,0,90,90,70
97,seq120,r_18_8_224,r_135_19_1,r_18_8_224,1.0,-37,187,224,70
5,r_93_110_244,r_83_43_282,r_11_85_288,r_93_110_244,0.8,0,244,244,70
46,r_71_5_255,seq29,seq31,r_71_5_255,0.39,0,255,255,70
42,r_61_94_206,seq15,seq115,r_61_94_206,0.56,9,215,206,70
69,seq29,r_32_119_201,seq87,r_32_119_201,0.75,2,203,201,70
45,r_77_70_159,seq130,r_133_137_15,r_77_70_159,0.59,-8,151,159,70
20,r_107_91_53,r_54_86_161,seq29,r_107_91_53,1.0,0,53,53,70
19,r_51_148_209,r_83_43_282,r_69_42_169,r_51_148_209,0.62,1,210,209,70
76,seq46,r_47_66_99,r_14_60_24,r_14_60_24,1.0,186,210,24,70
38,r_147_57_221,r_11_85_288,r_69_42_169,r_69_42_169,0.92,1,170,169,70
31,r_68_100_274,seq52,r_50_92_182,r_50_92_182,0.91,94,276,182,70
41,r_41_1_123,r_30_78_149,seq142,r_41_1_123,0.98,0,123,123,70
10,r_24_80_98,r_18_8_224,seq130,r_24_80_98,0.43,0,98,98,70
38,r_147_57_221,r_69_42_169,r_14_60_24,r_147_57_221,1.0,0,221,221,70
26,r_135_19_1,seq10,r_136_127_252,r_136_127_252,0.83,-1,251,252,70
78,seq52,r_68_100_274,r_117_63_45,r_117_63_45,1.0,231,276,45,70
0,r_11_85_288,r_143_67_280,r_54_86_161,r_54_86_161,1.0,8,169,161,70
15,r_47_66_99,seq46,r_32_119_201,r_32_119_201,0.94,9,210,201,70
48,r_32_119_201,seq29,r_47_66_99,r_32_119_201,0.75,0,201,201,70
62,seq15,r_61_94_206,seq28,r_61_94_206,0.76,6,212,206,70
85,seq76,r_113_118_279,r_97_139_146,r_97_139_146,0.98,133,279,146,70
96,seq115,r_88_121_74,r_33_111_18,r_88_121_74,0.81,-24,50,74,70
10,r_24_80_98,seq130,r_14_60_24,r_14_60_24,0.45,173,197,24,70
27,r_146_4_134,r_54_86_161,r_116_126_90,r_146_4_134,0.92,0,134,134,70
9,r_69_42_169,r_147_57_221,r_40_82_212,r_147_57_221,0.58,-8,213,221,70
47,r_54_86_161,seq75,r_11_85_288,r_54_86_161,0.99,0,161,161,70
4,r_33_111_18,r_129_65_54,seq115,r_33_111_18,1.0,0,18,18,70
29,r_18_8_224,seq10,r_69_42_169,r_18_8_224,0.94,0,224,224,70
24,r_112_6_153,seq36,seq21,r_112_6_153,0.98,0,153,153,70
43,r_128_144_89,seq46,r_55_101_243,r_55_101_243,1.0,28,271,243,70
33,r_40_82_212,seq132,r_69_42_169,r_69_42_169,0.6,45,214,169,70
58,seq10,r_18_8_224,seq149,r_18_8_224,1.0,0,224,224,70
65,seq23,r_55_101_243,r_131_34_46,r_131_34_46,0.97,53,99,46,70
98,seq125,r_55_101_243,r_98_124_43,r_98_124_43,0.99,11,54,43,70
32,r_58_64_226,r_123_96_267,seq59,r_58_64_226,0.75,0,226,226,70
38,r_147_57_221,r_129_65_54,r_11_85_288,r_129_65_54,0.86,10,64,54,70
2,r_129_65_54,r_147_57_221,seq74,r_129_65_54,1.0,0,54,54,70
1,r_98_124_43,r_40_82_212,seq125,r_98_124_43,1.0,0,43,43,70
14,r_123_96_267,r_50_92_182,seq138,r_123_96_267,1.0,3,270,267,70
23,r_14_60_24,r_131_34_46,seq46,r_14_60_24,1.0,1,25,24,70
34,r_140_106_67,r_16_2_107,seq3,r_16_2_107,1.0,-37,70,107,70
44,r_25_95_52,seq10,r_83_43_282,r_25_95_52,1.0,0,52,52,70
6,r_133_137_15,r_147_57_221,seq79,r_133_137_15,0.93,0,15,15,70
75,seq44,seq105,r_30_78_149,r_30_78_149,0.92,2,151,149,70
9,r_69_42_169,seq125,r_147_57_221,r_147_57_221,0.91,-52,169,221,70
3,r_131_34_46,seq141,seq23,r_131_34_46,1.0,0,46,46,70
35,r_22_81_129,seq145,r_97_139_146,r_97_139_146,0.81,-1,145,146,70
22,r_62_13_225,r_58_64_226,r_47_66_99,r_62_13_225,0.87,0,225,225,70
28,r_16_2_107,r_40_82_212,seq75,r_16_2_107,1.0,0,107,107,70
11,r_117_63_45,r_25_95_52,seq52,r_117_63_45,1.0,0,45,45,70
8,r_30_78_149,r_73_20_4,seq44,r_30_78_149,0.54,-5,144,149,70
17,r_50_92_182,r_123_96_267,r_68_100_274,r_50_92_182,0.89,91,273,182,70
35,r_22_81_129,r_40_82_212,seq145,r_22_81_129,0.57,0,129,129,70
12,r_122_48_266,seq39,r_16_2_107,r_122_48_266,0.57,0,266,266,70
93,seq100,r_117_145_168,seq94,r_117_145_168,1.0,0,168,168,71
9,r_92_112_219,seq35,seq42,r_92_112_219,1.0,0,219,219,71
8,r_21_109_147,seq149,seq69,r_21_109_147,0.83,0,147,147,71
43,r_120_50_140,r_61_136_220,seq68,r_120_50_140,0.99,0,140,140,71
33,r_144_41_54,seq65,r_117_145_168,r_144_41_54,0.97,2,56,54,71
86,seq82,r_77_6_258,r_39_28_111,r_77_6_258,0.98,-116,142,258,71
16,r_7_126_241,r_148_10_286,r_130_59_64,r_7_126_241,0.88,0,241,241,71
39,r_60_139_274,r_32_125_285,r_87_83_239,r_60_139_274,0.48,2,276,274,71
1,r_130_59_64,r_132_104_281,r_1_67_30,r_130_59_64,1.0,1,65,64,71
97,seq115,r_117_145_168,seq94,r_117_145_168,1.0,1,169,168,71
46,r_15_95_284,seq94,seq42,r_15_95_284,0.35,2,286,284,71
42,r_52_17_251,seq13,r_79_129_169,r_79_129_169,0.79,7,176,169,71
69,seq47,r_97_14_244,seq115,r_97_14_244,0.59,3,247,244,71
3,r_66_128_15,r_87_83_239,seq65,r_66_128_15,1.0,-1,14,15,71
33,r_144_41_54,r_117_145_168,seq94,r_117_145_168,0.96,0,168,168,71
66,seq35,seq20,r_87_83_239,r_87_83_239,0.82,-3,236,239,71
76,seq65,r_64_46_294,r_26_38_186,r_26_38_186,1.0,14,200,186,71
31,r_73_108_98,seq49,seq81,r_73_108_98,1.0,-2,96,98,71
41,r_55_44_92,seq2,r_102_24_48,r_55_44_92,1.0,3,95,92,71
67,seq40,r_98_19_215,r_63_122_42,r_63_122_42,1.0,176,218,42,71
90,seq93,seq20,r_45_89_171,r_45_89_171,0.99,1,172,171,71
4,r_30_3_108,seq53,r_12_72_7,r_30_3_108,0.97,0,108,108,71
78,seq69,seq65,r_21_109_147,r_21_109_147,1.0,6,153,147,71
0,r_79_129_169,seq134,r_52_17_251,r_79_129_169,0.9,1,170,169,71
20,r_111_9_228,seq142,seq20,r_111_9_228,0.82,2,230,228,71
13,r_98_19_215,seq40,r_54_133_58,r_98_19_215,0.35,3,218,215,71
14,r_48_146_18,r_92_112_219,seq29,r_48_146_18,1.0,0,18,18,71
15,r_26_38_186,seq27,seq65,r_26_38_186,0.98,0,186,186,71
49,r_132_104_281,seq47,r_113_11_128,r_113_11_128,0.58,155,283,128,71
57,seq143,r_22_34_145,seq20,r_22_34_145,0.99,0,145,145,71
45,r_141_8_56,r_85_119_295,seq75,r_141_8_56,1.0,0,56,56,71
12,r_61_136_220,seq13,r_30_3_108,r_61_136_220,0.95,4,224,220,71
6,r_87_83_239,r_148_10_286,seq35,r_87_83_239,0.52,1,240,239,71
0,r_79_129_169,r_52_17_251,r_97_14_244,r_79_129_169,0.94,82,251,169,71
2,r_124_107_17,r_30_3_108,seq27,r_124_107_17,0.99,0,17,17,71
40,r_77_6_258,seq82,r_66_128_15,r_77_6_258,0.76,-5,253,258,71
18,r_23_88_134,r_92_112_219,r_124_107_17,r_23_88_134,0.82,2,136,134,71
29,r_113_11_128,seq142,seq70,r_113_11_128,0.99,0,128,128,71
24,r_131_43_148,seq138,seq20,r_131_43_148,0.85,0,148,148,71
34,r_32_125_285,r_85_119_295,seq138,r_85_119_295,0.82,-9,286,295,71
27,r_102_24_48,r_45_89_171,seq56,r_102_24_48,1.0,2,50,48,71
35,r_148_10_286,r_96_36_53,r_66_128_15,r_148_10_286,0.39,0,286,286,71
25,r_45_89_171,seq13,r_118_140_160,r_45_89_171,0.69,0,171,171,71
58,seq16,r_118_140_160,seq42,r_118_140_160,1.0,0,160,160,71
37,r_96_36_53,r_39_28_111,seq101,r_96_36_53,1.0,1,54,53,71
10,r_37_106_34,seq71,seq142,r_37_106_34,0.57,10,44,34,71
68,seq42,seq16,r_92_112_219,r_92_112_219,0.93,0,219,219,71
11,r_1_67_30,seq110,seq91,r_1_67_30,0.96,-2,28,30,71
42,r_52_17_251,r_79_129_169,seq100,r_52_17_251,0.99,1,252,251,71
32,r_22_34_145,seq143,seq138,r_22_34_145,0.53,2,147,145,71
77,seq68,seq53,r_120_50_140,r_120_50_140,1.0,38,178,140,71
34,r_32_125_285,r_60_139_274,r_85_119_295,r_60_139_274,0.23,2,276,274,71
63,seq27,r_26_38_186,r_124_107_17,r_124_107_17,0.82,0,17,17,71
94,seq101,r_87_83_239,r_96_36_53,r_96_36_53,1.0,106,159,53,71
9,r_92_112_219,r_23_88_134,seq35,r_23_88_134,0.98,2,136,134,71
11,r_1_67_30,seq91,r_130_59_64,r_130_59_64,1.0,5,69,64,71
22,r_84_116_161,r_117_145_168,r_21_109_147,r_117_145_168,0.84,-7,161,168,71
23,r_118_140_160,seq35,r_117_145_168,r_117_145_168,0.7,23,191,168,71
28,r_105_33_206,seq70,r_30_3_108,r_105_33_206,0.57,1,207,206,71
44,r_63_122_42,seq16,seq40,r_63_122_42,0.99,2,44,42,71
49,r_132_104_281,r_130_59_64,seq47,r_130_59_64,1.0,2,66,64,71
23,r_118_140_160,seq16,seq35,r_118_140_160,0.6,0,160,160,71
19,r_137_123_57,seq62,r_37_106_34,r_137_123_57,1.0,1,58,57,71
35,r_148_10_286,r_87_83_239,r_96_36_53,r_96_36_53,1.0,63,116,53,71
12,r_61_136_220,r_120_50_140,seq13,r_120_50_140,1.0,0,140,140,71
89,seq91,seq138,r_1_67_30,r_1_67_30,1.0,0,30,30,71
30,r_33_95_134,seq45,seq83,r_33_95_134,0.99,0,134,134,72
36,r_125_74_124,r_123_71_5,r_93_87_279,r_125_74_124,0.97,0,124,124,72
92,seq104,seq64,r_84_100_107,r_84_100_107,1.0,2,109,107,72
53,seq5,r_99_68_244,seq43,r_99_68_244,1.0,-40,204,244,72
43,r_108_147_208,r_17_117_293,seq145,r_108_147_208,0.87,0,208,208,72
54,seq134,r_112_121_116,seq21,r_112_121_116,1.0,0,116,116,72
37,r_93_87_279,r_13_149_199,r_125_74_124,r_93_87_279,0.61,-84,195,279,72
3,r_76_31_178,r_35_98_24,seq69,r_76_31_178,0.78,2,180,178,72
86,seq77,seq81,r_13_149_199,r_13_149_199,1.0,0,199,199,72
39,r_73_85_280,r_128_7_174,r_19_103_111,r_73_85_280,0.8,-105,175,280,72
1,r_60_116_236,r_14_78_297,seq122,r_60_116_236,0.7,0,236,236,72
22,r_82_142_12,r_60_116_236,r_35_98_24,r_82_142_12,0.73,23,35,12,72
32,r_148_127_184,seq9,r_126_23_53,r_148_127_184,0.99,0,184,184,72
45,r_1_65_151,seq0,seq134,r_1_65_151,0.98,0,151,151,72
24,r_55_29_177,r_38_138_129,seq11,r_55_29_177,0.58,-159,18,177,72
24,r_55_29_177,seq11,seq50,r_55_29_177,0.98,-1,176,177,72
15,r_18_70_192,r_19_103_111,seq141,r_18_70_192,1.0,1,193,192,72
95,seq109,r_76_31_178,r_82_142_12,r_76_31_178,0.86,-42,136,178,72
39,r_73_85_280,r_19_103_111,r_55_29_177,r_73_85_280,0.63,1,281,280,72
31,r_128_7_174,r_73_85_280,seq2,r_128_7_174,0.98,1,175,174,72
41,r_99_68_244,seq5,seq51,r_99_68_244,0.73,0,244,244,72
10,r_38_138_129,seq141,r_114_140_96,r_114_140_96,1.0,32,128,96,72
38,r_35_98_24,r_75_97_218,r_82_142_12,r_35_98_24,0.94,0,24,24,72
26,r_139_119_17,r_84_100_107,seq32,r_139_119_17,1.0,0,17,17,72
20,r_101_26_25,r_18_70_192,seq109,r_101_26_25,0.81,0,25,25,72
16,r_22_53_230,r_129_44_26,seq69,r_22_53_230,0.65,1,231,230,72
48,r_72_16_52,r_148_127_184,r_123_71_5,r_72_16_52,1.0,0,52,52,72
4,r_8_28_240,seq24,r_128_7_174,r_8_28_240,0.85,1,241,240,72
46,r_129_44_26,seq64,r_22_53_230,r_129_44_26,1.0,0,26,26,72
0,r_84_100_107,seq83,seq104,r_84_100_107,1.0,1,108,107,72
46,r_129_44_26,r_22_53_230,r_3_118_28,r_22_53_230,0.9,1,231,230,72
15,r_18_70_192,r_6_48_160,r_19_103_111,r_19_103_111,0.99,3,114,111,72
57,seq11,r_4_86_292,r_33_95_134,r_33_95_134,1.0,127,261,134,72
6,r_67_144_141,seq34,r_139_119_17,r_67_144_141,1.0,0,141,141,72
62,seq24,r_8_28_240,seq111,r_8_28_240,0.88,1,241,240,72
36,r_125_74_124,r_93_87_279,r_1_65_151,r_1_65_151,0.58,129,280,151,72
27,r_88_25_271,seq51,r_8_28_240,r_88_25_271,0.19,0,271,271,72
8,r_3_118_28,r_143_66_165,seq81,r_3_118_28,0.99,0,28,28,72
47,r_19_103_111,seq107,r_18_70_192,r_19_103_111,0.96,-1,110,111,72
40,r_90_56_123,r_120_79_235,seq43,r_90_56_123,1.0,0,123,123,72
74,seq50,seq10,r_55_29_177,r_55_29_177,0.99,14,191,177,72
29,r_143_66_165,seq124,seq37,r_143_66_165,0.95,0,165,165,72
47,r_19_103_111,r_73_85_280,r_84_100_107,r_73_85_280,0.79,0,280,280,72
25,r_115_94_169,r_40_136_150,r_15_20_135,r_115_94_169,1.0,0,169,169,72
33,r_6_48_160,r_18_70_192,seq107,r_6_48_160,0.89,0,160,160,72
64,seq133,seq83,r_114_140_96,r_114_140_96,1.0,40,136,96,72
47,r_19_103_111,r_18_70_192,r_73_85_280,r_18_70_192,1.0,2,194,192,72
50,seq0,r_1_65_151,seq43,r_1_65_151,1.0,0,151,151,72
42,r_123_71_5,r_125_74_124,r_72_16_52,r_123_71_5,1.0,119,124,5,72
34,r_114_140_96,r_18_70_192,seq133,r_114_140_96,0.62,0,96,96,72
3,r_76_31_178,seq109,r_35_98_24,r_35_98_24,1.0,8,32,24,72
75,seq51,r_88_25_271,r_99_68_244,r_99_68_244,0.87,27,271,244,72
60,seq146,seq107,r_131_27_206,r_131_27_206,0.82,4,210,206,72
2,r_126_23_53,seq57,seq34,r_126_23_53,1.0,0,53,53,72
17,r_13_149_199,r_93_87_279,seq77,r_13_149_199,0.78,0,199,199,72
94,seq107,seq146,r_6_48_160,r_6_48_160,1.0,1,161,160,72
9,r_47_58_132,r_18_70_192,seq61,r_47_58_132,1.0,0,132,132,72
96,seq111,r_15_20_135,seq24,r_15_20_135,1.0,-19,116,135,72
35,r_15_20_135,seq46,r_115_94_169,r_115_94_169,0.98,24,193,169,72
37,r_93_87_279,r_125_74_124,seq137,r_93_87_279,0.83,1,280,279,72
16,r_22_53_230,seq77,r_129_44_26,r_129_44_26,1.0,27,53,26,72
7,r_75_97_218,seq57,r_106_36_13,r_75_97_218,0.93,1,219,218,72
32,r_148_127_184,r_72_16_52,seq9,r_72_16_52,1.0,0,52,52,72
44,r_135_96_120,seq62,seq122,r_135_96_120,0.88,-1,119,120,72
23,r_40_136_150,r_115_94_169,r_112_121_116,r_40_136_150,0.99,10,160,150,72
35,r_15_20_135,seq111,seq46,r_15_20_135,0.61,0,135,135,72
12,r_112_121_116,seq134,r_40_136_150,r_112_121_116,0.99,0,116,116,72
40,r_111_86_145,r_149_53_266,r_36_22_239,r_111_86_145,0.78,121,266,145,73
51,seq3,r_138_135_179,r_18_40_127,r_138_135_179,1.0,2,181,179,73
36,r_112_15_242,r_36_22_239,seq51,r_112_15_242,0.6,-2,240,242,73
39,r_23_8_123,r_107_147_60,r_140_47_135,r_23_8_123,0.77,31,154,123,73
14,r_140_47_135,r_81_42_282,r_23_8_123,r_81_42_282,0.75,-148,134,282,73
29,r_84_97_44,r_64_89_195,seq49,r_84_97_44,0.78,2,46,44,73
8,r_149_53_266,r_95_6_185,r_111_86_145,r_149_53_266,0.77,-81,185,266,73
54,seq11,r_130_122_260,r_77_21_84,r_77_21_84,0.93,9,93,84,73
37,r_57_32_202,r_66_34_269,r_41_93_25,r_57_32_202,0.75,2,204,202,73
59,seq20,r_137_139_226,r_138_135_179,r_137_139_226,0.42,4,230,226,73
71,seq51,seq44,r_112_15_242,r_112_15_242,0.46,2,244,242,73
16,r_131_143_111,seq120,seq37,r_131_143_111,0.78,20,131,111,73
21,r_99_124_101,seq37,r_87_50_37,r_99_124_101,0.98,-1,100,101,73
39,r_23_8_123,r_26_27_277,r_107_147_60,r_107_147_60,0.57,64,124,60,73
1,r_103_125_235,r_41_93_25,r_48_69_106,r_48_69_106,0.91,129,235,106,73
1,r_103_125_235,r_71_70_61,r_41_93_25,r_71_70_61,0.78,0,61,61,73
45,r_95_6_185,r_149_53_266,r_48_69_106,r_95_6_185,0.97,0,185,185,73
31,r_142_61_207,seq133,r_66_34_269,r_142_61_207,0.81,1,208,207,73
3,r_65_79_291,seq30,r_111_86_145,r_111_86_145,1.0,33,178,145,73
42,r_41_93_25,r_64_89_195,r_103_125_235,r_41_93_25,1.0,0,25,25,73
18,r_129_1_33,seq133,r_121_119_23,r_129_1_33,1.0,0,33,33,73
10,r_45_91_181,seq49,r_107_147_60,r_107_147_60,0.96,125,185,60,73
26,r_107_147_60,r_74_33_264,seq105,r_107_147_60,0.98,0,60,60,73
8,r_149_53_266,r_111_86_145,seq52,r_149_53_266,0.95,0,266,266,73
0,r_136_28_20,r_54_5_130,r_121_119_23,r_136_28_20,0.62,3,23,20,73
4,r_14_132_80,r_128_43_233,seq63,r_14_132_80,1.0,0,80,80,73
78,seq67,r_134_59_199,r_138_135_179,r_134_59_199,0.77,1,200,199,73
11,r_71_70_61,r_103_125_235,r_66_34_269,r_71_70_61,1.0,0,61,61,73
15,r_81_42_282,seq123,r_66_34_269,r_66_34_269,0.7,14,283,269,73
48,r_77_21_84,seq72,seq11,r_77_21_84,0.74,0,84,84,73
57,seq17,r_7_35_244,seq46,r_7_35_244,0.91,0,244,244,73
13,r_145_19_58,r_112_15_242,seq0,r_112_15_242,0.91,-85,157,242,73
6,r_9_83_177,seq30,r_36_22_239,r_9_83_177,0.96,2,179,177,73
10,r_45_91_181,r_107_147_60,r_74_33_264,r_74_33_264,0.99,1,265,264,73
27,r_134_59_199,seq67,r_9_83_177,r_134_59_199,0.69,1,200,199,73
41,r_121_119_23,seq20,r_136_28_20,r_121_119_23,1.0,0,23,23,73
87,seq98,r_64_89_195,r_84_97_44,r_84_97_44,0.79,155,199,44,73
2,r_64_89_195,seq98,seq63,r_64_89_195,0.81,4,199,195,73
47,r_100_82_253,r_26_27_277,r_9_83_177,r_9_83_177,1.0,77,254,177,73
40,r_111_86_145,seq58,r_149_53_266,r_111_86_145,1.0,0,145,145,73
24,r_48_69_106,seq29,seq58,r_48_69_106,0.99,0,106,106,73
25,r_26_27_277,seq31,r_140_47_135,r_140_47_135,0.94,143,278,135,73
64,seq31,r_26_27_277,r_141_104_280,r_26_27_277,0.25,3,280,277,73
50,seq0,seq75,r_137_139_226,r_137_139_226,0.75,28,254,226,73
6,r_9_83_177,r_36_22_239,r_134_59_199,r_36_22_239,1.0,1,240,239,73
65,seq37,r_99_124_101,r_131_143_111,r_99_124_101,1.0,-1,100,101,73
42,r_41_93_25,r_103_125_235,r_57_32_202,r_41_93_25,0.73,210,235,25,73
38,r_92_90_155,seq29,r_136_28_20,r_136_28_20,1.0,141,161,20,73
34,r_36_22_239,r_112_15_242,seq30,r_36_22_239,0.8,1,240,239,73
43,r_116_144_15,r_137_139_226,seq58,r_116_144_15,0.84,-2,13,15,73
17,r_66_34_269,r_57_32_202,r_71_70_61,r_66_34_269,0.56,-171,98,269,73
96,seq120,r_131_143_111,r_4_106_17,r_4_106_17,1.0,148,165,17,73
22,r_137_139_226,seq67,seq0,r_137_139_226,0.64,4,230,226,73
28,r_76_55_62,seq29,r_116_144_15,r_76_55_62,1.0,0,62,62,73
5,r_16_85_26,r_23_8_123,seq117,r_16_85_26,1.0,1,27,26,73
49,r_7_35_244,seq17,seq118,r_7_35_244,0.96,0,244,244,73
56,seq13,r_128_43_233,seq56,r_128_43_233,1.0,-26,207,233,73
44,r_115_2_96,r_57_32_202,r_77_21_84,r_115_2_96,0.98,1,97,96,73
23,r_54_5_130,r_140_47_135,r_16_85_26,r_54_5_130,0.93,1,131,130,73
32,r_4_106_17,r_48_69_106,seq120,r_4_106_17,1.0,0,17,17,73
19,r_87_50_37,r_145_19_58,seq101,r_87_50_37,1.0,0,37,37,73
13,r_145_19_58,r_140_47_135,r_112_15_242,r_145_19_58,0.98,1,59,58,73
93,seq112,r_135_73_232,r_76_124_108,r_76_124_108,1.0,9,117,108,74
30,r_78_106_170,r_20_71_221,r_38_148_285,r_20_71_221,0.62,-47,174,221,74
8,r_143_24_198,seq57,seq9,r_143_24_198,0.96,0,198,198,74
53,seq9,seq6,r_143_24_198,r_143_24_198,1.0,31,229,198,74
43,r_65_60_240,r_42_97_226,r_86_149_263,r_86_149_263,0.54,-88,175,263,74
83,seq89,r_58_61_203,seq57,r_58_61_203,0.67,1,204,203,74
3,r_105_16_112,seq110,r_51_0_204,r_51_0_204,1.0,26,230,204,74
59,seq29,r_86_149_263,r_82_43_115,r_82_43_115,1.0,151,266,115,74
19,r_58_61_203,seq89,r_44_138_110,r_58_61_203,0.98,1,204,203,74
55,seq14,r_46_146_250,r_133_70_143,r_133_70_143,0.48,110,253,143,74
86,seq94,r_100_2_183,r_132_7_77,r_132_7_77,1.0,107,184,77,74
16,r_82_43_115,seq37,r_42_97_226,r_82_43_115,0.99,1,116,115,74
21,r_102_17_158,seq114,r_44_138_110,r_102_17_158,0.99,0,158,158,74
39,r_100_2_183,seq94,r_44_138_110,r_44_138_110,0.84,74,184,110,74
37,r_31_27_23,r_105_16_112,r_88_10_57,r_31_27_23,0.76,0,23,23,74
46,r_141_22_223,r_40_8_265,r_130_36_222,r_40_8_265,0.52,-42,223,265,74
42,r_66_4_227,seq90,r_78_106_170,r_66_4_227,0.75,1,228,227,74
7,r_127_103_30,seq72,r_125_92_106,r_125_92_106,1.0,11,117,106,74
69,seq57,r_143_24_198,r_132_7_77,r_132_7_77,0.75,109,186,77,74
24,r_87_19_129,r_84_49_280,r_53_55_13,r_84_49_280,0.96,0,280,280,74
19,r_58_61_203,r_30_120_130,seq89,r_30_120_130,1.0,-12,118,130,74
33,r_42_97_226,r_82_43_115,seq80,r_42_97_226,0.83,0,226,226,74
27,r_84_49_280,r_87_19_129,seq45,r_84_49_280,0.68,0,280,280,74
31,r_125_92_106,r_63_3_235,r_127_103_30,r_125_92_106,1.0,1,107,106,74
41,r_48_32_259,seq33,r_51_0_204,r_48_32_259,0.66,1,260,259,74
3,r_105_16_112,seq37,seq110,r_105_16_112,1.0,0,112,112,74
9,r_23_11_49,seq64,seq6,r_23_11_49,1.0,0,49,49,74
18,r_38_148_285,r_65_60_240,r_117_123_73,r_38_148_285,0.92,1,286,285,74
26,r_133_70_143,r_85_21_165,seq14,r_133_70_143,0.9,1,144,143,74
16,r_82_43_115,r_42_97_226,seq64,r_42_97_226,0.99,0,226,226,74
78,seq79,r_51_0_204,seq45,r_51_0_204,1.0,0,204,204,74
0,r_117_123_73,seq112,r_98_13_210,r_117_123_73,1.0,4,77,73,74
11,r_85_21_165,seq147,seq108,r_85_21_165,0.71,0,165,165,74
20,r_136_74_246,r_87_19_129,r_113_91_252,r_87_19_129,1.0,-34,95,129,74
13,r_51_0_204,seq79,r_105_16_112,r_51_0_204,0.98,0,204,204,74
98,seq121,r_76_124_108,seq147,r_76_124_108,1.0,0,108,108,74
15,r_30_120_130,r_58_61_203,r_117_123_73,r_30_120_130,0.96,1,131,130,74
48,r_119_122_194,seq14,seq37,r_119_122_194,0.66,0,194,194,74
4,r_5_128_208,r_48_32_259,r_117_123_73,r_117_123_73,0.89,62,135,73,74
25,r_1_56_19,r_102_17_158,seq112,r_1_56_19,1.0,1,20,19,74
6,r_40_8_265,r_141_22_223,r_44_138_110,r_44_138_110,1.0,26,136,110,74
62,seq37,r_130_36_222,r_119_122_194,r_130_36_222,0.57,-28,194,222,74
37,r_31_27_23,r_88_10_57,r_132_7_77,r_132_7_77,0.8,3,80,77,74
0,r_117_123_73,r_98_13_210,r_30_120_130,r_30_120_130,0.87,64,194,130,74
10,r_88_10_57,r_143_24_198,seq90,r_88_10_57,0.85,1,58,57,74
27,r_84_49_280,seq111,r_87_19_129,r_87_19_129,1.0,13,142,129,74
43,r_65_60_240,r_38_148_285,r_78_106_170,r_38_148_285,0.97,1,286,285,74
30,r_78_106_170,r_38_148_285,r_66_4_227,r_66_4_227,0.98,59,286,227,74
4,r_5_128_208,seq109,r_48_32_259,r_5_128_208,0.64,-185,23,208,74
40,r_145_104_164,seq107,r_50_95_9,r_145_104_164,1.0,1,165,164,74
18,r_38_148_285,r_44_138_110,r_78_106_170,r_44_138_110,0.83,1,111,110,74
24,r_87_19_129,r_51_0_204,r_84_49_280,r_87_19_129,1.0,0,129,129,74
35,r_44_138_110,r_40_8_265,r_58_61_203,r_58_61_203,0.99,38,241,203,74
43,r_65_60_240,r_86_149_263,r_38_148_285,r_65_60_240,0.99,0,240,240,74
33,r_42_97_226,seq101,r_82_43_115,r_82_43_115,1.0,6,121,115,74
88,seq107,r_145_104_164,seq29,r_145_104_164,1.0,3,167,164,74
70,seq59,seq6,r_20_71_221,r_20_71_221,0.82,1,222,221,74
2,r_18_34_20,r_143_24_198,seq54,r_18_34_20,0.99,0,20,20,74
6,r_40_8_265,r_44_138_110,r_63_3_235,r_63_3_235,1.0,30,265,235,74
20,r_136_74_246,r_113_91_252,r_76_124_108,r_136_74_246,0.77,1,247,246,74
38,r_132_7_77,seq131,seq94,r_132_7_77,1.0,0,77,77,74
5,r_53_55_13,r_113_91_252,seq140,r_53_55_13,0.92,0,13,13,74
34,r_76_124_108,seq121,seq112,r_76_124_108,0.96,0,108,108,74
75,seq72,r_48_32_259,r_127_103_30,r_127_103_30,0.79,3,33,30,74
17,r_20_71_221,seq81,seq59,r_20_71_221,0.77,0,221,221,74
14,r_139_47_58,r_105_16_112,r_127_103_30,r_105_16_112,0.61,-54,58,112,74
98,seq121,seq147,r_117_123_73,r_117_123_73,0.56,114,187,73,74
22,r_77_68_151,r_15_96_224,seq67,r_77_68_151,1.0,0,151,151,74
4,r_5_128_208,r_117_123_73,r_85_21_165,r_5_128_208,0.57,0,208,208,74
28,r_86_149_263,seq29,r_51_0_204,r_51_0_204,0.9,62,266,204,74
56,seq144,seq81,r_130_36_222,r_130_36_222,0.97,8,230,222,74
18,r_38_148_285,r_78_106_170,r_65_60_240,r_78_106_170,0.54,70,240,170,74
32,r_28_62_52,seq110,r_18_34_20,r_28_62_52,1.0,0,52,52,74
98,seq121,r_117_123_73,r_63_3_235,r_63_3_235,1.0,15,250,235,74
7,r_127_103_30,r_117_123_73,seq72,r_127_103_30,0.87,3,33,30,74
35,r_44_138_110,r_38_148_285,r_40_8_265,r_44_138_110,1.0,1,111,110,74
93,seq112,r_25_98_140,r_75_64_19,r_25_98_140,0.98,2,142,140,75
40,r_10_86_162,r_13_37_163,r_50_127_114,r_50_127_114,0.98,0,114,114,75
30,r_70_12_217,r_118_132_150,r_105_9_67,r_105_9_67,0.75,10,77,67,75
20,r_33_95_35,seq126,seq2,r_33_95_35,0.96,0,35,35,75
47,r_5_143_37,r_25_98_140,seq104,r_5_143_37,1.0,0,37,37,75
36,r_42_130_253,seq90,r_89_19_195,r_42_130_253,0.76,0,253,253,75
9,r_107_65_280,r_105_9_67,r_1_63_170,r_105_9_67,0.68,213,280,67,75
14,r_116_109_221,r_96_77_169,seq140,r_96_77_169,0.55,3,172,169,75
8,r_71_22_84,r_40_128_2,seq88,r_71_22_84,1.0,0,84,84,75
53,seq135,seq54,r_66_148_148,r_66_148_148,1.0,8,156,148,75
43,r_119_121_159,seq21,seq20,r_119_121_159,0.94,0,159,159,75
11,r_62_122_145,seq91,seq72,r_62_122_145,0.69,33,178,145,75
44,r_108_18_228,r_119_121_159,seq138,r_108_18_228,0.74,0,228,228,75
37,r_133_41_100,r_57_84_64,r_118_132_150,r_133_41_100,0.53,3,103,100,75
21,r_118_132_150,r_107_65_280,seq28,r_118_132_150,1.0,0,150,150,75
46,r_34_32_289,seq129,r_60_94_122,r_60_94_122,0.54,168,290,122,75
42,r_105_9_67,r_6_85_282,r_70_12_217,r_105_9_67,1.0,0,67,67,75
30,r_70_12_217,r_6_85_282,seq82,r_6_85_282,0.94,0,282,282,75
80,seq73,r_34_32_289,r_3_43_60,r_3_43_60,1.0,80,140,60,75
45,r_1_63_170,seq104,seq120,r_1_63_170,0.99,0,170,170,75
11,r_62_122_145,seq72,r_75_64_19,r_62_122_145,0.65,98,243,145,75
24,r_142_97_193,r_117_55_250,r_30_131_52,r_30_131_52,0.64,135,187,52,75
19,r_96_77_169,r_116_109_221,seq146,r_96_77_169,0.53,3,172,169,75
55,seq138,r_31_14_49,r_107_65_280,r_31_14_49,0.89,-14,35,49,75
37,r_133_41_100,r_118_132_150,r_105_9_67,r_118_132_150,1.0,0,150,150,75
95,seq115,seq129,r_3_43_60,r_3_43_60,1.0,1,61,60,75
39,r_31_14_49,r_66_148_148,seq38,r_66_148_148,1.0,-10,138,148,75
41,r_66_148_148,seq38,r_31_14_49,r_31_14_49,1.0,15,64,49,75
3,r_74_45_239,seq82,seq129,r_74_45_239,0.84,0,239,239,75
26,r_0_141_118,r_60_94_122,r_3_43_60,r_0_141_118,0.98,0,118,118,75
16,r_6_85_282,seq82,r_70_12_217,r_70_12_217,1.0,0,217,217,75
0,r_89_19_195,seq54,seq91,r_89_19_195,0.82,2,197,195,75
11,r_62_122_145,seq69,seq91,r_62_122_145,0.7,1,146,145,75
7,r_30_131_52,r_58_93_297,seq46,r_30_131_52,1.0,0,52,52,75
39,r_31_14_49,r_70_12_217,r_66_148_148,r_31_14_49,1.0,0,49,49,75
13,r_123_103_104,seq146,r_57_84_64,r_123_103_104,1.0,0,104,104,75
15,r_59_27_178,r_107_65_280,seq137,r_59_27_178,0.95,0,178,178,75
40,r_10_86_162,r_50_127_114,seq21,r_10_86_162,0.67,2,164,162,75
6,r_7_67_69,r_123_103_104,seq78,r_7_67_69,0.87,1,70,69,75
62,seq21,r_119_121_159,r_10_86_162,r_119_121_159,0.54,0,159,159,75
55,seq138,r_60_94_122,r_108_18_228,r_108_18_228,0.97,22,250,228,75
27,r_60_94_122,r_0_141_118,seq138,r_60_94_122,0.97,2,124,122,75
30,r_70_12_217,r_105_9_67,r_6_85_282,r_70_12_217,0.94,1,218,217,75
16,r_6_85_282,r_105_9_67,seq82,r_105_9_67,1.0,-28,39,67,75
87,seq91,seq38,r_89_19_195,r_89_19_195,1.0,25,220,195,75
23,r_57_84_64,r_133_41_100,r_123_103_104,r_57_84_64,0.98,40,104,64,75
2,r_102_39_200,r_108_18_228,seq23,r_102_39_200,0.98,0,200,200,75
41,r_66_148_148,r_31_14_49,seq135,r_66_148_148,1.0,0,148,148,75
40,r_10_86_162,r_15_51_272,r_13_37_163,r_10_86_162,0.49,-80,82,162,75
18,r_50_127_114,r_142_97_193,r_10_86_162,r_50_127_114,0.93,0,114,114,75
29,r_3_43_60,seq78,seq115,r_3_43_60,1.0,0,60,60,75
24,r_142_97_193,r_50_127_114,r_117_55_250,r_50_127_114,0.84,0,114,114,75
25,r_136_101_197,seq52,r_149_92_21,r_136_101_197,0.56,0,197,197,75
33,r_44_29_265,r_87_145_293,r_116_109_221,r_87_145_293,0.58,-28,265,293,75
5,r_149_92_21,r_70_12_217,seq26,r_149_92_21,0.98,2,23,21,75
70,seq46,r_15_51_272,r_30_131_52,r_30_131_52,1.0,124,176,52,75
42,r_105_9_67,r_70_12_217,r_133_41_100,r_70_12_217,0.67,1,218,217,75
32,r_49_16_171,seq76,r_71_22_84,r_49_16_171,1.0,0,171,171,75
38,r_13_37_163,seq137,seq111,r_13_37_163,0.85,0,163,163,75
65,seq26,r_34_32_289,r_149_92_21,r_149_92_21,1.0,3,24,21,75
60,seq146,r_123_103_104,seq79,r_123_103_104,1.0,-1,103,104,75
17,r_56_48_95,r_117_55_250,seq52,r_56_48_95,1.0,0,95,95,75
9,r_107_65_280,r_59_27_178,r_105_9_67,r_105_9_67,1.0,111,178,67,75
16,r_6_85_282,r_70_12_217,r_105_9_67,r_6_85_282,0.91,0,282,282,75
31,r_80_114_156,seq72,r_116_109_221,r_116_109_221,0.8,3,224,221,75
22,r_83_110_277,seq28,r_7_67_69,r_7_67_69,0.91,209,278,69,75
28,r_25_98_140,r_10_86_162,r_66_148_148,r_25_98_140,0.65,104,244,140,75
28,r_25_98_140,seq112,seq54,r_25_98_140,0.9,2,142,140,75
18,r_50_127_114,r_10_86_162,r_149_92_21,r_10_86_162,0.72,28,190,162,75
44,r_108_18_228,r_102_39_200,r_119_121_159,r_108_18_228,0.66,-28,200,228,75
23,r_57_84_64,seq120,r_133_41_100,r_57_84_64,0.55,-1,63,64,75
60,seq146,seq79,r_96_77_169,r_96_77_169,1.0,20,189,169,75
35,r_8_147_165,seq28,r_149_92_21,r_8_147_165,1.0,0,165,165,75
12,r_15_51_272,seq46,r_40_128_2,r_15_51_272,0.23,6,278,272,75
55,seq138,r_107_65_280,r_60_94_122,r_60_94_122,1.0,11,133,122,75
30,r_74_131_84,r_49_109_232,r_38_87_29,r_74_131_84,1.0,0,84,84,76
36,r_102_42_97,r_17_119_135,seq39,r_17_119_135,0.97,-36,99,135,76
92,seq108,r_75_147_142,r_95_81_80,r_95_81_80,0.53,44,124,80,76
8,r_73_6_244,seq28,seq135,r_73_6_244,0.78,1,245,244,76
53,seq5,r_45_18_179,seq79,r_45_18_179,0.96,0,179,179,76
59,seq14,seq35,r_13_90_38,r_13_90_38,1.0,3,41,38,76
43,r_133_2_151,r_68_26_280,r_78_114_7,r_133_2_151,0.93,0,151,151,76
19,r_4_103_289,r_80_8_283,seq28,r_80_8_283,0.6,6,289,283,76
86,seq88,r_19_128_200,r_104_70_91,r_104_70_91,1.0,111,202,91,76
16,r_75_147_142,seq108,r_95_81_80,r_95_81_80,0.76,4,84,80,76
21,r_52_111_275,seq84,r_48_23_155,r_48_23_155,0.72,120,275,155,76
1,r_94_124_263,r_104_70_91,r_34_113_85,r_94_124_263,0.9,6,269,263,76
1,r_94_124_263,r_19_128_200,r_104_70_91,r_104_70_91,1.0,111,202,91,76
97,seq137,r_95_81_80,r_78_114_7,r_95_81_80,1.0,0,80,80,76
5,r_117_58_245,seq41,seq129,r_117_58_245,0.22,10,255,245,76
46,r_107_44_145,r_59_77_99,seq55,r_59_77_99,0.92,1,100,99,76
32,r_15_31_17,r_139_115_108,seq98,r_139_115_108,1.0,1,109,108,76
83,seq79,r_47_7_206,r_132_43_225,r_47_7_206,1.0,0,206,206,76
19,r_4_103_289,r_93_121_199,r_80_8_283,r_4_103_289,0.4,-91,198,289,76
15,r_139_115_108,r_15_31_17,r_105_76_252,r_139_115_108,1.0,3,111,108,76
33,r_95_81_80,r_75_147_142,seq108,r_75_147_142,1.0,0,142,142,76
95,seq116,seq146,r_148_118_92,r_148_118_92,1.0,2,94,92,76
31,r_49_109_232,r_74_131_84,r_73_6_244,r_74_131_84,1.0,0,84,84,76
41,r_143_138_150,seq21,seq144,r_143_138_150,1.0,0,150,150,76
89,seq144,r_50_11_236,r_143_138_150,r_143_138_150,0.51,86,236,150,76
3,r_32_63_172,r_71_92_261,seq54,r_32_63_172,0.96,0,172,172,76
10,r_59_77_99,r_107_44_145,seq136,r_59_77_99,0.96,1,100,99,76
90,seq98,seq55,r_19_128_200,r_19_128_200,1.0,30,230,200,76
26,r_30_40_118,r_73_6_244,seq35,r_30_40_118,1.0,0,118,118,76
72,seq35,seq67,r_30_40_118,r_30_40_118,1.0,13,131,118,76
15,r_139_115_108,r_83_56_36,r_15_31_17,r_83_56_36,1.0,0,36,36,76
16,r_75_147_142,r_95_81_80,seq91,r_75_147_142,1.0,0,142,142,76
4,r_37_127_65,seq72,seq20,r_37_127_65,1.0,0,65,65,76
73,seq39,r_32_63_172,r_102_42_97,r_32_63_172,1.0,-22,150,172,76
20,r_140_1_198,r_46_123_298,seq33,r_140_1_198,0.96,0,198,198,76
48,r_89_142_120,seq0,r_17_119_135,r_17_119_135,0.49,-13,122,135,76
6,r_47_7_206,r_117_58_245,seq33,r_47_7_206,0.93,1,207,206,76
85,seq84,r_52_111_275,r_148_118_92,r_148_118_92,1.0,183,275,92,76
99,seq149,r_80_8_283,r_49_109_232,r_49_109_232,0.89,53,285,232,76
27,r_50_11_236,seq144,seq108,r_50_11_236,0.84,0,236,236,76
87,seq91,r_51_64_101,seq54,r_51_64_101,1.0,2,103,101,76
46,r_107_44_145,seq55,r_78_114_7,r_107_44_145,0.81,2,147,145,76
2,r_45_18_179,seq5,r_75_147_142,r_45_18_179,1.0,0,179,179,76
47,r_34_113_85,r_132_43_225,seq116,r_34_113_85,0.79,0,85,85,76
74,seq41,r_117_58_245,r_49_109_232,r_49_109_232,0.97,23,255,232,76
18,r_148_118_92,r_49_109_232,seq116,r_148_118_92,0.96,0,92,92,76
29,r_97_99_253,seq55,r_15_31_17,r_15_31_17,0.37,65,82,17,76
25,r_105_76_252,r_57_61_117,r_78_114_7,r_57_61_117,0.96,0,117,117,76
38,r_83_56_36,r_139_115_108,seq82,r_83_56_36,1.0,0,36,36,76
33,r_95_81_80,seq137,r_75_147_142,r_95_81_80,1.0,0,80,80,76
34,r_141_125_12,r_95_81_80,seq29,r_141_125_12,1.0,2,14,12,76
92,seq108,r_95_81_80,r_50_11_236,r_50_11_236,0.98,1,237,236,76
70,seq29,seq120,r_141_125_12,r_141_125_12,0.99,110,122,12,76
65,seq22,seq35,r_17_119_135,r_17_119_135,0.72,-38,97,135,76
61,seq145,r_48_23_155,seq136,r_48_23_155,1.0,0,155,155,76
57,seq9,seq91,r_48_23_155,r_48_23_155,0.96,0,155,155,76
48,r_89_142_120,r_17_119_135,seq3,r_17_119_135,0.65,3,138,135,76
75,seq54,r_36_86_243,r_32_63_172,r_32_63_172,0.75,73,245,172,76
25,r_105_76_252,r_78_114_7,r_32_63_172,r_105_76_252,0.64,0,252,252,76
15,r_139_115_108,r_105_76_252,r_78_114_7,r_105_76_252,0.95,-49,203,252,76
31,r_49_109_232,r_73_6_244,seq3,r_49_109_232,0.74,0,232,232,76
29,r_97_99_253,r_15_31_17,seq108,r_15_31_17,0.51,237,254,17,76
22,r_19_128_200,seq88,seq98,r_19_128_200,0.63,2,202,200,76
28,r_17_119_135,r_102_42_97,seq22,r_17_119_135,0.87,0,135,135,76
84,seq82,seq54,r_83_56_36,r_83_56_36,1.0,5,41,36,76
49,r_71_92_261,r_32_63_172,seq129,r_32_63_172,0.98,0,172,172,76
7,r_93_121_199,r_4_103_289,r_102_42_97,r_4_103_289,0.52,-94,195,289,76
44,r_48_23_155,seq145,seq9,r_48_23_155,0.99,0,155,155,76
57,seq9,r_13_90_38,seq91,r_13_90_38,1.0,1,39,38,76
82,seq72,r_49_109_232,r_57_61_117,r_57_61_117,1.0,108,225,117,76
32,r_15_31_17,r_59_77_99,r_139_115_108,r_15_31_17,0.65,20,37,17,76
35,r_104_70_91,seq33,seq88,r_104_70_91,1.0,1,92,91,76
14,r_13_90_38,seq9,seq14,r_13_90_38,1.0,0,38,38,76
93,seq102,seq44,r_127_24_67,r_127_24_67,1.0,102,169,67,77
30,r_122_145_64,r_31_64_293,seq69,r_122_145_64,1.0,5,69,64,77
2,r_121_113_15,r_104_80_168,r_56_34_252,r_121_113_15,0.82,0,15,15,77
14,r_73_107_158,seq134,seq52,r_73_107_158,1.0,1,159,158,77
8,r_86_117_69,r_56_34_252,r_39_74_45,r_86_117_69,1.0,0,69,69,77
53,seq5,seq63,r_127_24_67,r_127_24_67,1.0,28,95,67,77
43,r_56_34_252,r_86_117_69,r_121_113_15,r_86_117_69,0.95,-1,68,69,77
18,r_141_55_16,r_127_24_67,seq118,r_141_55_16,0.85,0,16,16,77
54,seq134,r_73_107_158,seq11,r_73_107_158,1.0,1,159,158,77
3,r_0_135_86,r_139_62_169,r_21_144_2,r_139_62_169,0.99,1,170,169,77
55,seq8,seq16,r_104_80_168,r_104_80_168,0.91,10,178,168,77
86,seq72,r_14_77_282,r_41_85_210,r_41_85_210,1.0,15,225,210,77
16,r_127_24_67,seq69,seq5,r_127_24_67,1.0,2,69,67,77
21,r_104_80_168,seq44,r_98_99_65,r_98_99_65,1.0,-2,63,65,77
39,r_139_62_169,seq33,r_0_135_86,r_0_135_86,0.91,1,87,86,77
19,r_84_48_11,r_128_120_4,seq69,r_84_48_11,0.6,33,44,11,77
5,r_46_30_92,seq143,seq92,r_46_30_92,1.0,-1,91,92,77
46,r_3_112_242,seq13,r_26_129_54,r_3_112_242,0.68,0,242,242,77
42,r_75_111_80,seq60,seq43,r_75_111_80,1.0,1,81,80,77
33,r_108_140_50,seq72,r_139_62_169,r_139_62_169,1.0,0,169,169,77
19,r_84_48_11,seq69,r_121_113_15,r_84_48_11,0.33,118,129,11,77
39,r_139_62_169,r_0_135_86,r_108_140_50,r_139_62_169,0.97,1,170,169,77
41,r_115_90_283,r_7_65_208,r_18_9_137,r_115_90_283,0.69,-75,208,283,77
67,seq37,seq79,r_75_111_80,r_75_111_80,1.0,164,244,80,77
3,r_0_135_86,r_73_107_158,r_139_62_169,r_0_135_86,1.0,0,86,86,77
10,r_98_99_65,r_35_6_116,r_104_80_168,r_98_99_65,0.99,0,65,65,77
26,r_81_100_119,seq79,r_115_90_283,r_81_100_119,0.99,1,120,119,77
35,r_96_88_266,r_106_10_186,seq102,r_96_88_266,0.89,2,268,266,77
4,r_147_15_202,seq63,r_23_101_161,r_147_15_202,0.62,3,205,202,77
63,seq20,seq79,r_58_137_68,r_58_137_68,0.96,-6,62,68,77
11,r_58_137_68,r_148_123_177,seq20,r_58_137_68,0.9,3,71,68,77
20,r_18_9_137,r_73_107_158,r_81_100_119,r_18_9_137,0.79,0,137,137,77
13,r_28_27_223,r_31_64_293,r_35_6_116,r_31_64_293,0.63,-70,223,293,77
15,r_61_68_187,seq12,r_35_6_116,r_35_6_116,0.61,80,196,116,77
6,r_4_47_108,seq60,r_35_6_116,r_4_47_108,0.85,0,108,108,77
62,seq17,seq138,r_95_126_104,r_95_126_104,0.99,58,162,104,77
21,r_104_80_168,r_98_99_65,seq8,r_104_80_168,0.72,1,169,168,77
2,r_121_113_15,r_56_34_252,r_109_146_101,r_109_146_101,1.0,2,103,101,77
45,r_39_74_45,r_21_144_2,seq119,r_39_74_45,1.0,0,45,45,77
10,r_98_99_65,r_104_80_168,r_127_24_67,r_104_80_168,0.96,1,169,168,77
27,r_128_120_4,r_56_34_252,r_121_113_15,r_121_113_15,0.56,101,116,15,77
41,r_115_90_283,r_18_9_137,r_106_10_186,r_115_90_283,0.85,0,283,283,77
93,seq102,r_127_24_67,r_96_88_266,r_96_88_266,0.6,0,266,266,77
29,r_23_101_161,r_96_88_266,r_21_144_2,r_23_101_161,0.96,-1,160,161,77
24,r_7_65_208,r_115_90_283,seq134,r_7_65_208,0.85,0,208,208,77
25,r_124_93_183,r_105_116_182,seq60,r_124_93_183,0.79,-1,182,183,77
35,r_96_88_266,seq136,r_106_10_186,r_96_88_266,0.46,-23,243,266,77
33,r_108_140_50,seq119,seq72,r_108_140_50,0.92,42,92,50,77
88,seq79,seq37,r_35_6_116,r_35_6_116,0.85,13,129,116,77
19,r_84_48_11,seq1,r_128_120_4,r_84_48_11,0.52,3,14,11,77
6,r_4_47_108,r_35_6_116,r_84_48_11,r_4_47_108,0.32,133,241,108,77
32,r_41_85_210,seq83,seq72,r_41_85_210,0.75,0,210,210,77
38,r_142_59_264,r_106_10_186,r_46_30_92,r_46_30_92,0.74,95,187,92,77
9,r_26_129_54,r_7_65_208,seq38,r_26_129_54,1.0,0,54,54,77
22,r_29_22_53,r_128_120_4,seq38,r_29_22_53,0.98,-4,49,53,77
10,r_98_99_65,r_127_24_67,r_39_74_45,r_127_24_67,0.35,155,222,67,77
47,r_130_133_56,r_73_107_158,seq92,r_130_133_56,0.65,1,57,56,77
35,r_96_88_266,seq50,seq136,r_96_88_266,0.75,-51,215,266,77
60,seq143,r_115_90_283,r_18_9_137,r_18_9_137,1.0,146,283,137,77
17,r_35_6_116,r_98_99_65,seq79,r_98_99_65,0.87,3,68,65,77
26,r_81_100_119,r_115_90_283,r_18_9_137,r_81_100_119,0.47,164,283,119,77
28,r_109_146_101,r_21_144_2,r_121_113_15,r_109_146_101,1.0,0,101,101,77
84,seq70,r_58_137_68,r_56_34_252,r_58_137_68,0.55,184,252,68,77
56,seq138,seq17,r_95_126_104,r_95_126_104,0.96,23,127,104,77
44,r_106_10_186,r_142_59_264,seq13,r_106_10_186,0.85,1,187,186,77
23,r_148_123_177,r_58_137_68,seq91,r_58_137_68,0.74,3,71,68,77
35,r_96_88_266,r_23_101_161,seq50,r_23_101_161,0.94,-1,160,161,77
12,r_105_116_182,r_124_93_183,seq83,r_105_116_182,0.98,0,182,182,77
23,r_148_123_177,seq91,seq125,r_148_123_177,0.62,0,177,177,77
84,seq70,seq91,r_58_137_68,r_58_137_68,0.43,92,160,68,77
19,r_146_20_42,r_54_55_244,r_35_147_235,r_146_20_42,0.99,1,43,42,78
36,r_97_37_298,r_116_76_237,r_58_47_255,r_116_76_237,0.69,2,239,237,78
8,r_103_29_193,r_80_2_1,r_50_52_181,r_103_29_193,1.0,2,195,193,78
37,r_46_0_229,r_73_110_65,r_139_23_36,r_73_110_65,0.56,-1,64,65,78
19,r_146_20_42,r_35_147_235,seq105,r_35_147_235,0.98,-131,104,235,78
86,seq87,r_42_95_145,seq68,r_42_95_145,0.95,3,148,145,78
16,r_106_21_209,r_98_8_102,seq31,r_106_21_209,0.77,4,213,209,78
42,r_138_100_166,r_134_90_78,r_146_20_42,r_138_100_166,0.86,-98,68,166,78
39,r_50_52_181,r_111_130_38,r_46_0_229,r_111_130_38,0.93,-6,32,38,78
30,r_120_108_51,seq115,seq41,r_120_108_51,1.0,8,59,51,78
90,seq105,seq136,r_146_20_42,r_146_20_42,1.0,2,44,42,78
39,r_50_52_181,r_46_0_229,seq123,r_50_52_181,0.96,0,181,181,78
31,r_44_81_129,seq41,seq22,r_44_81_129,1.0,0,129,129,78
41,r_148_107_164,r_46_0_229,r_33_24_44,r_148_107_164,0.81,6,170,164,78
3,r_34_25_174,seq125,r_148_107_164,r_34_25_174,0.98,0,174,174,78
50,seq4,r_1_137_136,r_79_77_56,r_79_77_56,0.64,0,56,56,78
26,r_134_90_78,r_138_100_166,seq31,r_134_90_78,1.0,2,80,78,78
72,seq62,seq27,r_94_91_54,r_94_91_54,1.0,84,138,54,78
4,r_48_145_73,seq67,seq17,r_48_145_73,1.0,0,73,73,78
78,seq68,seq87,r_96_121_204,r_96_121_204,0.97,8,212,204,78
0,r_73_110_65,r_46_0_229,seq70,r_73_110_65,1.0,-1,64,65,78
20,r_132_45_155,seq113,r_118_85_258,r_132_45_155,0.82,3,158,155,78
15,r_98_8_102,r_106_21_209,r_79_77_56,r_79_77_56,1.0,157,213,56,78
48,r_35_147_235,seq105,r_146_20_42,r_146_20_42,1.0,19,61,42,78
25,r_79_77_56,r_99_128_288,seq4,r_79_77_56,1.0,0,56,56,78
35,r_111_130_38,r_50_52_181,r_98_8_102,r_111_130_38,0.78,1,39,38,78
6,r_19_14_124,seq39,seq126,r_19_14_124,0.99,0,124,124,78
21,r_56_28_16,r_127_144_172,r_40_7_151,r_56_28_16,0.98,156,172,16,78
99,seq126,r_18_60_138,r_19_14_124,r_19_14_124,0.9,14,138,124,78
27,r_75_149_161,seq84,r_120_108_51,r_75_149_161,0.5,0,161,161,78
30,r_120_108_51,seq41,r_75_149_161,r_75_149_161,0.84,7,168,161,78
2,r_116_76_237,r_97_37_298,r_32_86_58,r_116_76_237,0.5,2,239,237,78
47,r_117_16_256,seq142,r_94_91_54,r_94_91_54,1.0,202,256,54,78
40,r_42_95_145,seq87,seq105,r_42_95_145,0.92,4,149,145,78
29,r_12_69_243,seq84,seq39,r_12_69_243,0.45,1,244,243,78
24,r_18_60_138,seq126,r_44_81_129,r_44_81_129,0.99,9,138,129,78
35,r_111_130_38,r_98_8_102,r_92_11_20,r_98_8_102,0.53,149,251,102,78
43,r_3_102_245,seq105,r_79_77_56,r_3_102_245,0.81,1,246,245,78
48,r_35_147_235,r_146_20_42,r_148_107_164,r_35_147_235,0.87,0,235,235,78
58,seq142,r_117_16_256,seq140,r_117_16_256,0.8,0,256,256,78
44,r_139_23_36,r_54_55_244,r_46_0_229,r_139_23_36,1.0,0,36,36,78
21,r_56_28_16,r_75_149_161,r_127_144_172,r_56_28_16,0.87,0,16,16,78
68,seq39,r_19_14_124,r_43_83_5,r_19_14_124,1.0,-44,80,124,78
42,r_138_100_166,r_146_20_42,seq126,r_138_100_166,1.0,2,168,166,78
49,r_96_121_204,r_56_28_16,seq68,r_56_28_16,0.55,189,205,16,78
32,r_61_72_101,seq31,seq125,r_61_72_101,1.0,-2,99,101,78
34,r_36_49_217,seq119,seq71,r_36_49_217,0.51,0,217,217,78
17,r_131_129_196,seq133,r_32_86_58,r_32_86_58,0.99,141,199,58,78
46,r_92_11_20,r_19_14_124,seq115,r_19_14_124,0.67,-101,23,124,78
9,r_99_128_288,r_79_77_56,seq70,r_79_77_56,1.0,7,63,56,78
96,seq119,r_36_49_217,seq105,r_36_49_217,1.0,0,217,217,78
22,r_40_7_151,r_43_83_5,r_56_28_16,r_40_7_151,0.97,0,151,151,78
28,r_127_144_172,r_96_121_204,seq4,r_127_144_172,0.84,0,172,172,78
49,r_96_121_204,r_127_144_172,r_56_28_16,r_96_121_204,0.66,-32,172,204,78
7,r_1_137_136,seq5,seq136,r_1_137_136,1.0,0,136,136,78
23,r_122_57_87,r_56_28_16,seq104,r_122_57_87,1.0,-1,86,87,78
14,r_94_91_54,r_44_81_129,seq62,r_94_91_54,1.0,0,54,54,78
1,r_33_24_44,r_58_47_255,seq84,r_33_24_44,0.98,-4,40,44,78
30,r_114_135_206,seq48,r_88_24_120,r_88_24_120,1.0,88,208,120,79
44,r_14_92_117,r_131_42_203,r_60_101_158,r_60_101_158,0.49,45,203,158,79
13,r_43_54_30,r_93_141_243,seq37,r_43_54_30,0.81,-6,24,30,79
0,r_139_113_167,seq46,r_19_11_231,r_139_113_167,0.5,35,202,167,79
45,r_104_73_237,r_119_122_122,r_69_96_26,r_69_96_26,1.0,1,27,26,79
16,r_130_80_94,r_133_82_108,r_69_96_26,r_69_96_26,0.98,69,95,26,79
39,r_121_12_99,seq112,seq49,r_121_12_99,0.84,0,99,99,79
43,r_83_18_36,r_98_44_161,seq91,r_83_18_36,0.97,-9,27,36,79
1,r_94_41_241,r_23_100_239,r_133_82_108,r_133_82_108,0.99,133,241,108,79
5,r_1_30_6,r_60_101_158,seq90,r_1_30_6,0.51,152,158,6,79
46,r_68_47_221,seq142,r_20_40_75,r_20_40_75,0.99,150,225,75,79
40,r_13_107_51,r_121_12_99,seq5,r_13_107_51,1.0,0,51,51,79
25,r_147_28_152,r_121_12_99,seq61,r_147_28_152,1.0,5,157,152,79
19,r_2_89_31,r_114_135_206,seq112,r_2_89_31,0.53,0,31,31,79
31,r_25_115_139,r_86_118_171,seq61,r_86_118_171,0.97,-32,139,171,79
67,seq46,r_76_62_266,r_19_11_231,r_76_62_266,0.79,-32,234,266,79
3,r_88_24_120,seq55,seq53,r_88_24_120,1.0,0,120,120,79
10,r_38_36_182,seq134,r_138_125_28,r_38_36_182,0.83,1,183,182,79
26,r_20_40_75,seq134,seq128,r_20_40_75,1.0,0,75,75,79
4,r_137_10_67,seq5,seq85,r_137_10_67,1.0,0,67,67,79
33,r_99_87_48,r_78_52_201,seq134,r_99_87_48,1.0,0,48,48,79
78,seq65,seq0,r_33_9_110,r_33_9_110,0.76,83,193,110,79
0,r_139_113_167,r_94_41_241,seq46,r_139_113_167,0.66,1,168,167,79
9,r_136_45_98,seq3,r_1_30_6,r_136_45_98,0.6,64,162,98,79
6,r_69_96_26,seq51,seq67,r_69_96_26,0.64,0,26,26,79
48,r_32_84_289,seq85,r_143_148_268,r_143_148_268,0.88,22,290,268,79
18,r_60_101_158,r_131_42_203,r_81_71_190,r_60_101_158,0.46,45,203,158,79
74,seq59,r_57_50_273,r_131_42_203,r_131_42_203,0.51,22,225,203,79
2,r_143_148_268,r_1_30_6,r_99_87_48,r_143_148_268,0.67,1,269,268,79
27,r_27_22_177,seq15,r_38_36_182,r_38_36_182,0.98,3,185,182,79
87,seq85,r_78_52_201,r_137_10_67,r_137_10_67,0.98,134,201,67,79
2,r_143_148_268,r_60_101_158,r_1_30_6,r_1_30_6,0.48,152,158,6,79
18,r_60_101_158,r_16_140_130,r_143_148_268,r_16_140_130,0.67,-70,60,130,79
29,r_131_42_203,seq128,r_14_92_117,r_14_92_117,0.95,1,118,117,79
24,r_126_35_115,seq37,r_69_96_26,r_126_35_115,0.73,18,133,115,79
25,r_147_28_152,r_139_113_167,r_121_12_99,r_121_12_99,1.0,20,119,99,79
58,seq144,r_94_41_241,r_121_12_99,r_121_12_99,1.0,142,241,99,79
65,seq37,r_126_35_115,seq65,r_126_35_115,1.0,18,133,115,79
38,r_86_118_171,seq90,seq112,r_86_118_171,0.99,1,172,171,79
77,seq64,seq3,r_129_117_19,r_129_117_19,1.0,158,177,19,79
34,r_132_63_219,seq134,r_129_117_19,r_132_63_219,0.91,0,219,219,79
32,r_129_117_19,r_121_12_99,seq142,r_129_117_19,0.86,0,19,19,79
17,r_23_100_239,r_94_41_241,seq31,r_23_100_239,0.57,0,239,239,79
9,r_136_45_98,r_58_95_174,seq3,r_58_95_174,0.59,-67,107,174,79
11,r_138_125_28,r_136_45_98,r_27_22_177,r_136_45_98,0.78,-3,95,98,79
28,r_29_110_43,r_69_96_26,r_57_50_273,r_69_96_26,0.62,239,265,26,79
29,r_131_42_203,r_14_92_117,seq59,r_131_42_203,0.78,0,203,203,79
22,r_133_82_108,seq39,seq91,r_133_82_108,0.99,0,108,108,79
28,r_29_110_43,r_81_71_190,r_69_96_26,r_69_96_26,0.84,67,93,26,79
49,r_57_50_273,seq103,r_29_110_43,r_29_110_43,0.59,231,274,43,79
7,r_78_52_201,seq85,seq48,r_78_52_201,0.89,0,201,201,79
18,r_60_101_158,r_143_148_268,r_131_42_203,r_60_101_158,0.6,0,158,158,79
44,r_14_92_117,seq149,r_131_42_203,r_14_92_117,0.77,1,118,117,79
23,r_119_122_122,seq17,seq91,r_119_122_122,0.47,7,129,122,79
41,r_109_26_32,r_32_84_289,seq77,r_109_26_32,1.0,0,32,32,79
82,seq72,seq77,r_8_102_33,r_8_102_33,0.99,49,82,33,79
35,r_16_140_130,r_60_101_158,seq5,r_16_140_130,0.99,0,130,130,79
11,r_138_125_28,r_25_115_139,r_136_45_98,r_138_125_28,0.73,14,42,28,79
8,r_21_110_100,seq90,r_111_41_65,r_21_110_100,0.77,2,102,100,80
43,r_75_26_282,r_138_73_228,r_126_38_40,r_126_38_40,1.0,189,229,40,80
86,seq90,r_77_74_31,r_115_4_188,r_115_4_188,1.0,0,188,188,80
33,r_71_60_8,r_18_129_5,seq10,r_71_60_8,0.96,8,16,8,80
37,r_94_149_246,seq33,r_136_51_225,r_94_149_246,0.47,0,246,246,80
55,seq9,r_50_23_237,r_61_128_183,r_61_128_183,1.0,2,185,183,80
16,r_104_30_221,seq62,r_108_114_286,r_104_30_221,0.76,0,221,221,80
21,r_92_113_81,seq64,r_142_44_38,r_92_113_81,0.41,0,81,81,80
39,r_1_82_226,seq123,seq90,r_1_82_226,0.8,0,226,226,80
1,r_37_13_209,seq62,seq146,r_37_13_209,0.66,0,209,209,80
46,r_138_73_228,r_75_26_282,r_83_63_82,r_138_73_228,0.92,1,229,228,80
42,r_105_89_224,seq64,r_39_16_157,r_39_16_157,1.0,0,157,157,80
80,seq139,seq43,r_55_130_187,r_55_130_187,1.0,7,194,187,80
44,r_50_23_237,r_61_128_183,r_27_119_217,r_50_23_237,0.77,6,243,237,80
87,seq135,r_109_72_51,r_36_81_54,r_109_72_51,1.0,0,51,51,80
45,r_111_41_65,r_132_96_180,seq98,r_111_41_65,1.0,-1,64,65,80
19,r_120_124_182,r_94_149_246,seq146,r_120_124_182,0.62,12,194,182,80
30,r_5_46_46,seq54,r_19_99_173,r_5_46_46,0.98,0,46,46,80
66,seq33,r_108_114_286,seq7,r_108_114_286,0.55,-115,171,286,80
31,r_97_47_79,seq84,r_115_4_188,r_115_4_188,0.53,-116,72,188,80
41,r_70_79_61,seq76,seq35,r_70_79_61,1.0,0,61,61,80
67,seq35,seq3,r_70_79_61,r_70_79_61,1.0,83,144,61,80
30,r_5_46_46,r_19_99_173,r_83_63_82,r_5_46_46,0.94,39,85,46,80
3,r_83_63_82,seq53,r_5_46_46,r_83_63_82,1.0,0,82,82,80
26,r_36_81_54,seq33,r_122_148_94,r_122_148_94,1.0,40,134,94,80
78,seq64,r_92_113_81,r_105_89_224,r_92_113_81,0.97,0,81,81,80
11,r_61_128_183,r_127_24_3,seq146,r_61_128_183,0.76,0,183,183,80
13,r_132_96_180,seq118,r_70_79_61,r_70_79_61,1.0,120,181,61,80
98,seq118,r_132_96_180,r_25_86_35,r_25_86_35,0.62,82,117,35,80
15,r_131_22_172,seq3,seq11,r_131_22_172,1.0,0,172,172,80
48,r_39_16_157,r_50_23_237,r_34_91_163,r_39_16_157,0.99,0,157,157,80
6,r_115_4_188,r_97_47_79,seq90,r_115_4_188,0.67,0,188,188,80
27,r_122_148_94,r_20_121_55,r_145_133_241,r_20_121_55,1.0,0,55,55,80
99,seq123,r_1_82_226,r_18_129_5,r_1_82_226,0.98,0,226,226,80
0,r_19_99_173,r_5_46_46,seq29,r_19_99_173,0.99,0,173,173,80
47,r_25_86_35,r_21_110_100,seq8,r_25_86_35,0.99,1,36,35,80
4,r_142_44_38,r_67_17_160,seq15,r_142_44_38,1.0,1,39,38,80
22,r_126_38_40,r_75_26_282,r_19_99_173,r_19_99_173,1.0,105,278,173,80
40,r_66_45_152,r_68_85_84,seq123,r_66_45_152,1.0,0,152,152,80
74,seq56,r_136_51_225,r_87_12_102,r_87_12_102,1.0,124,226,102,80
29,r_136_51_225,seq56,seq117,r_136_51_225,0.49,1,226,225,80
24,r_87_12_102,r_108_114_286,seq56,r_87_12_102,1.0,0,102,102,80
27,r_122_148_94,r_145_133_241,r_36_81_54,r_122_148_94,1.0,0,94,94,80
64,seq29,r_75_26_282,r_19_99_173,r_19_99_173,1.0,38,211,173,80
22,r_126_38_40,seq102,r_75_26_282,r_126_38_40,1.0,0,40,40,80
50,seq2,r_67_17_160,r_75_26_282,r_67_17_160,0.79,0,160,160,80
70,seq43,seq139,r_109_72_51,r_109_72_51,1.0,21,72,51,80
42,r_105_89_224,r_39_16_157,seq2,r_105_89_224,1.0,2,226,224,80
61,seq146,r_50_23_237,r_37_13_209,r_37_13_209,0.74,27,236,209,80
32,r_0_140_106,seq3,seq100,r_0_140_106,0.83,4,110,106,80
77,seq62,r_69_52_296,r_77_74_31,r_77_74_31,1.0,55,86,31,80
34,r_127_24_3,r_34_91_163,seq54,r_34_91_163,1.0,0,163,163,80
4,r_142_44_38,seq15,r_92_113_81,r_92_113_81,0.97,4,85,81,80
9,r_67_17_160,seq2,seq112,r_67_17_160,1.0,0,160,160,80
50,seq2,r_75_26_282,r_105_89_224,r_105_89_224,0.62,0,224,224,80
31,r_97_47_79,r_115_4_188,seq54,r_115_4_188,1.0,0,188,188,80
25,r_141_42_52,r_132_96_180,seq116,r_141_42_52,1.0,0,52,52,80
28,r_34_91_163,r_127_24_3,r_39_16_157,r_39_16_157,0.93,6,163,157,80
0,r_19_99_173,r_37_13_209,r_5_46_46,r_5_46_46,1.0,0,46,46,80
43,r_75_26_282,r_126_38_40,r_68_85_84,r_75_26_282,1.0,0,282,282,80
44,r_50_23_237,seq9,r_61_128_183,r_61_128_183,1.0,2,185,183,80
20,r_109_72_51,seq135,seq43,r_109_72_51,1.0,0,51,51,80
7,r_77_74_31,r_27_119_217,seq62,r_77_74_31,0.99,1,32,31,80
12,r_55_130_187,seq100,seq139,r_55_130_187,0.96,0,187,187,80
30,r_39_125_268,r_48_30_217,r_100_66_188,r_100_66_188,1.0,12,200,188,81
36,r_71_85_173,seq0,seq77,r_71_85_173,0.99,0,173,173,81
92,seq114,r_46_22_149,r_117_133_99,r_46_22_149,1.0,-34,115,149,81
14,r_122_1_248,seq65,seq15,r_122_1_248,0.8,0,248,248,81
8,r_88_81_250,seq142,r_4_135_54,r_4_135_54,0.39,62,116,54,81
5,r_103_31_11,seq3,seq86,r_103_31_11,1.0,1,12,11,81
54,seq7,r_100_66_188,r_73_59_64,r_73_59_64,0.87,124,188,64,81
37,r_46_22_149,seq114,seq63,r_46_22_149,0.99,2,151,149,81
86,seq89,r_92_13_114,seq15,r_92_13_114,1.0,0,114,114,81
16,r_141_40_191,seq90,seq77,r_141_40_191,0.99,0,191,191,81
21,r_127_98_223,r_18_91_111,seq17,r_18_91_111,0.95,0,111,111,81
39,r_148_76_92,seq17,seq116,r_148_76_92,0.89,1,93,92,81
25,r_143_107_95,r_95_108_227,r_139_64_172,r_139_64_172,0.94,9,181,172,81
42,r_37_80_228,seq65,r_24_147_213,r_37_80_228,0.97,1,229,228,81
80,seq77,seq3,r_141_40_191,r_141_40_191,0.97,6,197,191,81
19,r_73_59_64,r_117_133_99,seq7,r_73_59_64,1.0,0,64,64,81
33,r_53_132_108,seq114,r_48_30_217,r_48_30_217,0.82,-17,200,217,81
27,r_138_146_166,r_16_58_211,r_53_132_108,r_138_146_166,0.98,0,166,166,81
18,r_10_96_98,r_16_58_211,r_109_34_153,r_10_96_98,0.99,55,153,98,81
31,r_12_111_93,seq129,seq17,r_12_111_93,1.0,0,93,93,81
41,r_57_106_207,seq114,seq65,r_57_106_207,0.63,0,207,207,81
10,r_95_108_227,seq68,r_148_76_92,r_95_108_227,0.3,2,229,227,81
90,seq102,seq35,r_4_135_54,r_4_135_54,0.92,37,91,54,81
85,seq86,r_113_144_296,r_103_31_11,r_103_31_11,0.85,1,12,11,81
26,r_140_27_286,seq82,r_123_72_77,r_123_72_77,0.72,94,171,77,81
8,r_88_81_250,r_4_135_54,seq61,r_88_81_250,0.54,1,251,250,81
11,r_74_54_117,seq63,seq25,r_74_54_117,1.0,0,117,117,81
20,r_93_26_112,seq8,seq6,r_93_26_112,1.0,2,114,112,81
13,r_32_126_214,seq121,seq90,r_32_126_214,0.78,0,214,214,81
98,seq121,r_32_126_214,r_36_20_43,r_36_20_43,1.0,178,221,43,81
15,r_123_72_77,seq17,seq8,r_123_72_77,0.8,1,78,77,81
48,r_2_131_76,r_138_146_166,seq33,r_2_131_76,0.74,1,77,76,81
6,r_16_58_211,r_138_146_166,r_10_96_98,r_10_96_98,1.0,14,112,98,81
62,seq25,seq82,r_74_54_117,r_74_54_117,1.0,17,134,117,81
21,r_127_98_223,seq17,r_140_27_286,r_127_98_223,0.55,-13,210,223,81
27,r_138_146_166,r_74_54_117,r_16_58_211,r_74_54_117,0.96,-49,68,117,81
35,r_130_9_34,r_74_54_117,r_21_149_8,r_21_149_8,1.0,26,34,8,81
30,r_39_125_268,r_100_66_188,r_112_50_238,r_39_125_268,0.76,2,270,268,81
87,seq90,r_141_40_191,seq115,r_141_40_191,1.0,0,191,191,81
2,r_18_91_111,r_127_98_223,r_103_31_11,r_18_91_111,1.0,0,111,111,81
40,r_48_30_217,seq102,r_53_132_108,r_53_132_108,1.0,116,224,108,81
74,seq60,r_112_50_238,seq124,r_112_50_238,1.0,0,238,238,81
18,r_10_96_98,r_43_5_294,r_16_58_211,r_10_96_98,0.83,0,98,98,81
29,r_139_64_172,seq145,r_143_107_95,r_139_64_172,0.97,0,172,172,81
24,r_45_11_274,seq89,r_39_125_268,r_39_125_268,0.55,6,274,268,81
25,r_143_107_95,seq38,r_32_126_214,r_143_107_95,0.78,2,97,95,81
43,r_109_34_153,r_10_96_98,r_46_22_149,r_10_96_98,0.44,156,254,98,81
33,r_53_132_108,seq84,seq114,r_53_132_108,1.0,0,108,108,81
32,r_4_135_54,r_141_40_191,seq102,r_141_40_191,0.98,-133,58,191,81
70,seq42,seq33,r_2_131_76,r_2_131_76,1.0,31,107,76,81
6,r_16_58_211,r_10_96_98,r_36_20_43,r_16_58_211,0.93,2,213,211,81
65,seq33,seq42,r_2_131_76,r_2_131_76,1.0,5,81,76,81
38,r_112_50_238,seq60,seq65,r_112_50_238,0.65,0,238,238,81
34,r_47_110_192,seq65,r_4_135_54,r_47_110_192,0.93,0,192,192,81
45,r_105_41_59,seq38,r_24_147_213,r_24_147_213,1.0,25,238,213,81
9,r_100_66_188,seq7,r_4_135_54,r_100_66_188,1.0,0,188,188,81
25,r_143_107_95,r_32_126_214,r_95_108_227,r_143_107_95,0.53,52,147,95,81
1,r_36_20_43,r_37_80_228,seq28,r_36_20_43,1.0,1,44,43,81
0,r_104_14_46,r_99_49_224,seq82,r_104_14_46,1.0,0,46,46,81
7,r_24_147_213,seq6,r_105_41_59,r_24_147_213,0.99,0,213,213,81
44,r_52_55_101,r_122_1_248,seq82,r_52_55_101,1.0,0,101,101,81
63,seq28,r_32_126_214,r_36_20_43,r_36_20_43,1.0,14,57,43,81
84,seq84,r_53_132_108,seq3,r_53_132_108,1.0,-1,107,108,81
3,r_51_87_37,r_105_41_59,seq129,r_51_87_37,1.0,1,38,37,81
36,r_91_94_146,r_105_106_292,seq97,r_91_94_146,0.77,0,146,146,82
9,r_78_66_248,r_96_146_80,r_138_147_218,r_138_147_218,0.98,6,224,218,82
14,r_11_17_115,r_2_13_291,seq53,r_11_17_115,1.0,0,115,115,82
8,r_30_108_268,r_27_77_161,r_91_94_146,r_27_77_161,0.4,107,268,161,82
53,seq6,r_78_66_248,r_96_146_80,r_96_146_80,1.0,47,127,80,82
43,r_69_52_123,seq14,seq50,r_69_52_123,1.0,0,123,123,82
37,r_81_110_241,r_2_13_291,r_27_77_161,r_81_110_241,0.46,0,241,241,82
71,seq53,r_122_1_128,r_11_17_115,r_11_17_115,1.0,21,136,115,82
16,r_22_33_11,r_76_114_270,r_79_87_214,r_22_33_11,0.52,259,270,11,82
21,r_139_36_122,seq145,seq18,r_139_36_122,1.0,0,122,122,82
39,r_129_141_200,r_54_59_240,seq103,r_129_141_200,0.67,0,200,200,82
1,r_115_35_89,r_76_114_270,seq14,r_115_35_89,1.0,0,89,89,82
5,r_124_95_282,seq145,r_78_66_248,r_124_95_282,0.41,0,282,282,82
0,r_96_146_80,seq6,r_138_147_218,r_96_146_80,0.55,192,272,80,82
49,r_102_49_48,r_10_12_298,seq37,r_102_49_48,1.0,0,48,48,82
69,seq50,r_72_120_255,r_140_73_20,r_140_73_20,0.79,235,255,20,82
45,r_57_42_210,seq88,r_86_149_55,r_86_149_55,0.96,156,211,55,82
9,r_78_66_248,r_138_147_218,seq74,r_78_66_248,0.4,0,248,248,82
19,r_134_85_199,seq58,r_46_98_194,r_46_98_194,0.96,9,203,194,82
31,r_127_32_96,seq145,r_22_33_11,r_127_32_96,1.0,0,96,96,82
41,r_104_116_186,seq43,seq19,r_104_116_186,0.96,0,186,186,82
10,r_76_114_270,r_22_33_11,r_139_36_122,r_76_114_270,0.42,0,270,270,82
26,r_2_13_291,r_81_110_241,r_113_4_27,r_2_13_291,0.53,-50,241,291,82
46,r_138_147_218,r_78_66_248,r_16_136_108,r_78_66_248,0.88,0,248,248,82
11,r_86_149_55,r_104_116_186,seq64,r_86_149_55,1.0,0,55,55,82
4,r_113_4_27,r_2_13_291,r_144_25_247,r_144_25_247,0.93,22,269,247,82
0,r_96_146_80,r_62_117_118,r_78_66_248,r_96_146_80,1.0,1,81,80,82
20,r_40_24_181,r_144_25_247,r_48_47_58,r_40_24_181,0.63,0,181,181,82
13,r_48_47_58,seq83,seq128,r_48_47_58,0.71,2,60,58,82
48,r_135_5_278,seq18,r_82_0_95,r_82_0_95,0.75,183,278,95,82
13,r_48_47_58,seq128,r_40_24_181,r_40_24_181,1.0,9,190,181,82
6,r_15_38_164,r_76_114_270,seq65,r_15_38_164,0.9,0,164,164,82
62,seq29,r_45_23_203,r_122_1_128,r_45_23_203,0.99,0,203,203,82
0,r_96_146_80,r_78_66_248,seq6,r_78_66_248,0.76,-24,224,248,82
42,r_92_143_17,seq74,r_71_112_139,r_92_143_17,0.87,0,17,17,82
30,r_137_44_29,r_30_108_268,seq133,r_137_44_29,1.0,0,29,29,82
53,seq6,r_96_146_80,r_138_147_218,r_138_147_218,1.0,35,253,218,82
38,r_140_73_20,seq39,seq50,r_140_73_20,1.0,0,20,20,82
65,seq37,seq51,r_102_49_48,r_102_49_48,1.0,0,48,48,82
2,r_79_87_214,seq103,r_22_33_11,r_79_87_214,0.5,0,214,214,82
18,r_9_99_140,seq55,r_140_73_20,r_9_99_140,0.56,0,140,140,82
29,r_130_7_228,r_135_5_278,seq107,r_130_7_228,0.78,0,228,228,82
24,r_10_12_298,r_22_33_11,r_67_100_162,r_67_100_162,1.0,15,177,162,82
25,r_82_0_95,r_129_141_200,seq19,r_82_0_95,0.96,0,95,95,82
33,r_16_136_108,seq132,seq89,r_16_136_108,0.98,0,108,108,82
58,seq19,r_2_13_291,r_82_0_95,r_82_0_95,0.99,0,95,95,82
68,seq43,r_104_116_186,seq101,r_104_116_186,1.0,0,186,186,82
32,r_54_59_240,r_72_120_255,r_40_24_181,r_40_24_181,0.89,58,239,181,82
34,r_46_98_194,seq103,r_134_85_199,r_46_98_194,0.87,0,194,194,82
60,seq21,seq93,r_119_90_264,r_119_90_264,0.57,3,267,264,82
9,r_78_66_248,seq6,r_96_146_80,r_96_146_80,1.0,4,84,80,82
28,r_75_125_159,r_76_114_270,seq101,r_75_125_159,1.0,0,159,159,82
91,seq148,seq58,r_28_131_51,r_28_131_51,1.0,109,160,51,82
56,seq145,r_124_95_282,r_144_25_247,r_144_25_247,0.82,0,247,247,82
7,r_71_112_139,seq107,r_92_143_17,r_92_143_17,0.95,130,147,17,82
23,r_144_25_247,seq97,seq145,r_144_25_247,0.82,1,248,247,82
27,r_3_123_41,seq14,seq88,r_3_123_41,0.95,0,41,41,82
79,seq65,r_105_106_292,r_15_38_164,r_15_38_164,1.0,0,164,164,82
35,r_67_100_162,seq83,r_10_12_298,r_67_100_162,0.97,2,164,162,82
12,r_62_117_118,seq8,seq84,r_62_117_118,1.0,1,119,118,82
93,seq107,r_97_2_101,r_129_23_103,r_129_23_103,1.0,0,103,103,83
30,r_4_148_128,r_93_15_180,r_104_8_47,r_4_148_128,0.85,3,131,128,83
36,r_64_39_152,seq11,r_69_132_281,r_69_132_281,0.88,-123,158,281,83
8,r_143_105_100,r_97_2_101,seq46,r_143_105_100,1.0,0,100,100,83
43,r_101_40_119,r_86_147_210,r_100_0_116,r_101_40_119,1.0,2,121,119,83
54,seq12,r_106_21_286,r_130_51_273,r_106_21_286,0.13,2,288,286,83
83,seq135,r_86_147_210,seq103,r_86_147_210,0.97,-4,206,210,83
37,r_121_1_107,seq56,seq62,r_121_1_107,0.47,25,132,107,83
3,r_49_119_285,r_85_47_110,r_100_0_116,r_85_47_110,0.43,175,285,110,83
49,r_125_133_54,r_72_108_169,r_131_45_178,r_125_133_54,1.0,1,55,54,83
39,r_141_139_283,seq79,r_17_48_108,r_17_48_108,0.77,175,283,108,83
1,r_100_0_116,seq24,r_129_23_103,r_100_0_116,1.0,0,116,116,83
5,r_28_137_77,r_126_123_118,seq73,r_28_137_77,1.0,0,77,77,83
46,r_96_118_63,r_145_13_153,r_126_123_118,r_96_118_63,0.73,1,64,63,83
42,r_131_45_178,r_124_122_202,r_14_66_69,r_14_66_69,1.0,0,69,69,83
19,r_16_127_117,r_49_119_285,r_96_118_63,r_16_127_117,0.98,0,117,117,83
34,r_5_136_27,r_98_60_292,seq7,r_5_136_27,1.0,0,27,27,83
27,r_145_13_153,r_112_68_67,r_4_148_128,r_145_13_153,0.51,0,153,153,83
95,seq110,r_17_48_108,seq67,r_17_48_108,1.0,0,108,108,83
38,r_87_76_251,r_112_68_67,r_20_128_75,r_87_76_251,0.68,4,255,251,83
31,r_93_15_180,seq37,r_14_66_69,r_93_15_180,0.93,1,181,180,83
41,r_112_68_67,r_18_89_293,r_145_13_153,r_112_68_67,0.94,0,67,67,83
23,r_84_52_186,r_85_47_110,r_33_114_20,r_33_114_20,0.81,6,26,20,83
30,r_4_148_128,r_104_8_47,r_145_13_153,r_145_13_153,0.89,17,170,153,83
3,r_49_119_285,r_16_127_117,r_85_47_110,r_49_119_285,0.98,-168,117,285,83
10,r_126_123_118,r_28_137_77,r_96_118_63,r_126_123_118,0.96,-41,77,118,83
25,r_71_61_45,r_28_137_77,seq140,r_71_61_45,0.92,0,45,45,83
50,seq7,seq24,r_5_136_27,r_5_136_27,1.0,2,29,27,83
80,seq70,r_72_108_169,r_26_38_13,r_72_108_169,0.7,-123,46,169,83
26,r_129_23_103,r_126_123_118,seq107,r_129_23_103,0.56,0,103,103,83
86,seq83,r_6_115_49,r_126_123_118,r_6_115_49,0.63,-6,43,49,83
0,r_130_51_273,seq92,seq11,r_130_51_273,0.2,0,273,273,83
11,r_74_59_124,seq43,r_104_8_47,r_74_59_124,0.89,1,125,124,83
20,r_90_30_171,r_106_21_286,seq24,r_90_30_171,1.0,0,171,171,83
15,r_17_48_108,seq110,seq144,r_17_48_108,1.0,0,108,108,83
48,r_106_21_286,seq12,r_134_57_203,r_134_57_203,0.75,85,288,203,83
49,r_125_133_54,r_131_45_178,r_14_66_69,r_131_45_178,0.74,-30,148,178,83
4,r_33_114_20,r_84_52_186,seq144,r_84_52_186,0.8,1,187,186,83
6,r_97_2_101,r_143_105_100,seq67,r_143_105_100,1.0,2,102,100,83
21,r_72_108_169,r_26_38_13,seq109,r_72_108_169,1.0,0,169,169,83
9,r_26_38_13,r_29_55_14,seq70,r_26_38_13,0.97,0,13,13,83
27,r_145_13_153,r_96_118_63,r_112_68_67,r_145_13_153,0.96,-89,64,153,83
26,r_129_23_103,seq107,r_100_0_116,r_100_0_116,1.0,14,130,116,83
41,r_112_68_67,r_145_13_153,seq138,r_145_13_153,0.99,-5,148,153,83
47,r_81_77_255,r_124_122_202,seq138,r_124_122_202,0.7,-93,109,202,83
18,r_104_8_47,r_131_45_178,r_96_118_63,r_131_45_178,0.96,-111,67,178,83
29,r_85_47_110,seq144,r_49_119_285,r_85_47_110,0.98,0,110,110,83
24,r_124_122_202,r_130_51_273,seq12,r_124_122_202,0.65,0,202,202,83
46,r_96_118_63,r_126_123_118,r_16_127_117,r_126_123_118,0.92,-3,115,118,83
33,r_95_149_165,seq109,seq67,r_95_149_165,1.0,1,166,165,83
47,r_81_77_255,seq138,r_33_114_20,r_81_77_255,0.5,-1,254,255,83
88,seq92,r_130_51_273,r_14_66_69,r_14_66_69,1.0,204,273,69,83
21,r_72_108_169,r_125_133_54,r_26_38_13,r_125_133_54,1.0,1,55,54,83
10,r_126_123_118,r_96_118_63,seq142,r_126_123_118,1.0,0,118,118,83
65,seq37,r_93_15_180,r_26_38_13,r_93_15_180,0.49,-43,137,180,83
68,seq43,r_74_59_124,seq62,r_74_59_124,0.9,1,125,124,83
42,r_131_45_178,r_14_66_69,seq7,r_131_45_178,1.0,2,180,178,83
32,r_113_80_265,seq135,r_33_114_20,r_33_114_20,0.5,246,266,20,83
38,r_87_76_251,r_130_51_273,r_112_68_67,r_112_68_67,1.0,45,112,67,83
76,seq138,r_81_77_255,r_84_52_186,r_84_52_186,0.6,10,196,186,83
4,r_33_114_20,seq19,r_84_52_186,r_33_114_20,0.98,0,20,20,83
51,seq9,r_141_139_283,r_6_115_49,r_6_115_49,1.0,1,50,49,83
14,r_88_78_28,seq73,seq79,r_88_78_28,1.0,0,28,28,83
17,r_86_147_210,seq135,seq11,r_86_147_210,0.84,0,210,210,83
94,seq109,r_49_119_285,r_72_108_169,r_72_108_169,1.0,8,177,169,83
13,r_6_115_49,r_124_122_202,seq9,r_6_115_49,1.0,0,49,49,83
29,r_85_47_110,r_49_119_285,r_72_108_169,r_72_108_169,1.0,116,285,169,83
22,r_14_66_69,r_134_57_203,r_125_133_54,r_14_66_69,0.95,0,69,69,83
28,r_20_128_75,r_121_1_107,seq34,r_20_128_75,0.94,4,79,75,83
7,r_134_57_203,seq67,r_112_68_67,r_134_57_203,0.97,1,204,203,83
18,r_104_8_47,r_96_118_63,r_74_59_124,r_74_59_124,1.0,20,144,124,83
41,r_112_68_67,seq138,r_134_57_203,r_134_57_203,1.0,14,217,203,83
79,seq67,r_134_57_203,r_97_2_101,r_134_57_203,0.99,1,204,203,83
12,r_31_146_213,r_113_80_265,seq54,r_31_146_213,0.61,4,217,213,83
23,r_84_52_186,r_33_114_20,seq138,r_84_52_186,0.95,1,187,186,83
84,seq79,r_141_139_283,r_88_78_28,r_88_78_28,1.0,255,283,28,83
40,r_25_88_43,seq132,r_11_41_164,r_11_41_164,1.0,-2,162,164,84
30,r_52_110_196,seq89,seq111,r_52_110_196,0.97,0,196,196,84
40,r_25_88_43,r_48_98_216,seq132,r_25_88_43,1.0,0,43,43,84
36,r_104_117_211,seq125,r_11_41_164,r_104_117_211,0.72,0,211,211,84
14,r_149_138_180,seq51,r_16_40_68,r_149_138_180,0.92,0,180,180,84
8,r_95_35_152,seq132,seq62,r_95_35_152,0.99,0,152,152,84
43,r_118_131_144,seq1,seq128,r_118_131_144,1.0,0,144,144,84
83,seq80,seq71,r_106_28_118,r_106_28_118,1.0,3,121,118,84
37,r_11_41_164,r_102_20_287,r_25_88_43,r_11_41_164,0.98,0,164,164,84
46,r_109_74_25,r_53_129_246,seq73,r_109_74_25,0.96,0,25,25,84
2,r_29_116_58,r_8_18_286,r_36_124_32,r_29_116_58,0.99,0,58,58,84
23,r_36_124_32,seq73,seq140,r_36_124_32,0.99,0,32,32,84
16,r_70_92_205,seq24,r_76_46_11,r_70_92_205,0.94,0,205,205,84
21,r_2_23_160,seq27,seq51,r_2_23_160,1.0,1,161,160,84
1,r_56_37_73,r_21_99_94,r_36_124_32,r_36_124_32,1.0,41,73,32,84
97,seq122,r_106_28_118,seq27,r_106_28_118,0.99,1,119,118,84
5,r_33_126_99,seq75,seq50,r_33_126_99,0.99,0,99,99,84
42,r_91_115_297,r_31_86_289,r_48_98_216,r_48_98_216,0.79,73,289,216,84
45,r_53_129_246,r_119_19_227,r_7_39_271,r_7_39_271,1.0,1,272,271,84
15,r_147_97_42,r_84_26_77,r_109_74_25,r_147_97_42,1.0,0,42,42,84
19,r_48_98_216,seq145,r_91_115_297,r_48_98_216,0.54,6,222,216,84
33,r_82_57_165,r_53_129_246,seq142,r_53_129_246,1.0,-10,236,246,84
11,r_96_15_22,r_17_5_174,seq89,r_96_15_22,0.94,0,22,22,84
11,r_96_15_22,seq89,r_0_63_147,r_0_63_147,0.99,72,219,147,84
9,r_84_26_77,seq146,r_113_64_81,r_113_64_81,0.87,27,108,81,84
97,seq122,seq27,r_48_98_216,r_48_98_216,0.62,30,246,216,84
31,r_69_108_276,seq89,seq90,r_69_108_276,0.52,-3,273,276,84
41,r_7_39_271,r_31_86_289,r_53_129_246,r_7_39_271,0.54,0,271,271,84
3,r_34_141_137,seq94,r_134_101_85,r_34_141_137,1.0,0,137,137,84
10,r_0_63_147,r_70_92_205,seq12,r_0_63_147,0.98,0,147,147,84
26,r_85_3_157,seq77,seq50,r_85_3_157,1.0,0,157,157,84
77,seq71,r_56_37_73,seq80,r_56_37_73,1.0,-19,54,73,84
4,r_78_65_90,seq146,seq93,r_78_65_90,1.0,0,90,90,84
0,r_42_59_214,seq77,r_34_141_137,r_34_141_137,1.0,79,216,137,84
63,seq24,r_70_92_205,seq87,r_70_92_205,1.0,0,205,205,84
20,r_113_64_81,seq107,r_84_26_77,r_113_64_81,1.0,-1,80,81,84
48,r_31_86_289,r_91_115_297,r_70_92_205,r_70_92_205,0.87,84,289,205,84
57,seq12,seq89,r_0_63_147,r_0_63_147,1.0,0,147,147,84
9,r_84_26_77,seq123,seq146,r_84_26_77,1.0,0,77,77,84
6,r_106_28_118,seq122,seq80,r_106_28_118,1.0,1,119,118,84
85,seq83,seq55,r_95_35_152,r_95_35_152,1.0,51,203,152,84
9,r_84_26_77,r_147_97_42,seq123,r_147_97_42,0.98,-7,35,42,84
27,r_134_101_85,r_61_32_258,seq145,r_134_101_85,0.76,-3,82,85,84
35,r_43_120_48,r_56_37_73,seq73,r_43_120_48,1.0,0,48,48,84
69,seq50,seq9,r_85_3_157,r_85_3_157,1.0,6,163,157,84
74,seq140,seq55,r_29_116_58,r_29_116_58,1.0,20,78,58,84
29,r_16_40_68,seq66,r_4_137_8,r_16_40_68,1.0,0,68,68,84
23,r_36_124_32,seq140,r_56_37_73,r_56_37_73,1.0,17,90,73,84
24,r_119_19_227,seq128,seq123,r_119_19_227,0.53,0,227,227,84
34,r_61_32_258,seq125,r_14_144_1,r_61_32_258,0.82,-1,257,258,84
25,r_105_135_248,seq27,r_95_35_152,r_105_135_248,0.81,2,250,248,84
33,r_82_57_165,seq93,r_53_129_246,r_82_57_165,0.6,0,165,165,84
76,seq66,r_16_40_68,seq9,r_16_40_68,1.0,-9,59,68,84
64,seq27,r_2_23_160,r_105_135_248,r_2_23_160,1.0,1,161,160,84
32,r_38_67_113,r_48_98_216,seq6,r_38_67_113,1.0,1,114,113,84
38,r_44_121_125,r_102_20_287,seq6,r_44_121_125,1.0,0,125,125,84
34,r_61_32_258,r_134_101_85,seq125,r_134_101_85,1.0,-7,78,85,84
46,r_109_74_25,seq73,r_147_97_42,r_147_97_42,1.0,33,75,42,84
81,seq77,r_42_59_214,r_70_92_205,r_70_92_205,0.99,13,218,205,84
17,r_102_20_287,r_44_121_125,seq62,r_44_121_125,1.0,0,125,125,84
29,r_16_40_68,r_4_137_8,r_149_138_180,r_149_138_180,1.0,4,184,180,84
22,r_4_137_8,seq103,r_16_40_68,r_16_40_68,1.0,0,68,68,84
79,seq73,seq133,r_43_120_48,r_43_120_48,1.0,1,49,48,84
28,r_21_99_94,seq71,seq62,r_21_99_94,1.0,0,94,94,84
49,r_13_127_204,seq6,r_0_63_147,r_13_127_204,1.0,1,205,204,84
44,r_60_143_156,seq128,r_34_141_137,r_60_143_156,0.92,0,156,156,84
17,r_102_20_287,seq62,r_42_59_214,r_102_20_287,0.32,0,287,287,84
12,r_8_18_286,seq145,r_106_28_118,r_106_28_118,0.92,168,286,118,84
93,seq105,r_5_83_176,r_19_73_133,r_19_73_133,0.99,57,190,133,85
30,r_88_90_210,r_117_45_161,r_135_6_33,r_117_45_161,0.76,2,163,161,85
20,r_135_6_33,r_82_102_106,seq22,r_82_102_106,0.69,-69,37,106,85
30,r_88_90_210,r_135_6_33,r_41_21_101,r_88_90_210,0.81,0,210,210,85
8,r_79_24_211,seq148,r_27_145_96,r_79_24_211,0.84,1,212,211,85
43,r_40_109_150,seq72,seq42,r_40_109_150,1.0,0,150,150,85
45,r_46_29_10,r_27_145_96,seq94,r_46_29_10,0.99,0,10,10,85
37,r_92_49_125,seq118,seq133,r_92_49_125,0.93,2,127,125,85
59,seq143,r_98_110_282,r_4_139_67,r_4_139_67,1.0,10,77,67,85
13,r_132_97_103,r_66_76_156,r_147_85_134,r_132_97_103,0.56,53,156,103,85
16,r_113_39_124,r_124_56_62,seq64,r_124_56_62,1.0,0,62,62,85
39,r_107_114_173,seq14,r_112_17_8,r_112_17_8,0.57,88,96,8,85
1,r_81_96_83,seq47,seq72,r_81_96_83,1.0,1,84,83,85
5,r_124_56_62,r_113_39_124,seq131,r_124_56_62,1.0,0,62,62,85
46,r_140_95_85,seq103,r_55_33_52,r_55_33_52,1.0,57,109,52,85
42,r_71_3_239,seq53,r_81_96_83,r_81_96_83,1.0,155,238,83,85
69,seq47,r_81_96_83,r_140_95_85,r_81_96_83,0.76,1,84,83,85
24,r_111_104_208,r_41_21_101,seq25,r_111_104_208,1.0,0,208,208,85
33,r_41_21_101,seq47,r_88_90_210,r_88_90_210,0.98,9,219,210,85
77,seq64,r_23_144_294,r_77_122_271,r_23_144_294,0.47,-22,272,294,85
27,r_52_57_15,r_120_101_247,r_26_136_92,r_26_136_92,0.95,155,247,92,85
66,seq37,r_99_50_229,r_15_62_73,r_15_62_73,0.99,156,229,73,85
14,r_82_102_106,r_135_6_33,r_126_146_30,r_126_146_30,0.96,7,37,30,85
39,r_107_114_173,r_112_17_8,r_117_45_161,r_107_114_173,1.0,0,173,173,85
41,r_66_76_156,seq18,seq138,r_66_76_156,1.0,0,156,156,85
31,r_120_101_247,seq91,r_52_57_15,r_52_57_15,1.0,6,21,15,85
3,r_98_110_282,seq143,r_78_1_169,r_98_110_282,0.38,0,282,282,85
90,seq94,r_2_106_270,r_46_29_10,r_46_29_10,0.52,181,191,10,85
26,r_43_16_94,seq131,seq72,r_43_16_94,1.0,0,94,94,85
16,r_113_39_124,seq64,seq74,r_113_39_124,1.0,-4,120,124,85
27,r_52_57_15,seq28,r_120_101_247,r_52_57_15,1.0,0,15,15,85
14,r_82_102_106,r_126_146_30,seq118,r_82_102_106,1.0,1,107,106,85
4,r_2_106_270,seq94,r_9_141_60,r_9_141_60,1.0,131,191,60,85
0,r_26_136_92,seq22,r_52_57_15,r_26_136_92,0.96,0,92,92,85
63,seq25,r_9_141_60,seq13,r_9_141_60,1.0,0,60,60,85
11,r_78_1_169,seq63,seq51,r_78_1_169,0.83,0,169,169,85
13,r_132_97_103,seq129,r_66_76_156,r_132_97_103,0.73,1,104,103,85
48,r_119_68_128,r_117_45_161,r_112_17_8,r_119_68_128,0.99,0,128,128,85
28,r_126_146_30,seq105,r_19_73_133,r_19_73_133,0.98,26,159,133,85
4,r_2_106_270,r_9_141_60,r_112_17_8,r_2_106_270,0.9,0,270,270,85
62,seq22,r_26_136_92,r_135_6_33,r_26_136_92,1.0,0,92,92,85
25,r_55_33_52,seq72,r_140_95_85,r_55_33_52,1.0,-1,51,52,85
2,r_15_62_73,seq103,seq8,r_15_62_73,1.0,1,74,73,85
47,r_9_141_60,seq25,r_46_29_10,r_9_141_60,0.99,0,60,60,85
40,r_147_85_134,r_111_104_208,r_132_97_103,r_132_97_103,0.62,31,134,103,85
18,r_4_139_67,seq36,seq143,r_4_139_67,1.0,3,70,67,85
29,r_34_130_151,r_23_144_294,r_112_17_8,r_34_130_151,1.0,0,151,151,85
24,r_111_104_208,r_147_85_134,r_41_21_101,r_111_104_208,0.72,-72,136,208,85
33,r_41_21_101,seq93,seq47,r_41_21_101,1.0,1,102,101,85
65,seq36,r_86_80_257,r_19_73_133,r_19_73_133,0.68,20,153,133,85
28,r_126_146_30,seq42,r_82_102_106,r_126_146_30,1.0,0,30,30,85
88,seq91,r_120_101_247,r_26_136_92,r_26_136_92,0.87,4,96,92,85
65,seq36,r_4_139_67,r_86_80_257,r_4_139_67,1.0,3,70,67,85
61,seq20,seq131,r_5_83_176,r_5_83_176,0.98,-2,174,176,85
32,r_44_12_84,seq131,seq28,r_44_12_84,0.97,1,85,84,85
38,r_19_73_133,seq121,seq36,r_19_73_133,1.0,0,133,133,85
77,seq64,r_113_39_124,r_23_144_294,r_113_39_124,0.83,-3,121,124,85
71,seq51,seq93,r_78_1_169,r_78_1_169,1.0,12,181,169,85
34,r_117_45_161,r_88_90_210,r_107_114_173,r_117_45_161,0.99,12,173,161,85
75,seq61,r_30_128_218,seq13,r_30_128_218,1.0,0,218,218,85
45,r_46_29_10,seq94,r_9_141_60,r_9_141_60,1.0,138,198,60,85
17,r_99_50_229,seq37,r_19_73_133,r_99_50_229,0.78,0,229,229,85
22,r_123_60_28,seq72,seq93,r_123_60_28,0.96,0,28,28,85
9,r_77_122_271,seq48,seq64,r_77_122_271,0.27,1,272,271,85
96,seq118,r_92_49_125,r_82_102_106,r_82_102_106,0.61,21,127,106,85
31,r_120_101_247,r_52_57_15,r_99_50_229,r_52_57_15,0.83,232,247,15,85
28,r_126_146_30,r_82_102_106,seq105,r_82_102_106,1.0,1,107,106,85
49,r_32_31_233,r_23_144_294,seq63,r_32_31_233,0.75,0,233,233,85
69,seq47,r_140_95_85,r_41_21_101,r_41_21_101,0.99,2,103,101,85
7,r_75_149_196,r_77_122_271,seq74,r_75_149_196,0.73,1,197,196,85
23,r_86_80_257,seq36,r_27_145_96,r_86_80_257,0.74,0,257,257,85
35,r_59_0_61,r_111_104_208,seq93,r_59_0_61,1.0,0,61,61,85
12,r_5_83_176,r_86_80_257,seq20,r_5_83_176,0.75,2,178,176,85
19,r_100_35_57,r_30_128_218,seq42,r_100_35_57,0.68,0,57,57,85
30,r_33_29_122,seq116,seq65,r_33_29_122,1.0,0,122,122,86
14,r_63_18_213,seq90,seq80,r_63_18_213,0.91,0,213,213,86
8,r_109_99_228,seq20,seq31,r_109_99_228,0.63,5,233,228,86
43,r_77_34_206,seq72,seq120,r_77_34_206,0.74,1,207,206,86
37,r_54_139_266,seq81,r_11_38_154,r_11_38_154,0.98,113,267,154,86
21,r_16_141_172,seq80,r_106_144_117,r_16_141_172,0.93,0,172,172,86
39,r_145_91_197,seq89,seq65,r_145_91_197,0.9,1,198,197,86
97,seq120,seq43,r_77_34_206,r_77_34_206,1.0,2,208,206,86
5,r_84_3_149,seq45,r_68_58_193,r_68_58_193,1.0,2,195,193,86
5,r_84_3_149,r_11_38_154,seq45,r_84_3_149,0.86,0,149,149,86
46,r_8_42_89,seq31,seq39,r_8_42_89,1.0,1,90,89,86
42,r_56_137_248,r_53_83_246,seq135,r_53_83_246,0.64,2,248,246,86
7,r_104_48_211,r_126_110_81,seq102,r_104_48_211,0.99,1,212,211,86
11,r_27_95_19,r_124_112_157,seq19,r_27_95_19,1.0,0,19,19,86
19,r_46_10_254,seq12,r_145_91_197,r_46_10_254,0.53,0,254,254,86
18,r_2_17_12,r_124_112_157,seq22,r_2_17_12,0.85,0,12,12,86
31,r_148_51_60,r_111_25_233,r_60_97_280,r_148_51_60,0.99,0,60,60,86
41,r_73_1_192,seq41,seq133,r_73_1_192,0.94,0,192,192,86
67,seq31,r_11_38_154,seq40,r_11_38_154,1.0,0,154,154,86
67,seq31,seq40,r_109_99_228,r_109_99_228,1.0,37,265,228,86
10,r_11_38_154,seq31,seq117,r_11_38_154,1.0,0,154,154,86
36,r_125_134_26,seq19,r_60_97_280,r_125_134_26,0.98,0,26,26,86
72,seq41,r_73_1_192,r_119_129_190,r_73_1_192,0.84,0,192,192,86
78,seq72,r_128_69_163,seq41,r_128_69_163,0.86,-17,146,163,86
73,seq43,r_78_70_232,seq120,r_78_70_232,1.0,-6,226,232,86
20,r_26_113_205,seq89,r_98_127_52,r_26_113_205,0.82,0,205,205,86
15,r_21_100_160,r_53_83_246,r_98_127_52,r_21_100_160,1.0,0,160,160,86
48,r_75_140_218,seq143,r_33_29_122,r_75_140_218,0.97,0,218,218,86
12,r_98_127_52,seq90,r_21_100_160,r_21_100_160,1.0,15,175,160,86
13,r_92_0_7,seq117,seq118,r_92_0_7,0.42,117,124,7,86
6,r_119_129_190,seq20,seq41,r_119_129_190,0.43,-100,90,190,86
85,seq89,r_26_113_205,r_103_66_67,r_103_66_67,0.91,109,176,67,86
27,r_78_70_232,seq43,r_49_61_134,r_78_70_232,0.48,0,232,232,86
2,r_124_112_157,seq118,seq116,r_124_112_157,0.7,0,157,157,86
29,r_103_66_67,seq22,seq89,r_103_66_67,1.0,1,68,67,86
35,r_126_110_81,r_104_48_211,r_128_69_163,r_104_48_211,1.0,1,212,211,86
25,r_59_147_166,r_53_83_246,r_124_112_157,r_53_83_246,1.0,-80,166,246,86
33,r_60_97_280,r_68_58_193,r_125_134_26,r_60_97_280,0.94,-227,53,280,86
58,seq143,r_75_140_218,r_4_36_168,r_75_140_218,1.0,-10,208,218,86
70,seq39,r_126_110_81,seq101,r_126_110_81,1.0,-1,80,81,86
32,r_5_96_179,seq88,seq143,r_5_96_179,0.96,0,179,179,86
38,r_132_85_62,r_24_142_223,seq86,r_132_85_62,0.99,0,62,62,86
52,seq133,seq65,r_73_1_192,r_73_1_192,0.99,21,213,192,86
34,r_37_82_3,r_53_83_246,r_24_142_223,r_24_142_223,0.98,15,238,223,86
12,r_98_127_52,r_73_1_192,seq90,r_98_127_52,1.0,1,53,52,86
17,r_106_144_117,seq117,r_105_6_6,r_106_144_117,1.0,0,117,117,86
9,r_94_13_260,r_114_15_294,seq136,r_114_15_294,0.63,-33,261,294,86
22,r_49_61_134,r_11_38_154,seq90,r_11_38_154,0.96,-20,134,154,86
28,r_105_6_6,r_67_52_270,r_106_144_117,r_106_144_117,1.0,13,130,117,86
49,r_79_50_125,r_26_113_205,r_55_71_98,r_79_50_125,0.99,0,125,125,86
7,r_104_48_211,seq20,r_126_110_81,r_126_110_81,1.0,9,90,81,86
44,r_24_142_223,seq115,r_37_82_3,r_24_142_223,0.52,0,223,223,86
23,r_67_52_270,r_105_6_6,r_11_38_154,r_105_6_6,0.51,264,270,6,86
75,seq45,seq19,r_68_58_193,r_68_58_193,1.0,48,241,193,86
35,r_126_110_81,seq39,r_104_48_211,r_126_110_81,1.0,0,81,81,86
81,seq80,r_2_17_12,r_63_18_213,r_63_18_213,0.99,2,215,213,86
84,seq88,r_5_96_179,r_128_69_163,r_5_96_179,1.0,0,179,179,86
93,seq101,seq4,r_122_140_173,r_122_140_173,1.0,24,197,173,87
51,seq1,r_52_51_128,seq69,r_52_51_128,0.59,9,137,128,87
36,r_52_51_128,seq1,seq124,r_52_51_128,0.86,0,128,128,87
14,r_116_123_126,seq69,seq97,r_116_123_126,0.99,0,126,126,87
8,r_71_24_175,r_6_108_165,r_5_117_149,r_5_117_149,0.99,27,176,149,87
43,r_125_67_104,seq33,r_91_39_109,r_125_67_104,0.84,0,104,104,87
37,r_122_140_173,seq29,seq101,r_122_140_173,1.0,1,174,173,87
16,r_149_96_228,seq99,r_106_45_87,r_149_96_228,0.96,0,228,228,87
39,r_30_148_100,r_3_100_1,r_18_85_18,r_30_148_100,0.6,-39,61,100,87
1,r_43_2_248,r_87_58_274,r_109_83_156,r_43_2_248,0.62,2,250,248,87
46,r_10_66_68,seq63,seq80,r_10_66_68,1.0,-1,67,68,87
24,r_15_111_252,r_115_35_61,seq101,r_115_35_61,0.48,191,252,61,87
19,r_87_58_274,r_43_2_248,seq22,r_43_2_248,0.9,2,250,248,87
15,r_16_26_55,seq139,r_5_117_149,r_5_117_149,1.0,2,151,149,87
11,r_95_41_133,r_18_85_18,seq14,r_95_41_133,0.6,76,209,133,87
38,r_113_131_6,r_84_86_213,seq46,r_84_86_213,0.87,0,213,213,87
31,r_119_137_110,seq72,seq1,r_119_137_110,0.87,1,111,110,87
41,r_9_138_216,seq120,seq74,r_9_138_216,0.77,0,216,216,87
67,seq46,r_44_121_283,r_113_131_6,r_113_131_6,0.59,119,125,6,87
42,r_21_127_25,seq144,r_141_132_30,r_21_127_25,1.0,0,25,25,87
10,r_70_61_171,seq0,seq104,r_70_61_171,0.91,0,171,171,87
26,r_98_27_182,seq32,seq46,r_98_27_182,0.98,0,182,182,87
4,r_40_77_273,seq147,r_82_60_107,r_82_60_107,1.0,166,273,107,87
45,r_59_37_34,r_40_77_273,seq32,r_59_37_34,1.0,1,35,34,87
11,r_95_41_133,r_81_11_296,r_18_85_18,r_95_41_133,0.5,16,149,133,87
3,r_103_107_13,r_52_51_128,seq22,r_103_107_13,0.44,0,13,13,87
20,r_109_83_156,seq97,seq36,r_109_83_156,0.45,7,163,156,87
13,r_81_11_296,r_95_41_133,r_106_45_87,r_81_11_296,0.87,-151,145,296,87
98,seq120,r_9_138_216,r_12_53_28,r_12_53_28,0.76,188,216,28,87
15,r_16_26_55,seq69,seq139,r_16_26_55,1.0,0,55,55,87
48,r_13_135_60,seq22,seq48,r_13_135_60,1.0,0,60,60,87
49,r_84_86_213,r_113_131_6,r_3_100_1,r_84_86_213,0.97,0,213,213,87
6,r_82_60_107,r_40_77_273,r_42_146_112,r_82_60_107,1.0,6,113,107,87
99,seq124,r_5_117_149,r_52_51_128,r_5_117_149,0.6,-1,148,149,87
5,r_141_132_30,r_7_118_82,r_21_127_25,r_141_132_30,0.99,2,32,30,87
21,r_134_20_19,r_13_135_60,seq55,r_134_20_19,0.62,-1,18,19,87
2,r_91_39_109,r_34_114_251,r_125_67_104,r_91_39_109,1.0,1,110,109,87
47,r_115_35_61,r_10_66_68,r_15_111_252,r_115_35_61,0.9,3,64,61,87
40,r_106_45_87,seq139,r_81_11_296,r_106_45_87,0.9,6,93,87,87
29,r_64_105_86,r_78_75_150,r_136_133_21,r_64_105_86,0.57,19,105,86,87
19,r_87_58_274,seq22,seq90,r_87_58_274,0.68,4,278,274,87
24,r_15_111_252,r_42_146_112,r_115_35_61,r_15_111_252,1.0,-164,88,252,87
34,r_18_85_18,r_30_148_100,r_3_100_1,r_30_148_100,1.0,0,100,100,87
25,r_44_121_283,r_84_86_213,seq46,r_84_86_213,0.89,-35,178,213,87
33,r_128_143_141,r_65_130_276,r_21_127_25,r_128_143_141,1.0,0,141,141,87
47,r_115_35_61,r_15_111_252,r_103_107_13,r_15_111_252,0.87,0,252,252,87
79,seq69,seq1,r_70_61_171,r_70_61_171,0.69,5,176,171,87
39,r_30_148_100,r_18_85_18,seq129,r_30_148_100,1.0,0,100,100,87
34,r_18_85_18,r_95_41_133,r_30_148_100,r_18_85_18,0.82,-1,17,18,87
50,seq0,r_70_61_171,seq97,r_70_61_171,1.0,0,171,171,87
32,r_126_73_225,seq110,seq22,r_126_73_225,0.91,0,225,225,87
81,seq74,seq104,r_9_138_216,r_9_138_216,0.83,13,229,216,87
17,r_34_114_251,seq145,seq22,r_34_114_251,0.53,0,251,251,87
25,r_44_121_283,seq46,seq145,r_44_121_283,0.83,0,283,283,87
22,r_42_146_112,r_15_111_252,r_82_60_107,r_42_146_112,0.96,3,115,112,87
27,r_38_31_42,seq33,seq55,r_38_31_42,1.0,0,42,42,87
28,r_12_53_28,r_95_41_133,seq129,r_12_53_28,1.0,0,28,28,87
7,r_7_118_82,r_136_133_21,seq63,r_7_118_82,1.0,0,82,82,87
44,r_28_17_264,seq4,r_6_108_165,r_6_108_165,0.94,103,268,165,87
23,r_65_130_276,r_19_89_281,seq63,r_65_130_276,0.25,1,277,276,87
96,seq110,r_3_100_1,r_21_127_25,r_21_127_25,1.0,-1,24,25,87
79,seq69,r_116_123_126,seq1,r_116_123_126,1.0,0,126,126,87
35,r_19_89_281,r_65_130_276,r_103_107_13,r_19_89_281,0.21,-4,277,281,87
12,r_136_133_21,r_6_108_165,r_64_105_86,r_136_133_21,0.59,83,104,21,87
95,seq104,seq74,r_70_61_171,r_70_61_171,1.0,10,181,171,87
84,seq80,seq112,r_10_66_68,r_10_66_68,0.97,4,72,68,87
40,r_132_35_15,r_122_6_193,r_16_1_130,r_16_1_130,1.0,74,204,130,88
30,r_80_53_117,r_63_120_74,r_102_139_215,r_63_120_74,1.0,0,74,74,88
44,r_135_12_8,r_105_73_287,seq14,r_105_73_287,0.73,-25,262,287,88
48,r_49_23_166,seq113,seq88,r_49_23_166,1.0,0,166,166,88
92,seq110,r_108_119_212,r_44_76_73,r_44_76_73,1.0,139,212,73,88
14,r_101_95_79,seq3,seq0,r_101_95_79,1.0,0,79,79,88
8,r_40_141_185,r_71_149_252,seq112,r_40_141_185,0.92,0,185,185,88
43,r_47_96_237,seq127,r_63_120_74,r_47_96_237,0.9,0,237,237,88
16,r_19_64_123,r_80_53_117,seq131,r_80_53_117,0.98,1,118,117,88
21,r_102_139_215,r_63_120_74,r_26_42_93,r_63_120_74,1.0,0,74,74,88
39,r_86_60_109,r_74_75_137,seq25,r_86_60_109,1.0,0,109,109,88
5,r_2_70_236,r_107_8_72,r_65_32_7,r_107_8_72,1.0,1,73,72,88
46,r_9_37_156,seq131,seq61,r_9_37_156,0.66,1,157,156,88
42,r_18_106_176,r_140_87_204,seq109,r_18_106_176,1.0,0,176,176,88
45,r_16_1_130,seq29,r_105_73_287,r_16_1_130,1.0,2,132,130,88
12,r_140_87_204,r_97_91_256,r_101_95_79,r_140_87_204,0.87,0,204,204,88
15,r_125_124_9,r_122_6_193,seq69,r_125_124_9,0.91,1,10,9,88
19,r_123_104_112,r_49_23_166,seq28,r_49_23_166,0.96,-54,112,166,88
95,seq113,r_26_42_93,r_40_141_185,r_26_42_93,0.45,8,101,93,88
66,seq30,r_101_95_79,r_55_45_57,r_101_95_79,1.0,-16,63,79,88
76,seq61,r_68_10_42,r_71_149_252,r_68_10_42,0.46,59,101,42,88
41,r_44_76_73,seq0,seq110,r_44_76_73,0.98,0,73,73,88
3,r_55_45_57,seq114,seq30,r_55_45_57,0.74,6,63,57,88
10,r_97_91_256,seq28,r_72_146_24,r_72_146_24,0.54,235,259,24,88
24,r_52_50_251,r_38_92_144,r_26_42_93,r_52_50_251,0.57,0,251,251,88
26,r_4_98_150,seq41,seq0,r_4_98_150,0.96,0,150,150,88
51,seq128,r_44_76_73,seq88,r_44_76_73,0.55,-24,49,73,88
4,r_67_115_134,r_135_12_8,seq131,r_67_115_134,0.71,5,139,134,88
78,seq69,seq62,r_125_124_9,r_125_124_9,0.97,142,151,9,88
63,seq25,r_142_27_267,r_20_5_240,r_20_5_240,1.0,27,267,240,88
20,r_54_134_120,seq138,seq113,r_54_134_120,0.89,0,120,120,88
13,r_99_24_139,seq116,r_43_66_63,r_99_24_139,1.0,0,139,139,88
48,r_49_23_166,r_123_104_112,seq113,r_123_104_112,0.89,0,112,112,88
6,r_38_92_144,seq112,r_52_50_251,r_38_92_144,0.94,0,144,144,88
62,seq21,r_43_66_63,r_78_100_271,r_43_66_63,1.0,0,63,63,88
21,r_102_139_215,r_26_42_93,seq83,r_102_139_215,0.54,4,219,215,88
95,seq113,r_54_134_120,r_108_119_212,r_108_119_212,0.91,-3,209,212,88
85,seq88,r_38_92_144,r_63_120_74,r_63_120_74,0.77,24,98,74,88
5,r_2_70_236,r_65_32_7,seq79,r_2_70_236,0.55,0,236,236,88
0,r_144_22_1,seq56,r_101_95_79,r_101_95_79,0.99,119,198,79,88
51,seq128,seq88,r_144_22_1,r_144_22_1,0.51,185,186,1,88
30,r_80_53_117,r_102_139_215,seq25,r_80_53_117,1.0,0,117,117,88
2,r_122_6_193,r_132_35_15,r_54_134_120,r_54_134_120,1.0,79,199,120,88
40,r_132_35_15,r_4_98_150,r_122_6_193,r_132_35_15,0.68,1,16,15,88
18,r_20_5_240,r_105_73_287,r_86_60_109,r_20_5_240,0.52,0,240,240,88
24,r_52_50_251,r_20_5_240,r_38_92_144,r_38_92_144,1.0,59,203,144,88
25,r_43_66_63,seq21,seq58,r_43_66_63,1.0,0,63,63,88
33,r_105_73_287,r_20_5_240,r_16_1_130,r_16_1_130,1.0,110,240,130,88
31,r_57_31_49,r_144_22_1,seq136,r_57_31_49,0.97,0,49,49,88
65,seq29,r_118_137_23,seq46,r_118_137_23,0.33,236,259,23,88
50,seq0,r_44_76_73,seq56,r_44_76_73,1.0,0,73,73,88
70,seq41,r_4_98_150,r_81_11_14,r_4_98_150,0.93,-56,94,150,88
6,r_38_92_144,r_52_50_251,r_16_1_130,r_52_50_251,0.98,0,251,251,88
20,r_54_134_120,seq113,r_122_6_193,r_122_6_193,0.96,32,225,193,88
1,r_118_137_23,r_2_70_236,seq51,r_118_137_23,0.9,1,24,23,88
32,r_147_15_189,seq17,r_13_7_10,r_147_15_189,0.74,24,213,189,88
38,r_142_27_267,seq25,seq30,r_142_27_267,0.24,0,267,267,88
76,seq61,r_71_149_252,r_9_37_156,r_9_37_156,0.71,23,179,156,88
7,r_13_7_10,r_16_1_130,seq51,r_16_1_130,0.97,-116,14,130,88
35,r_59_34_231,r_147_15_189,seq83,r_59_34_231,0.99,1,232,231,88
60,seq17,r_147_15_189,r_148_117_104,r_148_117_104,1.0,105,209,104,88
45,r_16_1_130,r_105_73_287,r_38_92_144,r_38_92_144,0.58,143,287,144,88
17,r_26_42_93,seq113,r_102_139_215,r_26_42_93,0.7,8,101,93,88
94,seq112,r_38_92_144,seq88,r_38_92_144,0.82,0,144,144,88
9,r_74_75_137,r_86_60_109,r_67_115_134,r_74_75_137,0.6,-28,109,137,88
50,seq0,seq56,r_4_98_150,r_4_98_150,1.0,1,151,150,88
9,r_74_75_137,r_67_115_134,seq89,r_74_75_137,0.93,-9,128,137,88
33,r_105_73_287,r_16_1_130,r_20_5_240,r_105_73_287,0.79,0,287,287,88
29,r_65_32_7,r_2_70_236,seq114,r_2_70_236,0.88,-52,184,236,88
62,seq21,r_78_100_271,r_147_15_189,r_147_15_189,0.7,-4,185,189,88
28,r_107_8_72,r_2_70_236,seq17,r_107_8_72,1.0,1,73,72,88
91,seq109,seq51,r_18_106_176,r_18_106_176,1.0,13,189,176,88
49,r_148_117_104,r_97_91_256,seq17,r_148_117_104,1.0,0,104,104,88
82,seq83,r_102_139_215,r_59_34_231,r_59_34_231,0.69,31,262,231,88
0,r_144_22_1,r_57_31_49,seq56,r_57_31_49,1.0,-1,48,49,88
44,r_135_12_8,r_67_115_134,r_105_73_287,r_135_12_8,0.44,136,144,8,88
22,r_72_146_24,r_63_120_74,seq48,r_72_146_24,0.98,1,25,24,88
94,seq112,seq88,r_40_141_185,r_40_141_185,0.98,19,204,185,88
17,r_26_42_93,r_102_139_215,r_68_10_42,r_102_139_215,0.89,-6,209,215,88
35,r_59_34_231,seq51,r_147_15_189,r_147_15_189,0.7,0,189,189,88
12,r_140_87_204,r_18_106_176,r_97_91_256,r_18_106_176,0.97,0,176,176,88
93,seq111,r_79_2_252,r_56_27_261,r_56_27_261,0.52,0,261,261,89
86,seq93,seq129,r_21_141_145,r_21_141_145,0.8,26,171,145,89
92,seq106,seq129,r_21_141_145,r_21_141_145,1.0,28,173,145,89
82,seq75,r_51_60_201,r_42_49_65,r_42_49_65,0.92,-1,64,65,89
86,seq93,r_62_29_134,seq129,r_62_29_134,0.94,0,134,134,89
16,r_69_9_210,r_135_102_278,r_21_141_145,r_21_141_145,0.98,2,147,145,89
21,r_123_57_169,seq74,seq65,r_123_57_169,0.98,1,170,169,89
39,r_99_85_150,seq63,seq149,r_99_85_150,1.0,0,150,150,89
1,r_88_128_264,seq28,r_47_113_217,r_47_113_217,0.81,50,267,217,89
97,seq120,r_37_35_191,seq104,r_37_35_191,1.0,-15,176,191,89
5,r_66_17_230,seq65,r_140_142_101,r_66_17_230,0.99,0,230,230,89
46,r_16_127_282,seq86,r_51_60_201,r_16_127_282,0.25,-1,281,282,89
42,r_137_115_215,r_88_128_264,r_12_146_221,r_137_115_215,0.92,0,215,215,89
19,r_37_35_191,seq120,seq139,r_37_35_191,1.0,0,191,191,89
0,r_89_61_35,r_109_126_294,r_51_60_201,r_89_61_35,1.0,0,35,35,89
41,r_76_100_86,seq116,seq38,r_76_100_86,0.97,1,87,86,89
89,seq101,r_148_41_216,seq77,r_148_41_216,0.69,-122,94,216,89
3,r_55_97_23,r_148_41_216,seq71,r_148_41_216,0.8,-193,23,216,89
10,r_0_92_64,r_79_2_252,seq147,r_0_92_64,1.0,0,64,64,89
72,seq52,r_53_15_119,seq86,r_53_15_119,0.87,1,120,119,89
4,r_51_60_201,r_19_39_153,r_89_61_35,r_51_60_201,0.92,-70,131,201,89
11,r_118_25_108,seq131,seq59,r_118_25_108,1.0,0,108,108,89
20,r_107_138_247,r_73_134_155,seq52,r_107_138_247,0.76,0,247,247,89
13,r_72_98_254,seq124,r_53_15_119,r_53_15_119,1.0,136,255,119,89
15,r_148_41_216,seq103,r_50_84_75,r_148_41_216,0.99,0,216,216,89
48,r_14_10_72,r_132_110_268,seq122,r_14_10_72,1.0,1,73,72,89
4,r_51_60_201,r_89_61_35,seq122,r_51_60_201,0.9,0,201,201,89
99,seq124,r_72_98_254,r_48_22_227,r_72_98_254,0.69,1,255,254,89
0,r_89_61_35,r_51_60_201,seq74,r_51_60_201,0.97,-30,171,201,89
87,seq94,r_37_35_191,seq104,r_37_35_191,1.0,-21,170,191,89
2,r_105_144_245,seq130,r_121_6_28,r_105_144_245,0.59,0,245,245,89
47,r_79_2_252,seq111,r_47_113_217,r_47_113_217,0.72,36,253,217,89
34,r_45_95_19,r_78_8_206,seq86,r_45_95_19,0.95,0,19,19,89
40,r_90_58_260,seq46,r_21_141_145,r_21_141_145,0.55,115,260,145,89
74,seq59,r_132_110_268,r_47_113_217,r_47_113_217,1.0,30,247,217,89
29,r_125_108_195,seq147,r_19_39_153,r_125_108_195,0.45,0,195,195,89
24,r_47_113_217,seq67,r_118_25_108,r_118_25_108,0.71,109,217,108,89
25,r_136_114_93,seq103,seq131,r_136_114_93,0.71,1,94,93,89
33,r_7_112_159,seq86,seq5,r_7_112_159,1.0,0,159,159,89
50,seq1,r_56_27_261,r_19_39_153,r_19_39_153,1.0,3,156,153,89
57,seq143,r_105_144_245,seq59,r_105_144_245,0.97,-188,57,245,89
61,seq149,seq40,r_99_85_150,r_99_85_150,1.0,2,152,150,89
32,r_13_91_138,seq54,seq130,r_13_91_138,1.0,0,138,138,89
38,r_42_49_65,seq5,seq75,r_42_49_65,1.0,4,69,65,89
77,seq67,r_47_113_217,r_99_85_150,r_99_85_150,0.62,67,217,150,89
17,r_64_81_285,seq139,r_21_141_145,r_21_141_145,0.65,140,285,145,89
9,r_62_29_134,seq93,seq26,r_62_29_134,1.0,0,134,134,89
31,r_48_22_227,r_88_128_264,seq54,r_48_22_227,0.96,5,232,227,89
27,r_121_6_28,r_37_35_191,seq46,r_37_35_191,0.66,-163,28,191,89
49,r_78_8_206,seq129,seq5,r_78_8_206,0.91,0,206,206,89
7,r_21_141_145,seq44,seq93,r_21_141_145,1.0,2,147,145,89
44,r_135_102_278,seq129,seq94,r_135_102_278,0.52,0,278,278,89
23,r_30_82_100,r_34_119_146,seq130,r_30_82_100,0.99,1,101,100,89
35,r_19_39_153,r_51_60_201,seq1,r_19_39_153,1.0,0,153,153,89
12,r_53_15_119,seq52,seq23,r_53_15_119,1.0,1,120,119,89
30,r_21_106_229,seq92,seq142,r_21_106_229,0.58,2,231,229,90
36,r_25_51_183,r_134_3_217,r_66_123_138,r_66_123_138,0.81,47,185,138,90
14,r_54_33_131,r_0_80_178,seq24,r_54_33_131,1.0,1,132,131,90
29,r_15_39_124,r_146_114_86,r_53_62_17,r_15_39_124,0.76,-78,46,124,90
21,r_53_62_17,r_57_111_291,r_12_137_177,r_57_111_291,0.64,-274,17,291,90
8,r_83_89_279,r_26_112_65,r_12_137_177,r_83_89_279,0.55,0,279,279,90
53,seq5,r_35_88_176,r_143_85_12,r_35_88_176,0.98,4,180,176,90
43,r_103_133_126,seq4,seq17,r_103_133_126,1.0,6,132,126,90
37,r_146_114_86,r_15_39_124,r_93_30_1,r_146_114_86,1.0,0,86,86,90
71,seq58,r_74_108_205,seq118,r_74_108_205,1.0,1,206,205,90
16,r_73_65_122,r_66_123_138,r_69_91_10,r_73_65_122,0.99,0,122,122,90
39,r_50_132_134,r_69_91_10,seq122,r_50_132_134,1.0,0,134,134,90
1,r_101_71_192,seq24,r_93_30_1,r_101_71_192,0.95,0,192,192,90
46,r_74_108_205,seq58,r_36_60_11,r_74_108_205,0.98,1,206,205,90
42,r_119_38_135,r_57_111_291,r_54_33_131,r_119_38_135,1.0,2,137,135,90
80,seq78,r_1_129_294,r_130_94_64,r_130_94_64,1.0,0,64,64,90
19,r_26_112_65,r_83_89_279,r_36_60_11,r_36_60_11,0.91,52,63,11,90
15,r_12_137_177,r_53_62_17,r_54_33_131,r_12_137_177,1.0,3,180,177,90
41,r_36_60_11,r_15_39_124,seq96,r_36_60_11,0.98,0,11,11,90
12,r_134_3_217,r_127_16_163,r_66_123_138,r_134_3_217,0.99,-2,215,217,90
31,r_31_79_209,seq20,seq46,r_31_79_209,0.94,0,209,209,90
10,r_147_9_114,seq105,seq122,r_147_9_114,1.0,0,114,114,90
90,seq105,r_22_90_102,r_34_48_105,r_34_48_105,1.0,4,109,105,90
26,r_52_84_231,r_54_33_131,r_93_30_1,r_54_33_131,1.0,1,132,131,90
4,r_66_123_138,r_73_65_122,r_0_80_178,r_73_65_122,0.98,0,122,122,90
0,r_124_115_263,seq4,r_8_41_69,r_8_41_69,1.0,194,263,69,90
73,seq61,r_130_94_64,seq116,r_130_94_64,1.0,1,65,64,90
13,r_110_14_238,r_1_129_294,r_54_33_131,r_110_14_238,0.6,0,238,238,90
98,seq122,r_34_48_105,seq99,r_34_48_105,1.0,0,105,105,90
48,r_1_129_294,r_138_37_264,r_22_90_102,r_1_129_294,0.83,-194,100,294,90
6,r_0_80_178,r_52_84_231,r_135_18_132,r_0_80_178,0.98,0,178,178,90
62,seq23,seq20,r_7_144_56,r_7_144_56,1.0,40,96,56,90
21,r_53_62_17,r_12_137_177,r_35_88_176,r_53_62_17,0.98,163,180,17,90
27,r_34_48_105,seq122,seq105,r_34_48_105,1.0,0,105,105,90
87,seq99,r_45_55_228,seq122,r_45_55_228,1.0,0,228,228,90
2,r_135_18_132,seq20,seq121,r_135_18_132,0.99,2,134,132,90
7,r_117_19_47,r_81_13_67,seq86,r_117_19_47,1.0,0,47,47,90
47,r_49_104_89,seq11,seq149,r_49_104_89,0.92,0,89,89,90
40,r_69_91_10,r_50_132_134,r_73_65_122,r_69_91_10,0.99,124,134,10,90
24,r_22_90_102,seq105,r_1_129_294,r_22_90_102,0.57,0,102,102,90
25,r_81_13_67,r_34_48_105,r_1_129_294,r_1_129_294,0.99,-227,67,294,90
33,r_44_139_157,seq149,seq148,r_44_139_157,1.0,0,157,157,90
65,seq32,r_76_126_81,seq70,r_76_126_81,0.98,2,83,81,90
15,r_12_137_177,r_15_39_124,r_53_62_17,r_53_62_17,0.71,8,25,17,90
32,r_130_94_64,seq61,seq78,r_130_94_64,1.0,0,64,64,90
4,r_66_123_138,r_0_80_178,seq4,r_0_80_178,0.68,-40,138,178,90
17,r_76_126_81,seq2,seq4,r_76_126_81,0.53,3,84,81,90
94,seq116,r_52_84_231,r_101_71_192,r_101_71_192,0.64,31,223,192,90
9,r_8_41_69,r_74_108_205,r_53_62_17,r_8_41_69,1.0,0,69,69,90
26,r_52_84_231,r_93_30_1,r_15_39_124,r_52_84_231,0.98,0,231,231,90
29,r_15_39_124,r_53_62_17,r_8_41_69,r_8_41_69,0.99,122,191,69,90
22,r_127_16_163,r_100_68_249,seq59,r_127_16_163,0.85,0,163,163,90
28,r_138_37_264,r_1_129_294,seq131,r_138_37_264,0.62,1,265,264,90
18,r_128_77_25,r_117_19_47,r_136_47_107,r_136_47_107,0.98,-82,25,107,90
49,r_35_88_176,seq5,r_53_62_17,r_35_88_176,0.99,4,180,176,90
18,r_128_77_25,r_136_47_107,r_143_85_12,r_136_47_107,0.48,48,155,107,90
44,r_136_47_107,r_35_88_176,seq2,r_35_88_176,1.0,-62,114,176,90
82,seq92,r_21_106_229,seq145,r_21_106_229,0.85,3,232,229,90
35,r_45_55_228,seq99,r_73_65_122,r_45_55_228,0.91,0,228,228,90
12,r_134_3_217,r_25_51_183,r_127_16_163,r_134_3_217,0.67,-33,184,217,90
38,r_7_144_56,seq142,seq23,r_7_144_56,0.99,1,57,56,90
93,seq100,r_49_130_196,r_8_78_89,r_8_78_89,1.0,14,103,89,91
79,seq66,r_112_144_257,r_40_120_59,r_112_144_257,0.55,-45,212,257,91
40,r_28_34_289,r_122_82_54,seq74,r_28_34_289,0.5,0,289,289,91
30,r_77_48_213,r_111_124_220,seq31,r_77_48_213,0.9,0,213,213,91
36,r_63_119_174,r_129_55_280,r_13_19_71,r_13_19_71,1.0,109,180,71,91
32,r_116_11_241,r_40_120_59,seq132,r_40_120_59,1.0,-4,55,59,91
14,r_3_26_256,seq75,r_148_138_80,r_148_138_80,0.75,176,256,80,91
8,r_8_78_89,r_111_124_220,seq100,r_8_78_89,1.0,-1,88,89,91
43,r_68_20_72,seq62,r_118_97_159,r_68_20_72,1.0,0,72,72,91
23,r_35_126_31,r_141_41_170,r_99_143_6,r_35_126_31,1.0,0,31,31,91
37,r_56_70_163,r_112_144_257,r_35_126_31,r_35_126_31,0.99,30,61,31,91
71,seq51,r_36_73_295,r_43_103_93,r_43_103_93,0.87,10,103,93,91
16,r_136_65_168,r_149_127_298,seq9,r_136_65_168,1.0,0,168,168,91
39,r_58_102_195,seq2,r_38_108_58,r_58_102_195,0.92,0,195,195,91
1,r_43_103_93,seq66,seq51,r_43_103_93,0.8,4,97,93,91
97,seq117,r_111_124_220,seq23,r_111_124_220,1.0,0,220,220,91
46,r_129_55_280,seq44,r_17_25_177,r_17_25_177,1.0,107,284,177,91
42,r_50_71_103,r_77_48_213,r_35_126_31,r_50_71_103,0.99,0,103,103,91
32,r_116_11_241,seq132,r_77_48_213,r_77_48_213,0.99,27,240,213,91
6,r_118_97_159,r_49_130_196,r_68_20_72,r_118_97_159,0.84,-124,35,159,91
21,r_109_131_36,seq64,seq146,r_109_131_36,1.0,0,36,36,91
13,r_99_143_6,r_43_103_93,r_35_126_31,r_35_126_31,0.98,11,42,31,91
79,seq66,r_136_65_168,r_112_144_257,r_136_65_168,0.98,-52,116,168,91
19,r_105_30_261,r_76_113_265,r_147_79_187,r_147_79_187,0.56,73,260,187,91
76,seq60,r_28_34_289,r_122_82_54,r_122_82_54,1.0,16,70,54,91
41,r_112_144_257,r_56_70_163,r_13_19_71,r_13_19_71,0.72,68,139,71,91
10,r_59_86_255,seq75,r_38_108_58,r_59_86_255,0.77,0,255,255,91
26,r_92_140_67,r_111_124_220,seq9,r_92_140_67,1.0,0,67,67,91
11,r_122_82_54,seq88,seq60,r_122_82_54,0.99,0,54,54,91
4,r_17_25_177,seq54,r_84_32_173,r_17_25_177,0.53,0,177,177,91
0,r_13_19_71,seq146,r_47_14_285,r_13_19_71,0.99,0,71,71,91
29,r_40_120_59,r_116_11_241,r_149_127_298,r_40_120_59,1.0,0,59,59,91
15,r_107_57_7,r_28_34_289,r_122_82_54,r_122_82_54,1.0,196,250,54,91
48,r_148_138_80,seq117,seq4,r_148_138_80,1.0,0,80,80,91
62,seq24,r_104_89_205,r_1_80_139,r_1_80_139,0.87,62,201,139,91
94,seq146,r_141_41_170,r_109_131_36,r_109_131_36,1.0,19,55,36,91
85,seq85,r_1_80_139,r_147_79_187,r_1_80_139,1.0,0,139,139,91
5,r_147_79_187,r_112_144_257,r_105_30_261,r_105_30_261,0.91,0,261,261,91
22,r_139_45_199,r_109_131_36,r_37_7_41,r_139_45_199,0.93,0,199,199,91
2,r_104_89_205,seq24,seq75,r_104_89_205,0.89,0,205,205,91
41,r_112_144_257,r_13_19_71,seq23,r_13_19_71,0.49,175,246,71,91
40,r_28_34_289,seq60,r_122_82_54,r_122_82_54,1.0,16,70,54,91
18,r_22_0_206,seq115,seq75,r_22_0_206,0.96,0,206,206,91
43,r_68_20_72,r_118_97_159,r_29_6_137,r_68_20_72,1.0,87,159,72,91
33,r_49_130_196,seq12,r_111_124_220,r_111_124_220,0.66,0,220,220,91
70,seq44,r_129_55_280,r_47_14_285,r_47_14_285,0.71,-1,284,285,91
6,r_118_97_159,r_68_20_72,seq64,r_118_97_159,0.95,0,159,159,91
38,r_101_15_226,r_16_128_231,r_139_45_199,r_16_128_231,0.8,-5,226,231,91
52,seq5,r_141_41_170,r_109_131_36,r_109_131_36,1.0,136,172,36,91
34,r_61_72_147,seq135,seq12,r_61_72_147,1.0,0,147,147,91
22,r_139_45_199,r_37_7_41,r_101_15_226,r_101_15_226,0.82,27,253,226,91
75,seq137,seq54,r_56_70_163,r_56_70_163,1.0,13,176,163,91
17,r_90_106_127,seq52,seq134,r_90_106_127,1.0,0,127,127,91
96,seq115,r_22_0_206,seq121,r_22_0_206,1.0,-3,203,206,91
37,r_56_70_163,r_35_126_31,r_40_120_59,r_35_126_31,0.51,99,130,31,91
22,r_139_45_199,r_110_145_252,r_109_131_36,r_109_131_36,1.0,59,95,36,91
28,r_16_128_231,seq2,r_118_97_159,r_16_128_231,0.93,0,231,231,91
49,r_76_113_265,seq21,r_50_71_103,r_76_113_265,0.64,0,265,265,91
44,r_149_127_298,r_136_65_168,r_40_120_59,r_149_127_298,0.55,-236,62,298,91
82,seq74,r_84_32_173,seq142,r_84_32_173,0.97,0,173,173,91
27,r_37_7_41,r_43_103_93,seq23,r_37_7_41,0.78,0,41,41,91
37,r_56_70_163,r_40_120_59,seq137,r_56_70_163,1.0,0,163,163,91
35,r_1_80_139,seq85,seq83,r_1_80_139,0.99,0,139,139,91
12,r_29_6_137,r_76_113_265,r_68_20_72,r_29_6_137,1.0,2,139,137,91
23,r_35_126_31,r_99_143_6,r_50_71_103,r_50_71_103,0.91,8,111,103,91
84,seq83,r_104_89_205,r_1_80_139,r_1_80_139,0.97,7,146,139,91
26,r_75_2_26,seq104,seq32,r_75_2_26,1.0,0,26,26,92
44,r_66_83_82,r_19_139_172,r_132_137_56,r_19_139_172,1.0,-30,142,172,92
92,seq99,r_12_106_125,r_39_112_145,r_12_106_125,1.0,-1,124,125,92
14,r_86_94_196,r_6_72_223,r_128_146_140,r_86_94_196,0.82,0,196,196,92
8,r_128_146_140,seq104,r_97_144_53,r_128_146_140,0.31,-20,120,140,92
58,seq141,seq65,r_134_73_201,r_134_73_201,1.0,1,202,201,92
43,r_62_131_132,seq141,seq90,r_62_131_132,0.77,2,134,132,92
16,r_38_145_1,r_68_0_177,r_128_146_140,r_68_0_177,0.91,1,178,177,92
39,r_23_133_130,seq90,seq98,r_23_133_130,1.0,0,130,130,92
1,r_29_15_203,r_6_72_223,seq18,r_29_15_203,0.6,0,203,203,92
97,seq120,r_12_106_125,r_97_144_53,r_12_106_125,0.95,-19,106,125,92
5,r_117_44_138,r_24_55_245,seq143,r_117_44_138,0.76,1,139,138,92
46,r_6_72_223,r_29_15_203,r_12_106_125,r_12_106_125,0.9,78,203,125,92
42,r_115_107_212,seq130,r_39_112_145,r_115_107_212,0.78,0,212,212,92
69,seq33,r_111_113_273,r_26_87_117,r_26_87_117,0.91,149,266,117,92
45,r_54_123_164,seq28,r_127_4_87,r_54_123_164,0.98,0,164,164,92
30,r_17_51_43,seq57,seq130,r_17_51_43,0.98,2,45,43,92
19,r_8_110_289,r_14_103_286,seq28,r_8_110_289,0.59,-222,67,289,92
27,r_19_139_172,r_66_83_82,seq28,r_19_139_172,1.0,0,172,172,92
66,seq28,seq20,r_19_139_172,r_19_139_172,1.0,43,215,172,92
76,seq57,r_17_51_43,r_47_125_70,r_47_125_70,0.97,1,71,70,92
97,seq120,r_97_144_53,r_128_146_140,r_97_144_53,0.52,169,222,53,92
31,r_79_126_211,seq21,r_128_146_140,r_79_126_211,0.89,0,211,211,92
3,r_39_112_145,seq3,r_115_107_212,r_115_107_212,0.98,41,253,212,92
18,r_40_35_33,r_111_113_273,seq10,r_40_35_33,1.0,0,33,33,92
10,r_74_16_124,r_24_55_245,seq84,r_74_16_124,0.93,13,137,124,92
15,r_142_58_15,r_68_0_177,r_101_147_4,r_142_58_15,0.83,0,15,15,92
8,r_128_146_140,r_97_144_53,r_129_82_183,r_129_82_183,1.0,7,190,183,92
4,r_1_149_185,seq67,r_127_4_87,r_1_149_185,0.94,2,187,185,92
78,seq65,r_66_83_82,r_142_58_15,r_66_83_82,1.0,0,82,82,92
11,r_129_82_183,seq84,r_128_146_140,r_129_82_183,0.71,0,183,183,92
20,r_43_41_248,r_36_135_3,r_19_139_172,r_36_135_3,0.58,245,248,3,92
6,r_12_106_125,seq99,seq20,r_12_106_125,1.0,-3,122,125,92
13,r_101_147_4,r_62_131_132,r_142_58_15,r_101_147_4,0.76,12,16,4,92
85,seq84,r_129_82_183,seq42,r_129_82_183,1.0,0,183,183,92
36,r_89_30_31,r_97_144_53,seq92,r_97_144_53,0.31,173,226,53,92
27,r_19_139_172,r_74_16_124,r_66_83_82,r_66_83_82,0.99,6,88,82,92
23,r_78_124_46,seq57,seq11,r_78_124_46,1.0,0,46,46,92
35,r_24_55_245,r_132_137_56,r_105_100_8,r_24_55_245,0.72,0,245,245,92
36,r_89_30_31,r_117_44_138,r_97_144_53,r_89_30_31,0.98,0,31,31,92
48,r_132_137_56,r_24_55_245,r_66_83_82,r_66_83_82,0.55,167,249,82,92
47,r_76_52_51,seq80,r_17_51_43,r_76_52_51,1.0,0,51,51,92
58,seq141,r_62_131_132,seq65,r_62_131_132,1.0,2,134,132,92
68,seq32,seq119,r_75_2_26,r_75_2_26,1.0,47,73,26,92
38,r_26_87_117,seq25,seq53,r_26_87_117,0.99,0,117,117,92
34,r_48_59_240,seq5,r_9_102_37,r_9_102_37,0.53,203,240,37,92
24,r_9_102_37,r_47_125_70,seq21,r_9_102_37,0.72,0,37,37,92
48,r_132_137_56,seq7,r_24_55_245,r_132_137_56,0.99,0,56,56,92
83,seq80,r_76_52_51,seq93,r_76_52_51,1.0,0,51,51,92
17,r_47_125_70,seq7,seq57,r_47_125_70,1.0,-1,69,70,92
25,r_70_88_163,seq92,r_127_4_87,r_70_88_163,0.91,-24,139,163,92
96,seq119,r_91_116_110,seq32,r_91_116_110,0.9,4,114,110,92
46,r_6_72_223,r_12_106_125,r_105_100_8,r_6_72_223,0.95,1,224,223,92
22,r_91_116_110,seq119,seq90,r_91_116_110,0.85,1,111,110,92
28,r_127_4_87,r_12_106_125,seq93,r_12_106_125,0.77,-32,93,125,92
51,seq3,r_39_112_145,r_97_144_53,r_97_144_53,0.62,-1,52,53,92
7,r_134_73_201,seq57,seq141,r_134_73_201,0.9,1,202,201,92
44,r_66_83_82,seq65,r_19_139_172,r_66_83_82,1.0,0,82,82,92
79,seq67,r_1_149_185,seq90,r_1_149_185,1.0,2,187,185,92
35,r_24_55_245,r_74_16_124,r_132_137_56,r_24_55_245,0.89,-119,126,245,92
12,r_68_0_177,r_38_145_1,seq37,r_68_0_177,0.94,1,178,177,92
93,seq106,r_84_32_270,r_34_78_49,r_34_78_49,0.99,57,106,49,93
30,r_85_114_99,r_90_109_231,seq3,r_85_114_99,0.99,0,99,99,93
8,r_35_5_244,r_105_24_187,r_26_124_215,r_35_5_244,0.58,2,246,244,93
58,seq142,seq60,r_26_124_215,r_26_124_215,0.98,2,217,215,93
9,r_53_52_87,r_58_101_199,seq117,r_58_101_199,0.59,-31,168,199,93
54,seq7,seq2,r_93_71_291,r_93_71_291,0.69,-83,208,291,93
37,r_127_132_183,seq146,seq3,r_127_132_183,0.73,0,183,183,93
54,seq7,r_93_71_291,r_118_65_284,r_118_65_284,0.94,4,288,284,93
16,r_26_124_215,r_137_115_221,seq142,r_26_124_215,0.86,0,215,215,93
39,r_137_115_221,seq54,r_83_18_11,r_137_115_221,0.9,2,223,221,93
97,seq121,r_119_113_276,r_96_134_31,r_119_113_276,0.68,-175,101,276,93
57,seq13,r_30_138_287,r_39_57_133,r_39_57_133,0.73,4,137,133,93
46,r_80_149_153,seq133,r_75_88_119,r_80_149_153,0.99,0,153,153,93
80,seq63,r_69_144_279,r_135_128_147,r_135_128_147,1.0,132,279,147,93
7,r_73_139_112,r_129_47_79,r_83_18_11,r_73_139_112,0.44,79,191,112,93
19,r_94_98_156,seq22,seq2,r_94_98_156,1.0,1,157,156,93
5,r_83_18_11,r_34_78_49,r_58_101_199,r_58_101_199,1.0,2,201,199,93
27,r_107_9_172,r_19_108_41,seq51,r_107_9_172,0.76,6,178,172,93
63,seq147,seq21,r_111_64_43,r_111_64_43,1.0,3,46,43,93
76,seq54,r_137_115_221,seq27,r_137_115_221,0.99,2,223,221,93
9,r_53_52_87,r_33_126_42,r_58_101_199,r_53_52_87,0.68,36,123,87,93
31,r_136_76_71,seq82,seq27,r_136_76_71,0.88,0,71,71,93
41,r_61_141_91,r_77_10_273,r_111_64_43,r_61_141_91,1.0,0,91,91,93
3,r_135_128_147,r_23_104_151,seq63,r_135_128_147,1.0,0,147,147,93
10,r_75_88_119,seq13,seq27,r_75_88_119,1.0,0,119,119,93
26,r_23_104_151,r_73_139_112,r_135_128_147,r_73_139_112,0.99,-32,80,112,93
0,r_19_108_41,seq13,r_107_9_172,r_19_108_41,1.0,0,41,41,93
72,seq145,r_37_102_253,r_72_4_152,r_72_4_152,0.65,101,253,152,93
11,r_39_57_133,seq140,seq13,r_39_57_133,0.82,0,133,133,93
5,r_83_18_11,r_14_62_129,seq106,r_83_18_11,0.97,0,11,11,93
20,r_84_32_270,seq106,r_136_76_71,r_136_76_71,0.55,201,272,71,93
46,r_80_149_153,r_75_88_119,seq100,r_80_149_153,0.45,79,232,153,93
36,r_148_11_19,r_84_32_270,seq74,r_148_11_19,1.0,1,20,19,93
57,seq13,r_75_88_119,r_30_138_287,r_75_88_119,0.57,0,119,119,93
27,r_107_9_172,seq143,r_19_108_41,r_19_108_41,1.0,7,48,41,93
21,r_45_43_37,seq147,r_61_141_91,r_61_141_91,1.0,43,134,91,93
0,r_19_108_41,r_107_9_172,seq143,r_107_9_172,0.64,6,178,172,93
40,r_72_4_152,r_35_5_244,seq145,r_72_4_152,0.89,0,152,152,93
18,r_129_47_79,r_26_124_215,r_84_32_270,r_129_47_79,1.0,0,79,79,93
29,r_119_113_276,seq51,r_6_46_134,r_119_113_276,0.74,0,276,276,93
1,r_131_55_23,r_107_9_172,r_105_24_187,r_131_55_23,0.93,-1,22,23,93
24,r_77_10_273,seq3,r_96_134_31,r_96_134_31,0.86,242,273,31,93
25,r_29_48_76,seq51,seq146,r_29_48_76,1.0,0,76,76,93
34,r_116_12_51,r_37_102_253,seq117,r_116_12_51,1.0,0,51,51,93
33,r_92_87_139,seq2,seq146,r_92_87_139,0.79,1,140,139,93
4,r_96_134_31,seq20,seq49,r_96_134_31,0.65,0,31,31,93
82,seq68,seq2,r_93_71_291,r_93_71_291,0.78,-83,208,291,93
5,r_83_18_11,seq130,r_34_78_49,r_34_78_49,0.5,64,113,49,93
6,r_30_138_287,seq112,r_90_109_231,r_30_138_287,0.42,1,288,287,93
68,seq27,r_118_65_284,r_75_88_119,r_75_88_119,1.0,165,284,119,93
21,r_45_43_37,r_116_12_51,seq147,r_45_43_37,0.97,0,37,37,93
38,r_69_144_279,seq63,r_90_109_231,r_69_144_279,0.34,0,279,279,93
52,seq3,r_77_10_273,r_85_114_99,r_85_114_99,1.0,11,110,99,93
77,seq56,r_90_109_231,r_6_46_134,r_6_46_134,0.99,12,146,134,93
75,seq51,r_119_113_276,r_107_9_172,r_119_113_276,0.63,-98,178,276,93
17,r_79_38_196,seq130,r_34_78_49,r_34_78_49,1.0,148,197,49,93
9,r_53_52_87,seq68,r_33_126_42,r_53_52_87,0.76,1,88,87,93
26,r_23_104_151,r_135_128_147,r_99_40_46,r_23_104_151,1.0,0,151,151,93
96,seq117,r_33_126_42,r_116_12_51,r_116_12_51,1.0,15,66,51,93
13,r_34_78_49,r_81_41_77,seq106,r_34_78_49,0.99,0,49,49,93
91,seq100,seq74,r_80_149_153,r_80_149_153,0.94,54,207,153,93
44,r_99_40_46,r_35_5_244,seq86,r_99_40_46,1.0,-2,44,46,93
49,r_6_46_134,seq3,seq56,r_6_46_134,0.97,0,134,134,93
7,r_73_139_112,r_23_104_151,r_129_47_79,r_23_104_151,1.0,-39,112,151,93
18,r_129_47_79,r_84_32_270,seq106,r_84_32_270,0.95,-87,183,270,93
42,r_111_64_43,seq123,seq147,r_111_64_43,1.0,1,44,43,93
23,r_14_62_129,seq86,seq133,r_14_62_129,1.0,0,129,129,93
82,seq68,r_53_52_87,seq2,r_53_52_87,1.0,-7,80,87,93
85,seq143,seq106,r_19_108_41,r_19_108_41,1.0,7,48,41,93
35,r_44_125_252,seq140,r_39_57_133,r_39_57_133,1.0,119,252,133,93
12,r_90_109_231,seq56,r_99_40_46,r_90_109_231,0.64,1,232,231,93
93,seq114,r_135_113_223,r_132_54_83,r_132_54_83,1.0,130,213,83,94
30,r_63_0_257,r_27_97_136,r_106_43_64,r_106_43_64,1.0,27,91,64,94
51,seq3,seq148,r_56_130_91,r_56_130_91,0.98,110,201,91,94
36,r_27_97_136,seq116,r_21_103_191,r_21_103_191,0.45,-63,128,191,94
14,r_11_95_92,seq9,seq41,r_11_95_92,0.85,7,99,92,94
8,r_29_136_132,r_122_139_139,r_106_43_64,r_106_43_64,0.91,69,133,64,94
29,r_10_119_289,r_7_121_55,r_105_88_78,r_7_121_55,0.58,235,290,55,94
37,r_120_33_111,seq14,seq62,r_120_33_111,0.8,5,116,111,94
86,seq82,seq65,r_45_93_243,r_45_93_243,0.91,3,246,243,94
16,r_105_88_78,seq129,seq17,r_105_88_78,1.0,0,78,78,94
1,r_94_147_254,r_51_23_239,r_21_103_191,r_21_103_191,0.99,53,244,191,94
63,seq32,r_59_19_267,r_1_125_17,r_1_125_17,0.91,24,41,17,94
22,r_7_121_55,seq13,r_10_119_289,r_7_121_55,0.96,1,56,55,94
24,r_106_43_64,r_27_97_136,r_29_136_132,r_29_136_132,0.73,7,139,132,94
19,r_149_55_264,seq40,r_30_26_247,r_149_55_264,0.38,0,264,264,94
95,seq116,r_27_97_136,r_106_43_64,r_106_43_64,1.0,64,128,64,94
76,seq65,seq82,r_72_28_69,r_72_28_69,1.0,4,73,69,94
39,r_85_46_26,r_21_103_191,r_27_97_136,r_21_103_191,0.84,-73,118,191,94
41,r_135_113_223,seq114,r_123_86_201,r_135_113_223,0.61,1,224,223,94
3,r_79_140_95,r_69_52_281,r_132_54_83,r_69_52_281,1.0,-186,95,281,94
4,r_21_103_191,seq144,r_85_46_26,r_21_103_191,0.29,-133,58,191,94
10,r_69_52_281,r_79_140_95,seq77,r_79_140_95,1.0,0,95,95,94
26,r_1_125_17,r_35_138_290,seq32,r_35_138_290,0.84,-273,17,290,94
2,r_101_146_36,seq44,seq80,r_101_146_36,1.0,2,38,36,94
0,r_67_22_215,r_124_89_240,seq144,r_124_89_240,0.95,-92,148,240,94
73,seq61,r_123_86_201,seq126,r_123_86_201,0.53,2,203,201,94
11,r_73_104_195,r_75_109_265,seq68,r_73_104_195,0.97,0,195,195,94
20,r_75_109_265,r_84_34_294,r_27_97_136,r_84_34_294,0.51,-28,266,294,94
13,r_72_28_69,r_56_130_91,seq65,r_72_28_69,1.0,0,69,69,94
84,seq80,r_117_110_188,r_101_146_36,r_101_146_36,1.0,8,44,36,94
44,r_131_108_51,r_142_58_298,r_101_146_36,r_142_58_298,0.99,-247,51,298,94
15,r_16_111_227,seq41,seq53,r_16_111_227,0.68,1,228,227,94
48,r_132_54_83,r_31_91_180,seq114,r_132_54_83,1.0,0,83,83,94
57,seq14,r_120_33_111,seq127,r_120_33_111,0.72,5,116,111,94
6,r_98_57_275,seq143,seq9,r_98_57_275,0.44,0,275,275,94
10,r_69_52_281,r_94_147_254,seq100,r_69_52_281,0.48,4,285,281,94
32,r_112_145_43,r_131_108_51,seq20,r_131_108_51,1.0,0,51,51,94
36,r_27_97_136,r_21_103_191,r_67_22_215,r_21_103_191,1.0,0,191,191,94
10,r_69_52_281,seq77,r_94_147_254,r_94_147_254,0.35,-13,241,254,94
30,r_63_0_257,r_106_43_64,r_72_28_69,r_63_0_257,0.57,0,257,257,94
87,seq83,seq53,r_42_5_135,r_42_5_135,0.93,7,142,135,94
22,r_7_121_55,r_10_119_289,r_79_140_95,r_79_140_95,0.94,194,289,95,94
42,r_39_87_39,r_124_89_240,seq70,r_39_87_39,1.0,3,42,39,94
40,r_56_130_91,seq62,seq37,r_56_130_91,0.94,6,97,91,94
74,seq62,r_56_130_91,r_120_33_111,r_56_130_91,0.5,6,97,91,94
18,r_45_93_243,seq100,seq82,r_45_93_243,0.61,-2,241,243,94
29,r_10_119_289,r_76_78_271,r_7_121_55,r_7_121_55,1.0,216,271,55,94
24,r_106_43_64,seq77,r_27_97_136,r_106_43_64,1.0,0,64,64,94
25,r_31_91_180,seq80,seq96,r_31_91_180,0.96,0,180,180,94
33,r_84_34_294,r_75_109_265,seq90,r_75_109_265,1.0,1,266,265,94
4,r_21_103_191,r_85_46_26,r_27_97_136,r_27_97_136,0.81,-40,96,136,94
50,seq129,r_105_88_78,r_117_110_188,r_105_88_78,1.0,0,78,78,94
65,seq37,r_134_47_287,r_56_130_91,r_56_130_91,0.87,44,135,91,94
34,r_76_78_271,r_10_119_289,r_106_43_64,r_106_43_64,1.0,207,271,64,94
17,r_42_5_135,seq77,seq83,r_42_5_135,0.5,0,135,135,94
94,seq115,r_35_138_290,r_30_26_247,r_35_138_290,0.17,-26,264,290,94
9,r_122_139_139,r_135_113_223,r_12_102_270,r_122_139_139,0.81,-1,138,139,94
92,seq107,r_16_111_227,r_11_95_92,r_16_111_227,0.49,-175,52,227,94
4,r_21_103_191,r_27_97_136,r_2_18_1,r_21_103_191,0.99,0,191,191,94
49,r_15_38_184,r_35_138_290,r_56_130_91,r_15_38_184,0.86,0,184,184,94
39,r_85_46_26,seq68,r_21_103_191,r_85_46_26,0.81,0,26,26,94
7,r_124_89_240,seq133,seq143,r_124_89_240,0.82,0,240,240,94
23,r_12_102_270,r_35_138_290,r_132_54_83,r_132_54_83,1.0,181,264,83,94
79,seq70,r_30_26_247,r_39_87_39,r_39_87_39,0.87,209,248,39,94
35,r_117_110_188,r_51_23_239,seq129,r_51_23_239,0.57,-50,189,239,94
36,r_27_97_136,r_67_22_215,r_75_109_265,r_75_109_265,0.99,6,271,265,94
93,seq108,r_37_70_117,seq3,r_37_70_117,1.0,1,118,117,95
30,r_73_14_198,r_146_119_46,r_37_70_117,r_146_119_46,0.85,152,198,46,95
51,seq128,r_90_101_253,r_133_121_149,r_133_121_149,0.99,104,253,149,95
66,seq34,r_112_115_62,r_138_16_212,r_138_16_212,1.0,8,220,212,95
14,r_24_141_211,r_5_75_274,r_86_8_166,r_24_141_211,0.48,1,212,211,95
8,r_112_115_62,seq39,seq111,r_112_115_62,1.0,7,69,62,95
43,r_145_143_100,seq39,seq35,r_145_143_100,1.0,0,100,100,95
32,r_148_6_31,r_144_116_207,seq122,r_148_6_31,1.0,0,31,31,95
37,r_138_16_212,r_139_137_138,r_145_143_100,r_145_143_100,0.86,43,143,100,95
16,r_94_44_233,r_67_83_231,r_37_70_117,r_37_70_117,0.75,114,231,117,95
21,r_133_121_149,seq85,seq128,r_133_121_149,1.0,0,149,149,95
39,r_51_26_115,seq89,seq85,r_51_26_115,0.92,-8,107,115,95
5,r_144_116_207,r_24_141_211,seq113,r_144_116_207,1.0,0,207,207,95
46,r_110_95_262,seq2,seq98,r_110_95_262,0.52,0,262,262,95
42,r_139_137_138,r_138_16_212,r_28_72_55,r_138_16_212,0.73,-69,143,212,95
70,seq45,r_114_27_284,r_36_9_42,r_36_9_42,0.99,0,42,42,95
80,seq71,r_91_64_196,seq31,r_91_64_196,0.88,0,196,196,95
38,r_134_11_40,seq136,seq105,r_134_11_40,1.0,-1,39,40,95
69,seq129,seq74,r_96_135_91,r_96_135_91,1.0,1,92,91,95
33,r_92_81_34,r_41_76_263,r_20_100_36,r_92_81_34,0.98,0,34,34,95
31,r_32_17_141,seq0,r_96_135_91,r_32_17_141,0.69,0,141,141,95
41,r_77_88_116,r_66_102_73,seq34,r_66_102_73,1.0,-6,67,73,95
67,seq35,r_120_104_275,r_145_143_100,r_145_143_100,1.0,60,160,100,95
10,r_82_55_208,seq123,r_91_64_196,r_82_55_208,0.69,-1,207,208,95
26,r_40_142_92,r_140_53_299,seq58,r_40_142_92,1.0,0,92,92,95
8,r_112_115_62,seq111,r_61_29_222,r_61_29_222,1.0,9,231,222,95
4,r_41_76_263,seq113,seq13,r_41_76_263,0.63,0,263,263,95
0,r_147_87_139,seq18,r_146_119_46,r_147_87_139,1.0,1,140,139,95
11,r_50_54_167,seq23,seq131,r_50_54_167,0.98,1,168,167,95
20,r_12_84_272,seq93,r_61_29_222,r_12_84_272,0.68,0,272,272,95
13,r_91_64_196,seq71,r_146_119_46,r_91_64_196,0.65,0,196,196,95
77,seq65,r_146_119_46,r_38_30_181,r_38_30_181,0.88,-4,177,181,95
15,r_97_48_271,seq149,seq118,r_97_48_271,0.23,-20,251,271,95
48,r_49_59_84,r_140_53_299,r_148_6_31,r_49_59_84,1.0,0,84,84,95
57,seq10,seq78,r_117_124_130,r_117_124_130,1.0,19,149,130,95
12,r_62_60_150,r_110_95_262,r_82_55_208,r_62_60_150,0.92,82,232,150,95
90,seq105,r_38_30_181,r_134_11_40,r_134_11_40,1.0,-1,39,40,95
24,r_20_100_36,r_37_70_117,r_92_81_34,r_20_100_36,0.99,-1,35,36,95
34,r_86_8_166,seq63,r_24_141_211,r_24_141_211,0.97,10,221,211,95
41,r_77_88_116,seq34,r_5_75_274,r_77_88_116,0.99,1,117,116,95
22,r_146_119_46,seq39,r_147_87_139,r_147_87_139,1.0,5,144,139,95
2,r_66_102_73,r_77_88_116,seq3,r_66_102_73,1.0,1,74,73,95
93,seq108,seq3,r_22_21_4,r_22_21_4,0.57,277,281,4,95
18,r_61_29_222,seq57,r_112_115_62,r_112_115_62,0.5,160,222,62,95
29,r_37_70_117,seq108,seq15,r_37_70_117,0.8,1,118,117,95
35,r_5_75_274,r_77_88_116,r_110_95_262,r_5_75_274,0.97,0,274,274,95
77,seq65,r_117_124_130,r_146_119_46,r_117_124_130,0.94,0,130,130,95
34,r_86_8_166,seq118,seq63,r_86_8_166,0.71,1,167,166,95
47,r_28_72_55,r_86_8_166,seq15,r_28_72_55,0.58,2,57,55,95
60,seq18,r_147_87_139,seq19,r_147_87_139,1.0,0,139,139,95
17,r_80_79_192,r_41_76_263,seq109,r_80_79_192,0.79,-1,191,192,95
9,r_117_124_130,seq65,seq10,r_117_124_130,1.0,0,130,130,95
96,seq113,r_41_76_263,r_144_116_207,r_144_116_207,0.84,53,260,207,95
37,r_138_16_212,r_145_143_100,seq34,r_138_16_212,1.0,0,212,212,95
28,r_67_83_231,r_94_44_233,seq136,r_67_83_231,0.73,0,231,231,95
56,seq136,r_140_53_299,r_67_83_231,r_67_83_231,1.0,21,252,231,95
7,r_38_30_181,seq31,seq65,r_38_30_181,0.94,2,183,181,95
23,r_33_127_132,seq23,seq31,r_33_127_132,0.94,0,132,132,95
35,r_5_75_274,r_24_141_211,r_77_88_116,r_77_88_116,0.97,96,212,116,95
12,r_62_60_150,r_20_100_36,r_110_95_262,r_62_60_150,0.75,2,152,150,95
40,r_114_101_81,r_148_85_187,r_121_73_178,r_148_85_187,0.63,-9,178,187,96
30,r_143_70_80,r_62_131_262,r_81_78_53,r_143_70_80,0.84,8,88,80,96
36,r_148_85_187,seq82,r_114_101_81,r_114_101_81,0.65,1,82,81,96
33,r_95_86_34,r_130_134_205,seq38,r_95_86_34,0.48,1,35,34,96
92,seq109,r_30_94_199,r_11_128_162,r_11_128_162,1.0,89,251,162,96
8,r_11_128_162,seq55,r_3_89_160,r_11_128_162,0.97,0,162,162,96
43,r_22_7_66,seq61,seq27,r_22_7_66,0.99,0,66,66,96
37,r_140_19_213,r_98_35_129,seq80,r_98_35_129,1.0,0,129,129,96
54,seq137,r_1_141_21,r_48_102_247,r_48_102_247,0.84,1,248,247,96
59,seq20,r_48_102_247,r_140_19_213,r_140_19_213,0.81,12,225,213,96
4,r_118_122_54,r_68_149_98,r_107_52_141,r_118_122_54,0.99,45,99,54,96
13,r_50_5_12,r_130_134_205,seq72,r_50_5_12,0.93,0,12,12,96
55,seq139,r_58_124_149,r_37_106_259,r_58_124_149,1.0,0,149,149,96
86,seq93,seq80,r_68_149_98,r_68_149_98,1.0,2,100,98,96
21,r_112_16_282,seq32,r_17_145_20,r_112_16_282,0.42,0,282,282,96
39,r_58_124_149,seq139,seq96,r_58_124_149,0.99,0,149,149,96
1,r_10_103_238,seq100,r_33_87_117,r_33_87_117,1.0,122,239,117,96
5,r_51_23_176,r_107_52_141,r_143_70_80,r_143_70_80,0.62,44,124,80,96
72,seq55,seq15,r_138_123_210,r_138_123_210,1.0,0,210,210,96
46,r_97_67_224,seq109,r_17_145_20,r_97_67_224,0.97,0,224,224,96
45,r_68_149_98,r_118_122_54,seq93,r_68_149_98,0.78,1,99,98,96
19,r_3_89_160,seq26,r_11_128_162,r_3_89_160,0.99,2,162,160,96
95,seq115,r_24_74_151,seq38,r_24_74_151,0.8,0,151,151,96
17,r_17_145_20,r_3_89_160,seq72,r_17_145_20,1.0,0,20,20,96
7,r_43_60_266,r_6_119_134,seq0,r_6_119_134,0.86,-13,121,134,96
31,r_107_52_141,seq8,r_118_122_54,r_107_52_141,0.94,0,141,141,96
67,seq36,r_48_102_247,r_144_108_182,r_144_108_182,0.98,12,194,182,96
3,r_33_87_117,r_24_74_151,r_68_149_98,r_33_87_117,1.0,0,117,117,96
10,r_133_41_273,seq88,r_146_44_163,r_146_44_163,0.61,117,280,163,96
90,seq104,r_25_77_216,r_51_23_176,r_25_77_216,0.91,-1,215,216,96
26,r_47_147_295,r_56_21_229,r_83_45_46,r_83_45_46,0.9,57,103,46,96
72,seq55,r_11_128_162,seq15,r_11_128_162,1.0,0,162,162,96
78,seq72,seq96,r_17_145_20,r_17_145_20,1.0,119,139,20,96
0,r_25_77_216,seq104,seq49,r_25_77_216,0.53,1,217,216,96
63,seq28,r_14_90_289,r_11_128_162,r_11_128_162,1.0,127,289,162,96
20,r_56_21_229,seq113,r_25_77_216,r_56_21_229,0.92,0,229,229,96
15,r_39_29_71,r_14_90_289,seq91,r_39_29_71,0.94,3,74,71,96
57,seq15,seq55,r_148_85_187,r_148_85_187,1.0,23,210,187,96
13,r_50_5_12,seq72,r_17_145_20,r_17_145_20,0.74,105,125,20,96
6,r_130_134_205,r_75_111_232,r_116_2_123,r_130_134_205,0.74,0,205,205,96
5,r_51_23_176,r_143_70_80,r_12_57_6,r_51_23_176,0.8,8,184,176,96
36,r_148_85_187,r_114_101_81,seq15,r_148_85_187,0.89,0,187,187,96
27,r_142_40_166,seq91,r_37_106_259,r_142_40_166,0.9,0,166,166,96
22,r_116_2_123,r_33_87_117,r_130_134_205,r_130_134_205,1.0,4,209,205,96
41,r_81_78_53,r_130_134_205,r_51_23_176,r_81_78_53,0.94,-1,52,53,96
2,r_46_76_92,r_43_60_266,seq126,r_46_76_92,1.0,0,92,92,96
41,r_81_78_53,r_51_23_176,r_143_70_80,r_143_70_80,0.81,104,184,80,96
47,r_121_73_178,seq28,r_1_141_21,r_121_73_178,0.66,1,179,178,96
40,r_114_101_81,r_136_63_153,r_148_85_187,r_114_101_81,0.64,0,81,81,96
18,r_14_90_289,seq28,r_130_134_205,r_130_134_205,1.0,84,289,205,96
25,r_6_119_134,r_43_60_266,seq32,r_6_119_134,1.0,-1,133,134,96
65,seq32,r_62_131_262,r_39_29_71,r_39_29_71,0.62,164,235,71,96
7,r_43_60_266,seq0,r_10_103_238,r_43_60_266,0.51,0,266,266,96
32,r_144_108_182,seq96,seq36,r_144_108_182,1.0,0,182,182,96
38,r_120_53_150,r_3_89_160,r_143_70_80,r_143_70_80,0.87,72,152,80,96
4,r_118_122_54,r_98_35_129,r_68_149_98,r_118_122_54,0.83,0,54,54,96
34,r_98_35_129,r_140_19_213,seq31,r_98_35_129,0.81,0,129,129,96
94,seq113,r_56_21_229,r_83_45_46,r_83_45_46,0.68,164,210,46,96
48,r_1_141_21,r_130_134_205,seq82,r_1_141_21,0.64,-5,16,21,96
9,r_48_102_247,seq20,seq137,r_48_102_247,0.6,1,248,247,96
37,r_140_19_213,seq80,seq20,r_140_19_213,1.0,0,213,213,96
22,r_116_2_123,seq126,r_33_87_117,r_116_2_123,1.0,0,123,123,96
28,r_75_111_232,r_130_134_205,r_11_128_162,r_75_111_232,0.46,-27,205,232,96
49,r_30_94_199,seq109,r_98_35_129,r_98_35_129,1.0,70,199,129,96
7,r_43_60_266,r_46_76_92,r_6_119_134,r_46_76_92,0.95,0,92,92,96
44,r_62_131_262,seq49,seq72,r_62_131_262,0.65,0,262,262,96
23,r_136_63_153,seq38,seq31,r_136_63_153,0.81,3,156,153,96
28,r_75_111_232,r_11_128_162,seq0,r_75_111_232,0.95,0,232,232,96
11,r_83_45_46,r_10_103_238,r_47_147_295,r_83_45_46,1.0,0,46,46,96
35,r_138_123_210,seq38,seq55,r_138_123_210,0.87,0,210,210,96
12,r_146_44_163,r_30_94_199,r_1_141_21,r_146_44_163,0.58,7,170,163,96
93,seq105,r_55_138_253,seq60,r_55_138_253,1.0,0,253,253,97
30,r_115_19_111,r_72_149_284,seq106,r_115_19_111,1.0,0,111,111,97
51,seq4,r_33_97_207,r_119_39_120,r_119_39_120,1.0,90,210,120,97
36,r_127_129_159,r_33_97_207,seq142,r_127_129_159,0.53,0,159,159,97
14,r_33_97_207,seq4,r_123_107_215,r_33_97_207,0.48,8,215,207,97
8,r_8_116_276,r_89_98_193,r_62_74_148,r_8_116_276,0.72,-83,193,276,97
43,r_109_99_175,r_128_66_133,seq53,r_128_66_133,0.99,-64,69,133,97
54,seq10,r_49_25_172,r_72_149_284,r_49_25_172,0.91,-84,88,172,97
81,seq68,seq4,r_76_47_191,r_76_47_191,0.97,39,230,191,97
37,r_18_145_5,r_128_66_133,seq65,r_128_66_133,1.0,0,133,133,97
54,seq10,r_72_149_284,r_90_146_225,r_90_146_225,0.82,52,277,225,97
16,r_89_98_193,r_8_116_276,seq106,r_89_98_193,0.99,0,193,193,97
21,r_62_74_148,seq58,r_69_54_138,r_62_74_148,1.0,2,150,148,97
39,r_24_28_136,seq41,seq79,r_24_28_136,1.0,3,139,136,97
1,r_76_47_191,seq31,r_96_126_77,r_76_47_191,0.79,2,193,191,97
97,seq112,r_8_116_276,r_55_138_253,r_55_138_253,0.82,6,259,253,97
5,r_90_146_225,r_119_39_120,r_5_12_28,r_90_146_225,1.0,-105,120,225,97
46,r_30_51_114,seq27,r_128_66_133,r_128_66_133,1.0,44,177,133,97
42,r_46_21_187,seq26,seq65,r_46_21_187,0.98,0,187,187,97
24,r_7_77_11,r_5_12_28,seq141,r_7_77_11,0.94,0,11,11,97
98,seq148,seq31,r_120_133_60,r_120_133_60,0.89,-1,59,60,97
32,r_72_149_284,seq10,r_76_47_191,r_76_47_191,0.97,93,284,191,97
45,r_34_117_98,r_132_104_109,seq73,r_34_117_98,0.73,-1,97,98,97
19,r_48_80_94,seq11,r_64_43_248,r_48_80_94,0.57,10,104,94,97
33,r_87_45_272,r_35_85_54,r_55_138_253,r_55_138_253,0.64,19,272,253,97
31,r_35_85_54,r_2_108_123,r_87_45_272,r_35_85_54,1.0,0,54,54,97
11,r_5_12_28,r_119_39_120,seq52,r_119_39_120,1.0,0,120,120,97
3,r_13_114_56,r_48_80_94,seq73,r_13_114_56,0.96,-1,55,56,97
41,r_23_143_3,seq27,r_30_51_114,r_23_143_3,0.47,67,70,3,97
10,r_96_126_77,seq144,seq141,r_96_126_77,1.0,0,77,77,97
26,r_120_133_60,r_119_39_120,seq148,r_119_39_120,1.0,-55,65,120,97
8,r_8_116_276,r_62_74_148,r_71_137_34,r_8_116_276,0.35,1,277,276,97
4,r_64_43_248,seq0,r_48_80_94,r_64_43_248,0.33,-146,102,248,97
0,r_94_32_61,seq106,r_13_114_56,r_94_32_61,0.81,1,62,61,97
63,seq22,seq106,r_56_3_162,r_56_3_162,1.0,48,210,162,97
47,r_82_37_4,seq57,r_102_84_49,r_102_84_49,1.0,5,54,49,97
20,r_49_25_172,seq79,seq27,r_49_25_172,0.78,1,173,172,97
15,r_1_103_213,seq6,r_42_70_186,r_42_70_186,0.87,28,214,186,97
48,r_42_70_186,r_46_21_187,seq93,r_42_70_186,0.96,0,186,186,97
81,seq68,r_35_85_54,seq4,r_35_85_54,0.99,-6,48,54,97
57,seq141,r_2_108_123,r_96_126_77,r_96_126_77,0.79,46,123,77,97
6,r_123_107_215,seq144,seq58,r_123_107_215,0.95,0,215,215,97
85,seq79,r_49_25_172,r_24_28_136,r_24_28_136,1.0,22,158,136,97
5,r_90_146_225,r_5_12_28,seq79,r_90_146_225,0.78,0,225,225,97
27,r_55_138_253,seq105,seq112,r_55_138_253,0.66,0,253,253,97
29,r_102_84_49,r_16_91_168,r_82_37_4,r_102_84_49,0.88,0,49,49,97
22,r_71_137_34,r_56_3_162,seq26,r_56_3_162,1.0,1,163,162,97
69,seq40,seq79,r_34_117_98,r_34_117_98,1.0,75,173,98,97
22,r_71_137_34,seq147,r_56_3_162,r_71_137_34,0.95,-1,33,34,97
2,r_88_122_184,seq6,r_5_12_28,r_88_122_184,0.92,0,184,184,97
41,r_23_143_3,r_30_51_114,r_2_108_123,r_2_108_123,1.0,18,141,123,97
25,r_44_121_183,seq148,r_118_92_6,r_44_121_183,0.91,0,183,183,97
43,r_109_99_175,seq53,seq27,r_109_99_175,1.0,0,175,175,97
33,r_87_45_272,r_69_54_138,r_35_85_54,r_87_45_272,0.79,-192,80,272,97
88,seq142,seq11,r_127_129_159,r_127_129_159,0.98,11,170,159,97
85,seq79,r_24_28_136,r_90_146_225,r_90_146_225,1.0,0,225,225,97
70,seq41,r_24_28_136,r_120_133_60,r_24_28_136,1.0,3,139,136,97
65,seq27,r_30_51_114,r_109_99_175,r_109_99_175,1.0,2,177,175,97
11,r_5_12_28,r_23_143_3,r_119_39_120,r_5_12_28,0.96,0,28,28,97
61,seq147,r_136_15_164,seq67,r_136_15_164,0.87,0,164,164,97
32,r_72_149_284,r_115_19_111,seq10,r_115_19_111,1.0,-1,110,111,97
38,r_69_54_138,seq83,seq144,r_69_54_138,0.58,0,138,138,97
77,seq60,r_16_91_168,seq105,r_16_91_168,1.0,1,169,168,97
69,seq40,r_131_130_189,seq79,r_131_130_189,0.51,-141,48,189,97
34,r_128_66_133,r_18_145_5,r_30_51_114,r_128_66_133,1.0,0,133,133,97
17,r_16_91_168,seq60,seq36,r_16_91_168,0.99,1,169,168,97
9,r_113_61_292,r_24_28_136,seq53,r_24_28_136,0.99,-42,94,136,97
31,r_35_85_54,r_87_45_272,seq83,r_87_45_272,0.53,-32,240,272,97
28,r_134_95_100,seq17,seq53,r_134_95_100,1.0,0,100,100,97
13,r_29_125_47,seq93,seq81,r_29_125_47,0.92,0,47,47,97
49,r_2_108_123,seq141,seq78,r_2_108_123,1.0,0,123,123,97
69,seq40,r_34_117_98,r_90_146_225,r_90_146_225,1.0,54,279,225,97
56,seq140,seq105,r_119_39_120,r_119_39_120,1.0,9,129,120,97
7,r_119_39_120,r_90_146_225,seq140,r_119_39_120,0.99,0,120,120,97
44,r_56_3_162,r_46_21_187,seq22,r_56_3_162,1.0,1,163,162,97
23,r_131_130_189,seq141,seq6,r_131_130_189,0.83,0,189,189,97
82,seq73,r_2_108_123,r_34_117_98,r_34_117_98,0.82,12,110,98,97
35,r_132_104_109,seq148,r_30_51_114,r_132_104_109,1.0,0,109,109,97
36,r_99_126_106,seq138,r_57_121_13,r_57_121_13,0.94,93,106,13,98
14,r_77_141_76,r_15_18_254,seq14,r_77_141_76,1.0,2,78,76,98
53,seq133,r_76_39_121,r_99_126_106,r_76_39_121,0.66,1,122,121,98
37,r_109_83_276,seq56,r_76_39_121,r_76_39_121,1.0,40,161,121,98
3,r_111_47_51,r_70_34_251,seq21,r_70_34_251,1.0,2,253,251,98
16,r_110_84_107,seq42,seq66,r_110_84_107,1.0,0,107,107,98
39,r_59_97_108,r_4_25_200,seq30,r_59_97_108,0.52,0,108,108,98
1,r_147_23_238,seq21,r_60_52_120,r_147_23_238,0.9,0,238,238,98
5,r_120_49_97,r_109_83_276,seq119,r_120_49_97,0.61,0,97,97,98
46,r_28_134_235,seq53,seq133,r_28_134_235,0.85,0,235,235,98
42,r_93_27_268,r_37_50_273,r_92_118_6,r_93_27_268,0.52,0,268,268,98
80,seq74,r_45_65_213,seq66,r_45_65_213,0.94,0,213,213,98
32,r_4_25_200,seq6,r_77_141_76,r_4_25_200,0.95,-1,199,200,98
19,r_116_79_228,seq98,r_29_105_112,r_116_79_228,0.6,4,232,228,98
15,r_136_0_138,r_93_27_268,seq8,r_93_27_268,0.99,0,268,268,98
45,r_113_10_31,r_16_107_270,seq82,r_113_10_31,1.0,1,32,31,98
31,r_72_43_48,r_147_23_238,r_5_146_20,r_147_23_238,0.69,-184,54,238,98
11,r_15_18_254,seq35,seq138,r_15_18_254,1.0,0,254,254,98
95,seq119,seq131,r_120_49_97,r_120_49_97,0.68,4,101,97,98
66,seq32,seq30,r_124_103_224,r_124_103_224,0.69,19,243,224,98
41,r_37_50_273,r_93_27_268,r_68_2_283,r_37_50_273,0.57,-4,269,273,98
12,r_76_39_121,r_109_83_276,seq56,r_109_83_276,0.74,0,276,276,98
67,seq35,r_15_18_254,seq22,r_15_18_254,1.0,-172,82,254,98
73,seq56,r_109_83_276,r_76_39_121,r_76_39_121,1.0,155,276,121,98
11,r_15_18_254,r_63_17_160,seq35,r_63_17_160,0.64,26,186,160,98
13,r_68_2_283,r_143_95_152,r_41_130_232,r_143_95_152,1.0,0,152,152,98
49,r_70_34_251,r_147_23_238,r_111_47_51,r_70_34_251,0.54,-183,68,251,98
15,r_136_0_138,r_4_25_200,r_93_27_268,r_136_0_138,0.95,0,138,138,98
12,r_76_39_121,r_57_121_13,r_109_83_276,r_76_39_121,1.0,-3,118,121,98
13,r_68_2_283,r_41_130_232,r_37_50_273,r_41_130_232,1.0,-1,231,232,98
83,seq82,r_15_18_254,r_113_10_31,r_113_10_31,0.9,28,59,31,98
27,r_29_105_112,seq86,seq6,r_29_105_112,0.95,-2,110,112,98
53,seq133,r_99_126_106,r_28_134_235,r_28_134_235,1.0,21,256,235,98
87,seq98,r_116_79_228,seq42,r_116_79_228,0.84,1,229,228,98
2,r_48_102_167,seq104,seq32,r_48_102_167,0.74,16,183,167,98
47,r_3_145_280,seq100,r_77_141_76,r_77_141_76,0.99,208,284,76,98
3,r_111_47_51,r_76_39_121,r_70_34_251,r_111_47_51,0.71,1,52,51,98
18,r_60_52_120,seq6,r_64_40_234,r_60_52_120,1.0,0,120,120,98
29,r_127_135_208,seq30,r_92_118_6,r_127_135_208,1.0,0,208,208,98
24,r_143_95_152,r_68_2_283,seq13,r_143_95_152,1.0,0,152,152,98
25,r_20_128_226,r_44_91_252,r_64_40_234,r_20_128_226,0.89,0,226,226,98
33,r_101_112_258,seq100,r_29_105_112,r_29_105_112,0.52,147,259,112,98
48,r_57_121_13,r_76_39_121,r_99_126_106,r_76_39_121,0.94,-3,118,121,98
88,seq100,r_71_80_216,r_92_118_6,r_71_80_216,0.96,0,216,216,98
50,seq129,r_69_24_210,seq139,r_69_24_210,0.99,1,211,210,98
49,r_70_34_251,r_5_146_20,r_147_23_238,r_70_34_251,0.52,-234,17,251,98
61,seq14,seq117,r_77_141_76,r_77_141_76,0.98,-3,73,76,98
32,r_4_25_200,r_59_97_108,seq6,r_59_97_108,1.0,0,108,108,98
38,r_71_80_216,seq100,r_144_36_3,r_71_80_216,0.82,0,216,216,98
77,seq66,r_96_94_181,seq74,r_96_94_181,0.97,1,182,181,98
34,r_69_24_210,seq129,r_60_52_120,r_69_24_210,0.92,1,211,210,98
60,seq13,seq86,r_143_95_152,r_143_95_152,1.0,61,213,152,98
48,r_57_121_13,r_33_148_32,r_76_39_121,r_57_121_13,0.51,3,16,13,98
9,r_45_65_213,seq74,seq53,r_45_65_213,0.97,0,213,213,98
37,r_109_83_276,r_76_39_121,r_110_84_107,r_109_83_276,0.83,0,276,276,98
22,r_54_73_253,seq55,r_44_91_252,r_44_91_252,0.84,2,254,252,98
44,r_41_130_232,r_68_2_283,r_29_105_112,r_41_130_232,0.51,1,233,232,98
7,r_33_148_32,r_64_40_234,r_5_146_20,r_33_148_32,1.0,0,32,32,98
49,r_70_34_251,r_111_47_51,seq22,r_70_34_251,0.92,0,251,251,98
12,r_76_39_121,r_111_47_51,r_57_121_13,r_111_47_51,0.97,1,52,51,98
35,r_63_17_160,r_15_18_254,seq140,r_15_18_254,0.77,-84,170,254,98
84,seq86,r_29_105_112,seq13,r_29_105_112,0.44,4,116,112,98
40,r_135_62_223,r_37_32_249,r_117_25_27,r_135_62_223,0.55,0,223,223,99
47,r_51_47_18,r_54_79_275,seq96,r_51_47_18,0.97,1,19,18,99
14,r_126_68_213,r_97_92_232,r_147_36_182,r_126_68_213,0.92,1,214,213,99
43,r_37_32_249,seq80,seq28,r_37_32_249,0.47,0,249,249,99
15,r_10_124_35,seq145,seq21,r_10_124_35,0.99,0,35,35,99
37,r_18_83_289,r_137_141_225,seq85,r_137_141_225,0.64,0,225,225,99
59,seq12,r_149_140_184,r_132_5_121,r_132_5_121,1.0,70,191,121,99
86,seq80,r_37_32_249,r_137_141_225,r_137_141_225,0.87,24,249,225,99
16,r_88_93_214,r_128_20_217,r_134_58_24,r_88_93_214,0.71,3,217,214,99
21,r_64_53_132,seq1,r_94_111_185,r_64_53_132,0.76,0,132,132,99
39,r_131_102_11,r_146_142_286,r_89_65_89,r_89_65_89,0.63,71,160,89,99
1,r_54_79_275,seq35,r_133_114_165,r_54_79_275,0.26,-1,274,275,99
97,seq120,r_98_17_84,r_147_36_182,r_147_36_182,0.81,-37,145,182,99
32,r_99_24_32,r_125_115_31,r_44_106_133,r_44_106_133,0.95,-2,131,133,99
45,r_81_60_76,seq144,seq101,r_81_60_76,0.98,-1,75,76,99
34,r_117_25_27,r_74_121_46,r_125_115_31,r_117_25_27,0.55,-1,26,27,99
27,r_134_58_24,r_44_106_133,seq72,r_44_106_133,0.62,11,144,133,99
31,r_61_30_105,r_135_62_223,seq144,r_61_30_105,0.93,3,108,105,99
41,r_14_26_191,r_84_104_298,seq43,r_14_26_191,0.72,0,191,191,99
20,r_147_36_182,seq120,r_126_68_213,r_126_68_213,0.98,12,225,213,99
17,r_74_121_46,r_46_49_37,seq0,r_74_121_46,0.94,-6,40,46,99
0,r_2_31_172,seq22,seq50,r_2_31_172,0.85,1,173,172,99
11,r_44_106_133,seq28,r_99_24_32,r_99_24_32,0.73,104,136,32,99
32,r_99_24_32,seq11,r_125_115_31,r_99_24_32,0.92,0,32,32,99
3,r_119_143_13,r_2_31_172,seq145,r_119_143_13,0.98,0,13,13,99
20,r_147_36_182,seq19,seq120,r_147_36_182,0.63,0,182,182,99
13,r_137_141_225,seq38,r_81_60_76,r_81_60_76,0.87,149,225,76,99
98,seq123,r_103_48_148,seq127,r_103_48_148,1.0,1,149,148,99
27,r_134_58_24,seq72,r_88_93_214,r_88_93_214,0.97,11,225,214,99
48,r_40_136_236,r_6_52_58,r_10_124_35,r_6_52_58,0.82,1,59,58,99
27,r_134_58_24,r_122_55_102,r_44_106_133,r_122_55_102,0.79,-28,74,102,99
2,r_98_17_84,r_88_93_214,seq1,r_98_17_84,0.99,-1,83,84,99
40,r_135_62_223,r_61_30_105,r_37_32_249,r_61_30_105,0.99,9,114,105,99
18,r_122_55_102,seq22,r_84_104_298,r_122_55_102,0.97,1,103,102,99
35,r_108_41_104,r_95_59_291,r_23_67_171,r_23_67_171,1.0,11,182,171,99
33,r_6_52_58,seq110,r_117_25_27,r_6_52_58,1.0,6,64,58,99
48,r_40_136_236,r_10_124_35,seq85,r_40_136_236,0.73,-1,235,236,99
5,r_63_56_23,r_125_115_31,r_94_111_185,r_63_56_23,0.87,0,23,23,99
70,seq35,seq105,r_89_65_89,r_89_65_89,0.69,174,263,89,99
52,seq130,r_97_92_232,r_46_49_37,r_46_49_37,0.71,194,231,37,99
24,r_46_49_37,r_74_121_46,seq130,r_46_49_37,1.0,0,37,37,99
75,seq45,r_125_115_31,r_108_41_104,r_108_41_104,1.0,51,155,104,99
9,r_71_3_144,r_37_32_249,seq28,r_71_3_144,0.45,0,144,144,99
37,r_18_83_289,seq85,r_88_93_214,r_18_83_289,0.76,0,289,289,99
22,r_149_140_184,seq12,r_63_56_23,r_63_56_23,0.91,168,191,23,99
34,r_117_25_27,r_125_115_31,r_6_52_58,r_6_52_58,0.68,7,65,58,99
7,r_94_111_185,seq76,r_64_53_132,r_64_53_132,0.9,11,143,132,99
44,r_23_67_171,seq35,r_125_115_31,r_23_67_171,0.97,2,173,171,99
23,r_103_48_148,seq123,r_6_52_58,r_103_48_148,0.8,1,149,148,99
19,r_112_34_47,seq138,seq100,r_112_34_47,1.0,0,47,47,99
79,seq69,r_90_118_195,r_133_114_165,r_90_118_195,0.9,-21,174,195,99
35,r_108_41_104,r_39_33_288,r_95_59_291,r_108_41_104,0.73,14,118,104,99
