14,r_148_78_66,r_109_110_139,seq57,r_109_110_139,0.69,-73,66,139,0
43,r_137_124_161,r_141_47_242,seq16,r_137_124_161,0.66,2,163,161,0
0,r_95_129_27,seq16,r_22_60_13,r_95_129_27,0.99,0,27,27,0
60,seq24,r_80_53_102,r_19_79_29,r_19_79_29,1.0,0,29,29,0
37,r_86_35_197,r_23_133_124,r_136_36_11,r_23_133_124,0.65,0,124,124,0
39,r_146_145_23,r_102_51_111,r_22_60_13,r_146_145_23,0.57,-2,21,23,0
59,seq21,r_104_75_177,r_32_97_140,r_32_97_140,1.0,49,189,140,0
71,seq54,seq77,r_23_133_124,r_23_133_124,1.0,1,125,124,0
42,r_18_42_134,seq114,r_140_142_22,r_18_42_134,1.0,0,134,134,0
58,seq16,seq38,r_137_124_161,r_137_124_161,0.68,7,168,161,0
19,r_98_5_212,r_44_6_187,r_32_97_140,r_32_97_140,0.78,47,187,140,0
16,r_65_71_20,r_68_45_157,seq111,r_65_71_20,0.89,0,20,20,0
11,r_90_94_14,r_140_142_22,seq69,r_90_94_14,0.73,-1,13,14,0
31,r_32_97_140,seq111,seq21,r_32_97_140,1.0,0,140,140,0
3,r_101_11_184,seq84,r_140_142_22,r_101_11_184,0.97,0,184,184,0
33,r_22_60_13,r_20_9_2,r_3_62_59,r_22_60_13,0.92,0,13,13,0
26,r_55_147_109,r_32_97_140,r_76_117_40,r_55_147_109,1.0,0,109,109,0
4,r_58_112_77,r_102_51_111,seq77,r_58_112_77,1.0,0,77,77,0
18,r_8_1_51,r_123_72_192,r_19_79_29,r_8_1_51,0.84,1,52,51,0
21,r_3_62_59,r_139_115_136,r_140_142_22,r_3_62_59,0.63,-1,58,59,0
99,seq127,r_10_116_204,r_104_75_177,r_10_116_204,0.56,-35,169,204,0
13,r_85_83_74,r_26_64_63,r_90_94_14,r_85_83_74,1.0,0,74,74,0
46,r_10_116_204,r_19_79_29,r_65_71_20,r_10_116_204,0.68,2,206,204,0
15,r_68_45_157,seq28,seq89,r_68_45_157,0.99,0,157,157,0
49,r_19_79_29,r_10_116_204,r_8_1_51,r_19_79_29,0.8,177,206,29,0
6,r_125_13_71,seq88,r_130_46_92,r_125_13_71,0.99,9,80,71,0
5,r_140_142_22,r_119_134_174,r_18_42_134,r_140_142_22,0.96,152,174,22,0
33,r_22_60_13,r_3_62_59,r_146_145_23,r_3_62_59,0.99,3,62,59,0
30,r_76_117_40,r_39_59_61,seq28,r_76_117_40,1.0,0,40,40,0
0,r_95_129_27,r_22_60_13,r_80_53_102,r_80_53_102,0.65,27,129,102,0
27,r_4_81_239,seq111,r_136_36_11,r_136_36_11,0.69,228,239,11,0
2,r_40_106_144,seq144,seq61,r_40_106_144,0.74,0,144,144,0
47,r_135_49_179,seq69,r_8_1_51,r_135_49_179,0.88,0,179,179,0
48,r_27_118_45,seq16,seq15,r_27_118_45,1.0,0,45,45,0
40,r_23_133_124,r_86_35_197,seq54,r_23_133_124,1.0,0,124,124,0
46,r_10_116_204,r_130_46_92,r_19_79_29,r_19_79_29,1.0,1,30,29,0
24,r_109_110_139,seq16,seq89,r_109_110_139,0.98,0,139,139,0
25,r_130_46_92,r_10_116_204,r_125_13_71,r_130_46_92,0.99,0,92,92,0
58,seq16,r_109_110_139,seq38,r_109_110_139,0.85,0,139,139,0
36,r_26_64_63,r_85_83_74,seq87,r_85_83_74,0.99,-24,50,74,0
32,r_105_14_110,seq128,r_90_94_14,r_105_14_110,1.0,0,110,110,0
38,r_139_115_136,seq89,seq132,r_139_115_136,0.84,7,143,136,0
19,r_98_5_212,r_32_97_140,r_58_112_77,r_98_5_212,0.66,0,212,212,0
34,r_149_103_193,seq28,r_82_100_16,r_149_103_193,0.88,0,193,193,0
57,seq15,seq7,r_27_118_45,r_27_118_45,1.0,7,52,45,0
5,r_140_142_22,seq89,r_119_134_174,r_140_142_22,0.78,-1,21,22,0
93,seq111,r_55_147_109,r_65_71_20,r_65_71_20,0.64,0,20,20,0
81,seq77,seq54,r_58_112_77,r_58_112_77,1.0,0,77,77,0
17,r_52_33_132,r_108_67_201,seq77,r_52_33_132,0.92,3,135,132,0
37,r_86_35_197,r_136_36_11,r_149_103_193,r_149_103_193,0.66,4,197,193,0
49,r_19_79_29,r_39_59_61,r_10_116_204,r_19_79_29,1.0,1,30,29,0
22,r_39_59_61,r_8_1_51,r_90_94_14,r_39_59_61,0.98,-1,60,61,0
28,r_44_6_187,r_98_5_212,seq93,r_44_6_187,0.57,0,187,187,0
35,r_123_72_192,r_8_1_51,r_102_51_111,r_8_1_51,0.66,-11,40,51,0
7,r_80_53_102,r_10_116_204,r_22_60_13,r_80_53_102,0.91,30,132,102,0
44,r_119_134_174,seq131,seq28,r_119_134_174,0.51,0,174,174,0
23,r_108_67_201,seq29,r_125_13_71,r_108_67_201,0.82,0,201,201,0
12,r_102_51_111,r_86_35_197,r_123_72_192,r_102_51_111,0.69,13,124,111,0
37,r_83_81_47,r_0_148_113,seq32,r_83_81_47,1.0,0,47,47,1
30,r_125_135_158,seq138,r_1_86_49,r_125_135_158,0.94,1,159,158,1
19,r_66_44_43,r_98_99_36,r_73_144_39,r_98_99_36,0.85,7,43,36,1
25,r_54_33_18,r_125_135_158,seq107,r_54_33_18,0.99,0,18,18,1
43,r_74_18_168,seq55,r_103_130_161,r_103_130_161,1.0,2,163,161,1
59,seq14,r_125_135_158,r_94_123_203,r_125_135_158,0.42,-48,110,158,1
16,r_94_123_203,seq116,r_121_68_126,r_121_68_126,1.0,7,133,126,1
21,r_11_117_208,r_129_85_205,seq112,r_11_117_208,0.65,0,208,208,1
1,r_26_28_239,r_129_85_205,r_111_27_247,r_129_85_205,0.88,-11,194,205,1
97,seq116,r_124_46_204,seq134,r_124_46_204,0.92,0,204,204,1
5,r_78_108_105,seq120,r_25_97_212,r_78_108_105,0.99,3,108,105,1
42,r_131_48_73,seq60,r_98_99_36,r_131_48_73,1.0,0,73,73,1
69,seq35,seq82,r_80_61_96,r_80_61_96,0.86,62,158,96,1
31,r_80_61_96,r_98_99_36,seq35,r_80_61_96,0.7,0,96,96,1
10,r_3_70_66,seq21,seq49,r_3_70_66,1.0,0,66,66,1
26,r_37_43_150,r_89_128_194,r_115_39_241,r_37_43_150,0.65,1,151,150,1
72,seq47,seq12,r_94_123_203,r_94_123_203,0.98,20,223,203,1
16,r_94_123_203,r_121_68_126,seq47,r_94_123_203,0.91,1,204,203,1
4,r_0_148_113,seq134,r_78_108_105,r_0_148_113,1.0,0,113,113,1
0,r_105_106_139,seq59,seq120,r_105_106_139,0.99,0,139,139,1
73,seq49,r_45_84_220,r_3_70_66,r_3_70_66,1.0,0,66,66,1
11,r_57_79_199,seq12,seq100,r_57_79_199,0.81,0,199,199,1
20,r_113_40_118,seq55,r_24_29_65,r_24_29_65,1.0,54,119,65,1
13,r_129_85_205,r_11_117_208,seq7,r_129_85_205,0.58,1,206,205,1
15,r_25_97_212,r_24_29_65,r_89_128_194,r_24_29_65,0.86,11,76,65,1
48,r_90_93_111,seq120,r_16_38_222,r_16_38_222,0.84,-100,122,222,1
14,r_133_77_35,seq49,seq120,r_133_77_35,1.0,1,36,35,1
99,seq120,r_90_93_111,r_105_106_139,r_105_106_139,1.0,2,141,139,1
5,r_78_108_105,r_25_97_212,r_0_148_113,r_25_97_212,0.98,0,212,212,1
40,r_1_86_49,r_87_9_153,r_66_44_43,r_1_86_49,1.0,0,49,49,1
47,r_140_114_180,seq96,r_103_130_161,r_140_114_180,1.0,0,180,180,1
87,seq141,r_2_72_140,r_50_119_143,r_50_119_143,0.63,3,146,143,1
29,r_87_9_153,r_1_86_49,seq62,r_1_86_49,1.0,0,49,49,1
2,r_4_127_198,seq132,r_111_27_247,r_4_127_198,0.71,0,198,198,1
47,r_140_114_180,r_89_128_194,seq96,r_89_128_194,0.32,-45,149,194,1
18,r_145_67_99,r_103_130_161,seq58,r_145_67_99,1.0,0,99,99,1
24,r_103_130_161,seq59,r_133_77_35,r_103_130_161,0.96,0,161,161,1
34,r_121_68_126,r_94_123_203,r_145_67_99,r_94_123_203,0.92,1,204,203,1
33,r_126_75_100,seq35,seq13,r_126_75_100,1.0,0,100,100,1
15,r_25_97_212,r_89_128_194,r_78_108_105,r_25_97_212,0.5,-107,105,212,1
32,r_109_102_120,seq56,seq132,r_109_102_120,1.0,2,122,120,1
34,r_121_68_126,r_45_84_220,r_94_123_203,r_121_68_126,0.99,0,126,126,1
35,r_89_128_194,seq96,seq62,r_89_128_194,0.72,0,194,194,1
9,r_124_46_204,seq116,r_149_95_5,r_149_95_5,0.85,199,204,5,1
15,r_25_97_212,r_78_108_105,r_94_123_203,r_78_108_105,0.88,108,213,105,1
29,r_87_9_153,seq62,r_24_29_65,r_87_9_153,0.85,0,153,153,1
28,r_92_51_169,seq60,seq14,r_92_51_169,0.97,1,170,169,1
49,r_71_5_146,seq55,r_149_95_5,r_71_5_146,0.97,0,146,146,1
1,r_26_28_239,r_111_27_247,r_50_119_143,r_26_28_239,0.84,0,239,239,1
7,r_111_27_247,r_129_85_205,r_4_127_198,r_111_27_247,0.56,-44,203,247,1
44,r_36_101_177,r_129_85_205,r_125_135_158,r_36_101_177,0.81,0,177,177,1
82,seq62,r_87_9_153,r_89_128_194,r_87_9_153,0.7,-1,152,153,1
35,r_89_128_194,r_37_43_150,seq96,r_37_43_150,0.73,1,151,150,1
12,r_41_19_91,seq112,r_24_29_65,r_41_19_91,0.99,1,92,91,1
40,r_115_34_216,r_120_73_15,r_54_83_177,r_115_34_216,0.89,0,216,216,2
30,r_28_7_160,seq25,seq44,r_28_7_160,0.91,0,160,160,2
92,seq105,seq143,r_52_33_144,r_52_33_144,0.75,1,145,144,2
14,r_23_2_93,r_31_128_247,r_100_71_55,r_23_2_93,0.88,0,93,93,2
8,r_103_145_151,seq9,seq11,r_103_145_151,0.98,0,151,151,2
43,r_39_95_184,seq76,r_22_130_41,r_39_95_184,0.94,1,185,184,2
0,r_114_131_28,r_68_89_243,r_81_72_63,r_114_131_28,0.84,-1,27,28,2
37,r_3_135_53,seq143,r_60_48_175,r_60_48_175,0.46,4,179,175,2
31,r_120_73_15,r_36_149_54,r_115_34_216,r_120_73_15,0.99,0,15,15,2
5,r_65_21_46,seq85,seq4,r_65_21_46,1.0,0,46,46,2
55,seq11,r_129_111_75,r_102_20_211,r_129_111_75,1.0,0,75,75,2
21,r_138_69_156,r_78_53_176,r_15_94_221,r_138_69_156,0.81,0,156,156,2
46,r_49_24_112,seq4,seq45,r_49_24_112,0.99,1,113,112,2
42,r_102_20_211,seq11,r_106_32_39,r_102_20_211,0.61,0,211,211,2
32,r_52_33_144,r_133_0_61,seq105,r_52_33_144,0.94,0,144,144,2
45,r_41_35_162,seq45,r_129_111_75,r_41_35_162,1.0,0,162,162,2
34,r_81_72_63,r_36_149_54,r_114_131_28,r_36_149_54,0.61,-25,29,54,2
19,r_93_96_78,seq66,seq46,r_93_96_78,1.0,1,79,78,2
44,r_67_79_44,seq139,seq123,r_67_79_44,1.0,2,46,44,2
41,r_91_51_225,seq137,r_22_130_41,r_22_130_41,1.0,184,225,41,2
72,seq46,r_113_109_17,r_93_96_78,r_93_96_78,1.0,4,82,78,2
4,r_57_1_87,r_92_16_116,seq75,r_57_1_87,0.64,0,87,87,2
11,r_19_90_83,seq44,seq134,r_19_90_83,1.0,2,85,83,2
47,r_36_149_54,r_15_94_221,r_6_59_241,r_36_149_54,1.0,0,54,54,2
20,r_119_30_231,seq12,seq144,r_119_30_231,0.59,1,232,231,2
17,r_22_130_41,seq38,seq141,r_22_130_41,1.0,0,41,41,2
98,seq126,r_91_51_225,r_42_17_45,r_42_17_45,1.0,32,77,45,2
15,r_26_74_152,seq144,r_120_73_15,r_26_74_152,0.96,0,152,152,2
12,r_61_18_13,seq85,r_112_10_129,r_112_10_129,0.83,0,129,129,2
36,r_6_59_241,r_100_71_55,r_36_149_54,r_6_59_241,0.97,-187,54,241,2
6,r_92_16_116,r_54_83_177,seq5,r_92_16_116,1.0,0,116,116,2
76,seq55,r_15_94_221,r_114_131_28,r_114_131_28,0.72,12,40,28,2
27,r_122_99_202,seq40,r_129_111_75,r_129_111_75,1.0,134,209,75,2
2,r_58_104_97,seq143,seq147,r_58_104_97,0.98,2,99,97,2
39,r_101_142_20,r_60_48_175,seq9,r_101_142_20,1.0,0,20,20,2
12,r_61_18_13,r_57_1_87,seq85,r_61_18_13,0.98,0,13,13,2
24,r_112_10_129,seq140,r_61_18_13,r_112_10_129,0.98,0,129,129,2
35,r_133_0_61,seq85,r_54_83_177,r_54_83_177,1.0,6,183,177,2
25,r_13_29_126,seq123,r_97_86_101,r_97_86_101,1.0,28,129,101,2
64,seq25,r_28_7_160,seq8,r_28_7_160,1.0,-65,95,160,2
32,r_52_33_144,seq85,r_133_0_61,r_133_0_61,1.0,-4,57,61,2
18,r_100_71_55,r_6_59_241,seq56,r_100_71_55,0.97,0,55,55,2
76,seq55,r_114_131_28,r_60_48_175,r_114_131_28,0.63,147,175,28,2
40,r_115_34_216,r_22_130_41,r_120_73_15,r_115_34_216,0.96,-202,14,216,2
60,seq144,r_26_74_152,r_108_110_229,r_26_74_152,0.72,0,152,152,2
9,r_78_53_176,r_138_69_156,seq127,r_138_69_156,1.0,-3,153,156,2
96,seq123,r_13_29_126,r_67_79_44,r_67_79_44,1.0,85,129,44,2
31,r_120_73_15,r_115_34_216,r_42_17_45,r_42_17_45,0.57,171,216,45,2
22,r_129_111_75,seq11,seq143,r_129_111_75,1.0,0,75,75,2
13,r_42_17_45,seq84,r_120_73_15,r_42_17_45,1.0,2,47,45,2
49,r_77_63_161,seq143,r_57_1_87,r_57_1_87,0.78,76,163,87,2
56,seq12,r_119_30_231,r_22_130_41,r_22_130_41,1.0,157,198,41,2
7,r_54_83_177,r_119_30_231,r_133_0_61,r_54_83_177,0.66,0,177,177,2
23,r_97_86_101,seq147,seq85,r_97_86_101,1.0,0,101,101,2
79,seq66,r_93_96_78,r_124_132_1,r_93_96_78,0.96,1,79,78,2
35,r_133_0_61,r_15_94_221,seq85,r_133_0_61,0.91,3,64,61,2
18,r_100_71_55,seq56,r_23_2_93,r_23_2_93,1.0,3,96,93,2
84,seq76,r_39_95_184,r_113_109_17,r_39_95_184,0.99,1,185,184,2
55,seq11,r_102_20_211,r_103_145_151,r_103_145_151,0.93,50,201,151,2
40,r_38_142_167,seq149,r_51_33_202,r_38_142_167,1.0,1,168,167,3
20,r_15_131_29,r_94_132_50,seq100,r_15_131_29,0.96,6,35,29,3
51,seq130,r_92_139_94,seq80,r_92_139_94,1.0,0,94,94,3
36,r_70_125_136,seq48,r_95_47_211,r_70_125_136,0.87,4,140,136,3
14,r_95_47_211,seq122,r_70_125_136,r_70_125_136,0.89,4,140,136,3
54,seq135,r_75_0_96,seq53,r_75_0_96,0.92,2,98,96,3
37,r_75_0_96,seq65,r_92_139_94,r_75_0_96,0.97,0,96,96,3
59,seq21,seq107,r_92_139_94,r_92_139_94,0.94,0,94,94,3
2,r_28_82_57,seq34,r_44_69_11,r_28_82_57,1.0,1,58,57,3
24,r_91_102_59,r_99_14_226,seq45,r_91_102_59,1.0,0,59,59,3
71,seq61,r_35_3_192,r_86_29_93,r_86_29_93,0.6,100,193,93,3
86,seq100,r_145_66_213,r_141_2_173,r_141_2_173,0.75,41,214,173,3
5,r_86_29_93,r_5_46_164,seq61,r_86_29_93,1.0,1,94,93,3
46,r_51_33_202,r_49_124_89,r_143_108_12,r_49_124_89,0.88,3,92,89,3
31,r_96_93_56,seq67,r_40_84_231,r_96_93_56,0.95,0,56,56,3
7,r_40_84_231,r_96_93_56,r_5_46_164,r_5_46_164,0.84,67,231,164,3
69,seq53,seq65,r_51_33_202,r_51_33_202,0.34,4,206,202,3
45,r_44_69_11,r_110_50_243,r_28_82_57,r_28_82_57,1.0,175,232,57,3
19,r_109_43_140,r_77_88_2,r_12_138_60,r_77_88_2,0.98,138,140,2,3
95,seq115,seq80,r_54_55_107,r_54_55_107,0.56,38,145,107,3
7,r_40_84_231,r_76_60_153,r_96_93_56,r_40_84_231,1.0,-173,58,231,3
67,seq48,r_70_125_136,seq104,r_70_125_136,1.0,4,140,136,3
89,seq105,r_99_14_226,r_11_7_77,r_11_7_77,0.96,150,227,77,3
10,r_92_139_94,seq130,seq21,r_92_139_94,0.83,0,94,94,3
26,r_11_7_77,r_38_142_167,seq4,r_11_7_77,0.97,1,78,77,3
72,seq63,r_116_83_212,r_11_7_77,r_11_7_77,0.93,135,212,77,3
14,r_95_47_211,r_70_125_136,seq48,r_95_47_211,0.98,-1,210,211,3
4,r_148_146_176,r_101_10_80,seq48,r_148_146_176,0.42,-4,172,176,3
0,r_22_16_161,r_148_146_176,r_51_33_202,r_22_16_161,0.88,0,161,161,3
11,r_128_137_66,r_62_1_101,seq56,r_128_137_66,0.6,0,66,66,3
13,r_58_30_81,seq26,seq23,r_58_30_81,1.0,2,83,81,3
98,seq123,r_127_144_247,seq20,r_127_144_247,0.48,-88,159,247,3
46,r_51_33_202,r_143_108_12,seq20,r_143_108_12,0.92,192,204,12,3
47,r_119_133_20,seq78,seq80,r_119_133_20,0.98,0,20,20,3
15,r_5_46_164,r_101_10_80,seq67,r_5_46_164,0.91,2,166,164,3
6,r_19_136_241,r_141_2_173,r_140_87_106,r_19_136_241,0.78,-66,175,241,3
16,r_143_108_12,r_31_32_244,r_51_33_202,r_143_108_12,1.0,0,12,12,3
23,r_79_81_34,r_62_1_101,seq65,r_79_81_34,1.0,1,35,34,3
36,r_70_125_136,r_95_47_211,seq129,r_95_47_211,0.98,3,214,211,3
39,r_114_42_31,r_70_125_136,seq80,r_114_42_31,0.98,4,35,31,3
1,r_57_39_8,r_22_16_161,seq149,r_57_39_8,0.63,4,12,8,3
40,r_38_142_167,r_11_7_77,seq149,r_11_7_77,1.0,1,78,77,3
18,r_140_87_106,seq61,seq149,r_140_87_106,0.64,2,108,106,3
61,seq26,r_58_30_81,seq149,r_58_30_81,1.0,2,83,81,3
32,r_141_2_173,r_19_136_241,r_15_131_29,r_141_2_173,0.73,2,175,173,3
38,r_145_66_213,seq100,seq17,r_145_66_213,0.36,1,214,213,3
77,seq71,r_59_8_137,seq113,r_59_8_137,1.0,3,140,137,3
34,r_49_124_89,r_51_33_202,seq97,r_49_124_89,0.99,0,89,89,3
75,seq67,seq17,r_5_46_164,r_5_46_164,0.99,9,173,164,3
94,seq113,r_9_117_196,seq71,r_9_117_196,0.99,0,196,196,3
21,r_85_24_46,seq97,seq98,r_85_24_46,0.98,0,46,46,3
53,seq6,seq97,r_94_132_50,r_94_132_50,0.99,0,50,50,3
9,r_35_3_192,seq61,seq147,r_35_3_192,0.82,1,193,192,3
31,r_96_93_56,r_40_84_231,r_35_3_192,r_35_3_192,0.97,39,231,192,3
28,r_126_121_122,seq89,r_92_139_94,r_126_121_122,0.83,1,123,122,3
49,r_62_1_101,r_35_3_192,r_19_136_241,r_62_1_101,0.95,0,101,101,3
82,seq89,r_126_121_122,seq71,r_126_121_122,0.86,1,123,122,3
42,r_94_132_50,r_96_93_56,seq6,r_96_93_56,0.73,-6,50,56,3
35,r_59_8_137,seq71,r_49_124_89,r_59_8_137,0.96,3,140,137,3
12,r_12_138_60,seq98,r_101_10_80,r_12_138_60,1.0,3,63,60,3
84,seq97,seq6,r_49_124_89,r_49_124_89,1.0,0,89,89,3
30,r_107_133_164,seq47,r_2_85_244,r_107_133_164,0.96,0,164,164,4
43,r_73_142_104,r_67_54_179,seq116,r_73_142_104,1.0,4,108,104,4
54,seq136,r_88_14_154,seq39,r_88_14_154,1.0,0,154,154,4
3,r_105_70_69,seq136,r_144_71_200,r_144_71_200,1.0,0,200,200,4
59,seq18,r_141_112_124,seq140,r_141_112_124,1.0,0,124,124,4
71,seq53,r_126_131_98,seq10,r_126_131_98,1.0,0,98,98,4
16,r_97_96_138,seq47,r_113_22_6,r_97_96_138,0.63,28,166,138,4
21,r_12_43_72,r_67_54_179,seq39,r_67_54_179,0.7,-99,80,179,4
1,r_134_15_28,r_147_45_172,seq1,r_147_45_172,0.9,1,173,172,4
32,r_86_63_50,r_55_74_73,r_144_71_200,r_86_63_50,1.0,0,50,50,4
24,r_40_33_25,seq32,seq100,r_40_33_25,1.0,2,27,25,4
32,r_86_63_50,r_144_71_200,seq19,r_144_71_200,0.87,-63,137,200,4
69,seq39,seq135,r_12_43_72,r_12_43_72,0.92,18,90,72,4
13,r_101_38_42,r_89_8_153,seq26,r_101_38_42,0.85,0,42,42,4
40,r_75_17_33,r_3_103_236,seq26,r_75_17_33,0.88,1,34,33,4
76,seq68,r_31_106_216,r_95_146_48,r_95_146_48,0.72,147,195,48,4
29,r_29_66_199,r_13_129_188,r_92_128_52,r_29_66_199,0.75,-145,54,199,4
6,r_99_59_100,r_42_78_152,seq26,r_42_78_152,0.58,-26,126,152,4
39,r_50_46_53,r_67_54_179,seq119,r_67_54_179,1.0,0,179,179,4
41,r_88_14_154,seq136,r_126_131_98,r_88_14_154,0.99,0,154,154,4
5,r_143_72_5,seq32,r_132_90_12,r_132_90_12,0.87,28,40,12,4
3,r_105_70_69,r_114_77_222,seq136,r_105_70_69,1.0,0,69,69,4
10,r_141_112_124,seq18,r_44_125_32,r_141_112_124,0.84,0,124,124,4
8,r_92_128_52,r_29_66_199,seq65,r_92_128_52,0.59,147,199,52,4
72,seq57,seq115,r_49_27_56,r_49_27_56,1.0,85,141,56,4
0,r_67_54_179,r_73_142_104,r_50_46_53,r_67_54_179,0.98,-71,108,179,4
31,r_44_125_32,r_48_24_144,seq94,r_44_125_32,1.0,0,32,32,4
20,r_55_74_73,seq119,seq84,r_55_74_73,1.0,0,73,73,4
98,seq124,r_25_7_161,seq69,r_25_7_161,1.0,-43,118,161,4
46,r_147_45_172,r_134_15_28,r_55_74_73,r_134_15_28,0.96,145,173,28,4
8,r_92_128_52,r_61_6_92,r_29_66_199,r_92_128_52,1.0,0,52,52,4
15,r_4_121_240,r_16_58_9,r_29_66_199,r_29_66_199,0.69,41,240,199,4
57,seq11,r_99_59_100,seq124,r_99_59_100,1.0,2,102,100,4
12,r_144_71_200,r_86_63_50,r_105_70_69,r_144_71_200,0.98,0,200,200,4
6,r_99_59_100,r_147_45_172,r_42_78_152,r_99_59_100,0.77,1,101,100,4
6,r_99_59_100,seq26,r_13_129_188,r_13_129_188,0.99,-2,186,188,4
0,r_67_54_179,r_50_46_53,r_55_74_73,r_67_54_179,0.98,0,179,179,4
39,r_50_46_53,r_61_6_92,r_67_54_179,r_50_46_53,1.0,0,53,53,4
27,r_31_106_216,seq68,r_40_33_25,r_31_106_216,0.62,0,216,216,4
17,r_95_146_48,r_49_27_56,seq68,r_95_146_48,1.0,1,49,48,4
37,r_56_111_44,r_64_98_128,seq138,r_56_111_44,1.0,0,44,44,4
18,r_51_130_211,seq47,r_12_43_72,r_51_130_211,0.78,0,211,211,4
25,r_64_98_128,seq91,seq79,r_64_98_128,0.99,0,128,128,4
46,r_147_45_172,r_99_59_100,r_134_15_28,r_147_45_172,0.88,-141,31,172,4
33,r_41_102_109,r_2_85_244,r_16_58_9,r_41_102_109,1.0,0,109,109,4
19,r_49_27_56,seq69,seq57,r_49_27_56,0.99,0,56,56,4
50,seq0,r_97_96_138,r_126_131_98,r_126_131_98,0.67,2,100,98,4
1,r_134_15_28,r_92_128_52,r_147_45_172,r_134_15_28,0.99,1,29,28,4
38,r_13_129_188,seq65,r_99_59_100,r_13_129_188,0.73,0,188,188,4
47,r_126_131_98,r_97_96_138,r_88_14_154,r_88_14_154,0.98,1,155,154,4
57,seq11,seq124,r_51_130_211,r_51_130_211,0.95,15,226,211,4
34,r_109_123_133,r_3_103_236,seq84,r_109_123_133,0.99,0,133,133,4
9,r_25_7_161,seq124,seq82,r_25_7_161,0.99,1,162,161,4
29,r_29_66_199,r_92_128_52,r_73_142_104,r_29_66_199,0.9,0,199,199,4
22,r_9_139_143,r_67_54_179,seq20,r_9_139_143,0.94,2,145,143,4
28,r_145_60_223,seq19,r_107_133_164,r_107_133_164,0.5,59,223,164,4
7,r_89_8_153,seq137,seq26,r_89_8_153,0.99,1,154,153,4
44,r_48_24_144,seq100,r_143_72_5,r_48_24_144,1.0,0,144,144,4
23,r_42_78_152,seq108,r_99_59_100,r_99_59_100,0.93,2,102,100,4
82,seq82,seq79,r_25_7_161,r_25_7_161,0.94,42,203,161,4
23,r_42_78_152,r_99_59_100,seq20,r_42_78_152,0.91,1,153,152,4
35,r_114_77_222,seq110,r_51_130_211,r_114_77_222,0.53,1,223,222,4
42,r_132_90_12,r_3_103_236,r_143_72_5,r_132_90_12,0.98,0,12,12,4
12,r_144_71_200,r_114_77_222,r_86_63_50,r_86_63_50,1.0,25,75,50,4
30,r_107_91_150,r_89_31_160,r_68_131_61,r_68_131_61,0.86,1,62,61,5
36,r_140_63_185,seq69,seq125,r_140_63_185,0.98,0,185,185,5
9,r_82_48_55,r_124_56_216,r_28_79_218,r_28_79_218,0.61,-2,216,218,5
14,r_28_79_218,seq123,r_19_71_162,r_19_71_162,1.0,56,218,162,5
43,r_18_87_158,r_124_56_216,seq35,r_18_87_158,0.97,1,159,158,5
71,seq45,r_43_42_192,r_95_39_96,r_95_39_96,0.91,100,196,96,5
16,r_93_67_184,seq64,r_82_48_55,r_93_67_184,0.95,0,184,184,5
39,r_1_36_83,seq85,seq54,r_1_36_83,1.0,0,83,83,5
1,r_124_56_216,r_18_87_158,r_82_48_55,r_18_87_158,0.63,1,159,158,5
97,seq123,r_28_79_218,r_141_88_29,r_141_88_29,0.92,37,66,29,5
5,r_118_126_148,seq58,r_1_36_83,r_1_36_83,0.96,66,149,83,5
46,r_34_136_183,seq5,r_149_62_12,r_34_136_183,0.79,1,184,183,5
9,r_82_48_55,r_53_65_240,r_124_56_216,r_82_48_55,0.87,1,56,55,5
19,r_76_57_77,r_102_84_62,r_53_65_240,r_102_84_62,0.98,-1,61,62,5
4,r_149_62_12,r_124_56_216,r_80_38_35,r_149_62_12,0.64,0,12,12,5
31,r_101_119_186,seq117,seq146,r_101_119_186,0.86,0,186,186,5
41,r_59_122_159,r_80_38_35,r_137_92_220,r_59_122_159,0.81,0,159,159,5
3,r_116_9_154,seq32,seq12,r_116_9_154,0.98,0,154,154,5
45,r_7_30_16,r_28_79_218,seq133,r_7_30_16,1.0,0,16,16,5
26,r_43_42_192,seq45,r_19_71_162,r_19_71_162,0.99,34,196,162,5
0,r_143_86_116,seq117,r_97_26_117,r_143_86_116,1.0,1,117,116,5
11,r_55_44_163,r_137_92_220,r_118_126_148,r_55_44_163,0.95,1,164,163,5
13,r_97_26_117,seq134,r_143_86_116,r_143_86_116,1.0,4,120,116,5
98,seq125,r_148_112_231,r_47_27_193,r_47_27_193,0.94,38,231,193,5
15,r_6_105_229,r_10_2_46,r_145_70_104,r_10_2_46,0.54,184,230,46,5
48,r_16_77_196,r_124_56_216,r_149_62_12,r_124_56_216,0.76,-20,196,216,5
2,r_0_120_125,r_73_61_106,seq5,r_0_120_125,0.68,-84,41,125,5
57,seq138,r_109_22_206,r_19_71_162,r_19_71_162,0.89,5,167,162,5
21,r_10_2_46,r_6_105_229,r_18_87_158,r_10_2_46,0.59,184,230,46,5
85,seq85,r_1_36_83,seq25,r_1_36_83,1.0,0,83,83,5
2,r_0_120_125,seq5,seq25,r_0_120_125,0.94,-3,122,125,5
19,r_76_57_77,r_53_65_240,seq51,r_76_57_77,1.0,0,77,77,5
17,r_145_70_104,r_82_48_55,seq20,r_145_70_104,0.46,-73,31,104,5
30,r_107_91_150,r_68_131_61,r_149_62_12,r_107_91_150,0.81,2,152,150,5
24,r_49_8_38,r_97_26_117,seq130,r_49_8_38,1.0,0,38,38,5
35,r_66_46_222,r_109_22_206,r_15_104_168,r_66_46_222,0.67,2,224,222,5
41,r_59_122_159,r_137_92_220,r_28_79_218,r_137_92_220,0.99,2,222,220,5
47,r_68_131_61,seq50,r_107_91_150,r_68_131_61,1.0,1,62,61,5
40,r_73_61_106,seq11,r_149_62_12,r_73_61_106,0.96,0,106,106,5
74,seq54,r_19_71_162,r_1_36_83,r_1_36_83,0.92,55,138,83,5
18,r_135_100_219,seq123,r_143_86_116,r_143_86_116,0.75,103,219,116,5
29,r_17_14_161,seq129,seq94,r_17_14_161,0.7,0,161,161,5
35,r_66_46_222,r_135_100_219,r_109_22_206,r_109_22_206,0.34,1,207,206,5
64,seq25,r_47_27_193,seq85,r_47_27_193,1.0,-106,87,193,5
47,r_68_131_61,r_107_91_150,seq133,r_107_91_150,0.63,3,153,150,5
58,seq11,r_73_61_106,seq127,r_73_61_106,1.0,-1,105,106,5
21,r_10_2_46,r_98_113_241,r_6_105_229,r_10_2_46,0.71,1,47,46,5
32,r_75_144_69,seq114,seq123,r_75_144_69,1.0,0,69,69,5
38,r_19_71_162,seq133,seq83,r_19_71_162,0.77,0,162,162,5
34,r_95_39_96,seq20,seq45,r_95_39_96,0.91,1,97,96,5
28,r_137_92_220,r_59_122_159,r_76_57_77,r_137_92_220,0.94,0,220,220,5
45,r_7_30_16,seq133,r_55_44_163,r_55_44_163,1.0,52,215,163,5
22,r_109_22_206,seq94,r_49_8_38,r_49_8_38,1.0,171,209,38,5
28,r_137_92_220,r_55_44_163,r_59_122_159,r_137_92_220,0.93,-56,164,220,5
44,r_89_31_160,r_19_71_162,r_116_9_154,r_89_31_160,0.8,0,160,160,5
5,r_118_126_148,r_1_36_83,r_55_44_163,r_55_44_163,0.67,9,172,163,5
23,r_148_112_231,seq125,seq69,r_148_112_231,0.42,0,231,231,5
10,r_141_88_29,r_95_39_96,seq123,r_141_88_29,0.5,-2,27,29,5
35,r_66_46_222,seq123,r_135_100_219,r_135_100_219,0.87,-122,97,219,5
12,r_47_27_193,seq25,r_140_63_185,r_47_27_193,0.86,0,193,193,5
40,r_18_125_168,r_108_40_45,r_51_102_42,r_18_125_168,0.97,0,168,168,6
12,r_143_33_78,r_63_22_13,r_2_56_96,r_2_56_96,0.79,18,114,96,6
26,r_108_40_45,r_3_92_228,r_18_125_168,r_108_40_45,1.0,0,45,45,6
14,r_3_92_228,r_104_36_207,r_84_14_93,r_84_14_93,1.0,113,206,93,6
8,r_32_132_176,r_45_124_201,seq12,r_45_124_201,0.83,-10,191,201,6
43,r_111_21_80,seq31,r_1_55_138,r_111_21_80,0.58,3,83,80,6
37,r_45_124_201,r_39_17_126,seq78,r_45_124_201,0.9,2,203,201,6
37,r_45_124_201,r_32_132_176,r_39_17_126,r_45_124_201,0.42,-24,177,201,6
30,r_140_23_50,seq31,seq121,r_140_23_50,1.0,5,55,50,6
5,r_41_107_105,seq110,r_111_21_80,r_41_107_105,0.93,2,107,105,6
46,r_142_138_180,seq73,seq103,r_142_138_180,0.85,0,180,180,6
42,r_10_95_95,seq46,r_41_107_105,r_10_95_95,1.0,0,95,95,6
45,r_58_100_133,seq139,r_42_79_60,r_42_79_60,1.0,71,131,60,6
39,r_133_69_52,seq123,r_118_54_163,r_133_69_52,1.0,2,54,52,6
23,r_15_4_233,seq112,r_50_48_47,r_50_48_47,1.0,-3,44,47,6
19,r_74_52_109,seq78,seq73,r_74_52_109,0.97,0,109,109,6
27,r_149_19_226,seq145,r_118_54_163,r_149_19_226,0.53,0,226,226,6
38,r_50_48_47,r_104_36_207,r_15_4_233,r_50_48_47,1.0,0,47,47,6
38,r_50_48_47,r_15_4_233,seq112,r_15_4_233,0.76,2,235,233,6
4,r_77_76_29,r_44_75_248,seq99,r_77_76_29,1.0,1,30,29,6
6,r_80_20_21,seq122,seq82,r_80_20_21,0.99,0,21,21,6
39,r_133_69_52,r_118_54_163,r_131_81_81,r_133_69_52,0.49,111,163,52,6
31,r_59_114_137,seq99,seq37,r_59_114_137,1.0,0,137,137,6
41,r_43_53_71,seq34,r_104_36_207,r_43_53_71,0.96,5,76,71,6
10,r_86_38_84,seq60,seq115,r_86_38_84,0.81,1,85,84,6
25,r_118_54_163,r_108_40_45,r_133_69_52,r_118_54_163,1.0,-118,45,163,6
72,seq136,r_39_17_126,seq113,r_39_17_126,0.84,17,143,126,6
43,r_111_21_80,r_1_55_138,r_41_107_105,r_1_55_138,1.0,-11,127,138,6
20,r_1_55_138,seq87,seq130,r_1_55_138,0.98,-1,137,138,6
36,r_62_119_53,r_84_14_93,seq82,r_62_119_53,0.75,1,54,53,6
21,r_39_17_126,r_45_124_201,r_1_55_138,r_45_124_201,0.97,2,203,201,6
27,r_149_19_226,r_120_93_116,seq145,r_120_93_116,1.0,-1,115,116,6
14,r_3_92_228,r_84_14_93,r_108_40_45,r_3_92_228,0.67,0,228,228,6
1,r_84_14_93,r_62_119_53,seq34,r_62_119_53,0.97,0,53,53,6
11,r_96_135_17,seq35,seq26,r_96_135_17,1.0,1,18,17,6
47,r_104_36_207,r_3_92_228,seq12,r_104_36_207,0.79,-1,206,207,6
93,seq115,r_86_38_84,r_120_93_116,r_120_93_116,1.0,107,223,116,6
40,r_18_125_168,r_44_75_248,r_108_40_45,r_108_40_45,1.0,35,80,45,6
18,r_42_79_60,r_142_138_180,seq126,r_42_79_60,1.0,0,60,60,6
29,r_66_68_210,r_117_28_114,r_98_25_197,r_117_28_114,0.99,-9,105,114,6
24,r_70_72_90,seq139,seq122,r_70_72_90,0.88,5,95,90,6
33,r_117_28_114,r_66_68_210,r_43_53_71,r_117_28_114,1.0,0,114,114,6
13,r_24_89_11,seq16,seq128,r_24_89_11,0.69,-1,10,11,6
28,r_65_0_46,seq109,r_71_134_15,r_65_0_46,1.0,0,46,46,6
70,seq37,r_2_56_96,r_5_85_178,r_2_56_96,0.99,-1,95,96,6
15,r_13_64_25,r_74_52_109,r_71_134_15,r_13_64_25,0.94,0,25,25,6
2,r_27_137_22,seq7,seq129,r_27_137_22,1.0,0,22,22,6
41,r_43_53_71,r_104_36_207,r_117_28_114,r_43_53_71,0.77,49,120,71,6
32,r_57_11_145,r_71_134_15,r_42_79_60,r_71_134_15,0.98,130,145,15,6
34,r_49_29_120,r_142_138_180,seq90,r_49_29_120,0.73,1,121,120,6
67,seq31,r_140_23_50,seq16,r_140_23_50,0.95,5,55,50,6
17,r_131_81_81,seq115,seq129,r_131_81_81,1.0,0,81,81,6
25,r_118_54_163,r_133_69_52,r_63_22_13,r_118_54_163,0.99,0,163,163,6
9,r_98_25_197,r_66_68_210,r_42_79_60,r_42_79_60,1.0,135,195,60,6
26,r_108_40_45,r_18_125_168,r_44_75_248,r_18_125_168,1.0,0,168,168,6
96,seq122,seq115,r_70_72_90,r_70_72_90,0.94,23,113,90,6
16,r_63_22_13,r_80_20_21,seq60,r_63_22_13,0.61,-2,11,13,6
29,r_66_68_210,r_98_25_197,seq7,r_66_68_210,0.78,2,212,210,6
22,r_5_85_178,seq26,seq123,r_5_85_178,0.96,0,178,178,6
91,seq112,r_15_4_233,r_1_55_138,r_1_55_138,0.99,25,163,138,6
39,r_133_69_52,r_131_81_81,r_106_61_177,r_106_61_177,0.92,2,179,177,6
35,r_47_105_39,r_39_17_126,seq9,r_47_105_39,0.88,1,40,39,6
49,r_44_75_248,r_18_125_168,r_108_40_45,r_108_40_45,1.0,123,168,45,6
1,r_84_14_93,seq34,seq129,r_84_14_93,1.0,0,93,93,6
44,r_120_93_116,r_149_19_226,seq115,r_120_93_116,1.0,0,116,116,6
12,r_143_33_78,seq67,r_63_22_13,r_143_33_78,0.98,-1,77,78,6
23,r_15_4_233,r_50_48_47,r_27_137_22,r_50_48_47,0.54,186,233,47,6
30,r_133_105_106,r_27_50_227,seq110,r_133_105_106,1.0,0,106,106,7
44,r_115_23_224,seq30,seq53,r_115_23_224,0.99,0,224,224,7
92,seq110,r_83_39_176,r_133_105_106,r_133_105_106,0.57,19,125,106,7
14,r_4_129_158,r_115_23_224,r_70_140_65,r_115_23_224,1.0,-66,158,224,7
8,r_18_146_173,r_101_63_29,seq148,r_18_146_173,0.48,0,173,173,7
43,r_2_62_191,r_100_20_163,seq141,r_100_20_163,0.88,-27,136,163,7
54,seq11,seq55,r_143_125_161,r_143_125_161,0.98,4,165,161,7
2,r_68_61_83,r_73_94_59,r_6_89_1,r_73_94_59,1.0,0,59,59,7
59,seq148,seq59,r_18_146_173,r_18_146_173,0.91,3,176,173,7
71,seq48,seq66,r_109_43_84,r_109_43_84,1.0,0,84,84,7
16,r_100_20_163,r_2_62_191,r_96_117_38,r_2_62_191,0.84,-25,166,191,7
21,r_65_67_151,seq55,r_91_132_97,r_65_67_151,0.94,0,151,151,7
39,r_5_90_230,seq10,r_65_67_151,r_65_67_151,0.98,79,230,151,7
1,r_64_85_62,r_123_46_149,r_1_99_121,r_64_85_62,0.81,87,149,62,7
1,r_64_85_62,seq107,r_123_46_149,r_64_85_62,1.0,0,62,62,7
42,r_7_72_145,seq93,seq98,r_7_72_145,0.95,4,149,145,7
49,r_42_0_48,r_65_67_151,seq142,r_42_0_48,0.94,0,48,48,7
80,seq66,seq48,r_122_57_69,r_122_57_69,0.63,3,72,69,7
43,r_2_62_191,seq141,r_121_78_178,r_2_62_191,0.92,0,191,191,7
19,r_143_125_161,seq142,seq11,r_143_125_161,0.94,0,161,161,7
0,r_37_136_50,r_122_57_69,r_77_103_190,r_122_57_69,0.72,-19,50,69,7
15,r_96_117_38,r_127_131_197,r_100_20_163,r_96_117_38,0.94,159,197,38,7
38,r_84_88_93,r_118_139_203,r_54_45_110,r_118_139_203,0.68,-13,190,203,7
31,r_27_50_227,r_133_105_106,r_70_140_65,r_27_50_227,1.0,-121,106,227,7
3,r_121_78_178,r_87_29_201,seq145,r_87_29_201,0.78,-21,180,201,7
10,r_32_112_117,seq17,seq49,r_32_112_117,0.94,-8,109,117,7
26,r_1_99_121,seq26,r_64_85_62,r_1_99_121,0.9,0,121,121,7
63,seq25,seq76,r_15_111_115,r_15_111_115,1.0,14,129,115,7
15,r_96_117_38,r_34_147_96,r_127_131_197,r_96_117_38,0.98,2,40,38,7
37,r_47_19_45,seq56,r_101_63_29,r_47_19_45,1.0,1,46,45,7
13,r_118_139_203,r_91_132_97,r_84_88_93,r_118_139_203,0.74,-106,97,203,7
46,r_73_94_59,seq49,r_36_35_124,r_36_35_124,1.0,1,125,124,7
48,r_70_140_65,seq59,r_47_19_45,r_70_140_65,0.96,1,66,65,7
36,r_74_108_19,r_34_147_96,seq11,r_74_108_19,0.98,0,19,19,7
13,r_118_139_203,r_84_88_93,seq148,r_84_88_93,0.78,110,203,93,7
6,r_109_43_84,r_36_35_124,seq48,r_109_43_84,0.96,0,84,84,7
5,r_9_86_36,r_36_35_124,r_80_75_51,r_36_35_124,1.0,-25,99,124,7
29,r_80_75_51,r_1_99_121,seq53,r_80_75_51,0.65,-1,50,51,7
59,seq148,r_18_146_173,r_118_139_203,r_118_139_203,0.79,0,203,203,7
0,r_37_136_50,r_77_103_190,r_123_46_149,r_123_46_149,1.0,44,193,149,7
27,r_138_12_196,seq21,r_34_147_96,r_138_12_196,0.93,0,196,196,7
4,r_101_63_29,r_138_12_196,r_47_19_45,r_47_19_45,0.99,5,50,45,7
40,r_91_132_97,r_118_139_203,seq107,r_91_132_97,1.0,0,97,97,7
5,r_9_86_36,r_91_132_97,r_36_35_124,r_9_86_36,0.97,0,36,36,7
18,r_123_46_149,r_64_85_62,r_37_136_50,r_123_46_149,0.79,0,149,149,7
25,r_77_103_190,seq79,r_37_136_50,r_37_136_50,0.98,11,61,50,7
33,r_54_45_110,seq76,seq52,r_54_45_110,1.0,1,111,110,7
64,seq26,r_1_99_121,r_104_106_135,r_1_99_121,1.0,1,122,121,7
47,r_92_128_58,r_42_0_48,seq56,r_92_128_58,0.33,68,126,58,7
32,r_95_33_92,seq107,seq14,r_95_33_92,1.0,1,93,92,7
2,r_68_61_83,r_6_89_1,r_64_85_62,r_68_61_83,0.98,0,83,83,7
38,r_84_88_93,seq49,r_118_139_203,r_84_88_93,0.53,0,93,93,7
45,r_127_131_197,r_144_82_118,r_96_117_38,r_96_117_38,0.8,0,38,38,7
75,seq53,r_36_35_124,r_80_75_51,r_36_35_124,1.0,-25,99,124,7
60,seq21,r_138_12_196,seq40,r_138_12_196,1.0,0,196,196,7
47,r_92_128_58,r_65_67_151,r_42_0_48,r_65_67_151,1.0,-92,59,151,7
45,r_127_131_197,r_96_117_38,r_64_85_62,r_96_117_38,0.88,159,197,38,7
81,seq69,r_15_111_115,r_91_132_97,r_91_132_97,0.52,19,116,97,7
17,r_113_137_71,r_100_20_163,seq30,r_113_137_71,0.85,2,73,71,7
25,r_77_103_190,r_37_136_50,r_7_72_145,r_77_103_190,0.78,3,193,190,7
94,seq116,r_113_137_71,seq141,r_113_137_71,0.81,2,73,71,7
9,r_34_147_96,seq93,seq10,r_34_147_96,0.97,0,96,96,7
31,r_27_50_227,r_70_140_65,seq114,r_27_50_227,0.55,0,227,227,7
46,r_73_94_59,r_68_61_83,seq49,r_73_94_59,1.0,0,59,59,7
29,r_80_75_51,seq53,r_9_86_36,r_80_75_51,0.44,105,156,51,7
22,r_144_82_118,seq58,seq76,r_144_82_118,0.88,1,119,118,7
91,seq107,r_15_111_115,r_91_132_97,r_91_132_97,0.62,2,99,97,7
56,seq14,seq3,r_95_33_92,r_95_33_92,1.0,34,126,92,7
7,r_122_57_69,seq142,seq66,r_122_57_69,0.96,1,70,69,7
44,r_115_23_224,r_4_129_158,seq30,r_4_129_158,1.0,0,158,158,7
23,r_15_111_115,seq69,seq25,r_15_111_115,0.91,1,116,115,7
79,seq59,r_70_140_65,seq126,r_70_140_65,1.0,1,66,65,7
12,r_87_29_201,seq52,seq40,r_87_29_201,0.85,0,201,201,7
84,seq79,r_77_103_190,seq124,r_77_103_190,0.97,-28,162,190,7
33,r_103_40_48,r_49_22_28,seq33,r_103_40_48,0.69,-3,45,48,8
36,r_86_41_113,r_79_89_132,seq21,r_86_41_113,1.0,1,114,113,8
14,r_111_108_130,r_73_67_81,r_83_135_76,r_111_108_130,1.0,0,130,130,8
8,r_97_77_140,r_116_142_185,seq16,r_97_77_140,1.0,0,140,140,8
48,r_49_22_28,r_103_40_48,r_20_125_30,r_20_125_30,1.0,0,30,30,8
43,r_140_118_229,r_42_46_225,r_92_34_137,r_42_46_225,0.23,10,235,225,8
83,seq80,seq123,r_83_135_76,r_83_135_76,0.79,80,156,76,8
86,seq91,seq10,r_83_135_76,r_83_135_76,0.93,1,77,76,8
16,r_100_120_172,seq143,r_82_51_133,r_100_120_172,0.85,0,172,172,8
39,r_83_135_76,seq16,seq91,r_83_135_76,0.69,2,78,76,8
5,r_50_47_151,seq88,seq24,r_50_47_151,1.0,0,151,151,8
46,r_117_69_115,r_137_114_184,r_103_40_48,r_117_69_115,1.0,0,115,115,8
7,r_106_28_43,seq19,r_43_134_54,r_43_134_54,0.93,58,112,54,8
45,r_44_84_77,seq148,r_137_114_184,r_44_84_77,1.0,2,79,77,8
19,r_128_54_183,seq24,r_102_87_174,r_128_54_183,0.93,0,183,183,8
64,seq24,r_79_89_132,r_50_47_151,r_50_47_151,0.51,60,211,151,8
1,r_25_129_176,r_32_68_162,seq143,r_32_68_162,0.93,-115,47,162,8
41,r_98_75_134,seq72,seq93,r_98_75_134,0.99,0,134,134,8
96,seq119,r_137_114_184,r_141_96_111,r_141_96_111,1.0,26,137,111,8
10,r_102_87_174,seq9,r_23_35_90,r_102_87_174,0.94,0,174,174,8
26,r_29_64_180,seq45,r_32_68_162,r_29_64_180,0.96,1,181,180,8
4,r_130_74_74,r_2_132_135,seq6,r_130_74_74,1.0,0,74,74,8
0,r_141_96_111,seq6,seq56,r_141_96_111,1.0,0,111,111,8
11,r_92_34_137,seq36,r_32_68_162,r_92_34_137,0.65,0,137,137,8
20,r_76_65_227,seq6,r_39_13_50,r_39_13_50,0.96,177,227,50,8
13,r_12_136_120,r_25_129_176,seq14,r_12_136_120,0.87,-4,116,120,8
57,seq14,seq16,r_12_136_120,r_12_136_120,0.95,0,120,120,8
6,r_138_107_119,seq133,r_4_71_14,r_138_107_119,0.98,0,119,119,8
21,r_78_90_35,r_81_127_131,seq7,r_81_127_131,0.82,3,134,131,8
85,seq88,r_50_47_151,seq101,r_50_47_151,1.0,-16,135,151,8
27,r_59_37_47,r_38_113_75,seq16,r_59_37_47,0.99,0,47,47,8
2,r_55_131_94,r_29_64_180,seq33,r_55_131_94,1.0,0,94,94,8
40,r_1_58_138,seq139,r_82_51_133,r_1_58_138,0.93,0,138,138,8
74,seq56,r_73_67_81,r_115_63_71,r_115_63_71,1.0,16,87,71,8
18,r_116_142_185,r_42_46_225,seq93,r_116_142_185,0.66,0,185,185,8
29,r_2_132_135,seq94,seq72,r_2_132_135,0.53,1,136,135,8
96,seq119,r_111_108_130,r_137_114_184,r_111_108_130,0.53,-79,51,130,8
25,r_32_68_162,r_92_34_137,r_130_74_74,r_32_68_162,0.99,-1,161,162,8
25,r_32_68_162,r_130_74_74,r_29_64_180,r_29_64_180,0.87,23,203,180,8
24,r_39_13_50,r_98_75_134,seq60,r_39_13_50,1.0,0,50,50,8
25,r_32_68_162,r_25_129_176,r_92_34_137,r_92_34_137,0.54,2,139,137,8
64,seq24,r_145_8_139,r_128_54_183,r_145_8_139,0.83,1,140,139,8
88,seq94,r_2_132_135,r_81_127_131,r_2_132_135,0.58,1,136,135,8
70,seq33,r_4_71_14,r_55_131_94,r_55_131_94,1.0,7,101,94,8
42,r_17_0_21,r_138_107_119,seq143,r_17_0_21,1.0,1,22,21,8
61,seq19,seq66,r_106_28_43,r_106_28_43,1.0,50,93,43,8
32,r_79_89_132,r_98_75_134,seq104,r_79_89_132,0.89,0,132,132,8
11,r_92_34_137,r_32_68_162,seq148,r_32_68_162,0.98,0,162,162,8
38,r_53_149_66,seq93,seq36,r_53_149_66,1.0,-1,65,66,8
47,r_20_125_30,r_59_37_47,r_49_22_28,r_49_22_28,1.0,2,30,28,8
7,r_106_28_43,seq7,seq19,r_106_28_43,1.0,0,43,43,8
64,seq24,r_128_54_183,r_79_89_132,r_128_54_183,1.0,0,183,183,8
30,r_38_113_75,r_59_37_47,seq147,r_38_113_75,0.65,-27,48,75,8
17,r_42_46_225,r_140_118_229,r_97_77_140,r_97_77_140,1.0,85,225,140,8
9,r_82_51_133,seq104,seq147,r_82_51_133,1.0,0,133,133,8
21,r_78_90_35,r_100_120_172,r_81_127_131,r_78_90_35,0.98,-1,34,35,8
28,r_137_114_184,r_115_63_71,r_82_51_133,r_82_51_133,0.54,51,184,133,8
22,r_23_35_90,r_79_89_132,seq101,r_23_35_90,1.0,0,90,90,8
28,r_137_114_184,r_117_69_115,r_115_63_71,r_137_114_184,0.94,-69,115,184,8
49,r_15_121_222,seq66,r_92_34_137,r_92_34_137,0.97,86,223,137,8
44,r_115_63_71,r_124_18_192,seq133,r_115_63_71,1.0,0,71,71,8
23,r_81_127_131,seq7,r_138_107_119,r_138_107_119,1.0,14,133,119,8
82,seq72,r_98_75_134,r_2_132_135,r_98_75_134,1.0,1,135,134,8
51,seq1,seq133,r_52_54_104,r_52_54_104,0.98,3,107,104,9
36,r_91_83_236,seq105,r_111_135_197,r_111_135_197,0.57,41,238,197,9
92,seq115,seq26,r_110_75_96,r_110_75_96,0.6,7,103,96,9
11,r_3_10_160,r_52_54_104,r_63_141_182,r_63_141_182,0.98,3,185,182,9
8,r_39_136_241,r_50_25_215,r_78_147_36,r_78_147_36,1.0,181,217,36,9
37,r_137_20_109,r_39_136_241,seq143,r_137_20_109,1.0,1,110,109,9
59,seq15,seq30,r_41_79_52,r_41_79_52,1.0,21,73,52,9
53,seq4,seq133,r_78_147_36,r_78_147_36,1.0,0,36,36,9
71,seq45,seq98,r_67_7_128,r_67_7_128,1.0,19,147,128,9
75,seq59,r_41_79_52,r_43_68_179,r_43_68_179,0.59,4,183,179,9
71,seq45,r_89_65_91,seq98,r_89_65_91,0.84,1,92,91,9
16,r_100_84_159,seq115,seq46,r_100_84_159,0.88,0,159,159,9
21,r_103_74_230,r_43_68_179,r_94_17_44,r_94_17_44,0.97,137,181,44,9
1,r_89_65_91,seq45,seq31,r_89_65_91,0.94,1,92,91,9
5,r_97_104_214,r_111_135_197,seq123,r_111_135_197,0.78,0,197,197,9
46,r_102_116_131,r_60_5_216,seq22,r_102_116_131,0.69,2,133,131,9
42,r_140_144_89,seq87,seq21,r_140_144_89,1.0,0,89,89,9
6,r_94_17_44,r_14_37_158,seq26,r_94_17_44,0.95,0,44,44,9
52,seq2,seq26,r_16_9_26,r_16_9_26,0.88,1,27,26,9
35,r_16_9_26,seq117,seq2,r_16_9_26,0.98,1,27,26,9
45,r_67_7_128,seq21,seq45,r_67_7_128,0.96,0,128,128,9
34,r_77_40_142,r_107_93_58,r_119_122_18,r_77_40_142,0.82,-113,29,142,9
19,r_19_18_243,r_38_121_62,r_119_122_18,r_38_121_62,0.99,2,64,62,9
19,r_19_18_243,r_119_122_18,r_29_23_93,r_29_23_93,0.63,24,117,93,9
89,seq108,seq64,r_77_40_142,r_77_40_142,1.0,0,142,142,9
7,r_56_47_32,seq32,r_69_113_245,r_56_47_32,0.97,2,34,32,9
3,r_38_121_62,r_19_18_243,seq101,r_38_121_62,1.0,0,62,62,9
19,r_19_18_243,r_29_23_93,r_100_84_159,r_100_84_159,0.89,13,172,159,9
14,r_119_122_18,r_77_40_142,r_140_144_89,r_140_144_89,0.99,50,139,89,9
4,r_110_75_96,seq117,seq115,r_110_75_96,0.53,7,103,96,9
11,r_3_10_160,seq27,r_52_54_104,r_52_54_104,0.86,58,162,104,9
19,r_19_18_243,r_100_84_159,r_60_5_216,r_60_5_216,1.0,2,218,216,9
13,r_6_58_155,seq114,r_52_54_104,r_52_54_104,0.91,52,156,104,9
14,r_119_122_18,seq44,r_77_40_142,r_119_122_18,0.9,0,18,18,9
15,r_106_149_164,r_62_73_238,r_119_122_18,r_106_149_164,0.67,0,164,164,9
48,r_145_142_141,seq59,seq143,r_145_142_141,0.99,1,142,141,9
85,seq95,r_139_66_101,r_13_55_99,r_13_55_99,1.0,12,111,99,9
27,r_86_148_133,seq22,seq27,r_86_148_133,0.87,0,133,133,9
47,r_8_129_81,seq115,r_71_70_17,r_8_129_81,0.7,4,85,81,9
40,r_52_54_104,r_139_66_101,seq1,r_52_54_104,0.99,0,104,104,9
18,r_42_80_237,seq146,r_86_148_133,r_42_80_237,0.23,1,238,237,9
29,r_43_68_179,r_103_74_230,seq59,r_43_68_179,0.65,9,188,179,9
24,r_124_0_129,seq95,seq61,r_124_0_129,1.0,0,129,129,9
10,r_112_57_209,seq26,r_71_70_17,r_112_57_209,0.68,-160,49,209,9
34,r_77_40_142,r_119_122_18,seq108,r_77_40_142,1.0,0,142,142,9
25,r_14_37_158,seq46,r_86_148_133,r_14_37_158,0.96,0,158,158,9
33,r_13_55_99,seq143,seq95,r_13_55_99,1.0,0,99,99,9
58,seq130,seq32,r_49_92_172,r_49_92_172,0.6,1,173,172,9
61,seq21,r_139_66_101,r_140_144_89,r_140_144_89,1.0,9,98,89,9
32,r_50_25_215,r_39_136_241,seq46,r_50_25_215,0.67,0,215,215,9
2,r_41_79_52,r_35_132_207,seq15,r_41_79_52,0.99,2,54,52,9
96,seq123,r_97_104_214,r_102_116_131,r_97_104_214,0.56,6,220,214,9
75,seq59,r_145_142_141,r_41_79_52,r_145_142_141,0.86,1,142,141,9
44,r_111_135_197,r_60_5_216,seq133,r_60_5_216,0.76,-3,213,216,9
31,r_107_93_58,seq21,r_41_79_52,r_107_93_58,0.99,0,58,58,9
94,seq118,r_63_141_182,seq146,r_63_141_182,0.52,0,182,182,9
96,seq123,r_49_92_172,r_97_104_214,r_49_92_172,0.94,0,172,172,9
63,seq26,r_36_33_167,r_94_17_44,r_94_17_44,1.0,1,45,44,9
22,r_63_141_182,seq118,r_3_10_160,r_63_141_182,0.64,0,182,182,9
14,r_119_122_18,r_140_144_89,r_106_149_164,r_106_149_164,0.99,18,182,164,9
21,r_103_74_230,r_94_17_44,r_119_122_18,r_103_74_230,0.98,0,230,230,9
44,r_111_135_197,r_97_104_214,r_60_5_216,r_111_135_197,0.37,0,197,197,9
5,r_97_104_214,seq123,seq117,r_97_104_214,0.51,6,220,214,9
23,r_51_99_152,seq27,seq134,r_51_99_152,0.65,2,154,152,9
82,seq87,r_140_144_89,r_71_70_17,r_140_144_89,1.0,-16,73,89,9
12,r_49_92_172,seq123,seq130,r_49_92_172,0.66,0,172,172,9
39,r_78_147_36,r_13_55_99,seq4,r_78_147_36,1.0,0,36,36,9
93,seq109,r_99_3_183,r_96_119_166,r_96_119_166,0.79,17,183,166,10
44,r_14_15_15,seq34,r_53_36_62,r_53_36_62,1.0,14,76,62,10
25,r_97_63_18,r_32_116_219,r_44_54_169,r_97_63_18,1.0,0,18,18,10
14,r_24_77_230,seq148,r_48_21_175,r_24_77_230,0.37,-1,229,230,10
22,r_55_114_54,seq149,r_88_33_49,r_55_114_54,1.0,0,54,54,10
37,r_16_123_188,r_32_116_219,r_11_40_104,r_16_123_188,0.31,-74,114,188,10
43,r_80_61_30,seq2,seq28,r_80_61_30,0.97,0,30,30,10
1,r_101_145_215,r_143_29_57,r_55_114_54,r_55_114_54,0.56,161,215,54,10
97,seq148,r_106_112_195,r_79_81_71,r_79_81_71,0.83,125,196,71,10
5,r_103_76_118,seq84,r_85_100_202,r_103_76_118,0.73,0,118,118,10
46,r_53_36_62,r_39_125_209,r_14_15_15,r_53_36_62,1.0,0,62,62,10
42,r_30_93_91,r_106_112_195,seq18,r_30_93_91,1.0,0,91,91,10
80,seq147,r_25_12_226,seq35,r_25_12_226,0.63,-51,175,226,10
45,r_27_68_237,seq83,r_87_72_141,r_87_72_141,0.89,96,237,141,10
44,r_14_15_15,r_87_72_141,seq34,r_14_15_15,0.99,0,15,15,10
19,r_78_49_194,seq83,seq22,r_78_49_194,0.67,0,194,194,10
11,r_96_119_166,r_88_33_49,seq109,r_96_119_166,1.0,0,166,166,10
95,seq115,r_107_13_95,seq129,r_107_13_95,1.0,1,96,95,10
39,r_1_108_24,r_48_21_175,r_11_40_104,r_1_108_24,1.0,1,25,24,10
31,r_6_69_21,r_32_116_219,seq41,r_6_69_21,1.0,0,21,21,10
3,r_107_13_95,seq115,seq71,r_107_13_95,1.0,1,96,95,10
10,r_32_116_219,seq110,r_143_29_57,r_32_116_219,0.51,0,219,219,10
1,r_101_145_215,seq141,r_143_29_57,r_143_29_57,1.0,-5,52,57,10
11,r_96_119_166,seq129,r_88_33_49,r_88_33_49,1.0,6,55,49,10
0,r_87_72_141,r_0_127_79,r_39_125_209,r_0_127_79,1.0,0,79,79,10
13,r_95_92_227,seq18,r_42_4_224,r_95_92_227,0.66,-1,226,227,10
64,seq22,seq84,r_78_49_194,r_78_49_194,0.99,0,194,194,10
4,r_85_100_202,r_37_31_7,r_80_61_30,r_80_61_30,0.95,157,187,30,10
6,r_111_102_176,seq5,r_107_13_95,r_107_13_95,1.0,80,175,95,10
62,seq20,r_142_94_225,r_60_118_109,r_142_94_225,0.76,-28,197,225,10
21,r_88_33_49,r_96_119_166,r_55_114_54,r_96_119_166,1.0,0,166,166,10
0,r_87_72_141,r_39_125_209,r_103_76_118,r_87_72_141,1.0,0,141,141,10
36,r_143_29_57,r_101_145_215,r_60_118_109,r_101_145_215,0.9,-1,214,215,10
63,seq149,r_55_114_54,seq52,r_55_114_54,1.0,0,54,54,10
27,r_66_50_222,seq130,r_42_4_224,r_66_50_222,0.45,1,223,222,10
87,seq83,r_78_49_194,seq126,r_78_49_194,0.9,-1,193,194,10
4,r_85_100_202,seq135,r_37_31_7,r_37_31_7,0.63,43,50,7,10
47,r_7_122_110,seq98,r_79_81_71,r_79_81_71,0.99,73,144,71,10
33,r_86_128_28,seq71,seq23,r_86_128_28,0.96,2,30,28,10
74,seq58,r_44_54_169,r_42_4_224,r_44_54_169,0.98,-1,168,169,10
18,r_25_12_226,seq147,r_85_100_202,r_25_12_226,0.37,2,228,226,10
29,r_133_117_148,seq5,seq67,r_133_117_148,1.0,0,148,148,10
24,r_136_26_229,seq146,r_55_114_54,r_55_114_54,0.98,174,228,54,10
36,r_143_29_57,seq109,r_101_145_215,r_143_29_57,0.99,0,57,57,10
58,seq130,r_66_50_222,r_16_123_188,r_16_123_188,0.92,35,223,188,10
15,r_121_137_56,r_39_125_209,seq141,r_121_137_56,1.0,1,57,56,10
20,r_37_31_7,seq91,r_0_127_79,r_0_127_79,1.0,36,115,79,10
68,seq35,r_134_131_82,seq147,r_134_131_82,1.0,-4,78,82,10
32,r_39_125_209,seq120,r_55_114_54,r_55_114_54,1.0,166,220,54,10
38,r_11_40_104,r_32_116_219,seq110,r_32_116_219,0.8,-95,124,219,10
77,seq146,r_136_26_229,r_107_13_95,r_107_13_95,1.0,134,229,95,10
5,r_103_76_118,r_85_100_202,r_87_72_141,r_87_72_141,0.98,4,145,141,10
34,r_142_94_225,seq20,r_85_100_202,r_85_100_202,0.73,23,225,202,10
17,r_79_81_71,r_60_118_109,seq148,r_79_81_71,1.0,1,72,71,10
25,r_97_63_18,r_44_54_169,r_0_127_79,r_0_127_79,0.94,90,169,79,10
94,seq110,r_32_116_219,r_11_40_104,r_32_116_219,0.79,-98,121,219,10
37,r_16_123_188,r_11_40_104,seq57,r_16_123_188,0.99,0,188,188,10
21,r_88_33_49,r_27_68_237,r_96_119_166,r_88_33_49,1.0,0,49,49,10
49,r_144_132_61,seq138,seq130,r_144_132_61,1.0,1,62,61,10
7,r_45_113_137,seq8,r_47_64_8,r_45_113_137,1.0,0,137,137,10
8,r_47_64_8,r_60_118_109,seq138,r_47_64_8,0.83,4,12,8,10
35,r_134_131_82,r_25_12_226,r_55_114_54,r_134_131_82,1.0,0,82,82,10
64,seq22,r_60_118_109,r_144_132_61,r_144_132_61,0.99,-11,50,61,10
44,r_15_3_170,r_57_38_43,r_12_78_167,r_15_3_170,0.97,0,170,170,11
36,r_135_33_82,seq52,r_76_79_21,r_135_33_82,0.94,6,88,82,11
14,r_59_36_228,seq21,r_127_67_195,r_127_67_195,0.51,34,229,195,11
8,r_17_42_92,seq26,seq129,r_17_42_92,0.99,0,92,92,11
53,seq4,r_147_145_78,r_123_84_18,r_147_145_78,1.0,0,78,78,11
43,r_126_65_186,seq9,r_70_39_12,r_126_65_186,0.61,1,187,186,11
48,r_92_48_33,r_94_146_105,seq96,r_92_48_33,1.0,0,33,33,11
37,r_114_141_112,seq96,seq0,r_114_141_112,1.0,0,112,112,11
59,seq138,r_56_50_130,seq11,r_56_50_130,1.0,1,131,130,11
16,r_147_145_78,seq4,seq8,r_147_145_78,1.0,0,78,78,11
21,r_112_101_150,seq99,r_70_39_12,r_112_101_150,0.7,0,150,150,11
39,r_23_2_94,seq9,seq148,r_23_2_94,0.81,0,94,94,11
97,seq121,r_25_72_222,r_41_63_48,r_41_63_48,0.71,101,149,48,11
46,r_116_108_169,seq90,seq148,r_116_108_169,0.93,0,169,169,11
45,r_106_24_114,seq5,r_86_53_128,r_106_24_114,0.5,1,115,114,11
41,r_16_68_135,r_37_100_97,r_76_79_21,r_76_79_21,0.95,1,22,21,11
30,r_70_39_12,r_25_72_222,r_112_101_150,r_70_39_12,0.52,1,13,12,11
15,r_18_87_219,seq80,seq138,r_18_87_219,0.46,0,219,219,11
27,r_43_22_63,r_16_68_135,r_76_79_21,r_16_68_135,0.99,4,139,135,11
66,seq21,r_59_36_228,r_104_98_57,r_104_98_57,1.0,172,229,57,11
76,seq66,r_114_141_112,r_75_132_61,r_114_141_112,0.89,-41,71,112,11
67,seq26,seq102,r_15_3_170,r_15_3_170,0.96,50,220,170,11
89,seq99,r_112_101_150,seq80,r_112_101_150,0.8,0,150,150,11
3,r_119_34_76,seq11,r_57_38_43,r_119_34_76,1.0,0,76,76,11
10,r_55_91_164,r_18_87_219,r_54_111_90,r_55_91_164,0.75,0,164,164,11
19,r_137_136_23,r_10_134_206,seq69,r_137_136_23,0.96,1,24,23,11
42,r_104_98_57,r_94_146_105,seq21,r_104_98_57,1.0,-1,56,57,11
74,seq58,seq30,r_10_134_206,r_10_134_206,0.91,2,208,206,11
26,r_109_27_201,r_139_81_111,seq85,r_139_81_111,1.0,-40,71,111,11
4,r_62_31_1,seq113,r_16_68_135,r_16_68_135,0.68,0,135,135,11
33,r_41_63_48,r_62_31_1,seq121,r_41_63_48,0.98,0,48,48,11
0,r_139_81_111,r_109_27_201,seq88,r_139_81_111,1.0,0,111,111,11
11,r_107_93_95,seq85,seq5,r_107_93_95,1.0,-1,94,95,11
20,r_86_53_128,r_62_31_1,r_57_38_43,r_86_53_128,0.88,0,128,128,11
13,r_25_72_222,seq121,r_119_34_76,r_119_34_76,0.86,146,222,76,11
98,seq124,r_10_134_206,r_32_19_88,r_32_19_88,1.0,118,206,88,11
15,r_18_87_219,r_32_19_88,seq80,r_32_19_88,1.0,-18,70,88,11
57,seq8,seq66,r_147_145_78,r_147_145_78,1.0,18,96,78,11
19,r_137_136_23,seq69,seq9,r_137_136_23,0.39,37,60,23,11
41,r_16_68_135,r_43_22_63,r_62_31_1,r_16_68_135,1.0,4,139,135,11
89,seq99,seq80,r_127_67_195,r_127_67_195,1.0,0,195,195,11
85,seq88,seq64,r_139_81_111,r_139_81_111,1.0,50,161,111,11
5,r_76_79_21,r_16_68_135,r_135_33_82,r_76_79_21,0.96,64,85,21,11
27,r_43_22_63,seq8,r_16_68_135,r_43_22_63,1.0,0,63,63,11
32,r_1_110_125,seq102,r_45_130_148,r_45_130_148,0.98,3,151,148,11
2,r_47_83_179,seq138,seq82,r_47_83_179,0.91,0,179,179,11
41,r_16_68_135,r_76_79_21,r_43_22_63,r_43_22_63,1.0,22,85,63,11
47,r_45_130_148,r_25_72_222,r_1_110_125,r_25_72_222,0.95,-73,149,222,11
88,seq96,r_114_141_112,r_92_48_33,r_92_48_33,0.62,0,33,33,11
74,seq58,r_62_31_1,seq9,r_62_31_1,0.46,75,76,1,11
29,r_56_50_130,seq138,r_137_136_23,r_56_50_130,0.96,1,131,130,11
44,r_15_3_170,seq129,r_57_38_43,r_57_38_43,1.0,-2,41,43,11
6,r_57_38_43,r_61_40_134,r_15_3_170,r_57_38_43,1.0,0,43,43,11
5,r_76_79_21,seq80,r_16_68_135,r_76_79_21,0.94,2,23,21,11
58,seq9,r_126_65_186,r_62_31_1,r_126_65_186,0.92,1,187,186,11
6,r_57_38_43,r_15_3_170,r_119_34_76,r_57_38_43,0.98,127,170,43,11
65,seq148,seq118,r_116_108_169,r_116_108_169,0.99,25,194,169,11
32,r_1_110_125,seq120,seq102,r_1_110_125,0.72,0,125,125,11
38,r_127_67_195,seq30,seq99,r_127_67_195,0.82,0,195,195,11
34,r_37_100_97,seq85,seq128,r_37_100_97,1.0,1,98,97,11
17,r_61_40_134,seq0,seq51,r_61_40_134,0.99,0,134,134,11
9,r_32_19_88,r_18_87_219,seq124,r_32_19_88,1.0,0,88,88,11
45,r_106_24_114,r_86_53_128,seq30,r_86_53_128,0.76,1,129,128,11
12,r_54_111_90,seq90,r_55_91_164,r_55_91_164,0.99,-1,163,164,11
28,r_115_125_49,seq128,seq124,r_115_125_49,1.0,0,49,49,11
49,r_12_78_167,seq131,r_15_3_170,r_12_78_167,0.74,3,170,167,11
56,seq129,r_15_3_170,r_17_42_92,r_17_42_92,0.57,14,106,92,11
7,r_29_20_132,seq85,seq131,r_29_20_132,0.89,2,134,132,11
23,r_94_146_105,seq13,seq85,r_94_146_105,0.49,2,107,105,11
19,r_137_136_23,seq9,r_56_50_130,r_137_136_23,0.54,75,98,23,11
82,seq80,r_18_87_219,r_75_132_61,r_18_87_219,0.66,-14,205,219,11
35,r_122_44_178,seq144,r_119_34_76,r_122_44_178,0.76,0,178,178,11
12,r_54_111_90,r_106_24_114,seq90,r_54_111_90,0.76,16,106,90,11
93,seq117,r_26_65_112,r_20_145_100,r_20_145_100,1.0,15,115,100,12
30,r_48_67_248,r_63_64_115,r_32_79_109,r_48_67_248,0.78,-151,97,248,12
51,seq3,seq71,r_144_33_76,r_144_33_76,1.0,1,77,76,12
36,r_63_64_115,r_48_67_248,r_141_84_101,r_63_64_115,0.84,0,115,115,12
14,r_59_137_143,r_141_84_101,r_13_102_77,r_59_137_143,0.77,-41,102,143,12
8,r_52_99_206,seq37,r_60_16_140,r_52_99_206,0.8,0,206,206,12
53,seq135,r_136_105_240,seq47,r_136_105_240,0.84,-1,239,240,12
43,r_5_116_188,r_81_110_195,seq126,r_5_116_188,0.46,1,189,188,12
42,r_128_83_26,seq47,seq42,r_128_83_26,1.0,0,26,26,12
3,r_82_114_137,seq42,r_63_64_115,r_63_64_115,1.0,1,116,115,12
37,r_54_44_130,r_93_133_142,seq143,r_54_44_130,0.77,-87,43,130,12
21,r_20_145_100,seq28,seq117,r_20_145_100,1.0,0,100,100,12
39,r_26_65_112,seq118,seq107,r_26_65_112,0.76,3,115,112,12
1,r_36_7_154,seq15,r_72_132_75,r_36_7_154,0.98,1,155,154,12
46,r_98_91_102,r_92_50_168,r_22_124_14,r_98_91_102,0.97,0,102,102,12
32,r_94_147_61,r_81_110_195,r_4_55_52,r_81_110_195,1.0,1,196,195,12
35,r_24_14_37,seq104,seq135,r_24_14_37,0.91,-1,36,37,12
11,r_144_33_76,r_56_123_238,r_13_102_77,r_144_33_76,0.45,-45,31,76,12
95,seq120,r_119_149_127,seq71,r_119_149_127,1.0,-50,77,127,12
66,seq37,r_52_99_206,r_140_68_45,r_140_68_45,0.62,151,196,45,12
31,r_8_49_93,seq118,seq139,r_8_49_93,1.0,0,93,93,12
76,seq66,r_51_142_163,r_11_31_38,r_11_31_38,1.0,1,39,38,12
41,r_103_43_228,r_94_147_61,r_90_76_124,r_94_147_61,0.61,41,102,61,12
11,r_144_33_76,r_13_102_77,seq3,r_144_33_76,1.0,-3,73,76,12
10,r_141_84_101,r_59_137_143,seq107,r_141_84_101,1.0,1,102,101,12
47,r_13_102_77,r_32_79_109,r_59_137_143,r_59_137_143,0.72,-103,40,143,12
26,r_41_86_174,r_72_132_75,r_90_76_124,r_72_132_75,1.0,4,79,75,12
0,r_32_79_109,seq101,seq85,r_32_79_109,0.88,0,109,109,12
63,seq28,r_20_145_100,r_24_14_37,r_20_145_100,1.0,2,102,100,12
5,r_140_68_45,seq28,seq37,r_140_68_45,0.98,-5,40,45,12
20,r_90_76_124,r_19_62_4,r_11_31_38,r_11_31_38,1.0,135,173,38,12
98,seq126,r_27_121_117,r_35_58_104,r_27_121_117,0.63,3,120,117,12
48,r_130_0_214,seq57,r_36_7_154,r_36_7_154,1.0,62,216,154,12
44,r_138_129_35,r_4_55_52,r_19_62_4,r_19_62_4,1.0,31,35,4,12
6,r_72_132_75,r_41_86_174,seq134,r_72_132_75,1.0,1,76,75,12
62,seq25,seq30,r_119_149_127,r_119_149_127,1.0,19,146,127,12
2,r_22_124_14,seq111,r_98_91_102,r_98_91_102,1.0,5,107,102,12
4,r_4_55_52,r_87_95_218,seq77,r_4_55_52,0.98,0,52,52,12
16,r_46_12_34,r_60_16_140,seq3,r_46_12_34,0.99,0,34,34,12
27,r_106_113_132,r_92_50_168,seq29,r_106_113_132,1.0,0,132,132,12
41,r_103_43_228,r_90_76_124,r_82_114_137,r_90_76_124,0.61,104,228,124,12
40,r_93_133_142,seq126,seq17,r_93_133_142,0.42,-37,105,142,12
18,r_34_96_90,r_51_142_163,seq104,r_34_96_90,1.0,0,90,90,12
29,r_112_1_189,r_5_116_188,r_128_83_26,r_112_1_189,0.87,0,189,189,12
25,r_89_80_152,seq6,seq29,r_89_80_152,0.86,0,152,152,12
33,r_18_73_150,seq2,seq17,r_18_73_150,0.72,1,151,150,12
64,seq29,seq45,r_89_80_152,r_89_80_152,0.96,24,176,152,12
47,r_13_102_77,r_59_137_143,seq126,r_59_137_143,0.69,6,149,143,12
50,seq2,r_18_73_150,r_138_129_35,r_138_129_35,0.61,100,135,35,12
83,seq88,seq45,r_130_0_214,r_130_0_214,0.53,-37,177,214,12
32,r_94_147_61,r_103_43_228,r_81_110_195,r_94_147_61,0.78,-2,59,61,12
15,r_60_16_140,r_46_12_34,seq127,r_46_12_34,1.0,-7,27,34,12
38,r_119_149_127,seq120,seq25,r_119_149_127,1.0,0,127,127,12
34,r_35_58_104,r_51_142_163,seq17,r_35_58_104,0.62,2,106,104,12
2,r_22_124_14,r_48_67_248,seq111,r_22_124_14,1.0,0,14,14,12
40,r_93_133_142,seq17,r_32_79_109,r_93_133_142,0.63,0,142,142,12
17,r_21_109_69,r_27_121_117,seq78,r_21_109_69,0.73,-2,67,69,12
14,r_59_137_143,r_13_102_77,seq77,r_59_137_143,0.99,6,149,143,12
9,r_51_142_163,seq66,seq126,r_51_142_163,0.77,0,163,163,12
26,r_41_86_174,r_90_76_124,seq42,r_41_86_174,0.99,0,174,174,12
50,seq2,r_138_129_35,r_51_142_163,r_138_129_35,0.75,189,224,35,12
22,r_81_110_195,seq77,r_87_95_218,r_81_110_195,0.68,-1,194,195,12
28,r_92_50_168,seq146,r_32_79_109,r_92_50_168,0.95,0,168,168,12
49,r_136_105_240,seq135,r_51_142_163,r_136_105_240,0.31,-1,239,240,12
7,r_74_70_148,seq78,seq69,r_74_70_148,1.0,0,148,148,12
23,r_27_121_117,seq126,seq69,r_27_121_117,1.0,2,119,117,12
19,r_136_52_13,r_40_9_224,r_12_28_203,r_12_28_203,0.85,1,204,203,13
14,r_12_28_203,seq7,r_136_52_13,r_12_28_203,0.88,0,203,203,13
8,r_101_16_87,seq58,seq142,r_101_16_87,0.83,26,113,87,13
53,seq7,r_12_28_203,r_11_130_227,r_12_28_203,0.82,1,204,203,13
43,r_10_105_60,r_12_28_203,r_75_22_56,r_10_105_60,0.91,0,60,60,13
54,seq137,r_61_6_230,r_68_5_32,r_68_5_32,0.77,198,230,32,13
37,r_118_38_62,seq69,r_11_130_227,r_118_38_62,1.0,0,62,62,13
19,r_136_52_13,r_138_8_138,r_147_95_172,r_138_8_138,0.39,7,145,138,13
16,r_92_35_168,seq42,seq13,r_92_35_168,0.83,0,168,168,13
21,r_25_104_108,seq7,r_107_114_246,r_25_104_108,1.0,1,109,108,13
39,r_122_135_159,seq67,seq78,r_122_135_159,0.36,-1,158,159,13
5,r_73_82_200,seq145,seq141,r_73_82_200,0.45,1,201,200,13
50,seq3,r_11_130_227,r_75_22_56,r_75_22_56,1.0,2,58,56,13
45,r_32_83_65,seq72,r_79_23_121,r_32_83_65,1.0,11,76,65,13
19,r_136_52_13,r_147_95_172,r_40_9_224,r_136_52_13,0.42,156,169,13,13
26,r_75_22_56,r_147_95_172,seq3,r_75_22_56,1.0,0,56,56,13
41,r_46_131_193,r_97_41_8,seq4,r_97_41_8,0.61,186,194,8,13
67,seq45,r_26_33_225,seq139,r_26_33_225,0.94,0,225,225,13
3,r_1_84_90,r_148_15_111,seq58,r_1_84_90,0.99,1,91,90,13
31,r_107_114_246,seq119,r_25_104_108,r_25_104_108,1.0,2,110,108,13
34,r_63_86_34,seq48,seq110,r_63_86_34,1.0,4,38,34,13
48,r_90_81_53,r_101_16_87,seq119,r_90_81_53,0.67,2,55,53,13
4,r_132_65_96,r_51_56_177,seq133,r_132_65_96,0.97,0,96,96,13
0,r_53_0_136,seq115,seq133,r_53_0_136,0.51,0,136,136,13
11,r_126_120_186,r_27_143_235,seq36,r_27_143_235,0.9,-47,188,235,13
20,r_109_66_127,seq80,seq117,r_109_66_127,0.38,9,136,127,13
57,seq142,r_128_21_146,r_101_16_87,r_101_16_87,0.91,13,100,87,13
13,r_87_89_29,r_107_114_246,seq57,r_87_89_29,0.75,0,29,29,13
27,r_27_143_235,seq45,r_11_130_227,r_27_143_235,0.33,0,235,235,13
42,r_138_8_138,r_53_0_136,r_136_52_13,r_138_8_138,0.71,-125,13,138,13
40,r_51_56_177,seq3,seq48,r_51_56_177,0.99,0,177,177,13
18,r_68_5_32,r_14_140_31,r_20_93_67,r_20_93_67,1.0,89,156,67,13
29,r_20_93_67,r_99_96_139,seq39,r_20_93_67,1.0,1,68,67,13
25,r_128_21_146,seq142,r_87_89_29,r_128_21_146,0.51,16,162,146,13
33,r_64_47_125,seq111,r_32_83_65,r_64_47_125,0.66,1,126,125,13
64,seq39,seq113,r_20_93_67,r_20_93_67,1.0,24,91,67,13
88,seq110,seq57,r_63_86_34,r_63_86_34,1.0,66,100,34,13
70,seq57,seq110,r_87_89_29,r_87_89_29,0.86,71,100,29,13
65,seq42,r_92_35_168,seq48,r_92_35_168,0.98,0,168,168,13
68,seq48,seq111,r_51_56_177,r_51_56_177,1.0,2,179,177,13
19,r_136_52_13,seq149,r_138_8_138,r_136_52_13,0.96,0,13,13,13
42,r_138_8_138,r_136_52_13,seq117,r_138_8_138,0.99,-1,137,138,13
32,r_147_95_172,r_61_6_230,r_122_135_159,r_147_95_172,0.45,0,172,172,13
17,r_148_15_111,r_26_33_225,r_32_83_65,r_26_33_225,0.99,-110,115,225,13
94,seq119,seq37,r_90_81_53,r_90_81_53,0.88,12,65,53,13
9,r_134_17_73,seq72,seq133,r_134_17_73,1.0,3,76,73,13
73,seq60,r_79_23_121,r_14_140_31,r_14_140_31,0.9,11,42,31,13
56,seq13,seq85,r_92_35_168,r_92_35_168,0.88,0,168,168,13
7,r_11_130_227,seq3,r_118_38_62,r_118_38_62,1.0,15,77,62,13
44,r_61_6_230,seq137,r_11_130_227,r_61_6_230,0.39,0,230,230,13
23,r_112_108_132,seq139,seq115,r_112_108_132,0.87,1,133,132,13
47,r_14_140_31,r_148_15_111,seq60,r_14_140_31,0.87,7,38,31,13
35,r_43_71_82,r_12_28_203,seq98,r_43_71_82,1.0,0,82,82,13
12,r_97_41_8,r_46_131_193,r_53_0_136,r_97_41_8,0.76,186,194,8,13
93,seq111,r_1_133_127,r_7_67_129,r_7_67_129,0.85,3,132,129,14
14,r_98_63_156,r_62_68_216,seq49,r_98_63_156,0.69,4,160,156,14
8,r_92_73_91,r_62_68_216,seq76,r_92_73_91,0.77,0,91,91,14
43,r_103_109_69,r_120_125_246,r_24_21_2,r_103_109_69,0.87,-1,68,69,14
32,r_132_114_95,seq65,r_105_148_20,r_132_114_95,0.71,-64,31,95,14
83,seq76,seq142,r_92_73_91,r_92_73_91,1.0,32,123,91,14
21,r_64_59_234,seq110,r_117_145_151,r_64_59_234,0.49,0,234,234,14
39,r_85_80_165,seq29,r_137_75_46,r_85_80_165,0.93,0,165,165,14
16,r_102_43_26,r_90_42_248,r_84_72_100,r_102_43_26,0.94,0,26,26,14
12,r_146_54_49,r_107_143_228,seq99,r_146_54_49,1.0,0,49,49,14
46,r_20_74_101,seq88,seq38,r_20_74_101,0.96,0,101,101,14
42,r_62_68_216,r_92_73_91,seq16,r_62_68_216,0.58,-125,91,216,14
24,r_78_35_11,r_120_125_246,seq76,r_78_35_11,0.89,0,11,11,14
23,r_79_97_178,seq5,r_19_122_109,r_79_97_178,0.99,0,178,178,14
45,r_1_133_127,seq111,seq121,r_1_133_127,0.54,5,132,127,14
41,r_9_50_79,r_115_23_105,r_118_128_160,r_9_50_79,0.89,0,79,79,14
3,r_139_52_42,r_115_23_105,r_27_147_85,r_27_147_85,1.0,107,192,85,14
26,r_24_21_2,r_96_40_225,r_103_109_69,r_24_21_2,0.53,76,78,2,14
16,r_102_43_26,r_84_72_100,r_91_104_75,r_91_104_75,1.0,25,100,75,14
11,r_77_101_119,seq121,seq70,r_77_101_119,0.46,2,121,119,14
20,r_91_104_75,r_79_97_178,r_102_43_26,r_91_104_75,1.0,0,75,75,14
15,r_123_17_239,seq45,r_39_57_48,r_39_57_48,0.65,191,239,48,14
48,r_124_94_86,r_84_72_100,r_27_147_85,r_27_147_85,1.0,108,193,85,14
5,r_27_147_85,r_124_94_86,r_33_71_135,r_33_71_135,1.0,34,169,135,14
6,r_115_23_105,r_9_50_79,seq29,r_9_50_79,1.0,0,79,79,14
27,r_113_95_125,r_137_75_46,seq56,r_137_75_46,1.0,0,46,46,14
5,r_27_147_85,r_79_97_178,r_124_94_86,r_27_147_85,1.0,0,85,85,14
13,r_34_130_30,r_92_73_91,seq15,r_92_73_91,0.76,-55,36,91,14
38,r_105_148_20,r_90_42_248,seq111,r_105_148_20,0.94,0,20,20,14
47,r_44_13_210,seq4,r_7_67_129,r_44_13_210,0.75,0,210,210,14
40,r_149_53_148,seq4,seq29,r_149_53_148,0.99,0,148,148,14
25,r_30_31_173,r_135_37_116,r_46_69_103,r_30_31_173,1.0,0,173,173,14
74,seq49,r_79_97_178,seq5,r_79_97_178,0.99,-49,129,178,14
18,r_96_40_225,r_24_21_2,r_135_37_116,r_135_37_116,0.71,110,226,116,14
25,r_30_31_173,r_118_128_160,r_135_37_116,r_135_37_116,0.83,22,138,116,14
33,r_33_71_135,r_79_97_178,r_27_147_85,r_79_97_178,1.0,-43,135,178,14
31,r_107_143_228,r_146_54_49,seq38,r_146_54_49,0.89,0,49,49,14
64,seq131,r_32_108_120,r_46_69_103,r_46_69_103,1.0,2,105,103,14
42,r_62_68_216,r_19_122_109,seq3,r_62_68_216,0.71,0,216,216,14
19,r_83_18_50,seq100,seq29,r_83_18_50,0.99,0,50,50,14
34,r_135_37_116,seq99,r_9_50_79,r_135_37_116,0.83,2,118,116,14
9,r_0_12_12,seq76,r_36_86_63,r_36_86_63,1.0,7,70,63,14
31,r_107_143_228,seq38,r_46_69_103,r_46_69_103,0.98,125,228,103,14
28,r_19_122_109,r_62_68_216,r_79_97_178,r_79_97_178,0.89,38,216,178,14
22,r_26_14_171,seq28,r_90_42_248,r_26_14_171,0.91,0,171,171,14
28,r_19_122_109,seq2,r_62_68_216,r_19_122_109,0.91,0,109,109,14
7,r_46_69_103,r_82_66_10,seq131,r_46_69_103,1.0,0,103,103,14
42,r_62_68_216,seq16,r_19_122_109,r_19_122_109,0.99,19,128,109,14
44,r_118_128_160,r_30_31_173,seq4,r_118_128_160,0.86,-6,154,160,14
23,r_79_97_178,r_33_71_135,seq5,r_33_71_135,1.0,0,135,135,14
49,r_137_75_46,r_113_95_125,seq138,r_137_75_46,1.0,0,46,46,14
35,r_36_86_63,r_124_94_86,r_0_12_12,r_36_86_63,1.0,-1,62,63,14
36,r_39_57_48,r_84_72_100,seq38,r_39_57_48,1.0,0,48,48,14
41,r_9_50_79,r_118_128_160,r_135_37_116,r_9_50_79,0.93,46,125,79,14
30,r_133_124_67,seq120,r_53_71_197,r_133_124_67,0.99,2,69,67,15
51,seq131,r_115_36_172,r_51_7_65,r_51_7_65,0.96,111,176,65,15
36,r_111_134_233,seq92,r_16_35_5,r_16_35_5,0.78,228,233,5,15
14,r_103_4_241,seq131,r_79_69_88,r_79_69_88,0.41,152,240,88,15
8,r_147_109_234,r_125_145_202,r_68_39_113,r_68_39_113,0.98,37,150,113,15
53,seq8,r_41_50_162,r_106_82_203,r_41_50_162,0.99,0,162,162,15
54,seq137,r_112_66_123,seq101,r_112_66_123,0.83,18,141,123,15
37,r_44_2_103,seq22,seq123,r_44_2_103,0.99,0,103,103,15
19,r_53_71_197,r_133_124_67,seq0,r_53_71_197,0.96,0,197,197,15
21,r_43_25_176,seq96,seq40,r_43_25_176,0.52,2,178,176,15
39,r_34_80_192,seq6,r_43_25_176,r_34_80_192,0.49,0,192,192,15
1,r_125_145_202,seq32,r_18_142_46,r_125_145_202,0.73,0,202,202,15
97,seq119,r_30_62_80,seq120,r_30_62_80,0.49,-16,64,80,15
5,r_121_102_222,seq84,seq29,r_121_102_222,0.63,0,222,222,15
46,r_115_36_172,seq131,r_106_82_203,r_115_36_172,0.76,4,176,172,15
42,r_75_132_207,seq23,seq120,r_75_132_207,0.87,0,207,207,15
32,r_146_70_38,r_51_7_65,seq87,r_146_70_38,0.94,0,38,38,15
45,r_113_144_95,r_122_100_1,r_74_116_32,r_113_144_95,0.99,0,95,95,15
19,r_53_71_197,r_24_73_104,r_133_124_67,r_53_71_197,0.6,-91,106,197,15
25,r_72_57_160,r_9_95_126,r_79_69_88,r_79_69_88,0.59,111,199,88,15
95,seq114,r_59_65_108,seq90,r_59_65_108,0.58,0,108,108,15
66,seq32,r_125_145_202,r_68_39_113,r_68_39_113,0.78,89,202,113,15
12,r_74_116_32,seq6,r_143_64_22,r_74_116_32,1.0,-1,31,32,15
31,r_41_50_162,seq110,seq31,r_41_50_162,0.4,0,162,162,15
41,r_30_62_80,seq119,seq120,r_30_62_80,0.54,-17,63,80,15
98,seq120,seq119,r_24_73_104,r_24_73_104,0.7,23,127,104,15
3,r_79_69_88,seq15,seq77,r_79_69_88,0.97,2,90,88,15
26,r_26_42_133,seq31,r_30_62_80,r_26_42_133,1.0,0,133,133,15
8,r_147_109_234,r_68_39_113,seq6,r_68_39_113,0.61,121,234,113,15
20,r_56_17_137,r_125_145_202,seq139,r_56_17_137,0.93,1,138,137,15
98,seq120,r_133_124_67,seq119,r_133_124_67,0.87,11,78,67,15
48,r_78_88_187,r_122_100_1,r_67_48_87,r_78_88_187,0.76,-1,186,187,15
6,r_149_12_69,seq123,seq94,r_149_12_69,0.99,2,71,69,15
98,seq120,r_24_73_104,r_78_88_187,r_78_88_187,0.99,-3,184,187,15
41,r_30_62_80,seq38,r_26_42_133,r_26_42_133,1.0,4,137,133,15
30,r_133_124_67,r_53_71_197,r_68_39_113,r_68_39_113,0.51,84,197,113,15
62,seq27,r_53_71_197,r_108_141_4,r_108_141_4,0.58,23,27,4,15
18,r_89_138_105,r_121_102_222,r_54_1_42,r_89_138_105,1.0,0,105,105,15
24,r_51_7_65,seq14,r_16_35_5,r_51_7_65,1.0,0,65,65,15
25,r_72_57_160,r_115_36_172,r_9_95_126,r_9_95_126,0.81,35,161,126,15
43,r_54_1_42,r_37_118_182,r_9_95_126,r_9_95_126,0.87,11,137,126,15
33,r_10_127_244,r_9_95_126,seq81,r_9_95_126,1.0,-6,120,126,15
29,r_83_60_55,r_111_134_233,seq13,r_83_60_55,1.0,0,55,55,15
13,r_130_93_50,seq52,r_18_142_46,r_130_93_50,1.0,0,50,50,15
97,seq119,r_67_48_87,r_128_47_109,r_128_47_109,1.0,9,118,109,15
2,r_143_64_22,r_112_66_123,seq97,r_143_64_22,0.99,0,22,22,15
61,seq23,r_75_132_207,seq104,r_75_132_207,0.7,-1,206,207,15
38,r_37_118_182,r_54_1_42,r_41_50_162,r_54_1_42,0.84,140,182,42,15
16,r_135_126_54,r_79_69_88,seq84,r_135_126_54,1.0,0,54,54,15
97,seq119,seq120,r_67_48_87,r_67_48_87,0.9,3,90,87,15
41,r_30_62_80,seq120,seq38,r_30_62_80,0.67,0,80,80,15
17,r_24_73_104,r_9_95_126,seq119,r_9_95_126,0.74,-18,108,126,15
94,seq110,r_41_50_162,seq140,r_41_50_162,0.98,0,162,162,15
9,r_68_39_113,r_128_47_109,seq32,r_68_39_113,0.68,1,114,113,15
10,r_18_142_46,r_41_50_162,r_130_93_50,r_18_142_46,0.8,4,50,46,15
22,r_9_95_126,r_125_145_202,r_54_1_42,r_9_95_126,0.99,0,126,126,15
62,seq27,r_108_141_4,r_68_39_113,r_68_39_113,1.0,48,161,113,15
89,seq97,seq0,r_143_64_22,r_143_64_22,1.0,4,26,22,15
49,r_3_5_206,seq131,r_53_71_197,r_3_5_206,0.76,0,206,206,15
7,r_67_48_87,r_44_2_103,seq119,r_67_48_87,1.0,0,87,87,15
44,r_20_11_165,seq85,seq131,r_20_11_165,0.81,0,165,165,15
98,seq120,r_78_88_187,r_75_132_207,r_75_132_207,0.68,5,212,207,15
43,r_54_1_42,seq123,r_37_118_182,r_54_1_42,0.52,3,45,42,15
35,r_59_65_108,seq114,r_106_82_203,r_59_65_108,0.34,0,108,108,15
30,r_70_103_201,seq90,seq127,r_70_103_201,0.6,0,201,201,16
20,r_8_56_117,r_93_83_52,r_142_42_10,r_8_56_117,0.9,-105,12,117,16
8,r_31_5_207,seq61,r_91_100_47,r_31_5_207,0.66,0,207,207,16
3,r_18_24_218,r_107_52_12,r_50_17_128,r_18_24_218,0.89,0,218,218,16
48,r_142_42_10,r_31_5_207,r_8_56_117,r_142_42_10,0.99,1,11,10,16
13,r_149_118_46,r_94_143_181,seq1,r_149_118_46,0.98,-1,45,46,16
43,r_92_130_144,r_60_78_112,r_119_7_124,r_92_130_144,0.92,0,144,144,16
16,r_74_81_133,r_25_38_199,seq86,r_74_81_133,0.61,0,133,133,16
1,r_60_78_112,r_3_126_186,r_92_130_144,r_60_78_112,0.97,0,112,112,16
97,seq120,seq34,r_26_101_70,r_26_101_70,1.0,35,105,70,16
5,r_119_7_124,seq97,seq51,r_119_7_124,0.99,1,125,124,16
42,r_3_126_186,r_60_78_112,r_77_11_151,r_60_78_112,0.89,0,112,112,16
43,r_92_130_144,seq146,r_60_78_112,r_60_78_112,0.85,0,112,112,16
46,r_134_141_36,r_31_5_207,seq47,r_134_141_36,0.99,-1,35,36,16
14,r_140_133_45,r_93_83_52,seq29,r_140_133_45,1.0,1,46,45,16
69,seq47,seq97,r_134_141_36,r_134_141_36,1.0,106,142,36,16
45,r_138_35_246,seq137,r_33_139_73,r_33_139_73,1.0,21,94,73,16
33,r_9_67_226,r_102_98_18,r_121_16_54,r_121_16_54,0.99,170,224,54,16
77,seq62,r_91_100_47,r_89_15_32,r_91_100_47,0.53,151,198,47,16
76,seq61,r_31_5_207,r_25_38_199,r_31_5_207,0.63,0,207,207,16
39,r_107_52_12,r_18_24_218,r_63_41_53,r_63_41_53,0.9,165,218,53,16
31,r_106_110_188,seq147,seq59,r_106_110_188,0.97,0,188,188,16
41,r_125_44_86,seq28,r_22_14_69,r_22_14_69,1.0,29,98,69,16
67,seq43,r_75_115_132,r_91_100_47,r_75_115_132,1.0,0,132,132,16
3,r_18_24_218,r_30_122_149,r_107_52_12,r_30_122_149,0.57,4,153,149,16
26,r_123_88_196,seq32,r_33_139_73,r_33_139_73,1.0,123,196,73,16
72,seq51,r_128_21_2,r_119_7_124,r_119_7_124,1.0,10,134,124,16
0,r_94_143_181,r_70_103_201,r_36_131_22,r_94_143_181,0.75,0,181,181,16
9,r_89_15_32,seq28,seq132,r_89_15_32,1.0,0,32,32,16
33,r_9_67_226,seq59,r_102_98_18,r_102_98_18,1.0,7,25,18,16
1,r_60_78_112,r_92_130_144,seq146,r_92_130_144,0.92,7,151,144,16
15,r_55_53_64,seq127,r_102_98_18,r_55_53_64,0.92,1,65,64,16
21,r_63_41_53,r_92_130_144,r_107_52_12,r_63_41_53,1.0,0,53,53,16
4,r_102_98_18,r_9_67_226,r_55_53_64,r_55_53_64,1.0,51,115,64,16
7,r_71_95_24,r_66_136_105,seq129,r_71_95_24,0.99,0,24,24,16
36,r_91_100_47,seq43,r_31_5_207,r_31_5_207,0.88,11,218,207,16
27,r_33_139_73,seq146,r_138_35_246,r_33_139_73,1.0,1,74,73,16
2,r_25_38_199,r_40_87_157,r_36_131_22,r_25_38_199,0.77,-42,157,199,16
47,r_22_14_69,r_106_110_188,seq23,r_22_14_69,1.0,0,69,69,16
4,r_102_98_18,r_138_35_246,r_9_67_226,r_102_98_18,1.0,0,18,18,16
18,r_144_64_67,r_50_17_128,seq32,r_144_64_67,0.69,1,68,67,16
24,r_75_115_132,seq43,seq127,r_75_115_132,1.0,0,132,132,16
16,r_74_81_133,seq86,r_121_16_54,r_74_81_133,0.41,32,165,133,16
23,r_30_122_149,r_77_11_151,r_142_42_10,r_30_122_149,0.52,55,204,149,16
48,r_142_42_10,r_8_56_117,seq69,r_8_56_117,0.61,0,117,117,16
25,r_121_16_54,seq109,seq46,r_121_16_54,0.99,-1,53,54,16
88,seq99,r_37_79_156,seq61,r_37_79_156,0.78,4,160,156,16
50,seq1,seq23,r_149_118_46,r_149_118_46,1.0,92,138,46,16
58,seq146,r_33_139_73,r_39_4_4,r_33_139_73,0.95,1,74,73,16
65,seq32,r_123_88_196,r_144_64_67,r_144_64_67,0.94,129,196,67,16
20,r_8_56_117,r_142_42_10,seq90,r_8_56_117,0.59,0,117,117,16
39,r_107_52_12,r_93_83_52,r_18_24_218,r_107_52_12,0.96,0,12,12,16
42,r_3_126_186,r_77_11_151,seq146,r_3_126_186,0.85,2,188,186,16
32,r_6_85_238,seq112,r_25_38_199,r_25_38_199,0.68,39,238,199,16
38,r_40_87_157,r_25_38_199,seq54,r_40_87_157,0.85,0,157,157,16
77,seq62,r_50_17_128,r_91_100_47,r_50_17_128,1.0,-9,119,128,16
36,r_91_100_47,r_144_64_67,seq43,r_91_100_47,0.47,0,47,47,16
75,seq59,r_9_67_226,r_106_110_188,r_106_110_188,1.0,21,209,188,16
43,r_92_130_144,r_63_41_53,seq146,r_63_41_53,0.75,1,54,53,16
60,seq20,r_65_108_215,r_93_83_52,r_93_83_52,1.0,169,221,52,16
17,r_50_17_128,seq62,seq68,r_50_17_128,0.98,0,128,128,16
28,r_36_131_22,r_10_96_33,r_25_38_199,r_36_131_22,0.69,1,23,22,16
6,r_10_96_33,seq112,seq27,r_10_96_33,1.0,-6,27,33,16
28,r_36_131_22,r_25_38_199,r_94_143_181,r_36_131_22,0.55,177,199,22,16
22,r_58_124_118,seq46,r_10_96_33,r_58_124_118,1.0,0,118,118,16
91,seq112,r_6_85_238,r_50_17_128,r_50_17_128,1.0,43,171,128,16
49,r_111_0_158,seq28,r_39_4_4,r_111_0_158,0.97,0,158,158,16
44,r_26_101_70,r_66_136_105,seq120,r_26_101_70,1.0,0,70,70,16
23,r_30_122_149,r_18_24_218,r_77_11_151,r_30_122_149,0.75,0,149,149,16
2,r_25_38_199,r_36_131_22,seq99,r_25_38_199,0.99,0,199,199,16
10,r_93_83_52,seq2,seq20,r_93_83_52,1.0,1,53,52,16
35,r_37_79_156,r_31_5_207,r_140_133_45,r_140_133_45,0.58,116,161,45,16
64,seq29,seq23,r_140_133_45,r_140_133_45,1.0,9,54,45,16
12,r_105_45_162,r_94_143_181,r_50_17_128,r_94_143_181,0.95,-19,162,181,16
93,seq114,r_141_72_133,r_63_70_122,r_63_70_122,0.74,12,134,122,17
36,r_64_88_99,r_53_22_106,r_32_43_228,r_64_88_99,1.0,0,99,99,17
14,r_146_138_136,r_117_40_164,r_97_34_135,r_146_138_136,0.56,0,136,136,17
8,r_54_143_139,r_83_108_150,seq46,r_54_143_139,1.0,0,139,139,17
43,r_141_72_133,seq114,r_106_130_82,r_106_130_82,0.72,52,134,82,17
41,r_136_94_18,r_97_34_135,seq65,r_136_94_18,0.91,0,18,18,17
55,seq134,r_38_16_96,r_98_58_55,r_38_16_96,0.54,-21,75,96,17
39,r_95_37_65,r_111_39_173,r_59_62_50,r_111_39_173,1.0,-108,65,173,17
18,r_120_0_53,seq51,r_59_62_50,r_120_0_53,0.99,-3,50,53,17
1,r_67_101_145,r_119_3_229,seq78,r_67_101_145,0.97,0,145,145,17
1,r_67_101_145,r_18_30_37,r_119_3_229,r_18_30_37,1.0,-1,36,37,17
69,seq41,r_111_39_173,r_147_113_104,r_147_113_104,1.0,6,110,104,17
76,seq60,r_6_145_120,seq126,r_6_145_120,1.0,0,120,120,17
31,r_11_123_186,seq47,r_54_143_139,r_11_123_186,0.91,0,186,186,17
67,seq149,seq90,r_85_52_84,r_85_52_84,1.0,3,87,84,17
3,r_96_23_176,seq68,seq90,r_96_23_176,0.62,0,176,176,17
10,r_6_145_120,seq60,seq26,r_6_145_120,1.0,0,120,120,17
26,r_45_131_143,seq128,seq4,r_45_131_143,0.99,0,143,143,17
72,seq46,seq65,r_54_143_139,r_54_143_139,0.98,5,144,139,17
0,r_97_34_135,r_119_3_229,r_146_138_136,r_119_3_229,0.56,-93,136,229,17
73,seq47,r_11_123_186,seq42,r_11_123_186,1.0,0,186,186,17
11,r_77_140_231,r_119_3_229,r_147_113_104,r_77_140_231,0.49,0,231,231,17
37,r_133_107_46,r_76_12_245,seq103,r_133_107_46,1.0,0,46,46,17
48,r_63_70_122,r_119_3_229,seq114,r_63_70_122,1.0,0,122,122,17
6,r_61_66_172,seq4,seq142,r_61_66_172,0.99,0,172,172,17
2,r_98_58_55,seq134,r_10_14_154,r_10_14_154,1.0,31,185,154,17
13,r_139_93_29,r_18_30_37,seq126,r_139_93_29,1.0,0,29,29,17
41,r_136_94_18,seq65,r_106_130_82,r_106_130_82,0.96,2,84,82,17
47,r_38_16_96,seq19,seq128,r_38_16_96,1.0,0,96,96,17
40,r_110_31_127,seq127,seq84,r_110_31_127,0.96,0,127,127,17
29,r_74_73_126,seq102,seq15,r_74_73_126,0.62,1,127,126,17
24,r_85_52_84,r_10_14_154,seq149,r_85_52_84,0.97,0,84,84,17
25,r_32_43_228,seq19,r_64_88_99,r_64_88_99,0.98,15,114,99,17
64,seq25,seq46,r_18_30_37,r_18_30_37,1.0,36,73,37,17
33,r_106_130_82,r_139_93_29,r_136_94_18,r_106_130_82,1.0,0,82,82,17
61,seq19,r_38_16_96,r_98_58_55,r_38_16_96,0.71,0,96,96,17
32,r_83_108_150,r_54_143_139,r_6_145_120,r_83_108_150,0.99,-11,139,150,17
38,r_49_82_230,r_148_1_14,seq81,r_148_1_14,0.38,216,230,14,17
52,seq2,r_53_22_106,r_125_144_15,r_53_22_106,0.98,-9,97,106,17
34,r_119_3_229,r_97_34_135,r_53_22_106,r_119_3_229,0.98,-93,136,229,17
33,r_106_130_82,r_136_94_18,r_141_72_133,r_141_72_133,1.0,45,178,133,17
46,r_59_62_50,seq19,r_120_0_53,r_59_62_50,0.97,0,50,50,17
46,r_59_62_50,r_120_0_53,r_95_37_65,r_95_37_65,0.81,26,91,65,17
2,r_98_58_55,r_11_123_186,seq134,r_98_58_55,0.97,-2,53,55,17
17,r_124_89_183,seq122,r_117_40_164,r_124_89_183,0.7,4,187,183,17
9,r_147_113_104,r_99_112_224,seq41,r_147_113_104,1.0,1,105,104,17
22,r_53_22_106,seq2,r_119_3_229,r_53_22_106,0.91,0,106,106,17
28,r_92_137_201,r_99_112_224,r_36_56_163,r_92_137_201,0.6,1,202,201,17
49,r_109_7_147,seq69,seq122,r_109_7_147,1.0,0,147,147,17
44,r_10_14_154,seq78,r_98_58_55,r_10_14_154,0.94,0,154,154,17
7,r_20_48_32,r_106_130_82,seq135,r_20_48_32,0.98,0,32,32,17
27,r_18_30_37,r_67_101_145,seq65,r_18_30_37,1.0,0,37,37,17
33,r_106_130_82,seq15,r_139_93_29,r_139_93_29,1.0,0,29,29,17
35,r_117_40_164,seq128,r_124_89_183,r_117_40_164,0.58,17,181,164,17
12,r_13_29_161,r_76_12_245,r_148_1_14,r_13_29_161,0.91,0,161,161,17
49,r_111_128_19,r_33_13_243,seq64,r_33_13_243,0.62,-225,18,243,18
36,r_143_120_232,r_33_13_243,r_2_147_41,r_2_147_41,1.0,191,232,41,18
14,r_104_28_77,seq140,r_126_46_22,r_104_28_77,0.98,0,77,77,18
8,r_80_94_180,seq31,seq98,r_80_94_180,0.89,4,184,180,18
43,r_141_112_188,r_97_73_150,r_72_42_120,r_141_112_188,0.55,-57,131,188,18
83,seq142,r_53_56_131,r_96_49_6,r_53_56_131,0.93,-63,68,131,18
37,r_110_3_79,r_33_13_243,seq106,r_110_3_79,1.0,0,79,79,18
16,r_6_81_149,seq40,seq93,r_6_81_149,0.95,0,149,149,18
21,r_82_34_184,r_12_95_179,seq41,r_82_34_184,0.91,1,185,184,18
39,r_109_26_101,r_91_10_140,seq23,r_109_26_101,1.0,1,102,101,18
1,r_68_135_112,r_32_74_247,seq103,r_68_135_112,1.0,0,112,112,18
97,seq121,r_67_115_116,r_52_84_14,r_67_115_116,0.95,-51,65,116,18
5,r_149_134_87,r_146_78_128,r_110_3_79,r_149_134_87,0.99,1,88,87,18
46,r_131_87_193,seq106,r_96_49_6,r_131_87_193,0.77,0,193,193,18
42,r_139_92_40,r_33_13_243,r_126_46_22,r_126_46_22,0.53,106,128,22,18
69,seq40,r_6_81_149,seq64,r_6_81_149,1.0,0,149,149,18
45,r_136_29_114,r_11_88_244,seq142,r_136_29_114,1.0,0,114,114,18
70,seq41,seq66,r_82_34_184,r_82_34_184,0.99,9,193,184,18
19,r_133_39_181,seq66,seq98,r_133_39_181,0.97,1,182,181,18
27,r_99_47_49,r_86_85_165,r_97_73_150,r_99_47_49,0.99,117,166,49,18
31,r_53_56_131,seq142,r_148_105_33,r_53_56_131,1.0,0,131,131,18
41,r_72_42_120,seq119,r_141_112_188,r_72_42_120,1.0,0,120,120,18
89,seq103,r_80_94_180,r_68_135_112,r_68_135_112,0.64,-2,110,112,18
26,r_76_51_93,seq140,r_126_46_22,r_76_51_93,0.94,-1,92,93,18
20,r_12_95_179,seq127,r_75_100_191,r_12_95_179,0.42,11,190,179,18
15,r_5_65_248,r_50_122_159,r_17_45_129,r_5_65_248,0.98,-89,159,248,18
6,r_91_10_140,r_109_26_101,r_1_123_31,r_109_26_101,1.0,-15,86,101,18
41,r_72_42_120,r_90_145_4,r_6_81_149,r_72_42_120,0.52,107,227,120,18
22,r_77_144_218,r_68_135_112,r_82_34_184,r_68_135_112,0.59,108,220,112,18
2,r_11_88_244,r_136_29_114,r_111_128_19,r_136_29_114,1.0,-6,108,114,18
41,r_72_42_120,r_141_112_188,r_90_145_4,r_141_112_188,1.0,3,191,188,18
18,r_50_122_159,r_5_65_248,seq127,r_50_122_159,0.69,0,159,159,18
29,r_25_137_220,r_32_74_247,r_6_81_149,r_32_74_247,0.43,-26,221,247,18
24,r_44_58_143,seq41,seq38,r_44_58_143,0.86,0,143,143,18
48,r_86_85_165,seq98,r_99_47_49,r_99_47_49,0.91,-2,47,49,18
47,r_52_84_14,r_70_125_24,seq121,r_52_84_14,0.92,-3,11,14,18
43,r_141_112_188,r_72_42_120,r_136_29_114,r_141_112_188,0.97,3,191,188,18
33,r_32_74_247,r_25_137_220,r_133_39_181,r_133_39_181,0.44,39,220,181,18
48,r_86_85_165,r_99_47_49,r_136_29_114,r_86_85_165,0.53,1,166,165,18
64,seq31,r_80_94_180,seq103,r_80_94_180,0.86,0,180,180,18
70,seq41,r_44_58_143,seq66,r_44_58_143,0.89,0,143,143,18
27,r_99_47_49,r_110_3_79,r_86_85_165,r_110_3_79,1.0,-30,49,79,18
68,seq38,r_17_45_129,r_2_147_41,r_2_147_41,0.68,88,129,41,18
13,r_70_125_24,r_104_28_77,seq60,r_104_28_77,0.57,-57,20,77,18
32,r_83_22_183,r_131_87_193,seq103,r_83_22_183,0.83,1,184,183,18
38,r_97_73_150,r_141_112_188,r_99_47_49,r_97_73_150,0.99,0,150,150,18
52,seq4,r_143_120_232,r_2_147_41,r_2_147_41,1.0,30,71,41,18
34,r_43_107_224,seq69,r_8_24_156,r_8_24_156,0.8,70,226,156,18
3,r_2_147_41,r_97_73_150,seq63,r_2_147_41,0.89,0,41,41,18
17,r_9_0_171,seq121,r_97_73_150,r_9_0_171,0.52,1,172,171,18
9,r_17_45_129,seq38,r_5_65_248,r_17_45_129,0.99,0,129,129,18
96,seq119,r_72_42_120,seq64,r_72_42_120,1.0,0,120,120,18
6,r_91_10_140,r_1_123_31,r_146_78_128,r_91_10_140,1.0,0,140,140,18
22,r_77_144_218,r_146_78_128,r_68_135_112,r_77_144_218,0.97,-81,137,218,18
28,r_75_100_191,r_32_74_247,seq101,r_75_100_191,0.76,0,191,191,18
7,r_67_115_116,r_20_118_151,seq60,r_67_115_116,0.97,0,116,116,18
44,r_20_118_151,seq138,seq15,r_20_118_151,0.47,-1,150,151,18
45,r_136_29_114,seq142,r_86_85_165,r_86_85_165,1.0,1,166,165,18
79,seq66,r_133_39_181,seq124,r_133_39_181,1.0,-3,178,181,18
23,r_126_46_22,r_11_88_244,r_139_92_40,r_11_88_244,0.57,-223,21,244,18
12,r_146_78_128,r_77_144_218,r_91_10_140,r_146_78_128,0.98,13,141,128,18
30,r_112_69_194,seq107,r_5_37_165,r_5_37_165,0.95,33,198,165,19
14,r_44_101_173,seq34,r_53_87_122,r_44_101_173,0.8,0,173,173,19
18,r_45_57_35,r_42_133_243,seq21,r_45_57_35,0.94,4,39,35,19
8,r_56_16_69,r_63_78_215,r_121_119_29,r_56_16_69,1.0,1,70,69,19
28,r_131_130_32,r_12_19_102,seq46,r_131_130_32,0.76,0,32,32,19
54,seq137,r_55_94_222,r_71_85_149,r_55_94_222,0.6,-137,85,222,19
83,seq88,r_146_99_159,r_93_35_40,r_146_99_159,1.0,-28,131,159,19
59,seq145,r_42_133_243,r_82_139_61,r_82_139_61,1.0,41,102,61,19
19,r_26_126_28,r_140_70_192,r_22_62_181,r_22_62_181,0.56,1,182,181,19
19,r_26_126_28,seq40,r_140_70_192,r_26_126_28,1.0,0,28,28,19
21,r_110_129_133,r_118_128_120,seq68,r_118_128_120,0.66,14,134,120,19
46,r_135_17_82,seq144,seq39,r_135_17_82,0.96,0,82,82,19
42,r_53_87_122,r_48_58_114,seq79,r_53_87_122,0.96,2,124,122,19
45,r_140_70_192,r_110_129_133,r_26_126_28,r_140_70_192,0.91,-58,134,192,19
45,r_140_70_192,r_26_126_28,seq95,r_140_70_192,0.97,1,193,192,19
95,seq113,r_12_19_102,seq148,r_12_19_102,1.0,0,102,102,19
31,r_98_76_77,r_55_94_222,seq11,r_98_76_77,0.69,4,81,77,19
41,r_132_72_177,seq23,r_5_37_165,r_5_37_165,0.69,12,177,165,19
67,seq34,r_44_101_173,r_67_66_41,r_67_66_41,0.7,46,87,41,19
3,r_63_78_215,seq31,seq68,r_63_78_215,0.57,0,215,215,19
5,r_121_119_29,seq15,r_56_16_69,r_56_16_69,0.97,13,82,69,19
10,r_77_84_65,seq10,seq11,r_77_84_65,1.0,1,66,65,19
5,r_121_119_29,r_96_4_216,seq15,r_121_119_29,0.95,1,30,29,19
4,r_125_92_156,seq74,r_115_54_144,r_125_92_156,1.0,0,156,156,19
0,r_27_134_93,seq1,seq47,r_27_134_93,0.7,2,95,93,19
11,r_32_89_207,seq39,r_131_130_32,r_131_130_32,0.72,177,209,32,19
39,r_28_122_75,seq145,seq100,r_28_122_75,0.68,-44,31,75,19
20,r_60_30_126,r_22_62_181,r_29_80_9,r_60_30_126,0.75,0,126,126,19
13,r_12_19_102,seq113,r_45_57_35,r_12_19_102,0.96,0,102,102,19
15,r_73_90_148,seq31,seq1,r_73_90_148,0.92,1,149,148,19
48,r_82_139_61,seq111,seq147,r_82_139_61,1.0,0,61,61,19
6,r_5_37_165,seq31,seq111,r_5_37_165,0.78,0,165,165,19
99,seq127,r_96_4_216,seq7,r_96_4_216,0.94,-47,169,216,19
27,r_108_25_94,seq64,seq31,r_108_25_94,0.97,0,94,94,19
47,r_81_136_100,r_65_20_245,r_93_35_40,r_81_136_100,0.63,1,101,100,19
59,seq145,r_82_139_61,r_24_8_153,r_24_8_153,1.0,17,170,153,19
29,r_48_58_114,r_53_87_122,seq102,r_53_87_122,0.59,-5,117,122,19
63,seq21,r_135_17_82,r_45_57_35,r_45_57_35,0.57,1,36,35,19
9,r_67_66_41,r_14_13_67,seq34,r_67_66_41,1.0,0,41,41,19
33,r_51_123_213,seq68,r_32_89_207,r_32_89_207,0.98,6,213,207,19
65,seq31,r_63_78_215,r_108_25_94,r_108_25_94,0.97,3,97,94,19
38,r_24_8_153,seq111,seq145,r_24_8_153,0.59,0,153,153,19
34,r_14_13_67,r_55_94_222,seq23,r_55_94_222,0.7,-149,73,222,19
75,seq138,r_14_13_67,seq111,r_14_13_67,0.66,15,82,67,19
17,r_118_128_120,r_110_129_133,r_26_126_28,r_118_128_120,0.99,14,134,120,19
94,seq111,r_24_8_153,r_112_69_194,r_24_8_153,1.0,-1,152,153,19
32,r_0_2_30,seq107,seq74,r_0_2_30,1.0,0,30,30,19
49,r_59_43_160,r_142_117_169,r_110_129_133,r_59_43_160,0.87,0,160,160,19
56,seq11,seq38,r_77_84_65,r_77_84_65,1.0,81,146,65,19
7,r_115_54_144,seq79,seq40,r_115_54_144,1.0,1,145,144,19
16,r_50_86_54,r_82_139_61,seq38,r_82_139_61,0.79,-5,56,61,19
75,seq138,seq111,r_125_92_156,r_125_92_156,1.0,57,213,156,19
35,r_52_9_74,seq11,seq46,r_52_9_74,0.97,0,74,74,19
12,r_146_99_159,seq88,r_29_80_9,r_146_99_159,0.57,0,159,159,19
93,seq105,r_23_40_168,seq12,r_23_40_168,0.97,-4,164,168,20
36,r_80_120_27,seq75,r_77_35_161,r_77_35_161,0.4,-87,74,161,20
8,r_11_70_144,seq32,r_16_140_104,r_11_70_144,0.6,0,144,144,20
53,seq134,r_115_10_137,seq133,r_115_10_137,0.95,0,137,137,20
43,r_58_48_177,seq124,r_6_2_129,r_58_48_177,0.99,0,177,177,20
55,seq137,seq49,r_34_27_103,r_34_27_103,1.0,6,109,103,20
16,r_115_10_137,seq134,r_148_89_150,r_115_10_137,0.49,-73,64,137,20
21,r_16_140_104,seq121,r_11_70_144,r_11_70_144,0.96,0,144,144,20
1,r_23_40_168,seq105,seq71,r_23_40_168,0.83,1,169,168,20
97,seq117,r_142_110_115,r_0_97_167,r_142_110_115,0.94,1,116,115,20
46,r_108_130_225,seq98,r_88_122_86,r_88_122_86,0.39,140,226,86,20
48,r_50_42_34,r_58_48_177,seq53,r_50_42_34,1.0,0,34,34,20
7,r_5_139_201,r_118_37_36,r_44_106_43,r_5_139_201,0.79,0,201,201,20
45,r_21_74_113,seq17,r_24_127_229,r_21_74_113,0.94,-1,112,113,20
36,r_80_120_27,seq137,seq75,r_80_120_27,0.98,1,28,27,20
19,r_9_123_159,seq67,seq107,r_9_123_159,0.97,0,159,159,20
39,r_65_8_28,seq137,r_115_10_137,r_115_10_137,0.91,2,139,137,20
41,r_148_89_150,seq133,r_78_104_80,r_148_89_150,0.97,0,150,150,20
22,r_87_128_95,r_132_62_12,r_34_27_103,r_87_128_95,0.68,27,122,95,20
89,seq100,r_87_128_95,seq32,r_87_128_95,0.76,1,96,95,20
20,r_44_106_43,seq91,r_22_57_20,r_44_106_43,0.94,-1,42,43,20
3,r_61_14_202,r_64_90_231,seq52,r_61_14_202,0.55,0,202,202,20
10,r_39_66_248,seq36,r_7_138_46,r_7_138_46,1.0,27,73,46,20
26,r_60_25_197,r_149_13_114,seq68,r_149_13_114,0.99,2,116,114,20
16,r_115_10_137,r_148_89_150,r_65_8_28,r_148_89_150,0.5,-13,137,150,20
4,r_82_72_182,seq105,r_147_54_165,r_147_54_165,1.0,19,184,165,20
81,seq75,r_147_54_165,r_22_57_20,r_22_57_20,0.79,2,22,20,20
78,seq68,r_59_45_178,r_6_2_129,r_6_2_129,0.68,22,151,129,20
73,seq53,r_44_106_43,r_50_42_34,r_50_42_34,0.66,0,34,34,20
11,r_34_27_103,r_64_90_231,r_87_128_95,r_34_27_103,0.98,0,103,103,20
39,r_65_8_28,seq67,seq137,r_65_8_28,0.65,3,31,28,20
17,r_113_125_48,seq117,seq17,r_113_125_48,0.93,0,48,48,20
13,r_118_37_36,r_5_139_201,r_103_86_77,r_103_86_77,0.95,124,201,77,20
6,r_33_116_172,seq71,seq133,r_33_116_172,0.9,0,172,172,20
97,seq117,r_0_97_167,r_24_127_229,r_0_97_167,1.0,-7,160,167,20
7,r_5_139_201,r_9_123_159,r_118_37_36,r_118_37_36,0.8,3,39,36,20
27,r_6_2_129,r_108_130_225,seq15,r_6_2_129,1.0,0,129,129,20
47,r_0_97_167,seq117,seq79,r_0_97_167,0.84,0,167,167,20
9,r_76_51_47,r_149_13_114,r_39_66_248,r_76_51_47,0.99,0,47,47,20
40,r_78_104_80,seq143,seq124,r_78_104_80,1.0,0,80,80,20
14,r_7_138_46,seq117,r_39_66_248,r_7_138_46,1.0,1,47,46,20
18,r_64_90_231,r_61_14_202,seq129,r_61_14_202,0.68,0,202,202,20
29,r_149_13_114,r_60_25_197,seq53,r_149_13_114,1.0,1,115,114,20
24,r_81_126_65,seq83,seq101,r_81_126_65,1.0,0,65,65,20
25,r_103_86_77,r_114_31_166,seq67,r_103_86_77,0.73,0,77,77,20
33,r_24_127_229,r_84_94_214,seq117,r_84_94_214,0.81,0,214,214,20
50,seq129,r_28_69_219,seq41,r_28_69_219,0.93,2,221,219,20
42,r_147_54_165,r_44_106_43,r_82_72_182,r_147_54_165,0.94,1,166,165,20
38,r_136_111_91,r_21_74_113,r_118_37_36,r_21_74_113,0.96,-22,91,113,20
77,seq67,r_9_123_159,r_103_86_77,r_103_86_77,0.82,82,159,77,20
34,r_84_94_214,r_24_127_229,r_78_104_80,r_78_104_80,1.0,134,214,80,20
37,r_22_57_20,r_84_94_214,r_147_54_165,r_22_57_20,1.0,0,20,20,20
0,r_3_1_25,r_113_125_48,seq143,r_3_1_25,0.73,-11,14,25,20
26,r_60_25_197,seq68,seq52,r_60_25_197,0.81,2,199,197,20
37,r_22_57_20,r_147_54_165,r_44_106_43,r_22_57_20,0.88,146,166,20,20
28,r_88_122_86,seq124,r_108_130_225,r_108_130_225,0.77,3,228,225,20
18,r_64_90_231,seq129,r_50_42_34,r_64_90_231,0.88,0,231,231,20
22,r_87_128_95,seq100,r_132_62_12,r_87_128_95,0.49,1,96,95,20
28,r_88_122_86,seq117,seq124,r_88_122_86,1.0,2,88,86,20
49,r_114_31_166,seq18,r_16_140_104,r_114_31_166,0.95,0,166,166,20
13,r_118_37_36,r_28_69_219,r_5_139_201,r_118_37_36,0.99,2,38,36,20
42,r_147_54_165,seq75,r_44_106_43,r_44_106_43,1.0,1,44,43,20
23,r_77_35_161,seq17,seq100,r_77_35_161,0.75,2,163,161,20
35,r_142_110_115,seq117,seq32,r_142_110_115,0.6,1,116,115,20
36,r_80_120_27,r_77_35_161,seq129,r_77_35_161,0.92,5,166,161,20
84,seq83,r_81_126_65,seq133,r_81_126_65,1.0,0,65,65,20
33,r_26_36_46,r_145_42_109,r_91_124_29,r_145_42_109,0.61,-64,45,109,21
30,r_80_6_97,r_77_4_140,seq55,r_80_6_97,0.99,0,97,97,21
51,seq131,r_15_95_240,r_1_3_164,r_1_3_164,1.0,48,212,164,21
65,seq28,r_10_14_61,r_86_118_165,r_10_14_61,0.97,-9,52,61,21
36,r_122_65_173,seq27,r_21_106_77,r_21_106_77,0.49,97,174,77,21
14,r_31_85_228,seq140,r_145_42_109,r_145_42_109,0.7,119,228,109,21
8,r_17_23_227,r_54_78_201,seq16,r_54_78_201,1.0,-1,200,201,21
43,r_87_99_225,r_133_102_130,r_67_130_71,r_67_130_71,0.65,7,78,71,21
37,r_51_62_192,seq5,r_133_102_130,r_133_102_130,0.99,62,192,130,21
59,seq142,r_132_39_141,r_133_102_130,r_133_102_130,0.84,6,136,130,21
17,r_86_118_165,seq38,r_144_79_22,r_144_79_22,1.0,1,23,22,21
16,r_132_39_141,seq142,seq138,r_132_39_141,0.89,-5,136,141,21
39,r_35_66_66,seq117,r_1_3_164,r_35_66_66,1.0,1,67,66,21
1,r_10_14_61,r_109_129_42,seq142,r_10_14_61,1.0,-1,60,61,21
5,r_67_130_71,r_47_76_219,r_87_99_225,r_67_130_71,1.0,0,71,71,21
42,r_15_95_240,seq131,r_113_114_94,r_113_114_94,1.0,7,101,94,21
7,r_43_30_185,seq72,seq29,r_43_30_185,0.62,-13,172,185,21
45,r_133_102_130,seq55,seq142,r_133_102_130,0.98,0,130,130,21
19,r_93_25_163,r_20_137_191,r_40_44_149,r_93_25_163,0.84,0,163,163,21
9,r_20_137_191,r_31_85_228,r_109_129_42,r_20_137_191,0.97,0,191,191,21
11,r_21_106_77,r_126_104_218,r_122_65_173,r_122_65_173,1.0,46,219,173,21
27,r_63_12_12,seq37,r_59_8_152,r_63_12_12,0.38,142,154,12,21
76,seq58,r_18_119_162,seq127,r_18_119_162,0.87,1,163,162,21
39,r_35_66_66,r_1_3_164,r_132_39_141,r_35_66_66,0.85,98,164,66,21
31,r_59_8_152,seq2,r_63_12_12,r_59_8_152,0.58,1,153,152,21
41,r_97_128_104,r_105_74_187,r_40_44_149,r_97_128_104,0.57,3,107,104,21
8,r_17_23_227,seq16,r_73_19_119,r_17_23_227,0.97,3,230,227,21
10,r_105_74_187,r_97_128_104,seq37,r_97_128_104,0.99,-13,91,104,21
26,r_0_9_235,seq96,r_20_137_191,r_20_137_191,0.62,45,236,191,21
18,r_144_79_22,r_34_69_248,r_86_118_165,r_144_79_22,1.0,2,24,22,21
29,r_107_136_28,r_75_111_231,seq55,r_107_136_28,1.0,0,28,28,21
4,r_32_135_118,seq29,seq142,r_32_135_118,1.0,0,118,118,21
0,r_113_114_94,r_61_83_168,r_15_95_240,r_113_114_94,1.0,-1,93,94,21
73,seq53,r_17_23_227,seq16,r_17_23_227,0.62,-7,220,227,21
11,r_21_106_77,seq140,r_126_104_218,r_21_106_77,0.99,2,79,77,21
48,r_52_148_26,r_105_74_187,seq120,r_52_148_26,1.0,0,26,26,21
13,r_89_92_79,r_21_106_77,r_52_148_26,r_89_92_79,1.0,-1,78,79,21
6,r_73_19_119,r_77_4_140,seq28,r_73_19_119,0.79,-1,118,119,21
46,r_45_50_51,r_32_135_118,seq115,r_45_50_51,0.96,-3,48,51,21
5,r_67_130_71,r_87_99_225,seq94,r_67_130_71,0.54,61,132,71,21
0,r_113_114_94,r_15_95_240,r_1_3_164,r_1_3_164,1.0,76,240,164,21
10,r_105_74_187,seq37,r_67_130_71,r_105_74_187,0.99,0,187,187,21
87,seq96,r_0_9_235,r_43_30_185,r_43_30_185,0.87,52,237,185,21
2,r_1_3_164,r_145_42_109,r_113_114_94,r_145_42_109,0.93,55,164,109,21
47,r_77_4_140,seq120,r_26_36_46,r_77_4_140,0.99,1,141,140,21
24,r_47_76_219,seq142,r_61_83_168,r_61_83_168,0.83,52,220,168,21
43,r_87_99_225,r_67_130_71,r_107_136_28,r_87_99_225,0.37,-41,184,225,21
52,seq5,r_51_62_192,r_145_42_109,r_51_62_192,0.33,21,213,192,21
34,r_126_104_218,seq146,r_21_106_77,r_21_106_77,1.0,4,81,77,21
9,r_20_137_191,r_93_25_163,r_31_85_228,r_93_25_163,0.81,0,163,163,21
22,r_61_83_168,seq110,r_97_128_104,r_61_83_168,0.9,1,169,168,21
28,r_84_46_175,seq13,r_109_129_42,r_109_129_42,0.99,131,173,42,21
91,seq103,r_15_95_240,r_1_3_164,r_1_3_164,1.0,43,207,164,21
49,r_75_111_231,seq33,r_21_106_77,r_75_111_231,0.31,1,232,231,21
7,r_43_30_185,r_123_112_105,seq72,r_123_112_105,0.88,-1,104,105,21
18,r_144_79_22,r_86_118_165,seq38,r_86_118_165,0.88,0,165,165,21
44,r_123_112_105,r_43_30_185,r_22_70_10,r_123_112_105,0.99,-1,104,105,21
20,r_91_124_29,r_143_116_217,seq117,r_91_124_29,1.0,0,29,29,21
94,seq115,seq37,r_45_50_51,r_45_50_51,0.96,7,58,51,21
23,r_54_78_201,r_17_23_227,r_145_42_109,r_54_78_201,0.61,-1,200,201,21
17,r_86_118_165,r_144_79_22,seq29,r_86_118_165,0.82,0,165,165,21
35,r_40_44_149,seq27,r_93_25_163,r_93_25_163,1.0,-1,162,163,21
12,r_64_24_183,r_40_44_149,r_10_14_61,r_10_14_61,0.69,122,183,61,21
21,r_109_129_42,r_10_14_61,r_52_148_26,r_109_129_42,1.0,2,44,42,21
4,r_67_121_22,seq27,r_104_52_132,r_67_121_22,0.94,0,22,22,22
93,seq117,r_87_31_194,r_6_123_151,r_6_123_151,1.0,48,199,151,22
40,r_78_66_21,r_6_123_151,r_135_56_200,r_6_123_151,1.0,1,152,151,22
30,r_147_14_185,r_104_52_132,r_101_3_89,r_104_52_132,1.0,4,136,132,22
44,r_81_84_184,r_120_53_17,seq25,r_81_84_184,0.99,0,184,184,22
12,r_26_58_44,r_103_91_175,seq116,r_26_58_44,1.0,2,46,44,22
40,r_78_66_21,r_135_56_200,r_41_57_110,r_135_56_200,0.99,0,200,200,22
6,r_69_133_52,r_87_31_194,seq42,r_69_133_52,1.0,0,52,52,22
8,r_144_95_203,r_137_55_58,seq27,r_137_55_58,0.95,4,62,58,22
43,r_8_29_178,seq20,r_78_66_21,r_8_29_178,0.87,0,178,178,22
83,seq86,r_97_112_108,seq48,r_97_112_108,0.94,2,110,108,22
37,r_36_142_83,seq70,seq93,r_36_142_83,1.0,0,83,83,22
19,r_98_4_94,r_49_21_198,seq35,r_49_21_198,1.0,0,198,198,22
86,seq94,r_101_3_89,r_26_58_44,r_26_58_44,1.0,55,99,44,22
16,r_103_91_175,r_87_31_194,r_104_52_132,r_103_91_175,0.9,0,175,175,22
39,r_89_9_234,seq127,r_143_19_43,r_143_19_43,0.86,192,235,43,22
1,r_7_88_167,seq16,r_129_30_7,r_7_88_167,0.97,0,167,167,22
5,r_87_31_194,seq117,seq111,r_87_31_194,0.55,5,199,194,22
46,r_49_21_198,r_145_100_127,r_98_4_94,r_49_21_198,0.92,-100,98,198,22
42,r_28_139_67,r_144_95_203,seq40,r_28_139_67,1.0,1,68,67,22
80,seq75,seq148,r_76_149_45,r_76_149_45,1.0,39,84,45,22
45,r_140_72_137,seq70,seq134,r_140_72_137,0.97,0,137,137,22
2,r_71_47_35,seq90,seq125,r_71_47_35,1.0,0,35,35,22
19,r_98_4_94,r_87_31_194,r_49_21_198,r_98_4_94,1.0,0,94,94,22
11,r_6_123_151,r_78_66_21,seq117,r_6_123_151,0.98,1,152,151,22
95,seq148,seq75,r_59_15_72,r_59_15_72,1.0,12,84,72,22
31,r_46_45_62,r_12_61_77,seq35,r_46_45_62,1.0,0,62,62,22
17,r_51_105_171,r_8_29_178,seq39,r_51_105_171,0.67,0,171,171,22
41,r_54_113_235,r_41_57_110,r_104_52_132,r_104_52_132,0.94,3,135,132,22
10,r_107_24_115,seq136,r_137_55_58,r_107_24_115,1.0,1,116,115,22
24,r_59_15_72,r_60_0_152,seq111,r_59_15_72,0.55,-51,21,72,22
26,r_104_52_132,r_147_14_185,r_54_113_235,r_104_52_132,0.99,1,133,132,22
8,r_144_95_203,seq27,seq70,r_144_95_203,0.83,-2,201,203,22
14,r_129_30_7,seq27,r_7_88_167,r_7_88_167,0.98,26,193,167,22
20,r_92_62_99,r_107_24_115,r_147_14_185,r_147_14_185,0.72,-84,101,185,22
13,r_85_34_201,seq25,r_7_88_167,r_7_88_167,1.0,38,205,167,22
46,r_49_21_198,r_98_4_94,seq2,r_49_21_198,0.99,0,198,198,22
15,r_5_118_210,r_81_84_184,r_126_1_148,r_126_1_148,0.59,32,180,148,22
48,r_41_57_110,seq119,seq96,r_41_57_110,0.92,0,110,110,22
21,r_102_38_5,r_80_115_160,r_132_17_240,r_80_115_160,0.96,-39,121,160,22
99,seq127,r_89_9_234,r_69_133_52,r_69_133_52,1.0,183,235,52,22
4,r_67_121_22,r_104_52_132,r_26_58_44,r_67_121_22,0.44,57,79,22,22
15,r_5_118_210,r_126_1_148,r_46_45_62,r_5_118_210,0.95,0,210,210,22
27,r_101_3_89,seq94,seq16,r_101_3_89,0.71,10,99,89,22
91,seq111,r_60_0_152,seq2,r_60_0_152,0.96,-2,150,152,22
41,r_54_113_235,r_104_52_132,r_7_88_167,r_54_113_235,0.64,0,235,235,22
47,r_83_110_187,seq35,seq10,r_83_110_187,0.75,0,187,187,22
18,r_97_112_108,seq86,r_69_133_52,r_69_133_52,1.0,58,110,52,22
29,r_80_115_160,seq2,seq18,r_80_115_160,0.97,0,160,160,22
20,r_92_62_99,r_147_14_185,seq18,r_92_62_99,0.56,60,159,99,22
44,r_81_84_184,seq90,r_120_53_17,r_120_53_17,1.0,23,40,17,22
35,r_60_0_152,seq111,seq20,r_60_0_152,0.96,0,152,152,22
33,r_126_1_148,seq131,seq134,r_126_1_148,0.99,0,148,148,22
70,seq42,r_89_9_234,r_69_133_52,r_69_133_52,1.0,9,61,52,22
92,seq116,seq18,r_26_58_44,r_26_58_44,1.0,11,55,44,22
42,r_28_139_67,seq40,r_5_118_210,r_5_118_210,0.99,2,212,210,22
7,r_135_56_200,r_78_66_21,seq25,r_135_56_200,1.0,0,200,200,22
38,r_12_61_77,r_36_142_83,seq136,r_12_61_77,1.0,0,77,77,22
68,seq39,r_87_31_194,r_51_105_171,r_51_105_171,0.92,0,171,171,22
34,r_137_55_58,r_144_95_203,seq131,r_137_55_58,0.95,4,62,58,22
23,r_143_19_43,seq70,seq40,r_143_19_43,1.0,0,43,43,22
17,r_51_105_171,r_147_14_185,r_8_29_178,r_8_29_178,0.45,-18,160,178,22
9,r_23_82_133,seq40,seq117,r_23_82_133,1.0,0,133,133,22
3,r_76_149_45,r_104_52_132,seq75,r_76_149_45,1.0,1,46,45,22
26,r_104_52_132,r_54_113_235,r_103_91_175,r_103_91_175,0.63,60,235,175,22
24,r_59_15_72,seq111,seq148,r_59_15_72,1.0,1,73,72,22
28,r_13_99_114,seq20,seq40,r_13_99_114,1.0,0,114,114,22
91,seq111,r_59_15_72,r_60_0_152,r_59_15_72,0.56,1,73,72,22
40,r_78_66_21,r_87_31_194,r_6_123_151,r_78_66_21,0.98,0,21,21,22
49,r_145_100_127,seq35,seq65,r_145_100_127,1.0,0,127,127,22
7,r_135_56_200,r_6_123_151,r_78_66_21,r_135_56_200,0.9,-48,152,200,22
11,r_6_123_151,r_135_56_200,r_78_66_21,r_78_66_21,0.98,11,32,21,22
60,seq20,r_92_62_99,r_60_0_152,r_60_0_152,1.0,33,185,152,22
35,r_60_0_152,r_59_15_72,seq111,r_59_15_72,0.63,1,73,72,22
22,r_64_114_47,seq70,seq2,r_64_114_47,1.0,0,47,47,22
36,r_63_109_12,seq106,seq117,r_63_109_12,0.97,1,13,12,22
16,r_35_21_15,r_70_45_186,r_24_18_139,r_35_21_15,0.99,0,15,15,23
51,seq3,seq143,r_8_2_100,r_8_2_100,1.0,23,123,100,23
13,r_70_45_186,r_10_66_188,r_31_88_203,r_31_88_203,0.68,-148,55,203,23
92,seq103,r_40_107_91,seq15,r_40_107_91,1.0,0,91,91,23
8,r_140_130_219,r_51_30_242,r_135_67_210,r_140_130_219,0.72,0,219,219,23
53,seq5,r_53_111_206,r_104_119_134,r_104_119_134,1.0,72,206,134,23
43,r_26_90_142,r_46_87_161,seq137,r_46_87_161,0.67,-19,142,161,23
4,r_104_119_134,seq43,r_71_93_40,r_71_93_40,1.0,13,53,40,23
3,r_36_116_6,seq25,r_32_13_55,r_32_13_55,1.0,16,71,55,23
21,r_117_98_88,r_20_74_195,seq55,r_117_98_88,0.62,5,93,88,23
39,r_85_42_137,r_57_7_225,r_36_116_6,r_36_116_6,0.62,132,138,6,23
1,r_100_73_220,seq19,r_41_121_179,r_41_121_179,0.75,42,221,179,23
13,r_70_45_186,r_35_21_15,r_10_66_188,r_35_21_15,0.81,0,15,15,23
5,r_101_54_84,r_138_29_98,seq34,r_138_29_98,0.9,-12,86,98,23
46,r_53_111_206,seq5,r_8_2_100,r_8_2_100,0.9,106,206,100,23
42,r_40_107_91,seq103,seq115,r_40_107_91,1.0,0,91,91,23
45,r_122_61_147,seq91,seq27,r_122_61_147,0.98,0,147,147,23
19,r_20_74_195,seq114,r_113_83_102,r_113_83_102,0.76,93,195,102,23
38,r_64_72_213,seq11,r_65_16_157,r_64_72_213,0.5,3,216,213,23
17,r_63_105_27,seq22,r_58_133_235,r_63_105_27,0.97,-7,20,27,23
67,seq27,seq148,r_122_61_147,r_122_61_147,1.0,1,148,147,23
90,seq94,r_46_87_161,r_65_16_157,r_46_87_161,0.9,-1,160,161,23
26,r_47_17_101,r_131_147_243,seq33,r_47_17_101,0.94,0,101,101,23
16,r_35_21_15,r_24_18_139,seq94,r_24_18_139,0.99,0,139,139,23
47,r_24_18_139,r_23_134_22,r_35_21_15,r_35_21_15,0.57,0,15,15,23
20,r_79_59_171,seq5,seq125,r_79_59_171,0.99,0,171,171,23
15,r_51_30_242,r_140_130_219,seq9,r_140_130_219,1.0,0,219,219,23
99,seq125,r_113_83_102,r_79_59_171,r_79_59_171,1.0,0,171,171,23
48,r_128_44_240,r_65_16_157,r_24_18_139,r_65_16_157,0.52,0,157,157,23
4,r_104_119_134,r_71_93_40,seq5,r_104_119_134,1.0,1,135,134,23
39,r_85_42_137,r_36_116_6,r_46_87_161,r_85_42_137,0.5,16,153,137,23
6,r_146_92_132,seq125,seq9,r_146_92_132,0.46,0,132,132,23
24,r_99_112_34,seq141,seq84,r_99_112_34,0.79,1,35,34,23
37,r_71_93_40,seq33,seq148,r_71_93_40,1.0,0,40,40,23
99,seq125,r_146_92_132,r_113_83_102,r_113_83_102,0.53,30,132,102,23
2,r_23_134_22,r_135_67_210,seq4,r_23_134_22,0.79,-5,17,22,23
13,r_70_45_186,r_31_88_203,seq142,r_31_88_203,0.73,-8,195,203,23
79,seq68,r_32_13_55,r_146_92_132,r_32_13_55,1.0,-7,48,55,23
40,r_124_132_154,seq86,r_63_105_27,r_124_132_154,0.63,0,154,154,23
18,r_10_66_188,r_51_30_242,r_117_98_88,r_10_66_188,0.91,0,188,188,23
29,r_65_16_157,r_128_44_240,seq94,r_128_44_240,0.91,-83,157,240,23
27,r_102_49_51,seq148,seq9,r_102_49_51,1.0,-1,50,51,23
25,r_8_2_100,r_146_92_132,seq3,r_8_2_100,1.0,-1,99,100,23
33,r_89_106_86,seq37,seq14,r_89_106_86,0.97,0,86,86,23
48,r_128_44_240,r_24_18_139,r_100_73_220,r_128_44_240,0.69,0,240,240,23
47,r_24_18_139,r_35_21_15,r_47_17_101,r_24_18_139,0.67,0,139,139,23
32,r_60_149_174,seq15,r_79_59_171,r_60_149_174,0.66,0,174,174,23
38,r_64_72_213,r_47_17_101,seq11,r_47_17_101,0.94,7,108,101,23
34,r_12_127_87,r_131_147_243,seq97,r_12_127_87,0.74,0,87,87,23
9,r_95_28_68,seq84,seq1,r_95_28_68,1.0,0,68,68,23
86,seq84,seq15,r_99_112_34,r_99_112_34,0.78,2,36,34,23
96,seq115,r_135_67_210,seq129,r_135_67_210,0.73,-15,195,210,23
37,r_71_93_40,seq148,r_110_123_175,r_110_123_175,1.0,1,176,175,23
22,r_31_88_203,seq38,r_75_96_151,r_31_88_203,0.68,0,203,203,23
10,r_32_13_55,seq68,r_36_116_6,r_32_13_55,1.0,0,55,55,23
49,r_139_0_36,seq5,seq114,r_139_0_36,1.0,0,36,36,23
23,r_41_121_179,seq9,seq144,r_41_121_179,0.49,0,179,179,23
12,r_113_83_102,r_124_132_154,seq68,r_113_83_102,1.0,0,102,102,23
0,r_138_29_98,seq22,seq103,r_138_29_98,0.92,0,98,98,23
93,seq106,r_13_66_46,r_11_96_193,r_11_96_193,0.75,5,198,193,24
92,seq105,r_9_53_211,seq125,r_9_53_211,0.8,1,212,211,24
14,r_46_112_72,seq61,seq110,r_46_112_72,1.0,0,72,72,24
8,r_144_119_114,seq51,r_25_28_5,r_144_119_114,1.0,0,114,114,24
43,r_85_50_195,r_2_132_169,seq7,r_2_132_169,0.89,0,169,169,24
37,r_36_10_141,seq75,r_113_131_95,r_36_10_141,1.0,1,142,141,24
10,r_94_149_29,r_147_15_246,seq148,r_94_149_29,0.71,2,31,29,24
55,seq7,r_2_132_169,r_91_137_155,r_2_132_169,0.6,-11,158,169,24
71,seq48,r_118_129_163,r_71_24_85,r_118_129_163,0.56,-2,161,163,24
16,r_19_99_75,seq126,seq88,r_19_99_75,1.0,0,75,75,24
39,r_55_26_204,r_16_29_164,r_54_5_139,r_55_26_204,0.86,-39,165,204,24
80,seq70,r_108_123_183,r_43_73_64,r_43_73_64,0.9,3,67,64,24
69,seq39,r_98_104_216,r_80_41_41,r_80_41_41,0.98,175,216,41,24
45,r_16_29_164,r_55_26_204,r_91_137_155,r_16_29_164,0.95,1,165,164,24
19,r_91_137_155,seq87,r_16_29_164,r_16_29_164,0.59,5,169,164,24
5,r_116_57_52,r_19_99_75,seq97,r_116_57_52,1.0,0,52,52,24
31,r_6_135_129,r_108_123_183,seq67,r_6_135_129,1.0,2,131,129,24
30,r_71_24_85,r_92_59_78,seq75,r_71_24_85,0.68,-65,20,85,24
25,r_23_109_207,r_113_131_95,r_18_12_18,r_23_109_207,0.88,-162,45,207,24
26,r_108_123_183,seq38,seq51,r_108_123_183,0.92,0,183,183,24
33,r_65_102_118,r_55_26_204,r_54_5_139,r_65_102_118,0.93,30,148,118,24
4,r_54_5_139,seq79,r_65_102_118,r_54_5_139,0.98,0,139,139,24
0,r_95_77_170,seq52,seq38,r_95_77_170,0.96,1,171,170,24
11,r_27_143_60,seq4,seq128,r_27_143_60,1.0,0,60,60,24
20,r_118_129_163,seq48,r_46_112_72,r_118_129_163,0.55,0,163,163,24
13,r_1_45_182,seq115,r_35_68_100,r_1_45_182,0.98,0,182,182,24
98,seq126,seq39,r_113_131_95,r_113_131_95,1.0,35,130,95,24
15,r_25_28_5,r_91_137_155,r_144_119_114,r_144_119_114,1.0,0,114,114,24
48,r_134_82_71,seq127,seq61,r_134_82_71,1.0,1,72,71,24
6,r_122_100_197,seq51,seq79,r_122_100_197,0.77,0,197,197,24
71,seq48,r_71_24_85,r_98_104_216,r_98_104_216,0.98,2,218,216,24
30,r_71_24_85,seq75,r_0_49_106,r_0_49_106,1.0,13,119,106,24
29,r_18_12_18,r_1_45_182,r_23_109_207,r_18_12_18,1.0,0,18,18,24
47,r_2_132_169,r_85_50_195,seq138,r_2_132_169,0.97,0,169,169,24
40,r_103_117_149,r_16_29_164,r_62_93_9,r_103_117_149,0.9,0,149,149,24
18,r_40_47_148,seq127,r_144_119_114,r_40_47_148,0.97,0,148,148,24
24,r_11_96_193,seq42,seq106,r_11_96_193,0.88,0,193,193,24
33,r_65_102_118,seq64,r_55_26_204,r_65_102_118,0.87,0,118,118,24
39,r_55_26_204,r_54_5_139,r_80_41_41,r_55_26_204,1.0,0,204,204,24
88,seq88,r_142_76_176,r_19_99_75,r_19_99_75,0.98,101,176,75,24
70,seq42,r_11_96_193,seq56,r_11_96_193,0.96,0,193,193,24
32,r_113_131_95,r_91_137_155,seq126,r_113_131_95,1.0,0,95,95,24
38,r_63_17_144,seq110,r_6_135_129,r_63_17_144,0.8,3,147,144,24
52,seq3,r_21_34_84,seq107,r_21_34_84,1.0,0,84,84,24
34,r_146_8_162,seq31,r_71_24_85,r_146_8_162,0.96,0,162,162,24
3,r_80_41_41,r_142_76_176,seq39,r_80_41_41,1.0,0,41,41,24
17,r_120_20_185,seq75,r_2_132_169,r_120_20_185,0.96,0,185,185,24
25,r_23_109_207,r_18_12_18,r_83_86_119,r_23_109_207,0.98,0,207,207,24
43,r_85_50_195,seq7,r_118_129_163,r_85_50_195,0.97,0,195,195,24
9,r_35_68_100,r_55_26_204,seq84,r_35_68_100,0.77,4,104,100,24
27,r_30_124_22,r_13_66_46,seq79,r_30_124_22,1.0,0,22,22,24
96,seq115,r_1_45_182,seq133,r_1_45_182,1.0,0,182,182,24
29,r_18_12_18,r_23_109_207,r_94_149_29,r_23_109_207,0.85,0,207,207,24
28,r_43_73_64,r_147_15_246,seq70,r_43_73_64,1.0,0,64,64,24
49,r_83_86_119,seq64,seq37,r_83_86_119,0.62,1,120,119,24
7,r_111_121_239,seq97,r_95_77_170,r_95_77_170,0.84,69,239,170,24
44,r_114_90_236,seq139,r_54_5_139,r_54_5_139,1.0,100,239,139,24
23,r_92_59_78,seq14,seq130,r_92_59_78,1.0,0,78,78,24
35,r_0_49_106,seq31,r_71_24_85,r_0_49_106,1.0,0,106,106,24
12,r_140_69_201,seq84,seq107,r_140_69_201,0.86,0,201,201,24
40,r_3_90_162,r_28_104_28,seq139,r_3_90_162,0.6,7,169,162,25
30,r_147_31_215,r_23_17_208,r_16_94_5,r_147_31_215,0.53,-5,210,215,25
36,r_121_93_84,seq71,r_143_36_9,r_121_93_84,1.0,2,86,84,25
14,r_124_148_206,r_78_59_238,r_122_30_211,r_124_148_206,0.52,5,211,206,25
8,r_130_15_229,seq33,r_28_104_28,r_28_104_28,0.64,203,231,28,25
43,r_85_81_239,r_122_30_211,r_61_105_248,r_85_81_239,0.28,-7,232,239,25
13,r_21_20_221,r_3_90_162,seq108,r_21_20_221,0.92,3,224,221,25
71,seq60,r_78_59_238,r_97_1_100,r_97_1_100,1.0,138,238,100,25
21,r_135_22_111,seq37,r_61_105_248,r_135_22_111,0.92,0,111,111,25
5,r_123_45_59,r_147_31_215,seq82,r_123_45_59,0.84,1,60,59,25
46,r_144_80_86,seq128,seq109,r_144_80_86,1.0,0,86,86,25
42,r_145_40_150,r_3_90_162,r_64_137_60,r_145_40_150,0.51,9,159,150,25
80,seq75,seq32,r_64_137_60,r_64_137_60,1.0,71,131,60,25
24,r_2_63_164,r_24_50_218,seq132,r_2_63_164,0.97,0,164,164,25
15,r_58_136_106,r_52_77_24,seq119,r_58_136_106,0.99,0,106,106,25
76,seq70,r_24_50_218,r_58_136_106,r_58_136_106,0.95,112,218,106,25
31,r_117_125_220,seq32,r_64_137_60,r_64_137_60,1.0,45,105,60,25
67,seq46,r_141_56_203,r_51_8_107,r_51_8_107,0.96,96,203,107,25
3,r_51_8_107,seq99,seq46,r_51_8_107,0.98,1,108,107,25
10,r_0_83_151,seq14,r_51_8_107,r_0_83_151,0.87,0,151,151,25
40,r_3_90_162,r_66_57_42,r_28_104_28,r_3_90_162,1.0,-134,28,162,25
72,seq138,seq128,r_66_57_42,r_66_57_42,1.0,-2,40,42,25
26,r_67_27_153,r_23_17_208,r_146_19_155,r_67_27_153,0.91,5,158,153,25
4,r_122_30_211,r_85_81_239,seq42,r_85_81_239,0.32,-27,212,239,25
0,r_25_79_127,seq88,seq99,r_25_79_127,0.95,19,146,127,25
11,r_97_1_100,r_44_73_181,seq128,r_97_1_100,0.99,0,100,100,25
13,r_21_20_221,r_47_106_171,r_3_90_162,r_21_20_221,0.8,-49,172,221,25
48,r_23_17_208,r_147_31_215,seq68,r_147_31_215,0.46,-5,210,215,25
15,r_58_136_106,r_0_83_151,r_52_77_24,r_52_77_24,1.0,0,24,24,25
6,r_133_29_156,seq100,seq110,r_133_29_156,0.69,0,156,156,25
99,seq127,r_115_18_237,r_64_137_60,r_64_137_60,1.0,177,237,60,25
27,r_115_18_237,seq127,seq53,r_115_18_237,0.42,0,237,237,25
2,r_64_137_60,r_54_89_205,r_76_11_46,r_54_89_205,0.71,-144,61,205,25
41,r_52_77_24,r_58_136_106,seq14,r_58_136_106,1.0,0,106,106,25
47,r_39_43_74,r_141_56_203,r_143_36_9,r_39_43_74,1.0,0,74,74,25
24,r_2_63_164,r_92_48_96,r_24_50_218,r_92_48_96,0.78,1,97,96,25
45,r_76_11_46,seq49,r_117_125_220,r_76_11_46,1.0,0,46,46,25
70,seq55,seq132,r_146_19_155,r_146_19_155,0.93,-1,154,155,25
16,r_112_131_23,r_51_8_107,seq128,r_112_131_23,0.93,0,23,23,25
32,r_146_19_155,seq116,seq55,r_146_19_155,0.68,1,156,155,25
38,r_134_91_78,r_35_129_202,seq100,r_134_91_78,0.99,0,78,78,25
45,r_76_11_46,r_117_125_220,r_145_40_150,r_145_40_150,1.0,68,218,150,25
17,r_47_106_171,r_21_20_221,r_146_19_155,r_47_106_171,0.5,1,172,171,25
28,r_28_104_28,seq12,r_130_15_229,r_28_104_28,0.6,200,228,28,25
41,r_52_77_24,r_2_63_164,r_58_136_106,r_52_77_24,0.96,0,24,24,25
9,r_44_73_181,seq6,seq70,r_44_73_181,0.43,0,181,181,25
28,r_28_104_28,r_3_90_162,seq12,r_3_90_162,0.82,1,163,162,25
22,r_35_129_202,seq127,r_84_95_196,r_35_129_202,0.43,1,203,202,25
91,seq109,r_54_89_205,r_144_80_86,r_144_80_86,1.0,120,206,86,25
28,r_28_104_28,seq49,r_3_90_162,r_28_104_28,0.96,0,28,28,25
56,seq139,r_21_20_221,r_3_90_162,r_3_90_162,0.69,29,191,162,25
44,r_84_95_196,seq55,r_61_105_248,r_61_105_248,0.62,-49,199,248,25
23,r_107_113_194,r_61_105_248,r_101_38_17,r_107_113_194,0.69,-4,190,194,25
19,r_66_57_42,r_3_90_162,seq138,r_66_57_42,1.0,-2,40,42,25
35,r_92_48_96,r_2_63_164,seq132,r_92_48_96,0.6,1,97,96,25
12,r_61_105_248,r_107_113_194,r_135_22_111,r_135_22_111,0.54,1,112,111,25
40,r_1_94_78,r_18_40_206,seq133,r_18_40_206,1.0,1,207,206,26
51,seq132,r_108_83_21,r_125_97_180,r_108_83_21,0.45,47,68,21,26
36,r_11_147_211,r_135_81_130,r_131_100_25,r_11_147_211,0.75,-187,24,211,26
16,r_120_86_62,r_148_118_190,r_12_87_168,r_120_86_62,1.0,0,62,62,26
1,r_136_145_162,seq112,seq21,r_136_145_162,0.99,0,162,162,26
5,r_119_46_104,seq140,seq34,r_119_46_104,1.0,0,104,104,26
42,r_65_115_5,r_44_15_198,r_113_60_26,r_113_60_26,0.92,172,198,26,26
39,r_117_30_24,seq121,seq95,r_117_30_24,0.93,0,24,24,26
19,r_36_29_67,seq71,r_6_129_37,r_36_29_67,1.0,1,68,67,26
29,r_88_90_30,r_10_5_167,seq140,r_88_90_30,1.0,0,30,30,26
32,r_22_49_47,r_136_145_162,seq20,r_22_49_47,1.0,0,47,47,26
95,seq109,r_63_51_185,r_76_64_73,r_76_64_73,1.0,0,73,73,26
45,r_72_110_13,r_146_45_54,seq68,r_72_110_13,0.66,0,13,13,26
14,r_6_129_37,seq33,seq27,r_6_129_37,1.0,0,37,37,26
31,r_10_5_167,seq133,r_128_105_44,r_128_105_44,0.5,123,167,44,26
17,r_131_100_25,r_76_64_73,r_11_147_211,r_76_64_73,1.0,-18,55,73,26
41,r_70_126_203,r_78_52_117,r_84_107_82,r_84_107_82,0.95,1,83,82,26
10,r_76_64_73,seq102,seq109,r_76_64_73,1.0,0,73,73,26
26,r_0_55_175,seq26,seq54,r_0_55_175,0.96,1,176,175,26
16,r_120_86_62,r_12_87_168,r_103_82_157,r_103_82_157,0.53,12,169,157,26
4,r_108_83_21,r_99_62_216,r_67_79_56,r_108_83_21,0.51,52,73,21,26
0,r_125_97_180,seq132,r_124_75_74,r_125_97_180,0.98,0,180,180,26
11,r_48_41_202,seq25,r_135_81_130,r_48_41_202,0.74,1,203,202,26
20,r_114_85_166,r_37_122_173,seq21,r_114_85_166,1.0,0,166,166,26
13,r_18_40_206,seq47,r_1_94_78,r_1_94_78,1.0,8,86,78,26
6,r_113_60_26,r_66_116_243,r_65_115_5,r_113_60_26,0.98,0,26,26,26
17,r_131_100_25,r_11_147_211,seq102,r_11_147_211,0.56,8,219,211,26
15,r_93_7_237,seq23,r_12_87_168,r_12_87_168,0.73,69,237,168,26
49,r_124_75_74,seq102,r_125_97_180,r_125_97_180,1.0,5,185,180,26
57,seq13,seq68,r_22_49_47,r_22_49_47,0.99,116,163,47,26
13,r_18_40_206,r_1_94_78,r_119_46_104,r_18_40_206,0.73,1,207,206,26
30,r_128_105_44,seq27,seq23,r_128_105_44,1.0,-4,40,44,26
27,r_31_106_137,seq111,seq23,r_31_106_137,1.0,0,137,137,26
73,seq47,r_10_5_167,r_143_92_45,r_143_92_45,0.99,0,45,45,26
51,seq132,r_125_97_180,r_108_83_21,r_125_97_180,1.0,0,180,180,26
50,seq3,r_2_138_70,r_130_91_126,r_130_91_126,0.91,11,137,126,26
41,r_70_126_203,r_84_107_82,r_9_137_98,r_84_107_82,0.53,123,205,82,26
47,r_32_101_85,r_103_82_157,r_36_29_67,r_32_101_85,0.97,0,85,85,26
40,r_1_94_78,seq21,r_18_40_206,r_1_94_78,1.0,-1,77,78,26
18,r_2_138_70,r_44_15_198,seq3,r_2_138_70,0.92,0,70,70,26
24,r_78_52_117,r_70_126_203,seq34,r_78_52_117,0.86,2,119,117,26
34,r_12_87_168,r_120_86_62,r_36_29_67,r_12_87_168,0.92,0,168,168,26
25,r_130_91_126,r_18_40_206,seq3,r_130_91_126,0.68,5,131,126,26
33,r_38_39_164,seq35,seq33,r_38_39_164,1.0,0,164,164,26
22,r_135_81_130,r_37_122_173,r_50_19_124,r_37_122_173,1.0,0,173,173,26
64,seq25,r_123_24_93,seq73,r_123_24_93,1.0,1,94,93,26
50,seq3,seq68,r_2_138_70,r_2_138_70,1.0,8,78,70,26
14,r_6_129_37,seq27,r_36_29_67,r_36_29_67,1.0,29,96,67,26
70,seq35,r_149_58_199,seq21,r_149_58_199,1.0,-70,129,199,26
68,seq33,seq68,r_38_39_164,r_38_39_164,1.0,8,172,164,26
38,r_44_15_198,r_65_115_5,r_119_46_104,r_119_46_104,0.99,100,204,104,26
12,r_84_107_82,r_143_92_45,r_12_87_168,r_143_92_45,0.99,-1,44,45,26
34,r_12_87_168,r_84_107_82,r_120_86_62,r_12_87_168,0.98,-99,69,168,26
80,seq68,seq43,r_72_110_13,r_72_110_13,1.0,15,28,13,26
79,seq61,r_124_75_74,r_146_45_54,r_146_45_54,1.0,-1,53,54,26
9,r_63_51_185,seq17,seq47,r_63_51_185,0.9,2,187,185,26
96,seq111,r_148_118_190,r_0_55_175,r_0_55_175,0.96,16,191,175,26
7,r_146_45_54,r_1_94_78,seq61,r_146_45_54,0.84,-1,53,54,26
28,r_123_24_93,seq25,r_113_60_26,r_123_24_93,0.7,1,94,93,26
49,r_124_75_74,seq61,seq102,r_124_75_74,0.75,-2,72,74,26
12,r_84_107_82,r_12_87_168,seq8,r_84_107_82,0.98,0,82,82,26
23,r_50_19_124,seq80,seq95,r_50_19_124,1.0,0,124,124,26
17,r_131_100_25,r_88_90_30,r_76_64_73,r_131_100_25,0.98,0,25,25,26
46,r_67_79_56,r_66_116_243,r_108_83_21,r_67_79_56,0.51,0,56,56,26
22,r_135_81_130,r_50_19_124,r_48_41_202,r_48_41_202,0.96,13,215,202,26
35,r_103_82_157,seq34,r_120_86_62,r_103_82_157,0.99,0,157,157,26
30,r_142_56_179,seq18,r_41_32_118,r_41_32_118,0.62,64,182,118,27
36,r_119_64_160,r_142_56_179,seq25,r_119_64_160,0.76,0,160,160,27
14,r_135_14_163,r_55_104_223,seq75,r_135_14_163,0.83,1,164,163,27
53,seq131,r_124_136_137,r_19_65_1,r_124_136_137,1.0,1,138,137,27
43,r_122_113_174,seq60,r_80_127_123,r_122_113_174,0.91,0,174,174,27
37,r_6_11_178,r_47_4_191,seq128,r_6_11_178,0.94,0,178,178,27
10,r_143_26_23,seq101,r_77_106_135,r_143_26_23,0.7,3,26,23,27
23,r_62_5_29,r_108_61_58,seq34,r_62_5_29,0.9,3,32,29,27
16,r_70_92_173,seq59,seq76,r_70_92_173,0.59,0,173,173,27
21,r_120_137_239,seq25,r_3_84_235,r_3_84_235,0.83,4,239,235,27
39,r_40_140_189,seq58,r_135_14_163,r_40_140_189,1.0,-1,188,189,27
1,r_3_84_235,r_144_22_159,seq0,r_144_22_159,1.0,-38,121,159,27
97,seq114,r_94_121_187,r_10_73_154,r_10_73_154,0.75,35,189,154,27
5,r_123_42_249,r_47_4_191,seq96,r_123_42_249,0.45,-56,193,249,27
33,r_17_31_246,r_141_53_59,r_72_24_168,r_141_53_59,0.99,0,59,59,27
69,seq34,seq76,r_62_5_29,r_62_5_29,0.97,141,170,29,27
45,r_144_22_159,r_36_109_247,seq30,r_144_22_159,0.98,0,159,159,27
24,r_77_106_135,r_146_12_217,seq100,r_146_12_217,0.95,1,218,217,27
19,r_147_83_238,seq27,r_50_63_20,r_50_63_20,0.57,219,239,20,27
11,r_54_98_212,r_52_129_57,r_57_134_120,r_52_129_57,0.76,155,212,57,27
95,seq105,r_36_109_247,r_57_134_120,r_57_134_120,0.92,53,173,120,27
66,seq29,seq105,r_80_127_123,r_80_127_123,1.0,1,124,123,27
38,r_52_129_57,r_54_98_212,r_110_39_119,r_110_39_119,0.9,4,123,119,27
31,r_51_89_155,seq71,seq0,r_51_89_155,0.97,3,158,155,27
67,seq30,r_72_24_168,r_144_22_159,r_144_22_159,0.96,9,168,159,27
89,seq96,r_147_83_238,r_55_104_223,r_55_104_223,0.85,2,225,223,27
3,r_80_127_123,r_148_85_132,seq29,r_80_127_123,0.99,0,123,123,27
8,r_88_37_50,r_120_137_239,r_20_125_107,r_88_37_50,0.55,28,78,50,27
15,r_50_63_20,r_9_97_36,seq99,r_50_63_20,0.97,-1,19,20,27
4,r_69_38_65,seq101,seq139,r_69_38_65,0.99,1,66,65,27
9,r_57_134_120,seq105,r_126_35_130,r_126_35_130,0.94,3,133,130,27
0,r_148_85_132,seq99,r_8_87_79,r_148_85_132,0.98,0,132,132,27
11,r_54_98_212,seq79,r_52_129_57,r_52_129_57,1.0,22,79,57,27
20,r_36_109_247,r_144_22_159,seq0,r_144_22_159,1.0,-38,121,159,27
13,r_72_24_168,seq30,seq66,r_72_24_168,0.47,0,168,168,27
8,r_88_37_50,r_82_21_53,r_120_137_239,r_82_21_53,0.98,-1,52,53,27
48,r_55_104_223,seq139,seq96,r_55_104_223,0.58,0,223,223,27
57,seq139,r_55_104_223,r_110_39_119,r_110_39_119,0.98,77,196,119,27
6,r_141_53_59,r_17_31_246,seq59,r_141_53_59,1.0,0,59,59,27
10,r_143_26_23,r_77_106_135,seq43,r_77_106_135,0.71,-39,96,135,27
87,seq91,r_117_23_209,r_107_90_2,r_117_23_209,0.74,0,209,209,27
12,r_82_21_53,r_88_37_50,r_8_87_79,r_82_21_53,1.0,3,56,53,27
2,r_95_138_232,seq78,r_135_14_163,r_135_14_163,0.77,69,232,163,27
47,r_146_12_217,r_116_68_230,seq74,r_116_68_230,0.41,-12,218,230,27
40,r_117_23_209,seq91,seq27,r_117_23_209,0.71,0,209,209,27
18,r_110_39_119,seq93,r_52_129_57,r_110_39_119,1.0,0,119,119,27
25,r_133_112_186,seq100,r_57_134_120,r_133_112_186,0.85,0,186,186,27
64,seq27,r_147_83_238,r_117_23_209,r_117_23_209,0.84,30,239,209,27
88,seq93,r_110_39_119,r_72_24_168,r_110_39_119,0.85,-4,115,119,27
22,r_47_4_191,r_123_42_249,r_62_5_29,r_123_42_249,0.63,-58,191,249,27
68,seq33,seq76,r_62_5_29,r_62_5_29,0.99,141,170,29,27
32,r_8_87_79,seq132,seq67,r_8_87_79,0.55,23,102,79,27
34,r_116_68_230,r_146_12_217,r_77_106_135,r_77_106_135,0.81,83,218,135,27
75,seq59,r_70_92_173,r_141_53_59,r_141_53_59,1.0,54,113,59,27
94,seq103,r_19_65_1,r_45_49_112,r_45_49_112,1.0,5,117,112,27
34,r_116_68_230,r_77_106_135,r_80_127_123,r_116_68_230,0.88,0,230,230,27
22,r_47_4_191,r_6_11_178,r_123_42_249,r_47_4_191,0.55,-13,178,191,27
28,r_41_32_118,seq128,seq130,r_41_32_118,1.0,0,118,118,27
49,r_45_49_112,r_144_22_159,seq103,r_45_49_112,1.0,0,112,112,27
44,r_124_136_137,seq131,seq114,r_124_136_137,0.99,1,138,137,27
17,r_9_97_36,r_77_106_135,r_41_32_118,r_41_32_118,0.57,5,123,118,27
82,seq76,seq33,r_70_92_173,r_70_92_173,0.69,8,181,173,27
79,seq71,r_51_89_155,r_19_65_1,r_51_89_155,1.0,3,158,155,27
17,r_9_97_36,r_120_137_239,r_77_106_135,r_9_97_36,0.91,0,36,36,27
38,r_52_129_57,r_47_4_191,r_54_98_212,r_52_129_57,1.0,0,57,57,27
40,r_35_41_147,seq107,r_71_70_126,r_35_41_147,0.98,0,147,147,28
40,r_35_41_147,r_105_28_64,seq107,r_35_41_147,0.5,-89,58,147,28
36,r_106_53_142,r_21_26_205,seq6,r_106_53_142,0.98,0,142,142,28
92,seq111,r_57_101_30,r_90_120_168,r_90_120_168,0.57,-139,29,168,28
30,r_57_101_30,seq111,r_105_28_64,r_105_28_64,0.55,-29,35,64,28
8,r_146_136_11,seq63,seq83,r_146_136_11,0.97,0,11,11,28
43,r_47_124_99,seq145,seq94,r_47_124_99,1.0,0,99,99,28
83,seq81,seq14,r_17_129_198,r_17_129_198,0.82,1,199,198,28
37,r_96_89_164,seq61,r_15_135_21,r_96_89_164,0.99,0,164,164,28
3,r_15_135_21,seq144,r_90_120_168,r_15_135_21,0.34,110,131,21,28
16,r_21_26_205,seq94,r_90_120_168,r_21_26_205,0.68,0,205,205,28
39,r_100_110_122,r_127_80_165,r_90_120_168,r_90_120_168,0.83,-43,125,168,28
5,r_67_112_73,seq60,seq61,r_67_112_73,1.0,0,73,73,28
42,r_8_62_104,seq148,r_109_132_48,r_8_62_104,0.76,0,104,104,28
51,seq2,seq68,r_55_0_29,r_55_0_29,0.95,-7,22,29,28
80,seq68,seq14,r_47_124_99,r_47_124_99,1.0,91,190,99,28
3,r_15_135_21,r_90_120_168,r_96_89_164,r_96_89_164,0.6,5,169,164,28
19,r_10_40_220,r_95_16_224,r_55_0_29,r_95_16_224,0.62,-3,221,224,28
33,r_109_132_48,r_90_120_168,r_8_62_104,r_109_132_48,0.49,84,132,48,28
38,r_105_28_64,r_35_41_147,r_57_101_30,r_57_101_30,0.5,24,54,30,28
38,r_105_28_64,r_57_101_30,r_74_87_113,r_74_87_113,1.0,6,119,113,28
31,r_74_87_113,r_114_37_244,r_105_28_64,r_74_87_113,0.97,0,113,113,28
41,r_98_30_121,seq50,seq117,r_98_30_121,1.0,3,124,121,28
89,seq103,r_79_140_140,seq59,r_79_140_140,0.83,0,140,140,28
17,r_42_48_35,r_4_141_200,seq25,r_42_48_35,0.98,-3,32,35,28
84,seq83,seq3,r_146_136_11,r_146_136_11,1.0,1,12,11,28
72,seq50,seq123,r_137_7_183,r_137_7_183,0.99,9,192,183,28
1,r_114_37_244,r_74_87_113,r_143_34_41,r_114_37_244,1.0,-192,52,244,28
33,r_109_132_48,r_97_20_223,r_90_120_168,r_109_132_48,1.0,0,48,48,28
0,r_17_129_198,seq91,r_149_119_179,r_17_129_198,0.77,0,198,198,28
20,r_149_119_179,seq144,r_130_75_114,r_130_75_114,0.98,35,149,114,28
20,r_149_119_179,r_130_75_114,seq81,r_149_119_179,1.0,0,179,179,28
6,r_71_70_126,r_13_82_238,seq14,r_71_70_126,1.0,0,126,126,28
99,seq126,r_51_23_172,seq107,r_51_23_172,0.93,0,172,172,28
48,r_143_34_41,r_71_70_126,r_114_37_244,r_114_37_244,0.58,-207,37,244,28
27,r_69_43_91,seq22,seq104,r_69_43_91,1.0,2,93,91,28
49,r_55_0_29,r_27_9_129,seq2,r_55_0_29,1.0,-1,28,29,28
30,r_57_101_30,r_105_28_64,r_116_39_118,r_116_39_118,1.0,1,119,118,28
87,seq92,r_85_134_215,seq14,r_85_134_215,1.0,0,215,215,28
18,r_130_75_114,r_97_20_223,r_149_119_179,r_130_75_114,0.99,-1,113,114,28
29,r_127_80_165,seq50,seq63,r_127_80_165,0.94,1,166,165,28
15,r_65_36_18,r_85_134_215,seq66,r_65_36_18,0.9,0,18,18,28
24,r_108_115_173,seq24,r_56_139_136,r_108_115_173,0.65,2,175,173,28
92,seq111,r_90_120_168,seq46,r_90_120_168,0.51,27,195,168,28
39,r_100_110_122,r_90_120_168,r_56_139_136,r_100_110_122,0.77,47,169,122,28
88,seq94,r_21_26_205,r_47_124_99,r_47_124_99,0.94,43,142,99,28
11,r_27_9_129,r_55_0_29,r_105_28_64,r_55_0_29,0.89,-1,28,29,28
61,seq148,r_8_62_104,seq18,r_8_62_104,1.0,-1,103,104,28
32,r_95_16_224,seq126,r_51_23_172,r_51_23_172,0.76,55,227,172,28
77,seq61,r_96_89_164,r_67_112_73,r_67_112_73,0.96,91,164,73,28
34,r_56_139_136,r_97_20_223,r_100_110_122,r_56_139_136,1.0,0,136,136,28
3,r_15_135_21,r_97_20_223,seq144,r_15_135_21,0.97,0,21,21,28
75,seq59,r_13_82_238,seq131,r_13_82_238,0.93,0,238,238,28
81,seq72,r_90_120_168,r_8_62_104,r_8_62_104,1.0,39,143,104,28
9,r_51_23_172,seq126,seq128,r_51_23_172,0.51,7,179,172,28
22,r_116_39_118,seq117,r_57_101_30,r_116_39_118,1.0,0,118,118,28
7,r_19_93_139,seq104,seq59,r_19_93_139,0.99,4,143,139,28
18,r_130_75_114,r_149_119_179,seq144,r_149_119_179,1.0,0,179,179,28
44,r_76_1_77,r_108_115_173,r_65_36_18,r_76_1_77,1.0,0,77,77,28
23,r_85_134_215,seq92,r_106_53_142,r_106_53_142,0.77,73,215,142,28
58,seq145,r_47_124_99,seq24,r_47_124_99,0.96,-42,57,99,28
79,seq66,r_78_102_137,r_65_36_18,r_78_102_137,0.66,0,137,137,28
12,r_90_120_168,seq72,r_116_39_118,r_116_39_118,0.99,51,169,118,28
51,seq2,r_31_133_243,r_110_62_164,r_110_62_164,0.52,-71,93,164,29
36,r_122_33_67,r_23_17_159,r_126_82_6,r_122_33_67,1.0,0,67,67,29
92,seq113,r_147_91_109,seq19,r_147_91_109,1.0,-1,108,109,29
8,r_109_53_128,r_14_108_54,seq127,r_14_108_54,0.84,22,76,54,29
43,r_138_132_217,seq58,seq127,r_138_132_217,0.59,1,218,217,29
16,r_56_101_141,seq60,seq40,r_56_101_141,1.0,0,141,141,29
39,r_110_62_164,seq58,seq46,r_110_62_164,1.0,0,164,164,29
1,r_14_108_54,r_109_53_128,r_141_48_233,r_14_108_54,0.95,22,76,54,29
5,r_135_68_92,r_37_85_130,seq0,r_135_68_92,1.0,0,92,92,29
46,r_90_130_144,seq64,r_119_145_125,r_90_130_144,1.0,2,146,144,29
42,r_25_77_117,seq78,seq34,r_25_77_117,0.97,0,117,117,29
24,r_6_4_27,r_66_70_168,seq27,r_6_4_27,1.0,0,27,27,29
14,r_72_112_14,r_9_97_237,seq69,r_72_112_14,1.0,1,15,14,29
45,r_9_97_237,seq0,r_95_51_163,r_9_97_237,0.52,-62,175,237,29
47,r_49_15_18,r_142_11_210,seq81,r_49_15_18,0.9,16,34,18,29
19,r_37_85_130,r_111_61_207,r_72_112_14,r_37_85_130,1.0,0,130,130,29
31,r_104_50_181,r_128_74_80,r_49_15_18,r_128_74_80,1.0,0,80,80,29
3,r_23_17_159,r_138_132_217,r_135_68_92,r_138_132_217,1.0,-58,159,217,29
10,r_111_61_207,r_37_85_130,r_47_79_124,r_111_61_207,0.92,-77,130,207,29
8,r_109_53_128,seq127,r_6_4_27,r_109_53_128,1.0,1,129,128,29
29,r_137_38_59,r_31_133_243,r_47_79_124,r_137_38_59,1.0,0,59,59,29
73,seq58,r_110_62_164,r_138_132_217,r_110_62_164,0.96,1,165,164,29
11,r_146_39_115,seq120,seq13,r_146_39_115,1.0,0,115,115,29
62,seq27,r_103_7_150,r_6_4_27,r_6_4_27,1.0,22,49,27,29
99,seq127,seq55,r_138_132_217,r_138_132_217,0.9,10,227,217,29
20,r_1_18_134,seq45,seq113,r_1_18_134,1.0,0,134,134,29
15,r_66_70_168,seq0,seq13,r_66_70_168,0.98,0,168,168,29
48,r_126_82_6,r_30_125_212,r_103_7_150,r_30_125_212,0.61,0,212,212,29
34,r_80_99_102,r_21_75_53,seq34,r_21_75_53,0.97,2,55,53,29
34,r_80_99_102,seq34,seq96,r_80_99_102,0.99,2,104,102,29
99,seq127,r_109_53_128,seq55,r_109_53_128,0.73,-3,125,128,29
5,r_135_68_92,seq0,r_23_17_159,r_23_17_159,1.0,13,172,159,29
4,r_100_84_28,seq55,seq0,r_100_84_28,1.0,0,28,28,29
10,r_111_61_207,r_47_79_124,r_100_84_28,r_111_61_207,0.99,0,207,207,29
27,r_30_125_212,r_126_82_6,r_111_61_207,r_111_61_207,0.67,5,212,207,29
51,seq2,r_110_62_164,seq73,r_110_62_164,0.83,1,165,164,29
2,r_142_11_210,seq115,seq3,r_142_11_210,0.48,0,210,210,29
83,seq81,r_128_74_80,r_49_15_18,r_128_74_80,0.92,-39,41,80,29
40,r_16_131_101,seq71,seq121,r_16_131_101,1.0,0,101,101,29
74,seq59,r_95_51_163,r_23_17_159,r_23_17_159,1.0,9,168,159,29
18,r_57_42_69,seq115,seq35,r_57_42_69,0.49,3,72,69,29
25,r_28_148_193,seq115,r_37_85_130,r_37_85_130,1.0,74,204,130,29
33,r_147_91_109,seq113,seq88,r_147_91_109,1.0,-1,108,109,29
64,seq34,r_80_99_102,r_134_86_63,r_134_86_63,1.0,5,68,63,29
21,r_21_75_53,r_80_99_102,seq78,r_21_75_53,1.0,2,55,53,29
65,seq35,seq83,r_57_42_69,r_57_42_69,0.96,7,76,69,29
73,seq58,r_138_132_217,seq19,r_138_132_217,1.0,3,220,217,29
68,seq45,r_1_18_134,r_31_133_243,r_1_18_134,1.0,0,134,134,29
61,seq26,r_107_106_140,seq60,r_107_106_140,1.0,1,141,140,29
32,r_102_44_218,r_31_133_243,r_23_17_159,r_31_133_243,0.72,-25,218,243,29
38,r_32_63_142,seq0,seq12,r_32_63_142,1.0,0,142,142,29
52,seq3,r_124_43_239,r_142_11_210,r_142_11_210,0.84,-1,209,210,29
0,r_65_117_47,r_1_18_134,r_72_112_14,r_65_117_47,1.0,0,47,47,29
45,r_9_97_237,r_95_51_163,r_14_108_54,r_9_97_237,0.94,0,237,237,29
17,r_95_51_163,seq59,r_9_97_237,r_95_51_163,0.46,5,168,163,29
9,r_107_106_140,seq26,r_144_5_85,r_107_106_140,0.54,0,140,140,29
28,r_47_79_124,r_111_61_207,seq26,r_111_61_207,0.94,-2,205,207,29
29,r_137_38_59,r_47_79_124,seq12,r_47_79_124,1.0,2,126,124,29
22,r_52_20_138,r_98_129_154,r_37_85_130,r_52_20_138,1.0,2,140,138,29
28,r_47_79_124,seq12,r_111_61_207,r_47_79_124,0.93,1,125,124,29
49,r_128_74_80,seq55,seq120,r_128_74_80,1.0,0,80,80,29
7,r_98_129_154,seq29,r_80_99_102,r_98_129_154,0.99,0,154,154,29
44,r_41_139_111,seq88,seq93,r_41_139_111,1.0,0,111,111,29
17,r_95_51_163,r_9_97_237,r_100_84_28,r_9_97_237,0.95,0,237,237,29
35,r_144_5_85,r_31_133_243,r_49_15_18,r_144_5_85,1.0,0,85,85,29
12,r_103_7_150,r_94_123_247,r_122_33_67,r_122_33_67,1.0,69,136,67,29
30,r_132_89_151,seq133,seq14,r_132_89_151,0.89,2,153,151,30
44,r_134_41_23,r_65_51_118,r_109_42_88,r_134_41_23,0.99,65,88,23,30
48,r_114_50_43,r_35_55_47,r_22_110_197,r_114_50_43,0.8,5,48,43,30
14,r_111_148_84,seq17,seq88,r_111_148_84,1.0,0,84,84,30
8,r_149_84_212,seq104,r_111_148_84,r_149_84_212,0.64,0,212,212,30
43,r_125_112_223,seq120,r_58_49_146,r_58_49_146,0.78,77,223,146,30
13,r_35_55_47,r_114_50_43,seq133,r_114_50_43,0.59,0,43,43,30
37,r_54_130_115,r_107_122_159,seq28,r_54_130_115,0.56,0,115,115,30
40,r_82_87_198,seq142,r_111_148_84,r_82_87_198,0.45,40,238,198,30
71,seq53,seq147,r_46_23_138,r_46_23_138,1.0,13,151,138,30
21,r_121_74_141,seq4,r_123_36_114,r_121_74_141,0.99,0,141,141,30
39,r_107_122_159,seq101,seq81,r_107_122_159,0.94,0,159,159,30
1,r_69_12_134,r_132_89_151,seq4,r_132_89_151,0.83,-12,139,151,30
5,r_109_42_88,r_93_90_210,r_134_41_23,r_109_42_88,1.0,1,89,88,30
46,r_46_23_138,r_58_49_146,seq53,r_46_23_138,0.99,0,138,138,30
42,r_79_56_74,r_65_51_118,r_114_50_43,r_79_56_74,1.0,0,74,74,30
44,r_134_41_23,r_61_52_171,r_65_51_118,r_134_41_23,1.0,0,23,23,30
80,seq78,r_31_67_191,seq81,r_31_67_191,1.0,0,191,191,30
6,r_83_38_58,r_129_66_110,r_96_25_45,r_129_66_110,1.0,3,113,110,30
7,r_77_45_83,r_44_13_37,r_121_74_141,r_121_74_141,0.94,55,196,141,30
45,r_135_106_207,seq127,r_69_12_134,r_69_12_134,0.65,73,207,134,30
19,r_30_9_153,seq101,seq17,r_30_9_153,0.83,0,153,153,30
31,r_92_98_215,seq26,r_111_148_84,r_111_148_84,0.91,131,215,84,30
41,r_123_36_114,seq26,r_107_122_159,r_123_36_114,0.89,0,114,114,30
67,seq133,r_132_89_151,r_1_33_80,r_1_33_80,0.99,19,99,80,30
69,seq39,r_64_72_227,r_105_143_28,r_105_143_28,1.0,2,30,28,30
10,r_136_29_173,seq14,seq120,r_136_29_173,0.92,0,173,173,30
36,r_105_143_28,r_35_55_47,seq39,r_105_143_28,1.0,1,29,28,30
3,r_102_43_30,r_54_130_115,seq62,r_102_43_30,1.0,0,30,30,30
26,r_40_128_147,r_30_9_153,seq80,r_30_9_153,0.75,-9,144,153,30
72,seq138,r_116_20_139,seq104,r_116_20_139,1.0,0,139,139,30
6,r_83_38_58,r_124_146_104,r_129_66_110,r_83_38_58,1.0,0,58,58,30
4,r_22_110_197,r_2_99_224,seq104,r_22_110_197,0.76,1,198,197,30
78,seq75,r_61_52_171,r_6_37_219,r_61_52_171,0.99,0,171,171,30
0,r_97_137_123,r_31_67_191,r_2_99_224,r_97_137_123,1.0,0,123,123,30
11,r_24_139_185,seq142,r_116_20_139,r_24_139_185,0.85,0,185,185,30
40,r_82_87_198,r_32_47_8,seq142,r_82_87_198,0.96,7,205,198,30
47,r_96_25_45,r_129_66_110,seq15,r_129_66_110,0.96,-17,93,110,30
20,r_1_33_80,r_63_57_117,seq133,r_1_33_80,0.6,0,80,80,30
98,seq120,r_125_112_223,r_136_29_173,r_136_29_173,0.59,29,202,173,30
15,r_31_67_191,seq78,seq75,r_31_67_191,0.89,0,191,191,30
13,r_35_55_47,seq133,r_126_11_128,r_126_11_128,1.0,49,177,128,30
85,seq88,r_24_139_185,r_111_148_84,r_111_148_84,1.0,6,90,84,30
99,seq127,r_135_106_207,r_63_57_117,r_63_57_117,1.0,7,124,117,30
0,r_97_137_123,r_2_99_224,r_64_72_227,r_64_72_227,0.67,0,227,227,30
48,r_114_50_43,r_22_110_197,r_79_56_74,r_79_56_74,0.87,0,74,74,30
22,r_129_66_110,r_83_38_58,seq133,r_129_66_110,0.99,0,110,110,30
2,r_59_60_167,r_18_85_222,r_129_66_110,r_59_60_167,0.8,0,167,167,30
40,r_82_87_198,seq3,r_32_47_8,r_82_87_198,0.81,-44,154,198,30
29,r_18_85_222,seq70,seq140,r_18_85_222,0.6,0,222,222,30
24,r_126_11_128,r_6_37_219,r_35_55_47,r_126_11_128,1.0,1,129,128,30
25,r_58_49_146,seq115,seq113,r_58_49_146,0.69,2,148,146,30
33,r_145_48_231,seq71,r_22_110_197,r_145_48_231,0.59,0,231,231,30
47,r_96_25_45,r_149_84_212,r_129_66_110,r_149_84_212,0.79,-161,51,212,30
18,r_44_13_37,seq120,seq68,r_44_13_37,0.92,0,37,37,30
32,r_124_146_104,seq16,seq70,r_124_146_104,0.97,0,104,104,30
52,seq4,r_121_74_141,r_69_12_134,r_121_74_141,0.99,0,141,141,30
77,seq131,r_93_90_210,r_35_55_47,r_35_55_47,0.79,168,215,47,30
34,r_64_72_227,seq39,r_97_137_123,r_64_72_227,0.36,0,227,227,30
81,seq80,r_6_37_219,r_40_128_147,r_40_128_147,0.71,-14,133,147,30
17,r_2_99_224,r_22_110_197,r_97_137_123,r_97_137_123,0.98,4,127,123,30
41,r_123_36_114,r_107_122_159,r_121_74_141,r_123_36_114,0.83,45,159,114,30
9,r_116_20_139,seq138,seq39,r_116_20_139,0.98,0,139,139,30
22,r_129_66_110,r_96_25_45,r_83_38_58,r_83_38_58,1.0,17,75,58,30
28,r_93_90_210,seq133,r_61_52_171,r_61_52_171,0.99,40,211,171,30
49,r_63_57_117,seq28,seq127,r_63_57_117,1.0,0,117,117,30
7,r_77_45_83,seq127,r_44_13_37,r_77_45_83,1.0,0,83,83,30
23,r_73_95_65,seq3,seq144,r_73_95_65,0.99,1,66,65,30
17,r_2_99_224,r_97_137_123,r_136_29_173,r_97_137_123,0.92,103,226,123,30
35,r_65_51_118,seq15,seq120,r_65_51_118,1.0,0,118,118,30
30,r_25_97_79,r_15_5_203,seq47,r_15_5_203,0.62,-123,80,203,31
51,seq132,r_0_95_154,r_91_40_18,r_0_95_154,0.57,-56,98,154,31
36,r_4_126_173,seq81,r_80_13_121,r_4_126_173,0.55,0,173,173,31
69,seq51,r_25_97_79,r_127_37_36,r_127_37_36,1.0,-1,35,36,31
14,r_68_129_147,r_56_143_157,seq137,r_68_129_147,1.0,1,148,147,31
8,r_79_48_148,seq77,r_102_130_128,r_79_48_148,1.0,0,148,148,31
43,r_12_27_162,seq148,seq109,r_12_27_162,0.47,0,162,162,31
37,r_100_131_182,seq101,seq89,r_100_131_182,0.87,0,182,182,31
21,r_56_143_157,r_68_129_147,r_80_13_121,r_56_143_157,0.66,-9,148,157,31
39,r_15_5_203,seq61,r_39_50_105,r_15_5_203,0.51,0,203,203,31
1,r_0_95_154,seq132,seq145,r_0_95_154,1.0,1,155,154,31
46,r_67_108_97,r_136_87_106,seq19,r_67_108_97,1.0,0,97,97,31
42,r_76_9_72,r_141_74_183,r_78_118_53,r_141_74_183,1.0,-111,72,183,31
47,r_80_13_121,r_1_135_136,r_4_126_173,r_4_126_173,1.0,4,177,173,31
19,r_112_10_140,seq140,seq85,r_112_10_140,0.99,0,140,140,31
11,r_123_46_1,r_11_96_144,r_75_14_33,r_75_14_33,0.97,2,35,33,31
38,r_20_58_12,r_1_135_136,seq138,r_20_58_12,0.98,0,12,12,31
95,seq114,r_26_59_201,r_17_122_110,r_17_122_110,1.0,90,200,110,31
31,r_42_8_101,r_11_96_144,seq44,r_42_8_101,1.0,1,102,101,31
41,r_90_70_170,r_84_54_247,seq105,r_90_70_170,0.85,0,170,170,31
10,r_11_96_144,seq85,r_83_45_84,r_83_45_84,0.86,60,144,84,31
72,seq60,r_7_24_196,r_25_97_79,r_7_24_196,0.86,-109,87,196,31
4,r_149_92_189,seq41,r_133_128_5,r_149_92_189,0.74,1,190,189,31
73,seq61,r_15_5_203,seq51,r_15_5_203,0.98,0,203,203,31
22,r_102_130_128,r_56_143_157,r_79_48_148,r_102_130_128,1.0,23,151,128,31
13,r_64_134_246,r_102_130_128,seq120,r_102_130_128,1.0,0,128,128,31
15,r_7_24_196,seq60,seq99,r_7_24_196,0.85,1,197,196,31
17,r_75_14_33,seq144,r_123_46_1,r_75_14_33,1.0,0,33,33,31
90,seq105,r_33_124_56,seq104,r_33_124_56,0.98,2,58,56,31
47,r_80_13_121,r_103_49_230,r_1_135_136,r_1_135_136,0.95,0,136,136,31
0,r_52_139_26,r_4_126_173,seq51,r_52_139_26,1.0,0,26,26,31
85,seq144,r_75_14_33,r_79_48_148,r_75_14_33,0.97,-7,26,33,31
29,r_142_106_28,r_68_129_147,seq116,r_142_106_28,0.85,1,29,28,31
5,r_133_128_5,seq137,r_149_92_189,r_149_92_189,0.97,1,190,189,31
27,r_125_21_87,seq137,seq34,r_125_21_87,1.0,1,88,87,31
6,r_36_72_50,seq66,seq32,r_36_72_50,1.0,0,50,50,31
49,r_53_22_54,seq34,seq28,r_53_22_54,1.0,0,54,54,31
2,r_1_135_136,seq3,r_80_13_121,r_1_135_136,0.89,0,136,136,31
47,r_80_13_121,r_93_71_202,r_103_49_230,r_80_13_121,0.48,0,121,121,31
40,r_121_117_235,seq132,r_146_107_212,r_146_107_212,0.8,25,237,212,31
18,r_84_54_247,r_90_70_170,r_39_50_105,r_39_50_105,0.56,19,124,105,31
24,r_31_38_207,seq47,r_36_72_50,r_31_38_207,0.7,0,207,207,31
25,r_17_122_110,r_12_27_162,r_142_106_28,r_17_122_110,0.68,0,110,110,31
88,seq101,r_100_131_182,seq99,r_100_131_182,0.98,0,182,182,31
68,seq47,r_31_38_207,r_125_21_87,r_125_21_87,1.0,120,207,87,31
32,r_136_87_106,seq30,seq47,r_136_87_106,1.0,0,106,106,31
45,r_63_86_22,seq60,seq51,r_63_86_22,0.42,169,191,22,31
33,r_91_40_18,r_1_135_136,seq132,r_91_40_18,0.99,0,18,18,31
97,seq116,r_23_29_69,r_142_106_28,r_142_106_28,1.0,19,47,28,31
85,seq144,r_78_118_53,r_2_62_67,r_2_62_67,0.85,9,76,67,31
9,r_141_74_183,seq94,seq89,r_141_74_183,0.94,0,183,183,31
90,seq105,seq104,r_90_70_170,r_90_70_170,0.99,7,177,170,31
7,r_78_118_53,r_149_92_189,seq144,r_78_118_53,0.93,0,53,53,31
22,r_102_130_128,r_64_134_246,r_56_143_157,r_64_134_246,0.3,-114,132,246,31
28,r_2_62_67,r_11_96_144,seq144,r_2_62_67,1.0,0,67,67,31
44,r_83_45_84,r_0_95_154,seq30,r_83_45_84,1.0,0,84,84,31
23,r_39_50_105,seq19,r_84_54_247,r_39_50_105,0.99,1,106,105,31
35,r_103_49_230,r_25_97_79,r_127_37_36,r_127_37_36,1.0,154,190,36,31
12,r_146_107_212,seq34,seq6,r_146_107_212,0.48,3,215,212,31
26,r_33_124_56,seq105,seq113,r_33_124_56,1.0,2,58,56,31
7,r_78_118_53,seq144,r_76_9_72,r_76_9_72,0.99,3,75,72,31
30,r_69_34_180,r_146_38_172,r_71_17_129,r_71_17_129,0.97,43,172,129,32
46,r_125_116_85,r_136_107_46,seq43,r_125_116_85,0.94,1,86,85,32
14,r_80_121_154,seq36,r_136_107_46,r_80_121_154,0.94,0,154,154,32
8,r_47_101_69,seq51,seq26,r_47_101_69,1.0,1,70,69,32
20,r_95_94_57,r_61_123_104,seq5,r_61_123_104,1.0,0,104,104,32
54,seq135,seq24,r_13_144_72,r_13_144_72,1.0,1,73,72,32
37,r_138_81_167,seq65,seq8,r_138_81_167,0.95,0,167,167,32
16,r_129_58_199,r_0_87_203,seq126,r_0_87_203,0.62,-3,200,203,32
39,r_86_106_176,seq88,seq119,r_86_106_176,0.81,0,176,176,32
1,r_105_32_75,r_125_116_85,seq37,r_105_32_75,1.0,0,75,75,32
46,r_125_116_85,r_105_32_75,r_136_107_46,r_105_32_75,0.8,-5,70,75,32
80,seq65,r_138_81_167,r_41_30_218,r_138_81_167,1.0,0,167,167,32
69,seq31,seq25,r_11_60_78,r_11_60_78,0.99,26,104,78,32
33,r_91_77_13,seq15,r_134_103_183,r_134_103_183,0.89,0,183,183,32
38,r_147_54_80,r_50_104_165,r_57_28_115,r_50_104_165,0.94,7,172,165,32
31,r_57_28_115,r_112_7_196,r_147_54_80,r_147_54_80,1.0,36,116,80,32
41,r_134_103_183,seq25,r_11_60_78,r_11_60_78,1.0,0,78,78,32
67,seq25,seq37,r_105_32_75,r_105_32_75,1.0,6,81,75,32
30,r_69_34_180,r_71_17_129,r_13_144_72,r_69_34_180,0.89,3,183,180,32
67,seq25,r_105_32_75,r_53_44_140,r_53_44_140,1.0,4,144,140,32
10,r_72_39_237,r_2_102_125,r_90_127_9,r_2_102_125,0.94,-44,81,125,32
33,r_91_77_13,r_92_117_88,seq15,r_91_77_13,0.98,0,13,13,32
72,seq37,seq25,r_105_32_75,r_105_32_75,1.0,3,78,75,32
0,r_11_60_78,r_57_28_115,r_134_103_183,r_11_60_78,0.69,-1,77,78,32
11,r_2_102_125,r_72_39_237,seq126,r_2_102_125,0.98,5,130,125,32
83,seq78,r_111_120_24,r_49_73_50,r_49_73_50,0.86,-7,43,50,32
13,r_0_87_203,r_92_117_88,r_129_58_199,r_92_117_88,1.0,-5,83,88,32
25,r_133_6_33,seq63,seq83,r_133_6_33,1.0,0,33,33,32
15,r_137_12_238,seq67,r_129_58_199,r_129_58_199,0.89,39,238,199,32
48,r_130_84_144,seq140,seq126,r_130_84_144,0.96,0,144,144,32
12,r_50_104_165,r_147_54_80,seq64,r_50_104_165,0.51,1,166,165,32
13,r_0_87_203,r_129_58_199,r_113_56_187,r_129_58_199,0.84,5,204,199,32
6,r_1_131_84,r_53_44_140,seq63,r_1_131_84,1.0,-1,83,84,32
22,r_136_107_46,seq110,r_92_117_88,r_136_107_46,0.73,-24,22,46,32
43,r_74_16_17,seq126,seq88,r_74_16_17,1.0,0,17,17,32
99,seq126,r_111_120_24,r_2_102_125,r_2_102_125,0.99,2,127,125,32
0,r_11_60_78,r_134_103_183,r_53_44_140,r_53_44_140,0.6,51,191,140,32
10,r_72_39_237,r_90_127_9,r_68_76_2,r_90_127_9,0.3,230,239,9,32
36,r_85_42_29,r_1_131_84,seq149,r_85_42_29,1.0,-2,27,29,32
2,r_71_17_129,r_80_121_154,r_82_145_123,r_71_17_129,1.0,1,130,129,32
41,r_134_103_183,r_11_60_78,r_91_77_13,r_11_60_78,0.6,105,183,78,32
40,r_41_30_218,seq65,r_57_28_115,r_57_28_115,0.67,103,218,115,32
74,seq51,r_47_101_69,r_136_107_46,r_47_101_69,1.0,1,70,69,32
18,r_21_62_168,seq115,seq93,r_21_62_168,0.99,0,168,168,32
29,r_128_143_141,seq14,seq20,r_128_143_141,1.0,0,141,141,32
20,r_95_94_57,r_33_66_147,r_61_123_104,r_95_94_57,1.0,0,57,57,32
24,r_13_144_72,r_71_17_129,seq135,r_13_144_72,1.0,0,72,72,32
70,seq35,seq8,r_2_102_125,r_2_102_125,0.77,-4,121,125,32
68,seq26,r_57_28_115,r_47_101_69,r_47_101_69,1.0,63,132,69,32
32,r_61_123_104,seq99,r_95_94_57,r_95_94_57,0.86,5,62,57,32
38,r_147_54_80,r_21_62_168,r_50_104_165,r_147_54_80,1.0,0,80,80,32
34,r_97_118_89,r_111_120_24,r_85_42_29,r_111_120_24,0.76,65,89,24,32
17,r_114_109_60,r_129_58_199,seq3,r_114_109_60,1.0,-2,58,60,32
81,seq67,r_137_12_238,seq24,r_137_12_238,0.61,0,238,238,32
94,seq115,r_21_62_168,seq110,r_21_62_168,1.0,0,168,168,32
21,r_108_40_52,r_68_76_2,seq52,r_108_40_52,0.98,0,52,52,32
9,r_92_117_88,r_0_87_203,seq124,r_92_117_88,1.0,0,88,88,32
45,r_49_73_50,seq15,seq78,r_49_73_50,0.99,-8,42,50,32
28,r_113_56_187,seq149,seq93,r_113_56_187,0.93,0,187,187,32
49,r_33_66_147,r_50_104_165,seq89,r_33_66_147,0.98,0,147,147,32
32,r_61_123_104,r_95_94_57,seq110,r_61_123_104,0.98,0,104,104,32
23,r_53_44_140,seq89,seq25,r_53_44_140,0.99,0,140,140,32
35,r_82_145_123,r_57_28_115,seq64,r_82_145_123,0.93,1,124,123,32
12,r_50_104_165,r_112_7_196,r_147_54_80,r_147_54_80,1.0,6,86,80,32
22,r_136_107_46,r_92_117_88,seq51,r_92_117_88,0.98,-33,55,88,32
30,r_81_40_74,r_65_60_88,seq99,r_65_60_88,0.78,-11,77,88,33
40,r_91_76_187,r_45_52_67,seq69,r_91_76_187,0.98,0,187,187,33
37,r_116_134_54,seq68,seq90,r_116_134_54,0.87,1,55,54,33
14,r_112_80_103,seq25,seq114,r_112_80_103,1.0,0,103,103,33
8,r_142_118_84,r_62_138_91,r_144_28_237,r_144_28_237,1.0,-153,84,237,33
43,r_135_107_222,r_72_143_165,seq11,r_72_143_165,0.98,-1,164,165,33
3,r_74_133_31,r_9_147_201,r_108_104_102,r_108_104_102,1.0,121,223,102,33
59,seq130,r_78_56_121,r_66_98_66,r_66_98_66,0.98,-1,65,66,33
71,seq48,r_85_5_228,seq141,r_85_5_228,0.94,-43,185,228,33
16,r_115_111_73,seq129,seq121,r_115_111_73,0.54,1,74,73,33
39,r_149_92_225,seq128,r_47_14_133,r_149_92_225,0.37,6,231,225,33
1,r_108_104_102,r_71_87_123,r_74_133_31,r_108_104_102,1.0,0,102,102,33
46,r_66_98_66,seq88,seq130,r_66_98_66,1.0,-1,65,66,33
80,seq69,seq140,r_91_76_187,r_91_76_187,0.98,4,191,187,33
19,r_17_54_144,seq126,seq90,r_17_54_144,0.55,5,149,144,33
49,r_101_105_207,r_53_97_53,r_47_14_133,r_53_97_53,1.0,0,53,53,33
11,r_146_55_38,seq114,seq37,r_146_55_38,1.0,-1,37,38,33
42,r_53_97_53,r_101_105_207,r_117_124_195,r_53_97_53,1.0,0,53,53,33
31,r_38_13_61,r_142_118_84,seq30,r_38_13_61,0.93,0,61,61,33
41,r_65_60_88,seq140,seq103,r_65_60_88,0.96,0,88,88,33
36,r_33_34_26,r_72_143_165,r_91_76_187,r_33_34_26,1.0,0,26,26,33
38,r_96_29_59,r_43_22_177,seq25,r_96_29_59,0.91,0,59,59,33
26,r_44_57_214,r_117_124_195,r_9_147_201,r_44_57_214,0.59,-19,195,214,33
8,r_142_118_84,r_144_28_237,r_1_27_154,r_1_27_154,0.94,0,154,154,33
4,r_85_5_228,seq48,r_43_22_177,r_85_5_228,0.44,1,229,228,33
73,seq50,seq0,r_12_36_219,r_12_36_219,0.54,-149,70,219,33
20,r_43_22_177,r_91_76_187,seq30,r_43_22_177,0.73,0,177,177,33
13,r_45_52_67,r_122_132_172,seq2,r_45_52_67,1.0,0,67,67,33
15,r_109_21_239,seq75,r_51_26_170,r_51_26_170,0.94,68,238,170,33
48,r_131_100_72,r_101_105_207,r_45_52_67,r_131_100_72,0.61,-1,71,72,33
49,r_101_105_207,r_47_14_133,r_108_104_102,r_47_14_133,0.69,74,207,133,33
57,seq11,r_51_26_170,seq136,r_51_26_170,0.97,1,171,170,33
0,r_9_147_201,r_74_133_31,seq68,r_9_147_201,0.42,16,217,201,33
36,r_33_34_26,r_91_76_187,r_24_86_82,r_33_34_26,0.48,161,187,26,33
26,r_44_57_214,r_9_147_201,r_32_16_135,r_9_147_201,0.55,13,214,201,33
21,r_4_125_15,r_109_21_239,seq39,r_4_125_15,0.96,-1,14,15,33
27,r_78_56_121,seq130,r_53_97_53,r_78_56_121,0.93,0,121,121,33
47,r_24_86_82,r_71_87_123,r_33_34_26,r_24_86_82,1.0,0,82,82,33
40,r_91_76_187,r_43_22_177,r_45_52_67,r_45_52_67,1.0,110,177,67,33
74,seq58,r_95_3_230,r_145_70_189,r_145_70_189,0.96,46,235,189,33
24,r_72_143_165,r_135_107_222,seq148,r_72_143_165,0.88,0,165,165,33
35,r_47_14_133,r_101_105_207,r_149_92_225,r_101_105_207,0.96,0,207,207,33
25,r_42_94_68,r_144_28_237,seq61,r_42_94_68,1.0,0,68,68,33
43,r_135_107_222,seq11,r_32_16_135,r_135_107_222,0.61,15,237,222,33
33,r_145_70_189,seq0,seq11,r_145_70_189,0.87,0,189,189,33
88,seq90,r_144_28_237,r_17_54_144,r_17_54_144,0.75,39,183,144,33
50,seq0,r_145_70_189,seq50,r_145_70_189,0.97,0,189,189,33
70,seq46,r_32_16_135,seq137,r_32_16_135,1.0,1,136,135,33
42,r_53_97_53,r_117_124_195,r_78_56_121,r_53_97_53,0.77,142,195,53,33
32,r_84_49_167,seq68,r_110_120_50,r_84_49_167,0.41,0,167,167,33
52,seq2,r_43_22_177,r_131_100_72,r_131_100_72,0.48,1,73,72,33
16,r_115_111_73,seq121,r_62_138_91,r_62_138_91,1.0,-1,90,91,33
3,r_74_133_31,seq8,r_9_147_201,r_74_133_31,1.0,0,31,31,33
81,seq75,r_109_21_239,r_144_28_237,r_109_21_239,0.39,-1,238,239,33
17,r_95_3_230,seq58,r_117_124_195,r_117_124_195,0.78,43,238,195,33
94,seq114,r_47_14_133,r_112_80_103,r_112_80_103,1.0,-7,96,103,33
9,r_32_16_135,seq46,seq61,r_32_16_135,0.9,1,136,135,33
0,r_9_147_201,seq50,r_74_133_31,r_74_133_31,1.0,1,32,31,33
28,r_51_26_170,seq11,seq7,r_51_26_170,0.97,1,171,170,33
7,r_71_87_123,seq30,seq90,r_71_87_123,1.0,0,123,123,33
44,r_12_36_219,seq129,r_108_104_102,r_108_104_102,1.0,120,222,102,33
23,r_122_132_172,seq90,r_72_143_165,r_122_132_172,0.97,0,172,172,33
6,r_19_89_12,r_74_133_31,seq137,r_19_89_12,0.98,0,12,12,33
12,r_73_41_105,r_71_87_123,seq20,r_73_41_105,0.98,0,105,105,33
93,seq112,r_38_27_126,seq133,r_38_27_126,1.0,0,126,126,34
8,r_73_12_88,seq16,seq108,r_73_12_88,1.0,3,91,88,34
16,r_90_55_8,r_43_91_176,seq79,r_90_55_8,0.8,2,10,8,34
27,r_38_27_126,r_54_82_70,r_21_142_169,r_21_142_169,0.96,14,183,169,34
83,seq68,r_138_120_246,r_37_101_186,r_37_101_186,0.95,0,186,186,34
37,r_78_64_51,seq5,r_90_55_8,r_78_64_51,0.99,0,51,51,34
86,seq94,r_42_137_82,r_21_142_169,r_42_137_82,1.0,0,82,82,34
21,r_28_98_207,r_136_56_232,seq130,r_28_98_207,0.7,0,207,207,34
39,r_128_57_219,seq16,r_96_131_179,r_96_131_179,0.6,40,219,179,34
1,r_122_52_117,r_81_32_216,r_73_12_88,r_122_52_117,1.0,0,117,117,34
5,r_43_91_176,seq106,r_54_82_70,r_43_91_176,0.88,2,178,176,34
46,r_80_141_4,r_49_103_133,seq149,r_80_141_4,0.47,129,133,4,34
42,r_0_93_124,seq10,seq106,r_0_93_124,0.94,0,124,124,34
80,seq61,r_113_86_213,seq1,r_113_86_213,0.76,0,213,213,34
45,r_21_142_169,r_37_101_186,r_38_27_126,r_21_142_169,0.54,0,169,169,34
34,r_8_97_81,seq30,r_36_116_142,r_36_116_142,0.93,-2,140,142,34
30,r_4_71_21,seq119,seq104,r_4_71_21,1.0,0,21,21,34
19,r_100_51_194,seq111,r_69_70_71,r_100_51_194,0.76,0,194,194,34
33,r_45_110_74,r_3_76_140,seq16,r_3_76_140,1.0,0,140,140,34
76,seq44,seq16,r_134_11_96,r_134_11_96,1.0,3,99,96,34
31,r_144_102_233,r_135_40_162,r_122_52_117,r_122_52_117,0.64,46,163,117,34
14,r_145_72_24,seq39,seq139,r_145_72_24,0.99,2,26,24,34
89,seq104,r_129_63_220,r_3_76_140,r_3_76_140,0.99,80,220,140,34
43,r_92_83_16,r_144_102_233,seq104,r_92_83_16,0.99,0,16,16,34
3,r_54_82_70,seq31,seq87,r_54_82_70,1.0,0,70,70,34
10,r_3_76_140,r_73_12_88,r_45_110_74,r_3_76_140,0.64,-56,84,140,34
90,seq106,r_43_91_176,r_0_93_124,r_0_93_124,0.83,53,177,124,34
26,r_42_137_82,seq94,seq119,r_42_137_82,1.0,0,82,82,34
14,r_145_72_24,seq139,r_14_66_67,r_14_66_67,1.0,22,89,67,34
4,r_37_101_186,r_21_142_169,r_147_34_100,r_147_34_100,1.0,10,110,100,34
78,seq50,r_136_56_232,r_3_76_140,r_3_76_140,1.0,63,203,140,34
0,r_129_63_220,seq104,r_147_34_100,r_147_34_100,0.93,120,220,100,34
11,r_13_77_135,r_140_124_166,seq115,r_13_77_135,1.0,0,135,135,34
20,r_69_70_71,r_88_15_188,seq10,r_69_70_71,1.0,1,72,71,34
15,r_136_56_232,seq50,r_90_55_8,r_136_56_232,0.34,0,232,232,34
48,r_147_34_100,r_26_48_224,seq94,r_147_34_100,1.0,0,100,100,34
4,r_37_101_186,r_147_34_100,seq68,r_37_101_186,0.99,0,186,186,34
6,r_134_11_96,seq5,seq44,r_134_11_96,1.0,0,96,96,34
85,seq87,r_18_41_182,r_54_82_70,r_54_82_70,0.99,3,73,70,34
27,r_38_27_126,seq112,r_54_82_70,r_38_27_126,0.98,0,126,126,34
2,r_96_131_179,seq108,r_126_85_118,r_96_131_179,0.96,1,180,179,34
47,r_49_103_133,r_80_141_4,seq30,r_49_103_133,0.94,0,133,133,34
40,r_84_74_95,r_38_27_126,seq143,r_84_74_95,1.0,0,95,95,34
18,r_113_86_213,seq25,r_3_76_140,r_113_86_213,0.79,0,213,213,34
29,r_46_75_136,seq60,seq94,r_46_75_136,1.0,0,136,136,34
24,r_18_41_182,seq148,seq149,r_18_41_182,0.74,1,183,182,34
33,r_45_110_74,r_37_101_186,r_3_76_140,r_45_110_74,0.99,0,74,74,34
46,r_80_141_4,seq149,r_140_124_166,r_140_124_166,1.0,-1,165,166,34
13,r_65_105_40,seq143,seq9,r_65_105_40,0.69,10,50,40,34
70,seq30,seq95,r_49_103_133,r_49_103_133,1.0,-1,132,133,34
68,seq25,r_113_86_213,seq1,r_113_86_213,0.94,-7,206,213,34
32,r_99_53_59,seq19,seq2,r_99_53_59,0.98,7,66,59,34
34,r_8_97_81,seq139,seq30,r_8_97_81,0.95,0,81,81,34
10,r_3_76_140,r_45_110_74,r_92_83_16,r_3_76_140,1.0,0,140,140,34
81,seq62,r_65_105_40,seq143,r_65_105_40,0.54,46,86,40,34
17,r_140_124_166,seq24,r_80_141_4,r_140_124_166,0.93,0,166,166,34
9,r_138_120_246,r_22_58_183,r_37_101_186,r_37_101_186,0.99,7,193,186,34
26,r_42_137_82,seq119,r_135_40_162,r_135_40_162,1.0,6,168,162,34
31,r_144_102_233,r_122_52_117,r_28_98_207,r_144_102_233,0.96,0,233,233,34
28,r_22_58_183,r_138_120_246,seq9,r_138_120_246,0.61,-53,193,246,34
91,seq108,r_96_131_179,r_73_12_88,r_73_12_88,0.97,92,180,88,34
49,r_126_85_118,seq62,seq31,r_126_85_118,1.0,0,118,118,34
7,r_81_32_216,r_122_52_117,r_146_125_92,r_81_32_216,1.0,-101,115,216,34
44,r_146_125_92,seq44,r_81_32_216,r_146_125_92,1.0,0,92,92,34
79,seq60,r_46_75_136,seq62,r_46_75_136,1.0,-2,134,136,34
35,r_14_66_67,seq25,r_145_72_24,r_14_66_67,1.0,0,67,67,34
12,r_135_40_162,r_96_131_179,r_42_137_82,r_96_131_179,1.0,-17,162,179,34
93,seq106,r_126_100_116,seq60,r_126_100_116,0.93,1,117,116,35
30,r_36_49_119,seq46,seq89,r_36_49_119,0.69,21,140,119,35
44,r_42_111_136,r_144_141_220,r_44_125_203,r_42_111_136,0.95,84,220,136,35
36,r_137_68_238,seq94,r_129_110_215,r_129_110_215,0.58,23,238,215,35
14,r_44_125_203,seq114,r_42_111_136,r_42_111_136,0.92,67,203,136,35
43,r_67_62_84,r_70_104_108,r_146_17_1,r_67_62_84,1.0,0,84,84,35
22,r_12_96_53,r_7_116_60,seq105,r_12_96_53,1.0,-1,52,53,35
37,r_148_72_181,r_140_50_170,r_38_136_25,r_38_136_25,0.95,81,106,25,35
32,r_147_51_47,seq105,r_86_115_27,r_147_51_47,0.87,-2,45,47,35
16,r_63_56_212,r_30_130_240,r_74_37_126,r_74_37_126,0.6,86,212,126,35
21,r_140_50_170,r_148_72_181,r_113_41_109,r_140_50_170,1.0,0,170,170,35
1,r_108_79_221,seq52,r_88_76_202,r_108_79_221,0.46,0,221,221,35
85,seq89,r_90_23_216,r_38_136_25,r_38_136_25,1.0,2,27,25,35
45,r_70_104_108,r_67_62_84,r_12_96_53,r_70_104_108,1.0,-35,73,108,35
0,r_35_87_15,seq82,r_7_116_60,r_7_116_60,1.0,5,65,60,35
27,r_86_115_27,r_112_24_179,r_74_37_126,r_86_115_27,0.76,-2,25,27,35
19,r_15_32_162,r_88_76_202,seq106,r_15_32_162,0.92,0,162,162,35
2,r_4_5_218,seq69,seq131,r_4_5_218,0.63,-1,217,218,35
63,seq25,seq142,r_122_43_20,r_122_43_20,1.0,1,21,20,35
33,r_113_41_109,seq64,r_140_50_170,r_140_50_170,1.0,5,175,170,35
46,r_120_95_30,seq82,seq99,r_120_95_30,1.0,-1,29,30,35
27,r_86_115_27,r_74_37_126,r_147_51_47,r_74_37_126,0.97,0,126,126,35
31,r_38_136_25,seq117,seq28,r_38_136_25,1.0,0,25,25,35
41,r_57_20_143,seq66,r_102_19_11,r_57_20_143,0.85,2,145,143,35
67,seq31,r_108_79_221,r_145_77_94,r_145_77_94,1.0,15,109,94,35
10,r_39_45_177,r_4_5_218,seq3,r_39_45_177,1.0,1,178,177,35
66,seq28,r_90_23_216,r_38_136_25,r_38_136_25,1.0,0,25,25,35
26,r_80_58_227,r_81_40_249,seq107,r_80_58_227,0.55,0,227,227,35
11,r_126_100_116,seq106,r_124_1_5,r_126_100_116,0.95,1,117,116,35
20,r_88_76_202,r_15_32_162,seq117,r_15_32_162,1.0,-35,127,162,35
13,r_48_101_217,seq143,r_14_59_59,r_14_59_59,1.0,158,217,59,35
15,r_81_40_249,seq60,r_14_59_59,r_14_59_59,1.0,1,60,59,35
48,r_139_118_69,r_112_24_179,r_81_40_249,r_139_118_69,1.0,0,69,69,35
4,r_74_37_126,r_86_115_27,seq52,r_74_37_126,1.0,1,127,126,35
6,r_144_141_220,seq142,r_42_111_136,r_42_111_136,1.0,24,160,136,35
3,r_2_121_16,r_18_75_230,seq134,r_18_75_230,0.54,-214,16,230,35
2,r_4_5_218,r_39_45_177,seq69,r_39_45_177,0.91,1,178,177,35
47,r_9_91_150,seq98,seq71,r_9_91_150,1.0,0,150,150,35
99,seq127,r_90_23_216,r_38_136_25,r_38_136_25,1.0,2,27,25,35
29,r_14_59_59,seq73,r_81_40_249,r_14_59_59,1.0,1,60,59,35
4,r_74_37_126,r_44_125_203,r_86_115_27,r_86_115_27,0.82,16,43,27,35
0,r_35_87_15,r_48_101_217,seq82,r_35_87_15,1.0,0,15,15,35
34,r_129_110_215,r_67_62_84,r_16_34_135,r_129_110_215,0.94,0,215,215,35
25,r_7_116_60,r_145_77_94,r_35_87_15,r_7_116_60,1.0,0,60,60,35
33,r_113_41_109,seq114,seq64,r_113_41_109,0.95,5,114,109,35
58,seq142,r_144_141_220,r_42_111_136,r_42_111_136,1.0,25,161,136,35
70,seq52,r_108_79_221,r_109_65_173,r_109_65_173,0.82,48,221,173,35
6,r_144_141_220,r_42_111_136,r_39_45_177,r_144_141_220,1.0,0,220,220,35
65,seq27,r_112_24_179,seq133,r_112_24_179,1.0,0,179,179,35
20,r_88_76_202,seq117,r_38_136_25,r_88_76_202,0.99,0,202,202,35
42,r_102_19_11,r_137_68_238,r_57_20_143,r_57_20_143,0.98,8,151,143,35
38,r_16_34_135,seq31,seq22,r_16_34_135,1.0,0,135,135,35
34,r_129_110_215,seq60,r_67_62_84,r_67_62_84,1.0,38,122,84,35
17,r_13_135_74,seq66,r_86_115_27,r_13_135_74,0.64,4,78,74,35
5,r_122_43_20,r_48_101_217,seq25,r_122_43_20,0.61,0,20,20,35
9,r_109_65_173,seq69,seq52,r_109_65_173,0.73,0,173,173,35
76,seq66,r_13_135_74,seq98,r_13_135_74,0.91,-26,48,74,35
37,r_148_72_181,r_38_136_25,seq52,r_148_72_181,0.99,1,182,181,35
28,r_112_24_179,seq27,seq117,r_112_24_179,0.52,0,179,179,35
49,r_145_77_94,seq107,seq31,r_145_77_94,0.98,0,94,94,35
44,r_42_111_136,r_48_101_217,r_144_141_220,r_42_111_136,1.0,0,136,136,35
42,r_102_19_11,seq25,r_137_68_238,r_102_19_11,0.51,1,12,11,35
12,r_90_23_216,seq53,r_35_87_15,r_35_87_15,0.57,202,217,15,35
30,r_1_130_125,seq139,r_74_69_40,r_1_130_125,0.91,0,125,125,36
20,r_74_69_40,r_89_28_105,r_128_146_181,r_128_146_181,0.92,-146,35,181,36
51,seq2,r_120_110_157,r_42_76_166,r_120_110_157,0.79,6,163,157,36
26,r_33_104_44,seq134,r_64_22_14,r_33_104_44,1.0,0,44,44,36
25,r_140_46_182,r_37_144_81,r_14_138_86,r_140_46_182,1.0,0,182,182,36
14,r_37_144_81,r_128_146_181,r_140_46_182,r_37_144_81,1.0,0,81,81,36
43,r_54_50_70,seq71,r_17_149_227,r_54_50_70,0.92,0,70,70,36
37,r_53_96_82,r_36_113_75,r_52_18_22,r_53_96_82,0.99,0,82,82,36
86,seq93,r_116_20_231,r_108_34_29,r_108_34_29,0.99,203,232,29,36
39,r_137_21_225,seq45,r_125_4_136,r_125_4_136,1.0,25,161,136,36
1,r_14_138_86,seq8,seq57,r_14_138_86,0.69,2,88,86,36
97,seq123,r_17_149_227,r_73_111_221,r_17_149_227,0.84,0,227,227,36
80,seq82,r_39_84_51,r_142_68_174,r_142_68_174,0.99,20,194,174,36
5,r_17_149_227,seq123,r_23_105_58,r_23_105_58,0.64,169,227,58,36
46,r_100_29_126,seq77,r_52_18_22,r_100_29_126,0.98,0,126,126,36
24,r_78_97_189,r_36_113_75,r_35_136_11,r_35_136_11,1.0,0,11,11,36
80,seq82,seq127,r_39_84_51,r_39_84_51,1.0,57,108,51,36
24,r_78_97_189,r_35_136_11,r_60_72_112,r_35_136_11,0.96,179,190,11,36
19,r_120_110_157,seq2,r_12_99_3,r_120_110_157,0.89,0,157,157,36
45,r_31_131_23,r_10_63_98,seq77,r_31_131_23,1.0,0,23,23,36
39,r_137_21_225,r_125_4_136,r_86_143_95,r_137_21_225,1.0,0,225,225,36
31,r_125_4_136,seq38,r_137_21_225,r_125_4_136,0.97,1,137,136,36
41,r_6_40_63,seq7,r_42_76_166,r_6_40_63,1.0,0,63,63,36
10,r_16_94_187,seq119,r_86_143_95,r_16_94_187,0.85,0,187,187,36
3,r_86_143_95,r_58_148_13,r_51_0_89,r_86_143_95,1.0,0,95,95,36
34,r_106_43_235,r_12_99_3,seq49,r_106_43_235,0.4,-148,87,235,36
12,r_35_136_11,seq45,r_78_97_189,r_35_136_11,1.0,0,11,11,36
34,r_106_43_235,seq49,r_12_99_3,r_106_43_235,0.59,-70,165,235,36
14,r_37_144_81,r_140_46_182,seq119,r_140_46_182,1.0,0,182,182,36
4,r_24_11_194,seq92,seq44,r_24_11_194,0.73,1,195,194,36
16,r_39_84_51,seq26,seq82,r_39_84_51,1.0,0,51,51,36
0,r_42_76_166,seq139,r_6_40_63,r_6_40_63,1.0,0,63,63,36
73,seq70,r_107_83_215,r_36_113_75,r_107_83_215,0.89,-143,72,215,36
98,seq124,r_95_141_151,seq147,r_95_141_151,1.0,0,151,151,36
15,r_67_112_196,seq81,r_89_28_105,r_67_112_196,0.62,0,196,196,36
48,r_51_0_89,r_107_83_215,seq71,r_107_83_215,0.7,-127,88,215,36
12,r_35_136_11,r_78_97_189,seq91,r_78_97_189,1.0,1,190,189,36
23,r_58_148_13,r_39_84_51,seq121,r_58_148_13,1.0,0,13,13,36
6,r_36_113_75,r_78_97_189,seq70,r_78_97_189,1.0,-117,72,189,36
62,seq32,r_66_98_76,r_14_138_86,r_66_98_76,0.99,2,78,76,36
11,r_52_18_22,r_15_133_61,seq117,r_52_18_22,0.94,-1,21,22,36
2,r_128_146_181,r_74_69_40,r_62_145_36,r_128_146_181,0.97,0,181,181,36
29,r_108_34_29,r_12_99_3,seq93,r_108_34_29,1.0,0,29,29,36
0,r_42_76_166,r_6_40_63,seq2,r_42_76_166,0.74,0,166,166,36
27,r_15_133_61,r_106_43_235,seq87,r_15_133_61,0.99,0,61,61,36
59,seq26,r_39_84_51,seq57,r_39_84_51,1.0,-4,47,51,36
30,r_1_130_125,r_74_69_40,seq127,r_1_130_125,0.4,89,214,125,36
76,seq77,r_100_29_126,r_31_131_23,r_31_131_23,0.56,4,27,23,36
2,r_128_146_181,r_37_144_81,r_74_69_40,r_37_144_81,0.99,-10,71,81,36
41,r_6_40_63,r_42_76_166,r_60_72_112,r_6_40_63,0.93,103,166,63,36
59,seq26,seq57,r_86_143_95,r_86_143_95,1.0,33,128,95,36
40,r_60_72_112,seq57,seq117,r_60_72_112,1.0,0,112,112,36
18,r_142_68_174,seq117,seq82,r_142_68_174,0.51,1,175,174,36
95,seq121,seq45,r_58_148_13,r_58_148_13,1.0,0,13,13,36
25,r_140_46_182,r_5_55_150,r_37_144_81,r_37_144_81,0.99,69,150,81,36
43,r_54_50_70,r_17_149_227,r_107_83_215,r_54_50_70,0.67,145,215,70,36
33,r_47_88_218,seq81,r_6_40_63,r_47_88_218,0.43,0,218,218,36
70,seq57,r_60_72_112,r_14_138_86,r_60_72_112,0.9,-1,111,112,36
20,r_74_69_40,r_128_146_181,r_89_28_105,r_128_146_181,0.65,0,181,181,36
32,r_61_132_211,r_107_83_215,seq75,r_61_132_211,0.68,0,211,211,36
34,r_106_43_235,r_15_133_61,r_12_99_3,r_15_133_61,0.97,0,61,61,36
8,r_23_105_58,r_86_143_95,seq3,r_23_105_58,0.51,0,58,58,36
17,r_118_13_108,seq44,r_86_143_95,r_118_13_108,1.0,0,108,108,36
9,r_5_55_150,r_140_46_182,seq65,r_5_55_150,0.99,0,150,150,36
31,r_125_4_136,r_137_21_225,r_95_141_151,r_125_4_136,0.44,89,225,136,36
22,r_10_63_98,r_89_28_105,seq7,r_10_63_98,1.0,0,98,98,36
28,r_25_19_129,seq119,seq45,r_25_19_129,0.95,0,129,129,36
7,r_62_145_36,r_126_41_60,seq135,r_62_145_36,0.98,0,36,36,36
49,r_95_141_151,seq124,r_125_4_136,r_95_141_151,0.97,0,151,151,36
72,seq65,seq44,r_5_55_150,r_5_55_150,0.98,8,158,150,36
56,seq9,r_1_130_125,seq117,r_1_130_125,0.99,-42,83,125,36
44,r_66_98_76,r_60_72_112,seq123,r_66_98_76,1.0,0,76,76,36
35,r_126_41_60,seq109,seq7,r_126_41_60,1.0,0,60,60,36
3,r_86_143_95,r_23_105_58,r_58_148_13,r_23_105_58,0.84,-20,38,58,36
30,r_141_133_64,r_16_127_159,seq130,r_141_133_64,1.0,0,64,64,37
8,r_74_95_85,r_140_104_82,r_85_86_74,r_74_95_85,0.98,-3,82,85,37
43,r_42_94_222,r_52_101_160,seq114,r_52_101_160,0.93,0,160,160,37
42,r_100_137_28,r_52_101_160,seq27,r_100_137_28,0.98,-2,26,28,37
0,r_146_90_27,seq54,r_85_86_74,r_146_90_27,0.99,0,27,27,37
37,r_105_17_191,seq89,seq18,r_105_17_191,0.95,0,191,191,37
3,r_13_106_121,seq109,r_146_90_27,r_13_106_121,0.99,2,123,121,37
59,seq145,r_118_2_181,seq72,r_118_2_181,0.99,3,184,181,37
21,r_96_120_91,r_9_45_237,seq124,r_96_120_91,0.94,0,91,91,37
39,r_33_149_189,seq72,r_67_60_78,r_67_60_78,0.7,114,192,78,37
5,r_93_129_118,r_113_46_216,seq41,r_93_129_118,0.83,0,118,118,37
24,r_88_139_234,r_44_26_210,seq145,r_88_139_234,0.88,0,234,234,37
2,r_28_97_34,seq54,r_102_103_111,r_28_97_34,1.0,1,35,34,37
24,r_88_139_234,r_76_66_23,r_44_26_210,r_88_139_234,0.4,-11,223,234,37
95,seq116,r_44_26_210,r_135_61_120,r_135_61_120,1.0,90,210,120,37
45,r_44_26_210,r_88_139_234,r_76_66_23,r_88_139_234,0.83,0,234,234,37
41,r_50_121_83,seq89,r_146_90_27,r_50_121_83,0.99,1,84,83,37
20,r_102_103_111,seq12,r_28_97_34,r_28_97_34,1.0,8,42,34,37
3,r_13_106_121,r_76_66_23,seq109,r_76_66_23,0.55,0,23,23,37
36,r_113_46_216,r_93_129_118,r_99_57_14,r_113_46_216,0.8,-190,26,216,37
14,r_76_66_23,r_88_139_234,r_44_26_210,r_76_66_23,0.42,211,234,23,37
4,r_140_104_82,r_74_95_85,seq30,r_140_104_82,1.0,0,82,82,37
26,r_99_57_14,r_63_147_59,r_113_46_216,r_99_57_14,0.99,0,14,14,37
11,r_63_147_59,r_39_80_240,seq65,r_63_147_59,1.0,3,62,59,37
13,r_22_143_86,r_71_144_199,seq6,r_22_143_86,1.0,1,87,86,37
48,r_52_101_160,r_42_94_222,seq65,r_52_101_160,0.62,0,160,160,37
35,r_134_59_16,seq10,r_135_61_120,r_134_59_16,0.94,0,16,16,37
31,r_123_131_13,r_44_26_210,r_22_143_86,r_123_131_13,0.9,0,13,13,37
6,r_81_75_92,r_9_45_237,seq43,r_81_75_92,1.0,0,92,92,37
2,r_28_97_34,r_102_103_111,seq12,r_102_103_111,0.95,1,112,111,37
0,r_146_90_27,r_85_86_74,r_13_106_121,r_13_106_121,1.0,30,151,121,37
36,r_113_46_216,r_99_57_14,r_0_49_101,r_0_49_101,0.59,115,216,101,37
47,r_1_15_35,r_16_127_159,r_107_4_56,r_107_4_56,0.98,5,61,56,37
29,r_135_61_120,r_134_59_16,seq116,r_135_61_120,0.91,2,122,120,37
24,r_88_139_234,r_83_55_52,r_76_66_23,r_88_139_234,0.94,-205,29,234,37
35,r_134_59_16,r_135_61_120,r_87_110_123,r_134_59_16,0.81,119,135,16,37
25,r_67_60_78,r_33_149_189,seq64,r_67_60_78,0.64,7,85,78,37
43,r_42_94_222,seq114,r_52_101_160,r_42_94_222,0.91,0,222,222,37
12,r_115_20_39,seq38,seq36,r_115_20_39,1.0,0,39,39,37
19,r_107_4_56,r_33_149_189,r_1_15_35,r_107_4_56,1.0,0,56,56,37
64,seq30,r_9_45_237,r_140_104_82,r_140_104_82,1.0,8,90,82,37
47,r_1_15_35,r_107_4_56,r_87_110_123,r_87_110_123,1.0,7,130,123,37
14,r_76_66_23,r_13_106_121,r_88_139_234,r_76_66_23,0.95,0,23,23,37
20,r_102_103_111,r_28_97_34,r_0_49_101,r_102_103_111,0.99,1,112,111,37
32,r_85_86_74,seq21,seq14,r_85_86_74,0.63,-9,65,74,37
38,r_118_2_181,seq145,r_99_57_14,r_118_2_181,0.89,3,184,181,37
52,seq132,r_9_45_237,seq91,r_9_45_237,0.88,-61,176,237,37
77,seq64,r_71_144_199,r_67_60_78,r_67_60_78,0.89,121,199,78,37
35,r_134_59_16,r_87_110_123,r_119_31_7,r_134_59_16,0.26,195,211,16,37
34,r_40_79_94,r_113_46_216,r_100_137_28,r_113_46_216,0.72,-124,92,216,37
75,seq56,r_16_127_159,seq35,r_16_127_159,0.47,8,167,159,37
81,seq72,r_33_149_189,seq145,r_33_149_189,0.96,3,192,189,37
17,r_24_138_239,seq91,r_67_60_78,r_24_138_239,0.42,0,239,239,37
94,seq114,r_42_94_222,r_67_60_78,r_67_60_78,1.0,144,222,78,37
26,r_99_57_14,r_113_46_216,r_83_55_52,r_83_55_52,1.0,164,216,52,37
31,r_123_131_13,r_22_143_86,r_67_60_78,r_123_131_13,1.0,75,88,13,37
33,r_39_80_240,r_63_147_59,r_1_15_35,r_63_147_59,1.0,-12,47,59,37
7,r_83_55_52,r_88_139_234,r_99_57_14,r_83_55_52,0.98,1,53,52,37
28,r_128_8_89,seq18,r_85_86_74,r_128_8_89,1.0,0,89,89,37
91,seq109,r_13_106_121,r_0_49_101,r_13_106_121,0.81,3,124,121,37
49,r_9_45_237,seq132,r_115_20_39,r_115_20_39,0.89,198,237,39,37
44,r_53_48_161,seq32,seq130,r_53_48_161,0.93,2,163,161,37
23,r_87_110_123,seq27,r_1_15_35,r_87_110_123,1.0,0,123,123,37
30,r_89_130_187,seq5,seq0,r_89_130_187,0.94,0,187,187,38
38,r_10_38_46,r_75_27_154,seq139,r_10_38_46,1.0,0,46,46,38
51,seq128,r_75_27_154,seq84,r_75_27_154,1.0,4,158,154,38
36,r_64_29_175,r_54_56_240,seq32,r_64_29_175,0.62,8,183,175,38
9,r_82_112_163,r_80_4_75,seq101,r_82_112_163,0.99,-1,162,163,38
8,r_75_27_154,seq128,r_93_120_218,r_75_27_154,0.76,4,158,154,38
43,r_129_23_177,r_34_14_70,r_40_62_36,r_34_14_70,1.0,-7,63,70,38
37,r_110_7_186,seq68,r_108_6_134,r_110_7_186,0.56,1,187,186,38
59,seq145,seq106,r_87_126_101,r_87_126_101,1.0,26,127,101,38
21,r_28_111_87,r_94_125_193,seq133,r_28_111_87,0.98,0,87,87,38
39,r_19_96_211,seq68,seq11,r_19_96_211,0.7,0,211,211,38
2,r_124_59_40,r_80_4_75,seq32,r_124_59_40,0.55,37,77,40,38
1,r_94_125_193,r_146_8_243,r_44_1_135,r_94_125_193,0.47,1,194,193,38
25,r_57_92_16,r_108_6_134,r_93_120_218,r_57_92_16,0.97,0,16,16,38
5,r_48_9_162,seq53,seq95,r_48_9_162,0.98,0,162,162,38
46,r_93_120_218,seq63,r_75_27_154,r_75_27_154,0.96,47,201,154,38
42,r_108_6_134,r_137_135_165,seq30,r_108_6_134,0.55,1,135,134,38
32,r_77_98_220,r_79_78_111,r_55_103_133,r_77_98_220,0.82,4,224,220,38
19,r_18_104_146,seq26,r_44_1_135,r_18_104_146,0.82,2,148,146,38
32,r_77_98_220,r_132_116_26,r_79_78_111,r_79_78_111,0.99,9,120,111,38
95,seq114,r_25_49_202,r_100_85_63,r_100_85_63,1.0,141,204,63,38
89,seq95,seq16,r_48_9_162,r_48_9_162,1.0,2,164,162,38
3,r_31_70_120,r_148_74_212,seq67,r_31_70_120,0.97,2,122,120,38
0,r_51_136_17,r_18_104_146,seq35,r_51_136_17,0.88,0,17,17,38
26,r_22_140_109,seq12,r_87_126_101,r_22_140_109,1.0,0,109,109,38
24,r_21_142_116,r_51_136_17,r_44_1_135,r_44_1_135,0.92,13,148,135,38
4,r_44_1_135,seq67,r_21_142_116,r_44_1_135,0.99,-1,134,135,38
78,seq61,seq73,r_34_14_70,r_34_14_70,1.0,8,78,70,38
63,seq30,seq72,r_108_6_134,r_108_6_134,1.0,2,136,134,38
11,r_46_113_138,seq3,seq99,r_46_113_138,0.99,0,138,138,38
48,r_132_116_26,r_82_112_163,seq134,r_132_116_26,1.0,0,26,26,38
98,seq121,r_82_112_163,r_80_4_75,r_80_4_75,0.97,50,125,75,38
13,r_40_62_36,r_94_125_193,r_122_149_245,r_40_62_36,0.98,1,37,36,38
2,r_124_59_40,seq139,r_80_4_75,r_124_59_40,0.85,1,41,40,38
6,r_13_45_136,seq61,seq5,r_13_45_136,0.69,-10,126,136,38
62,seq26,r_18_104_146,r_71_33_13,r_18_104_146,0.82,2,148,146,38
20,r_81_66_48,r_82_112_163,seq63,r_81_66_48,1.0,0,48,48,38
27,r_54_56_240,r_64_29_175,seq15,r_64_29_175,0.97,0,175,175,38
47,r_37_127_217,seq63,r_143_88_103,r_37_127_217,0.46,-132,85,217,38
40,r_118_90_74,r_18_104_146,seq60,r_18_104_146,0.75,-71,75,146,38
74,seq52,r_109_97_222,r_55_103_133,r_55_103_133,0.95,89,222,133,38
18,r_141_86_119,seq99,seq47,r_141_86_119,0.99,0,119,119,38
29,r_137_135_165,seq115,r_44_1_135,r_137_135_165,0.99,0,165,165,38
43,r_129_23_177,r_40_62_36,seq61,r_129_23_177,0.96,0,177,177,38
33,r_87_126_101,r_82_112_163,seq145,r_87_126_101,1.0,0,101,101,38
66,seq35,seq12,r_51_136_17,r_51_136_17,1.0,0,17,17,38
47,r_37_127_217,r_143_88_103,r_40_62_36,r_143_88_103,0.54,114,217,103,38
31,r_131_147_45,r_55_103_133,seq12,r_131_147_45,1.0,1,46,45,38
68,seq139,r_25_49_202,r_10_38_46,r_10_38_46,0.96,79,125,46,38
32,r_77_98_220,r_100_85_63,r_132_116_26,r_77_98_220,0.53,-157,63,220,38
52,seq3,r_46_113_138,r_71_33_13,r_46_113_138,0.99,0,138,138,38
34,r_138_2_227,seq32,r_71_33_13,r_71_33_13,0.41,215,228,13,38
45,r_122_149_245,r_34_14_70,r_40_62_36,r_34_14_70,0.55,-29,41,70,38
17,r_143_88_103,r_148_74_212,r_37_127_217,r_143_88_103,0.57,8,111,103,38
94,seq107,r_34_14_70,r_40_62_36,r_34_14_70,0.95,2,72,70,38
9,r_82_112_163,r_87_126_101,r_80_4_75,r_82_112_163,0.97,-62,101,163,38
28,r_79_78_111,r_77_98_220,r_25_49_202,r_79_78_111,0.8,103,214,111,38
22,r_55_103_133,seq24,seq53,r_55_103_133,1.0,0,133,133,38
28,r_79_78_111,seq63,r_77_98_220,r_79_78_111,1.0,0,111,111,38
49,r_80_4_75,r_21_142_116,seq24,r_80_4_75,0.99,1,76,75,38
7,r_100_85_63,r_77_98_220,r_10_38_46,r_100_85_63,1.0,0,63,63,38
44,r_25_49_202,seq114,seq61,r_25_49_202,0.82,2,204,202,38
17,r_143_88_103,r_37_127_217,r_75_27_154,r_143_88_103,0.82,114,217,103,38
82,seq68,r_19_96_211,seq20,r_19_96_211,0.7,0,211,211,38
79,seq63,r_93_120_218,r_57_92_16,r_57_92_16,0.99,157,173,16,38
18,r_141_86_119,seq47,r_71_33_13,r_141_86_119,0.55,42,161,119,38
35,r_34_14_70,seq107,seq61,r_34_14_70,1.0,1,71,70,38
41,r_97_96_1,r_144_146_27,r_109_120_17,r_97_96_1,0.52,16,17,1,39
14,r_61_18_148,seq16,seq14,r_61_18_148,0.58,1,149,148,39
8,r_59_134_177,r_107_28_218,r_72_20_138,r_59_134_177,0.67,0,177,177,39
43,r_73_69_163,r_138_132_55,seq51,r_73_69_163,0.91,0,163,163,39
13,r_115_147_105,seq145,r_124_91_153,r_124_91_153,1.0,-1,152,153,39
17,r_100_139_25,r_13_70_14,seq84,r_13_70_14,0.46,61,75,14,39
37,r_47_19_190,seq95,seq130,r_47_19_190,0.43,1,191,190,39
59,seq16,r_79_57_88,r_10_78_56,r_79_57_88,1.0,-11,77,88,39
16,r_32_25_120,seq130,seq145,r_32_25_120,0.83,0,120,120,39
21,r_9_46_171,seq106,seq94,r_9_46_171,0.72,1,172,171,39
1,r_3_40_102,seq51,r_33_35_11,r_3_40_102,0.93,-3,99,102,39
97,seq116,r_115_147_105,r_108_127_29,r_115_147_105,0.68,-14,91,105,39
5,r_114_143_214,seq110,r_101_126_158,r_101_126_158,0.78,57,215,158,39
4,r_27_121_59,seq11,seq58,r_27_121_59,1.0,0,59,59,39
12,r_44_140_209,r_34_88_159,seq51,r_44_140_209,0.9,0,209,209,39
42,r_10_78_56,r_67_129_154,seq16,r_67_129_154,0.99,-99,55,154,39
45,r_123_77_101,seq2,seq49,r_123_77_101,1.0,0,101,101,39
19,r_141_118_242,r_44_140_209,r_34_88_159,r_34_88_159,0.74,50,209,159,39
38,r_107_28_218,r_6_149_181,r_123_77_101,r_107_28_218,0.99,0,218,218,39
29,r_105_8_38,r_47_19_190,seq116,r_105_8_38,1.0,0,38,38,39
76,seq64,seq2,r_67_129_154,r_67_129_154,1.0,3,157,154,39
97,seq116,r_108_127_29,r_92_15_8,r_108_127_29,0.64,122,151,29,39
39,r_80_37_194,r_63_56_6,seq49,r_80_37_194,0.9,0,194,194,39
47,r_144_146_27,r_97_96_1,seq75,r_144_146_27,1.0,1,28,27,39
3,r_117_99_63,seq130,seq93,r_117_99_63,0.97,0,63,63,39
10,r_67_129_154,seq71,seq64,r_67_129_154,0.99,0,154,154,39
26,r_45_113_145,seq4,r_141_118_242,r_45_113_145,0.99,4,149,145,39
15,r_108_127_29,r_45_113_145,seq106,r_45_113_145,0.43,-126,19,145,39
73,seq51,r_3_40_102,r_23_54_235,r_3_40_102,0.73,-5,97,102,39
11,r_72_20_138,seq75,seq49,r_72_20_138,1.0,3,141,138,39
30,r_33_35_11,r_22_55_179,seq95,r_33_35_11,0.98,0,11,11,39
48,r_6_149_181,seq95,r_107_28_218,r_6_149_181,0.67,0,181,181,39
36,r_109_120_17,r_23_54_235,r_97_96_1,r_109_120_17,0.88,0,17,17,39
13,r_115_147_105,r_92_15_8,seq145,r_115_147_105,1.0,0,105,105,39
6,r_34_88_159,seq39,r_45_113_145,r_34_88_159,0.9,0,159,159,39
27,r_136_111_78,r_3_40_102,seq90,r_136_111_78,0.73,1,79,78,39
96,seq110,r_114_143_214,r_103_89_37,r_103_89_37,1.0,1,38,37,39
91,seq94,seq84,r_9_46_171,r_9_46_171,1.0,5,176,171,39
2,r_52_17_92,r_107_28_218,r_144_146_27,r_52_17_92,1.0,0,92,92,39
40,r_101_126_158,r_47_19_190,r_105_8_38,r_47_19_190,0.93,-32,158,190,39
25,r_13_70_14,r_117_99_63,r_137_148_46,r_117_99_63,0.49,-50,13,63,39
24,r_23_54_235,seq51,r_61_18_148,r_61_18_148,0.68,88,236,148,39
50,seq2,r_123_77_101,seq133,r_123_77_101,1.0,-8,93,101,39
70,seq48,r_22_55_179,seq29,r_22_55_179,1.0,0,179,179,39
20,r_103_89_37,r_21_0_187,seq110,r_103_89_37,1.0,1,38,37,39
38,r_107_28_218,r_59_134_177,r_6_149_181,r_107_28_218,0.67,-41,177,218,39
0,r_98_76_43,r_67_129_154,r_97_96_1,r_98_76_43,1.0,-1,42,43,39
48,r_6_149_181,r_107_28_218,r_138_132_55,r_107_28_218,0.98,0,218,218,39
34,r_128_43_197,r_44_140_209,seq131,r_44_140_209,0.77,-12,197,209,39
9,r_22_55_179,seq48,seq75,r_22_55_179,0.7,0,179,179,39
33,r_112_66_51,r_23_54_235,r_92_15_8,r_112_66_51,1.0,1,52,51,39
31,r_63_56_6,r_80_37_194,r_125_24_100,r_125_24_100,0.98,65,165,100,39
28,r_92_15_8,r_115_147_105,r_112_66_51,r_92_15_8,1.0,97,105,8,39
29,r_105_8_38,seq116,r_101_126_158,r_101_126_158,0.98,3,161,158,39
22,r_79_57_88,seq16,seq14,r_79_57_88,0.98,0,88,88,39
7,r_21_0_187,seq85,r_103_89_37,r_103_89_37,0.72,151,188,37,39
44,r_53_1_72,r_114_143_214,seq29,r_53_1_72,0.97,0,72,72,39
23,r_5_31_132,r_59_134_177,r_3_40_102,r_3_40_102,0.53,30,132,102,39
17,r_100_139_25,r_10_78_56,r_13_70_14,r_100_139_25,0.9,0,25,25,39
79,seq71,r_67_129_154,seq4,r_67_129_154,1.0,-23,131,154,39
35,r_125_24_100,seq84,r_63_56_6,r_125_24_100,1.0,0,100,100,39
12,r_44_140_209,r_128_43_197,r_34_88_159,r_34_88_159,0.9,38,197,159,39
46,r_137_148_46,r_6_149_181,r_13_70_14,r_6_149_181,0.79,-135,46,181,39
93,seq106,r_16_55_132,r_109_63_61,r_109_63_61,0.58,27,88,61,40
36,r_113_61_232,seq127,r_102_62_152,r_113_61_232,0.47,0,232,232,40
43,r_40_72_67,r_52_97_209,r_87_103_178,r_40_72_67,0.92,0,67,67,40
54,seq9,r_130_73_206,r_66_93_76,r_66_93_76,0.91,130,206,76,40
37,r_146_42_142,seq10,seq31,r_146_42_142,0.49,0,142,142,40
3,r_2_59_224,seq19,r_44_80_86,r_2_59_224,0.56,0,224,224,40
16,r_119_30_54,r_128_49_58,seq37,r_119_30_54,0.78,4,58,54,40
21,r_76_6_198,seq68,r_35_46_65,r_76_6_198,0.68,2,200,198,40
1,r_3_137_73,r_47_1_138,r_128_49_58,r_47_1_138,0.46,-64,74,138,40
97,seq122,r_0_22_149,seq4,r_0_22_149,0.97,-20,129,149,40
46,r_52_97_209,seq31,seq41,r_52_97_209,0.84,0,209,209,40
42,r_141_43_122,r_16_55_132,seq51,r_141_43_122,0.92,0,122,122,40
39,r_13_148_24,seq95,r_119_30_54,r_13_148_24,0.85,0,24,24,40
9,r_109_63_61,r_18_133_63,r_145_48_17,r_145_48_17,0.6,0,17,17,40
10,r_56_85_43,seq132,r_13_148_24,r_56_85_43,0.92,3,46,43,40
95,seq116,r_129_131_227,r_7_28_41,r_7_28_41,0.73,31,72,41,40
78,seq79,seq114,r_23_45_80,r_23_45_80,1.0,1,81,80,40
31,r_75_134_191,seq5,r_18_133_63,r_75_134_191,0.88,0,191,191,40
12,r_128_49_58,seq17,r_3_137_73,r_3_137_73,1.0,3,76,73,40
15,r_99_32_51,seq8,seq5,r_99_32_51,1.0,0,51,51,40
3,r_2_59_224,r_35_46_65,seq19,r_35_46_65,1.0,0,65,65,40
26,r_142_70_171,r_87_103_178,r_18_133_63,r_87_103_178,0.89,-6,172,178,40
72,seq65,r_129_131_227,r_7_28_41,r_7_28_41,0.51,45,86,41,40
4,r_102_62_152,r_67_112_175,r_87_103_178,r_102_62_152,0.87,2,154,152,40
0,r_123_36_121,r_2_59_224,r_57_149_96,r_123_36_121,0.99,-4,117,121,40
73,seq139,seq140,r_33_111_163,r_33_111_163,0.99,0,163,163,40
11,r_25_24_168,seq12,r_141_43_122,r_25_24_168,0.88,0,168,168,40
39,r_13_148_24,r_119_30_54,r_56_85_43,r_119_30_54,0.94,4,58,54,40
13,r_118_26_186,seq15,r_57_149_96,r_118_26_186,0.83,2,188,186,40
30,r_71_21_118,seq19,r_16_55_132,r_16_55_132,0.98,18,150,132,40
48,r_66_93_76,r_115_136_145,seq68,r_66_93_76,1.0,2,78,76,40
57,seq12,r_25_24_168,r_56_85_43,r_25_24_168,0.84,0,168,168,40
6,r_105_121_78,r_113_61_232,r_40_72_67,r_105_121_78,1.0,0,78,78,40
38,r_78_14_164,r_25_24_168,seq19,r_25_24_168,0.81,-63,105,168,40
20,r_147_107_14,r_78_14_164,seq58,r_147_107_14,0.97,0,14,14,40
8,r_7_28_41,seq37,seq20,r_7_28_41,0.96,0,41,41,40
27,r_115_136_145,seq20,seq92,r_115_136_145,0.94,0,145,145,40
42,r_141_43_122,seq51,r_25_24_168,r_25_24_168,1.0,8,176,168,40
87,seq94,r_39_53_197,r_87_103_178,r_39_53_197,0.88,0,197,197,40
9,r_109_63_61,r_145_48_17,seq106,r_109_63_61,1.0,0,61,61,40
49,r_145_48_17,r_109_63_61,r_57_149_96,r_145_48_17,0.56,44,61,17,40
2,r_74_101_176,seq81,r_23_45_80,r_23_45_80,0.65,96,176,80,40
47,r_60_144_83,r_39_53_197,r_3_137_73,r_60_144_83,0.8,0,83,83,40
40,r_0_22_149,seq122,r_124_108_57,r_0_22_149,0.99,0,149,149,40
18,r_18_133_63,r_35_46_65,seq127,r_18_133_63,1.0,-1,62,63,40
29,r_91_120_203,seq50,seq125,r_91_120_203,0.76,0,203,203,40
35,r_35_46_65,r_91_120_203,r_76_6_198,r_35_46_65,0.54,134,199,65,40
25,r_64_29_103,r_91_120_203,seq20,r_64_29_103,0.98,-4,99,103,40
33,r_23_45_80,r_74_101_176,seq79,r_23_45_80,0.67,0,80,80,40
24,r_90_110_25,seq79,seq69,r_90_110_25,0.93,1,26,25,40
50,seq4,r_71_21_118,seq122,r_71_21_118,1.0,0,118,118,40
58,seq15,r_118_26_186,seq117,r_118_26_186,1.0,2,188,186,40
49,r_145_48_17,seq11,r_109_63_61,r_145_48_17,0.51,0,17,17,40
38,r_78_14_164,seq19,seq81,r_78_14_164,1.0,0,164,164,40
32,r_47_1_138,r_146_42_142,seq11,r_47_1_138,0.96,0,138,138,40
38,r_78_14_164,r_123_36_121,r_25_24_168,r_25_24_168,0.66,-87,81,168,40
34,r_57_149_96,seq20,r_145_48_17,r_57_149_96,0.86,1,97,96,40
60,seq19,r_2_59_224,seq27,r_2_59_224,0.64,0,224,224,40
17,r_54_126_234,seq94,r_118_26_186,r_118_26_186,0.9,48,234,186,40
22,r_143_38_180,seq34,r_99_32_51,r_143_38_180,0.84,0,180,180,40
28,r_130_73_206,seq9,r_71_21_118,r_71_21_118,0.98,88,206,118,40
12,r_128_49_58,r_119_30_54,seq17,r_128_49_58,1.0,0,58,58,40
56,seq11,seq125,r_47_1_138,r_47_1_138,1.0,15,153,138,40
7,r_129_131_227,seq65,r_0_22_149,r_129_131_227,0.67,0,227,227,40
44,r_33_111_163,seq9,seq139,r_33_111_163,0.99,0,163,163,40
79,seq81,r_74_101_176,r_78_14_164,r_74_101_176,0.69,0,176,176,40
35,r_35_46_65,r_2_59_224,r_91_120_203,r_35_46_65,1.0,0,65,65,40
30,r_23_125_126,r_47_68_220,seq81,r_23_125_126,0.99,3,129,126,41
44,r_147_128_200,r_132_97_105,r_36_137_124,r_147_128_200,0.98,0,200,200,41
9,r_56_92_26,seq41,r_138_62_111,r_138_62_111,0.58,0,111,111,41
14,r_77_67_238,r_104_149_201,r_78_107_35,r_78_107_35,1.0,26,61,35,41
8,r_138_62_111,seq41,r_56_92_26,r_56_92_26,0.99,85,111,26,41
43,r_115_135_60,r_63_109_175,r_40_130_8,r_115_135_60,1.0,1,61,60,41
21,r_54_121_76,seq17,r_106_1_216,r_54_121_76,0.91,0,76,76,41
5,r_7_37_133,r_119_4_243,seq35,r_7_37_133,1.0,0,133,133,41
42,r_63_109_175,seq123,r_18_86_142,r_18_86_142,0.74,36,178,142,41
10,r_12_31_42,r_27_113_33,r_89_80_194,r_12_31_42,0.91,1,43,42,41
19,r_49_33_207,seq26,seq126,r_49_33_207,0.71,7,214,207,41
15,r_90_98_46,seq17,r_102_60_217,r_102_60_217,0.66,7,224,217,41
39,r_2_55_55,seq74,r_19_52_181,r_19_52_181,0.98,2,183,181,41
31,r_95_101_137,seq66,r_117_73_108,r_95_101_137,0.96,0,137,137,41
41,r_6_127_88,seq35,seq28,r_6_127_88,1.0,1,89,88,41
67,seq28,seq94,r_6_127_88,r_6_127_88,1.0,4,92,88,41
3,r_16_38_78,r_36_137_124,seq0,r_16_38_78,1.0,4,82,78,41
1,r_27_113_33,r_12_31_42,seq93,r_27_113_33,0.91,0,33,33,41
16,r_104_149_201,r_78_107_35,r_42_146_186,r_42_146_186,0.96,17,203,186,41
14,r_77_67_238,r_78_107_35,seq9,r_77_67_238,0.36,0,238,238,41
0,r_42_146_186,seq139,seq93,r_42_146_186,0.72,0,186,186,41
63,seq20,seq143,r_63_109_175,r_63_109_175,0.67,27,202,175,41
20,r_18_86_142,seq21,r_114_129_70,r_18_86_142,0.97,5,147,142,41
13,r_114_129_70,seq25,seq143,r_114_129_70,0.96,6,76,70,41
98,seq143,seq20,r_114_129_70,r_114_129_70,0.95,126,196,70,41
62,seq17,r_54_121_76,r_117_73_108,r_117_73_108,0.68,0,108,108,41
21,r_54_121_76,r_106_1_216,r_44_111_123,r_54_121_76,0.56,141,217,76,41
99,seq126,r_34_29_152,seq72,r_34_29_152,0.87,2,154,152,41
10,r_12_31_42,r_89_80_194,r_58_96_166,r_12_31_42,0.98,153,195,42,41
27,r_102_60_217,seq10,r_90_98_46,r_90_98_46,0.96,178,224,46,41
22,r_19_52_181,r_8_145_62,r_2_55_55,r_19_52_181,0.94,1,182,181,41
2,r_71_64_64,seq51,r_105_70_110,r_71_64_64,1.0,5,69,64,41
45,r_78_107_35,seq134,r_19_52_181,r_78_107_35,0.97,1,36,35,41
18,r_117_73_108,seq76,seq17,r_117_73_108,0.96,0,108,108,41
29,r_89_80_194,r_132_97_105,r_12_31_42,r_89_80_194,0.87,-89,105,194,41
16,r_104_149_201,r_77_67_238,r_78_107_35,r_78_107_35,1.0,2,37,35,41
35,r_132_97_105,r_147_128_200,seq35,r_147_128_200,1.0,0,200,200,41
33,r_100_88_65,seq20,seq82,r_100_88_65,1.0,0,65,65,41
88,seq85,r_8_145_62,r_83_142_30,r_8_145_62,0.7,0,62,62,41
23,r_32_13_10,r_83_142_30,seq72,r_32_13_10,0.96,0,10,10,41
68,seq35,r_147_128_200,seq110,r_147_128_200,0.97,-33,167,200,41
34,r_34_29_152,seq126,r_116_5_169,r_34_29_152,0.94,2,154,152,41
15,r_90_98_46,r_89_80_194,seq17,r_90_98_46,0.92,0,46,46,41
39,r_2_55_55,r_63_109_175,seq74,r_2_55_55,0.99,0,55,55,41
45,r_78_107_35,r_19_52_181,r_8_145_62,r_78_107_35,0.83,147,182,35,41
17,r_44_111_123,r_48_103_3,r_54_121_76,r_44_111_123,0.86,0,123,123,41
49,r_83_142_30,seq43,seq85,r_83_142_30,1.0,0,30,30,41
29,r_89_80_194,r_12_31_42,r_36_137_124,r_89_80_194,0.97,0,194,194,41
22,r_19_52_181,seq94,r_8_145_62,r_8_145_62,1.0,1,63,62,41
28,r_8_145_62,seq85,r_78_107_35,r_8_145_62,1.0,0,62,62,41
9,r_56_92_26,seq69,seq41,r_56_92_26,1.0,0,26,26,41
7,r_87_22_67,seq20,seq72,r_87_22_67,1.0,0,67,67,41
44,r_147_128_200,seq35,r_132_97_105,r_132_97_105,1.0,42,147,105,41
35,r_132_97_105,r_89_80_194,r_147_128_200,r_132_97_105,1.0,0,105,105,41
37,r_30_108_18,r_106_1_216,seq53,r_30_108_18,0.97,0,18,18,41
30,r_6_110_176,seq91,seq29,r_6_110_176,0.72,0,176,176,42
14,r_5_57_76,seq29,r_84_125_127,r_5_57_76,1.0,-1,75,76,42
1,r_149_17_222,seq40,r_59_99_32,r_59_99_32,1.0,0,32,32,42
3,r_27_2_11,seq115,r_30_96_171,r_30_96_171,1.0,3,174,171,42
59,seq24,seq91,r_9_86_20,r_9_86_20,0.91,220,240,20,42
3,r_27_2_11,r_75_144_154,seq115,r_27_2_11,0.99,0,11,11,42
19,r_30_96_171,r_138_35_6,r_27_2_11,r_30_96_171,0.99,1,172,171,42
16,r_18_37_153,r_6_110_176,r_111_55_44,r_18_37_153,0.96,0,153,153,42
25,r_3_41_43,r_145_32_131,seq63,r_3_41_43,1.0,-3,40,43,42
1,r_149_17_222,r_59_99_32,r_5_57_76,r_5_57_76,0.97,147,223,76,42
33,r_11_133_206,r_66_58_59,seq72,r_11_133_206,0.34,30,236,206,42
18,r_9_86_20,r_149_17_222,seq115,r_9_86_20,1.0,-2,18,20,42
31,r_25_134_117,r_30_96_171,seq40,r_25_134_117,1.0,0,117,117,42
41,r_34_103_157,seq53,seq105,r_34_103_157,0.94,4,161,157,42
36,r_66_58_59,seq72,r_113_107_90,r_113_107_90,1.0,3,93,90,42
89,seq100,r_128_95_151,r_42_83_88,r_42_83_88,0.89,27,115,88,42
90,seq105,seq73,r_34_103_157,r_34_103_157,0.97,12,169,157,42
26,r_48_45_218,r_43_44_237,r_88_143_191,r_48_45_218,0.58,0,218,218,42
34,r_111_55_44,seq26,r_20_118_111,r_20_118_111,0.71,1,112,111,42
14,r_5_57_76,r_84_125_127,r_149_17_222,r_149_17_222,0.58,-29,193,222,42
0,r_78_117_142,seq29,seq97,r_78_117_142,1.0,0,142,142,42
11,r_113_107_90,r_36_141_122,r_66_58_59,r_113_107_90,0.95,0,90,90,42
99,seq127,seq89,r_112_104_65,r_112_104_65,1.0,133,198,65,42
20,r_19_82_217,r_106_122_121,r_84_125_127,r_106_122_121,1.0,-6,115,121,42
13,r_88_143_191,seq21,r_7_61_4,r_88_143_191,0.92,1,192,191,42
46,r_22_16_230,r_7_61_4,r_27_2_11,r_27_2_11,0.44,219,230,11,42
76,seq69,seq105,r_94_23_13,r_94_23_13,0.98,0,13,13,42
15,r_33_102_80,seq124,seq29,r_33_102_80,1.0,0,80,80,42
48,r_112_104_65,r_22_16_230,r_75_144_154,r_112_104_65,1.0,0,65,65,42
49,r_75_144_154,r_112_104_65,seq97,r_75_144_154,0.98,0,154,154,42
6,r_14_60_114,seq64,seq124,r_14_60_114,1.0,2,116,114,42
9,r_39_12_49,seq13,seq129,r_39_12_49,0.55,-12,37,49,42
23,r_43_44_237,r_14_60_114,r_78_117_142,r_43_44_237,0.58,0,237,237,42
85,seq91,r_6_110_176,seq24,r_6_110_176,0.78,5,181,176,42
46,r_22_16_230,r_112_104_65,r_7_61_4,r_112_104_65,0.95,-25,40,65,42
38,r_94_23_13,r_90_77_95,seq69,r_94_23_13,0.93,0,13,13,42
27,r_36_141_122,r_6_110_176,r_7_61_4,r_6_110_176,0.53,-38,138,176,42
37,r_138_35_6,seq13,r_126_76_188,r_138_35_6,0.52,216,222,6,42
52,seq129,seq87,r_39_12_49,r_39_12_49,1.0,1,50,49,42
87,seq97,r_109_8_225,r_78_117_142,r_78_117_142,0.96,83,225,142,42
2,r_126_76_188,seq87,r_138_35_6,r_126_76_188,0.67,1,189,188,42
47,r_135_114_85,seq29,seq105,r_135_114_85,1.0,0,85,85,42
40,r_139_148_201,seq68,seq98,r_139_148_201,0.96,0,201,201,42
5,r_0_71_35,seq127,seq81,r_0_71_35,1.0,1,36,35,42
29,r_101_80_63,r_130_131_240,seq124,r_101_80_63,1.0,0,63,63,42
24,r_137_51_102,r_136_4_160,seq116,r_137_51_102,1.0,0,102,102,42
43,r_59_99_32,r_14_60_114,r_147_50_247,r_59_99_32,1.0,-1,31,32,42
35,r_136_4_160,r_84_125_127,r_59_99_32,r_136_4_160,0.84,0,160,160,42
99,seq127,r_0_71_35,seq89,r_0_71_35,1.0,-1,34,35,42
33,r_11_133_206,r_75_144_154,r_66_58_59,r_66_58_59,0.99,26,85,59,42
48,r_112_104_65,r_75_144_154,seq72,r_75_144_154,0.99,0,154,154,42
58,seq21,r_88_143_191,r_137_51_102,r_137_51_102,0.95,90,192,102,42
20,r_19_82_217,r_84_125_127,r_7_61_4,r_19_82_217,0.67,0,217,217,42
68,seq53,r_34_103_157,r_111_55_44,r_111_55_44,0.76,97,141,44,42
61,seq28,r_22_16_230,r_7_61_4,r_7_61_4,0.62,91,95,4,42
32,r_106_122_121,r_130_131_240,seq74,r_106_122_121,1.0,1,122,121,42
81,seq81,seq13,r_0_71_35,r_0_71_35,1.0,45,80,35,42
56,seq142,r_18_37_153,r_7_61_4,r_18_37_153,0.62,-114,39,153,42
55,seq13,seq81,r_138_35_6,r_138_35_6,0.95,22,28,6,42
37,r_138_35_6,r_30_96_171,seq13,r_30_96_171,0.99,1,172,171,42
22,r_84_125_127,r_109_8_225,r_3_41_43,r_3_41_43,1.0,101,144,43,42
34,r_111_55_44,r_130_131_240,seq26,r_111_55_44,0.96,0,44,44,42
28,r_130_131_240,seq63,r_25_134_117,r_25_134_117,1.0,123,240,117,42
49,r_75_144_154,seq93,r_112_104_65,r_112_104_65,1.0,16,81,65,42
7,r_20_118_111,r_145_32_131,r_111_55_44,r_111_55_44,1.0,71,115,44,42
23,r_43_44_237,r_48_45_218,r_14_60_114,r_14_60_114,1.0,104,218,114,42
36,r_66_58_59,r_130_131_240,seq72,r_66_58_59,0.99,0,59,59,42
35,r_136_4_160,r_137_51_102,r_84_125_127,r_137_51_102,1.0,-31,71,102,42
12,r_42_83_88,seq26,seq100,r_42_83_88,0.83,0,88,88,42
93,seq113,r_104_49_83,r_0_61_12,r_104_49_83,1.0,0,83,83,43
36,r_6_4_67,r_67_70_51,seq40,r_6_4_67,1.0,0,67,67,43
14,r_38_54_113,seq85,r_116_66_185,r_38_54_113,0.98,2,115,113,43
83,seq92,r_5_33_206,r_37_74_99,r_37_74_99,0.99,50,149,99,43
3,r_116_66_185,r_38_54_113,r_0_61_12,r_116_66_185,1.0,0,185,185,43
59,seq149,r_47_129_194,seq117,r_47_129_194,0.77,1,195,194,43
39,r_145_36_228,seq138,r_116_66_185,r_116_66_185,0.93,45,230,185,43
1,r_63_142_131,r_13_132_209,seq85,r_63_142_131,1.0,0,131,131,43
5,r_28_50_147,seq93,seq46,r_28_50_147,0.98,0,147,147,43
46,r_47_129_194,seq149,r_38_54_113,r_38_54_113,0.95,82,195,113,43
80,seq85,r_59_23_244,r_63_142_131,r_63_142_131,1.0,2,133,131,43
47,r_42_82_221,r_71_44_245,r_112_45_128,r_71_44_245,0.78,-23,222,245,43
69,seq43,r_79_127_216,r_71_44_245,r_79_127_216,0.8,0,216,216,43
18,r_29_39_45,seq146,seq147,r_29_39_45,1.0,0,45,45,43
45,r_48_12_232,seq96,r_86_144_191,r_48_12_232,0.34,0,232,232,43
19,r_104_49_83,seq113,seq102,r_104_49_83,1.0,0,83,83,43
11,r_0_61_12,r_52_98_225,r_116_66_185,r_116_66_185,0.85,40,225,185,43
31,r_99_135_202,r_120_53_158,r_141_118_172,r_99_135_202,0.85,-40,162,202,43
3,r_116_66_185,r_58_17_134,r_38_54_113,r_116_66_185,0.98,-63,122,185,43
10,r_139_76_166,seq85,r_1_103_154,r_139_76_166,0.78,0,166,166,43
26,r_56_83_123,seq72,seq101,r_56_83_123,0.98,1,124,123,43
48,r_51_97_89,r_116_66_185,r_112_45_128,r_51_97_89,0.94,43,132,89,43
4,r_86_144_191,r_79_127_216,r_37_74_99,r_86_144_191,0.73,0,191,191,43
0,r_112_45_128,seq117,r_51_97_89,r_51_97_89,0.63,39,128,89,43
73,seq138,r_95_24_196,r_77_94_36,r_77_94_36,0.79,162,198,36,43
20,r_141_118_172,seq101,r_99_135_202,r_99_135_202,0.57,-27,175,202,43
31,r_99_135_202,r_141_118_172,seq102,r_99_135_202,0.81,0,202,202,43
15,r_79_127_216,seq43,r_116_66_185,r_79_127_216,0.69,0,216,216,43
48,r_51_97_89,seq105,r_116_66_185,r_51_97_89,0.97,0,89,89,43
49,r_52_98_225,r_0_61_12,seq43,r_52_98_225,0.4,0,225,225,43
57,seq146,r_11_68_201,r_91_14_167,r_91_14_167,0.8,35,202,167,43
85,seq96,r_48_12_232,r_81_119_176,r_81_119_176,0.88,56,232,176,43
99,seq126,r_1_103_154,r_26_18_156,r_26_18_156,0.56,3,159,156,43
13,r_77_94_36,r_42_82_221,seq105,r_77_94_36,1.0,0,36,36,43
49,r_52_98_225,r_104_49_83,r_0_61_12,r_52_98_225,0.79,-213,12,225,43
2,r_5_33_206,seq92,seq15,r_5_33_206,0.71,0,206,206,43
47,r_42_82_221,r_89_73_212,r_71_44_245,r_89_73_212,0.83,-13,199,212,43
33,r_107_133_30,seq134,seq126,r_107_133_30,1.0,0,30,30,43
40,r_91_14_167,r_48_12_232,seq146,r_91_14_167,0.9,0,167,167,43
29,r_90_137_72,r_5_33_206,r_128_8_42,r_90_137_72,1.0,0,72,72,43
24,r_110_88_153,seq136,seq72,r_110_88_153,0.88,0,153,153,43
6,r_16_121_41,r_5_33_206,r_148_84_92,r_16_121_41,1.0,0,41,41,43
25,r_130_106_141,r_21_114_187,r_29_39_45,r_130_106_141,0.94,0,141,141,43
20,r_141_118_172,r_99_135_202,r_11_68_201,r_141_118_172,0.46,40,212,172,43
42,r_100_55_35,r_59_23_244,seq125,r_100_55_35,0.99,3,38,35,43
88,seq102,r_27_122_1,r_104_49_83,r_104_49_83,1.0,1,84,83,43
38,r_21_114_187,r_130_106_141,seq46,r_130_106_141,1.0,0,141,141,43
38,r_21_114_187,seq46,r_27_122_1,r_21_114_187,1.0,0,187,187,43
34,r_89_73_212,r_42_82_221,r_116_66_185,r_89_73_212,0.74,-1,211,212,43
43,r_148_84_92,seq147,r_128_8_42,r_128_8_42,1.0,12,54,42,43
17,r_95_24_196,seq138,r_112_45_128,r_95_24_196,0.96,2,198,196,43
9,r_11_68_201,seq146,r_62_64_70,r_62_64_70,0.87,132,202,70,43
11,r_0_61_12,r_139_76_166,r_52_98_225,r_0_61_12,0.78,0,12,12,43
28,r_62_64_70,r_145_36_228,seq80,r_62_64_70,1.0,1,71,70,43
44,r_65_140_171,seq19,seq111,r_65_140_171,0.99,0,171,171,43
21,r_128_8_42,seq34,r_148_84_92,r_128_8_42,1.0,0,42,42,43
23,r_81_119_176,seq22,r_6_4_67,r_81_119_176,0.84,0,176,176,43
35,r_58_17_134,r_116_66_185,r_128_8_42,r_58_17_134,0.97,0,134,134,43
12,r_120_53_158,r_26_18_156,r_37_74_99,r_37_74_99,1.0,78,177,99,43
74,seq147,r_148_84_92,r_29_39_45,r_29_39_45,1.0,1,46,45,43
27,r_120_17_44,r_11_106_226,seq134,r_120_17_44,1.0,0,44,44,44
9,r_89_144_72,r_32_128_47,r_102_23_111,r_102_23_111,1.0,24,135,111,44
14,r_147_140_119,r_119_135_153,r_126_84_118,r_147_140_119,0.54,0,119,119,44
43,r_91_71_148,seq29,seq73,r_91_71_148,0.9,0,148,148,44
54,seq9,r_89_144_72,seq85,r_89_144_72,1.0,1,73,72,44
37,r_65_148_209,r_126_84_118,r_30_98_38,r_65_148_209,0.99,-140,69,209,44
16,r_126_84_118,r_65_148_209,r_147_140_119,r_65_148_209,0.54,-90,119,209,44
39,r_47_112_100,seq66,seq14,r_47_112_100,0.96,0,100,100,44
1,r_38_58_67,r_11_106_226,seq93,r_11_106_226,0.78,-2,224,226,44
1,r_38_58_67,r_24_133_191,r_11_106_226,r_38_58_67,1.0,0,67,67,44
5,r_35_28_233,r_114_33_223,r_78_45_214,r_35_28_233,0.36,-14,219,233,44
85,seq86,r_103_96_33,r_11_106_226,r_103_96_33,1.0,-5,28,33,44
46,r_123_105_122,seq99,r_78_45_214,r_123_105_122,0.96,0,122,122,44
42,r_102_23_111,seq88,r_89_144_72,r_102_23_111,1.0,1,112,111,44
93,seq109,seq113,r_35_28_233,r_35_28_233,0.51,-150,83,233,44
45,r_145_39_172,seq97,r_103_96_33,r_103_96_33,0.87,142,175,33,44
30,r_116_82_21,r_103_96_33,seq132,r_116_82_21,1.0,0,21,21,44
8,r_129_108_27,seq132,r_92_83_241,r_129_108_27,1.0,0,27,27,44
62,seq26,r_50_22_74,r_16_146_158,r_50_22_74,0.59,-22,52,74,44
76,seq66,r_47_112_100,seq57,r_47_112_100,0.99,-19,81,100,44
33,r_103_96_33,seq86,seq85,r_103_96_33,1.0,0,33,33,44
31,r_16_146_158,seq85,seq97,r_16_146_158,0.61,9,167,158,44
36,r_56_51_32,r_34_55_77,seq64,r_56_51_32,0.69,0,32,32,44
3,r_119_135_153,r_147_140_119,r_44_68_49,r_44_68_49,0.87,70,119,49,44
90,seq97,r_145_39_172,r_147_140_119,r_147_140_119,1.0,49,168,119,44
4,r_10_107_114,r_63_31_164,seq26,r_63_31_164,0.65,-44,120,164,44
2,r_30_98_38,r_32_128_47,r_65_148_209,r_30_98_38,1.0,0,38,38,44
78,seq72,r_130_15_243,seq66,r_130_15_243,0.59,-136,107,243,44
0,r_54_94_69,r_78_45_214,r_129_108_27,r_54_94_69,1.0,-1,68,69,44
41,r_62_80_163,seq13,seq66,r_62_80_163,1.0,0,163,163,44
11,r_24_133_191,r_92_83_241,r_119_135_153,r_24_133_191,0.72,0,191,191,44
17,r_60_70_112,seq72,seq25,r_60_70_112,0.96,0,112,112,44
20,r_34_55_77,seq48,r_103_96_33,r_103_96_33,0.56,44,77,33,44
13,r_69_19_193,seq110,r_32_128_47,r_69_19_193,0.79,0,193,193,44
98,seq124,r_35_28_233,r_136_76_179,r_136_76_179,1.0,3,182,179,44
46,r_123_105_122,r_78_45_214,r_147_140_119,r_78_45_214,0.46,1,215,214,44
48,r_139_79_73,r_119_135_153,seq77,r_139_79_73,0.99,0,73,73,44
12,r_11_106_226,r_38_58_67,r_60_70_112,r_11_106_226,0.65,0,226,226,44
6,r_63_31_164,r_10_107_114,r_136_76_179,r_10_107_114,0.66,5,119,114,44
2,r_30_98_38,r_65_148_209,seq67,r_65_148_209,0.48,-22,187,209,44
34,r_136_76_179,r_69_19_193,seq124,r_136_76_179,0.97,0,179,179,44
10,r_111_115_55,r_74_20_95,r_101_121_11,r_111_115_55,0.85,-1,54,55,44
51,seq4,r_116_82_21,seq27,r_116_82_21,0.34,156,177,21,44
6,r_63_31_164,r_136_76_179,seq134,r_63_31_164,1.0,0,164,164,44
93,seq109,r_35_28_233,r_65_148_209,r_35_28_233,0.31,-14,219,233,44
40,r_21_143_94,r_138_95_197,r_74_20_95,r_21_143_94,1.0,1,95,94,44
74,seq134,r_41_42_236,r_63_31_164,r_63_31_164,1.0,33,197,164,44
61,seq25,seq9,r_60_70_112,r_60_70_112,0.6,-3,109,112,44
24,r_74_20_95,seq61,r_21_143_94,r_21_143_94,1.0,2,96,94,44
19,r_101_121_11,seq13,seq104,r_101_121_11,1.0,0,11,11,44
85,seq86,r_11_106_226,seq93,r_11_106_226,0.64,-52,174,226,44
32,r_41_42_236,r_74_20_95,r_62_80_163,r_62_80_163,0.91,73,236,163,44
76,seq66,seq57,r_138_95_197,r_138_95_197,0.53,18,215,197,44
15,r_32_128_47,r_35_28_233,seq117,r_32_128_47,0.99,0,47,47,44
75,seq64,r_53_142_231,r_56_51_32,r_56_51_32,0.97,0,32,32,44
81,seq77,r_8_122_113,r_139_79_73,r_139_79_73,0.76,0,73,73,44
5,r_35_28_233,r_78_45_214,r_131_127_183,r_78_45_214,0.54,19,233,214,44
28,r_78_45_214,r_123_105_122,seq13,r_78_45_214,0.79,1,215,214,44
9,r_89_144_72,seq9,r_32_128_47,r_89_144_72,0.9,0,72,72,44
37,r_65_148_209,r_30_98_38,r_69_19_193,r_65_148_209,0.57,0,209,209,44
21,r_44_68_49,seq25,r_3_7_1,r_44_68_49,1.0,0,49,49,44
22,r_8_122_113,seq5,r_74_20_95,r_8_122_113,1.0,0,113,113,44
28,r_78_45_214,r_54_94_69,seq14,r_78_45_214,0.72,-146,68,214,44
7,r_100_52_159,seq6,seq132,r_100_52_159,0.98,0,159,159,44
3,r_119_135_153,r_44_68_49,r_65_148_209,r_119_135_153,0.55,20,173,153,44
84,seq85,r_53_142_231,r_103_96_33,r_103_96_33,0.99,0,33,33,44
79,seq73,seq14,r_91_71_148,r_91_71_148,1.0,19,167,148,44
3,r_119_135_153,r_65_148_209,r_24_133_191,r_119_135_153,0.57,38,191,153,44
12,r_11_106_226,seq93,r_38_58_67,r_38_58_67,1.0,4,71,67,44
28,r_78_45_214,seq14,r_123_105_122,r_123_105_122,1.0,-1,121,122,44
61,seq25,r_44_68_49,seq9,r_44_68_49,1.0,0,49,49,44
52,seq6,r_65_15_217,r_57_138_30,r_57_138_30,1.0,1,31,30,45
14,r_84_134_92,seq114,seq67,r_84_134_92,1.0,1,93,92,45
8,r_124_104_168,seq96,seq88,r_124_104_168,0.93,2,170,168,45
53,seq7,r_121_97_221,r_124_104_168,r_124_104_168,0.96,54,222,168,45
43,r_145_4_158,r_87_110_5,r_34_131_57,r_34_131_57,1.0,7,64,57,45
37,r_100_102_87,r_5_132_236,r_55_95_4,r_100_102_87,0.94,0,87,87,45
86,seq88,seq7,r_124_104_168,r_124_104_168,0.98,0,168,168,45
16,r_89_17_101,r_112_148_211,seq12,r_89_17_101,1.0,0,101,101,45
21,r_39_133_15,r_41_37_213,seq61,r_41_37_213,1.0,-80,133,213,45
39,r_31_85_93,seq106,seq60,r_31_85_93,0.7,0,93,93,45
5,r_125_3_230,seq137,r_62_113_174,r_125_3_230,0.35,2,232,230,45
46,r_58_75_191,seq120,r_135_24_204,r_58_75_191,0.86,0,191,191,45
45,r_32_111_66,r_53_49_248,seq94,r_32_111_66,1.0,-1,65,66,45
19,r_41_37_213,r_39_133_15,seq21,r_41_37_213,0.95,0,213,213,45
11,r_62_113_174,seq88,r_51_44_19,r_62_113_174,0.52,-7,167,174,45
39,r_31_85_93,seq60,r_130_86_98,r_31_85_93,0.73,60,153,93,45
41,r_82_1_70,r_64_40_81,seq128,r_82_1_70,1.0,1,71,70,45
36,r_52_122_51,r_107_142_17,seq137,r_52_122_51,1.0,2,53,51,45
3,r_77_70_99,seq128,seq60,r_77_70_99,1.0,0,99,99,45
10,r_48_20_68,r_45_83_167,seq73,r_48_20_68,1.0,0,68,68,45
0,r_45_83_167,seq137,r_135_24_204,r_45_83_167,0.73,0,167,167,45
73,seq137,r_125_3_230,r_147_98_192,r_147_98_192,0.82,40,232,192,45
20,r_81_139_76,seq108,r_107_142_17,r_81_139_76,1.0,1,77,76,45
15,r_78_149_82,r_89_17_101,seq73,r_78_149_82,1.0,0,82,82,45
26,r_118_71_183,seq105,r_126_11_31,r_126_11_31,1.0,0,31,31,45
13,r_126_11_31,r_118_71_183,r_57_138_30,r_126_11_31,0.67,152,183,31,45
87,seq94,r_107_142_17,r_32_111_66,r_32_111_66,1.0,-1,65,66,45
9,r_47_117_52,r_87_110_5,seq114,r_47_117_52,1.0,1,53,52,45
11,r_62_113_174,r_34_131_57,seq88,r_34_131_57,1.0,0,57,57,45
47,r_64_40_81,seq68,seq108,r_64_40_81,1.0,0,81,81,45
18,r_87_110_5,r_145_4_158,r_34_131_57,r_34_131_57,0.69,80,137,57,45
29,r_10_27_233,seq23,r_124_104_168,r_124_104_168,1.0,65,233,168,45
24,r_147_98_192,r_5_132_236,r_52_122_51,r_147_98_192,0.65,0,192,192,45
13,r_126_11_31,r_53_49_248,r_118_71_183,r_126_11_31,1.0,0,31,31,45
43,r_145_4_158,r_34_131_57,seq79,r_145_4_158,1.0,1,159,158,45
2,r_57_138_30,r_52_122_51,seq6,r_57_138_30,0.99,0,30,30,45
33,r_116_92_159,r_5_132_236,r_77_70_99,r_116_92_159,0.99,0,159,159,45
88,seq96,r_124_104_168,r_48_20_68,r_48_20_68,0.82,102,170,68,45
6,r_34_131_57,r_145_4_158,r_87_110_5,r_145_4_158,1.0,1,159,158,45
20,r_81_139_76,r_107_142_17,r_93_66_120,r_93_66_120,1.0,50,170,120,45
61,seq19,r_5_132_236,r_57_138_30,r_57_138_30,0.96,206,236,30,45
32,r_112_148_211,seq8,r_46_90_146,r_46_90_146,0.97,65,211,146,45
75,seq60,seq42,r_77_70_99,r_77_70_99,1.0,22,121,99,45
59,seq16,r_81_139_76,r_0_36_7,r_81_139_76,0.61,-51,25,76,45
26,r_118_71_183,r_126_11_31,seq12,r_118_71_183,0.95,0,183,183,45
22,r_30_33_184,r_58_75_191,r_80_56_2,r_30_33_184,0.91,0,184,184,45
28,r_130_86_98,r_25_29_62,r_31_85_93,r_130_86_98,1.0,1,99,98,45
49,r_123_146_65,r_82_1_70,r_25_29_62,r_123_146_65,1.0,0,65,65,45
44,r_135_24_204,r_5_132_236,r_22_91_73,r_5_132_236,0.88,-28,208,236,45
6,r_34_131_57,r_62_113_174,r_145_4_158,r_34_131_57,1.0,0,57,57,45
35,r_46_90_146,r_112_148_211,seq50,r_46_90_146,0.87,0,146,146,45
30,r_35_13_60,r_6_85_173,r_144_110_3,r_35_13_60,0.95,3,63,60,46
44,r_3_139_115,seq61,r_144_110_3,r_3_139_115,0.4,76,191,115,46
8,r_92_11_144,r_12_9_126,r_25_5_7,r_92_11_144,0.52,-96,48,144,46
36,r_131_17_203,r_39_82_147,r_128_46_187,r_39_82_147,0.91,-10,137,147,46
14,r_41_14_217,seq149,seq20,r_41_14_217,0.66,0,217,217,46
43,r_147_23_90,seq34,r_75_74_46,r_147_23_90,1.0,0,90,90,46
54,seq136,r_134_113_233,r_24_121_64,r_24_121_64,1.0,172,236,64,46
83,seq76,r_69_120_125,seq64,r_69_120_125,1.0,0,125,125,46
3,r_75_74_46,r_43_51_149,r_147_23_90,r_75_74_46,0.98,104,150,46,46
19,r_24_121_64,r_95_126_174,seq136,r_95_126_174,1.0,0,174,174,46
16,r_114_116_237,r_19_117_123,r_24_121_64,r_114_116_237,0.76,-136,101,237,46
21,r_128_46_187,r_39_82_147,r_131_17_203,r_39_82_147,0.97,-10,137,147,46
1,r_140_104_93,r_88_56_136,seq20,r_88_56_136,0.46,-38,98,136,46
5,r_48_135_179,seq26,seq53,r_48_135_179,0.94,0,179,179,46
46,r_122_42_205,seq138,seq20,r_122_42_205,0.7,4,209,205,46
21,r_128_46_187,r_131_17_203,r_129_108_48,r_129_108_48,0.9,141,189,48,46
32,r_25_5_7,r_12_9_126,seq26,r_12_9_126,1.0,0,126,126,46
69,seq44,r_102_106_204,r_19_117_123,r_19_117_123,1.0,86,209,123,46
45,r_99_100_159,seq45,seq30,r_99_100_159,0.82,0,159,159,46
19,r_24_121_64,r_65_54_211,r_95_126_174,r_24_121_64,0.79,3,67,64,46
36,r_131_17_203,r_128_46_187,r_48_135_179,r_131_17_203,0.86,-24,179,203,46
66,seq34,r_147_23_90,seq119,r_147_23_90,1.0,0,90,90,46
38,r_39_82_147,r_143_37_244,r_102_106_204,r_102_106_204,1.0,5,209,204,46
31,r_143_37_244,r_6_85_173,r_75_74_46,r_75_74_46,0.57,127,173,46,46
37,r_101_62_116,r_12_9_126,r_25_5_7,r_25_5_7,0.65,41,48,7,46
26,r_65_54_211,seq20,r_88_56_136,r_88_56_136,0.34,75,211,136,46
8,r_92_11_144,r_25_5_7,seq76,r_92_11_144,0.98,1,145,144,46
16,r_114_116_237,r_24_121_64,r_81_94_96,r_24_121_64,0.33,173,237,64,46
4,r_118_0_154,r_145_79_236,r_31_4_88,r_31_4_88,0.89,9,97,88,46
0,r_95_126_174,r_114_116_237,seq105,r_95_126_174,0.93,0,174,174,46
63,seq26,r_48_135_179,r_25_5_7,r_48_135_179,0.76,-38,141,179,46
11,r_6_85_173,r_143_37_244,r_144_110_3,r_6_85_173,0.97,0,173,173,46
39,r_129_108_48,seq16,r_60_91_242,r_129_108_48,1.0,1,49,48,46
20,r_124_7_156,seq26,r_81_94_96,r_81_94_96,1.0,3,99,96,46
13,r_87_22_107,seq20,r_12_9_126,r_12_9_126,0.82,0,126,126,46
15,r_96_130_121,r_40_137_69,r_43_51_149,r_40_137_69,1.0,-1,68,69,46
4,r_118_0_154,r_31_4_88,seq103,r_118_0_154,1.0,0,154,154,46
27,r_8_57_124,seq30,seq72,r_8_57_124,0.93,5,129,124,46
79,seq67,seq16,r_89_112_188,r_89_112_188,0.95,7,195,188,46
2,r_144_110_3,r_60_91_242,r_35_13_60,r_35_13_60,1.0,6,66,60,46
41,r_59_27_25,r_102_106_204,r_19_117_123,r_19_117_123,0.97,7,130,123,46
47,r_81_94_96,seq49,r_124_7_156,r_81_94_96,1.0,1,97,96,46
18,r_40_137_69,r_96_130_121,r_129_108_48,r_40_137_69,0.7,0,69,69,46
29,r_148_80_61,seq109,seq103,r_148_80_61,1.0,0,61,61,46
24,r_43_51_149,r_6_85_173,seq64,r_43_51_149,0.89,1,150,149,46
47,r_81_94_96,r_25_5_7,r_114_116_237,r_114_116_237,0.96,1,238,237,46
25,r_50_78_238,seq123,r_114_116_237,r_114_116_237,0.85,3,240,237,46
64,seq30,r_8_57_124,seq15,r_8_57_124,0.6,-6,118,124,46
47,r_81_94_96,r_124_7_156,r_25_5_7,r_124_7_156,0.99,5,161,156,46
15,r_96_130_121,r_43_51_149,seq83,r_96_130_121,1.0,0,121,121,46
36,r_131_17_203,r_48_135_179,r_144_110_3,r_131_17_203,0.97,0,203,203,46
6,r_12_9_126,r_25_5_7,r_87_22_107,r_12_9_126,1.0,0,126,126,46
20,r_124_7_156,r_81_94_96,seq109,r_124_7_156,1.0,5,161,156,46
61,seq20,r_65_54_211,r_122_42_205,r_122_42_205,0.62,6,211,205,46
38,r_39_82_147,r_131_17_203,r_143_37_244,r_39_82_147,0.68,0,147,147,46
41,r_59_27_25,r_144_110_3,r_102_106_204,r_59_27_25,0.74,3,28,25,46
17,r_19_117_123,r_114_116_237,r_59_27_25,r_19_117_123,0.99,0,123,123,46
9,r_88_56_136,seq103,seq119,r_88_56_136,0.98,0,136,136,46
3,r_75_74_46,r_148_80_61,r_43_51_149,r_75_74_46,1.0,0,46,46,46
37,r_101_62_116,r_25_5_7,seq36,r_101_62_116,1.0,1,117,116,46
22,r_31_4_88,seq44,seq127,r_31_4_88,0.91,11,99,88,46
28,r_102_106_204,seq44,r_39_82_147,r_102_106_204,0.72,5,209,204,46
49,r_68_63_163,r_60_91_242,r_25_5_7,r_68_63_163,0.98,0,163,163,46
7,r_58_66_157,seq105,r_87_22_107,r_58_66_157,1.0,0,157,157,46
44,r_3_139_115,r_87_22_107,seq61,r_3_139_115,1.0,2,117,115,46
23,r_89_112_188,r_29_52_245,seq67,r_89_112_188,0.91,0,188,188,46
35,r_29_52_245,r_89_112_188,r_19_117_123,r_19_117_123,0.93,65,188,123,46
12,r_69_120_125,seq76,seq123,r_69_120_125,1.0,0,125,125,46
36,r_97_43_64,r_118_99_104,seq6,r_118_99_104,1.0,-34,70,104,47
48,r_127_35_219,r_1_146_62,r_119_122_22,r_127_35_219,0.96,-188,31,219,47
43,r_96_60_103,seq141,seq143,r_96_60_103,1.0,1,104,103,47
54,seq6,r_73_32_77,r_97_43_64,r_73_32_77,1.0,0,77,77,47
37,r_93_25_83,r_118_99_104,seq109,r_93_25_83,0.95,4,87,83,47
19,r_114_50_26,r_61_13_135,r_36_90_60,r_114_50_26,0.9,109,135,26,47
71,seq49,r_2_18_226,r_21_117_142,r_21_117_142,1.0,73,215,142,47
42,r_29_26_158,r_79_52_81,r_81_55_56,r_29_26_158,1.0,0,158,158,47
86,seq85,r_29_26_158,r_79_52_81,r_79_52_81,0.5,77,158,81,47
16,r_80_70_117,seq8,r_15_67_1,r_80_70_117,0.78,0,117,117,47
21,r_0_39_5,r_44_27_74,seq10,r_44_27_74,1.0,0,74,74,47
1,r_40_3_146,r_133_113_145,r_76_68_14,r_76_68_14,0.92,131,145,14,47
97,seq136,r_22_14_132,r_121_20_173,r_121_20_173,0.97,8,181,173,47
5,r_11_111_193,r_1_146_62,r_119_122_22,r_11_111_193,0.71,-128,65,193,47
42,r_29_26_158,seq85,r_79_52_81,r_79_52_81,1.0,33,114,81,47
7,r_76_68_14,seq24,r_40_3_146,r_40_3_146,1.0,4,150,146,47
32,r_148_91_32,seq33,seq5,r_148_91_32,0.99,1,33,32,47
11,r_119_122_22,r_126_75_140,r_127_35_219,r_119_122_22,0.69,0,22,22,47
11,r_119_122_22,r_127_35_219,r_125_38_59,r_125_38_59,0.96,161,220,59,47
34,r_79_52_81,seq85,r_149_104_177,r_149_104_177,1.0,11,188,177,47
89,seq89,r_30_107_194,r_61_13_135,r_61_13_135,0.73,40,175,135,47
3,r_57_132_157,seq4,r_108_69_44,r_57_132_157,0.71,2,159,157,47
10,r_28_98_153,seq86,seq144,r_28_98_153,1.0,0,153,153,47
19,r_114_50_26,r_48_142_205,r_61_13_135,r_114_50_26,0.99,-2,24,26,47
26,r_77_64_97,seq124,r_76_68_14,r_77_64_97,0.92,3,100,97,47
8,r_61_13_135,r_114_50_26,seq89,r_61_13_135,1.0,0,135,135,47
78,seq66,r_36_90_60,r_137_138_228,r_36_90_60,1.0,3,63,60,47
0,r_1_146_62,r_11_111_193,seq56,r_1_146_62,1.0,3,65,62,47
29,r_95_92_114,r_12_94_30,seq45,r_95_92_114,1.0,0,114,114,47
29,r_95_92_114,seq78,r_12_94_30,r_12_94_30,0.93,29,59,30,47
91,seq102,seq37,r_76_68_14,r_76_68_14,1.0,30,44,14,47
6,r_126_75_140,seq120,seq141,r_126_75_140,0.96,1,141,140,47
85,seq84,seq110,r_112_116_109,r_112_116_109,1.0,21,130,109,47
99,seq124,r_77_64_97,seq110,r_77_64_97,1.0,3,100,97,47
5,r_11_111_193,r_119_122_22,r_77_64_97,r_77_64_97,0.84,99,196,97,47
8,r_61_13_135,seq110,r_114_50_26,r_114_50_26,1.0,2,28,26,47
75,seq59,r_22_14_132,r_76_68_14,r_76_68_14,0.71,40,54,14,47
87,seq86,r_28_98_153,seq135,r_28_98_153,0.79,6,159,153,47
93,seq109,r_93_25_83,r_137_138_228,r_137_138_228,0.45,6,234,228,47
41,r_54_23_238,seq102,seq82,r_54_23_238,0.34,-113,125,238,47
93,seq109,seq110,r_93_25_83,r_93_25_83,0.88,77,160,83,47
40,r_44_27_74,r_0_39_5,r_114_50_26,r_44_27_74,1.0,0,74,74,47
18,r_2_18_226,seq49,r_12_94_30,r_12_94_30,1.0,210,240,30,47
34,r_79_52_81,r_29_26_158,seq85,r_29_26_158,1.0,0,158,158,47
25,r_36_90_60,seq66,r_114_50_26,r_36_90_60,1.0,3,63,60,47
33,r_129_140_80,r_48_142_205,seq51,r_129_140_80,0.55,4,84,80,47
48,r_127_35_219,r_119_122_22,r_80_70_117,r_80_70_117,0.9,103,220,117,47
31,r_12_94_30,r_30_107_194,r_95_92_114,r_12_94_30,0.93,0,30,30,47
38,r_22_14_132,seq136,seq8,r_22_14_132,0.68,19,151,132,47
4,r_108_69_44,seq56,seq10,r_108_69_44,1.0,0,44,44,47
34,r_79_52_81,seq101,r_29_26_158,r_79_52_81,0.99,0,81,81,47
7,r_76_68_14,r_65_139_31,seq24,r_76_68_14,0.83,-1,13,14,47
26,r_77_64_97,r_76_68_14,r_11_111_193,r_77_64_97,0.52,58,155,97,47
50,seq130,seq135,r_81_55_56,r_81_55_56,1.0,3,59,56,47
17,r_112_116_109,r_87_134_237,seq84,r_112_116_109,0.98,1,110,109,47
94,seq110,r_61_13_135,r_114_50_26,r_61_13_135,0.6,-2,133,135,47
9,r_48_142_205,r_121_20_173,seq101,r_48_142_205,0.63,-28,177,205,47
96,seq120,r_126_75_140,seq101,r_126_75_140,1.0,1,141,140,47
31,r_12_94_30,r_95_92_114,r_118_99_104,r_12_94_30,1.0,84,114,30,47
37,r_93_25_83,seq109,r_128_105_206,r_128_105_206,0.89,6,212,206,47
22,r_31_19_70,seq144,r_148_91_32,r_31_19_70,0.65,0,70,70,47
67,seq41,seq24,r_76_68_14,r_76_68_14,0.97,40,54,14,47
9,r_48_142_205,seq101,r_40_3_146,r_48_142_205,0.9,5,210,205,47
49,r_21_117_142,seq5,seq49,r_21_117_142,0.69,0,142,142,47
13,r_81_55_56,r_46_47_71,seq130,r_81_55_56,1.0,1,57,56,47
44,r_46_47_71,seq147,r_76_68_14,r_46_47_71,1.0,0,71,71,47
20,r_34_106_28,r_48_142_205,seq5,r_34_106_28,0.96,1,29,28,47
23,r_73_32_77,seq6,seq110,r_73_32_77,1.0,0,77,77,47
35,r_65_139_31,seq45,r_114_50_26,r_65_139_31,0.99,0,31,31,47
12,r_30_107_194,seq143,seq62,r_30_107_194,0.92,0,194,194,47
23,r_73_32_77,seq110,r_81_55_56,r_81_55_56,0.47,87,143,56,47
30,r_6_101_176,seq68,seq130,r_6_101_176,0.98,0,176,176,48
44,r_96_62_68,r_79_75_227,r_113_127_72,r_79_75_227,0.89,0,227,227,48
62,seq148,r_128_23_70,r_87_121_169,r_87_121_169,0.54,-141,28,169,48
14,r_20_42_164,r_71_61_189,r_14_55_232,r_20_42_164,0.97,0,164,164,48
8,r_95_37_89,seq34,r_142_47_10,r_95_37_89,0.97,0,89,89,48
43,r_54_2_111,seq145,r_80_118_80,r_80_118_80,1.0,16,96,80,48
59,seq16,seq107,r_73_132_102,r_73_132_102,1.0,3,105,102,48
40,r_106_126_35,r_74_124_43,seq104,r_106_126_35,1.0,0,35,35,48
16,r_30_88_110,r_82_103_136,r_26_41_132,r_26_41_132,1.0,-19,113,132,48
21,r_128_23_70,seq16,seq140,r_128_23_70,1.0,2,72,70,48
39,r_144_111_201,r_22_46_161,seq112,r_22_46_161,0.45,9,170,161,48
5,r_86_85_193,seq131,seq94,r_86_85_193,0.77,-1,192,193,48
46,r_58_9_95,seq90,seq49,r_58_9_95,1.0,1,96,95,48
42,r_5_38_216,seq52,r_110_129_104,r_110_129_104,0.98,112,216,104,48
45,r_100_122_226,seq140,r_95_37_89,r_95_37_89,1.0,137,226,89,48
13,r_12_70_230,r_95_37_89,r_30_88_110,r_12_70_230,0.59,0,230,230,48
95,seq145,r_54_2_111,r_71_61_189,r_71_61_189,1.0,15,204,189,48
76,seq53,seq48,r_74_124_43,r_74_124_43,1.0,22,65,43,48
31,r_79_75_227,r_51_117_139,r_96_62_68,r_51_117_139,0.7,-71,68,139,48
41,r_110_129_104,seq108,r_24_35_190,r_110_129_104,1.0,0,104,104,48
3,r_71_61_189,r_20_42_164,r_30_88_110,r_30_88_110,0.61,54,164,110,48
9,r_114_105_49,r_120_10_205,seq59,r_114_105_49,0.8,0,49,49,48
26,r_137_33_184,seq59,r_106_126_35,r_137_33_184,0.9,0,184,184,48
0,r_73_132_102,r_12_70_230,seq16,r_73_132_102,0.99,0,102,102,48
11,r_109_57_120,r_21_63_47,seq99,r_109_57_120,1.0,0,120,120,48
39,r_144_111_201,seq112,seq34,r_144_111_201,0.46,3,204,201,48
20,r_77_43_115,seq84,r_142_47_10,r_77_43_115,1.0,1,116,115,48
13,r_12_70_230,r_4_133_211,r_95_37_89,r_95_37_89,1.0,122,211,89,48
85,seq78,r_147_83_83,r_26_41_132,r_147_83_83,1.0,-36,47,83,48
15,r_51_117_139,r_79_75_227,seq50,r_51_117_139,0.97,5,144,139,48
22,r_28_31_231,r_73_132_102,r_142_47_10,r_28_31_231,0.67,-221,10,231,48
3,r_71_61_189,r_30_88_110,seq145,r_71_61_189,0.96,2,191,189,48
48,r_142_47_10,r_95_37_89,r_28_31_231,r_28_31_231,0.77,-221,10,231,48
4,r_13_3_36,seq32,seq94,r_13_3_36,0.98,-2,34,36,48
27,r_120_10_205,seq92,seq11,r_120_10_205,0.52,0,205,205,48
22,r_28_31_231,r_142_47_10,r_120_10_205,r_142_47_10,0.26,221,231,10,48
37,r_119_143_52,r_147_83_83,seq135,r_119_143_52,0.84,-3,49,52,48
36,r_26_41_132,r_71_61_189,seq78,r_71_61_189,0.8,-144,45,189,48
2,r_134_69_93,seq52,seq84,r_134_69_93,1.0,1,94,93,48
41,r_110_129_104,r_24_35_190,r_5_38_216,r_5_38_216,0.61,3,219,216,48
18,r_22_46_161,r_144_111_201,seq107,r_22_46_161,0.8,1,162,161,48
24,r_87_121_169,seq139,r_96_62_68,r_87_121_169,0.9,0,169,169,48
33,r_80_118_80,seq130,r_54_2_111,r_80_118_80,1.0,0,80,80,48
48,r_142_47_10,r_28_31_231,r_77_43_115,r_77_43_115,1.0,63,178,115,48
70,seq135,seq94,r_119_143_52,r_119_143_52,0.99,99,151,52,48
32,r_113_127_72,seq66,seq76,r_113_127_72,1.0,0,72,72,48
38,r_4_133_211,r_12_70_230,r_128_23_70,r_12_70_230,0.48,-19,211,230,48
34,r_125_115_13,r_30_88_110,seq149,r_125_115_13,1.0,0,13,13,48
1,r_74_124_43,r_106_126_35,r_97_60_200,r_74_124_43,0.7,-12,31,43,48
7,r_40_81_12,r_86_85_193,seq34,r_40_81_12,0.72,0,12,12,48
17,r_91_123_165,seq32,seq59,r_91_123_165,0.93,0,165,165,48
28,r_39_8_51,r_14_55_232,seq93,r_39_8_51,1.0,-2,49,51,48
31,r_79_75_227,r_96_62_68,seq104,r_79_75_227,0.48,0,227,227,48
99,seq112,r_128_23_70,seq148,r_128_23_70,0.74,-41,29,70,48
62,seq148,r_87_121_169,seq11,r_87_121_169,0.89,-67,102,169,48
49,r_72_19_186,r_12_70_230,r_6_101_176,r_12_70_230,0.98,-44,186,230,48
44,r_96_62_68,seq17,r_79_75_227,r_79_75_227,0.79,-109,118,227,48
35,r_147_83_83,seq78,r_128_23_70,r_147_83_83,1.0,0,83,83,48
12,r_21_63_47,r_109_57_120,r_106_126_35,r_21_63_47,0.74,72,119,47,48
30,r_11_133_149,r_115_4_158,r_73_52_134,r_115_4_158,0.73,-9,149,158,49
4,r_6_93_28,r_35_63_57,seq126,r_6_93_28,1.0,1,29,28,49
36,r_122_143_98,r_80_134_215,r_110_66_209,r_122_143_98,0.81,1,99,98,49
14,r_62_128_70,r_115_4_158,seq65,r_62_128_70,1.0,0,70,70,49
8,r_13_87_136,seq58,r_54_112_184,r_13_87_136,0.8,0,136,136,49
43,r_49_131_114,seq135,seq116,r_49_131_114,0.9,0,114,114,49
37,r_70_10_97,seq14,seq105,r_70_10_97,0.99,3,100,97,49
22,r_35_63_57,seq57,seq43,r_35_63_57,1.0,0,57,57,49
71,seq45,r_26_108_239,r_129_71_32,r_26_108_239,0.47,0,239,239,49
39,r_111_91_157,seq140,r_46_75_47,r_111_91_157,0.97,1,158,157,49
1,r_110_66_209,r_122_143_98,r_24_7_169,r_110_66_209,0.99,-1,208,209,49
1,r_110_66_209,r_115_4_158,r_122_143_98,r_122_143_98,1.0,21,119,98,49
97,seq123,r_82_21_163,seq27,r_82_21_163,1.0,0,163,163,49
5,r_26_108_239,seq45,r_90_94_112,r_90_94_112,1.0,127,239,112,49
77,seq58,r_13_87_136,r_46_75_47,r_46_75_47,0.63,2,49,47,49
19,r_22_31_61,r_49_131_114,seq57,r_22_31_61,1.0,0,61,61,49
38,r_146_32_40,r_124_101_140,seq97,r_146_32_40,1.0,0,40,40,49
41,r_85_17_42,r_84_86_151,r_109_39_232,r_85_17_42,0.98,0,42,42,49
55,seq138,r_46_75_47,seq130,r_46_75_47,1.0,-2,45,47,49
3,r_78_121_117,r_89_103_237,seq132,r_78_121_117,0.98,0,117,117,49
0,r_77_0_159,r_18_25_192,seq92,r_77_0_159,0.99,0,159,159,49
11,r_24_7_169,seq30,r_62_128_70,r_62_128_70,1.0,100,170,70,49
23,r_120_48_41,seq107,r_102_106_186,r_120_48_41,0.98,0,41,41,49
20,r_84_86_151,seq92,seq105,r_84_86_151,1.0,0,151,151,49
29,r_54_112_184,r_13_87_136,r_15_3_148,r_54_112_184,1.0,0,184,184,49
13,r_100_64_91,seq138,seq59,r_100_64_91,1.0,0,91,91,49
98,seq126,seq136,r_6_93_28,r_6_93_28,0.93,109,137,28,49
46,r_46_75_47,seq138,seq58,r_46_75_47,1.0,0,47,47,49
15,r_124_101_140,seq37,seq132,r_124_101_140,0.44,4,144,140,49
48,r_51_98_71,r_68_83_135,seq41,r_51_98_71,0.77,-1,70,71,49
99,seq127,r_90_94_112,r_129_71_32,r_90_94_112,0.93,-84,28,112,49
90,seq105,r_70_10_97,r_84_86_151,r_84_86_151,1.0,27,178,151,49
6,r_89_103_237,r_78_121_117,r_100_64_91,r_89_103_237,0.92,-146,91,237,49
36,r_122_143_98,r_110_66_209,r_90_94_112,r_110_66_209,0.68,-28,181,209,49
10,r_109_39_232,r_85_17_42,seq144,r_109_39_232,0.47,0,232,232,49
27,r_60_12_219,seq127,r_124_101_140,r_60_12_219,0.61,1,220,219,49
91,seq107,r_120_48_41,seq97,r_120_48_41,1.0,-8,33,41,49
2,r_9_42_170,seq40,r_129_71_32,r_9_42_170,0.99,0,170,170,49
41,r_85_17_42,r_109_39_232,r_124_101_140,r_109_39_232,0.55,-1,231,232,49
47,r_82_21_163,seq123,r_111_91_157,r_82_21_163,0.97,0,163,163,49
12,r_73_52_134,r_102_106_186,r_11_133_149,r_102_106_186,0.98,0,186,186,49
40,r_115_4_158,r_110_66_209,seq27,r_115_4_158,0.58,8,166,158,49
18,r_90_94_112,seq127,r_122_143_98,r_90_94_112,0.99,0,112,112,49
29,r_54_112_184,r_15_3_148,r_13_87_136,r_54_112_184,0.84,-36,148,184,49
26,r_19_61_43,r_84_86_151,r_6_93_28,r_6_93_28,0.92,0,28,28,49
25,r_68_83_135,seq37,r_6_93_28,r_68_83_135,0.98,2,137,135,49
33,r_81_5_228,seq58,r_110_66_209,r_110_66_209,0.98,24,233,209,49
64,seq30,r_24_7_169,r_69_149_183,r_24_7_169,0.89,1,170,169,49
50,seq2,r_141_44_226,r_22_31_61,r_22_31_61,1.0,164,225,61,49
6,r_89_103_237,r_100_64_91,r_95_142_88,r_89_103_237,0.53,0,237,237,49
8,r_13_87_136,r_54_112_184,r_90_94_112,r_54_112_184,1.0,-1,183,184,49
10,r_109_39_232,r_73_52_134,r_85_17_42,r_109_39_232,0.78,-188,44,232,49
68,seq40,r_148_16_156,r_1_20_54,r_1_20_54,0.97,102,156,54,49
16,r_1_20_54,seq55,seq40,r_1_20_54,1.0,0,54,54,49
85,seq92,r_15_3_148,r_77_0_159,r_77_0_159,0.86,11,170,159,49
34,r_33_38_73,r_49_131_114,seq92,r_49_131_114,0.99,-50,64,114,49
81,seq72,r_88_28_240,r_77_0_159,r_77_0_159,0.97,81,240,159,49
17,r_141_44_226,seq2,seq23,r_141_44_226,0.58,0,226,226,49
94,seq116,r_102_106_186,r_49_131_114,r_49_131_114,0.51,21,135,114,49
9,r_80_134_215,r_81_5_228,r_22_31_61,r_80_134_215,0.77,1,216,215,49
26,r_19_61_43,r_6_93_28,seq140,r_6_93_28,0.52,118,146,28,49
90,seq105,seq29,r_70_10_97,r_70_10_97,1.0,7,104,97,49
37,r_70_10_97,seq105,r_148_16_156,r_148_16_156,1.0,21,177,156,49
28,r_88_28_240,seq72,r_110_66_209,r_110_66_209,0.8,31,240,209,49
49,r_18_25_192,seq79,r_85_17_42,r_18_25_192,0.84,1,193,192,49
56,seq140,r_111_91_157,r_56_125_86,r_111_91_157,0.74,1,158,157,49
7,r_69_149_183,seq144,seq30,r_69_149_183,0.38,14,197,183,49
44,r_56_125_86,seq136,seq34,r_56_125_86,0.8,1,87,86,49
42,r_129_71_32,seq2,seq127,r_129_71_32,0.77,-3,29,32,49
35,r_15_3_148,r_54_112_184,r_33_38_73,r_33_38_73,0.93,75,148,73,49
12,r_73_52_134,seq27,r_102_106_186,r_73_52_134,0.92,1,135,134,49
23,r_120_48_41,r_102_106_186,r_73_52_134,r_73_52_134,0.9,52,186,134,49
51,seq2,r_103_90_164,r_73_102_6,r_103_90_164,0.9,0,164,164,50
12,r_138_111_33,r_79_97_165,seq64,r_138_111_33,0.98,0,33,33,50
14,r_103_90_164,seq2,r_50_118_106,r_103_90_164,0.95,0,164,164,50
43,r_44_8_203,seq75,r_24_128_105,r_44_8_203,0.66,0,203,203,50
83,seq76,r_74_35_205,r_138_111_33,r_74_35_205,0.53,0,205,205,50
37,r_104_95_199,r_49_93_144,r_112_84_102,r_104_95_199,0.5,-93,106,199,50
16,r_49_93_144,r_104_95_199,seq122,r_49_93_144,0.99,0,144,144,50
21,r_6_96_232,seq144,seq107,r_6_96_232,0.39,0,232,232,50
39,r_140_77_217,seq10,r_138_111_33,r_138_111_33,0.65,185,218,33,50
1,r_65_92_170,seq71,r_101_98_20,r_65_92_170,0.83,0,170,170,50
5,r_26_56_119,r_14_78_209,seq47,r_26_56_119,0.96,0,119,119,50
46,r_91_80_179,r_148_126_212,r_79_97_165,r_148_126_212,0.7,-31,181,212,50
45,r_17_99_1,r_114_11_73,r_94_62_36,r_17_99_1,0.58,73,74,1,50
19,r_9_41_158,r_24_128_105,r_142_130_103,r_142_130_103,0.57,6,109,103,50
30,r_143_67_66,r_104_95_199,r_147_120_40,r_143_67_66,0.59,-7,59,66,50
19,r_9_41_158,r_142_130_103,seq12,r_9_41_158,1.0,0,158,158,50
31,r_69_139_140,seq15,seq108,r_69_139_140,0.73,0,140,140,50
67,seq31,r_142_130_103,r_147_120_40,r_142_130_103,0.66,0,103,103,50
89,seq144,seq52,r_101_98_20,r_101_98_20,0.88,49,69,20,50
3,r_74_35_205,seq76,seq87,r_74_35_205,0.48,0,205,205,50
4,r_146_37_58,r_115_135_246,seq40,r_146_37_58,1.0,0,58,58,50
10,r_24_128_105,r_9_41_158,seq22,r_24_128_105,0.55,8,113,105,50
15,r_101_98_20,seq7,seq144,r_101_98_20,0.95,3,23,20,50
11,r_114_11_73,r_17_99_1,r_14_78_209,r_114_11_73,0.94,1,74,73,50
9,r_142_130_103,r_9_41_158,r_73_102_6,r_9_41_158,1.0,0,158,158,50
13,r_54_33_146,seq45,r_115_135_246,r_54_33_146,0.5,0,146,146,50
48,r_127_38_174,r_74_35_205,seq137,r_74_35_205,0.81,-31,174,205,50
0,r_147_120_40,r_26_56_119,r_142_130_103,r_147_120_40,0.77,0,40,40,50
99,seq124,r_4_121_86,r_101_98_20,r_4_121_86,0.95,0,86,86,50
27,r_129_21_161,seq64,r_73_102_6,r_129_21_161,0.83,0,161,161,50
87,seq88,r_63_28_186,r_68_23_99,r_68_23_99,1.0,87,186,99,50
2,r_86_39_69,r_24_128_105,seq106,r_86_39_69,0.75,4,73,69,50
47,r_5_43_139,seq60,r_4_121_86,r_5_43_139,1.0,1,140,139,50
93,seq108,r_114_11_73,r_69_139_140,r_69_139_140,0.99,60,200,140,50
18,r_46_0_68,seq2,seq45,r_46_0_68,0.97,0,68,68,50
24,r_141_30_125,r_74_35_205,seq117,r_141_30_125,0.62,0,125,125,50
64,seq22,seq36,r_24_128_105,r_24_128_105,0.99,8,113,105,50
33,r_131_57_51,seq64,seq107,r_131_57_51,0.6,2,53,51,50
58,seq16,r_63_28_186,r_68_23_99,r_68_23_99,1.0,87,186,99,50
70,seq40,seq34,r_146_37_58,r_146_37_58,1.0,36,94,58,50
32,r_42_51_91,r_17_99_1,seq7,r_42_51_91,1.0,0,91,91,50
38,r_68_23_99,seq81,seq72,r_68_23_99,0.96,0,99,99,50
34,r_4_121_86,seq124,seq10,r_4_121_86,1.0,0,86,86,50
20,r_58_110_138,r_115_135_246,r_104_95_199,r_104_95_199,0.77,-4,195,199,50
0,r_147_120_40,r_142_130_103,r_143_67_66,r_142_130_103,0.95,-39,64,103,50
81,seq72,r_63_28_186,r_68_23_99,r_68_23_99,1.0,20,119,99,50
17,r_79_97_165,seq18,seq70,r_79_97_165,0.66,0,165,165,50
94,seq109,r_91_80_179,seq25,r_91_80_179,0.96,-11,168,179,50
9,r_142_130_103,seq31,r_9_41_158,r_142_130_103,0.99,0,103,103,50
37,r_104_95_199,r_112_84_102,r_58_110_138,r_58_110_138,0.62,66,204,138,50
22,r_105_85_61,r_55_13_107,seq133,r_55_13_107,0.61,-46,61,107,50
91,seq106,seq7,r_86_39_69,r_86_39_69,0.94,9,78,69,50
49,r_148_126_212,r_91_80_179,seq109,r_91_80_179,0.68,-5,174,179,50
7,r_115_135_246,seq71,r_94_62_36,r_115_135_246,0.41,-72,174,246,50
44,r_29_132_85,seq107,r_146_37_58,r_146_37_58,0.62,28,86,58,50
42,r_136_59_43,r_50_118_106,seq64,r_136_59_43,0.78,1,44,43,50
23,r_112_84_102,seq75,r_104_95_199,r_112_84_102,0.87,16,118,102,50
49,r_148_126_212,seq109,r_79_97_165,r_148_126_212,0.96,0,212,212,50
35,r_55_13_107,seq108,r_115_135_246,r_55_13_107,0.66,-2,105,107,50
23,r_112_84_102,r_104_95_199,r_79_97_165,r_79_97_165,0.86,39,204,165,50
51,seq4,r_25_105_155,seq126,r_25_105_155,0.42,0,155,155,51
36,r_102_52_176,seq69,r_140_16_28,r_140_16_28,0.52,148,176,28,51
9,r_107_106_58,r_65_2_224,r_78_42_22,r_65_2_224,0.58,-11,213,224,51
43,r_36_139_150,r_1_29_227,r_80_97_127,r_36_139_150,1.0,0,150,150,51
37,r_60_57_141,seq111,seq87,r_60_57_141,1.0,0,141,141,51
59,seq148,r_45_138_219,r_143_81_51,r_143_81_51,0.95,132,183,51,51
26,r_118_14_40,r_55_136_198,seq23,r_118_14_40,1.0,0,40,40,51
55,seq142,seq49,r_99_125_88,r_99_125_88,1.0,64,152,88,51
16,r_80_97_127,r_94_64_133,seq69,r_80_97_127,1.0,0,127,127,51
39,r_24_34_210,seq117,r_63_144_223,r_63_144_223,0.78,0,223,223,51
1,r_65_2_224,r_107_106_58,seq54,r_65_2_224,0.46,0,224,224,51
1,r_65_2_224,seq109,r_107_106_58,r_107_106_58,1.0,15,73,58,51
5,r_1_29_227,r_36_139_150,r_7_110_69,r_1_29_227,1.0,-77,150,227,51
46,r_83_66_62,seq22,seq49,r_83_66_62,1.0,0,62,62,51
80,seq76,seq126,r_40_130_102,r_40_130_102,1.0,16,118,102,51
32,r_95_51_181,r_121_0_31,seq82,r_95_51_181,0.95,0,181,181,51
69,seq41,r_27_128_239,seq23,r_27_128_239,0.65,0,239,239,51
51,seq4,seq126,r_53_20_25,r_53_20_25,0.52,158,183,25,51
30,r_78_42_22,seq79,seq109,r_78_42_22,1.0,0,22,22,51
35,r_121_0_31,seq44,r_95_51_181,r_121_0_31,1.0,2,33,31,51
15,r_98_56_237,r_121_0_31,r_1_29_227,r_98_56_237,0.83,0,237,237,51
27,r_53_20_25,r_149_70_212,r_145_68_54,r_145_68_54,0.68,128,182,54,51
6,r_116_92_33,seq47,seq109,r_116_92_33,1.0,1,34,33,51
38,r_141_119_154,r_24_34_210,r_74_108_139,r_141_119_154,1.0,-1,153,154,51
31,r_131_73_66,r_30_43_242,r_140_16_28,r_131_73_66,1.0,0,66,66,51
3,r_27_128_239,seq41,r_45_138_219,r_27_128_239,0.24,0,239,239,51
10,r_114_58_136,seq49,r_116_92_33,r_114_58_136,1.0,0,136,136,51
92,seq109,r_65_2_224,r_116_92_33,r_116_92_33,1.0,0,33,33,51
4,r_112_13_228,seq17,r_143_81_51,r_112_13_228,0.49,0,228,228,51
45,r_55_136_198,r_100_135_29,r_26_50_64,r_26_50_64,1.0,19,83,64,51
78,seq69,r_102_52_176,r_80_97_127,r_80_97_127,1.0,39,166,127,51
20,r_67_91_104,r_1_29_227,r_53_20_25,r_67_91_104,1.0,0,104,104,51
13,r_63_144_223,r_30_43_242,r_32_3_86,r_63_144_223,0.47,-137,86,223,51
8,r_143_81_51,seq62,r_113_134_50,r_143_81_51,0.92,1,52,51,51
15,r_98_56_237,r_122_103_171,r_121_0_31,r_121_0_31,0.95,142,173,31,51
45,r_55_136_198,r_118_14_40,r_100_135_29,r_55_136_198,0.97,-158,40,198,51
85,seq87,seq104,r_60_57_141,r_60_57_141,1.0,25,166,141,51
9,r_107_106_58,r_71_19_60,r_65_2_224,r_107_106_58,0.98,1,59,58,51
5,r_1_29_227,r_7_110_69,seq4,r_7_110_69,0.47,159,228,69,51
19,r_145_68_54,r_32_3_86,r_53_20_25,r_145_68_54,1.0,0,54,54,51
0,r_100_135_29,r_55_136_198,r_80_97_127,r_80_97_127,1.0,71,198,127,51
30,r_78_42_22,seq109,r_107_106_58,r_107_106_58,1.0,27,85,58,51
51,seq4,r_53_20_25,r_1_29_227,r_1_29_227,0.92,2,229,227,51
48,r_85_6_35,r_84_133_249,seq124,r_85_6_35,1.0,0,35,35,51
2,r_9_59_98,seq117,seq37,r_9_59_98,1.0,0,98,98,51
47,r_122_103_171,r_39_28_179,r_85_6_35,r_85_6_35,0.98,138,173,35,51
40,r_93_75_178,seq21,r_9_59_98,r_93_75_178,0.94,0,178,178,51
18,r_26_50_64,seq129,r_55_136_198,r_26_50_64,1.0,0,64,64,51
29,r_99_125_88,seq87,seq142,r_99_125_88,0.98,0,88,88,51
24,r_32_3_86,r_141_119_154,r_63_144_223,r_141_119_154,0.96,-68,86,154,51
34,r_7_110_69,r_1_29_227,r_45_138_219,r_45_138_219,0.7,9,228,219,51
45,r_55_136_198,r_26_50_64,r_143_81_51,r_55_136_198,0.8,0,198,198,51
35,r_121_0_31,r_95_51_181,r_143_81_51,r_95_51_181,0.61,0,181,181,51
25,r_71_19_60,r_107_106_58,seq129,r_71_19_60,0.94,0,60,60,51
33,r_40_130_102,seq31,seq76,r_40_130_102,1.0,0,102,102,51
0,r_100_135_29,seq109,r_55_136_198,r_100_135_29,0.99,0,29,29,51
68,seq38,r_27_128_239,r_60_57_141,r_60_57_141,0.96,0,141,141,51
11,r_140_16_28,r_53_20_25,seq88,r_140_16_28,1.0,0,28,28,51
32,r_95_51_181,r_122_103_171,r_121_0_31,r_121_0_31,1.0,68,99,31,51
38,r_141_119_154,r_32_3_86,r_24_34_210,r_141_119_154,0.65,-68,86,154,51
34,r_7_110_69,r_112_13_228,r_1_29_227,r_7_110_69,0.99,3,72,69,51
60,seq21,r_93_75_178,r_118_14_40,r_118_14_40,0.63,138,178,40,51
27,r_53_20_25,r_140_16_28,r_149_70_212,r_53_20_25,0.85,3,28,25,51
22,r_39_28_179,r_98_56_237,seq62,r_39_28_179,0.64,1,180,179,51
28,r_74_108_139,seq12,seq54,r_74_108_139,0.83,1,140,139,51
49,r_11_8_146,seq37,r_60_57_141,r_11_8_146,0.98,1,147,146,51
56,seq17,r_112_13_228,seq77,r_112_13_228,0.47,0,228,228,51
7,r_45_138_219,seq148,seq147,r_45_138_219,0.6,0,219,219,51
18,r_26_50_64,r_55_136_198,r_100_135_29,r_55_136_198,0.57,0,198,198,51
44,r_94_64_133,seq82,seq123,r_94_64_133,1.0,1,134,133,51
28,r_74_108_139,seq54,r_141_119_154,r_74_108_139,0.58,45,184,139,51
23,r_149_70_212,r_65_2_224,r_53_20_25,r_53_20_25,0.96,-4,21,25,51
12,r_25_105_155,seq4,r_100_135_29,r_25_105_155,0.51,0,155,155,51
42,r_113_134_50,seq88,r_143_81_51,r_113_134_50,0.82,1,51,50,51
23,r_149_70_212,r_53_20_25,r_83_66_62,r_149_70_212,0.63,0,212,212,51
30,r_23_146_82,r_77_106_206,seq27,r_23_146_82,1.0,0,82,82,52
29,r_5_105_27,r_143_99_163,seq16,r_5_105_27,1.0,0,27,27,52
92,seq101,seq127,r_52_88_93,r_52_88_93,0.98,12,105,93,52
14,r_40_41_221,r_37_93_84,r_97_55_233,r_37_93_84,1.0,0,84,84,52
18,r_36_107_44,r_143_99_163,r_108_114_12,r_36_107_44,1.0,0,44,44,52
43,r_77_106_206,seq66,seq149,r_77_106_206,0.75,0,206,206,52
21,r_92_78_85,seq24,r_121_59_129,r_121_59_129,0.83,15,144,129,52
87,seq139,r_13_73_100,r_108_114_12,r_108_114_12,1.0,0,12,12,52
86,seq66,r_77_106_206,seq133,r_77_106_206,0.85,0,206,206,52
21,r_92_78_85,seq111,seq24,r_92_78_85,0.92,4,89,85,52
39,r_52_88_93,seq27,seq140,r_52_88_93,0.93,0,93,93,52
1,r_74_110_181,seq54,r_125_126_122,r_125_126_122,0.99,60,182,122,52
5,r_67_100_215,seq133,r_97_55_233,r_97_55_233,0.72,-18,215,233,52
46,r_142_120_159,r_19_7_108,seq140,r_19_7_108,1.0,-30,78,108,52
42,r_125_126_122,seq56,seq24,r_125_126_122,0.99,0,122,122,52
45,r_102_8_62,r_15_72_81,seq9,r_102_8_62,1.0,0,62,62,52
19,r_97_55_233,r_40_41_221,r_76_0_88,r_76_0_88,0.65,144,232,88,52
25,r_87_61_34,r_19_7_108,seq138,r_87_61_34,0.76,2,36,34,52
5,r_67_100_215,r_97_55_233,r_3_70_61,r_97_55_233,0.78,0,233,233,52
89,seq85,r_6_116_209,r_82_94_90,r_82_94_90,0.74,119,209,90,52
0,r_17_69_172,r_49_18_71,r_96_144_143,r_17_69_172,0.48,51,223,172,52
10,r_13_73_100,seq139,seq21,r_13_73_100,0.7,1,101,100,52
26,r_49_18_71,r_15_72_81,r_131_129_240,r_49_18_71,1.0,0,71,71,52
14,r_40_41_221,r_97_55_233,r_77_106_206,r_40_41_221,0.4,1,222,221,52
24,r_15_72_81,r_39_113_25,r_135_118_116,r_135_118_116,1.0,11,127,116,52
4,r_98_83_66,seq130,seq56,r_98_83_66,0.71,0,66,66,52
0,r_17_69_172,r_121_59_129,r_67_100_215,r_121_59_129,1.0,0,129,129,52
73,seq38,r_147_104_192,r_5_105_27,r_147_104_192,0.59,0,192,192,52
11,r_143_99_163,seq53,seq117,r_143_99_163,0.99,0,163,163,52
20,r_34_45_207,seq47,r_37_93_84,r_34_45_207,0.63,1,208,207,52
46,r_142_120_159,seq140,seq1,r_142_120_159,1.0,0,159,159,52
15,r_37_93_84,r_40_41_221,seq22,r_37_93_84,0.88,0,84,84,52
48,r_79_86_189,r_103_71_236,seq53,r_79_86_189,0.63,0,189,189,52
57,seq9,r_124_123_46,r_102_8_62,r_102_8_62,1.0,19,81,62,52
3,r_42_10_39,seq149,seq14,r_42_10_39,1.0,0,39,39,52
6,r_134_141_142,r_131_129_240,seq21,r_134_141_142,0.89,1,143,142,52
16,r_108_114_12,seq132,seq139,r_108_114_12,0.96,0,12,12,52
2,r_76_0_88,r_40_41_221,seq132,r_76_0_88,0.57,91,179,88,52
36,r_39_113_25,r_148_81_38,seq132,r_39_113_25,0.9,0,25,25,52
27,r_60_64_83,r_131_129_240,seq140,r_60_64_83,1.0,0,83,83,52
98,seq132,r_28_119_228,r_39_113_25,r_39_113_25,0.75,7,32,25,52
2,r_76_0_88,r_89_50_157,r_40_41_221,r_89_50_157,0.52,-54,103,157,52
47,r_121_59_129,r_17_69_172,r_92_78_85,r_121_59_129,0.99,0,129,129,52
40,r_84_32_130,seq20,seq63,r_84_32_130,1.0,0,130,130,52
2,r_76_0_88,seq132,r_97_55_233,r_76_0_88,0.74,144,232,88,52
0,r_17_69_172,r_67_100_215,r_49_18_71,r_17_69_172,0.98,0,172,172,52
24,r_15_72_81,seq90,r_39_113_25,r_15_72_81,0.99,0,81,81,52
33,r_89_50_157,seq138,seq14,r_89_50_157,0.87,0,157,157,52
32,r_46_91_58,seq1,r_87_61_34,r_46_91_58,1.0,0,58,58,52
38,r_82_94_90,r_143_99_163,seq85,r_143_99_163,0.68,-72,91,163,52
34,r_135_118_116,seq56,r_15_72_81,r_135_118_116,1.0,0,116,116,52
60,seq140,seq127,r_60_64_83,r_60_64_83,1.0,46,129,83,52
17,r_19_7_108,seq127,seq30,r_19_7_108,1.0,0,108,108,52
94,seq111,r_92_78_85,r_96_144_143,r_92_78_85,0.79,0,85,85,52
9,r_28_119_228,seq149,r_143_99_163,r_143_99_163,0.88,64,227,163,52
26,r_49_18_71,r_131_129_240,r_26_57_196,r_26_57_196,1.0,44,240,196,52
22,r_3_70_61,seq95,seq127,r_3_70_61,1.0,0,61,61,52
4,r_98_83_66,r_147_104_192,r_17_69_172,r_147_104_192,0.6,-1,191,192,52
28,r_96_144_143,seq16,seq111,r_96_144_143,0.92,4,147,143,52
49,r_145_33_141,r_40_41_221,r_96_144_143,r_145_33_141,1.0,0,141,141,52
31,r_80_112_30,r_124_123_46,seq25,r_80_112_30,0.85,1,31,30,52
7,r_131_129_240,r_60_64_83,r_49_18_71,r_131_129_240,1.0,-157,83,240,52
44,r_26_57_196,seq27,r_49_18_71,r_26_57_196,0.75,0,196,196,52
13,r_148_81_38,seq30,seq127,r_148_81_38,0.96,0,38,38,52
23,r_147_104_192,seq38,r_87_61_34,r_147_104_192,0.89,0,192,192,52
35,r_6_116_209,seq85,r_12_75_67,r_12_75_67,1.0,142,209,67,52
73,seq38,r_5_105_27,r_98_83_66,r_5_105_27,0.47,186,213,27,52
12,r_12_75_67,seq20,seq35,r_12_75_67,1.0,0,67,67,52
40,r_127_10_8,r_36_137_207,r_9_106_229,r_36_137_207,0.48,9,216,207,53
30,r_7_20_1,r_92_43_238,r_139_105_248,r_139_105_248,0.55,-10,238,248,53
6,r_0_87_22,r_52_48_213,seq85,r_0_87_22,0.93,0,22,22,53
36,r_12_140_139,r_52_48_213,seq63,r_12_140_139,0.86,0,139,139,53
14,r_52_48_213,r_12_140_139,r_4_46_231,r_12_140_139,1.0,0,139,139,53
8,r_71_88_184,r_8_15_222,seq93,r_71_88_184,0.66,1,185,184,53
53,seq129,r_115_13_227,r_142_60_210,r_115_13_227,0.57,-5,222,227,53
43,r_29_132_161,seq41,seq23,r_29_132_161,0.8,0,161,161,53
37,r_76_62_90,seq98,seq116,r_76_62_90,1.0,0,90,90,53
3,r_97_83_138,r_52_48_213,r_22_109_26,r_97_83_138,0.99,1,139,138,53
16,r_144_49_194,seq58,seq16,r_144_49_194,0.67,0,194,194,53
21,r_99_95_131,r_4_46_231,seq40,r_99_95_131,0.97,0,131,131,53
39,r_120_30_246,r_14_61_197,r_126_114_54,r_126_114_54,1.0,146,200,54,53
42,r_104_121_114,r_52_48_213,r_77_31_98,r_104_121_114,0.88,1,115,114,53
31,r_77_31_98,r_126_114_54,seq23,r_126_114_54,0.93,0,54,54,53
78,seq72,r_9_106_229,r_97_83_138,r_9_106_229,0.44,2,231,229,53
1,r_130_19_30,r_142_60_210,seq101,r_130_19_30,0.97,0,30,30,53
41,r_39_86_117,seq28,r_34_146_59,r_34_146_59,1.0,62,121,59,53
67,seq40,r_59_2_85,seq103,r_59_2_85,0.97,7,92,85,53
3,r_97_83_138,r_24_70_70,r_52_48_213,r_24_70_70,1.0,-8,62,70,53
45,r_44_47_15,r_113_33_23,seq107,r_44_47_15,0.99,1,16,15,53
26,r_92_43_238,r_7_20_1,r_52_48_213,r_52_48_213,0.62,25,238,213,53
0,r_113_33_23,r_142_60_210,seq41,r_113_33_23,0.93,0,23,23,53
14,r_52_48_213,r_4_46_231,r_108_21_201,r_52_48_213,0.66,-8,205,213,53
4,r_59_2_85,seq40,seq119,r_59_2_85,1.0,6,91,85,53
78,seq72,r_35_128_166,r_9_106_229,r_35_128_166,1.0,3,169,166,53
11,r_111_45_199,seq56,seq40,r_111_45_199,0.8,0,199,199,53
20,r_81_91_65,r_90_117_61,seq143,r_81_91_65,1.0,0,65,65,53
13,r_55_57_110,r_73_3_239,seq96,r_55_57_110,0.91,0,110,110,53
25,r_34_146_59,r_8_15_222,seq6,r_34_146_59,1.0,0,59,59,53
29,r_22_109_26,seq1,seq133,r_22_109_26,0.93,0,26,26,53
15,r_73_3_239,seq84,r_115_13_227,r_115_13_227,0.92,12,239,227,53
46,r_90_117_61,r_8_15_222,seq1,r_90_117_61,0.9,-3,58,61,53
57,seq143,seq32,r_81_91_65,r_81_91_65,1.0,2,67,65,53
99,seq125,r_142_60_210,seq119,r_142_60_210,0.96,-77,133,210,53
27,r_149_50_113,r_142_60_210,r_24_70_70,r_149_50_113,0.52,0,113,113,53
87,seq98,r_76_62_90,seq74,r_76_62_90,1.0,0,90,90,53
91,seq107,seq85,r_44_47_15,r_44_47_15,0.99,2,17,15,53
17,r_26_53_29,seq133,r_44_47_15,r_26_53_29,0.98,-2,27,29,53
50,seq1,r_22_109_26,r_90_117_61,r_22_109_26,0.47,0,26,26,53
33,r_78_17_134,r_29_132_161,seq101,r_78_17_134,0.86,2,136,134,53
64,seq32,seq123,r_22_109_26,r_22_109_26,0.99,79,105,26,53
69,seq135,seq122,r_145_110_4,r_145_110_4,0.47,38,42,4,53
68,seq41,r_29_132_161,r_113_33_23,r_29_132_161,0.58,0,161,161,53
38,r_5_54_121,r_9_106_229,seq74,r_5_54_121,0.97,0,121,121,53
52,seq6,seq89,r_34_146_59,r_34_146_59,1.0,34,93,59,53
34,r_36_137_207,r_127_10_8,r_76_62_90,r_36_137_207,0.82,-2,205,207,53
9,r_14_61_197,r_120_30_246,r_22_109_26,r_22_109_26,0.99,174,200,26,53
48,r_126_114_54,r_77_31_98,r_120_30_246,r_126_114_54,1.0,0,54,54,53
31,r_77_31_98,seq23,seq74,r_77_31_98,0.56,-6,92,98,53
7,r_108_21_201,r_115_13_227,r_52_48_213,r_108_21_201,0.63,0,201,201,53
23,r_42_82_160,r_142_60_210,seq56,r_42_82_160,0.89,0,160,160,53
35,r_4_46_231,r_52_48_213,r_111_45_199,r_52_48_213,0.56,18,231,213,53
12,r_24_70_70,r_97_83_138,seq37,r_24_70_70,1.0,0,70,70,53
88,seq101,r_77_31_98,r_130_19_30,r_130_19_30,1.0,0,30,30,53
30,r_135_22_82,seq120,seq129,r_135_22_82,0.99,1,83,82,54
36,r_40_59_32,r_141_114_140,seq146,r_141_114_140,1.0,0,140,140,54
8,r_78_131_121,r_48_128_213,r_106_127_242,r_78_131_121,0.76,1,122,121,54
10,r_43_63_160,r_33_47_83,r_56_29_195,r_33_47_83,1.0,-43,40,83,54
43,r_110_82_141,seq18,r_92_74_6,r_110_82_141,0.94,-1,140,141,54
17,r_61_117_183,r_71_31_28,seq102,r_61_117_183,0.76,-2,181,183,54
10,r_43_63_160,r_3_80_2,r_112_44_187,r_112_44_187,1.0,0,187,187,54
71,seq46,r_64_130_116,seq10,r_64_130_116,1.0,0,116,116,54
39,r_35_12_101,seq18,r_72_97_39,r_35_12_101,1.0,1,102,101,54
1,r_107_98_215,r_106_127_242,seq120,r_107_98_215,0.46,3,218,215,54
5,r_20_23_125,seq37,r_103_65_97,r_103_65_97,0.97,28,125,97,54
42,r_26_70_220,r_52_15_243,r_125_4_48,r_26_70_220,0.77,0,220,220,54
23,r_39_77_21,r_95_108_78,seq136,r_39_77_21,1.0,1,22,21,54
69,seq41,seq24,r_105_126_52,r_105_126_52,1.0,15,67,52,54
45,r_68_137_203,seq134,r_21_81_53,r_21_81_53,0.84,151,204,53,54
24,r_79_60_206,seq36,r_57_140_109,r_79_60_206,1.0,1,207,206,54
19,r_113_69_212,seq129,r_112_44_187,r_113_69_212,0.84,1,213,212,54
66,seq37,r_20_23_125,seq134,r_20_23_125,0.98,7,132,125,54
0,r_38_87_36,r_61_117_183,seq67,r_38_87_36,1.0,-1,35,36,54
31,r_84_9_166,r_61_117_183,r_96_30_132,r_96_30_132,0.97,34,166,132,54
41,r_132_85_13,r_135_22_82,seq2,r_132_85_13,0.79,0,13,13,54
26,r_57_140_109,seq88,seq11,r_57_140_109,0.98,0,109,109,54
8,r_78_131_121,r_106_127_242,r_42_143_19,r_78_131_121,0.47,118,239,121,54
72,seq49,r_48_128_213,r_52_15_243,r_48_128_213,0.87,-65,148,213,54
78,seq66,seq14,r_33_47_83,r_33_47_83,1.0,35,118,83,54
63,seq25,r_148_147_205,r_72_97_39,r_148_147_205,0.86,2,207,205,54
11,r_6_94_197,seq2,seq27,r_6_94_197,0.52,2,199,197,54
20,r_141_114_140,r_40_59_32,r_33_47_83,r_40_59_32,0.91,108,140,32,54
3,r_125_4_48,seq134,seq100,r_125_4_48,1.0,1,49,48,54
15,r_72_97_39,r_56_29_195,r_35_12_101,r_35_12_101,0.94,94,195,101,54
48,r_33_47_83,r_43_63_160,seq142,r_33_47_83,1.0,0,83,83,54
57,seq13,seq124,r_95_108_78,r_95_108_78,1.0,0,78,78,54
12,r_32_34_108,r_95_108_78,r_149_17_219,r_32_34_108,0.37,88,196,108,54
6,r_5_139_130,r_79_60_206,seq18,r_5_139_130,0.92,1,131,130,54
62,seq24,seq89,r_103_65_97,r_103_65_97,1.0,11,108,97,54
82,seq142,seq66,r_33_47_83,r_33_47_83,0.99,2,85,83,54
21,r_71_31_28,r_20_23_125,seq88,r_71_31_28,0.86,0,28,28,54
10,r_43_63_160,r_56_29_195,r_3_80_2,r_43_63_160,0.78,1,161,160,54
27,r_138_58_238,seq89,r_148_147_205,r_148_147_205,0.91,35,240,205,54
47,r_64_130_116,seq46,seq54,r_64_130_116,0.97,0,116,116,54
29,r_103_65_97,seq18,seq24,r_103_65_97,0.99,0,97,97,54
24,r_79_60_206,r_5_139_130,seq36,r_5_139_130,1.0,0,130,130,54
75,seq54,seq24,r_64_130_116,r_64_130_116,1.0,5,121,116,54
38,r_28_121_192,r_50_144_102,r_33_47_83,r_50_144_102,0.87,90,192,102,54
34,r_148_147_205,seq25,r_38_87_36,r_148_147_205,0.5,0,205,205,54
25,r_42_143_19,r_141_114_140,r_107_98_215,r_42_143_19,0.99,4,23,19,54
2,r_21_81_53,r_105_126_52,seq18,r_21_81_53,0.97,0,53,53,54
17,r_61_117_183,r_84_9_166,r_71_31_28,r_71_31_28,0.96,135,163,28,54
25,r_42_143_19,r_107_98_215,r_78_131_121,r_78_131_121,0.99,49,170,121,54
9,r_112_44_187,seq36,r_43_63_160,r_112_44_187,0.88,0,187,187,54
33,r_105_126_52,r_21_81_53,seq41,r_105_126_52,1.0,0,52,52,54
18,r_99_90_10,r_6_94_197,r_123_116_188,r_99_90_10,0.88,0,10,10,54
28,r_106_127_242,r_107_98_215,r_78_131_121,r_78_131_121,0.95,96,217,121,54
49,r_96_30_132,r_107_98_215,seq111,r_96_30_132,1.0,0,132,132,54
7,r_56_29_195,r_72_97_39,seq109,r_56_29_195,0.51,0,195,195,54
18,r_99_90_10,r_123_116_188,r_38_87_36,r_38_87_36,0.71,154,190,36,54
44,r_75_73_134,r_20_23_125,seq8,r_75_73_134,0.95,-2,132,134,54
79,seq67,r_86_145_184,r_38_87_36,r_38_87_36,0.93,122,158,36,54
35,r_95_108_78,seq18,seq13,r_95_108_78,1.0,0,78,78,54
84,seq89,r_138_58_238,r_103_65_97,r_103_65_97,1.0,143,240,97,54
51,seq130,r_35_74_180,r_62_32_84,r_35_74_180,0.56,-71,109,180,55
92,seq102,r_41_66_75,seq11,r_41_66_75,1.0,2,77,75,55
66,seq149,r_56_81_192,r_72_67_29,r_72_67_29,0.69,180,209,29,55
8,r_73_21_196,seq70,seq47,r_73_21_196,0.52,3,199,196,55
43,r_83_92_158,seq77,seq135,r_83_92_158,0.76,1,159,158,55
37,r_123_34_56,seq89,r_128_65_55,r_128_65_55,1.0,2,57,55,55
32,r_36_2_41,r_80_46_189,seq117,r_80_46_189,0.79,-144,45,189,55
14,r_113_38_9,r_71_116_57,r_54_15_23,r_71_116_57,1.0,0,57,57,55
39,r_112_48_92,seq37,r_132_91_18,r_112_48_92,0.8,1,93,92,55
46,r_41_66_75,seq102,seq20,r_41_66_75,1.0,2,77,75,55
42,r_18_7_193,seq8,r_1_94_149,r_18_7_193,0.93,0,193,193,55
91,seq100,r_57_95_140,r_55_124_34,r_55_124_34,0.48,0,34,34,55
80,seq77,r_83_92_158,r_54_15_23,r_83_92_158,0.97,1,159,158,55
45,r_63_59_231,seq86,r_36_2_41,r_63_59_231,0.36,2,233,231,55
22,r_64_76_46,r_30_109_82,seq98,r_64_76_46,1.0,0,46,46,55
1,r_128_65_55,seq135,r_123_34_56,r_128_65_55,1.0,0,55,55,55
66,seq149,seq28,r_56_81_192,r_56_81_192,0.85,-48,144,192,55
24,r_14_50_42,seq146,seq23,r_14_50_42,1.0,0,42,42,55
41,r_29_114_167,r_139_127_37,r_71_116_57,r_71_116_57,1.0,4,61,57,55
28,r_72_67_29,seq144,seq28,r_72_67_29,1.0,0,29,29,55
10,r_1_94_149,r_101_16_156,seq143,r_1_94_149,0.78,0,149,149,55
4,r_79_40_71,seq146,r_108_119_203,r_79_40_71,1.0,0,71,71,55
78,seq60,r_35_74_180,r_68_6_51,r_68_6_51,0.84,20,71,51,55
16,r_68_6_51,seq47,seq60,r_68_6_51,1.0,0,51,51,55
63,seq146,r_79_40_71,seq58,r_79_40_71,1.0,0,71,71,55
89,seq98,seq9,r_64_76_46,r_64_76_46,1.0,0,46,46,55
30,r_54_15_23,r_30_109_82,seq77,r_54_15_23,0.82,3,26,23,55
13,r_115_93_205,r_61_140_245,r_72_67_29,r_115_93_205,0.7,0,205,205,55
48,r_35_74_180,seq130,seq102,r_35_74_180,0.47,0,180,180,55
4,r_79_40_71,r_108_119_203,r_82_33_146,r_82_33_146,0.91,50,196,146,55
9,r_82_33_146,seq0,r_79_40_71,r_82_33_146,1.0,0,146,146,55
6,r_62_32_84,seq143,seq130,r_62_32_84,0.7,0,84,84,55
62,seq144,seq118,r_133_96_125,r_133_96_125,1.0,43,168,125,55
2,r_27_17_89,r_129_104_225,r_147_141_236,r_129_104_225,0.68,-20,205,225,55
5,r_132_91_18,r_106_148_244,r_112_48_92,r_112_48_92,1.0,16,108,92,55
27,r_101_16_156,r_1_94_149,seq8,r_101_16_156,0.99,-1,155,156,55
2,r_27_17_89,r_5_42_171,r_129_104_225,r_5_42_171,0.78,-77,94,171,55
41,r_29_114_167,r_71_116_57,r_128_65_55,r_29_114_167,1.0,0,167,167,55
47,r_43_4_127,r_5_42_171,r_132_91_18,r_43_4_127,0.95,-2,125,127,55
93,seq105,seq9,r_1_94_149,r_1_94_149,0.93,29,178,149,55
40,r_22_24_86,seq13,seq26,r_22_24_86,1.0,0,86,86,55
18,r_85_10_151,seq142,seq70,r_85_10_151,0.92,3,154,151,55
61,seq143,seq105,r_1_94_149,r_1_94_149,1.0,0,149,149,55
34,r_108_119_203,r_79_40_71,r_36_2_41,r_108_119_203,0.92,1,204,203,55
11,r_51_110_45,seq20,r_132_91_18,r_51_110_45,0.97,-2,43,45,55
21,r_121_126_26,r_80_46_189,seq78,r_121_126_26,1.0,0,26,26,55
33,r_125_134_99,r_82_33_146,seq138,r_125_134_99,0.98,0,99,99,55
36,r_106_148_244,r_122_75_234,r_132_91_18,r_132_91_18,1.0,4,22,18,55
92,seq102,seq11,r_35_74_180,r_35_74_180,1.0,19,199,180,55
70,seq37,r_112_48_92,seq45,r_112_48_92,1.0,1,93,92,55
31,r_55_124_34,r_82_33_146,seq100,r_55_124_34,0.99,0,34,34,55
34,r_108_119_203,r_5_42_171,r_79_40_71,r_79_40_71,0.95,5,76,71,55
67,seq23,r_61_140_245,r_14_50_42,r_14_50_42,1.0,8,50,42,55
26,r_71_116_57,seq89,r_29_114_167,r_71_116_57,1.0,0,57,57,55
81,seq78,r_69_25_197,r_128_65_55,r_128_65_55,1.0,49,104,55,55
17,r_122_75_234,seq77,r_71_116_57,r_71_116_57,1.0,177,234,57,55
9,r_82_33_146,r_125_134_99,seq0,r_125_134_99,1.0,0,99,99,55
63,seq146,seq58,r_30_109_82,r_30_109_82,0.66,117,199,82,55
26,r_71_116_57,r_29_114_167,r_61_140_245,r_29_114_167,1.0,0,167,167,55
73,seq47,r_55_124_34,r_73_21_196,r_55_124_34,0.5,163,197,34,55
5,r_132_91_18,r_128_65_55,r_106_148_244,r_106_148_244,0.99,-225,19,244,55
49,r_103_137_69,r_30_109_82,seq130,r_103_137_69,1.0,0,69,69,55
7,r_5_42_171,seq131,r_85_10_151,r_5_42_171,0.97,0,171,171,55
44,r_56_81_192,seq49,r_54_15_23,r_54_15_23,0.84,178,201,23,55
26,r_71_116_57,r_61_140_245,r_122_75_234,r_122_75_234,0.54,0,234,234,55
14,r_113_38_9,r_54_15_23,seq89,r_54_15_23,0.72,89,112,23,55
35,r_57_95_140,seq100,seq135,r_57_95_140,1.0,0,140,140,55
12,r_80_46_189,seq3,r_79_40_71,r_79_40_71,0.58,119,190,71,55
93,seq114,r_135_117_118,seq53,r_135_117_118,1.0,-56,62,118,56
30,r_22_26_158,r_27_14_168,r_58_37_84,r_27_14_168,0.83,-4,164,168,56
92,seq111,seq47,r_74_1_23,r_74_1_23,0.88,6,29,23,56
14,r_83_81_200,seq148,seq9,r_83_81_200,0.42,0,200,200,56
3,r_4_85_99,r_130_7_205,seq25,r_130_7_205,0.6,1,206,205,56
59,seq16,r_80_21_212,seq131,r_80_21_212,0.96,-9,203,212,56
16,r_71_97_94,seq127,seq148,r_71_97_94,0.6,3,97,94,56
21,r_135_117_118,seq50,r_34_125_60,r_135_117_118,1.0,1,119,118,56
1,r_80_21_212,seq16,seq104,r_80_21_212,0.56,0,212,212,56
42,r_8_94_172,seq51,r_134_149_90,r_8_94_172,0.94,4,176,172,56
7,r_134_149_90,seq70,r_8_94_172,r_8_94_172,1.0,4,176,172,56
69,seq33,r_46_84_192,r_115_98_184,r_46_84_192,0.71,-41,151,192,56
19,r_27_14_168,r_22_26_158,seq62,r_27_14_168,0.85,0,168,168,56
53,seq9,r_71_97_94,r_57_87_32,r_57_87_32,0.96,2,34,32,56
38,r_34_125_60,r_46_84_192,r_135_117_118,r_34_125_60,0.69,133,193,60,56
31,r_116_145_127,seq67,r_5_73_14,r_116_145_127,0.93,0,127,127,56
41,r_108_2_197,seq25,r_83_81_200,r_83_81_200,0.72,4,204,200,56
89,seq104,r_106_91_199,seq67,r_106_91_199,1.0,0,199,199,56
37,r_109_121_48,r_54_64_203,seq6,r_109_121_48,1.0,0,48,48,56
3,r_4_85_99,seq24,r_130_7_205,r_4_85_99,1.0,0,99,99,56
10,r_58_37_84,seq148,r_88_136_202,r_58_37_84,0.77,3,87,84,56
26,r_44_59_93,r_99_90_230,seq102,r_44_59_93,1.0,0,93,93,56
13,r_106_91_199,seq104,seq15,r_106_91_199,0.93,0,199,199,56
90,seq105,seq86,r_35_56_55,r_35_56_55,1.0,1,56,55,56
15,r_32_43_103,r_113_36_167,r_109_121_48,r_109_121_48,0.92,55,103,48,56
6,r_88_136_202,seq122,r_58_37_84,r_88_136_202,0.49,-132,70,202,56
52,seq6,seq47,r_109_121_48,r_109_121_48,1.0,4,52,48,56
8,r_137_103_41,r_115_98_184,seq30,r_137_103_41,1.0,0,41,41,56
10,r_58_37_84,r_88_136_202,r_22_26_158,r_22_26_158,0.8,17,175,158,56
27,r_28_89_133,seq104,seq142,r_28_89_133,1.0,0,133,133,56
79,seq67,seq77,r_80_21_212,r_80_21_212,1.0,17,229,212,56
2,r_63_55_1,r_79_143_233,r_92_72_112,r_79_143_233,0.74,0,233,233,56
47,r_69_82_151,seq142,r_75_18_52,r_69_82_151,0.94,0,151,151,56
74,seq50,r_135_117_118,r_134_149_90,r_135_117_118,0.47,1,119,118,56
18,r_48_38_210,seq146,r_58_37_84,r_58_37_84,0.73,6,90,84,56
35,r_46_84_192,r_34_125_60,seq47,r_34_125_60,0.61,133,193,60,56
25,r_113_36_167,r_92_72_112,r_74_1_23,r_113_36_167,0.91,0,167,167,56
46,r_107_39_31,r_115_98_184,seq13,r_107_39_31,0.99,0,31,31,56
68,seq31,seq119,r_93_118_25,r_93_118_25,0.83,2,27,25,56
6,r_88_136_202,r_58_37_84,r_71_97_94,r_88_136_202,0.36,2,204,202,56
38,r_34_125_60,r_0_29_241,r_46_84_192,r_34_125_60,1.0,0,60,60,56
34,r_133_66_150,seq67,seq40,r_133_66_150,0.91,1,151,150,56
48,r_35_56_55,r_115_98_184,seq105,r_35_56_55,1.0,1,56,55,56
45,r_75_18_52,seq96,r_27_14_168,r_75_18_52,1.0,0,52,52,56
45,r_75_18_52,r_27_14_168,r_69_82_151,r_75_18_52,1.0,116,168,52,56
17,r_54_64_203,seq110,r_83_81_200,r_54_64_203,0.32,3,206,203,56
56,seq13,r_88_136_202,r_107_39_31,r_107_39_31,1.0,1,32,31,56
9,r_144_138_231,seq76,r_44_59_93,r_44_59_93,1.0,138,231,93,56
43,r_115_98_184,r_35_56_55,seq33,r_35_56_55,1.0,1,56,55,56
0,r_93_118_25,r_79_143_233,seq31,r_93_118_25,1.0,0,25,25,56
28,r_49_95_176,seq70,seq17,r_49_95_176,0.62,0,176,176,56
91,seq110,r_54_64_203,seq102,r_54_64_203,0.73,0,203,203,56
49,r_100_20_75,r_135_117_118,r_92_72_112,r_100_20_75,1.0,0,75,75,56
4,r_5_73_14,seq119,r_112_52_8,r_5_73_14,0.68,2,16,14,56
7,r_134_149_90,seq41,seq70,r_134_149_90,0.87,5,95,90,56
44,r_101_65_125,seq11,seq15,r_101_65_125,0.57,46,171,125,56
11,r_57_87_32,r_135_117_118,seq9,r_57_87_32,0.98,0,32,32,56
20,r_42_12_29,seq6,r_129_61_66,r_42_12_29,0.96,0,29,29,56
35,r_46_84_192,seq33,r_34_125_60,r_34_125_60,1.0,0,60,60,56
23,r_74_1_23,r_49_95_176,seq111,r_74_1_23,0.99,-2,21,23,56
12,r_79_143_233,r_63_55_1,r_144_138_231,r_79_143_233,0.27,0,233,233,56
39,r_139_132_33,r_135_117_118,seq30,r_139_132_33,0.97,3,36,33,56
93,seq113,r_3_73_225,r_29_123_82,r_29_123_82,1.0,24,106,82,57
30,r_82_144_154,r_131_41_115,seq30,r_131_41_115,1.0,0,115,115,57
51,seq132,r_3_73_225,r_78_105_69,r_78_105_69,1.0,120,189,69,57
92,seq112,r_14_104_165,r_39_106_111,r_14_104_165,0.81,1,166,165,57
8,r_28_140_219,r_52_15_126,seq10,r_52_15_126,0.99,2,128,126,57
0,r_52_15_126,r_28_140_219,seq137,r_52_15_126,0.99,0,126,126,57
37,r_55_2_62,r_34_0_176,seq109,r_55_2_62,1.0,0,62,62,57
86,seq95,r_90_4_232,r_62_110_238,r_90_4_232,0.74,0,232,232,57
16,r_76_148_164,seq22,r_47_24_173,r_47_24_173,0.5,0,173,173,57
39,r_17_48_85,seq71,seq23,r_17_48_85,1.0,1,86,85,57
1,r_80_99_162,seq127,seq91,r_80_99_162,0.65,0,162,162,57
5,r_72_102_65,seq51,seq42,r_72_102_65,1.0,-1,64,65,57
69,seq51,seq30,r_139_108_87,r_139_108_87,0.98,36,123,87,57
45,r_26_57_96,r_52_15_126,r_125_69_142,r_26_57_96,0.95,0,96,96,57
19,r_74_31_185,seq142,r_37_100_160,r_74_31_185,0.89,0,185,185,57
40,r_8_12_49,seq113,seq71,r_8_12_49,1.0,1,50,49,57
76,seq75,r_1_115_178,r_13_67_17,r_13_67_17,0.92,161,178,17,57
43,r_60_25_7,r_136_117_22,r_90_4_232,r_136_117_22,0.48,-10,12,22,57
89,seq103,r_111_130_180,r_92_68_37,r_111_130_180,0.89,2,182,180,57
3,r_133_53_81,seq96,r_13_67_17,r_133_53_81,0.73,1,82,81,57
10,r_14_104_165,seq112,r_37_100_160,r_14_104_165,0.96,1,166,165,57
26,r_125_69_142,seq87,r_19_35_104,r_125_69_142,0.92,3,145,142,57
78,seq83,r_11_20_228,seq87,r_11_20_228,0.52,-34,194,228,57
0,r_52_15_126,r_6_147_89,r_28_140_219,r_6_147_89,0.97,-1,88,89,57
63,seq42,seq16,r_131_41_115,r_131_41_115,1.0,1,116,115,57
11,r_6_147_89,r_52_15_126,r_55_2_62,r_6_147_89,1.0,0,89,89,57
20,r_50_81_206,seq56,seq59,r_50_81_206,0.81,0,206,206,57
15,r_47_24_173,seq44,r_76_148_164,r_47_24_173,0.89,-1,172,173,57
48,r_94_33_135,seq49,seq137,r_94_33_135,0.99,0,135,135,57
57,seq149,r_143_146_125,seq36,r_143_146_125,1.0,-1,124,125,57
6,r_78_105_69,r_101_9_194,seq132,r_78_105_69,1.0,0,69,69,57
43,r_60_25_7,seq127,r_121_77_39,r_121_77_39,0.54,102,141,39,57
13,r_121_77_39,r_47_24_173,seq112,r_121_77_39,1.0,0,39,39,57
99,seq127,r_64_63_93,seq128,r_64_63_93,1.0,0,93,93,57
41,r_138_141_26,r_120_18_113,seq114,r_138_141_26,0.94,0,26,26,57
27,r_64_63_93,seq127,r_7_145_41,r_64_63_93,0.6,0,93,93,57
81,seq86,r_120_18_113,r_136_117_22,r_136_117_22,0.62,-1,21,22,57
12,r_7_145_41,seq42,seq46,r_7_145_41,0.98,0,41,41,57
29,r_39_106_111,r_74_31_185,seq112,r_74_31_185,0.85,-75,110,185,57
45,r_26_57_96,r_125_69_142,r_143_146_125,r_26_57_96,0.8,47,143,96,57
8,r_28_140_219,seq10,r_47_24_173,r_47_24_173,0.67,-1,172,173,57
34,r_54_122_38,seq112,r_121_77_39,r_54_122_38,0.42,143,181,38,57
33,r_29_123_82,r_5_70_233,seq113,r_29_123_82,1.0,-1,81,82,57
46,r_129_27_36,r_72_102_65,seq22,r_129_27_36,1.0,-4,32,36,57
70,seq56,r_50_81_206,r_62_110_238,r_50_81_206,1.0,0,206,206,57
42,r_136_117_22,seq23,seq86,r_136_117_22,1.0,1,23,22,57
38,r_34_0_176,seq36,seq58,r_34_0_176,0.93,1,177,176,57
34,r_54_122_38,r_101_9_194,seq112,r_101_9_194,0.6,-153,41,194,57
17,r_5_70_233,seq114,r_78_105_69,r_78_105_69,1.0,166,235,69,57
9,r_3_73_225,seq132,r_72_102_65,r_72_102_65,1.0,160,225,65,57
8,r_28_140_219,r_47_24_173,r_78_105_69,r_28_140_219,0.95,-1,218,219,57
22,r_120_18_113,seq86,r_6_147_89,r_120_18_113,1.0,0,113,113,57
91,seq109,seq119,r_55_2_62,r_55_2_62,1.0,8,70,62,57
49,r_139_108_87,r_3_73_225,seq51,r_3_73_225,0.67,-138,87,225,57
7,r_143_146_125,seq149,r_26_57_96,r_143_146_125,1.0,0,125,125,57
23,r_131_41_115,r_82_144_154,seq42,r_131_41_115,1.0,0,115,115,57
32,r_13_67_17,r_121_77_39,seq75,r_13_67_17,0.97,0,17,17,57
43,r_60_25_7,r_90_4_232,seq127,r_60_25_7,0.34,50,57,7,57
93,seq114,r_38_2_211,r_82_97_70,r_82_97_70,1.0,99,169,70,58
30,r_121_7_200,seq135,seq18,r_121_7_200,0.91,1,201,200,58
36,r_141_64_95,seq34,seq115,r_141_64_95,0.81,0,95,95,58
14,r_70_107_204,seq114,r_5_81_109,r_5_81_109,0.97,98,207,109,58
8,r_131_138_213,r_78_29_222,r_116_109_18,r_116_109_18,0.73,195,213,18,58
36,r_141_64_95,seq115,r_147_26_129,r_147_26_129,0.93,6,135,129,58
37,r_52_16_160,seq10,seq41,r_52_16_160,0.9,0,160,160,58
86,seq98,r_77_23_175,seq34,r_77_23_175,0.98,0,175,175,58
16,r_77_23_175,r_30_113_133,seq98,r_30_113_133,0.97,0,133,133,58
21,r_145_84_164,r_140_61_148,r_130_1_113,r_145_84_164,0.37,-50,114,164,58
39,r_99_45_107,r_52_16_160,seq146,r_52_16_160,0.84,-48,112,160,58
1,r_137_100_155,seq19,r_67_111_159,r_137_100_155,0.92,4,159,155,58
97,seq123,seq101,r_59_55_58,r_59_55_58,0.65,124,182,58,58
5,r_30_113_133,r_77_23_175,seq115,r_30_113_133,1.0,0,133,133,58
46,r_142_27_236,seq88,r_128_144_182,r_142_27_236,0.21,2,238,236,58
33,r_86_136_36,r_70_107_204,seq10,r_86_136_36,0.92,2,38,36,58
44,r_116_109_18,r_137_100_155,seq94,r_116_109_18,0.83,0,18,18,58
45,r_119_35_214,seq106,r_76_75_176,r_76_75_176,0.96,42,218,176,58
19,r_83_79_117,r_25_28_196,seq91,r_83_79_117,0.98,0,117,117,58
3,r_40_110_191,seq0,seq124,r_40_110_191,0.88,-2,189,191,58
31,r_147_26_129,seq129,r_141_64_95,r_147_26_129,0.82,1,130,129,58
41,r_108_71_166,seq21,r_5_81_109,r_5_81_109,0.92,57,166,109,58
3,r_40_110_191,r_9_60_172,seq0,r_9_60_172,0.61,0,172,172,58
90,seq106,r_119_35_214,r_83_79_117,r_83_79_117,1.0,59,176,117,58
43,r_20_58_17,r_46_53_179,seq41,r_46_53_179,0.9,-155,24,179,58
26,r_67_111_159,r_119_35_214,r_137_100_155,r_67_111_159,0.49,11,170,159,58
0,r_51_105_233,r_38_2_211,r_82_97_70,r_82_97_70,1.0,142,212,70,58
73,seq54,r_30_113_133,seq98,r_30_113_133,0.99,-8,125,133,58
28,r_4_102_25,r_46_53_179,seq135,r_4_102_25,0.99,0,25,25,58
20,r_128_144_182,r_121_7_200,seq37,r_121_7_200,0.63,-92,108,200,58
13,r_82_97_70,r_17_149_156,seq114,r_82_97_70,1.0,0,70,70,58
98,seq124,r_131_138_213,r_40_110_191,r_40_110_191,0.96,22,213,191,58
21,r_145_84_164,r_130_1_113,seq44,r_145_84_164,1.0,0,164,164,58
15,r_9_60_172,r_40_110_191,r_83_79_117,r_83_79_117,0.75,55,172,117,58
48,r_48_127_184,seq123,seq21,r_48_127_184,0.72,0,184,184,58
62,seq22,r_77_23_175,seq34,r_77_23_175,1.0,0,175,175,58
85,seq95,seq112,r_118_89_28,r_118_89_28,0.95,48,76,28,58
2,r_25_28_196,r_93_132_130,r_46_53_179,r_25_28_196,0.79,5,201,196,58
27,r_93_132_130,seq57,r_20_58_17,r_93_132_130,0.58,5,135,130,58
87,seq101,seq123,r_46_53_179,r_46_53_179,0.72,3,182,179,58
6,r_139_133_13,r_30_113_133,seq10,r_139_133_13,1.0,0,13,13,58
2,r_25_28_196,r_83_79_117,r_93_132_130,r_25_28_196,0.6,-78,118,196,58
47,r_24_66_100,r_38_2_211,seq106,r_24_66_100,0.97,0,100,100,58
40,r_140_61_148,r_145_84_164,seq126,r_145_84_164,0.89,-10,154,164,58
74,seq56,r_32_87_239,r_137_100_155,r_137_100_155,1.0,26,181,155,58
29,r_130_1_113,r_125_6_123,seq85,r_125_6_123,0.93,-2,121,123,58
24,r_46_53_179,seq50,seq101,r_46_53_179,0.5,3,182,179,58
64,seq34,r_141_64_95,seq98,r_141_64_95,1.0,1,96,95,58
20,r_128_144_182,seq37,r_80_117_31,r_128_144_182,0.62,-9,173,182,58
34,r_17_149_156,seq41,r_139_133_13,r_17_149_156,0.79,1,157,156,58
60,seq19,r_137_100_155,r_59_55_58,r_137_100_155,1.0,4,159,155,58
17,r_63_42_162,seq129,r_140_61_148,r_63_42_162,0.66,-1,161,162,58
9,r_76_75_176,seq103,r_4_102_25,r_76_75_176,0.92,0,176,176,58
18,r_118_89_28,r_82_97_70,seq95,r_82_97_70,0.57,-42,28,70,58
53,seq135,r_128_144_182,r_4_102_25,r_4_102_25,0.91,17,42,25,58
22,r_5_81_109,seq115,seq10,r_5_81_109,1.0,0,109,109,58
91,seq146,seq92,r_99_45_107,r_99_45_107,0.53,54,161,107,58
0,r_51_105_233,r_82_97_70,r_30_113_133,r_51_105_233,0.9,1,234,233,58
16,r_77_23_175,seq98,r_82_97_70,r_77_23_175,0.93,0,175,175,58
23,r_125_6_123,r_130_1_113,r_147_26_129,r_130_1_113,1.0,1,114,113,58
32,r_80_117_31,r_128_144_182,seq129,r_80_117_31,0.6,6,37,31,58
12,r_38_2_211,r_51_105_233,r_80_117_31,r_80_117_31,0.51,181,212,31,58
36,r_141_64_95,r_147_26_129,r_30_113_133,r_30_113_133,0.7,93,226,133,58
23,r_125_6_123,r_147_26_129,r_30_113_133,r_30_113_133,0.73,95,228,133,58
40,r_35_136_194,seq52,r_142_98_136,r_35_136_194,0.98,0,194,194,59
30,r_84_71_227,seq108,r_121_57_56,r_121_57_56,1.0,36,92,56,59
54,seq133,r_121_57_56,r_8_141_210,r_121_57_56,0.44,2,58,56,59
92,seq108,r_84_71_227,r_70_56_147,r_70_56_147,0.76,72,219,147,59
14,r_63_38_93,r_128_27_113,seq39,r_63_38_93,1.0,0,93,93,59
8,r_97_68_168,seq10,seq104,r_97_68_168,0.99,0,168,168,59
53,seq4,seq60,r_5_100_52,r_5_100_52,1.0,90,142,52,59
37,r_37_114_92,r_77_11_175,r_91_43_51,r_37_114_92,1.0,0,92,92,59
2,r_54_111_33,r_17_127_164,seq147,r_54_111_33,1.0,0,33,33,59
39,r_81_78_225,seq40,r_50_95_23,r_50_95_23,0.86,202,225,23,59
1,r_90_146_216,r_105_132_218,seq0,r_90_146_216,0.84,0,216,216,59
5,r_65_93_77,r_77_11_175,seq104,r_77_11_175,0.73,-112,63,175,59
46,r_118_23_203,seq124,seq32,r_118_23_203,0.51,0,203,203,59
42,r_113_26_83,seq122,seq40,r_113_26_83,1.0,-2,81,83,59
80,seq62,r_14_123_160,seq130,r_14_123_160,1.0,-2,158,160,59
69,seq39,r_1_45_148,r_63_38_93,r_63_38_93,0.94,55,148,93,59
27,r_135_19_54,r_16_87_131,seq40,r_135_19_54,1.0,0,54,54,59
19,r_51_64_127,seq52,seq107,r_51_64_127,0.85,0,127,127,59
43,r_86_139_49,seq4,r_22_73_4,r_86_139_49,1.0,0,49,49,59
66,seq32,r_129_49_145,seq96,r_129_49_145,1.0,-62,83,145,59
29,r_121_57_56,seq133,seq108,r_121_57_56,0.94,-2,54,56,59
31,r_18_149_64,r_148_13_114,seq41,r_18_149_64,0.97,0,64,64,59
41,r_134_3_139,r_118_23_203,seq0,r_134_3_139,1.0,-1,138,139,59
35,r_91_43_51,r_148_13_114,seq116,r_91_43_51,1.0,1,52,51,59
3,r_105_132_218,r_90_146_216,r_135_19_54,r_90_146_216,0.5,3,219,216,59
10,r_94_42_125,r_144_109_112,r_22_73_4,r_144_109_112,1.0,1,113,112,59
26,r_47_44_96,seq0,r_18_149_64,r_47_44_96,1.0,0,96,96,59
4,r_77_11_175,r_142_98_136,r_82_20_129,r_77_11_175,0.89,-42,133,175,59
11,r_142_98_136,r_77_11_175,r_51_64_127,r_142_98_136,0.85,0,136,136,59
13,r_82_20_129,seq59,seq104,r_82_20_129,0.99,1,130,129,59
6,r_128_27_113,r_97_68_168,r_137_69_223,r_137_69_223,0.71,4,227,223,59
15,r_144_109_112,r_94_42_125,seq122,r_144_109_112,0.96,0,112,112,59
48,r_1_45_148,seq39,seq36,r_1_45_148,0.95,0,148,148,59
72,seq46,seq31,r_15_33_15,r_15_33_15,1.0,33,48,15,59
57,seq9,r_67_28_201,r_120_66_75,r_120_66_75,0.97,27,102,75,59
6,r_128_27_113,seq147,r_77_11_175,r_128_27_113,0.97,0,113,113,59
99,seq126,r_89_143_217,r_140_138_171,r_140_138_171,0.94,51,222,171,59
52,seq131,r_99_102_19,r_37_114_92,r_37_114_92,1.0,56,148,92,59
10,r_94_42_125,r_22_73_4,r_89_143_217,r_22_73_4,0.51,206,210,4,59
30,r_84_71_227,r_121_57_56,r_80_12_224,r_84_71_227,0.52,0,227,227,59
87,seq101,r_105_132_218,seq117,r_105_132_218,0.86,0,218,218,59
40,r_35_136_194,r_140_138_171,seq52,r_140_138_171,0.89,-9,162,171,59
18,r_76_21_115,r_1_45_148,seq34,r_76_21_115,0.97,0,115,115,59
24,r_17_127_164,seq41,seq145,r_17_127_164,0.35,-15,149,164,59
25,r_70_56_147,r_8_141_210,r_121_57_56,r_70_56_147,0.5,1,148,147,59
33,r_119_53_206,seq30,r_120_66_75,r_120_66_75,0.7,131,206,75,59
82,seq75,r_22_73_4,r_97_68_168,r_97_68_168,0.94,38,206,168,59
7,r_50_95_23,seq59,seq39,r_50_95_23,0.82,0,23,23,59
20,r_99_102_19,seq145,seq131,r_99_102_19,0.98,0,19,19,59
89,seq104,r_128_27_113,r_97_68_168,r_97_68_168,1.0,5,173,168,59
70,seq40,r_81_78_225,r_113_26_83,r_113_26_83,1.0,90,173,83,59
6,r_128_27_113,r_77_11_175,r_97_68_168,r_128_27_113,1.0,62,175,113,59
20,r_99_102_19,seq131,r_37_114_92,r_37_114_92,1.0,-1,91,92,59
32,r_140_138_171,r_35_136_194,seq126,r_140_138_171,0.74,1,172,171,59
38,r_8_141_210,seq55,r_76_21_115,r_76_21_115,1.0,103,218,115,59
4,r_77_11_175,r_82_20_129,seq30,r_77_11_175,0.98,1,176,175,59
34,r_80_12_224,seq116,r_148_13_114,r_80_12_224,0.29,2,226,224,59
52,seq131,r_80_12_224,r_99_102_19,r_99_102_19,1.0,1,20,19,59
17,r_148_13_114,r_35_136_194,seq31,r_148_13_114,0.99,0,114,114,59
94,seq116,seq131,r_91_43_51,r_91_43_51,1.0,3,54,51,59
9,r_15_33_15,r_67_28_201,seq46,r_15_33_15,0.99,0,15,15,59
96,seq122,r_113_26_83,r_121_57_56,r_121_57_56,0.67,30,86,56,59
5,r_65_93_77,seq104,seq83,r_65_93_77,0.48,1,78,77,59
29,r_121_57_56,seq108,r_70_56_147,r_70_56_147,0.96,0,147,147,59
22,r_120_66_75,r_148_13_114,seq9,r_120_66_75,1.0,0,75,75,59
28,r_129_49_145,seq32,r_142_98_136,r_129_49_145,0.5,1,146,145,59
49,r_85_72_193,seq10,seq101,r_85_72_193,0.98,0,193,193,59
0,r_5_100_52,r_47_44_96,seq10,r_5_100_52,1.0,1,53,52,59
44,r_110_115_166,r_84_71_227,seq125,r_110_115_166,0.65,1,167,166,59
23,r_137_69_223,seq30,r_128_27_113,r_128_27_113,0.8,110,223,113,59
82,seq75,r_16_87_131,r_22_73_4,r_16_87_131,0.99,-3,128,131,59
96,seq122,r_121_57_56,r_144_109_112,r_144_109_112,1.0,0,112,112,59
12,r_2_79_88,r_47_44_96,seq60,r_2_79_88,1.0,1,89,88,59
36,r_26_32_146,seq129,seq68,r_26_32_146,0.97,0,146,146,60
33,r_87_93_34,seq107,r_13_120_20,r_87_93_34,0.92,1,35,34,60
74,seq37,r_87_93_34,r_19_0_88,r_19_0_88,1.0,1,89,88,60
43,r_80_147_118,r_124_79_121,seq137,r_80_147_118,0.99,1,119,118,60
37,r_115_44_82,seq138,r_63_45_35,r_115_44_82,1.0,0,82,82,60
16,r_42_139_169,seq8,r_125_88_27,r_42_139_169,0.99,0,169,169,60
21,r_86_36_128,seq133,seq70,r_86_36_128,0.99,5,133,128,60
1,r_19_0_88,seq43,seq37,r_19_0_88,0.97,1,89,88,60
97,seq121,r_77_55_237,r_75_123_160,r_75_123_160,0.88,77,237,160,60
39,r_13_120_20,r_33_41_162,r_2_95_69,r_2_95_69,0.66,-51,18,69,60
46,r_2_95_69,seq37,seq127,r_2_95_69,1.0,0,69,69,60
42,r_50_101_49,r_134_114_248,r_109_49_246,r_50_101_49,0.63,15,64,49,60
69,seq30,r_96_132_227,r_92_25_61,r_92_25_61,1.0,19,80,61,60
19,r_71_149_147,r_143_116_198,r_72_112_109,r_71_149_147,0.99,1,148,147,60
66,seq22,r_38_135_176,r_105_61_94,r_38_135_176,0.96,-62,114,176,60
76,seq129,r_26_32_146,r_103_60_2,r_26_32_146,1.0,0,146,146,60
41,r_66_81_134,r_26_32_146,r_125_88_27,r_125_88_27,1.0,107,134,27,60
84,seq70,seq84,r_86_36_128,r_86_36_128,1.0,2,130,128,60
3,r_24_28_161,seq104,r_92_25_61,r_24_28_161,1.0,0,161,161,60
10,r_144_97_197,r_53_128_240,r_109_49_246,r_109_49_246,0.53,-45,201,246,60
26,r_78_21_87,seq70,r_98_67_32,r_78_21_87,1.0,0,87,87,60
4,r_119_57_67,r_106_64_243,seq117,r_119_57_67,0.97,0,67,67,60
0,r_125_88_27,r_17_56_179,r_66_81_134,r_125_88_27,0.73,109,136,27,60
32,r_63_45_35,r_33_41_162,seq5,r_63_45_35,0.96,4,39,35,60
20,r_38_135_176,seq108,seq84,r_38_135_176,0.93,1,177,176,60
13,r_53_128_240,r_144_97_197,r_51_146_39,r_51_146_39,1.0,162,201,39,60
98,seq122,r_131_102_166,seq59,r_131_102_166,1.0,0,166,166,60
15,r_33_41_162,seq117,r_87_93_34,r_33_41_162,0.67,0,162,162,60
47,r_20_40_50,seq35,seq34,r_20_40_50,0.92,0,50,50,60
57,seq138,r_115_44_82,r_98_67_32,r_115_44_82,0.51,-5,77,82,60
35,r_51_146_39,r_106_64_243,r_53_128_240,r_51_146_39,0.99,0,39,39,60
30,r_98_67_32,seq110,seq138,r_98_67_32,0.99,-1,31,32,60
6,r_143_116_198,r_17_56_179,seq140,r_17_56_179,0.98,0,179,179,60
99,seq127,r_105_61_94,r_2_95_69,r_2_95_69,1.0,7,76,69,60
45,r_65_58_45,seq99,seq39,r_65_58_45,1.0,0,45,45,60
27,r_94_118_226,seq117,seq43,r_94_118_226,0.49,0,226,226,60
40,r_72_112_109,r_106_64_243,r_96_132_227,r_72_112_109,0.66,2,111,109,60
29,r_62_83_190,r_106_64_243,r_119_57_67,r_119_57_67,1.0,126,193,67,60
24,r_75_123_160,seq108,seq121,r_75_123_160,0.88,0,160,160,60
25,r_90_48_214,seq15,r_75_123_160,r_90_48_214,0.46,0,214,214,60
50,seq1,r_26_32_146,r_103_60_2,r_26_32_146,0.99,-19,127,146,60
61,seq15,r_90_48_214,r_51_146_39,r_51_146_39,0.64,175,214,39,60
38,r_3_4_195,r_109_49_246,r_63_45_35,r_63_45_35,0.66,162,197,35,60
34,r_105_61_94,seq130,seq22,r_105_61_94,0.61,5,99,94,60
40,r_72_112_109,r_96_132_227,r_71_149_147,r_71_149_147,0.59,1,148,147,60
31,r_92_25_61,seq68,seq30,r_92_25_61,0.99,-3,58,61,60
17,r_142_91_163,seq5,seq8,r_142_91_163,0.97,0,163,163,60
9,r_77_55_237,seq121,r_80_147_118,r_80_147_118,1.0,119,237,118,60
39,r_13_120_20,r_2_95_69,r_87_93_34,r_2_95_69,0.9,-25,44,69,60
22,r_96_132_227,seq30,r_42_139_169,r_42_139_169,0.97,58,227,169,60
28,r_12_82_99,seq8,r_85_126_11,r_12_82_99,1.0,0,99,99,60
91,seq104,r_24_28_161,r_103_60_2,r_24_28_161,0.63,0,161,161,60
49,r_46_27_117,r_124_79_121,r_109_49_246,r_46_27_117,0.99,3,120,117,60
56,seq137,seq89,r_80_147_118,r_80_147_118,1.0,10,128,118,60
7,r_134_114_248,r_50_101_49,r_9_10_95,r_9_10_95,0.99,2,97,95,60
44,r_17_56_179,r_143_116_198,r_24_28_161,r_17_56_179,0.88,0,179,179,60
23,r_85_126_11,r_106_64_243,r_12_82_99,r_12_82_99,1.0,12,111,99,60
14,r_109_49_246,r_106_64_243,r_50_101_49,r_50_101_49,0.66,5,54,49,60
12,r_9_10_95,r_77_55_237,r_134_114_248,r_9_10_95,1.0,1,96,95,60
84,seq70,r_78_21_87,seq84,r_78_21_87,1.0,0,87,87,60
22,r_75_79_43,r_102_68_49,seq76,r_75_79_43,1.0,1,44,43,61
30,r_78_138_227,seq97,r_114_86_56,r_114_86_56,0.98,171,227,56,61
51,seq128,r_145_108_215,seq73,r_145_108_215,0.86,-12,203,215,61
36,r_77_121_134,seq94,seq133,r_77_121_134,0.87,0,134,134,61
8,r_17_122_97,r_130_43_108,r_64_51_53,r_17_122_97,1.0,0,97,97,61
32,r_70_139_31,r_74_105_207,seq67,r_70_139_31,1.0,0,31,31,61
83,seq82,seq119,r_102_68_49,r_102_68_49,1.0,19,68,49,61
55,seq129,r_74_105_207,r_114_86_56,r_114_86_56,1.0,85,141,56,61
1,r_1_46_136,r_35_71_203,r_77_121_134,r_1_46_136,0.57,0,136,136,61
5,r_35_71_203,r_1_46_136,r_39_111_52,r_35_71_203,0.94,-103,100,203,61
46,r_69_66_158,seq90,seq73,r_69_66_158,0.97,0,158,158,61
42,r_80_29_72,seq94,r_37_88_60,r_80_29_72,1.0,0,72,72,61
19,r_47_57_117,seq63,r_102_68_49,r_102_68_49,1.0,80,129,49,61
15,r_54_141_167,r_27_8_12,r_110_85_21,r_54_141_167,0.77,-146,21,167,61
40,r_65_24_204,r_49_18_145,r_77_121_134,r_65_24_204,0.96,2,206,204,61
15,r_54_141_167,r_110_85_21,seq98,r_54_141_167,0.94,0,167,167,61
27,r_9_149_125,r_27_8_12,seq119,r_9_149_125,0.98,0,125,125,61
39,r_52_6_171,r_126_12_57,r_114_86_56,r_52_6_171,0.99,0,171,171,61
31,r_130_43_108,r_17_122_97,r_103_72_5,r_130_43_108,1.0,-11,97,108,61
41,r_60_142_175,r_118_4_222,seq107,r_60_142_175,0.65,0,175,175,61
3,r_31_26_228,seq21,r_7_83_157,r_31_26_228,0.59,1,229,228,61
26,r_10_96_192,r_112_20_194,r_84_113_50,r_84_113_50,0.98,142,192,50,61
4,r_25_56_130,r_118_4_222,seq21,r_25_56_130,1.0,0,130,130,61
78,seq63,r_49_18_145,r_114_86_56,r_114_86_56,0.76,89,145,56,61
11,r_32_100_86,seq3,seq30,r_32_100_86,0.97,0,86,86,61
2,r_114_86_56,r_7_83_157,seq129,r_114_86_56,1.0,0,56,56,61
20,r_112_20_194,r_10_96_192,r_32_100_86,r_32_100_86,0.9,110,196,86,61
49,r_126_12_57,r_52_6_171,r_99_91_101,r_52_6_171,0.91,-10,161,171,61
13,r_27_8_12,r_9_149_125,r_84_113_50,r_9_149_125,1.0,0,125,125,61
27,r_9_149_125,r_135_45_46,r_27_8_12,r_135_45_46,1.0,0,46,46,61
16,r_135_45_46,r_9_149_125,seq0,r_135_45_46,1.0,0,46,46,61
5,r_35_71_203,r_39_111_52,seq34,r_39_111_52,0.58,151,203,52,61
0,r_147_19_201,r_95_146_4,r_77_121_134,r_77_121_134,0.96,68,202,134,61
59,seq14,r_54_141_167,seq144,r_54_141_167,0.86,-129,38,167,61
14,r_140_134_42,r_145_108_215,r_39_111_52,r_140_134_42,0.99,0,42,42,61
9,r_64_51_53,r_145_108_215,seq76,r_64_51_53,1.0,0,53,53,61
21,r_39_111_52,r_52_6_171,r_140_134_42,r_39_111_52,0.96,7,59,52,61
47,r_50_125_188,r_145_108_215,r_114_86_56,r_50_125_188,0.91,0,188,188,61
93,seq107,r_38_16_160,r_60_142_175,r_60_142_175,1.0,3,178,175,61
40,r_65_24_204,r_54_141_167,r_49_18_145,r_49_18_145,0.64,22,167,145,61
18,r_74_105_207,seq129,seq21,r_74_105_207,0.68,0,207,207,61
29,r_7_83_157,seq3,seq123,r_7_83_157,0.61,1,158,157,61
24,r_37_88_60,seq34,r_110_85_21,r_37_88_60,0.95,1,61,60,61
34,r_49_18_145,r_65_24_204,r_70_139_31,r_65_24_204,0.89,2,206,204,61
33,r_93_87_140,r_147_19_201,seq62,r_93_87_140,1.0,0,140,140,61
70,seq34,r_27_8_12,r_35_71_203,r_27_8_12,0.64,195,207,12,61
64,seq21,r_31_26_228,r_25_56_130,r_25_56_130,1.0,20,150,130,61
25,r_84_113_50,seq28,r_27_8_12,r_84_113_50,0.94,3,53,50,61
39,r_52_6_171,r_39_111_52,r_126_12_57,r_52_6_171,0.91,-112,59,171,61
79,seq67,r_54_141_167,r_70_139_31,r_70_139_31,0.98,2,33,31,61
13,r_27_8_12,r_54_141_167,r_9_149_125,r_27_8_12,0.59,8,20,12,61
38,r_110_85_21,r_54_141_167,r_37_88_60,r_110_85_21,0.83,146,167,21,61
77,seq62,r_10_96_192,r_93_87_140,r_93_87_140,0.79,31,171,140,61
34,r_49_18_145,seq63,r_65_24_204,r_49_18_145,0.88,0,145,145,61
48,r_102_68_49,seq132,seq82,r_102_68_49,1.0,1,50,49,61
17,r_38_16_160,r_54_141_167,seq107,r_54_141_167,0.98,-19,148,167,61
25,r_84_113_50,r_27_8_12,r_10_96_192,r_10_96_192,0.98,0,192,192,61
68,seq30,r_135_45_46,seq97,r_135_45_46,0.94,-21,25,46,61
96,seq117,r_5_48_115,seq13,r_5_48_115,1.0,-15,100,115,61
28,r_99_91_101,r_147_19_201,r_126_12_57,r_99_91_101,0.5,-1,100,101,61
43,r_11_59_41,r_1_46_136,seq28,r_1_46_136,0.91,-90,46,136,61
49,r_126_12_57,seq13,r_52_6_171,r_126_12_57,0.82,4,61,57,61
7,r_58_120_120,r_60_142_175,r_80_29_72,r_60_142_175,0.95,-56,119,175,61
44,r_5_48_115,seq117,seq133,r_5_48_115,0.93,6,121,115,61
23,r_115_92_109,seq90,seq133,r_115_92_109,0.94,1,110,109,61
87,seq96,r_59_27_153,r_37_3_85,r_59_27_153,1.0,-47,106,153,62
30,r_127_146_127,seq131,seq135,r_127_146_127,0.76,0,127,127,62
51,seq1,r_16_41_181,r_59_27_153,r_59_27_153,0.87,28,181,153,62
43,r_59_27_153,seq13,r_98_58_47,r_59_27_153,0.99,0,153,153,62
54,seq5,seq102,r_16_41_181,r_16_41_181,0.97,0,181,181,62
44,r_98_58_47,seq111,seq105,r_98_58_47,1.0,0,47,47,62
16,r_32_38_218,r_122_130_228,r_129_56_27,r_32_38_218,0.41,-157,61,218,62
39,r_100_54_144,r_112_10_180,r_49_133_246,r_100_54_144,0.98,0,144,144,62
1,r_29_145_81,seq149,seq44,r_29_145_81,1.0,0,81,81,62
7,r_88_9_163,r_82_42_97,r_141_93_22,r_88_9_163,1.0,0,163,163,62
48,r_62_69_114,r_73_103_55,r_118_20_80,r_62_69_114,0.9,0,114,114,62
45,r_17_19_32,seq105,r_141_93_22,r_17_19_32,1.0,0,32,32,62
73,seq135,r_15_67_56,r_6_63_186,r_15_67_56,0.99,-1,55,56,62
27,r_33_61_19,seq22,seq110,r_33_61_19,1.0,0,19,19,62
66,seq24,r_140_87_223,seq81,r_140_87_223,0.98,0,223,223,62
41,r_52_119_96,r_49_133_246,r_68_83_37,r_52_119_96,1.0,0,96,96,62
10,r_37_3_85,seq44,seq7,r_37_3_85,0.68,18,103,85,62
8,r_15_67_56,seq135,seq60,r_15_67_56,0.95,-1,55,56,62
72,seq39,r_109_75_178,seq24,r_109_75_178,0.82,0,178,178,62
14,r_78_113_9,r_74_97_134,r_62_69_114,r_78_113_9,1.0,125,134,9,62
4,r_89_143_118,r_53_91_157,r_70_14_247,r_89_143_118,1.0,0,118,118,62
25,r_73_103_55,seq0,r_62_69_114,r_73_103_55,1.0,-1,54,55,62
0,r_109_75_178,seq39,r_59_27_153,r_109_75_178,0.58,0,178,178,62
11,r_16_41_181,seq1,seq5,r_16_41_181,0.85,0,181,181,62
36,r_68_83_37,r_74_97_134,seq102,r_68_83_37,1.0,-1,36,37,62
13,r_82_42_97,seq115,r_88_9_163,r_82_42_97,0.99,0,97,97,62
98,seq124,r_55_45_243,r_122_130_228,r_122_130_228,0.91,0,228,228,62
15,r_48_134_232,seq149,r_29_145_81,r_29_145_81,1.0,151,232,81,62
48,r_62_69_114,seq124,r_73_103_55,r_73_103_55,1.0,17,72,55,62
49,r_74_97_134,r_78_113_9,r_49_133_246,r_74_97_134,1.0,1,135,134,62
4,r_89_143_118,r_70_14_247,seq0,r_89_143_118,0.54,96,214,118,62
13,r_82_42_97,r_88_9_163,seq51,r_88_9_163,1.0,0,163,163,62
6,r_85_30_94,seq12,r_117_79_46,r_85_30_94,1.0,-1,93,94,62
94,seq111,seq115,r_117_79_46,r_117_79_46,1.0,-1,45,46,62
9,r_117_79_46,r_53_91_157,seq115,r_117_79_46,0.56,0,46,46,62
40,r_4_18_244,r_106_71_219,r_80_95_5,r_80_95_5,0.72,44,49,5,62
2,r_53_91_157,seq116,seq111,r_53_91_157,0.99,0,157,157,62
47,r_120_142_193,seq99,r_29_145_81,r_29_145_81,1.0,112,193,81,62
18,r_40_72_166,seq105,seq149,r_40_72_166,0.9,-1,165,166,62
29,r_21_128_137,r_107_147_67,seq28,r_21_128_137,1.0,0,137,137,62
28,r_49_133_246,seq0,r_100_54_144,r_100_54_144,0.99,7,151,144,62
49,r_74_97_134,r_68_83_37,r_78_113_9,r_74_97_134,0.79,-108,26,134,62
92,seq108,r_106_71_219,r_80_95_5,r_80_95_5,0.76,44,49,5,62
33,r_107_147_67,r_21_128_137,r_15_67_56,r_107_147_67,0.74,70,137,67,62
32,r_84_36_207,seq51,r_59_27_153,r_84_36_207,0.67,0,207,207,62
38,r_101_94_210,seq105,r_68_83_37,r_68_83_37,0.55,173,210,37,62
34,r_112_10_180,seq60,seq124,r_112_10_180,0.93,0,180,180,62
75,seq47,r_122_130_228,r_80_95_5,r_122_130_228,0.6,0,228,228,62
26,r_141_93_22,r_11_86_170,seq65,r_141_93_22,1.0,0,22,22,62
17,r_118_20_80,r_106_71_219,seq44,r_118_20_80,1.0,0,80,80,62
71,seq35,seq131,r_123_25_54,r_123_25_54,1.0,0,54,54,62
25,r_73_103_55,r_62_69_114,seq124,r_62_69_114,1.0,1,115,114,62
21,r_137_121_52,seq131,seq115,r_137_121_52,1.0,0,52,52,62
28,r_49_133_246,r_52_119_96,seq0,r_52_119_96,1.0,0,96,96,62
46,r_123_25_54,r_59_27_153,seq35,r_123_25_54,1.0,0,54,54,62
7,r_88_9_163,seq51,r_82_42_97,r_82_42_97,1.0,0,97,97,62
23,r_6_63_186,seq138,seq77,r_6_63_186,0.72,0,186,186,62
96,seq115,seq111,r_137_121_52,r_137_121_52,1.0,0,52,52,62
35,r_122_130_228,seq47,seq124,r_122_130_228,0.48,0,228,228,62
79,seq60,r_11_86_170,r_15_67_56,r_15_67_56,1.0,-1,55,56,62
23,r_22_66_51,r_67_8_81,seq2,r_67_8_81,0.94,-29,52,81,63
30,r_146_6_197,seq4,r_142_80_50,r_146_6_197,0.85,0,197,197,63
36,r_71_134_65,r_106_14_151,seq54,r_71_134_65,1.0,0,65,65,63
14,r_143_57_121,seq147,seq77,r_143_57_121,1.0,1,122,121,63
56,seq10,r_39_79_137,r_109_99_29,r_109_99_29,0.93,-2,27,29,63
54,seq5,r_93_107_231,seq21,r_93_107_231,0.91,-65,166,231,63
83,seq65,r_30_100_178,seq116,r_30_100_178,1.0,1,179,178,63
37,r_75_141_192,seq1,r_143_57_121,r_143_57_121,0.99,72,193,121,63
22,r_89_9_17,r_56_61_177,seq1,r_89_9_17,0.85,0,17,17,63
16,r_48_115_107,r_39_79_137,r_125_92_13,r_125_92_13,0.94,94,107,13,63
1,r_112_85_116,r_75_141_192,r_62_42_45,r_112_85_116,0.88,1,117,116,63
46,r_67_8_81,seq77,seq21,r_67_8_81,1.0,0,81,81,63
85,seq76,r_32_84_47,r_119_50_11,r_119_50_11,0.89,0,11,11,63
31,r_149_81_85,r_0_140_33,seq23,r_0_140_33,0.59,5,38,33,63
27,r_62_42_45,r_146_6_197,r_112_85_116,r_112_85_116,0.89,4,120,116,63
27,r_62_42_45,r_149_81_85,r_146_6_197,r_62_42_45,0.98,0,45,45,63
3,r_25_41_79,r_20_132_176,seq124,r_25_41_79,0.83,6,85,79,63
91,seq94,r_60_28_23,r_96_17_106,r_96_17_106,0.93,11,117,106,63
26,r_3_36_187,r_137_103_179,r_58_120_111,r_58_120_111,0.8,78,189,111,63
6,r_114_128_58,seq131,seq64,r_114_128_58,1.0,0,58,58,63
15,r_119_50_11,seq144,seq76,r_119_50_11,0.75,0,11,11,63
4,r_52_136_146,r_93_107_231,r_67_8_81,r_67_8_81,1.0,141,222,81,63
48,r_125_92_13,seq2,r_20_132_176,r_125_92_13,0.58,0,13,13,63
31,r_149_81_85,seq23,r_38_12_104,r_149_81_85,0.93,1,86,85,63
20,r_51_97_52,r_20_132_176,seq33,r_51_97_52,1.0,0,52,52,63
57,seq13,seq35,r_34_113_86,r_34_113_86,1.0,0,86,86,63
42,r_122_129_32,r_38_12_104,seq4,r_122_129_32,1.0,0,32,32,63
2,r_20_132_176,seq64,r_122_129_32,r_20_132_176,0.68,0,176,176,63
41,r_38_12_104,r_149_81_85,r_32_84_47,r_38_12_104,0.94,0,104,104,63
18,r_137_103_179,r_3_36_187,r_25_41_79,r_3_36_187,1.0,-7,180,187,63
29,r_27_135_122,seq116,r_96_17_106,r_27_135_122,1.0,0,122,122,63
24,r_106_14_151,r_71_134_65,seq90,r_71_134_65,1.0,0,65,65,63
25,r_43_102_8,r_86_19_134,r_130_121_70,r_43_102_8,0.95,61,69,8,63
33,r_30_100_178,seq65,r_71_134_65,r_71_134_65,1.0,114,179,65,63
48,r_125_92_13,r_20_132_176,r_48_115_107,r_125_92_13,0.78,110,123,13,63
64,seq21,r_95_139_196,r_67_8_81,r_67_8_81,0.98,101,182,81,63
21,r_0_140_33,r_149_81_85,seq37,r_0_140_33,1.0,0,33,33,63
32,r_56_61_177,seq76,seq94,r_56_61_177,0.94,0,177,177,63
38,r_95_139_196,seq21,seq105,r_95_139_196,0.79,0,196,196,63
5,r_138_127_14,seq23,seq24,r_138_127_14,1.0,-1,13,14,63
34,r_93_107_231,r_52_136_146,seq148,r_93_107_231,0.46,0,231,231,63
17,r_47_78_203,seq133,seq45,r_47_78_203,0.45,0,203,203,63
28,r_130_121_70,seq29,r_43_102_8,r_130_121_70,1.0,0,70,70,63
91,seq94,r_34_113_86,r_60_28_23,r_34_113_86,0.89,0,86,86,63
49,r_108_70_102,r_86_19_134,seq7,r_86_19_134,1.0,-15,119,134,63
7,r_74_59_220,seq1,r_108_70_102,r_74_59_220,0.31,0,220,220,63
94,seq110,r_32_84_47,r_123_11_7,r_32_84_47,0.62,11,58,47,63
41,r_38_12_104,r_122_129_32,r_149_81_85,r_38_12_104,1.0,-72,32,104,63
43,r_142_80_50,r_39_79_137,seq29,r_142_80_50,0.99,1,51,50,63
19,r_32_84_47,seq110,seq83,r_32_84_47,1.0,0,47,47,63
79,seq54,r_39_79_137,r_71_134_65,r_71_134_65,0.57,73,138,65,63
35,r_58_120_111,seq77,seq33,r_58_120_111,0.96,0,111,111,63
12,r_34_113_86,seq94,seq13,r_34_113_86,1.0,0,86,86,63
36,r_119_50_92,seq126,seq32,r_119_50_92,1.0,0,92,92,64
14,r_91_34_188,seq25,r_18_49_248,r_91_34_188,0.97,0,188,188,64
43,r_6_36_231,seq23,seq22,r_6_36_231,0.4,0,231,231,64
22,r_142_26_26,r_104_12_116,seq148,r_142_26_26,0.95,0,26,26,64
37,r_74_86_80,seq87,seq89,r_74_86_80,0.63,6,86,80,64
20,r_108_20_40,r_115_102_63,r_18_49_248,r_115_102_63,0.94,-23,40,63,64
59,seq17,r_137_94_210,r_141_80_100,r_141_80_100,0.83,111,211,100,64
16,r_109_145_175,seq11,r_121_93_146,r_109_145_175,1.0,0,175,175,64
21,r_111_59_61,r_74_86_80,r_88_45_123,r_111_59_61,0.96,-1,60,61,64
39,r_112_124_211,r_149_9_144,r_141_80_100,r_112_124_211,0.91,-109,102,211,64
12,r_1_40_49,seq5,seq69,r_1_40_49,1.0,0,49,49,64
46,r_123_24_135,seq128,r_72_120_223,r_123_24_135,1.0,2,137,135,64
42,r_64_31_149,seq128,r_0_130_140,r_64_31_149,1.0,0,149,149,64
15,r_117_129_242,r_68_106_46,r_137_94_210,r_117_129_242,0.67,-192,50,242,64
19,r_137_94_210,seq17,r_0_130_140,r_137_94_210,0.54,1,211,210,64
30,r_3_138_47,r_56_95_220,seq107,r_3_138_47,0.87,-1,46,47,64
15,r_117_129_242,r_137_94_210,r_104_12_116,r_104_12_116,0.56,10,126,116,64
66,seq25,r_91_34_188,seq73,r_91_34_188,1.0,0,188,188,64
80,seq70,r_3_138_47,r_28_66_130,r_28_66_130,0.73,1,131,130,64
39,r_112_124_211,r_141_80_100,seq13,r_112_124_211,0.96,1,212,211,64
41,r_90_62_69,seq4,r_115_102_63,r_90_62_69,1.0,0,69,69,64
3,r_61_58_77,r_141_80_100,seq51,r_61_58_77,1.0,0,77,77,64
10,r_0_130_140,seq132,seq32,r_0_130_140,1.0,0,140,140,64
26,r_10_134_228,seq107,seq78,r_10_134_228,0.43,1,229,228,64
8,r_52_63_41,r_97_67_10,r_16_53_95,r_52_63_41,0.45,66,107,41,64
4,r_79_29_204,r_37_96_200,r_118_44_50,r_79_29_204,0.87,-4,200,204,64
78,seq65,r_125_76_218,r_140_71_73,r_140_71_73,1.0,146,219,73,64
0,r_105_48_148,seq87,r_149_9_144,r_105_48_148,0.97,0,148,148,64
11,r_104_12_116,r_19_101_160,r_117_129_242,r_104_12_116,0.98,0,116,116,64
13,r_42_127_187,seq22,r_14_15_34,r_42_127_187,0.95,0,187,187,64
49,r_140_71_73,r_99_55_181,seq132,r_99_55_181,0.99,1,182,181,64
6,r_149_9_144,r_112_124_211,r_30_113_137,r_149_9_144,1.0,2,146,144,64
21,r_111_59_61,r_88_45_123,r_57_35_78,r_88_45_123,1.0,1,124,123,64
2,r_141_80_100,r_112_124_211,seq17,r_112_124_211,0.92,1,212,211,64
99,seq126,r_119_50_92,seq143,r_119_50_92,1.0,-7,85,92,64
8,r_52_63_41,seq81,r_97_67_10,r_52_63_41,1.0,0,41,41,64
27,r_30_113_137,seq147,r_149_9_144,r_149_9_144,0.99,6,150,144,64
62,seq148,seq46,r_142_26_26,r_142_26_26,1.0,1,27,26,64
87,seq87,r_105_48_148,seq43,r_105_48_148,1.0,0,148,148,64
1,r_97_67_10,r_88_45_123,seq51,r_97_67_10,0.84,0,10,10,64
2,r_141_80_100,seq32,r_112_124_211,r_141_80_100,1.0,0,100,100,64
40,r_16_53_95,seq114,r_52_63_41,r_52_63_41,1.0,68,109,41,64
29,r_139_131_103,r_42_127_187,seq98,r_139_131_103,0.99,1,104,103,64
35,r_19_101_160,seq98,seq147,r_19_101_160,1.0,0,160,160,64
25,r_99_55_181,r_125_76_218,r_140_71_73,r_140_71_73,1.0,0,73,73,64
33,r_18_49_248,r_56_95_220,r_108_20_40,r_18_49_248,0.53,-183,65,248,64
48,r_38_85_43,r_149_9_144,r_137_94_210,r_149_9_144,1.0,-37,107,144,64
48,r_38_85_43,r_137_94_210,r_104_12_116,r_38_85_43,0.65,126,169,43,64
50,seq128,r_123_24_135,r_68_106_46,r_123_24_135,0.95,2,137,135,64
47,r_68_106_46,r_117_129_242,seq4,r_68_106_46,0.98,0,46,46,64
65,seq23,r_6_36_231,seq116,r_6_36_231,0.98,0,231,231,64
61,seq147,r_30_113_137,r_19_101_160,r_19_101_160,0.95,0,160,160,64
32,r_28_66_130,seq32,seq70,r_28_66_130,0.99,0,130,130,64
38,r_57_35_78,r_6_36_231,r_111_59_61,r_57_35_78,1.0,0,78,78,64
52,seq4,r_90_62_69,r_68_106_46,r_90_62_69,0.86,-3,66,69,64
45,r_14_15_34,r_104_12_116,seq4,r_14_15_34,0.97,0,34,34,64
9,r_118_44_50,seq46,seq22,r_118_44_50,0.99,0,50,50,64
34,r_27_144_118,seq132,seq136,r_27_144_118,1.0,0,118,118,64
45,r_14_15_34,seq4,r_42_127_187,r_42_127_187,0.66,6,193,187,64
25,r_99_55_181,r_140_71_73,seq13,r_99_55_181,0.82,1,182,181,64
79,seq69,r_121_93_146,r_1_40_49,r_1_40_49,1.0,1,50,49,64
18,r_115_102_63,r_108_20_40,r_125_76_218,r_115_102_63,0.81,-42,21,63,64
48,r_38_85_43,r_61_58_77,r_149_9_144,r_38_85_43,0.99,0,43,43,64
28,r_88_45_123,seq25,r_111_59_61,r_111_59_61,1.0,10,71,61,64
49,r_140_71_73,r_121_93_146,r_99_55_181,r_140_71_73,1.0,1,74,73,64
56,seq11,r_109_145_175,r_83_82_9,r_109_145_175,0.71,1,176,175,64
7,r_37_96_200,r_79_29_204,r_104_12_116,r_37_96_200,0.99,0,200,200,64
44,r_56_95_220,r_18_49_248,r_140_71_73,r_140_71_73,0.98,147,220,73,64
17,r_83_82_9,r_37_96_200,seq11,r_37_96_200,1.0,-4,196,200,64
18,r_115_102_63,r_125_76_218,seq84,r_115_102_63,1.0,0,63,63,64
35,r_19_101_160,r_104_12_116,seq98,r_104_12_116,0.97,-39,77,116,64
28,r_88_45_123,r_111_59_61,seq147,r_88_45_123,1.0,1,124,123,64
30,r_118_17_84,seq71,r_16_145_134,r_118_17_84,0.85,0,84,84,65
44,r_28_42_238,seq35,r_112_138_91,r_112_138_91,0.96,2,93,91,65
51,seq130,seq75,r_31_33_72,r_31_33_72,0.98,27,99,72,65
14,r_133_65_198,r_22_54_213,r_112_138_91,r_133_65_198,0.84,-1,197,198,65
8,r_0_51_138,seq68,r_115_128_16,r_0_51_138,0.9,7,145,138,65
12,r_32_36_42,r_3_141_231,seq113,r_32_36_42,1.0,0,42,42,65
39,r_108_15_87,r_84_73_126,r_22_54_213,r_108_15_87,1.0,0,87,87,65
1,r_62_96_150,r_45_44_165,r_115_128_16,r_45_44_165,0.99,-13,152,165,65
13,r_79_81_15,r_28_42_238,seq137,r_79_81_15,0.98,0,15,15,65
5,r_97_121_92,seq68,seq35,r_97_121_92,0.99,2,94,92,65
46,r_30_132_141,seq64,seq111,r_30_132_141,0.96,0,141,141,65
45,r_112_138_91,r_41_76_111,r_28_42_238,r_112_138_91,1.0,0,91,91,65
48,r_26_67_24,r_118_17_84,seq92,r_26_67_24,0.54,0,24,24,65
44,r_28_42_238,r_79_81_15,seq35,r_79_81_15,0.8,0,15,15,65
19,r_139_55_110,seq74,r_16_145_134,r_139_55_110,0.76,0,110,110,65
39,r_108_15_87,r_22_54_213,r_72_38_100,r_22_54_213,1.0,0,213,213,65
31,r_19_116_201,seq68,r_133_65_198,r_19_116_201,0.82,0,201,201,65
41,r_22_54_213,seq102,r_108_15_87,r_108_15_87,1.0,47,134,87,65
67,seq29,seq131,r_8_70_74,r_8_70_74,0.97,-4,70,74,65
35,r_69_66_52,r_47_114_180,seq102,r_69_66_52,1.0,0,52,52,65
3,r_103_106_167,r_146_143_249,seq85,r_103_106_167,0.75,0,167,167,65
90,seq102,r_22_54_213,r_69_66_52,r_69_66_52,0.99,24,76,52,65
36,r_7_56_26,seq37,seq105,r_7_56_26,1.0,0,26,26,65
37,r_148_93_59,r_103_106_167,r_79_81_15,r_148_93_59,1.0,0,59,59,65
26,r_98_99_195,seq58,r_62_96_150,r_98_99_195,0.64,1,196,195,65
78,seq71,r_43_57_70,r_115_128_16,r_43_57_70,0.97,0,70,70,65
11,r_43_57_70,seq71,seq64,r_43_57_70,1.0,0,70,70,65
20,r_87_83_67,seq131,seq113,r_87_83_67,1.0,1,68,67,65
15,r_8_70_74,seq39,seq29,r_8_70_74,0.84,0,74,74,65
6,r_45_44_165,r_123_142_239,r_108_15_87,r_123_142_239,0.91,-74,165,239,65
0,r_77_2_219,seq4,r_103_106_167,r_77_2_219,0.58,1,220,219,65
27,r_146_143_249,r_103_106_167,r_89_94_137,r_146_143_249,1.0,-82,167,249,65
13,r_79_81_15,seq137,r_148_93_59,r_148_93_59,0.96,9,68,59,65
87,seq95,r_13_11_227,seq58,r_13_11_227,0.8,0,227,227,65
21,r_107_63_28,seq20,seq34,r_107_63_28,0.76,1,29,28,65
42,r_104_60_37,r_139_55_110,seq86,r_104_60_37,0.93,4,41,37,65
2,r_89_94_137,seq34,r_146_143_249,r_89_94_137,0.96,0,137,137,65
41,r_22_54_213,r_108_15_87,seq10,r_22_54_213,0.98,0,213,213,65
47,r_41_76_111,seq136,seq75,r_41_76_111,0.55,5,116,111,65
18,r_123_142_239,r_61_6_191,r_122_90_133,r_123_142_239,0.66,-48,191,239,65
24,r_13_11_227,seq95,r_22_54_213,r_13_11_227,0.6,0,227,227,65
25,r_122_90_133,seq39,r_123_142_239,r_122_90_133,0.83,1,134,133,65
33,r_49_82_64,r_13_11_227,seq39,r_49_82_64,0.97,0,64,64,65
61,seq147,r_91_46_101,seq4,r_91_46_101,1.0,0,101,101,65
32,r_61_6_191,r_123_142_239,seq39,r_61_6_191,0.6,0,191,191,65
52,seq131,r_87_83_67,seq4,r_87_83_67,0.99,1,68,67,65
34,r_135_9_173,r_77_2_219,seq1,r_135_9_173,0.93,0,173,173,65
75,seq58,r_98_99_195,seq95,r_98_99_195,0.99,1,196,195,65
45,r_112_138_91,r_28_42_238,r_133_65_198,r_133_65_198,0.85,5,203,198,65
17,r_3_141_231,r_52_24_228,r_62_96_150,r_62_96_150,0.49,78,228,150,65
9,r_84_73_126,seq27,r_104_60_37,r_84_73_126,0.88,-1,125,126,65
22,r_59_124_179,seq68,r_31_33_72,r_31_33_72,0.96,137,209,72,65
28,r_47_114_180,seq134,seq88,r_47_114_180,0.94,0,180,180,65
0,r_77_2_219,r_135_9_173,seq4,r_135_9_173,0.72,-127,46,173,65
49,r_72_38_100,seq119,r_108_15_87,r_72_38_100,0.94,0,100,100,65
7,r_91_46_101,seq147,seq35,r_91_46_101,1.0,0,101,101,65
23,r_31_33_72,seq92,seq130,r_31_33_72,0.94,0,72,72,65
44,r_28_42_238,r_112_138_91,r_107_63_28,r_28_42_238,0.42,0,238,238,65
93,seq110,r_62_99_88,r_134_87_238,r_62_99_88,1.0,0,88,88,66
51,seq129,r_67_105_102,r_7_51_111,r_7_51_111,0.9,2,113,111,66
45,r_143_88_41,r_7_51_111,seq90,r_143_88_41,0.97,2,43,41,66
92,seq109,seq5,r_138_135_162,r_138_135_162,1.0,4,166,162,66
14,r_115_15_177,seq34,seq139,r_115_15_177,0.91,1,178,177,66
8,r_70_120_76,r_62_99_88,r_143_88_41,r_70_120_76,1.0,0,76,76,66
35,r_145_63_105,r_1_13_46,seq29,r_145_63_105,1.0,0,105,105,66
37,r_93_68_165,seq109,r_75_149_22,r_93_68_165,0.88,0,165,165,66
23,r_74_52_54,seq129,r_61_30_7,r_74_52_54,0.95,0,54,54,66
16,r_36_141_94,seq83,seq109,r_36_141_94,1.0,0,94,94,66
21,r_132_4_151,r_71_142_167,seq46,r_132_4_151,0.71,7,158,151,66
5,r_14_32_72,seq37,seq83,r_14_32_72,0.89,7,79,72,66
69,seq38,r_92_102_183,r_93_68_165,r_92_102_183,0.54,1,184,183,66
46,r_1_13_46,r_145_63_105,r_69_91_156,r_145_63_105,1.0,-1,104,105,66
44,r_64_39_48,r_82_147_101,r_85_0_73,r_64_39_48,1.0,0,48,48,66
66,seq34,r_115_15_177,r_148_40_43,r_115_15_177,0.98,-49,128,177,66
76,seq58,r_31_78_142,seq6,r_31_78_142,1.0,0,142,142,66
38,r_7_51_111,seq113,seq129,r_7_51_111,1.0,0,111,111,66
31,r_3_16_100,r_70_120_76,r_134_87_238,r_70_120_76,0.8,-15,61,76,66
41,r_24_18_82,seq56,r_100_44_230,r_24_18_82,1.0,0,82,82,66
30,r_21_119_30,r_67_105_102,seq140,r_21_119_30,0.88,3,33,30,66
3,r_138_135_162,seq111,seq109,r_138_135_162,1.0,0,162,162,66
10,r_31_78_142,seq58,seq133,r_31_78_142,0.97,0,142,142,66
26,r_77_66_158,seq121,seq111,r_77_66_158,1.0,0,158,158,66
4,r_2_125_172,r_144_48_240,r_77_66_158,r_2_125_172,0.82,0,172,172,66
0,r_123_76_182,seq116,seq11,r_123_76_182,0.71,2,184,182,66
63,seq28,r_134_87_238,r_137_131_159,r_137_131_159,0.84,79,238,159,66
20,r_55_45_103,seq130,seq80,r_55_45_103,1.0,0,103,103,66
13,r_82_147_101,seq43,r_70_120_76,r_70_120_76,1.0,26,102,76,66
15,r_23_20_90,r_144_48_240,seq25,r_23_20_90,1.0,0,90,90,66
48,r_137_131_159,r_81_97_203,seq110,r_137_131_159,0.99,0,159,159,66
6,r_92_102_183,seq38,seq130,r_92_102_183,0.9,0,183,183,66
99,seq124,seq8,r_145_63_105,r_145_63_105,1.0,93,198,105,66
19,r_114_146_53,seq128,seq9,r_114_146_53,1.0,0,53,53,66
27,r_49_73_107,seq86,r_84_94_20,r_49_73_107,0.84,6,113,107,66
2,r_81_97_203,r_137_131_159,seq86,r_137_131_159,0.98,0,159,159,66
41,r_24_18_82,r_100_44_230,r_14_32_72,r_100_44_230,0.74,4,234,230,66
47,r_96_136_146,seq37,seq113,r_96_136_146,0.99,0,146,146,66
38,r_7_51_111,r_143_88_41,seq113,r_143_88_41,0.97,2,43,41,66
93,seq110,r_134_87_238,r_137_131_159,r_137_131_159,0.95,2,161,159,66
29,r_69_91_156,r_84_94_20,r_1_13_46,r_1_13_46,1.0,114,160,46,66
25,r_100_44_230,seq43,r_24_18_82,r_24_18_82,1.0,44,126,82,66
33,r_134_87_238,seq28,r_126_12_6,r_134_87_238,0.19,0,238,238,66
64,seq29,seq139,r_145_63_105,r_145_63_105,1.0,14,119,105,66
31,r_3_16_100,r_134_87_238,seq59,r_3_16_100,1.0,0,100,100,66
32,r_89_108_87,r_22_50_3,seq128,r_89_108_87,1.0,0,87,87,66
77,seq59,r_57_118_92,r_3_16_100,r_3_16_100,0.84,-1,99,100,66
85,seq90,r_112_33_9,r_143_88_41,r_143_88_41,1.0,11,52,41,66
34,r_62_99_88,seq110,seq111,r_62_99_88,1.0,0,88,88,66
43,r_75_149_22,seq106,seq43,r_75_149_22,0.59,1,23,22,66
25,r_100_44_230,r_24_18_82,r_55_45_103,r_100_44_230,0.68,4,234,230,66
2,r_81_97_203,seq86,r_75_149_22,r_81_97_203,0.86,1,204,203,66
49,r_57_118_92,seq59,seq34,r_57_118_92,0.91,4,96,92,66
7,r_84_94_20,r_69_91_156,r_49_73_107,r_49_73_107,1.0,53,160,107,66
40,r_112_33_9,r_92_102_183,seq90,r_112_33_9,0.42,13,22,9,66
35,r_145_63_105,r_69_91_156,r_1_13_46,r_1_13_46,0.95,19,65,46,66
12,r_67_105_102,seq129,seq111,r_67_105_102,0.96,1,103,102,66
46,r_1_13_46,seq72,r_145_63_105,r_1_13_46,0.88,0,46,46,66
93,seq104,r_51_63_208,r_40_49_130,r_40_49_130,0.91,77,207,130,67
30,r_10_22_247,r_110_76_228,r_119_131_161,r_119_131_161,0.75,26,187,161,67
51,seq134,r_23_132_193,seq139,r_23_132_193,0.99,1,194,193,67
36,r_145_6_117,seq64,seq97,r_145_6_117,1.0,1,118,117,67
8,r_112_123_133,seq74,seq149,r_112_123_133,1.0,1,134,133,67
43,r_18_85_134,seq59,seq147,r_18_85_134,0.99,1,135,134,67
54,seq9,r_82_143_225,r_19_106_72,r_19_106_72,0.99,153,225,72,67
37,r_51_63_208,seq104,seq101,r_51_63_208,0.87,0,208,208,67
71,seq53,r_65_54_227,seq139,r_65_54_227,1.0,-38,189,227,67
16,r_89_96_127,seq83,seq57,r_89_96_127,0.99,3,130,127,67
21,r_122_92_145,r_79_52_219,seq34,r_122_92_145,0.79,0,145,145,67
32,r_27_60_19,r_65_54_227,r_89_96_127,r_89_96_127,1.0,100,227,127,67
7,r_19_106_72,r_82_143_225,seq9,r_82_143_225,1.0,0,225,225,67
69,seq43,r_35_148_243,r_108_144_109,r_108_144_109,1.0,124,233,109,67
24,r_79_52_219,r_108_144_109,seq36,r_79_52_219,1.0,0,219,219,67
19,r_61_55_89,r_100_66_168,r_103_15_43,r_61_55_89,0.72,0,89,89,67
6,r_48_91_53,r_115_120_57,seq37,r_48_91_53,1.0,0,53,53,67
15,r_82_143_225,r_19_106_72,r_79_52_219,r_19_106_72,0.97,153,225,72,67
33,r_146_16_151,seq83,r_128_116_158,r_146_16_151,0.96,0,151,151,67
66,seq37,r_3_129_234,r_48_91_53,r_48_91_53,1.0,181,234,53,67
31,r_3_129_234,seq37,r_122_92_145,r_122_92_145,1.0,89,234,145,67
49,r_70_47_104,seq21,r_8_113_7,r_70_47_104,0.91,0,104,104,67
41,r_30_56_107,seq107,seq137,r_30_56_107,1.0,1,108,107,67
3,r_87_25_177,seq28,r_30_56_107,r_87_25_177,0.99,0,177,177,67
10,r_41_44_230,seq98,r_81_2_62,r_81_2_62,0.96,168,230,62,67
26,r_141_69_150,seq105,seq64,r_141_69_150,0.85,0,150,150,67
14,r_65_54_227,r_27_60_19,r_5_68_46,r_65_54_227,0.63,0,227,227,67
4,r_117_114_173,seq34,seq105,r_117_114_173,0.93,0,173,173,67
0,r_138_118_115,seq62,r_5_68_46,r_138_118_115,1.0,0,115,115,67
63,seq32,r_31_84_226,r_81_2_62,r_81_2_62,1.0,164,226,62,67
73,seq57,seq139,r_89_96_127,r_89_96_127,1.0,9,136,127,67
11,r_31_84_226,seq32,r_89_96_127,r_89_96_127,0.95,99,226,127,67
20,r_108_144_109,seq125,r_79_52_219,r_108_144_109,1.0,0,109,109,67
13,r_94_46_119,seq77,r_61_55_89,r_94_46_119,0.96,1,120,119,67
46,r_5_68_46,seq125,r_138_118_115,r_138_118_115,1.0,21,136,115,67
15,r_82_143_225,seq9,r_19_106_72,r_19_106_72,1.0,10,82,72,67
48,r_100_66_168,seq12,r_8_113_7,r_100_66_168,0.96,0,168,168,67
57,seq13,r_110_76_228,r_119_131_161,r_119_131_161,0.9,67,228,161,67
14,r_65_54_227,r_23_132_193,r_27_60_19,r_27_60_19,1.0,0,19,19,67
46,r_5_68_46,seq78,seq125,r_5_68_46,1.0,5,51,46,67
42,r_90_29_18,seq11,seq7,r_90_29_18,0.51,-5,13,18,67
47,r_17_33_87,r_70_47_104,seq59,r_17_33_87,0.99,0,87,87,67
40,r_119_131_161,seq38,seq77,r_119_131_161,0.81,0,161,161,67
29,r_23_132_193,seq134,seq62,r_23_132_193,0.85,1,194,193,67
17,r_103_15_43,seq50,seq64,r_103_15_43,1.0,0,43,43,67
24,r_79_52_219,r_122_92_145,r_108_144_109,r_79_52_219,0.63,-74,145,219,67
25,r_88_4_91,seq50,seq74,r_88_4_91,1.0,1,92,91,67
33,r_146_16_151,r_72_67_76,seq83,r_72_67_76,1.0,0,76,76,67
5,r_121_14_23,r_75_130_175,seq102,r_121_14_23,1.0,0,23,23,67
70,seq50,r_88_4_91,seq78,r_88_4_91,1.0,1,92,91,67
20,r_108_144_109,r_79_52_219,r_145_6_117,r_79_52_219,0.89,-1,218,219,67
32,r_27_60_19,r_108_144_109,r_65_54_227,r_27_60_19,1.0,0,19,19,67
19,r_61_55_89,r_103_15_43,r_94_46_119,r_94_46_119,1.0,12,131,119,67
81,seq77,r_94_46_119,r_110_76_228,r_94_46_119,1.0,1,120,119,67
94,seq105,r_26_45_233,r_117_114_173,r_117_114_173,0.91,60,233,173,67
9,r_127_86_232,seq74,r_112_123_133,r_112_123_133,1.0,98,231,133,67
98,seq126,r_146_16_151,r_122_92_145,r_122_92_145,0.3,84,229,145,67
22,r_39_133_201,seq1,r_115_120_57,r_115_120_57,1.0,144,201,57,67
28,r_40_49_130,r_39_133_201,seq104,r_40_49_130,1.0,0,130,130,67
81,seq77,r_110_76_228,r_119_131_161,r_119_131_161,0.73,8,169,161,67
49,r_70_47_104,r_17_33_87,seq21,r_17_33_87,0.98,-15,72,87,67
7,r_19_106_72,r_110_76_228,r_82_143_225,r_19_106_72,1.0,0,72,72,67
44,r_72_67_76,r_146_16_151,seq21,r_72_67_76,1.0,1,77,76,67
45,r_140_71_20,r_128_116_158,seq32,r_140_71_20,1.0,0,20,20,67
82,seq78,r_5_68_46,seq50,r_5_68_46,0.83,-29,17,46,67
23,r_111_0_121,seq101,r_140_71_20,r_111_0_121,0.96,3,124,121,67
12,r_81_2_62,seq28,r_140_71_20,r_81_2_62,1.0,1,63,62,67
38,r_115_120_57,seq137,seq59,r_115_120_57,1.0,0,57,57,67
30,r_10_9_138,r_127_103_172,r_111_104_240,r_10_9_138,1.0,0,138,138,68
40,r_5_25_65,r_73_66_53,seq52,r_73_66_53,0.88,-10,43,53,68
36,r_62_34_124,seq115,seq137,r_62_34_124,0.89,13,137,124,68
92,seq101,r_78_130_215,r_2_83_33,r_2_83_33,1.0,182,215,33,68
14,r_111_104_240,r_15_129_88,r_128_135_60,r_111_104_240,1.0,-150,90,240,68
8,r_146_77_237,seq136,r_97_59_140,r_97_59_140,1.0,97,237,140,68
43,r_28_87_118,r_95_70_243,r_125_0_57,r_28_87_118,1.0,0,118,118,68
19,r_79_11_98,r_132_82_115,r_148_46_23,r_148_46_23,1.0,-7,16,23,68
54,seq12,r_4_120_233,r_117_1_133,r_117_1_133,0.61,103,236,133,68
37,r_44_65_105,seq69,r_29_149_28,r_44_65_105,1.0,0,105,105,68
19,r_79_11_98,r_148_46_23,r_100_145_52,r_79_11_98,1.0,0,98,98,68
86,seq86,seq50,r_68_67_92,r_68_67_92,1.0,64,156,92,68
16,r_78_130_215,seq24,r_125_0_57,r_125_0_57,0.72,158,215,57,68
21,r_117_1_133,seq51,seq52,r_117_1_133,1.0,1,134,133,68
39,r_124_112_197,seq35,r_148_46_23,r_124_112_197,0.43,0,197,197,68
1,r_139_63_128,seq19,seq88,r_139_63_128,0.9,3,131,128,68
25,r_27_131_232,r_58_140_72,r_138_98_16,r_138_98_16,0.88,-1,15,16,68
69,seq40,r_4_120_233,r_23_96_32,r_23_96_32,0.85,202,234,32,68
45,r_113_102_162,seq105,seq76,r_113_102_162,0.81,-15,147,162,68
27,r_148_46_23,r_144_133_214,r_79_11_98,r_148_46_23,0.98,2,25,23,68
24,r_14_48_121,seq84,r_56_121_35,r_14_48_121,1.0,0,121,121,68
27,r_148_46_23,r_79_11_98,seq93,r_79_11_98,1.0,0,98,98,68
66,seq36,r_13_126_227,r_97_59_140,r_97_59_140,1.0,63,203,140,68
76,seq52,r_5_25_65,r_61_75_54,r_61_75_54,0.98,13,67,54,68
32,r_61_75_54,r_147_92_174,seq88,r_61_75_54,1.0,0,54,54,68
3,r_39_32_4,r_127_103_172,seq6,r_127_103_172,0.9,6,178,172,68
18,r_2_83_33,r_56_121_35,r_78_130_215,r_2_83_33,1.0,0,33,33,68
10,r_47_30_153,seq53,seq42,r_47_30_153,1.0,1,154,153,68
47,r_138_98_16,r_144_133_214,r_27_131_232,r_138_98_16,1.0,2,18,16,68
72,seq43,seq84,r_58_140_72,r_58_140_72,1.0,1,73,72,68
14,r_111_104_240,r_128_135_60,r_10_9_138,r_10_9_138,1.0,58,196,138,68
4,r_141_118_235,seq93,r_71_106_238,r_71_106_238,0.97,-3,235,238,68
11,r_147_92_174,seq42,r_49_54_62,r_147_92_174,0.98,0,174,174,68
46,r_100_145_52,seq33,seq60,r_100_145_52,1.0,0,52,52,68
50,seq6,r_127_103_172,r_100_145_52,r_100_145_52,1.0,0,52,52,68
31,r_23_96_32,seq31,r_5_25_65,r_5_25_65,1.0,7,72,65,68
13,r_107_116_189,seq17,seq50,r_107_116_189,0.69,5,194,189,68
98,seq115,r_62_34_124,r_8_85_131,r_8_85_131,1.0,6,137,131,68
15,r_8_85_131,r_111_104_240,seq76,r_8_85_131,0.98,0,131,131,68
48,r_123_80_69,r_147_92_174,r_2_83_33,r_123_80_69,0.97,0,69,69,68
12,r_73_66_53,r_144_133_214,r_62_34_124,r_62_34_124,0.9,91,215,124,68
62,seq26,r_13_126_227,r_97_59_140,r_97_59_140,1.0,3,143,140,68
30,r_10_9_138,r_111_104_240,r_58_140_72,r_111_104_240,0.5,0,240,240,68
2,r_58_140_72,seq37,seq43,r_58_140_72,0.98,0,72,72,68
41,r_49_54_62,r_124_112_197,r_147_92_174,r_147_92_174,0.67,23,197,174,68
24,r_14_48_121,r_15_129_88,seq84,r_14_48_121,0.84,-99,22,121,68
29,r_97_59_140,seq17,seq26,r_97_59_140,1.0,0,140,140,68
33,r_68_67_92,seq60,seq86,r_68_67_92,1.0,0,92,92,68
47,r_138_98_16,r_27_131_232,r_141_118_235,r_141_118_235,0.78,0,235,235,68
6,r_144_133_214,seq53,r_73_66_53,r_73_66_53,1.0,1,54,53,68
6,r_144_133_214,r_73_66_53,seq17,r_144_133_214,0.59,0,214,214,68
65,seq35,r_124_112_197,r_147_92_174,r_147_92_174,0.96,23,197,174,68
61,seq24,r_78_130_215,r_2_83_33,r_2_83_33,1.0,182,215,33,68
28,r_95_70_243,r_28_87_118,r_128_135_60,r_95_70_243,1.0,-184,59,243,68
40,r_5_25_65,seq52,seq136,r_5_25_65,0.98,1,66,65,68
34,r_94_57_61,r_119_21_248,r_29_149_28,r_94_57_61,1.0,1,62,61,68
17,r_128_135_60,r_97_59_140,r_95_70_243,r_128_135_60,0.71,-2,58,60,68
26,r_125_0_57,r_124_112_197,r_3_74_195,r_125_0_57,1.0,0,57,57,68
12,r_73_66_53,r_5_25_65,r_144_133_214,r_73_66_53,1.0,0,53,53,68
81,seq69,r_44_65_105,seq36,r_44_65_105,1.0,0,105,105,68
25,r_27_131_232,r_138_98_16,r_2_83_33,r_2_83_33,0.79,199,232,33,68
9,r_15_129_88,r_111_104_240,seq42,r_15_129_88,1.0,2,90,88,68
26,r_125_0_57,r_3_74_195,r_28_87_118,r_28_87_118,1.0,16,134,118,68
0,r_56_121_35,r_2_83_33,seq60,r_2_83_33,0.82,-1,32,33,68
14,r_111_104_240,r_10_9_138,r_132_82_115,r_111_104_240,0.96,0,240,240,68
22,r_119_21_248,r_124_112_197,r_147_92_174,r_147_92_174,0.99,23,197,174,68
91,seq93,r_132_82_115,r_148_46_23,r_132_82_115,0.64,1,116,115,68
5,r_29_149_28,r_3_74_195,seq38,r_29_149_28,0.82,-1,27,28,68
49,r_4_120_233,seq40,r_132_82_115,r_4_120_233,0.4,1,234,233,68
31,r_23_96_32,r_15_129_88,seq31,r_23_96_32,1.0,-1,31,32,68
7,r_127_103_172,r_39_32_4,seq64,r_39_32_4,0.53,174,178,4,68
18,r_2_83_33,r_78_130_215,seq101,r_78_130_215,0.61,0,215,215,68
23,r_132_82_115,seq93,seq45,r_132_82_115,0.88,1,116,115,68
41,r_49_54_62,seq45,r_124_112_197,r_49_54_62,0.59,-22,40,62,68
35,r_13_126_227,seq36,r_8_85_131,r_8_85_131,0.98,96,227,131,68
93,seq109,r_113_122_196,r_16_22_69,r_16_22_69,0.56,128,197,69,69
30,r_47_85_245,r_38_51_128,seq70,r_38_51_128,1.0,0,128,128,69
36,r_75_13_72,seq101,seq80,r_75_13_72,1.0,0,72,72,69
92,seq108,r_149_28_164,seq55,r_149_28_164,0.7,0,164,164,69
14,r_34_103_219,r_75_13_72,seq129,r_75_13_72,1.0,-4,68,72,69
43,r_144_142_70,seq20,seq93,r_144_142_70,0.87,2,72,70,69
48,r_21_146_12,seq93,seq118,r_21_146_12,0.98,0,12,12,69
54,seq128,seq37,r_7_94_54,r_7_94_54,1.0,15,69,54,69
37,r_66_71_91,seq20,seq101,r_66_71_91,1.0,0,91,91,69
3,r_3_127_8,r_100_63_71,r_114_46_247,r_100_63_71,1.0,0,71,71,69
3,r_3_127_8,r_114_46_247,r_38_51_128,r_38_51_128,1.0,59,187,128,69
39,r_88_89_213,r_98_104_111,r_131_10_212,r_98_104_111,1.0,0,111,111,69
1,r_41_147_216,seq90,r_141_44_1,r_41_147_216,0.55,0,216,216,69
97,seq120,seq128,r_30_31_11,r_30_31_11,0.97,170,181,11,69
5,r_2_76_175,r_29_14_17,seq140,r_2_76_175,0.87,1,176,175,69
42,r_116_92_147,r_58_87_170,r_21_146_12,r_116_92_147,0.9,-1,146,147,69
69,seq53,r_4_119_157,r_130_9_4,r_4_119_157,1.0,-65,92,157,69
98,seq123,r_72_50_221,seq65,r_72_50_221,0.52,-74,147,221,69
11,r_78_11_28,r_60_64_217,r_16_22_69,r_16_22_69,0.65,148,217,69,69
98,seq123,r_39_83_41,r_114_46_247,r_39_83_41,0.92,0,41,41,69
39,r_88_89_213,r_131_10_212,r_16_22_69,r_88_89_213,0.9,1,214,213,69
31,r_49_132_176,seq19,seq53,r_49_132_176,0.83,0,176,176,69
41,r_43_126_201,r_60_64_217,seq48,r_43_126_201,0.65,0,201,201,69
67,seq37,seq120,r_30_31_11,r_30_31_11,0.97,58,69,11,69
96,seq118,r_21_146_12,r_16_22_69,r_16_22_69,1.0,81,150,69,69
18,r_40_6_55,r_16_22_69,seq95,r_16_22_69,1.0,-12,57,69,69
72,seq57,r_112_115_222,r_67_125_143,r_67_125_143,0.99,9,152,143,69
4,r_121_59_74,seq55,r_8_54_43,r_121_59_74,1.0,0,74,74,69
13,r_60_64_217,r_43_126_201,r_78_11_28,r_78_11_28,0.67,161,189,28,69
15,r_58_87_170,seq95,seq53,r_58_87_170,0.83,0,170,170,69
12,r_38_51_128,r_114_46_247,r_3_127_8,r_38_51_128,0.53,74,202,128,69
6,r_112_115_222,seq99,seq124,r_112_115_222,0.26,7,229,222,69
85,seq95,r_58_87_170,r_40_6_55,r_58_87_170,0.96,-29,141,170,69
14,r_34_103_219,seq129,r_17_27_112,r_17_27_112,1.0,14,126,112,69
26,r_39_83_41,seq123,r_141_44_1,r_39_83_41,1.0,0,41,41,69
87,seq99,r_112_115_222,r_100_63_71,r_100_63_71,1.0,158,229,71,69
22,r_100_63_71,r_3_127_8,seq99,r_100_63_71,1.0,0,71,71,69
2,r_36_137_86,r_84_96_76,seq139,r_36_137_86,1.0,1,87,86,69
47,r_4_119_157,seq53,seq61,r_4_119_157,0.88,0,157,157,69
29,r_114_46_247,seq32,r_3_127_8,r_3_127_8,0.99,171,179,8,69
35,r_17_27_112,r_34_103_219,r_60_64_217,r_17_27_112,0.71,109,221,112,69
25,r_98_104_111,r_88_89_213,seq111,r_98_104_111,0.69,0,111,111,69
33,r_25_110_64,r_4_119_157,r_78_11_28,r_25_110_64,1.0,0,64,64,69
48,r_21_146_12,seq118,r_116_92_147,r_116_92_147,1.0,20,167,147,69
14,r_34_103_219,r_17_27_112,r_84_96_76,r_17_27_112,0.59,109,221,112,69
79,seq79,r_58_87_170,r_134_86_31,r_134_86_31,0.67,2,33,31,69
11,r_78_11_28,r_34_103_219,r_60_64_217,r_78_11_28,0.99,0,28,28,69
32,r_138_106_145,r_67_125_143,r_141_44_1,r_141_44_1,1.0,145,146,1,69
38,r_131_10_212,r_77_74_246,r_30_31_11,r_131_10_212,0.54,12,224,212,69
77,seq70,r_82_12_130,r_47_85_245,r_82_12_130,1.0,0,130,130,69
34,r_16_22_69,r_62_5_172,seq118,r_16_22_69,1.0,0,69,69,69
17,r_72_50_221,seq140,r_62_5_172,r_72_50_221,0.69,0,221,221,69
94,seq111,seq128,r_98_104_111,r_98_104_111,0.77,4,115,111,69
16,r_30_31_11,seq26,seq37,r_30_31_11,0.85,0,11,11,69
28,r_113_122_196,seq109,seq20,r_113_122_196,0.48,0,196,196,69
49,r_45_52_93,seq120,r_8_54_43,r_45_52_93,1.0,0,93,93,69
13,r_60_64_217,r_78_11_28,r_17_27_112,r_60_64_217,0.73,1,218,217,69
7,r_82_12_130,seq70,seq26,r_82_12_130,1.0,0,130,130,69
44,r_91_133_150,r_49_132_176,seq129,r_91_133_150,0.44,2,152,150,69
35,r_17_27_112,r_62_5_172,r_34_103_219,r_17_27_112,1.0,0,112,112,69
24,r_134_86_31,r_144_142_70,seq79,r_134_86_31,1.0,0,31,31,69
12,r_38_51_128,r_47_85_245,r_114_46_247,r_38_51_128,1.0,0,128,128,69
96,seq118,r_60_64_217,r_21_146_12,r_21_146_12,1.0,0,12,12,69
84,seq93,seq105,r_144_142_70,r_144_142_70,0.95,40,110,70,69
20,r_7_94_54,r_113_122_196,seq128,r_7_94_54,1.0,0,54,54,69
37,r_13_124_64,seq2,seq15,r_13_124_64,0.7,-8,56,64,70
47,r_63_90_36,r_18_60_212,seq39,r_63_90_36,0.85,1,37,36,70
51,seq1,seq108,r_20_107_126,r_20_107_126,1.0,51,177,126,70
36,r_101_143_211,seq39,r_28_97_48,r_28_97_48,1.0,166,214,48,70
9,r_115_50_95,r_140_129_234,r_144_10_84,r_115_50_95,0.65,139,234,95,70
49,r_5_104_147,r_67_3_176,r_46_134_21,r_5_104_147,0.86,0,147,147,70
54,seq6,seq131,r_106_133_106,r_106_133_106,0.79,8,114,106,70
10,r_99_110_27,r_145_137_118,seq31,r_99_110_27,1.0,4,31,27,70
19,r_9_26_146,seq59,seq100,r_9_26_146,1.0,2,148,146,70
55,seq135,seq32,r_140_129_234,r_140_129_234,0.72,0,234,234,70
39,r_70_17_61,seq92,seq41,r_70_17_61,1.0,0,61,61,70
46,r_20_107_126,r_5_104_147,r_71_16_89,r_71_16_89,0.93,37,126,89,70
42,r_24_8_98,r_106_133_106,r_54_58_75,r_106_133_106,1.0,-8,98,106,70
3,r_29_75_24,r_21_102_231,r_46_134_21,r_29_75_24,0.63,0,24,24,70
14,r_19_79_41,r_77_121_213,r_46_134_21,r_19_79_41,1.0,0,41,41,70
8,r_14_72_54,r_144_10_84,r_29_75_24,r_14_72_54,1.0,0,54,54,70
45,r_140_129_234,seq138,r_115_50_95,r_115_50_95,1.0,4,99,95,70
19,r_9_26_146,seq92,seq59,r_9_26_146,0.33,-62,84,146,70
32,r_25_52_47,r_13_124_64,seq85,r_25_52_47,0.93,0,47,47,70
33,r_86_98_144,r_46_134_21,r_106_133_106,r_86_98_144,0.53,0,144,144,70
43,r_28_97_48,r_147_141_137,r_18_60_212,r_28_97_48,1.0,1,49,48,70
31,r_35_103_239,seq108,r_139_42_133,r_139_42_133,1.0,19,152,133,70
21,r_145_137_118,r_99_110_27,seq135,r_99_110_27,0.98,0,27,27,70
41,r_88_91_69,r_43_112_193,seq73,r_88_91_69,0.82,1,70,69,70
90,seq92,r_70_17_61,seq59,r_70_17_61,1.0,0,61,61,70
41,r_88_91_69,seq73,r_71_16_89,r_71_16_89,1.0,4,93,89,70
26,r_114_0_160,r_21_102_231,seq68,r_114_0_160,0.99,-1,159,160,70
4,r_57_117_173,seq85,seq148,r_57_117_173,1.0,0,173,173,70
11,r_71_16_89,seq120,r_88_91_69,r_71_16_89,0.98,0,89,89,70
15,r_54_58_75,seq131,r_122_66_249,r_54_58_75,1.0,1,76,75,70
48,r_139_42_133,seq83,r_35_103_239,r_139_42_133,1.0,0,133,133,70
6,r_142_132_163,seq65,r_93_109_15,r_142_132_163,0.95,0,163,163,70
21,r_145_137_118,seq135,seq100,r_145_137_118,0.93,0,118,118,70
13,r_113_62_14,seq1,seq53,r_113_62_14,0.88,0,14,14,70
5,r_46_134_21,r_86_98_144,r_48_12_97,r_46_134_21,1.0,99,120,21,70
46,r_20_107_126,r_71_16_89,r_95_11_140,r_95_11_140,0.94,14,154,140,70
10,r_99_110_27,seq31,r_43_112_193,r_43_112_193,0.71,26,219,193,70
28,r_93_109_15,r_81_36_141,seq55,r_93_109_15,0.61,2,17,15,70
27,r_47_64_184,r_18_60_212,seq89,r_47_64_184,0.77,0,184,184,70
23,r_149_146_46,r_142_132_163,seq131,r_149_146_46,0.51,0,46,46,70
2,r_106_133_106,r_24_8_98,seq6,r_24_8_98,1.0,-1,97,98,70
40,r_144_10_84,r_94_7_203,seq138,r_144_10_84,0.7,7,91,84,70
3,r_29_75_24,r_46_134_21,r_14_72_54,r_14_72_54,1.0,8,62,54,70
18,r_48_12_97,seq131,r_46_134_21,r_48_12_97,0.95,0,97,97,70
29,r_94_7_203,seq31,r_118_80_93,r_94_7_203,0.41,-2,201,203,70
25,r_84_34_125,seq69,seq2,r_84_34_125,0.89,0,125,125,70
43,r_28_97_48,r_18_60_212,r_101_143_211,r_101_143_211,0.69,7,218,211,70
48,r_139_42_133,r_35_103_239,r_95_11_140,r_139_42_133,0.71,106,239,133,70
38,r_76_126_201,r_21_102_231,seq56,r_76_126_201,0.44,0,201,201,70
52,seq2,r_13_124_64,r_84_34_125,r_84_34_125,0.76,0,125,125,70
77,seq59,seq92,r_9_26_146,r_9_26_146,0.39,-62,84,146,70
34,r_119_4_128,seq130,seq69,r_119_4_128,0.94,0,128,128,70
5,r_46_134_21,seq73,r_86_98_144,r_46_134_21,0.93,0,21,21,70
33,r_86_98_144,seq130,r_46_134_21,r_46_134_21,1.0,3,24,21,70
45,r_140_129_234,r_115_50_95,seq135,r_115_50_95,0.37,139,234,95,70
17,r_147_141_137,seq89,seq32,r_147_141_137,0.68,0,137,137,70
94,seq108,seq73,r_71_16_89,r_71_16_89,1.0,21,110,89,70
9,r_115_50_95,seq23,r_140_129_234,r_115_50_95,1.0,0,95,95,70
77,seq59,r_9_26_146,seq92,r_9_26_146,1.0,-18,128,146,70
31,r_35_103_239,r_139_42_133,r_54_58_75,r_139_42_133,0.88,106,239,133,70
49,r_5_104_147,r_20_107_126,r_67_3_176,r_67_3_176,0.59,-50,126,176,70
24,r_123_38_17,r_13_124_64,r_46_134_21,r_13_124_64,0.87,-6,58,64,70
7,r_21_102_231,seq15,r_47_64_184,r_47_64_184,0.87,47,231,184,70
44,r_81_36_141,seq39,seq22,r_81_36_141,0.97,0,141,141,70
79,seq65,r_77_121_213,r_54_58_75,r_54_58_75,1.0,138,213,75,70
35,r_43_112_193,seq32,r_115_50_95,r_43_112_193,0.76,0,193,193,70
30,r_87_98_110,r_107_119_215,r_79_7_98,r_87_98_110,0.94,5,115,110,71
9,r_86_105_230,r_45_81_50,r_52_125_231,r_45_81_50,0.48,180,230,50,71
36,r_61_42_58,r_149_138_197,seq4,r_61_42_58,1.0,0,58,58,71
14,r_65_143_151,r_0_27_133,r_62_14_96,r_62_14_96,0.71,0,96,96,71
49,r_24_64_229,seq35,r_62_14_96,r_24_64_229,0.59,-83,146,229,71
53,seq4,r_86_105_230,r_61_42_58,r_61_42_58,1.0,6,64,58,71
22,r_126_53_25,r_58_46_82,seq92,r_126_53_25,0.84,1,26,25,71
14,r_65_143_151,r_62_14_96,seq11,r_65_143_151,1.0,0,151,151,71
16,r_145_123_156,seq39,r_23_67_76,r_145_123_156,1.0,0,156,156,71
21,r_91_19_182,seq93,seq39,r_91_19_182,0.91,0,182,182,71
1,r_36_113_136,seq56,r_146_135_70,r_36_113_136,0.98,1,137,136,71
5,r_52_125_231,r_149_138_197,r_43_63_55,r_43_63_55,1.0,115,170,55,71
46,r_60_21_159,seq93,r_114_73_69,r_60_21_159,1.0,-2,157,159,71
20,r_48_66_20,r_36_113_136,seq35,r_48_66_20,0.92,0,20,20,71
19,r_55_90_34,r_79_7_98,seq99,r_55_90_34,1.0,-3,31,34,71
43,r_18_85_179,r_83_44_212,r_77_103_16,r_77_103_16,1.0,33,49,16,71
31,r_43_63_55,seq93,r_52_125_231,r_43_63_55,1.0,-1,54,55,71
67,seq32,r_86_105_230,r_45_81_50,r_45_81_50,1.0,1,51,50,71
3,r_109_110_126,seq16,r_61_42_58,r_109_110_126,1.0,1,127,126,71
86,seq92,r_69_30_235,r_126_53_25,r_126_53_25,1.0,2,27,25,71
10,r_114_73_69,seq133,r_69_30_235,r_114_73_69,1.0,0,69,69,71
2,r_51_68_29,r_83_44_212,seq131,r_51_68_29,0.97,0,29,29,71
26,r_22_74_201,r_24_64_229,r_62_14_96,r_62_14_96,1.0,60,156,96,71
0,r_146_135_70,r_130_121_158,r_22_74_201,r_130_121_158,0.72,-88,70,158,71
11,r_142_5_99,r_76_59_238,seq57,r_142_5_99,1.0,0,99,99,71
13,r_23_67_76,seq35,seq133,r_23_67_76,1.0,0,76,76,71
15,r_149_138_197,r_52_125_231,r_43_63_55,r_43_63_55,1.0,99,154,55,71
48,r_54_8_122,seq17,r_61_42_58,r_54_8_122,1.0,0,122,122,71
6,r_69_30_235,seq92,r_114_73_69,r_114_73_69,1.0,19,88,69,71
81,seq78,seq89,r_45_81_50,r_45_81_50,1.0,1,51,50,71
8,r_1_137_22,r_146_135_70,seq16,r_1_137_22,1.0,0,22,22,71
5,r_52_125_231,r_43_63_55,r_86_105_230,r_52_125_231,1.0,0,231,231,71
0,r_146_135_70,r_22_74_201,r_36_113_136,r_36_113_136,0.76,-2,134,136,71
36,r_61_42_58,seq4,r_109_110_126,r_109_110_126,1.0,4,130,126,71
10,r_114_73_69,r_69_30_235,r_20_38_169,r_20_38_169,1.0,31,200,169,71
27,r_80_12_63,r_69_30_235,seq122,r_80_12_63,0.99,0,63,63,71
87,seq93,r_91_19_182,seq72,r_91_19_182,1.0,0,182,182,71
4,r_45_81_50,r_49_3_196,seq32,r_45_81_50,1.0,0,50,50,71
25,r_76_59_238,r_142_5_99,r_55_90_34,r_76_59_238,0.8,-207,31,238,71
47,r_58_46_82,seq134,r_80_12_63,r_58_46_82,1.0,3,85,82,71
40,r_83_44_212,seq111,r_58_46_82,r_58_46_82,0.91,130,212,82,71
29,r_130_121_158,seq133,r_126_53_25,r_130_121_158,0.96,0,158,158,71
24,r_0_27_133,r_65_143_151,seq94,r_0_27_133,1.0,0,133,133,71
34,r_107_119_215,seq94,r_109_110_126,r_107_119_215,0.95,0,215,215,71
43,r_18_85_179,r_77_103_16,r_130_121_158,r_18_85_179,0.96,0,179,179,71
23,r_62_14_96,r_65_143_151,r_24_64_229,r_65_143_151,1.0,0,151,151,71
33,r_95_108_167,seq4,r_88_41_149,r_95_108_167,0.97,1,168,167,71
18,r_100_97_46,seq34,seq17,r_100_97_46,1.0,1,47,46,71
50,seq129,r_49_3_196,seq16,r_49_3_196,0.74,-35,161,196,71
70,seq35,r_23_67_76,r_22_74_201,r_23_67_76,0.97,-1,75,76,71
42,r_77_103_16,r_109_110_126,r_18_85_179,r_77_103_16,1.0,0,16,16,71
20,r_48_66_20,seq35,r_62_14_96,r_62_14_96,0.96,87,183,96,71
42,r_77_103_16,r_18_85_179,r_139_15_107,r_139_15_107,0.87,72,179,107,71
32,r_20_38_169,seq136,r_60_21_159,r_20_38_169,0.95,0,169,169,71
38,r_139_15_107,seq133,seq37,r_139_15_107,1.0,0,107,107,71
72,seq39,r_0_27_133,r_91_19_182,r_91_19_182,0.86,5,187,182,71
34,r_107_119_215,r_87_98_110,seq94,r_87_98_110,0.98,5,115,110,71
9,r_86_105_230,r_139_15_107,r_45_81_50,r_86_105_230,1.0,-179,51,230,71
75,seq50,seq9,r_126_53_25,r_126_53_25,0.98,127,152,25,71
44,r_79_7_98,r_83_44_212,r_87_98_110,r_79_7_98,0.63,17,115,98,71
17,r_102_25_73,r_62_14_96,seq29,r_102_25_73,1.0,-1,72,73,71
25,r_76_59_238,r_55_90_34,r_91_19_182,r_91_19_182,1.0,56,238,182,71
85,seq89,r_86_105_230,r_61_42_58,r_61_42_58,1.0,1,59,58,71
15,r_149_138_197,r_43_63_55,r_120_6_60,r_149_138_197,1.0,0,197,197,71
31,r_43_63_55,r_52_125_231,r_49_3_196,r_43_63_55,0.43,175,230,55,71
28,r_70_144_233,seq16,r_65_143_151,r_70_144_233,0.76,0,233,233,71
28,r_70_144_233,r_62_14_96,seq16,r_62_14_96,1.0,-8,88,96,71
49,r_24_64_229,r_65_143_151,seq35,r_65_143_151,0.41,-29,122,151,71
45,r_120_6_60,seq92,seq56,r_120_6_60,0.99,-1,59,60,71
56,seq136,r_10_124_191,r_49_3_196,r_10_124_191,0.53,5,196,191,71
7,r_49_3_196,seq122,seq136,r_49_3_196,0.56,0,196,196,71
44,r_79_7_98,seq117,r_83_44_212,r_79_7_98,0.36,1,99,98,71
23,r_62_14_96,r_70_144_233,r_65_143_151,r_62_14_96,1.0,0,96,96,71
26,r_22_74_201,r_62_14_96,seq72,r_22_74_201,0.88,6,207,201,71
12,r_106_147_101,seq29,r_80_12_63,r_106_147_101,1.0,2,103,101,71
93,seq106,r_126_59_158,r_4_125_234,r_126_59_158,1.0,-6,152,158,72
30,r_99_31_200,seq144,r_75_102_66,r_75_102_66,0.99,137,203,66,72
44,r_146_50_228,r_53_147_118,r_24_79_210,r_53_147_118,1.0,110,228,118,72
92,seq105,seq132,r_138_33_203,r_138_33_203,0.52,2,205,203,72
14,r_133_66_170,r_99_31_200,seq77,r_133_66_170,0.52,0,170,170,72
8,r_119_15_144,seq69,r_75_102_66,r_119_15_144,0.95,0,144,144,72
53,seq3,r_103_94_153,r_121_85_12,r_121_85_12,0.92,109,121,12,72
43,r_96_72_103,r_133_66_170,seq81,r_96_72_103,0.99,0,103,103,72
9,r_117_100_201,seq130,r_40_107_115,r_117_100_201,0.97,1,202,201,72
59,seq16,r_117_100_201,r_116_48_135,r_116_48_135,0.91,22,157,135,72
86,seq88,seq60,r_52_17_57,r_52_17_57,1.0,19,76,57,72
16,r_28_67_141,seq144,seq87,r_28_67_141,0.98,0,141,141,72
39,r_46_76_96,seq44,r_141_137_50,r_46_76_96,1.0,0,96,96,72
97,seq118,seq55,r_62_148_114,r_62_148_114,0.47,-2,112,114,72
42,r_24_79_210,seq113,seq8,r_24_79_210,0.89,0,210,210,72
61,seq144,r_133_66_170,r_13_27_17,r_13_27_17,1.0,0,17,17,72
78,seq60,seq98,r_20_29_24,r_20_29_24,1.0,0,24,24,72
19,r_40_107_115,r_146_50_228,r_19_112_20,r_40_107_115,0.71,5,120,115,72
95,seq113,r_24_79_210,seq132,r_24_79_210,0.96,0,210,210,72
10,r_73_11_175,r_117_100_201,seq90,r_73_11_175,0.95,0,175,175,72
26,r_47_82_75,seq55,r_146_50_228,r_47_82_75,0.66,0,75,75,72
5,r_13_27_17,seq60,seq144,r_13_27_17,0.97,0,17,17,72
4,r_138_33_203,seq140,seq105,r_138_33_203,0.61,0,203,203,72
20,r_103_94_153,r_84_136_221,r_13_27_17,r_13_27_17,0.98,160,177,17,72
13,r_123_83_111,seq36,seq25,r_123_83_111,1.0,0,111,111,72
29,r_78_34_26,r_145_35_98,seq26,r_78_34_26,1.0,0,26,26,72
48,r_84_136_221,seq54,r_119_15_144,r_119_15_144,0.99,78,222,144,72
6,r_45_51_88,seq18,r_7_42_10,r_45_51_88,1.0,0,88,88,72
85,seq87,seq81,r_28_67_141,r_28_67_141,1.0,13,154,141,72
2,r_53_147_118,r_146_50_228,r_47_82_75,r_146_50_228,0.82,0,228,228,72
27,r_5_38_216,seq26,seq3,r_5_38_216,0.61,0,216,216,72
11,r_52_17_57,r_62_148_114,seq88,r_52_17_57,1.0,0,57,57,72
2,r_53_147_118,r_5_38_216,r_146_50_228,r_53_147_118,0.94,0,118,118,72
47,r_14_21_188,seq37,seq36,r_14_21_188,0.9,0,188,188,72
40,r_57_68_137,r_4_125_234,r_116_48_135,r_4_125_234,0.7,-97,137,234,72
18,r_120_129_138,r_99_31_200,r_121_85_12,r_121_85_12,0.47,145,157,12,72
23,r_115_43_18,seq30,r_13_27_17,r_13_27_17,0.74,0,17,17,72
41,r_7_42_10,r_133_66_170,seq61,r_7_42_10,1.0,0,10,10,72
33,r_75_102_66,r_146_50_228,seq111,r_75_102_66,1.0,0,66,66,72
88,seq91,r_146_50_228,r_53_147_118,r_53_147_118,0.99,110,228,118,72
70,seq39,r_89_108_95,r_45_51_88,r_45_51_88,1.0,16,104,88,72
68,seq36,r_123_83_111,r_92_63_180,r_123_83_111,1.0,0,111,111,72
32,r_134_124_206,seq55,r_75_102_66,r_75_102_66,1.0,140,206,66,72
68,seq36,r_92_63_180,r_14_21_188,r_14_21_188,1.0,1,189,188,72
34,r_4_125_234,seq8,r_53_147_118,r_4_125_234,0.39,0,234,234,72
75,seq55,r_134_124_206,r_117_100_201,r_134_124_206,0.91,-4,202,206,72
45,r_121_85_12,seq3,r_120_129_138,r_120_129_138,0.48,16,154,138,72
45,r_121_85_12,r_141_137_50,seq3,r_121_85_12,0.92,0,12,12,72
17,r_65_86_123,r_92_63_180,seq16,r_65_86_123,0.96,2,125,123,72
7,r_92_63_180,r_52_17_57,r_1_32_132,r_1_32_132,0.59,16,148,132,72
94,seq111,seq26,r_75_102_66,r_75_102_66,1.0,115,181,66,72
9,r_117_100_201,r_73_11_175,seq130,r_73_11_175,0.99,0,175,175,72
26,r_47_82_75,r_146_50_228,r_53_147_118,r_53_147_118,1.0,88,206,118,72
22,r_62_148_114,seq132,seq118,r_62_148_114,0.51,0,114,114,72
28,r_142_95_93,seq56,seq93,r_142_95_93,1.0,0,93,93,72
49,r_1_32_132,r_5_38_216,r_92_63_180,r_1_32_132,0.9,1,133,132,72
56,seq8,r_4_125_234,r_24_79_210,r_24_79_210,0.88,24,234,210,72
7,r_92_63_180,r_65_86_123,r_52_17_57,r_52_17_57,1.0,66,123,57,72
44,r_146_50_228,seq91,r_53_147_118,r_53_147_118,1.0,38,156,118,72
24,r_64_104_45,r_47_82_75,seq37,r_64_104_45,0.97,2,47,45,72
35,r_109_131_86,r_1_32_132,r_13_27_17,r_109_131_86,0.99,3,89,86,72
12,r_139_2_181,seq26,r_13_27_17,r_13_27_17,0.74,164,181,17,72
36,r_20_29_24,r_53_147_118,seq60,r_20_29_24,1.0,-1,23,24,72
30,r_113_58_98,r_13_141_235,seq24,r_113_58_98,0.98,0,98,98,73
51,seq1,r_63_45_133,seq19,r_63_45_133,1.0,-3,130,133,73
95,seq117,r_27_20_211,r_49_111_42,r_49_111_42,1.0,5,47,42,73
14,r_79_145_69,r_43_102_201,r_109_140_113,r_79_145_69,1.0,0,69,69,73
8,r_52_88_85,seq75,seq67,r_52_88_85,1.0,1,86,85,73
12,r_107_38_184,seq143,r_43_102_201,r_43_102_201,0.97,0,201,201,73
37,r_147_17_182,seq67,seq6,r_147_17_182,0.88,0,182,182,73
55,seq7,r_134_92_140,r_135_35_6,r_134_92_140,0.99,-97,43,140,73
59,seq12,r_81_71_127,r_62_54_249,r_81_71_127,0.83,0,127,127,73
16,r_112_2_68,seq125,seq19,r_112_2_68,1.0,2,70,68,73
21,r_139_34_81,seq19,seq24,r_139_34_81,1.0,0,81,81,73
1,r_31_82_200,seq33,seq114,r_31_82_200,0.74,0,200,200,73
5,r_53_8_179,r_69_44_204,r_25_91_45,r_25_91_45,1.0,129,174,45,73
69,seq33,r_31_82_200,r_10_64_49,r_10_64_49,1.0,151,200,49,73
45,r_103_61_91,seq24,r_26_56_9,r_103_61_91,0.88,0,91,91,73
39,r_49_111_42,r_103_61_91,seq117,r_49_111_42,0.51,5,47,42,73
31,r_13_141_235,r_113_58_98,seq29,r_113_58_98,1.0,0,98,98,73
41,r_105_48_158,r_128_39_135,r_53_8_179,r_128_39_135,0.78,1,136,135,73
3,r_124_149_86,r_69_44_204,r_122_18_4,r_124_149_86,1.0,1,87,86,73
10,r_43_102_201,seq114,r_107_38_184,r_107_38_184,0.63,17,201,184,73
26,r_109_140_113,r_31_82_200,r_79_145_69,r_79_145_69,0.88,31,100,69,73
40,r_28_132_16,r_134_92_140,seq77,r_28_132_16,1.0,1,17,16,73
0,r_95_100_171,seq77,r_66_47_53,r_95_100_171,0.94,1,172,171,73
29,r_101_32_59,r_52_88_85,seq137,r_52_88_85,0.54,-26,59,85,73
11,r_136_98_197,seq40,r_79_145_69,r_79_145_69,0.99,129,198,69,73
20,r_84_144_97,r_63_45_133,r_79_145_69,r_79_145_69,0.98,29,98,69,73
13,r_115_68_92,seq117,seq142,r_115_68_92,0.78,1,93,92,73
98,seq125,r_112_2_68,r_134_92_140,r_112_2_68,0.98,2,70,68,73
4,r_26_56_9,seq42,r_134_92_140,r_134_92_140,1.0,17,157,140,73
6,r_27_20_211,seq117,r_66_47_53,r_66_47_53,1.0,17,70,53,73
15,r_25_91_45,r_66_47_53,r_53_8_179,r_53_8_179,1.0,-134,45,179,73
41,r_105_48_158,r_53_8_179,r_129_93_17,r_105_48_158,1.0,0,158,158,73
80,seq70,r_78_121_65,r_101_32_59,r_78_121_65,0.68,-8,57,65,73
99,seq126,r_131_119_163,r_97_148_48,r_131_119_163,0.8,-101,62,163,73
36,r_97_148_48,r_84_144_97,seq126,r_84_144_97,0.99,-46,51,97,73
47,r_99_21_95,seq142,r_135_35_6,r_99_21_95,1.0,0,95,95,73
18,r_128_39_135,r_105_48_158,seq29,r_128_39_135,0.9,1,136,135,73
24,r_134_92_140,seq7,r_26_56_9,r_134_92_140,0.97,0,140,140,73
4,r_26_56_9,r_136_98_197,seq42,r_26_56_9,0.61,22,31,9,73
48,r_129_93_17,seq114,r_105_48_158,r_105_48_158,0.96,0,158,158,73
64,seq19,seq138,r_112_2_68,r_112_2_68,1.0,52,120,68,73
42,r_122_18_4,seq90,r_124_149_86,r_124_149_86,0.68,25,111,86,73
32,r_63_45_133,seq1,r_79_145_69,r_63_45_133,0.99,0,133,133,73
48,r_129_93_17,seq90,seq114,r_129_93_17,0.84,2,19,17,73
38,r_59_9_122,r_81_71_127,seq29,r_59_9_122,0.99,0,122,122,73
44,r_15_127_50,seq6,seq75,r_15_127_50,0.67,-1,49,50,73
9,r_41_30_192,seq75,r_53_8_179,r_41_30_192,0.6,0,192,192,73
42,r_122_18_4,seq133,seq90,r_122_18_4,0.61,35,39,4,73
31,r_13_141_235,seq29,r_95_100_171,r_95_100_171,0.95,64,235,171,73
22,r_78_121_65,seq137,seq37,r_78_121_65,1.0,0,65,65,73
28,r_81_71_127,seq12,seq55,r_81_71_127,0.99,0,127,127,73
49,r_89_80_109,seq73,r_23_60_76,r_89_80_109,0.75,1,110,109,73
56,seq137,r_78_121_65,r_101_32_59,r_78_121_65,0.64,0,65,65,73
7,r_131_119_163,seq126,r_101_32_59,r_131_119_163,1.0,0,163,163,73
23,r_3_14_72,r_104_85_214,r_23_60_76,r_3_14_72,0.71,4,76,72,73
79,seq67,r_147_17_182,r_52_88_85,r_52_88_85,0.96,29,114,85,73
35,r_120_108_99,r_63_45_133,seq125,r_120_108_99,1.0,1,100,99,73
93,seq110,r_55_123_164,r_101_62_93,r_101_62_93,0.44,38,131,93,74
45,r_10_83_43,r_115_52_188,seq130,r_10_83_43,1.0,0,43,43,74
36,r_141_8_128,r_75_136_152,r_49_57_119,r_49_57_119,0.7,9,128,119,74
8,r_101_62_93,seq74,seq110,r_101_62_93,0.99,0,93,93,74
43,r_79_84_190,r_73_19_104,r_51_95_216,r_73_19_104,0.29,86,190,104,74
83,seq90,seq110,r_24_2_215,r_24_2_215,0.71,2,217,215,74
37,r_89_22_167,r_133_56_161,seq7,r_133_56_161,0.98,0,161,161,74
71,seq46,r_147_64_182,seq129,r_147_64_182,0.56,0,182,182,74
27,r_51_95_216,r_79_84_190,r_48_9_122,r_51_95_216,0.89,0,216,216,74
86,seq94,r_139_134_129,r_51_95_216,r_139_134_129,0.98,0,129,129,74
21,r_126_124_180,r_148_86_240,seq112,r_126_124_180,0.84,0,180,180,74
1,r_43_92_110,r_48_9_122,seq11,r_43_92_110,1.0,0,110,110,74
46,r_146_71_237,r_132_117_84,seq96,r_146_71_237,0.74,-136,101,237,74
80,seq74,r_97_53_127,seq70,r_97_53_127,1.0,-1,126,127,74
32,r_12_18_132,r_49_57_119,seq16,r_12_18_132,0.43,106,238,132,74
30,r_13_61_41,seq140,seq93,r_13_61_41,0.98,3,44,41,74
19,r_20_80_101,seq50,seq67,r_20_80_101,0.72,1,102,101,74
39,r_142_54_48,r_133_56_161,r_121_111_19,r_142_54_48,0.89,-1,47,48,74
66,seq40,r_115_52_188,r_128_102_87,r_128_102_87,0.96,12,99,87,74
38,r_37_26_18,r_24_2_215,r_48_9_122,r_48_9_122,1.0,50,172,122,74
31,r_99_118_89,r_75_136_152,r_32_29_7,r_99_118_89,0.86,0,89,89,74
25,r_48_9_122,r_97_53_127,r_37_26_18,r_48_9_122,0.53,0,122,122,74
90,seq145,r_127_0_203,r_14_25_139,r_14_25_139,0.7,30,169,139,74
14,r_137_42_8,r_6_60_228,r_132_117_84,r_132_117_84,1.0,144,228,84,74
4,r_81_65_193,seq35,r_55_123_164,r_81_65_193,0.46,0,193,193,74
29,r_138_116_105,seq96,r_133_56_161,r_133_56_161,1.0,-1,160,161,74
11,r_132_117_84,r_146_71_237,r_137_42_8,r_132_117_84,1.0,4,88,84,74
20,r_14_25_139,seq33,seq145,r_14_25_139,0.7,0,139,139,74
48,r_128_102_87,seq17,seq40,r_128_102_87,0.97,1,88,87,74
26,r_36_82_25,r_4_23_211,seq120,r_36_82_25,0.82,0,25,25,74
62,seq31,r_148_86_240,r_132_117_84,r_132_117_84,0.99,156,240,84,74
17,r_66_143_30,r_115_52_188,seq98,r_66_143_30,1.0,1,31,30,74
27,r_51_95_216,seq94,r_79_84_190,r_79_84_190,0.54,4,194,190,74
38,r_37_26_18,r_133_56_161,r_24_2_215,r_37_26_18,0.96,1,19,18,74
9,r_121_111_19,seq47,seq11,r_121_111_19,1.0,0,19,19,74
2,r_115_52_188,r_27_144_196,r_20_80_101,r_115_52_188,0.63,0,188,188,74
47,r_73_19_104,r_75_136_152,r_79_84_190,r_75_136_152,1.0,-44,108,152,74
40,r_139_134_129,seq94,seq21,r_139_134_129,1.0,0,129,129,74
18,r_27_144_196,seq40,r_99_118_89,r_99_118_89,1.0,113,202,89,74
29,r_138_116_105,r_77_3_214,seq96,r_138_116_105,0.96,0,105,105,74
24,r_59_58_113,seq28,r_32_29_7,r_32_29_7,0.91,118,125,7,74
25,r_48_9_122,r_43_92_110,r_97_53_127,r_43_92_110,0.69,0,110,110,74
47,r_73_19_104,r_79_84_190,r_38_103_42,r_79_84_190,1.0,0,190,190,74
88,seq98,r_89_22_167,r_66_143_30,r_66_143_30,0.85,143,173,30,74
58,seq16,seq41,r_49_57_119,r_49_57_119,0.41,-8,111,119,74
6,r_24_2_215,r_37_26_18,seq90,r_24_2_215,0.72,2,217,215,74
42,r_6_60_228,r_24_2_215,r_137_42_8,r_137_42_8,0.97,3,11,8,74
42,r_6_60_228,r_137_42_8,r_13_61_41,r_13_61_41,0.68,187,228,41,74
61,seq28,r_59_58_113,seq5,r_59_58_113,0.91,12,125,113,74
32,r_12_18_132,r_122_106_229,r_49_57_119,r_12_18_132,1.0,0,132,132,74
77,seq70,r_97_53_127,seq74,r_97_53_127,0.95,1,128,127,74
34,r_133_56_161,r_89_22_167,r_138_116_105,r_89_22_167,1.0,-6,161,167,74
75,seq68,r_4_23_211,seq135,r_4_23_211,0.91,0,211,211,74
43,r_79_84_190,r_51_95_216,seq94,r_51_95_216,1.0,0,216,216,74
94,seq112,r_104_34_97,r_126_124_180,r_126_124_180,0.93,1,181,180,74
56,seq140,r_13_61_41,seq149,r_13_61_41,0.7,-10,31,41,74
31,r_99_118_89,r_32_29_7,r_27_144_196,r_27_144_196,0.7,11,207,196,74
28,r_148_86_240,seq31,r_43_92_110,r_148_86_240,0.19,0,240,240,74
49,r_122_106_229,r_12_18_132,seq67,r_12_18_132,1.0,-33,99,132,74
7,r_30_88_37,seq98,r_32_29_7,r_30_88_37,0.87,0,37,37,74
77,seq70,seq74,r_75_136_152,r_75_136_152,1.0,9,161,152,74
23,r_147_64_182,seq46,r_66_143_30,r_147_64_182,0.45,8,190,182,74
35,r_55_123_164,seq110,seq47,r_55_123_164,0.95,3,167,164,74
12,r_49_57_119,r_81_65_193,seq39,r_81_65_193,0.79,-23,170,193,74
6,r_24_2_215,r_126_124_180,r_37_26_18,r_37_26_18,0.9,1,19,18,74
5,r_107_108_15,seq93,seq47,r_107_108_15,0.88,0,15,15,74
36,r_22_64_104,seq42,seq30,r_22_64_104,1.0,0,104,104,75
8,r_32_53_76,seq18,seq146,r_32_53_76,1.0,0,76,76,75
43,r_143_140_130,seq70,seq141,r_143_140_130,1.0,4,134,130,75
25,r_39_3_25,r_32_53_76,r_17_11_64,r_39_3_25,1.0,-1,24,25,75
37,r_17_11_64,seq129,r_125_109_41,r_17_11_64,1.0,0,64,64,75
48,r_16_8_20,r_17_11_64,seq58,r_16_8_20,0.98,0,20,20,75
21,r_149_73_69,r_74_24_113,seq107,r_149_73_69,1.0,2,71,69,75
39,r_50_6_210,seq9,seq38,r_50_6_210,0.68,0,210,210,75
1,r_36_135_131,r_15_62_137,r_22_64_104,r_22_64_104,1.0,27,131,104,75
97,seq113,seq48,r_112_132_85,r_112_132_85,1.0,4,89,85,75
5,r_148_119_161,r_99_98_135,r_86_145_48,r_86_145_48,1.0,35,83,48,75
46,r_124_56_124,seq4,r_112_132_85,r_124_56_124,0.55,-1,123,124,75
42,r_106_121_230,seq97,r_36_135_131,r_36_135_131,0.98,101,232,131,75
25,r_39_3_25,r_17_11_64,seq38,r_17_11_64,1.0,0,64,64,75
35,r_51_82_18,r_137_101_209,seq146,r_51_82_18,1.0,0,18,18,75
24,r_125_109_41,r_13_45_62,seq0,r_125_109_41,0.99,0,41,41,75
41,r_105_76_14,r_86_145_48,seq46,r_105_76_14,0.98,0,14,14,75
7,r_117_68_39,r_21_114_228,r_5_126_127,r_5_126_127,0.54,1,128,127,75
19,r_123_55_206,seq40,seq131,r_123_55_206,0.86,1,207,206,75
31,r_142_44_155,seq40,r_74_24_113,r_142_44_155,1.0,0,155,155,75
20,r_37_41_40,r_112_132_85,seq103,r_37_41_40,0.78,2,42,40,75
3,r_128_71_4,r_20_57_236,r_115_78_214,r_115_78_214,0.99,22,236,214,75
45,r_28_144_16,r_32_53_76,r_138_95_225,r_28_144_16,0.97,0,16,16,75
16,r_86_145_48,r_148_119_161,r_28_144_16,r_148_119_161,1.0,1,162,161,75
4,r_91_127_129,seq97,r_74_24_113,r_91_127_129,1.0,1,130,129,75
13,r_5_126_127,r_10_43_171,r_117_68_39,r_117_68_39,0.65,88,127,39,75
15,r_19_63_61,seq107,seq1,r_19_63_61,1.0,2,63,61,75
9,r_74_24_113,r_15_62_137,r_91_127_129,r_74_24_113,0.61,25,138,113,75
34,r_59_134_63,r_74_24_113,r_77_47_94,r_59_134_63,0.98,49,112,63,75
6,r_23_116_51,r_89_52_55,r_16_8_20,r_16_8_20,0.98,41,61,20,75
62,seq26,r_123_55_206,r_139_54_56,r_139_54_56,0.95,5,61,56,75
0,r_139_54_56,seq7,seq26,r_139_54_56,1.0,0,56,56,75
85,seq87,r_21_114_228,r_35_92_203,r_21_114_228,0.6,-31,197,228,75
5,r_148_119_161,r_86_145_48,seq80,r_148_119_161,1.0,1,162,161,75
2,r_99_98_135,r_138_95_225,r_125_109_41,r_99_98_135,0.99,1,136,135,75
47,r_21_114_228,seq87,r_96_34_182,r_21_114_228,0.64,0,228,228,75
40,r_35_92_203,seq42,seq87,r_35_92_203,0.39,-6,197,203,75
18,r_112_132_85,seq94,seq1,r_112_132_85,1.0,0,85,85,75
29,r_138_95_225,r_99_98_135,r_28_144_16,r_99_98_135,0.64,1,136,135,75
33,r_72_130_96,seq58,r_125_109_41,r_72_130_96,0.9,0,96,96,75
16,r_86_145_48,r_72_130_96,r_148_119_161,r_86_145_48,1.0,0,48,48,75
58,seq9,r_50_6_210,r_99_98_135,r_99_98_135,1.0,62,197,135,75
11,r_65_118_28,r_123_55_206,seq93,r_65_118_28,0.64,0,28,28,75
32,r_29_100_204,seq67,r_37_41_40,r_29_100_204,0.65,2,206,204,75
34,r_59_134_63,r_22_64_104,r_74_24_113,r_59_134_63,1.0,0,63,63,75
60,seq141,r_137_101_209,r_143_140_130,r_143_140_130,0.95,14,144,130,75
45,r_28_144_16,r_138_95_225,r_86_145_48,r_86_145_48,1.0,178,226,48,75
17,r_137_101_209,seq46,r_37_41_40,r_137_101_209,0.82,0,209,209,75
95,seq146,r_10_43_171,r_51_82_18,r_51_82_18,1.0,0,18,18,75
94,seq107,r_5_126_127,r_149_73_69,r_149_73_69,1.0,4,73,69,75
9,r_74_24_113,r_29_100_204,r_59_134_63,r_59_134_63,1.0,0,63,63,75
29,r_138_95_225,r_28_144_16,r_59_134_63,r_138_95_225,0.72,1,226,225,75
22,r_115_78_214,seq136,seq94,r_115_78_214,0.78,0,214,214,75
79,seq129,r_17_11_64,seq38,r_17_11_64,1.0,-15,49,64,75
28,r_89_52_55,r_23_116_51,seq60,r_89_52_55,0.75,6,61,55,75
49,r_77_47_94,r_5_126_127,r_59_134_63,r_5_126_127,1.0,-32,95,127,75
27,r_81_110_42,seq58,seq84,r_81_110_42,0.93,0,42,42,75
44,r_13_45_62,r_149_73_69,r_16_8_20,r_13_45_62,1.0,0,62,62,75
9,r_74_24_113,r_59_134_63,r_15_62_137,r_74_24_113,0.99,0,113,113,75
82,seq80,seq136,r_148_119_161,r_148_119_161,0.97,19,180,161,75
7,r_117_68_39,r_17_11_64,r_21_114_228,r_117_68_39,0.67,1,40,39,75
30,r_48_35_172,r_142_47_213,seq15,r_48_35_172,0.97,2,174,172,76
36,r_140_65_141,seq16,seq95,r_140_65_141,0.97,0,141,141,76
14,r_106_122_76,seq67,r_60_8_36,r_106_122_76,1.0,0,76,76,76
8,r_37_80_118,seq76,seq15,r_37_80_118,1.0,0,118,118,76
1,r_13_102_49,r_134_88_239,r_145_33_181,r_13_102_49,1.0,1,50,49,76
43,r_12_57_96,r_134_88_239,seq79,r_12_57_96,1.0,0,96,96,76
83,seq76,r_37_80_118,r_52_40_15,r_37_80_118,0.92,0,118,118,76
37,r_49_20_102,seq16,seq15,r_49_20_102,0.98,4,106,102,76
16,r_145_33_181,r_3_117_70,seq11,r_3_117_70,1.0,4,74,70,76
39,r_142_47_213,r_48_35_172,seq100,r_48_35_172,0.59,2,174,172,76
97,seq115,r_116_21_111,r_26_55_225,r_116_21_111,1.0,0,111,111,76
5,r_112_90_220,seq95,r_0_25_37,r_112_90_220,0.47,0,220,220,76
42,r_63_78_148,seq131,seq1,r_63_78_148,0.87,0,148,148,76
7,r_74_86_80,r_134_88_239,r_136_111_221,r_74_86_80,0.25,160,240,80,76
24,r_136_111_221,seq149,seq91,r_136_111_221,0.91,2,223,221,76
25,r_60_8_36,r_13_102_49,seq22,r_60_8_36,0.98,0,36,36,76
78,seq67,seq15,r_101_137_128,r_101_137_128,1.0,21,149,128,76
97,seq115,r_26_55_225,r_96_118_173,r_96_118_173,0.99,54,227,173,76
31,r_87_121_104,seq22,seq14,r_87_121_104,1.0,0,104,104,76
41,r_134_88_239,r_12_57_96,r_74_86_80,r_134_88_239,0.95,-143,96,239,76
22,r_3_117_70,r_105_127_100,r_23_56_137,r_105_127_100,0.97,0,100,100,76
10,r_59_114_3,r_126_72_92,r_128_42_60,r_59_114_3,0.99,81,84,3,76
26,r_69_27_211,seq75,r_70_58_9,r_69_27_211,0.58,0,211,211,76
16,r_145_33_181,seq11,seq36,r_145_33_181,0.92,0,181,181,76
4,r_43_32_233,seq93,r_148_53_226,r_43_32_233,0.53,1,234,233,76
78,seq67,r_106_122_76,seq15,r_106_122_76,0.99,1,77,76,76
73,seq39,r_120_38_205,r_116_21_111,r_116_21_111,0.99,20,131,111,76
20,r_123_138_177,r_26_55_225,seq28,r_26_55_225,0.49,-48,177,225,76
13,r_26_55_225,r_123_138_177,r_96_118_173,r_26_55_225,0.96,-48,177,225,76
46,r_120_38_205,r_113_45_26,seq93,r_113_45_26,0.88,179,205,26,76
15,r_5_4_151,r_136_111_221,r_13_102_49,r_5_4_151,0.99,0,151,151,76
48,r_105_127_100,r_128_42_60,r_108_44_170,r_128_42_60,1.0,0,60,60,76
12,r_113_45_26,r_120_38_205,r_81_107_112,r_81_107_112,0.9,93,205,112,76
1,r_13_102_49,r_145_33_181,r_104_85_83,r_13_102_49,0.98,39,88,49,76
6,r_141_89_190,r_126_72_92,r_128_42_60,r_141_89_190,0.92,-99,91,190,76
12,r_113_45_26,seq7,r_120_38_205,r_113_45_26,0.99,0,26,26,76
0,r_96_118_173,seq1,r_26_55_225,r_26_55_225,0.66,-53,172,225,76
27,r_116_21_111,seq115,seq39,r_116_21_111,1.0,0,111,111,76
2,r_81_107_112,seq15,seq39,r_81_107_112,1.0,0,112,112,76
41,r_134_88_239,r_74_86_80,r_108_44_170,r_74_86_80,0.36,160,240,80,76
47,r_23_56_137,seq147,r_3_117_70,r_3_117_70,1.0,71,141,70,76
0,r_96_118_173,r_26_55_225,seq115,r_26_55_225,0.88,2,227,225,76
3,r_9_133_28,r_37_80_118,seq18,r_9_133_28,0.95,0,28,28,76
40,r_126_72_92,r_141_89_190,r_24_92_52,r_126_72_92,0.63,0,92,92,76
74,seq129,r_0_25_37,r_146_62_120,r_146_62_120,1.0,4,124,120,76
18,r_128_42_60,r_105_127_100,r_59_114_3,r_128_42_60,1.0,0,60,60,76
24,r_136_111_221,r_5_4_151,seq149,r_5_4_151,1.0,0,151,151,76
21,r_41_99_10,r_108_44_170,seq10,r_41_99_10,1.0,0,10,10,76
46,r_120_38_205,seq28,r_113_45_26,r_113_45_26,0.96,5,31,26,76
33,r_146_62_120,seq147,seq129,r_146_62_120,1.0,0,120,120,76
39,r_142_47_213,seq100,r_60_8_36,r_142_47_213,0.97,0,213,213,76
50,seq1,r_54_66_234,r_63_78_148,r_63_78_148,0.95,0,148,148,76
45,r_52_40_15,seq18,seq76,r_52_40_15,0.98,0,15,15,76
6,r_141_89_190,r_128_42_60,r_143_97_105,r_141_89_190,0.99,0,190,190,76
32,r_108_44_170,seq131,seq68,r_108_44_170,0.92,0,170,170,76
38,r_61_64_204,seq77,r_140_65_141,r_140_65_141,0.62,63,204,141,76
29,r_24_92_52,seq91,seq125,r_24_92_52,1.0,0,52,52,76
35,r_46_98_44,r_104_85_83,r_41_99_10,r_46_98_44,1.0,0,44,44,76
13,r_26_55_225,r_96_118_173,r_126_72_92,r_96_118_173,0.89,54,227,173,76
60,seq16,r_54_66_234,r_63_78_148,r_63_78_148,1.0,88,236,148,76
9,r_109_119_103,r_143_97_105,seq15,r_109_119_103,1.0,0,103,103,76
22,r_3_117_70,r_145_33_181,r_105_127_100,r_3_117_70,0.86,4,74,70,76
28,r_2_103_66,seq15,seq76,r_2_103_66,1.0,1,67,66,76
91,seq93,r_43_32_233,r_136_111_221,r_43_32_233,0.47,1,234,233,76
49,r_101_137_128,seq17,seq67,r_101_137_128,1.0,1,129,128,76
7,r_74_86_80,r_43_32_233,r_134_88_239,r_74_86_80,1.0,3,83,80,76
44,r_143_97_105,r_37_80_118,seq11,r_143_97_105,0.94,0,105,105,76
23,r_104_85_83,seq79,r_13_102_49,r_104_85_83,1.0,0,83,83,76
48,r_105_127_100,r_108_44_170,seq51,r_105_127_100,1.0,0,100,100,76
84,seq77,r_61_64_204,r_60_8_36,r_60_8_36,0.91,168,204,36,76
30,r_134_16_101,seq28,r_145_12_165,r_134_16_101,1.0,0,101,101,77
36,r_149_80_183,seq42,r_33_44_93,r_149_80_183,0.96,1,184,183,77
8,r_58_30_225,r_71_67_4,seq107,r_58_30_225,0.36,5,230,225,77
31,r_137_132_43,r_48_52_244,seq24,r_137_132_43,1.0,0,43,43,77
71,seq42,r_149_80_183,r_8_54_110,r_149_80_183,0.99,1,184,183,77
86,seq88,seq1,r_19_47_107,r_19_47_107,1.0,17,124,107,77
16,r_140_146_86,r_95_130_149,seq148,r_140_146_86,1.0,0,86,86,77
39,r_85_93_228,seq13,r_70_127_215,r_85_93_228,0.35,2,230,228,77
1,r_31_43_138,r_123_96_219,seq101,r_31_43_138,0.96,0,138,138,77
46,r_4_74_67,seq27,seq2,r_4_74_67,1.0,0,67,67,77
42,r_73_86_212,r_62_122_233,r_134_16_101,r_62_122_233,0.67,-21,212,233,77
49,r_53_23_152,r_126_56_210,r_114_83_163,r_53_23_152,0.63,13,165,152,77
45,r_25_143_170,r_104_63_80,r_131_106_73,r_25_143_170,1.0,-90,80,170,77
70,seq41,seq3,r_142_128_44,r_142_128_44,1.0,2,46,44,77
19,r_37_129_97,r_66_18_213,seq99,r_37_129_97,1.0,0,97,97,77
25,r_97_89_36,r_8_54_110,seq77,r_97_89_36,1.0,0,36,36,77
95,seq109,r_113_100_162,seq98,r_113_100_162,1.0,1,163,162,77
29,r_87_59_25,seq139,seq3,r_87_59_25,0.86,-9,16,25,77
41,r_8_54_110,seq38,seq49,r_8_54_110,0.59,3,113,110,77
3,r_70_127_215,seq39,r_61_22_164,r_61_22_164,0.66,54,218,164,77
10,r_95_130_149,r_140_146_86,r_91_120_188,r_140_146_86,1.0,-8,78,86,77
90,seq99,seq107,r_37_129_97,r_37_129_97,1.0,7,104,97,77
26,r_57_50_141,seq49,r_103_124_22,r_57_50_141,0.99,0,141,141,77
4,r_119_82_94,r_61_22_164,r_71_67_4,r_119_82_94,1.0,1,95,94,77
9,r_61_22_164,r_103_124_22,r_142_128_44,r_61_22_164,1.0,0,164,164,77
11,r_114_83_163,seq111,r_53_23_152,r_114_83_163,1.0,0,163,163,77
2,r_9_11_56,r_45_65_108,seq28,r_9_11_56,0.77,0,56,56,77
62,seq27,r_57_50_141,r_145_12_165,r_57_50_141,0.98,-43,98,141,77
79,seq72,r_87_59_25,r_85_93_228,r_87_59_25,0.88,3,28,25,77
20,r_62_122_233,r_73_86_212,r_33_44_93,r_33_44_93,1.0,119,212,93,77
13,r_10_112_62,seq60,seq28,r_10_112_62,1.0,0,62,62,77
47,r_126_56_210,r_53_23_152,r_4_74_67,r_126_56_210,0.95,0,210,210,77
48,r_71_67_4,r_58_30_225,r_119_82_94,r_119_82_94,1.0,1,95,94,77
12,r_103_124_22,r_33_44_93,r_104_63_80,r_103_124_22,1.0,71,93,22,77
6,r_123_96_219,seq68,seq72,r_123_96_219,0.68,1,220,219,77
18,r_33_44_93,r_142_128_44,r_103_124_22,r_33_44_93,0.84,-70,23,93,77
7,r_142_128_44,r_126_56_210,seq41,r_142_128_44,1.0,0,44,44,77
75,seq60,r_10_112_62,seq138,r_10_112_62,1.0,-22,40,62,77
18,r_33_44_93,r_62_122_233,r_40_14_60,r_62_122_233,0.87,0,233,233,77
10,r_95_130_149,r_91_120_188,seq35,r_95_130_149,0.99,0,149,149,77
27,r_104_63_80,r_25_143_170,r_103_124_22,r_104_63_80,1.0,1,81,80,77
30,r_134_16_101,r_145_12_165,r_141_125_151,r_141_125_151,1.0,14,165,151,77
79,seq72,r_85_93_228,r_123_96_219,r_123_96_219,0.56,10,229,219,77
60,seq24,seq79,r_137_132_43,r_137_132_43,1.0,11,54,43,77
22,r_40_14_60,r_31_43_138,r_33_44_93,r_40_14_60,0.47,78,138,60,77
12,r_103_124_22,r_10_112_62,r_33_44_93,r_103_124_22,1.0,0,22,22,77
94,seq107,r_97_89_36,r_37_129_97,r_97_89_36,0.53,131,167,36,77
24,r_19_47_107,r_85_93_228,seq88,r_19_47_107,1.0,0,107,107,77
81,seq77,r_9_11_56,r_97_89_36,r_97_89_36,1.0,0,36,36,77
47,r_126_56_210,r_61_22_164,r_53_23_152,r_126_56_210,0.5,-54,156,210,77
88,seq94,r_126_56_210,r_103_124_22,r_103_124_22,0.88,188,210,22,77
47,r_126_56_210,r_142_128_44,r_61_22_164,r_142_128_44,1.0,2,46,44,77
68,seq38,r_8_54_110,seq76,r_8_54_110,0.76,3,113,110,77
77,seq68,r_123_96_219,r_33_44_93,r_33_44_93,1.0,127,220,93,77
20,r_62_122_233,r_33_44_93,seq29,r_62_122_233,0.77,0,233,233,77
45,r_25_143_170,r_131_106_73,r_9_11_56,r_25_143_170,0.97,0,170,170,77
17,r_131_106_73,seq79,seq55,r_131_106_73,1.0,0,73,73,77
9,r_61_22_164,r_141_125_151,r_103_124_22,r_103_124_22,0.78,130,152,22,77
52,seq3,seq41,r_87_59_25,r_87_59_25,0.95,-9,16,25,77
22,r_40_14_60,r_114_83_163,r_31_43_138,r_40_14_60,1.0,0,60,60,77
28,r_91_120_188,seq105,r_131_106_73,r_131_106_73,1.0,116,189,73,77
49,r_53_23_152,seq55,r_126_56_210,r_126_56_210,0.85,-59,151,210,77
56,seq13,r_85_93_228,seq29,r_85_93_228,0.49,2,230,228,77
18,r_33_44_93,r_103_124_22,r_62_122_233,r_33_44_93,1.0,0,93,93,77
44,r_45_65_108,seq107,r_33_44_93,r_45_65_108,0.99,1,109,108,77
23,r_113_100_162,seq109,r_33_44_93,r_113_100_162,0.95,1,163,162,77
0,r_0_133_16,r_33_44_93,seq5,r_0_133_16,1.0,0,16,16,77
35,r_66_18_213,r_62_122_233,seq60,r_66_18_213,0.48,0,213,213,77
40,r_125_11_22,r_141_94_154,r_122_29_35,r_125_11_22,0.78,134,156,22,78
30,r_98_25_223,seq109,r_58_16_91,r_58_16_91,1.0,15,106,91,78
51,seq1,r_26_61_224,r_112_64_122,r_112_64_122,0.99,103,225,122,78
14,r_47_66_228,seq23,r_67_104_133,r_67_104_133,0.79,97,230,133,78
9,r_58_16_91,r_98_25_223,r_129_35_16,r_58_16_91,0.7,132,223,91,78
53,seq5,r_60_9_152,r_57_99_68,r_60_9_152,0.97,-19,133,152,78
37,r_32_123_71,r_119_117_199,seq103,r_32_123_71,1.0,0,71,71,78
87,seq83,r_62_136_197,r_119_117_199,r_119_117_199,0.87,-1,198,199,78
86,seq77,r_93_91_193,r_125_11_22,r_125_11_22,0.71,111,133,22,78
16,r_60_9_152,seq40,r_141_94_154,r_141_94_154,0.9,-2,152,154,78
21,r_55_43_120,seq27,r_32_123_71,r_55_43_120,0.98,0,120,120,78
39,r_97_107_148,seq83,r_129_35_16,r_97_107_148,0.96,0,148,148,78
5,r_145_106_83,r_58_16_91,seq48,r_145_106_83,1.0,0,83,83,78
46,r_76_134_157,seq121,seq140,r_76_134_157,0.93,1,158,157,78
69,seq39,seq84,r_85_2_142,r_85_2_142,1.0,17,159,142,78
45,r_96_56_129,seq0,seq142,r_96_56_129,0.98,0,129,129,78
95,seq110,seq140,r_130_17_24,r_130_17_24,1.0,33,57,24,78
48,r_130_17_24,r_141_94_154,seq110,r_130_17_24,1.0,0,24,24,78
32,r_112_64_122,r_20_127_119,r_73_41_3,r_20_127_119,0.39,115,234,119,78
19,r_118_12_102,r_28_37_169,seq83,r_118_12_102,1.0,0,102,102,78
33,r_141_94_154,r_125_11_22,r_60_9_152,r_60_9_152,1.0,4,156,152,78
27,r_93_91_193,r_122_29_35,r_73_41_3,r_93_91_193,0.73,0,193,193,78
41,r_7_143_72,r_112_64_122,seq6,r_112_64_122,0.91,-46,76,122,78
24,r_65_81_48,r_26_61_224,seq0,r_65_81_48,0.99,0,48,48,78
4,r_22_80_147,seq1,r_55_43_120,r_22_80_147,0.94,0,147,147,78
78,seq54,seq116,r_67_104_133,r_67_104_133,0.99,1,134,133,78
11,r_8_139_163,seq23,r_20_127_119,r_8_139_163,1.0,0,163,163,78
20,r_102_147_136,r_60_9_152,seq140,r_102_147_136,0.96,0,136,136,78
98,seq121,r_76_134_157,seq44,r_76_134_157,0.98,-10,147,157,78
15,r_10_53_60,r_120_13_221,seq0,r_10_53_60,1.0,0,60,60,78
13,r_122_29_35,r_93_91_193,seq77,r_93_91_193,0.86,0,193,193,78
30,r_98_25_223,r_58_16_91,r_119_117_199,r_98_25_223,0.82,0,223,223,78
34,r_124_69_214,r_118_12_102,r_76_134_157,r_124_69_214,0.86,-19,195,214,78
87,seq83,r_97_107_148,r_62_136_197,r_97_107_148,0.92,0,148,148,78
31,r_78_24_23,r_132_114_216,seq15,r_78_24_23,1.0,0,23,23,78
2,r_132_114_216,seq131,r_124_69_214,r_124_69_214,0.51,2,216,214,78
47,r_20_127_119,r_124_69_214,seq135,r_20_127_119,0.97,0,119,119,78
18,r_62_136_197,seq83,r_32_123_71,r_32_123_71,1.0,127,198,71,78
43,r_14_95_19,seq110,seq84,r_14_95_19,0.95,-1,18,19,78
25,r_113_126_231,seq59,r_57_99_68,r_57_99_68,1.0,167,235,68,78
44,r_115_19_33,seq77,seq48,r_115_19_33,1.0,0,33,33,78
13,r_122_29_35,seq140,r_93_91_193,r_122_29_35,1.0,0,35,35,78
32,r_112_64_122,r_7_143_72,r_97_107_148,r_112_64_122,0.6,-42,80,122,78
88,seq84,seq39,r_14_95_19,r_14_95_19,1.0,6,25,19,78
34,r_124_69_214,r_85_2_142,r_118_12_102,r_85_2_142,0.87,2,144,142,78
33,r_141_94_154,r_130_17_24,r_125_11_22,r_141_94_154,0.99,-130,24,154,78
17,r_28_37_169,r_118_12_102,seq36,r_118_12_102,1.0,-4,98,102,78
22,r_57_99_68,seq131,r_14_95_19,r_57_99_68,0.97,3,71,68,78
28,r_119_117_199,seq135,seq83,r_119_117_199,0.73,0,199,199,78
49,r_18_3_88,r_28_37_169,seq1,r_28_37_169,0.87,-77,92,169,78
32,r_112_64_122,r_97_107_148,r_20_127_119,r_112_64_122,0.82,0,122,122,78
27,r_93_91_193,seq77,r_122_29_35,r_122_29_35,1.0,7,42,35,78
7,r_92_71_106,seq46,seq49,r_92_71_106,0.85,0,106,106,78
1,r_129_35_16,r_87_63_247,seq23,r_129_35_16,0.79,1,17,16,78
40,r_125_11_22,r_60_9_152,r_141_94_154,r_125_11_22,1.0,0,22,22,78
23,r_4_90_239,seq74,r_122_29_35,r_122_29_35,0.93,204,239,35,78
17,r_28_37_169,seq36,r_129_35_16,r_28_37_169,1.0,0,169,169,78
35,r_26_61_224,seq1,r_88_144_178,r_26_61_224,0.35,0,224,224,78
12,r_34_146_155,seq142,r_7_143_72,r_34_146_155,0.93,0,155,155,78
93,seq142,r_139_21_93,r_112_55_78,r_112_55_78,0.86,7,85,78,79
40,r_139_21_93,r_70_145_54,r_121_115_177,r_121_115_177,1.0,0,177,177,79
30,r_35_27_235,seq20,r_103_137_92,r_103_137_92,0.72,143,235,92,79
36,r_81_0_90,r_43_94_198,r_31_141_76,r_81_0_90,0.53,0,90,90,79
14,r_143_99_124,r_43_94_198,r_95_88_61,r_95_88_61,0.6,63,124,61,79
8,r_31_141_76,r_1_90_132,seq9,r_31_141_76,1.0,0,76,76,79
43,r_11_4_128,seq34,seq2,r_11_4_128,0.55,16,144,128,79
37,r_65_96_82,r_139_21_93,seq84,r_65_96_82,0.93,0,82,82,79
3,r_62_41_161,r_23_15_38,seq2,r_23_15_38,0.48,123,161,38,79
4,r_128_135_19,r_26_108_64,r_70_145_54,r_128_135_19,1.0,46,65,19,79
55,seq9,r_101_3_69,r_31_141_76,r_31_141_76,1.0,2,78,76,79
39,r_121_115_177,r_54_74_109,r_139_21_93,r_121_115_177,0.98,0,177,177,79
1,r_119_66_185,r_42_118_183,r_60_122_96,r_60_122_96,0.55,88,184,96,79
5,r_146_47_97,r_77_56_240,r_22_87_204,r_146_47_97,0.97,0,97,97,79
46,r_101_3_69,seq9,seq18,r_101_3_69,0.6,2,71,69,79
42,r_1_90_132,seq134,r_112_55_78,r_112_55_78,0.64,55,133,78,79
80,seq63,r_43_94_198,seq36,r_43_94_198,0.84,1,199,198,79
48,r_23_15_38,r_119_66_185,seq53,r_23_15_38,0.77,0,38,38,79
45,r_112_55_78,seq97,seq142,r_112_55_78,1.0,4,82,78,79
15,r_125_49_219,r_65_96_82,r_113_106_4,r_113_106_4,0.57,213,217,4,79
11,r_95_88_61,seq142,r_143_99_124,r_143_99_124,1.0,17,141,124,79
47,r_67_107_52,r_121_115_177,r_60_122_96,r_67_107_52,1.0,0,52,52,79
3,r_62_41_161,seq53,r_23_15_38,r_23_15_38,0.69,6,44,38,79
76,seq52,r_42_118_183,r_102_73_126,r_42_118_183,0.89,-55,128,183,79
18,r_93_8_12,r_132_149_237,seq2,r_93_8_12,0.98,0,12,12,79
33,r_80_69_33,seq84,seq14,r_80_69_33,0.92,0,33,33,79
41,r_44_50_153,seq100,r_93_8_12,r_44_50_153,1.0,2,155,153,79
67,seq29,seq33,r_130_6_106,r_130_6_106,1.0,1,107,106,79
26,r_43_94_198,seq63,r_146_47_97,r_146_47_97,0.7,102,199,97,79
72,seq36,r_10_79_112,seq63,r_10_79_112,1.0,1,113,112,79
38,r_132_149_237,r_146_47_97,r_54_74_109,r_132_149_237,0.47,-166,71,237,79
0,r_60_122_96,seq34,r_119_66_185,r_119_66_185,0.78,5,190,185,79
11,r_95_88_61,seq18,seq142,r_95_88_61,1.0,0,61,61,79
20,r_103_137_92,seq51,seq72,r_103_137_92,0.99,1,93,92,79
13,r_130_6_106,r_40_89_224,seq29,r_130_6_106,1.0,1,107,106,79
10,r_70_145_54,seq127,r_128_135_19,r_70_145_54,1.0,2,56,54,79
62,seq18,r_95_88_61,r_101_3_69,r_95_88_61,1.0,3,64,61,79
19,r_75_48_49,r_119_66_185,seq144,r_75_48_49,1.0,0,49,49,79
27,r_113_106_4,seq82,r_114_12_26,r_114_12_26,0.81,34,60,26,79
40,r_139_21_93,r_65_96_82,r_70_145_54,r_70_145_54,0.79,29,83,54,79
29,r_10_79_112,seq36,r_128_135_19,r_10_79_112,0.71,1,113,112,79
24,r_77_56_240,seq76,r_95_88_61,r_95_88_61,0.82,179,240,61,79
15,r_125_49_219,r_7_110_35,r_65_96_82,r_65_96_82,0.54,-29,53,82,79
38,r_132_149_237,r_93_8_12,r_146_47_97,r_146_47_97,0.54,-42,55,97,79
38,r_132_149_237,r_54_74_109,r_23_15_38,r_23_15_38,0.31,179,217,38,79
21,r_7_110_35,r_31_141_76,seq104,r_31_141_76,0.72,-39,37,76,79
4,r_128_135_19,r_43_94_198,r_26_108_64,r_128_135_19,0.6,1,20,19,79
34,r_42_118_183,r_119_66_185,seq13,r_42_118_183,0.37,0,183,183,79
17,r_131_116_136,seq133,seq52,r_131_116_136,1.0,6,142,136,79
9,r_16_37_205,seq82,r_71_28_176,r_16_37_205,0.55,0,205,205,79
28,r_114_12_26,r_43_94_198,r_113_106_4,r_114_12_26,0.95,5,31,26,79
49,r_71_28_176,seq104,seq109,r_71_28_176,0.93,1,177,176,79
7,r_124_126_86,r_131_116_136,r_22_87_204,r_22_87_204,0.98,-118,86,204,79
44,r_30_86_129,seq33,r_146_47_97,r_30_86_129,0.93,0,129,129,79
23,r_148_98_114,seq64,r_65_96_82,r_148_98_114,0.8,12,126,114,79
87,seq84,r_80_69_33,r_23_15_38,r_80_69_33,0.56,-1,32,33,79
93,seq103,r_136_17_233,seq119,r_136_17_233,0.54,1,234,233,80
22,r_114_32_42,seq18,seq88,r_114_32_42,0.72,2,44,42,80
26,r_96_127_25,r_114_32_42,seq92,r_96_127_25,0.79,1,26,25,80
40,r_120_28_34,r_19_65_108,seq37,r_19_65_108,0.97,0,108,108,80
66,seq30,seq77,r_67_89_47,r_67_89_47,1.0,-1,46,47,80
36,r_143_140_65,r_22_124_154,seq51,r_143_140_65,1.0,0,65,65,80
9,r_107_83_76,r_70_131_63,r_29_113_17,r_29_113_17,0.62,155,172,17,80
14,r_42_48_128,seq40,r_47_106_116,r_42_48_128,1.0,0,128,128,80
43,r_76_117_164,seq82,r_87_7_60,r_87_7_60,0.61,105,165,60,80
86,seq79,r_85_26_29,r_112_148_152,r_112_148_152,0.58,8,160,152,80
44,r_101_24_46,seq44,seq108,r_101_24_46,1.0,1,47,46,80
86,seq79,seq18,r_85_26_29,r_85_26_29,0.89,51,80,29,80
21,r_31_16_244,r_63_38_198,r_47_106_116,r_63_38_198,1.0,0,198,198,80
39,r_95_74_135,seq149,r_114_32_42,r_95_74_135,1.0,0,135,135,80
1,r_47_106_116,r_63_38_198,r_42_48_128,r_42_48_128,0.97,70,198,128,80
5,r_112_148_152,seq20,r_98_145_162,r_112_148_152,0.96,0,152,152,80
42,r_98_145_162,seq4,r_112_148_152,r_112_148_152,0.68,13,165,152,80
45,r_33_110_180,seq51,r_126_80_8,r_33_110_180,0.95,2,182,180,80
52,seq3,r_120_28_34,seq12,r_120_28_34,0.99,9,43,34,80
95,seq115,r_146_142_159,r_19_65_108,r_19_65_108,0.83,51,159,108,80
40,r_120_28_34,seq3,r_19_65_108,r_120_28_34,0.99,0,34,34,80
76,seq55,r_13_118_182,seq73,r_13_118_182,0.87,0,182,182,80
31,r_144_34_207,r_43_121_245,r_130_60_48,r_43_121_245,0.52,-38,207,245,80
41,r_94_72_189,seq88,seq14,r_94_72_189,0.92,0,189,189,80
46,r_19_65_108,r_36_105_148,r_120_28_34,r_120_28_34,0.98,0,34,34,80
10,r_59_39_124,r_54_116_218,seq3,r_59_39_124,0.99,0,124,124,80
47,r_67_89_47,seq4,seq30,r_67_89_47,1.0,0,47,47,80
11,r_147_125_40,r_94_72_189,seq62,r_147_125_40,0.92,1,41,40,80
81,seq68,seq64,r_85_26_29,r_85_26_29,1.0,6,35,29,80
4,r_136_17_233,seq103,seq64,r_136_17_233,0.45,1,234,233,80
20,r_25_71_168,seq40,seq149,r_25_71_168,0.83,0,168,168,80
46,r_19_65_108,r_120_28_34,seq58,r_19_65_108,1.0,0,108,108,80
30,r_6_81_31,r_138_49_24,seq37,r_6_81_31,1.0,0,31,31,80
13,r_135_111_97,seq53,seq30,r_135_111_97,1.0,1,98,97,80
23,r_0_46_13,r_42_48_128,seq108,r_0_46_13,0.82,0,13,13,80
6,r_22_124_154,seq5,r_126_80_8,r_22_124_154,0.85,0,154,154,80
99,seq149,r_95_74_135,r_36_105_148,r_95_74_135,1.0,0,135,135,80
52,seq3,seq12,r_59_39_124,r_59_39_124,1.0,4,128,124,80
3,r_52_137_21,seq68,r_29_113_17,r_52_137_21,0.89,-5,16,21,80
27,r_85_26_29,r_135_111_97,seq68,r_85_26_29,0.99,0,29,29,80
2,r_130_60_48,seq108,seq69,r_130_60_48,0.85,24,72,48,80
18,r_70_131_63,seq37,r_138_49_24,r_70_131_63,1.0,0,63,63,80
29,r_63_38_198,r_31_16_244,r_57_109_157,r_31_16_244,0.95,-46,198,244,80
24,r_56_1_96,seq20,r_87_7_60,r_87_7_60,0.57,37,97,60,80
25,r_138_49_24,seq129,r_70_131_63,r_70_131_63,1.0,6,69,63,80
33,r_54_116_218,seq69,seq15,r_54_116_218,0.55,3,221,218,80
70,seq40,r_42_48_128,r_126_80_8,r_42_48_128,1.0,0,128,128,80
61,seq18,r_146_142_159,r_41_91_78,r_41_91_78,0.85,23,101,78,80
32,r_41_91_78,r_22_124_154,seq18,r_41_91_78,1.0,0,78,78,80
38,r_43_121_245,r_144_34_207,seq21,r_144_34_207,0.84,0,207,207,80
34,r_75_86_187,r_63_38_198,r_33_110_180,r_75_86_187,0.59,0,187,187,80
17,r_146_142_159,seq115,r_93_8_83,r_146_142_159,0.98,0,159,159,80
9,r_107_83_76,r_29_113_17,r_70_131_63,r_70_131_63,1.0,24,87,63,80
49,r_100_139_19,r_130_60_48,seq27,r_100_139_19,0.97,0,19,19,80
8,r_10_61_20,r_95_74_135,seq45,r_10_61_20,0.99,0,20,20,80
9,r_107_83_76,r_29_113_17,r_43_121_245,r_107_83_76,0.51,114,190,76,80
56,seq11,r_95_74_135,r_36_105_148,r_95_74_135,0.99,-66,69,135,80
7,r_87_7_60,r_59_39_124,r_56_1_96,r_87_7_60,0.7,1,61,60,80
13,r_135_111_97,r_85_26_29,seq53,r_85_26_29,1.0,-1,28,29,80
0,r_29_113_17,r_120_28_34,r_52_137_21,r_120_28_34,0.64,-18,16,34,80
35,r_99_2_146,seq5,seq4,r_99_2_146,0.98,0,146,146,80
30,r_64_39_108,r_16_130_209,r_17_2_130,r_17_2_130,0.6,7,137,130,81
9,r_106_141_235,r_131_107_7,r_84_116_89,r_84_116_89,1.0,13,102,89,81
14,r_17_2_130,seq54,r_64_39_108,r_17_2_130,1.0,-2,128,130,81
9,r_106_141_235,r_84_116_89,r_0_111_20,r_84_116_89,0.5,146,235,89,81
53,seq5,r_3_147_169,r_10_127_141,r_10_127_141,0.52,29,170,141,81
37,r_145_19_178,seq55,r_3_147_169,r_145_19_178,0.95,0,178,178,81
21,r_85_65_242,r_38_47_245,r_37_58_38,r_37_58_38,0.64,200,238,38,81
1,r_124_81_109,r_145_19_178,r_64_39_108,r_124_81_109,0.99,0,109,109,81
16,r_110_148_43,r_67_75_156,r_109_34_83,r_110_148_43,0.97,1,44,43,81
46,r_134_70_187,seq7,seq92,r_134_70_187,0.84,0,187,187,81
53,seq5,r_10_127_141,r_59_101_208,r_59_101_208,1.0,3,211,208,81
69,seq42,seq80,r_145_19_178,r_145_19_178,0.67,4,182,178,81
45,r_97_49_79,r_105_69_148,seq72,r_97_49_79,1.0,0,79,79,81
19,r_16_130_209,seq136,seq23,r_16_130_209,0.7,0,209,209,81
31,r_37_58_38,r_57_46_243,seq32,r_37_58_38,1.0,0,38,38,81
27,r_44_22_195,r_110_148_43,r_82_117_217,r_110_148_43,0.49,154,197,43,81
39,r_89_113_12,r_91_88_204,seq119,r_91_88_204,0.89,-63,141,204,81
3,r_102_50_95,seq100,seq92,r_102_50_95,1.0,0,95,95,81
10,r_3_147_169,seq5,seq62,r_3_147_169,0.86,1,170,169,81
26,r_35_25_64,seq120,seq1,r_35_25_64,0.67,14,78,64,81
4,r_77_133_75,r_115_98_82,r_110_148_43,r_77_133_75,0.98,1,76,75,81
73,seq54,r_59_101_208,seq23,r_59_101_208,0.94,0,208,208,81
20,r_67_75_156,r_118_21_190,r_112_63_166,r_118_21_190,0.93,-30,160,190,81
13,r_109_34_83,r_44_22_195,seq92,r_109_34_83,1.0,0,83,83,81
11,r_33_30_40,r_106_141_235,seq122,r_33_30_40,1.0,0,40,40,81
48,r_118_21_190,seq132,seq146,r_118_21_190,0.82,1,191,190,81
49,r_84_116_89,r_106_141_235,r_131_107_7,r_84_116_89,0.61,110,199,89,81
17,r_6_138_46,r_102_50_95,r_110_148_43,r_6_138_46,0.83,6,52,46,81
2,r_10_127_141,r_145_19_178,r_110_148_43,r_110_148_43,0.74,98,141,43,81
43,r_91_88_204,r_99_104_162,r_89_113_12,r_89_113_12,0.74,35,47,12,81
27,r_44_22_195,r_109_34_83,r_110_148_43,r_44_22_195,0.71,-112,83,195,81
6,r_52_93_37,r_134_70_187,seq129,r_52_93_37,1.0,1,38,37,81
87,seq92,r_145_19_178,r_109_34_83,r_109_34_83,0.86,22,105,83,81
47,r_18_45_161,seq7,seq136,r_18_45_161,0.85,1,162,161,81
40,r_36_41_86,r_115_98_82,r_86_143_76,r_86_143_76,1.0,18,94,76,81
74,seq55,r_145_19_178,seq23,r_145_19_178,1.0,0,178,178,81
18,r_13_8_97,r_106_141_235,r_33_30_40,r_106_141_235,0.99,-138,97,235,81
25,r_121_87_227,seq95,r_82_117_217,r_82_117_217,0.54,10,227,217,81
9,r_106_141_235,r_33_30_40,r_131_107_7,r_33_30_40,0.62,1,41,40,81
43,r_91_88_204,r_89_113_12,r_131_107_7,r_89_113_12,0.51,192,204,12,81
33,r_12_4_119,r_99_104_162,seq132,r_12_4_119,0.97,3,122,119,81
64,seq24,r_35_25_64,r_9_61_98,r_9_61_98,1.0,5,103,98,81
16,r_110_148_43,r_109_34_83,r_77_133_75,r_109_34_83,0.56,0,83,83,81
50,seq128,seq108,r_105_69_148,r_105_69_148,1.0,-4,144,148,81
32,r_114_66_116,r_118_21_190,r_52_93_37,r_114_66_116,0.82,0,116,116,81
38,r_135_53_207,seq139,r_12_4_119,r_12_4_119,0.52,88,207,119,81
34,r_99_104_162,seq32,seq144,r_99_104_162,0.37,-9,153,162,81
39,r_89_113_12,r_52_93_37,r_91_88_204,r_89_113_12,0.96,1,13,12,81
81,seq129,r_38_47_245,r_52_93_37,r_52_93_37,1.0,160,197,37,81
94,seq119,r_99_104_162,r_89_113_12,r_89_113_12,0.89,98,110,12,81
29,r_131_107_7,r_106_141_235,r_84_116_89,r_84_116_89,1.0,21,110,89,81
22,r_115_98_82,seq20,seq7,r_115_98_82,0.47,4,86,82,81
28,r_59_101_208,seq54,seq5,r_59_101_208,0.86,0,208,208,81
49,r_84_116_89,seq62,r_106_141_235,r_84_116_89,1.0,0,89,89,81
56,seq139,r_135_53_207,seq100,r_135_53_207,0.65,0,207,207,81
7,r_73_137_134,r_112_63_166,seq7,r_73_137_134,0.98,1,135,134,81
44,r_9_61_98,r_99_104_162,seq24,r_9_61_98,0.98,0,98,98,81
23,r_112_63_166,seq78,r_18_45_161,r_18_45_161,0.48,9,170,161,81
82,seq74,r_35_25_64,seq68,r_35_25_64,0.54,39,103,64,81
35,r_105_69_148,seq40,seq128,r_105_69_148,0.97,4,152,148,81
12,r_86_143_76,r_17_2_130,r_36_41_86,r_86_143_76,0.99,1,77,76,81
44,r_79_73_74,r_47_69_204,r_7_5_134,r_7_5_134,0.99,30,164,134,82
16,r_71_94_15,seq65,seq123,r_71_94_15,0.85,0,15,15,82
51,seq1,r_120_6_32,r_46_9_73,r_46_9_73,1.0,2,75,73,82
14,r_90_131_82,r_101_13_195,seq12,r_90_131_82,0.99,1,83,82,82
8,r_67_30_68,r_120_6_32,r_52_34_12,r_67_30_68,0.99,1,69,68,82
37,r_38_66_181,seq27,r_118_128_174,r_38_66_181,0.63,0,181,181,82
59,seq17,r_56_44_131,r_136_107_152,r_136_107_152,0.81,-34,118,152,82
1,r_42_111_92,r_97_57_203,r_29_75_213,r_97_57_203,0.47,33,236,203,82
1,r_42_111_92,seq35,r_97_57_203,r_42_111_92,0.93,0,92,92,82
46,r_59_14_224,seq43,r_24_26_108,r_24_26_108,1.0,119,227,108,82
42,r_136_107_152,r_95_36_91,r_46_9_73,r_136_107_152,0.7,-61,91,152,82
38,r_52_34_12,r_39_50_26,seq106,r_52_34_12,0.96,0,12,12,82
26,r_8_145_56,seq130,seq16,r_8_145_56,1.0,0,56,56,82
31,r_133_76_144,seq35,r_136_107_152,r_133_76_144,0.92,1,145,144,82
41,r_48_23_126,r_53_74_242,r_95_36_91,r_48_23_126,0.74,-1,125,126,82
10,r_29_75_213,seq93,r_118_128_174,r_29_75_213,0.87,0,213,213,82
43,r_147_49_23,r_21_55_221,r_71_94_15,r_147_49_23,0.86,1,24,23,82
16,r_71_94_15,seq123,r_147_49_23,r_71_94_15,0.46,66,81,15,82
4,r_46_9_73,seq51,seq1,r_46_9_73,1.0,0,73,73,82
0,r_135_81_122,seq51,seq27,r_135_81_122,1.0,4,126,122,82
13,r_137_33_240,r_98_117_239,r_48_23_126,r_48_23_126,0.9,113,239,126,82
15,r_60_82_220,seq32,r_71_94_15,r_60_82_220,0.64,0,220,220,82
48,r_24_26_108,r_114_70_146,r_28_108_209,r_24_26_108,0.69,1,109,108,82
73,seq63,seq35,r_84_10_35,r_84_10_35,1.0,13,48,35,82
2,r_39_50_26,r_67_30_68,seq32,r_39_50_26,0.53,0,26,26,82
6,r_56_44_131,seq17,r_120_6_32,r_56_44_131,0.33,-1,130,131,82
19,r_129_72_22,r_42_111_92,seq80,r_129_72_22,0.97,-2,20,22,82
7,r_114_70_146,r_38_66_181,r_20_85_176,r_114_70_146,0.85,0,146,146,82
30,r_126_110_66,seq35,r_118_128_174,r_126_110_66,0.55,113,179,66,82
42,r_136_107_152,r_46_9_73,r_133_76_144,r_133_76_144,1.0,1,145,144,82
39,r_84_10_35,seq31,seq63,r_84_10_35,0.85,0,35,35,82
49,r_127_37_18,seq138,seq1,r_127_37_18,0.71,-2,16,18,82
47,r_2_4_79,r_20_85_176,seq109,r_2_4_79,1.0,-2,77,79,82
18,r_100_140_172,r_60_82_220,r_46_9_73,r_46_9_73,1.0,103,176,73,82
24,r_47_69_204,seq61,r_71_94_15,r_71_94_15,0.71,189,204,15,82
35,r_28_108_209,r_24_26_108,r_71_94_15,r_28_108_209,0.83,0,209,209,82
48,r_24_26_108,r_28_108_209,seq19,r_28_108_209,0.96,-11,198,209,82
64,seq27,r_38_66_181,r_135_81_122,r_135_81_122,0.89,59,181,122,82
70,seq43,r_132_58_191,seq89,r_132_58_191,0.98,3,194,191,82
68,seq40,r_126_110_66,seq99,r_126_110_66,0.96,10,76,66,82
76,seq143,seq99,r_90_131_82,r_90_131_82,0.8,119,201,82,82
34,r_53_74_242,r_48_23_126,seq119,r_48_23_126,0.9,-1,125,126,82
17,r_7_5_134,r_28_108_209,r_79_73_74,r_7_5_134,1.0,0,134,134,82
40,r_102_22_28,r_42_111_92,seq105,r_102_22_28,1.0,2,30,28,82
9,r_95_36_91,r_136_107_152,seq51,r_95_36_91,1.0,0,91,91,82
22,r_21_55_221,seq121,r_90_131_82,r_90_131_82,0.45,140,222,82,82
28,r_101_13_195,seq89,seq93,r_101_13_195,0.94,0,195,195,82
7,r_114_70_146,r_24_26_108,r_38_66_181,r_24_26_108,1.0,1,109,108,82
44,r_79_73_74,seq116,r_47_69_204,r_79_73_74,0.94,3,77,74,82
65,seq31,r_84_10_35,seq19,r_84_10_35,0.83,1,36,35,82
35,r_28_108_209,r_7_5_134,r_24_26_108,r_28_108_209,0.74,-75,134,209,82
12,r_118_128_174,r_20_85_176,r_38_66_181,r_38_66_181,0.8,-1,180,181,82
30,r_52_54_150,seq118,r_29_140_10,r_52_54_150,0.99,0,150,150,83
44,r_61_73_19,r_133_10_101,r_113_87_43,r_133_10_101,0.54,0,101,101,83
17,r_58_143_50,seq69,seq75,r_58_143_50,0.95,0,50,50,83
43,r_57_65_166,seq126,seq91,r_57_65_166,0.41,1,167,166,83
64,seq26,r_58_143_50,r_18_25_94,r_58_143_50,0.44,182,232,50,83
54,seq129,r_85_94_199,r_9_36_79,r_9_36_79,0.98,122,201,79,83
21,r_9_36_79,seq102,seq129,r_9_36_79,0.72,1,80,79,83
39,r_96_37_89,seq33,r_52_54_150,r_96_37_89,1.0,0,89,89,83
2,r_111_92_28,r_50_0_248,seq135,r_111_92_28,1.0,0,28,28,83
1,r_59_41_118,r_132_103_95,r_88_86_45,r_59_41_118,0.94,-23,95,118,83
5,r_98_32_120,r_23_42_197,seq74,r_98_32_120,0.91,-1,119,120,83
46,r_45_109_99,r_85_94_199,r_132_103_95,r_45_109_99,0.58,0,99,99,83
42,r_38_35_210,seq79,seq11,r_38_35_210,0.87,0,210,210,83
4,r_93_2_58,r_16_55_173,seq80,r_16_55_173,0.59,-114,59,173,83
80,seq78,seq19,r_113_87_43,r_113_87_43,1.0,21,64,43,83
7,r_83_4_104,seq3,r_28_48_169,r_28_48_169,1.0,3,172,169,83
45,r_60_137_91,seq3,seq39,r_60_137_91,0.82,-1,90,91,83
19,r_81_144_162,r_46_70_233,r_96_37_89,r_46_70_233,1.0,-71,162,233,83
8,r_113_87_43,r_38_35_210,seq78,r_113_87_43,1.0,0,43,43,83
1,r_59_41_118,r_88_86_45,seq126,r_59_41_118,0.97,0,118,118,83
95,seq120,r_107_47_139,r_136_119_105,r_107_47_139,0.63,0,139,139,83
66,seq33,r_96_37_89,r_67_49_49,r_96_37_89,0.92,0,89,89,83
38,r_53_138_106,seq11,r_88_86_45,r_53_138_106,1.0,0,106,106,83
39,r_96_37_89,r_52_54_150,r_107_47_139,r_96_37_89,0.99,61,150,89,83
31,r_16_55_173,seq120,seq128,r_16_55_173,0.82,1,174,173,83
41,r_46_70_233,r_81_144_162,r_58_143_50,r_46_70_233,0.74,-90,143,233,83
37,r_121_24_47,r_7_116_239,seq145,r_121_24_47,1.0,1,48,47,83
3,r_43_6_200,seq74,r_104_134_14,r_43_6_200,0.58,0,200,200,83
90,seq108,r_28_48_169,seq110,r_28_48_169,0.93,-96,73,169,83
44,r_61_73_19,r_111_92_28,r_133_10_101,r_61_73_19,1.0,0,19,19,83
0,r_136_119_105,seq89,seq120,r_136_119_105,0.51,0,105,105,83
13,r_17_148_215,r_117_76_212,r_113_87_43,r_113_87_43,0.66,172,215,43,83
25,r_82_84_59,r_124_20_185,seq12,r_82_84_59,1.0,0,59,59,83
98,seq126,r_57_65_166,r_59_41_118,r_59_41_118,1.0,49,167,118,83
15,r_27_97_126,seq102,r_111_92_28,r_27_97_126,0.83,0,126,126,83
57,seq12,seq31,r_82_84_59,r_82_84_59,1.0,158,217,59,83
83,seq89,r_88_86_45,seq69,r_88_86_45,0.95,1,46,45,83
6,r_50_0_248,r_77_106_110,seq75,r_77_106_110,1.0,0,110,110,83
70,seq135,r_51_141_170,r_111_92_28,r_111_92_28,0.9,6,34,28,83
36,r_88_86_45,r_59_41_118,r_53_138_106,r_88_86_45,0.63,73,118,45,83
27,r_117_76_212,seq22,r_88_86_45,r_117_76_212,0.45,6,218,212,83
22,r_133_10_101,r_61_73_19,seq75,r_133_10_101,0.98,0,101,101,83
41,r_46_70_233,r_58_143_50,r_132_103_95,r_46_70_233,0.24,0,233,233,83
47,r_77_106_110,r_50_0_248,r_136_119_105,r_77_106_110,0.75,0,110,110,83
36,r_88_86_45,seq89,r_59_41_118,r_88_86_45,0.94,1,46,45,83
18,r_18_25_94,seq15,seq126,r_18_25_94,0.99,3,97,94,83
24,r_51_141_170,seq135,seq125,r_51_141_170,0.88,0,170,170,83
9,r_5_100_41,r_53_138_106,seq31,r_5_100_41,1.0,0,41,41,83
88,seq102,r_27_97_126,seq95,r_27_97_126,1.0,0,126,126,83
61,seq145,r_124_20_185,r_132_103_95,r_132_103_95,0.98,91,186,95,83
32,r_85_94_199,seq129,seq13,r_85_94_199,0.43,2,201,199,83
10,r_104_134_14,seq79,r_68_122_141,r_104_134_14,0.98,0,14,14,83
34,r_146_72_84,seq26,r_104_134_14,r_146_72_84,1.0,0,84,84,83
48,r_67_49_49,r_46_70_233,seq33,r_67_49_49,0.58,1,50,49,83
11,r_149_71_24,r_113_87_43,seq145,r_149_71_24,1.0,0,24,24,83
28,r_29_140_10,seq89,r_52_54_150,r_52_54_150,0.97,0,150,150,83
49,r_21_131_102,seq12,r_132_103_95,r_21_131_102,1.0,0,102,102,83
56,seq11,seq145,r_38_35_210,r_38_35_210,0.94,1,211,210,83
7,r_83_4_104,seq62,seq3,r_83_4_104,0.98,0,104,104,83
23,r_132_103_95,r_59_41_118,r_121_24_47,r_132_103_95,1.0,0,95,95,83
82,seq80,r_45_109_99,r_93_2_58,r_45_109_99,0.99,-35,64,99,83
38,r_53_138_106,r_5_100_41,seq11,r_5_100_41,1.0,0,41,41,83
97,seq125,seq126,r_51_141_170,r_51_141_170,1.0,0,170,170,83
22,r_133_10_101,seq19,r_61_73_19,r_61_73_19,0.94,4,23,19,83
35,r_124_20_185,seq145,r_60_137_91,r_124_20_185,0.91,1,186,185,83
40,r_129_103_187,r_2_8_38,seq17,r_129_103_187,0.97,0,187,187,84
37,r_60_149_56,r_6_100_238,r_116_67_31,r_60_149_56,0.8,0,56,56,84
23,r_2_8_38,r_114_31_53,r_129_103_187,r_2_8_38,1.0,0,38,38,84
20,r_25_63_12,r_85_18_29,r_42_49_95,r_25_63_12,0.41,0,12,12,84
36,r_106_102_168,seq66,r_1_93_141,r_106_102_168,0.74,0,168,168,84
92,seq107,r_82_134_167,r_68_61_101,r_68_61_101,0.79,-1,100,101,84
43,r_1_93_141,seq13,seq136,r_1_93_141,0.97,0,141,141,84
30,r_62_0_55,seq26,seq44,r_62_0_55,1.0,0,55,55,84
19,r_86_38_228,seq137,r_12_120_119,r_12_120_119,0.91,103,222,119,84
86,seq94,r_40_118_240,r_114_31_53,r_114_31_53,1.0,10,63,53,84
16,r_83_77_178,seq121,seq26,r_83_77_178,0.78,0,178,178,84
21,r_139_88_68,seq30,seq36,r_139_88_68,1.0,0,68,68,84
39,r_76_58_131,r_86_38_228,seq74,r_76_58_131,0.98,0,131,131,84
5,r_84_130_186,r_56_34_207,r_23_90_21,r_84_130_186,0.96,1,187,186,84
46,r_140_14_61,seq101,r_85_18_29,r_140_14_61,1.0,0,61,61,84
42,r_132_51_139,seq59,seq24,r_132_51_139,1.0,-1,138,139,84
32,r_82_134_167,r_85_18_29,r_25_63_12,r_82_134_167,0.87,1,168,167,84
45,r_68_61_101,r_20_135_177,seq107,r_68_61_101,1.0,0,101,101,84
19,r_86_38_228,r_76_58_131,seq137,r_76_58_131,0.92,0,131,131,84
15,r_12_120_119,r_6_100_238,r_86_38_228,r_86_38_228,0.88,9,237,228,84
33,r_40_118_240,r_23_90_21,r_6_100_238,r_23_90_21,0.39,219,240,21,84
13,r_117_123_34,r_65_39_142,seq55,r_117_123_34,0.99,0,34,34,84
66,seq29,r_48_115_222,r_3_81_199,r_3_81_199,0.62,13,212,199,84
31,r_104_72_120,r_56_34_207,seq19,r_104_72_120,1.0,0,120,120,84
67,seq30,seq26,r_148_80_111,r_148_80_111,1.0,0,111,111,84
89,seq144,r_148_80_111,seq17,r_148_80_111,1.0,0,111,111,84
3,r_113_142_40,r_82_134_167,seq101,r_113_142_40,1.0,0,40,40,84
10,r_35_64_196,seq45,r_25_63_12,r_35_64_196,0.52,0,196,196,84
26,r_3_81_199,seq19,seq29,r_3_81_199,0.72,1,200,199,84
11,r_56_34_207,r_84_130_186,r_6_100_238,r_84_130_186,0.69,1,187,186,84
11,r_56_34_207,r_6_100_238,seq36,r_6_100_238,0.69,-31,207,238,84
33,r_40_118_240,seq21,r_23_90_21,r_23_90_21,0.75,4,25,21,84
15,r_12_120_119,seq44,r_6_100_238,r_12_120_119,0.67,0,119,119,84
4,r_6_100_238,seq131,r_12_120_119,r_12_120_119,1.0,3,122,119,84
48,r_23_90_21,r_113_142_40,r_40_118_240,r_23_90_21,0.8,0,21,21,84
6,r_75_97_96,r_3_81_199,r_42_49_95,r_75_97_96,0.95,0,96,96,84
62,seq19,r_3_81_199,seq45,r_3_81_199,0.94,0,199,199,84
1,r_85_18_29,r_82_134_167,r_140_14_61,r_85_18_29,0.86,54,83,29,84
2,r_126_92_125,r_109_57_193,r_27_89_157,r_109_57_193,0.87,0,193,193,84
27,r_145_111_75,r_82_134_167,seq66,r_145_111_75,1.0,0,75,75,84
2,r_126_92_125,r_27_89_157,r_91_138_211,r_126_92_125,0.5,113,238,125,84
2,r_126_92_125,r_129_103_187,r_109_57_193,r_126_92_125,0.99,0,125,125,84
47,r_91_138_211,seq96,r_126_92_125,r_126_92_125,0.87,86,211,125,84
40,r_129_103_187,r_126_92_125,r_2_8_38,r_129_103_187,0.92,-113,74,187,84
18,r_109_57_193,seq107,r_126_92_125,r_126_92_125,1.0,0,125,125,84
29,r_43_146_98,seq7,seq101,r_43_146_98,0.99,0,98,98,84
24,r_148_80_111,seq17,seq30,r_148_80_111,1.0,0,111,111,84
25,r_27_89_157,r_56_34_207,r_140_14_61,r_27_89_157,1.0,1,158,157,84
48,r_23_90_21,r_40_118_240,r_84_130_186,r_84_130_186,1.0,54,240,186,84
88,seq96,r_91_138_211,r_54_108_158,r_54_108_158,0.96,53,211,158,84
1,r_85_18_29,seq17,r_82_134_167,r_85_18_29,1.0,0,29,29,84
61,seq17,seq13,r_129_103_187,r_129_103_187,0.99,5,192,187,84
41,r_99_112_27,r_132_51_139,seq121,r_99_112_27,0.94,1,28,27,84
34,r_73_52_194,seq128,seq141,r_73_52_194,0.96,0,194,194,84
20,r_25_63_12,r_42_49_95,r_99_112_27,r_25_63_12,0.94,13,25,12,84
75,seq47,r_56_34_207,seq131,r_56_34_207,1.0,-14,193,207,84
28,r_116_67_31,r_53_79_133,r_60_149_56,r_60_149_56,1.0,4,60,56,84
9,r_20_135_177,r_68_61_101,r_145_111_75,r_20_135_177,1.0,-76,101,177,84
28,r_116_67_31,r_43_146_98,r_53_79_133,r_116_67_31,0.97,0,31,31,84
14,r_114_31_53,r_48_115_222,seq94,r_114_31_53,1.0,0,53,53,84
4,r_6_100_238,r_12_120_119,seq29,r_6_100_238,0.39,0,238,238,84
56,seq137,r_41_69_210,r_86_38_228,r_41_69_210,0.76,0,210,210,84
18,r_109_57_193,r_126_92_125,r_75_97_96,r_109_57_193,1.0,0,193,193,84
44,r_65_39_142,seq16,seq147,r_65_39_142,0.99,0,142,142,84
32,r_82_134_167,r_113_142_40,r_85_18_29,r_82_134_167,1.0,-130,37,167,84
35,r_105_33_195,r_20_135_177,r_68_61_101,r_68_61_101,1.0,94,195,101,84
12,r_42_49_95,r_83_77_178,r_75_97_96,r_42_49_95,0.99,1,96,95,84
23,r_2_8_38,r_129_103_187,seq136,r_129_103_187,1.0,0,187,187,84
4,r_6_100_238,r_60_149_56,seq131,r_60_149_56,1.0,0,56,56,84
44,r_117_123_181,r_149_126_89,r_5_28_178,r_117_123_181,1.0,0,181,181,85
92,seq106,r_13_65_191,r_111_31_176,r_111_31_176,0.57,15,191,176,85
14,r_37_10_180,seq67,seq147,r_37_10_180,0.8,2,182,180,85
8,r_69_56_243,r_66_19_119,r_2_142_109,r_69_56_243,1.0,-124,119,243,85
33,r_133_73_56,seq16,seq32,r_133_73_56,1.0,0,56,56,85
37,r_71_52_230,r_149_126_89,seq93,r_149_126_89,0.96,-4,85,89,85
78,seq62,r_125_110_41,r_137_127_142,r_125_110_41,1.0,-6,35,41,85
86,seq94,seq147,r_5_28_178,r_5_28_178,0.81,1,179,178,85
1,r_70_55_26,seq54,r_100_136_131,r_100_136_131,1.0,37,168,131,85
5,r_115_135_86,r_37_10_180,r_41_118_73,r_41_118_73,1.0,13,86,73,85
46,r_66_19_119,r_69_56_243,seq94,r_66_19_119,0.96,0,119,119,85
42,r_88_104_70,r_81_33_107,seq99,r_88_104_70,0.98,0,70,70,85
45,r_82_87_146,seq53,seq148,r_82_87_146,0.99,1,147,146,85
30,r_72_51_43,r_129_20_130,r_69_56_243,r_69_56_243,0.98,-206,37,243,85
19,r_81_33_107,r_117_123_181,seq103,r_81_33_107,1.0,0,107,107,85
31,r_44_3_44,seq98,r_5_28_178,r_44_3_44,0.99,0,44,44,85
95,seq113,r_12_60_173,seq25,r_12_60_173,0.99,1,174,173,85
39,r_89_131_8,r_96_8_203,r_12_60_173,r_12_60_173,0.96,25,198,173,85
41,r_29_97_114,seq6,seq67,r_29_97_114,0.86,0,114,114,85
89,seq99,seq21,r_88_104_70,r_88_104_70,1.0,10,80,70,85
16,r_80_109_18,r_59_45_94,seq46,r_80_109_18,0.98,0,18,18,85
25,r_18_0_97,r_59_45_94,r_141_14_235,r_18_0_97,0.52,12,109,97,85
3,r_59_45_94,r_22_120_127,seq94,r_59_45_94,1.0,0,94,94,85
10,r_23_1_63,r_81_33_107,seq46,r_23_1_63,1.0,0,63,63,85
26,r_96_8_203,r_41_118_73,r_89_131_8,r_41_118_73,0.99,0,73,73,85
1,r_70_55_26,r_129_20_130,seq54,r_70_55_26,1.0,1,27,26,85
4,r_108_86_88,seq4,r_44_3_44,r_108_86_88,1.0,1,89,88,85
0,r_141_14_235,r_74_78_123,r_102_90_87,r_141_14_235,1.0,-112,123,235,85
11,r_137_127_142,seq62,r_47_122_68,r_47_122_68,1.0,31,99,68,85
23,r_125_110_41,seq62,seq54,r_125_110_41,1.0,0,41,41,85
20,r_43_15_92,r_12_60_173,r_96_8_203,r_43_15_92,1.0,0,92,92,85
13,r_102_90_87,seq16,r_36_50_244,r_102_90_87,1.0,0,87,87,85
98,seq121,seq11,r_74_78_123,r_74_78_123,1.0,14,137,123,85
15,r_111_31_176,seq93,seq68,r_111_31_176,0.87,0,176,176,85
48,r_138_77_155,seq146,r_116_85_13,r_138_77_155,0.86,0,155,155,85
6,r_58_27_95,seq106,r_80_109_18,r_58_27_95,1.0,0,95,95,85
85,seq93,r_111_31_176,r_96_8_203,r_96_8_203,0.75,-27,176,203,85
0,r_141_14_235,r_102_90_87,r_115_135_86,r_115_135_86,0.51,147,233,86,85
27,r_47_122_68,seq94,r_137_127_142,r_47_122_68,1.0,0,68,68,85
42,r_88_104_70,seq99,r_35_130_116,r_35_130_116,1.0,9,125,116,85
2,r_13_65_191,seq106,seq93,r_13_65_191,0.79,0,191,191,85
47,r_22_120_127,r_59_45_94,seq11,r_59_45_94,1.0,0,94,94,85
40,r_83_144_189,seq64,seq11,r_83_144_189,0.96,0,189,189,85
18,r_149_126_89,r_71_52_230,seq9,r_149_126_89,0.99,0,89,89,85
29,r_74_78_123,r_141_14_235,seq121,r_74_78_123,0.99,0,123,123,85
24,r_36_50_244,r_141_14_235,r_102_90_87,r_102_90_87,1.0,4,91,87,85
25,r_18_0_97,r_69_56_243,r_59_45_94,r_18_0_97,0.43,0,97,97,85
50,seq128,r_84_91_210,seq25,r_84_91_210,0.83,-7,203,210,85
72,seq46,r_129_20_130,r_80_109_18,r_80_109_18,0.9,10,28,18,85
20,r_43_15_92,r_96_8_203,r_12_60_173,r_43_15_92,0.97,104,196,92,85
32,r_49_79_59,seq32,seq9,r_49_79_59,1.0,0,59,59,85
61,seq148,seq24,r_82_87_146,r_82_87_146,0.95,1,147,146,85
38,r_41_118_73,r_96_8_203,r_83_144_189,r_83_144_189,0.66,-116,73,189,85
52,seq6,r_29_97_114,seq101,r_29_97_114,0.98,0,114,114,85
34,r_5_28_178,seq68,seq94,r_5_28_178,0.47,0,178,178,85
25,r_18_0_97,r_141_14_235,seq68,r_18_0_97,0.47,36,133,97,85
75,seq54,r_92_75_200,r_132_140_10,r_92_75_200,0.75,0,200,200,85
81,seq67,r_37_10_180,r_29_97_114,r_29_97_114,0.49,68,182,114,85
7,r_132_140_10,r_141_14_235,seq54,r_132_140_10,0.94,0,10,10,85
26,r_96_8_203,r_89_131_8,r_59_45_94,r_96_8_203,0.97,0,203,203,85
31,r_44_3_44,r_5_28_178,r_108_86_88,r_108_86_88,1.0,84,172,88,85
28,r_116_85_13,r_105_26_240,r_111_31_176,r_116_85_13,0.84,-1,12,13,85
37,r_71_52_230,seq93,r_149_126_89,r_149_126_89,0.31,142,231,89,85
28,r_116_85_13,r_111_31_176,r_138_77_155,r_116_85_13,0.95,150,163,13,85
22,r_92_75_200,seq54,seq62,r_92_75_200,0.52,0,200,200,85
38,r_41_118_73,r_83_144_189,r_115_135_86,r_41_118_73,0.83,19,92,73,85
49,r_2_142_109,seq103,r_72_51_43,r_2_142_109,1.0,0,109,109,85
44,r_117_123_181,r_81_33_107,r_149_126_89,r_117_123_181,0.97,-73,108,181,85
82,seq68,r_5_28_178,r_111_31_176,r_111_31_176,1.0,2,178,176,85
25,r_18_0_97,seq68,r_66_19_119,r_18_0_97,0.51,94,191,97,85
35,r_12_60_173,seq113,seq95,r_12_60_173,0.97,0,173,173,85
47,r_22_120_127,seq11,r_137_127_142,r_22_120_127,1.0,0,127,127,85
30,r_97_92_85,seq82,r_2_38_206,r_97_92_85,1.0,0,85,85,86
9,r_122_95_37,r_120_93_196,r_99_128_36,r_120_93_196,0.93,0,196,196,86
86,seq147,r_138_12_45,r_105_114_76,r_105_114_76,0.81,11,87,76,86
8,r_125_136_240,seq24,seq83,r_125_136_240,0.21,0,240,240,86
43,r_52_74_91,seq65,r_85_80_233,r_52_74_91,0.96,0,91,91,86
83,seq82,r_97_92_85,r_141_37_77,r_97_92_85,1.0,-1,84,85,86
37,r_142_148_139,r_91_98_249,r_141_37_77,r_91_98_249,1.0,-109,140,249,86
3,r_53_139_22,r_10_94_197,seq18,r_53_139_22,1.0,0,22,22,86
39,r_102_46_151,seq146,seq55,r_102_46_151,1.0,0,151,151,86
1,r_112_140_178,seq129,r_107_72_78,r_107_72_78,1.0,99,177,78,86
5,r_149_116_232,r_120_93_196,r_122_95_37,r_122_95_37,0.75,152,189,37,86
46,r_105_114_76,seq16,seq147,r_105_114_76,1.0,0,76,76,86
42,r_50_104_222,seq17,r_126_113_63,r_126_113_63,1.0,34,97,63,86
18,r_67_27_41,r_125_136_240,r_42_5_3,r_67_27_41,0.56,4,45,41,86
19,r_107_72_78,seq70,seq34,r_107_72_78,1.0,0,78,78,86
33,r_124_0_90,r_61_88_169,r_99_128_36,r_61_88_169,0.93,1,170,169,86
76,seq64,seq146,r_36_23_195,r_36_23_195,0.99,10,205,195,86
31,r_2_38_206,seq18,r_97_92_85,r_97_92_85,1.0,-1,84,85,86
41,r_132_79_188,seq64,r_141_37_77,r_132_79_188,0.56,0,188,188,86
27,r_133_103_31,r_125_136_240,r_53_139_22,r_133_103_31,0.87,0,31,31,86
10,r_101_3_234,seq26,r_52_74_91,r_52_74_91,1.0,144,235,91,86
26,r_42_5_3,r_124_0_90,r_67_27_41,r_42_5_3,0.87,58,61,3,86
72,seq54,r_127_57_147,seq8,r_127_57_147,1.0,2,149,147,86
11,r_66_32_42,seq147,seq26,r_66_32_42,0.6,6,48,42,86
4,r_85_80_233,r_22_40_210,r_52_74_91,r_52_74_91,0.78,6,97,91,86
0,r_36_23_195,seq118,seq64,r_36_23_195,0.88,0,195,195,86
73,seq55,r_76_130_241,r_2_38_206,r_2_38_206,0.92,4,210,206,86
20,r_120_93_196,r_141_37_77,r_122_95_37,r_120_93_196,0.79,-134,62,196,86
15,r_131_35_176,r_125_136_240,r_33_21_118,r_131_35_176,0.94,0,176,176,86
17,r_111_29_101,r_105_114_76,r_102_46_151,r_105_114_76,0.54,145,221,76,86
6,r_141_37_77,r_120_93_196,r_138_12_45,r_120_93_196,0.93,-101,95,196,86
9,r_122_95_37,seq83,r_120_93_196,r_122_95_37,1.0,0,37,37,86
30,r_97_92_85,r_2_38_206,seq8,r_2_38_206,0.96,-16,190,206,86
22,r_126_113_63,r_50_104_222,r_62_9_218,r_50_104_222,0.54,0,222,222,86
21,r_81_1_18,r_44_45_239,seq68,r_81_1_18,0.99,0,18,18,86
2,r_127_57_147,seq54,seq4,r_127_57_147,0.82,2,149,147,86
40,r_63_75_198,seq49,seq90,r_63_75_198,0.52,0,198,198,86
28,r_99_128_36,seq106,seq145,r_99_128_36,0.75,5,41,36,86
29,r_61_88_169,r_91_98_249,r_124_0_90,r_124_0_90,0.82,46,136,90,86
24,r_100_86_105,r_44_45_239,seq65,r_100_86_105,0.97,-2,103,105,86
7,r_41_11_20,r_102_46_151,seq4,r_41_11_20,0.99,0,20,20,86
33,r_124_0_90,r_42_5_3,r_61_88_169,r_124_0_90,0.49,1,91,90,86
50,seq129,r_112_140_178,r_67_27_41,r_67_27_41,0.54,136,177,41,86
29,r_61_88_169,r_124_0_90,r_67_27_41,r_61_88_169,0.81,1,170,169,86
65,seq34,r_13_71_47,r_107_72_78,r_107_72_78,1.0,17,95,78,86
20,r_120_93_196,r_122_95_37,seq134,r_120_93_196,0.93,0,196,196,86
42,r_50_104_222,r_126_113_63,r_141_37_77,r_126_113_63,0.57,159,222,63,86
32,r_117_31_186,seq49,r_39_119_164,r_117_31_186,0.43,-2,184,186,86
34,r_60_20_187,seq49,seq16,r_60_20_187,0.92,0,187,187,86
17,r_111_29_101,r_124_0_90,seq55,r_111_29_101,0.77,7,108,101,86
31,r_2_38_206,r_97_92_85,seq55,r_2_38_206,0.93,4,210,206,86
22,r_126_113_63,r_39_119_164,r_50_104_222,r_126_113_63,0.95,-3,60,63,86
44,r_10_94_197,r_22_40_210,seq17,r_10_94_197,0.56,0,197,197,86
23,r_138_12_45,seq28,seq25,r_138_12_45,0.76,5,50,45,86
17,r_111_29_101,seq55,r_105_114_76,r_111_29_101,0.56,76,177,101,86
79,seq70,r_107_72_78,seq83,r_107_72_78,0.96,1,79,78,86
30,r_44_129_232,seq131,r_46_121_211,r_44_129_232,0.53,0,232,232,87
51,seq1,seq55,r_50_90_72,r_50_90_72,1.0,5,77,72,87
36,r_24_110_131,seq72,r_61_91_11,r_24_110_131,0.99,0,131,131,87
92,seq114,r_80_40_100,seq142,r_80_40_100,1.0,2,102,100,87
14,r_20_89_12,r_69_58_119,r_103_74_37,r_69_58_119,0.97,0,119,119,87
8,r_46_121_211,seq55,r_75_43_105,r_46_121_211,0.69,0,211,211,87
37,r_141_111_132,seq0,seq131,r_141_111_132,0.98,0,132,132,87
3,r_108_65_38,r_112_115_230,seq120,r_108_65_38,0.37,200,238,38,87
55,seq8,r_109_88_181,r_83_71_95,r_83_71_95,1.0,85,180,95,87
86,seq100,r_75_43_105,r_96_79_116,r_75_43_105,0.97,0,105,105,87
16,r_54_68_153,seq125,r_92_144_43,r_92_144_43,1.0,41,84,43,87
39,r_82_93_167,seq45,seq119,r_82_93_167,0.99,0,167,167,87
1,r_98_95_75,r_5_94_236,r_92_144_43,r_98_95_75,0.94,2,77,75,87
97,seq122,seq100,r_85_60_125,r_85_60_125,1.0,0,125,125,87
42,r_57_47_238,seq101,r_46_121_211,r_57_47_238,0.38,0,238,238,87
45,r_5_94_236,seq136,r_84_66_57,r_5_94_236,0.31,0,236,236,87
13,r_39_33_51,r_126_87_219,seq36,r_39_33_51,1.0,0,51,51,87
19,r_62_77_135,seq104,seq139,r_62_77_135,0.94,0,135,135,87
11,r_113_107_22,r_98_95_75,seq142,r_113_107_22,1.0,0,22,22,87
27,r_70_63_235,r_62_77_135,seq29,r_70_63_235,0.54,0,235,235,87
95,seq119,r_37_138_113,r_82_93_167,r_82_93_167,0.99,0,167,167,87
41,r_15_25_175,seq146,r_39_33_51,r_39_33_51,0.6,124,175,51,87
10,r_96_79_116,seq146,seq100,r_96_79_116,0.9,0,116,116,87
67,seq23,r_6_86_229,r_75_43_105,r_75_43_105,1.0,1,106,105,87
26,r_109_88_181,seq8,r_17_4_79,r_17_4_79,0.7,101,180,79,87
72,seq35,r_117_18_159,r_80_40_100,r_80_40_100,0.91,58,158,100,87
16,r_54_68_153,r_92_144_43,r_83_71_95,r_54_68_153,0.97,-1,152,153,87
4,r_133_64_121,r_82_93_167,r_20_89_12,r_133_64_121,0.97,3,124,121,87
0,r_6_86_229,seq23,r_85_60_125,r_85_60_125,1.0,104,229,125,87
20,r_132_56_171,r_14_67_208,r_96_79_116,r_132_56_171,0.88,0,171,171,87
15,r_14_67_208,seq36,seq52,r_14_67_208,0.81,0,208,208,87
48,r_17_4_79,r_134_127_36,r_5_94_236,r_17_4_79,0.97,2,81,79,87
12,r_85_60_125,r_6_86_229,seq122,r_85_60_125,0.83,0,125,125,87
6,r_102_27_154,seq3,seq28,r_102_27_154,0.76,0,154,154,87
21,r_112_115_230,r_108_65_38,r_46_121_211,r_46_121_211,0.57,20,231,211,87
67,seq23,r_41_31_48,r_6_86_229,r_41_31_48,1.0,-1,47,48,87
5,r_59_32_49,seq16,r_73_22_17,r_59_32_49,0.77,1,50,49,87
46,r_103_74_37,r_50_90_72,r_20_89_12,r_50_90_72,0.95,-33,39,72,87
27,r_70_63_235,seq105,r_62_77_135,r_62_77_135,1.0,14,149,135,87
87,seq101,r_57_47_238,seq124,r_57_47_238,0.61,0,238,238,87
2,r_10_148_203,seq137,seq8,r_10_148_203,0.53,1,204,203,87
47,r_50_90_72,r_102_27_154,seq1,r_50_90_72,1.0,0,72,72,87
38,r_92_144_43,r_62_77_135,seq7,r_92_144_43,1.0,0,43,43,87
40,r_123_149_68,seq101,seq130,r_123_149_68,0.98,0,68,68,87
29,r_75_43_105,seq100,seq23,r_75_43_105,1.0,1,106,105,87
64,seq146,r_15_25_175,r_83_71_95,r_15_25_175,1.0,-1,174,175,87
24,r_11_12_142,seq49,r_85_60_125,r_11_12_142,0.9,0,142,142,87
33,r_9_81_129,r_11_12_142,r_113_107_22,r_9_81_129,0.7,0,129,129,87
48,r_17_4_79,r_5_94_236,r_109_88_181,r_17_4_79,0.56,94,173,79,87
64,seq146,r_96_79_116,r_15_25_175,r_96_79_116,0.99,0,116,116,87
50,seq0,r_141_111_132,r_61_91_11,r_141_111_132,0.67,0,132,132,87
65,seq131,r_44_129_232,r_141_111_132,r_141_111_132,1.0,72,204,132,87
25,r_84_66_57,seq139,seq53,r_84_66_57,1.0,1,58,57,87
68,seq26,r_5_94_236,r_97_19_139,r_97_19_139,0.99,0,139,139,87
34,r_69_58_119,r_20_89_12,seq13,r_69_58_119,1.0,0,119,119,87
28,r_30_78_53,r_85_60_125,seq52,r_30_78_53,1.0,0,53,53,87
12,r_85_60_125,r_30_78_53,r_6_86_229,r_30_78_53,1.0,0,53,53,87
21,r_112_115_230,r_80_40_100,r_108_65_38,r_112_115_230,0.78,-192,38,230,87
17,r_61_91_11,seq122,seq34,r_61_91_11,0.95,0,11,11,87
81,seq55,r_46_121_211,r_117_18_159,r_117_18_159,0.56,52,211,159,87
9,r_97_19_139,r_48_116_198,seq26,r_97_19_139,0.88,0,139,139,87
12,r_85_60_125,seq122,r_11_12_142,r_11_12_142,1.0,1,143,142,87
22,r_117_18_159,seq35,r_50_90_72,r_50_90_72,0.79,86,158,72,87
49,r_83_71_95,seq45,seq140,r_83_71_95,0.98,0,95,95,87
7,r_37_138_113,seq119,r_113_107_22,r_113_107_22,0.57,105,127,22,87
23,r_135_145_92,r_44_129_232,seq139,r_135_145_92,0.99,2,94,92,87
35,r_80_40_100,seq114,seq35,r_80_40_100,1.0,0,100,100,87
43,r_41_31_48,seq23,seq7,r_41_31_48,1.0,0,48,48,87
3,r_108_65_38,seq140,r_112_115_230,r_108_65_38,1.0,0,38,38,87
30,r_23_40_155,seq82,seq110,r_23_40_155,0.78,0,155,155,88
51,seq129,r_11_138_245,r_43_141_170,r_11_138_245,0.79,-49,196,245,88
6,r_86_33_136,r_69_128_97,r_38_127_49,r_38_127_49,1.0,3,52,49,88
41,r_38_127_49,r_66_8_178,r_86_33_136,r_38_127_49,1.0,0,49,49,88
54,seq133,seq124,r_64_113_139,r_64_113_139,1.0,-2,137,139,88
83,seq88,r_36_106_214,seq0,r_36_106_214,0.94,3,217,214,88
37,r_3_58_219,seq134,r_97_90_44,r_97_90_44,0.76,175,219,44,88
19,r_96_99_13,r_135_31_197,seq15,r_135_31_197,0.9,0,197,197,88
55,seq134,r_3_58_219,r_70_44_50,r_70_44_50,0.96,169,219,50,88
16,r_28_55_66,seq116,r_13_75_195,r_28_55_66,1.0,0,66,66,88
39,r_107_111_137,seq16,seq124,r_107_111_137,0.75,1,138,137,88
29,r_135_31_197,r_50_100_47,r_96_99_13,r_135_31_197,0.94,-184,13,197,88
1,r_92_37_145,r_36_106_214,r_109_71_127,r_92_37_145,0.8,1,146,145,88
45,r_57_132_148,seq27,seq16,r_57_132_148,0.93,0,148,148,88
46,r_123_94_29,r_107_111_137,r_114_35_230,r_123_94_29,1.0,0,29,29,88
14,r_69_128_97,r_97_90_44,seq126,r_97_90_44,0.84,-18,26,44,88
10,r_18_7_191,r_3_58_219,seq147,r_3_58_219,0.48,-26,193,219,88
90,seq143,r_54_34_96,r_144_93_182,r_54_34_96,1.0,-13,83,96,88
26,r_66_8_178,seq76,r_64_113_139,r_66_8_178,0.85,0,178,178,88
16,r_28_55_66,r_13_75_195,r_107_111_137,r_107_111_137,1.0,7,144,137,88
14,r_69_128_97,seq126,r_38_127_49,r_38_127_49,0.84,46,95,49,88
4,r_131_87_161,seq30,r_112_95_25,r_131_87_161,0.94,2,163,161,88
73,seq62,r_26_74_80,seq59,r_26_74_80,1.0,2,82,80,88
11,r_89_24_120,seq130,seq126,r_89_24_120,1.0,0,120,120,88
44,r_73_85_56,r_3_58_219,seq60,r_73_85_56,1.0,0,56,56,88
16,r_28_55_66,r_107_111_137,seq83,r_28_55_66,0.41,125,191,66,88
3,r_115_103_36,r_107_111_137,seq30,r_115_103_36,1.0,0,36,36,88
20,r_146_46_171,r_63_1_177,r_84_45_205,r_146_46_171,0.8,0,171,171,88
98,seq125,r_13_75_195,seq83,r_13_75_195,0.9,0,195,195,88
46,r_123_94_29,r_114_35_230,seq10,r_114_35_230,0.48,0,230,230,88
15,r_149_29_154,r_2_79_235,seq91,r_2_79_235,0.67,-81,154,235,88
48,r_26_74_80,seq62,seq56,r_26_74_80,1.0,2,82,80,88
61,seq16,seq20,r_25_5_153,r_25_5_153,1.0,2,155,153,88
62,seq19,r_137_39_1,r_102_67_135,r_102_67_135,1.0,13,148,135,88
31,r_50_100_47,seq15,seq88,r_50_100_47,1.0,1,48,47,88
99,seq126,r_69_128_97,r_57_132_148,r_57_132_148,0.72,-80,68,148,88
36,r_112_95_25,r_49_139_160,seq10,r_112_95_25,1.0,0,25,25,88
17,r_97_90_44,r_69_128_97,r_63_1_177,r_97_90_44,1.0,0,44,44,88
27,r_36_106_214,seq88,r_6_142_31,r_36_106_214,0.71,3,217,214,88
87,seq104,r_63_1_177,r_97_90_44,r_97_90_44,1.0,134,178,44,88
22,r_70_44_50,r_3_58_219,seq78,r_3_58_219,1.0,0,219,219,88
41,r_38_127_49,r_86_33_136,r_69_128_97,r_86_33_136,0.98,0,136,136,88
47,r_105_21_121,r_25_5_153,r_43_141_170,r_105_21_121,0.94,0,121,121,88
43,r_48_120_18,seq134,seq32,r_48_120_18,0.96,-3,15,18,88
40,r_61_42_64,r_2_79_235,r_43_141_170,r_2_79_235,0.97,1,236,235,88
18,r_2_79_235,r_61_42_64,r_96_99_13,r_61_42_64,0.34,172,236,64,88
24,r_102_67_135,seq82,seq19,r_102_67_135,1.0,0,135,135,88
13,r_6_142_31,seq10,seq108,r_6_142_31,1.0,0,31,31,88
35,r_63_1_177,r_97_90_44,r_107_111_137,r_63_1_177,0.95,1,178,177,88
25,r_144_93_182,seq143,r_43_141_170,r_144_93_182,0.54,0,182,182,88
33,r_13_75_195,seq125,r_73_85_56,r_13_75_195,0.69,0,195,195,88
64,seq27,r_57_132_148,r_69_128_97,r_57_132_148,0.85,0,148,148,88
28,r_114_35_230,r_6_142_31,r_123_94_29,r_114_35_230,0.98,-200,30,230,88
50,seq0,r_2_79_235,r_50_100_47,r_50_100_47,1.0,162,209,47,88
70,seq56,r_137_39_1,r_26_74_80,r_26_74_80,1.0,0,80,80,88
6,r_86_33_136,r_38_127_49,r_112_95_25,r_86_33_136,1.0,0,136,136,88
19,r_96_99_13,r_131_87_161,r_135_31_197,r_96_99_13,0.99,0,13,13,88
61,seq16,r_107_111_137,seq20,r_107_111_137,0.69,1,138,137,88
32,r_22_121_78,seq0,seq126,r_22_121_78,1.0,0,78,78,88
38,r_25_5_153,seq41,r_57_132_148,r_25_5_153,0.79,0,153,153,88
52,seq130,r_89_24_120,seq110,r_89_24_120,1.0,-8,112,120,88
34,r_14_17_159,seq9,seq76,r_14_17_159,0.69,1,160,159,88
22,r_70_44_50,r_49_139_160,r_3_58_219,r_70_44_50,1.0,0,50,50,88
9,r_109_71_127,seq82,r_48_120_18,r_109_71_127,0.87,0,127,127,88
90,seq143,r_144_93_182,seq62,r_144_93_182,1.0,-14,168,182,88
28,r_114_35_230,r_123_94_29,r_43_141_170,r_114_35_230,0.36,0,230,230,88
29,r_135_31_197,r_96_99_13,r_131_87_161,r_135_31_197,0.83,0,197,197,88
49,r_51_118_69,r_131_87_161,seq41,r_51_118_69,1.0,0,69,69,88
7,r_145_53_174,r_36_106_214,r_48_120_18,r_145_53_174,0.82,0,174,174,88
17,r_97_90_44,r_63_1_177,seq104,r_63_1_177,1.0,1,178,177,88
35,r_63_1_177,r_146_46_171,r_97_90_44,r_97_90_44,1.0,29,73,44,88
12,r_64_113_139,seq30,seq133,r_64_113_139,0.94,0,139,139,88
30,r_137_53_67,seq43,seq38,r_137_53_67,1.0,0,67,67,89
12,r_140_95_47,r_91_104_98,seq54,r_140_95_47,1.0,0,47,47,89
51,seq132,seq99,r_57_10_125,r_57_10_125,1.0,14,139,125,89
8,r_146_2_134,seq87,r_142_3_88,r_146_2_134,1.0,0,134,134,89
43,r_118_33_166,seq54,r_64_145_205,r_118_33_166,0.98,0,166,166,89
37,r_82_72_175,r_120_111_141,seq106,r_82_72_175,0.95,2,177,175,89
2,r_58_86_59,r_122_19_187,r_48_23_24,r_58_86_59,1.0,0,59,59,89
54,seq138,r_119_15_17,r_122_19_187,r_119_15_17,0.7,156,173,17,89
59,seq16,seq43,r_98_26_121,r_98_26_121,1.0,1,122,121,89
34,r_129_42_184,seq44,r_71_123_25,r_71_123_25,1.0,-1,24,25,89
55,seq11,r_131_39_163,r_64_145_205,r_131_39_163,0.87,-12,151,163,89
71,seq51,r_17_31_216,r_30_41_199,r_30_41_199,0.66,27,226,199,89
86,seq96,seq6,r_35_112_64,r_35_112_64,1.0,19,83,64,89
16,r_55_59_152,seq81,r_25_79_90,r_55_59_152,1.0,0,152,152,89
39,r_30_41_199,r_64_145_205,seq51,r_64_145_205,0.84,-5,200,205,89
1,r_131_39_163,seq11,seq106,r_131_39_163,0.99,0,163,163,89
5,r_91_104_98,r_57_10_125,r_84_7_87,r_57_10_125,1.0,-27,98,125,89
46,r_17_31_216,seq51,r_119_15_17,r_119_15_17,0.84,209,226,17,89
83,seq87,r_35_112_64,r_115_136_204,r_115_136_204,1.0,2,206,204,89
42,r_114_29_28,seq113,seq100,r_114_29_28,0.98,0,28,28,89
19,r_93_12_149,seq14,seq16,r_93_12_149,1.0,0,149,149,89
27,r_84_7_87,r_122_19_187,r_91_104_98,r_84_7_87,0.46,105,192,87,89
95,seq113,r_75_135_240,r_48_23_24,r_75_135_240,0.6,-5,235,240,89
66,seq43,seq16,r_142_3_88,r_142_3_88,0.75,3,91,88,89
31,r_1_4_185,seq103,r_48_23_24,r_1_4_185,0.82,0,185,185,89
41,r_117_34_194,r_115_136_204,seq56,r_117_34_194,0.57,0,194,194,89
3,r_127_24_213,seq116,seq21,r_127_24_213,0.62,2,215,213,89
10,r_147_67_142,r_142_3_88,seq116,r_147_67_142,0.97,0,142,142,89
26,r_57_10_125,r_48_23_24,seq132,r_57_10_125,1.0,1,126,125,89
20,r_5_109_219,seq56,seq21,r_5_109_219,0.53,0,219,219,89
13,r_64_145_205,r_30_41_199,seq11,r_30_41_199,0.6,-2,197,199,89
29,r_71_123_25,r_1_4_185,r_129_42_184,r_71_123_25,0.98,1,26,25,89
48,r_98_26_121,r_89_74_162,seq16,r_98_26_121,0.99,0,121,121,89
6,r_68_45_150,seq143,seq14,r_68_45_150,0.98,0,150,150,89
2,r_58_86_59,r_48_23_24,seq63,r_58_86_59,0.45,115,174,59,89
9,r_89_74_162,r_101_70_29,r_78_22_11,r_89_74_162,0.99,-1,161,162,89
0,r_78_22_11,seq13,r_89_74_162,r_89_74_162,1.0,32,194,162,89
27,r_84_7_87,r_91_104_98,r_122_19_187,r_122_19_187,1.0,-100,87,187,89
21,r_101_70_29,r_9_40_229,r_120_111_141,r_101_70_29,1.0,0,29,29,89
47,r_142_3_88,r_147_67_142,seq43,r_147_67_142,0.71,-51,91,142,89
40,r_128_85_153,seq113,r_71_123_25,r_128_85_153,0.98,0,153,153,89
74,seq56,r_5_109_219,r_147_67_142,r_147_67_142,0.91,77,219,142,89
18,r_35_112_64,seq16,seq96,r_35_112_64,1.0,0,64,64,89
15,r_76_144_19,r_146_2_134,seq54,r_76_144_19,0.99,-1,18,19,89
24,r_48_23_24,r_57_10_125,r_69_50_112,r_57_10_125,1.0,-14,111,125,89
34,r_129_42_184,r_71_123_25,seq141,r_129_42_184,0.88,0,184,184,89
35,r_122_19_187,r_84_7_87,seq138,r_122_19_187,0.8,5,192,187,89
33,r_88_62_198,r_120_111_141,r_35_112_64,r_35_112_64,1.0,135,199,64,89
11,r_119_15_17,r_35_112_64,seq56,r_119_15_17,0.99,0,17,17,89
32,r_102_77_68,seq52,seq27,r_102_77_68,1.0,3,71,68,89
38,r_134_0_180,r_122_19_187,r_69_50_112,r_134_0_180,0.68,0,180,180,89
45,r_108_125_31,seq51,seq66,r_108_125_31,0.89,0,31,31,89
44,r_92_80_49,r_128_85_153,seq143,r_92_80_49,1.0,0,49,49,89
81,seq81,r_55_59_152,seq121,r_55_59_152,0.84,1,153,152,89
17,r_115_136_204,r_117_34_194,seq63,r_117_34_194,0.52,0,194,194,89
54,seq138,r_17_31_216,r_119_15_17,r_119_15_17,0.72,42,59,17,89
22,r_97_126_50,seq138,seq141,r_97_126_50,1.0,0,50,50,89
9,r_89_74_162,r_98_26_121,r_101_70_29,r_89_74_162,0.9,-41,121,162,89
79,seq66,seq38,r_108_125_31,r_108_125_31,1.0,15,46,31,89
96,seq116,r_127_24_213,r_147_67_142,r_147_67_142,0.81,73,215,142,89
29,r_71_123_25,r_129_42_184,r_128_85_153,r_128_85_153,0.37,32,185,153,89
49,r_69_50_112,r_115_136_204,seq65,r_115_136_204,0.95,-89,115,204,89
7,r_133_139_81,r_64_145_205,seq14,r_133_139_81,1.0,0,81,81,89
23,r_28_36_104,seq143,r_142_3_88,r_28_36_104,1.0,0,104,104,89
35,r_122_19_187,r_17_31_216,r_84_7_87,r_84_7_87,1.0,25,112,87,89
36,r_102_24_129,r_74_114_187,r_122_28_117,r_102_24_129,1.0,0,129,129,90
8,r_109_112_207,r_106_96_221,seq42,r_106_96_221,0.82,-14,207,221,90
83,seq66,r_4_22_216,r_35_143_166,r_35_143_166,0.93,51,217,166,90
37,r_140_62_86,r_92_20_6,seq101,r_140_62_86,1.0,0,86,86,90
21,r_107_129_239,seq2,r_135_45_146,r_135_45_146,1.0,93,239,146,90
43,r_126_130_21,r_95_85_177,r_90_10_30,r_126_130_21,0.99,6,27,21,90
1,r_71_83_164,r_44_64_183,seq128,r_71_83_164,0.87,0,164,164,90
5,r_79_63_90,r_138_111_131,seq94,r_79_63_90,1.0,0,90,90,90
46,r_35_143_166,r_147_117_228,seq66,r_35_143_166,1.0,0,166,166,90
42,r_136_81_96,seq84,seq42,r_136_81_96,1.0,1,97,96,90
45,r_27_46_112,r_5_116_233,seq84,r_27_46_112,0.91,0,112,112,90
19,r_37_40_69,seq55,seq17,r_37_40_69,1.0,0,69,69,90
95,seq146,seq97,r_122_28_117,r_122_28_117,1.0,48,165,117,90
31,r_47_14_88,r_122_28_117,r_87_70_40,r_47_14_88,1.0,1,89,88,90
41,r_5_116_233,seq94,r_135_45_146,r_5_116_233,0.31,0,233,233,90
3,r_122_28_117,r_29_26_116,seq55,r_122_28_117,0.99,-1,116,117,90
17,r_87_70_40,r_121_73_103,r_5_116_233,r_87_70_40,1.0,0,40,40,90
10,r_52_148_71,seq134,seq133,r_52_148_71,1.0,1,72,71,90
17,r_87_70_40,r_5_116_233,r_47_14_88,r_47_14_88,1.0,8,96,88,90
26,r_149_103_105,seq144,r_72_91_46,r_149_103_105,1.0,0,105,105,90
11,r_4_22_216,seq66,seq86,r_4_22_216,0.76,1,217,216,90
20,r_74_114_187,r_102_24_129,seq125,r_102_24_129,1.0,0,129,129,90
13,r_54_76_133,r_135_45_146,r_82_142_15,r_54_76_133,0.99,0,133,133,90
15,r_139_25_158,r_0_53_44,seq21,r_139_25_158,0.97,0,158,158,90
6,r_106_96_221,seq68,r_4_22_216,r_4_22_216,0.61,8,224,216,90
16,r_36_118_12,r_124_104_47,seq15,r_36_118_12,0.75,0,12,12,90
85,seq84,r_136_81_96,seq86,r_136_81_96,0.87,1,97,96,90
99,seq125,r_74_114_187,seq134,r_74_114_187,0.98,2,189,187,90
10,r_52_148_71,seq133,r_138_111_131,r_138_111_131,1.0,11,142,131,90
27,r_141_30_24,seq11,r_88_137_93,r_88_137_93,0.79,0,93,93,90
79,seq55,seq146,r_122_28_117,r_122_28_117,1.0,4,121,117,90
47,r_67_105_176,r_106_96_221,r_31_127_17,r_67_105_176,0.83,1,177,176,90
40,r_75_59_229,r_31_127_17,r_124_104_47,r_124_104_47,1.0,182,229,47,90
18,r_138_111_131,r_79_63_90,r_90_10_30,r_79_63_90,0.8,0,90,90,90
29,r_135_45_146,seq60,r_58_3_247,r_135_45_146,1.0,-1,145,146,90
34,r_120_108_92,seq119,r_95_85_177,r_95_85_177,0.95,1,178,177,90
25,r_92_20_6,r_140_62_86,r_82_142_15,r_140_62_86,0.94,0,86,86,90
88,seq94,r_5_116_233,r_139_25_158,r_139_25_158,0.92,31,189,158,90
58,seq12,r_88_137_93,r_29_26_116,r_29_26_116,0.96,0,116,116,90
70,seq134,r_52_148_71,seq125,r_52_148_71,1.0,1,72,71,90
65,seq21,seq128,r_139_25_158,r_139_25_158,1.0,1,159,158,90
20,r_74_114_187,seq125,seq32,r_74_114_187,1.0,2,189,187,90
68,seq33,seq66,r_115_57_225,r_115_57_225,0.99,11,236,225,90
32,r_44_64_183,r_106_96_221,r_82_142_15,r_106_96_221,0.57,-38,183,221,90
38,r_1_51_159,r_147_117_228,r_29_26_116,r_1_51_159,0.99,-1,158,159,90
85,seq84,seq86,r_27_46_112,r_27_46_112,0.88,12,124,112,90
34,r_120_108_92,seq101,seq119,r_120_108_92,0.99,1,93,92,90
60,seq15,r_122_28_117,seq50,r_122_28_117,0.7,-34,83,117,90
14,r_77_69_58,r_74_114_187,seq113,r_77_69_58,1.0,0,58,58,90
39,r_82_142_15,r_58_3_247,r_92_20_6,r_82_142_15,1.0,0,15,15,90
9,r_29_26_116,r_122_28_117,seq12,r_29_26_116,0.99,0,116,116,90
33,r_124_104_47,r_75_59_229,seq68,r_124_104_47,1.0,0,47,47,90
28,r_90_10_30,seq6,r_126_130_21,r_90_10_30,0.97,1,31,30,90
49,r_88_137_93,seq12,r_141_30_24,r_88_137_93,0.93,0,93,93,90
44,r_72_91_46,r_5_116_233,seq39,r_72_91_46,0.65,37,83,46,90
79,seq55,r_37_40_69,seq146,r_37_40_69,1.0,0,69,69,90
60,seq15,seq50,r_82_142_15,r_82_142_15,0.47,130,145,15,90
35,r_31_127_17,r_75_59_229,r_67_105_176,r_67_105_176,0.85,53,229,176,90
24,r_80_132_31,r_141_30_24,seq68,r_80_132_31,0.99,0,31,31,90
18,r_138_111_131,r_90_10_30,r_0_53_44,r_138_111_131,1.0,0,131,131,90
84,seq68,r_106_96_221,r_124_104_47,r_124_104_47,1.0,177,224,47,90
30,r_133_2_68,r_59_105_234,r_27_64_46,r_133_2_68,1.0,0,68,68,91
9,r_63_111_47,r_99_5_100,r_17_138_204,r_17_138_204,0.49,-6,198,204,91
8,r_130_57_239,seq147,r_42_94_139,r_42_94_139,0.93,101,240,139,91
53,seq6,r_99_5_100,seq103,r_99_5_100,1.0,4,104,100,91
54,seq7,r_59_105_234,r_73_48_25,r_73_48_25,0.92,209,234,25,91
37,r_146_143_61,seq14,r_46_112_13,r_146_143_61,1.0,0,61,61,91
23,r_26_54_89,r_55_88_56,seq103,r_55_88_56,0.96,-2,54,56,91
19,r_46_112_13,r_148_114_180,r_55_88_56,r_46_112_13,0.69,168,181,13,91
39,r_47_109_150,seq90,seq70,r_47_109_150,0.86,1,151,150,91
45,r_80_139_128,seq67,r_43_121_116,r_80_139_128,0.72,0,128,128,91
73,seq60,seq83,r_27_64_46,r_27_64_46,1.0,0,46,46,91
5,r_87_33_54,r_144_13_209,r_92_135_160,r_87_33_54,0.96,-2,52,54,91
41,r_98_119_85,seq52,r_75_107_161,r_75_107_161,0.63,-77,84,161,91
3,r_42_94_139,r_148_114_180,r_98_119_85,r_42_94_139,1.0,0,139,139,91
10,r_17_138_204,seq79,r_63_111_47,r_63_111_47,1.0,162,209,47,91
47,r_129_65_49,r_20_85_64,r_45_101_35,r_129_65_49,1.0,-2,47,49,91
4,r_41_16_91,seq28,seq120,r_41_16_91,1.0,1,92,91,91
0,r_75_107_161,r_50_3_84,r_98_119_85,r_75_107_161,0.56,-76,85,161,91
63,seq25,r_26_54_89,seq32,r_26_54_89,0.77,0,89,89,91
11,r_66_124_168,r_148_114_180,r_47_109_150,r_66_124_168,0.97,0,168,168,91
20,r_43_121_116,r_19_78_241,seq77,r_43_121_116,1.0,0,116,116,91
13,r_128_125_214,seq127,r_51_116_213,r_128_125_214,0.74,0,214,214,91
48,r_144_13_209,seq77,r_50_3_84,r_50_3_84,1.0,130,214,84,91
17,r_59_105_234,r_133_2_68,seq7,r_133_2_68,1.0,-17,51,68,91
70,seq136,r_102_71_58,r_22_36_23,r_22_36_23,1.0,-1,22,23,91
52,seq132,r_59_105_234,r_73_48_25,r_73_48_25,0.98,-1,24,25,91
6,r_20_85_64,r_113_76_6,seq30,r_20_85_64,0.91,-4,60,64,91
99,seq127,r_128_125_214,r_75_107_161,r_75_107_161,0.98,53,214,161,91
5,r_87_33_54,r_92_135_160,seq142,r_92_135_160,0.55,1,161,160,91
0,r_75_107_161,r_98_119_85,seq69,r_75_107_161,1.0,-1,160,161,91
27,r_50_3_84,r_75_107_161,seq24,r_50_3_84,1.0,1,85,84,91
2,r_39_56_174,r_19_78_241,seq123,r_39_56_174,0.42,1,175,174,91
41,r_98_119_85,r_75_107_161,r_137_149_111,r_75_107_161,0.88,0,161,161,91
18,r_51_116_213,seq37,r_128_125_214,r_51_116_213,0.75,0,213,213,91
24,r_49_38_101,seq29,seq62,r_49_38_101,1.0,0,101,101,91
25,r_99_5_100,seq6,r_63_111_47,r_63_111_47,1.0,30,77,47,91
19,r_46_112_13,r_98_119_85,r_148_114_180,r_46_112_13,0.61,-2,11,13,91
43,r_92_135_160,r_87_33_54,seq0,r_92_135_160,0.67,0,160,160,91
33,r_104_97_182,r_17_138_204,r_39_56_174,r_17_138_204,0.85,-7,197,204,91
91,seq91,r_1_58_131,r_55_88_56,r_55_88_56,0.98,-1,55,56,91
50,seq0,seq44,r_92_135_160,r_92_135_160,0.84,1,161,160,91
65,seq29,r_49_38_101,seq12,r_49_38_101,1.0,-7,94,101,91
42,r_148_114_180,r_42_94_139,r_46_112_13,r_46_112_13,0.99,-2,11,13,91
16,r_73_48_25,r_17_138_204,seq132,r_73_48_25,0.99,-2,23,25,91
42,r_148_114_180,r_46_112_13,seq67,r_148_114_180,0.95,1,181,180,91
29,r_40_95_45,r_41_16_91,seq90,r_41_16_91,0.67,-35,56,91,91
32,r_1_58_131,seq91,r_50_3_84,r_50_3_84,0.99,49,133,84,91
38,r_108_84_66,seq81,seq14,r_108_84_66,1.0,2,68,66,91
77,seq69,seq127,r_75_107_161,r_75_107_161,1.0,14,175,161,91
9,r_63_111_47,seq134,r_99_5_100,r_63_111_47,0.97,3,50,47,91
64,seq28,r_63_111_47,r_68_96_189,r_63_111_47,0.44,152,199,47,91
60,seq18,r_110_9_173,r_50_3_84,r_50_3_84,1.0,81,165,84,91
25,r_99_5_100,r_63_111_47,r_20_85_64,r_99_5_100,0.43,99,199,100,91
1,r_22_36_23,r_50_3_84,seq136,r_22_36_23,0.96,0,23,23,91
22,r_102_71_58,seq136,r_19_78_241,r_102_71_58,0.86,4,62,58,91
7,r_137_149_111,seq131,r_98_119_85,r_137_149_111,1.0,0,111,111,91
44,r_15_21_202,r_113_76_6,r_108_84_66,r_108_84_66,0.85,136,202,66,91
14,r_55_88_56,r_26_54_89,seq91,r_55_88_56,1.0,-2,54,56,91
17,r_59_105_234,seq7,r_23_115_4,r_23_115_4,0.71,230,234,4,91
36,r_45_101_35,r_42_94_139,seq131,r_45_101_35,0.95,0,35,35,91
82,seq77,r_144_13_209,r_43_121_116,r_43_121_116,1.0,96,212,116,91
35,r_4_35_149,seq91,seq100,r_4_35_149,0.44,2,151,149,91
43,r_92_135_160,seq142,r_87_33_54,r_87_33_54,0.49,-2,52,54,91
36,r_40_149_185,seq27,r_5_117_35,r_40_149_185,0.97,0,185,185,92
23,r_129_120_134,r_91_134_99,r_83_37_27,r_83_37_27,0.95,1,28,27,92
43,r_148_87_87,seq115,seq9,r_148_87_87,1.0,0,87,87,92
0,r_83_37_27,r_147_22_226,seq1,r_83_37_27,1.0,0,27,27,92
55,seq6,r_74_99_183,r_25_35_126,r_74_99_183,0.92,0,183,183,92
16,r_20_92_219,seq28,r_42_72_91,r_42_72_91,0.99,128,219,91,92
39,r_86_12_65,seq46,r_96_10_50,r_86_12_65,1.0,0,65,65,92
1,r_104_16_72,seq15,seq84,r_104_16_72,1.0,0,72,72,92
18,r_34_145_144,seq1,r_125_8_108,r_34_145_144,1.0,1,145,144,92
7,r_26_111_122,seq1,r_2_53_187,r_2_53_187,1.0,13,200,187,92
86,seq82,r_79_109_115,r_5_117_35,r_79_109_115,0.84,31,146,115,92
45,r_18_113_123,seq56,seq23,r_18_113_123,1.0,0,123,123,92
41,r_124_63_25,r_143_13_208,seq140,r_124_63_25,1.0,0,25,25,92
24,r_89_116_127,r_143_13_208,r_106_67_195,r_143_13_208,0.92,-12,196,208,92
78,seq56,seq36,r_52_19_32,r_52_19_32,1.0,0,32,32,92
5,r_103_127_75,seq138,r_102_48_235,r_103_127_75,0.47,-38,37,75,92
34,r_95_85_56,r_141_60_8,seq69,r_95_85_56,0.93,0,56,56,92
10,r_79_109_115,r_26_111_122,r_143_13_208,r_79_109_115,0.87,6,121,115,92
26,r_57_0_81,r_137_144_203,r_104_16_72,r_57_0_81,0.69,16,97,81,92
14,r_29_90_216,r_20_92_219,r_18_113_123,r_18_113_123,1.0,93,216,123,92
73,seq38,r_42_72_91,r_147_22_226,r_42_72_91,1.0,-14,77,91,92
20,r_130_97_152,seq115,seq123,r_130_97_152,1.0,0,152,152,92
13,r_41_51_63,r_131_7_193,seq88,r_41_51_63,1.0,-3,60,63,92
8,r_101_76_34,r_74_99_183,seq122,r_101_76_34,0.96,0,34,34,92
15,r_102_48_235,r_103_127_75,r_26_111_122,r_26_111_122,1.0,113,235,122,92
48,r_73_45_130,seq133,seq33,r_73_45_130,1.0,0,130,130,92
37,r_141_60_8,r_95_85_56,seq77,r_95_85_56,1.0,-1,55,56,92
12,r_143_13_208,seq14,r_141_60_8,r_143_13_208,0.73,0,208,208,92
6,r_21_142_166,seq98,r_130_97_152,r_21_142_166,0.96,0,166,166,92
12,r_143_13_208,r_124_63_25,seq14,r_124_63_25,1.0,1,26,25,92
5,r_103_127_75,r_102_48_235,r_20_92_219,r_102_48_235,0.44,0,235,235,92
10,r_79_109_115,r_143_13_208,r_89_116_127,r_143_13_208,1.0,1,209,208,92
2,r_106_67_195,seq30,r_89_116_127,r_89_116_127,1.0,70,197,127,92
18,r_34_145_144,r_91_134_99,seq1,r_91_134_99,0.83,1,100,99,92
29,r_2_53_187,seq88,r_26_111_122,r_2_53_187,0.69,0,187,187,92
24,r_89_116_127,seq119,r_143_13_208,r_89_116_127,0.72,0,127,127,92
25,r_125_8_108,seq146,r_96_10_50,r_125_8_108,0.76,3,111,108,92
33,r_47_107_133,seq30,r_78_54_1,r_47_107_133,0.94,0,133,133,92
68,seq28,r_20_92_219,r_78_54_1,r_20_92_219,0.46,0,219,219,92
32,r_137_144_203,seq88,r_129_120_134,r_137_144_203,0.8,1,204,203,92
28,r_5_117_35,r_96_10_50,r_25_35_126,r_5_117_35,1.0,0,35,35,92
60,seq140,r_62_70_204,r_124_63_25,r_124_63_25,0.99,0,25,25,92
46,r_17_61_7,r_21_142_166,seq108,r_17_61_7,0.57,3,10,7,92
17,r_135_105_213,seq59,r_129_120_134,r_135_105_213,0.67,1,214,213,92
9,r_91_134_99,r_34_145_144,seq138,r_91_134_99,0.86,1,100,99,92
28,r_5_117_35,r_25_35_126,r_40_149_185,r_40_149_185,0.95,0,185,185,92
22,r_81_100_114,seq49,seq36,r_81_100_114,1.0,0,114,114,92
34,r_95_85_56,seq77,r_141_60_8,r_141_60_8,0.5,4,12,8,92
7,r_26_111_122,seq110,seq1,r_26_111_122,0.71,0,122,122,92
44,r_42_72_91,seq38,seq32,r_42_72_91,1.0,0,91,91,92
79,seq59,r_135_105_213,seq39,r_135_105_213,0.99,1,214,213,92
35,r_121_66_223,r_64_93_221,r_79_109_115,r_121_66_223,0.33,0,223,223,92
97,seq122,r_62_70_204,r_101_76_34,r_101_76_34,0.87,0,34,34,92
23,r_129_120_134,r_83_37_27,seq140,r_129_120_134,1.0,1,135,134,92
93,seq110,seq130,r_149_139_69,r_149_139_69,1.0,6,75,69,93
30,r_85_133_127,r_49_15_198,r_42_27_248,r_85_133_127,0.84,0,127,127,93
14,r_10_114_171,seq53,r_60_21_87,r_10_114_171,0.97,0,171,171,93
8,r_116_54_189,seq130,r_51_23_65,r_116_54_189,0.56,0,189,189,93
99,seq121,r_60_21_87,r_138_67_14,r_138_67_14,1.0,10,24,14,93
43,r_0_24_213,r_49_15_198,r_43_122_117,r_43_122_117,0.95,18,135,117,93
31,r_45_86_35,r_4_90_49,seq146,r_45_86_35,0.93,0,35,35,93
19,r_38_113_79,r_18_144_158,seq118,r_18_144_158,1.0,0,158,158,93
16,r_136_104_105,r_49_15_198,seq3,r_136_104_105,1.0,0,105,105,93
5,r_52_123_201,seq146,r_61_72_112,r_61_72_112,0.94,89,201,112,93
19,r_38_113_79,r_62_44_220,r_18_144_158,r_38_113_79,0.97,0,79,79,93
33,r_18_144_158,r_38_113_79,r_76_91_142,r_38_113_79,1.0,79,158,79,93
28,r_26_93_44,r_52_123_201,seq102,r_26_93_44,1.0,0,44,44,93
76,seq70,seq142,r_89_35_122,r_89_35_122,1.0,4,126,122,93
41,r_149_139_69,seq41,seq110,r_149_139_69,1.0,0,69,69,93
67,seq34,r_129_50_72,r_85_133_127,r_129_50_72,1.0,1,73,72,93
38,r_76_91_142,r_47_137_203,seq88,r_76_91_142,1.0,0,142,142,93
89,seq99,r_89_35_122,r_103_135_177,r_89_35_122,0.96,-23,99,122,93
3,r_5_108_120,seq3,seq28,r_5_108_120,0.98,0,120,120,93
10,r_61_72_112,seq39,r_57_17_55,r_61_72_112,0.91,0,112,112,93
80,seq78,r_111_79_209,r_13_120_13,r_13_120_13,0.96,6,19,13,93
26,r_75_16_149,seq115,r_60_21_87,r_75_16_149,0.96,0,149,149,93
72,seq53,r_10_114_171,seq132,r_10_114_171,0.59,-6,165,171,93
63,seq28,r_46_12_162,r_5_108_120,r_5_108_120,0.94,12,132,120,93
11,r_92_32_126,seq112,seq99,r_92_32_126,1.0,0,126,126,93
6,r_13_120_13,r_46_12_162,seq78,r_13_120_13,0.87,1,14,13,93
20,r_49_15_198,r_85_133_127,r_0_24_213,r_85_133_127,0.63,-13,114,127,93
13,r_43_122_117,r_84_19_144,seq34,r_43_122_117,0.61,2,119,117,93
48,r_46_12_162,seq28,seq142,r_46_12_162,0.71,4,166,162,93
21,r_83_148_28,seq140,seq128,r_83_148_28,0.98,0,28,28,93
27,r_8_22_141,seq29,seq73,r_8_22_141,0.99,0,141,141,93
51,seq1,seq134,r_125_109_98,r_125_109_98,1.0,9,107,98,93
22,r_62_44_220,r_101_131_12,r_92_32_126,r_62_44_220,0.87,0,220,220,93
2,r_47_137_203,seq39,seq71,r_47_137_203,0.72,0,203,203,93
47,r_96_58_194,r_69_68_133,r_48_74_111,r_96_58_194,0.9,0,194,194,93
40,r_55_20_26,r_5_108_120,seq134,r_55_20_26,0.78,0,26,26,93
18,r_125_109_98,r_92_32_126,r_149_139_69,r_125_109_98,0.99,0,98,98,93
29,r_48_74_111,seq3,r_45_86_35,r_48_74_111,1.0,2,113,111,93
25,r_129_50_72,seq34,r_57_17_55,r_129_50_72,0.99,0,72,72,93
43,r_0_24_213,r_43_122_117,seq56,r_0_24_213,0.85,1,214,213,93
33,r_18_144_158,r_76_91_142,r_38_113_79,r_38_113_79,1.0,15,94,79,93
34,r_138_67_14,r_5_108_120,seq121,r_138_67_14,0.95,0,14,14,93
50,seq128,r_143_11_236,r_83_148_28,r_83_148_28,1.0,208,236,28,93
58,seq130,r_116_54_189,r_125_109_98,r_125_109_98,0.96,91,189,98,93
6,r_13_120_13,seq78,r_4_90_49,r_4_90_49,1.0,76,125,49,93
36,r_4_90_49,seq119,r_13_120_13,r_4_90_49,1.0,1,50,49,93
20,r_49_15_198,r_0_24_213,r_96_58_194,r_96_58_194,0.91,4,198,194,93
32,r_42_27_248,r_62_44_220,r_85_133_127,r_85_133_127,0.92,10,137,127,93
38,r_76_91_142,r_18_144_158,r_47_137_203,r_47_137_203,0.42,-109,94,203,93
39,r_101_131_12,r_84_19_144,seq105,r_101_131_12,0.98,1,13,12,93
17,r_127_65_56,seq70,seq37,r_127_65_56,1.0,2,58,56,93
46,r_57_17_55,r_48_74_111,seq119,r_57_17_55,0.99,0,55,55,93
31,r_45_86_35,seq146,r_48_74_111,r_48_74_111,1.0,9,120,111,93
22,r_62_44_220,r_38_113_79,r_101_131_12,r_38_113_79,1.0,0,79,79,93
49,r_103_135_177,seq25,r_126_124_228,r_103_135_177,0.98,0,177,177,93
72,seq53,seq132,r_6_106_184,r_6_106_184,0.96,7,191,184,93
55,seq134,seq77,r_55_20_26,r_55_20_26,1.0,6,32,26,93
23,r_6_106_184,seq63,seq53,r_6_106_184,0.81,0,184,184,93
42,r_66_107_59,r_76_91_142,seq110,r_66_107_59,1.0,0,59,59,93
35,r_89_35_122,seq99,seq70,r_89_35_122,0.98,1,123,122,93
36,r_74_135_216,seq91,seq118,r_74_135_216,0.59,0,216,216,94
22,r_82_128_39,r_4_68_37,r_41_92_30,r_41_92_30,0.93,9,39,30,94
32,r_45_17_10,seq37,seq48,r_45_17_10,0.93,0,10,10,94
83,seq61,seq3,r_116_97_191,r_116_97_191,0.49,-99,92,191,94
37,r_103_84_207,seq123,r_6_80_156,r_6_80_156,0.85,1,157,156,94
39,r_35_107_131,seq2,seq130,r_35_107_131,1.0,-1,130,131,94
46,r_125_144_109,r_31_36_138,seq141,r_125_144_109,0.99,0,109,109,94
42,r_119_99_221,seq12,r_70_121_83,r_70_121_83,1.0,8,91,83,94
92,seq91,r_74_135_216,r_30_101_20,r_30_101_20,1.0,0,20,20,94
15,r_114_117_42,seq1,seq23,r_114_117_42,1.0,0,42,42,94
19,r_10_96_137,r_70_121_83,r_133_8_47,r_70_121_83,0.78,0,83,83,94
33,r_133_8_47,r_10_96_137,seq49,r_10_96_137,1.0,0,137,137,94
16,r_81_64_38,seq56,seq14,r_81_64_38,1.0,0,38,38,94
6,r_131_53_31,r_109_55_66,seq48,r_109_55_66,1.0,-32,34,66,94
31,r_95_115_140,r_24_139_98,r_63_137_141,r_24_139_98,0.85,-1,97,98,94
67,seq21,r_110_29_210,r_98_32_73,r_98_32_73,1.0,137,210,73,94
3,r_143_79_122,r_113_122_55,r_63_137_141,r_63_137_141,1.0,7,148,141,94
90,seq141,r_110_29_210,r_125_144_109,r_125_144_109,1.0,13,122,109,94
0,r_41_92_30,r_35_107_131,seq138,r_41_92_30,0.91,0,30,30,94
26,r_60_38_62,r_78_16_151,r_131_53_31,r_60_38_62,0.99,0,62,62,94
4,r_77_111_187,seq71,seq56,r_77_111_187,0.96,0,187,187,94
11,r_110_29_210,seq21,r_10_96_137,r_110_29_210,0.8,0,210,210,94
20,r_34_18_87,seq91,r_88_148_58,r_34_18_87,1.0,-6,81,87,94
62,seq14,r_25_44_245,r_81_64_38,r_81_64_38,1.0,2,40,38,94
48,r_120_87_107,seq37,r_95_115_140,r_120_87_107,0.39,-44,63,107,94
17,r_40_54_32,seq124,r_62_39_200,r_40_54_32,1.0,1,33,32,94
33,r_133_8_47,seq138,r_10_96_137,r_133_8_47,0.79,3,50,47,94
2,r_62_39_200,r_40_54_32,r_50_140_225,r_62_39_200,0.88,0,200,200,94
27,r_127_106_171,seq129,seq146,r_127_106_171,0.68,0,171,171,94
2,r_62_39_200,r_83_65_130,r_40_54_32,r_62_39_200,0.97,-70,130,200,94
47,r_98_32_73,seq91,seq21,r_98_32_73,1.0,1,74,73,94
18,r_70_121_83,r_10_96_137,r_119_99_221,r_119_99_221,0.49,-138,83,221,94
24,r_31_36_138,seq129,r_81_64_38,r_31_36_138,0.93,1,139,138,94
21,r_109_55_66,r_104_85_217,seq26,r_109_55_66,1.0,1,67,66,94
34,r_88_148_58,seq136,seq69,r_88_148_58,1.0,0,58,58,94
25,r_50_140_225,r_4_68_37,r_94_22_84,r_94_22_84,0.94,16,100,84,94
48,r_120_87_107,seq118,r_6_80_156,r_6_80_156,1.0,11,167,156,94
19,r_10_96_137,r_133_8_47,r_109_55_66,r_10_96_137,1.0,0,137,137,94
42,r_119_99_221,r_70_121_83,r_133_8_47,r_119_99_221,0.79,0,221,221,94
33,r_133_8_47,seq49,r_119_99_221,r_119_99_221,0.99,1,222,221,94
60,seq12,r_15_73_182,r_66_100_222,r_15_73_182,1.0,6,188,182,94
21,r_109_55_66,r_131_53_31,r_104_85_217,r_109_55_66,0.65,-32,34,66,94
28,r_78_16_151,seq23,r_50_140_225,r_78_16_151,0.63,1,152,151,94
91,seq89,r_63_137_141,r_133_8_47,r_63_137_141,0.63,0,141,141,94
49,r_6_80_156,seq3,r_120_87_107,r_6_80_156,0.72,0,156,156,94
7,r_63_137_141,seq89,r_143_79_122,r_63_137_141,1.0,0,141,141,94
18,r_70_121_83,r_119_99_221,r_103_84_207,r_70_121_83,0.84,138,221,83,94
23,r_94_22_84,seq89,r_50_140_225,r_94_22_84,0.98,8,92,84,94
17,r_40_54_32,r_62_39_200,r_66_100_222,r_62_39_200,1.0,-6,194,200,94
35,r_0_90_85,seq5,seq20,r_0_90_85,0.99,2,87,85,94
37,r_103_84_207,r_6_80_156,r_70_121_83,r_103_84_207,1.0,0,207,207,94
12,r_83_65_130,r_62_39_200,r_120_87_107,r_83_65_130,1.0,0,130,130,94
29,r_57_126_15,r_86_7_246,seq71,r_57_126_15,1.0,0,15,15,94
30,r_58_134_28,seq14,r_50_140_225,r_58_134_28,1.0,0,28,28,94
30,r_111_34_215,seq4,r_1_63_44,r_1_63_44,1.0,170,214,44,95
44,r_77_15_234,r_46_49_56,r_110_99_16,r_77_15_234,0.63,-8,226,234,95
64,seq20,seq89,r_8_75_54,r_8_75_54,1.0,2,56,54,95
14,r_109_148_225,r_35_73_45,seq96,r_35_73_45,0.86,36,81,45,95
8,r_132_13_199,seq67,seq37,r_132_13_199,0.65,2,201,199,95
91,seq108,seq40,r_59_92_160,r_59_92_160,0.95,4,164,160,95
83,seq78,seq6,r_23_66_83,r_23_66_83,1.0,-1,82,83,95
28,r_71_39_24,r_64_52_197,seq19,r_71_39_24,1.0,0,24,24,95
16,r_65_48_164,seq14,seq53,r_65_48_164,0.95,0,164,164,95
21,r_98_2_120,r_16_149_207,r_109_148_225,r_16_149_207,0.48,-82,125,207,95
39,r_139_123_110,r_131_122_149,r_70_81_84,r_139_123_110,0.65,14,124,110,95
33,r_142_22_18,r_41_51_184,r_77_15_234,r_142_22_18,0.93,2,20,18,95
5,r_61_36_159,seq19,r_85_145_124,r_61_36_159,1.0,0,159,159,95
19,r_85_145_124,seq55,seq119,r_85_145_124,0.71,8,132,124,95
31,r_59_92_160,r_147_47_3,seq108,r_59_92_160,0.96,0,160,160,95
41,r_23_66_83,seq14,seq78,r_23_66_83,1.0,0,83,83,95
3,r_3_118_98,r_95_104_200,seq134,r_3_118_98,1.0,-1,97,98,95
24,r_30_103_153,r_129_113_94,r_35_73_45,r_30_103_153,1.0,0,153,153,95
26,r_95_104_200,seq121,r_41_51_184,r_95_104_200,0.89,0,200,200,95
73,seq50,seq24,r_46_49_56,r_46_49_56,1.0,70,126,56,95
11,r_143_33_72,seq4,seq90,r_143_33_72,1.0,0,72,72,95
2,r_46_49_56,r_143_33_72,r_142_22_18,r_46_49_56,1.0,0,56,56,95
68,seq37,r_102_120_49,r_44_88_126,r_102_120_49,0.99,-2,47,49,95
13,r_100_17_138,r_139_123_110,r_41_51_184,r_100_17_138,1.0,0,138,138,95
98,seq126,seq14,r_8_75_54,r_8_75_54,1.0,81,135,54,95
15,r_117_42_227,seq119,r_44_88_126,r_117_42_227,0.5,2,229,227,95
4,r_44_88_126,seq37,seq6,r_44_88_126,0.66,3,129,126,95
6,r_74_87_135,seq6,r_83_105_31,r_83_105_31,0.87,112,143,31,95
21,r_98_2_120,r_109_148_225,seq96,r_98_2_120,0.7,106,226,120,95
68,seq37,seq40,r_132_13_199,r_132_13_199,1.0,0,199,199,95
9,r_1_63_44,r_70_81_84,seq144,r_1_63_44,1.0,1,45,44,95
10,r_8_75_54,seq37,seq20,r_8_75_54,1.0,0,54,54,95
87,seq90,r_64_52_197,r_143_33_72,r_143_33_72,1.0,100,172,72,95
4,r_44_88_126,seq45,seq37,r_44_88_126,0.43,-76,50,126,95
91,seq108,r_83_105_31,seq40,r_83_105_31,0.35,95,126,31,95
1,r_102_120_49,r_8_75_54,seq140,r_102_120_49,1.0,0,49,49,95
40,r_115_31_118,seq80,seq133,r_115_31_118,0.7,6,124,118,95
14,r_109_148_225,seq96,r_98_2_120,r_98_2_120,0.44,10,130,120,95
74,seq53,seq80,r_65_48_164,r_65_48_164,0.98,6,170,164,95
18,r_64_52_197,seq90,r_79_94_157,r_64_52_197,0.82,0,197,197,95
29,r_70_81_84,seq96,seq128,r_70_81_84,1.0,0,84,84,95
24,r_30_103_153,r_59_92_160,r_129_113_94,r_129_113_94,0.7,11,105,94,95
46,r_83_105_31,seq24,seq121,r_83_105_31,1.0,0,31,31,95
88,seq96,r_70_81_84,seq112,r_70_81_84,1.0,0,84,84,95
50,seq128,r_131_122_149,r_70_81_84,r_70_81_84,0.58,37,121,84,95
14,r_109_148_225,r_98_2_120,r_1_63_44,r_109_148_225,0.54,0,225,225,95
25,r_97_106_50,r_95_104_200,seq116,r_97_106_50,0.94,8,58,50,95
61,seq14,r_23_66_83,r_82_27_26,r_23_66_83,0.49,0,83,83,95
38,r_138_76_101,seq136,seq55,r_138_76_101,1.0,0,101,101,95
77,seq58,r_32_21_167,r_8_75_54,r_8_75_54,0.96,113,167,54,95
68,seq37,r_44_88_126,seq40,r_44_88_126,0.57,6,132,126,95
75,seq55,r_85_145_124,r_138_76_101,r_138_76_101,1.0,9,110,101,95
48,r_60_72_23,r_117_42_227,seq6,r_60_72_23,1.0,0,23,23,95
17,r_0_56_128,seq107,r_143_33_72,r_0_56_128,0.89,0,128,128,95
37,r_110_99_16,r_0_56_128,r_124_146_150,r_110_99_16,0.65,-4,12,16,95
47,r_35_73_45,r_109_148_225,seq5,r_35_73_45,0.94,4,49,45,95
91,seq108,seq78,r_83_105_31,r_83_105_31,0.77,27,58,31,95
22,r_32_21_167,seq58,r_41_51_184,r_32_21_167,0.9,0,167,167,95
49,r_79_94_157,seq119,seq141,r_79_94_157,0.64,9,166,157,95
44,r_77_15_234,seq24,r_46_49_56,r_46_49_56,1.0,70,126,56,95
23,r_16_149_207,seq69,r_82_27_26,r_82_27_26,0.56,181,207,26,95
33,r_142_22_18,r_77_15_234,r_46_49_56,r_46_49_56,1.0,2,58,56,95
32,r_129_113_94,r_30_103_153,r_147_47_3,r_30_103_153,1.0,-4,149,153,95
79,seq67,r_132_13_199,seq134,r_132_13_199,0.68,2,201,199,95
35,r_131_122_149,seq128,r_46_49_56,r_131_122_149,0.94,0,149,149,95
93,seq103,r_125_24_219,r_102_104_65,r_102_104_65,0.94,12,77,65,96
30,r_46_50_61,r_110_108_224,seq148,r_46_50_61,0.99,1,62,61,96
36,r_105_59_157,r_14_16_84,r_145_49_214,r_14_16_84,1.0,0,84,84,96
22,r_57_100_27,r_23_29_237,r_40_36_174,r_57_100_27,0.92,0,27,27,96
69,seq43,seq25,r_33_28_49,r_33_28_49,1.0,2,51,49,96
46,r_11_75_125,r_67_132_20,r_83_42_2,r_11_75_125,1.0,0,125,125,96
14,r_146_1_205,r_143_38_233,seq52,r_143_38_233,0.57,-28,205,233,96
48,r_55_44_29,seq18,seq43,r_55_44_29,1.0,1,30,29,96
1,r_120_47_46,r_118_94_236,seq26,r_120_47_46,0.98,4,50,46,96
19,r_145_49_214,seq128,r_83_42_2,r_83_42_2,0.73,213,215,2,96
16,r_65_92_116,seq128,r_27_91_102,r_65_92_116,0.77,0,116,116,96
39,r_98_7_189,r_145_49_214,seq74,r_98_7_189,0.59,1,190,189,96
5,r_118_94_236,seq39,r_105_59_157,r_118_94_236,0.21,3,239,236,96
46,r_11_75_125,seq20,r_67_132_20,r_11_75_125,0.35,-46,79,125,96
41,r_27_91_102,r_40_36_174,r_65_92_116,r_40_36_174,0.56,-40,134,174,96
19,r_145_49_214,r_82_3_113,seq128,r_82_3_113,1.0,0,113,113,96
27,r_71_95_72,r_146_1_205,r_57_100_27,r_146_1_205,0.93,0,205,205,96
95,seq113,seq48,r_142_4_78,r_142_4_78,1.0,20,98,78,96
31,r_149_5_121,r_72_45_162,r_67_132_20,r_149_5_121,1.0,0,121,121,96
41,r_27_91_102,seq8,r_40_36_174,r_27_91_102,0.75,0,102,102,96
3,r_85_130_139,seq8,seq31,r_85_130_139,0.99,0,139,139,96
90,seq96,r_66_73_120,seq128,r_66_73_120,1.0,-1,119,120,96
8,r_68_126_35,r_21_109_99,seq81,r_21_109_99,0.74,108,207,99,96
72,seq52,seq8,r_116_86_56,r_116_86_56,1.0,22,78,56,96
4,r_9_2_137,seq76,seq20,r_9_2_137,1.0,1,138,137,96
26,r_10_140_34,r_120_47_46,seq41,r_10_140_34,1.0,1,35,34,96
11,r_125_24_219,seq138,r_46_50_61,r_46_50_61,0.96,160,221,61,96
20,r_23_29_237,r_72_45_162,r_134_17_124,r_23_29_237,0.84,-74,163,237,96
98,seq148,r_12_99_246,r_46_50_61,r_46_50_61,1.0,24,85,61,96
10,r_116_86_56,r_21_109_99,seq52,r_116_86_56,0.96,0,56,56,96
6,r_15_136_115,seq133,seq31,r_15_136_115,0.9,0,115,115,96
62,seq20,r_93_69_74,r_67_132_20,r_93_69_74,0.99,3,77,74,96
36,r_105_59_157,r_145_49_214,seq8,r_105_59_157,0.96,0,157,157,96
8,r_68_126_35,seq97,r_21_109_99,r_68_126_35,1.0,0,35,35,96
27,r_71_95_72,r_65_92_116,r_146_1_205,r_71_95_72,0.72,0,72,72,96
22,r_57_100_27,r_40_36_174,r_71_95_72,r_57_100_27,0.68,147,174,27,96
37,r_33_28_49,r_121_122_170,r_55_44_29,r_33_28_49,1.0,0,49,49,96
2,r_134_17_124,seq79,r_23_29_237,r_134_17_124,0.92,-1,123,124,96
47,r_37_114_60,r_93_69_74,seq39,r_37_114_60,1.0,1,61,60,96
40,r_110_108_224,r_46_50_61,seq88,r_46_50_61,0.65,5,66,61,96
18,r_102_104_65,seq97,r_117_87_28,r_102_104_65,0.99,1,66,65,96
29,r_143_38_233,r_146_1_205,seq80,r_146_1_205,1.0,0,205,205,96
24,r_89_123_127,seq139,r_12_99_246,r_89_123_127,1.0,0,127,127,96
34,r_12_99_246,r_72_45_162,r_89_123_127,r_89_123_127,0.72,18,145,127,96
25,r_93_69_74,seq20,seq52,r_93_69_74,1.0,0,74,74,96
34,r_12_99_246,r_63_107_51,r_72_45_162,r_63_107_51,0.98,0,51,51,96
43,r_67_132_20,r_11_75_125,r_149_5_121,r_67_132_20,0.97,102,122,20,96
33,r_30_124_138,seq35,r_121_122_170,r_30_124_138,0.99,0,138,138,96
58,seq139,r_89_123_127,seq133,r_89_123_127,1.0,0,127,127,96
32,r_82_3_113,r_145_49_214,seq127,r_82_3_113,1.0,0,113,113,96
38,r_40_36_174,r_146_1_205,seq138,r_40_36_174,0.68,0,174,174,96
29,r_143_38_233,seq80,seq135,r_143_38_233,0.74,0,233,233,96
21,r_63_107_51,r_12_99_246,seq90,r_63_107_51,0.97,0,51,51,96
9,r_66_73_120,seq96,seq35,r_66_73_120,0.99,0,120,120,96
62,seq20,r_67_132_20,r_9_2_137,r_9_2_137,1.0,0,137,137,96
28,r_137_147_235,seq70,r_82_3_113,r_82_3_113,0.73,126,239,113,96
91,seq97,r_102_104_65,seq129,r_102_104_65,0.74,1,66,65,96
7,r_72_45_162,r_23_29_237,seq52,r_72_45_162,0.67,1,163,162,96
44,r_142_4_78,r_40_36_174,seq113,r_142_4_78,1.0,0,78,78,96
13,r_117_87_28,r_146_1_205,seq103,r_117_87_28,0.68,0,28,28,96
23,r_144_112_172,seq84,r_121_122_170,r_144_112_172,0.98,0,172,172,96
79,seq70,r_137_147_235,r_34_0_15,r_34_0_15,0.76,224,239,15,96
42,r_34_0_15,r_9_2_137,seq39,r_34_0_15,0.98,-3,12,15,96
43,r_67_132_20,r_125_24_219,r_11_75_125,r_67_132_20,0.69,8,28,20,96
12,r_14_16_84,r_105_59_157,seq97,r_14_16_84,1.0,0,84,84,96
68,seq41,r_121_122_170,r_10_140_34,r_10_140_34,1.0,4,38,34,96
84,seq79,r_134_17_124,r_83_42_2,r_134_17_124,0.96,-1,123,124,96
51,seq1,r_104_83_212,seq140,r_104_83_212,0.51,6,218,212,97
36,r_6_123_170,seq43,r_92_36_96,r_6_123_170,0.93,4,174,170,97
9,r_79_101_45,r_18_60_183,r_51_129_117,r_51_129_117,1.0,73,190,117,97
8,r_22_111_127,r_61_10_151,seq64,r_22_111_127,1.0,0,127,127,97
37,r_32_82_111,seq25,seq56,r_32_82_111,1.0,0,111,111,97
59,seq142,r_38_88_64,seq19,r_38_88_64,1.0,0,64,64,97
86,seq95,r_107_130_222,seq41,r_107_130_222,0.69,0,222,222,97
39,r_26_39_84,seq64,seq25,r_26_39_84,1.0,-1,83,84,97
4,r_31_37_47,r_71_87_119,seq73,r_31_37_47,0.98,1,48,47,97
5,r_18_60_183,seq59,r_79_101_45,r_79_101_45,1.0,50,95,45,97
46,r_71_87_119,r_2_115_130,seq41,r_2_115_130,0.86,-11,119,130,97
42,r_61_10_151,seq144,r_51_129_117,r_51_129_117,1.0,41,158,117,97
80,seq75,r_105_53_198,r_77_7_145,r_105_53_198,0.63,0,198,198,97
45,r_77_7_145,seq4,seq75,r_77_7_145,0.53,17,162,145,97
38,r_65_146_53,r_125_128_201,seq73,r_65_146_53,0.99,1,54,53,97
66,seq25,seq17,r_26_39_84,r_26_39_84,1.0,2,86,84,97
6,r_14_30_223,r_85_34_106,r_69_145_12,r_85_34_106,0.57,-72,34,106,97
31,r_90_72_210,seq59,seq96,r_90_72_210,0.48,0,210,210,97
41,r_105_53_198,seq75,r_108_20_35,r_105_53_198,0.8,0,198,198,97
26,r_69_145_12,r_92_36_96,r_14_30_223,r_14_30_223,0.49,-120,103,223,97
11,r_57_149_46,r_127_24_1,r_109_135_34,r_57_149_46,0.77,2,48,46,97
0,r_122_132_103,r_2_115_130,seq131,r_122_132_103,1.0,0,103,103,97
20,r_113_16_216,r_80_46_134,r_49_47_31,r_113_16_216,0.38,2,218,216,97
98,seq124,r_125_128_201,r_6_123_170,r_6_123_170,0.67,31,201,170,97
30,r_63_93_10,r_109_135_34,seq114,r_63_93_10,0.59,0,10,10,97
15,r_85_34_106,r_14_30_223,seq43,r_85_34_106,1.0,0,106,106,97
17,r_141_148_52,r_127_24_1,seq0,r_141_148_52,1.0,0,52,52,97
57,seq12,r_55_42_4,r_77_7_145,r_55_42_4,0.59,194,198,4,97
99,seq126,r_68_40_208,r_125_128_201,r_68_40_208,0.53,-6,202,208,97
5,r_18_60_183,r_79_101_45,r_141_148_52,r_141_148_52,0.96,138,190,52,97
9,r_79_101_45,seq15,r_18_60_183,r_79_101_45,1.0,0,45,45,97
2,r_38_88_64,seq142,seq73,r_38_88_64,1.0,0,64,64,97
40,r_51_129_117,r_6_123_170,seq59,r_51_129_117,1.0,0,117,117,97
18,r_54_81_177,seq94,seq75,r_54_81_177,0.71,5,182,177,97
29,r_2_115_130,r_80_46_134,seq78,r_2_115_130,0.97,0,130,130,97
24,r_9_143_126,r_54_81_177,r_62_103_72,r_9_143_126,0.94,2,128,126,97
77,seq64,r_104_83_212,r_22_111_127,r_22_111_127,0.98,3,130,127,97
70,seq43,r_6_123_170,r_85_34_106,r_85_34_106,0.86,29,135,106,97
6,r_14_30_223,r_69_145_12,r_79_101_45,r_79_101_45,0.68,178,223,45,97
68,seq140,seq142,r_22_111_127,r_22_111_127,1.0,16,143,127,97
32,r_84_70_171,seq131,seq67,r_84_70_171,0.97,1,172,171,97
77,seq64,r_26_39_84,r_104_83_212,r_26_39_84,0.98,-2,82,84,97
1,r_49_47_31,r_26_39_84,seq43,r_26_39_84,0.85,-56,28,84,97
10,r_109_135_34,r_147_119_150,r_57_149_46,r_109_135_34,0.98,1,35,34,97
26,r_69_145_12,r_14_30_223,r_84_70_171,r_84_70_171,0.81,53,224,171,97
96,seq120,r_107_130_222,seq41,r_107_130_222,0.96,0,222,222,97
49,r_35_8_8,r_68_40_208,seq126,r_68_40_208,0.73,0,208,208,97
7,r_68_40_208,r_35_8_8,r_55_42_4,r_35_8_8,0.68,200,208,8,97
44,r_66_102_122,r_77_7_145,seq73,r_66_102_122,0.89,0,122,122,97
23,r_29_133_138,seq52,seq97,r_29_133_138,0.89,0,138,138,97
3,r_3_86_25,seq64,seq45,r_3_86_25,0.96,0,25,25,97
19,r_108_20_35,r_48_134_243,seq73,r_108_20_35,0.66,2,37,35,97
35,r_98_58_85,seq75,seq59,r_98_58_85,0.99,0,85,85,97
36,r_115_29_164,r_103_27_234,seq25,r_115_29_164,0.98,0,164,164,98
9,r_128_92_173,r_35_14_17,seq6,r_128_92_173,0.94,0,173,173,98
2,r_52_121_62,r_81_94_115,r_113_144_113,r_81_94_115,0.71,2,117,115,98
0,r_87_49_55,seq82,r_18_132_25,r_87_49_55,1.0,0,55,55,98
14,r_100_11_69,seq13,seq46,r_100_11_69,1.0,3,72,69,98
53,seq8,r_95_37_194,seq28,r_95_37_194,0.82,1,195,194,98
58,seq142,seq138,r_43_86_188,r_43_86_188,1.0,11,199,188,98
43,r_16_36_172,seq3,r_126_136_107,r_126_136_107,1.0,84,191,107,98
83,seq73,r_43_86_188,seq72,r_43_86_188,0.84,0,188,188,98
37,r_103_27_234,r_115_29_164,seq30,r_115_29_164,0.99,0,164,164,98
3,r_143_112_211,r_103_27_234,r_116_47_156,r_143_112_211,0.73,-6,205,211,98
19,r_83_105_212,seq90,r_111_75_98,r_83_105_212,0.66,0,212,212,98
55,seq138,r_33_97_144,r_116_47_156,r_116_47_156,0.64,7,163,156,98
39,r_126_136_107,r_89_23_19,r_69_5_112,r_126_136_107,0.97,1,108,107,98
1,r_22_80_73,r_7_62_149,r_126_136_107,r_22_80_73,0.88,76,149,73,98
1,r_22_80_73,seq72,r_7_62_149,r_22_80_73,1.0,0,73,73,98
5,r_69_5_112,r_10_102_240,r_126_136_107,r_69_5_112,0.7,0,112,112,98
42,r_2_123_122,r_71_106_163,r_87_49_55,r_87_49_55,1.0,79,134,55,98
87,seq82,r_87_49_55,r_9_77_5,r_87_49_55,1.0,-4,51,55,98
32,r_45_135_223,seq48,r_145_26_193,r_145_26_193,0.6,2,195,193,98
3,r_143_112_211,r_56_40_23,r_103_27_234,r_56_40_23,1.0,1,24,23,98
45,r_148_119_100,r_139_68_99,seq25,r_148_119_100,0.67,1,101,100,98
9,r_128_92_173,r_87_49_55,r_35_14_17,r_128_92_173,0.98,-156,17,173,98
19,r_83_105_212,r_115_29_164,seq90,r_115_29_164,1.0,-33,131,164,98
65,seq25,r_148_119_100,r_115_29_164,r_115_29_164,1.0,37,201,164,98
34,r_81_94_115,r_52_121_62,seq99,r_81_94_115,1.0,0,115,115,98
41,r_61_55_116,seq142,seq50,r_61_55_116,1.0,0,116,116,98
34,r_81_94_115,r_45_135_223,r_52_121_62,r_52_121_62,0.64,2,64,62,98
10,r_89_23_19,seq64,r_56_40_23,r_56_40_23,1.0,61,84,23,98
26,r_113_144_113,r_45_135_223,r_52_121_62,r_52_121_62,0.76,52,114,62,98
6,r_35_14_17,r_95_37_194,r_128_92_173,r_35_14_17,1.0,0,17,17,98
63,seq20,seq63,r_111_75_98,r_111_75_98,1.0,27,125,98,98
73,seq46,seq134,r_100_11_69,r_100_11_69,1.0,25,94,69,98
11,r_95_37_194,seq8,r_115_29_164,r_95_37_194,0.55,1,195,194,98
13,r_33_97_144,seq138,seq32,r_33_97_144,0.56,4,148,144,98
15,r_0_149_203,seq82,r_95_37_194,r_0_149_203,0.79,1,204,203,98
57,seq13,r_100_11_69,r_114_4_247,r_100_11_69,1.0,2,71,69,98
12,r_7_62_149,r_22_80_73,r_9_77_5,r_7_62_149,1.0,-1,148,149,98
27,r_59_67_56,r_91_122_84,seq78,r_59_67_56,0.89,0,56,56,98
85,seq78,seq134,r_59_67_56,r_59_67_56,1.0,4,60,56,98
99,seq127,seq31,r_85_88_137,r_85_88_137,1.0,0,137,137,98
46,r_101_24_12,r_98_41_77,seq44,r_101_24_12,0.78,0,12,12,98
30,r_18_132_25,seq63,r_87_49_55,r_87_49_55,0.9,50,105,55,98
2,r_52_121_62,r_43_86_188,r_81_94_115,r_52_121_62,1.0,0,62,62,98
47,r_139_68_99,r_148_119_100,r_91_122_84,r_139_68_99,0.85,0,99,99,98
33,r_66_60_58,r_33_97_144,seq141,r_66_60_58,0.99,0,58,58,98
40,r_43_86_188,seq73,seq142,r_43_86_188,0.7,0,188,188,98
18,r_116_47_156,seq79,r_101_24_12,r_116_47_156,0.49,1,157,156,98
29,r_71_106_163,r_145_26_193,r_116_47_156,r_71_106_163,0.9,0,163,163,98
32,r_45_135_223,r_145_26_193,seq28,r_45_135_223,1.0,0,223,223,98
25,r_145_26_193,r_71_106_163,r_69_5_112,r_69_5_112,0.93,51,163,112,98
34,r_81_94_115,r_129_58_26,r_45_135_223,r_129_58_26,0.56,-9,17,26,98
58,seq142,r_61_55_116,seq138,r_61_55_116,0.85,2,118,116,98
25,r_145_26_193,r_45_135_223,r_59_67_56,r_45_135_223,0.73,5,228,223,98
6,r_35_14_17,r_128_92_173,r_7_62_149,r_35_14_17,0.89,158,175,17,98
35,r_56_40_23,r_143_112_211,r_89_23_19,r_56_40_23,1.0,0,23,23,98
4,r_91_122_84,r_9_77_5,r_139_68_99,r_139_68_99,0.89,38,137,99,98
32,r_45_135_223,r_113_144_113,seq48,r_113_144_113,0.53,15,128,113,98
68,seq31,r_51_107_57,seq13,r_51_107_57,0.64,138,195,57,98
75,seq50,r_120_39_182,r_61_55_116,r_61_55_116,1.0,75,191,116,98
65,seq25,r_84_57_31,r_148_119_100,r_148_119_100,0.94,9,109,100,98
65,seq25,r_51_107_57,r_84_57_31,r_51_107_57,1.0,1,58,57,98
17,r_10_102_240,seq32,r_98_41_77,r_98_41_77,0.84,163,240,77,98
30,r_18_132_25,r_113_144_113,seq63,r_18_132_25,1.0,0,25,25,98
37,r_103_27_234,seq30,seq72,r_103_27_234,0.77,0,234,234,98
28,r_19_42_136,seq44,seq90,r_19_42_136,0.87,0,136,136,98
91,seq99,seq141,r_81_94_115,r_81_94_115,1.0,14,129,115,98
24,r_51_107_57,seq25,seq127,r_51_107_57,1.0,1,58,57,98
25,r_145_26_193,r_69_5_112,r_45_135_223,r_145_26_193,0.75,0,193,193,98
7,r_1_146_167,seq141,seq137,r_1_146_167,0.86,1,168,167,98
44,r_85_88_137,seq54,seq127,r_85_88_137,1.0,2,139,137,98
4,r_91_122_84,seq25,r_9_77_5,r_91_122_84,0.94,0,84,84,98
79,seq64,r_89_23_19,r_130_108_27,r_130_108_27,0.98,57,84,27,98
12,r_7_62_149,seq70,r_22_80_73,r_22_80_73,1.0,3,76,73,98
72,seq44,r_33_97_144,r_101_24_12,r_101_24_12,1.0,0,12,12,98
4,r_91_122_84,r_59_67_56,seq25,r_59_67_56,0.71,0,56,56,98
93,seq110,seq79,r_71_115_227,r_71_115_227,0.62,-6,221,227,99
36,r_15_30_96,seq73,seq7,r_15_30_96,1.0,0,96,96,99
92,seq109,r_68_45_164,r_118_0_12,r_68_45_164,1.0,-101,63,164,99
14,r_92_20_157,seq24,seq134,r_92_20_157,0.7,0,157,157,99
8,r_38_123_177,seq79,seq12,r_38_123_177,0.8,0,177,177,99
53,seq7,r_106_126_224,r_15_30_96,r_15_30_96,1.0,34,130,96,99
43,r_56_54_104,r_90_69_244,seq83,r_56_54_104,1.0,0,104,104,99
54,seq137,r_141_1_179,r_36_116_44,r_36_116_44,0.75,54,98,44,99
83,seq83,r_21_99_189,r_56_54_104,r_56_54_104,1.0,96,200,104,99
37,r_136_121_171,seq27,seq32,r_136_121_171,0.99,0,171,171,99
55,seq12,r_75_18_223,r_38_123_177,r_38_123_177,0.71,25,202,177,99
16,r_29_11_226,r_4_2_212,r_90_69_244,r_29_11_226,0.49,-14,212,226,99
1,r_21_99_189,seq83,seq47,r_21_99_189,0.46,11,200,189,99
5,r_120_82_42,r_139_43_50,seq39,r_120_82_42,1.0,1,43,42,99
45,r_4_2_212,r_29_11_226,r_92_20_157,r_4_2_212,0.77,0,212,212,99
15,r_23_9_173,r_5_100_30,r_71_115_227,r_5_100_30,0.4,144,174,30,99
11,r_59_127_39,r_33_62_184,r_120_82_42,r_59_127_39,0.51,145,184,39,99
31,r_117_101_85,r_108_86_132,r_25_88_54,r_117_101_85,0.88,0,85,85,99
41,r_51_142_206,seq39,seq79,r_51_142_206,0.71,-1,205,206,99
3,r_78_96_123,r_53_98_100,r_107_132_188,r_53_98_100,1.0,1,101,100,99
26,r_105_57_64,seq135,seq7,r_105_57_64,0.99,0,64,64,99
11,r_59_127_39,r_120_82_42,r_29_11_226,r_59_127_39,0.72,188,227,39,99
32,r_53_98_100,r_71_115_227,seq110,r_71_115_227,0.62,-67,160,227,99
0,r_145_149_84,seq55,seq130,r_145_149_84,0.98,2,86,84,99
20,r_68_45_164,r_6_87_193,r_15_30_96,r_6_87_193,0.96,-29,164,193,99
46,r_22_138_10,seq39,r_64_10_130,r_64_10_130,1.0,2,132,130,99
15,r_23_9_173,seq41,r_5_100_30,r_5_100_30,0.83,63,93,30,99
48,r_133_44_175,seq114,seq113,r_133_44_175,0.9,0,175,175,99
13,r_5_100_30,r_23_9_173,seq47,r_23_9_173,0.99,0,173,173,99
6,r_107_132_188,seq140,seq39,r_107_132_188,0.98,0,188,188,99
44,r_71_115_227,r_23_9_173,seq110,r_71_115_227,0.87,0,227,227,99
27,r_90_69_244,r_56_54_104,seq113,r_56_54_104,0.99,-7,97,104,99
16,r_29_11_226,r_90_69_244,r_59_127_39,r_29_11_226,1.0,0,226,226,99
15,r_23_9_173,r_71_115_227,seq27,r_71_115_227,0.7,0,227,227,99
40,r_52_16_3,r_46_89_220,r_25_88_54,r_25_88_54,1.0,77,131,54,99
18,r_64_10_130,seq60,r_22_138_10,r_64_10_130,1.0,0,130,130,99
29,r_42_35_203,seq109,r_107_132_188,r_42_35_203,0.69,0,203,203,99
24,r_63_128_161,r_107_132_188,r_118_0_12,r_63_128_161,0.95,0,161,161,99
13,r_5_100_30,seq110,r_23_9_173,r_5_100_30,0.71,1,31,30,99
3,r_78_96_123,r_107_132_188,r_145_149_84,r_78_96_123,1.0,0,123,123,99
25,r_46_89_220,r_52_16_3,r_133_44_175,r_133_44_175,0.65,45,220,175,99
75,seq66,r_145_149_84,seq83,r_145_149_84,0.54,107,191,84,99
33,r_141_1_179,seq137,r_120_82_42,r_141_1_179,0.57,0,179,179,99
42,r_33_62_184,seq39,r_59_127_39,r_59_127_39,1.0,-1,38,39,99
88,seq95,seq143,r_61_50_88,r_61_50_88,0.66,2,90,88,99
65,seq32,r_17_37_238,r_136_121_171,r_136_121_171,0.96,34,205,171,99
42,r_33_62_184,r_59_127_39,r_118_0_12,r_33_62_184,0.82,1,185,184,99
32,r_53_98_100,r_78_96_123,r_71_115_227,r_53_98_100,0.86,2,102,100,99
38,r_106_126_224,seq7,r_51_142_206,r_51_142_206,0.65,18,224,206,99
10,r_129_84_22,r_133_44_175,seq12,r_129_84_22,1.0,1,23,22,99
7,r_118_0_12,r_38_123_177,seq109,r_118_0_12,0.62,2,14,12,99
46,r_22_138_10,r_92_20_157,seq39,r_22_138_10,0.87,0,10,10,99
81,seq79,r_38_123_177,seq110,r_38_123_177,0.9,0,177,177,99
2,r_139_43_50,seq125,seq134,r_139_43_50,0.66,3,53,50,99
17,r_17_37_238,seq32,r_68_45_164,r_17_37_238,0.28,0,238,238,99
94,seq113,r_108_86_132,r_29_11_226,r_108_86_132,1.0,0,132,132,99
9,r_72_65_156,r_17_37_238,seq134,r_72_65_156,0.47,1,157,156,99
22,r_61_50_88,r_112_58_148,seq95,r_112_58_148,0.99,-45,103,148,99
49,r_6_87_193,r_42_35_203,seq140,r_6_87_193,0.8,0,193,193,99
30,r_25_88_54,r_75_18_223,seq24,r_25_88_54,1.0,0,54,54,99
39,r_36_116_44,r_23_9_173,seq137,r_36_116_44,1.0,0,44,44,99
44,r_71_115_227,seq49,r_23_9_173,r_23_9_173,0.87,-3,170,173,99
23,r_97_144_160,r_17_37_238,r_124_28_143,r_97_144_160,0.52,-89,71,160,99
11,r_59_127_39,r_68_45_164,r_33_62_184,r_59_127_39,1.0,0,39,39,99
35,r_31_48_129,r_61_50_88,seq49,r_61_50_88,0.51,42,130,88,99
12,r_112_58_148,r_61_50_88,seq113,r_112_58_148,0.93,-1,147,148,99
81,seq79,seq110,r_51_142_206,r_51_142_206,0.63,14,220,206,99
23,r_97_144_160,r_124_28_143,r_36_116_44,r_97_144_160,1.0,-1,159,160,99
