51,r_27_204_116,seq76,seq11,r_27_204_116,1.0,-1,115,116,0
36,r_172_215_163,seq193,seq140,r_172_215_163,0.98,0,163,163,0
37,r_55_134_55,seq68,seq14,r_55_134_55,0.89,0,55,55,0
92,seq32,r_54_205_144,r_115_202_24,r_115_202_24,0.99,5,29,24,0
8,r_194_219_77,r_158_129_105,seq68,r_194_219_77,1.0,0,77,77,0
59,r_145_110_77,seq113,seq135,r_145_110_77,1.0,0,77,77,0
13,r_77_67_45,seq91,r_78_45_15,r_77_67_45,1.0,0,45,45,0
71,r_131_80_131,seq142,seq100,r_131_80_131,0.96,0,131,131,0
21,r_0_70_65,seq140,seq173,r_0_70_65,1.0,0,65,65,0
14,r_223_123_44,r_141_90_149,r_153_106_124,r_223_123_44,1.0,0,44,44,0
1,r_141_90_149,r_108_101_143,seq69,r_141_90_149,0.59,-1,148,149,0
97,seq41,r_31_164_164,r_102_88_115,r_102_88_115,0.92,50,165,115,0
5,r_6_146_86,r_102_88_115,seq224,r_6_146_86,1.0,0,86,86,0
42,r_174_221_159,seq135,seq76,r_174_221_159,0.82,0,159,159,0
39,r_19_10_24,r_168_166_100,seq140,r_19_10_24,1.0,0,24,24,0
89,seq154,r_114_85_59,seq220,r_114_85_59,0.99,-17,42,59,0
19,r_48_17_171,r_65_191_173,r_181_12_165,r_48_17_171,0.72,0,171,171,0
27,r_128_3_185,seq73,seq171,r_128_3_185,0.83,0,185,185,0
66,r_218_37_170,r_153_106_124,r_59_1_77,r_218_37_170,0.54,0,170,170,0
100,seq173,r_209_39_178,r_0_70_65,r_0_70_65,1.0,2,67,65,0
39,r_19_10_24,seq140,r_187_63_174,r_187_63_174,0.52,-2,172,174,0
41,r_212_51_177,seq58,r_172_215_163,r_212_51_177,0.59,0,177,177,0
3,r_168_166_100,r_199_36_105,r_152_23_82,r_152_23_82,1.0,18,100,82,0
10,r_150_98_65,seq127,r_161_95_6,r_150_98_65,1.0,0,65,65,0
26,r_102_88_115,seq57,seq189,r_102_88_115,1.0,0,115,115,0
139,seq189,r_109_25_185,r_102_88_115,r_102_88_115,1.0,71,186,115,0
55,r_176_56_40,r_138_18_183,seq126,r_176_56_40,1.0,0,40,40,0
4,r_211_79_165,r_181_12_165,r_47_74_129,r_211_79_165,0.47,0,165,165,0
0,r_187_63_174,r_48_17_171,seq61,r_187_63_174,0.5,-3,171,174,0
63,r_210_155_155,seq136,r_86_207_85,r_210_155_155,0.98,0,155,155,0
16,r_185_163_57,r_47_74_129,r_30_214_62,r_185_163_57,1.0,0,57,57,0
73,r_65_191_173,r_187_63_174,seq118,r_65_191_173,0.54,0,173,173,0
11,r_108_101_143,r_141_90_149,seq193,r_108_101_143,1.0,2,145,143,0
107,seq57,r_102_88_115,r_86_207_85,r_102_88_115,1.0,-21,94,115,0
20,r_29_200_99,r_131_80_131,r_43_94_74,r_29_200_99,0.8,0,99,99,0
67,r_114_85_59,seq154,r_77_67_45,r_114_85_59,0.76,0,59,59,0
15,r_50_165_151,r_170_15_16,r_21_203_155,r_21_203_155,0.64,2,157,155,0
102,seq49,r_153_106_124,r_26_122_52,r_26_122_52,1.0,1,53,52,0
90,seq28,r_43_94_74,r_190_125_9,r_190_125_9,0.96,15,24,9,0
6,r_47_74_129,r_197_99_112,r_168_166_100,r_168_166_100,0.63,11,111,100,0
62,r_87_72_183,seq16,r_184_111_175,r_87_72_183,0.46,0,183,183,0
69,r_26_122_52,seq68,seq49,r_26_122_52,1.0,0,52,52,0
48,r_44_103_18,seq73,seq113,r_44_103_18,1.0,0,18,18,0
27,r_128_3_185,seq58,seq73,r_128_3_185,0.4,-71,114,185,0
87,seq149,r_102_88_115,seq69,r_102_88_115,1.0,-22,93,115,0
60,r_112_139_41,r_0_70_65,seq104,r_112_139_41,1.0,-1,40,41,0
53,r_4_33_17,r_130_2_133,seq182,r_4_33_17,0.89,1,18,17,0
2,r_181_12_165,r_211_79_165,r_151_178_82,r_151_178_82,0.63,83,165,82,0
47,r_60_119_149,r_172_215_163,seq120,r_60_119_149,0.91,0,149,149,0
40,r_186_167_167,seq121,seq28,r_186_167_167,0.62,0,167,167,0
56,r_115_202_24,r_210_155_155,seq32,r_115_202_24,1.0,0,24,24,0
74,r_199_36_105,seq192,r_159_34_93,r_199_36_105,0.99,0,105,105,0
18,r_151_178_82,seq61,seq14,r_151_178_82,0.8,0,82,82,0
29,r_53_82_73,r_162_160_111,seq142,r_53_82_73,1.0,1,74,73,0
24,r_222_46_169,seq40,r_168_166_100,r_168_166_100,1.0,69,169,100,0
6,r_47_74_129,r_168_166_100,seq208,r_47_74_129,1.0,3,132,129,0
25,r_209_39_178,seq173,r_174_221_159,r_209_39_178,0.62,0,178,178,0
64,r_197_99_112,r_47_74_129,seq143,r_197_99_112,1.0,0,112,112,0
50,r_170_15_16,r_50_165_151,r_213_105_77,r_213_105_77,1.0,74,151,77,0
58,r_196_24_181,seq142,r_158_129_105,r_196_24_181,0.76,1,182,181,0
68,r_132_144_74,r_162_160_111,seq208,r_132_144_74,1.0,0,74,74,0
38,r_213_105_77,r_138_18_183,r_170_15_16,r_213_105_77,1.0,0,77,77,0
52,r_162_160_111,seq121,seq84,r_162_160_111,1.0,0,111,111,0
34,r_158_129_105,r_59_1_77,seq220,r_158_129_105,1.0,1,106,105,0
54,r_5_124_53,seq68,r_77_67_45,r_5_124_53,1.0,0,53,53,0
17,r_21_203_155,r_222_46_169,r_50_165_151,r_21_203_155,0.93,0,155,155,0
121,seq224,seq118,r_6_146_86,r_6_146_86,1.0,3,89,86,0
9,r_153_106_124,seq49,r_170_15_16,r_170_15_16,0.66,44,60,16,0
145,seq120,r_30_214_62,r_184_111_175,r_30_214_62,0.32,31,93,62,0
22,r_152_23_82,seq58,r_47_74_129,r_152_23_82,1.0,0,82,82,0
28,r_43_94_74,seq62,seq40,r_43_94_74,0.65,-10,64,74,0
49,r_133_42_35,r_141_90_149,seq9,r_133_42_35,0.87,0,35,35,0
44,r_130_2_133,seq93,r_55_134_55,r_130_2_133,1.0,0,133,133,0
22,r_152_23_82,r_47_74_129,r_168_166_100,r_47_74_129,0.69,1,130,129,0
145,seq120,r_184_111_175,r_60_119_149,r_60_119_149,1.0,9,158,149,0
35,r_54_205_144,seq11,r_77_67_45,r_54_205_144,0.84,-1,143,144,0
23,r_161_95_6,r_48_17_171,r_150_98_65,r_150_98_65,1.0,106,171,65,0
84,seq16,r_87_72_183,seq217,r_87_72_183,0.93,0,183,183,0
65,r_89_137_55,r_181_12_165,r_44_103_18,r_89_137_55,1.0,0,55,55,0
93,seq32,r_64_98_181,seq210,r_64_98_181,0.6,0,181,181,1
30,r_30_182_151,r_33_10_158,r_18_9_74,r_33_10_158,0.44,-7,151,158,1
44,r_40_135_170,r_214_126_97,r_203_50_26,r_40_135_170,0.86,0,170,170,1
51,r_31_221_165,r_48_176_189,r_119_192_54,r_31_221_165,0.91,0,165,165,1
14,r_64_98_181,seq32,r_138_95_126,r_138_95_126,0.54,55,181,126,1
147,seq115,r_217_145_116,seq204,r_217_145_116,1.0,-18,98,116,1
8,r_104_159_110,seq47,r_203_50_26,r_203_50_26,0.93,84,110,26,1
53,r_148_22_186,r_187_4_88,r_203_50_26,r_148_22_186,0.88,-97,89,186,1
4,r_203_50_26,r_11_27_140,seq143,r_203_50_26,0.95,0,26,26,1
43,r_187_4_88,r_148_22_186,seq180,r_187_4_88,1.0,1,89,88,1
54,r_154_129_79,r_194_151_141,r_3_178_4,r_154_129_79,1.0,0,79,79,1
37,r_120_37_169,seq67,r_111_1_52,r_120_37_169,0.86,0,169,169,1
65,r_128_76_42,seq26,seq56,r_128_76_42,0.64,-1,41,42,1
59,r_168_118_148,seq7,seq204,r_168_118_148,0.94,0,148,148,1
55,r_8_132_85,seq51,r_189_49_89,r_8_132_85,1.0,0,85,85,1
71,r_131_60_176,seq219,r_14_156_104,r_131_60_176,0.43,0,176,176,1
16,r_138_95_126,r_48_176_189,r_33_10_158,r_138_95_126,0.98,0,126,126,1
21,r_99_6_99,r_42_5_104,seq170,r_99_6_99,1.0,0,99,99,1
1,r_107_62_107,seq57,seq164,r_107_62_107,1.0,0,107,107,1
5,r_194_151_141,r_33_10_158,seq209,r_194_151_141,0.42,0,141,141,1
46,r_218_123_94,seq166,r_18_9_74,r_218_123_94,0.99,0,94,94,1
111,seq61,r_187_4_88,seq209,r_187_4_88,1.0,0,88,88,1
133,seq219,r_131_60_176,r_130_175_49,r_130_175_49,1.0,7,56,49,1
45,r_106_134_78,seq197,r_66_177_14,r_66_177_14,0.85,75,89,14,1
20,r_39_0_109,r_161_207_6,seq201,r_39_0_109,0.97,1,110,109,1
33,r_14_156_104,r_148_22_186,r_194_151_141,r_14_156_104,0.76,82,186,104,1
95,seq34,r_59_220_122,r_133_162_140,r_59_220_122,0.54,-8,114,122,1
66,r_86_15_133,r_102_43_2,seq71,r_86_15_133,0.82,0,133,133,1
129,seq85,seq51,r_79_73_79,r_79_73_79,1.0,23,102,79,1
41,r_189_49_89,seq13,r_8_132_85,r_8_132_85,0.7,5,90,85,1
67,r_144_109_65,seq38,seq51,r_144_109_65,1.0,0,65,65,1
53,r_148_22_186,r_14_156_104,r_84_139_8,r_148_22_186,0.67,0,186,186,1
10,r_133_162_140,r_41_184_196,r_74_117_141,r_41_184_196,0.65,-119,77,196,1
39,r_70_108_10,r_138_95_126,seq57,r_70_108_10,0.95,0,10,10,1
109,seq57,r_107_62_107,r_42_5_104,r_107_62_107,1.0,-9,98,107,1
115,seq67,r_120_37_169,r_223_196_27,r_223_196_27,0.76,142,169,27,1
72,r_112_46_133,seq38,r_130_175_49,r_112_46_133,0.9,0,133,133,1
0,r_79_73_79,r_42_5_104,seq85,r_79_73_79,1.0,0,79,79,1
73,r_35_68_65,r_59_220_122,r_18_9_74,r_35_68_65,0.63,0,65,65,1
11,r_18_9_74,r_168_118_148,seq28,r_168_118_148,0.77,-74,74,148,1
20,r_39_0_109,r_214_126_97,r_161_207_6,r_214_126_97,0.98,1,98,97,1
13,r_214_126_97,r_39_0_109,r_40_135_170,r_214_126_97,0.71,1,98,97,1
69,r_206_53_34,r_218_123_94,seq204,r_206_53_34,0.96,0,34,34,1
13,r_214_126_97,r_40_135_170,r_39_0_109,r_40_135_170,0.97,3,173,170,1
6,r_185_122_134,seq198,seq115,r_185_122_134,0.96,0,134,134,1
2,r_78_97_180,r_189_49_89,r_106_134_78,r_78_97_180,0.81,-1,179,180,1
42,r_191_75_13,r_189_49_89,seq211,r_191_75_13,0.99,0,13,13,1
25,r_223_196_27,r_138_95_126,seq212,r_223_196_27,1.0,0,27,27,1
64,r_92_157_47,r_120_37_169,seq211,r_92_157_47,0.97,0,47,47,1
29,r_199_127_23,seq87,seq47,r_199_127_23,0.65,0,23,23,1
2,r_78_97_180,seq87,r_189_49_89,r_189_49_89,1.0,1,90,89,1
47,r_44_19_75,r_138_95_126,seq65,r_44_19_75,1.0,0,75,75,1
3,r_111_1_52,seq209,seq211,r_111_1_52,0.84,0,52,52,1
40,r_42_5_104,seq212,seq57,r_42_5_104,0.78,-6,98,104,1
126,seq82,r_48_176_189,r_168_118_148,r_168_118_148,0.86,41,189,148,1
74,r_153_172_118,seq195,seq209,r_153_172_118,0.72,14,132,118,1
18,r_33_10_158,r_194_151_141,r_138_95_126,r_138_95_126,0.99,15,141,126,1
24,r_161_207_6,r_39_0_109,seq38,r_39_0_109,0.93,1,110,109,1
33,r_14_156_104,seq38,r_148_22_186,r_14_156_104,0.92,0,104,104,1
52,r_130_175_49,seq216,seq219,r_130_175_49,1.0,0,49,49,1
130,seq87,seq142,r_189_49_89,r_189_49_89,1.0,33,122,89,1
61,r_102_43_2,r_86_15_133,r_189_49_89,r_86_15_133,0.66,0,133,133,1
38,r_59_220_122,seq34,r_39_0_109,r_59_220_122,0.91,0,122,122,1
34,r_150_45_149,seq51,r_203_50_26,r_150_45_149,0.95,0,149,149,1
75,seq201,r_131_60_176,r_39_0_109,r_39_0_109,0.54,4,113,109,1
60,r_90_200_112,seq193,r_189_49_89,r_90_200_112,0.69,0,112,112,1
68,r_213_91_25,r_189_49_89,seq136,r_213_91_25,1.0,0,25,25,1
9,r_11_27_140,seq20,seq114,r_11_27_140,0.92,0,140,140,1
96,seq180,seq166,r_187_4_88,r_187_4_88,1.0,43,131,88,1
53,r_148_22_186,r_203_50_26,r_14_156_104,r_14_156_104,1.0,7,111,104,1
15,r_119_192_54,seq216,seq105,r_119_192_54,0.88,0,54,54,1
12,r_222_183_13,r_79_73_79,seq12,r_79_73_79,0.74,-64,15,79,1
28,r_217_145_116,seq115,seq216,r_217_145_116,1.0,0,116,116,1
91,seq28,r_88_80_60,r_18_9_74,r_88_80_60,1.0,1,61,60,1
49,r_124_141_93,seq72,seq105,r_124_141_93,1.0,1,94,93,1
56,r_2_163_103,r_217_145_116,seq56,r_2_163_103,0.83,0,103,103,1
44,r_40_135_170,r_218_123_94,r_214_126_97,r_40_135_170,0.72,-76,94,170,1
118,seq71,seq72,r_86_15_133,r_86_15_133,0.9,1,134,133,1
23,r_88_80_60,seq28,r_119_192_54,r_88_80_60,1.0,1,61,60,1
35,r_181_215_120,seq211,seq24,r_181_215_120,0.96,0,120,120,1
40,r_137_217_28,r_117_124_112,r_14_90_57,r_137_217_28,0.54,86,114,28,2
33,r_119_38_45,r_194_182_194,seq79,r_119_38_45,1.0,0,45,45,2
53,r_204_23_28,r_106_178_123,seq75,r_204_23_28,1.0,1,29,28,2
36,r_32_202_71,r_134_166_171,seq78,r_32_202_71,1.0,0,71,71,2
9,r_159_5_151,r_97_89_26,r_67_84_93,r_159_5_151,0.86,2,153,151,2
19,r_186_195_36,r_93_7_189,seq81,r_186_195_36,1.0,0,36,36,2
13,r_95_175_22,r_177_16_146,seq21,r_95_175_22,0.71,2,24,22,2
14,r_181_110_104,seq172,seq200,r_181_110_104,0.46,0,104,104,2
8,r_102_219_62,r_174_74_141,seq114,r_102_219_62,0.82,3,65,62,2
43,r_150_163_101,r_28_133_153,seq19,r_150_163_101,1.0,1,102,101,2
54,r_61_33_111,r_49_96_32,r_152_4_88,r_49_96_32,1.0,79,111,32,2
55,r_122_73_155,seq70,seq91,r_122_73_155,0.79,2,157,155,2
71,r_41_167_116,seq62,seq171,r_41_167_116,0.83,0,116,116,2
16,r_67_84_93,r_209_144_118,r_2_151_63,r_2_151_63,0.76,30,93,63,2
21,r_55_136_157,seq79,r_11_140_39,r_11_140_39,0.97,119,158,39,2
39,r_146_103_139,seq129,seq200,r_146_103_139,0.9,0,139,139,2
1,r_106_178_123,r_9_142_131,seq40,r_9_142_131,0.74,-21,110,131,2
5,r_31_27_145,r_224_66_158,r_11_140_39,r_31_27_145,0.74,0,145,145,2
42,r_28_133_153,r_150_163_101,r_213_0_94,r_28_133_153,1.0,-52,101,153,2
51,r_138_215_22,r_194_182_194,seq35,r_138_215_22,1.0,0,22,22,2
18,r_97_89_26,r_94_98_118,r_159_5_151,r_97_89_26,1.0,0,26,26,2
34,r_15_155_10,r_31_27_145,seq100,r_15_155_10,0.83,0,10,10,2
61,r_191_22_48,seq20,seq132,r_191_22_48,1.0,0,48,48,2
138,seq100,r_55_136_157,r_15_155_10,r_15_155_10,0.79,1,11,10,2
100,seq40,r_209_144_118,r_106_178_123,r_209_144_118,0.91,-11,107,118,2
103,seq43,r_209_144_118,r_106_178_123,r_209_144_118,0.96,-11,107,118,2
31,r_2_151_63,r_181_110_104,r_187_120_19,r_2_151_63,1.0,0,63,63,2
129,seq81,r_218_196_190,r_123_162_162,r_123_162_162,0.6,28,190,162,2
41,r_108_216_85,seq172,seq198,r_108_216_85,1.0,1,86,85,2
67,r_139_69_169,seq57,r_15_155_10,r_139_69_169,0.68,0,169,169,2
3,r_177_16_146,seq132,r_49_96_32,r_177_16_146,0.83,0,146,146,2
10,r_224_66_158,seq70,r_191_22_48,r_191_22_48,0.97,110,158,48,2
40,r_137_217_28,r_25_179_183,r_117_124_112,r_137_217_28,0.95,0,28,28,2
78,seq132,r_177_16_146,r_191_22_48,r_191_22_48,0.9,12,60,48,2
63,r_94_98_118,seq214,r_12_189_34,r_94_98_118,1.0,0,118,118,2
73,r_135_125_100,r_199_42_149,seq17,r_135_125_100,0.97,0,100,100,2
48,r_131_46_151,r_168_165_159,r_41_167_116,r_168_165_159,0.99,0,159,159,2
6,r_213_0_94,r_106_178_123,r_28_133_153,r_213_0_94,1.0,0,94,94,2
50,r_170_118_13,r_55_136_157,r_9_142_131,r_170_118_13,0.99,0,13,13,2
12,r_187_120_19,r_88_210_196,seq193,r_187_120_19,1.0,-1,18,19,2
27,r_157_92_130,seq75,r_186_195_36,r_157_92_130,0.96,0,130,130,2
60,r_49_96_32,r_186_195_36,r_177_16_146,r_177_16_146,1.0,7,153,146,2
69,r_211_72_18,seq107,r_97_89_26,r_97_89_26,0.55,129,155,26,2
2,r_123_162_162,seq10,r_55_136_157,r_123_162_162,0.68,0,162,162,2
47,r_12_189_34,r_44_154_170,r_24_164_2,r_12_189_34,0.99,1,35,34,2
4,r_3_143_22,r_41_167_116,seq10,r_3_143_22,0.98,2,24,22,2
105,seq47,r_94_98_118,r_223_111_56,r_223_111_56,0.71,62,118,56,2
126,seq78,r_30_130_190,r_32_202_71,r_32_202_71,1.0,47,118,71,2
46,r_116_101_37,seq75,seq40,r_116_101_37,1.0,0,37,37,2
37,r_11_140_39,r_159_5_151,seq26,r_11_140_39,1.0,0,39,39,2
69,r_211_72_18,r_181_110_104,seq107,r_211_72_18,0.55,2,20,18,2
127,seq79,r_55_136_157,r_119_38_45,r_119_38_45,1.0,113,158,45,2
64,r_77_113_135,r_123_162_162,r_135_125_100,r_77_113_135,0.85,1,136,135,2
47,r_12_189_34,r_24_164_2,r_94_98_118,r_94_98_118,1.0,13,131,118,2
59,r_34_45_58,r_168_165_159,r_194_182_194,r_34_45_58,1.0,1,59,58,2
58,r_99_115_61,r_88_210_196,r_187_120_19,r_99_115_61,0.86,0,61,61,2
70,r_85_104_116,r_123_162_162,r_102_219_62,r_85_104_116,1.0,0,116,116,2
65,r_9_142_131,r_106_178_123,r_157_92_130,r_9_142_131,0.97,0,131,131,2
25,r_14_90_57,seq114,r_137_217_28,r_14_90_57,1.0,1,58,57,2
68,r_80_222_105,seq8,seq1,r_80_222_105,1.0,0,105,105,2
29,r_223_111_56,r_28_133_153,seq188,r_223_111_56,1.0,0,56,56,2
32,r_183_220_189,r_218_196_190,r_30_130_190,r_30_130_190,0.74,-1,189,190,2
38,r_168_165_159,r_131_46_151,r_55_136_157,r_55_136_157,0.62,2,159,157,2
9,r_159_5_151,r_11_140_39,r_97_89_26,r_159_5_151,1.0,-121,30,151,2
144,seq114,r_14_90_57,r_102_219_62,r_14_90_57,0.92,1,58,57,2
45,r_207_48_52,r_177_16_146,seq105,r_207_48_52,0.98,0,52,52,2
60,r_49_96_32,r_61_33_111,r_186_195_36,r_49_96_32,0.88,79,111,32,2
17,r_180_141_128,r_174_74_141,r_24_164_2,r_180_141_128,0.98,0,128,128,2
50,r_170_118_13,r_9_142_131,r_34_45_58,r_170_118_13,0.94,118,131,13,2
96,seq161,r_174_74_141,r_152_4_88,r_152_4_88,1.0,53,141,88,2
123,seq201,r_134_166_171,r_102_219_62,r_134_166_171,0.53,0,171,171,2
28,r_44_154_170,seq171,seq145,r_44_154_170,0.56,1,171,170,2
49,r_218_196_190,seq81,r_213_0_94,r_218_196_190,0.37,0,190,190,2
7,r_117_124_112,seq160,r_24_164_2,r_117_124_112,1.0,2,114,112,2
18,r_97_89_26,r_159_5_151,r_211_72_18,r_159_5_151,1.0,2,153,151,2
44,r_152_4_88,seq60,seq161,r_152_4_88,1.0,0,88,88,2
101,seq169,r_194_182_194,r_170_118_13,r_170_118_13,0.8,101,114,13,2
51,r_77_64_109,seq146,seq206,r_77_64_109,0.98,1,110,109,3
36,r_120_68_121,r_221_153_190,seq51,r_120_68_121,0.97,1,122,121,3
122,seq206,r_37_168_98,seq44,r_37_168_98,1.0,4,102,98,3
14,r_211_127_147,r_79_214_102,r_41_191_82,r_41_191_82,0.71,7,89,82,3
53,r_173_52_152,seq46,r_120_68_121,r_120_68_121,0.46,31,152,121,3
55,r_188_49_149,r_73_67_142,r_36_194_2,r_73_67_142,0.73,-15,127,142,3
86,seq18,r_203_180_114,r_31_217_61,r_31_217_61,1.0,39,100,61,3
21,r_19_224_152,seq94,seq139,r_19_224_152,0.86,0,152,152,3
1,r_160_25_130,seq32,r_156_142_89,r_160_25_130,0.82,1,131,130,3
46,r_26_4_89,r_41_191_82,r_186_166_194,r_26_4_89,0.44,-29,60,89,3
46,r_26_4_89,r_186_166_194,seq27,r_26_4_89,0.99,0,89,89,3
69,r_37_168_98,seq206,seq51,r_37_168_98,0.98,4,102,98,3
29,r_59_5_57,seq32,seq193,r_59_5_57,1.0,1,58,57,3
19,r_53_162_186,seq3,r_60_14_60,r_60_14_60,0.99,126,186,60,3
13,r_148_6_25,r_38_136_69,r_147_50_3,r_148_6_25,0.55,1,26,25,3
55,r_188_49_149,r_36_194_2,seq27,r_188_49_149,0.97,2,151,149,3
37,r_189_207_26,seq193,seq212,r_189_207_26,0.99,0,26,26,3
31,r_215_35_49,r_169_223_80,seq106,r_169_223_80,0.86,-30,50,80,3
129,seq219,r_157_100_192,r_116_137_79,r_116_137_79,0.98,23,102,79,3
110,seq51,seq24,r_37_168_98,r_37_168_98,1.0,4,102,98,3
3,r_116_137_79,r_74_210_174,seq219,r_116_137_79,0.98,0,79,79,3
10,r_213_63_162,seq149,r_222_204_112,r_213_63_162,0.85,1,163,162,3
59,r_184_122_48,seq108,seq13,r_184_122_48,1.0,0,48,48,3
26,r_123_96_169,seq139,seq99,r_123_96_169,0.65,1,170,169,3
72,r_134_129_138,seq83,r_197_0_62,r_197_0_62,1.0,34,96,62,3
139,seq106,seq99,r_215_35_49,r_215_35_49,0.98,30,79,49,3
4,r_71_144_14,r_213_63_162,seq209,r_71_144_14,0.86,0,14,14,3
140,seq108,r_184_122_48,seq83,r_184_122_48,1.0,0,48,48,3
0,r_17_48_127,r_101_130_185,seq18,r_17_48_127,0.8,2,129,127,3
63,r_29_93_158,r_186_166_194,r_60_14_60,r_60_14_60,0.62,98,158,60,3
114,seq193,seq175,r_59_5_57,r_59_5_57,1.0,62,119,57,3
11,r_197_0_62,r_56_154_175,r_134_129_138,r_197_0_62,0.97,0,62,62,3
20,r_57_47_115,r_55_199_131,r_36_194_2,r_55_199_131,0.59,-16,115,131,3
67,r_216_87_44,r_103_84_84,seq98,r_216_87_44,1.0,0,44,44,3
15,r_185_34_92,seq171,r_179_91_93,r_179_91_93,0.98,3,96,93,3
48,r_72_183_94,seq32,r_62_45_63,r_72_183_94,0.94,0,94,94,3
57,r_9_61_117,r_192_107_7,seq161,r_9_61_117,0.94,0,117,117,3
6,r_38_136_69,r_173_52_152,r_192_107_7,r_38_136_69,1.0,2,71,69,3
62,r_222_204_112,seq209,seq58,r_222_204_112,0.65,-4,108,112,3
14,r_211_127_147,r_41_191_82,seq46,r_211_127_147,1.0,0,147,147,3
27,r_31_217_61,seq140,seq18,r_31_217_61,1.0,1,62,61,3
62,r_222_204_112,seq58,r_213_63_162,r_213_63_162,0.97,0,162,162,3
73,r_155_54_35,r_38_136_69,seq135,r_155_54_35,0.69,-2,33,35,3
2,r_60_14_60,r_197_0_62,r_163_177_54,r_163_177_54,0.95,6,60,54,3
74,r_74_210_174,r_36_194_2,r_215_35_49,r_215_35_49,0.9,125,174,49,3
18,r_12_85_123,r_221_153_190,r_148_6_25,r_12_85_123,0.99,0,123,123,3
44,r_102_10_39,r_74_210_174,seq149,r_102_10_39,1.0,2,41,39,3
25,r_179_91_93,r_9_61_117,r_185_34_92,r_185_34_92,0.63,1,93,92,3
64,r_121_69_105,seq159,seq27,r_121_69_105,0.99,1,106,105,3
66,r_178_152_46,seq187,seq193,r_178_152_46,1.0,1,47,46,3
50,r_205_132_63,r_117_82_155,r_163_177_54,r_117_82_155,0.98,-91,64,155,3
65,r_62_45_63,r_121_69_105,r_72_183_94,r_62_45_63,1.0,35,98,63,3
68,r_190_167_35,r_222_204_112,seq13,r_190_167_35,0.62,0,35,35,3
38,r_33_131_119,seq83,seq40,r_33_131_119,0.99,5,124,119,3
34,r_117_82_155,seq21,r_72_183_94,r_72_183_94,1.0,62,156,94,3
124,seq83,r_156_142_89,r_179_91_93,r_179_91_93,0.98,1,94,93,3
11,r_197_0_62,r_134_129_138,seq18,r_134_129_138,1.0,-19,119,138,3
140,seq108,seq83,r_60_14_60,r_60_14_60,0.84,118,178,60,3
22,r_36_194_2,r_74_210_174,r_156_142_89,r_156_142_89,0.79,85,174,89,3
102,seq40,r_221_153_190,r_33_131_119,r_33_131_119,0.98,3,122,119,3
49,r_192_107_7,r_179_91_93,r_38_136_69,r_192_107_7,0.72,86,93,7,3
149,seq149,r_213_63_162,r_102_10_39,r_102_10_39,0.75,32,71,39,3
7,r_88_15_74,seq11,seq3,r_88_15_74,1.0,1,75,74,3
23,r_169_223_80,seq27,seq146,r_169_223_80,1.0,0,80,80,3
72,r_134_129_138,r_197_0_62,r_38_136_69,r_134_129_138,0.96,1,139,138,3
82,seq140,r_31_217_61,seq3,r_31_217_61,1.0,0,61,61,3
47,r_198_75_38,r_17_48_127,seq139,r_198_75_38,0.99,0,38,38,3
35,r_156_142_89,seq83,r_80_200_9,r_156_142_89,0.73,5,94,89,3
12,r_203_180_114,seq176,seq92,r_203_180_114,0.89,1,115,114,3
128,seq90,r_208_39_105,seq43,r_208_39_105,1.0,0,105,105,3
30,r_139_108_114,r_113_100_107,r_132_77_101,r_139_108_114,0.94,1,115,114,4
59,r_214_140_19,r_126_24_64,r_204_163_178,r_204_163_178,0.92,-161,17,178,4
36,r_127_196_118,r_65_220_111,seq174,r_127_196_118,0.92,1,119,118,4
9,r_173_43_76,seq4,r_70_184_144,r_70_184_144,1.0,4,148,144,4
54,r_1_13_108,r_76_40_59,seq80,r_76_40_59,1.0,-14,45,59,4
8,r_55_28_66,seq183,seq193,r_55_28_66,1.0,1,67,66,4
53,r_132_77_101,seq29,seq213,r_132_77_101,0.98,0,101,101,4
70,r_38_63_103,r_96_187_61,r_102_202_63,r_38_63_103,1.0,1,104,103,4
43,r_185_69_2,r_102_202_63,seq64,r_102_202_63,0.99,1,64,63,4
54,r_1_13_108,seq80,seq166,r_1_13_108,0.67,0,108,108,4
55,r_91_59_97,seq203,r_126_24_64,r_126_24_64,0.6,34,98,64,4
16,r_74_44_116,seq222,seq120,r_74_44_116,0.34,7,123,116,4
21,r_182_152_70,seq178,seq85,r_182_152_70,1.0,0,70,70,4
39,r_19_27_80,seq178,seq128,r_19_27_80,1.0,2,82,80,4
1,r_160_7_58,seq177,seq157,r_160_7_58,1.0,2,60,58,4
5,r_194_12_155,r_17_75_58,seq183,r_17_75_58,1.0,5,63,58,4
42,r_126_24_64,seq85,seq33,r_126_24_64,1.0,3,67,64,4
10,r_58_49_18,seq213,seq151,r_58_49_18,1.0,0,18,18,4
69,r_205_101_62,r_105_89_64,seq18,r_205_101_62,1.0,1,63,62,4
76,seq130,seq198,r_197_154_21,r_197_154_21,0.83,3,24,21,4
19,r_96_187_61,r_99_97_195,r_38_63_103,r_96_187_61,1.0,0,61,61,4
15,r_197_154_21,r_2_93_107,seq130,r_197_154_21,0.99,0,21,21,4
19,r_96_187_61,seq145,r_57_53_153,r_57_53_153,0.83,11,164,153,4
27,r_39_211_154,r_133_118_23,r_129_131_145,r_129_131_145,0.78,9,154,145,4
66,r_50_66_79,r_39_211_154,seq10,r_50_66_79,0.98,0,79,79,4
100,seq177,r_186_104_123,seq183,r_186_104_123,0.96,-19,104,123,4
51,r_81_6_21,seq80,seq178,r_81_6_21,0.96,0,21,21,4
103,seq170,r_117_167_78,seq168,r_117_167_78,1.0,1,79,78,4
31,r_121_158_118,r_200_156_198,seq177,r_200_156_198,0.68,-80,118,198,4
92,seq151,seq207,r_58_49_18,r_58_49_18,1.0,9,27,18,4
41,r_136_48_128,seq64,r_216_217_108,r_136_48_128,0.86,0,128,128,4
67,r_111_3_155,seq41,r_197_154_21,r_111_3_155,0.97,1,156,155,4
19,r_96_187_61,r_38_63_103,seq145,r_38_63_103,1.0,1,104,103,4
3,r_204_163_178,r_113_100_107,r_214_140_19,r_214_140_19,0.92,90,109,19,4
46,r_95_221_16,r_58_49_18,seq36,r_95_221_16,0.9,1,17,16,4
113,seq183,r_55_28_66,r_194_12_155,r_55_28_66,1.0,1,67,66,4
26,r_31_54_116,r_39_211_154,seq199,r_39_211_154,0.75,-38,116,154,4
72,r_8_162_86,r_39_211_154,r_79_142_85,r_39_211_154,0.59,-72,82,154,4
78,seq5,seq222,r_191_180_77,r_191_180_77,1.0,20,97,77,4
0,r_149_181_103,r_185_69_2,seq134,r_149_181_103,0.97,1,104,103,4
63,r_105_89_64,r_111_3_155,seq82,r_105_89_64,1.0,0,64,64,4
73,r_17_75_58,r_194_12_155,seq222,r_17_75_58,0.73,5,63,58,4
11,r_113_100_107,r_139_108_114,r_79_142_85,r_113_100_107,0.81,8,115,107,4
99,seq166,r_0_71_162,r_1_13_108,r_1_13_108,0.96,2,110,108,4
20,r_159_23_74,r_79_142_85,r_194_12_155,r_159_23_74,0.96,1,75,74,4
48,r_0_71_162,seq88,r_113_100_107,r_113_100_107,0.7,55,162,107,4
4,r_133_118_23,r_39_211_154,r_2_93_107,r_2_93_107,0.97,22,129,107,4
57,r_98_34_80,r_30_22_185,seq107,r_98_34_80,1.0,0,80,80,4
6,r_90_73_180,seq146,seq145,r_90_73_180,0.41,0,180,180,4
62,r_164_192_186,r_94_35_187,r_95_221_16,r_164_192_186,0.31,2,188,186,4
27,r_39_211_154,r_50_66_79,r_133_118_23,r_50_66_79,0.65,0,79,79,4
148,seq125,seq112,r_67_21_79,r_67_21_79,1.0,51,130,79,4
4,r_133_118_23,seq161,r_39_211_154,r_133_118_23,0.75,0,23,23,4
2,r_117_167_78,seq170,seq177,r_117_167_78,0.76,3,81,78,4
47,r_25_165_68,r_224_114_192,seq161,r_25_165_68,1.0,0,68,68,4
74,r_26_150_106,seq178,seq88,r_26_150_106,0.89,4,110,106,4
18,r_218_176_64,r_155_138_166,seq128,r_218_176_64,0.99,-2,62,64,4
29,r_119_143_80,seq36,r_182_152_70,r_119_143_80,0.7,1,81,80,4
120,seq198,seq130,r_67_21_79,r_67_21_79,0.41,-62,17,79,4
33,r_155_138_166,seq206,seq198,r_155_138_166,0.59,2,168,166,4
64,r_216_217_108,seq85,seq147,r_216_217_108,0.96,1,109,108,4
50,r_65_220_111,r_127_196_118,seq161,r_65_220_111,0.82,3,114,111,4
58,r_52_201_124,seq210,r_106_42_6,r_52_201_124,1.0,1,125,124,4
70,r_38_63_103,seq145,r_96_187_61,r_96_187_61,1.0,2,63,61,4
32,r_191_180_77,r_188_208_174,seq5,r_191_180_77,0.96,0,77,77,4
52,r_67_21_79,seq212,seq125,r_67_21_79,0.65,-1,78,79,4
34,r_60_84_138,seq222,seq207,r_60_84_138,0.9,0,138,138,4
60,r_30_22_185,seq15,r_182_152_70,r_182_152_70,1.0,115,185,70,4
5,r_194_12_155,seq183,r_159_23_74,r_159_23_74,0.76,25,99,74,4
17,r_72_109_124,seq14,r_81_6_21,r_81_6_21,0.78,106,127,21,4
121,seq161,r_26_150_106,r_65_220_111,r_65_220_111,0.72,-12,99,111,4
9,r_173_43_76,seq178,seq4,r_173_43_76,0.92,0,76,76,4
145,seq120,r_79_142_85,r_74_44_116,r_79_142_85,0.72,15,100,85,4
22,r_102_202_63,r_185_69_2,seq47,r_102_202_63,1.0,1,64,63,4
28,r_70_184_144,seq219,r_173_43_76,r_70_184_144,0.86,0,144,144,4
13,r_116_190_17,r_133_118_23,seq46,r_116_190_17,1.0,0,17,17,4
49,r_79_142_85,seq120,r_8_162_86,r_79_142_85,0.65,5,90,85,4
149,seq213,seq203,r_132_77_101,r_132_77_101,1.0,3,104,101,4
56,r_2_93_107,r_136_48_128,r_133_118_23,r_2_93_107,0.99,-2,105,107,4
44,r_215_169_56,seq68,seq157,r_215_169_56,1.0,4,60,56,4
71,r_56_51_58,r_188_208_174,seq209,r_56_51_58,1.0,0,58,58,4
23,r_94_35_187,r_164_192_186,r_160_7_58,r_160_7_58,0.97,130,188,58,4
108,seq206,r_155_138_166,r_126_24_64,r_126_24_64,1.0,98,162,64,4
35,r_45_9_94,seq135,seq18,r_45_9_94,1.0,0,94,94,4
68,r_76_40_59,r_1_13_108,seq171,r_76_40_59,1.0,0,59,59,4
12,r_129_131_145,seq209,r_39_211_154,r_129_131_145,0.85,1,146,145,4
61,r_20_148_52,r_98_34_80,seq137,r_20_148_52,0.86,0,52,52,4
135,seq195,r_42_58_119,r_164_15_29,r_164_15_29,1.0,0,29,29,5
51,r_4_213_142,seq146,r_54_124_106,r_4_213_142,0.75,2,144,142,5
65,r_78_154_49,r_105_187_40,r_134_184_28,r_78_154_49,1.0,0,49,49,5
14,r_54_124_106,seq41,seq174,r_54_124_106,0.95,1,107,106,5
53,r_215_152_94,r_208_129_136,seq161,r_208_129_136,0.77,-42,94,136,5
58,r_71_148_181,r_100_192_20,r_22_125_126,r_71_148_181,0.71,0,181,181,5
48,r_164_15_29,r_128_209_111,seq195,r_164_15_29,0.68,1,30,29,5
43,r_194_85_121,r_97_51_190,seq166,r_194_85_121,0.9,2,123,121,5
146,seq118,r_200_123_179,seq161,r_200_123_179,0.58,-87,92,179,5
54,r_0_218_129,r_40_16_151,r_134_184_28,r_0_218_129,0.57,0,129,129,5
116,seq139,seq150,r_27_211_94,r_27_211_94,0.84,3,97,94,5
59,r_159_18_116,seq13,seq48,r_159_18_116,1.0,0,116,116,5
55,r_70_49_98,seq174,seq220,r_70_49_98,0.99,0,98,98,5
71,r_83_157_179,seq107,r_137_35_80,r_137_35_80,0.55,99,179,80,5
16,r_42_58_119,seq151,r_159_18_116,r_159_18_116,0.94,6,122,116,5
21,r_111_64_108,r_63_5_64,seq198,r_111_64_108,0.81,1,109,108,5
39,r_28_60_195,r_34_153_141,seq61,r_34_153_141,0.89,3,144,141,5
1,r_67_191_134,seq221,r_217_156_20,r_217_156_20,0.99,100,120,20,5
5,r_30_46_137,seq12,seq112,r_30_46_137,0.99,3,140,137,5
45,r_34_153_141,r_28_60_195,seq33,r_34_153_141,0.68,2,143,141,5
41,r_188_17_30,seq214,seq20,r_188_17_30,0.98,0,30,30,5
99,seq214,r_188_17_30,r_215_152_94,r_188_17_30,0.77,3,33,30,5
66,r_206_178_157,seq82,r_44_160_116,r_206_178_157,0.77,0,157,157,5
31,r_186_55_112,r_34_153_141,seq12,r_186_55_112,0.99,0,112,112,5
3,r_135_170_84,r_215_152_94,seq59,r_135_170_84,1.0,3,87,84,5
113,seq59,r_77_197_120,r_135_170_84,r_135_170_84,0.66,14,98,84,5
109,seq221,r_67_191_134,r_98_168_67,r_98_168_67,1.0,-2,65,67,5
26,r_52_162_167,seq220,r_44_160_116,r_52_162_167,0.7,3,170,167,5
72,r_190_36_117,seq108,r_134_184_28,r_190_36_117,0.81,0,117,117,5
0,r_40_16_151,r_0_218_129,r_179_76_37,r_40_16_151,0.92,-65,86,151,5
63,r_73_196_145,r_182_175_158,r_217_156_20,r_182_175_158,1.0,-13,145,158,5
25,r_120_56_29,r_176_116_193,r_38_140_22,r_120_56_29,1.0,1,30,29,5
73,r_62_130_151,r_71_148_181,r_40_16_151,r_62_130_151,0.79,0,151,151,5
11,r_23_145_2,r_212_103_151,r_100_192_20,r_23_145_2,0.88,149,151,2,5
99,seq214,r_215_152_94,seq112,r_215_152_94,0.52,28,122,94,5
107,seq45,r_44_160_116,seq109,r_44_160_116,0.95,21,137,116,5
32,r_210_127_32,r_224_9_157,r_90_132_17,r_210_127_32,0.92,0,32,32,5
15,r_117_87_101,seq21,seq12,r_117_87_101,1.0,2,103,101,5
57,r_66_222_104,seq2,seq82,r_66_222_104,1.0,0,104,104,5
117,seq198,r_95_57_153,r_111_64_108,r_111_64_108,0.97,1,109,108,5
62,r_22_125_126,r_40_16_151,seq2,r_22_125_126,0.95,2,128,126,5
85,seq13,r_181_69_189,r_201_223_73,r_201_223_73,1.0,9,82,73,5
0,r_40_16_151,r_179_76_37,r_62_130_151,r_40_16_151,1.0,2,153,151,5
33,r_90_132_17,r_75_183_46,seq11,r_90_132_17,1.0,0,17,17,5
42,r_38_140_22,r_144_122_123,seq13,r_38_140_22,0.99,2,24,22,5
10,r_179_76_37,r_40_16_151,seq80,r_40_16_151,0.98,2,153,151,5
27,r_181_69_189,seq13,r_135_170_84,r_135_170_84,0.65,105,189,84,5
19,r_75_183_46,r_28_60_195,seq29,r_75_183_46,0.86,2,48,46,5
47,r_91_89_83,seq141,seq43,r_91_89_83,1.0,0,83,83,5
142,seq189,r_202_79_144,r_50_193_5,r_202_79_144,1.0,0,144,144,5
10,r_179_76_37,r_27_211_94,r_40_16_151,r_179_76_37,0.97,4,41,37,5
40,r_204_171_90,r_186_55_112,seq139,r_204_171_90,0.69,0,90,90,5
74,r_102_180_166,seq81,r_137_35_80,r_137_35_80,0.63,86,166,80,5
18,r_173_72_119,r_208_129_136,r_215_152_94,r_208_129_136,1.0,-17,119,136,5
58,r_71_148_181,r_137_35_80,r_100_192_20,r_71_148_181,0.71,-99,82,181,5
17,r_134_184_28,r_92_147_154,seq151,r_134_184_28,1.0,2,30,28,5
137,seq106,r_208_129_136,r_144_122_123,r_208_129_136,0.92,1,137,136,5
61,r_63_5_64,r_4_213_142,seq2,r_4_213_142,0.8,-60,82,142,5
38,r_131_155_60,r_27_211_94,r_164_15_29,r_131_155_60,1.0,0,60,60,5
52,r_98_168_67,r_185_205_150,seq221,r_98_168_67,0.99,0,67,67,5
37,r_100_192_20,r_102_180_166,r_23_145_2,r_100_192_20,0.99,0,20,20,5
60,r_208_129_136,seq142,r_134_184_28,r_208_129_136,0.96,1,137,136,5
9,r_37_216_182,r_10_149_189,r_44_160_116,r_10_149_189,0.44,-7,182,189,5
22,r_136_14_129,r_50_193_5,r_182_175_158,r_50_193_5,0.37,122,127,5,5
56,r_32_177_119,seq61,r_136_14_129,r_32_177_119,0.84,1,120,119,5
7,r_27_211_94,r_182_175_158,seq139,r_27_211_94,0.53,2,96,94,5
44,r_114_94_119,seq133,r_201_223_73,r_114_94_119,0.54,4,123,119,5
12,r_137_35_80,r_71_148_181,seq169,r_137_35_80,0.99,2,82,80,5
68,r_47_39_32,r_135_170_84,seq41,r_135_170_84,0.89,-46,38,84,5
35,r_217_156_20,r_27_211_94,seq6,r_217_156_20,0.99,1,21,20,5
19,r_140_126_43,seq33,seq94,r_140_126_43,1.0,0,43,43,6
9,r_20_66_173,r_152_163_90,r_200_49_7,r_20_66_173,0.85,2,175,173,6
92,seq24,seq107,r_108_205_86,r_108_205_86,1.0,1,87,86,6
14,r_217_9_101,seq100,r_46_29_36,r_217_9_101,0.99,1,102,101,6
147,seq120,r_79_119_97,seq69,r_79_119_97,0.59,-14,83,97,6
53,r_152_163_90,seq169,r_20_66_173,r_152_163_90,0.99,0,90,90,6
146,seq118,seq160,r_138_58_60,r_138_58_60,1.0,9,69,60,6
35,r_181_4_21,r_175_213_78,seq113,r_181_4_21,0.78,-1,20,21,6
37,r_61_206_148,r_170_212_194,seq17,r_61_206_148,0.83,0,148,148,6
54,r_51_3_158,r_191_39_35,seq208,r_51_3_158,0.48,1,159,158,6
59,r_55_28_92,seq44,seq118,r_55_28_92,1.0,0,92,92,6
16,r_175_213_78,seq134,r_5_164_45,r_175_213_78,1.0,0,78,78,6
21,r_91_74_180,r_202_157_146,seq129,r_202_157_146,0.99,0,146,146,6
1,r_45_211_190,r_84_97_49,r_54_63_15,r_54_63_15,0.8,175,190,15,6
1,r_45_211_190,seq155,r_84_97_49,r_84_97_49,1.0,26,75,49,6
97,seq33,r_26_96_1,r_199_53_48,r_199_53_48,0.99,13,61,48,6
42,r_198_34_70,seq109,seq184,r_198_34_70,0.87,4,74,70,6
6,r_84_97_49,r_77_115_70,r_5_164_45,r_84_97_49,1.0,0,49,49,6
80,seq133,seq6,r_181_4_21,r_181_4_21,0.94,62,83,21,6
143,seq111,r_149_210_192,r_47_78_30,r_47_78_30,0.97,25,55,30,6
41,r_122_81_11,seq133,seq204,r_122_81_11,1.0,0,11,11,6
66,r_185_172_60,r_189_48_159,seq146,r_185_172_60,1.0,1,61,60,6
103,seq169,r_179_73_175,r_22_0_147,r_179_73_175,0.98,-1,174,175,6
50,r_131_161_42,r_162_35_77,r_135_221_20,r_131_161_42,1.0,1,43,42,6
67,r_77_115_70,seq43,seq25,r_77_115_70,1.0,1,71,70,6
54,r_51_3_158,seq160,r_191_39_35,r_51_3_158,0.58,-109,49,158,6
10,r_189_48_159,r_153_216_171,r_26_96_1,r_26_96_1,0.95,159,160,1,6
71,r_110_32_34,r_26_96_1,r_56_16_21,r_26_96_1,0.68,33,34,1,6
78,seq171,r_41_132_177,r_76_124_160,r_76_124_160,0.47,1,161,160,6
0,r_67_114_72,r_179_73_175,seq52,r_67_114_72,1.0,1,73,72,6
63,r_138_58_60,seq184,seq118,r_138_58_60,1.0,0,60,60,6
114,seq60,r_37_167_45,r_159_166_75,r_159_166_75,1.0,33,108,75,6
73,r_31_156_119,r_190_220_92,r_198_34_70,r_190_220_92,0.98,0,92,92,6
11,r_76_124_160,r_8_93_195,seq171,r_76_124_160,0.63,0,160,160,6
46,r_46_29_36,seq24,r_153_216_171,r_46_29_36,0.91,7,43,36,6
20,r_219_23_67,seq195,r_56_16_21,r_219_23_67,1.0,1,68,67,6
56,r_136_144_161,r_46_29_36,r_186_207_71,r_136_144_161,0.69,0,161,161,6
46,r_46_29_36,r_153_216_171,r_65_183_154,r_46_29_36,0.93,133,169,36,6
29,r_14_187_26,r_84_97_49,r_37_167_45,r_14_187_26,1.0,0,26,26,6
48,r_200_49_7,r_151_86_146,r_56_16_21,r_200_49_7,0.72,140,147,7,6
57,r_186_207_71,r_26_96_1,seq107,r_186_207_71,1.0,0,71,71,6
117,seq193,seq150,r_181_4_21,r_181_4_21,0.99,128,149,21,6
17,r_177_12_52,r_26_96_1,seq160,r_177_12_52,1.0,0,52,52,6
55,r_191_39_35,r_65_183_154,r_51_3_158,r_191_39_35,0.47,6,41,35,6
62,r_7_88_135,r_159_166_75,r_162_35_77,r_159_166_75,0.98,2,77,75,6
7,r_56_16_21,r_26_96_1,seq106,r_56_16_21,0.99,3,24,21,6
53,r_152_163_90,r_20_66_173,r_92_10_198,r_152_163_90,0.9,84,174,90,6
48,r_200_49_7,r_56_16_21,r_20_66_173,r_20_66_173,0.96,0,173,173,6
22,r_65_183_154,r_19_215_5,r_217_9_101,r_65_183_154,0.8,0,154,154,6
2,r_57_127_160,r_153_216_171,r_19_215_5,r_153_216_171,0.69,-7,164,171,6
47,r_202_157_146,r_91_74_180,seq196,r_202_157_146,0.98,0,146,146,6
30,r_197_209_51,seq25,seq139,r_197_209_51,1.0,0,51,51,6
105,seq44,r_55_28_92,r_104_165_197,r_55_28_92,1.0,0,92,92,6
18,r_143_222_113,r_149_210_192,seq128,r_143_222_113,0.84,0,113,113,6
25,r_224_30_113,seq36,seq68,r_224_30_113,0.93,0,113,113,6
64,r_190_220_92,r_31_156_119,r_54_63_15,r_190_220_92,1.0,0,92,92,6
145,seq113,seq133,r_181_4_21,r_181_4_21,1.0,6,27,21,6
140,seq106,seq2,r_56_16_21,r_56_16_21,1.0,8,29,21,6
69,r_142_214_34,seq107,seq160,r_142_214_34,0.85,8,42,34,6
52,r_199_53_48,r_41_132_177,seq33,r_199_53_48,1.0,1,49,48,6
58,r_79_119_97,seq120,seq168,r_79_119_97,0.78,0,97,97,6
70,r_159_166_75,r_7_88_135,seq60,r_159_166_75,0.99,1,76,75,6
68,r_41_132_177,seq17,r_57_127_160,r_41_132_177,0.55,0,177,177,6
13,r_135_221_20,r_152_163_90,r_137_62_13,r_135_221_20,0.84,0,20,20,6
61,r_194_188_76,r_61_206_148,r_162_35_77,r_194_188_76,0.84,7,83,76,6
32,r_108_205_86,r_91_74_180,seq24,r_108_205_86,0.99,1,87,86,6
38,r_151_86_146,r_200_49_7,seq33,r_151_86_146,0.5,1,147,146,6
34,r_141_1_137,r_170_212_194,r_67_114_72,r_170_212_194,0.56,-57,137,194,6
3,r_47_78_30,seq192,seq111,r_47_78_30,0.81,2,32,30,6
60,r_102_72_129,seq107,r_104_165_197,r_102_72_129,0.97,0,129,129,6
49,r_162_35_77,r_7_88_135,r_194_188_76,r_7_88_135,0.85,-24,111,135,6
112,seq184,r_138_58_60,r_198_34_70,r_138_58_60,0.99,0,60,60,6
9,r_20_66_173,seq71,r_152_163_90,r_152_163_90,0.71,1,91,90,6
22,r_65_183_154,seq134,r_19_215_5,r_65_183_154,0.35,-72,82,154,6
49,r_162_35_77,r_136_144_161,r_7_88_135,r_136_144_161,0.83,-84,77,161,6
56,r_136_144_161,r_162_35_77,r_46_29_36,r_136_144_161,0.81,-84,77,161,6
44,r_116_89_154,r_76_124_160,seq21,r_76_124_160,1.0,-34,126,160,6
118,seq195,r_219_23_67,seq123,r_219_23_67,1.0,2,69,67,6
62,r_7_88_135,r_162_35_77,r_224_30_113,r_7_88_135,1.0,0,135,135,6
55,r_191_39_35,r_51_3_158,r_177_12_52,r_191_39_35,0.47,124,159,35,6
30,r_106_75_62,r_44_190_104,r_155_24_39,r_106_75_62,0.99,0,62,62,7
55,r_8_35_33,r_104_134_100,seq43,r_104_134_100,0.64,-67,33,100,7
51,r_223_140_148,r_48_50_156,r_183_78_78,r_48_50_156,0.7,-8,148,156,7
36,r_46_201_111,r_157_60_166,r_4_52_108,r_157_60_166,0.46,-55,111,166,7
8,r_204_217_109,seq12,r_48_50_156,r_204_217_109,0.63,0,109,109,7
43,r_102_143_182,seq162,r_104_134_100,r_104_134_100,1.0,82,182,100,7
66,r_3_173_43,seq66,seq56,r_3_173_43,0.97,-2,41,43,7
54,r_10_79_99,r_200_22_139,r_108_63_43,r_10_79_99,0.84,1,100,99,7
3,r_90_9_181,seq135,r_199_156_71,r_90_9_181,0.47,0,181,181,7
59,r_220_110_159,r_30_96_113,r_81_186_193,r_30_96_113,0.92,0,113,113,7
16,r_107_0_78,r_89_73_107,seq197,r_107_0_78,1.0,1,79,78,7
21,r_76_150_129,r_165_47_188,r_80_127_33,r_165_47_188,0.77,-59,129,188,7
1,r_41_159_119,seq91,r_29_152_88,r_41_159_119,0.94,0,119,119,7
5,r_199_156_71,seq197,seq66,r_199_156_71,1.0,-2,69,71,7
42,r_171_82_107,r_30_96_113,seq67,r_171_82_107,1.0,1,108,107,7
64,r_193_116_48,r_89_73_107,seq211,r_193_116_48,1.0,1,49,48,7
32,r_80_127_33,r_90_9_181,seq169,r_80_127_33,1.0,0,33,33,7
70,r_48_50_156,r_204_217_109,r_104_134_100,r_48_50_156,0.72,10,166,156,7
20,r_215_93_146,r_204_217_109,r_108_63_43,r_215_93_146,0.9,0,146,146,7
62,r_31_49_30,r_153_7_160,seq176,r_31_49_30,1.0,0,30,30,7
19,r_30_96_113,r_220_110_159,seq214,r_30_96_113,0.85,0,113,113,7
22,r_213_207_46,r_90_9_181,seq92,r_213_207_46,1.0,0,46,46,7
31,r_14_77_168,seq64,r_80_127_33,r_14_77_168,0.69,0,168,168,7
41,r_19_168_79,r_72_202_129,seq178,r_19_168_79,0.71,-10,69,79,7
67,r_165_47_188,r_76_150_129,r_179_84_19,r_76_150_129,0.92,0,129,129,7
35,r_38_40_52,seq147,seq191,r_38_40_52,1.0,0,52,52,7
26,r_97_161_109,seq169,r_170_210_69,r_170_210_69,0.99,45,114,69,7
72,r_174_33_183,r_139_118_161,r_158_103_43,r_158_103_43,0.77,119,162,43,7
58,r_108_63_43,r_41_159_119,seq138,r_108_63_43,1.0,0,43,43,7
81,seq136,seq17,r_154_196_20,r_154_196_20,0.64,15,35,20,7
0,r_68_62_130,r_215_93_146,r_137_166_52,r_215_93_146,0.98,-16,130,146,7
63,r_183_78_78,r_204_217_109,seq147,r_204_217_109,0.95,-30,79,109,7
114,seq57,r_185_198_163,r_80_127_33,r_80_127_33,0.75,99,132,33,7
11,r_105_87_130,seq147,r_10_79_99,r_10_79_99,0.87,31,130,99,7
68,r_175_203_10,r_179_84_19,r_121_184_1,r_175_203_10,1.0,0,10,10,7
20,r_215_93_146,r_68_62_130,r_204_217_109,r_215_93_146,0.63,-15,131,146,7
13,r_148_195_71,r_104_134_100,seq61,r_148_195_71,0.77,-2,69,71,7
59,r_220_110_159,r_81_186_193,r_204_217_109,r_220_110_159,0.82,7,166,159,7
15,r_89_73_107,r_185_198_163,r_157_60_166,r_89_73_107,1.0,0,107,107,7
48,r_151_114_178,seq39,r_2_37_72,r_2_37_72,1.0,36,108,72,7
12,r_158_103_43,r_174_33_183,r_69_58_85,r_69_58_85,0.93,98,183,85,7
6,r_69_58_85,r_4_52_108,r_121_184_1,r_121_184_1,1.0,84,85,1,7
46,r_155_24_39,seq180,seq129,r_155_24_39,1.0,0,39,39,7
17,r_131_163_49,r_11_142_56,seq27,r_131_163_49,1.0,0,49,49,7
73,r_154_196_20,r_200_22_139,seq136,r_154_196_20,0.87,0,20,20,7
12,r_158_103_43,seq26,r_174_33_183,r_158_103_43,0.85,-2,41,43,7
2,r_104_134_100,seq162,seq176,r_104_134_100,0.99,0,100,100,7
10,r_36_25_29,r_74_70_135,seq209,r_36_25_29,0.98,0,29,29,7
40,r_153_7_160,r_121_184_1,seq100,r_153_7_160,0.52,4,164,160,7
29,r_139_118_161,r_174_33_183,r_104_134_100,r_139_118_161,0.51,2,163,161,7
67,r_165_47_188,r_179_84_19,r_148_195_71,r_148_195_71,0.52,112,183,71,7
53,r_121_184_1,r_153_7_160,r_175_203_10,r_175_203_10,0.98,15,25,10,7
25,r_2_37_72,r_74_70_135,seq197,r_2_37_72,0.99,0,72,72,7
33,r_187_128_173,seq61,r_19_168_79,r_19_168_79,0.96,98,177,79,7
48,r_151_114_178,r_2_37_72,r_90_9_181,r_151_114_178,0.65,-2,176,178,7
94,seq28,seq17,r_154_196_20,r_154_196_20,0.59,36,56,20,7
50,r_4_52_108,seq162,r_121_184_1,r_4_52_108,0.99,0,108,108,7
70,r_48_50_156,r_223_140_148,r_204_217_109,r_204_217_109,0.53,7,116,109,7
65,r_72_202_129,r_157_60_166,r_107_0_78,r_72_202_129,0.55,1,130,129,7
39,r_11_142_56,r_223_140_148,seq65,r_11_142_56,1.0,1,57,56,7
61,r_222_71_98,seq176,seq214,r_222_71_98,1.0,-2,96,98,7
52,r_167_101_170,r_121_184_1,r_14_77_168,r_167_101_170,0.77,0,170,170,7
113,seq56,r_13_20_121,r_3_173_43,r_3_173_43,1.0,-2,41,43,7
34,r_144_51_63,r_204_217_109,r_3_173_43,r_144_51_63,1.0,0,63,63,7
94,seq28,r_157_60_166,r_174_33_183,r_174_33_183,0.78,1,184,183,7
60,r_55_85_153,seq178,seq64,r_55_85_153,0.89,1,154,153,7
119,seq65,r_123_42_165,r_11_142_56,r_11_142_56,0.97,7,63,56,7
72,r_174_33_183,r_158_103_43,seq28,r_174_33_183,0.99,0,183,183,7
27,r_137_166_52,seq212,seq132,r_137_166_52,1.0,1,53,52,7
102,seq39,r_151_114_178,r_2_37_72,r_2_37_72,1.0,25,97,72,7
49,r_29_152_88,r_123_42_165,r_216_126_16,r_29_152_88,1.0,1,89,88,7
4,r_221_34_16,r_3_173_43,seq133,r_221_34_16,0.97,0,16,16,7
23,r_1_119_81,seq45,seq172,r_1_119_81,1.0,1,82,81,7
8,r_204_217_109,r_48_50_156,r_220_110_159,r_204_217_109,0.97,56,165,109,7
3,r_90_9_181,r_213_207_46,seq135,r_213_207_46,0.97,-9,37,46,7
93,seq176,r_93_167_163,r_211_160_27,r_93_167_163,0.92,1,164,163,8
14,r_169_155_29,seq116,seq55,r_169_155_29,1.0,0,29,29,8
26,r_87_75_26,r_19_32_90,seq74,r_87_75_26,0.99,1,27,26,8
91,seq28,r_207_212_59,r_217_66_17,r_207_212_59,1.0,0,59,59,8
36,r_121_12_93,seq157,r_33_151_11,r_121_12_93,1.0,0,93,93,8
147,seq123,r_43_15_159,r_64_114_46,r_64_114_46,0.93,113,159,46,8
58,r_8_104_139,r_109_164_14,seq98,r_8_104_139,0.42,0,139,139,8
3,r_63_137_28,r_120_4_45,seq70,r_63_137_28,0.61,-2,26,28,8
37,r_136_51_82,r_96_198_127,seq116,r_96_198_127,0.83,-45,82,127,8
59,r_165_69_123,seq124,seq61,r_165_69_123,0.98,0,123,123,8
19,r_159_99_8,seq55,seq214,r_159_99_8,0.51,71,79,8,8
55,r_67_38_135,seq83,seq157,r_67_38_135,0.5,0,135,135,8
16,r_30_175_62,r_121_12_93,seq0,r_30_175_62,1.0,0,62,62,8
21,r_156_115_128,seq91,r_165_69_123,r_165_69_123,0.98,7,130,123,8
39,r_23_135_107,seq178,r_136_51_82,r_23_135_107,1.0,0,107,107,8
1,r_43_15_159,seq123,seq112,r_43_15_159,0.77,0,159,159,8
46,r_125_133_81,r_202_199_109,seq10,r_125_133_81,1.0,0,81,81,8
42,r_180_58_141,seq86,seq78,r_180_58_141,0.81,0,141,141,8
120,seq77,seq24,r_26_36_26,r_26_36_26,1.0,13,39,26,8
69,r_5_65_131,seq17,seq22,r_5_65_131,0.57,4,135,131,8
15,r_50_45_43,r_96_198_127,r_127_206_77,r_50_45_43,0.96,72,115,43,8
40,r_209_153_38,r_8_104_139,seq78,r_209_153_38,0.98,0,38,38,8
66,r_105_130_70,r_93_167_163,r_139_218_58,r_105_130_70,1.0,0,70,70,8
38,r_109_164_14,r_8_104_139,seq216,r_8_104_139,0.47,5,144,139,8
117,seq73,seq84,r_142_168_24,r_142_168_24,0.69,13,37,24,8
103,seq178,r_23_135_107,r_8_104_139,r_23_135_107,0.97,0,107,107,8
58,r_8_104_139,seq216,r_109_164_14,r_109_164_14,1.0,0,14,14,8
11,r_188_154_27,seq132,seq95,r_188_154_27,1.0,0,27,27,8
10,r_113_221_106,r_29_195_164,r_125_133_81,r_113_221_106,0.98,0,106,106,8
5,r_144_145_191,r_120_4_45,r_211_160_27,r_120_4_45,1.0,-12,33,45,8
115,seq197,r_165_69_123,r_82_224_109,r_165_69_123,0.64,-10,113,123,8
72,r_202_199_109,seq184,r_127_206_77,r_202_199_109,0.99,0,109,109,8
38,r_109_164_14,seq166,r_8_104_139,r_109_164_14,1.0,0,14,14,8
28,r_187_186_45,r_19_32_90,r_217_66_17,r_187_186_45,1.0,2,47,45,8
0,r_171_191_76,r_53_143_92,r_217_66_17,r_53_143_92,1.0,-16,76,92,8
63,r_131_54_116,seq60,r_188_154_27,r_131_54_116,0.66,0,116,116,8
20,r_93_167_163,seq176,seq60,r_93_167_163,0.94,1,164,163,8
30,r_138_20_26,r_30_175_62,seq106,r_30_175_62,0.56,-36,26,62,8
48,r_41_222_100,seq24,r_71_101_2,r_41_222_100,0.99,0,100,100,8
57,r_173_119_65,seq17,seq49,r_173_119_65,1.0,1,66,65,8
106,seq181,r_102_146_144,seq190,r_102_146_144,1.0,0,144,144,8
62,r_35_205_153,seq140,r_87_75_26,r_35_205_153,0.93,1,154,153,8
15,r_50_45_43,r_131_54_116,r_96_198_127,r_50_45_43,1.0,0,43,43,8
41,r_26_36_26,r_96_198_127,seq77,r_26_36_26,1.0,0,26,26,8
121,seq78,r_209_153_38,r_180_58_141,r_180_58_141,1.0,10,151,141,8
47,r_11_80_109,seq214,r_173_119_65,r_11_80_109,1.0,1,110,109,8
33,r_193_170_30,seq178,seq124,r_193_170_30,1.0,0,30,30,8
32,r_100_89_27,r_171_191_76,seq68,r_100_89_27,0.92,0,27,27,8
74,r_213_47_104,seq129,seq147,r_213_47_104,1.0,1,105,104,8
24,r_96_198_127,seq86,r_87_75_26,r_96_198_127,0.99,0,127,127,8
64,r_57_163_101,seq34,seq60,r_57_163_101,0.83,0,101,101,8
88,seq22,seq129,r_5_65_131,r_5_65_131,0.78,5,136,131,8
73,r_88_183_32,seq106,seq0,r_88_183_32,1.0,0,32,32,8
2,r_64_114_46,r_172_13_179,seq123,r_64_114_46,1.0,0,46,46,8
70,r_72_16_78,seq14,r_173_119_65,r_72_16_78,1.0,1,79,78,8
65,r_29_195_164,seq215,r_136_51_82,r_29_195_164,0.75,0,164,164,8
97,seq166,r_109_164_14,r_107_42_60,r_109_164_14,0.79,-1,13,14,8
25,r_33_151_11,seq37,seq78,r_33_151_11,1.0,-1,10,11,8
68,r_39_203_153,seq62,r_82_224_109,r_82_224_109,0.67,56,165,109,8
61,r_102_146_144,seq181,r_120_4_45,r_102_146_144,0.84,0,144,144,8
52,r_182_79_146,seq46,r_30_175_62,r_30_175_62,0.82,84,146,62,8
34,r_107_42_60,seq103,seq166,r_107_42_60,0.88,0,60,60,8
60,r_128_94_144,r_93_167_163,r_44_40_94,r_93_167_163,0.89,-19,144,163,8
31,r_139_218_58,r_102_146_144,seq86,r_139_218_58,1.0,0,58,58,8
7,r_142_168_24,r_141_162_150,seq73,r_142_168_24,0.48,-3,21,24,8
17,r_53_143_92,r_171_191_76,seq7,r_53_143_92,1.0,0,92,92,8
25,r_33_151_11,seq78,r_121_12_93,r_121_12_93,1.0,0,93,93,8
121,seq78,r_19_32_90,r_209_153_38,r_209_153_38,0.99,53,91,38,8
9,r_44_40_94,seq129,seq140,r_44_40_94,0.97,0,94,94,8
12,r_207_212_59,seq28,seq91,r_207_212_59,0.95,0,59,59,8
22,r_185_59_136,seq157,seq55,r_185_59_136,1.0,0,136,136,8
135,seq98,seq84,r_8_104_139,r_8_104_139,0.94,13,152,139,8
49,r_1_56_117,seq68,seq24,r_1_56_117,0.99,0,117,117,8
67,r_192_6_45,r_173_119_65,seq215,r_192_6_45,1.0,0,45,45,8
4,r_120_4_45,r_165_69_123,seq111,r_120_4_45,0.96,0,45,45,8
56,r_127_206_77,r_141_162_150,r_50_45_43,r_127_206_77,0.55,0,77,77,8
44,r_82_224_109,r_213_47_104,seq197,r_213_47_104,0.9,1,105,104,8
131,seq91,r_156_115_128,r_207_212_59,r_207_212_59,1.0,71,130,59,8
23,r_9_90_63,seq84,r_26_36_26,r_26_36_26,0.68,37,63,26,8
35,r_211_160_27,r_30_175_62,seq176,r_30_175_62,1.0,-31,31,62,8
51,r_3_31_27,r_1_56_117,r_171_191_76,r_3_31_27,1.0,0,27,27,8
30,r_48_123_81,r_178_41_113,r_171_38_82,r_178_41_113,0.58,-29,84,113,9
36,r_211_50_149,seq222,r_118_101_37,r_118_101_37,0.53,113,150,37,9
101,seq166,r_210_45_186,r_3_158_142,r_3_158_142,0.7,-6,136,142,9
14,r_66_103_39,r_69_55_113,r_186_5_109,r_66_103_39,0.98,77,116,39,9
48,r_120_184_12,r_147_79_102,seq124,r_120_184_12,0.91,0,12,12,9
37,r_159_216_117,seq68,r_22_54_192,r_159_216_117,1.0,0,117,117,9
59,r_51_191_96,r_177_156_113,r_80_150_22,r_51_191_96,0.59,19,115,96,9
25,r_75_181_38,r_198_212_105,r_186_5_109,r_75_181_38,0.96,2,40,38,9
1,r_11_57_18,r_3_158_142,r_82_218_132,r_11_57_18,0.84,112,130,18,9
143,seq107,r_81_83_6,r_162_208_132,r_162_208_132,0.98,0,132,132,9
13,r_126_21_41,seq144,seq182,r_126_21_41,0.86,0,41,41,9
120,seq199,seq30,r_189_34_35,r_189_34_35,0.54,17,52,35,9
80,seq6,r_188_137_184,r_48_123_81,r_48_123_81,0.92,94,175,81,9
7,r_135_99_14,r_207_36_133,r_177_156_113,r_135_99_14,0.76,119,133,14,9
69,r_185_223_127,r_174_86_132,r_8_167_124,r_185_223_127,0.75,2,129,127,9
45,r_7_183_94,seq0,seq24,r_7_183_94,1.0,1,95,94,9
19,r_3_158_142,r_157_155_146,r_210_45_186,r_3_158_142,0.82,0,142,142,9
16,r_82_218_132,seq20,r_118_101_37,r_118_101_37,0.58,1,38,37,9
38,r_116_175_101,r_48_123_81,r_69_55_113,r_48_123_81,0.67,61,142,81,9
100,seq165,r_7_183_94,r_56_204_191,r_56_204_191,0.54,-116,75,191,9
31,r_188_137_184,seq6,r_118_101_37,r_118_101_37,0.69,147,184,37,9
67,r_132_67_175,r_62_40_179,r_135_99_14,r_135_99_14,0.94,161,175,14,9
50,r_173_2_41,r_87_28_43,r_174_86_132,r_173_2_41,0.6,0,41,41,9
3,r_16_19_91,seq95,seq68,r_16_19_91,1.0,2,93,91,9
26,r_105_77_164,r_174_86_132,seq60,r_174_86_132,0.57,34,166,132,9
8,r_146_141_38,r_180_164_155,seq52,r_180_164_155,1.0,-32,123,155,9
72,r_163_112_137,r_49_160_5,seq151,r_163_112_137,0.81,0,137,137,9
16,r_82_218_132,r_118_101_37,r_11_57_18,r_82_218_132,0.7,0,132,132,9
4,r_198_212_105,r_3_158_142,r_113_100_48,r_3_158_142,0.97,-37,105,142,9
21,r_76_154_12,r_157_155_146,seq14,r_76_154_12,0.92,1,13,12,9
0,r_177_156_113,r_37_108_147,seq15,r_177_156_113,0.94,4,117,113,9
73,r_207_36_133,seq15,r_135_99_14,r_135_99_14,0.46,47,61,14,9
11,r_12_33_162,r_91_90_199,r_115_219_136,r_91_90_199,0.46,-37,162,199,9
20,r_22_54_192,r_180_164_155,r_159_216_117,r_159_216_117,0.73,38,155,117,9
15,r_180_164_155,r_22_54_192,seq47,r_180_164_155,0.67,0,155,155,9
49,r_1_31_39,seq6,r_75_181_38,r_1_31_39,0.44,148,187,39,9
57,r_157_155_146,r_3_158_142,seq194,r_157_155_146,0.75,-2,144,146,9
18,r_129_58_97,r_65_42_66,r_133_170_140,r_65_42_66,0.73,-9,57,66,9
6,r_162_208_132,r_70_172_142,seq107,r_162_208_132,0.81,3,135,132,9
141,seq104,r_133_170_140,r_70_172_142,r_133_170_140,0.55,1,141,140,9
134,seq222,r_211_50_149,r_215_109_24,r_211_50_149,0.98,1,150,149,9
117,seq194,seq192,r_157_155_146,r_157_155_146,0.96,12,158,146,9
71,r_118_101_37,seq52,r_82_218_132,r_118_101_37,1.0,0,37,37,9
49,r_1_31_39,r_39_201_196,seq6,r_1_31_39,0.99,0,39,39,9
2,r_65_42_66,seq72,seq199,r_65_42_66,0.73,1,67,66,9
47,r_171_38_82,seq127,r_48_123_81,r_171_38_82,0.83,2,84,82,9
117,seq194,r_87_28_43,seq192,r_87_28_43,0.99,0,43,43,9
109,seq52,r_118_101_37,r_22_54_192,r_118_101_37,0.98,0,37,37,9
74,r_111_18_102,seq89,seq85,r_111_18_102,0.63,1,103,102,9
17,r_110_139_17,r_87_28_43,seq106,r_110_139_17,0.88,0,17,17,9
34,r_87_28_43,seq194,seq13,r_87_28_43,1.0,0,43,43,9
33,r_10_149_86,r_207_36_133,r_173_2_41,r_10_149_86,0.59,1,87,86,9
64,r_178_41_113,seq13,r_66_103_39,r_178_41_113,0.96,3,116,113,9
65,r_210_45_186,r_116_175_101,seq166,r_116_175_101,0.8,0,101,101,9
18,r_129_58_97,r_133_170_140,seq73,r_129_58_97,0.53,-3,94,97,9
66,r_200_92_53,seq136,r_80_150_22,r_200_92_53,1.0,0,53,53,9
61,r_69_55_113,seq122,r_116_175_101,r_69_55_113,1.0,4,117,113,9
38,r_116_175_101,r_210_45_186,r_48_123_81,r_116_175_101,0.82,0,101,101,9
71,r_118_101_37,r_82_218_132,r_211_50_149,r_118_101_37,0.69,95,132,37,9
39,r_113_100_48,seq63,seq209,r_113_100_48,1.0,3,51,48,9
7,r_135_99_14,r_129_58_97,r_207_36_133,r_135_99_14,0.87,-1,13,14,9
109,seq52,r_22_54_192,r_146_141_38,r_22_54_192,0.53,-18,174,192,9
65,r_210_45_186,r_3_158_142,r_93_114_19,r_210_45_186,0.96,-3,183,186,9
60,r_8_167_124,seq143,seq192,r_8_167_124,0.98,0,124,124,9
111,seq182,r_12_33_162,r_126_21_41,r_126_21_41,0.47,0,41,41,9
19,r_3_158_142,r_210_45_186,seq166,r_210_45_186,0.91,-3,183,186,9
25,r_75_181_38,r_186_5_109,r_197_190_9,r_186_5_109,1.0,0,109,109,9
121,seq72,r_59_74_85,seq169,r_59_74_85,0.82,7,92,85,9
9,r_59_74_85,seq72,r_93_114_19,r_59_74_85,0.6,2,87,85,9
22,r_62_40_179,seq140,r_12_33_162,r_12_33_162,0.74,18,180,162,9
101,seq166,r_146_141_38,r_210_45_186,r_146_141_38,1.0,0,38,38,9
28,r_174_86_132,r_185_223_127,r_177_156_113,r_174_86_132,0.86,-3,129,132,9
73,r_207_36_133,r_135_99_14,seq169,r_207_36_133,0.9,0,133,133,9
102,seq169,r_56_204_191,r_48_123_81,r_48_123_81,1.0,74,155,81,9
100,seq165,r_56_204_191,r_147_79_102,r_147_79_102,0.57,4,106,102,9
40,r_80_150_22,seq15,seq4,r_80_150_22,0.97,-1,21,22,9
54,r_93_114_19,r_126_21_41,seq63,r_93_114_19,0.81,-1,18,19,9
8,r_146_141_38,seq166,r_180_164_155,r_146_141_38,0.93,0,38,38,9
56,r_37_108_147,seq23,r_215_109_24,r_37_108_147,0.81,3,150,147,9
32,r_168_213_52,r_56_204_191,r_187_43_6,r_168_213_52,0.95,0,52,52,9
65,r_210_45_186,seq166,r_3_158_142,r_3_158_142,0.96,-3,139,142,9
23,r_147_79_102,r_210_45_186,seq165,r_147_79_102,0.97,2,104,102,9
41,r_189_34_35,seq161,seq199,r_189_34_35,0.86,5,40,35,9
35,r_115_219_136,r_12_33_162,seq17,r_115_219_136,0.43,0,136,136,9
12,r_94_202_174,seq199,r_162_208_132,r_162_208_132,0.51,43,175,132,9
21,r_169_26_55,seq28,r_191_172_14,r_169_26_55,1.0,-1,54,55,10
51,r_174_167_187,seq53,r_124_135_165,r_124_135_165,0.61,22,187,165,10
5,r_142_74_51,r_131_157_155,r_222_70_110,r_142_74_51,1.0,0,51,51,10
124,seq75,r_215_101_4,r_47_5_81,r_47_5_81,1.0,0,81,81,10
14,r_63_129_103,seq3,r_65_11_166,r_63_129_103,1.0,0,103,103,10
8,r_21_92_144,r_174_167_187,r_169_26_55,r_174_167_187,0.59,-43,144,187,10
16,r_200_168_9,r_187_108_146,seq98,r_200_168_9,0.91,1,10,9,10
53,r_41_127_138,seq1,r_137_99_58,r_137_99_58,1.0,96,154,58,10
58,r_131_157_155,seq163,r_88_156_115,r_131_157_155,0.97,0,155,155,10
43,r_115_49_95,r_63_129_103,r_64_130_86,r_63_129_103,0.68,-8,95,103,10
54,r_22_133_125,seq218,seq62,r_22_133_125,0.99,1,126,125,10
37,r_71_96_98,seq57,r_169_26_55,r_71_96_98,1.0,0,98,98,10
59,r_93_95_98,r_4_158_189,seq223,r_93_95_98,0.96,0,98,98,10
55,r_111_211_26,r_159_186_31,r_203_60_43,r_111_211_26,0.82,45,71,26,10
111,seq58,r_137_99_58,seq62,r_137_99_58,1.0,-5,53,58,10
46,r_76_14_188,seq8,r_97_118_120,r_76_14_188,0.49,0,188,188,10
42,r_117_150_102,r_84_102_163,seq217,r_117_150_102,1.0,1,103,102,10
66,r_213_91_19,r_29_192_54,r_222_70_110,r_29_192_54,1.0,1,55,54,10
69,r_132_40_80,seq122,seq196,r_132_40_80,1.0,1,81,80,10
15,r_155_89_66,r_209_171_145,r_7_148_133,r_7_148_133,1.0,4,137,133,10
31,r_208_51_125,r_81_25_137,seq57,r_81_25_137,0.68,-11,126,137,10
129,seq82,r_52_100_170,r_90_134_17,r_90_134_17,0.79,153,170,17,10
67,r_126_48_175,seq98,r_213_91_19,r_126_48_175,0.74,1,176,175,10
10,r_97_118_120,seq16,r_154_59_6,r_97_118_120,0.89,3,123,120,10
124,seq75,seq206,r_215_101_4,r_215_101_4,0.89,15,19,4,10
72,r_7_148_133,seq217,r_155_89_66,r_7_148_133,0.98,1,134,133,10
92,seq33,seq177,r_29_192_54,r_29_192_54,1.0,0,54,54,10
63,r_52_100_170,seq82,seq112,r_52_100_170,0.61,0,170,170,10
114,seq193,r_116_106_153,r_13_73_135,r_116_106_153,0.94,0,153,153,10
73,r_197_160_137,r_12_149_138,seq28,r_197_160_137,0.77,0,137,137,10
129,seq82,r_90_134_17,r_119_165_182,r_119_165_182,0.86,0,182,182,10
107,seq53,r_174_167_187,r_97_118_120,r_97_118_120,1.0,66,186,120,10
20,r_47_5_81,seq161,seq75,r_47_5_81,0.96,0,81,81,10
13,r_68_2_171,r_65_11_166,seq190,r_68_2_171,0.55,0,171,171,10
15,r_155_89_66,r_203_60_43,r_209_171_145,r_155_89_66,1.0,1,67,66,10
57,r_116_106_153,seq193,r_85_18_24,r_116_106_153,0.57,0,153,153,10
117,seq196,seq166,r_132_40_80,r_132_40_80,1.0,43,123,80,10
70,r_159_186_31,r_179_42_54,seq50,r_179_42_54,1.0,-32,22,54,10
6,r_88_156_115,r_12_149_138,r_180_152_11,r_180_152_11,0.68,111,122,11,10
99,seq43,seq178,r_187_108_146,r_187_108_146,0.99,2,148,146,10
45,r_180_152_11,r_6_78_18,seq0,r_180_152_11,0.94,0,11,11,10
134,seq223,r_162_199_29,r_137_99_58,r_137_99_58,1.0,11,69,58,10
27,r_219_188_182,r_64_130_86,seq8,r_219_188_182,0.56,-112,70,182,10
58,r_131_157_155,r_142_74_51,seq163,r_142_74_51,1.0,2,53,51,10
25,r_36_31_35,r_142_74_51,r_162_199_29,r_36_31_35,1.0,-1,34,35,10
2,r_222_70_110,seq79,r_213_91_19,r_213_91_19,1.0,57,76,19,10
40,r_81_25_137,seq82,r_115_49_95,r_81_25_137,0.98,0,137,137,10
29,r_119_165_182,seq69,r_182_104_181,r_119_165_182,0.52,1,183,182,10
127,seq79,r_222_70_110,r_121_143_12,r_121_143_12,1.0,2,14,12,10
33,r_187_108_146,seq1,seq43,r_187_108_146,0.97,0,146,146,10
86,seq19,r_84_102_163,r_179_42_54,r_179_42_54,1.0,0,54,54,10
64,r_77_214_164,seq164,r_61_220_147,r_77_214_164,0.75,0,164,164,10
65,r_209_171_145,r_155_89_66,seq3,r_209_171_145,0.52,5,150,145,10
88,seq201,r_10_153_165,r_185_37_72,r_185_37_72,1.0,93,165,72,10
11,r_90_134_17,r_21_92_144,seq38,r_90_134_17,0.95,0,17,17,10
50,r_212_17_113,seq80,seq1,r_212_17_113,1.0,1,114,113,10
65,r_209_171_145,seq75,r_155_89_66,r_155_89_66,1.0,11,77,66,10
35,r_162_199_29,seq223,seq33,r_162_199_29,0.71,0,29,29,10
61,r_182_104_181,r_204_27_180,r_119_165_182,r_182_104_181,0.45,0,181,181,10
32,r_185_37_72,seq75,seq181,r_185_37_72,1.0,0,72,72,10
48,r_210_9_19,seq15,seq181,r_210_9_19,1.0,0,19,19,10
52,r_23_105_73,seq58,r_65_11_166,r_23_105_73,0.76,1,74,73,10
36,r_189_45_198,r_21_92_144,r_203_60_43,r_21_92_144,0.55,-102,42,144,10
74,r_137_99_58,seq58,seq223,r_137_99_58,1.0,0,58,58,10
24,r_85_18_24,r_29_192_54,seq3,r_29_192_54,0.96,-31,23,54,10
30,r_203_60_43,r_155_89_66,r_111_211_26,r_155_89_66,1.0,-23,43,66,10
112,seq62,r_23_105_73,r_22_133_125,r_22_133_125,1.0,0,125,125,10
9,r_87_56_189,seq161,r_97_118_120,r_97_118_120,0.62,69,189,120,10
66,r_213_91_19,seq34,r_29_192_54,r_213_91_19,0.83,0,19,19,10
3,r_29_192_54,r_213_91_19,seq33,r_29_192_54,1.0,1,55,54,10
22,r_35_125_66,r_13_73_135,seq166,r_35_125_66,1.0,0,66,66,10
62,r_179_42_54,r_159_186_31,seq19,r_179_42_54,1.0,0,54,54,10
60,r_121_143_12,r_124_135_165,seq79,r_121_143_12,0.96,0,12,12,10
28,r_13_73_135,seq112,seq193,r_13_73_135,0.57,2,137,135,10
49,r_64_130_86,r_219_188_182,r_115_49_95,r_64_130_86,0.94,11,97,86,10
3,r_29_192_54,r_85_18_24,r_213_91_19,r_213_91_19,0.93,0,19,19,10
7,r_10_153_165,seq201,r_121_143_12,r_10_153_165,0.74,0,165,165,10
44,r_107_66_99,r_208_51_125,r_151_24_70,r_107_66_99,1.0,0,99,99,10
23,r_84_102_163,seq19,seq38,r_84_102_163,0.81,0,163,163,10
12,r_207_221_72,r_76_14_188,seq161,r_207_221_72,1.0,0,72,72,10
68,r_120_86_43,seq33,seq44,r_120_86_43,1.0,0,43,43,10
100,seq44,r_61_220_147,r_120_86_43,r_120_86_43,1.0,0,43,43,10
30,r_153_58_118,r_18_191_134,r_154_61_182,r_154_61_182,0.86,-64,118,182,11
51,r_44_148_100,r_130_38_77,seq126,r_44_148_100,0.6,-2,98,100,11
50,r_138_212_49,seq9,r_31_54_20,r_138_212_49,0.99,0,49,49,11
14,r_15_4_79,r_169_206_184,seq134,r_15_4_79,1.0,1,80,79,11
147,seq123,r_108_11_88,r_21_162_66,r_21_162_66,1.0,49,115,66,11
8,r_180_223_90,seq142,seq106,r_180_223_90,1.0,0,90,90,11
53,r_83_172_75,seq63,r_43_202_71,r_83_172_75,1.0,-2,73,75,11
43,r_173_75_22,r_105_135_179,r_124_96_27,r_124_96_27,0.74,153,180,27,11
54,r_21_162_66,seq63,seq123,r_21_162_66,1.0,0,66,66,11
37,r_94_181_175,r_108_11_88,r_15_4_79,r_94_181_175,0.37,0,175,175,11
59,r_128_37_188,r_147_85_170,r_130_38_77,r_147_85_170,0.89,1,171,170,11
16,r_147_85_170,r_128_37_188,seq41,r_128_37_188,0.36,-17,171,188,11
1,r_100_197_170,r_48_95_166,r_79_55_2,r_100_197_170,0.57,1,171,170,11
143,seq115,r_68_158_184,r_198_87_78,r_198_87_78,1.0,106,184,78,11
5,r_198_87_78,r_99_146_124,seq3,r_198_87_78,0.93,2,80,78,11
46,r_88_102_178,r_109_57_146,seq113,r_109_57_146,0.81,1,147,146,11
70,r_177_42_8,r_180_223_90,seq72,r_177_42_8,0.77,32,40,8,11
69,r_29_205_145,r_220_17_181,r_43_202_71,r_43_202_71,1.0,13,84,71,11
45,r_118_210_92,r_68_158_184,seq199,r_118_210_92,0.98,0,92,92,11
19,r_109_57_146,r_88_102_178,seq168,r_109_57_146,0.76,1,147,146,11
66,r_201_136_140,seq101,r_130_38_77,r_201_136_140,0.5,9,149,140,11
64,r_99_146_124,seq131,r_130_38_77,r_99_146_124,1.0,1,125,124,11
38,r_114_211_13,r_60_78_164,r_44_148_100,r_60_78_164,0.52,0,164,164,11
31,r_33_164_71,r_13_176_72,seq161,r_33_164_71,1.0,0,71,71,11
10,r_28_213_122,seq113,seq26,r_28_213_122,0.98,0,122,122,11
26,r_219_39_143,seq41,r_118_210_92,r_118_210_92,0.9,55,147,92,11
72,r_1_175_177,seq106,r_130_38_77,r_130_38_77,0.75,100,177,77,11
78,seq5,seq101,r_130_38_77,r_130_38_77,0.38,14,91,77,11
63,r_157_174_111,seq69,seq104,r_157_174_111,0.85,1,112,111,11
56,r_179_51_43,seq71,r_108_11_88,r_179_51_43,1.0,-1,42,43,11
20,r_13_176_72,r_33_164_71,r_12_183_28,r_13_176_72,0.95,-1,71,72,11
13,r_186_221_153,r_108_11_88,r_190_195_70,r_190_195_70,0.18,83,153,70,11
98,seq41,r_219_39_143,r_190_195_70,r_190_195_70,0.99,77,147,70,11
48,r_90_84_90,seq34,r_108_11_88,r_90_84_90,1.0,0,90,90,11
57,r_190_195_70,r_163_182_193,r_40_2_7,r_190_195_70,1.0,0,70,70,11
117,seq69,r_157_174_111,seq193,r_157_174_111,0.96,1,112,111,11
70,r_177_42_8,seq133,r_180_223_90,r_177_42_8,0.38,14,22,8,11
6,r_203_103_64,r_21_162_66,seq117,r_203_103_64,1.0,0,64,64,11
7,r_124_96_27,r_130_38_77,seq63,r_124_96_27,0.99,-2,25,27,11
71,r_49_218_32,r_130_38_77,r_40_2_7,r_49_218_32,1.0,-1,31,32,11
36,r_12_183_28,r_68_158_184,r_13_176_72,r_13_176_72,0.79,30,102,72,11
38,r_114_211_13,r_100_197_170,r_60_78_164,r_114_211_13,1.0,0,13,13,11
148,seq126,r_60_78_164,r_44_148_100,r_60_78_164,0.54,-63,101,164,11
30,r_153_58_118,r_154_61_182,r_43_202_71,r_154_61_182,0.95,3,185,182,11
36,r_12_183_28,seq76,r_68_158_184,r_12_183_28,0.8,-1,27,28,11
69,r_29_205_145,r_43_202_71,r_44_148_100,r_29_205_145,0.93,1,146,145,11
142,seq113,r_28_213_122,r_109_57_146,r_28_213_122,0.8,-47,75,122,11
74,r_116_171_124,r_109_57_146,r_130_38_77,r_116_171_124,0.91,0,124,124,11
18,r_220_17_181,r_154_61_182,r_130_38_77,r_130_38_77,0.72,104,181,77,11
29,r_97_224_75,r_186_221_153,seq142,r_97_224_75,1.0,-1,74,75,11
24,r_8_107_122,seq69,seq3,r_8_107_122,0.97,1,123,122,11
25,r_151_122_44,seq140,seq91,r_151_122_44,1.0,0,44,44,11
64,r_99_146_124,r_198_87_78,seq131,r_198_87_78,0.95,2,80,78,11
65,r_40_2_7,r_139_62_136,r_190_195_70,r_40_2_7,0.83,67,74,7,11
58,r_23_32_122,seq168,seq7,r_23_32_122,0.97,1,123,122,11
68,r_204_45_104,r_6_141_143,seq117,r_204_45_104,1.0,1,105,104,11
32,r_145_166_117,seq53,seq20,r_145_166_117,0.98,0,117,117,11
52,r_170_27_130,seq126,r_177_42_8,r_170_27_130,0.83,2,132,130,11
21,r_121_24_51,seq26,r_12_183_28,r_121_24_51,0.97,0,51,51,11
70,r_177_42_8,seq72,r_97_224_75,r_97_224_75,0.68,24,99,75,11
17,r_105_135_179,r_173_75_22,r_169_206_184,r_173_75_22,0.76,162,184,22,11
22,r_194_47_50,seq25,r_79_55_2,r_194_47_50,0.99,0,50,50,11
42,r_144_215_40,r_110_67_113,seq86,r_110_67_113,0.59,-74,39,113,11
89,seq26,r_121_24_51,r_108_11_88,r_121_24_51,1.0,0,51,51,11
70,r_177_42_8,r_97_224_75,r_170_27_130,r_177_42_8,0.85,124,132,8,11
60,r_60_78_164,seq126,r_114_211_13,r_114_211_13,1.0,11,24,13,11
28,r_43_202_71,seq34,r_83_172_75,r_43_202_71,1.0,0,71,71,11
59,r_128_37_188,r_130_38_77,r_189_178_125,r_128_37_188,0.96,0,188,188,11
49,r_110_67_113,seq3,r_149_165_65,r_110_67_113,1.0,1,114,113,11
44,r_132_160_117,seq156,r_79_55_2,r_132_160_117,1.0,0,117,117,11
11,r_10_143_52,r_6_141_143,r_108_11_88,r_10_143_52,1.0,0,52,52,11
60,r_60_78_164,r_114_211_13,r_109_57_146,r_60_78_164,0.84,0,164,164,11
35,r_217_30_110,seq134,seq184,r_217_30_110,0.92,0,110,110,11
142,seq113,r_109_57_146,r_198_87_78,r_109_57_146,1.0,-9,137,146,11
12,r_150_159_95,seq134,seq64,r_150_159_95,0.95,-2,93,95,11
30,r_180_8_86,seq194,r_26_115_33,r_180_8_86,1.0,0,86,86,12
55,r_49_44_34,r_192_187_132,r_134_142_104,r_134_142_104,0.72,-71,33,104,12
9,r_195_99_37,r_31_62_140,r_128_124_49,r_31_62_140,0.83,0,140,140,12
63,r_161_119_43,r_224_188_144,r_56_96_18,r_161_119_43,0.97,0,43,43,12
53,r_137_89_152,r_202_113_190,seq152,r_202_113_190,0.76,-36,154,190,12
43,r_162_98_179,seq97,r_59_107_1,r_162_98_179,0.56,1,180,179,12
54,r_73_164_158,seq14,r_156_191_2,r_73_164_158,0.75,0,158,158,12
37,r_55_151_94,seq32,r_37_81_26,r_55_151_94,0.69,0,94,94,12
45,r_128_124_49,r_88_174_152,r_195_99_37,r_128_124_49,0.59,0,49,49,12
19,r_192_187_132,r_26_115_33,r_91_24_86,r_26_115_33,0.91,101,134,33,12
16,r_202_113_190,seq181,seq173,r_202_113_190,0.26,0,190,190,12
1,r_111_30_91,r_209_29_137,seq80,r_209_29_137,0.67,-44,93,137,12
117,seq160,seq149,r_199_205_15,r_199_205_15,1.0,0,15,15,12
5,r_18_177_179,r_88_174_152,r_104_17_95,r_104_17_95,1.0,8,103,95,12
136,seq143,r_172_175_114,seq125,r_172_175_114,1.0,-65,49,114,12
6,r_220_167_53,seq57,seq132,r_220_167_53,0.94,0,53,53,12
46,r_127_79_14,r_189_184_30,r_196_131_11,r_127_79_14,0.98,0,14,14,12
31,r_68_1_166,r_211_22_62,r_169_129_83,r_68_1_166,1.0,-104,62,166,12
80,seq138,seq213,r_136_72_31,r_136_72_31,1.0,4,35,31,12
21,r_157_3_28,r_128_124_49,r_101_6_197,r_128_124_49,0.95,-22,27,49,12
41,r_21_10_194,r_83_168_170,r_154_23_191,r_21_10_194,0.55,-24,170,194,12
27,r_112_46_17,seq138,seq141,r_112_46_17,0.81,0,17,17,12
3,r_211_22_62,r_68_1_166,seq34,r_211_22_62,0.84,0,62,62,12
26,r_182_117_110,r_114_94_199,seq181,r_182_117_110,1.0,0,110,110,12
8,r_198_201_126,r_133_212_22,r_114_94_199,r_198_201_126,0.64,2,128,126,12
72,r_104_17_95,seq0,r_18_177_179,r_104_17_95,0.99,0,95,95,12
4,r_43_122_114,seq148,seq221,r_43_122_114,1.0,1,115,114,12
11,r_59_107_1,r_38_210_3,r_87_42_93,r_87_42_93,1.0,3,96,93,12
20,r_91_24_86,r_41_65_73,seq130,r_91_24_86,0.83,0,86,86,12
15,r_40_75_120,seq86,seq149,r_40_75_120,0.98,0,120,120,12
48,r_193_123_61,r_40_75_120,seq219,r_40_75_120,0.81,-59,61,120,12
2,r_101_6_197,r_12_203_192,r_157_3_28,r_157_3_28,0.77,-2,26,28,12
49,r_100_147_168,r_180_8_86,seq33,r_100_147_168,0.82,0,168,168,12
9,r_195_99_37,r_26_115_33,r_31_62_140,r_195_99_37,1.0,0,37,37,12
8,r_198_201_126,seq155,r_133_212_22,r_133_212_22,0.99,0,22,22,12
5,r_18_177_179,r_104_17_95,r_41_65_73,r_41_65_73,0.59,115,188,73,12
10,r_31_62_140,r_195_99_37,seq159,r_31_62_140,0.99,0,140,140,12
28,r_56_96_18,r_40_75_120,seq158,r_56_96_18,0.52,-1,17,18,12
148,seq125,r_224_188_144,seq143,r_224_188_144,1.0,0,144,144,12
25,r_189_184_30,seq66,seq4,r_189_184_30,1.0,-1,29,30,12
93,seq155,r_133_212_22,r_153_165_170,r_153_165_170,0.92,2,172,170,12
40,r_92_222_96,seq181,seq25,r_92_222_96,0.68,0,96,96,12
74,r_209_29_137,r_204_76_144,r_38_210_3,r_209_29_137,0.85,0,137,137,12
29,r_27_20_120,seq0,seq2,r_27_20_120,0.94,0,120,120,12
24,r_134_142_104,r_41_65_73,r_26_115_33,r_134_142_104,0.81,2,106,104,12
66,r_41_65_73,r_134_142_104,seq63,r_41_65_73,0.59,-16,57,73,12
33,r_146_179_104,r_59_107_1,r_133_212_22,r_146_179_104,0.91,10,114,104,12
68,r_196_131_11,r_26_115_33,r_127_79_14,r_127_79_14,0.92,0,14,14,12
104,seq47,r_100_147_168,r_26_115_33,r_26_115_33,0.52,0,33,33,12
64,r_87_42_93,r_85_28_185,r_59_107_1,r_87_42_93,1.0,0,93,93,12
50,r_169_129_83,r_153_165_170,r_68_1_166,r_169_129_83,0.96,0,83,83,12
58,r_171_183_123,seq173,r_112_46_17,r_171_183_123,0.87,0,123,123,12
70,r_83_168_170,r_21_10_194,seq214,r_83_168_170,0.6,0,170,170,12
42,r_133_212_22,r_40_75_120,r_198_201_126,r_133_212_22,0.99,0,22,22,12
65,r_88_174_152,r_18_177_179,r_190_116_92,r_190_116_92,0.6,63,155,92,12
39,r_136_72_31,r_134_142_104,seq51,r_136_72_31,1.0,-1,30,31,12
17,r_67_135_28,r_85_28_185,r_26_115_33,r_67_135_28,0.99,2,30,28,12
42,r_133_212_22,r_198_201_126,seq155,r_198_201_126,1.0,9,135,126,12
32,r_153_165_170,seq176,seq155,r_153_165_170,0.91,1,171,170,12
52,r_11_53_111,seq158,r_26_115_33,r_11_53_111,0.77,1,112,111,12
47,r_16_223_42,seq51,seq130,r_16_223_42,1.0,0,42,42,12
34,r_208_45_113,r_204_76_144,r_112_46_17,r_112_46_17,0.57,90,107,17,12
10,r_31_62_140,seq34,r_195_99_37,r_195_99_37,1.0,1,38,37,12
124,seq219,r_202_113_190,r_193_123_61,r_193_123_61,0.98,0,61,61,12
60,r_120_186_174,seq132,r_172_175_114,r_172_175_114,0.95,60,174,114,12
81,seq132,r_120_186_174,r_220_167_53,r_220_167_53,1.0,109,162,53,12
94,seq158,r_11_53_111,seq185,r_11_53_111,0.93,1,112,111,12
63,r_161_119_43,r_56_96_18,seq86,r_56_96_18,0.6,108,126,18,12
145,seq221,r_202_113_190,r_43_122_114,r_43_122_114,1.0,5,119,114,12
50,r_169_129_83,r_68_1_166,r_73_164_158,r_169_129_83,0.45,83,166,83,12
19,r_192_187_132,r_49_44_34,r_26_115_33,r_26_115_33,0.42,0,33,33,12
31,r_68_1_166,r_169_129_83,r_182_117_110,r_68_1_166,0.65,0,166,166,12
93,seq155,r_43_122_114,r_133_212_22,r_133_212_22,0.75,1,23,22,12
22,r_206_52_121,r_192_187_132,r_218_50_29,r_218_50_29,0.92,55,84,29,12
12,r_199_205_15,r_101_6_197,seq160,r_199_205_15,0.85,0,15,15,12
51,r_218_50_29,r_224_188_144,seq150,r_218_50_29,1.0,0,29,29,12
49,r_100_147_168,seq47,r_180_8_86,r_180_8_86,1.0,2,88,86,12
7,r_84_9_131,r_209_29_137,r_154_23_191,r_209_29_137,0.98,-6,131,137,12
44,r_172_175_114,seq143,seq25,r_172_175_114,1.0,0,114,114,12
23,r_170_108_140,seq219,seq97,r_170_108_140,0.3,1,141,140,12
35,r_5_105_103,r_171_183_123,seq221,r_5_105_103,0.77,0,103,103,12
55,r_49_44_34,r_134_142_104,seq106,r_134_142_104,0.57,7,111,104,12
22,r_192_172_28,r_221_170_14,seq39,r_192_172_28,0.99,-1,27,28,13
14,r_121_163_93,seq222,r_181_136_67,r_181_136_67,0.77,27,94,67,13
8,r_58_125_183,seq209,r_166_211_116,r_58_125_183,0.4,3,186,183,13
53,r_130_78_77,seq160,seq222,r_130_78_77,1.0,0,77,77,13
43,r_195_207_113,seq50,seq209,r_195_207_113,0.95,0,113,113,13
54,r_49_199_89,r_14_194_125,seq48,r_49_199_89,0.97,0,89,89,13
37,r_108_42_80,r_101_40_102,r_71_83_41,r_108_42_80,0.8,-3,77,80,13
59,r_81_79_106,seq116,seq16,r_81_79_106,1.0,4,110,106,13
55,r_174_6_165,seq38,r_149_137_150,r_149_137_150,0.55,15,165,150,13
71,r_180_212_124,r_150_147_6,r_37_105_33,r_180_212_124,0.99,0,124,124,13
21,r_183_95_100,seq145,seq64,r_183_95_100,0.77,1,101,100,13
39,r_190_109_77,seq201,seq44,r_190_109_77,1.0,0,77,77,13
1,r_101_40_102,seq38,seq110,r_101_40_102,0.93,0,102,102,13
5,r_181_136_67,seq128,seq184,r_181_136_67,1.0,0,67,67,13
46,r_88_52_135,seq69,r_138_148_15,r_138_148_15,0.53,121,136,15,13
69,r_45_1_141,r_34_56_178,r_11_76_18,r_45_1_141,0.59,0,141,141,13
19,r_29_61_70,r_101_40_102,seq80,r_29_61_70,1.0,1,71,70,13
44,r_51_168_109,r_77_182_63,seq10,r_51_168_109,0.7,-70,39,109,13
11,r_158_219_189,seq30,r_36_112_143,r_36_112_143,0.99,47,190,143,13
66,r_132_157_114,seq25,r_11_76_18,r_132_157_114,0.74,0,114,114,13
41,r_4_146_69,seq187,seq133,r_4_146_69,1.0,0,69,69,13
67,r_22_224_90,r_164_96_176,seq167,r_22_224_90,0.93,0,90,90,13
34,r_193_86_43,r_149_137_150,seq156,r_193_86_43,0.87,-4,39,43,13
10,r_178_126_86,seq27,seq10,r_178_126_86,1.0,0,86,86,13
84,seq12,r_206_176_119,r_191_118_49,r_191_118_49,1.0,-1,48,49,13
115,seq64,r_90_173_2,r_183_95_100,r_183_95_100,0.95,5,105,100,13
120,seq73,r_217_23_66,seq48,r_217_23_66,0.88,-38,28,66,13
4,r_204_100_83,r_51_168_109,seq44,r_204_100_83,1.0,0,83,83,13
73,r_175_15_167,seq50,r_204_100_83,r_204_100_83,0.96,84,167,83,13
11,r_158_219_189,r_92_127_76,seq30,r_92_127_76,1.0,0,76,76,13
20,r_43_142_144,r_2_28_195,r_29_61_70,r_43_142_144,0.84,0,144,144,13
13,r_102_141_113,seq144,r_90_173_2,r_102_141_113,0.92,0,113,113,13
98,seq133,r_72_215_103,r_4_146_69,r_4_146_69,1.0,2,71,69,13
15,r_53_218_70,seq115,seq50,r_53_218_70,1.0,0,70,70,13
48,r_217_23_66,seq73,seq38,r_217_23_66,1.0,0,66,66,13
35,r_46_13_37,seq10,seq27,r_46_13_37,1.0,0,37,37,13
49,r_71_83_41,r_149_137_150,r_92_127_76,r_92_127_76,0.97,74,150,76,13
72,r_191_118_49,r_2_28_195,seq12,r_191_118_49,1.0,-1,48,49,13
3,r_159_55_43,r_180_212_124,seq169,r_159_55_43,0.99,-4,39,43,13
6,r_2_28_195,r_43_142_144,seq165,r_43_142_144,0.95,1,145,144,13
62,r_206_176_119,seq7,r_92_127_76,r_92_127_76,0.99,46,122,76,13
137,seq187,r_4_146_69,seq167,r_4_146_69,1.0,-14,55,69,13
74,r_11_76_18,r_124_70_198,r_45_1_141,r_45_1_141,0.92,3,144,141,13
36,r_149_137_150,r_71_83_41,r_85_8_170,r_149_137_150,0.61,0,150,150,13
27,r_152_202_114,seq169,seq0,r_152_202_114,0.79,0,114,114,13
65,r_34_56_178,r_92_127_76,seq59,r_34_56_178,1.0,0,178,178,13
87,seq16,r_72_215_103,r_81_79_106,r_81_79_106,1.0,3,109,106,13
2,r_92_127_76,r_158_219_189,r_159_55_43,r_92_127_76,0.8,0,76,76,13
40,r_197_203_104,seq69,r_47_114_48,r_197_203_104,0.87,0,104,104,13
29,r_14_194_125,seq123,seq222,r_14_194_125,0.99,0,125,125,13
25,r_89_24_107,seq0,r_20_188_99,r_89_24_107,0.96,2,109,107,13
33,r_150_147_6,r_180_212_124,seq48,r_180_212_124,1.0,-34,90,124,13
58,r_97_122_8,r_192_172_28,r_37_105_33,r_192_172_28,0.52,-18,10,28,13
65,r_34_56_178,r_45_1_141,r_92_127_76,r_92_127_76,0.84,65,141,76,13
70,r_138_148_15,r_164_96_176,seq128,r_138_148_15,0.99,0,15,15,13
61,r_77_182_63,r_51_168_109,seq213,r_51_168_109,1.0,-42,67,109,13
38,r_66_200_158,seq5,r_217_23_66,r_217_23_66,0.57,92,158,66,13
60,r_90_173_2,seq48,r_102_141_113,r_102_141_113,1.0,8,121,113,13
17,r_18_68_140,seq5,seq187,r_18_68_140,0.5,0,140,140,13
112,seq59,r_196_9_177,r_34_56_178,r_34_56_178,0.79,2,180,178,13
9,r_107_60_89,seq143,seq19,r_107_60_89,1.0,0,89,89,13
145,seq116,r_81_79_106,r_124_70_198,r_81_79_106,1.0,4,110,106,13
133,seq222,r_82_99_175,r_130_78_77,r_130_78_77,1.0,5,82,77,13
49,r_71_83_41,r_135_154_164,r_149_137_150,r_71_83_41,0.96,0,41,41,13
74,r_11_76_18,seq16,r_124_70_198,r_11_76_18,0.97,0,18,18,13
36,r_149_137_150,r_193_86_43,r_71_83_41,r_149_137_150,0.48,-107,43,150,13
7,r_47_114_48,seq156,r_197_203_104,r_47_114_48,0.68,74,122,48,13
23,r_164_96_176,seq103,r_46_13_37,r_46_13_37,0.97,140,177,37,13
30,r_87_219_156,seq163,seq130,r_87_219_156,0.47,2,158,156,14
51,r_86_198_3,seq118,r_171_164_96,r_171_164_96,1.0,34,130,96,14
36,r_27_16_97,r_210_132_180,seq141,r_27_16_97,0.96,0,97,97,14
58,r_15_129_51,seq137,seq102,r_15_129_51,1.0,0,51,51,14
14,r_24_133_60,seq185,seq49,r_24_133_60,0.9,1,61,60,14
57,r_184_150_54,r_116_178_2,seq155,r_184_150_54,0.84,-11,43,54,14
54,r_28_138_157,seq123,r_4_139_121,r_28_138_157,0.67,4,161,157,14
20,r_220_18_40,r_144_107_48,seq186,r_220_18_40,0.99,0,40,40,14
4,r_4_139_121,r_39_208_95,r_28_138_157,r_28_138_157,0.84,7,164,157,14
55,r_54_224_78,r_171_164_96,seq122,r_171_164_96,0.99,-15,81,96,14
71,r_26_114_93,seq51,seq151,r_26_114_93,0.92,0,93,93,14
16,r_203_168_77,seq215,seq183,r_203_168_77,1.0,1,78,77,14
1,r_65_45_123,r_63_104_128,r_55_197_32,r_63_104_128,0.6,-2,126,128,14
5,r_62_32_61,seq199,seq128,r_62_32_61,1.0,1,62,61,14
21,r_99_37_133,r_12_143_129,r_110_72_177,r_99_37_133,0.89,42,175,133,14
2,r_30_135_18,r_120_34_72,r_78_204_53,r_30_135_18,0.87,54,72,18,14
69,r_47_36_148,r_75_188_19,r_167_21_58,r_47_36_148,0.73,0,148,148,14
45,r_136_19_77,seq170,r_145_14_172,r_136_19_77,0.87,4,81,77,14
2,r_30_135_18,r_38_97_100,r_120_34_72,r_30_135_18,1.0,0,18,18,14
19,r_22_222_123,r_175_172_194,seq49,r_22_222_123,0.97,0,123,123,14
66,r_110_72_177,seq3,r_99_37_133,r_99_37_133,0.65,44,177,133,14
41,r_63_104_128,r_65_45_123,seq216,r_63_104_128,0.76,-1,127,128,14
67,r_0_46_117,seq186,r_167_21_58,r_167_21_58,0.96,59,117,58,14
43,r_80_195_13,r_76_192_96,seq173,r_80_195_13,0.87,-1,12,13,14
10,r_201_179_137,seq60,seq105,r_201_179_137,0.82,0,137,137,14
26,r_81_13_69,r_28_138_157,seq141,r_81_13_69,0.99,1,70,69,14
72,r_91_71_141,r_12_143_129,r_176_200_25,r_176_200_25,0.71,106,131,25,14
139,seq106,r_50_42_81,seq141,r_50_42_81,0.94,0,81,81,14
4,r_4_139_121,seq141,r_39_208_95,r_4_139_121,0.81,2,123,121,14
78,seq3,r_110_72_177,seq25,r_110_72_177,0.69,0,177,177,14
72,r_91_71_141,r_176_200_25,seq152,r_91_71_141,0.73,0,141,141,14
73,r_96_211_152,seq183,r_176_200_25,r_176_200_25,0.64,127,152,25,14
11,r_120_34_72,r_20_6_111,seq5,r_120_34_72,1.0,0,72,72,14
98,seq163,r_87_219_156,r_203_168_77,r_203_168_77,1.0,75,152,77,14
56,r_50_42_81,r_210_132_180,r_157_191_108,r_210_132_180,0.69,-31,149,180,14
65,r_124_190_30,r_203_168_77,seq51,r_124_190_30,1.0,0,30,30,14
15,r_20_6_111,r_120_34_72,r_30_135_18,r_20_6_111,0.55,-39,72,111,14
48,r_207_134_136,seq5,r_62_32_61,r_207_134_136,0.84,0,136,136,14
15,r_20_6_111,r_30_135_18,seq213,r_20_6_111,1.0,0,111,111,14
27,r_93_74_64,r_127_153_37,seq159,r_93_74_64,0.84,3,67,64,14
37,r_59_196_36,seq17,seq137,r_59_196_36,0.52,1,37,36,14
62,r_41_57_156,seq123,r_167_21_58,r_41_57_156,0.54,0,156,156,14
27,r_93_74_64,r_144_107_48,r_127_153_37,r_93_74_64,0.75,-16,48,64,14
137,seq102,r_182_142_28,r_15_129_51,r_15_129_51,0.99,4,55,51,14
136,seq100,r_147_31_143,seq25,r_147_31_143,0.98,0,143,143,14
53,r_55_197_32,r_65_45_123,seq173,r_55_197_32,0.72,6,38,32,14
52,r_144_107_48,r_93_74_64,seq181,r_144_107_48,1.0,0,48,48,14
74,r_125_154_157,seq118,r_80_195_13,r_125_154_157,0.54,2,159,157,14
18,r_70_101_76,r_203_168_77,r_144_107_48,r_70_101_76,1.0,0,76,76,14
29,r_68_92_127,seq213,r_27_16_97,r_68_92_127,1.0,1,128,127,14
34,r_145_14_172,r_136_19_77,r_76_192_96,r_145_14_172,0.55,0,172,172,14
63,r_78_204_53,r_175_172_194,r_30_135_18,r_78_204_53,0.81,0,53,53,14
25,r_148_177_131,seq216,r_68_92_127,r_68_92_127,0.62,5,132,127,14
33,r_44_206_138,seq193,r_50_42_81,r_44_206_138,0.81,0,138,138,14
127,seq215,r_203_168_77,r_68_92_127,r_203_168_77,1.0,0,77,77,14
64,r_171_164_96,seq215,r_86_198_3,r_171_164_96,1.0,0,96,96,14
70,r_9_11_138,seq60,r_203_168_77,r_9_11_138,0.72,2,140,138,14
6,r_76_192_96,r_9_11_138,r_120_34_72,r_76_192_96,0.78,1,97,96,14
68,r_39_208_95,r_27_16_97,seq216,r_39_208_95,0.79,0,95,95,14
50,r_166_209_16,r_50_42_81,seq123,r_166_209_16,0.64,0,16,16,14
61,r_160_205_65,seq106,r_85_90_29,r_160_205_65,0.99,0,65,65,14
34,r_145_14_172,seq52,r_136_19_77,r_136_19_77,0.93,4,81,77,14
24,r_176_200_25,r_145_14_172,seq112,r_176_200_25,0.99,0,25,25,14
132,seq186,r_0_46_117,r_220_18_40,r_220_18_40,1.0,14,54,40,14
60,r_157_191_108,seq7,r_50_42_81,r_157_191_108,0.81,0,108,108,14
45,r_136_19_77,r_145_14_172,r_30_135_18,r_145_14_172,0.92,1,173,172,14
8,r_167_21_58,seq122,seq193,r_167_21_58,1.0,0,58,58,14
17,r_38_97_100,seq51,seq162,r_38_97_100,0.66,6,106,100,14
119,seq161,r_99_37_133,seq223,r_99_37_133,1.0,3,136,133,14
112,seq60,r_9_11_138,r_86_198_3,r_9_11_138,0.49,4,142,138,14
94,seq158,seq185,r_127_153_37,r_127_153_37,1.0,104,141,37,14
32,r_85_90_29,r_175_172_194,seq199,r_85_90_29,1.0,0,29,29,14
28,r_83_48_12,r_127_153_37,r_121_79_10,r_83_48_12,0.77,0,12,12,14
22,r_111_56_118,r_147_31_143,seq215,r_111_56_118,1.0,0,118,118,14
102,seq199,r_62_32_61,r_85_90_29,r_62_32_61,0.52,1,62,61,14
0,r_109_194_41,r_35_140_106,seq73,r_109_194_41,0.94,5,46,41,14
40,r_189_40_21,r_167_21_58,seq1,r_189_40_21,0.97,0,21,21,14
49,r_69_202_64,seq162,seq52,r_69_202_64,1.0,0,64,64,14
56,r_50_42_81,seq106,r_210_132_180,r_50_42_81,0.98,0,81,81,14
7,r_35_140_106,r_175_172_194,r_220_18_40,r_175_172_194,0.81,-88,106,194,14
44,r_12_143_129,r_91_71_141,r_174_103_146,r_91_71_141,0.78,-10,131,141,14
13,r_127_153_37,seq53,seq158,r_127_153_37,1.0,1,38,37,14
108,seq183,r_65_45_123,r_203_168_77,r_203_168_77,0.96,37,114,77,14
6,r_76_192_96,r_80_195_13,r_9_11_138,r_76_192_96,0.67,-84,12,96,14
101,seq170,r_136_19_77,seq2,r_136_19_77,0.94,6,83,77,14
12,r_210_132_180,seq130,r_167_21_58,r_167_21_58,0.77,122,180,58,14
30,r_63_116_79,r_205_214_172,seq138,r_63_116_79,1.0,0,79,79,15
51,r_203_213_131,seq28,r_18_4_4,r_203_213_131,1.0,0,131,131,15
36,r_3_2_93,r_189_60_195,seq85,r_3_2_93,0.57,6,99,93,15
70,r_99_50_31,r_141_172_34,seq125,r_141_172_34,0.8,-6,28,34,15
19,r_130_1_15,r_203_213_131,seq98,r_130_1_15,0.87,0,15,15,15
8,r_173_218_170,seq139,r_157_57_116,r_173_218_170,0.58,0,170,170,15
37,r_151_65_129,seq152,seq171,r_151_65_129,0.84,0,129,129,15
59,r_102_195_105,r_128_39_152,seq204,r_102_195_105,1.0,0,105,105,15
55,r_90_55_83,r_96_113_173,r_29_30_77,r_29_30_77,0.98,31,108,77,15
71,r_76_101_59,r_23_111_144,r_198_147_106,r_76_101_59,1.0,1,60,59,15
21,r_158_106_162,seq93,r_205_214_172,r_205_214_172,0.5,-10,162,172,15
39,r_67_15_86,seq169,seq14,r_67_15_86,1.0,0,86,86,15
1,r_189_60_195,r_70_120_148,r_20_64_115,r_20_64_115,0.96,39,154,115,15
53,r_94_132_19,r_77_159_177,seq84,r_94_132_19,0.93,0,19,19,15
5,r_181_149_165,seq182,seq17,r_181_149_165,0.71,2,167,165,15
104,seq44,r_145_75_173,r_202_191_129,r_202_191_129,0.82,22,151,129,15
66,r_210_10_52,r_20_64_115,seq43,r_210_10_52,1.0,0,52,52,15
69,r_136_27_122,seq59,seq0,r_136_27_122,0.58,-4,118,122,15
45,r_96_113_173,r_90_55_83,r_185_121_57,r_185_121_57,0.98,9,66,57,15
52,r_141_172_34,seq148,seq139,r_141_172_34,1.0,0,34,34,15
11,r_105_21_163,r_51_168_34,r_194_211_78,r_194_211_78,1.0,92,170,78,15
27,r_162_33_22,r_105_21_163,r_36_58_104,r_36_58_104,1.0,44,148,104,15
13,r_51_168_34,r_109_46_160,r_162_33_22,r_51_168_34,1.0,0,34,34,15
95,seq28,r_203_213_131,r_205_214_172,r_203_213_131,1.0,0,131,131,15
31,r_70_120_148,r_189_60_195,seq143,r_70_120_148,0.74,3,151,148,15
67,r_129_220_159,r_83_160_194,r_210_10_52,r_210_10_52,0.99,112,164,52,15
3,r_190_163_1,r_73_62_161,r_9_16_71,r_9_16_71,0.95,90,161,71,15
10,r_104_37_90,seq56,seq224,r_104_37_90,0.99,0,90,90,15
115,seq59,r_136_27_122,r_110_176_56,r_110_176_56,0.83,62,118,56,15
72,r_174_117_92,r_35_6_160,seq66,r_174_117_92,0.93,4,96,92,15
26,r_156_184_42,r_29_30_77,seq193,r_156_184_42,0.58,0,42,42,15
11,r_105_21_163,seq134,r_51_168_34,r_51_168_34,0.97,20,54,34,15
4,r_108_187_138,r_105_21_163,seq81,r_105_21_163,0.43,-22,141,163,15
78,seq196,r_36_58_104,seq43,r_36_58_104,1.0,0,104,104,15
20,r_192_13_111,r_175_32_175,r_47_26_108,r_47_26_108,0.66,3,111,108,15
15,r_36_58_104,seq196,r_72_207_43,r_36_58_104,0.57,0,104,104,15
49,r_201_137_4,seq144,r_20_64_115,r_20_64_115,1.0,12,127,115,15
62,r_183_61_147,seq87,r_29_30_77,r_29_30_77,1.0,69,146,77,15
74,r_185_121_57,r_96_113_173,r_5_167_29,r_96_113_173,1.0,0,173,173,15
85,seq14,r_181_149_165,r_67_15_86,r_67_15_86,0.89,17,103,86,15
148,seq123,r_109_46_160,r_205_214_172,r_109_46_160,0.79,0,160,160,15
2,r_157_57_116,r_47_26_108,seq165,r_157_57_116,1.0,0,116,116,15
47,r_86_199_83,r_20_64_115,r_183_61_147,r_86_199_83,0.75,0,83,83,15
40,r_109_46_160,seq123,seq53,r_109_46_160,0.66,0,160,160,15
74,r_185_121_57,r_129_220_159,r_96_113_173,r_185_121_57,1.0,4,61,57,15
29,r_9_16_71,seq43,r_190_163_1,r_9_16_71,1.0,1,72,71,15
24,r_77_159_177,r_115_170_154,r_29_30_77,r_29_30_77,1.0,82,159,77,15
25,r_20_64_115,seq44,seq53,r_20_64_115,1.0,0,115,115,15
68,r_92_127_57,r_31_206_85,seq56,r_92_127_57,1.0,0,57,57,15
64,r_25_166_136,seq68,seq146,r_25_166_136,0.74,2,138,136,15
50,r_29_30_77,r_107_186_186,r_90_55_83,r_29_30_77,1.0,0,77,77,15
58,r_202_191_129,seq7,seq152,r_202_191_129,0.98,0,129,129,15
24,r_77_159_177,r_29_30_77,r_205_214_172,r_77_159_177,0.84,0,177,177,15
42,r_5_167_29,r_96_113_173,r_185_121_57,r_5_167_29,0.71,144,173,29,15
61,r_23_111_144,r_35_6_160,seq148,r_23_111_144,0.87,0,144,144,15
38,r_42_154_116,r_107_186_186,seq153,r_42_154_116,0.98,0,116,116,15
34,r_35_6_160,seq68,r_89_131_141,r_35_6_160,0.63,1,161,160,15
60,r_215_126_81,r_109_46_160,seq24,r_215_126_81,1.0,0,81,81,15
45,r_96_113_173,r_185_121_57,r_205_214_172,r_185_121_57,0.85,116,173,57,15
17,r_89_131_141,seq188,seq153,r_89_131_141,0.94,0,141,141,15
9,r_128_39_152,r_102_195_105,seq87,r_102_195_105,1.0,-11,94,105,15
27,r_162_33_22,r_36_58_104,r_105_21_163,r_162_33_22,0.89,0,22,22,15
22,r_110_176_56,r_95_100_146,seq118,r_110_176_56,0.99,-1,55,56,15
28,r_73_62_161,r_190_163_1,r_157_57_116,r_190_163_1,0.62,160,161,1,15
33,r_72_207_43,r_104_37_90,r_162_33_22,r_72_207_43,0.97,0,43,43,15
140,seq98,r_107_186_186,r_41_135_149,r_107_186_186,0.6,-8,178,186,15
56,r_107_186_186,seq98,r_210_10_52,r_210_10_52,1.0,134,186,52,15
7,r_175_32_175,seq146,r_205_214_172,r_205_214_172,0.73,3,175,172,15
44,r_115_170_154,r_77_159_177,seq196,r_77_159_177,0.9,-18,159,177,15
118,seq66,r_41_135_149,r_174_117_92,r_174_117_92,0.98,58,150,92,15
131,seq87,r_128_39_152,r_185_121_57,r_185_121_57,0.84,24,81,57,15
138,seq224,r_183_61_147,r_104_37_90,r_104_37_90,0.98,2,92,90,15
42,r_5_167_29,r_208_80_59,r_96_113_173,r_5_167_29,1.0,0,29,29,15
82,seq138,r_173_218_170,r_63_116_79,r_63_116_79,1.0,1,80,79,15
12,r_194_211_78,r_129_220_159,seq91,r_194_211_78,1.0,0,78,78,15
6,r_74_124_19,r_96_113_173,seq219,r_74_124_19,1.0,0,19,19,15
9,r_128_39_152,seq87,r_110_176_56,r_128_39_152,0.96,0,152,152,15
40,r_224_25_167,r_43_34_24,seq217,r_224_25_167,0.86,0,167,167,16
30,r_158_123_95,r_50_199_171,seq161,r_158_123_95,0.94,0,95,95,16
36,r_79_193_148,seq135,r_157_70_105,r_157_70_105,0.59,62,167,105,16
53,r_169_202_64,seq164,r_22_113_51,r_169_202_64,0.86,0,64,64,16
41,r_179_46_50,r_125_190_74,r_27_4_45,r_179_46_50,1.0,-1,49,50,16
72,r_43_34_24,r_169_202_64,r_224_25_167,r_224_25_167,0.65,-144,23,167,16
54,r_127_208_127,seq154,r_153_186_82,r_127_208_127,0.63,0,127,127,16
37,r_82_84_68,r_220_106_92,r_47_122_43,r_220_106_92,1.0,-24,68,92,16
55,r_17_42_104,seq3,r_33_91_15,r_17_42_104,1.0,0,104,104,16
71,r_153_186_82,r_220_106_92,r_187_192_193,r_153_186_82,0.98,0,82,82,16
16,r_157_70_105,seq37,r_107_40_72,r_157_70_105,0.77,0,105,105,16
21,r_8_191_94,seq196,seq14,r_8_191_94,0.55,1,95,94,16
39,r_20_114_187,r_137_26_188,seq142,r_20_114_187,0.3,0,187,187,16
1,r_170_168_136,r_47_122_43,r_129_1_28,r_170_168_136,0.84,1,137,136,16
6,r_32_111_70,r_221_97_115,seq121,r_221_97_115,1.0,3,118,115,16
57,r_125_190_74,r_203_139_47,seq3,r_125_190_74,0.56,0,74,74,16
45,r_181_200_98,r_157_70_105,seq211,r_181_200_98,1.0,0,98,98,16
61,r_207_183_10,r_136_94_44,seq197,r_207_183_10,0.98,0,10,10,16
9,r_22_113_51,r_15_141_185,seq101,r_22_113_51,1.0,1,52,51,16
31,r_47_122_43,r_220_106_92,r_32_111_70,r_47_122_43,1.0,-1,42,43,16
57,r_125_190_74,r_179_46_50,r_203_139_47,r_179_46_50,0.69,-1,49,50,16
73,r_194_134_46,r_220_106_92,seq90,r_194_134_46,1.0,0,46,46,16
46,r_33_91_15,r_110_54_57,seq11,r_33_91_15,1.0,-1,14,15,16
4,r_175_29_29,r_32_111_70,seq217,r_175_29_29,0.85,17,46,29,16
26,r_60_119_48,r_110_54_57,seq196,r_60_119_48,0.93,1,49,48,16
14,r_108_173_24,r_157_70_105,seq219,r_108_173_24,0.99,2,26,24,16
44,r_76_2_53,r_107_40_72,seq213,r_76_2_53,1.0,1,54,53,16
67,r_63_132_12,r_110_54_57,seq78,r_63_132_12,0.99,0,12,12,16
10,r_93_155_116,seq205,r_108_173_24,r_93_155_116,0.96,0,116,116,16
23,r_87_59_42,r_103_28_169,r_5_35_189,r_87_59_42,1.0,0,42,42,16
139,seq105,seq90,r_194_134_46,r_194_134_46,1.0,82,128,46,16
11,r_214_120_176,seq3,seq128,r_214_120_176,0.58,1,177,176,16
81,seq11,r_187_192_193,r_33_91_15,r_33_91_15,0.95,10,25,15,16
13,r_221_97_115,r_184_85_105,r_47_122_43,r_184_85_105,0.94,0,105,105,16
15,r_0_138_138,seq150,r_175_29_29,r_0_138_138,0.69,0,138,138,16
48,r_31_189_97,seq24,r_47_122_43,r_31_189_97,0.96,0,97,97,16
12,r_5_35_189,r_87_59_42,r_167_36_121,r_87_59_42,0.34,147,189,42,16
6,r_32_111_70,r_51_206_109,r_221_97_115,r_32_111_70,0.99,0,70,70,16
70,r_129_1_28,r_179_46_50,r_203_139_47,r_179_46_50,0.82,0,50,50,16
69,r_201_144_14,r_22_113_51,r_209_116_172,r_201_144_14,0.79,0,14,14,16
51,r_96_156_11,seq89,r_8_191_94,r_96_156_11,0.55,103,114,11,16
69,r_201_144_14,r_209_116_172,seq128,r_209_116_172,0.94,1,173,172,16
1,r_170_168_136,r_32_111_70,r_47_122_43,r_170_168_136,1.0,-87,49,136,16
47,r_107_40_72,r_184_85_105,seq159,r_184_85_105,0.98,-12,93,105,16
18,r_62_185_66,r_109_77_152,r_167_36_121,r_62_185_66,1.0,1,67,66,16
29,r_103_28_169,seq38,r_158_123_95,r_158_123_95,0.78,75,170,95,16
24,r_187_192_193,seq11,r_153_186_82,r_153_186_82,1.0,2,84,82,16
66,r_126_88_32,r_5_35_189,seq135,r_126_88_32,0.98,2,34,32,16
35,r_110_54_57,seq212,seq24,r_110_54_57,1.0,0,57,57,16
43,r_53_180_34,r_110_54_57,seq55,r_53_180_34,0.79,0,34,34,16
33,r_149_188_135,r_220_106_92,r_170_168_136,r_149_188_135,0.75,1,136,135,16
64,r_209_116_172,seq118,r_136_94_44,r_209_116_172,0.53,1,173,172,16
58,r_137_26_188,seq61,r_22_113_51,r_22_113_51,1.0,137,188,51,16
20,r_27_4_45,seq133,r_187_192_193,r_27_4_45,1.0,-1,44,45,16
38,r_204_165_141,seq161,r_0_138_138,r_204_165_141,0.83,0,141,141,16
52,r_184_85_105,r_221_97_115,seq163,r_184_85_105,1.0,0,105,105,16
70,r_129_1_28,r_224_25_167,r_179_46_50,r_129_1_28,0.96,3,31,28,16
34,r_172_7_120,seq163,seq142,r_172_7_120,0.83,1,121,120,16
40,r_224_25_167,r_129_1_28,r_43_34_24,r_224_25_167,0.99,-144,23,167,16
68,r_48_95_26,seq67,seq215,r_48_95_26,0.99,0,26,26,16
75,seq128,r_44_86_189,r_214_120_176,r_214_120_176,0.74,13,189,176,16
60,r_6_81_97,r_220_106_92,seq55,r_6_81_97,0.68,0,97,97,16
65,r_9_71_57,seq90,r_115_160_9,r_9_71_57,1.0,1,58,57,16
5,r_136_94_44,r_79_193_148,seq57,r_136_94_44,0.82,-3,41,44,16
148,seq213,seq117,r_76_2_53,r_76_2_53,1.0,0,53,53,16
22,r_72_145_60,r_209_116_172,r_53_180_34,r_72_145_60,1.0,0,60,60,16
28,r_51_206_109,seq14,seq150,r_51_206_109,0.95,3,112,109,16
102,seq171,seq67,r_157_70_105,r_157_70_105,1.0,-1,104,105,16
62,r_64_18_13,r_136_94_44,seq56,r_64_18_13,1.0,0,13,13,16
31,r_47_122_43,r_32_111_70,r_82_84_68,r_47_122_43,0.99,27,70,43,16
49,r_166_21_152,seq133,seq121,r_166_21_152,0.88,0,152,152,16
72,r_43_34_24,r_224_25_167,r_166_21_152,r_43_34_24,0.64,143,167,24,16
74,r_69_66_6,r_175_29_29,r_96_156_11,r_69_66_6,0.88,13,19,6,16
56,r_12_19_89,seq24,seq68,r_12_19_89,1.0,-1,88,89,16
12,r_5_35_189,seq105,r_87_59_42,r_87_59_42,1.0,10,52,42,16
42,r_203_139_47,r_9_71_57,r_129_1_28,r_203_139_47,0.99,3,50,47,16
108,seq55,seq41,r_53_180_34,r_53_180_34,0.56,14,48,34,16
23,r_87_59_42,r_5_35_189,r_125_190_74,r_125_190_74,0.7,115,189,74,16
7,r_35_161_22,r_109_193_153,r_185_11_178,r_35_161_22,0.63,-4,18,22,17
30,r_164_37_80,r_112_182_156,seq111,r_164_37_80,0.95,3,83,80,17
51,r_109_193_153,seq8,seq180,r_109_193_153,0.73,0,153,153,17
14,r_101_80_184,seq142,r_203_70_5,r_203_70_5,0.61,179,184,5,17
53,r_38_194_106,r_153_207_86,seq114,r_38_194_106,0.76,0,106,106,17
119,seq216,r_16_179_92,r_56_26_123,r_56_26_123,0.97,-6,117,123,17
54,r_2_116_68,seq66,seq52,r_2_116_68,0.92,1,69,68,17
59,r_93_60_96,r_145_208_190,r_2_116_68,r_93_60_96,1.0,1,97,96,17
71,r_72_154_99,r_62_0_100,r_164_37_80,r_164_37_80,1.0,19,99,80,17
40,r_130_167_15,r_220_218_149,seq196,r_130_167_15,0.85,0,15,15,17
21,r_215_156_127,seq111,r_78_126_86,r_215_156_127,0.62,3,130,127,17
39,r_145_208_190,seq81,r_40_53_148,r_145_208_190,0.21,0,190,190,17
15,r_94_9_24,r_16_179_92,seq129,r_16_179_92,0.73,-24,68,92,17
1,r_134_212_83,r_215_156_127,r_1_7_41,r_134_212_83,1.0,0,83,83,17
5,r_150_77_91,seq216,seq180,r_150_77_91,1.0,0,91,91,17
42,r_147_34_102,r_128_3_179,seq81,r_147_34_102,1.0,0,102,102,17
7,r_35_161_22,r_185_11_178,r_64_50_87,r_64_50_87,1.0,57,144,87,17
69,r_133_6_139,r_185_11_178,r_136_46_146,r_133_6_139,0.89,2,141,139,17
13,r_95_49_147,r_29_44_51,r_200_138_51,r_95_49_147,0.89,-96,51,147,17
19,r_210_5_123,r_75_71_129,r_197_51_91,r_197_51_91,0.57,29,120,91,17
23,r_222_82_28,r_120_217_44,seq52,r_222_82_28,0.92,1,29,28,17
38,r_29_44_51,r_95_49_147,seq155,r_29_44_51,1.0,3,54,51,17
27,r_128_3_179,r_221_97_22,r_201_12_133,r_128_3_179,0.63,0,179,179,17
66,r_47_195_132,seq140,r_165_135_95,r_47_195_132,0.8,-15,117,132,17
76,seq8,r_109_193_153,r_120_217_44,r_109_193_153,0.99,0,153,153,17
55,r_200_138_51,r_95_49_147,seq115,r_95_49_147,0.95,-45,102,147,17
41,r_158_152_123,seq196,r_18_214_3,r_158_152_123,0.58,7,130,123,17
67,r_96_28_133,seq171,seq139,r_96_28_133,0.99,0,133,133,17
3,r_137_20_63,r_199_188_193,seq66,r_137_20_63,0.99,0,63,63,17
10,r_16_179_92,r_118_184_170,r_199_188_193,r_118_184_170,0.62,-78,92,170,17
63,r_87_176_89,r_205_103_72,r_173_108_25,r_173_108_25,0.88,3,28,25,17
60,r_45_63_42,r_112_182_156,r_118_184_170,r_45_63_42,0.98,3,45,42,17
20,r_58_27_47,r_112_182_156,r_18_214_3,r_58_27_47,0.96,0,47,47,17
26,r_75_71_129,seq143,seq68,r_75_71_129,0.88,6,135,129,17
8,r_173_108_25,r_87_176_89,r_69_187_187,r_87_176_89,1.0,0,89,89,17
72,r_219_55_60,r_124_84_125,r_199_188_193,r_219_55_60,0.9,0,60,60,17
73,r_124_84_125,seq52,r_57_107_138,r_124_84_125,0.46,5,130,125,17
11,r_40_53_148,seq92,r_164_37_80,r_40_53_148,0.93,1,149,148,17
48,r_132_198_25,seq88,seq117,r_132_198_25,0.91,1,26,25,17
91,seq196,r_158_152_123,r_130_167_15,r_130_167_15,0.91,0,15,15,17
15,r_94_9_24,r_145_208_190,r_16_179_92,r_94_9_24,0.95,0,24,24,17
25,r_120_217_44,r_15_43_166,seq86,r_120_217_44,0.58,12,56,44,17
13,r_95_49_147,r_200_138_51,r_45_63_42,r_95_49_147,0.91,0,147,147,17
6,r_78_126_86,seq148,seq42,r_78_126_86,1.0,0,86,86,17
62,r_56_26_123,seq104,seq216,r_56_26_123,0.94,1,124,123,17
8,r_173_108_25,r_40_53_148,r_87_176_89,r_173_108_25,1.0,0,25,25,17
27,r_128_3_179,r_147_34_102,r_221_97_22,r_147_34_102,0.71,0,102,102,17
2,r_197_51_91,seq141,seq22,r_197_51_91,0.59,2,93,91,17
142,seq115,seq36,r_200_138_51,r_200_138_51,1.0,53,104,51,17
74,r_62_0_100,seq180,seq10,r_62_0_100,0.9,0,100,100,17
18,r_112_182_156,seq163,r_201_12_133,r_201_12_133,0.65,31,164,133,17
24,r_39_190_153,r_35_161_22,r_221_97_22,r_35_161_22,0.71,133,155,22,17
34,r_118_184_170,r_45_63_42,seq142,r_118_184_170,0.76,0,170,170,17
33,r_13_100_102,seq113,seq160,r_13_100_102,0.96,2,104,102,17
36,r_221_97_22,r_57_107_138,seq59,r_221_97_22,0.96,0,22,22,17
64,r_205_103_72,seq89,seq178,r_205_103_72,1.0,1,73,72,17
88,seq22,seq106,r_197_51_91,r_197_51_91,0.82,84,175,91,17
65,r_64_50_87,seq36,r_35_161_22,r_64_50_87,1.0,0,87,87,17
55,r_200_138_51,r_220_218_149,r_95_49_147,r_200_138_51,1.0,0,51,51,17
130,seq223,r_169_211_180,r_175_14_183,r_169_211_180,0.77,0,180,180,17
32,r_61_162_159,r_136_46_146,r_153_207_86,r_136_46_146,0.65,15,161,146,17
52,r_79_192_91,seq42,seq125,r_79_192_91,0.97,-2,89,91,17
34,r_118_184_170,seq129,r_45_63_42,r_45_63_42,1.0,19,61,42,17
47,r_4_172_55,r_65_102_94,seq42,r_4_172_55,1.0,0,55,55,17
119,seq216,r_150_77_91,r_16_179_92,r_150_77_91,0.97,0,91,91,17
9,r_220_218_149,seq160,seq181,r_220_218_149,0.73,5,154,149,17
63,r_87_176_89,r_173_108_25,seq113,r_87_176_89,1.0,0,89,89,17
96,seq36,r_64_50_87,seq115,r_64_50_87,1.0,0,87,87,17
120,seq81,r_145_208_190,r_169_211_180,r_169_211_180,0.68,10,190,180,17
37,r_185_11_178,r_35_161_22,seq54,r_35_161_22,0.37,163,185,22,17
22,r_189_73_122,r_32_206_191,r_69_187_187,r_32_206_191,0.89,-92,99,191,17
28,r_33_19_60,r_112_182_156,r_153_207_86,r_33_19_60,0.93,10,70,60,17
135,seq104,r_56_26_123,seq191,r_56_26_123,0.99,1,124,123,17
56,r_165_135_95,r_189_73_122,r_203_70_5,r_165_135_95,0.99,0,95,95,17
44,r_65_102_94,r_101_80_184,seq155,r_65_102_94,0.98,3,97,94,17
82,seq143,r_75_71_129,r_201_12_133,r_75_71_129,0.64,6,135,129,17
79,seq140,r_47_195_132,seq141,r_47_195_132,1.0,-19,113,132,17
60,r_45_63_42,r_118_184_170,r_95_49_147,r_45_63_42,0.78,128,170,42,17
35,r_153_207_86,r_215_156_127,r_33_19_60,r_153_207_86,0.97,13,99,86,17
37,r_185_11_178,r_133_6_139,r_35_161_22,r_185_11_178,0.72,-160,18,178,17
30,r_159_173_154,r_16_151_97,r_89_44_65,r_159_173_154,0.57,-71,83,154,18
31,r_45_31_9,seq42,r_88_177_33,r_88_177_33,1.0,23,56,33,18
51,r_10_192_110,r_101_29_105,r_169_5_41,r_10_192_110,1.0,0,110,110,18
65,r_62_35_52,seq201,r_67_162_116,r_62_35_52,1.0,0,52,52,18
36,r_212_12_140,seq174,r_214_0_132,r_212_12_140,0.66,4,144,140,18
50,r_196_65_66,r_43_13_12,seq78,r_196_65_66,0.96,-17,49,66,18
14,r_139_204_138,r_66_197_58,r_100_157_26,r_66_197_58,0.96,-13,45,58,18
146,seq124,seq42,r_147_87_50,r_147_87_50,1.0,45,95,50,18
37,r_26_103_149,r_79_136_100,r_101_29_105,r_79_136_100,1.0,0,100,100,18
69,r_88_177_33,seq207,r_45_31_9,r_88_177_33,1.0,0,33,33,18
71,r_89_44_65,r_141_9_122,r_169_5_41,r_89_44_65,0.8,1,66,65,18
16,r_102_138_176,r_160_137_192,r_155_133_28,r_102_138_176,0.42,1,177,176,18
39,r_22_37_117,r_2_216_169,seq61,r_22_37_117,1.0,0,117,117,18
1,r_79_136_100,r_26_103_149,r_144_117_17,r_79_136_100,1.0,0,100,100,18
5,r_27_182_72,seq58,seq55,r_27_182_72,1.0,0,72,72,18
42,r_92_72_194,r_67_162_116,r_167_194_135,r_167_194_135,0.86,21,156,135,18
63,r_179_193_106,seq131,r_19_73_37,r_179_193_106,0.53,5,111,106,18
19,r_213_127_87,r_156_51_157,seq32,r_213_127_87,1.0,0,87,87,18
57,r_105_47_11,r_178_84_49,r_202_17_41,r_105_47_11,1.0,41,52,11,18
23,r_187_145_29,seq42,seq4,r_187_145_29,1.0,0,29,29,18
66,r_25_15_80,seq134,r_169_5_41,r_25_15_80,0.99,0,80,80,18
57,r_105_47_11,r_7_181_152,r_178_84_49,r_105_47_11,0.96,0,11,11,18
43,r_155_133_28,seq77,r_76_63_33,r_76_63_33,1.0,5,38,33,18
67,r_76_63_33,seq218,r_155_133_28,r_76_63_33,1.0,0,33,33,18
89,seq32,seq23,r_213_127_87,r_213_127_87,1.0,19,106,87,18
22,r_167_194_135,r_222_120_164,r_62_35_52,r_222_120_164,0.68,-27,137,164,18
3,r_222_120_164,seq34,r_161_46_103,r_161_46_103,1.0,7,110,103,18
10,r_2_216_169,seq91,r_203_93_4,r_2_216_169,0.35,1,170,169,18
90,seq34,r_222_120_164,r_24_171_97,r_24_171_97,0.87,35,132,97,18
96,seq42,seq124,r_45_31_9,r_45_31_9,1.0,10,19,9,18
63,r_179_193_106,r_195_153_109,seq131,r_195_153_109,0.64,-31,78,109,18
26,r_186_158_155,seq96,r_167_194_135,r_186_158_155,0.43,-7,148,155,18
14,r_139_204_138,r_100_157_26,seq221,r_139_204_138,1.0,0,138,138,18
4,r_175_122_186,r_104_59_75,r_3_80_55,r_3_80_55,0.51,22,77,55,18
62,r_3_80_55,seq55,r_175_122_186,r_3_80_55,1.0,0,55,55,18
0,r_7_181_152,r_1_188_12,seq128,r_7_181_152,0.62,0,152,152,18
73,r_6_191_146,r_54_176_163,r_43_13_12,r_6_191_146,0.98,0,146,146,18
11,r_109_71_196,r_24_171_97,r_178_84_49,r_178_84_49,0.95,49,98,49,18
46,r_178_84_49,seq218,seq132,r_178_84_49,1.0,3,52,49,18
55,r_100_157_26,r_92_72_194,r_146_224_132,r_100_157_26,0.94,-7,19,26,18
13,r_210_112_118,seq132,r_142_36_19,r_210_112_118,0.93,0,118,118,18
29,r_146_224_132,r_169_5_41,r_100_157_26,r_169_5_41,0.61,-15,26,41,18
48,r_39_57_87,r_167_194_135,r_109_71_196,r_109_71_196,0.55,-109,87,196,18
2,r_169_5_41,r_66_197_58,seq150,r_169_5_41,1.0,0,41,41,18
4,r_175_122_186,r_3_80_55,r_214_0_132,r_175_122_186,0.48,2,188,186,18
106,seq61,seq170,r_22_37_117,r_22_37_117,1.0,22,139,117,18
21,r_147_87_50,seq4,seq124,r_147_87_50,1.0,0,50,50,18
6,r_86_90_35,r_139_204_138,seq8,r_86_90_35,0.86,2,37,35,18
45,r_140_154_11,r_76_63_33,seq56,r_140_154_11,0.95,0,11,11,18
38,r_1_188_12,r_169_5_41,seq211,r_169_5_41,0.86,-28,13,41,18
27,r_152_11_147,seq64,seq77,r_152_11_147,0.59,2,149,147,18
12,r_202_17_41,r_152_11_147,r_105_47_11,r_202_17_41,0.97,2,43,41,18
30,r_159_173_154,r_89_44_65,r_24_171_97,r_159_173_154,0.82,0,154,154,18
53,r_19_73_37,r_7_181_152,seq77,r_19_73_37,1.0,1,38,37,18
59,r_66_197_58,r_146_224_132,seq70,r_66_197_58,0.98,0,58,58,18
142,seq116,seq189,r_68_217_103,r_68_217_103,0.99,9,112,103,18
40,r_104_59_75,r_175_122_186,seq60,r_104_59_75,0.98,2,77,75,18
105,seq60,r_98_118_187,r_104_59_75,r_104_59_75,1.0,114,189,75,18
18,r_161_46_103,seq85,r_222_120_164,r_161_46_103,1.0,0,103,103,18
25,r_156_51_157,seq56,r_10_192_110,r_156_51_157,0.73,0,157,157,18
33,r_114_113_167,seq148,r_76_63_33,r_76_63_33,0.96,134,167,33,18
65,r_62_35_52,r_67_162_116,r_167_194_135,r_62_35_52,0.65,104,156,52,18
58,r_67_162_116,r_92_72_194,r_39_57_87,r_39_57_87,0.94,29,116,87,18
70,r_183_20_95,seq83,r_140_154_11,r_183_20_95,1.0,0,95,95,18
68,r_53_14_133,seq208,r_169_5_41,r_53_14_133,0.84,0,133,133,18
61,r_98_118_187,seq60,r_26_103_149,r_26_103_149,0.64,40,189,149,18
32,r_214_0_132,seq99,r_100_157_26,r_214_0_132,0.85,0,132,132,18
34,r_185_130_83,seq52,seq70,r_185_130_83,1.0,0,83,83,18
124,seq215,r_195_153_109,seq174,r_195_153_109,1.0,0,109,109,18
24,r_184_219_34,r_106_33_184,seq198,r_184_219_34,1.0,0,34,34,18
15,r_28_205_47,r_106_33_184,r_109_71_196,r_28_205_47,1.0,0,47,47,18
60,r_68_217_103,seq95,seq116,r_68_217_103,0.85,2,105,103,18
115,seq77,r_155_133_28,r_19_73_37,r_19_73_37,0.54,-7,30,37,18
17,r_54_176_163,seq201,r_18_50_17,r_18_50_17,0.93,148,165,17,18
9,r_106_33_184,seq168,r_3_80_55,r_106_33_184,0.63,0,184,184,18
133,seq99,r_214_0_132,seq82,r_214_0_132,0.97,0,132,132,18
29,r_146_224_132,r_100_157_26,seq208,r_146_224_132,0.99,1,133,132,18
22,r_167_194_135,r_39_57_87,r_222_120_164,r_39_57_87,0.99,0,87,87,18
62,r_3_80_55,r_175_122_186,r_106_33_184,r_3_80_55,0.35,133,188,55,18
49,r_16_151_97,seq150,r_101_29_105,r_16_151_97,0.98,1,98,97,18
7,r_24_171_97,r_109_71_196,r_100_157_26,r_24_171_97,0.86,1,98,97,18
3,r_222_120_164,r_161_46_103,r_147_87_50,r_222_120_164,1.0,0,164,164,18
18,r_161_46_103,r_222_120_164,seq34,r_222_120_164,1.0,0,164,164,18
63,r_179_193_106,r_104_59_75,r_195_153_109,r_195_153_109,0.53,-58,51,109,18
101,seq55,seq221,r_27_182_72,r_27_182_72,1.0,2,74,72,18
35,r_101_29_105,r_10_192_110,r_16_151_97,r_101_29_105,1.0,5,110,105,18
37,r_26_103_149,r_101_29_105,r_202_17_41,r_26_103_149,0.63,1,150,149,18
55,r_100_157_26,r_146_224_132,r_214_0_132,r_100_157_26,0.61,107,133,26,18
66,r_196_165_59,seq205,r_114_209_157,r_114_209_157,0.85,5,162,157,19
14,r_107_98_149,seq95,r_218_102_58,r_107_98_149,0.77,0,149,149,19
46,r_218_102_58,r_42_106_161,r_107_98_149,r_218_102_58,0.71,91,149,58,19
147,seq123,seq147,r_86_140_93,r_86_140_93,1.0,1,94,93,19
53,r_30_146_93,seq25,seq24,r_30_146_93,1.0,0,93,93,19
43,r_12_32_118,r_28_31_136,seq171,r_12_32_118,1.0,0,118,118,19
54,r_28_31_136,r_12_32_118,r_141_200_176,r_12_32_118,0.87,0,118,118,19
55,r_19_62_166,seq33,seq137,r_19_62_166,0.47,0,166,166,19
16,r_129_136_182,seq157,r_27_89_61,r_129_136_182,0.66,-127,55,182,19
39,r_44_41_36,r_5_144_157,r_18_99_39,r_18_99_39,1.0,116,155,39,19
54,r_28_31_136,r_141_200_176,r_166_84_20,r_28_31_136,1.0,0,136,136,19
5,r_45_201_120,r_210_85_115,r_116_173_55,r_45_201_120,0.96,-5,115,120,19
46,r_218_102_58,seq132,r_114_209_157,r_218_102_58,0.96,4,62,58,19
69,r_27_89_61,seq158,r_129_136_182,r_27_89_61,1.0,0,61,61,19
20,r_166_84_20,r_179_189_164,seq49,r_166_84_20,1.0,0,20,20,19
45,r_57_59_119,seq188,seq75,r_57_59_119,1.0,0,119,119,19
19,r_179_189_164,r_14_217_199,r_213_159_118,r_179_189_164,0.8,0,164,164,19
52,r_192_199_24,r_162_105_24,r_125_115_8,r_162_105_24,1.0,-2,22,24,19
37,r_162_105_24,r_192_199_24,r_210_85_115,r_162_105_24,1.0,1,25,24,19
31,r_114_209_157,r_21_139_133,seq202,r_21_139_133,0.82,1,134,133,19
41,r_23_176_185,seq156,r_36_215_100,r_23_176_185,0.41,1,186,185,19
24,r_180_155_96,r_116_173_55,r_94_3_149,r_116_173_55,1.0,0,55,55,19
110,seq163,r_109_76_172,r_185_191_172,r_185_191_172,0.6,1,173,172,19
3,r_197_169_157,seq16,r_167_52_105,r_197_169_157,0.71,0,157,157,19
17,r_18_99_39,r_57_59_119,r_88_186_13,r_88_186_13,1.0,27,40,13,19
10,r_141_200_176,r_108_10_182,r_210_85_115,r_210_85_115,0.61,61,176,115,19
26,r_104_78_20,r_185_191_172,r_170_212_93,r_170_212_93,1.0,59,152,93,19
8,r_1_177_41,r_64_79_140,r_162_105_24,r_64_79_140,1.0,0,140,140,19
72,r_14_217_199,r_179_189_164,r_18_99_39,r_18_99_39,0.99,79,118,39,19
16,r_129_136_182,r_27_89_61,r_166_84_20,r_166_84_20,0.58,160,180,20,19
4,r_213_159_118,r_174_50_148,r_46_2_38,r_213_159_118,0.53,-20,98,118,19
0,r_126_190_172,seq20,r_180_155_96,r_126_190_172,0.45,0,172,172,19
63,r_198_0_104,seq130,seq33,r_198_0_104,1.0,0,104,104,19
73,r_174_50_148,seq206,seq132,r_174_50_148,0.7,0,148,148,19
46,r_218_102_58,r_114_209_157,r_42_106_161,r_218_102_58,0.42,73,131,58,19
15,r_122_195_111,r_26_97_166,r_7_148_37,r_122_195_111,0.46,2,113,111,19
68,r_64_79_140,r_45_201_120,r_1_177_41,r_64_79_140,0.88,-84,56,140,19
30,r_34_66_52,r_45_201_120,r_94_3_149,r_34_66_52,1.0,0,52,52,19
70,r_116_173_55,r_180_155_96,r_219_58_34,r_116_173_55,0.65,0,55,55,19
65,r_88_186_13,seq149,r_14_217_199,r_88_186_13,1.0,-1,12,13,19
6,r_138_112_100,seq80,seq214,r_138_112_100,0.98,0,100,100,19
62,r_167_52_105,seq24,seq93,r_167_52_105,1.0,2,107,105,19
24,r_180_155_96,r_94_3_149,seq83,r_180_155_96,0.95,2,98,96,19
8,r_1_177_41,r_142_68_169,r_64_79_140,r_64_79_140,0.54,-96,44,140,19
66,r_196_165_59,r_42_106_161,seq205,r_196_165_59,0.98,0,59,59,19
59,r_96_220_25,r_142_68_169,seq188,r_96_220_25,1.0,1,26,25,19
87,seq20,r_126_190_172,r_120_13_53,r_120_13_53,0.98,107,160,53,19
40,r_53_81_124,r_197_169_157,seq75,r_53_81_124,0.96,0,124,124,19
18,r_29_70_131,r_92_55_144,r_122_195_111,r_29_70_131,0.88,3,134,131,19
29,r_145_135_117,r_179_189_164,r_143_11_162,r_145_135_117,1.0,0,117,117,19
34,r_142_68_169,seq82,r_213_159_118,r_142_68_169,0.66,0,169,169,19
33,r_92_55_144,r_23_176_185,r_208_39_133,r_92_55_144,0.82,1,145,144,19
70,r_116_173_55,r_219_58_34,r_45_201_120,r_45_201_120,1.0,1,121,120,19
64,r_9_54_85,seq47,seq87,r_9_54_85,0.49,14,99,85,19
42,r_46_2_38,r_185_191_172,seq156,r_46_2_38,1.0,0,38,38,19
13,r_121_127_35,seq149,seq47,r_121_127_35,1.0,0,35,35,19
50,r_42_106_161,seq101,r_166_84_20,r_42_106_161,0.62,0,161,161,19
58,r_21_139_133,r_114_209_157,r_182_22_12,r_21_139_133,0.97,1,134,133,19
47,r_56_152_44,r_174_50_148,seq211,r_56_152_44,0.99,2,46,44,19
32,r_208_39_133,seq137,seq163,r_208_39_133,0.82,1,134,133,19
38,r_8_110_140,seq214,r_213_159_118,r_8_110_140,0.64,0,140,140,19
2,r_182_22_12,r_19_62_166,seq25,r_182_22_12,1.0,0,12,12,19
68,r_64_79_140,r_1_177_41,r_208_39_133,r_64_79_140,0.9,0,140,140,19
67,r_94_3_149,r_180_155_96,seq87,r_180_155_96,1.0,-43,53,96,19
124,seq206,r_174_50_148,seq37,r_174_50_148,1.0,-2,146,148,19
60,r_7_148_37,seq6,seq147,r_7_148_37,0.97,0,37,37,19
81,seq137,r_208_39_133,r_185_191_172,r_208_39_133,0.69,1,134,133,19
71,r_120_13_53,seq188,seq101,r_120_13_53,1.0,1,54,53,19
24,r_180_155_96,seq83,r_126_190_172,r_126_190_172,0.86,-2,170,172,19
37,r_162_105_24,r_210_85_115,r_1_177_41,r_210_85_115,1.0,0,115,115,19
22,r_160_90_184,seq131,r_18_99_39,r_160_90_184,0.43,0,184,184,19
28,r_204_113_116,r_29_70_131,r_48_168_100,r_204_113_116,0.73,1,117,116,19
49,r_48_168_100,seq17,seq133,r_48_168_100,0.98,1,101,100,19
56,r_210_85_115,r_45_201_120,seq157,r_210_85_115,0.96,0,115,115,19
7,r_5_144_157,r_44_41_36,r_223_63_5,r_5_144_157,0.57,0,157,157,19
44,r_170_212_93,r_36_215_100,r_104_78_20,r_170_212_93,1.0,0,93,93,19
23,r_86_140_93,seq214,seq123,r_86_140_93,1.0,0,93,93,19
82,seq132,r_218_102_58,seq171,r_218_102_58,1.0,4,62,58,19
60,r_7_148_37,seq147,r_122_195_111,r_122_195_111,1.0,13,124,111,19
12,r_185_191_172,r_104_78_20,r_208_39_133,r_104_78_20,0.74,152,172,20,19
57,r_219_58_34,r_94_3_149,seq216,r_219_58_34,1.0,0,34,34,19
84,seq16,r_197_169_157,seq43,r_197_169_157,0.97,0,157,157,19
31,r_114_209_157,seq202,r_196_165_59,r_114_209_157,0.82,0,157,157,19
30,r_204_120_99,r_205_133_140,seq62,r_204_120_99,1.0,0,99,99,20
44,r_81_166_37,r_137_140_180,r_157_145_62,r_81_166_37,0.59,143,180,37,20
53,r_191_46_29,seq159,seq88,r_191_46_29,0.97,0,29,29,20
51,r_124_144_131,seq214,seq111,r_124_144_131,0.72,0,131,131,20
40,r_20_168_11,r_119_148_98,seq49,r_119_148_98,0.71,-86,12,98,20
35,r_63_174_20,seq162,seq138,r_63_174_20,1.0,0,20,20,20
54,r_155_219_143,seq32,seq169,r_155_219_143,0.87,0,143,143,20
37,r_194_110_82,r_205_133_140,seq84,r_194_110_82,0.98,0,82,82,20
59,r_114_176_180,seq111,seq51,r_114_176_180,0.4,0,180,180,20
71,r_181_136_150,r_104_4_115,r_82_146_6,r_104_4_115,0.63,1,116,115,20
16,r_45_109_55,seq99,r_154_211_178,r_45_109_55,1.0,3,58,55,20
21,r_165_61_72,seq131,seq43,r_165_61_72,1.0,5,77,72,20
39,r_22_224_181,seq88,r_103_188_182,r_22_224_181,0.43,4,185,181,20
46,r_117_202_192,r_154_211_178,r_45_109_55,r_45_109_55,1.0,23,78,55,20
42,r_69_170_61,seq159,seq29,r_69_170_61,1.0,0,61,61,20
69,r_153_116_144,seq2,seq29,r_153_116_144,0.67,0,144,144,20
45,r_127_52_121,seq143,r_27_6_13,r_127_52_121,0.89,1,122,121,20
74,r_0_197_42,seq28,seq177,r_0_197_42,1.0,0,42,42,20
24,r_129_77_64,r_128_40_127,r_199_218_117,r_129_77_64,1.0,63,127,64,20
147,seq169,r_37_105_40,r_155_219_143,r_155_219_143,0.95,0,143,143,20
31,r_196_1_26,seq160,r_63_174_20,r_196_1_26,1.0,0,26,26,20
41,r_154_211_178,r_129_77_64,r_45_109_55,r_154_211_178,0.92,-113,65,178,20
67,r_149_192_170,seq173,r_179_141_89,r_179_141_89,0.73,81,170,89,20
22,r_137_140_180,r_81_166_37,r_199_218_117,r_137_140_180,0.86,0,180,180,20
43,r_72_83_24,seq30,seq88,r_72_83_24,0.95,0,24,24,20
72,r_190_107_111,r_60_193_141,r_63_174_20,r_63_174_20,0.96,91,111,20,20
16,r_45_109_55,r_154_211_178,r_199_218_117,r_45_109_55,0.73,123,178,55,20
6,r_205_133_140,r_8_34_87,r_10_186_13,r_205_133_140,0.96,0,140,140,20
4,r_119_148_98,seq43,r_121_115_23,r_119_148_98,0.74,0,98,98,20
0,r_8_34_87,r_200_172_139,seq30,r_8_34_87,0.75,0,87,87,20
63,r_189_213_97,r_17_135_144,seq130,r_189_213_97,0.97,1,98,97,20
15,r_199_218_117,seq177,r_129_77_64,r_199_218_117,0.95,0,117,117,20
57,r_59_38_62,r_8_34_87,seq55,r_8_34_87,0.56,-24,63,87,20
147,seq169,seq53,r_37_105_40,r_37_105_40,0.54,5,45,40,20
6,r_205_133_140,r_184_85_122,r_8_34_87,r_205_133_140,0.53,-18,122,140,20
62,r_104_4_115,r_181_136_150,seq30,r_104_4_115,0.99,1,116,115,20
61,r_24_76_58,seq5,r_191_46_29,r_24_76_58,0.94,0,58,58,20
10,r_42_222_142,r_33_139_30,r_10_186_13,r_42_222_142,0.99,0,142,142,20
27,r_184_85_122,r_205_133_140,r_92_13_18,r_205_133_140,0.88,-18,122,140,20
50,r_167_80_80,r_33_139_30,r_3_39_29,r_167_80_80,1.0,0,80,80,20
50,r_167_80_80,r_158_18_38,r_33_139_30,r_167_80_80,0.51,-42,38,80,20
58,r_112_123_21,r_23_65_124,seq173,r_112_123_21,0.74,0,21,21,20
20,r_27_6_13,r_196_1_26,seq173,r_27_6_13,0.78,0,13,13,20
41,r_154_211_178,r_45_109_55,r_164_171_164,r_164_171_164,0.71,14,178,164,20
18,r_128_40_127,seq106,r_129_77_64,r_129_77_64,0.99,-4,60,64,20
24,r_129_77_64,r_154_211_178,r_128_40_127,r_129_77_64,0.85,1,65,64,20
25,r_103_188_182,seq198,r_22_224_181,r_22_224_181,0.74,1,182,181,20
33,r_179_141_89,seq206,seq32,r_179_141_89,0.99,0,89,89,20
64,r_200_172_139,r_149_192_170,r_9_187_104,r_200_172_139,0.91,0,139,139,20
11,r_163_201_16,seq78,seq138,r_163_201_16,0.98,0,16,16,20
70,r_41_216_42,seq51,r_196_1_26,r_196_1_26,1.0,43,69,26,20
110,seq53,seq169,r_97_182_13,r_97_182_13,0.78,13,26,13,20
13,r_16_26_19,r_129_77_64,seq98,r_16_26_19,0.96,1,20,19,20
38,r_47_212_149,r_22_224_181,seq206,r_22_224_181,0.46,-32,149,181,20
52,r_60_193_141,r_23_65_124,seq67,r_60_193_141,0.89,1,142,141,20
44,r_81_166_37,r_114_176_180,r_137_140_180,r_81_166_37,1.0,0,37,37,20
23,r_150_15_57,r_17_135_144,r_63_174_20,r_63_174_20,0.56,38,58,20,20
124,seq79,r_194_110_82,seq30,r_194_110_82,1.0,0,82,82,20
2,r_152_142_39,r_9_187_104,seq131,r_152_142_39,0.96,0,39,39,20
32,r_3_39_29,r_42_222_142,seq159,r_3_39_29,0.98,0,29,29,20
10,r_42_222_142,r_114_176_180,r_33_139_30,r_33_139_30,0.99,17,47,30,20
22,r_137_140_180,r_164_171_164,r_81_166_37,r_81_166_37,0.99,107,144,37,20
34,r_97_182_13,r_158_18_38,seq53,r_97_182_13,1.0,-1,12,13,20
28,r_183_64_170,seq195,r_189_213_97,r_183_64_170,0.49,0,170,170,20
71,r_181_136_150,r_82_146_6,r_204_120_99,r_181_136_150,0.83,1,151,150,20
49,r_17_135_144,seq207,r_97_182_13,r_17_135_144,0.85,0,144,144,20
55,r_220_58_29,seq195,seq96,r_220_58_29,0.94,0,29,29,20
8,r_158_18_38,r_167_80_80,seq29,r_158_18_38,0.99,0,38,38,20
56,r_157_145_62,seq130,r_0_197_42,r_157_145_62,1.0,0,62,62,20
7,r_164_171_164,r_137_140_180,r_42_222_142,r_164_171_164,0.64,0,164,164,20
18,r_128_40_127,r_129_77_64,seq98,r_128_40_127,0.99,0,127,127,20
108,seq51,r_41_216_42,seq5,r_41_216_42,0.65,35,77,42,20
65,r_33_139_30,r_113_178_196,seq111,r_33_139_30,0.95,3,33,30,20
12,r_9_187_104,seq5,r_19_102_107,r_9_187_104,1.0,7,111,104,20
17,r_37_105_40,r_24_76_58,seq43,r_37_105_40,0.53,2,42,40,20
36,r_10_186_13,r_191_46_29,seq195,r_10_186_13,0.98,0,13,13,20
128,seq206,r_179_141_89,seq55,r_179_141_89,1.0,0,89,89,20
93,seq152,r_106_63_85,r_1_72_72,r_106_63_85,1.0,0,85,85,21
30,r_67_219_167,r_170_71_168,r_151_143_133,r_67_219_167,0.83,1,168,167,21
53,r_210_135_30,r_1_72_72,seq70,r_210_135_30,1.0,-1,29,30,21
73,r_198_117_12,r_67_219_167,r_83_18_196,r_198_117_12,0.88,0,12,12,21
68,r_34_165_36,r_83_18_196,r_105_98_15,r_34_165_36,1.0,-5,31,36,21
14,r_78_11_86,seq183,r_43_33_46,r_78_11_86,1.0,3,89,86,21
8,r_160_108_82,r_146_27_157,r_198_117_12,r_160_108_82,0.97,0,82,82,21
54,r_174_129_116,seq138,seq0,r_174_129_116,0.95,0,116,116,21
37,r_208_178_63,seq52,seq55,r_208_178_63,1.0,0,63,63,21
59,r_169_45_183,seq202,r_177_212_42,r_169_45_183,0.52,2,185,183,21
71,r_197_62_109,r_12_142_114,seq2,r_197_62_109,0.99,0,109,109,21
21,r_10_21_78,r_131_155_163,r_47_24_4,r_10_21_78,1.0,0,78,78,21
39,r_69_35_182,seq221,r_109_80_13,r_69_35_182,0.55,0,182,182,21
143,seq103,r_161_195_193,r_160_108_82,r_160_108_82,1.0,101,183,82,21
35,r_179_91_4,r_177_212_42,seq8,r_177_212_42,1.0,3,45,42,21
5,r_37_110_43,r_181_9_94,seq75,r_37_110_43,1.0,0,43,43,21
44,r_188_66_92,seq190,r_38_175_107,r_38_175_107,0.76,28,135,107,21
19,r_102_13_149,seq167,seq216,r_102_13_149,0.75,0,149,149,21
77,seq2,seq128,r_197_62_109,r_197_62_109,0.98,35,144,109,21
66,r_17_157_177,seq189,r_67_219_167,r_67_219_167,0.69,10,177,167,21
148,seq125,seq73,r_144_222_46,r_144_222_46,1.0,1,47,46,21
31,r_111_191_173,seq14,seq216,r_111_191_173,0.67,2,175,173,21
41,r_139_44_199,r_146_27_157,r_116_118_56,r_116_118_56,1.0,70,126,56,21
67,r_5_60_181,seq207,r_170_71_168,r_5_60_181,0.37,0,181,181,21
51,r_43_33_46,r_181_9_94,seq70,r_43_33_46,0.91,-1,45,46,21
103,seq41,r_94_68_119,seq128,r_94_68_119,0.98,-65,54,119,21
10,r_181_9_94,seq3,r_163_19_65,r_181_9_94,0.7,-1,93,94,21
72,r_127_95_65,r_5_60_181,seq3,r_127_95_65,1.0,0,65,65,21
0,r_16_97_2,r_158_134_151,seq79,r_158_134_151,1.0,0,151,151,21
11,r_217_203_97,seq26,seq70,r_217_203_97,1.0,0,97,97,21
20,r_96_136_119,r_16_97_2,seq201,r_96_136_119,0.94,0,119,119,21
13,r_49_123_78,seq88,seq70,r_49_123_78,1.0,1,79,78,21
15,r_220_150_117,r_28_145_144,r_181_9_94,r_220_150_117,0.63,3,120,117,21
48,r_170_71_168,r_67_219_167,seq138,r_170_71_168,0.81,0,168,168,21
106,seq221,r_69_35_182,r_111_191_173,r_111_191_173,0.61,9,182,173,21
62,r_50_90_177,seq70,seq214,r_50_90_177,0.6,0,177,177,21
34,r_74_192_159,r_65_29_91,seq168,r_65_29_91,0.63,-32,59,91,21
45,r_92_187_47,r_127_95_65,r_105_98_15,r_92_187_47,0.78,0,47,47,21
70,r_76_159_25,r_1_72_72,seq75,r_76_159_25,0.96,1,26,25,21
6,r_177_212_42,r_179_91_4,seq207,r_177_212_42,1.0,3,45,42,21
42,r_109_80_13,r_151_143_133,seq14,r_109_80_13,1.0,0,13,13,21
87,seq201,r_50_90_177,r_96_136_119,r_96_136_119,0.78,14,133,119,21
32,r_107_133_22,seq128,seq211,r_107_133_22,1.0,0,22,22,21
26,r_105_98_15,r_153_84_145,seq52,r_105_98_15,1.0,0,15,15,21
2,r_131_155_163,seq189,r_74_192_159,r_131_155_163,0.72,0,163,163,21
74,r_146_27_157,r_139_44_199,seq205,r_146_27_157,0.93,0,157,157,21
18,r_53_112_153,seq75,r_47_24_4,r_53_112_153,0.93,0,153,153,21
29,r_147_180_40,r_87_119_172,r_106_63_85,r_147_180_40,0.79,48,88,40,21
34,r_74_192_159,seq168,seq86,r_74_192_159,0.49,0,159,159,21
61,r_93_120_25,r_82_51_195,r_184_173_9,r_93_120_25,1.0,-2,23,25,21
25,r_65_29_91,r_111_191_173,r_163_19_65,r_65_29_91,0.99,1,92,91,21
33,r_196_140_110,seq194,seq57,r_196_140_110,1.0,2,112,110,21
50,r_158_134_151,r_16_97_2,seq152,r_158_134_151,0.92,0,151,151,21
58,r_38_175_107,r_94_68_119,r_188_66_92,r_38_175_107,0.7,1,108,107,21
47,r_144_222_46,r_28_145_144,seq125,r_144_222_46,1.0,0,46,46,21
65,r_4_115_103,r_5_60_181,r_107_133_22,r_4_115_103,0.81,0,103,103,21
38,r_151_143_133,seq190,seq3,r_151_143_133,0.78,1,134,133,21
52,r_87_119_172,seq15,r_196_140_110,r_196_140_110,1.0,63,173,110,21
77,seq2,r_193_104_87,seq128,r_193_104_87,0.45,-14,73,87,21
60,r_124_121_82,r_153_84_145,r_177_212_42,r_124_121_82,1.0,0,82,82,21
17,r_163_19_65,r_96_136_119,r_105_98_15,r_163_19_65,0.87,-1,64,65,21
9,r_153_84_145,seq22,seq103,r_153_84_145,0.91,0,145,145,21
145,seq189,r_131_155_163,seq138,r_131_155_163,1.0,0,163,163,21
43,r_116_118_56,r_65_29_91,r_144_222_46,r_116_118_56,1.0,0,56,56,21
120,seq70,r_50_90_177,r_217_203_97,r_217_203_97,0.99,80,177,97,21
123,seq73,r_146_27_157,r_116_118_56,r_116_118_56,0.93,71,127,56,21
4,r_83_18_196,r_34_165_36,r_198_117_12,r_83_18_196,0.7,-161,35,196,21
49,r_106_63_85,seq152,r_147_180_40,r_106_63_85,0.97,0,85,85,21
56,r_6_164_167,seq138,r_67_219_167,r_6_164_167,0.76,-1,166,167,21
44,r_188_66_92,seq22,seq190,r_188_66_92,0.99,0,92,92,21
69,r_141_30_23,r_94_68_119,r_198_117_12,r_141_30_23,1.0,0,23,23,21
23,r_193_104_87,seq2,r_141_30_23,r_193_104_87,0.86,1,88,87,21
12,r_94_68_119,seq41,r_109_80_13,r_94_68_119,1.0,1,120,119,21
30,r_46_3_55,seq1,r_79_163_185,r_46_3_55,0.55,13,68,55,22
4,r_31_109_32,r_83_67_45,seq188,r_31_109_32,1.0,-3,29,32,22
36,r_70_81_107,seq218,r_28_174_21,r_70_81_107,0.71,0,107,107,22
92,seq34,r_38_45_179,r_156_120_51,r_156_120_51,1.0,128,179,51,22
14,r_131_106_59,seq166,seq188,r_131_106_59,0.96,2,61,59,22
147,seq153,r_216_151_69,seq140,r_216_151_69,0.67,8,77,69,22
8,r_178_59_61,r_70_81_107,r_114_43_70,r_178_59_61,1.0,16,77,61,22
53,r_155_141_172,r_172_219_188,seq36,r_172_219_188,0.52,-14,174,188,22
54,r_112_60_116,r_101_122_190,r_159_144_64,r_159_144_64,1.0,55,119,64,22
37,r_47_87_113,seq168,r_212_17_30,r_47_87_113,0.85,0,113,113,22
59,r_90_5_178,seq34,r_22_186_153,r_22_186_153,0.75,25,178,153,22
55,r_124_157_158,r_136_68_48,r_224_6_83,r_136_68_48,0.4,111,159,48,22
16,r_143_55_99,r_135_21_152,seq20,r_143_55_99,0.99,0,99,99,22
21,r_135_21_152,r_143_55_99,r_159_144_64,r_159_144_64,0.56,35,99,64,22
39,r_104_42_137,r_96_27_186,r_196_97_138,r_104_42_137,0.93,0,137,137,22
1,r_182_111_102,r_108_220_135,r_51_9_78,r_108_220_135,1.0,-31,104,135,22
46,r_71_127_109,r_85_74_146,r_159_144_64,r_159_144_64,0.99,47,111,64,22
95,seq166,r_131_106_59,r_79_163_185,r_131_106_59,1.0,2,61,59,22
66,r_201_195_1,seq93,r_128_76_146,r_128_76_146,1.0,0,146,146,22
76,seq4,r_128_76_146,r_213_98_134,r_128_76_146,0.72,0,146,146,22
103,seq177,r_108_220_135,r_121_49_57,r_121_49_57,0.98,18,75,57,22
31,r_165_18_70,r_39_217_197,seq44,r_165_18_70,1.0,0,70,70,22
129,seq164,r_101_122_190,r_203_137_161,r_203_137_161,0.69,9,170,161,22
41,r_132_202_90,r_190_199_194,seq198,r_132_202_90,0.99,2,92,90,22
67,r_128_76_146,seq4,r_201_195_1,r_128_76_146,0.97,0,146,146,22
72,r_89_95_27,r_143_55_99,seq193,r_143_55_99,0.48,-72,27,99,22
73,r_64_11_26,r_31_109_32,r_135_21_152,r_64_11_26,0.85,0,26,26,22
143,seq115,seq133,r_212_17_30,r_212_17_30,1.0,3,33,30,22
63,r_37_181_73,r_128_76_146,seq75,r_37_181_73,0.61,2,75,73,22
11,r_38_45_179,seq34,r_22_186_153,r_22_186_153,0.67,26,179,153,22
20,r_51_9_78,seq193,seq168,r_51_9_78,1.0,1,79,78,22
13,r_180_209_141,r_73_176_123,r_121_49_57,r_121_49_57,0.95,75,132,57,22
15,r_154_13_71,r_62_139_94,r_108_220_135,r_62_139_94,1.0,-19,75,94,22
48,r_136_68_48,seq146,r_7_125_67,r_7_125_67,1.0,10,77,67,22
57,r_158_179_112,r_126_0_180,r_178_59_61,r_158_179_112,0.91,1,113,112,22
25,r_147_183_20,r_65_56_81,seq61,r_147_183_20,0.81,0,20,20,22
52,r_171_148_42,r_22_186_153,seq10,r_171_148_42,1.0,0,42,42,22
6,r_65_56_81,seq117,seq218,r_65_56_81,1.0,1,82,81,22
62,r_79_163_185,r_22_186_153,seq166,r_22_186_153,0.91,3,156,153,22
75,seq1,r_46_3_55,seq218,r_46_3_55,0.94,1,56,55,22
30,r_46_3_55,r_79_163_185,seq166,r_79_163_185,0.68,-30,155,185,22
32,r_159_144_64,r_135_21_152,r_71_127_109,r_159_144_64,1.0,56,120,64,22
2,r_126_0_180,seq48,seq146,r_126_0_180,0.26,-6,174,180,22
47,r_206_214_115,r_173_8_177,r_154_13_71,r_206_214_115,0.58,0,115,115,22
40,r_29_187_132,seq93,seq188,r_29_187_132,0.92,0,132,132,22
74,r_213_98_134,seq175,seq4,r_213_98_134,0.5,0,134,134,22
29,r_162_15_153,seq35,r_135_21_152,r_162_15_153,0.87,0,153,153,22
24,r_222_192_164,r_143_55_99,r_159_144_64,r_222_192_164,0.94,-101,63,164,22
34,r_83_67_45,seq218,r_73_176_123,r_73_176_123,0.55,9,132,123,22
7,r_28_174_21,r_31_109_32,seq204,r_28_174_21,1.0,-1,20,21,22
33,r_32_99_97,r_123_2_123,r_182_111_102,r_32_99_97,0.89,5,102,97,22
64,r_114_43_70,r_47_87_113,r_178_59_61,r_114_43_70,1.0,0,70,70,22
111,seq61,seq208,r_147_183_20,r_147_183_20,0.93,20,40,20,22
50,r_216_151_69,seq153,seq75,r_216_151_69,0.93,8,77,69,22
58,r_160_215_72,r_126_0_180,seq52,r_160_215_72,0.85,6,78,72,22
70,r_108_220_135,seq78,r_130_80_41,r_130_80_41,0.76,41,82,41,22
65,r_16_210_99,seq145,r_147_183_20,r_16_210_99,0.87,0,99,99,22
68,r_196_97_138,seq23,r_104_42_137,r_196_97_138,0.62,2,140,138,22
62,r_79_163_185,seq166,r_194_150_166,r_79_163_185,0.78,0,185,185,22
61,r_85_74_146,seq134,r_64_11_26,r_85_74_146,0.89,1,147,146,22
32,r_159_144_64,seq86,r_135_21_152,r_159_144_64,1.0,0,64,64,22
38,r_101_122_190,r_112_60_116,r_105_84_2,r_112_60_116,0.96,3,119,116,22
0,r_156_120_51,r_178_59_61,seq34,r_156_120_51,1.0,1,52,51,22
60,r_33_119_126,seq117,r_196_97_138,r_33_119_126,0.99,0,126,126,22
18,r_212_17_30,r_126_0_180,seq115,r_212_17_30,0.99,0,30,30,22
17,r_149_40_156,r_129_142_128,seq197,r_149_40_156,0.58,1,157,156,22
119,seq75,seq177,r_65_56_81,r_65_56_81,1.0,2,83,81,22
5,r_130_80_41,r_131_106_59,r_108_220_135,r_131_106_59,0.75,-18,41,59,22
9,r_22_186_153,r_79_163_185,r_85_74_146,r_22_186_153,0.6,2,155,153,22
21,r_135_21_152,r_159_144_64,r_162_15_153,r_135_21_152,0.98,0,152,152,22
28,r_62_139_94,seq25,r_7_125_67,r_62_139_94,1.0,0,94,94,22
73,r_64_11_26,r_135_21_152,r_22_186_153,r_135_21_152,0.76,-2,150,152,22
34,r_83_67_45,r_73_176_123,seq218,r_83_67_45,0.75,1,46,45,22
56,r_7_125_67,seq198,r_136_68_48,r_7_125_67,1.0,2,69,67,22
44,r_172_219_188,r_155_141_172,r_149_40_156,r_155_141_172,0.69,4,176,172,22
23,r_194_150_166,r_38_45_179,r_156_120_51,r_156_120_51,1.0,13,64,51,22
101,seq175,r_213_98_134,r_105_84_2,r_213_98_134,0.87,-32,102,134,22
35,r_203_137_161,r_39_217_197,seq164,r_203_137_161,0.78,0,161,161,22
12,r_58_118_38,r_159_144_64,r_129_142_128,r_129_142_128,0.86,-90,38,128,22
95,seq166,r_79_163_185,r_46_3_55,r_46_3_55,0.49,130,185,55,22
26,r_121_49_57,seq188,seq177,r_121_49_57,0.76,1,58,57,22
23,r_194_150_166,r_156_120_51,r_171_148_42,r_194_150_166,0.93,2,168,166,22
84,seq20,seq94,r_143_55_99,r_143_55_99,1.0,1,100,99,22
41,r_82_120_45,r_222_128_169,r_13_135_33,r_222_128_169,0.77,-124,45,169,23
68,r_156_30_18,r_32_174_153,seq219,r_156_30_18,0.95,0,18,18,23
65,r_68_148_163,r_80_137_81,r_93_50_36,r_93_50_36,0.89,16,52,36,23
53,r_175_130_177,seq20,r_163_3_143,r_175_130_177,0.56,0,177,177,23
57,r_178_1_19,r_32_174_153,r_28_107_51,r_28_107_51,1.0,17,68,51,23
25,r_133_180_24,seq33,seq125,r_133_180_24,0.97,0,24,24,23
30,r_129_223_18,r_31_165_114,seq2,r_129_223_18,0.95,0,18,18,23
18,r_108_147_50,seq45,seq6,r_108_147_50,1.0,1,51,50,23
39,r_202_111_69,seq34,seq2,r_202_111_69,1.0,0,69,69,23
5,r_31_165_114,seq6,r_176_220_34,r_31_165_114,0.88,0,114,114,23
24,r_57_5_88,r_211_65_175,r_13_135_33,r_13_135_33,0.9,8,41,33,23
69,r_76_10_166,seq154,r_52_24_22,r_76_10_166,0.7,0,166,166,23
61,r_63_72_11,r_122_81_182,r_54_150_147,r_63_72_11,0.94,-1,10,11,23
52,r_66_64_153,r_93_50_36,seq132,r_66_64_153,0.46,0,153,153,23
15,r_32_174_153,r_178_1_19,r_176_220_34,r_176_220_34,0.65,120,154,34,23
66,r_211_65_175,seq179,r_129_223_18,r_129_223_18,0.51,157,175,18,23
31,r_78_56_118,r_11_189_38,r_110_87_92,r_78_56_118,0.45,0,118,118,23
36,r_134_224_52,r_123_27_111,r_166_152_193,r_134_224_52,1.0,1,53,52,23
67,r_221_4_181,seq73,r_122_81_182,r_122_81_182,0.66,-1,181,182,23
67,r_221_4_181,r_140_127_48,seq73,r_140_127_48,1.0,0,48,48,23
57,r_178_1_19,r_28_107_51,r_32_174_153,r_178_1_19,0.99,0,19,19,23
26,r_62_103_65,r_221_4_181,seq73,r_62_103_65,0.91,91,156,65,23
48,r_86_203_17,r_122_81_182,r_106_198_17,r_86_203_17,1.0,0,17,17,23
72,r_214_37_128,r_44_157_191,seq94,r_214_37_128,0.93,3,131,128,23
4,r_164_171_90,r_54_150_147,seq20,r_54_150_147,0.59,-50,97,147,23
78,seq179,r_211_65_175,r_28_107_51,r_28_107_51,1.0,124,175,51,23
0,r_99_104_71,seq145,r_80_137_81,r_80_137_81,0.99,0,81,81,23
63,r_91_53_65,seq96,seq17,r_91_53_65,1.0,1,66,65,23
73,r_163_3_143,seq177,r_175_130_177,r_163_3_143,0.61,35,178,143,23
20,r_36_43_184,seq199,r_122_81_182,r_122_81_182,0.75,2,184,182,23
13,r_172_41_73,seq12,r_13_135_33,r_172_41_73,1.0,0,73,73,23
117,seq196,seq132,r_68_148_163,r_68_148_163,0.66,1,164,163,23
6,r_206_98_159,r_117_153_156,r_108_147_50,r_206_98_159,0.53,-3,156,159,23
54,r_191_112_34,r_44_157_191,r_106_198_17,r_191_112_34,0.99,0,34,34,23
85,seq17,seq35,r_91_53_65,r_91_53_65,1.0,40,105,65,23
43,r_106_198_17,r_206_98_159,r_86_203_17,r_106_198_17,1.0,0,17,17,23
59,r_77_114_38,seq200,seq143,r_77_114_38,0.99,0,38,38,23
136,seq94,seq192,r_214_37_128,r_214_37_128,1.0,-2,126,128,23
29,r_52_24_22,seq58,r_11_189_38,r_52_24_22,1.0,0,22,22,23
7,r_47_38_47,r_140_127_48,seq55,r_47_38_47,1.0,0,47,47,23
47,r_110_87_92,r_70_26_188,seq131,r_110_87_92,1.0,0,92,92,23
15,r_32_174_153,r_211_65_175,r_178_1_19,r_178_1_19,1.0,14,33,19,23
40,r_212_141_110,seq190,seq40,r_212_141_110,1.0,0,110,110,23
122,seq74,r_222_128_169,r_140_127_48,r_140_127_48,0.99,10,58,48,23
74,r_90_7_125,r_205_183_125,seq18,r_90_7_125,0.94,1,126,125,23
24,r_57_5_88,r_13_135_33,r_206_98_159,r_57_5_88,1.0,0,88,88,23
46,r_13_135_33,seq143,r_57_5_88,r_13_135_33,0.98,-2,31,33,23
2,r_84_118_30,r_163_3_143,r_62_103_65,r_84_118_30,0.86,0,30,30,23
33,r_119_85_142,r_19_139_135,seq218,r_119_85_142,0.95,0,142,142,23
64,r_19_139_135,r_119_85_142,seq23,r_119_85_142,0.99,-5,137,142,23
65,r_68_148_163,r_93_50_36,seq196,r_68_148_163,0.57,0,163,163,23
3,r_28_107_51,seq23,r_178_1_19,r_28_107_51,1.0,0,51,51,23
88,seq20,r_175_130_177,r_164_171_90,r_175_130_177,0.69,-26,151,177,23
50,r_123_27_111,seq113,seq144,r_123_27_111,0.98,2,113,111,23
70,r_14_100_90,r_175_130_177,seq42,r_14_100_90,1.0,2,92,90,23
32,r_187_201_128,r_66_64_153,r_28_107_51,r_187_201_128,1.0,1,129,128,23
52,r_66_64_153,r_187_201_128,r_93_50_36,r_93_50_36,0.69,93,129,36,23
10,r_142_138_42,r_28_107_51,r_97_126_2,r_97_126_2,1.0,40,42,2,23
34,r_44_157_191,r_214_37_128,r_136_22_8,r_214_37_128,0.62,3,131,128,23
60,r_80_137_81,r_68_148_163,r_99_104_71,r_80_137_81,1.0,0,81,81,23
106,seq55,seq196,r_47_38_47,r_47_38_47,1.0,12,59,47,23
17,r_11_189_38,r_78_56_118,r_52_24_22,r_11_189_38,0.99,80,118,38,23
112,seq190,r_212_141_110,seq177,r_212_141_110,1.0,0,110,110,23
94,seq33,r_68_148_163,r_93_50_36,r_93_50_36,1.0,68,104,36,23
121,seq73,r_221_4_181,r_62_103_65,r_62_103_65,0.9,117,182,65,23
9,r_222_128_169,seq95,r_142_138_42,r_142_138_42,0.9,127,169,42,23
24,r_57_5_88,r_206_98_159,r_217_21_21,r_206_98_159,1.0,0,159,159,23
62,r_140_127_48,r_221_4_181,seq74,r_140_127_48,1.0,0,48,48,23
21,r_176_220_34,r_108_147_50,seq143,r_176_220_34,1.0,0,34,34,23
133,seq218,r_66_64_153,r_119_85_142,r_119_85_142,0.97,11,153,142,23
22,r_170_208_164,seq8,r_206_98_159,r_206_98_159,0.99,16,175,159,23
49,r_205_183_125,r_90_7_125,seq116,r_205_183_125,0.94,1,126,125,23
56,r_169_101_112,seq83,seq2,r_169_101_112,0.88,1,113,112,23
44,r_121_29_32,seq196,r_47_38_47,r_47_38_47,1.0,72,119,47,23
51,r_92_15_14,r_63_72_11,seq144,r_92_15_14,0.83,3,17,14,23
46,r_13_135_33,r_57_5_88,r_172_41_73,r_13_135_33,0.55,55,88,33,23
35,r_48_16_96,r_11_189_38,seq39,r_48_16_96,1.0,0,96,96,23
12,r_71_61_76,r_11_189_38,seq79,r_71_61_76,1.0,0,76,76,23
19,r_217_21_21,seq35,seq23,r_217_21_21,0.99,0,21,21,23
84,seq144,seq105,r_92_15_14,r_92_15_14,0.74,71,85,14,23
68,r_33_224_31,r_201_107_177,seq199,r_33_224_31,0.99,0,31,31,24
14,r_222_165_111,r_122_156_185,r_206_15_16,r_222_165_111,0.97,0,111,111,24
131,seq91,seq76,r_60_188_35,r_60_188_35,0.98,-1,34,35,24
100,seq172,seq48,r_181_21_38,r_181_21_38,1.0,6,44,38,24
146,seq120,seq25,r_1_223_62,r_1_223_62,1.0,11,73,62,24
18,r_206_15_16,r_102_5_186,r_36_93_81,r_206_15_16,0.99,0,16,16,24
54,r_57_104_138,seq46,r_64_144_78,r_57_104_138,0.9,0,138,138,24
37,r_17_178_98,r_51_155_124,seq179,r_17_178_98,0.72,1,99,98,24
15,r_94_212_169,seq179,seq127,r_94_212_169,0.99,1,170,169,24
7,r_174_10_43,r_19_101_112,r_2_211_195,r_174_10_43,0.95,-1,42,43,24
55,r_154_40_129,seq49,seq28,r_154_40_129,0.98,0,129,129,24
24,r_36_93_81,r_84_65_12,r_206_15_16,r_206_15_16,0.54,0,16,16,24
16,r_167_203_186,r_145_132_186,r_82_220_155,r_82_220_155,0.87,1,156,155,24
1,r_137_208_4,r_18_52_189,r_98_12_90,r_98_12_90,1.0,8,98,90,24
5,r_102_5_186,seq22,r_90_105_101,r_90_105_101,1.0,85,186,101,24
42,r_63_192_63,r_8_45_130,seq22,r_63_192_63,1.0,0,63,63,24
111,seq59,r_23_0_74,seq47,r_23_0_74,0.98,-8,66,74,24
69,r_98_12_90,r_145_132_186,r_137_208_4,r_98_12_90,1.0,0,90,90,24
12,r_196_31_24,r_204_42_164,r_98_12_90,r_196_31_24,0.87,-1,23,24,24
24,r_36_93_81,r_206_15_16,r_14_133_27,r_36_93_81,1.0,0,81,81,24
19,r_90_105_101,r_2_211_195,r_36_93_81,r_90_105_101,0.69,0,101,101,24
4,r_205_218_13,r_170_16_102,r_41_27_169,r_205_218_13,0.66,2,15,13,24
22,r_124_53_23,r_1_223_62,r_146_163_177,r_124_53_23,0.9,-4,19,23,24
95,seq37,r_19_101_112,r_84_65_12,r_19_101_112,0.99,-15,97,112,24
41,r_3_159_142,seq99,r_17_178_98,r_3_159_142,0.79,1,143,142,24
67,r_2_211_195,r_130_89_79,r_174_10_43,r_130_89_79,0.74,-2,77,79,24
3,r_50_140_92,r_154_40_129,seq71,r_50_140_92,1.0,0,92,92,24
10,r_67_158_128,r_57_104_138,seq183,r_57_104_138,0.73,-6,132,138,24
8,r_145_132_186,r_98_12_90,r_196_31_24,r_145_132_186,0.64,-163,23,186,24
26,r_9_152_128,seq219,seq87,r_9_152_128,0.91,0,128,128,24
8,r_145_132_186,r_196_31_24,r_64_144_78,r_196_31_24,0.27,162,186,24,24
72,r_44_106_118,seq179,seq149,r_44_106_118,1.0,0,118,118,24
0,r_136_100_171,seq43,seq160,r_136_100_171,0.46,0,171,171,24
63,r_122_156_185,seq69,r_195_85_142,r_195_85_142,0.78,43,185,142,24
39,r_198_217_47,r_214_92_138,seq191,r_198_217_47,0.69,-2,45,47,24
73,r_180_135_136,r_1_223_62,r_6_150_142,r_1_223_62,1.0,-1,61,62,24
20,r_215_157_76,seq78,r_196_31_24,r_215_157_76,1.0,0,76,76,24
13,r_170_16_102,seq25,seq109,r_170_16_102,0.99,0,102,102,24
15,r_94_212_169,r_62_138_137,seq179,r_62_138_137,1.0,0,137,137,24
48,r_112_171_77,r_108_142_105,r_34_141_77,r_34_141_77,1.0,2,79,77,24
57,r_97_20_134,seq119,r_34_141_77,r_97_20_134,0.94,1,135,134,24
12,r_196_31_24,r_98_12_90,r_215_157_76,r_196_31_24,0.48,66,90,24,24
37,r_17_178_98,seq179,r_3_159_142,r_3_159_142,0.87,0,142,142,24
6,r_210_182_165,r_148_190_177,r_137_208_4,r_137_208_4,0.81,162,166,4,24
62,r_1_223_62,r_180_135_136,seq120,r_1_223_62,1.0,-1,61,62,24
21,r_214_92_138,r_196_31_24,r_63_192_63,r_214_92_138,0.72,0,138,138,24
99,seq43,r_136_100_171,seq193,r_136_100_171,0.55,0,171,171,24
27,r_34_141_77,seq77,r_112_171_77,r_34_141_77,0.99,0,77,77,24
51,r_146_163_177,r_124_53_23,r_50_140_92,r_146_163_177,0.73,2,179,177,24
87,seq28,seq176,r_154_40_129,r_154_40_129,1.0,28,157,129,24
51,r_146_163_177,seq173,r_124_53_23,r_124_53_23,1.0,3,26,23,24
22,r_124_53_23,r_146_163_177,seq173,r_146_163_177,0.92,2,179,177,24
2,r_80_75_79,seq113,r_189_70_77,r_80_75_79,1.0,0,79,79,24
47,r_82_220_155,r_210_182_165,r_204_42_164,r_82_220_155,0.76,0,155,155,24
28,r_84_65_12,r_36_93_81,seq37,r_84_65_12,0.62,-1,11,12,24
71,r_38_4_32,r_50_140_92,seq25,r_50_140_92,0.54,-60,32,92,24
74,r_130_89_79,r_2_211_195,seq161,r_130_89_79,1.0,0,79,79,24
29,r_79_128_120,r_51_155_124,r_56_194_85,r_56_194_85,0.93,36,121,85,24
18,r_206_15_16,r_84_65_12,r_222_165_111,r_222_165_111,0.68,-4,107,111,24
34,r_7_213_160,r_189_70_77,r_34_141_77,r_7_213_160,0.93,1,161,160,24
25,r_23_0_74,seq59,seq48,r_23_0_74,1.0,0,74,74,24
33,r_8_45_130,seq199,seq47,r_8_45_130,0.95,1,131,130,24
59,r_30_221_70,r_204_42_164,seq29,r_30_221_70,0.87,-11,59,70,24
58,r_204_42_164,seq151,r_82_220_155,r_82_220_155,0.88,9,164,155,24
70,r_189_70_77,r_153_32_87,r_80_75_79,r_189_70_77,1.0,-1,76,77,24
64,r_181_21_38,r_61_81_164,seq172,r_181_21_38,1.0,0,38,38,24
137,seq109,seq173,r_170_16_102,r_170_16_102,0.99,-4,98,102,24
61,r_55_24_178,seq149,r_195_85_142,r_195_85_142,0.98,37,179,142,24
38,r_64_144_78,r_18_52_189,seq166,r_64_144_78,0.86,6,84,78,24
52,r_56_194_85,seq86,r_23_0_74,r_56_194_85,1.0,0,85,85,24
21,r_214_92_138,r_198_217_47,r_196_31_24,r_214_92_138,0.65,-87,51,138,24
34,r_7_213_160,r_19_101_112,r_189_70_77,r_7_213_160,0.64,-86,74,160,24
122,seq76,seq91,r_60_188_35,r_60_188_35,1.0,-1,34,35,24
60,r_184_83_194,r_122_156_185,r_167_203_186,r_167_203_186,0.37,-1,185,186,24
17,r_61_81_164,seq74,r_154_40_129,r_61_81_164,0.89,0,164,164,24
112,seq191,r_108_142_105,r_198_217_47,r_198_217_47,0.76,34,81,47,24
144,seq187,seq116,r_51_155_124,r_51_155_124,1.0,6,130,124,24
9,r_62_138_137,r_94_212_169,seq116,r_62_138_137,0.93,0,137,137,24
120,seq73,r_189_70_77,r_125_202_87,r_189_70_77,0.75,-6,71,77,24
53,r_60_188_35,r_174_10_43,seq91,r_60_188_35,0.87,0,35,35,24
73,r_180_135_136,r_6_150_142,r_80_75_79,r_180_135_136,0.63,0,136,136,24
135,seq99,r_3_159_142,seq207,r_3_159_142,0.97,1,143,142,24
49,r_19_101_112,seq37,seq110,r_19_101_112,0.98,2,114,112,24
149,seq127,r_51_155_124,r_58_13_195,r_51_155_124,1.0,0,124,124,24
56,r_125_202_87,r_195_85_142,seq73,r_195_85_142,0.79,-57,85,142,24
18,r_206_15_16,r_36_93_81,r_84_65_12,r_36_93_81,0.76,2,83,81,24
23,r_51_155_124,seq127,seq187,r_51_155_124,1.0,0,124,124,24
82,seq22,r_102_5_186,r_63_192_63,r_63_192_63,1.0,4,67,63,24
65,r_18_52_189,r_64_144_78,r_137_208_4,r_18_52_189,0.65,-153,36,189,24
35,r_148_190_177,seq185,r_174_10_43,r_148_190_177,0.68,0,177,177,24
128,seq86,r_56_194_85,r_137_208_4,r_56_194_85,1.0,-31,54,85,24
46,r_14_133_27,r_117_169_190,seq185,r_14_133_27,0.96,0,27,27,24
30,r_45_93_162,seq0,r_100_16_51,r_45_93_162,0.88,0,162,162,25
36,r_66_62_64,r_173_209_198,seq204,r_66_62_64,1.0,0,64,64,25
48,r_184_149_47,r_54_212_105,r_173_209_198,r_184_149_47,1.0,1,48,47,25
65,r_157_216_46,seq31,r_29_70_11,r_157_216_46,1.0,0,46,46,25
14,r_167_50_85,seq196,seq7,r_167_50_85,1.0,0,85,85,25
8,r_206_118_66,r_172_122_104,seq191,r_206_118_66,1.0,0,66,66,25
53,r_106_36_171,r_161_53_1,r_167_50_85,r_167_50_85,1.0,87,172,85,25
37,r_172_122_104,seq203,seq107,r_172_122_104,1.0,0,104,104,25
59,r_111_17_160,seq219,r_91_34_96,r_111_17_160,0.67,0,160,160,25
55,r_123_72_118,r_102_49_133,r_153_213_3,r_153_213_3,0.6,116,119,3,25
71,r_25_48_135,r_65_55_137,r_133_114_61,r_133_114_61,0.99,78,139,61,25
21,r_179_194_75,r_222_98_47,r_211_40_165,r_179_194_75,0.93,1,76,75,25
39,r_215_170_107,seq130,r_60_188_103,r_60_188_103,0.55,6,109,103,25
1,r_128_112_131,seq78,seq11,r_128_112_131,0.9,0,131,131,25
104,seq177,r_141_140_184,r_18_83_116,r_18_83_116,0.78,52,168,116,25
46,r_195_115_147,r_222_98_47,seq78,r_195_115_147,0.85,0,147,147,25
42,r_137_221_154,seq164,r_124_158_86,r_124_158_86,1.0,76,162,86,25
69,r_151_97_181,seq21,r_187_90_129,r_187_90_129,0.97,52,181,129,25
41,r_192_168_17,seq196,r_222_98_47,r_192_168_17,0.62,8,25,17,25
23,r_3_185_55,r_148_154_147,seq2,r_3_185_55,0.51,-6,49,55,25
19,r_148_154_147,seq79,seq131,r_148_154_147,0.6,0,147,147,25
66,r_20_24_61,r_23_86_91,r_18_83_116,r_20_24_61,0.83,2,63,61,25
56,r_162_51_174,r_179_194_75,r_189_210_27,r_162_51_174,0.99,0,174,174,25
2,r_180_181_165,r_100_16_51,r_189_210_27,r_180_181_165,0.99,-114,51,165,25
129,seq78,r_128_112_131,r_153_213_3,r_128_112_131,0.97,0,131,131,25
47,r_109_190_173,r_75_81_103,r_148_154_147,r_109_190_173,1.0,0,173,173,25
64,r_91_34_96,r_88_42_181,seq89,r_91_34_96,0.53,-39,57,96,25
3,r_187_90_129,seq1,seq219,r_187_90_129,0.99,0,129,129,25
10,r_119_95_107,r_211_40_165,r_222_98_47,r_119_95_107,0.57,1,108,107,25
8,r_206_118_66,seq191,r_179_194_75,r_206_118_66,0.4,70,136,66,25
4,r_63_96_160,seq202,r_119_95_107,r_63_96_160,0.66,0,160,160,25
63,r_5_159_141,r_141_140_184,r_91_34_96,r_5_159_141,0.77,0,141,141,25
73,r_33_71_103,seq202,seq130,r_33_71_103,0.99,0,103,103,25
5,r_29_70_11,r_102_49_133,seq121,r_29_70_11,0.88,0,11,11,25
15,r_23_86_91,r_5_159_141,r_217_87_80,r_23_86_91,0.94,0,91,91,25
57,r_13_138_64,r_119_95_107,seq0,r_13_138_64,0.95,0,64,64,25
62,r_104_127_73,r_54_212_105,r_165_132_10,r_165_132_10,1.0,65,75,10,25
27,r_67_143_46,r_167_50_85,r_144_94_48,r_67_143_46,0.91,2,48,46,25
21,r_179_194_75,r_211_40_165,r_206_118_66,r_211_40_165,0.98,1,166,165,25
85,seq130,r_215_170_107,r_33_71_103,r_33_71_103,1.0,4,107,103,25
2,r_180_181_165,r_189_210_27,r_59_73_143,r_180_181_165,0.84,1,166,165,25
74,r_35_220_47,r_179_194_75,seq129,r_35_220_47,1.0,0,47,47,25
51,r_189_210_27,r_180_181_165,r_162_51_174,r_189_210_27,0.85,145,172,27,25
57,r_13_138_64,seq0,r_54_212_105,r_54_212_105,1.0,1,106,105,25
47,r_109_190_173,r_102_49_133,r_75_81_103,r_75_81_103,0.94,15,118,103,25
40,r_39_142_73,r_139_214_195,r_222_98_47,r_39_142_73,1.0,0,73,73,25
18,r_18_83_116,seq146,r_60_188_103,r_60_188_103,0.77,-28,75,103,25
29,r_54_212_105,seq41,r_13_138_64,r_54_212_105,0.99,0,105,105,25
24,r_211_40_165,r_162_51_174,r_133_114_61,r_211_40_165,0.74,1,166,165,25
33,r_224_76_79,seq183,seq177,r_224_76_79,1.0,0,79,79,25
127,seq204,r_102_49_133,seq7,r_102_49_133,0.96,1,134,133,25
12,r_52_64_39,r_217_87_80,seq7,r_52_64_39,0.88,0,39,39,25
50,r_88_42_181,seq99,seq146,r_88_42_181,0.36,2,183,181,25
58,r_173_209_198,r_66_62_64,r_184_149_47,r_173_209_198,1.0,-134,64,198,25
70,r_65_55_137,r_161_53_1,r_153_213_3,r_65_55_137,0.85,0,137,137,25
66,r_20_24_61,r_18_83_116,seq26,r_18_83_116,0.9,5,121,116,25
32,r_124_158_86,r_119_95_107,r_68_108_18,r_124_158_86,1.0,0,86,86,25
52,r_60_188_103,r_57_38_133,r_215_170_107,r_60_188_103,0.61,12,115,103,25
77,seq2,r_222_98_47,r_3_185_55,r_3_185_55,0.87,23,78,55,25
34,r_59_73_143,r_88_42_181,seq58,r_59_73_143,0.65,4,147,143,25
68,r_100_16_51,r_180_181_165,seq193,r_100_16_51,0.89,0,51,51,25
18,r_18_83_116,r_60_188_103,r_224_76_79,r_18_83_116,0.98,5,121,116,25
60,r_75_81_103,seq182,seq7,r_75_81_103,0.99,0,103,103,25
94,seq202,r_63_96_160,r_133_114_61,r_133_114_61,1.0,99,160,61,25
133,seq89,r_85_10_158,r_91_34_96,r_91_34_96,0.92,2,98,96,25
22,r_105_135_159,seq14,r_215_170_107,r_105_135_159,0.45,1,160,159,25
116,seq58,r_144_94_48,seq4,r_144_94_48,1.0,0,48,48,25
45,r_160_126_59,r_18_83_116,r_207_155_1,r_160_126_59,1.0,0,59,59,25
56,r_162_51_174,r_211_40_165,r_179_194_75,r_179_194_75,0.98,71,146,75,25
44,r_102_49_133,seq204,r_124_158_86,r_124_158_86,1.0,48,134,86,25
35,r_208_197_96,seq58,r_224_76_79,r_224_76_79,0.77,15,94,79,25
38,r_68_108_18,r_105_135_159,seq31,r_68_108_18,1.0,0,18,18,25
51,r_189_210_27,r_208_197_96,r_180_181_165,r_189_210_27,1.0,0,27,27,25
30,r_178_35_129,r_105_211_2,seq220,r_178_35_129,1.0,0,129,129,26
69,r_168_15_50,r_212_82_50,seq47,r_168_15_50,0.98,1,51,50,26
25,r_61_27_43,r_161_135_19,seq171,r_61_27_43,0.87,0,43,43,26
18,r_169_133_43,seq12,r_44_39_83,r_169_133_43,0.94,1,44,43,26
37,r_99_98_160,seq106,r_221_128_59,r_99_98_160,0.81,0,160,160,26
59,r_77_2_98,r_163_81_178,seq63,r_77_2_98,0.99,0,98,98,26
65,r_143_112_10,seq96,r_38_206_24,r_143_112_10,0.57,21,31,10,26
34,r_21_187_25,r_129_141_131,r_114_162_1,r_21_187_25,0.91,0,25,25,26
16,r_6_74_57,seq132,seq0,r_6_74_57,1.0,3,60,57,26
21,r_213_215_147,r_56_97_189,r_136_50_61,r_136_50_61,0.99,89,150,61,26
39,r_173_73_186,r_186_183_106,r_217_16_64,r_173_73_186,0.7,-107,79,186,26
1,r_58_43_156,seq20,r_105_211_2,r_58_43_156,0.84,0,156,156,26
5,r_55_23_138,r_84_9_181,r_166_59_19,r_55_23_138,0.71,8,146,138,26
42,r_1_89_137,r_158_32_160,r_148_30_129,r_1_89_137,0.92,0,137,137,26
53,r_44_39_83,r_169_133_43,r_182_195_53,r_44_39_83,1.0,1,84,83,26
80,seq7,r_88_64_155,r_201_93_11,r_88_64_155,0.66,-7,148,155,26
19,r_151_116_136,r_222_142_198,r_38_206_24,r_222_142_198,0.68,-62,136,198,26
66,r_217_16_64,seq156,r_29_165_38,r_217_16_64,0.78,6,70,64,26
120,seq208,r_168_15_50,r_113_214_141,r_113_214_141,1.0,4,145,141,26
39,r_173_73_186,r_217_16_64,r_169_133_43,r_217_16_64,0.64,124,188,64,26
31,r_199_207_165,seq126,r_151_116_136,r_199_207_165,0.84,0,165,165,26
67,r_190_198_137,r_10_150_96,seq140,r_190_198_137,0.79,0,137,137,26
24,r_182_195_53,seq121,seq167,r_182_195_53,1.0,0,53,53,26
45,r_161_135_19,r_61_27_43,r_88_64_155,r_61_27_43,0.89,0,43,43,26
26,r_46_184_195,seq204,r_1_89_137,r_1_89_137,0.99,11,148,137,26
11,r_38_206_24,r_186_183_106,r_143_112_10,r_38_206_24,0.71,2,26,24,26
46,r_181_31_25,r_186_183_106,seq76,r_181_31_25,0.81,1,26,25,26
0,r_164_5_151,seq203,r_19_185_81,r_164_5_151,0.87,0,151,151,26
18,r_169_133_43,r_44_39_83,seq91,r_44_39_83,1.0,1,84,83,26
73,r_194_87_69,r_79_192_156,r_139_127_4,r_194_87_69,1.0,1,70,69,26
15,r_209_191_109,r_108_223_193,r_161_135_19,r_209_191_109,0.77,0,109,109,26
48,r_78_11_171,seq202,r_99_98_160,r_78_11_171,0.6,0,171,171,26
65,r_143_112_10,r_88_64_155,seq96,r_143_112_10,0.96,0,10,10,26
13,r_29_165_38,r_186_183_106,r_217_16_64,r_186_183_106,1.0,0,106,106,26
6,r_62_57_150,seq71,seq45,r_62_57_150,0.93,0,150,150,26
134,seq106,r_99_98_160,seq203,r_99_98_160,0.95,0,160,160,26
136,seq203,r_154_147_153,seq106,r_154_147_153,0.98,-37,116,153,26
14,r_210_101_42,r_209_191_109,seq204,r_210_101_42,0.99,0,42,42,26
2,r_186_183_106,seq119,r_19_185_81,r_186_183_106,0.99,0,106,106,26
47,r_80_34_82,r_55_23_138,r_179_219_10,r_80_34_82,0.93,3,85,82,26
142,seq119,r_186_183_106,r_217_16_64,r_186_183_106,0.57,0,106,106,26
40,r_205_66_123,r_40_94_152,seq75,r_205_66_123,0.98,0,123,123,26
105,seq176,r_84_9_181,r_163_81_178,r_84_9_181,0.52,0,181,181,26
8,r_110_224_29,seq124,seq24,r_110_224_29,1.0,0,29,29,26
33,r_88_64_155,seq218,seq4,r_88_64_155,0.89,0,155,155,26
68,r_92_51_15,r_110_224_29,r_19_185_81,r_19_185_81,0.95,-67,14,81,26
64,r_136_50_61,seq177,r_58_43_156,r_136_50_61,1.0,1,62,61,26
47,r_80_34_82,r_179_219_10,r_114_162_1,r_179_219_10,0.51,160,170,10,26
58,r_153_138_104,seq208,seq67,r_153_138_104,0.97,0,104,104,26
70,r_154_147_153,seq203,r_29_165_38,r_154_147_153,0.87,-2,151,153,26
56,r_221_128_59,r_40_94_152,r_61_27_43,r_221_128_59,1.0,0,59,59,26
51,r_103_22_59,r_113_214_141,r_200_174_27,r_103_22_59,0.88,0,59,59,26
72,r_19_185_81,r_166_59_19,r_92_51_15,r_92_51_15,0.97,0,15,15,26
32,r_79_192_156,r_26_54_186,seq119,r_79_192_156,0.85,1,157,156,26
45,r_161_135_19,r_88_64_155,r_209_191_109,r_209_191_109,0.61,-8,101,109,26
68,r_92_51_15,r_19_185_81,seq96,r_19_185_81,0.93,0,81,81,26
64,r_136_50_61,r_58_43_156,r_213_215_147,r_58_43_156,0.62,-4,152,156,26
75,seq0,r_88_64_155,r_6_74_57,r_6_74_57,0.9,65,122,57,26
35,r_160_118_25,r_169_133_43,seq176,r_160_118_25,0.79,1,26,25,26
112,seq67,seq124,r_153_138_104,r_153_138_104,0.83,7,111,104,26
53,r_44_39_83,seq91,r_169_133_43,r_169_133_43,0.97,7,50,43,26
9,r_113_214_141,seq159,seq208,r_113_214_141,0.93,1,142,141,26
22,r_65_36_138,seq71,seq115,r_65_36_138,0.96,0,138,138,26
57,r_179_219_10,r_44_39_83,seq208,r_179_219_10,0.86,0,10,10,26
28,r_85_100_120,seq137,seq123,r_85_100_120,0.9,0,120,120,26
72,r_19_185_81,r_92_51_15,seq157,r_19_185_81,0.98,0,81,81,26
41,r_200_174_27,r_129_141_131,seq107,r_200_174_27,0.97,2,29,27,26
149,seq126,r_199_207_165,r_129_141_131,r_199_207_165,0.95,0,165,165,26
54,r_212_82_50,seq188,seq159,r_212_82_50,1.0,2,52,50,26
7,r_40_94_152,r_222_142_198,r_114_162_1,r_40_94_152,0.51,0,152,152,26
13,r_29_165_38,seq3,r_186_183_106,r_29_165_38,0.97,0,38,38,26
23,r_148_30_129,seq220,r_1_89_137,r_1_89_137,0.96,15,152,137,26
101,seq171,r_155_197_164,r_99_98_160,r_155_197_164,0.62,3,167,164,26
43,r_83_196_44,r_6_74_57,seq180,r_83_196_44,1.0,1,45,44,26
45,r_161_135_19,r_186_183_106,r_61_27_43,r_161_135_19,0.84,-1,18,19,26
63,r_201_93_11,r_129_141_131,seq7,r_201_93_11,0.92,0,11,11,26
61,r_52_28_49,seq120,seq123,r_52_28_49,0.98,0,49,49,26
51,r_99_171_79,r_109_91_130,seq72,r_99_171_79,1.0,2,81,79,27
14,r_155_213_174,r_9_223_34,r_183_131_75,r_155_213_174,0.92,0,174,174,27
14,r_155_213_174,r_145_160_162,r_9_223_34,r_155_213_174,0.63,-12,162,174,27
131,seq211,r_155_213_174,r_167_179_10,r_167_179_10,0.89,2,12,10,27
43,r_209_81_99,r_126_216_102,r_174_92_66,r_209_81_99,0.95,1,100,99,27
45,r_167_179_10,r_135_83_163,seq211,r_167_179_10,0.98,0,10,10,27
37,r_159_117_74,r_46_195_161,r_38_166_184,r_159_117_74,1.0,0,74,74,27
59,r_22_152_131,r_18_62_133,seq220,r_22_152_131,0.99,0,131,131,27
71,r_123_32_129,r_58_45_133,r_29_95_108,r_123_32_129,0.97,0,129,129,27
16,r_119_11_111,r_38_166_184,seq23,r_119_11_111,0.77,2,113,111,27
1,r_38_166_184,r_119_11_111,r_157_122_156,r_157_122_156,0.66,3,159,156,27
97,seq31,r_135_83_163,r_1_47_93,r_1_47_93,0.62,1,94,93,27
39,r_102_149_55,r_109_91_130,r_87_35_81,r_102_149_55,0.79,28,83,55,27
5,r_174_92_66,seq197,seq161,r_174_92_66,1.0,0,66,66,27
149,seq127,r_43_105_80,r_9_223_34,r_43_105_80,0.99,-40,40,80,27
15,r_3_214_175,r_40_189_13,r_155_213_174,r_40_189_13,0.57,162,175,13,27
28,r_176_73_58,r_1_47_93,seq23,r_176_73_58,0.88,0,58,58,27
36,r_74_103_2,seq75,r_170_86_53,r_170_86_53,1.0,2,55,53,27
31,r_8_48_86,seq132,seq178,r_8_48_86,1.0,0,86,86,27
41,r_93_100_102,seq201,r_185_165_85,r_185_165_85,0.97,18,103,85,27
67,r_70_180_197,r_46_195_161,r_41_42_81,r_41_42_81,0.73,0,81,81,27
58,r_124_94_46,seq77,seq140,r_124_94_46,1.0,-2,44,46,27
89,seq20,r_6_203_107,seq215,r_6_203_107,1.0,0,107,107,27
3,r_46_195_161,seq161,r_28_85_73,r_46_195_161,0.6,0,161,161,27
115,seq61,r_87_35_81,r_182_210_43,r_87_35_81,0.97,-10,71,81,27
35,r_170_86_53,seq147,r_154_162_37,r_170_86_53,1.0,0,53,53,27
4,r_181_17_119,seq147,seq19,r_181_17_119,1.0,0,119,119,27
0,r_28_85_73,r_29_95_108,r_169_50_28,r_28_85_73,0.95,0,73,73,27
63,r_1_47_93,seq10,seq31,r_1_47_93,1.0,0,93,93,27
114,seq188,r_33_202_126,seq215,r_33_202_126,1.0,-3,123,126,27
47,r_114_107_54,r_199_108_28,seq16,r_114_107_54,1.0,0,54,54,27
20,r_145_160_162,r_155_213_174,seq194,r_145_160_162,0.65,0,162,162,27
13,r_135_83_163,seq31,r_170_86_53,r_170_86_53,0.71,110,163,53,27
56,r_40_189_13,r_3_214_175,seq188,r_3_214_175,0.85,-7,168,175,27
48,r_43_105_80,seq15,seq132,r_43_105_80,1.0,0,80,80,27
54,r_168_142_31,r_109_91_130,seq63,r_168_142_31,0.97,1,32,31,27
57,r_60_30_77,r_8_48_86,r_174_92_66,r_8_48_86,0.81,-9,77,86,27
6,r_120_53_35,r_52_134_199,seq128,r_120_53_35,1.0,2,37,35,27
85,seq15,r_43_105_80,r_14_222_71,r_43_105_80,1.0,-9,71,80,27
15,r_3_214_175,r_33_202_126,r_40_189_13,r_40_189_13,0.95,0,13,13,27
99,seq197,r_174_92_66,r_169_50_28,r_174_92_66,0.99,-3,63,66,27
46,r_182_210_43,r_170_86_53,seq61,r_170_86_53,0.98,-5,48,53,27
70,r_191_89_33,r_87_35_81,r_169_50_28,r_87_35_81,0.6,-40,41,81,27
39,r_102_149_55,r_58_45_133,r_109_91_130,r_102_149_55,1.0,1,56,55,27
2,r_29_95_108,seq104,seq187,r_29_95_108,1.0,1,109,108,27
40,r_41_42_81,r_80_64_98,r_70_180_197,r_70_180_197,0.99,-116,81,197,27
56,r_40_189_13,r_80_64_98,r_3_214_175,r_40_189_13,0.94,0,13,13,27
74,r_76_139_186,seq36,r_120_53_35,r_120_53_35,0.84,151,186,35,27
33,r_67_57_75,r_199_108_28,r_59_106_37,r_59_106_37,1.0,34,71,37,27
50,r_113_121_97,r_76_139_186,seq39,r_113_121_97,0.97,0,97,97,27
53,r_177_66_43,r_74_103_2,seq27,r_177_66_43,1.0,1,44,43,27
65,r_34_148_139,seq23,r_212_0_31,r_34_148_139,0.98,0,139,139,27
21,r_219_4_11,r_52_134_199,seq84,r_219_4_11,0.75,0,11,11,27
61,r_126_216_102,seq5,seq12,r_126_216_102,0.99,1,103,102,27
32,r_183_131_75,r_3_214_175,seq72,r_183_131_75,1.0,0,75,75,27
38,r_193_68_147,seq54,r_52_134_199,r_193_68_147,0.48,2,149,147,27
52,r_118_44_163,seq27,r_14_222_71,r_118_44_163,0.77,0,163,163,27
34,r_18_62_133,seq39,r_168_142_31,r_18_62_133,0.91,0,133,133,27
10,r_9_223_34,r_46_195_161,seq127,r_9_223_34,0.57,4,38,34,27
8,r_154_162_37,r_93_100_102,r_74_103_2,r_154_162_37,1.0,0,37,37,27
124,seq72,r_7_136_169,r_183_131_75,r_183_131_75,1.0,94,169,75,27
60,r_157_122_156,seq146,r_116_208_148,r_157_122_156,0.68,0,156,156,27
72,r_217_153_19,r_135_83_163,seq173,r_217_153_19,1.0,0,19,19,27
17,r_144_49_164,seq111,seq25,r_144_49_164,0.84,0,164,164,27
9,r_109_91_130,seq21,r_184_55_7,r_109_91_130,0.92,0,130,130,27
42,r_169_50_28,r_156_79_92,r_191_89_33,r_169_50_28,0.95,11,39,28,27
37,r_159_117_74,r_38_166_184,r_116_208_148,r_116_208_148,0.92,22,170,148,27
1,r_38_166_184,r_157_122_156,r_87_35_81,r_38_166_184,0.96,0,184,184,27
22,r_80_64_98,seq178,r_174_92_66,r_80_64_98,1.0,0,98,98,27
91,seq150,r_82_26_175,r_168_142_31,r_168_142_31,0.5,150,181,31,27
24,r_212_0_31,r_192_218_181,seq21,r_212_0_31,0.99,1,32,31,27
44,r_101_137_156,r_56_112_197,r_8_48_86,r_8_48_86,0.42,70,156,86,27
23,r_33_202_126,seq188,seq54,r_33_202_126,0.79,0,126,126,27
12,r_6_203_107,seq20,seq10,r_6_203_107,1.0,0,107,107,27
68,r_59_106_37,r_176_73_58,seq36,r_59_106_37,1.0,1,38,37,27
128,seq77,r_124_94_46,r_184_55_7,r_124_94_46,1.0,0,46,46,27
23,r_6_213_49,seq166,r_44_88_39,r_44_88_39,1.0,13,52,39,28
30,r_77_48_138,seq16,seq159,r_77_48_138,0.79,2,140,138,28
51,r_199_95_94,r_66_144_25,r_12_7_91,r_199_95_94,0.8,-1,93,94,28
36,r_204_38_141,seq118,r_109_188_64,r_204_38_141,0.93,0,141,141,28
92,seq153,r_207_119_89,r_169_45_191,r_207_119_89,1.0,1,90,89,28
14,r_83_128_105,r_164_208_115,seq143,r_83_128_105,0.51,-2,103,105,28
8,r_18_200_62,seq52,seq179,r_18_200_62,0.99,4,66,62,28
12,r_218_93_14,r_92_32_86,seq172,r_218_93_14,0.96,0,14,14,28
10,r_132_136_34,seq181,seq151,r_132_136_34,1.0,-4,30,34,28
55,r_194_107_104,seq153,r_4_108_95,r_194_107_104,0.95,4,108,104,28
71,r_207_119_89,seq153,seq120,r_207_119_89,0.97,1,90,89,28
16,r_97_146_118,seq94,r_18_200_62,r_97_146_118,0.88,0,118,118,28
46,r_9_183_91,seq42,seq137,r_9_183_91,0.88,-2,89,91,28
42,r_203_124_130,seq24,r_57_15_5,r_203_124_130,0.93,-1,129,130,28
1,r_44_88_39,r_87_81_38,r_6_213_49,r_44_88_39,1.0,0,39,39,28
45,r_169_45_191,r_198_216_125,seq153,r_198_216_125,1.0,5,130,125,28
58,r_123_56_42,r_22_214_147,seq137,r_123_56_42,0.98,0,42,42,28
19,r_102_167_98,r_203_124_130,r_66_144_25,r_102_167_98,0.94,0,98,98,28
100,seq40,r_82_28_181,r_210_138_77,r_210_138_77,0.99,21,98,77,28
31,r_168_3_146,r_192_209_139,seq13,r_192_209_139,0.88,10,149,139,28
41,r_177_33_97,seq130,r_4_108_95,r_177_33_97,1.0,0,97,97,28
67,r_164_208_115,seq120,r_4_108_95,r_164_208_115,0.95,0,115,115,28
15,r_46_162_17,r_4_108_95,seq24,r_46_162_17,0.95,3,20,17,28
72,r_154_79_67,seq72,r_18_200_62,r_154_79_67,1.0,0,67,67,28
0,r_35_2_132,seq175,seq8,r_35_2_132,0.9,-1,131,132,28
73,r_206_195_157,r_22_214_147,r_4_108_95,r_4_108_95,0.99,52,147,95,28
26,r_185_184_24,r_97_146_118,seq143,r_97_146_118,1.0,-67,51,118,28
20,r_22_214_147,r_206_195_157,r_218_93_14,r_22_214_147,0.9,0,147,147,28
13,r_198_216_125,r_169_45_191,r_83_128_105,r_198_216_125,0.65,1,126,125,28
98,seq166,r_5_217_198,r_26_86_20,r_26_86_20,0.8,40,60,20,28
57,r_51_65_86,r_66_144_25,seq39,r_51_65_86,1.0,0,86,86,28
6,r_66_144_25,r_164_208_115,r_102_167_98,r_66_144_25,0.99,74,99,25,28
62,r_147_69_99,r_71_30_191,seq84,r_147_69_99,0.96,1,100,99,28
47,r_34_78_10,r_224_222_127,seq148,r_34_78_10,0.98,0,10,10,28
56,r_201_21_19,r_113_59_143,seq52,r_201_21_19,1.0,0,19,19,28
73,r_206_195_157,r_4_108_95,r_66_144_25,r_206_195_157,0.91,0,157,157,28
21,r_145_142_131,seq54,seq151,r_145_142_131,0.58,-116,15,131,28
2,r_192_209_139,r_168_3_146,r_51_65_86,r_51_65_86,1.0,63,149,86,28
142,seq118,r_161_134_64,r_57_15_5,r_161_134_64,1.0,0,64,64,28
29,r_210_138_77,seq114,seq40,r_210_138_77,1.0,0,77,77,28
24,r_92_32_86,seq41,seq105,r_92_32_86,0.96,11,97,86,28
65,r_211_139_154,seq31,seq155,r_211_139_154,0.95,-1,153,154,28
61,r_12_7_91,seq80,seq41,r_12_7_91,0.98,0,91,91,28
32,r_85_17_123,seq84,r_26_86_20,r_85_17_123,0.97,0,123,123,28
38,r_49_25_138,seq189,seq221,r_49_25_138,0.47,19,157,138,28
52,r_176_27_150,seq170,r_199_95_94,r_176_27_150,0.91,0,150,150,28
64,r_26_86_20,r_223_47_193,seq166,r_26_86_20,0.8,1,21,20,28
34,r_212_23_90,seq173,seq37,r_212_23_90,1.0,1,91,90,28
21,r_145_142_131,seq0,seq175,r_145_142_131,0.55,-5,126,131,28
60,r_129_104_120,seq80,r_18_200_62,r_129_104_120,1.0,0,120,120,28
17,r_113_59_143,seq143,seq120,r_113_59_143,0.6,0,143,143,28
9,r_4_108_95,seq64,seq148,r_4_108_95,0.97,0,95,95,28
50,r_29_140_35,r_5_217_198,seq130,r_29_140_35,1.0,0,35,35,28
22,r_10_158_160,seq175,r_43_133_1,r_10_158_160,0.44,0,160,160,28
28,r_161_134_64,seq118,seq178,r_161_134_64,0.99,0,64,64,28
49,r_68_76_68,r_96_193_190,r_18_200_62,r_18_200_62,1.0,119,181,62,28
4,r_117_165_16,r_113_59_143,seq196,r_117_165_16,1.0,0,16,16,28
48,r_121_111_32,r_177_33_97,r_57_15_5,r_121_111_32,1.0,0,32,32,28
149,seq127,r_220_100_135,r_109_188_64,r_109_188_64,0.37,86,150,64,28
7,r_224_222_127,seq137,seq36,r_224_222_127,1.0,0,127,127,28
138,seq105,r_66_144_25,r_92_32_86,r_92_32_86,0.76,11,97,86,28
63,r_215_152_55,r_210_138_77,r_74_163_124,r_215_152_55,1.0,0,55,55,28
35,r_82_28_181,seq40,r_9_183_91,r_82_28_181,0.56,0,181,181,28
5,r_156_186_15,r_97_146_118,r_180_60_174,r_156_186_15,0.74,0,15,15,28
132,seq92,r_59_195_85,r_162_18_13,r_59_195_85,0.82,-61,24,85,29
45,r_120_78_43,r_202_31_199,r_130_86_165,r_120_78_43,1.0,0,43,43,29
36,r_219_207_152,r_93_44_170,r_91_217_122,r_93_44_170,0.88,-18,152,170,29
92,seq23,r_127_124_133,seq118,r_127_124_133,0.98,-68,65,133,29
14,r_133_16_175,seq123,r_68_10_144,r_68_10_144,0.97,31,175,144,29
8,r_84_21_174,seq220,seq29,r_84_21_174,0.51,1,175,174,29
60,r_149_65_49,r_140_81_111,r_100_212_98,r_140_81_111,0.88,-15,96,111,29
125,seq83,seq23,r_178_4_130,r_178_4_130,0.98,10,140,130,29
54,r_205_39_98,r_63_67_83,r_74_47_137,r_63_67_83,0.78,3,86,83,29
37,r_104_187_69,r_197_89_190,seq159,r_104_187_69,0.99,-5,64,69,29
43,r_35_0_14,r_22_157_67,seq166,r_35_0_14,0.92,0,14,14,29
86,seq12,r_197_89_190,r_204_54_122,r_204_54_122,1.0,59,181,122,29
16,r_221_134_87,r_84_21_174,seq111,r_221_134_87,1.0,1,88,87,29
39,r_95_222_122,r_140_81_111,r_100_212_98,r_95_222_122,0.47,-34,88,122,29
1,r_156_14_169,seq85,r_113_64_93,r_113_64_93,0.57,76,169,93,29
5,r_5_146_94,seq107,seq46,r_5_146_94,1.0,0,94,94,29
46,r_112_147_11,r_98_173_20,r_206_53_65,r_112_147_11,0.53,52,63,11,29
42,r_76_55_88,r_17_180_114,seq72,r_76_55_88,1.0,0,88,88,29
48,r_131_99_38,r_68_10_144,seq72,r_131_99_38,1.0,0,38,38,29
50,r_71_116_50,seq29,seq6,r_71_116_50,1.0,0,50,50,29
40,r_109_26_27,r_22_157_67,seq8,r_22_157_67,0.72,-43,24,67,29
22,r_62_106_19,r_113_64_93,seq213,r_62_106_19,1.0,0,19,19,29
66,r_130_86_165,seq189,r_22_157_67,r_22_157_67,1.0,0,67,67,29
60,r_149_65_49,r_68_10_144,r_140_81_111,r_149_65_49,0.77,-2,47,49,29
31,r_90_196_106,r_17_180_114,r_100_212_98,r_100_212_98,0.98,10,108,98,29
67,r_119_33_84,seq128,seq224,r_119_33_84,0.98,2,86,84,29
59,r_162_18_13,r_87_185_133,seq92,r_87_185_133,0.77,-120,13,133,29
73,r_40_126_52,r_127_124_133,r_162_18_13,r_40_126_52,0.99,1,53,52,29
26,r_197_89_190,r_104_187_69,seq224,r_104_187_69,1.0,2,71,69,29
72,r_208_37_183,seq103,r_181_97_55,r_181_97_55,0.69,130,185,55,29
35,r_190_198_53,seq138,r_80_88_4,r_190_198_53,1.0,0,53,53,29
0,r_137_121_88,r_211_58_116,seq135,r_137_121_88,0.84,0,88,88,29
63,r_125_168_64,r_74_47_137,seq79,r_125_168_64,1.0,0,64,64,29
11,r_179_129_188,seq215,r_34_57_126,r_34_57_126,1.0,62,188,126,29
39,r_95_222_122,r_100_212_98,seq32,r_95_222_122,1.0,0,122,122,29
20,r_100_212_98,r_102_182_157,r_90_196_106,r_100_212_98,0.83,6,104,98,29
13,r_113_64_93,seq101,seq103,r_113_64_93,1.0,0,93,93,29
46,r_112_147_11,r_206_53_65,seq144,r_206_53_65,0.35,67,132,65,29
15,r_94_161_81,seq132,r_204_54_122,r_94_161_81,0.57,-10,71,81,29
6,r_68_10_144,r_82_73_185,seq155,r_68_10_144,0.9,0,144,144,29
62,r_93_44_170,seq46,r_74_47_137,r_93_44_170,0.7,0,170,170,29
29,r_127_124_133,r_148_136_110,r_203_145_43,r_203_145_43,1.0,0,43,43,29
85,seq11,r_74_47_137,seq223,r_74_47_137,0.93,-14,123,137,29
51,r_98_173_20,r_202_31_199,r_175_139_20,r_98_173_20,0.67,3,23,20,29
99,seq159,seq186,r_104_187_69,r_104_187_69,1.0,50,119,69,29
27,r_91_217_122,r_17_180_114,r_113_64_93,r_17_180_114,1.0,8,122,114,29
148,seq224,seq12,r_119_33_84,r_119_33_84,1.0,-1,83,84,29
34,r_204_54_122,r_94_161_81,r_119_33_84,r_204_54_122,1.0,0,122,122,29
106,seq42,r_100_212_98,seq118,r_100_212_98,0.46,38,136,98,29
47,r_82_73_185,seq111,r_156_14_169,r_156_14_169,0.54,16,185,169,29
126,seq220,r_19_154_165,r_22_157_67,r_22_157_67,1.0,99,166,67,29
18,r_191_60_169,r_34_57_126,r_93_44_170,r_34_57_126,0.94,2,128,126,29
25,r_17_180_114,r_91_217_122,seq85,r_91_217_122,0.69,-3,119,122,29
142,seq114,r_113_64_93,r_201_49_30,r_201_49_30,0.78,0,30,30,29
64,r_206_53_65,seq43,seq141,r_206_53_65,0.92,-1,64,65,29
58,r_48_27_100,seq103,seq101,r_48_27_100,1.0,0,100,100,29
70,r_102_182_157,r_100_212_98,r_87_185_133,r_87_185_133,0.92,24,157,133,29
65,r_59_195_85,seq92,seq128,r_59_195_85,0.99,-1,84,85,29
44,r_74_47_137,seq9,r_93_44_170,r_74_47_137,0.8,40,177,137,29
68,r_77_174_107,seq115,seq167,r_77_174_107,1.0,1,108,107,29
61,r_63_67_83,r_205_39_98,seq193,r_63_67_83,0.72,0,83,83,29
32,r_87_185_133,seq1,seq2,r_87_185_133,0.97,2,135,133,29
38,r_148_136_110,r_127_124_133,seq220,r_148_136_110,0.52,1,111,110,29
52,r_211_58_116,seq153,r_206_53_65,r_211_58_116,0.57,30,146,116,29
34,r_204_54_122,r_109_26_27,r_94_161_81,r_94_161_81,0.56,-10,71,81,29
54,r_205_39_98,r_74_47_137,r_171_122_1,r_205_39_98,0.57,1,99,98,29
21,r_25_52_34,seq105,seq209,r_25_52_34,1.0,1,35,34,29
30,r_203_145_43,r_125_168_64,r_38_108_47,r_203_145_43,1.0,0,43,43,29
17,r_34_57_126,r_191_60_169,seq150,r_34_57_126,0.55,2,128,126,29
9,r_22_157_67,r_34_57_126,r_130_86_165,r_22_157_67,1.0,1,68,67,29
26,r_197_89_190,seq224,r_181_97_55,r_197_89_190,0.22,0,190,190,29
97,seq29,r_35_0_14,r_84_21_174,r_84_21_174,1.0,-2,172,174,29
71,r_201_49_30,seq223,seq114,r_201_49_30,0.99,0,30,30,29
123,seq79,seq220,r_125_168_64,r_125_168_64,1.0,8,72,64,29
29,r_127_124_133,r_203_145_43,r_22_157_67,r_127_124_133,0.4,1,134,133,29
28,r_163_199_188,seq153,r_181_97_55,r_163_199_188,0.2,0,188,188,29
49,r_178_4_130,seq41,seq83,r_178_4_130,0.83,0,130,130,29
140,seq107,r_5_146_94,r_197_89_190,r_5_146_94,0.86,2,96,94,29
56,r_75_184_85,r_93_44_170,r_162_18_13,r_75_184_85,1.0,-1,84,85,29
7,r_181_97_55,r_127_124_133,seq160,r_127_124_133,0.99,-68,65,133,29
44,r_74_47_137,seq11,seq9,r_74_47_137,0.92,0,137,137,29
23,r_15_142_101,r_127_124_133,seq24,r_127_124_133,0.62,-30,103,133,29
57,r_69_183_61,r_192_210_193,seq153,r_69_183_61,1.0,-2,59,61,29
19,r_38_108_47,seq6,r_203_145_43,r_38_108_47,1.0,0,47,47,29
55,r_175_139_20,seq189,r_98_173_20,r_175_139_20,1.0,0,20,20,29
12,r_152_117_80,seq213,seq193,r_152_117_80,0.55,0,80,80,29
15,r_94_161_81,r_204_54_122,r_109_26_27,r_204_54_122,1.0,0,122,122,29
18,r_191_60_169,r_93_44_170,r_152_117_80,r_191_60_169,1.0,0,169,169,29
30,r_84_76_126,seq127,seq44,r_84_76_126,0.66,2,128,126,30
49,r_99_194_19,seq13,seq202,r_99_194_19,0.98,-1,18,19,30
51,r_123_8_106,seq82,seq127,r_123_8_106,0.99,2,108,106,30
6,r_215_160_22,seq130,seq149,r_215_160_22,1.0,0,22,22,30
36,r_69_3_60,r_28_192_179,r_27_162_26,r_69_3_60,0.79,0,60,60,30
8,r_119_31_118,seq195,r_132_14_118,r_119_31_118,0.83,0,118,118,30
43,r_110_121_88,seq152,r_137_23_6,r_110_121_88,0.99,2,90,88,30
37,r_0_30_170,seq78,r_123_8_106,r_123_8_106,0.88,66,172,106,30
3,r_92_203_79,r_159_75_174,seq164,r_92_203_79,0.45,97,176,79,30
59,r_63_37_119,seq45,seq115,r_63_37_119,0.91,0,119,119,30
19,r_216_85_173,r_179_22_61,seq53,r_179_22_61,0.6,114,175,61,30
55,r_210_113_82,seq169,seq7,r_210_113_82,1.0,0,82,82,30
71,r_224_120_151,seq163,seq114,r_224_120_151,0.73,0,151,151,30
21,r_218_100_174,seq72,r_39_125_95,r_39_125_95,0.86,79,174,95,30
39,r_196_60_150,seq223,r_106_97_76,r_106_97_76,0.97,74,150,76,30
1,r_10_183_159,seq168,r_106_97_76,r_10_183_159,0.82,0,159,159,30
143,seq115,seq202,r_63_37_119,r_63_37_119,0.98,14,133,119,30
5,r_64_87_69,r_18_139_166,seq201,r_64_87_69,0.94,0,69,69,30
42,r_47_95_168,seq149,r_27_162_26,r_47_95_168,0.68,0,168,168,30
69,r_51_36_137,r_52_59_176,r_39_125_95,r_51_36_137,0.88,0,137,137,30
19,r_216_85_173,r_94_193_94,r_179_22_61,r_179_22_61,0.98,1,62,61,30
66,r_66_122_29,seq141,seq72,r_66_122_29,1.0,0,29,29,30
67,r_187_217_15,r_106_97_76,r_94_193_94,r_106_97_76,0.96,1,77,76,30
3,r_92_203_79,r_224_120_151,r_159_75_174,r_92_203_79,0.99,0,79,79,30
46,r_222_190_17,seq163,seq29,r_222_190_17,1.0,0,17,17,30
9,r_134_131_38,r_166_165_132,seq61,r_134_131_38,0.99,0,38,38,30
14,r_179_22_61,r_216_85_173,r_32_177_145,r_179_22_61,0.57,114,175,61,30
4,r_90_81_174,seq155,r_174_19_69,r_90_81_174,0.62,0,174,174,30
0,r_212_220_175,r_159_75_174,r_39_125_95,r_39_125_95,0.76,81,176,95,30
63,r_159_75_174,r_212_220_175,r_224_120_151,r_224_120_151,0.52,23,174,151,30
73,r_89_2_151,seq72,r_106_97_76,r_89_2_151,0.7,0,151,151,30
11,r_132_14_118,r_32_177_145,r_119_31_118,r_132_14_118,0.72,0,118,118,30
20,r_144_172_85,seq202,r_66_122_29,r_144_172_85,0.87,0,85,85,30
13,r_174_19_69,r_144_172_85,seq79,r_174_19_69,0.58,0,69,69,30
98,seq164,r_104_109_138,r_174_19_69,r_174_19_69,0.83,74,143,69,30
48,r_166_165_132,r_142_181_197,r_119_31_118,r_166_165_132,0.58,0,132,132,30
2,r_27_162_26,r_93_49_179,seq107,r_27_162_26,0.99,0,26,26,30
49,r_99_194_19,seq202,r_16_129_155,r_16_129_155,0.88,10,165,155,30
57,r_191_148_138,r_143_154_177,seq53,r_191_148_138,0.93,0,138,138,30
117,seq65,r_18_139_166,seq26,r_18_139_166,1.0,0,166,166,30
27,r_91_138_87,r_10_183_159,r_144_172_85,r_91_138_87,1.0,0,87,87,30
53,r_25_15_143,r_142_181_197,r_134_131_38,r_25_15_143,1.0,0,143,143,30
41,r_56_48_38,r_32_177_145,seq130,r_56_48_38,1.0,0,38,38,30
87,seq146,seq141,r_96_213_77,r_96_213_77,0.93,8,85,77,30
47,r_143_154_177,seq72,r_208_173_89,r_143_154_177,0.46,0,177,177,30
142,seq114,r_32_177_145,r_224_120_151,r_224_120_151,0.61,5,156,151,30
126,seq78,r_0_30_170,seq161,r_0_30_170,0.98,2,172,170,30
74,r_68_214_87,r_102_35_112,seq176,r_68_214_87,0.9,3,90,87,30
24,r_96_213_77,seq61,seq146,r_96_213_77,0.97,1,78,77,30
35,r_74_105_184,r_170_219_30,r_27_162_26,r_74_105_184,0.56,0,184,184,30
33,r_34_178_78,r_144_172_85,seq168,r_34_178_78,1.0,0,78,78,30
64,r_185_50_108,r_54_156_193,r_111_184_46,r_185_50_108,0.69,0,108,108,30
68,r_200_88_39,r_84_76_126,seq195,r_200_88_39,0.89,0,39,39,30
70,r_16_129_155,seq175,r_99_194_19,r_16_129_155,0.63,0,155,155,30
61,r_94_193_94,r_216_85_173,seq41,r_94_193_94,0.35,30,124,94,30
32,r_1_17_71,r_166_165_132,r_196_60_150,r_1_17_71,0.98,0,71,71,30
38,r_106_97_76,r_187_217_15,r_180_211_18,r_106_97_76,1.0,1,77,76,30
28,r_147_112_45,r_196_60_150,seq163,r_147_112_45,0.95,0,45,45,30
34,r_9_209_80,r_54_156_193,r_52_59_176,r_9_209_80,0.99,0,80,80,30
35,r_74_105_184,seq197,r_170_219_30,r_170_219_30,0.95,14,44,30,30
60,r_52_59_176,r_51_36_137,r_9_209_80,r_52_59_176,0.64,-39,137,176,30
45,r_170_219_30,r_74_105_184,seq117,r_74_105_184,0.85,-80,104,184,30
65,r_180_211_18,r_191_148_138,seq133,r_180_211_18,1.0,0,18,18,30
50,r_33_83_59,seq26,seq163,r_33_83_59,1.0,0,59,59,30
17,r_39_125_95,r_84_76_126,seq7,r_39_125_95,0.87,10,105,95,30
14,r_179_22_61,r_159_75_174,r_216_85_173,r_179_22_61,0.91,-3,58,61,30
45,r_170_219_30,seq182,r_74_105_184,r_170_219_30,0.79,3,33,30,30
121,seq72,r_55_136_179,r_66_122_29,r_66_122_29,0.92,35,64,29,30
53,r_25_15_143,r_208_173_89,r_142_181_197,r_208_173_89,0.98,-35,54,89,30
56,r_208_173_89,r_25_15_143,seq126,r_208_173_89,0.54,0,89,89,30
7,r_32_177_145,seq114,r_179_22_61,r_179_22_61,0.91,95,156,61,30
108,seq53,r_157_151_197,r_191_148_138,r_191_148_138,1.0,8,146,138,30
12,r_103_150_132,r_90_81_174,seq127,r_103_150_132,0.66,4,136,132,30
30,r_84_133_91,r_157_40_167,seq189,r_84_133_91,0.99,0,91,91,31
51,r_197_87_93,r_5_70_134,r_196_98_57,r_5_70_134,0.52,-39,95,134,31
36,r_150_209_63,r_47_53_99,seq106,r_150_209_63,1.0,0,63,63,31
6,r_101_138_32,seq59,r_195_20_184,r_101_138_32,1.0,0,32,32,31
14,r_161_81_134,seq52,r_149_111_54,r_161_81_134,0.92,-1,133,134,31
8,r_123_126_126,seq175,r_56_50_14,r_123_126_126,0.62,1,127,126,31
53,r_38_107_81,r_73_193_63,seq110,r_38_107_81,1.0,0,81,81,31
43,r_57_200_117,r_91_211_137,seq215,r_57_200_117,0.78,1,118,117,31
146,seq113,r_174_170_150,seq45,r_174_170_150,0.84,0,150,150,31
54,r_32_46_113,r_122_67_193,r_84_133_91,r_84_133_91,0.98,22,113,91,31
59,r_47_53_99,seq180,r_115_160_91,r_47_53_99,1.0,0,99,99,31
19,r_49_79_180,r_130_116_46,r_84_133_91,r_49_79_180,0.46,4,184,180,31
55,r_1_205_98,seq212,seq222,r_1_205_98,1.0,0,98,98,31
71,r_208_121_94,r_157_40_167,r_66_24_39,r_157_40_167,0.99,-73,94,167,31
16,r_54_136_136,r_157_40_167,seq202,r_54_136_136,0.54,0,136,136,31
21,r_188_105_83,seq65,r_185_37_26,r_188_105_83,0.99,1,84,83,31
1,r_115_160_91,seq25,r_42_169_32,r_115_160_91,0.74,0,91,91,31
143,seq106,r_137_184_184,r_150_209_63,r_150_209_63,1.0,111,174,63,31
42,r_91_211_137,seq19,seq11,r_91_211_137,0.88,0,137,137,31
7,r_56_50_14,r_75_97_64,r_123_126_126,r_123_126_126,0.91,3,129,126,31
69,r_89_117_76,seq187,r_153_172_29,r_89_117_76,0.98,0,76,76,31
45,r_0_204_131,seq142,r_38_107_81,r_0_204_131,0.53,1,132,131,31
19,r_49_79_180,r_89_117_76,r_130_116_46,r_49_79_180,1.0,-104,76,180,31
5,r_153_172_29,r_115_160_91,seq90,r_153_172_29,1.0,0,29,29,31
66,r_139_140_75,seq65,seq156,r_139_140_75,1.0,4,79,75,31
26,r_216_152_3,seq110,r_86_2_45,r_86_2_45,1.0,3,48,45,31
31,r_104_55_72,r_91_211_137,seq31,r_104_55_72,0.99,1,73,72,31
41,r_185_37_26,r_74_83_170,r_188_105_83,r_188_105_83,0.91,88,171,83,31
67,r_176_23_93,r_123_126_126,seq30,r_176_23_93,0.85,0,93,93,31
3,r_125_43_117,r_5_70_134,r_176_23_93,r_176_23_93,0.52,24,117,93,31
10,r_124_112_112,seq224,seq15,r_124_112_112,1.0,0,112,112,31
63,r_18_119_121,seq31,r_84_133_91,r_18_119_121,0.87,0,121,121,31
114,seq189,seq4,r_84_133_91,r_84_133_91,0.98,-2,89,91,31
73,r_218_179_129,seq29,r_104_55_72,r_218_179_129,0.89,1,130,129,31
20,r_206_44_112,r_0_204_131,r_196_98_57,r_206_44_112,0.81,0,112,112,31
48,r_27_191_121,r_0_204_131,r_101_138_32,r_27_191_121,0.96,0,121,121,31
11,r_195_20_184,seq175,r_101_138_32,r_101_138_32,1.0,19,51,32,31
70,r_95_26_55,r_122_67_193,r_66_24_39,r_95_26_55,0.93,0,55,55,31
57,r_34_190_153,seq72,r_158_108_30,r_34_190_153,0.9,0,153,153,31
62,r_74_83_170,r_185_37_26,seq178,r_185_37_26,0.59,145,171,26,31
23,r_86_2_45,seq148,r_216_152_3,r_86_2_45,1.0,0,45,45,31
46,r_131_159_40,r_149_111_54,seq186,r_131_159_40,1.0,0,40,40,31
52,r_99_100_151,seq202,r_149_111_54,r_149_111_54,1.0,-1,53,54,31
52,r_99_100_151,r_149_111_54,r_115_160_91,r_99_100_151,0.95,0,151,151,31
0,r_149_111_54,r_99_100_151,r_161_81_134,r_149_111_54,0.82,97,151,54,31
17,r_158_108_30,r_115_160_91,seq213,r_158_108_30,0.98,1,31,30,31
27,r_173_129_83,seq127,r_223_155_53,r_173_129_83,0.99,1,84,83,31
33,r_66_24_39,r_54_136_136,seq109,r_66_24_39,0.98,1,40,39,31
40,r_13_217_140,seq68,r_185_37_26,r_13_217_140,0.87,0,140,140,31
74,r_93_146_89,seq109,r_78_154_86,r_93_146_89,1.0,0,89,89,31
18,r_174_170_150,seq113,r_173_129_83,r_173_129_83,1.0,67,150,83,31
29,r_177_181_152,r_17_102_3,r_101_138_32,r_177_181_152,0.86,0,152,152,31
24,r_17_102_3,r_177_181_152,seq16,r_177_181_152,0.99,0,152,152,31
64,r_33_147_74,r_93_146_89,seq19,r_33_147_74,0.92,1,75,74,31
15,r_132_134_37,seq120,seq80,r_132_134_37,1.0,1,38,37,31
50,r_151_210_60,r_6_219_185,seq163,r_151_210_60,1.0,0,60,60,31
0,r_149_111_54,r_6_219_185,r_99_100_151,r_149_111_54,0.99,0,54,54,31
68,r_167_182_141,seq15,seq3,r_167_182_141,0.76,0,141,141,31
130,seq163,r_73_193_63,r_151_210_60,r_151_210_60,1.0,44,104,60,31
38,r_145_162_145,r_165_58_191,r_206_44_112,r_145_162_145,0.57,3,148,145,31
56,r_5_70_134,seq72,r_132_134_37,r_5_70_134,1.0,-1,133,134,31
7,r_56_50_14,r_39_143_96,r_75_97_64,r_56_50_14,0.99,0,14,14,31
34,r_122_67_193,r_32_46_113,seq3,r_32_46_113,0.97,0,113,113,31
44,r_51_61_46,r_137_184_184,seq35,r_51_61_46,0.97,6,52,46,31
47,r_196_98_57,r_75_97_64,r_201_118_8,r_196_98_57,1.0,0,57,57,31
32,r_223_155_53,seq4,seq128,r_223_155_53,1.0,0,53,53,31
60,r_103_64_119,r_145_162_145,seq11,r_103_64_119,0.91,2,121,119,31
9,r_141_28_68,seq213,seq109,r_141_28_68,1.0,0,68,68,31
145,seq110,r_96_194_170,r_38_107_81,r_38_107_81,1.0,14,95,81,31
31,r_104_55_72,seq31,r_218_179_129,r_218_179_129,1.0,8,137,129,31
22,r_157_40_167,seq207,seq10,r_157_40_167,0.55,4,171,167,31
28,r_78_154_86,seq76,r_93_146_89,r_93_146_89,1.0,0,89,89,31
58,r_42_169_32,seq192,seq142,r_42_169_32,0.56,1,33,32,31
49,r_77_62_112,seq35,seq63,r_77_62_112,0.98,0,112,112,31
13,r_75_97_64,r_196_98_57,seq69,r_75_97_64,0.62,-7,57,64,31
56,r_5_70_134,r_125_43_117,seq72,r_125_43_117,0.75,0,117,117,31
39,r_130_116_46,r_122_67_193,r_42_169_32,r_130_116_46,0.99,0,46,46,31
35,r_6_219_185,seq11,r_150_209_63,r_150_209_63,0.91,123,186,63,31
12,r_165_58_191,r_145_162_145,seq9,r_145_162_145,0.95,3,148,145,31
17,r_109_123_45,seq114,seq130,r_109_123_45,1.0,0,45,45,32
37,r_33_160_57,r_60_112_145,seq199,r_33_160_57,0.97,-2,55,57,32
14,r_179_153_141,seq148,r_70_198_66,r_179_153_141,0.8,4,145,141,32
76,seq1,r_6_206_35,r_159_72_81,r_6_206_35,0.97,-4,31,35,32
53,r_23_163_105,r_22_64_185,r_195_111_133,r_23_163_105,0.95,1,106,105,32
43,r_19_196_109,seq94,seq219,r_19_196_109,1.0,0,109,109,32
54,r_129_91_72,r_143_214_108,r_70_198_66,r_129_91_72,1.0,2,74,72,32
24,r_66_125_50,r_117_46_72,seq53,r_66_125_50,1.0,-1,49,50,32
59,r_118_27_139,seq37,r_2_41_57,r_118_27_139,0.58,2,141,139,32
72,r_197_201_35,r_152_164_125,r_62_86_18,r_197_201_35,0.55,-1,34,35,32
45,r_35_88_27,r_66_125_50,seq208,r_35_88_27,0.93,0,27,27,32
55,r_36_177_143,r_60_112_145,seq30,r_60_112_145,0.54,-2,143,145,32
71,r_139_0_70,seq76,r_197_201_35,r_139_0_70,0.99,-3,67,70,32
21,r_108_217_137,seq54,seq140,r_108_217_137,0.61,0,137,137,32
1,r_218_15_136,r_24_77_57,seq94,r_218_15_136,0.67,0,136,136,32
5,r_181_122_87,seq140,r_222_157_41,r_222_157_41,0.97,7,48,41,32
42,r_55_67_154,seq51,seq14,r_55_67_154,0.66,0,154,154,32
13,r_135_167_42,seq53,seq147,r_135_167_42,1.0,-1,41,42,32
73,r_52_21_29,r_60_112_145,seq16,r_52_21_29,1.0,0,29,29,32
111,seq56,r_29_119_150,r_118_27_139,r_118_27_139,0.69,22,161,139,32
10,r_62_86_18,r_34_59_185,seq211,r_62_86_18,0.99,0,18,18,32
16,r_222_157_41,r_99_89_122,seq75,r_222_157_41,1.0,1,42,41,32
19,r_34_59_185,seq116,r_108_217_137,r_108_217_137,0.95,48,185,137,32
56,r_151_93_26,r_7_50_41,seq127,r_151_93_26,0.93,0,26,26,32
30,r_142_149_13,r_209_25_60,seq49,r_142_149_13,0.96,0,13,13,32
61,r_221_100_45,r_191_126_196,seq211,r_221_100_45,0.98,0,45,45,32
31,r_156_81_141,r_60_112_145,r_109_123_45,r_156_81_141,0.75,3,144,141,32
3,r_85_40_3,seq211,r_63_133_76,r_63_133_76,1.0,13,89,76,32
72,r_197_201_35,r_62_86_18,r_139_0_70,r_139_0_70,0.91,22,92,70,32
16,r_222_157_41,seq75,r_121_172_104,r_121_172_104,1.0,4,108,104,32
60,r_202_65_32,r_22_64_185,seq140,r_202_65_32,0.97,-2,30,32,32
65,r_187_168_26,r_22_64_185,seq115,r_187_168_26,1.0,0,26,26,32
4,r_144_104_124,r_55_67_154,r_159_72_81,r_144_104_124,0.88,0,124,124,32
0,r_63_133_76,seq8,r_85_40_3,r_63_133_76,0.97,0,76,76,32
20,r_90_173_143,seq137,r_139_0_70,r_139_0_70,0.6,73,143,70,32
98,seq219,seq145,r_60_112_145,r_60_112_145,0.91,19,164,145,32
6,r_99_89_122,seq210,seq75,r_99_89_122,0.95,0,122,122,32
62,r_159_72_81,r_143_214_108,seq141,r_143_214_108,1.0,-26,82,108,32
68,r_32_188_22,r_179_153_141,seq16,r_32_188_22,0.97,0,22,22,32
119,seq140,seq75,r_202_65_32,r_202_65_32,0.98,9,41,32,32
134,seq224,r_71_171_127,r_152_164_125,r_71_171_127,1.0,0,127,127,32
125,seq208,r_7_50_41,r_35_88_27,r_35_88_27,0.47,1,28,27,32
27,r_195_111_133,seq47,r_23_163_105,r_23_163_105,0.99,32,137,105,32
41,r_58_166_154,r_202_65_32,seq134,r_58_166_154,0.74,0,154,154,32
87,seq16,r_22_64_185,r_52_21_29,r_52_21_29,0.97,10,39,29,32
28,r_7_50_41,r_118_27_139,r_38_184_33,r_7_50_41,0.99,0,41,41,32
18,r_29_119_150,seq56,r_90_173_143,r_90_173_143,0.73,18,161,143,32
29,r_215_146_89,seq211,r_70_198_66,r_215_146_89,0.58,1,90,89,32
66,r_105_204_31,r_179_153_141,r_106_83_1,r_105_204_31,0.98,0,31,31,32
25,r_60_112_145,r_36_177_143,seq219,r_60_112_145,0.82,0,145,145,32
33,r_158_61_69,r_29_119_150,seq186,r_158_61_69,0.98,-2,67,69,32
69,r_216_92_21,r_63_133_76,r_106_83_1,r_63_133_76,0.51,-56,20,76,32
63,r_183_205_17,seq53,seq161,r_183_205_17,1.0,-1,16,17,32
5,r_181_122_87,r_222_157_41,seq130,r_181_122_87,1.0,0,87,87,32
11,r_209_25_60,r_45_31_6,seq82,r_209_25_60,0.99,-1,59,60,32
50,r_71_171_127,seq224,r_70_198_66,r_71_171_127,0.93,0,127,127,32
44,r_155_95_27,r_106_83_1,r_96_18_192,r_155_95_27,1.0,0,27,27,32
74,r_2_41_57,r_169_103_188,seq17,r_2_41_57,1.0,0,57,57,32
38,r_70_198_66,seq53,r_105_204_31,r_70_198_66,1.0,0,66,66,32
52,r_107_68_93,seq48,seq47,r_107_68_93,0.96,0,93,93,32
76,seq1,r_159_72_81,r_73_200_94,r_73_200_94,1.0,1,95,94,32
70,r_38_184_33,seq161,seq116,r_38_184_33,1.0,-2,31,33,32
34,r_39_110_65,seq30,seq98,r_39_110_65,1.0,0,65,65,32
40,r_169_103_188,r_2_41_57,seq162,r_2_41_57,0.92,-15,42,57,32
121,seq75,seq140,r_99_89_122,r_99_89_122,0.91,3,125,122,32
2,r_9_220_38,seq219,seq94,r_9_220_38,1.0,-1,37,38,32
9,r_22_64_185,r_23_163_105,r_209_25_60,r_22_64_185,1.0,-79,106,185,32
145,seq148,r_179_153_141,seq162,r_179_153_141,1.0,4,145,141,32
35,r_6_206_35,seq1,r_62_86_18,r_6_206_35,1.0,0,35,35,32
49,r_223_79_130,seq186,r_24_77_57,r_223_79_130,0.76,0,130,130,32
48,r_106_83_1,seq136,r_105_204_31,r_105_204_31,1.0,1,32,31,32
7,r_121_172_104,seq98,r_222_157_41,r_121_172_104,0.79,-1,103,104,32
41,r_58_166_154,seq140,r_202_65_32,r_202_65_32,1.0,0,32,32,32
47,r_4_178_27,r_34_59_185,seq51,r_4_178_27,1.0,-1,26,27,32
82,seq10,r_117_46_72,r_143_214_108,r_143_214_108,0.87,21,129,108,32
12,r_73_200_94,seq75,seq1,r_73_200_94,1.0,1,95,94,32
41,r_188_142_45,seq151,r_68_146_182,r_188_142_45,1.0,0,45,45,33
7,r_197_115_184,r_183_87_65,r_208_27_10,r_208_27_10,0.73,8,18,10,33
71,r_24_48_24,r_130_7_131,seq37,r_24_48_24,1.0,0,24,24,33
51,r_149_176_199,r_0_51_93,r_3_1_49,r_3_1_49,0.93,47,96,49,33
36,r_105_119_1,r_186_153_184,r_44_120_108,r_44_120_108,1.0,10,118,108,33
124,seq207,r_149_176_199,r_3_1_49,r_3_1_49,1.0,2,51,49,33
14,r_0_51_93,r_149_176_199,seq136,r_0_51_93,0.94,3,96,93,33
8,r_164_206_132,seq4,seq150,r_164_206_132,0.7,0,132,132,33
53,r_2_65_172,seq73,r_78_34_58,r_78_34_58,1.0,114,172,58,33
43,r_97_92_172,seq91,r_192_169_195,r_192_169_195,0.66,-23,172,195,33
37,r_10_8_84,r_141_29_128,r_197_115_184,r_141_29_128,0.77,-26,102,128,33
52,r_187_222_36,r_111_147_149,r_208_27_10,r_187_222_36,1.0,0,36,36,33
86,seq22,seq217,r_212_85_82,r_212_85_82,1.0,4,86,82,33
16,r_14_62_160,r_149_176_199,r_78_34_58,r_78_34_58,0.81,102,160,58,33
21,r_49_6_67,r_18_184_125,seq16,r_18_184_125,0.88,-58,67,125,33
104,seq182,r_47_148_143,r_23_25_53,r_23_25_53,1.0,99,152,53,33
61,r_118_193_27,r_152_133_199,r_192_169_195,r_118_193_27,1.0,0,27,27,33
45,r_54_181_167,seq20,r_154_116_22,r_154_116_22,1.0,0,22,22,33
80,seq138,r_218_211_130,seq61,r_218_211_130,0.99,0,130,130,33
74,r_154_116_22,r_2_65_172,r_54_181_167,r_154_116_22,1.0,0,22,22,33
69,r_111_147_149,seq207,r_44_120_108,r_44_120_108,1.0,42,150,108,33
19,r_84_156_161,seq26,seq58,r_84_156_161,0.74,-1,160,161,33
66,r_210_75_83,r_170_90_88,seq126,r_210_75_83,0.99,0,83,83,33
33,r_45_57_36,r_201_179_169,r_105_119_1,r_45_57_36,0.82,0,36,36,33
35,r_155_205_22,r_49_6_67,r_68_146_182,r_155_205_22,0.97,0,22,22,33
31,r_104_166_70,r_201_179_169,seq200,r_104_166_70,1.0,0,70,70,33
130,seq91,r_97_92_172,r_215_99_28,r_215_99_28,1.0,2,30,28,33
67,r_141_29_128,r_10_8_84,r_98_108_110,r_98_108_110,0.99,0,110,110,33
10,r_98_108_110,seq202,seq64,r_98_108_110,1.0,0,110,110,33
55,r_195_69_49,r_49_6_67,seq80,r_195_69_49,0.96,-3,46,49,33
115,seq67,r_130_7_131,r_183_87_65,r_183_87_65,1.0,10,75,65,33
4,r_139_174_67,seq11,seq150,r_139_174_67,1.0,0,67,67,33
29,r_23_25_53,r_218_211_130,r_94_110_5,r_23_25_53,1.0,0,53,53,33
0,r_130_7_131,r_52_123_131,seq185,r_52_123_131,0.73,0,131,131,33
11,r_112_127_85,seq217,seq117,r_112_127_85,1.0,0,85,85,33
13,r_170_90_88,r_128_134_198,r_94_110_5,r_170_90_88,1.0,-1,87,88,33
32,r_86_173_24,r_164_206_132,seq202,r_86_173_24,0.91,-6,18,24,33
48,r_21_131_121,r_121_93_168,r_183_87_65,r_183_87_65,1.0,70,135,65,33
117,seq70,r_219_71_140,seq167,r_219_71_140,0.73,7,147,140,33
3,r_161_180_39,r_170_90_88,seq60,r_161_180_39,1.0,0,39,39,33
6,r_40_132_66,r_201_179_169,seq38,r_40_132_66,0.92,1,67,66,33
62,r_28_63_113,seq41,seq126,r_28_63_113,0.62,5,118,113,33
74,r_154_116_22,r_54_181_167,r_218_211_130,r_218_211_130,0.79,37,167,130,33
7,r_197_115_184,r_208_27_10,r_10_8_84,r_197_115_184,0.75,-117,67,184,33
40,r_3_1_49,seq182,seq207,r_3_1_49,1.0,0,49,49,33
27,r_212_85_82,seq117,seq22,r_212_85_82,1.0,1,83,82,33
2,r_32_107_91,r_10_8_84,seq221,r_32_107_91,1.0,0,91,91,33
47,r_52_123_131,r_130_7_131,r_3_1_49,r_3_1_49,0.83,81,130,49,33
1,r_68_146_182,r_129_114_189,r_155_205_22,r_155_205_22,1.0,0,22,22,33
24,r_215_99_28,r_47_148_143,seq91,r_215_99_28,1.0,1,29,28,33
25,r_218_211_130,seq138,r_154_116_22,r_218_211_130,0.93,0,130,130,33
64,r_213_88_180,seq19,r_139_174_67,r_139_174_67,0.79,113,180,67,33
67,r_141_29_128,r_98_108_110,seq203,r_141_29_128,0.95,2,130,128,33
50,r_50_31_127,r_103_9_147,r_0_51_93,r_50_31_127,0.92,0,127,127,33
70,r_83_140_122,r_68_146_182,r_172_46_178,r_68_146_182,0.82,-59,123,182,33
65,r_198_177_117,r_18_184_125,seq209,r_18_184_125,0.64,-8,117,125,33
68,r_13_158_179,seq182,r_21_131_121,r_13_158_179,0.52,0,179,179,33
7,r_197_115_184,r_10_8_84,r_3_1_49,r_197_115_184,0.26,0,184,184,33
38,r_129_114_189,seq209,r_215_99_28,r_129_114_189,0.35,0,189,189,33
57,r_94_110_5,r_47_148_143,r_170_90_88,r_170_90_88,1.0,65,153,88,33
34,r_214_165_103,seq200,r_118_193_27,r_214_165_103,1.0,1,104,103,33
97,seq37,r_97_92_172,r_24_48_24,r_24_48_24,0.98,-1,23,24,33
75,seq4,r_164_206_132,r_124_53_31,r_124_53_31,0.92,101,132,31,33
132,seq221,r_103_9_147,r_32_107_91,r_32_107_91,1.0,83,174,91,33
59,r_124_53_31,r_214_165_103,seq74,r_124_53_31,0.96,1,32,31,33
60,r_190_39_79,r_152_133_199,seq160,r_190_39_79,1.0,0,79,79,33
45,r_54_181_167,r_154_116_22,r_3_1_49,r_3_1_49,0.69,118,167,49,33
26,r_208_27_10,r_78_34_58,r_197_115_184,r_208_27_10,0.93,0,10,10,33
17,r_219_71_140,seq70,r_141_29_128,r_141_29_128,1.0,12,140,128,33
48,r_21_131_121,r_183_87_65,r_13_158_179,r_13_158_179,0.95,1,180,179,33
9,r_12_224_160,seq36,seq11,r_12_224_160,0.77,0,160,160,33
26,r_208_27_10,r_197_115_184,r_187_222_36,r_208_27_10,0.87,61,71,10,33
96,seq36,r_12_224_160,r_192_169_195,r_12_224_160,0.99,-6,154,160,33
37,r_10_8_84,r_197_115_184,r_14_62_160,r_14_62_160,0.82,24,184,160,33
22,r_18_184_125,seq33,seq37,r_18_184_125,0.93,0,125,125,33
28,r_47_148_143,r_13_158_179,seq217,r_13_158_179,0.69,-27,152,179,33
49,r_223_163_138,seq38,seq19,r_223_163_138,0.94,1,139,138,33
54,r_15_5_52,r_170_90_88,seq102,r_15_5_52,1.0,0,52,52,33
56,r_186_153_184,r_105_119_1,r_192_169_195,r_192_169_195,0.76,-11,184,195,33
44,r_43_79_116,r_103_9_147,seq138,r_43_79_116,0.92,10,126,116,33
23,r_44_120_108,r_213_88_180,r_45_57_36,r_44_120_108,0.99,0,108,108,33
20,r_78_34_58,r_104_166_70,seq162,r_78_34_58,1.0,0,58,58,33
82,seq16,r_130_7_131,r_49_6_67,r_130_7_131,0.64,-32,99,131,33
84,seq19,r_213_88_180,r_72_178_144,r_72_178_144,0.96,36,180,144,33
30,r_44_150_96,seq78,r_184_223_5,r_44_150_96,1.0,0,96,96,34
50,r_76_52_136,r_163_5_82,seq155,r_76_52_136,1.0,0,136,136,34
36,r_91_17_65,r_166_125_163,seq161,r_91_17_65,1.0,0,65,65,34
8,r_86_25_142,seq177,seq117,r_86_25_142,0.53,0,142,142,34
49,r_21_148_59,seq104,seq178,r_21_148_59,1.0,-1,58,59,34
53,r_93_75_108,r_40_201_117,r_167_181_35,r_167_181_35,1.0,72,107,35,34
43,r_53_102_84,r_76_52_136,seq64,r_53_102_84,0.56,0,84,84,34
125,seq78,r_44_150_96,seq161,r_44_150_96,1.0,1,97,96,34
54,r_165_95_96,r_180_218_116,seq6,r_165_95_96,1.0,0,96,96,34
37,r_31_176_141,r_86_25_142,r_127_200_14,r_31_176_141,0.94,0,141,141,34
59,r_71_144_81,r_53_102_84,r_124_216_35,r_71_144_81,1.0,1,82,81,34
60,r_85_203_149,r_26_41_96,r_159_210_47,r_85_203_149,0.99,-99,50,149,34
55,r_212_132_142,seq13,r_9_83_198,r_212_132_142,0.91,1,143,142,34
71,r_106_130_159,r_73_141_117,r_147_48_171,r_106_130_159,0.49,8,167,159,34
39,r_57_206_59,r_33_164_150,r_146_43_68,r_57_206_59,1.0,4,63,59,34
25,r_23_192_15,r_119_35_199,seq156,r_23_192_15,0.99,0,15,15,34
5,r_34_123_70,r_33_164_150,seq187,r_34_123_70,0.66,1,71,70,34
46,r_40_201_117,r_58_19_196,r_167_181_35,r_40_201_117,0.98,1,118,117,34
42,r_47_145_80,seq177,seq126,r_47_145_80,0.73,1,81,80,34
88,seq22,r_103_72_184,r_86_25_142,r_103_72_184,0.33,-1,183,184,34
69,r_80_68_116,seq64,r_16_135_36,r_80_68_116,1.0,-1,115,116,34
3,r_60_8_14,r_26_41_96,seq15,r_60_8_14,0.98,0,14,14,34
45,r_26_41_96,r_96_70_104,r_183_2_47,r_26_41_96,1.0,-1,95,96,34
19,r_180_218_116,r_147_48_171,r_26_41_96,r_26_41_96,1.0,24,120,96,34
66,r_96_70_104,seq12,seq56,r_96_70_104,0.98,-1,103,104,34
67,r_20_77_154,r_184_223_5,r_73_141_117,r_20_77_154,0.81,0,154,154,34
110,seq56,r_185_175_155,r_96_70_104,r_96_70_104,0.5,12,116,104,34
10,r_73_141_117,r_106_130_159,r_20_77_154,r_20_77_154,0.98,6,160,154,34
90,seq27,r_146_43_68,r_88_217_191,r_146_43_68,1.0,3,71,68,34
7,r_38_138_22,r_146_43_68,seq6,r_38_138_22,0.98,0,22,22,34
115,seq63,r_211_61_92,seq177,r_211_61_92,0.93,1,93,92,34
72,r_185_175_155,seq4,r_9_83_198,r_185_175_155,0.89,0,155,155,34
63,r_131_39_167,seq188,seq54,r_131_39_167,0.76,0,167,167,34
29,r_167_181_35,r_91_17_65,seq28,r_167_181_35,0.95,6,41,35,34
11,r_118_111_116,r_142_0_162,seq177,r_118_111_116,0.78,2,118,116,34
20,r_110_154_183,r_163_5_82,seq153,r_163_5_82,1.0,0,82,82,34
88,seq22,r_18_79_26,r_103_72_184,r_18_79_26,0.68,3,29,26,34
15,r_142_0_162,seq187,seq128,r_142_0_162,0.67,0,162,162,34
102,seq178,seq1,r_124_216_35,r_124_216_35,1.0,2,37,35,34
106,seq177,r_86_25_142,r_118_111_116,r_118_111_116,0.5,30,146,116,34
62,r_108_215_67,seq134,seq193,r_108_215_67,1.0,0,67,67,34
85,seq13,r_212_132_142,r_163_5_82,r_163_5_82,0.86,42,124,82,34
2,r_14_189_127,r_38_138_22,r_184_223_5,r_14_189_127,0.95,1,128,127,34
40,r_184_223_5,r_20_77_154,r_14_189_127,r_20_77_154,0.62,0,154,154,34
74,r_103_72_184,seq22,r_165_95_96,r_165_95_96,0.58,90,186,96,34
24,r_191_158_96,seq193,r_167_181_35,r_191_158_96,0.99,0,96,96,34
48,r_159_210_47,r_91_17_65,r_85_203_149,r_159_210_47,0.94,0,47,47,34
33,r_67_152_102,seq10,r_60_8_14,r_67_152_102,0.97,0,102,102,34
48,r_159_210_47,r_85_203_149,r_146_43_68,r_159_210_47,0.9,103,150,47,34
64,r_179_99_166,r_209_24_2,r_90_11_156,r_209_24_2,0.89,165,167,2,34
50,r_76_52_136,r_53_102_84,r_163_5_82,r_76_52_136,0.99,-52,84,136,34
70,r_32_7_156,seq161,seq92,r_32_7_156,0.87,0,156,156,34
20,r_110_154_183,seq153,r_53_102_84,r_110_154_183,0.49,0,183,183,34
2,r_14_189_127,seq162,r_38_138_22,r_38_138_22,1.0,0,22,22,34
61,r_166_125_163,seq202,r_9_83_198,r_166_125_163,0.88,0,163,163,34
32,r_169_151_86,r_67_152_102,seq66,r_67_152_102,0.91,-15,87,102,34
38,r_74_62_162,r_88_217_191,r_9_83_198,r_74_62_162,0.5,0,162,162,34
52,r_88_217_191,r_74_62_162,seq133,r_74_62_162,0.89,-20,142,162,34
21,r_59_69_57,seq89,r_9_83_198,r_59_69_57,1.0,0,57,57,34
6,r_124_216_35,r_26_41_96,seq178,r_124_216_35,0.99,1,36,35,34
57,r_112_199_108,r_18_79_26,r_67_152_102,r_112_199_108,1.0,0,108,108,34
9,r_182_3_50,r_180_218_116,seq56,r_182_3_50,1.0,0,50,50,34
34,r_140_213_133,r_147_48_171,r_127_200_14,r_140_213_133,0.95,3,136,133,34
132,seq89,r_147_48_171,r_34_123_70,r_34_123_70,0.84,59,129,70,34
14,r_18_79_26,seq22,seq87,r_18_79_26,0.99,2,28,26,34
17,r_146_43_68,seq27,seq12,r_146_43_68,1.0,1,69,68,34
94,seq161,r_32_7_156,r_91_17_65,r_91_17_65,1.0,91,156,65,34
90,seq27,r_88_217_191,r_114_100_154,r_114_100_154,1.0,5,159,154,34
22,r_49_121_117,r_9_83_198,r_16_135_36,r_49_121_117,0.99,1,118,117,34
28,r_33_164_150,r_86_25_142,r_38_138_22,r_33_164_150,0.77,0,150,150,34
57,r_112_199_108,r_16_135_36,r_18_79_26,r_112_199_108,0.82,-62,46,108,34
135,seq221,seq219,r_76_52_136,r_76_52_136,0.92,30,166,136,34
13,r_183_2_47,r_74_62_162,seq104,r_183_2_47,1.0,0,47,47,34
44,r_114_100_154,seq155,seq27,r_114_100_154,0.74,0,154,154,34
118,seq66,r_55_197_65,r_90_11_156,r_55_197_65,0.44,96,161,65,34
23,r_147_48_171,seq120,r_106_130_159,r_147_48_171,0.4,9,180,171,34
108,seq51,r_90_11_156,seq92,r_90_11_156,1.0,4,160,156,34
60,r_85_203_149,r_159_210_47,seq66,r_85_203_149,0.89,1,150,149,34
35,r_163_5_82,r_110_154_183,seq13,r_163_5_82,1.0,0,82,82,34
1,r_16_135_36,r_112_199_108,r_58_19_196,r_112_199_108,0.78,-68,40,108,34
12,r_74_208_56,seq98,r_67_197_27,r_74_208_56,1.0,1,57,56,35
14,r_212_154_84,r_48_14_176,seq162,r_212_154_84,1.0,0,84,84,35
43,r_103_92_186,seq129,r_112_17_141,r_103_92_186,0.62,0,186,186,35
37,r_62_39_11,r_79_170_175,r_146_96_130,r_146_96_130,0.86,13,143,130,35
10,r_121_12_30,r_127_176_66,r_119_59_167,r_121_12_30,1.0,0,30,30,35
59,r_5_179_101,r_109_220_194,seq13,r_5_179_101,0.81,0,101,101,35
49,r_209_65_31,r_188_172_191,seq21,r_209_65_31,1.0,0,31,31,35
55,r_163_66_77,seq180,r_116_222_53,r_116_222_53,1.0,46,99,53,35
86,seq18,r_140_148_114,seq16,r_140_148_114,1.0,5,119,114,35
21,r_0_20_185,r_163_66_77,r_165_55_7,r_0_20_185,0.28,1,186,185,35
46,r_115_168_190,seq196,r_127_176_66,r_127_176_66,1.0,124,190,66,35
111,seq184,r_84_81_189,r_127_176_66,r_127_176_66,1.0,123,189,66,35
69,r_132_186_105,seq124,r_163_66_77,r_132_186_105,0.88,0,105,105,35
45,r_56_199_177,r_160_161_151,r_5_179_101,r_5_179_101,0.63,54,155,101,35
70,r_35_47_46,r_31_78_182,seq214,r_31_78_182,0.73,-129,53,182,35
66,r_135_8_153,seq108,r_185_57_136,r_135_8_153,0.83,0,153,153,35
3,r_24_43_43,r_175_91_50,seq198,r_24_43_43,1.0,0,43,43,35
129,seq87,r_112_17_141,r_27_141_39,r_27_141_39,0.72,9,48,39,35
39,r_189_213_54,r_101_28_145,r_155_206_157,r_101_28_145,0.63,0,145,145,35
31,r_146_96_130,seq72,r_62_39_11,r_146_96_130,1.0,0,130,130,35
41,r_48_14_176,seq181,r_207_204_55,r_207_204_55,0.99,121,176,55,35
67,r_202_158_157,seq134,r_152_77_156,r_202_158_157,0.71,2,159,157,35
54,r_200_97_52,seq75,seq157,r_200_97_52,1.0,4,56,52,35
109,seq53,r_185_57_136,r_163_66_77,r_185_57_136,0.97,-1,135,136,35
26,r_183_190_168,seq195,seq131,r_183_190_168,0.64,0,168,168,35
4,r_152_77_156,seq10,r_202_158_157,r_152_77_156,0.72,1,157,156,35
0,r_112_17_141,seq139,r_24_43_43,r_24_43_43,1.0,112,155,43,35
11,r_118_64_112,seq182,seq49,r_118_64_112,0.96,0,112,112,35
13,r_84_81_189,seq184,r_191_46_36,r_84_81_189,0.44,0,189,189,35
8,r_156_224_46,seq13,r_200_97_52,r_200_97_52,0.94,0,52,52,35
15,r_142_221_98,r_149_210_160,r_212_154_84,r_142_221_98,0.83,0,98,98,35
51,r_9_130_46,r_31_78_182,seq162,r_9_130_46,1.0,0,46,46,35
6,r_140_148_114,seq18,r_163_66_77,r_140_148_114,0.71,5,119,114,35
62,r_185_57_136,seq53,r_5_179_101,r_185_57_136,0.67,0,136,136,35
20,r_123_144_48,r_207_204_55,seq110,r_123_144_48,1.0,0,48,48,35
29,r_175_91_50,r_71_80_54,r_209_65_31,r_175_91_50,0.97,0,50,50,35
63,r_101_28_145,r_159_167_176,r_189_213_54,r_189_213_54,1.0,0,54,54,35
39,r_189_213_54,seq214,r_101_28_145,r_189_213_54,1.0,-1,53,54,35
10,r_121_12_30,r_119_59_167,r_174_93_122,r_174_93_122,1.0,24,146,122,35
2,r_58_6_148,seq129,r_121_12_30,r_121_12_30,0.91,123,153,30,35
47,r_166_52_63,seq133,r_24_43_43,r_166_52_63,1.0,0,63,63,35
40,r_155_206_157,seq173,r_189_213_54,r_189_213_54,1.0,98,152,54,35
45,r_56_199_177,r_5_179_101,r_146_96_130,r_56_199_177,0.83,5,182,177,35
126,seq211,r_23_201_118,r_217_223_16,r_23_201_118,0.64,-17,101,118,35
17,r_207_204_55,seq68,seq173,r_207_204_55,1.0,0,55,55,35
18,r_86_3_183,r_122_136_144,r_140_148_114,r_122_136_144,0.64,39,183,144,35
64,r_143_7_167,r_122_136_144,r_146_96_130,r_143_7_167,0.81,1,168,167,35
68,r_67_197_27,seq89,seq129,r_67_197_27,0.99,0,27,27,35
60,r_116_222_53,seq26,seq63,r_116_222_53,1.0,0,53,53,35
58,r_122_136_144,r_143_7_167,r_127_176_66,r_127_176_66,0.73,99,165,66,35
65,r_151_54_111,r_103_92_186,seq68,r_151_54_111,0.97,0,111,111,35
7,r_125_177_11,r_74_208_56,seq18,r_125_177_11,0.57,0,11,11,35
38,r_159_167_176,seq134,r_101_28_145,r_101_28_145,0.67,31,176,145,35
52,r_160_161_151,r_56_199_177,r_112_17_141,r_56_199_177,0.67,-22,155,177,35
5,r_76_194_13,r_32_50_160,seq26,r_76_194_13,0.99,0,13,13,35
57,r_2_113_52,r_153_29_196,r_112_17_141,r_153_29_196,0.41,-13,183,196,35
57,r_2_113_52,r_61_114_12,r_153_29_196,r_2_113_52,1.0,0,52,52,35
23,r_27_141_39,r_79_170_175,r_218_15_37,r_27_141_39,0.95,4,43,39,35
124,seq164,r_56_199_177,r_112_17_141,r_56_199_177,0.57,5,182,177,35
81,seq129,r_58_6_148,r_74_208_56,r_74_208_56,1.0,97,153,56,35
27,r_217_223_16,r_84_81_189,seq211,r_217_223_16,1.0,0,16,16,35
61,r_188_172_191,r_209_65_31,seq11,r_209_65_31,1.0,0,31,31,35
53,r_218_15_37,r_84_81_189,r_27_141_39,r_218_15_37,0.99,0,37,37,35
9,r_153_29_196,seq4,r_2_113_52,r_2_113_52,1.0,11,63,52,35
63,r_101_28_145,r_189_213_54,r_35_47_46,r_101_28_145,1.0,0,145,145,35
145,seq117,r_216_73_168,r_23_201_118,r_23_201_118,0.96,49,167,118,35
133,seq94,r_37_145_177,r_191_46_36,r_191_46_36,1.0,30,66,36,35
22,r_127_176_66,seq63,seq21,r_127_176_66,1.0,0,66,66,35
28,r_174_93_122,r_45_25_193,r_121_12_30,r_174_93_122,0.72,0,122,122,35
33,r_71_80_54,r_175_91_50,seq34,r_175_91_50,0.53,-1,49,50,35
82,seq10,r_152_77_156,seq30,r_152_77_156,1.0,1,157,156,35
35,r_23_201_118,seq211,seq105,r_23_201_118,1.0,0,118,118,35
135,seq98,r_74_208_56,seq108,r_74_208_56,1.0,1,57,56,35
95,seq214,r_189_213_54,r_35_47_46,r_189_213_54,0.9,-9,45,54,35
30,r_27_15_116,r_60_150_115,r_198_204_103,r_27_15_116,0.81,0,116,116,36
36,r_37_176_112,seq122,r_134_213_68,r_37_176_112,0.99,0,112,112,36
122,seq205,r_76_216_148,r_18_143_11,r_76_216_148,0.56,1,149,148,36
14,r_32_81_88,seq34,r_198_204_103,r_32_81_88,1.0,0,88,88,36
8,r_130_104_102,r_123_69_103,seq160,r_130_104_102,0.84,3,105,102,36
67,r_181_177_42,r_178_193_120,seq206,r_181_177_42,1.0,0,42,42,36
54,r_93_117_127,seq40,r_45_219_76,r_45_219_76,1.0,53,129,76,36
42,r_13_83_52,seq132,r_72_16_65,r_13_83_52,0.98,0,52,52,36
59,r_10_108_138,r_180_103_174,seq53,r_10_108_138,0.75,-1,137,138,36
32,r_68_23_45,seq199,seq132,r_68_23_45,1.0,0,45,45,36
55,r_125_19_74,seq160,seq182,r_125_19_74,1.0,0,74,74,36
16,r_14_138_167,r_198_204_103,r_152_63_3,r_14_138_167,0.62,0,167,167,36
1,r_180_103_174,seq153,r_123_69_103,r_180_103_174,0.72,0,174,174,36
45,r_194_70_120,seq73,seq7,r_194_70_120,0.94,0,120,120,36
31,r_126_57_38,r_129_127_166,seq145,r_126_57_38,1.0,0,38,38,36
66,r_80_168_179,seq145,r_152_63_3,r_152_63_3,0.68,177,180,3,36
70,r_201_220_5,seq113,r_96_75_47,r_96_75_47,1.0,3,50,47,36
63,r_112_142_27,r_130_104_102,seq141,r_112_142_27,0.98,0,27,27,36
65,r_151_21_28,r_37_176_112,r_217_211_140,r_151_21_28,0.96,0,28,28,36
109,seq159,r_217_211_140,r_152_63_3,r_217_211_140,0.95,0,140,140,36
72,r_24_223_123,r_217_211_140,r_198_204_103,r_24_223_123,0.8,0,123,123,36
4,r_72_16_65,seq124,r_151_21_28,r_72_16_65,0.99,0,65,65,36
73,r_187_192_119,seq179,seq39,r_187_192_119,1.0,1,120,119,36
11,r_0_82_96,seq164,r_11_64_25,r_0_82_96,0.97,0,96,96,36
20,r_54_29_73,seq136,r_13_83_52,r_54_29_73,1.0,0,73,73,36
13,r_76_216_148,seq205,r_152_63_3,r_76_216_148,0.92,0,148,148,36
98,seq42,seq52,r_95_84_7,r_95_84_7,0.75,78,85,7,36
15,r_217_211_140,seq159,seq38,r_217_211_140,0.97,0,140,140,36
48,r_207_158_80,seq98,seq105,r_207_158_80,0.97,0,80,80,36
44,r_18_143_11,seq173,seq73,r_18_143_11,1.0,0,11,11,36
33,r_154_100_45,r_45_219_76,seq90,r_45_219_76,0.96,-22,54,76,36
74,r_6_128_188,r_66_121_55,r_130_104_102,r_66_121_55,0.68,133,188,55,36
52,r_2_9_93,seq105,r_4_44_35,r_4_44_35,0.86,18,53,35,36
27,r_45_219_76,r_27_15_116,seq131,r_45_219_76,0.87,1,77,76,36
42,r_13_83_52,r_184_155_132,r_54_29_73,r_54_29_73,0.72,4,77,73,36
39,r_66_121_55,seq105,r_6_128_188,r_66_121_55,0.99,1,56,55,36
2,r_135_167_103,seq110,seq97,r_135_167_103,0.97,0,103,103,36
12,r_48_58_40,seq106,seq115,r_48_58_40,1.0,0,40,40,36
37,r_119_47_7,r_135_167_103,seq113,r_119_47_7,0.75,3,10,7,36
40,r_170_166_89,r_190_186_183,r_66_121_55,r_170_166_89,0.98,0,89,89,36
53,r_96_75_47,r_93_117_127,r_201_220_5,r_96_75_47,1.0,0,47,47,36
74,r_6_128_188,r_43_147_85,r_66_121_55,r_6_128_188,1.0,-103,85,188,36
18,r_184_155_132,seq39,r_3_51_104,r_3_51_104,0.88,37,141,104,36
29,r_200_146_85,r_185_1_149,seq157,r_200_146_85,1.0,3,88,85,36
42,r_13_83_52,r_72_16_65,r_184_155_132,r_72_16_65,0.67,0,65,65,36
24,r_171_30_177,seq62,seq12,r_171_30_177,0.45,0,177,177,36
25,r_185_1_149,seq133,r_135_167_103,r_185_1_149,0.73,0,149,149,36
64,r_86_46_118,seq163,r_88_59_10,r_86_46_118,1.0,0,118,118,36
65,r_151_21_28,r_217_211_140,r_72_16_65,r_151_21_28,1.0,77,105,28,36
17,r_88_59_10,r_76_216_148,seq52,r_88_59_10,0.85,0,10,10,36
88,seq31,r_139_79_164,r_95_84_7,r_139_79_164,0.75,1,165,164,36
50,r_41_50_114,r_85_140_149,r_112_142_27,r_41_50_114,0.99,30,144,114,36
58,r_43_147_85,r_6_128_188,r_4_44_35,r_43_147_85,1.0,0,85,85,36
68,r_77_144_188,r_123_69_103,r_85_140_149,r_77_144_188,0.69,0,188,188,36
38,r_85_140_149,r_41_50_114,r_125_19_74,r_85_140_149,0.86,0,149,149,36
39,r_66_121_55,r_6_128_188,r_3_51_104,r_3_51_104,1.0,-2,102,104,36
6,r_4_44_35,r_2_9_93,r_43_147_85,r_4_44_35,1.0,57,92,35,36
6,r_4_44_35,r_93_117_127,r_2_9_93,r_4_44_35,0.98,1,36,35,36
34,r_178_193_120,seq92,seq163,r_178_193_120,0.93,0,120,120,36
52,r_2_9_93,r_4_44_35,seq98,r_2_9_93,1.0,0,93,93,36
149,seq124,r_6_128_188,r_13_83_52,r_13_83_52,0.93,2,54,52,36
60,r_139_79_164,seq31,r_41_50_114,r_139_79_164,0.67,1,165,164,36
119,seq203,r_148_118_159,seq34,r_148_118_159,1.0,-1,158,159,36
9,r_123_69_103,r_130_104_102,seq53,r_130_104_102,0.68,3,105,102,36
117,seq73,r_194_70_120,r_18_143_11,r_18_143_11,0.98,0,11,11,36
133,seq97,r_93_117_127,r_135_167_103,r_135_167_103,1.0,4,107,103,36
28,r_190_186_183,r_88_59_10,r_152_63_3,r_190_186_183,0.7,0,183,183,36
22,r_87_25_107,r_148_118_159,seq163,r_87_25_107,0.88,0,107,107,36
28,r_190_186_183,r_170_166_89,r_88_59_10,r_170_166_89,1.0,0,89,89,36
51,r_65_17_29,r_48_58_40,seq169,r_65_17_29,1.0,0,29,29,36
49,r_165_109_35,r_178_193_120,r_35_20_174,r_165_109_35,1.0,0,35,35,36
23,r_35_20_174,seq206,r_165_109_35,r_165_109_35,1.0,37,72,35,36
47,r_22_71_25,seq124,seq98,r_22_71_25,0.99,1,26,25,36
35,r_3_51_104,seq102,r_170_166_89,r_3_51_104,0.87,0,104,104,36
40,r_14_62_41,r_131_145_21,r_75_116_168,r_131_145_21,0.22,147,168,21,37
40,r_14_62_41,r_44_97_31,r_131_145_21,r_14_62_41,0.87,-10,31,41,37
30,r_138_117_107,seq137,seq187,r_138_117_107,0.84,0,107,107,37
8,r_28_34_47,seq13,seq149,r_28_34_47,0.99,0,47,47,37
42,r_129_80_42,r_134_78_40,r_83_126_198,r_134_78_40,1.0,-9,31,40,37
36,r_90_162_132,seq69,r_196_168_95,r_196_168_95,0.99,54,149,95,37
140,seq104,r_139_86_92,r_10_128_43,r_10_128_43,0.88,0,43,43,37
14,r_127_91_68,seq224,seq58,r_127_91_68,0.98,0,68,68,37
43,r_173_48_84,r_176_25_158,r_7_130_74,r_173_48_84,0.5,5,89,84,37
108,seq55,r_172_190_20,r_220_180_59,r_220_180_59,0.57,-4,55,59,37
116,seq68,r_197_179_84,seq63,r_197_179_84,1.0,4,88,84,37
3,r_172_190_20,r_41_221_163,r_139_86_92,r_139_86_92,0.74,54,146,92,37
59,r_15_46_82,seq39,seq59,r_15_46_82,0.88,0,82,82,37
48,r_189_203_10,r_156_51_178,r_148_125_131,r_189_203_10,1.0,1,11,10,37
71,r_175_136_181,seq114,r_131_145_21,r_131_145_21,0.67,160,181,21,37
16,r_196_168_95,r_216_77_166,r_15_46_82,r_196_168_95,0.77,1,96,95,37
21,r_113_42_130,seq20,r_109_40_41,r_113_42_130,0.74,7,137,130,37
39,r_210_66_110,seq20,seq12,r_210_66_110,0.56,1,111,110,37
1,r_26_30_106,seq58,r_193_76_26,r_26_30_106,1.0,7,113,106,37
5,r_7_130_74,r_138_117_107,r_185_118_170,r_185_118_170,0.8,-96,74,170,37
46,r_223_132_128,seq206,r_129_80_42,r_223_132_128,0.55,0,128,128,37
58,r_119_152_53,seq8,seq94,r_119_152_53,1.0,2,55,53,37
67,r_182_166_11,r_165_155_110,seq22,r_182_166_11,0.81,3,14,11,37
45,r_197_179_84,seq68,r_157_191_46,r_197_179_84,0.89,0,84,84,37
13,r_171_154_178,seq204,r_151_17_49,r_151_17_49,0.63,2,51,49,37
19,r_73_37_149,seq102,seq174,r_73_37_149,0.62,2,151,149,37
66,r_98_35_90,seq94,r_16_163_85,r_98_35_90,1.0,0,90,90,37
82,seq209,seq39,r_134_78_40,r_134_78_40,1.0,11,51,40,37
38,r_44_97_31,r_14_62_41,seq158,r_44_97_31,0.98,0,31,31,37
18,r_10_128_43,r_165_155_110,seq104,r_10_128_43,0.84,0,43,43,37
129,seq213,r_95_82_151,r_110_159_78,r_95_82_151,0.63,1,152,151,37
12,r_115_64_26,r_215_195_37,seq19,r_115_64_26,0.72,1,27,26,37
110,seq57,r_90_162_132,r_74_147_47,r_74_147_47,0.88,19,66,47,37
9,r_193_76_26,seq135,seq224,r_193_76_26,0.79,-2,24,26,37
0,r_134_78_40,r_129_80_42,seq209,r_134_78_40,0.9,1,41,40,37
26,r_49_140_42,r_98_35_90,seq177,r_49_140_42,1.0,0,42,42,37
74,r_89_71_9,r_26_30_106,seq94,r_89_71_9,0.94,2,11,9,37
4,r_165_155_110,seq11,seq137,r_165_155_110,0.61,5,115,110,37
63,r_65_133_94,r_41_221_163,r_44_97_31,r_65_133_94,0.87,4,98,94,37
11,r_0_170_82,seq99,seq209,r_0_170_82,0.92,-2,80,82,37
104,seq177,seq96,r_49_140_42,r_49_140_42,1.0,10,52,42,37
20,r_185_118_170,seq108,r_7_130_74,r_7_130_74,1.0,23,97,74,37
23,r_41_221_163,r_127_91_68,r_172_190_20,r_41_221_163,0.65,-139,24,163,37
73,r_72_181_48,r_29_144_173,seq38,r_72_181_48,0.99,0,48,48,37
13,r_171_154_178,r_151_17_49,seq96,r_171_154_178,0.64,3,181,178,37
62,r_95_82_151,seq213,r_151_17_49,r_95_82_151,0.74,1,152,151,37
5,r_7_130_74,r_185_118_170,r_176_25_158,r_7_130_74,0.88,99,173,74,37
70,r_109_40_41,r_73_37_149,seq106,r_109_40_41,0.99,0,41,41,37
55,r_220_180_59,r_16_163_85,seq55,r_220_180_59,1.0,0,59,59,37
69,r_100_21_32,seq167,r_6_123_37,r_100_21_32,0.73,0,32,32,37
27,r_176_25_158,r_83_126_198,r_7_130_74,r_83_126_198,0.75,-39,159,198,37
3,r_172_190_20,seq213,r_41_221_163,r_172_190_20,0.95,0,20,20,37
25,r_151_17_49,seq4,r_171_154_178,r_151_17_49,0.63,2,51,49,37
60,r_92_88_27,r_105_169_62,r_173_48_84,r_92_88_27,0.8,0,27,27,37
64,r_122_101_23,r_193_76_26,seq222,r_122_101_23,0.9,1,24,23,37
52,r_74_147_47,seq2,seq57,r_74_147_47,0.98,1,48,47,37
2,r_156_51_178,seq183,r_56_93_80,r_56_93_80,0.59,101,181,80,37
59,r_15_46_82,seq59,r_196_168_95,r_15_46_82,0.48,67,149,82,37
29,r_105_169_62,r_26_30_106,seq20,r_105_169_62,0.89,-1,61,62,37
33,r_139_86_92,seq38,r_172_190_20,r_139_86_92,0.88,6,98,92,37
48,r_189_203_10,r_148_125_131,r_215_195_37,r_189_203_10,0.91,123,133,10,37
70,r_109_40_41,seq106,r_113_42_130,r_113_42_130,0.55,-2,128,130,37
15,r_157_191_46,seq2,r_197_179_84,r_197_179_84,1.0,8,92,84,37
20,r_185_118_170,r_7_130_74,r_214_194_50,r_185_118_170,0.8,3,173,170,37
68,r_83_126_198,r_176_25_158,r_129_80_42,r_176_25_158,0.86,-64,94,158,37
137,seq99,r_0_170_82,r_92_88_27,r_0_170_82,0.6,-2,80,82,37
32,r_1_200_168,r_56_93_80,r_220_180_59,r_1_200_168,0.89,-88,80,168,37
34,r_143_84_84,r_216_77_166,r_6_123_37,r_143_84_84,0.82,3,87,84,37
24,r_24_202_52,r_119_152_53,seq207,r_119_152_53,0.93,-9,44,53,37
61,r_205_192_196,r_73_37_149,r_131_145_21,r_205_192_196,0.54,-172,24,196,37
53,r_67_43_57,r_73_37_149,seq137,r_67_43_57,1.0,0,57,57,37
57,r_131_145_21,r_127_91_68,r_205_192_196,r_131_145_21,0.9,1,22,21,37
17,r_50_111_143,seq22,r_105_169_62,r_105_169_62,0.57,82,144,62,37
25,r_151_17_49,r_171_154_178,r_95_82_151,r_151_17_49,0.61,132,181,49,37
144,seq108,r_185_118_170,r_7_130_74,r_7_130_74,0.99,99,173,74,37
50,r_148_125_131,r_215_195_37,r_198_219_13,r_148_125_131,1.0,2,133,131,37
31,r_214_194_50,r_16_163_85,r_44_97_31,r_214_194_50,0.99,1,51,50,37
123,seq206,r_223_132_128,r_56_93_80,r_56_93_80,1.0,48,128,80,37
28,r_216_77_166,seq207,r_50_111_143,r_216_77_166,0.46,0,166,166,37
10,r_47_120_11,r_24_202_52,seq96,r_24_202_52,0.45,-33,19,52,37
49,r_56_93_80,r_1_200_168,seq206,r_56_93_80,0.97,0,80,80,37
72,r_215_195_37,r_148_125_131,r_189_203_10,r_148_125_131,1.0,2,133,131,37
72,r_215_195_37,seq158,r_148_125_131,r_215_195_37,1.0,0,37,37,37
44,r_85_201_79,r_138_117_107,seq81,r_85_201_79,0.49,3,82,79,37
89,seq19,r_165_155_110,r_115_64_26,r_115_64_26,0.85,1,27,26,37
60,r_92_88_27,r_173_48_84,seq99,r_173_48_84,1.0,5,89,84,37
35,r_16_163_85,r_107_124_100,r_100_21_32,r_107_124_100,0.45,-13,87,100,37
50,r_148_125_131,r_109_40_41,r_215_195_37,r_148_125_131,0.96,-94,37,131,37
23,r_41_221_163,r_172_190_20,r_98_35_90,r_98_35_90,1.0,69,159,90,37
51,r_4_216_83,seq51,seq215,r_4_216_83,0.99,0,83,83,38
36,r_157_148_100,r_65_135_155,r_174_55_31,r_157_148_100,1.0,1,101,100,38
41,r_137_158_86,r_159_166_59,seq29,r_137_158_86,1.0,0,86,86,38
14,r_3_24_68,r_81_145_173,r_179_221_38,r_3_24_68,1.0,0,68,68,38
8,r_26_197_116,seq131,seq144,r_26_197_116,0.93,1,117,116,38
58,r_63_47_190,r_176_188_49,seq155,r_63_47_190,0.49,0,190,190,38
43,r_65_135_155,r_157_148_100,r_85_89_42,r_65_135_155,1.0,-54,101,155,38
17,r_129_72_22,r_159_166_59,seq18,r_129_72_22,1.0,0,22,22,38
91,seq154,r_206_98_58,r_142_100_19,r_142_100_19,0.91,38,57,19,38
54,r_103_84_115,r_219_33_121,r_121_209_46,r_219_33_121,0.69,-6,115,121,38
116,seq195,seq183,r_65_135_155,r_65_135_155,0.65,2,157,155,38
37,r_152_71_81,seq14,seq29,r_152_71_81,0.86,9,90,81,38
3,r_224_119_176,r_10_171_27,r_159_166_59,r_224_119_176,0.91,0,176,176,38
59,r_52_127_62,seq169,seq132,r_52_127_62,0.99,1,63,62,38
73,r_2_114_51,r_224_119_176,r_176_188_49,r_2_114_51,1.0,0,51,51,38
55,r_36_186_160,r_0_82_197,seq204,r_36_186_160,0.62,1,161,160,38
16,r_198_22_155,seq61,r_214_140_107,r_214_140_107,0.57,50,157,107,38
7,r_159_166_59,r_137_158_86,seq19,r_159_166_59,0.79,28,87,59,38
1,r_90_125_133,seq210,r_13_146_118,r_90_125_133,0.98,0,133,133,38
143,seq147,r_208_88_116,r_206_98_58,r_208_88_116,1.0,0,116,116,38
46,r_214_140_107,r_73_49_117,seq123,r_214_140_107,0.98,0,107,107,38
42,r_73_49_117,r_214_140_107,seq177,r_214_140_107,0.88,0,107,107,38
45,r_96_46_53,r_214_140_107,r_54_67_173,r_96_46_53,1.0,-2,51,53,38
24,r_54_67_173,r_96_46_53,r_4_216_83,r_54_67_173,0.7,0,173,173,38
5,r_192_92_52,seq187,r_150_182_10,r_192_92_52,1.0,0,52,52,38
95,seq30,r_185_165_157,seq28,r_185_165_157,0.9,0,157,157,38
66,r_211_111_76,seq177,seq141,r_211_111_76,1.0,0,76,76,38
67,r_62_139_129,r_40_175_111,r_179_221_38,r_62_139_129,0.93,0,129,129,38
24,r_54_67_173,seq144,r_96_46_53,r_96_46_53,1.0,2,55,53,38
20,r_142_100_19,r_198_22_155,seq154,r_142_100_19,1.0,-2,17,19,38
113,seq61,r_198_22_155,seq187,r_198_22_155,0.82,2,157,155,38
40,r_35_205_36,r_12_194_61,seq207,r_35_205_36,1.0,1,37,36,38
7,r_159_166_59,seq19,r_206_98_58,r_206_98_58,0.25,65,123,58,38
41,r_137_158_86,seq28,r_159_166_59,r_159_166_59,0.54,-3,56,59,38
63,r_76_109_86,seq210,seq42,r_76_109_86,1.0,0,86,86,38
11,r_208_88_116,seq147,seq177,r_208_88_116,1.0,0,116,116,38
39,r_174_55_31,seq18,seq189,r_174_55_31,0.92,0,31,31,38
10,r_138_168_159,seq187,seq83,r_138_168_159,0.51,-131,28,159,38
15,r_10_171_27,seq18,r_223_190_62,r_223_190_62,1.0,15,77,62,38
57,r_218_53_72,seq162,seq151,r_218_53_72,0.98,5,77,72,38
106,seq177,r_0_82_197,r_208_88_116,r_208_88_116,1.0,33,149,116,38
6,r_206_98_58,r_63_47_190,seq147,r_206_98_58,0.76,18,76,58,38
13,r_150_182_10,r_220_201_101,r_192_92_52,r_150_182_10,1.0,49,59,10,38
53,r_176_188_49,r_73_49_117,r_2_114_51,r_176_188_49,1.0,2,51,49,38
52,r_223_190_62,r_10_171_27,r_40_175_111,r_40_175_111,0.83,16,127,111,38
10,r_138_168_159,seq83,r_174_55_31,r_138_168_159,0.55,1,160,159,38
27,r_11_43_109,seq39,seq200,r_11_43_109,0.83,1,110,109,38
22,r_121_209_46,r_26_197_116,r_103_84_115,r_121_209_46,0.78,71,117,46,38
47,r_117_25_146,seq14,r_214_140_107,r_117_25_146,0.87,1,147,146,38
7,r_159_166_59,r_206_98_58,r_224_119_176,r_224_119_176,0.86,-4,172,176,38
74,r_40_175_111,r_212_5_171,r_223_190_62,r_223_190_62,0.99,56,118,62,38
107,seq51,r_103_84_115,r_86_106_52,r_103_84_115,0.92,-68,47,115,38
18,r_56_16_135,seq207,r_10_171_27,r_56_16_135,0.85,0,135,135,38
29,r_220_201_101,seq215,seq112,r_220_201_101,1.0,0,101,101,38
25,r_185_165_157,seq30,seq19,r_185_165_157,0.58,0,157,157,38
33,r_13_146_118,seq141,r_85_89_42,r_13_146_118,0.98,0,118,118,38
48,r_85_89_42,r_65_135_155,r_13_146_118,r_13_146_118,1.0,4,122,118,38
13,r_150_182_10,r_12_194_61,r_220_201_101,r_150_182_10,0.93,0,10,10,38
3,r_224_119_176,r_2_114_51,r_10_171_27,r_2_114_51,1.0,0,51,51,38
50,r_44_66_162,r_153_184_120,r_65_135_155,r_44_66_162,0.47,0,162,162,38
58,r_63_47_190,r_206_98_58,r_176_188_49,r_176_188_49,1.0,27,76,49,38
70,r_118_178_122,seq187,seq51,r_118_178_122,1.0,1,123,122,38
65,r_180_6_103,seq170,seq14,r_180_6_103,0.99,0,103,103,38
61,r_59_60_141,seq1,r_11_43_109,r_59_60_141,0.79,0,141,141,38
32,r_163_167_87,r_56_16_135,r_174_55_31,r_163_167_87,0.81,1,88,87,38
38,r_203_41_118,seq83,seq18,r_203_41_118,0.96,0,118,118,38
52,r_223_190_62,seq130,r_10_171_27,r_223_190_62,0.98,1,63,62,38
22,r_121_209_46,r_11_43_109,r_26_197_116,r_121_209_46,0.94,3,49,46,38
69,r_179_221_38,seq196,seq39,r_179_221_38,1.0,0,38,38,38
34,r_31_37_156,r_12_194_61,seq19,r_31_37_156,0.98,0,156,156,38
2,r_74_193_14,r_126_217_173,seq19,r_74_193_14,0.94,0,14,14,38
60,r_133_20_143,r_212_5_171,r_4_216_83,r_4_216_83,0.59,60,143,83,38
45,r_96_46_53,r_54_67_173,r_129_72_22,r_54_67_173,0.96,0,173,173,38
43,r_65_135_155,r_85_89_42,seq195,r_65_135_155,0.54,-6,149,155,38
94,seq29,r_212_5_171,seq191,r_212_5_171,0.87,-4,167,171,38
127,seq83,r_138_168_159,r_211_111_76,r_138_168_159,0.58,1,160,159,38
49,r_126_217_173,seq156,r_211_111_76,r_126_217_173,0.83,0,173,173,38
56,r_107_15_74,seq131,seq136,r_107_15_74,0.68,20,94,74,38
7,r_159_166_59,r_11_43_109,r_137_158_86,r_159_166_59,0.79,2,61,59,38
48,r_85_89_42,seq200,r_65_135_155,r_85_89_42,1.0,0,42,42,38
44,r_212_5_171,seq29,r_121_209_46,r_212_5_171,0.76,0,171,171,38
23,r_23_199_126,r_54_67_173,r_176_188_49,r_23_199_126,0.96,0,126,126,38
35,r_116_50_93,r_12_194_61,seq70,r_116_50_93,1.0,0,93,93,38
12,r_79_8_105,seq191,r_76_109_86,r_79_8_105,0.99,2,107,105,38
30,r_80_26_70,r_112_106_193,r_103_47_37,r_80_26_70,1.0,0,70,70,39
143,seq116,r_178_196_165,r_162_78_32,r_162_78_32,0.97,-1,31,32,39
63,r_60_128_43,r_15_57_119,r_159_53_30,r_60_128_43,1.0,0,43,43,39
41,r_120_30_17,r_218_89_53,seq200,r_120_30_17,0.97,0,17,17,39
14,r_55_155_180,seq211,r_66_69_112,r_66_69_112,0.56,68,180,112,39
49,r_54_130_58,r_178_196_165,seq31,r_54_130_58,0.97,0,58,58,39
67,r_103_47_37,seq211,r_146_86_94,r_103_47_37,0.94,0,37,37,39
53,r_16_28_165,seq165,r_44_169_138,r_44_169_138,0.48,31,169,138,39
43,r_81_105_171,seq134,r_82_1_89,r_81_105_171,0.71,0,171,171,39
32,r_162_78_32,r_16_28_165,seq116,r_162_78_32,0.99,-1,31,32,39
50,r_92_177_19,r_82_1_89,seq108,r_92_177_19,0.68,3,22,19,39
54,r_145_182_62,r_146_86_94,seq220,r_145_182_62,1.0,-1,61,62,39
37,r_146_86_94,seq0,seq179,r_146_86_94,1.0,0,94,94,39
54,r_145_182_62,seq220,r_20_113_75,r_145_182_62,0.57,78,140,62,39
59,r_102_14_146,seq180,seq193,r_102_14_146,0.85,0,146,146,39
55,r_32_41_142,seq127,r_210_217_74,r_32_41_142,0.62,4,146,142,39
71,r_34_39_123,seq180,r_82_1_89,r_34_39_123,0.82,0,123,123,39
21,r_68_172_180,seq160,r_150_88_40,r_150_88_40,0.83,141,181,40,39
65,r_12_136_44,seq165,r_174_168_144,r_12_136_44,1.0,0,44,44,39
5,r_173_161_188,seq75,r_159_53_30,r_173_161_188,0.26,2,190,188,39
42,r_15_57_119,seq126,seq134,r_15_57_119,1.0,0,119,119,39
69,r_109_132_197,r_74_192_123,r_34_39_123,r_109_132_197,1.0,-74,123,197,39
12,r_21_149_34,r_100_201_19,seq206,r_21_149_34,0.97,1,35,34,39
19,r_183_46_73,r_32_41_142,seq165,r_183_46_73,0.97,1,74,73,39
39,r_123_119_33,r_216_51_126,seq154,r_216_51_126,1.0,0,126,126,39
31,r_66_69_112,r_68_172_180,seq19,r_66_69_112,0.98,0,112,112,39
3,r_144_45_165,r_173_161_188,seq110,r_173_161_188,0.51,-22,166,188,39
10,r_222_107_188,r_48_175_112,seq211,r_48_175_112,0.9,5,117,112,39
26,r_104_29_135,seq75,seq59,r_104_29_135,0.75,0,135,135,39
8,r_216_51_126,r_123_119_33,r_183_46_73,r_216_51_126,1.0,0,126,126,39
72,r_18_5_74,seq148,r_202_194_48,r_18_5_74,1.0,0,74,74,39
4,r_215_64_147,seq200,seq223,r_215_64_147,0.94,0,147,147,39
0,r_152_97_78,r_174_168_144,r_218_89_53,r_152_97_78,1.0,0,78,78,39
29,r_101_35_59,r_82_1_89,seq160,r_101_35_59,1.0,0,59,59,39
11,r_195_209_101,seq8,r_38_94_198,r_195_209_101,1.0,0,101,101,39
22,r_181_198_51,seq59,r_83_6_96,r_181_198_51,1.0,0,51,51,39
107,seq180,r_102_14_146,seq126,r_102_14_146,1.0,0,146,146,39
20,r_214_176_141,r_144_45_165,seq27,r_214_176_141,0.99,0,141,141,39
13,r_58_212_141,seq27,r_104_29_135,r_58_212_141,0.96,0,141,141,39
8,r_216_51_126,seq154,r_123_119_33,r_123_119_33,1.0,1,34,33,39
15,r_143_156_153,seq204,seq148,r_143_156_153,0.88,0,153,153,39
48,r_82_1_89,r_92_177_19,seq43,r_82_1_89,0.89,-3,86,89,39
73,r_202_194_48,r_63_96_191,seq131,r_202_194_48,1.0,0,48,48,39
16,r_150_88_40,seq19,seq193,r_150_88_40,1.0,0,40,40,39
6,r_2_90_67,seq160,r_153_170_46,r_2_90_67,1.0,0,67,67,39
62,r_24_84_134,r_166_207_198,seq122,r_24_84_134,0.99,0,134,134,39
67,r_103_47_37,r_146_86_94,r_80_26_70,r_146_86_94,0.57,0,94,94,39
17,r_208_65_44,r_146_86_94,seq157,r_208_65_44,1.0,0,44,44,39
27,r_153_170_46,r_24_84_134,seq116,r_153_170_46,1.0,1,47,46,39
40,r_48_175_112,r_222_107_188,r_195_209_101,r_195_209_101,1.0,16,117,101,39
74,r_44_169_138,r_166_207_198,seq203,r_166_207_198,0.62,-60,138,198,39
24,r_74_192_123,r_109_132_197,r_21_149_34,r_74_192_123,0.98,0,123,123,39
25,r_129_185_62,seq200,seq184,r_129_185_62,1.0,0,62,62,39
33,r_166_207_198,r_24_84_134,seq22,r_24_84_134,1.0,0,134,134,39
141,seq108,seq187,r_92_177_19,r_92_177_19,0.96,6,25,19,39
65,r_12_136_44,r_174_168_144,r_140_137_196,r_174_168_144,1.0,0,144,144,39
28,r_159_53_30,seq205,seq167,r_159_53_30,0.99,0,30,30,39
47,r_174_168_144,r_12_136_44,r_166_207_198,r_174_168_144,0.9,0,144,144,39
44,r_13_10_45,seq206,seq197,r_13_10_45,1.0,0,45,45,39
70,r_115_79_71,r_83_6_96,seq108,r_115_79_71,1.0,0,71,71,39
111,seq59,seq91,r_104_29_135,r_104_29_135,1.0,16,151,135,39
68,r_140_137_196,r_174_168_144,r_115_79_71,r_115_79_71,0.5,45,116,71,39
61,r_111_125_91,seq188,seq91,r_111_125_91,1.0,0,91,91,39
38,r_95_56_134,r_38_94_198,r_152_97_78,r_38_94_198,1.0,-64,134,198,39
45,r_178_196_165,r_54_130_58,r_159_53_30,r_178_196_165,0.53,-113,52,165,39
60,r_25_199_188,seq135,r_55_155_180,r_55_155_180,0.92,10,190,180,39
45,r_178_196_165,r_159_53_30,r_215_64_147,r_159_53_30,0.97,135,165,30,39
9,r_83_6_96,r_114_4_166,r_181_198_51,r_181_198_51,1.0,20,71,51,39
85,seq19,r_150_88_40,r_100_201_19,r_150_88_40,0.7,0,40,40,39
123,seq75,r_173_161_188,r_114_4_166,r_114_4_166,0.71,24,190,166,39
102,seq220,seq206,r_20_113_75,r_20_113_75,1.0,5,80,75,39
135,seq135,r_25_199_188,seq85,r_25_199_188,0.71,-4,184,188,39
47,r_174_168_144,r_152_97_78,r_12_136_44,r_12_136_44,0.55,0,44,44,39
140,seq188,r_111_125_91,seq70,r_111_125_91,1.0,-2,89,91,39
56,r_77_61_88,seq122,seq36,r_77_61_88,1.0,0,88,88,39
7,r_20_113_75,r_195_209_101,r_145_182_62,r_20_113_75,1.0,0,75,75,39
23,r_210_217_74,seq203,seq3,r_210_217_74,0.86,6,80,74,39
39,r_123_119_33,seq200,r_216_51_126,r_123_119_33,0.94,0,33,33,39
57,r_224_118_30,r_162_78_32,r_159_53_30,r_159_53_30,0.99,-1,29,30,39
79,seq134,r_81_105_171,r_15_57_119,r_15_57_119,0.85,52,171,119,39
35,r_114_4_166,r_83_6_96,seq126,r_114_4_166,0.86,0,166,166,39
111,seq59,r_181_198_51,seq91,r_181_198_51,1.0,0,51,51,39
30,r_209_53_85,r_218_35_92,r_142_71_62,r_209_53_85,0.64,3,88,85,40
36,r_117_192_128,r_113_170_161,r_93_163_81,r_93_163_81,0.95,14,95,81,40
36,r_117_192_128,r_93_163_81,r_197_128_112,r_117_192_128,1.0,0,128,128,40
69,r_124_112_151,seq49,r_186_96_52,r_186_96_52,1.0,3,55,52,40
132,seq98,seq79,r_4_168_49,r_4_168_49,1.0,0,49,49,40
8,r_119_45_151,seq42,seq51,r_119_45_151,0.68,7,158,151,40
53,r_142_71_62,r_62_149_181,r_181_143_139,r_142_71_62,1.0,1,63,62,40
38,r_222_136_130,r_32_166_61,seq90,r_222_136_130,0.93,3,133,130,40
43,r_6_122_187,seq11,r_47_210_125,r_47_210_125,0.59,62,187,125,40
146,seq153,seq76,r_151_139_26,r_151_139_26,1.0,9,35,26,40
125,seq90,seq195,r_222_136_130,r_222_136_130,0.47,4,134,130,40
37,r_181_143_139,seq207,seq22,r_181_143_139,0.85,0,139,139,40
135,seq195,seq90,r_194_216_59,r_194_216_59,1.0,-1,58,59,40
55,r_201_9_107,seq219,seq89,r_201_9_107,0.72,0,107,107,40
86,seq21,r_67_69_96,r_18_203_139,r_18_203_139,0.82,15,154,139,40
16,r_67_69_96,r_179_10_69,r_113_170_161,r_179_10_69,0.87,0,69,69,40
21,r_18_203_139,seq5,seq107,r_18_203_139,0.57,0,139,139,40
39,r_29_86_117,r_93_163_81,r_32_166_61,r_29_86_117,1.0,-35,82,117,40
1,r_185_101_154,seq208,r_66_220_159,r_185_101_154,0.79,1,155,154,40
5,r_120_215_128,seq107,r_147_3_127,r_120_215_128,0.72,0,128,128,40
42,r_218_35_92,r_176_187_172,seq68,r_218_35_92,0.99,0,92,92,40
111,seq63,seq11,r_29_86_117,r_29_86_117,0.34,30,147,117,40
45,r_197_128_112,r_102_7_162,seq224,r_197_128_112,0.85,0,112,112,40
25,r_37_74_41,r_114_134_142,seq146,r_37_74_41,0.99,0,41,41,40
19,r_93_163_81,r_29_86_117,r_117_192_128,r_93_163_81,0.94,1,82,81,40
26,r_114_134_142,seq25,r_15_73_64,r_15_73_64,0.96,8,72,64,40
31,r_183_214_139,seq40,r_209_53_85,r_209_53_85,1.0,62,147,85,40
13,r_200_12_54,r_209_53_85,seq1,r_200_12_54,1.0,0,54,54,40
3,r_106_135_186,seq175,r_200_12_54,r_200_12_54,0.85,132,186,54,40
61,r_66_220_159,r_34_56_74,r_55_160_132,r_66_220_159,0.72,5,164,159,40
10,r_15_73_64,r_62_149_181,r_114_134_142,r_15_73_64,0.99,0,64,64,40
90,seq25,r_114_134_142,r_15_73_64,r_15_73_64,0.85,81,145,64,40
32,r_4_168_49,r_114_134_142,seq98,r_4_168_49,0.61,0,49,49,40
72,r_156_16_106,r_222_136_130,r_38_60_100,r_156_16_106,0.73,0,106,106,40
48,r_186_96_52,r_152_48_139,r_154_129_36,r_186_96_52,0.77,0,52,52,40
4,r_159_20_95,r_30_196_166,seq23,r_159_20_95,1.0,0,95,95,40
63,r_171_182_101,r_176_187_172,r_123_91_61,r_176_187_172,0.97,-70,102,172,40
114,seq68,seq207,r_218_35_92,r_218_35_92,1.0,29,121,92,40
73,r_55_160_132,r_124_112_151,seq158,r_55_160_132,0.87,1,133,132,40
11,r_190_217_120,r_108_78_136,r_93_163_81,r_108_78_136,0.96,-16,120,136,40
20,r_88_199_65,seq65,r_123_91_61,r_88_199_65,1.0,7,72,65,40
15,r_32_166_61,seq59,r_29_86_117,r_32_166_61,1.0,1,62,61,40
54,r_161_75_51,r_102_7_162,r_113_170_161,r_161_75_51,1.0,0,51,51,40
49,r_34_56_74,r_66_220_159,r_141_26_108,r_141_26_108,0.69,56,164,108,40
53,r_142_71_62,r_181_143_139,r_209_53_85,r_181_143_139,0.75,-28,111,139,40
57,r_157_125_176,r_61_46_186,seq14,r_157_125_176,0.62,0,176,176,40
52,r_33_58_42,r_64_150_67,seq59,r_33_58_42,1.0,0,42,42,40
35,r_154_129_36,r_201_9_107,r_55_160_132,r_154_129_36,0.93,3,39,36,40
6,r_179_10_69,r_67_69_96,r_54_115_103,r_179_10_69,1.0,3,72,69,40
62,r_155_204_77,r_209_53_85,seq153,r_155_204_77,1.0,1,78,77,40
14,r_105_198_12,r_32_166_61,seq65,r_105_198_12,0.94,-1,11,12,40
85,seq19,r_47_210_125,r_148_2_139,r_47_210_125,0.61,15,140,125,40
10,r_15_73_64,r_114_134_142,seq25,r_114_134_142,1.0,0,142,142,40
27,r_123_91_61,r_209_53_85,seq79,r_209_53_85,0.5,-24,61,85,40
26,r_114_134_142,r_37_74_41,seq25,r_37_74_41,1.0,0,41,41,40
35,r_154_129_36,r_55_160_132,r_213_140_65,r_154_129_36,0.67,36,72,36,40
69,r_124_112_151,r_186_96_52,seq208,r_124_112_151,0.87,1,152,151,40
2,r_102_7_162,r_0_188_180,r_181_143_139,r_181_143_139,0.79,25,164,139,40
47,r_95_193_169,r_108_78_136,seq110,r_95_193_169,0.84,0,169,169,40
40,r_94_206_149,seq221,r_28_191_50,r_94_206_149,0.87,0,149,149,40
105,seq175,r_106_135_186,r_119_45_151,r_119_45_151,0.79,35,186,151,40
74,r_61_46_186,r_157_125_176,r_6_122_187,r_157_125_176,0.54,0,176,176,40
18,r_147_3_127,seq92,seq49,r_147_3_127,0.94,1,128,127,40
29,r_141_26_108,seq65,r_34_56_74,r_141_26_108,0.99,2,110,108,40
61,r_66_220_159,seq89,r_34_56_74,r_34_56_74,1.0,27,101,74,40
33,r_38_60_100,seq178,r_156_16_106,r_38_60_100,0.73,6,106,100,40
127,seq92,r_147_3_127,seq70,r_147_3_127,0.99,1,128,127,40
64,r_205_77_133,r_30_196_166,r_180_137_13,r_205_77_133,0.66,0,133,133,40
68,r_151_139_26,r_147_3_127,seq153,r_151_139_26,1.0,1,27,26,40
19,r_93_163_81,r_117_192_128,r_190_217_120,r_93_163_81,0.98,47,128,81,40
50,r_54_115_103,seq207,r_179_10_69,r_179_10_69,1.0,36,105,69,40
58,r_189_31_119,r_145_130_75,r_201_9_107,r_189_31_119,0.95,0,119,119,40
61,r_66_220_159,r_200_12_54,seq89,r_200_12_54,0.62,-17,37,54,40
70,r_132_43_75,seq65,r_186_96_52,r_186_96_52,1.0,31,83,52,40
65,r_87_116_95,seq5,seq178,r_87_116_95,0.58,6,101,95,40
38,r_222_136_130,r_156_16_106,r_32_166_61,r_32_166_61,0.93,45,106,61,40
34,r_152_48_139,seq162,seq27,r_152_48_139,0.63,0,139,139,40
60,r_145_130_75,seq13,r_189_31_119,r_145_130_75,1.0,0,75,75,40
17,r_64_150_67,seq1,seq5,r_64_150_67,0.99,1,68,67,40
24,r_184_39_13,r_159_20_95,r_113_170_161,r_184_39_13,0.69,-3,10,13,40
22,r_213_140_65,r_156_16_106,r_154_129_36,r_213_140_65,1.0,1,66,65,40
91,seq27,seq85,r_152_48_139,r_152_48_139,1.0,9,148,139,40
49,r_34_56_74,r_172_72_142,r_66_220_159,r_34_56_74,1.0,0,74,74,40
140,seq110,seq103,r_123_91_61,r_123_91_61,0.84,84,145,61,40
56,r_109_131_151,seq1,r_183_214_139,r_183_214_139,0.77,13,152,139,40
7,r_57_50_178,seq173,r_180_137_13,r_180_137_13,0.64,166,179,13,40
44,r_0_188_180,seq104,r_190_217_120,r_190_217_120,0.68,61,181,120,40
118,seq79,seq44,r_123_91_61,r_123_91_61,0.91,20,81,61,40
26,r_114_134_142,r_15_73_64,r_190_217_120,r_114_134_142,1.0,0,142,142,40
23,r_62_149_181,seq24,r_94_206_149,r_94_206_149,0.67,26,175,149,40
138,seq107,r_106_135_186,r_18_203_139,r_18_203_139,1.0,10,149,139,40
12,r_194_216_59,seq68,seq195,r_194_216_59,1.0,1,60,59,40
128,seq221,r_94_206_149,seq97,r_94_206_149,0.89,0,149,149,40
30,r_161_50_139,r_24_53_179,seq69,r_161_50_139,0.8,0,139,139,41
44,r_100_115_77,r_102_117_184,r_110_34_177,r_100_115_77,0.88,108,185,77,41
51,r_156_82_189,seq189,r_171_148_110,r_171_148_110,0.47,80,190,110,41
36,r_126_30_101,seq76,seq143,r_126_30_101,0.99,5,106,101,41
14,r_176_140_102,r_168_158_152,r_44_14_1,r_176_140_102,0.92,0,102,102,41
8,r_88_61_177,seq40,r_213_214_104,r_88_61_177,0.7,0,177,177,41
43,r_45_119_112,r_213_214_104,r_195_191_165,r_45_119_112,1.0,0,112,112,41
54,r_108_20_88,seq8,r_78_180_26,r_108_20_88,0.93,0,88,88,41
65,r_12_85_40,r_27_16_195,r_222_175_155,r_12_85_40,1.0,1,41,40,41
59,r_212_59_124,r_71_187_191,seq77,r_212_59_124,0.96,1,125,124,41
55,r_68_204_156,r_27_16_195,r_93_89_51,r_68_204_156,0.9,1,157,156,41
71,r_83_223_105,r_168_158_152,seq135,r_83_223_105,1.0,0,105,105,41
39,r_209_22_68,r_86_116_104,r_5_25_17,r_209_22_68,0.56,-6,62,68,41
16,r_78_180_26,r_178_9_168,seq17,r_78_180_26,1.0,0,26,26,41
1,r_213_214_104,r_45_119_112,r_29_224_74,r_213_214_104,0.99,-7,97,104,41
37,r_66_41_176,r_24_53_179,r_5_25_17,r_5_25_17,1.0,6,23,17,41
5,r_52_185_153,r_168_158_152,seq129,r_52_185_153,0.82,1,154,153,41
42,r_65_139_83,seq17,seq11,r_65_139_83,0.99,1,84,83,41
69,r_197_62_88,seq136,r_198_150_79,r_198_150_79,0.91,9,88,79,41
45,r_216_64_106,r_39_105_71,r_160_220_32,r_216_64_106,0.98,0,106,106,41
63,r_170_101_21,seq21,r_168_158_152,r_170_101_21,1.0,2,23,21,41
7,r_94_87_55,r_71_187_191,seq91,r_94_87_55,0.97,-1,54,55,41
66,r_102_117_184,seq147,r_88_61_177,r_102_117_184,0.55,1,185,184,41
31,r_201_32_86,r_125_1_168,seq159,r_201_32_86,0.94,-2,84,86,41
41,r_0_205_158,seq75,seq91,r_0_205_158,0.67,0,158,158,41
3,r_198_150_79,r_167_138_198,seq163,r_198_150_79,1.0,1,80,79,41
10,r_110_34_177,seq74,r_100_115_77,r_100_115_77,0.96,101,178,77,41
62,r_177_127_17,r_198_150_79,seq109,r_177_127_17,1.0,0,17,17,41
26,r_124_151_99,seq194,r_168_158_152,r_124_151_99,0.99,-2,97,99,41
20,r_93_89_51,r_213_214_104,r_31_55_118,r_93_89_51,1.0,-2,49,51,41
72,r_107_206_175,seq183,r_110_34_177,r_107_206_175,0.43,7,182,175,41
29,r_199_51_63,r_10_162_35,seq194,r_10_162_35,0.72,-7,28,35,41
4,r_171_148_110,seq67,r_93_89_51,r_171_148_110,0.54,0,110,110,41
11,r_24_53_179,r_66_41_176,seq35,r_24_53_179,0.44,0,179,179,41
13,r_19_188_185,seq8,r_78_180_26,r_78_180_26,0.97,160,186,26,41
22,r_160_220_32,seq11,r_168_158_152,r_160_220_32,1.0,0,32,32,41
2,r_222_175_155,r_161_50_139,r_12_85_40,r_222_175_155,0.7,-114,41,155,41
57,r_98_54_80,seq81,seq104,r_98_54_80,1.0,0,80,80,41
74,r_10_162_35,r_199_51_63,seq84,r_10_162_35,1.0,-4,31,35,41
117,seq74,r_110_34_177,r_133_36_136,r_133_36_136,0.81,4,140,136,41
6,r_106_217_120,seq91,r_58_132_124,r_106_217_120,0.98,5,125,120,41
2,r_222_175_155,r_12_85_40,r_215_18_32,r_222_175_155,0.9,1,156,155,41
27,r_4_26_186,seq57,r_171_148_110,r_171_148_110,0.85,76,186,110,41
53,r_154_137_47,r_33_111_120,seq57,r_154_137_47,0.68,-9,38,47,41
47,r_43_72_178,seq67,r_94_87_55,r_94_87_55,1.0,123,178,55,41
140,seq104,r_156_82_189,r_98_54_80,r_98_54_80,0.78,2,82,80,41
126,seq163,r_4_26_186,r_197_62_88,r_197_62_88,0.94,3,91,88,41
18,r_131_95_69,seq104,seq144,r_131_95_69,1.0,1,70,69,41
24,r_23_47_73,r_209_22_68,r_94_87_55,r_23_47_73,0.99,0,73,73,41
25,r_178_9_168,seq109,r_52_185_153,r_178_9_168,0.77,0,168,168,41
33,r_122_134_94,seq91,r_199_51_63,r_122_134_94,0.79,0,94,94,41
127,seq84,r_31_55_118,seq90,r_31_55_118,1.0,-26,92,118,41
32,r_130_155_43,r_198_150_79,seq28,r_198_150_79,0.55,-36,43,79,41
64,r_31_55_118,r_71_187_191,seq194,r_31_55_118,0.98,1,119,118,41
65,r_12_85_40,r_222_175_155,r_106_217_120,r_12_85_40,0.51,120,160,40,41
58,r_114_73_78,r_33_111_120,r_78_180_26,r_114_73_78,0.94,-1,77,78,41
70,r_149_97_95,seq142,seq49,r_149_97_95,0.91,-2,93,95,41
20,r_93_89_51,r_31_55_118,seq90,r_31_55_118,1.0,1,119,118,41
52,r_86_116_104,seq147,r_130_155_43,r_86_116_104,0.99,0,104,104,41
19,r_5_25_17,r_52_185_153,r_66_41_176,r_5_25_17,1.0,0,17,17,41
124,seq81,r_98_54_80,r_153_141_9,r_98_54_80,0.92,-4,76,80,41
29,r_199_51_63,seq194,r_195_191_165,r_199_51_63,1.0,0,63,63,41
60,r_125_1_168,r_200_190_196,r_171_148_110,r_125_1_168,0.66,0,168,168,41
17,r_58_132_124,r_0_205_158,r_106_217_120,r_58_132_124,0.98,0,124,124,41
9,r_29_224_74,seq145,seq144,r_29_224_74,0.99,0,74,74,41
40,r_179_211_54,r_171_148_110,r_168_158_152,r_179_211_54,1.0,0,54,54,41
46,r_186_219_59,r_65_139_83,seq57,r_186_219_59,0.95,0,59,59,41
28,r_215_18_32,r_156_82_189,r_222_175_155,r_215_18_32,0.71,125,157,32,41
28,r_215_18_32,r_4_26_186,r_156_82_189,r_4_26_186,0.69,-101,85,186,41
135,seq96,r_3_184_99,seq145,r_3_184_99,1.0,-7,92,99,41
140,seq104,r_131_95_69,r_156_82_189,r_131_95_69,0.69,0,69,69,41
56,r_174_113_134,r_200_190_196,r_199_51_63,r_199_51_63,1.0,74,137,63,41
44,r_100_115_77,r_149_97_95,r_102_117_184,r_100_115_77,1.0,0,77,77,41
23,r_133_36_136,r_71_187_191,seq74,r_133_36_136,0.81,0,136,136,41
7,r_94_87_55,seq91,r_23_47_73,r_23_47_73,1.0,24,97,73,41
108,seq57,r_4_26_186,r_33_111_120,r_33_111_120,0.71,66,186,120,41
35,r_3_184_99,seq96,r_93_89_51,r_3_184_99,0.62,-2,97,99,41
12,r_6_7_123,seq146,r_168_158_152,r_6_7_123,0.93,0,123,123,41
51,r_104_31_97,seq198,seq190,r_104_31_97,1.0,0,97,97,42
36,r_214_46_89,seq158,seq50,r_214_46_89,1.0,0,89,89,42
122,seq198,r_104_31_97,seq16,r_104_31_97,1.0,-1,96,97,42
53,r_175_102_32,r_19_114_141,seq28,r_175_102_32,0.99,0,32,32,42
125,seq74,seq66,r_166_140_71,r_166_140_71,1.0,45,116,71,42
54,r_135_150_139,seq152,seq44,r_135_150_139,0.75,2,141,139,42
72,r_58_3_34,seq4,seq53,r_58_3_34,0.99,1,35,34,42
59,r_117_110_171,seq199,r_145_128_89,r_117_110_171,0.85,1,172,171,42
17,r_65_138_139,r_216_173_51,r_20_207_19,r_65_138_139,1.0,-116,23,139,42
71,r_126_193_87,seq172,r_58_3_34,r_126_193_87,0.59,2,89,87,42
16,r_188_56_99,r_196_143_92,seq152,r_188_56_99,1.0,1,100,99,42
21,r_166_140_71,r_121_87_130,seq74,r_166_140_71,1.0,0,71,71,42
5,r_112_164_136,seq199,seq198,r_112_164_136,1.0,0,136,136,42
104,seq171,r_157_192_167,r_151_113_87,r_151_113_87,1.0,80,167,87,42
46,r_162_224_133,r_42_14_67,seq26,r_162_224_133,0.57,-1,132,133,42
42,r_145_128_89,r_104_31_97,seq160,r_145_128_89,1.0,0,89,89,42
111,seq172,r_126_193_87,seq15,r_126_193_87,1.0,-10,77,87,42
69,r_51_201_183,r_18_64_188,r_47_163_177,r_51_201_183,0.44,0,183,183,42
45,r_181_52_8,r_223_120_151,r_104_31_97,r_104_31_97,0.93,48,145,97,42
15,r_20_207_19,r_65_138_139,seq45,r_65_138_139,0.99,0,139,139,42
105,seq44,r_86_35_152,seq26,r_86_35_152,0.46,-101,51,152,42
66,r_133_83_115,seq33,r_122_205_64,r_133_83_115,1.0,0,115,115,42
31,r_151_113_87,r_213_124_165,seq89,r_151_113_87,0.95,0,87,87,42
67,r_157_192_167,seq171,r_121_87_130,r_157_192_167,0.96,0,167,167,42
14,r_180_221_22,r_0_40_176,seq141,r_180_221_22,1.0,0,22,22,42
110,seq50,r_131_186_180,r_6_73_152,r_6_73_152,0.88,29,181,152,42
114,seq185,r_78_206_60,r_134_161_11,r_78_206_60,1.0,-15,45,60,42
138,seq100,r_170_85_180,r_137_222_35,r_137_222_35,0.87,10,45,35,42
3,r_78_206_60,r_196_143_92,seq158,r_78_206_60,1.0,0,60,60,42
63,r_184_7_112,r_25_36_41,seq176,r_184_7_112,1.0,0,112,112,42
15,r_20_207_19,r_170_85_180,r_65_138_139,r_20_207_19,1.0,0,19,19,42
4,r_122_205_64,r_131_186_180,seq66,r_122_205_64,1.0,-1,63,64,42
63,r_184_7_112,r_212_101_73,r_25_36_41,r_212_101_73,1.0,0,73,73,42
11,r_220_182_142,r_47_163_177,r_99_41_7,r_220_182_142,0.88,-5,137,142,42
26,r_67_88_51,r_59_108_160,r_99_41_7,r_67_88_51,1.0,0,51,51,42
20,r_54_156_158,seq17,r_78_206_60,r_78_206_60,1.0,100,160,60,42
105,seq44,seq26,r_135_150_139,r_135_150_139,0.89,2,141,139,42
73,r_123_195_15,r_0_40_176,r_43_84_161,r_123_195_15,1.0,1,16,15,42
117,seq190,r_34_24_131,r_104_31_97,r_104_31_97,0.57,1,98,97,42
105,seq44,r_162_224_133,r_86_35_152,r_86_35_152,0.44,-122,30,152,42
6,r_19_114_141,seq109,seq4,r_19_114_141,0.92,0,141,141,42
62,r_95_169_70,r_86_35_152,seq66,r_95_169_70,1.0,1,71,70,42
122,seq198,seq16,r_112_164_136,r_112_164_136,0.96,24,160,136,42
2,r_0_40_176,seq198,r_196_143_92,r_0_40_176,0.78,0,176,176,42
40,r_93_202_79,r_112_164_136,r_175_102_32,r_93_202_79,0.96,2,81,79,42
74,r_91_159_128,seq100,r_78_206_60,r_78_206_60,1.0,70,130,60,42
18,r_208_60_109,seq5,seq53,r_208_60_109,0.95,4,113,109,42
24,r_18_64_188,r_106_12_189,r_177_57_61,r_18_64_188,0.43,0,188,188,42
19,r_216_173_51,r_131_186_180,seq152,r_216_173_51,1.0,0,51,51,42
25,r_106_12_189,r_18_64_188,r_165_70_103,r_165_70_103,0.77,86,189,103,42
64,r_194_103_113,seq89,seq119,r_194_103_113,0.99,0,113,113,42
37,r_134_161_11,r_137_222_35,seq185,r_134_161_11,1.0,0,11,11,42
50,r_43_84_161,r_93_202_79,r_123_195_15,r_93_202_79,0.76,-14,65,79,42
58,r_179_27_118,r_91_159_128,seq4,r_179_27_118,1.0,0,118,118,42
70,r_197_167_115,seq109,r_121_87_130,r_197_167_115,1.0,0,115,115,42
47,r_25_36_41,r_194_103_113,seq16,r_194_103_113,1.0,-67,46,113,42
65,r_75_76_114,r_116_92_168,r_62_38_192,r_75_76_114,0.98,0,114,114,42
137,seq97,r_47_163_177,seq199,r_47_163_177,0.83,-1,176,177,42
61,r_165_70_103,r_6_73_152,seq183,r_165_70_103,0.98,2,105,103,42
32,r_223_120_151,r_181_52_8,r_126_193_87,r_181_52_8,0.66,143,151,8,42
38,r_10_127_137,seq168,r_122_205_64,r_10_127_137,1.0,0,137,137,42
34,r_125_211_131,seq9,seq2,r_125_211_131,0.99,0,131,131,42
41,r_22_218_14,r_117_110_171,seq4,r_22_218_14,1.0,1,15,14,42
57,r_42_14_67,r_162_224_133,r_151_113_87,r_42_14_67,0.77,66,133,67,42
9,r_115_215_140,seq183,r_20_207_19,r_115_215_140,0.75,0,140,140,42
50,r_43_84_161,r_123_195_15,r_137_222_35,r_43_84_161,0.53,1,162,161,42
120,seq66,r_217_29_148,r_95_169_70,r_95_169_70,0.98,28,98,70,42
28,r_217_29_148,seq66,r_112_164_136,r_217_29_148,0.91,4,152,148,42
73,r_123_195_15,r_43_84_161,seq199,r_43_84_161,0.99,1,162,161,42
49,r_82_154_78,r_196_143_92,r_22_218_14,r_82_154_78,0.95,2,80,78,42
140,seq105,r_133_83_115,r_121_87_130,r_133_83_115,1.0,-48,67,115,42
56,r_131_186_180,seq50,r_188_56_99,r_188_56_99,0.7,82,181,99,42
44,r_213_124_165,seq160,r_78_206_60,r_213_124_165,0.81,0,165,165,42
23,r_59_108_160,seq33,r_137_222_35,r_59_108_160,0.95,0,160,160,42
17,r_65_138_139,r_20_207_19,r_122_205_64,r_20_207_19,0.99,120,139,19,42
108,seq176,r_13_132_163,r_184_7_112,r_184_7_112,1.0,14,126,112,42
29,r_137_222_35,seq147,seq100,r_137_222_35,0.95,5,40,35,42
35,r_212_101_73,r_184_7_112,r_196_143_92,r_196_143_92,1.0,-19,73,92,42
12,r_177_57_61,seq53,seq109,r_177_57_61,1.0,0,61,61,42
30,r_108_213_69,seq43,seq72,r_108_213_69,0.89,1,70,69,43
51,r_189_199_106,r_55_167_99,r_122_56_33,r_122_56_33,1.0,30,63,33,43
36,r_186_121_190,seq23,r_197_151_77,r_197_151_77,0.71,113,190,77,43
22,r_223_92_27,r_188_29_39,seq224,r_223_92_27,1.0,0,27,27,43
92,seq154,r_150_110_163,r_194_181_47,r_194_181_47,0.95,116,163,47,43
8,r_73_156_134,seq99,r_108_213_69,r_73_156_134,0.79,0,134,134,43
54,r_107_64_63,seq172,r_104_111_35,r_107_64_63,0.62,0,63,63,43
116,seq211,r_200_91_86,r_100_96_119,r_100_96_119,1.0,10,129,119,43
37,r_52_165_18,seq174,r_185_133_144,r_52_165_18,0.41,134,152,18,43
3,r_170_78_167,r_178_102_89,r_55_167_99,r_178_102_89,0.59,78,167,89,43
71,r_130_79_72,r_222_4_85,seq98,r_130_79_72,1.0,0,72,72,43
39,r_28_93_128,seq173,seq147,r_28_93_128,0.72,0,128,128,43
1,r_161_175_179,seq43,r_176_212_119,r_176_212_119,0.85,62,181,119,43
143,seq115,seq61,r_6_117_85,r_6_117_85,1.0,18,103,85,43
5,r_81_145_86,seq48,r_94_190_46,r_81_145_86,1.0,0,86,86,43
104,seq173,r_28_93_128,r_105_13_154,r_28_93_128,0.68,0,128,128,43
111,seq58,seq166,r_86_198_46,r_86_198_46,1.0,26,72,46,43
19,r_191_60_12,r_41_63_86,seq103,r_191_60_12,0.85,0,12,12,43
69,r_14_51_67,r_141_159_127,r_74_171_26,r_14_51_67,0.98,1,68,67,43
45,r_150_110_163,seq154,r_130_79_72,r_130_79_72,0.85,91,163,72,43
60,r_128_5_56,r_27_112_82,r_59_126_8,r_128_5_56,0.47,1,57,56,43
11,r_182_192_113,r_168_47_14,r_191_60_12,r_182_192_113,0.98,0,113,113,43
103,seq172,r_107_64_63,seq12,r_107_64_63,1.0,0,63,63,43
11,r_182_192_113,r_76_135_75,r_168_47_14,r_182_192_113,0.81,-90,23,113,43
67,r_140_90_165,seq160,r_100_96_119,r_140_90_165,0.83,0,165,165,43
89,seq23,r_186_121_190,r_170_78_167,r_170_78_167,1.0,23,190,167,43
3,r_170_78_167,r_21_49_171,r_178_102_89,r_178_102_89,0.74,-8,81,89,43
17,r_20_68_40,r_76_135_75,r_146_54_3,r_146_54_3,0.73,37,40,3,43
10,r_187_203_177,r_193_152_178,seq61,r_187_203_177,0.66,1,178,177,43
49,r_118_216_46,r_193_152_178,seq88,r_118_216_46,0.99,3,49,46,43
72,r_27_112_82,r_70_202_139,r_108_213_69,r_27_112_82,1.0,1,83,82,43
4,r_178_102_89,seq215,seq83,r_178_102_89,0.71,9,98,89,43
58,r_86_198_46,r_204_65_55,seq58,r_86_198_46,1.0,0,46,46,43
112,seq61,r_6_117_85,r_187_203_177,r_187_203_177,0.95,6,183,177,43
16,r_46_34_51,seq80,seq163,r_46_34_51,1.0,0,51,51,43
0,r_76_135_75,seq174,seq207,r_76_135_75,1.0,0,75,75,43
55,r_139_22_104,r_105_13_154,seq127,r_139_22_104,0.99,-51,53,104,43
20,r_100_96_119,seq61,seq211,r_100_96_119,1.0,0,119,119,43
15,r_197_151_77,seq26,seq218,r_197_151_77,1.0,1,78,77,43
48,r_177_9_75,r_69_183_121,r_14_51_67,r_14_51_67,0.84,14,81,67,43
25,r_204_65_55,r_18_153_190,seq116,r_204_65_55,1.0,1,56,55,43
6,r_144_11_93,r_28_93_128,seq217,r_144_11_93,0.97,0,93,93,43
62,r_141_159_127,r_24_62_191,seq12,r_141_159_127,0.94,1,128,127,43
104,seq173,r_105_13_154,seq143,r_105_13_154,0.97,-5,149,154,43
64,r_71_67_58,r_140_90_165,seq207,r_71_67_58,1.0,0,58,58,43
27,r_17_149_84,r_176_212_119,seq99,r_17_149_84,1.0,0,84,84,43
53,r_168_47_14,r_182_192_113,seq219,r_182_192_113,1.0,0,113,113,43
59,r_74_171_26,r_89_205_78,r_189_199_106,r_74_171_26,1.0,0,26,26,43
2,r_41_63_86,seq195,seq48,r_41_63_86,0.99,0,86,86,43
59,r_74_171_26,r_189_199_106,r_14_51_67,r_74_171_26,0.99,64,90,26,43
40,r_200_91_86,seq211,r_197_151_77,r_197_151_77,1.0,16,93,77,43
105,seq174,seq120,r_10_87_92,r_10_87_92,0.99,18,110,92,43
29,r_176_212_119,seq173,r_161_175_179,r_176_212_119,0.75,61,180,119,43
14,r_194_181_47,seq39,seq154,r_194_181_47,1.0,0,47,47,43
74,r_70_202_139,seq221,r_55_167_99,r_70_202_139,0.94,0,139,139,43
18,r_101_180_181,seq134,seq173,r_101_180_181,0.54,0,181,181,43
29,r_176_212_119,seq127,seq173,r_176_212_119,0.63,5,124,119,43
24,r_69_183_121,seq134,r_10_87_92,r_69_183_121,0.8,0,121,121,43
53,r_168_47_14,r_94_190_46,r_182_192_113,r_182_192_113,0.7,-99,14,113,43
43,r_104_111_35,seq221,r_97_158_140,r_97_158_140,1.0,6,146,140,43
51,r_189_199_106,r_122_56_33,seq26,r_189_199_106,1.0,0,106,106,43
70,r_89_205_78,r_25_45_43,r_157_82_129,r_89_205_78,0.54,87,165,78,43
70,r_89_205_78,seq207,r_25_45_43,r_89_205_78,1.0,0,78,78,43
65,r_24_62_191,r_141_159_127,r_30_7_10,r_141_159_127,0.98,-29,98,127,43
66,r_25_45_43,seq137,seq0,r_25_45_43,0.84,10,53,43,43
137,seq98,seq143,r_130_79_72,r_130_79_72,1.0,2,74,72,43
32,r_75_184_2,seq137,r_40_44_99,r_40_44_99,0.97,42,141,99,43
38,r_105_13_154,seq173,seq23,r_105_13_154,0.8,0,154,154,43
123,seq209,seq155,r_94_190_46,r_94_190_46,1.0,7,53,46,43
75,seq0,r_18_153_190,r_25_45_43,r_25_45_43,0.89,55,98,43,43
68,r_196_208_46,seq221,seq134,r_196_208_46,1.0,0,46,46,43
52,r_122_56_33,r_70_202_139,r_74_171_26,r_122_56_33,1.0,0,33,33,43
43,r_104_111_35,r_178_102_89,seq221,r_104_111_35,1.0,0,35,35,43
144,seq116,r_125_129_191,r_204_65_55,r_204_65_55,1.0,87,142,55,43
9,r_55_167_99,r_189_199_106,r_20_68_40,r_55_167_99,0.79,1,100,99,43
63,r_188_29_39,r_187_203_177,seq142,r_187_203_177,0.61,1,178,177,43
73,r_97_158_140,r_55_167_99,r_74_171_26,r_97_158_140,0.98,-83,57,140,43
28,r_10_87_92,seq15,seq174,r_10_87_92,0.46,2,94,92,43
73,r_97_158_140,r_74_171_26,r_104_111_35,r_97_158_140,1.0,0,140,140,43
102,seq43,r_161_175_179,seq215,r_161_175_179,0.84,2,181,179,43
56,r_21_49_171,seq32,r_46_34_51,r_46_34_51,0.91,120,171,51,43
7,r_6_117_85,r_69_183_121,r_222_4_85,r_69_183_121,0.59,-36,85,121,43
44,r_157_82_129,r_42_114_182,r_89_205_78,r_89_205_78,1.0,53,131,78,43
23,r_40_44_99,r_157_82_129,r_75_184_2,r_40_44_99,0.86,4,103,99,43
138,seq99,r_73_156_134,r_17_149_84,r_17_149_84,0.99,23,107,84,43
35,r_185_133_144,seq137,r_52_165_18,r_185_133_144,0.71,-2,142,144,43
46,r_94_190_46,seq166,seq209,r_94_190_46,1.0,0,46,46,43
128,seq215,r_178_102_89,seq43,r_178_102_89,0.97,14,103,89,43
51,r_108_61_156,seq121,r_69_182_133,r_69_182_133,1.0,33,166,133,44
45,r_120_164_44,r_112_152_81,seq160,r_120_164_44,1.0,-1,43,44,44
36,r_219_128_100,seq36,seq171,r_219_128_100,1.0,0,100,100,44
124,seq73,r_88_136_101,r_4_106_55,r_88_136_101,0.95,-59,42,101,44
14,r_88_136_101,r_53_125_163,seq104,r_88_136_101,0.99,0,101,101,44
69,r_206_119_174,r_107_114_78,r_57_45_37,r_57_45_37,0.91,-1,36,37,44
8,r_99_32_120,r_202_211_178,r_186_14_63,r_186_14_63,1.0,21,84,63,44
53,r_12_8_64,seq43,r_169_144_20,r_12_8_64,1.0,0,64,64,44
43,r_191_197_71,r_82_214_140,seq171,r_191_197_71,1.0,0,71,71,44
54,r_101_11_181,seq37,r_82_214_140,r_82_214_140,0.92,41,181,140,44
37,r_166_71_144,r_151_10_115,r_186_14_63,r_186_14_63,1.0,56,119,63,44
59,r_216_215_173,r_202_211_178,seq157,r_216_215_173,0.83,0,173,173,44
71,r_70_42_91,seq121,r_188_123_14,r_70_42_91,1.0,0,91,91,44
16,r_19_140_145,seq49,seq133,r_19_140_145,0.96,0,145,145,44
39,r_58_193_80,seq28,seq160,r_58_193_80,0.94,-3,77,80,44
1,r_92_17_139,r_38_115_139,seq180,r_92_17_139,0.98,0,139,139,44
97,seq30,r_137_75_133,r_2_213_71,r_137_75_133,1.0,-15,118,133,44
28,r_217_51_53,r_189_40_132,seq15,r_189_40_132,0.9,-81,51,132,44
5,r_137_75_133,seq30,seq150,r_137_75_133,0.81,0,133,133,44
132,seq87,seq177,r_63_100_53,r_63_100_53,1.0,2,55,53,44
13,r_161_48_13,r_31_79_191,seq134,r_161_48_13,1.0,0,13,13,44
30,r_67_6_77,r_127_16_47,seq138,r_127_16_47,0.6,-10,37,47,44
19,r_35_192_142,r_82_214_140,seq28,r_35_192_142,0.99,0,142,142,44
18,r_57_45_37,r_206_119_174,r_97_25_85,r_97_25_85,0.99,8,93,85,44
24,r_117_94_84,r_4_106_55,r_155_41_82,r_4_106_55,0.98,-13,42,55,44
103,seq37,r_101_11_181,r_89_118_21,r_89_118_21,0.97,160,181,21,44
41,r_151_10_115,r_166_71_144,r_58_193_80,r_151_10_115,0.67,4,119,115,44
67,r_131_18_73,seq134,r_188_123_14,r_131_18_73,0.72,0,73,73,44
67,r_131_18_73,r_188_123_14,r_38_115_139,r_38_115_139,1.0,20,159,139,44
3,r_112_152_81,r_135_93_168,seq27,r_112_152_81,1.0,0,81,81,44
42,r_63_100_53,r_202_211_178,seq87,r_63_100_53,1.0,1,54,53,44
48,r_188_123_14,r_137_75_133,seq179,r_188_123_14,1.0,1,15,14,44
26,r_109_201_141,seq104,seq171,r_109_201_141,0.99,0,141,141,44
2,r_224_162_42,r_55_223_50,seq210,r_55_223_50,0.95,-12,38,50,44
73,r_135_93_168,seq157,r_64_65_8,r_135_93_168,0.78,2,170,168,44
11,r_69_182_133,seq141,r_108_61_156,r_69_182_133,1.0,1,134,133,44
57,r_4_106_55,r_117_94_84,seq73,r_117_94_84,0.95,-42,42,84,44
68,r_203_195_13,seq27,r_82_214_140,r_203_195_13,0.76,3,16,13,44
15,r_175_129_64,seq121,seq138,r_175_129_64,1.0,0,64,64,44
66,r_55_223_50,seq121,seq9,r_55_223_50,1.0,0,50,50,44
46,r_148_143_59,seq3,seq122,r_148_143_59,1.0,-1,58,59,44
121,seq177,r_22_86_28,r_64_65_8,r_22_86_28,0.63,-11,17,28,44
62,r_2_213_71,r_109_201_141,seq60,r_109_201_141,1.0,-75,66,141,44
55,r_64_65_8,r_217_51_53,seq177,r_64_65_8,0.82,4,12,8,44
34,r_186_14_63,seq9,r_99_32_120,r_186_14_63,1.0,-4,59,63,44
49,r_22_86_28,seq179,seq52,r_22_86_28,1.0,0,28,28,44
38,r_169_144_20,r_89_118_21,r_107_114_78,r_169_144_20,1.0,0,20,20,44
58,r_107_114_78,r_206_119_174,r_169_144_20,r_169_144_20,1.0,1,21,20,44
69,r_206_119_174,r_57_45_37,r_64_65_8,r_206_119_174,0.52,1,175,174,44
147,seq121,r_55_223_50,r_149_163_96,r_55_223_50,0.96,-12,38,50,44
47,r_184_158_95,r_207_46_76,seq141,r_184_158_95,1.0,0,95,95,44
29,r_126_102_178,seq121,seq47,r_126_102_178,0.67,0,178,178,44
98,seq133,r_219_128_100,r_74_159_10,r_74_159_10,0.44,1,11,10,44
34,r_186_14_63,r_99_32_120,r_58_193_80,r_99_32_120,1.0,0,120,120,44
25,r_207_46_76,r_184_158_95,r_117_94_84,r_207_46_76,0.99,19,95,76,44
33,r_38_115_139,r_92_17_139,r_131_18_73,r_38_115_139,0.86,0,139,139,44
4,r_113_142_31,r_31_79_191,seq116,r_113_142_31,1.0,0,31,31,44
146,seq116,r_101_11_181,r_113_142_31,r_113_142_31,1.0,1,32,31,44
18,r_57_45_37,r_148_143_59,r_206_119_174,r_57_45_37,1.0,0,37,37,44
70,r_189_40_132,r_217_51_53,seq210,r_189_40_132,1.0,0,132,132,44
20,r_103_145_57,r_222_168_175,r_155_41_82,r_103_145_57,0.52,118,175,57,44
137,seq98,r_101_11_181,r_155_41_82,r_155_41_82,1.0,15,97,82,44
61,r_21_20_71,r_109_201_141,seq84,r_21_20_71,0.81,0,71,71,44
32,r_147_95_126,r_82_214_140,seq121,r_147_95_126,0.99,0,126,126,44
8,r_99_32_120,r_186_14_63,r_175_129_64,r_99_32_120,1.0,0,120,120,44
74,r_155_41_82,r_88_136_101,r_117_94_84,r_88_136_101,0.89,-43,58,101,44
30,r_67_6_77,seq138,r_161_48_13,r_67_6_77,0.97,0,77,77,44
37,r_166_71_144,r_186_14_63,r_147_95_126,r_166_71_144,0.48,0,144,144,44
60,r_194_199_102,seq171,r_217_51_53,r_194_199_102,1.0,0,102,102,44
7,r_89_118_21,r_194_199_102,r_190_83_3,r_89_118_21,1.0,0,21,21,44
17,r_149_163_96,seq33,seq121,r_149_163_96,0.57,4,100,96,44
58,r_107_114_78,r_169_144_20,r_172_68_63,r_172_68_63,0.89,15,78,63,44
21,r_127_16_47,r_67_6_77,r_169_144_20,r_127_16_47,1.0,-1,46,47,44
38,r_169_144_20,r_107_114_78,r_12_8_64,r_169_144_20,0.53,58,78,20,44
98,seq133,r_74_159_10,r_19_140_145,r_19_140_145,1.0,13,158,145,44
22,r_53_125_163,seq90,r_35_192_142,r_35_192_142,1.0,22,164,142,44
56,r_97_25_85,r_109_201_141,r_57_45_37,r_97_25_85,0.91,0,85,85,44
44,r_218_156_189,seq49,r_89_118_21,r_89_118_21,0.56,168,189,21,44
131,seq84,seq24,r_21_20_71,r_21_20_71,1.0,0,71,71,44
23,r_222_168_175,r_207_46_76,r_103_145_57,r_103_145_57,0.98,5,62,57,44
20,r_103_145_57,r_112_152_81,r_222_168_175,r_103_145_57,0.91,1,58,57,44
10,r_154_181_27,r_92_17_139,seq146,r_154_181_27,1.0,0,27,27,44
35,r_85_59_88,r_202_211_178,seq139,r_85_59_88,1.0,0,88,88,44
12,r_72_165_178,r_200_91_195,r_88_136_101,r_88_136_101,1.0,77,178,101,44
23,r_222_168_175,r_103_145_57,r_38_115_139,r_222_168_175,0.5,0,175,175,44
72,r_74_159_10,r_172_68_63,seq133,r_74_159_10,0.9,0,10,10,44
30,r_0_45_145,r_71_95_179,r_207_146_16,r_0_45_145,1.0,0,145,145,45
44,r_32_142_116,seq183,r_109_126_99,r_32_142_116,0.69,0,116,116,45
51,r_93_164_148,seq209,r_116_159_9,r_93_164_148,0.8,0,148,148,45
92,seq150,r_18_224_127,r_73_199_74,r_18_224_127,0.75,-36,91,127,45
14,r_86_10_186,seq63,seq155,r_86_10_186,0.5,0,186,186,45
8,r_18_224_127,seq150,seq213,r_18_224_127,0.94,1,128,127,45
58,r_148_38_179,r_154_185_64,seq133,r_154_185_64,0.63,116,180,64,45
125,seq141,r_21_113_182,seq133,r_21_113_182,0.87,-28,154,182,45
54,r_80_68_134,seq209,r_116_159_9,r_80_68_134,0.93,0,134,134,45
37,r_87_27_153,r_8_5_78,r_130_2_6,r_87_27_153,0.54,0,153,153,45
59,r_154_185_64,seq219,seq208,r_154_185_64,1.0,0,64,64,45
19,r_26_195_170,r_135_96_31,r_221_212_53,r_26_195_170,0.71,1,171,170,45
23,r_36_52_32,r_32_142_116,r_157_54_25,r_36_52_32,1.0,0,32,32,45
55,r_174_99_137,r_117_15_7,r_136_153_99,r_174_99_137,0.66,1,138,137,45
71,r_71_95_179,seq145,r_36_52_32,r_36_52_32,0.71,151,183,32,45
16,r_182_127_8,r_79_64_86,seq123,r_79_64_86,1.0,0,86,86,45
21,r_211_205_82,r_18_224_127,r_46_35_80,r_211_205_82,1.0,0,82,82,45
39,r_132_144_128,r_156_88_193,seq197,r_132_144_128,0.8,0,128,128,45
1,r_17_143_160,seq184,r_47_19_14,r_17_143_160,0.54,0,160,160,45
46,r_21_113_182,seq141,r_97_23_32,r_97_23_32,0.62,151,183,32,45
42,r_72_82_75,r_119_120_122,r_186_6_14,r_72_82_75,0.85,-3,72,75,45
63,r_47_19_14,seq203,seq192,r_47_19_14,0.63,1,15,14,45
50,r_222_74_34,r_114_59_64,seq51,r_222_74_34,0.64,0,34,34,45
69,r_67_200_106,r_49_24_179,r_116_159_9,r_67_200_106,0.93,0,106,106,45
45,r_49_24_179,seq25,r_7_30_175,r_49_24_179,0.32,4,183,179,45
24,r_97_23_32,seq28,r_21_113_182,r_97_23_32,0.34,151,183,32,45
73,r_160_98_46,seq13,seq187,r_160_98_46,1.0,0,46,46,45
20,r_91_223_42,seq41,seq149,r_91_223_42,1.0,1,43,42,45
66,r_114_59_64,r_148_38_179,r_207_146_16,r_114_59_64,1.0,0,64,64,45
31,r_14_170_98,r_136_153_99,seq41,r_14_170_98,0.88,0,98,98,45
129,seq83,r_7_30_175,r_118_11_99,r_118_11_99,0.99,61,160,99,45
41,r_46_35_80,seq89,r_211_205_82,r_46_35_80,1.0,2,82,80,45
67,r_73_199_74,seq203,seq150,r_73_199_74,0.71,-7,67,74,45
64,r_221_212_53,r_122_139_183,seq111,r_221_212_53,0.98,4,57,53,45
89,seq179,r_169_151_165,r_129_172_165,r_169_151_165,0.53,1,166,165,45
36,r_207_146_16,seq76,seq53,r_207_146_16,0.97,0,16,16,45
72,r_201_190_122,r_7_30_175,seq123,r_201_190_122,0.8,4,126,122,45
0,r_84_167_152,seq183,r_173_81_39,r_84_167_152,0.5,0,152,152,45
11,r_79_64_86,r_182_127_8,seq22,r_79_64_86,1.0,0,86,86,45
5,r_186_6_14,r_222_74_34,seq101,r_186_6_14,0.98,0,14,14,45
13,r_70_40_77,r_21_113_182,r_91_223_42,r_70_40_77,1.0,5,82,77,45
15,r_181_105_166,r_104_44_198,r_14_170_98,r_181_105_166,0.57,0,166,166,45
48,r_48_138_149,r_7_30_175,seq85,r_48_138_149,0.52,0,149,149,45
57,r_196_108_83,r_14_170_98,seq31,r_196_108_83,1.0,0,83,83,45
62,r_119_120_122,seq123,seq133,r_119_120_122,0.98,1,123,122,45
74,r_218_12_14,r_73_199_74,seq203,r_73_199_74,0.84,49,123,74,45
136,seq219,seq147,r_136_153_99,r_136_153_99,1.0,4,103,99,45
28,r_161_115_37,seq22,seq50,r_161_115_37,0.97,1,38,37,45
19,r_26_195_170,seq145,r_135_96_31,r_135_96_31,1.0,22,53,31,45
27,r_140_62_136,r_156_88_193,seq111,r_140_62_136,0.82,0,136,136,45
136,seq219,r_154_185_64,seq147,r_154_185_64,0.97,1,65,64,45
44,r_32_142_116,r_36_52_32,seq183,r_36_52_32,0.97,0,32,32,45
2,r_125_178_145,r_122_139_183,seq58,r_125_178_145,0.61,0,145,145,45
18,r_180_103_149,seq137,r_116_159_9,r_180_103_149,0.71,0,149,149,45
74,r_218_12_14,seq131,r_73_199_74,r_218_12_14,1.0,0,14,14,45
127,seq184,r_17_143_160,seq141,r_17_143_160,0.72,0,160,160,45
85,seq149,seq152,r_91_223_42,r_91_223_42,1.0,9,51,42,45
58,r_148_38_179,r_114_59_64,r_154_185_64,r_148_38_179,1.0,-115,64,179,45
70,r_92_16_161,seq58,seq101,r_92_16_161,0.58,0,161,161,45
56,r_122_139_183,seq203,r_72_82_75,r_122_139_183,0.87,3,186,183,45
108,seq53,seq131,r_207_146_16,r_207_146_16,1.0,23,39,16,45
43,r_162_194_54,r_156_88_193,r_100_29_39,r_162_194_54,1.0,3,57,54,45
65,r_117_15_7,r_174_99_137,seq58,r_174_99_137,0.97,1,138,137,45
40,r_220_165_39,r_156_88_193,seq209,r_220_165_39,0.98,2,41,39,45
97,seq166,seq106,r_1_107_32,r_1_107_32,1.0,17,49,32,45
52,r_169_151_165,seq179,r_204_4_121,r_204_4_121,0.65,44,165,121,45
34,r_60_202_170,r_86_10_186,r_36_52_32,r_60_202_170,0.31,4,174,170,45
3,r_1_107_32,r_104_44_198,seq166,r_1_107_32,0.99,0,32,32,45
60,r_43_78_80,r_46_35_80,r_162_194_54,r_43_78_80,0.99,2,82,80,45
47,r_217_55_59,seq208,seq141,r_217_55_59,1.0,0,59,59,45
107,seq51,r_86_10_186,r_222_74_34,r_222_74_34,0.71,0,34,34,45
61,r_135_96_31,r_86_10_186,seq69,r_135_96_31,0.99,0,31,31,45
26,r_157_54_25,seq101,r_36_52_32,r_157_54_25,0.96,8,33,25,45
29,r_173_81_39,r_156_88_193,seq63,r_173_81_39,0.99,3,42,39,45
22,r_109_126_99,seq28,r_135_96_31,r_109_126_99,1.0,0,99,99,45
24,r_97_23_32,seq158,seq28,r_97_23_32,0.98,0,32,32,45
49,r_34_37_91,r_169_151_165,seq42,r_34_37_91,0.98,1,92,91,45
56,r_122_139_183,r_125_178_145,seq203,r_125_178_145,1.0,0,145,145,45
7,r_118_11_99,seq184,seq83,r_118_11_99,0.98,7,106,99,45
12,r_136_153_99,seq42,seq219,r_136_153_99,1.0,0,99,99,45
93,seq33,r_54_224_186,r_41_13_116,r_41_13_116,1.0,58,174,116,46
36,r_192_154_182,r_1_127_158,r_66_216_96,r_66_216_96,0.91,65,161,96,46
14,r_175_59_82,r_193_89_87,r_61_209_39,r_193_89_87,0.62,-5,82,87,46
8,r_77_161_83,r_160_60_17,seq200,r_77_161_83,1.0,0,83,83,46
53,r_17_104_134,seq162,r_40_43_121,r_17_104_134,0.96,0,134,134,46
58,r_62_133_15,r_166_18_168,r_44_70_55,r_62_133_15,0.75,129,144,15,46
43,r_217_79_146,r_85_221_179,r_50_74_57,r_217_79_146,0.97,0,146,146,46
54,r_44_70_55,r_81_194_197,r_62_133_15,r_44_70_55,0.51,13,68,55,46
37,r_134_155_120,seq170,r_113_96_20,r_134_155_120,0.99,0,120,120,46
15,r_52_121_32,r_1_127_158,r_20_47_35,r_52_121_32,1.0,2,34,32,46
69,r_107_56_33,r_28_112_118,r_50_74_57,r_107_56_33,0.53,0,33,33,46
55,r_28_112_118,r_40_43_121,seq119,r_28_112_118,1.0,0,118,118,46
30,r_61_209_39,r_117_10_90,r_218_29_33,r_61_209_39,1.0,0,39,39,46
55,r_28_112_118,r_72_190_82,r_40_43_121,r_72_190_82,1.0,0,82,82,46
71,r_68_102_79,seq186,seq58,r_68_102_79,0.81,0,79,79,46
49,r_223_126_55,r_87_198_1,seq188,r_223_126_55,1.0,0,55,55,46
21,r_24_137_151,seq167,seq4,r_24_137_151,0.72,1,152,151,46
97,seq167,r_24_137_151,seq170,r_24_137_151,1.0,1,152,151,46
42,r_93_82_70,r_175_59_82,r_61_209_39,r_61_209_39,1.0,31,70,39,46
80,seq141,r_212_213_103,r_22_172_98,r_212_213_103,0.6,-5,98,103,46
88,seq132,r_107_56_33,r_220_180_125,r_220_180_125,0.85,0,125,125,46
45,r_66_216_96,r_23_202_164,seq135,r_66_216_96,0.99,1,97,96,46
19,r_30_145_149,seq125,seq200,r_30_145_149,0.93,1,150,149,46
66,r_117_10_90,seq158,seq19,r_117_10_90,1.0,1,91,90,46
31,r_53_201_103,r_87_198_1,r_32_171_18,r_53_201_103,0.99,1,104,103,46
67,r_219_118_183,seq204,r_114_150_51,r_114_150_51,0.56,132,183,51,46
115,seq69,r_114_150_51,r_134_155_120,r_134_155_120,0.78,-3,117,120,46
72,r_21_173_91,seq162,seq76,r_21_173_91,0.83,4,95,91,46
4,r_64_36_114,r_206_84_105,r_9_48_77,r_64_36_114,0.98,0,114,114,46
0,r_105_203_83,seq119,seq181,r_105_203_83,1.0,0,83,83,46
73,r_42_189_129,seq170,r_114_150_51,r_42_189_129,1.0,3,132,129,46
11,r_220_180_125,r_166_18_168,seq132,r_220_180_125,0.78,8,133,125,46
13,r_147_165_109,r_160_60_17,seq65,r_147_165_109,0.81,-3,106,109,46
48,r_206_84_105,r_64_36_114,r_3_94_7,r_64_36_114,0.88,-9,105,114,46
6,r_22_172_98,seq88,r_129_149_29,r_22_172_98,0.93,3,101,98,46
17,r_6_168_59,r_80_174_94,seq170,r_6_168_59,1.0,0,59,59,46
7,r_99_123_39,r_53_201_103,r_61_209_39,r_99_123_39,0.91,0,39,39,46
2,r_40_43_121,seq164,seq109,r_40_43_121,0.98,1,122,121,46
40,r_41_13_116,r_73_31_178,seq33,r_41_13_116,0.99,0,116,116,46
88,seq132,r_147_165_109,r_107_56_33,r_107_56_33,0.95,0,33,33,46
74,r_113_96_20,r_147_165_109,r_152_39_57,r_152_39_57,1.0,33,90,57,46
145,seq119,r_23_202_164,r_28_112_118,r_28_112_118,1.0,3,121,118,46
24,r_54_224_186,seq33,r_52_121_32,r_52_121_32,0.62,154,186,32,46
64,r_37_14_108,r_166_18_168,r_68_102_79,r_37_14_108,0.84,6,114,108,46
47,r_215_78_29,seq88,seq33,r_215_78_29,0.91,2,31,29,46
50,r_156_130_72,seq153,seq95,r_156_130_72,1.0,0,72,72,46
70,r_212_213_103,seq141,seq204,r_212_213_103,1.0,0,103,103,46
65,r_72_190_82,r_28_112_118,r_175_59_82,r_72_190_82,1.0,0,82,82,46
3,r_114_150_51,seq76,seq162,r_114_150_51,0.88,3,54,51,46
38,r_34_51_148,seq148,r_64_36_114,r_34_51_148,0.63,1,149,148,46
34,r_85_221_179,seq12,r_64_36_114,r_85_221_179,0.55,1,180,179,46
59,r_50_74_57,r_140_115_66,r_107_56_33,r_50_74_57,0.95,0,57,57,46
60,r_166_18_168,r_37_14_108,r_44_70_55,r_44_70_55,0.77,43,98,55,46
33,r_32_171_18,r_175_59_82,seq176,r_32_171_18,0.7,0,18,18,46
32,r_129_149_29,r_61_209_39,seq164,r_129_149_29,1.0,0,29,29,46
9,r_140_115_66,seq67,seq158,r_140_115_66,0.74,32,98,66,46
61,r_152_39_57,r_28_112_118,r_113_96_20,r_152_39_57,0.98,0,57,57,46
145,seq119,r_105_203_83,r_23_202_164,r_105_203_83,1.0,0,83,83,46
22,r_57_179_121,seq181,seq65,r_57_179_121,0.93,0,121,121,46
28,r_35_138_151,seq122,r_40_43_121,r_35_138_151,0.87,0,151,151,46
91,seq158,r_117_10_90,r_140_115_66,r_117_10_90,0.98,1,91,90,46
149,seq125,r_30_145_149,seq157,r_30_145_149,0.9,2,151,149,46
56,r_193_89_87,seq63,r_160_60_17,r_193_89_87,0.91,3,90,87,46
23,r_46_2_184,seq200,r_134_155_120,r_134_155_120,0.64,64,184,120,46
39,r_218_29_33,r_28_112_118,seq12,r_218_29_33,1.0,0,33,33,46
58,r_62_133_15,r_40_43_121,r_166_18_168,r_62_133_15,0.92,0,15,15,46
60,r_166_18_168,r_44_70_55,r_38_8_7,r_44_70_55,0.51,115,170,55,46
35,r_9_48_77,seq153,seq177,r_9_48_77,0.73,0,77,77,46
30,r_10_41_186,r_187_113_103,r_104_62_62,r_10_41_186,0.35,0,186,186,47
36,r_115_72_155,r_122_205_94,r_204_101_46,r_115_72_155,1.0,-85,70,155,47
122,seq200,seq218,r_145_105_78,r_145_105_78,1.0,0,78,78,47
25,r_83_213_18,r_178_207_174,seq170,r_83_213_18,1.0,0,18,18,47
14,r_143_118_67,seq128,seq85,r_143_118_67,0.99,0,67,67,47
43,r_159_194_184,seq54,r_111_139_16,r_159_194_184,0.43,0,184,184,47
18,r_71_32_32,r_173_51_37,r_203_179_3,r_71_32_32,1.0,0,32,32,47
59,r_168_175_118,r_95_7_127,seq16,r_168_175_118,1.0,0,118,118,47
71,r_13_24_154,r_46_169_198,seq29,r_13_24_154,0.63,2,156,154,47
27,r_145_105_78,seq200,r_64_58_85,r_64_58_85,0.86,15,100,85,47
16,r_53_212_123,r_97_98_178,seq25,r_53_212_123,0.98,0,123,123,47
21,r_206_87_87,seq221,seq85,r_206_87_87,1.0,0,87,87,47
39,r_96_68_118,r_3_110_187,r_126_184_109,r_126_184_109,0.98,80,189,109,47
1,r_133_166_132,r_46_169_198,r_187_113_103,r_133_166_132,0.35,1,133,132,47
5,r_104_62_62,seq201,r_71_32_32,r_104_62_62,1.0,0,62,62,47
53,r_91_196_13,seq218,seq80,r_91_196_13,0.99,0,13,13,47
69,r_174_35_157,seq12,r_187_113_103,r_174_35_157,0.92,1,158,157,47
45,r_216_70_129,seq136,seq37,r_216_70_129,0.99,0,129,129,47
15,r_111_139_16,seq108,r_91_196_13,r_91_196_13,0.9,3,16,13,47
70,r_204_101_46,seq34,seq65,r_204_101_46,1.0,0,46,46,47
19,r_84_61_112,seq0,r_173_51_37,r_84_61_112,0.72,2,114,112,47
4,r_224_142_46,r_64_58_85,seq43,r_224_142_46,1.0,0,46,46,47
60,r_173_51_37,r_71_32_32,seq90,r_71_32_32,0.68,-1,31,32,47
66,r_49_132_167,r_171_125_7,r_55_183_154,r_55_183_154,0.99,16,170,154,47
41,r_3_110_187,r_96_68_118,r_147_217_131,r_147_217_131,0.99,58,189,131,47
10,r_156_5_92,seq170,seq152,r_156_5_92,1.0,0,92,92,47
26,r_100_138_70,r_96_68_118,seq165,r_100_138_70,0.96,0,70,70,47
139,seq106,r_146_56_102,seq155,r_146_56_102,0.81,3,105,102,47
74,r_161_28_50,seq37,r_71_32_32,r_161_28_50,0.75,1,51,50,47
78,seq214,r_162_124_131,seq52,r_162_124_131,0.96,0,131,131,47
0,r_8_130_118,r_97_98_178,r_79_116_68,r_8_130_118,1.0,0,118,118,47
63,r_134_149_115,r_95_7_127,seq188,r_134_149_115,0.56,8,123,115,47
114,seq221,r_206_87_87,seq136,r_206_87_87,1.0,0,87,87,47
73,r_180_50_140,seq152,r_146_56_102,r_180_50_140,0.73,0,140,140,47
20,r_178_207_174,seq192,r_111_139_16,r_111_139_16,0.7,158,174,16,47
57,r_191_151_138,seq0,seq220,r_191_151_138,0.44,1,139,138,47
6,r_185_141_92,seq135,seq170,r_185_141_92,0.83,2,94,92,47
11,r_158_190_21,seq153,seq140,r_158_190_21,1.0,0,21,21,47
65,r_122_205_94,r_96_68_118,r_126_184_109,r_126_184_109,1.0,4,113,109,47
76,seq128,r_143_118_67,seq165,r_143_118_67,0.93,-13,54,67,47
36,r_115_72_155,r_204_101_46,seq210,r_115_72_155,0.67,0,155,155,47
134,seq93,r_78_208_140,seq221,r_78_208_140,1.0,-8,132,140,47
27,r_145_105_78,seq92,seq200,r_145_105_78,0.89,0,78,78,47
148,seq218,seq165,r_162_124_131,r_162_124_131,0.91,7,138,131,47
72,r_182_22_16,r_121_215_11,seq152,r_182_22_16,0.94,0,16,16,47
61,r_197_18_11,r_206_87_87,seq9,r_197_18_11,0.94,0,11,11,47
2,r_119_131_173,seq210,r_133_166_132,r_119_131_173,0.58,0,173,173,47
29,r_160_2_150,seq34,r_71_32_32,r_160_2_150,0.68,0,150,150,47
24,r_64_58_85,r_89_172_155,r_145_105_78,r_89_172_155,0.52,-70,85,155,47
33,r_1_60_134,seq9,seq165,r_1_60_134,0.95,0,134,134,47
127,seq210,r_119_131_173,r_115_72_155,r_115_72_155,0.6,18,173,155,47
50,r_148_63_145,seq170,seq154,r_148_63_145,0.65,1,146,145,47
58,r_55_183_154,r_3_110_187,seq155,r_55_183_154,0.8,0,154,154,47
65,r_122_205_94,r_115_72_155,r_96_68_118,r_115_72_155,0.67,-61,94,155,47
37,r_114_82_54,r_178_207_174,seq19,r_114_82_54,0.99,0,54,54,47
67,r_36_112_38,r_94_198_86,r_11_186_128,r_36_112_38,1.0,0,38,38,47
42,r_48_129_28,seq92,seq120,r_48_129_28,0.99,-5,23,28,47
32,r_219_222_127,r_174_35_157,seq202,r_219_222_127,1.0,0,127,127,47
52,r_97_98_178,seq137,r_216_70_129,r_97_98_178,0.43,0,178,178,47
47,r_23_66_27,r_133_166_132,seq38,r_23_66_27,1.0,0,27,27,47
34,r_147_217_131,seq144,seq136,r_147_217_131,1.0,0,131,131,47
105,seq43,seq163,r_224_142_46,r_224_142_46,1.0,0,46,46,47
38,r_77_15_23,r_206_87_87,seq220,r_77_15_23,1.0,0,23,23,47
17,r_203_179_3,r_219_222_127,r_104_62_62,r_104_62_62,0.57,65,127,62,47
133,seq92,r_145_105_78,seq210,r_145_105_78,1.0,0,78,78,47
22,r_14_181_101,seq86,r_158_190_21,r_14_181_101,1.0,0,101,101,47
28,r_17_103_139,seq47,seq188,r_17_103_139,0.77,0,139,139,47
135,seq165,seq128,r_1_60_134,r_1_60_134,0.98,4,138,134,47
49,r_146_56_102,seq106,seq19,r_146_56_102,1.0,0,102,102,47
56,r_209_76_170,seq69,r_121_215_11,r_209_76_170,0.29,7,177,170,47
7,r_94_198_86,r_49_132_167,seq9,r_94_198_86,0.59,-5,81,86,47
44,r_78_208_140,seq93,r_150_67_1,r_78_208_140,0.8,0,140,140,47
118,seq65,seq165,r_204_101_46,r_204_101_46,1.0,42,88,46,47
23,r_95_7_127,seq140,r_23_66_27,r_95_7_127,0.71,0,127,127,47
82,seq12,r_174_35_157,r_104_62_62,r_104_62_62,1.0,95,157,62,47
60,r_173_51_37,seq90,r_84_61_112,r_84_61_112,1.0,19,131,112,47
51,r_6_42_38,r_95_7_127,seq86,r_6_42_38,1.0,0,38,38,47
51,r_94_192_67,r_76_132_141,seq88,r_94_192_67,1.0,-1,66,67,48
122,seq203,r_164_91_70,seq8,r_164_91_70,1.0,-2,68,70,48
58,r_97_26_51,r_110_191_147,r_215_119_53,r_97_26_51,1.0,0,51,51,48
14,r_76_132_141,r_94_192_67,r_134_95_64,r_76_132_141,0.83,-77,64,141,48
60,r_120_177_13,r_198_14_146,r_194_180_191,r_120_177_13,0.93,0,13,13,48
53,r_21_175_110,r_76_132_141,r_155_15_170,r_21_175_110,0.49,-35,75,110,48
43,r_67_24_63,seq42,seq54,r_67_24_63,1.0,-3,60,63,48
62,r_72_193_19,r_80_157_138,seq197,r_72_193_19,1.0,1,20,19,48
37,r_10_214_123,r_51_143_102,seq139,r_51_143_102,0.88,-26,76,102,48
55,r_165_147_72,r_208_199_121,r_105_40_73,r_165_147_72,1.0,0,72,72,48
16,r_181_158_93,r_215_119_53,seq17,r_181_158_93,0.98,1,94,93,48
21,r_164_91_70,seq203,r_215_119_53,r_164_91_70,1.0,0,70,70,48
39,r_61_92_81,seq173,seq139,r_61_92_81,1.0,1,82,81,48
143,seq116,r_110_191_147,r_36_65_110,r_36_65_110,0.97,4,114,110,48
46,r_126_222_88,seq131,seq121,r_126_222_88,0.94,0,88,88,48
42,r_122_83_78,r_44_43_112,seq217,r_122_83_78,0.53,-2,76,78,48
22,r_93_100_24,r_195_213_88,seq63,r_93_100_24,0.99,0,24,24,48
57,r_182_201_185,r_11_163_124,r_21_175_110,r_182_201_185,0.91,0,185,185,48
80,seq138,r_105_40_73,seq127,r_105_40_73,0.72,12,85,73,48
5,r_56_188_43,r_194_180_191,seq131,r_56_188_43,1.0,0,43,43,48
69,r_134_95_64,r_111_31_174,seq28,r_134_95_64,1.0,0,64,64,48
45,r_38_189_129,seq50,r_23_41_135,r_23_41_135,0.75,1,136,135,48
30,r_186_46_155,r_36_65_110,seq8,r_36_65_110,1.0,-66,44,110,48
137,seq101,seq52,r_178_57_47,r_178_57_47,1.0,0,47,47,48
37,r_10_214_123,seq139,r_105_40_73,r_10_214_123,1.0,0,123,123,48
27,r_154_53_157,seq146,r_7_29_115,r_154_53_157,0.94,0,157,157,48
25,r_178_57_47,seq37,seq101,r_178_57_47,1.0,0,47,47,48
66,r_12_115_124,r_154_53_157,r_96_102_21,r_12_115_124,0.88,0,124,124,48
35,r_123_68_58,r_198_14_146,r_120_177_13,r_123_68_58,1.0,0,58,58,48
31,r_23_41_135,r_167_32_188,r_38_189_129,r_23_41_135,0.85,0,135,135,48
15,r_64_196_59,r_171_174_130,seq221,r_64_196_59,0.99,0,59,59,48
67,r_55_141_129,seq54,r_94_192_67,r_55_141_129,0.91,1,130,129,48
23,r_59_35_26,seq8,seq54,r_59_35_26,0.84,0,26,26,48
3,r_155_15_170,seq173,r_7_29_115,r_7_29_115,1.0,58,173,115,48
90,seq151,r_153_150_77,r_198_14_146,r_153_150_77,1.0,-1,76,77,48
26,r_171_174_130,seq197,seq142,r_171_174_130,0.99,0,130,130,48
72,r_167_32_188,seq135,r_36_65_110,r_36_65_110,0.65,79,189,110,48
14,r_76_132_141,r_134_95_64,r_72_193_19,r_76_132_141,0.83,0,141,141,48
4,r_34_60_93,seq73,seq133,r_34_60_93,1.0,-1,92,93,48
0,r_184_216_128,seq108,seq86,r_184_216_128,1.0,0,128,128,48
63,r_44_43_112,seq30,seq137,r_44_43_112,0.99,1,113,112,48
73,r_47_18_156,r_182_201_185,seq206,r_182_201_185,0.68,-25,160,185,48
11,r_11_163_124,seq25,seq176,r_11_163_124,0.87,0,124,124,48
20,r_99_200_148,r_182_201_185,seq124,r_99_200_148,0.47,11,159,148,48
48,r_113_204_98,r_130_218_99,seq25,r_113_204_98,1.0,0,98,98,48
57,r_182_201_185,r_47_18_156,r_11_163_124,r_11_163_124,1.0,36,160,124,48
106,seq176,r_182_201_185,r_11_163_124,r_11_163_124,1.0,35,159,124,48
6,r_79_125_119,r_182_201_185,seq139,r_79_125_119,1.0,1,120,119,48
53,r_21_175_110,r_155_15_170,seq159,r_21_175_110,0.93,0,110,110,48
56,r_215_119_53,r_181_158_93,seq135,r_181_158_93,0.96,-57,36,93,48
90,seq151,r_198_14_146,r_51_143_102,r_198_14_146,0.99,-32,114,146,48
33,r_78_148_30,seq66,seq30,r_78_148_30,1.0,1,31,30,48
27,r_154_53_157,r_130_218_99,seq146,r_130_218_99,1.0,-25,74,99,48
30,r_186_46_155,seq8,r_96_102_21,r_96_102_21,0.43,136,157,21,48
116,seq63,r_34_60_93,r_93_100_24,r_93_100_24,0.85,0,24,24,48
54,r_90_162_41,r_33_85_83,r_107_0_78,r_90_162_41,0.99,44,85,41,48
2,r_51_143_102,r_10_214_123,seq151,r_51_143_102,0.76,0,102,102,48
47,r_77_129_110,seq207,r_130_218_99,r_77_129_110,0.91,0,110,110,48
54,r_90_162_41,r_55_141_129,r_33_85_83,r_90_162_41,0.98,0,41,41,48
40,r_9_172_105,seq146,r_145_170_93,r_9_172_105,1.0,0,105,105,48
74,r_179_103_170,seq28,r_12_115_124,r_12_115_124,0.58,47,171,124,48
18,r_7_29_115,seq159,seq16,r_7_29_115,0.52,1,116,115,48
29,r_111_31_174,seq17,r_11_163_124,r_11_163_124,1.0,54,178,124,48
24,r_130_218_99,r_154_53_157,r_195_213_88,r_130_218_99,1.0,0,99,99,48
64,r_109_211_184,seq206,r_33_85_83,r_33_85_83,0.96,101,184,83,48
70,r_208_199_121,r_194_180_191,r_107_0_78,r_194_180_191,1.0,-70,121,191,48
65,r_110_191_147,seq124,seq183,r_110_191_147,0.83,3,150,147,48
19,r_210_128_35,r_110_191_147,r_153_150_77,r_153_150_77,0.55,12,89,77,48
68,r_87_114_93,r_215_119_53,r_94_192_67,r_215_119_53,1.0,41,94,53,48
1,r_4_202_56,seq58,seq25,r_4_202_56,1.0,0,56,56,48
130,seq217,r_155_15_170,r_122_83_78,r_122_83_78,0.76,-2,76,78,48
32,r_36_65_110,r_186_46_155,seq116,r_36_65_110,1.0,0,110,110,48
38,r_107_0_78,seq149,r_90_162_41,r_107_0_78,1.0,0,78,78,48
36,r_96_102_21,seq116,seq74,r_96_102_21,0.99,0,21,21,48
49,r_194_180_191,r_56_188_43,r_120_177_13,r_194_180_191,0.98,-167,24,191,48
34,r_153_150_77,seq151,r_210_128_35,r_153_150_77,0.99,0,77,77,48
19,r_210_128_35,r_33_85_83,r_110_191_147,r_210_128_35,0.98,0,35,35,48
17,r_33_85_83,r_90_162_41,seq73,r_33_85_83,1.0,2,85,83,48
17,r_33_85_83,r_210_128_35,r_90_162_41,r_33_85_83,1.0,-43,40,83,48
13,r_48_71_32,seq219,seq168,r_48_71_32,0.91,0,32,32,48
9,r_145_170_93,seq63,r_123_68_58,r_145_170_93,1.0,1,94,93,48
10,r_161_156_50,r_113_204_98,seq30,r_161_156_50,1.0,0,50,50,48
28,r_195_213_88,r_51_143_102,seq220,r_195_213_88,0.98,0,88,88,48
140,seq108,r_184_216_128,seq52,r_184_216_128,1.0,-44,84,128,48
7,r_140_89_141,seq187,seq149,r_140_89_141,0.57,1,142,141,48
44,r_80_157_138,r_110_191_147,r_145_170_93,r_110_191_147,0.75,-9,138,147,48
41,r_223_98_30,r_186_46_155,seq121,r_223_98_30,1.0,1,31,30,48
60,r_120_177_13,r_194_180_191,r_123_68_58,r_123_68_58,1.0,30,88,58,48
12,r_105_40_73,seq168,r_165_147_72,r_105_40_73,0.63,7,80,73,48
30,r_5_128_68,seq223,seq205,r_5_128_68,1.0,0,68,68,49
38,r_161_167_46,r_54_180_175,seq68,r_161_167_46,1.0,0,46,46,49
36,r_41_221_121,r_54_180_175,seq97,r_41_221_121,0.95,1,122,121,49
9,r_122_61_182,r_55_198_37,seq208,r_122_61_182,0.62,0,182,182,49
122,seq163,r_54_180_175,r_138_146_41,r_138_146_41,1.0,134,175,41,49
14,r_86_168_137,seq176,r_141_182_37,r_86_168_137,1.0,0,137,137,49
8,r_210_162_123,r_107_117_153,r_191_200_5,r_210_162_123,0.84,8,131,123,49
43,r_179_30_139,r_100_62_164,r_119_87_24,r_179_30_139,0.81,1,140,139,49
107,seq202,r_20_67_66,r_3_114_30,r_3_114_30,0.95,0,30,30,49
42,r_3_114_30,r_125_4_123,seq202,r_3_114_30,1.0,0,30,30,49
39,r_144_8_57,seq95,r_125_4_123,r_125_4_123,1.0,14,137,123,49
63,r_53_48_42,seq74,r_10_203_7,r_53_48_42,1.0,-1,41,42,49
21,r_195_16_24,seq202,seq36,r_195_16_24,0.78,-1,23,24,49
19,r_107_117_153,r_210_162_123,r_3_114_30,r_3_114_30,0.91,123,153,30,49
66,r_156_209_137,r_107_117_153,r_112_135_120,r_156_209_137,0.48,0,137,137,49
40,r_197_148_33,r_210_162_123,seq98,r_197_148_33,0.99,1,34,33,49
31,r_126_24_103,r_122_61_182,seq74,r_126_24_103,0.99,0,103,103,49
67,r_127_196_173,r_186_93_174,r_126_24_103,r_126_24_103,1.0,70,173,103,49
26,r_139_155_62,r_77_220_75,r_42_206_47,r_42_206_47,0.56,15,62,47,49
72,r_109_218_93,seq89,seq150,r_109_218_93,1.0,1,94,93,49
27,r_105_116_52,r_160_19_166,seq89,r_105_116_52,1.0,0,52,52,49
15,r_38_73_36,r_153_39_75,seq65,r_38_73_36,1.0,0,36,36,49
4,r_166_79_94,seq36,r_106_175_193,r_166_79_94,1.0,-1,93,94,49
78,seq7,r_122_61_182,r_57_84_172,r_57_84_172,0.49,-3,169,172,49
0,r_20_67_66,seq158,seq49,r_20_67_66,0.88,0,66,66,49
73,r_37_63_102,seq98,r_55_198_37,r_37_63_102,0.98,0,102,102,49
11,r_133_201_81,r_0_96_165,seq18,r_133_201_81,1.0,0,81,81,49
20,r_192_136_89,r_145_101_181,r_212_143_194,r_145_101_181,0.59,-83,98,181,49
13,r_58_88_136,r_184_131_75,seq173,r_184_131_75,1.0,0,75,75,49
48,r_43_83_115,seq173,r_190_64_61,r_43_83_115,1.0,0,115,115,49
13,r_58_88_136,seq173,seq215,r_58_88_136,1.0,0,136,136,49
62,r_125_4_123,seq140,r_144_8_57,r_125_4_123,0.99,0,123,123,49
52,r_184_131_75,r_107_117_153,seq214,r_107_117_153,0.88,0,153,153,49
55,r_100_62_164,r_179_30_139,r_69_177_62,r_69_177_62,0.84,-3,59,62,49
10,r_55_198_37,r_122_61_182,seq52,r_122_61_182,0.73,0,182,182,49
47,r_82_137_116,seq130,seq159,r_82_137_116,0.81,3,119,116,49
126,seq216,seq129,r_47_169_71,r_47_169_71,1.0,1,72,71,49
74,r_23_194_141,seq165,r_126_24_103,r_23_194_141,0.99,0,141,141,49
18,r_27_149_133,seq18,seq140,r_27_149_133,0.98,0,133,133,49
29,r_0_96_165,seq97,seq152,r_0_96_165,0.79,1,166,165,49
33,r_77_220_75,seq59,seq68,r_77_220_75,0.88,-2,73,75,49
16,r_211_92_48,r_160_19_166,seq113,r_211_92_48,1.0,0,48,48,49
64,r_90_66_86,seq202,r_81_56_195,r_90_66_86,0.71,4,90,86,49
9,r_122_61_182,r_125_4_123,r_55_198_37,r_122_61_182,0.85,-138,44,182,49
3,r_69_177_62,seq129,seq159,r_69_177_62,0.99,-3,59,62,49
58,r_54_180_175,seq163,r_25_71_145,r_54_180_175,0.75,0,175,175,49
70,r_164_188_141,seq49,seq68,r_164_188_141,0.36,0,141,141,49
65,r_145_101_181,seq124,r_5_128_68,r_5_128_68,1.0,113,181,68,49
32,r_160_19_166,seq85,r_20_67_66,r_160_19_166,0.67,1,167,166,49
52,r_184_131_75,r_58_88_136,r_107_117_153,r_184_131_75,1.0,0,75,75,49
111,seq65,r_57_84_172,r_38_73_36,r_38_73_36,1.0,1,37,36,49
51,r_138_146_41,r_20_67_66,seq163,r_138_146_41,1.0,0,41,41,49
46,r_26_44_49,r_106_175_193,seq118,r_26_44_49,0.99,1,50,49,49
132,seq95,r_144_8_57,r_112_135_120,r_112_135_120,0.84,17,137,120,49
5,r_141_182_37,seq2,seq94,r_141_182_37,0.84,1,38,37,49
113,seq70,r_81_56_195,r_119_87_24,r_119_87_24,1.0,-3,21,24,49
94,seq36,r_166_79_94,r_195_16_24,r_166_79_94,1.0,-28,66,94,49
22,r_32_193_120,seq163,r_105_116_52,r_105_116_52,1.0,69,121,52,49
28,r_42_206_47,r_20_67_66,r_139_155_62,r_42_206_47,0.95,17,64,47,49
102,seq49,r_164_188_141,seq170,r_164_188_141,0.53,0,141,141,49
149,seq213,r_102_151_189,r_122_61_182,r_122_61_182,0.81,7,189,182,49
10,r_55_198_37,r_6_1_129,r_122_61_182,r_55_198_37,1.0,0,37,37,49
56,r_34_224_84,r_45_181_191,seq157,r_34_224_84,0.95,-1,83,84,49
7,r_25_71_145,seq189,seq158,r_25_71_145,0.52,6,151,145,49
44,r_112_135_120,r_25_71_145,seq95,r_112_135_120,0.7,2,122,120,49
34,r_153_39_75,r_38_73_36,seq124,r_38_73_36,0.87,0,36,36,49
6,r_119_87_24,r_55_198_37,seq70,r_55_198_37,0.62,-14,23,37,49
101,seq176,r_86_168_137,seq163,r_86_168_137,0.99,0,137,137,49
35,r_47_169_71,r_102_151_189,seq216,r_47_169_71,0.99,0,71,71,49
12,r_102_151_189,seq213,r_141_182_37,r_102_151_189,0.39,0,189,189,49
55,r_100_62_164,r_69_177_62,r_25_71_145,r_100_62_164,0.56,1,165,164,49
50,r_7_14_49,seq26,seq25,r_7_14_49,0.99,2,51,49,50
44,r_190_179_42,r_42_1_184,r_101_31_95,r_190_179_42,0.51,103,145,42,50
36,r_87_203_174,r_43_129_83,r_209_10_41,r_87_203_174,0.96,-98,76,174,50
8,r_15_21_96,r_220_91_121,seq146,r_220_91_121,0.76,-15,106,121,50
53,r_224_9_65,seq198,seq94,r_224_9_65,1.0,0,65,65,50
43,r_220_91_121,seq127,seq64,r_220_91_121,1.0,2,123,121,50
125,seq82,seq114,r_105_154_69,r_105_154_69,0.99,13,82,69,50
59,r_45_174_64,seq163,r_134_126_11,r_45_174_64,1.0,0,64,64,50
10,r_217_3_120,r_61_121_74,r_199_206_10,r_217_3_120,0.8,-110,10,120,50
39,r_51_77_65,seq161,r_218_142_34,r_51_77_65,0.82,0,65,65,50
1,r_88_100_38,r_119_112_150,r_90_98_39,r_88_100_38,0.72,112,150,38,50
0,r_74_200_77,r_33_70_8,seq29,r_74_200_77,0.33,30,107,77,50
46,r_162_63_91,r_101_31_95,seq104,r_162_63_91,1.0,0,91,91,50
42,r_128_164_155,r_122_8_188,seq94,r_122_8_188,0.84,-33,155,188,50
111,seq187,seq64,r_66_138_134,r_66_138_134,1.0,1,135,134,50
139,seq144,r_221_113_94,seq40,r_221_113_94,0.99,-53,41,94,50
45,r_62_118_125,seq37,r_59_117_6,r_62_118_125,0.72,1,126,125,50
20,r_183_223_43,seq54,r_79_159_4,r_183_223_43,1.0,0,43,43,50
41,r_101_31_95,r_58_53_107,r_190_179_42,r_190_179_42,0.99,60,102,42,50
67,r_148_171_106,seq57,r_17_2_68,r_148_171_106,1.0,0,106,106,50
89,seq184,r_0_28_91,r_27_110_11,r_0_28_91,1.0,-10,81,91,50
64,r_202_20_189,r_181_189_85,r_42_1_184,r_202_20_189,0.5,-153,36,189,50
3,r_32_19_185,r_44_167_5,r_199_206_10,r_199_206_10,0.85,178,188,10,50
26,r_177_36_66,r_173_172_149,r_202_20_189,r_177_36_66,1.0,0,66,66,50
72,r_44_167_5,r_32_19_185,r_173_172_149,r_173_172_149,0.79,17,166,149,50
35,r_209_10_41,seq16,r_87_203_174,r_209_10_41,1.0,1,42,41,50
4,r_137_80_157,r_199_206_10,r_136_182_7,r_199_206_10,0.55,149,159,10,50
0,r_74_200_77,r_62_118_125,r_33_70_8,r_74_200_77,0.78,1,78,77,50
63,r_43_129_83,r_148_171_106,r_134_126_11,r_43_129_83,1.0,0,83,83,50
73,r_119_112_150,seq11,r_88_100_38,r_88_100_38,1.0,27,65,38,50
13,r_61_121_74,r_217_3_120,r_93_18_187,r_61_121_74,1.0,0,74,74,50
48,r_173_172_149,seq140,r_44_167_5,r_173_172_149,0.68,0,149,149,50
57,r_66_138_134,seq57,seq187,r_66_138_134,1.0,0,134,134,50
6,r_105_154_69,r_39_130_191,seq82,r_105_154_69,0.94,14,83,69,50
16,r_208_96_30,r_105_154_69,seq135,r_105_154_69,0.55,-23,46,69,50
36,r_87_203_174,r_209_10_41,r_74_200_77,r_209_10_41,0.5,134,175,41,50
10,r_217_3_120,r_199_206_10,seq196,r_217_3_120,0.46,9,129,120,50
27,r_69_60_142,r_124_151_170,seq71,r_69_60_142,0.59,3,145,142,50
148,seq125,r_38_160_184,seq115,r_38_160_184,0.49,0,184,184,50
87,seq25,r_132_120_120,r_7_14_49,r_7_14_49,1.0,82,131,49,50
30,r_102_12_57,r_93_18_187,seq207,r_102_12_57,1.0,0,57,57,50
40,r_52_185_57,seq71,r_102_12_57,r_102_12_57,0.92,0,57,57,50
15,r_205_22_38,r_74_200_77,seq48,r_205_22_38,1.0,1,39,38,50
71,r_17_2_68,r_51_77_65,r_148_171_106,r_148_171_106,1.0,14,120,106,50
74,r_58_53_107,seq207,seq193,r_58_53_107,0.97,0,107,107,50
29,r_221_113_94,r_35_106_199,seq71,r_221_113_94,0.99,0,94,94,50
24,r_124_151_170,seq135,r_102_12_57,r_102_12_57,1.0,114,171,57,50
35,r_209_10_41,r_87_203_174,seq57,r_87_203_174,1.0,0,174,174,50
64,r_202_20_189,r_42_1_184,r_177_36_66,r_177_36_66,1.0,3,69,66,50
54,r_175_169_31,seq145,seq71,r_175_169_31,0.75,-9,22,31,50
70,r_132_120_120,seq25,seq127,r_132_120_120,0.6,11,131,120,50
65,r_165_141_91,r_79_159_4,r_90_98_39,r_90_98_39,0.9,53,92,39,50
37,r_42_1_184,seq197,r_190_179_42,r_190_179_42,1.0,3,45,42,50
68,r_201_195_117,seq168,r_51_77_65,r_51_77_65,0.99,52,117,65,50
61,r_85_222_114,seq95,seq75,r_85_222_114,0.82,1,115,114,50
84,seq146,r_218_142_34,r_124_151_170,r_218_142_34,1.0,0,34,34,50
38,r_194_55_171,seq30,r_59_117_6,r_194_55_171,0.64,0,171,171,50
52,r_170_214_80,r_149_152_133,seq156,r_170_214_80,1.0,0,80,80,50
25,r_134_126_11,r_124_151_170,seq54,r_134_126_11,0.69,0,11,11,50
77,seq135,r_124_151_170,r_4_68_137,r_4_68_137,0.61,24,161,137,50
34,r_149_152_133,seq198,seq135,r_149_152_133,0.91,0,133,133,50
69,r_27_110_11,r_162_63_91,seq184,r_27_110_11,0.85,0,11,11,50
60,r_79_159_4,r_165_141_91,r_183_223_43,r_183_223_43,0.65,57,100,43,50
11,r_93_18_187,r_74_200_77,r_61_121_74,r_93_18_187,1.0,-113,74,187,50
112,seq64,seq65,r_220_91_121,r_220_91_121,1.0,5,126,121,50
37,r_42_1_184,r_190_179_42,r_101_31_95,r_101_31_95,0.59,3,98,95,50
9,r_0_28_91,seq184,r_134_126_11,r_0_28_91,0.99,0,91,91,50
11,r_93_18_187,r_102_12_57,r_74_200_77,r_93_18_187,0.49,-163,24,187,50
123,seq207,r_58_53_107,r_102_12_57,r_102_12_57,1.0,50,107,57,50
73,r_119_112_150,r_88_100_38,r_199_206_10,r_119_112_150,0.79,0,150,150,50
91,seq29,seq198,r_74_200_77,r_74_200_77,0.95,62,139,77,50
22,r_139_178_36,r_124_151_170,r_136_182_7,r_139_178_36,1.0,1,37,36,50
44,r_190_179_42,seq47,r_42_1_184,r_190_179_42,1.0,2,44,42,50
149,seq127,r_220_91_121,r_132_120_120,r_220_91_121,0.67,2,123,121,50
56,r_4_68_137,seq94,seq135,r_4_68_137,0.54,1,138,137,50
7,r_191_219_110,r_149_152_133,seq156,r_191_219_110,0.95,1,111,110,50
23,r_153_155_76,seq216,r_205_22_38,r_153_155_76,0.86,0,76,76,50
138,seq104,seq176,r_162_63_91,r_162_63_91,1.0,26,117,91,50
62,r_218_142_34,seq146,seq84,r_218_142_34,1.0,0,34,34,50
1,r_88_100_38,seq46,r_119_112_150,r_88_100_38,0.99,2,40,38,50
30,r_69_62_127,seq32,seq119,r_69_62_127,0.97,0,127,127,51
16,r_160_206_15,r_134_66_157,seq104,r_160_206_15,0.91,0,15,15,51
51,r_37_144_72,seq169,r_9_35_24,r_37_144_72,1.0,0,72,72,51
8,r_74_192_157,seq48,seq24,r_74_192_157,0.51,2,159,157,51
43,r_53_102_91,r_95_193_119,r_28_198_40,r_53_102_91,1.0,0,91,91,51
22,r_167_166_55,seq214,r_9_35_24,r_167_166_55,1.0,2,57,55,51
55,r_67_101_87,seq196,seq140,r_67_101_87,1.0,1,88,87,51
71,r_13_3_66,seq136,r_95_193_119,r_13_3_66,1.0,2,68,66,51
21,r_27_44_121,seq191,r_157_23_48,r_27_44_121,0.97,1,122,121,51
39,r_174_215_152,r_74_192_157,r_33_163_37,r_174_215_152,0.85,3,155,152,51
25,r_28_198_40,r_75_141_150,r_189_71_119,r_75_141_150,0.63,-110,40,150,51
5,r_50_110_64,seq203,seq85,r_50_110_64,1.0,2,66,64,51
46,r_75_141_150,seq59,r_90_54_13,r_75_141_150,0.96,0,150,150,51
42,r_36_120_107,r_168_148_121,r_207_126_78,r_168_148_121,0.71,-14,107,121,51
69,r_7_80_136,seq87,r_58_46_132,r_7_80_136,1.0,0,136,136,51
14,r_60_105_41,seq119,seq123,r_60_105_41,1.0,0,41,41,51
48,r_9_35_24,r_95_193_119,seq99,r_9_35_24,1.0,0,24,24,51
95,seq133,r_164_200_123,seq111,r_164_200_123,1.0,1,124,123,51
66,r_6_42_166,seq104,r_124_188_56,r_124_188_56,1.0,110,166,56,51
31,r_49_219_108,r_189_71_119,r_115_139_118,r_49_219_108,0.99,10,118,108,51
67,r_189_71_119,r_49_219_108,seq203,r_189_71_119,1.0,-1,118,119,51
110,seq201,r_183_8_90,r_143_51_12,r_183_8_90,0.9,0,90,90,51
68,r_176_151_18,r_187_109_86,r_160_206_15,r_176_151_18,1.0,1,19,18,51
90,seq20,r_61_34_158,r_208_216_46,r_208_216_46,0.88,112,158,46,51
36,r_205_52_29,seq5,seq32,r_205_52_29,0.97,0,29,29,51
44,r_31_68_19,r_47_194_49,seq30,r_31_68_19,0.89,0,19,19,51
26,r_153_57_123,seq2,r_222_149_81,r_153_57_123,1.0,0,123,123,51
72,r_21_29_73,seq129,r_98_18_2,r_21_29_73,1.0,0,73,73,51
33,r_157_23_48,r_115_139_118,seq136,r_157_23_48,1.0,0,48,48,51
38,r_76_83_29,r_208_216_46,seq73,r_76_83_29,1.0,0,29,29,51
73,r_175_122_70,seq204,r_155_202_14,r_175_122_70,0.89,0,70,70,51
11,r_172_156_165,seq87,r_212_113_45,r_172_156_165,0.64,0,165,165,51
3,r_143_51_12,r_76_83_29,seq201,r_143_51_12,0.96,1,13,12,51
13,r_187_109_86,r_38_223_29,seq169,r_187_109_86,1.0,0,86,86,51
15,r_115_139_118,seq123,r_28_198_40,r_115_139_118,1.0,0,118,118,51
57,r_164_200_123,seq133,seq30,r_164_200_123,1.0,1,124,123,51
106,seq178,seq93,r_184_221_109,r_184_221_109,1.0,4,113,109,51
45,r_124_188_56,seq16,seq132,r_124_188_56,1.0,0,56,56,51
0,r_212_113_45,seq73,r_155_202_14,r_212_113_45,0.96,0,45,45,51
137,seq99,seq119,r_9_35_24,r_9_35_24,1.0,19,43,24,51
6,r_25_179_154,seq97,r_7_80_136,r_25_179_154,0.81,0,154,154,51
62,r_159_154_82,r_211_145_130,r_157_23_48,r_211_145_130,1.0,-46,84,130,51
41,r_208_216_46,seq10,seq20,r_208_216_46,0.98,0,46,46,51
63,r_173_1_31,r_168_148_121,r_146_161_7,r_173_1_31,1.0,0,31,31,51
27,r_184_221_109,seq30,seq178,r_184_221_109,1.0,0,109,109,51
9,r_190_118_20,r_27_44_121,seq14,r_190_118_20,0.96,0,20,20,51
142,seq140,r_27_44_121,r_67_101_87,r_67_101_87,0.52,0,87,87,51
47,r_112_195_35,seq15,seq129,r_112_195_35,1.0,0,35,35,51
40,r_211_145_130,seq12,seq64,r_211_145_130,0.97,0,130,130,51
18,r_41_217_129,seq32,r_146_161_7,r_41_217_129,0.99,0,129,129,51
29,r_94_39_181,seq138,r_160_206_15,r_94_39_181,0.46,0,181,181,51
24,r_107_213_70,r_13_3_66,r_60_105_41,r_60_105_41,1.0,66,107,41,51
144,seq114,r_207_126_78,r_155_202_14,r_155_202_14,0.82,0,14,14,51
20,r_47_194_49,r_183_8_90,seq85,r_47_194_49,1.0,1,50,49,51
64,r_82_147_71,r_184_221_109,seq5,r_82_147_71,0.96,0,71,71,51
54,r_45_56_22,r_47_194_49,r_146_161_7,r_45_56_22,0.97,0,22,22,51
70,r_38_223_29,r_187_109_86,r_183_8_90,r_38_223_29,1.0,59,88,29,51
65,r_17_70_132,seq40,seq199,r_17_70_132,0.83,0,132,132,51
61,r_135_209_74,seq48,seq12,r_135_209_74,1.0,0,74,74,51
52,r_224_131_62,seq137,seq116,r_224_131_62,1.0,4,66,62,51
139,seq104,r_168_148_121,r_160_206_15,r_160_206_15,0.84,0,15,15,51
34,r_58_46_132,seq14,r_135_209_74,r_58_46_132,0.98,0,132,132,51
2,r_155_202_14,seq152,seq114,r_155_202_14,1.0,0,14,14,51
60,r_92_81_22,r_168_148_121,seq132,r_92_81_22,1.0,3,25,22,51
35,r_72_171_43,r_107_213_70,r_205_52_29,r_72_171_43,1.0,1,44,43,51
53,r_22_162_57,r_168_148_121,r_146_161_7,r_22_162_57,1.0,0,57,57,51
17,r_207_126_78,seq114,r_95_193_119,r_207_126_78,1.0,1,79,78,51
112,seq138,r_94_39_181,r_69_62_127,r_69_62_127,0.98,54,181,127,51
25,r_28_198_40,r_189_71_119,r_53_102_91,r_28_198_40,1.0,62,102,40,51
32,r_186_108_20,seq40,r_91_128_12,r_186_108_20,1.0,0,20,20,51
62,r_159_154_82,r_157_23_48,r_37_144_72,r_159_154_82,0.35,105,187,82,51
28,r_55_19_130,seq64,seq130,r_55_19_130,0.97,0,130,130,51
49,r_183_8_90,seq201,r_38_223_29,r_183_8_90,1.0,0,90,90,51
56,r_61_34_158,seq20,r_184_221_109,r_61_34_158,0.77,0,158,158,51
7,r_91_128_12,r_55_19_130,r_186_108_20,r_91_128_12,0.93,64,76,12,51
23,r_168_148_121,seq104,seq117,r_168_148_121,0.85,6,127,121,51
82,seq10,seq137,r_124_188_56,r_124_188_56,1.0,46,102,56,51
84,seq12,r_211_145_130,r_135_209_74,r_135_209_74,0.85,56,130,74,51
59,r_100_125_15,r_95_193_119,r_91_128_12,r_100_125_15,0.96,0,15,15,51
51,r_46_215_63,seq74,seq180,r_46_215_63,0.81,-2,61,63,52
37,r_204_6_55,seq192,seq73,r_204_6_55,1.0,0,55,55,52
92,seq30,r_29_126_83,r_199_222_141,r_29_126_83,1.0,-21,62,83,52
14,r_122_37_104,seq198,seq76,r_122_37_104,0.94,2,106,104,52
8,r_178_167_74,r_186_213_170,seq145,r_178_167_74,1.0,-1,73,74,52
53,r_108_132_121,r_96_130_75,r_53_218_71,r_108_132_121,1.0,-49,72,121,52
7,r_181_14_15,r_142_124_74,r_54_94_163,r_181_14_15,0.99,0,15,15,52
54,r_67_120_108,r_127_165_167,r_5_175_103,r_67_120_108,1.0,0,108,108,52
56,r_221_88_15,r_20_210_180,r_53_218_71,r_53_218_71,1.0,1,72,71,52
69,r_41_201_33,r_223_69_161,r_25_212_140,r_41_201_33,1.0,0,33,33,52
71,r_85_8_78,seq133,seq56,r_85_8_78,1.0,1,79,78,52
16,r_154_207_185,r_2_12_159,r_101_179_87,r_101_179_87,0.99,32,119,87,52
21,r_110_78_185,seq107,r_143_11_17,r_143_11_17,0.75,169,186,17,52
39,r_2_12_159,r_154_207_185,r_5_175_103,r_2_12_159,0.91,1,160,159,52
30,r_109_57_24,seq31,seq70,r_109_57_24,0.98,-1,23,24,52
1,r_87_21_117,seq158,seq28,r_87_21_117,0.99,0,117,117,52
143,seq107,r_110_78_185,r_49_7_153,r_49_7_153,0.7,33,186,153,52
42,r_203_188_67,r_178_167_74,r_48_115_199,r_203_188_67,0.92,-2,65,67,52
111,seq180,r_178_167_74,r_46_215_63,r_178_167_74,1.0,-13,61,74,52
7,r_181_14_15,r_54_94_163,r_113_157_157,r_181_14_15,0.57,148,163,15,52
11,r_127_165_167,seq13,r_223_69_161,r_127_165_167,0.95,2,169,167,52
38,r_156_66_95,r_53_218_71,r_195_187_12,r_195_187_12,0.61,0,12,12,52
66,r_150_23_160,r_35_15_180,r_49_7_153,r_150_23_160,0.57,1,161,160,52
60,r_0_138_28,r_169_22_194,r_10_209_104,r_0_138_28,1.0,0,28,28,52
38,r_156_66_95,r_195_187_12,r_96_130_75,r_96_130_75,1.0,22,97,75,52
46,r_173_33_20,r_53_218_71,seq39,r_173_33_20,0.55,0,20,20,52
127,seq141,r_34_47_190,r_155_38_5,r_155_38_5,0.74,6,11,5,52
67,r_10_209_104,r_0_138_28,seq182,r_10_209_104,1.0,0,104,104,52
67,r_10_209_104,r_142_124_74,r_0_138_28,r_0_138_28,0.87,0,28,28,52
115,seq190,seq50,r_160_183_81,r_160_183_81,1.0,2,83,81,52
26,r_25_212_140,r_49_7_153,r_208_149_127,r_25_212_140,0.99,0,140,140,52
16,r_154_207_185,r_101_179_87,seq80,r_101_179_87,0.47,98,185,87,52
4,r_49_7_153,r_97_65_198,seq107,r_97_65_198,0.69,-45,153,198,52
0,r_142_124_74,r_25_212_140,seq134,r_142_124_74,1.0,0,74,74,52
73,r_105_40_130,r_99_26_4,r_42_148_14,r_99_26_4,0.45,128,132,4,52
11,r_127_165_167,r_67_120_108,seq13,r_67_120_108,0.9,-5,103,108,52
107,seq158,r_87_21_117,r_5_175_103,r_87_21_117,0.97,0,117,117,52
13,r_27_166_139,seq104,seq30,r_27_166_139,0.42,0,139,139,52
15,r_79_45_173,seq125,r_112_153_150,r_79_45_173,0.36,4,177,173,52
48,r_160_183_81,r_105_40_130,seq190,r_160_183_81,0.98,0,81,81,52
23,r_42_148_14,r_1_64_49,r_35_15_180,r_42_148_14,0.52,-1,13,14,52
6,r_128_163_165,seq31,r_46_215_63,r_128_163_165,0.82,0,165,165,52
62,r_20_210_180,seq56,r_87_21_117,r_87_21_117,1.0,63,180,117,52
5,r_199_222_141,seq13,seq92,r_199_222_141,0.95,2,143,141,52
33,r_143_11_17,r_204_6_55,seq135,r_143_11_17,1.0,0,17,17,52
134,seq185,r_174_71_121,r_59_62_66,r_59_62_66,0.95,-1,65,66,52
28,r_100_224_17,r_176_139_168,r_108_132_121,r_100_224_17,0.91,0,17,17,52
27,r_98_60_63,r_178_167_74,r_1_64_49,r_98_60_63,1.0,1,64,63,52
35,r_164_18_52,r_20_210_180,seq82,r_164_18_52,0.86,-3,49,52,52
22,r_101_179_87,r_154_207_185,r_112_153_150,r_154_207_185,0.94,0,185,185,52
69,r_41_201_33,r_25_212_140,r_97_65_198,r_25_212_140,1.0,0,140,140,52
2,r_5_175_103,seq82,seq158,r_5_175_103,0.65,-6,97,103,52
47,r_176_139_168,seq133,r_85_8_78,r_85_8_78,1.0,90,168,78,52
74,r_113_157_157,seq24,seq145,r_113_157_157,0.89,0,157,157,52
18,r_223_69_161,seq50,r_10_209_104,r_10_209_104,0.8,58,162,104,52
29,r_131_184_163,r_154_207_185,r_164_18_52,r_131_184_163,0.73,0,163,163,52
24,r_219_90_168,seq159,r_131_184_163,r_219_90_168,0.7,1,169,168,52
25,r_118_144_74,r_208_149_127,r_99_26_4,r_118_144_74,1.0,0,74,74,52
31,r_1_64_49,seq70,r_0_138_28,r_1_64_49,0.93,0,49,49,52
64,r_51_102_116,seq180,seq50,r_51_102_116,0.85,8,124,116,52
65,r_119_83_176,r_29_126_83,r_1_64_49,r_29_126_83,0.64,94,177,83,52
50,r_29_126_83,seq30,r_119_83_176,r_29_126_83,0.96,0,83,83,52
70,r_59_62_66,seq107,seq185,r_59_62_66,0.87,3,69,66,52
65,r_119_83_176,r_186_213_170,r_29_126_83,r_29_126_83,1.0,2,85,83,52
3,r_220_162_54,seq13,seq192,r_220_162_54,1.0,0,54,54,52
20,r_123_206_38,r_208_149_127,seq36,r_123_206_38,0.93,0,38,38,52
61,r_96_130_75,r_108_132_121,seq217,r_96_130_75,1.0,1,76,75,52
32,r_97_65_198,r_49_7_153,r_41_201_33,r_97_65_198,0.93,-45,153,198,52
34,r_129_200_83,r_174_71_121,seq141,r_129_200_83,1.0,0,83,83,52
127,seq141,r_155_38_5,r_129_200_83,r_129_200_83,1.0,19,102,83,52
40,r_121_171_26,r_123_206_38,r_48_115_199,r_121_171_26,0.99,-1,25,26,52
81,seq9,r_189_19_171,r_199_222_141,r_199_222_141,0.84,34,175,141,52
9,r_114_17_60,seq50,r_109_57_24,r_114_17_60,1.0,0,60,60,52
63,r_195_187_12,r_156_66_95,seq125,r_156_66_95,1.0,22,117,95,52
50,r_29_126_83,r_119_83_176,seq170,r_119_83_176,0.84,1,177,176,52
28,r_100_224_17,r_108_132_121,r_221_88_15,r_108_132_121,0.75,6,127,121,52
123,seq73,seq152,r_204_6_55,r_204_6_55,1.0,6,61,55,52
17,r_54_94_163,r_193_93_155,r_181_14_15,r_181_14_15,1.0,0,15,15,52
22,r_101_179_87,r_35_15_180,r_154_207_185,r_101_179_87,1.0,0,87,87,52
91,seq28,seq125,r_87_21_117,r_87_21_117,1.0,3,120,117,52
55,r_103_43_40,r_169_22_194,r_221_88_15,r_103_43_40,0.97,2,42,40,52
138,seq91,r_219_90_168,r_208_149_127,r_219_90_168,0.69,-33,135,168,52
17,r_54_94_163,r_181_14_15,r_85_8_78,r_181_14_15,0.89,148,163,15,52
19,r_61_55_46,r_46_215_63,seq216,r_61_55_46,0.95,1,47,46,52
101,seq170,r_186_213_170,r_29_126_83,r_29_126_83,0.63,86,169,83,52
60,r_0_138_28,r_10_209_104,r_1_64_49,r_10_209_104,0.98,0,104,104,52
56,r_221_88_15,r_53_218_71,r_20_210_180,r_221_88_15,0.91,0,15,15,52
12,r_53_218_71,r_208_149_127,r_103_43_40,r_208_149_127,0.93,-56,71,127,52
23,r_42_148_14,r_35_15_180,r_105_40_130,r_105_40_130,0.65,12,142,130,52
63,r_195_187_12,r_143_11_17,r_156_66_95,r_195_187_12,0.99,1,13,12,52
55,r_103_43_40,r_221_88_15,r_53_218_71,r_53_218_71,1.0,57,128,71,52
30,r_27_104_61,seq149,seq141,r_27_104_61,1.0,0,61,61,53
51,r_10_144_65,seq18,r_165_168_54,r_10_144_65,0.94,3,68,65,53
36,r_109_158_116,r_21_136_142,r_213_161_116,r_213_161_116,0.96,1,117,116,53
14,r_71_77_184,r_35_157_91,seq63,r_35_157_91,0.99,-27,64,91,53
53,r_117_222_59,r_36_60_108,seq56,r_117_222_59,1.0,1,60,59,53
125,seq208,seq174,r_106_6_150,r_106_6_150,0.82,8,158,150,53
54,r_9_75_92,r_35_157_91,r_80_224_86,r_80_224_86,0.71,5,91,86,53
83,seq16,seq95,r_142_171_97,r_142_171_97,1.0,9,106,97,53
74,r_140_57_12,r_148_99_120,seq7,r_140_57_12,1.0,1,13,12,53
71,r_198_155_94,r_30_115_144,r_51_28_66,r_198_155_94,1.0,-2,92,94,53
1,r_13_173_106,seq145,r_50_12_44,r_13_173_106,0.99,4,110,106,53
97,seq40,r_213_161_116,seq74,r_213_161_116,1.0,-18,98,116,53
5,r_172_42_73,r_13_173_106,r_139_193_105,r_172_42_73,0.81,0,73,73,53
46,r_30_115_144,r_68_151_183,r_126_20_181,r_30_115_144,0.86,0,144,144,53
11,r_107_87_11,seq16,seq18,r_107_87_11,1.0,0,11,11,53
18,r_132_61_25,r_164_17_114,r_130_125_42,r_132_61_25,0.8,20,45,25,53
80,seq141,r_189_22_133,r_27_104_61,r_27_104_61,0.92,72,133,61,53
63,r_130_125_42,r_3_119_165,r_132_61_25,r_130_125_42,0.99,-1,41,42,53
85,seq18,r_3_119_165,r_107_87_11,r_107_87_11,1.0,0,11,11,53
69,r_153_116_172,seq11,r_197_180_49,r_153_116_172,0.65,1,173,172,53
45,r_21_136_142,seq63,r_213_161_116,r_21_136_142,0.95,0,142,142,53
10,r_94_83_59,r_58_24_181,seq110,r_94_83_59,1.0,-2,57,59,53
15,r_41_134_186,r_76_127_10,r_189_22_133,r_189_22_133,0.97,9,142,133,53
43,r_163_65_49,seq179,seq154,r_163_65_49,1.0,0,49,49,53
66,r_58_24_181,seq56,seq145,r_58_24_181,0.36,0,181,181,53
26,r_106_6_150,seq214,r_2_167_58,r_2_167_58,0.48,-5,53,58,53
31,r_114_89_190,seq92,seq174,r_114_89_190,0.24,0,190,190,53
129,seq214,r_106_6_150,r_2_167_58,r_106_6_150,0.63,-1,149,150,53
67,r_139_193_105,seq53,seq82,r_139_193_105,0.98,-1,104,105,53
32,r_70_8_49,r_94_83_59,r_178_67_7,r_70_8_49,1.0,0,49,49,53
14,r_71_77_184,seq63,r_153_116_172,r_71_77_184,0.68,0,184,184,53
78,seq138,r_41_134_186,r_76_127_10,r_41_134_186,0.36,-55,131,186,53
0,r_148_99_120,seq204,r_10_144_65,r_148_99_120,0.98,0,120,120,53
8,r_1_219_15,r_13_173_106,seq204,r_1_219_15,1.0,0,15,15,53
73,r_182_86_160,seq216,r_106_6_150,r_182_86_160,0.85,0,160,160,53
20,r_51_28_66,seq82,seq179,r_51_28_66,1.0,3,69,66,53
13,r_102_85_60,r_79_201_81,seq46,r_102_85_60,1.0,0,60,60,53
48,r_124_88_133,seq162,r_123_187_107,r_124_88_133,0.94,0,133,133,53
4,r_3_119_165,r_107_87_11,r_206_72_2,r_3_119_165,0.63,4,169,165,53
57,r_69_29_145,seq152,seq74,r_69_29_145,0.84,0,145,145,53
6,r_213_161_116,seq40,r_109_158_116,r_213_161_116,0.95,1,117,116,53
99,seq45,r_90_31_184,r_10_144_65,r_10_144_65,1.0,48,113,65,53
3,r_197_180_49,seq32,seq39,r_197_180_49,1.0,1,50,49,53
17,r_66_166_52,r_41_134_186,seq181,r_66_166_52,1.0,1,53,52,53
27,r_2_167_58,r_124_88_133,seq214,r_124_88_133,0.87,-57,76,133,53
136,seq98,r_68_151_183,r_36_60_108,r_36_60_108,0.99,75,183,108,53
87,seq149,r_27_104_61,r_76_127_10,r_27_104_61,1.0,0,61,61,53
39,r_221_160_41,seq53,r_23_212_121,r_221_160_41,1.0,0,41,41,53
2,r_36_60_108,r_189_22_133,seq98,r_36_60_108,1.0,0,108,108,53
47,r_175_217_99,seq64,seq92,r_175_217_99,0.93,0,99,99,53
142,seq110,seq137,r_94_83_59,r_94_83_59,1.0,11,70,59,53
15,r_41_134_186,r_66_166_52,r_76_127_10,r_66_166_52,1.0,1,53,52,53
25,r_79_201_81,seq137,r_94_83_59,r_94_83_59,1.0,67,126,59,53
127,seq82,r_51_28_66,r_213_161_116,r_51_28_66,0.88,-3,63,66,53
64,r_80_224_86,seq174,r_9_75_92,r_80_224_86,0.99,6,92,86,53
58,r_129_91_63,r_44_131_123,r_197_180_49,r_129_91_63,1.0,2,65,63,53
70,r_81_128_154,seq55,r_106_6_150,r_106_6_150,0.84,5,155,150,53
42,r_76_127_10,r_94_83_59,r_41_134_186,r_76_127_10,0.83,1,11,10,53
68,r_142_171_97,r_195_38_105,seq16,r_142_171_97,1.0,0,97,97,53
61,r_195_38_105,seq39,r_107_87_11,r_195_38_105,0.98,1,106,105,53
38,r_23_212_121,seq154,r_221_160_41,r_221_160_41,0.96,81,122,41,53
52,r_54_26_176,seq82,r_1_219_15,r_54_26_176,0.63,0,176,176,53
5,r_172_42_73,r_139_193_105,r_35_157_91,r_139_193_105,0.62,2,107,105,53
23,r_164_17_114,r_106_6_150,r_132_61_25,r_132_61_25,0.93,0,25,25,53
34,r_111_223_156,seq207,r_135_52_129,r_111_223_156,0.86,0,156,156,53
62,r_50_12_44,seq93,seq185,r_50_12_44,1.0,0,44,44,53
60,r_165_168_54,seq108,seq93,r_165_168_54,0.45,2,56,54,53
50,r_37_73_24,r_197_180_49,seq143,r_37_73_24,0.97,1,25,24,53
112,seq63,r_21_136_142,seq64,r_21_136_142,0.94,0,142,142,53
121,seq204,r_148_99_120,r_178_67_7,r_148_99_120,0.64,-48,72,120,53
9,r_96_218_133,seq174,r_107_87_11,r_96_218_133,0.88,0,133,133,53
26,r_106_6_150,r_2_167_58,r_81_128_154,r_106_6_150,0.92,-1,149,150,53
28,r_44_131_123,r_126_20_181,r_213_161_116,r_44_131_123,0.96,0,123,123,53
18,r_132_61_25,r_44_131_123,r_164_17_114,r_132_61_25,0.65,0,25,25,53
91,seq154,r_23_212_121,r_163_65_49,r_163_65_49,1.0,73,122,49,53
135,seq95,r_182_86_160,seq92,r_182_86_160,0.8,-64,96,160,53
49,r_133_170_104,seq121,seq33,r_133_170_104,0.86,4,108,104,53
140,seq108,r_165_168_54,r_123_187_107,r_123_187_107,0.54,3,110,107,53
56,r_123_187_107,seq64,seq108,r_123_187_107,0.92,0,107,107,53
44,r_189_22_133,seq141,r_41_134_186,r_189_22_133,0.94,0,133,133,53
76,seq7,r_153_116_172,r_140_57_12,r_140_57_12,1.0,2,14,12,53
134,seq93,seq45,r_165_168_54,r_165_168_54,0.96,-8,46,54,53
108,seq59,r_90_31_184,r_148_99_120,r_148_99_120,1.0,49,169,120,53
35,r_5_113_128,r_41_134_186,r_206_72_2,r_5_113_128,0.96,1,129,128,53
12,r_135_52_129,seq112,r_97_192_4,r_135_52_129,1.0,0,129,129,53
23,r_164_17_114,r_132_61_25,seq112,r_164_17_114,0.8,10,124,114,53
4,r_3_119_165,r_130_125_42,r_107_87_11,r_3_119_165,0.86,-128,37,165,53
44,r_14_66_139,r_12_203_7,seq212,r_14_66_139,0.88,0,139,139,54
51,r_143_133_190,seq107,r_42_6_158,r_42_6_158,1.0,32,190,158,54
1,r_7_87_11,r_108_86_88,seq126,r_108_86_88,0.8,-77,11,88,54
8,r_131_174_105,r_62_193_118,seq212,r_131_174_105,1.0,0,105,105,54
43,r_91_125_146,seq219,r_155_119_70,r_91_125_146,0.93,0,146,146,54
54,r_153_224_149,r_52_216_120,r_15_112_70,r_15_112_70,0.57,50,120,70,54
37,r_127_186_62,seq72,seq49,r_127_186_62,1.0,0,62,62,54
31,r_31_46_40,r_108_86_88,seq9,r_31_46_40,1.0,0,40,40,54
3,r_13_26_22,seq201,seq72,r_13_26_22,1.0,0,22,22,54
16,r_69_156_131,seq126,r_176_41_33,r_69_156_131,0.66,0,131,131,54
39,r_68_56_15,seq175,r_37_105_79,r_37_105_79,1.0,5,84,79,54
143,seq115,r_30_67_191,r_92_23_75,r_92_23_75,1.0,18,93,75,54
5,r_129_146_174,r_134_21_177,r_44_135_15,r_134_21_177,0.32,-3,174,177,54
46,r_142_84_131,seq151,r_176_41_33,r_142_84_131,0.96,2,133,131,54
42,r_145_221_98,seq124,seq152,r_145_221_98,1.0,0,98,98,54
69,r_200_159_161,seq152,r_158_70_85,r_158_70_85,0.72,76,161,85,54
19,r_163_218_137,seq210,seq154,r_163_218_137,0.81,0,137,137,54
66,r_11_118_158,seq72,seq212,r_11_118_158,0.87,0,158,158,54
103,seq175,r_68_56_15,r_132_157_107,r_132_157_107,0.97,5,112,107,54
67,r_82_208_174,seq4,r_13_26_22,r_13_26_22,0.87,152,174,22,54
10,r_134_21_177,r_129_146_174,r_89_182_62,r_89_182_62,1.0,3,65,62,54
72,r_166_36_97,r_52_216_120,seq72,r_166_36_97,0.91,1,98,97,54
4,r_194_214_162,seq121,seq140,r_194_214_162,0.36,2,164,162,54
78,seq4,r_82_208_174,r_116_59_4,r_82_208_174,0.66,0,174,174,54
63,r_61_1_127,r_142_84_131,seq34,r_61_1_127,0.72,0,127,127,54
20,r_42_6_158,r_168_223_108,r_76_88_117,r_42_6_158,0.75,0,158,158,54
15,r_15_112_70,seq10,r_128_181_41,r_15_112_70,0.71,0,70,70,54
48,r_100_141_139,seq95,seq165,r_100_141_139,0.51,0,139,139,54
55,r_78_178_30,r_89_182_62,seq219,r_78_178_30,1.0,0,30,30,54
57,r_20_172_108,seq179,seq151,r_20_172_108,0.96,-1,107,108,54
6,r_16_38_84,r_43_103_174,r_22_217_95,r_22_217_95,0.74,14,109,95,54
61,r_192_19_28,r_101_185_176,r_161_74_194,r_192_19_28,0.86,1,29,28,54
141,seq113,r_32_150_164,seq2,r_32_150_164,0.8,0,164,164,54
99,seq165,r_149_187_182,r_100_141_139,r_100_141_139,0.7,9,148,139,54
134,seq95,r_100_141_139,r_7_87_11,r_100_141_139,0.81,0,139,139,54
10,r_134_21_177,r_89_182_62,seq205,r_134_21_177,0.58,-12,165,177,54
27,r_77_207_144,seq190,r_76_88_117,r_77_207_144,0.78,0,144,144,54
148,seq124,r_145_221_98,seq201,r_145_221_98,1.0,-10,88,98,54
13,r_137_60_50,r_164_120_132,seq154,r_164_120_132,0.57,-77,55,132,54
17,r_176_41_33,r_155_119_70,seq39,r_176_41_33,1.0,-5,28,33,54
41,r_128_181_41,r_52_216_120,r_15_112_70,r_128_181_41,0.68,79,120,41,54
59,r_12_203_7,r_14_66_139,r_168_223_108,r_14_66_139,1.0,0,139,139,54
40,r_101_185_176,seq85,r_194_214_162,r_101_185_176,0.26,1,177,176,54
74,r_155_119_70,r_32_150_164,seq210,r_155_119_70,1.0,0,70,70,54
18,r_158_70_85,r_90_64_199,seq151,r_158_70_85,1.0,0,85,85,54
29,r_169_79_120,seq94,seq80,r_169_79_120,0.99,0,120,120,54
62,r_161_74_194,r_69_156_131,r_192_19_28,r_69_156_131,0.92,-85,46,131,54
24,r_209_213_98,seq94,r_78_178_30,r_209_213_98,0.99,0,98,98,54
25,r_22_217_95,r_132_157_107,seq71,r_22_217_95,1.0,1,96,95,54
54,r_153_224_149,r_15_112_70,seq196,r_153_224_149,0.98,0,149,149,54
33,r_62_193_118,seq196,seq184,r_62_193_118,0.96,0,118,118,54
127,seq210,r_163_218_137,r_155_119_70,r_155_119_70,0.97,28,98,70,54
41,r_128_181_41,seq3,r_52_216_120,r_128_181_41,0.99,0,41,41,54
58,r_25_81_124,seq54,r_168_223_108,r_25_81_124,0.92,0,124,124,54
65,r_106_29_75,seq33,seq190,r_106_29_75,1.0,0,75,75,54
68,r_37_105_79,r_92_23_75,r_68_56_15,r_68_56_15,1.0,65,80,15,54
32,r_93_50_148,seq130,seq121,r_93_50_148,0.52,0,148,148,54
52,r_164_120_132,seq34,seq165,r_164_120_132,0.97,0,132,132,54
60,r_180_148_144,r_91_125_146,r_195_191_25,r_195_191_25,0.86,119,144,25,54
94,seq167,r_206_136_149,r_111_188_55,r_111_188_55,1.0,60,115,55,54
9,r_89_182_62,r_158_70_85,r_134_21_177,r_89_182_62,1.0,0,62,62,54
47,r_17_40_21,seq202,seq71,r_17_40_21,1.0,0,21,21,54
14,r_195_191_25,seq9,seq3,r_195_191_25,0.96,6,31,25,54
96,seq33,r_101_185_176,r_42_6_158,r_42_6_158,0.99,19,177,158,54
22,r_76_88_117,r_147_24_163,r_111_188_55,r_76_88_117,0.9,0,117,117,54
28,r_108_86_88,r_14_66_139,seq72,r_14_66_139,0.64,-51,88,139,54
49,r_32_150_164,seq113,r_168_223_108,r_32_150_164,0.8,0,164,164,54
56,r_215_57_111,seq184,seq196,r_215_57_111,0.99,2,113,111,54
131,seq219,r_91_125_146,r_209_213_98,r_209_213_98,0.97,48,146,98,54
23,r_43_103_174,seq0,r_69_156_131,r_69_156_131,0.51,43,174,131,54
138,seq107,r_143_133_190,r_149_187_182,r_149_187_182,0.89,8,190,182,54
12,r_132_157_107,seq184,seq175,r_132_157_107,0.99,4,111,107,54
30,r_24_35_177,seq212,r_213_144_119,r_24_35_177,0.75,0,177,177,55
51,r_29_58_152,seq87,r_54_8_94,r_29_58_152,0.74,0,152,152,55
36,r_126_175_74,seq0,r_219_116_32,r_126_175_74,1.0,1,75,74,55
14,r_195_105_166,r_179_44_76,seq125,r_179_44_76,0.59,1,77,76,55
8,r_9_6_71,seq171,r_147_80_42,r_147_80_42,1.0,29,71,42,55
53,r_26_118_169,seq28,r_60_218_160,r_60_218_160,0.63,9,169,160,55
43,r_134_200_84,seq188,seq32,r_134_200_84,0.96,0,84,84,55
15,r_219_116_32,r_179_44_76,r_112_151_199,r_219_116_32,0.99,0,32,32,55
26,r_111_71_40,r_201_152_148,seq46,r_111_71_40,0.49,3,43,40,55
54,r_131_93_105,r_1_97_182,seq158,r_1_97_182,0.82,-74,108,182,55
37,r_169_84_164,seq212,r_11_132_65,r_11_132_65,1.0,102,167,65,55
59,r_221_138_85,seq199,seq124,r_221_138_85,1.0,0,85,85,55
55,r_103_191_167,seq115,r_60_218_160,r_103_191_167,0.58,0,167,167,55
71,r_127_129_117,r_1_97_182,r_49_186_5,r_1_97_182,0.84,-34,148,182,55
86,seq171,r_9_6_71,r_62_146_167,r_62_146_167,0.56,-7,160,167,55
21,r_160_207_151,seq43,r_92_7_87,r_92_7_87,0.66,64,151,87,55
5,r_213_144_119,r_110_36_29,seq20,r_213_144_119,0.78,1,120,119,55
14,r_195_105_166,r_197_114_108,r_203_202_74,r_195_105_166,1.0,0,166,166,55
69,r_214_59_120,seq43,seq3,r_214_59_120,0.98,0,120,120,55
19,r_82_164_125,r_137_177_165,seq10,r_82_164_125,0.88,0,125,125,55
27,r_90_34_180,r_18_72_40,r_82_164_125,r_90_34_180,0.63,-1,179,180,55
66,r_174_190_136,r_90_34_180,r_131_93_105,r_174_190_136,0.97,0,136,136,55
31,r_201_152_148,seq51,r_217_145_59,r_217_145_59,1.0,90,149,59,55
41,r_12_30_123,seq45,seq3,r_12_30_123,0.94,1,124,123,55
67,r_223_181_90,seq123,seq16,r_223_181_90,0.99,1,91,90,55
110,seq48,r_176_194_126,seq142,r_176_194_126,1.0,0,126,126,55
28,r_147_80_42,r_213_144_119,seq168,r_147_80_42,1.0,0,42,42,55
10,r_60_218_160,seq209,r_223_181_90,r_60_218_160,0.87,0,160,160,55
109,seq47,seq188,r_92_7_87,r_92_7_87,0.99,23,110,87,55
33,r_110_36_29,r_85_39_139,r_109_14_130,r_110_36_29,0.52,127,156,29,55
0,r_92_7_87,r_174_190_136,seq47,r_174_190_136,0.62,-48,88,136,55
63,r_109_14_130,seq184,r_110_36_29,r_109_14_130,1.0,1,131,130,55
73,r_136_193_180,r_99_198_160,seq142,r_99_198_160,0.85,0,160,160,55
11,r_19_52_66,r_68_83_154,r_161_108_70,r_161_108_70,1.0,1,71,70,55
46,r_102_98_52,r_19_52_66,r_66_113_50,r_102_98_52,1.0,0,52,52,55
23,r_156_100_41,seq3,seq168,r_156_100_41,1.0,0,41,41,55
13,r_62_146_167,seq65,seq171,r_62_146_167,0.73,0,167,167,55
82,seq142,r_18_72_40,r_136_193_180,r_18_72_40,0.99,2,42,40,55
148,seq124,r_61_27_149,r_221_138_85,r_221_138_85,0.98,2,87,85,55
48,r_197_114_108,seq143,r_195_105_166,r_197_114_108,0.99,0,108,108,55
4,r_74_141_31,r_31_130_53,seq46,r_74_141_31,0.56,80,111,31,55
6,r_179_44_76,r_195_105_166,seq87,r_179_44_76,1.0,0,76,76,55
62,r_86_187_174,seq158,r_134_200_84,r_134_200_84,0.99,92,176,84,55
45,r_18_72_40,seq142,r_90_34_180,r_18_72_40,1.0,0,40,40,55
14,r_195_105_166,seq125,r_197_114_108,r_197_114_108,0.61,1,109,108,55
4,r_74_141_31,r_15_41_37,r_31_130_53,r_31_130_53,0.59,-19,34,53,55
27,r_90_34_180,r_174_190_136,r_18_72_40,r_90_34_180,0.83,-104,76,180,55
142,seq115,r_222_162_145,r_66_113_50,r_66_113_50,0.75,95,145,50,55
74,r_112_151_199,r_12_30_123,r_219_116_32,r_112_151_199,1.0,-132,67,199,55
18,r_67_37_98,r_62_146_167,seq16,r_67_37_98,0.74,0,98,98,55
29,r_22_133_74,r_54_8_94,r_203_202_74,r_22_133_74,1.0,3,77,74,55
130,seq184,r_88_117_28,r_2_95_11,r_88_117_28,0.68,-8,20,28,55
64,r_31_130_53,r_82_164_125,r_74_141_31,r_74_141_31,0.63,0,31,31,55
25,r_185_38_175,seq209,r_179_44_76,r_185_38_175,0.56,0,175,175,55
33,r_110_36_29,r_213_144_119,r_85_39_139,r_213_144_119,0.62,2,121,119,55
70,r_176_194_126,seq48,r_2_95_11,r_176_194_126,0.96,0,126,126,55
65,r_63_196_81,r_68_83_154,seq163,r_63_196_81,1.0,0,81,81,55
68,r_205_139_89,seq55,r_63_196_81,r_63_196_81,1.0,19,100,81,55
61,r_180_148_60,r_126_175_74,r_2_95_11,r_180_148_60,0.63,0,60,60,55
120,seq64,r_66_113_50,seq159,r_66_113_50,1.0,0,50,50,55
32,r_192_23_76,r_29_58_152,seq13,r_192_23_76,1.0,0,76,76,55
38,r_161_108_70,r_222_162_145,seq182,r_161_108_70,1.0,0,70,70,55
52,r_5_183_63,r_214_59_120,seq158,r_5_183_63,0.7,0,63,63,55
93,seq155,seq50,r_107_96_29,r_107_96_29,1.0,25,54,29,55
34,r_99_198_160,r_136_193_180,r_74_141_31,r_99_198_160,0.85,0,160,160,55
16,r_217_145_59,r_60_218_160,seq65,r_217_145_59,1.0,0,59,59,55
24,r_211_40_34,seq75,seq120,r_211_40_34,0.97,0,34,34,55
1,r_15_41_37,r_214_59_120,seq70,r_15_41_37,0.63,1,38,37,55
45,r_18_72_40,r_90_34_180,r_1_97_182,r_90_34_180,0.5,2,182,180,55
17,r_173_206_182,seq0,r_12_30_123,r_12_30_123,0.62,59,182,123,55
144,seq120,r_68_83_154,r_54_8_94,r_54_8_94,1.0,61,155,94,55
121,seq65,r_62_146_167,r_217_145_59,r_217_145_59,1.0,108,167,59,55
9,r_203_202_74,r_99_198_160,r_22_133_74,r_203_202_74,1.0,1,75,74,55
133,seq87,r_29_58_152,r_179_44_76,r_179_44_76,0.6,76,152,76,55
123,seq70,seq50,r_15_41_37,r_15_41_37,0.98,41,78,37,55
44,r_66_113_50,seq64,seq154,r_66_113_50,1.0,0,50,50,55
22,r_54_8_94,r_174_190_136,seq120,r_54_8_94,0.98,2,96,94,55
148,seq124,r_91_167_21,r_61_27_149,r_91_167_21,0.96,8,29,21,55
7,r_11_132_65,r_161_108_70,r_107_96_29,r_161_108_70,0.89,-5,65,70,55
118,seq188,r_134_200_84,r_22_133_74,r_134_200_84,0.82,0,84,84,55
48,r_197_114_108,r_195_105_166,r_110_36_29,r_195_105_166,0.76,1,167,166,55
57,r_107_96_29,r_161_108_70,seq155,r_107_96_29,1.0,0,29,29,55
35,r_88_117_28,seq122,seq46,r_88_117_28,0.99,3,31,28,55
64,r_31_130_53,r_74_141_31,r_15_41_37,r_31_130_53,0.66,-2,51,53,55
30,r_107_71_70,r_192_154_71,seq143,r_107_71_70,0.91,4,74,70,56
51,r_195_74_122,seq183,seq17,r_195_74_122,0.99,1,123,122,56
36,r_54_119_138,r_93_180_190,r_78_43_42,r_54_119_138,0.95,0,138,138,56
0,r_204_171_11,r_29_96_111,seq220,r_204_171_11,0.97,0,11,11,56
25,r_78_43_42,seq113,r_81_215_32,r_78_43_42,1.0,1,43,42,56
26,r_164_59_43,r_11_68_122,r_200_80_183,r_164_59_43,1.0,0,43,43,56
146,seq123,r_112_7_170,r_89_34_42,r_89_34_42,0.79,54,96,42,56
37,r_0_130_147,r_30_94_3,r_145_170_6,r_0_130_147,0.69,1,148,147,56
59,r_11_68_122,r_69_221_144,r_195_74_122,r_11_68_122,0.98,8,130,122,56
21,r_167_106_78,r_152_198_183,seq149,r_167_106_78,1.0,0,78,78,56
46,r_190_125_167,seq176,r_81_215_32,r_190_125_167,0.76,1,168,167,56
32,r_181_147_98,seq83,seq10,r_181_147_98,0.92,1,99,98,56
45,r_122_91_74,r_157_208_187,r_12_136_42,r_122_91_74,1.0,0,74,74,56
10,r_137_138_15,r_89_34_42,seq92,r_137_138_15,1.0,0,15,15,56
2,r_81_215_32,r_22_114_44,seq88,r_81_215_32,1.0,0,32,32,56
3,r_29_96_111,r_111_224_160,seq47,r_111_224_160,1.0,-44,116,160,56
34,r_42_163_47,r_141_196_170,r_164_59_43,r_42_163_47,0.7,1,48,47,56
4,r_53_133_131,seq17,seq50,r_53_133_131,0.92,0,131,131,56
63,r_48_5_85,seq21,seq142,r_48_5_85,1.0,0,85,85,56
73,r_166_49_166,seq47,seq36,r_166_49_166,0.62,0,166,166,56
134,seq92,seq175,r_137_138_15,r_137_138_15,1.0,0,15,15,56
44,r_148_58_36,r_112_7_170,seq161,r_148_58_36,1.0,-1,35,36,56
6,r_1_146_59,r_192_154_71,seq220,r_1_146_59,0.86,1,60,59,56
62,r_61_2_174,seq161,r_145_170_6,r_145_170_6,0.65,168,174,6,56
61,r_62_52_28,r_77_73_107,seq21,r_62_52_28,0.98,1,29,28,56
31,r_64_31_39,r_181_147_98,r_121_16_47,r_181_147_98,1.0,2,100,98,56
56,r_200_80_183,seq193,r_164_59_43,r_164_59_43,1.0,7,50,43,56
31,r_64_31_39,r_104_56_152,r_181_147_98,r_64_31_39,0.95,2,41,39,56
22,r_76_131_31,seq50,r_100_38_74,r_100_38_74,1.0,46,120,74,56
22,r_76_131_31,seq193,seq50,r_76_131_31,1.0,2,33,31,56
57,r_121_16_47,r_190_125_167,r_64_31_39,r_121_16_47,1.0,0,47,47,56
40,r_182_139_61,r_77_73_107,r_212_174_21,r_182_139_61,1.0,0,61,61,56
126,seq83,r_157_208_187,r_64_31_39,r_64_31_39,1.0,123,162,39,56
74,r_69_221_144,r_11_68_122,r_162_197_6,r_11_68_122,0.71,22,144,122,56
29,r_192_154_71,seq21,seq173,r_192_154_71,1.0,1,72,71,56
33,r_37_18_98,seq50,r_150_35_50,r_37_18_98,1.0,-1,97,98,56
67,r_99_32_8,seq14,r_60_223_30,r_60_223_30,0.96,28,58,30,56
9,r_140_19_44,seq187,seq193,r_140_19_44,1.0,0,44,44,56
50,r_102_127_104,seq177,r_184_207_80,r_102_127_104,0.99,0,104,104,56
70,r_85_28_62,r_75_189_69,seq50,r_85_28_62,1.0,0,62,62,56
68,r_152_198_183,seq151,r_167_106_78,r_167_106_78,1.0,105,183,78,56
130,seq87,seq161,r_115_51_46,r_115_51_46,1.0,34,80,46,56
32,r_181_147_98,seq193,seq83,r_181_147_98,0.65,-26,72,98,56
38,r_75_189_69,r_101_129_11,seq3,r_75_189_69,0.99,0,69,69,56
52,r_63_194_115,seq187,r_181_147_98,r_181_147_98,1.0,24,122,98,56
28,r_150_35_50,r_218_120_191,seq98,r_150_35_50,0.99,0,50,50,56
17,r_77_73_107,r_45_109_182,r_115_51_46,r_77_73_107,0.83,2,109,107,56
26,r_164_59_43,r_200_80_183,r_140_19_44,r_200_80_183,0.71,0,183,183,56
19,r_60_223_30,r_89_34_42,r_99_32_8,r_60_223_30,1.0,3,33,30,56
120,seq183,r_195_74_122,r_86_82_1,r_195_74_122,1.0,1,123,122,56
149,seq149,seq17,r_167_106_78,r_167_106_78,1.0,7,85,78,56
72,r_144_72_56,r_0_130_147,r_150_35_50,r_144_72_56,1.0,0,56,56,56
65,r_12_136_42,r_195_74_122,seq124,r_12_136_42,1.0,1,43,42,56
49,r_212_174_21,seq113,r_218_120_191,r_212_174_21,1.0,-1,20,21,56
11,r_115_51_46,r_219_191_198,seq87,r_115_51_46,1.0,0,46,46,56
12,r_100_38_74,r_53_133_131,r_76_131_31,r_100_38_74,0.85,0,74,74,56
128,seq142,r_168_203_134,r_48_5_85,r_48_5_85,1.0,60,145,85,56
58,r_202_97_39,r_53_133_131,seq161,r_202_97_39,1.0,1,40,39,56
30,r_18_78_88,r_141_66_130,r_208_48_66,r_18_78_88,1.0,0,88,88,57
44,r_220_125_117,seq70,seq39,r_220_125_117,1.0,0,117,117,57
51,r_164_176_174,seq27,r_129_6_116,r_164_176_174,0.49,0,174,174,57
26,r_208_48_66,seq70,r_224_204_109,r_208_48_66,0.88,0,66,66,57
14,r_151_148_92,r_96_157_168,r_38_74_14,r_96_157_168,1.0,-79,89,168,57
8,r_45_80_102,seq143,seq172,r_45_80_102,0.99,0,102,102,57
43,r_160_153_87,r_178_102_6,r_187_22_78,r_160_153_87,0.9,0,87,87,57
18,r_201_116_34,seq144,seq133,r_201_116_34,1.0,-2,32,34,57
69,r_107_118_25,r_145_87_98,seq70,r_107_118_25,0.98,0,25,25,57
59,r_53_97_105,seq65,r_41_216_55,r_53_97_105,0.79,0,105,105,57
55,r_183_156_146,seq163,r_178_102_6,r_183_156_146,0.88,0,146,146,57
71,r_92_124_129,r_121_196_175,r_201_116_34,r_201_116_34,0.86,97,131,34,57
21,r_192_94_163,r_215_8_179,seq143,r_215_8_179,0.7,-16,163,179,57
39,r_173_137_73,r_67_136_194,seq212,r_173_137_73,1.0,0,73,73,57
1,r_149_120_148,r_211_63_155,r_158_117_57,r_211_63_155,0.63,-7,148,155,57
97,seq36,r_25_55_113,r_46_128_77,r_46_128_77,1.0,56,133,77,57
57,r_178_102_6,seq185,r_115_179_179,r_178_102_6,0.35,100,106,6,57
46,r_154_171_156,seq170,r_175_47_6,r_154_171_156,0.81,0,156,156,57
4,r_180_24_59,seq86,seq212,r_180_24_59,1.0,0,59,59,57
11,r_54_71_22,r_41_216_55,r_101_159_146,r_101_159_146,0.87,29,175,146,57
19,r_217_139_104,r_129_6_116,seq20,r_217_139_104,0.96,0,104,104,57
5,r_2_52_52,seq199,seq194,r_2_52_52,0.89,0,52,52,57
11,r_54_71_22,r_18_78_88,r_41_216_55,r_18_78_88,0.99,0,88,88,57
66,r_211_63_155,seq163,r_173_137_73,r_211_63_155,0.87,1,156,155,57
129,seq212,seq42,r_173_137_73,r_173_137_73,1.0,1,74,73,57
41,r_168_83_61,r_19_106_112,r_175_47_6,r_168_83_61,1.0,0,61,61,57
11,r_54_71_22,r_3_147_58,r_18_78_88,r_54_71_22,0.97,1,23,22,57
67,r_40_62_90,seq195,seq184,r_40_62_90,1.0,0,90,90,57
89,seq26,r_11_181_140,seq199,r_11_181_140,1.0,0,140,140,57
10,r_25_55_113,seq36,seq58,r_25_55_113,0.61,17,130,113,57
115,seq64,r_88_75_162,seq104,r_88_75_162,0.8,0,162,162,57
72,r_141_66_130,r_18_78_88,r_41_216_55,r_141_66_130,0.74,-42,88,130,57
74,r_206_95_32,r_140_198_112,r_145_87_98,r_206_95_32,0.96,1,33,32,57
63,r_108_202_132,seq81,r_2_52_52,r_108_202_132,0.99,0,132,132,57
73,r_46_128_77,r_114_152_87,r_1_161_38,r_1_161_38,0.55,40,78,38,57
2,r_41_216_55,r_192_94_163,r_141_66_130,r_41_216_55,0.92,1,56,55,57
107,seq172,r_121_196_175,r_45_80_102,r_45_80_102,1.0,73,175,102,57
13,r_111_49_85,seq112,r_142_207_199,r_111_49_85,0.74,-4,81,85,57
98,seq165,r_134_76_174,r_155_190_107,r_155_190_107,1.0,67,174,107,57
48,r_96_157_168,seq123,seq59,r_96_157_168,0.83,0,168,168,57
57,r_178_102_6,r_160_153_87,seq185,r_160_153_87,0.88,1,88,87,57
45,r_4_37_55,r_177_34_158,seq29,r_4_37_55,1.0,1,56,55,57
6,r_129_6_116,r_119_15_164,r_4_37_55,r_129_6_116,0.99,0,116,116,57
74,r_206_95_32,r_145_87_98,r_160_153_87,r_206_95_32,0.99,66,98,32,57
2,r_41_216_55,r_141_66_130,r_53_97_105,r_41_216_55,1.0,75,130,55,57
5,r_2_52_52,seq194,r_108_202_132,r_108_202_132,1.0,10,142,132,57
93,seq133,seq10,r_201_116_34,r_201_116_34,1.0,-2,32,34,57
52,r_99_91_30,seq12,r_224_204_109,r_224_204_109,1.0,2,111,109,57
134,seq219,r_155_190_107,seq7,r_155_190_107,1.0,0,107,107,57
27,r_30_56_80,r_177_34_158,seq44,r_30_56_80,0.97,-1,79,80,57
87,seq20,seq13,r_217_139_104,r_217_139_104,1.0,1,105,104,57
26,r_208_48_66,r_224_204_109,r_18_78_88,r_224_204_109,0.79,0,109,109,57
47,r_101_159_146,seq193,r_54_71_22,r_54_71_22,1.0,138,160,22,57
25,r_84_14_24,r_114_152_87,r_33_0_4,r_114_152_87,0.9,-62,25,87,57
29,r_155_190_107,seq219,seq165,r_155_190_107,1.0,0,107,107,57
34,r_175_47_6,seq184,r_168_83_61,r_168_83_61,1.0,19,80,61,57
37,r_28_126_39,r_53_97_105,seq212,r_28_126_39,1.0,0,39,39,57
26,r_208_48_66,r_3_147_58,seq70,r_3_147_58,0.92,-30,28,58,57
49,r_224_204_109,r_208_48_66,r_99_91_30,r_224_204_109,1.0,0,109,109,57
33,r_213_222_182,r_215_8_179,r_30_56_80,r_30_56_80,0.64,102,182,80,57
64,r_140_198_112,seq130,r_132_21_82,r_140_198_112,0.93,4,116,112,57
50,r_127_223_100,seq165,r_111_49_85,r_127_223_100,0.94,0,100,100,57
61,r_215_8_179,r_41_216_55,r_167_73_54,r_167_73_54,1.0,2,56,54,57
70,r_88_75_162,seq64,seq169,r_88_75_162,0.9,0,162,162,57
44,r_220_125_117,r_201_116_34,seq70,r_201_116_34,0.91,2,36,34,57
65,r_209_210_84,r_11_181_140,seq113,r_209_210_84,1.0,-1,83,84,57
32,r_205_23_169,r_215_8_179,r_155_190_107,r_205_23_169,0.68,0,169,169,57
38,r_114_152_87,r_127_223_100,seq194,r_114_152_87,1.0,0,87,87,57
13,r_111_49_85,r_142_207_199,r_127_223_100,r_127_223_100,0.99,4,104,100,57
52,r_99_91_30,r_140_198_112,seq12,r_99_91_30,1.0,0,30,30,57
57,r_178_102_6,r_115_179_179,r_183_156_146,r_178_102_6,0.81,142,148,6,57
75,seq130,r_140_198_112,r_57_110_46,r_57_110_46,1.0,70,116,46,57
17,r_119_15_164,r_129_6_116,seq104,r_129_6_116,1.0,0,116,116,57
72,r_141_66_130,r_41_216_55,r_224_204_109,r_141_66_130,1.0,0,130,130,57
9,r_134_76_174,seq165,r_201_116_34,r_134_76_174,0.74,0,174,174,57
145,seq112,r_111_49_85,seq35,r_111_49_85,0.56,0,85,85,57
22,r_145_87_98,seq58,r_132_21_82,r_145_87_98,1.0,0,98,98,57
53,r_167_73_54,seq218,r_215_8_179,r_167_73_54,1.0,0,54,54,57
102,seq43,r_60_166_188,r_28_126_39,r_28_126_39,1.0,32,71,39,57
49,r_224_204_109,r_67_136_194,r_208_48_66,r_208_48_66,1.0,20,86,66,57
131,seq86,r_140_198_112,r_57_110_46,r_57_110_46,1.0,1,47,46,57
28,r_1_161_38,seq44,seq199,r_1_161_38,0.43,-10,28,38,57
56,r_187_22_78,r_101_159_146,r_206_95_32,r_187_22_78,1.0,0,78,78,57
23,r_69_61_97,r_11_181_140,r_151_148_92,r_69_61_97,1.0,1,98,97,57
20,r_3_147_58,r_40_62_90,seq185,r_3_147_58,1.0,0,58,58,57
35,r_115_179_179,seq86,r_177_34_158,r_177_34_158,0.63,21,179,158,57
30,r_4_130_139,seq200,r_52_53_18,r_4_130_139,0.58,0,139,139,58
44,r_79_45_135,r_7_209_34,r_147_81_62,r_79_45_135,0.98,0,135,135,58
51,r_216_115_171,seq192,r_160_176_161,r_216_115_171,0.75,0,171,171,58
36,r_103_208_117,r_121_108_155,r_101_203_91,r_103_208_117,1.0,3,120,117,58
124,seq202,r_85_134_18,r_181_23_132,r_181_23_132,1.0,22,154,132,58
14,r_69_96_138,r_167_63_177,seq43,r_69_96_138,0.99,0,138,138,58
8,r_210_104_81,seq178,seq56,r_210_104_81,1.0,1,82,81,58
43,r_217_128_87,r_89_40_171,seq29,r_217_128_87,0.99,0,87,87,58
17,r_80_106_55,r_201_138_197,seq83,r_80_106_55,1.0,1,56,55,58
54,r_7_209_34,r_79_45_135,r_74_92_110,r_7_209_34,0.74,92,126,34,58
59,r_198_110_137,seq91,seq166,r_198_110_137,0.86,0,137,137,58
40,r_50_20_15,r_4_130_139,seq18,r_50_20_15,0.93,0,15,15,58
86,seq22,seq143,r_117_32_113,r_117_32_113,1.0,11,124,113,58
16,r_47_222_102,seq202,r_214_211_1,r_47_222_102,1.0,0,102,102,58
1,r_59_185_115,r_149_77_197,seq113,r_149_77_197,0.52,-82,115,197,58
5,r_42_137_184,seq113,r_122_51_129,r_122_51_129,0.71,56,185,129,58
104,seq178,r_210_104_81,seq166,r_210_104_81,1.0,1,82,81,58
46,r_76_94_172,r_57_125_47,seq112,r_76_94_172,0.58,0,172,172,58
42,r_175_73_78,seq78,seq124,r_175_73_78,1.0,0,78,78,58
80,seq143,r_120_170_158,r_64_36_120,r_64_36_120,1.0,41,161,120,58
66,r_120_170_158,seq143,seq200,r_120_170_158,0.55,3,161,158,58
31,r_133_165_177,seq118,r_50_20_15,r_133_165_177,0.67,0,177,177,58
41,r_129_146_176,seq215,r_54_1_155,r_54_1_155,0.52,20,175,155,58
3,r_135_15_188,seq100,r_120_170_158,r_120_170_158,0.73,30,188,158,58
124,seq202,r_25_205_49,r_85_134_18,r_85_134_18,0.86,16,34,18,58
109,seq56,r_123_97_106,r_46_142_141,r_123_97_106,1.0,-1,105,106,58
26,r_64_36_120,seq159,seq143,r_64_36_120,0.96,0,120,120,58
139,seq100,r_135_15_188,r_123_97_106,r_123_97_106,1.0,20,126,106,58
71,r_75_87_16,seq224,seq215,r_75_87_16,1.0,0,16,16,58
4,r_123_97_106,seq56,seq100,r_123_97_106,1.0,0,106,106,58
0,r_57_125_47,r_76_94_172,r_103_208_117,r_103_208_117,0.95,55,172,117,58
63,r_2_184_129,seq131,seq39,r_2_184_129,0.98,0,129,129,58
114,seq189,r_122_51_129,r_33_30_91,r_122_51_129,0.95,-67,62,129,58
11,r_17_132_83,r_181_23_132,seq166,r_17_132_83,0.9,-1,82,83,58
39,r_12_190_48,r_133_165_177,seq221,r_12_190_48,0.94,1,49,48,58
20,r_167_63_177,seq179,r_160_176_161,r_160_176_161,0.49,16,177,161,58
47,r_10_206_18,r_140_158_3,seq131,r_10_206_18,1.0,2,20,18,58
15,r_54_1_155,seq114,r_67_24_120,r_54_1_155,0.52,0,155,155,58
44,r_79_45_135,seq95,r_7_209_34,r_7_209_34,0.99,1,35,34,58
57,r_147_81_62,r_31_152_162,seq78,r_147_81_62,1.0,0,62,62,58
34,r_21_61_56,seq155,r_187_86_153,r_21_61_56,1.0,0,56,56,58
6,r_89_40_171,seq221,r_187_86_153,r_187_86_153,0.71,19,172,153,58
62,r_34_182_136,seq27,seq88,r_34_182_136,0.98,0,136,136,58
54,r_7_209_34,r_3_119_103,r_79_45_135,r_7_209_34,0.99,0,34,34,58
74,r_187_86_153,r_21_61_56,seq163,r_187_86_153,0.6,0,153,153,58
99,seq43,seq88,r_69_96_138,r_69_96_138,1.0,6,144,138,58
52,r_11_99_28,r_127_116_149,seq27,r_127_116_149,0.99,0,149,149,58
45,r_25_205_49,seq202,seq93,r_25_205_49,0.71,1,50,49,58
134,seq220,r_31_152_162,r_174_150_43,r_174_150_43,0.92,120,163,43,58
27,r_149_77_197,r_59_185_115,r_21_61_56,r_21_61_56,1.0,59,115,56,58
48,r_153_9_35,r_168_102_174,seq95,r_153_9_35,1.0,0,35,35,58
73,r_140_158_3,r_10_206_18,seq202,r_10_206_18,0.85,2,20,18,58
2,r_160_176_161,seq13,r_47_222_102,r_160_176_161,0.5,1,162,161,58
142,seq107,r_122_51_129,r_33_30_91,r_122_51_129,1.0,0,129,129,58
74,r_187_86_153,r_59_185_115,r_21_61_56,r_21_61_56,1.0,10,66,56,58
29,r_127_116_149,r_57_125_47,r_11_99_28,r_11_99_28,1.0,48,76,28,58
10,r_44_154_49,seq183,seq155,r_44_154_49,1.0,0,49,49,58
34,r_21_61_56,r_187_86_153,r_59_185_115,r_187_86_153,0.99,0,153,153,58
25,r_193_196_63,r_117_32_113,seq28,r_193_196_63,1.0,0,63,63,58
33,r_181_23_132,seq112,seq202,r_181_23_132,1.0,0,132,132,58
127,seq207,r_31_152_162,r_174_150_43,r_174_150_43,0.79,49,92,43,58
19,r_68_37_56,r_69_96_138,seq35,r_68_37_56,0.97,0,56,56,58
64,r_55_199_133,seq98,r_67_24_120,r_55_199_133,0.97,0,133,133,58
18,r_186_162_35,r_193_196_63,seq109,r_186_162_35,0.95,2,37,35,58
50,r_136_156_138,r_160_176_161,r_25_205_49,r_136_156_138,1.0,0,138,138,58
58,r_141_197_93,r_55_199_133,seq29,r_141_197_93,0.56,0,93,93,58
70,r_65_213_179,seq194,r_17_132_83,r_17_132_83,0.98,96,179,83,58
136,seq95,r_79_45_135,r_153_9_35,r_153_9_35,0.98,0,35,35,58
68,r_101_203_91,seq14,seq178,r_101_203_91,0.97,0,91,91,58
61,r_117_32_113,seq223,seq22,r_117_32_113,1.0,0,113,113,58
38,r_85_134_18,r_186_162_35,seq202,r_85_134_18,0.66,3,21,18,58
23,r_174_150_43,r_198_110_137,seq207,r_174_150_43,1.0,0,43,43,58
65,r_5_145_15,r_186_162_35,seq60,r_5_145_15,0.84,0,15,15,58
144,seq112,r_181_23_132,r_218_66_65,r_218_66_65,0.68,67,132,65,58
29,r_127_116_149,r_11_99_28,r_59_185_115,r_127_116_149,0.98,0,149,149,58
22,r_173_139_175,seq82,r_68_37_56,r_173_139_175,0.77,0,175,175,58
28,r_3_119_103,r_168_102_174,r_47_222_102,r_168_102_174,0.95,-71,103,174,58
13,r_52_53_18,r_31_152_162,seq194,r_52_53_18,0.92,-1,17,18,58
49,r_218_66_65,r_69_96_138,seq183,r_218_66_65,1.0,-1,64,65,58
56,r_172_41_68,seq83,seq58,r_172_41_68,1.0,0,68,68,58
7,r_74_92_110,seq19,r_7_209_34,r_74_92_110,0.98,-1,109,110,58
138,seq98,r_55_199_133,r_57_125_47,r_55_199_133,1.0,0,133,133,58
35,r_90_84_144,seq58,seq107,r_90_84_144,0.96,0,144,144,58
128,seq82,r_173_139_175,r_174_150_43,r_174_150_43,0.95,133,176,43,58
30,r_106_40_92,seq57,seq108,r_106_40_92,1.0,0,92,92,59
9,r_39_93_42,r_223_195_178,r_131_11_24,r_39_93_42,1.0,1,43,42,59
36,r_42_113_99,r_37_20_133,r_192_176_63,r_42_113_99,1.0,0,99,99,59
6,r_140_7_125,r_158_185_70,r_224_65_142,r_140_7_125,0.84,11,136,125,59
54,r_120_85_50,r_83_117_74,seq142,r_120_85_50,1.0,0,50,50,59
8,r_101_90_117,r_193_105_145,r_28_206_111,r_193_105_145,0.61,-28,117,145,59
53,r_169_184_137,r_59_220_137,r_9_3_177,r_169_184_137,1.0,1,138,137,59
62,r_198_66_57,r_71_70_163,seq162,r_198_66_57,0.91,1,58,57,59
1,r_122_41_42,r_0_123_131,seq119,r_122_41_42,0.84,0,42,42,59
83,seq16,r_224_65_142,r_83_117_74,r_83_117_74,0.76,33,107,74,59
59,r_204_144_165,seq58,r_37_20_133,r_204_144_165,0.64,0,165,165,59
26,r_213_109_39,seq146,seq23,r_213_109_39,1.0,1,40,39,59
55,r_152_197_150,seq191,seq138,r_152_197_150,0.87,1,151,150,59
71,r_45_130_196,r_214_82_168,r_39_93_42,r_39_93_42,0.7,127,169,42,59
16,r_80_46_147,seq32,r_118_33_147,r_80_46_147,0.95,0,147,147,59
97,seq32,r_80_46_147,seq134,r_80_46_147,1.0,0,147,147,59
143,seq145,seq168,r_187_100_93,r_187_100_93,1.0,7,100,93,59
5,r_224_65_142,seq177,r_140_7_125,r_224_65_142,0.5,-37,105,142,59
104,seq172,r_183_166_97,seq1,r_183_166_97,0.98,2,99,97,59
46,r_196_43_193,r_14_174_114,r_131_11_24,r_196_43_193,0.6,-79,114,193,59
42,r_137_171_113,seq147,r_143_51_32,r_137_171_113,0.83,0,113,113,59
43,r_143_51_32,r_19_44_138,seq49,r_143_51_32,0.89,0,32,32,59
69,r_34_132_151,r_15_186_98,r_60_91_171,r_34_132_151,0.52,0,151,151,59
14,r_72_161_132,seq153,r_31_173_37,r_31_173_37,1.0,4,41,37,59
45,r_182_219_79,seq78,seq162,r_182_219_79,1.0,3,82,79,59
64,r_217_30_39,seq134,seq6,r_217_30_39,1.0,1,40,39,59
38,r_215_87_32,seq55,seq17,r_215_87_32,1.0,0,32,32,59
66,r_118_33_147,r_189_154_80,r_80_46_147,r_118_33_147,0.98,0,147,147,59
129,seq78,r_182_219_79,seq54,r_182_219_79,1.0,3,82,79,59
67,r_68_35_109,r_164_36_146,r_143_51_32,r_164_36_146,0.85,-34,112,146,59
89,seq222,r_223_195_178,r_59_220_137,r_59_220_137,1.0,2,139,137,59
20,r_24_127_17,r_83_117_74,seq77,r_24_127_17,0.99,0,17,17,59
37,r_179_167_16,r_9_3_177,seq69,r_179_167_16,0.93,-1,15,16,59
3,r_214_82_168,r_45_130_196,r_183_166_97,r_214_82_168,0.79,1,169,168,59
10,r_25_22_66,r_0_123_131,seq67,r_25_22_66,0.99,6,72,66,59
90,seq23,r_199_149_158,r_213_109_39,r_213_109_39,0.56,49,88,39,59
72,r_158_185_70,r_83_117_74,r_140_7_125,r_140_7_125,0.83,-52,73,125,59
14,r_72_161_132,r_31_173_37,seq202,r_72_161_132,0.99,0,132,132,59
4,r_15_186_98,r_34_132_151,r_25_22_66,r_15_186_98,0.75,-3,95,98,59
63,r_28_206_111,r_180_104_151,seq201,r_28_206_111,0.99,0,111,111,59
73,r_200_103_78,seq209,r_150_151_1,r_200_103_78,1.0,0,78,78,59
11,r_187_100_93,r_19_44_138,seq145,r_187_100_93,0.99,1,94,93,59
13,r_223_195_178,seq222,r_2_62_16,r_2_62_16,0.9,162,178,16,59
18,r_175_98_36,seq48,seq159,r_175_98_36,0.78,0,36,36,59
15,r_189_154_80,r_118_33_147,seq191,r_118_33_147,0.94,-48,99,147,59
49,r_211_8_181,r_111_74_50,seq148,r_211_8_181,0.42,1,182,181,59
57,r_37_20_133,seq73,r_217_30_39,r_37_20_133,0.58,0,133,133,59
106,seq47,seq177,r_83_117_74,r_83_117_74,1.0,27,101,74,59
6,r_140_7_125,r_101_90_117,r_158_185_70,r_140_7_125,0.74,-47,78,125,59
0,r_31_173_37,r_72_161_132,seq203,r_72_161_132,1.0,0,132,132,59
39,r_126_97_38,r_101_90_117,r_150_151_1,r_126_97_38,1.0,0,38,38,59
87,seq148,r_194_160_119,seq75,r_194_160_119,0.98,0,119,119,59
12,r_218_53_48,r_60_91_171,r_143_51_32,r_218_53_48,1.0,0,48,48,59
69,r_34_132_151,r_60_91_171,r_136_170_194,r_60_91_171,1.0,0,171,171,59
2,r_71_70_163,r_60_91_171,r_224_65_142,r_71_70_163,0.82,0,163,163,59
40,r_9_3_177,seq95,r_169_184_137,r_169_184_137,1.0,11,148,137,59
74,r_128_99_71,r_9_3_177,seq209,r_128_99_71,0.99,1,72,71,59
29,r_12_121_110,r_71_70_163,r_15_186_98,r_12_121_110,0.95,0,110,110,59
24,r_164_36_146,seq181,seq108,r_164_36_146,0.96,0,146,146,59
25,r_114_76_130,seq17,seq26,r_114_76_130,0.93,2,132,130,59
19,r_110_141_41,seq108,seq168,r_110_141_41,1.0,0,41,41,59
33,r_59_220_137,seq26,seq222,r_59_220_137,0.88,0,137,137,59
48,r_111_74_50,r_211_8_181,r_15_186_98,r_111_74_50,0.43,117,167,50,59
88,seq21,r_0_123_131,seq205,r_0_123_131,1.0,-12,119,131,59
50,r_180_104_151,seq188,r_137_171_113,r_180_104_151,0.63,0,151,151,59
70,r_19_44_138,seq88,seq5,r_19_44_138,1.0,0,138,138,59
47,r_131_11_24,r_84_163_137,r_14_174_114,r_14_174_114,0.57,-90,24,114,59
65,r_193_105_145,seq69,r_175_98_36,r_175_98_36,0.51,113,149,36,59
68,r_0_123_131,seq21,seq54,r_0_123_131,0.99,0,131,131,59
61,r_183_166_97,seq172,r_128_99_71,r_183_166_97,1.0,0,97,97,59
47,r_131_11_24,r_14_174_114,r_39_93_42,r_14_174_114,0.81,-34,80,114,59
52,r_192_176_63,seq6,seq222,r_192_176_63,1.0,1,64,63,59
0,r_31_173_37,seq115,r_72_161_132,r_31_173_37,0.96,5,42,37,59
34,r_14_174_114,r_196_43_193,seq48,r_14_174_114,0.99,0,114,114,59
48,r_111_74_50,r_216_210_52,r_211_8_181,r_216_210_52,0.47,-2,50,52,59
49,r_211_8_181,r_4_116_109,r_111_74_50,r_211_8_181,0.88,-131,50,181,59
60,r_79_10_80,seq57,r_150_151_1,r_79_10_80,1.0,0,80,80,59
144,seq108,r_223_195_178,r_164_36_146,r_164_36_146,1.0,26,172,146,59
22,r_83_117_74,r_164_36_146,seq16,r_83_117_74,0.79,5,79,74,59
28,r_27_64_187,seq48,r_175_98_36,r_175_98_36,0.91,153,189,36,59
72,r_158_185_70,r_140_7_125,r_194_160_119,r_158_185_70,0.87,66,136,70,59
56,r_84_163_137,seq162,r_24_127_17,r_84_163_137,0.96,0,137,137,59
7,r_199_149_158,seq23,r_122_41_42,r_199_149_158,0.66,1,159,158,59
23,r_216_210_52,r_111_74_50,seq5,r_216_210_52,1.0,-2,50,52,59
131,seq208,r_14_174_114,r_131_11_24,r_14_174_114,0.79,-33,81,114,59
101,seq177,r_139_107_160,r_83_117_74,r_83_117_74,0.92,0,74,74,59
128,seq77,r_37_20_133,r_24_127_17,r_37_20_133,0.54,-27,106,133,59
51,r_186_224_95,seq103,seq171,r_186_224_95,1.0,0,95,95,60
8,r_92_150_107,seq204,seq162,r_92_150_107,0.54,0,107,107,60
30,r_75_142_121,seq9,r_57_198_33,r_57_198_33,1.0,2,35,33,60
87,seq21,r_56_38_151,r_148_8_29,r_148_8_29,1.0,0,29,29,60
54,r_207_182_62,r_164_66_89,r_44_128_141,r_207_182_62,1.0,0,62,62,60
37,r_44_128_141,r_4_156_98,r_177_165_78,r_44_128_141,1.0,-64,77,141,60
53,r_177_165_78,seq29,r_83_99_11,r_177_165_78,0.58,-54,24,78,60
31,r_196_93_17,r_110_32_135,r_44_128_141,r_196_93_17,0.96,-2,15,17,60
55,r_211_188_125,seq30,seq141,r_211_188_125,0.95,1,126,125,60
71,r_3_130_62,r_207_182_62,seq77,r_3_130_62,1.0,0,62,62,60
21,r_190_68_175,r_19_127_154,seq80,r_19_127_154,0.4,-38,116,154,60
118,seq204,r_39_79_153,r_55_72_11,r_39_79_153,0.86,-119,34,153,60
1,r_39_79_153,r_60_105_149,seq126,r_60_105_149,0.52,4,153,149,60
97,seq40,r_120_195_187,r_24_223_85,r_24_223_85,1.0,104,189,85,60
39,r_216_7_18,r_46_113_178,seq153,r_216_7_18,0.63,0,18,18,60
5,r_56_38_151,seq212,seq53,r_56_38_151,0.89,0,151,151,60
104,seq157,r_67_185_81,r_18_35_171,r_67_185_81,0.81,-6,75,81,60
42,r_110_32_135,seq170,r_211_188_125,r_211_188_125,0.97,10,135,125,60
69,r_19_127_154,r_190_68_175,seq171,r_190_68_175,0.76,-20,155,175,60
45,r_175_132_179,r_209_102_194,r_167_23_151,r_209_102_194,0.43,-15,179,194,60
53,r_177_165_78,r_83_99_11,r_44_128_141,r_177_165_78,1.0,0,78,78,60
19,r_202_194_19,r_189_206_159,seq141,r_202_194_19,0.98,0,19,19,60
41,r_159_28_11,r_84_135_111,seq47,r_159_28_11,0.87,0,11,11,60
147,seq124,r_129_205_153,r_45_134_50,r_45_134_50,0.99,0,50,50,60
66,r_15_180_66,seq208,r_31_104_47,r_15_180_66,0.95,-1,65,66,60
76,seq171,r_221_94_149,r_19_127_154,r_19_127_154,0.5,1,155,154,60
46,r_189_206_159,r_46_113_178,r_98_78_100,r_189_206_159,0.66,-54,105,159,60
16,r_31_104_47,r_199_0_89,r_15_180_66,r_15_180_66,0.85,11,77,66,60
39,r_216_7_18,seq153,r_84_135_111,r_84_135_111,1.0,12,123,111,60
68,r_51_88_139,r_33_166_178,seq218,r_33_166_178,1.0,0,178,178,60
67,r_178_71_74,seq172,seq112,r_178_71_74,1.0,0,74,74,60
72,r_98_78_100,r_92_150_107,r_189_206_159,r_98_78_100,0.77,2,102,100,60
9,r_33_166_178,r_167_23_151,r_51_88_139,r_33_166_178,0.94,-36,142,178,60
4,r_84_135_111,r_33_166_178,r_216_7_18,r_33_166_178,0.54,-67,111,178,60
73,r_67_185_81,seq157,seq222,r_67_185_81,0.97,1,82,81,60
11,r_37_11_83,seq222,seq30,r_37_11_83,0.56,1,84,83,60
20,r_152_109_72,r_67_185_81,r_196_93_17,r_196_93_17,1.0,55,72,17,60
13,r_95_149_154,seq115,r_184_20_141,r_95_149_154,0.62,0,154,154,60
46,r_189_206_159,r_12_52_79,r_46_113_178,r_12_52_79,0.79,1,80,79,60
48,r_60_105_149,r_39_79_153,seq153,r_39_79_153,0.51,-2,151,153,60
7,r_45_134_50,seq153,seq124,r_45_134_50,1.0,-2,48,50,60
26,r_57_198_33,r_121_65_130,r_75_142_121,r_57_198_33,1.0,-2,31,33,60
57,r_96_34_169,seq141,seq9,r_96_34_169,0.54,0,169,169,60
16,r_31_104_47,seq43,r_199_0_89,r_31_104_47,1.0,0,47,47,60
6,r_184_20_141,seq204,r_14_48_135,r_184_20_141,0.59,6,147,141,60
62,r_174_118_140,seq168,r_24_223_85,r_24_223_85,1.0,56,141,85,60
99,seq42,r_70_213_125,seq172,r_70_213_125,1.0,1,126,125,60
72,r_98_78_100,r_189_206_159,r_54_193_105,r_189_206_159,1.0,2,161,159,60
27,r_14_48_135,seq85,seq157,r_14_48_135,0.91,0,135,135,60
30,r_75_142_121,r_57_198_33,seq155,r_75_142_121,0.91,0,121,121,60
2,r_63_139_91,seq47,seq219,r_63_139_91,1.0,0,91,91,60
47,r_221_94_149,seq171,seq172,r_221_94_149,0.4,1,150,149,60
40,r_160_181_74,r_75_142_121,seq158,r_160_181_74,0.49,2,76,74,60
46,r_189_206_159,r_202_194_19,r_12_52_79,r_202_194_19,0.62,0,19,19,60
15,r_106_147_53,r_96_34_169,seq222,r_106_147_53,1.0,0,53,53,60
25,r_4_156_98,r_44_128_141,r_12_52_79,r_4_156_98,0.81,0,98,98,60
10,r_173_200_36,seq183,r_55_72_11,r_173_200_36,1.0,0,36,36,60
33,r_54_193_105,seq101,r_98_78_100,r_54_193_105,0.95,0,105,105,60
64,r_121_65_130,seq155,r_37_11_83,r_121_65_130,0.76,-10,120,130,60
58,r_117_143_10,r_84_135_111,seq27,r_117_143_10,0.76,0,10,10,60
50,r_131_161_61,r_167_23_151,seq112,r_131_161_61,1.0,0,61,61,60
70,r_169_90_92,r_56_38_151,seq80,r_169_90_92,0.83,1,93,92,60
68,r_51_88_139,r_129_205_153,r_33_166_178,r_129_205_153,0.88,-14,139,153,60
137,seq111,r_18_35_171,r_45_134_50,r_45_134_50,0.86,121,171,50,60
61,r_76_26_114,seq61,r_73_58_14,r_73_58_14,0.46,100,114,14,60
38,r_64_91_101,seq16,seq40,r_64_91_101,0.99,0,101,101,60
77,seq133,r_214_50_85,seq61,r_214_50_85,1.0,-9,76,85,60
34,r_100_97_117,r_33_166_178,seq17,r_100_97_117,0.87,3,120,117,60
75,seq2,seq10,r_151_1_61,r_151_1_61,1.0,8,69,61,60
60,r_197_87_134,seq114,seq80,r_197_87_134,0.79,0,134,134,60
17,r_12_52_79,seq203,seq16,r_12_52_79,0.98,0,79,79,60
18,r_83_99_11,r_56_38_151,r_177_165_78,r_83_99_11,0.57,0,11,11,60
144,seq212,r_56_38_151,r_24_223_85,r_24_223_85,0.94,66,151,85,60
9,r_33_166_178,r_100_97_117,r_167_23_151,r_100_97_117,0.84,3,120,117,60
26,r_57_198_33,r_75_142_121,seq9,r_75_142_121,1.0,-3,118,121,60
22,r_24_223_85,seq27,seq21,r_24_223_85,1.0,0,85,85,60
12,r_73_58_14,r_106_147_53,r_76_26_114,r_73_58_14,0.99,1,15,14,60
28,r_70_213_125,seq42,r_37_11_83,r_70_213_125,0.98,1,126,125,60
49,r_151_1_61,r_197_87_134,seq2,r_151_1_61,1.0,0,61,61,60
140,seq114,r_197_87_134,seq125,r_197_87_134,1.0,0,134,134,60
21,r_190_68_175,seq80,seq41,r_190_68_175,1.0,-1,174,175,60
56,r_164_66_89,seq171,r_173_200_36,r_164_66_89,0.56,-2,87,89,60
46,r_189_206_159,r_98_78_100,seq183,r_189_206_159,1.0,2,161,159,60
18,r_83_99_11,r_177_165_78,seq172,r_177_165_78,1.0,0,78,78,60
44,r_49_59_102,seq36,seq171,r_49_59_102,0.97,0,102,102,60
9,r_33_166_178,r_51_88_139,r_129_205_153,r_33_166_178,0.97,0,178,178,60
23,r_46_113_178,seq162,r_63_139_91,r_63_139_91,0.94,87,178,91,60
80,seq9,r_57_198_33,r_96_34_169,r_96_34_169,1.0,8,177,169,60
51,r_75_85_188,seq64,r_143_121_31,r_143_121_31,0.95,159,190,31,61
48,r_114_210_136,r_63_203_74,r_145_44_126,r_114_210_136,1.0,0,136,136,61
122,seq69,r_108_154_127,r_169_79_106,r_169_79_106,0.49,24,130,106,61
92,seq25,seq171,r_55_66_81,r_55_66_81,1.0,1,82,81,61
14,r_124_31_147,seq69,r_63_203_74,r_124_31_147,0.91,1,148,147,61
53,r_107_113_66,seq129,r_127_13_82,r_107_113_66,0.88,0,66,66,61
29,r_218_139_86,r_207_202_34,seq92,r_218_139_86,0.75,5,91,86,61
125,seq74,seq57,r_186_148_77,r_186_148_77,1.0,5,82,77,61
127,seq224,r_21_18_37,r_190_53_30,r_190_53_30,0.85,15,45,30,61
54,r_86_149_75,seq211,seq7,r_86_149_75,1.0,0,75,75,61
37,r_169_79_106,seq123,seq69,r_169_79_106,1.0,0,106,106,61
26,r_178_59_21,r_37_137_163,seq101,r_178_59_21,1.0,0,21,21,61
55,r_151_110_103,seq101,r_109_158_104,r_151_110_103,0.99,1,104,103,61
71,r_125_100_128,seq220,r_159_106_50,r_125_100_128,0.7,0,128,128,61
72,r_130_41_165,r_111_168_60,r_28_155_23,r_130_41_165,0.65,-143,22,165,61
21,r_58_103_15,r_108_154_127,seq118,r_58_103_15,0.65,55,70,15,61
1,r_207_202_34,r_218_139_86,r_143_121_31,r_143_121_31,0.52,77,108,31,61
5,r_97_47_131,r_201_176_116,r_71_196_115,r_201_176_116,1.0,1,117,116,61
46,r_170_102_76,r_151_110_103,r_8_172_68,r_170_102_76,1.0,0,76,76,61
61,r_194_82_27,r_125_100_128,seq101,r_194_82_27,1.0,0,27,27,61
80,seq6,r_117_94_152,r_109_158_104,r_109_158_104,0.69,15,119,104,61
69,r_201_176_116,r_97_47_131,r_48_90_10,r_201_176_116,0.99,1,117,116,61
45,r_186_148_77,seq36,seq74,r_186_148_77,1.0,1,78,77,61
70,r_48_90_10,r_117_94_152,seq142,r_48_90_10,0.86,0,10,10,61
19,r_67_34_70,seq3,seq175,r_67_34_70,0.96,1,71,70,61
66,r_183_116_144,seq56,r_174_112_59,r_183_116_144,0.94,0,144,144,61
21,r_58_103_15,r_152_198_115,r_17_216_138,r_58_103_15,0.84,119,134,15,61
78,seq4,r_184_208_146,r_162_0_137,r_184_208_146,1.0,-5,141,146,61
1,r_207_202_34,r_170_102_76,r_218_139_86,r_207_202_34,0.67,1,35,34,61
48,r_114_210_136,seq224,r_63_203_74,r_114_210_136,0.89,-49,87,136,61
31,r_63_203_74,r_170_102_76,r_114_210_136,r_63_203_74,0.83,0,74,74,61
98,seq35,seq32,r_78_144_23,r_78_144_23,1.0,14,37,23,61
3,r_108_154_127,seq69,r_71_196_115,r_108_154_127,0.93,1,128,127,61
10,r_117_94_152,seq6,seq12,r_117_94_152,0.64,0,152,152,61
17,r_42_160_145,r_78_144_23,seq138,r_42_160_145,0.85,5,150,145,61
113,seq57,seq156,r_174_112_59,r_174_112_59,1.0,17,76,59,61
16,r_43_200_7,r_71_196_115,r_197_146_67,r_197_146_67,1.0,10,77,67,61
27,r_188_120_15,r_11_88_57,seq123,r_188_120_15,1.0,0,15,15,61
78,seq4,r_8_172_68,r_184_208_146,r_8_172_68,0.98,1,69,68,61
63,r_17_216_138,seq24,r_58_103_15,r_17_216_138,0.98,1,139,138,61
11,r_162_0_137,seq54,seq4,r_162_0_137,0.84,0,137,137,61
12,r_159_106_50,seq175,seq93,r_159_106_50,1.0,0,50,50,61
138,seq96,seq68,r_11_88_57,r_11_88_57,1.0,0,57,57,61
53,r_107_113_66,r_127_13_82,seq56,r_127_13_82,0.75,-1,81,82,61
6,r_161_173_137,r_42_160_145,r_71_196_115,r_161_173_137,0.75,0,137,137,61
62,r_49_52_149,seq140,seq175,r_49_52_149,0.9,1,150,149,61
8,r_11_88_57,seq5,seq96,r_11_88_57,1.0,0,57,57,61
73,r_89_182_45,r_114_210_136,seq93,r_89_182_45,0.98,0,45,45,61
2,r_128_165_68,seq69,r_215_84_42,r_128_165_68,1.0,0,68,68,61
41,r_21_18_37,seq189,r_70_26_148,r_70_26_148,0.99,1,149,148,61
47,r_72_27_115,seq223,r_63_203_74,r_72_27_115,0.57,2,117,115,61
40,r_55_66_81,seq175,seq25,r_55_66_81,1.0,0,81,81,61
18,r_197_146_67,r_126_80_160,r_43_200_7,r_197_146_67,0.93,2,69,67,61
24,r_184_208_146,r_163_192_172,seq6,r_184_208_146,0.85,1,147,146,61
33,r_167_187_113,seq175,seq56,r_167_187_113,0.82,0,113,113,61
64,r_152_198_115,seq54,seq175,r_152_198_115,0.83,27,142,115,61
41,r_21_18_37,r_159_106_50,seq189,r_159_106_50,1.0,-9,41,50,61
42,r_45_10_15,r_147_135_181,seq56,r_45_10_15,0.96,-1,14,15,61
103,seq129,r_107_113_66,seq140,r_107_113_66,1.0,-10,56,66,61
50,r_132_141_110,seq153,seq223,r_132_141_110,0.96,0,110,110,61
59,r_174_112_59,r_63_203_74,seq57,r_174_112_59,0.96,0,59,59,61
58,r_163_192_172,seq33,r_143_121_31,r_143_121_31,0.63,143,174,31,61
57,r_205_50_27,r_162_0_137,seq57,r_205_50_27,1.0,0,27,27,61
65,r_119_221_111,seq115,seq24,r_119_221_111,1.0,0,111,111,61
36,r_126_80_160,r_197_146_67,r_87_180_44,r_126_80_160,0.65,-110,50,160,61
68,r_29_23_164,seq64,r_28_155_23,r_29_23_164,0.49,0,164,164,61
38,r_127_13_82,seq223,r_125_100_128,r_127_13_82,0.93,0,82,82,61
52,r_8_172_68,seq4,r_87_180_44,r_8_172_68,0.71,1,69,68,61
22,r_91_30_49,r_119_221_111,seq223,r_91_30_49,0.97,0,49,49,61
28,r_28_155_23,r_78_144_23,r_130_41_165,r_130_41_165,1.0,-143,22,165,61
38,r_127_13_82,r_125_100_128,r_193_15_90,r_125_100_128,1.0,0,128,128,61
34,r_193_15_90,r_117_94_152,r_127_13_82,r_127_13_82,0.67,8,90,82,61
124,seq140,r_49_52_149,r_86_149_75,r_86_149_75,0.47,75,150,75,61
48,r_114_210_136,r_89_182_45,seq224,r_114_210_136,0.97,-87,49,136,61
13,r_87_180_44,seq25,r_126_80_160,r_87_180_44,1.0,0,44,44,61
81,seq7,r_145_44_126,r_86_149_75,r_86_149_75,0.94,32,107,75,61
17,r_42_160_145,r_161_173_137,r_78_144_23,r_78_144_23,0.99,114,137,23,61
9,r_109_158_104,r_161_173_137,r_151_110_103,r_109_158_104,0.98,0,104,104,61
31,r_63_203_74,r_114_210_136,r_72_27_115,r_114_210_136,0.86,0,136,136,61
0,r_143_121_31,seq177,seq39,r_143_121_31,1.0,1,32,31,61
21,r_58_103_15,seq118,r_152_198_115,r_152_198_115,0.5,-1,114,115,61
28,r_28_155_23,r_130_41_165,r_29_23_164,r_28_155_23,0.7,142,165,23,61
91,seq24,r_17_216_138,r_119_221_111,r_119_221_111,0.55,28,139,111,61
49,r_204_16_90,r_17_216_138,r_174_112_59,r_204_16_90,1.0,0,90,90,61
72,r_130_41_165,r_28_155_23,r_86_149_75,r_86_149_75,0.97,90,165,75,61
140,seq217,r_70_26_148,r_61_38_158,r_70_26_148,0.97,0,148,148,61
56,r_70_26_148,seq217,r_21_18_37,r_70_26_148,0.76,0,148,148,61
44,r_145_44_126,r_49_52_149,seq25,r_145_44_126,0.98,0,126,126,61
118,seq64,r_75_85_188,r_108_154_127,r_108_154_127,0.99,61,188,127,61
29,r_218_139_86,r_11_88_57,r_207_202_34,r_207_202_34,0.76,3,37,34,61
12,r_131_120_128,r_86_208_59,r_45_18_49,r_131_120_128,1.0,0,128,128,62
36,r_202_167_105,r_25_218_136,r_75_98_68,r_75_98_68,1.0,37,105,68,62
14,r_39_94_77,r_107_174_156,seq196,r_39_94_77,1.0,0,77,77,62
8,r_74_80_90,seq33,r_7_158_71,r_7_158_71,0.97,21,92,71,62
53,r_199_89_61,r_184_194_179,r_84_172_50,r_199_89_61,0.82,3,64,61,62
43,r_61_97_164,r_131_120_128,r_186_183_15,r_61_97_164,0.68,-150,14,164,62
71,r_54_146_145,seq67,r_152_58_142,r_152_58_142,0.69,4,146,142,62
21,r_100_46_125,seq93,r_220_16_59,r_100_46_125,0.66,0,125,125,62
39,r_34_35_119,r_26_15_165,r_39_94_77,r_39_94_77,0.71,45,122,77,62
5,r_76_209_108,seq205,r_27_179_44,r_76_209_108,0.98,1,109,108,62
32,r_84_172_50,r_212_23_186,seq81,r_84_172_50,1.0,0,50,50,62
46,r_176_128_74,r_74_80_90,seq37,r_176_128_74,1.0,1,75,74,62
42,r_213_123_121,r_25_218_136,r_39_94_77,r_39_94_77,0.7,46,123,77,62
111,seq201,r_26_15_165,r_180_215_109,r_180_215_109,1.0,58,167,109,62
69,r_212_23_186,seq37,r_14_147_73,r_212_23_186,0.25,0,186,186,62
45,r_112_40_79,r_65_122_123,r_193_66_195,r_65_122_123,0.96,-37,86,123,62
47,r_187_41_50,r_29_150_97,seq134,r_187_41_50,0.57,47,97,50,62
35,r_223_6_50,seq63,seq53,r_223_6_50,1.0,1,51,50,62
30,r_156_219_44,r_29_150_97,seq222,r_156_219_44,1.0,0,44,44,62
19,r_86_208_59,seq69,r_131_120_128,r_86_208_59,0.86,2,61,59,62
57,r_12_135_16,r_43_124_92,seq153,r_12_135_16,1.0,0,16,16,62
66,r_138_103_59,seq204,seq214,r_138_103_59,1.0,2,61,59,62
78,seq133,seq48,r_107_174_156,r_107_174_156,1.0,15,171,156,62
31,r_43_124_92,r_131_120_128,seq189,r_43_124_92,0.65,0,92,92,62
41,r_165_106_69,r_159_168_177,r_50_190_22,r_165_106_69,0.98,0,69,69,62
67,r_90_173_110,seq196,seq64,r_90_173_110,0.72,0,110,110,62
3,r_25_218_136,seq153,r_186_183_15,r_25_218_136,0.78,0,136,136,62
90,seq149,r_159_168_177,r_224_21_79,r_224_21_79,0.65,6,85,79,62
109,seq178,r_112_40_79,r_14_147_73,r_14_147_73,1.0,17,90,73,62
115,seq189,seq37,r_43_124_92,r_43_124_92,1.0,16,108,92,62
26,r_7_158_71,r_200_117_191,seq170,r_7_158_71,0.99,0,71,71,62
139,seq222,seq204,r_156_219_44,r_156_219_44,1.0,48,92,44,62
4,r_157_102_154,r_132_121_113,r_165_106_69,r_132_121_113,0.55,40,153,113,62
63,r_24_19_169,r_193_66_195,r_52_3_105,r_52_3_105,0.92,72,177,105,62
16,r_50_190_22,seq48,seq82,r_50_190_22,0.98,0,22,22,62
73,r_141_163_129,r_25_218_136,r_191_31_120,r_141_163_129,0.56,1,130,129,62
11,r_79_182_56,r_157_102_154,r_156_219_44,r_79_182_56,0.81,11,67,56,62
20,r_52_3_105,r_152_58_142,r_223_6_50,r_52_3_105,0.62,0,105,105,62
13,r_119_198_95,seq214,seq17,r_119_198_95,1.0,2,97,95,62
38,r_71_4_51,r_54_146_145,seq93,r_71_4_51,0.99,0,51,51,62
78,seq133,r_27_179_44,seq48,r_27_179_44,0.74,12,56,44,62
10,r_144_216_27,r_155_211_82,seq137,r_144_216_27,0.99,1,28,27,62
15,r_14_147_73,r_131_120_128,seq178,r_14_147_73,1.0,0,73,73,62
48,r_217_109_85,seq82,r_7_158_71,r_217_109_85,0.91,0,85,85,62
47,r_187_41_50,r_65_122_123,r_29_150_97,r_187_41_50,0.98,0,50,50,62
6,r_171_49_104,seq17,r_74_80_90,r_171_49_104,0.99,1,105,104,62
47,r_187_41_50,seq134,r_191_31_120,r_187_41_50,0.77,70,120,50,62
22,r_197_9_32,r_74_80_90,seq214,r_197_9_32,0.97,1,33,32,62
1,r_45_18_49,seq196,seq20,r_45_18_49,1.0,0,49,49,62
2,r_65_122_123,seq178,seq63,r_65_122_123,1.0,0,123,123,62
74,r_159_168_177,seq196,seq67,r_159_168_177,0.45,0,177,177,62
18,r_180_215_109,r_220_16_59,r_52_3_105,r_180_215_109,0.47,-2,107,109,62
29,r_193_66_195,r_24_19_169,r_112_40_79,r_193_66_195,0.57,-31,164,195,62
24,r_152_58_142,seq47,r_43_124_92,r_152_58_142,0.8,0,142,142,62
37,r_192_188_39,seq36,seq92,r_192_188_39,0.98,0,39,39,62
64,r_91_96_109,r_115_177_192,r_13_129_107,r_115_177_192,0.38,-82,110,192,62
59,r_27_179_44,seq133,r_108_151_49,r_108_151_49,0.64,7,56,49,62
19,r_86_208_59,r_131_120_128,r_61_97_164,r_131_120_128,1.0,-28,100,128,62
50,r_107_174_156,seq136,seq133,r_107_174_156,0.72,0,156,156,62
58,r_72_99_86,r_119_198_95,r_144_216_27,r_72_99_86,0.99,0,86,86,62
68,r_224_21_79,seq104,seq149,r_224_21_79,0.99,0,79,79,62
61,r_75_98_68,r_32_55_161,r_86_208_59,r_75_98_68,0.99,0,68,68,62
52,r_114_175_138,r_221_101_179,r_191_31_120,r_114_175_138,0.89,0,138,138,62
34,r_132_121_113,r_157_102_154,r_74_80_90,r_132_121_113,0.49,3,116,113,62
40,r_186_183_15,r_26_15_165,r_61_97_164,r_61_97_164,0.47,-150,14,164,62
60,r_116_60_118,r_54_146_145,r_52_3_105,r_116_60_118,0.92,0,118,118,62
17,r_184_194_179,seq206,r_156_219_44,r_156_219_44,0.61,135,179,44,62
119,seq196,r_159_168_177,r_39_94_77,r_39_94_77,1.0,53,130,77,62
51,r_105_5_54,r_221_101_179,seq210,r_105_5_54,1.0,0,54,54,62
144,seq210,seq166,r_105_5_54,r_105_5_54,1.0,21,75,54,62
9,r_155_211_82,r_193_66_195,r_32_55_161,r_155_211_82,1.0,0,82,82,62
28,r_108_151_49,r_115_177_192,r_27_179_44,r_108_151_49,1.0,0,49,49,62
49,r_13_129_107,r_85_62_153,seq77,r_13_129_107,1.0,0,107,107,62
7,r_221_101_179,seq81,r_71_4_51,r_221_101_179,0.54,0,179,179,62
44,r_11_142_85,r_52_3_105,seq48,r_11_142_85,0.86,0,85,85,62
118,seq67,r_54_146_145,seq137,r_54_146_145,1.0,1,146,145,62
0,r_29_150_97,r_187_41_50,seq36,r_29_150_97,1.0,0,97,97,62
131,seq206,r_184_194_179,r_14_147_73,r_14_147_73,0.92,106,179,73,62
23,r_85_62_153,seq153,r_84_172_50,r_84_172_50,1.0,108,158,50,62
101,seq37,r_212_23_186,r_152_58_142,r_152_58_142,0.96,17,159,142,62
12,r_131_120_128,r_14_147_73,r_86_208_59,r_131_120_128,0.83,-55,73,128,62
128,seq205,r_76_209_108,r_112_40_79,r_76_209_108,0.98,1,109,108,62
30,r_91_181_71,seq3,seq162,r_91_181_71,1.0,0,71,71,63
51,r_211_124_164,seq10,r_70_209_33,r_211_124_164,0.68,0,164,164,63
40,r_37_96_34,r_98_51_104,seq116,r_37_96_34,0.65,9,43,34,63
54,r_178_35_57,seq151,r_142_25_54,r_178_35_57,1.0,0,57,57,63
53,r_222_106_116,seq18,r_64_47_61,r_222_106_116,0.99,0,116,116,63
43,r_191_27_83,seq95,seq199,r_191_27_83,0.99,0,83,83,63
56,r_213_2_24,r_152_195_67,seq135,r_213_2_24,1.0,-1,23,24,63
32,r_39_121_45,r_72_23_158,seq108,r_39_121_45,1.0,0,45,45,63
71,r_205_8_120,r_14_93_127,seq149,r_14_93_127,0.94,-1,126,127,63
16,r_210_36_92,seq74,r_40_164_39,r_210_36_92,1.0,0,92,92,63
21,r_65_68_83,seq194,seq132,r_65_68_83,1.0,0,83,83,63
1,r_79_90_167,seq33,r_4_215_22,r_79_90_167,0.65,0,167,167,63
143,seq113,r_100_77_167,r_64_47_61,r_64_47_61,1.0,106,167,61,63
5,r_29_38_113,seq85,r_21_144_163,r_21_144_163,0.42,6,169,163,63
42,r_105_80_119,seq71,seq73,r_105_80_119,0.88,0,119,119,63
111,seq138,seq19,r_161_76_115,r_161_76_115,1.0,11,126,115,63
80,seq10,r_146_87_177,r_92_159_85,r_92_159_85,1.0,82,167,85,63
45,r_111_81_113,r_12_15_145,r_37_96_34,r_111_81_113,0.99,1,114,113,63
19,r_99_212_79,seq71,seq135,r_99_212_79,0.52,0,79,79,63
66,r_177_45_106,seq16,seq3,r_177_45_106,1.0,1,107,106,63
39,r_102_50_27,r_104_61_84,seq116,r_102_50_27,0.45,2,29,27,63
73,r_136_49_53,r_156_122_91,seq186,r_156_122_91,0.93,-35,56,91,63
41,r_188_137_128,r_140_30_168,seq176,r_188_137_128,0.96,2,130,128,63
67,r_157_55_79,seq71,seq20,r_157_55_79,1.0,0,79,79,63
14,r_4_215_22,seq86,seq43,r_4_215_22,0.82,0,22,22,63
3,r_64_47_61,r_32_184_190,seq113,r_64_47_61,1.0,0,61,61,63
27,r_114_153_31,seq190,r_75_17_9,r_114_153_31,0.98,0,31,31,63
10,r_221_202_117,seq13,r_191_27_83,r_191_27_83,0.96,41,124,83,63
26,r_54_193_138,seq127,seq192,r_54_193_138,0.88,0,138,138,63
72,r_12_15_145,seq180,r_59_42_8,r_12_15_145,0.91,0,145,145,63
139,seq108,r_21_144_163,r_39_121_45,r_39_121_45,1.0,74,119,45,63
0,r_152_195_67,r_14_93_127,r_102_50_27,r_14_93_127,0.9,-60,67,127,63
63,r_14_93_127,r_205_8_120,seq71,r_14_93_127,1.0,-1,126,127,63
114,seq192,r_98_51_104,r_148_129_170,r_148_129_170,0.54,-48,122,170,63
11,r_171_206_125,seq110,r_52_6_26,r_171_206_125,0.73,2,127,125,63
20,r_21_144_163,seq108,r_29_38_113,r_21_144_163,0.57,0,163,163,63
13,r_140_30_168,seq112,r_156_122_91,r_156_122_91,1.0,17,108,91,63
46,r_59_42_8,r_32_184_190,r_117_118_2,r_32_184_190,0.75,0,190,190,63
15,r_104_61_84,seq154,seq97,r_104_61_84,1.0,0,84,84,63
48,r_48_89_94,seq97,r_37_96_34,r_48_89_94,1.0,0,94,94,63
9,r_133_163_16,r_139_103_81,r_142_25_54,r_142_25_54,1.0,1,55,54,63
75,seq128,seq216,r_114_153_31,r_114_153_31,1.0,26,57,31,63
65,r_172_145_37,r_189_56_129,r_205_8_120,r_172_145_37,1.0,0,37,37,63
13,r_140_30_168,r_156_122_91,seq160,r_140_30_168,1.0,0,168,168,63
39,r_102_50_27,seq116,r_152_195_67,r_102_50_27,0.79,42,69,27,63
49,r_142_25_54,seq187,r_133_163_16,r_142_25_54,1.0,0,54,54,63
2,r_130_224_97,r_126_179_112,seq150,r_130_224_97,0.99,0,97,97,63
105,seq180,r_12_15_145,r_57_41_91,r_57_41_91,0.64,54,145,91,63
74,r_175_169_149,r_155_183_181,seq135,r_175_169_149,0.97,0,149,149,63
18,r_126_179_112,seq116,seq43,r_126_179_112,0.87,2,114,112,63
29,r_92_159_85,seq154,seq10,r_92_159_85,1.0,0,85,85,63
24,r_148_129_170,seq53,seq33,r_148_129_170,0.66,0,170,170,63
25,r_98_51_104,seq192,r_111_81_113,r_111_81_113,1.0,9,122,113,63
33,r_57_41_91,seq62,seq180,r_57_41_91,1.0,-1,90,91,63
64,r_146_87_177,seq10,r_210_36_92,r_146_87_177,0.37,0,177,177,63
65,r_172_145_37,r_205_8_120,seq158,r_205_8_120,0.71,12,132,120,63
141,seq174,r_99_212_79,r_40_164_39,r_40_164_39,0.56,-1,38,39,63
62,r_52_6_26,r_104_61_84,seq204,r_52_6_26,0.99,0,26,26,63
50,r_156_122_91,r_82_207_128,r_65_68_83,r_82_207_128,0.9,-37,91,128,63
70,r_72_23_158,seq13,seq185,r_72_23_158,0.31,15,173,158,63
68,r_161_76_115,seq199,seq138,r_161_76_115,0.99,0,115,115,63
59,r_70_209_33,r_148_129_170,seq101,r_70_209_33,1.0,0,33,33,63
61,r_170_123_122,seq11,seq208,r_170_123_122,1.0,0,122,122,63
38,r_28_214_108,r_32_184_190,seq135,r_28_214_108,1.0,1,109,108,63
52,r_84_1_175,seq97,r_70_209_33,r_84_1_175,0.49,0,175,175,63
69,r_196_109_48,seq135,seq53,r_196_109_48,1.0,0,48,48,63
34,r_141_7_135,seq73,r_39_121_45,r_141_7_135,0.99,2,137,135,63
90,seq151,r_178_35_57,seq19,r_178_35_57,0.99,0,57,57,63
109,seq187,r_52_6_26,r_100_77_167,r_100_77_167,0.6,-25,142,167,63
60,r_189_56_129,seq204,r_210_36_92,r_189_56_129,0.95,0,129,129,63
17,r_155_183_181,r_175_169_149,r_172_145_37,r_155_183_181,0.7,-83,98,181,63
121,seq74,r_210_36_92,seq34,r_210_36_92,1.0,0,92,92,63
31,r_32_184_190,r_59_42_8,r_99_212_79,r_32_184_190,0.44,0,190,190,63
22,r_22_201_86,seq101,seq216,r_22_201_86,1.0,0,86,86,63
28,r_5_217_137,seq173,r_37_96_34,r_5_217_137,0.64,3,140,137,63
102,seq173,r_5_217_137,r_172_145_37,r_172_145_37,0.82,122,159,37,63
35,r_78_143_32,r_210_36_92,seq165,r_78_143_32,0.97,0,32,32,63
44,r_139_103_81,r_133_163_16,r_114_153_31,r_114_153_31,0.66,50,81,31,63
57,r_40_164_39,r_104_61_84,seq174,r_40_164_39,1.0,0,39,39,63
23,r_166_26_85,seq186,seq97,r_166_26_85,0.98,0,85,85,63
17,r_155_183_181,r_172_145_37,r_126_179_112,r_172_145_37,0.75,144,181,37,63
6,r_200_223_11,seq208,seq218,r_200_223_11,0.54,1,12,11,63
12,r_82_207_128,seq160,r_119_197_86,r_82_207_128,0.98,0,128,128,63
30,r_221_49_177,seq224,r_59_17_50,r_59_17_50,1.0,130,180,50,64
71,r_120_189_23,seq139,r_199_12_9,r_120_189_23,1.0,0,23,23,64
36,r_84_151_134,seq28,r_10_15_100,r_84_151_134,0.85,0,134,134,64
8,r_63_162_109,seq107,seq47,r_63_162_109,0.99,2,111,109,64
43,r_35_124_88,seq60,seq52,r_35_124_88,0.99,0,88,88,64
37,r_102_56_78,seq24,seq172,r_102_56_78,1.0,0,78,78,64
59,r_45_103_62,r_118_204_176,seq77,r_45_103_62,1.0,1,63,62,64
34,r_37_75_25,seq67,r_193_91_199,r_37_75_25,1.0,0,25,25,64
55,r_68_1_162,seq24,r_199_12_9,r_68_1_162,0.7,0,162,162,64
39,r_187_219_181,r_221_49_177,seq18,r_221_49_177,0.39,4,181,177,64
1,r_14_209_67,r_187_219_181,seq24,r_14_209_67,0.99,3,70,67,64
46,r_58_80_125,seq172,seq25,r_58_80_125,0.81,1,126,125,64
69,r_160_64_77,r_165_156_100,seq153,r_160_64_77,0.99,0,77,77,64
33,r_112_213_42,seq132,seq95,r_112_213_42,1.0,0,42,42,64
10,r_216_61_13,r_86_81_143,seq172,r_216_61_13,0.54,2,15,13,64
24,r_206_79_173,r_183_144_75,seq141,r_206_79_173,0.99,0,173,173,64
19,r_10_15_100,seq39,r_192_177_40,r_10_15_100,1.0,0,100,100,64
66,r_190_121_123,seq135,r_111_55_199,r_190_121_123,0.92,0,123,123,64
100,seq180,r_130_7_140,r_38_41_132,r_130_7_140,0.57,-1,139,140,64
103,seq220,seq82,r_98_169_53,r_98_169_53,1.0,16,69,53,64
31,r_143_26_101,r_205_36_156,r_173_210_15,r_143_26_101,0.98,0,101,101,64
67,r_97_53_70,r_140_54_193,r_212_78_109,r_97_53_70,1.0,2,72,70,64
89,seq22,r_201_3_82,r_8_185_4,r_201_3_82,1.0,0,82,82,64
3,r_74_211_4,r_206_79_173,r_183_144_75,r_183_144_75,1.0,98,173,75,64
72,r_94_200_73,seq88,seq138,r_94_200_73,1.0,0,73,73,64
112,seq158,r_11_131_197,r_167_223_16,r_167_223_16,1.0,-1,15,16,64
0,r_183_144_75,seq47,r_206_79_173,r_183_144_75,0.99,0,75,75,64
63,r_165_156_100,seq28,r_97_53_70,r_97_53_70,0.93,32,102,70,64
73,r_13_27_121,seq222,r_214_62_37,r_13_27_121,0.87,0,121,121,64
11,r_50_6_86,r_148_159_195,seq96,r_50_6_86,1.0,-3,83,86,64
20,r_145_164_131,seq155,seq117,r_145_164_131,0.76,6,137,131,64
65,r_98_169_53,seq217,seq220,r_98_169_53,1.0,1,54,53,64
15,r_197_142_74,seq69,seq155,r_197_142_74,1.0,1,75,74,64
48,r_86_81_143,r_93_147_141,r_154_116_110,r_86_81_143,0.69,1,144,143,64
6,r_195_44_174,r_206_79_173,r_201_3_82,r_201_3_82,0.55,92,174,82,64
0,r_183_144_75,r_206_79_173,r_212_78_109,r_206_79_173,0.75,-18,155,173,64
67,r_97_53_70,r_212_78_109,r_165_156_100,r_97_53_70,0.61,41,111,70,64
134,seq92,r_179_0_187,r_205_36_156,r_205_36_156,0.66,33,189,156,64
87,seq20,r_93_147_141,r_32_203_182,r_93_147_141,0.59,-1,140,141,64
21,r_214_62_37,r_184_163_163,seq69,r_214_62_37,0.78,-19,18,37,64
2,r_184_163_163,seq18,r_197_142_74,r_197_142_74,1.0,91,165,74,64
47,r_110_101_104,r_111_55_199,seq178,r_110_101_104,0.91,0,104,104,64
105,seq43,r_118_204_176,r_165_156_100,r_118_204_176,0.48,1,177,176,64
74,r_16_123_120,seq180,seq57,r_16_123_120,0.98,0,120,120,64
18,r_201_3_82,seq22,seq138,r_201_3_82,1.0,0,82,82,64
29,r_179_0_187,seq92,r_183_144_75,r_183_144_75,1.0,114,189,75,64
24,r_206_79_173,r_195_44_174,r_183_144_75,r_183_144_75,1.0,11,86,75,64
25,r_23_202_193,seq224,r_90_104_88,r_90_104_88,1.0,79,167,88,64
64,r_137_198_111,r_148_159_195,seq129,r_137_198_111,0.95,0,111,111,64
50,r_118_204_176,r_212_78_109,r_165_156_100,r_118_204_176,0.93,-66,110,176,64
58,r_42_152_168,seq132,r_63_162_109,r_42_152_168,0.73,2,170,168,64
70,r_212_78_109,r_118_204_176,r_183_144_75,r_183_144_75,0.74,35,110,75,64
137,seq96,seq171,r_50_6_86,r_50_6_86,1.0,-6,80,86,64
61,r_146_51_129,r_111_55_199,seq70,r_146_51_129,0.91,0,129,129,64
32,r_93_147_141,seq20,r_130_7_140,r_93_147_141,0.45,0,141,141,64
38,r_130_7_140,seq180,seq125,r_130_7_140,0.9,0,140,140,64
75,seq129,r_182_114_188,seq222,r_182_114_188,0.65,-46,142,188,64
17,r_208_29_139,seq66,seq153,r_208_29_139,0.74,0,139,139,64
9,r_111_55_199,r_146_51_129,r_194_161_87,r_111_55_199,0.59,-70,129,199,64
68,r_192_177_40,r_50_6_86,r_111_55_199,r_50_6_86,0.59,-46,40,86,64
50,r_118_204_176,r_165_156_100,seq85,r_165_156_100,0.92,77,177,100,64
96,seq150,r_175_196_184,r_63_162_109,r_63_162_109,0.88,75,184,109,64
27,r_109_34_28,r_58_80_125,seq52,r_109_34_28,0.99,0,28,28,64
22,r_205_36_156,seq138,seq92,r_205_36_156,0.57,0,156,156,64
40,r_59_17_50,r_205_36_156,seq107,r_59_17_50,1.0,2,52,50,64
4,r_2_19_34,r_154_116_110,r_173_210_15,r_2_19_34,0.78,1,35,34,64
49,r_194_161_87,r_11_131_197,r_111_55_199,r_194_161_87,0.87,4,91,87,64
44,r_149_30_134,seq191,seq24,r_149_30_134,0.73,-1,133,134,64
60,r_167_223_16,seq77,seq158,r_167_223_16,0.91,-1,15,16,64
23,r_90_104_88,r_205_36_156,r_23_202_193,r_90_104_88,1.0,1,89,88,64
35,r_154_116_110,r_21_134_192,seq57,r_154_116_110,1.0,0,110,110,64
30,r_82_173_157,seq176,seq219,r_82_173_157,0.96,2,159,157,65
51,r_2_172_107,r_54_84_190,r_26_57_23,r_26_57_23,0.76,84,107,23,65
17,r_117_164_47,r_148_30_102,seq163,r_117_164_47,0.96,0,47,47,65
66,r_108_141_43,r_156_31_33,r_160_122_115,r_160_122_115,1.0,0,115,115,65
14,r_155_159_66,r_87_184_95,seq176,r_155_159_66,1.0,0,66,66,65
43,r_87_184_95,seq18,seq217,r_87_184_95,0.91,0,95,95,65
36,r_136_85_24,r_190_73_62,r_75_133_195,r_136_85_24,1.0,0,24,24,65
54,r_185_162_109,seq68,seq207,r_185_162_109,1.0,0,109,109,65
16,r_44_193_121,seq177,r_36_102_23,r_44_193_121,1.0,0,121,121,65
39,r_3_170_101,r_130_43_167,seq21,r_3_170_101,1.0,1,102,101,65
37,r_26_57_23,r_212_186_107,r_99_171_142,r_26_57_23,1.0,0,23,23,65
46,r_205_83_106,r_99_171_142,seq37,r_205_83_106,0.55,0,106,106,65
42,r_215_8_162,r_130_43_167,r_3_170_101,r_3_170_101,1.0,61,162,101,65
55,r_91_71_57,r_129_157_177,seq166,r_91_71_57,1.0,-1,56,57,65
78,seq214,r_89_95_133,r_106_38_24,r_106_38_24,0.98,0,24,24,65
45,r_200_97_82,seq224,seq23,r_200_97_82,0.99,-1,81,82,65
2,r_36_102_23,r_99_171_142,r_80_138_7,r_36_102_23,0.89,-5,18,23,65
21,r_143_62_45,r_194_151_199,seq65,r_143_62_45,1.0,0,45,45,65
19,r_104_28_71,seq15,seq79,r_104_28_71,1.0,0,71,71,65
138,seq166,seq103,r_91_71_57,r_91_71_57,0.54,-26,31,57,65
31,r_16_1_102,r_213_98_110,seq68,r_16_1_102,0.64,4,106,102,65
41,r_99_171_142,seq207,r_106_38_24,r_99_171_142,0.99,0,142,142,65
89,seq23,r_2_172_107,r_200_97_82,r_200_97_82,0.94,0,82,82,65
3,r_145_178_92,r_197_211_132,r_136_85_24,r_145_178_92,1.0,-1,91,92,65
10,r_167_165_176,seq183,r_129_157_177,r_167_165_176,0.47,0,176,176,65
115,seq161,r_148_30_102,seq137,r_148_30_102,0.6,0,102,102,65
26,r_190_73_62,r_213_98_110,seq137,r_190_73_62,0.88,0,62,62,65
18,r_204_56_54,r_24_115_73,seq107,r_24_115_73,0.63,-24,49,73,65
4,r_197_211_132,seq79,r_36_102_23,r_197_211_132,0.93,1,133,132,65
25,r_19_140_159,r_148_30_102,seq63,r_19_140_159,0.95,0,159,159,65
63,r_39_111_79,r_148_30_102,r_55_50_52,r_39_111_79,0.8,4,83,79,65
38,r_156_31_33,r_16_1_102,seq94,r_156_31_33,0.93,-4,29,33,65
73,r_142_47_68,r_75_133_195,r_121_81_20,r_142_47_68,1.0,0,68,68,65
107,seq60,r_213_98_110,r_24_115_73,r_24_115_73,1.0,1,74,73,65
141,seq107,r_216_189_78,r_204_56_54,r_204_56_54,0.85,-5,49,54,65
20,r_148_30_102,seq161,r_26_57_23,r_148_30_102,0.92,0,102,102,65
13,r_212_186_107,r_42_67_138,r_91_71_57,r_42_67_138,1.0,-28,110,138,65
47,r_113_51_30,r_190_73_62,r_0_86_4,r_113_51_30,0.99,-1,29,30,65
48,r_24_115_73,r_82_173_157,seq60,r_24_115_73,1.0,0,73,73,65
57,r_128_69_138,seq37,seq161,r_128_69_138,0.98,0,138,138,65
62,r_34_5_167,seq78,seq32,r_34_5_167,0.85,0,167,167,65
36,r_136_85_24,r_75_133_195,r_145_178_92,r_145_178_92,1.0,0,92,92,65
58,r_194_151_199,r_143_62_45,seq18,r_143_62_45,0.96,-8,37,45,65
72,r_158_10_32,seq45,seq183,r_158_10_32,0.93,-3,29,32,65
87,seq21,r_54_84_190,r_3_170_101,r_3_170_101,1.0,43,144,101,65
24,r_49_132_24,r_88_223_172,r_195_110_24,r_49_132_24,1.0,0,24,24,65
40,r_192_22_104,seq37,seq196,r_192_22_104,1.0,0,104,104,65
56,r_106_38_24,r_117_164_47,seq214,r_106_38_24,1.0,0,24,24,65
71,r_121_81_20,seq188,seq103,r_121_81_20,1.0,0,20,20,65
74,r_52_154_97,r_197_211_132,r_26_57_23,r_26_57_23,0.67,75,98,23,65
25,r_19_140_159,r_20_53_106,r_148_30_102,r_19_140_159,1.0,-56,103,159,65
33,r_216_189_78,seq222,seq96,r_216_189_78,0.48,-6,72,78,65
50,r_29_191_188,seq149,seq41,r_29_191_188,0.15,0,188,188,65
66,r_108_141_43,r_197_211_132,r_156_31_33,r_108_141_43,1.0,0,43,43,65
115,seq161,seq137,r_128_69_138,r_128_69_138,0.99,11,149,138,65
65,r_20_53_106,r_19_140_159,r_121_81_20,r_20_53_106,1.0,0,106,106,65
68,r_6_59_148,seq207,r_190_73_62,r_6_59_148,0.97,0,148,148,65
61,r_213_98_110,seq60,r_123_169_59,r_123_169_59,1.0,20,79,59,65
32,r_124_220_101,seq219,r_24_115_73,r_124_220_101,0.81,-3,98,101,65
75,seq149,r_29_191_188,r_89_95_133,r_89_95_133,0.99,55,188,133,65
60,r_160_122_115,seq147,r_108_141_43,r_160_122_115,0.77,0,115,115,65
119,seq219,r_124_220_101,r_201_4_178,r_124_220_101,0.98,-11,90,101,65
104,seq222,r_216_189_78,r_204_56_54,r_204_56_54,0.77,-5,49,54,65
9,r_125_187_101,seq207,seq79,r_125_187_101,0.98,0,101,101,65
26,r_190_73_62,seq137,r_6_59_148,r_6_59_148,1.0,-1,147,148,65
12,r_123_169_59,r_180_70_197,seq210,r_123_169_59,1.0,0,59,59,65
37,r_26_57_23,r_99_171_142,r_2_172_107,r_26_57_23,0.95,87,110,23,65
22,r_42_67_138,seq35,seq18,r_42_67_138,0.64,1,139,138,65
28,r_66_199_68,seq9,r_121_81_20,r_66_199_68,1.0,0,68,68,65
49,r_40_17_132,seq68,r_158_10_32,r_40_17_132,0.93,0,132,132,65
7,r_101_13_166,seq177,seq188,r_101_13_166,0.39,1,167,166,65
44,r_89_95_133,seq214,seq149,r_89_95_133,0.88,0,133,133,65
67,r_195_110_24,r_75_133_195,r_49_132_24,r_195_110_24,0.97,0,24,24,65
23,r_129_157_177,seq127,r_167_165_176,r_167_165_176,0.72,1,177,176,65
30,r_140_162_181,r_46_207_153,seq129,r_46_207_153,0.83,-92,61,153,66
51,r_180_137_146,seq132,r_193_179_77,r_180_137_146,0.83,0,146,146,66
36,r_158_91_168,r_198_160_178,r_156_42_43,r_158_91_168,0.7,0,168,168,66
14,r_159_185_190,r_143_151_169,r_17_7_153,r_17_7_153,0.98,37,190,153,66
53,r_15_144_83,seq153,r_47_11_16,r_15_144_83,1.0,2,85,83,66
43,r_52_188_157,r_219_117_199,r_99_73_81,r_99_73_81,1.0,78,159,81,66
54,r_182_168_58,seq212,r_96_184_192,r_182_168_58,0.76,16,74,58,66
37,r_148_31_105,seq169,seq132,r_148_31_105,0.86,0,105,105,66
71,r_97_133_122,r_54_222_187,r_99_73_81,r_54_222_187,0.66,-65,122,187,66
16,r_198_160_178,r_158_91_168,r_202_183_187,r_198_160_178,0.64,-11,167,178,66
25,r_53_145_40,r_15_144_83,seq24,r_53_145_40,1.0,0,40,40,66
42,r_124_204_127,seq67,seq153,r_124_204_127,0.91,3,130,127,66
69,r_6_109_193,r_18_196_182,r_223_220_40,r_6_109_193,0.49,-11,182,193,66
73,r_210_34_13,r_54_222_187,r_1_134_167,r_210_34_13,1.0,0,13,13,66
19,r_99_73_81,seq23,r_106_211_6,r_99_73_81,1.0,0,81,81,66
95,seq33,r_20_9_78,r_106_211_6,r_20_9_78,1.0,0,78,78,66
128,seq85,r_180_137_146,r_83_66_86,r_83_66_86,0.84,-15,71,86,66
39,r_115_60_8,r_100_197_182,r_68_27_93,r_68_27_93,1.0,89,182,93,66
41,r_56_205_132,r_112_62_136,seq12,r_56_205_132,0.99,0,132,132,66
67,r_203_127_160,r_0_65_159,seq35,r_0_65_159,0.76,4,163,159,66
10,r_190_195_97,r_69_116_102,seq80,r_190_195_97,0.98,0,97,97,66
38,r_155_88_24,r_126_118_24,seq163,r_155_88_24,1.0,0,24,24,66
59,r_19_176_48,r_181_217_67,seq194,r_19_176_48,0.72,0,48,48,66
72,r_0_65_159,r_203_127_160,r_32_123_29,r_32_123_29,0.93,134,163,29,66
0,r_87_173_81,seq135,r_221_22_22,r_221_22_22,1.0,60,82,22,66
28,r_136_93_26,r_216_8_173,r_221_22_22,r_136_93_26,0.96,0,26,26,66
20,r_186_164_68,r_148_31_105,r_210_34_13,r_186_164_68,1.0,0,68,68,66
46,r_26_141_12,r_99_73_81,r_156_42_43,r_99_73_81,0.48,-1,80,81,66
57,r_83_66_86,r_29_63_101,seq85,r_83_66_86,1.0,2,88,86,66
6,r_152_98_121,seq12,r_53_145_40,r_53_145_40,0.98,81,121,40,66
62,r_193_179_77,seq23,r_55_70_81,r_193_179_77,1.0,3,80,77,66
11,r_221_22_22,seq218,seq90,r_221_22_22,0.98,-1,21,22,66
2,r_122_84_36,r_203_127_160,seq44,r_122_84_36,0.38,86,122,36,66
27,r_181_217_67,r_104_89_75,seq74,r_104_89_75,0.9,-2,73,75,66
30,r_140_162_181,seq129,r_29_63_101,r_140_162_181,0.36,0,181,181,66
145,seq153,seq50,r_124_204_127,r_124_204_127,1.0,1,128,127,66
40,r_17_7_153,r_108_114_83,seq113,r_17_7_153,0.75,0,153,153,66
105,seq48,r_146_95_130,seq129,r_146_95_130,1.0,0,130,130,66
29,r_20_9_78,seq33,seq4,r_20_9_78,0.86,0,78,78,66
17,r_13_40_42,r_99_73_81,seq169,r_13_40_42,0.7,1,43,42,66
61,r_1_134_167,r_210_34_13,r_87_173_81,r_1_134_167,0.65,2,169,167,66
24,r_146_95_130,seq48,r_181_217_67,r_146_95_130,0.96,0,130,130,66
46,r_26_141_12,r_69_116_102,r_99_73_81,r_26_141_12,0.94,1,13,12,66
61,r_1_134_167,seq128,r_210_34_13,r_210_34_13,0.96,10,23,13,66
18,r_111_5_47,r_181_217_67,seq51,r_111_5_47,1.0,0,47,47,66
50,r_18_196_182,r_6_109_193,r_156_42_43,r_156_42_43,0.93,139,182,43,66
70,r_46_207_153,seq218,r_139_121_98,r_139_121_98,0.81,55,153,98,66
65,r_143_151_169,r_159_185_190,r_87_173_81,r_143_151_169,0.64,0,169,169,66
68,r_104_89_75,seq166,seq113,r_104_89_75,1.0,0,75,75,66
47,r_47_11_16,seq194,r_167_175_12,r_47_11_16,0.44,-2,14,16,66
52,r_112_62_136,seq135,seq72,r_112_62_136,0.98,0,136,136,66
34,r_202_183_187,seq10,r_216_8_173,r_216_8_173,0.6,14,187,173,66
7,r_156_42_43,seq30,r_26_141_12,r_156_42_43,1.0,0,43,43,66
3,r_100_197_182,r_150_38_32,seq51,r_150_38_32,1.0,0,32,32,66
58,r_32_123_29,r_18_196_182,seq24,r_32_123_29,1.0,0,29,29,66
75,seq128,r_1_134_167,r_186_164_68,r_186_164_68,1.0,101,169,68,66
60,r_101_45_155,seq166,seq213,r_101_45_155,0.3,14,169,155,66
63,r_167_175_12,r_216_8_173,seq110,r_167_175_12,0.95,0,12,12,66
132,seq90,r_54_222_187,r_221_22_22,r_221_22_22,1.0,4,26,22,66
32,r_126_118_24,r_3_201_65,seq199,r_126_118_24,0.87,2,26,24,66
9,r_177_138_102,seq206,r_53_145_40,r_177_138_102,1.0,0,102,102,66
145,seq153,r_15_144_83,seq50,r_15_144_83,1.0,2,85,83,66
16,r_198_160_178,r_202_183_187,r_87_173_81,r_198_160_178,0.98,0,178,178,66
22,r_139_121_98,seq51,r_92_82_173,r_139_121_98,0.98,0,98,98,66
73,r_210_34_13,r_1_134_167,r_186_164_68,r_186_164_68,1.0,101,169,68,66
49,r_172_25_129,seq113,r_181_217_67,r_172_25_129,1.0,0,129,129,66
115,seq194,r_18_196_182,r_19_176_48,r_19_176_48,0.95,0,48,48,66
35,r_150_38_32,r_100_197_182,r_47_11_16,r_150_38_32,1.0,0,32,32,66
44,r_3_201_65,r_77_105_77,seq12,r_3_201_65,1.0,0,65,65,66
131,seq169,r_148_31_105,r_13_40_42,r_148_31_105,0.64,0,105,105,66
23,r_131_187_12,r_26_141_12,seq48,r_131_187_12,0.42,79,91,12,66
31,r_147_178_36,r_87_173_81,seq94,r_147_178_36,0.58,0,36,36,66
12,r_68_27_93,r_148_31_105,r_111_5_47,r_148_31_105,1.0,-12,93,105,66
2,r_122_84_36,r_100_197_182,r_203_127_160,r_122_84_36,0.99,0,36,36,66
30,r_28_149_157,r_60_73_175,seq134,r_28_149_157,0.68,0,157,157,67
13,r_176_216_18,r_145_71_89,r_194_106_197,r_194_106_197,0.8,-179,18,197,67
51,r_60_73_175,r_6_83_12,seq164,r_60_73_175,0.9,0,175,175,67
51,r_60_73_175,r_28_149_157,r_6_83_12,r_60_73_175,0.71,-18,157,175,67
38,r_196_104_36,seq198,r_109_127_181,r_196_104_36,1.0,2,38,36,67
14,r_40_13_105,r_153_135_105,seq136,r_40_13_105,0.82,2,107,105,67
147,seq121,r_109_127_181,r_137_79_84,r_137_79_84,0.98,32,116,84,67
53,r_45_114_167,seq76,r_69_102_81,r_69_102_81,0.9,87,168,81,67
37,r_132_206_147,seq126,r_172_12_128,r_132_206_147,0.75,1,148,147,67
43,r_122_8_14,r_90_140_121,seq144,r_122_8_14,0.72,0,14,14,67
54,r_22_125_22,r_200_156_96,r_93_161_47,r_200_156_96,0.64,-1,95,96,67
59,r_207_123_120,seq101,r_14_157_70,r_207_123_120,0.99,0,120,120,67
40,r_61_63_34,r_153_135_105,seq166,r_61_63_34,1.0,1,35,34,67
71,r_199_20_41,r_35_181_196,r_153_135_105,r_153_135_105,0.8,19,124,105,67
21,r_69_102_81,r_202_44_5,seq189,r_69_102_81,0.99,0,81,81,67
1,r_48_211_153,seq18,seq25,r_48_211_153,0.82,-1,152,153,67
80,seq136,r_109_127_181,r_40_13_105,r_40_13_105,0.97,0,105,105,67
5,r_215_188_70,seq89,r_222_42_40,r_215_188_70,0.99,0,70,70,67
46,r_14_157_70,r_116_91_118,seq19,r_14_157_70,1.0,0,70,70,67
42,r_151_173_170,seq105,r_214_97_20,r_151_173_170,0.74,1,171,170,67
85,seq19,r_26_29_26,r_14_157_70,r_14_157_70,1.0,4,74,70,67
19,r_180_47_90,r_182_118_188,seq218,r_180_47_90,0.99,0,90,90,67
66,r_182_118_188,seq178,r_215_188_70,r_215_188_70,1.0,118,188,70,67
38,r_196_104_36,r_109_127_181,r_138_209_148,r_196_104_36,0.72,145,181,36,67
34,r_124_141_22,r_153_135_105,seq17,r_124_141_22,0.96,0,22,22,67
69,r_200_156_96,r_153_135_105,r_93_161_47,r_93_161_47,1.0,0,47,47,67
50,r_64_88_115,r_69_102_81,r_90_140_121,r_69_102_81,0.57,-61,20,81,67
67,r_86_80_183,seq1,r_37_84_143,r_86_80_183,0.45,1,184,183,67
10,r_142_11_107,seq155,seq94,r_142_11_107,0.99,0,107,107,67
90,seq155,r_142_11_107,seq34,r_142_11_107,1.0,-1,106,107,67
3,r_214_97_20,r_138_209_148,seq24,r_214_97_20,0.99,-2,18,20,67
6,r_70_146_58,seq19,seq168,r_70_146_58,1.0,0,58,58,67
63,r_58_65_125,seq189,seq87,r_58_65_125,0.93,1,126,125,67
11,r_92_98_97,r_3_7_145,seq144,r_92_98_97,1.0,0,97,97,67
0,r_6_83_12,r_207_123_120,seq77,r_6_83_12,0.74,0,12,12,67
98,seq168,r_37_84_143,r_70_146_58,r_70_146_58,0.94,17,75,58,67
56,r_109_127_181,r_196_104_36,r_158_96_125,r_109_127_181,0.68,0,181,181,67
57,r_56_154_178,r_202_44_5,r_40_13_105,r_40_13_105,0.91,73,178,105,67
62,r_50_112_55,r_92_98_97,r_199_20_41,r_92_98_97,1.0,-34,63,97,67
141,seq108,r_109_127_181,r_137_79_84,r_137_79_84,0.99,75,159,84,67
80,seq136,r_33_171_26,r_109_127_181,r_33_171_26,0.73,3,29,26,67
16,r_99_72_45,r_215_188_70,seq34,r_99_72_45,1.0,1,46,45,67
134,seq95,r_60_73_175,seq68,r_60_73_175,0.62,-30,145,175,67
27,r_15_9_137,r_100_4_148,r_58_65_125,r_58_65_125,0.72,12,137,125,67
72,r_187_128_29,r_69_102_81,seq66,r_187_128_29,1.0,0,29,29,67
39,r_30_27_23,seq75,seq178,r_30_27_23,0.94,0,23,23,67
4,r_152_147_51,r_194_106_197,seq204,r_152_147_51,1.0,-2,49,51,67
2,r_194_106_197,r_78_190_102,r_176_216_18,r_194_106_197,0.94,-89,108,197,67
47,r_37_84_143,seq168,seq76,r_37_84_143,0.97,0,143,143,67
60,r_23_16_34,r_5_185_194,seq184,r_23_16_34,1.0,1,35,34,67
74,r_137_79_84,seq25,seq121,r_137_79_84,0.97,0,84,84,67
29,r_119_36_164,seq144,r_31_223_6,r_119_36_164,0.74,1,165,164,67
56,r_109_127_181,seq121,r_196_104_36,r_196_104_36,1.0,20,56,36,67
24,r_138_209_148,r_119_36_164,r_196_104_36,r_119_36_164,0.49,-16,148,164,67
123,seq164,r_31_223_6,r_60_73_175,r_60_73_175,1.0,1,176,175,67
34,r_124_141_22,seq17,r_78_190_102,r_78_190_102,0.55,-7,95,102,67
25,r_117_195_160,seq203,r_158_96_125,r_117_195_160,0.64,0,160,160,67
33,r_74_179_66,r_172_12_128,seq115,r_74_179_66,0.98,2,68,66,67
92,seq32,seq110,r_116_91_118,r_116_91_118,0.69,37,155,118,67
54,r_22_125_22,r_158_96_125,r_200_156_96,r_22_125_22,1.0,0,22,22,67
70,r_81_57_105,r_48_211_153,r_22_125_22,r_81_57_105,0.91,1,106,105,67
69,r_200_156_96,r_93_161_47,seq94,r_200_156_96,0.99,-1,95,96,67
77,seq131,r_109_127_181,r_137_79_84,r_137_79_84,0.99,32,116,84,67
15,r_93_161_47,seq66,r_22_125_22,r_93_161_47,0.98,0,47,47,67
17,r_220_177_62,r_151_173_170,seq160,r_220_177_62,0.76,1,63,62,67
121,seq77,r_132_206_147,seq103,r_132_206_147,1.0,-35,112,147,67
32,r_33_171_26,seq136,seq166,r_33_171_26,0.96,3,29,26,67
9,r_172_12_128,seq184,seq89,r_172_12_128,0.97,0,128,128,67
68,r_0_183_53,r_132_206_147,seq21,r_0_183_53,1.0,1,54,53,67
50,r_64_88_115,r_90_140_121,seq162,r_64_88_115,0.97,1,116,115,67
96,seq166,r_182_118_188,r_61_63_34,r_61_63_34,1.0,57,91,34,67
123,seq164,r_158_96_125,r_31_223_6,r_158_96_125,0.84,0,125,125,67
36,r_222_42_40,r_35_181_196,seq55,r_222_42_40,0.99,1,41,40,67
49,r_78_190_102,r_194_106_197,r_124_141_22,r_78_190_102,0.92,6,108,102,67
7,r_153_135_105,seq126,r_199_20_41,r_153_135_105,0.78,5,110,105,67
44,r_145_71_89,seq55,r_170_159_17,r_145_71_89,1.0,0,89,89,67
58,r_53_51_47,r_48_211_153,seq197,r_53_51_47,0.92,0,47,47,67
35,r_2_150_132,seq213,r_222_42_40,r_2_150_132,0.95,0,132,132,67
31,r_170_159_17,r_48_211_153,r_176_216_18,r_170_159_17,1.0,2,19,17,67
12,r_116_91_118,r_14_157_70,r_53_51_47,r_14_157_70,0.42,0,70,70,67
84,seq18,r_48_211_153,r_23_16_34,r_23_16_34,0.6,118,152,34,67
12,r_116_91_118,r_53_51_47,seq129,r_116_91_118,1.0,0,118,118,67
30,r_197_134_95,seq200,seq190,r_197_134_95,1.0,0,95,95,68
51,r_83_114_81,seq44,seq55,r_83_114_81,1.0,0,81,81,68
38,r_11_2_34,seq222,seq69,r_11_2_34,0.97,0,34,34,68
36,r_5_34_79,r_160_96_131,r_4_144_32,r_160_96_131,0.97,-52,79,131,68
117,seq66,seq8,r_4_144_32,r_4_144_32,1.0,2,34,32,68
14,r_112_101_86,seq143,r_208_168_46,r_208_168_46,1.0,49,95,46,68
8,r_111_171_113,r_119_86_192,r_163_21_91,r_111_171_113,1.0,0,113,113,68
43,r_93_166_83,r_138_29_104,seq24,r_93_166_83,0.53,-2,81,83,68
72,r_30_72_50,r_17_103_25,r_63_64_46,r_30_72_50,0.92,-6,44,50,68
37,r_48_131_131,seq32,r_191_210_24,r_48_131_131,0.87,0,131,131,68
3,r_80_79_75,r_128_136_188,r_105_127_163,r_105_127_163,1.0,0,163,163,68
55,r_175_146_43,r_208_168_46,seq117,r_175_146_43,1.0,0,43,43,68
74,r_6_51_24,r_197_134_95,seq9,r_6_51_24,1.0,2,26,24,68
72,r_30_72_50,seq154,r_17_103_25,r_30_72_50,0.47,-28,22,50,68
16,r_133_31_167,seq177,seq164,r_133_31_167,0.81,0,167,167,68
21,r_169_13_99,seq164,seq12,r_169_13_99,1.0,0,99,99,68
42,r_180_7_141,seq143,r_132_49_38,r_180_7_141,0.86,0,141,141,68
69,r_128_136_188,r_84_126_70,r_80_79_75,r_80_79_75,1.0,2,77,75,68
45,r_213_147_163,seq44,r_197_134_95,r_197_134_95,0.96,68,163,95,68
86,seq18,r_187_108_108,r_17_103_25,r_17_103_25,0.62,-2,23,25,68
24,r_160_96_131,r_223_73_153,r_112_101_86,r_160_96_131,1.0,0,131,131,68
19,r_178_204_92,r_67_148_136,seq18,r_178_204_92,1.0,0,92,92,68
128,seq82,r_119_86_192,r_109_16_39,r_109_16_39,0.99,-1,38,39,68
12,r_137_35_17,r_80_79_75,r_71_219_60,r_137_35_17,1.0,0,17,17,68
66,r_67_148_136,seq60,seq44,r_67_148_136,0.88,0,136,136,68
108,seq179,seq56,r_196_90_7,r_196_90_7,0.86,12,19,7,68
31,r_183_218_65,r_91_215_69,seq195,r_183_218_65,1.0,0,65,65,68
41,r_76_121_110,r_107_167_188,r_163_21_91,r_163_21_91,1.0,20,111,91,68
67,r_42_156_115,r_191_210_24,r_92_38_106,r_191_210_24,1.0,91,115,24,68
3,r_80_79_75,seq190,r_128_136_188,r_80_79_75,1.0,0,75,75,68
17,r_4_144_32,r_157_36_157,seq66,r_4_144_32,1.0,0,32,32,68
10,r_107_167_188,seq176,r_203_141_29,r_107_167_188,0.41,1,189,188,68
90,seq24,r_187_108_108,r_93_166_83,r_93_166_83,0.99,0,83,83,68
25,r_109_16_39,r_84_126_70,seq82,r_109_16_39,0.96,0,39,39,68
4,r_52_149_179,r_71_219_60,r_54_120_43,r_54_120_43,1.0,136,179,43,68
114,seq190,r_158_75_161,r_197_134_95,r_197_134_95,0.86,6,101,95,68
11,r_187_108_108,seq155,r_182_85_68,r_182_85_68,0.99,41,109,68,68
13,r_39_0_166,seq69,seq60,r_39_0_166,0.65,0,166,166,68
6,r_17_103_25,r_92_38_106,seq18,r_17_103_25,0.85,1,26,25,68
15,r_223_73_153,seq165,r_132_49_38,r_223_73_153,0.92,0,153,153,68
54,r_58_62_27,r_4_144_32,r_84_126_70,r_58_62_27,1.0,0,27,27,68
48,r_220_189_163,seq145,r_182_85_68,r_182_85_68,1.0,1,69,68,68
35,r_41_95_37,seq43,r_137_35_17,r_41_95_37,1.0,0,37,37,68
40,r_208_168_46,r_175_146_43,r_17_103_25,r_208_168_46,0.99,-2,44,46,68
57,r_88_94_158,seq66,seq129,r_88_94_158,0.77,0,158,158,68
106,seq176,r_107_167_188,r_112_101_86,r_112_101_86,0.83,103,189,86,68
147,seq123,r_105_127_163,seq150,r_105_127_163,0.63,-112,51,163,68
61,r_203_141_29,seq165,seq139,r_203_141_29,0.99,0,29,29,68
67,r_42_156_115,r_17_103_25,r_191_210_24,r_42_156_115,0.92,-89,26,115,68
27,r_63_64_46,r_53_186_94,seq177,r_63_64_46,1.0,0,46,46,68
53,r_191_210_24,seq28,r_48_131_131,r_48_131_131,0.97,4,135,131,68
53,r_191_210_24,r_42_156_115,seq28,r_42_156_115,0.97,0,115,115,68
136,seq98,seq143,r_110_89_93,r_110_89_93,1.0,12,105,93,68
87,seq174,seq222,r_91_215_69,r_91_215_69,1.0,10,79,69,68
22,r_182_85_68,r_220_189_163,r_187_108_108,r_182_85_68,0.84,87,155,68,68
69,r_128_136_188,r_80_79_75,r_137_35_17,r_128_136_188,0.48,1,189,188,68
2,r_61_1_177,seq150,r_39_0_166,r_61_1_177,0.54,0,177,177,68
18,r_157_36_157,r_151_81_11,r_27_19_12,r_157_36_157,0.75,0,157,157,68
29,r_158_75_161,seq190,r_84_126_70,r_158_75_161,0.91,0,161,161,68
120,seq69,seq33,r_11_2_34,r_11_2_34,1.0,1,35,34,68
53,r_191_210_24,seq24,r_42_156_115,r_191_210_24,0.94,2,26,24,68
60,r_163_21_91,r_209_207_184,r_111_171_113,r_111_171_113,0.85,12,125,113,68
59,r_27_19_12,r_183_218_65,seq154,r_27_19_12,0.94,0,12,12,68
33,r_100_194_66,r_160_96_131,seq9,r_100_194_66,0.71,-1,65,66,68
48,r_220_189_163,r_182_85_68,r_92_38_106,r_182_85_68,0.91,95,163,68,68
50,r_205_50_122,r_157_36_157,r_109_16_39,r_205_50_122,0.95,0,122,122,68
70,r_91_215_69,r_67_148_136,seq174,r_91_215_69,1.0,0,69,69,68
65,r_192_20_189,seq135,r_53_186_94,r_53_186_94,0.61,95,189,94,68
68,r_142_22_117,r_119_86_192,seq206,r_142_22_117,0.96,0,117,117,68
34,r_172_211_81,seq15,seq70,r_172_211_81,1.0,0,81,81,68
60,r_163_21_91,seq206,r_209_207_184,r_163_21_91,0.94,0,91,91,68
47,r_201_59_59,seq174,seq32,r_201_59_59,1.0,0,59,59,68
5,r_132_49_38,r_83_114_81,seq140,r_132_49_38,1.0,0,38,38,68
9,r_138_29_104,seq12,seq122,r_138_29_104,1.0,0,104,104,68
24,r_160_96_131,r_5_34_79,r_223_73_153,r_5_34_79,0.98,-25,54,79,68
28,r_152_3_23,r_80_79_75,seq78,r_80_79_75,0.75,-52,23,75,68
0,r_77_99_25,seq33,r_151_81_11,r_77_99_25,1.0,0,25,25,68
22,r_182_85_68,r_133_31_167,r_220_189_163,r_182_85_68,1.0,-1,67,68,68
135,seq165,r_223_73_153,seq123,r_223_73_153,0.47,0,153,153,68
49,r_110_89_93,r_220_189_163,seq98,r_110_89_93,0.98,2,95,93,68
73,r_54_120_43,r_71_219_60,seq10,r_54_120_43,1.0,-1,42,43,68
7,r_105_127_163,seq123,r_80_79_75,r_80_79_75,0.63,88,163,75,68
44,r_40_65_120,seq143,r_63_64_46,r_40_65_120,1.0,0,120,120,68
71,r_217_115_42,r_187_108_108,r_132_49_38,r_217_115_42,1.0,0,42,42,68
40,r_208_168_46,r_17_103_25,r_112_101_86,r_112_101_86,0.69,-1,85,86,68
30,r_55_35_180,r_15_147_144,r_56_163_17,r_55_35_180,0.64,-33,147,180,69
51,r_38_6_101,seq48,r_46_205_105,r_38_6_101,0.97,3,104,101,69
52,r_61_167_36,r_0_73_74,r_13_87_190,r_61_167_36,1.0,1,37,36,69
14,r_108_118_72,r_63_220_129,seq48,r_108_118_72,1.0,-1,71,72,69
53,r_0_73_74,seq32,r_83_151_66,r_0_73_74,0.95,2,76,74,69
5,r_190_194_90,r_12_152_22,r_186_34_140,r_190_194_90,0.43,57,147,90,69
7,r_56_163_17,seq187,r_55_35_180,r_56_163_17,0.99,-2,15,17,69
54,r_49_222_143,seq69,seq168,r_49_222_143,0.56,1,144,143,69
26,r_212_18_52,seq74,seq219,r_212_18_52,1.0,0,52,52,69
21,r_15_147_144,r_55_35_180,r_88_189_124,r_15_147_144,0.45,3,147,144,69
5,r_190_194_90,seq207,r_12_152_22,r_190_194_90,0.98,0,90,90,69
69,r_199_136_147,r_184_23_198,r_182_160_103,r_199_136_147,0.81,1,148,147,69
45,r_144_214_120,r_164_198_149,r_108_118_72,r_108_118_72,0.57,54,126,72,69
20,r_27_111_155,seq218,r_110_89_168,r_110_89_168,0.98,2,170,168,69
87,seq218,r_12_152_22,seq32,r_12_152_22,0.97,0,22,22,69
23,r_24_132_44,seq203,seq113,r_24_132_44,0.99,0,44,44,69
19,r_45_19_100,r_110_89_168,r_117_54_26,r_45_19_100,0.75,6,106,100,69
11,r_78_80_181,r_0_73_74,r_27_111_155,r_27_111_155,0.54,26,181,155,69
41,r_166_25_34,seq188,seq28,r_166_25_34,1.0,0,34,34,69
31,r_63_220_129,r_57_85_199,r_56_163_17,r_63_220_129,1.0,1,130,129,69
110,seq168,seq30,r_49_222_143,r_49_222_143,0.83,27,170,143,69
90,seq28,seq64,r_166_25_34,r_166_25_34,1.0,65,99,34,69
109,seq58,seq32,r_175_22_23,r_175_22_23,0.99,100,123,23,69
72,r_139_128_70,r_190_194_90,r_29_77_188,r_139_128_70,0.64,1,71,70,69
16,r_52_179_53,r_181_201_134,r_129_91_187,r_181_201_134,0.98,2,136,134,69
0,r_42_9_124,r_191_213_168,seq165,r_191_213_168,0.8,-42,126,168,69
63,r_2_196_149,seq209,r_15_147_144,r_2_196_149,0.35,-33,116,149,69
73,r_100_105_96,r_15_147_144,r_59_94_32,r_15_147_144,0.79,-48,96,144,69
11,r_78_80_181,seq64,r_0_73_74,r_0_73_74,0.99,31,105,74,69
80,seq11,r_123_142_31,r_56_163_17,r_56_163_17,1.0,-2,15,17,69
13,r_215_4_109,r_184_23_198,seq157,r_215_4_109,0.92,0,109,109,69
29,r_117_54_26,r_164_198_149,seq7,r_117_54_26,1.0,0,26,26,69
15,r_41_70_130,seq84,seq197,r_41_70_130,0.98,1,131,130,69
66,r_172_145_50,seq101,r_57_85_199,r_172_145_50,1.0,0,50,50,69
48,r_154_195_199,r_122_148_62,r_149_170_15,r_122_148_62,1.0,0,62,62,69
63,r_2_196_149,r_15_147_144,r_13_87_190,r_2_196_149,0.88,4,153,149,69
57,r_83_151_66,r_45_19_100,seq71,r_83_151_66,0.98,3,69,66,69
70,r_12_152_22,seq218,seq209,r_12_152_22,1.0,0,22,22,69
37,r_138_156_37,r_172_145_50,seq207,r_138_156_37,0.99,0,37,37,69
62,r_37_131_179,seq104,r_169_51_45,r_169_51_45,0.9,134,179,45,69
1,r_169_51_45,r_202_92_51,seq1,r_169_51_45,1.0,0,45,45,69
6,r_21_185_29,r_37_131_179,seq17,r_21_185_29,1.0,1,30,29,69
67,r_82_224_79,r_181_201_134,seq74,r_82_224_79,0.56,-44,35,79,69
93,seq159,r_78_80_181,seq64,r_78_80_181,0.47,-8,173,181,69
40,r_16_216_63,r_215_4_109,r_175_22_23,r_16_216_63,0.99,0,63,63,69
74,r_112_221_82,seq3,seq206,r_112_221_82,1.0,1,83,82,69
18,r_29_77_188,seq187,r_139_128_70,r_139_128_70,0.82,-2,68,70,69
25,r_46_205_105,seq209,r_38_6_101,r_46_205_105,0.97,1,106,105,69
33,r_122_148_62,r_154_195_199,seq203,r_122_148_62,1.0,0,62,62,69
64,r_81_31_176,seq44,r_21_185_29,r_21_185_29,0.99,158,187,29,69
65,r_181_201_134,r_52_179_53,r_66_14_85,r_181_201_134,1.0,0,134,134,69
46,r_123_142_31,seq135,seq3,r_123_142_31,0.64,1,32,31,69
50,r_186_34_140,seq113,r_190_194_90,r_190_194_90,1.0,52,142,90,69
58,r_96_223_136,r_49_222_143,seq188,r_96_223_136,0.41,1,137,136,69
65,r_181_201_134,r_82_224_79,r_52_179_53,r_52_179_53,1.0,7,60,53,69
61,r_143_39_69,r_63_220_129,r_59_94_32,r_59_94_32,0.81,37,69,32,69
32,r_66_14_85,seq113,seq48,r_66_14_85,0.99,2,87,85,69
38,r_141_93_137,r_15_147_144,seq146,r_141_93_137,0.63,0,137,137,69
10,r_175_22_23,r_46_205_105,seq69,r_175_22_23,1.0,0,23,23,69
27,r_43_133_54,seq64,seq60,r_43_133_54,0.98,4,58,54,69
34,r_8_97_91,seq178,r_124_5_122,r_8_97_91,1.0,0,91,91,69
75,seq1,r_109_102_143,r_169_51_45,r_169_51_45,0.95,100,145,45,69
60,r_171_150_112,r_15_147_144,r_125_65_129,r_15_147_144,0.95,-32,112,144,69
17,r_68_162_115,r_57_85_199,r_212_18_52,r_57_85_199,1.0,-84,115,199,69
2,r_26_176_34,r_49_222_143,seq155,r_26_176_34,0.76,3,37,34,69
16,r_52_179_53,seq71,r_181_201_134,r_52_179_53,1.0,0,53,53,69
22,r_88_189_124,r_110_89_168,seq173,r_110_89_168,0.71,-37,131,168,69
12,r_149_170_15,r_186_34_140,r_154_195_199,r_149_170_15,0.92,0,15,15,69
28,r_10_210_163,seq197,r_56_163_17,r_10_210_163,0.72,0,163,163,69
91,seq157,r_110_89_168,r_202_92_51,r_110_89_168,0.9,-17,151,168,69
72,r_139_128_70,r_29_77_188,r_169_51_45,r_139_128_70,0.6,120,190,70,69
8,r_137_183_38,r_37_131_179,r_149_170_15,r_137_183_38,0.89,0,38,38,69
56,r_182_160_103,r_13_87_190,seq33,r_182_160_103,0.95,2,105,103,69
18,r_29_77_188,r_139_128_70,r_166_25_34,r_166_25_34,0.56,155,189,34,69
44,r_72_140_166,seq219,r_21_185_29,r_21_185_29,0.98,141,170,29,69
35,r_164_198_149,seq146,r_24_132_44,r_164_198_149,0.71,0,149,149,69
135,seq101,r_172_145_50,seq188,r_172_145_50,1.0,0,50,50,69
39,r_59_94_32,r_15_147_144,seq53,r_59_94_32,0.89,4,36,32,69
14,r_62_138_128,r_113_117_139,r_201_184_74,r_113_117_139,0.92,-10,129,139,70
8,r_5_107_82,r_110_26_159,seq23,r_110_26_159,0.71,-78,81,159,70
43,r_157_119_134,seq171,seq33,r_157_119_134,0.87,1,135,134,70
66,r_89_215_44,r_223_98_118,seq24,r_89_215_44,1.0,0,44,44,70
146,seq153,r_20_39_149,r_134_52_50,r_134_52_50,1.0,99,149,50,70
22,r_148_140_26,r_67_65_123,seq73,r_148_140_26,1.0,0,26,26,70
37,r_220_210_95,r_193_196_165,seq199,r_220_210_95,0.93,0,95,95,70
86,seq16,r_223_98_118,r_128_189_109,r_223_98_118,1.0,-1,117,118,70
21,r_191_75_184,seq129,r_62_138_128,r_62_138_128,0.93,56,184,128,70
60,r_218_118_106,r_121_80_53,r_142_211_21,r_142_211_21,1.0,0,21,21,70
1,r_83_133_125,r_152_55_86,seq6,r_152_55_86,1.0,1,87,86,70
5,r_108_180_122,seq18,seq207,r_108_180_122,0.89,0,122,122,70
49,r_11_141_56,r_190_88_142,r_154_102_55,r_11_141_56,0.74,0,56,56,70
69,r_178_99_188,r_137_186_151,r_44_31_36,r_44_31_36,0.69,102,138,36,70
19,r_110_26_159,seq32,r_142_211_21,r_110_26_159,0.59,0,159,159,70
45,r_19_70_13,r_164_163_100,seq77,r_19_70_13,1.0,0,13,13,70
0,r_121_80_53,r_53_78_108,seq72,r_53_78_108,0.93,-65,43,108,70
76,seq129,r_191_75_184,r_108_180_122,r_108_180_122,0.65,62,184,122,70
129,seq213,r_84_38_147,r_190_88_142,r_190_88_142,0.57,5,147,142,70
41,r_190_88_142,seq4,seq213,r_190_88_142,0.69,0,142,142,70
110,seq47,r_206_59_180,r_144_216_27,r_144_216_27,0.93,153,180,27,70
23,r_112_12_40,r_83_133_125,seq37,r_112_12_40,1.0,0,40,40,70
3,r_84_38_147,seq213,r_205_158_129,r_205_158_129,0.87,18,147,129,70
10,r_43_40_130,seq33,seq132,r_43_40_130,0.87,0,130,130,70
36,r_179_9_23,r_34_68_117,r_212_208_8,r_179_9_23,0.88,-7,16,23,70
72,r_85_214_93,seq6,r_44_31_36,r_44_31_36,0.66,54,90,36,70
11,r_156_56_109,seq114,seq24,r_156_56_109,0.91,0,109,109,70
18,r_144_216_27,seq14,seq47,r_144_216_27,0.99,0,27,27,70
1,r_83_133_125,seq6,seq77,r_83_133_125,1.0,1,126,125,70
20,r_67_65_123,seq72,r_172_50_84,r_67_65_123,0.93,0,123,123,70
98,seq32,r_110_26_159,seq182,r_110_26_159,0.63,1,160,159,70
48,r_205_158_129,seq24,r_2_202_7,r_205_158_129,0.96,0,129,129,70
73,r_174_195_19,r_85_214_93,seq18,r_174_195_19,0.93,-3,16,19,70
57,r_81_87_83,r_198_222_48,seq162,r_81_87_83,1.0,0,83,83,70
47,r_164_163_100,seq6,r_221_123_134,r_221_123_134,1.0,1,135,134,70
62,r_35_49_102,r_191_75_184,r_121_80_53,r_35_49_102,1.0,0,102,102,70
9,r_44_31_36,r_5_107_82,r_128_189_109,r_44_31_36,1.0,0,36,36,70
51,r_2_202_7,r_190_88_142,r_205_158_129,r_2_202_7,0.8,135,142,7,70
2,r_223_98_118,seq16,seq22,r_223_98_118,0.97,0,118,118,70
47,r_164_163_100,seq28,seq6,r_164_163_100,0.63,3,103,100,70
40,r_146_135_152,r_48_36_194,r_11_141_56,r_48_36_194,0.81,-43,151,194,70
74,r_173_64_60,seq14,seq147,r_173_64_60,0.95,1,61,60,70
29,r_137_186_151,r_178_99_188,r_20_39_149,r_137_186_151,0.86,0,151,151,70
24,r_34_68_117,seq105,seq17,r_34_68_117,0.98,0,117,117,70
25,r_193_196_165,seq42,r_62_138_128,r_193_196_165,0.4,0,165,165,70
64,r_206_59_180,seq47,r_212_208_8,r_206_59_180,0.48,0,180,180,70
50,r_53_78_108,seq18,r_144_216_27,r_53_78_108,0.6,0,108,108,70
58,r_63_45_126,seq166,seq165,r_63_45_126,0.99,1,127,126,70
65,r_90_54_173,seq92,r_134_52_50,r_134_52_50,0.93,123,173,50,70
68,r_131_76_95,seq37,r_201_184_74,r_131_76_95,1.0,0,95,95,70
42,r_142_211_21,r_218_118_106,r_110_26_159,r_110_26_159,0.92,0,159,159,70
32,r_125_10_192,r_97_170_106,r_89_215_44,r_125_10_192,1.0,-97,95,192,70
56,r_134_52_50,seq165,seq150,r_134_52_50,1.0,1,51,50,70
38,r_201_184_74,seq23,seq18,r_201_184_74,1.0,0,74,74,70
52,r_221_123_134,seq188,r_164_163_100,r_221_123_134,0.96,0,134,134,70
34,r_143_217_84,seq33,seq8,r_143_217_84,0.96,-2,82,84,70
55,r_154_102_55,r_175_74_54,r_11_141_56,r_154_102_55,0.99,2,57,55,70
17,r_109_127_164,seq28,r_44_31_36,r_44_31_36,0.77,128,164,36,70
54,r_27_124_58,r_20_39_149,seq14,r_27_124_58,0.99,1,59,58,70
121,seq71,seq23,r_152_55_86,r_152_55_86,1.0,4,90,86,70
70,r_185_126_38,r_7_167_196,seq23,r_185_126_38,0.78,2,40,38,70
67,r_175_74_54,r_154_102_55,r_44_31_36,r_175_74_54,1.0,0,54,54,70
28,r_20_39_149,seq153,r_172_50_84,r_20_39_149,0.79,0,149,149,70
42,r_142_211_21,r_220_210_95,r_218_118_106,r_142_211_21,0.99,0,21,21,70
39,r_7_167_196,r_185_126_38,seq82,r_185_126_38,0.67,6,44,38,70
69,r_178_99_188,r_44_31_36,r_108_180_122,r_178_99_188,0.74,0,188,188,70
7,r_115_194_124,seq28,seq91,r_115_194_124,0.99,0,124,124,70
82,seq8,seq160,r_143_217_84,r_143_217_84,1.0,-6,78,84,70
60,r_218_118_106,r_142_211_21,seq151,r_218_118_106,0.68,6,112,106,70
12,r_97_170_106,r_125_10_192,r_218_118_106,r_97_170_106,0.99,-1,105,106,70
93,seq28,r_66_64_110,seq185,r_66_64_110,0.92,18,128,110,71
15,r_204_82_66,r_177_75_49,seq143,r_177_75_49,0.96,0,49,49,71
51,r_179_120_169,r_55_77_161,r_154_219_93,r_154_219_93,1.0,17,110,93,71
36,r_5_68_144,r_55_77_161,seq12,r_5_68_144,0.98,0,144,144,71
20,r_190_36_147,seq140,r_70_44_101,r_190_36_147,0.98,1,148,147,71
14,r_216_97_95,seq85,seq84,r_216_97_95,0.98,0,95,95,71
21,r_156_114_17,r_1_163_177,r_8_116_194,r_156_114_17,1.0,0,17,17,71
27,r_202_152_19,r_121_130_104,r_124_41_38,r_202_152_19,0.92,28,47,19,71
8,r_40_198_159,seq84,r_104_96_40,r_40_198_159,0.7,0,159,159,71
53,r_109_197_111,r_15_111_98,r_48_169_16,r_109_197_111,0.9,1,112,111,71
48,r_32_89_18,r_184_196_58,seq69,r_184_196_58,1.0,-28,30,58,71
43,r_46_25_110,r_193_102_5,seq206,r_46_25_110,1.0,0,110,110,71
146,seq170,r_1_163_177,r_204_82_66,r_204_82_66,0.99,113,179,66,71
33,r_222_113_154,r_87_117_9,r_209_211_47,r_209_211_47,0.96,9,56,47,71
46,r_10_103_11,r_104_96_40,seq101,r_10_103_11,1.0,0,11,11,71
37,r_167_31_73,r_191_93_177,seq108,r_167_31_73,1.0,1,74,73,71
61,r_86_189_162,r_179_120_169,r_11_195_37,r_11_195_37,1.0,-1,36,37,71
54,r_48_169_16,r_50_187_86,seq85,r_50_187_86,1.0,0,86,86,71
4,r_94_186_133,seq141,r_194_58_178,r_94_186_133,0.67,45,178,133,71
16,r_1_163_177,seq170,r_40_198_159,r_1_163_177,0.45,2,179,177,71
5,r_80_159_143,seq172,seq157,r_80_159_143,0.87,0,143,143,71
6,r_177_75_49,r_204_82_66,seq19,r_177_75_49,1.0,0,49,49,71
45,r_78_60_169,seq218,r_193_102_5,r_78_60_169,0.8,0,169,169,71
19,r_194_58_178,seq210,r_94_186_133,r_94_186_133,0.52,45,178,133,71
124,seq79,r_54_221_135,r_155_45_53,r_155_45_53,1.0,1,54,53,71
27,r_202_152_19,r_2_107_172,r_121_130_104,r_202_152_19,0.97,0,19,19,71
66,r_92_138_57,r_123_173_69,r_62_33_11,r_123_173_69,0.88,-9,60,69,71
31,r_212_98_26,r_155_45_53,seq151,r_212_98_26,1.0,0,26,26,71
103,seq172,r_80_159_143,r_184_196_58,r_184_196_58,0.64,85,143,58,71
69,r_121_130_104,r_179_120_169,r_202_152_19,r_202_152_19,0.98,12,31,19,71
67,r_224_153_189,seq69,r_193_102_5,r_193_102_5,0.76,184,189,5,71
3,r_39_106_76,r_8_116_194,seq140,r_39_106_76,0.99,5,81,76,71
10,r_91_122_88,r_53_110_4,seq161,r_91_122_88,0.96,1,89,88,71
34,r_124_41_38,seq81,r_202_152_19,r_124_41_38,0.93,0,38,38,71
72,r_67_105_158,r_214_142_186,r_94_186_133,r_67_105_158,0.82,0,158,158,71
139,seq101,r_214_142_186,r_150_136_171,r_150_136_171,0.56,16,187,171,71
54,r_48_169_16,r_104_96_40,r_50_187_86,r_48_169_16,1.0,0,16,16,71
4,r_94_186_133,seq171,seq141,r_94_186_133,0.88,0,133,133,71
73,r_14_164_93,r_53_110_4,seq199,r_14_164_93,1.0,0,93,93,71
11,r_53_110_4,r_91_122_88,r_209_211_47,r_53_110_4,0.95,85,89,4,71
87,seq19,seq200,r_177_75_49,r_177_75_49,1.0,-5,44,49,71
20,r_190_36_147,r_154_219_93,seq140,r_154_219_93,0.96,0,93,93,71
13,r_193_102_5,r_46_25_110,r_212_98_26,r_193_102_5,0.99,105,110,5,71
44,r_50_187_86,seq12,r_48_169_16,r_48_169_16,0.96,19,35,16,71
27,r_202_152_19,r_124_41_38,r_179_120_169,r_179_120_169,0.48,-5,164,169,71
57,r_26_4_139,r_8_116_194,seq34,r_26_4_139,0.9,0,139,139,71
118,seq200,seq47,r_90_99_21,r_90_99_21,1.0,22,43,21,71
141,seq108,r_179_120_169,r_167_31_73,r_167_31_73,1.0,34,107,73,71
2,r_133_158_36,r_71_127_193,r_86_189_162,r_133_158_36,0.37,122,158,36,71
39,r_155_45_53,seq43,seq79,r_155_45_53,1.0,0,53,53,71
44,r_50_187_86,r_48_169_16,r_204_82_66,r_50_187_86,1.0,0,86,86,71
56,r_71_127_193,r_24_115_151,r_133_158_36,r_133_158_36,0.8,7,43,36,71
51,r_179_120_169,r_154_219_93,r_202_152_19,r_179_120_169,0.72,1,170,169,71
22,r_11_195_37,r_86_189_162,seq108,r_86_189_162,0.65,1,163,162,71
69,r_121_130_104,r_202_152_19,r_91_122_88,r_121_130_104,0.99,0,104,104,71
47,r_55_77_161,r_179_120_169,r_54_221_135,r_55_77_161,0.88,0,161,161,71
54,r_48_169_16,seq85,r_109_197_111,r_109_197_111,1.0,0,111,111,71
105,seq157,seq43,r_80_159_143,r_80_159_143,1.0,-1,142,143,71
74,r_24_115_151,r_71_127_193,seq74,r_24_115_151,0.82,0,151,151,71
18,r_13_183_168,seq175,r_167_31_73,r_167_31_73,1.0,95,168,73,71
1,r_184_196_58,r_168_52_176,seq172,r_184_196_58,1.0,0,58,58,71
61,r_86_189_162,r_11_195_37,r_133_158_36,r_86_189_162,0.39,1,163,162,71
24,r_123_173_69,r_92_138_57,r_10_103_11,r_123_173_69,0.99,1,70,69,71
25,r_76_139_116,seq42,seq0,r_76_139_116,0.95,0,116,116,71
127,seq210,r_194_58_178,r_49_27_79,r_49_27_79,0.97,99,178,79,71
64,r_54_221_135,seq213,r_53_110_4,r_54_221_135,0.62,0,135,135,71
50,r_70_44_101,seq29,seq220,r_70_44_101,1.0,2,103,101,71
58,r_132_129_90,seq84,r_90_99_21,r_132_129_90,0.93,0,90,90,71
32,r_8_116_194,r_39_106_76,r_156_114_17,r_8_116_194,0.83,-113,81,194,71
38,r_49_27_79,r_214_142_186,seq140,r_49_27_79,0.97,0,79,79,71
52,r_119_95_125,seq28,r_70_44_101,r_119_95_125,0.81,0,125,125,71
28,r_209_211_47,seq181,r_222_113_154,r_209_211_47,0.98,6,53,47,71
60,r_165_72_59,r_54_221_135,r_222_113_154,r_165_72_59,0.88,3,62,59,71
81,seq12,seq85,r_5_68_144,r_5_68_144,1.0,1,145,144,71
17,r_144_201_88,seq181,seq128,r_144_201_88,0.94,-1,87,88,71
9,r_168_52_176,r_215_35_198,seq128,r_215_35_198,0.36,-17,181,198,71
29,r_62_33_11,r_109_197_111,r_92_138_57,r_62_33_11,0.57,62,73,11,71
22,r_11_195_37,seq192,r_86_189_162,r_11_195_37,1.0,0,37,37,71
40,r_90_99_21,r_40_198_159,seq200,r_90_99_21,1.0,0,21,21,71
49,r_154_219_93,r_190_36_147,r_11_195_37,r_154_219_93,1.0,0,93,93,71
149,seq213,r_54_221_135,r_70_44_101,r_70_44_101,0.99,34,135,101,71
7,r_150_136_171,seq88,seq29,r_150_136_171,0.71,0,171,171,71
11,r_53_110_4,r_209_211_47,r_54_221_135,r_54_221_135,0.82,0,135,135,71
41,r_104_96_40,r_55_77_161,seq206,r_104_96_40,0.98,0,40,40,71
82,seq141,r_179_120_169,seq108,r_179_120_169,0.3,-16,153,169,71
65,r_73_160_12,r_13_183_168,seq3,r_73_160_12,1.0,1,13,12,71
15,r_204_82_66,seq143,seq7,r_204_82_66,0.92,1,67,66,71
35,r_182_65_165,seq3,seq188,r_182_65_165,0.9,1,166,165,71
29,r_62_33_11,r_80_159_143,r_109_197_111,r_62_33_11,0.5,0,11,11,71
2,r_133_158_36,r_190_36_147,r_71_127_193,r_133_158_36,1.0,0,36,36,71
93,seq22,r_110_80_180,r_97_150_75,r_97_150_75,1.0,59,134,75,72
41,r_181_168_45,r_110_80_180,seq177,r_181_168_45,1.0,0,45,45,72
30,r_47_25_139,r_110_80_180,r_210_188_75,r_210_188_75,1.0,44,119,75,72
36,r_218_202_80,r_110_80_180,seq174,r_218_202_80,1.0,0,80,80,72
43,r_171_217_165,r_126_136_143,r_182_223_131,r_182_223_131,0.6,13,144,131,72
70,r_9_207_12,r_124_34_75,seq40,r_9_207_12,0.98,0,12,12,72
146,seq118,r_37_112_170,seq137,r_37_112_170,0.85,0,170,170,72
43,r_171_217_165,r_182_223_131,r_47_25_139,r_171_217_165,0.92,0,165,165,72
37,r_71_185_107,r_126_136_143,r_61_162_43,r_71_185_107,0.94,-1,106,107,72
59,r_106_94_86,r_128_81_184,seq208,r_106_94_86,0.67,3,89,86,72
55,r_119_109_98,seq39,seq170,r_119_109_98,0.65,2,100,98,72
71,r_92_117_177,seq186,r_181_168_45,r_181_168_45,0.68,132,177,45,72
21,r_68_195_185,seq172,r_50_205_99,r_50_205_99,1.0,1,100,99,72
39,r_7_152_60,r_96_75_135,seq102,r_7_152_60,0.82,0,60,60,72
1,r_21_107_148,r_83_30_143,r_20_173_10,r_21_107_148,0.9,-5,143,148,72
4,r_4_151_38,r_114_144_108,r_197_85_172,r_4_151_38,0.99,2,40,38,72
28,r_216_63_46,seq42,seq187,r_216_63_46,0.74,5,51,46,72
42,r_50_205_99,seq65,seq172,r_50_205_99,0.93,1,100,99,72
80,seq135,r_182_223_131,seq104,r_182_223_131,0.62,-9,122,131,72
32,r_97_150_75,r_210_188_75,r_83_30_143,r_83_30_143,0.99,40,183,143,72
69,r_126_136_143,r_171_217_165,seq135,r_126_136_143,0.94,1,144,143,72
19,r_198_64_99,r_215_178_149,r_9_207_12,r_198_64_99,1.0,3,102,99,72
66,r_31_51_133,seq40,r_167_1_89,r_31_51_133,0.99,1,134,133,72
76,seq3,r_197_85_172,r_103_45_84,r_197_85_172,0.74,0,172,172,72
31,r_158_88_130,seq221,r_124_34_75,r_158_88_130,0.59,0,130,130,72
8,r_121_154_50,r_179_76_178,seq142,r_121_154_50,1.0,0,50,50,72
110,seq172,r_193_98_82,seq35,r_193_98_82,1.0,0,82,82,72
15,r_113_79_50,r_121_154_50,seq186,r_113_79_50,1.0,1,51,50,72
3,r_60_77_66,seq135,seq40,r_60_77_66,0.94,2,68,66,72
10,r_153_36_142,seq222,seq164,r_153_36_142,0.99,0,142,142,72
62,r_141_148_57,seq108,seq139,r_141_148_57,0.98,0,57,57,72
40,r_214_156_44,r_97_150_75,seq186,r_97_150_75,1.0,-30,45,75,72
109,seq49,seq108,r_124_34_75,r_124_34_75,1.0,2,77,75,72
72,r_215_178_149,r_198_64_99,r_121_154_50,r_215_178_149,0.93,-49,100,149,72
80,seq135,seq104,r_126_136_143,r_126_136_143,1.0,0,143,143,72
0,r_219_138_178,seq58,r_175_91_157,r_219_138_178,0.54,1,179,178,72
63,r_169_95_91,seq174,seq123,r_169_95_91,1.0,2,93,91,72
16,r_220_192_57,seq208,seq102,r_220_192_57,0.96,0,57,57,72
20,r_122_73_153,seq40,r_6_125_156,r_122_73_153,0.85,3,156,153,72
13,r_179_76_178,seq132,r_198_64_99,r_198_64_99,1.0,80,179,99,72
56,r_53_82_41,r_70_191_155,r_124_34_75,r_53_82_41,0.73,116,157,41,72
48,r_210_188_75,seq27,seq134,r_210_188_75,1.0,0,75,75,72
4,r_4_151_38,r_197_85_172,r_16_147_162,r_4_151_38,0.77,126,164,38,72
51,r_61_162_43,seq35,seq165,r_61_162_43,0.98,0,43,43,72
6,r_114_144_108,r_215_178_149,seq123,r_114_144_108,0.74,0,108,108,72
27,r_37_112_170,seq118,r_4_151_38,r_37_112_170,0.81,0,170,170,72
53,r_70_191_155,r_53_82_41,r_9_207_12,r_70_191_155,0.94,2,157,155,72
148,seq123,r_19_160_188,r_114_144_108,r_114_144_108,1.0,52,160,108,72
72,r_215_178_149,r_121_154_50,r_105_38_4,r_215_178_149,0.99,0,149,149,72
87,seq143,r_175_91_157,seq140,r_175_91_157,0.84,0,157,157,72
2,r_83_30_143,r_21_107_148,r_97_150_75,r_83_30_143,0.7,1,144,143,72
47,r_18_189_73,seq40,seq222,r_18_189_73,1.0,1,74,73,72
74,r_46_209_67,r_167_1_89,seq101,r_46_209_67,1.0,0,67,67,72
18,r_19_160_188,seq123,r_48_2_15,r_19_160_188,0.24,0,188,188,72
29,r_175_91_157,seq143,r_121_154_50,r_121_154_50,0.73,111,161,50,72
24,r_116_14_29,r_122_73_153,seq146,r_116_14_29,0.97,0,29,29,72
25,r_110_80_180,r_218_202_80,seq134,r_218_202_80,1.0,-9,71,80,72
33,r_193_98_82,seq172,seq157,r_193_98_82,1.0,0,82,82,72
64,r_74_41_116,r_179_76_178,r_7_152_60,r_74_41_116,0.91,4,120,116,72
143,seq108,seq17,r_43_54_34,r_43_54_34,1.0,10,44,34,72
50,r_161_0_190,seq104,r_103_45_84,r_103_45_84,0.8,106,190,84,72
58,r_16_147_162,seq186,r_4_151_38,r_16_147_162,0.7,1,163,162,72
68,r_32_29_187,seq87,r_121_154_50,r_121_154_50,0.97,139,189,50,72
61,r_167_1_89,r_46_209_67,r_113_79_50,r_167_1_89,0.75,-22,67,89,72
32,r_97_150_75,seq87,r_210_188_75,r_97_150_75,0.94,0,75,75,72
61,r_167_1_89,r_113_79_50,seq206,r_167_1_89,1.0,1,90,89,72
38,r_204_15_155,r_13_52_188,r_119_109_98,r_119_109_98,0.54,55,153,98,72
52,r_182_223_131,seq135,r_74_41_116,r_182_223_131,0.74,1,132,131,72
67,r_183_24_14,r_60_77_66,seq196,r_183_24_14,0.99,-3,11,14,72
56,r_53_82_41,seq201,r_70_191_155,r_53_82_41,1.0,0,41,41,72
26,r_43_54_34,r_19_160_188,seq108,r_43_54_34,0.99,0,34,34,72
81,seq8,r_111_57_165,r_127_72_80,r_127_72_80,0.71,85,165,80,72
17,r_124_34_75,r_111_57_165,r_128_81_184,r_124_34_75,1.0,1,76,75,72
25,r_110_80_180,seq134,seq39,r_110_80_180,0.66,4,184,180,72
53,r_70_191_155,seq130,r_53_82_41,r_53_82_41,1.0,9,50,41,72
9,r_6_125_156,r_203_62_195,r_122_73_153,r_6_125_156,0.86,0,156,156,72
49,r_111_57_165,seq8,r_106_94_86,r_111_57_165,0.84,0,165,165,72
7,r_127_72_80,seq199,seq8,r_127_72_80,0.98,1,81,80,72
44,r_129_166_143,seq196,seq28,r_129_166_143,0.98,0,143,143,72
23,r_5_200_89,seq49,seq86,r_5_200_89,0.95,0,89,89,72
30,r_47_25_139,r_210_188_75,r_183_24_14,r_47_25_139,0.99,-3,136,139,72
101,seq139,seq28,r_141_148_57,r_141_148_57,1.0,13,70,57,72
79,seq134,r_110_80_180,r_210_188_75,r_210_188_75,1.0,19,94,75,72
35,r_128_81_184,r_106_94_86,r_124_34_75,r_124_34_75,1.0,14,89,75,72
12,r_197_85_172,seq3,seq137,r_197_85_172,0.78,0,172,172,72
40,r_131_219_64,r_165_177_150,r_211_104_81,r_131_219_64,0.87,87,151,64,73
44,r_10_200_39,r_59_110_162,seq136,r_59_110_162,1.0,0,162,162,73
51,r_34_166_134,seq54,r_217_36_25,r_34_166_134,0.73,0,134,134,73
36,r_41_118_177,r_82_30_60,seq135,r_82_30_60,0.59,117,177,60,73
92,seq153,r_145_157_132,r_137_45_140,r_145_157_132,0.46,0,132,132,73
147,seq115,r_161_9_100,r_210_79_101,r_161_9_100,0.84,2,102,100,73
8,r_165_177_150,r_93_39_198,r_131_219_64,r_131_219_64,1.0,2,66,64,73
43,r_210_79_101,seq28,seq115,r_210_79_101,0.58,0,101,101,73
54,r_35_143_80,r_100_86_122,r_40_126_62,r_35_143_80,1.0,0,80,80,73
37,r_207_25_77,seq202,seq222,r_207_25_77,0.99,1,78,77,73
59,r_161_9_100,seq115,r_208_120_17,r_161_9_100,1.0,2,102,100,73
28,r_103_37_24,r_34_166_134,r_44_62_12,r_103_37_24,0.89,0,24,24,73
55,r_168_214_185,seq224,r_100_86_122,r_100_86_122,0.63,63,185,122,73
71,r_169_74_97,r_137_45_140,r_206_90_58,r_206_90_58,1.0,41,99,58,73
16,r_197_174_103,r_63_112_195,r_187_49_45,r_197_174_103,0.97,0,103,103,73
21,r_138_128_107,r_75_221_75,r_213_151_185,r_75_221_75,1.0,0,75,75,73
39,r_81_162_125,seq148,seq88,r_81_162_125,0.98,0,125,125,73
46,r_223_122_118,r_63_112_195,r_40_126_62,r_223_122_118,0.55,5,123,118,73
22,r_77_3_24,r_160_31_132,seq48,r_77_3_24,1.0,0,24,24,73
73,r_191_185_41,r_34_166_134,seq124,r_191_185_41,0.92,0,41,41,73
80,seq8,r_170_146_185,r_123_173_89,r_123_173_89,0.98,96,185,89,73
45,r_59_110_162,seq136,r_10_200_39,r_10_200_39,0.99,30,69,39,73
92,seq153,r_137_45_140,r_64_99_152,r_64_99_152,0.97,1,153,152,73
19,r_198_154_132,r_137_45_140,seq109,r_198_154_132,0.98,0,132,132,73
41,r_204_127_22,r_50_189_134,r_203_1_22,r_204_127_22,1.0,0,22,22,73
44,r_10_200_39,seq109,r_59_110_162,r_10_200_39,1.0,0,39,39,73
66,r_129_167_84,seq4,seq133,r_129_167_84,1.0,0,84,84,73
31,r_170_146_185,seq8,r_207_25_77,r_207_25_77,0.68,108,185,77,73
67,r_218_125_125,seq87,seq149,r_218_125_125,1.0,0,125,125,73
3,r_76_215_138,seq73,r_116_18_9,r_76_215_138,0.97,0,138,138,73
47,r_44_62_12,r_160_31_132,seq108,r_44_62_12,1.0,0,12,12,73
0,r_208_120_17,seq2,seq27,r_208_120_17,0.99,0,17,17,73
8,r_165_177_150,r_131_219_64,r_50_189_134,r_165_177_150,0.65,1,151,150,73
72,r_98_176_125,seq16,seq14,r_98_176_125,0.85,0,125,125,73
63,r_75_221_75,r_138_128_107,r_106_142_46,r_138_128_107,0.7,-32,75,107,73
11,r_68_29_165,r_113_71_198,r_44_62_12,r_68_29_165,0.76,1,166,165,73
20,r_137_45_140,seq108,r_206_90_58,r_206_90_58,0.78,82,140,58,73
13,r_211_104_81,seq183,seq89,r_211_104_81,0.99,0,81,81,73
98,seq164,r_32_11_178,r_204_127_22,r_204_127_22,0.94,157,179,22,73
56,r_85_6_154,r_116_18_9,seq96,r_85_6_154,0.98,0,154,154,73
15,r_80_102_117,seq115,seq16,r_80_102_117,0.99,2,119,117,73
48,r_5_61_101,r_76_215_138,r_44_62_12,r_5_61_101,0.97,0,101,101,73
49,r_50_189_134,r_82_30_60,r_70_188_48,r_50_189_134,0.95,1,135,134,73
57,r_7_111_133,seq52,seq56,r_7_111_133,0.95,0,133,133,73
23,r_51_23_12,r_58_156_6,r_117_17_69,r_51_23_12,0.92,1,13,12,73
6,r_132_196_176,seq144,r_77_3_24,r_132_196_176,0.52,2,178,176,73
29,r_171_13_41,r_137_45_140,seq73,r_171_13_41,0.92,2,43,41,73
94,seq27,r_69_107_185,r_208_120_17,r_208_120_17,1.0,0,17,17,73
53,r_21_92_26,r_100_86_122,seq136,r_100_86_122,1.0,0,122,122,73
69,r_116_18_9,r_85_6_154,r_76_215_138,r_116_18_9,0.98,145,154,9,73
42,r_187_49_45,seq135,r_82_30_60,r_187_49_45,0.99,0,45,45,73
142,seq144,r_132_196_176,r_186_20_46,r_186_20_46,1.0,132,178,46,73
40,r_131_219_64,r_117_17_69,r_165_177_150,r_131_219_64,1.0,0,64,64,73
18,r_64_99_152,seq101,seq153,r_64_99_152,0.71,0,152,152,73
34,r_184_159_57,seq47,seq46,r_184_159_57,1.0,1,58,57,73
61,r_203_1_22,seq135,seq164,r_203_1_22,0.99,1,23,22,73
25,r_100_86_122,r_35_143_80,r_21_92_26,r_100_86_122,0.99,-42,80,122,73
70,r_213_151_185,r_44_62_12,r_137_45_140,r_44_62_12,0.73,173,185,12,73
53,r_21_92_26,r_7_111_133,r_100_86_122,r_21_92_26,1.0,1,27,26,73
47,r_44_62_12,seq108,r_5_61_101,r_5_61_101,1.0,41,142,101,73
50,r_105_119_113,r_137_45_140,r_113_71_198,r_105_119_113,1.0,0,113,113,73
58,r_175_60_86,r_213_151_185,seq52,r_175_60_86,0.97,0,86,86,73
70,r_213_151_185,r_175_60_86,r_44_62_12,r_175_60_86,0.9,0,86,86,73
21,r_138_128_107,r_213_151_185,r_75_221_75,r_138_128_107,1.0,0,107,107,73
65,r_40_126_62,seq163,seq67,r_40_126_62,0.98,3,65,62,73
68,r_130_179_64,seq121,r_204_127_22,r_130_179_64,0.97,0,64,64,73
38,r_123_173_89,r_93_39_198,seq12,r_123_173_89,1.0,0,89,89,73
52,r_180_194_95,seq57,r_106_142_46,r_180_194_95,0.94,0,95,95,73
27,r_206_90_58,r_158_91_156,seq73,r_206_90_58,1.0,0,58,58,73
79,seq135,r_203_1_22,seq181,r_203_1_22,0.79,1,23,22,73
2,r_186_20_46,r_98_176_125,seq144,r_186_20_46,1.0,1,47,46,73
49,r_50_189_134,r_204_127_22,r_82_30_60,r_204_127_22,1.0,-1,21,22,73
124,seq73,r_76_215_138,r_206_90_58,r_206_90_58,0.6,60,118,58,73
4,r_217_36_25,r_76_215_138,r_44_62_12,r_217_36_25,1.0,-4,21,25,73
32,r_70_188_48,r_197_174_103,seq183,r_70_188_48,1.0,0,48,48,73
60,r_95_66_120,seq148,r_40_126_62,r_95_66_120,0.99,0,120,120,73
45,r_59_110_162,r_10_200_39,r_105_119_113,r_59_110_162,0.97,0,162,162,73
17,r_113_71_198,r_68_29_165,r_105_119_113,r_105_119_113,0.91,6,119,113,73
119,seq67,seq2,r_40_126_62,r_40_126_62,1.0,30,92,62,73
112,seq56,seq14,r_7_111_133,r_7_111_133,0.99,2,135,133,73
144,seq109,seq12,r_198_154_132,r_198_154_132,1.0,37,169,132,73
30,r_220_139_25,r_58_156_6,seq89,r_220_139_25,1.0,0,25,25,73
145,seq222,r_68_29_165,r_207_25_77,r_207_25_77,0.92,0,77,77,73
33,r_106_142_46,r_175_60_86,seq216,r_106_142_46,1.0,1,47,46,73
9,r_150_15_25,r_117_17_69,seq67,r_150_15_25,0.97,1,26,25,73
149,seq124,r_93_39_198,r_100_86_122,r_100_86_122,1.0,0,122,122,73
138,seq97,seq47,r_171_13_41,r_171_13_41,1.0,26,67,41,73
25,r_100_86_122,r_21_92_26,seq124,r_100_86_122,0.99,0,122,122,73
12,r_32_11_178,seq164,r_217_36_25,r_217_36_25,0.48,154,179,25,73
135,seq216,r_98_176_125,r_106_142_46,r_106_142_46,0.84,4,50,46,73
84,seq14,r_32_11_178,r_98_176_125,r_98_176_125,0.75,-3,122,125,73
37,r_142_105_46,r_108_62_106,r_144_100_6,r_142_105_46,0.79,1,47,46,74
30,r_160_140_67,r_179_24_40,seq150,r_160_140_67,1.0,2,69,67,74
51,r_163_56_115,r_81_50_189,r_67_54_108,r_163_56_115,0.81,0,115,115,74
36,r_75_203_114,seq12,r_29_110_12,r_75_203_114,0.99,0,114,114,74
14,r_221_79_112,r_109_166_173,seq173,r_221_79_112,0.72,0,112,112,74
8,r_185_124_145,seq206,r_66_21_69,r_185_124_145,0.56,7,152,145,74
43,r_47_83_62,r_29_110_12,seq137,r_47_83_62,0.96,5,67,62,74
54,r_29_110_12,r_47_83_62,seq208,r_47_83_62,0.86,0,62,62,74
59,r_67_54_108,seq197,seq65,r_67_54_108,0.82,1,109,108,74
7,r_91_2_45,seq118,seq102,r_91_2_45,0.62,-3,42,45,74
55,r_153_51_137,seq211,seq137,r_153_51_137,0.8,2,139,137,74
71,r_55_154_134,seq92,r_46_115_22,r_55_154_134,0.43,5,139,134,74
16,r_177_58_79,seq113,r_156_187_82,r_177_58_79,1.0,0,79,79,74
21,r_96_168_131,r_109_166_173,r_57_34_93,r_96_168_131,0.94,0,131,131,74
39,r_57_34_93,seq77,r_194_11_184,r_57_34_93,0.96,5,98,93,74
69,r_30_112_154,seq222,seq77,r_30_112_154,0.61,0,154,154,74
45,r_194_11_184,seq36,seq13,r_194_11_184,0.56,1,185,184,74
70,r_0_103_23,r_160_140_67,seq43,r_0_103_23,0.82,2,25,23,74
66,r_93_22_131,r_45_71_186,r_29_110_12,r_93_22_131,0.58,1,132,131,74
100,seq42,r_133_3_135,r_7_217_147,r_133_3_135,0.67,1,136,135,74
31,r_109_166_173,seq70,r_1_132_35,r_1_132_35,0.98,139,174,35,74
129,seq85,r_172_131_195,r_41_104_85,r_41_104_85,1.0,83,168,85,74
41,r_66_21_69,seq209,seq222,r_66_21_69,0.79,3,72,69,74
67,r_193_139_13,seq158,r_141_61_196,r_193_139_13,0.68,-1,12,13,74
90,seq152,r_127_198_156,r_63_14_176,r_127_198_156,1.0,6,162,156,74
26,r_127_198_156,seq152,r_162_215_87,r_127_198_156,0.58,5,161,156,74
72,r_190_202_126,seq220,r_45_71_186,r_45_71_186,0.64,-47,139,186,74
119,seq183,r_162_215_87,seq174,r_162_215_87,0.55,36,123,87,74
0,r_121_19_73,seq10,r_146_116_66,r_121_19_73,1.0,1,74,73,74
63,r_45_71_186,r_93_22_131,r_190_202_126,r_190_202_126,0.5,6,132,126,74
11,r_41_104_85,seq77,seq85,r_41_104_85,1.0,1,86,85,74
62,r_141_61_196,r_148_181_69,r_193_139_13,r_148_181_69,0.77,-40,29,69,74
39,r_57_34_93,r_194_11_184,r_96_168_131,r_96_168_131,0.55,1,132,131,74
13,r_46_115_22,r_32_80_7,r_55_154_134,r_55_154_134,0.5,-71,63,134,74
15,r_37_107_160,r_31_192_192,r_179_24_40,r_37_107_160,0.5,0,160,160,74
48,r_186_155_115,r_30_112_154,seq213,r_186_155_115,0.9,0,115,115,74
57,r_123_199_62,r_146_116_66,seq114,r_123_199_62,1.0,0,62,62,74
6,r_6_122_72,seq137,seq101,r_6_122_72,1.0,1,73,72,74
101,seq43,r_37_107_160,r_0_103_23,r_0_103_23,0.5,6,29,23,74
9,r_40_147_30,r_6_122_72,seq23,r_6_122_72,0.86,-36,36,72,74
99,seq220,r_190_202_126,seq15,r_190_202_126,0.75,13,139,126,74
4,r_87_26_55,seq82,seq92,r_87_26_55,1.0,0,55,55,74
27,r_146_116_66,r_75_203_114,r_44_27_30,r_146_116_66,0.98,5,71,66,74
72,r_190_202_126,r_45_71_186,r_17_68_106,r_45_71_186,0.76,2,188,186,74
22,r_44_27_30,seq165,r_121_19_73,r_121_19_73,1.0,35,108,73,74
47,r_73_184_104,r_108_62_106,r_41_104_85,r_108_62_106,0.99,-3,103,106,74
142,seq113,r_177_58_79,seq12,r_177_58_79,1.0,0,79,79,74
74,r_48_182_182,seq4,r_63_14_176,r_48_182_182,0.22,5,187,182,74
18,r_108_62_106,seq84,seq118,r_108_62_106,0.95,0,106,106,74
24,r_145_178_78,seq211,seq197,r_145_178_78,0.96,3,81,78,74
25,r_95_125_78,seq35,seq42,r_95_125_78,0.83,-7,71,78,74
64,r_31_192_192,r_37_107_160,r_39_196_59,r_39_196_59,1.0,101,160,59,74
32,r_133_3_135,seq42,seq138,r_133_3_135,0.82,1,136,135,74
22,r_44_27_30,r_67_54_108,seq165,r_44_27_30,0.88,0,30,30,74
52,r_25_86_157,r_81_50_189,seq84,r_25_86_157,0.6,5,162,157,74
77,seq4,r_48_182_182,r_49_207_169,r_49_207_169,0.63,17,186,169,74
124,seq208,r_5_94_161,r_75_203_114,r_75_203_114,0.96,48,162,114,74
17,r_49_207_169,seq8,seq4,r_49_207_169,0.52,0,169,169,74
12,r_39_196_59,seq143,r_37_107_160,r_39_196_59,0.91,0,59,59,74
53,r_1_132_35,seq143,seq10,r_1_132_35,0.93,0,35,35,74
144,seq118,r_91_2_45,r_37_107_160,r_91_2_45,0.7,4,49,45,74
28,r_162_215_87,seq65,seq20,r_162_215_87,1.0,2,89,87,74
102,seq173,r_148_181_69,r_193_139_13,r_148_181_69,0.92,1,70,69,74
63,r_45_71_186,r_190_202_126,r_108_62_106,r_45_71_186,0.9,1,187,186,74
49,r_169_216_81,r_127_198_156,r_28_188_16,r_169_216_81,0.99,13,94,81,74
44,r_164_106_162,seq206,r_78_161_168,r_164_106_162,0.31,3,165,162,74
23,r_148_181_69,seq173,r_219_223_4,r_148_181_69,0.92,2,71,69,74
138,seq101,r_117_191_190,r_6_122_72,r_6_122_72,1.0,23,95,72,74
82,seq12,r_75_203_114,seq8,r_75_203_114,0.99,0,114,114,74
79,seq8,r_49_207_169,seq12,r_49_207_169,0.89,0,169,169,74
12,r_39_196_59,r_37_107_160,r_74_129_84,r_74_129_84,0.92,-1,83,84,74
35,r_130_195_21,seq8,seq77,r_130_195_21,1.0,0,21,21,74
30,r_89_178_163,seq33,r_63_158_21,r_89_178_163,0.97,0,163,163,75
51,r_214_129_89,r_153_143_156,seq11,r_214_129_89,0.86,0,89,89,75
14,r_79_218_172,seq50,r_159_97_122,r_79_218_172,0.58,0,172,172,75
8,r_51_2_146,seq169,r_19_74_8,r_51_2_146,0.95,1,147,146,75
43,r_113_184_60,seq7,r_91_40_61,r_113_184_60,1.0,0,60,60,75
54,r_196_221_124,seq44,r_132_5_124,r_196_221_124,1.0,0,124,124,75
37,r_66_223_156,r_210_166_121,r_188_110_46,r_188_110_46,0.83,28,74,46,75
71,r_71_182_40,r_113_184_60,seq164,r_71_182_40,0.59,0,40,40,75
59,r_151_37_77,r_159_97_122,r_61_85_44,r_151_37_77,1.0,0,77,77,75
42,r_14_95_166,seq130,seq31,r_14_95_166,0.79,0,166,166,75
7,r_188_110_46,r_66_223_156,r_88_56_141,r_188_110_46,1.0,98,144,46,75
69,r_122_203_68,seq137,seq217,r_122_203_68,1.0,1,69,68,75
58,r_146_73_42,seq9,seq7,r_146_73_42,0.98,0,42,42,75
2,r_25_167_32,r_127_8_172,seq39,r_25_167_32,1.0,0,32,32,75
103,seq44,r_196_221_124,r_210_166_121,r_196_221_124,1.0,-12,112,124,75
9,r_206_101_23,r_14_95_166,seq115,r_206_101_23,1.0,0,23,23,75
31,r_58_76_73,r_107_0_115,seq181,r_58_76_73,1.0,0,73,73,75
41,r_68_199_181,seq15,r_49_175_161,r_68_199_181,0.42,0,181,181,75
67,r_108_186_81,r_107_0_115,seq98,r_108_186_81,0.88,2,83,81,75
110,seq137,r_122_203_68,r_125_12_32,r_122_203_68,1.0,1,69,68,75
89,seq20,r_4_134_190,r_206_101_23,r_206_101_23,1.0,167,190,23,75
3,r_219_100_156,r_23_16_198,seq198,r_219_100_156,0.82,1,157,156,75
115,seq65,r_69_111_157,r_148_24_135,r_69_111_157,0.51,-14,143,157,75
72,r_162_92_128,r_89_178_163,seq65,r_162_92_128,0.95,0,128,128,75
4,r_49_175_161,seq154,r_64_48_59,r_64_48_59,1.0,13,72,59,75
114,seq192,r_106_62_123,r_57_163_82,r_57_163_82,1.0,41,123,82,75
73,r_17_96_157,seq75,seq128,r_17_96_157,0.8,0,157,157,75
11,r_106_62_123,seq192,seq98,r_106_62_123,0.68,0,123,123,75
20,r_172_123_115,seq10,r_34_32_76,r_34_32_76,0.75,40,116,76,75
13,r_104_81_67,r_189_46_198,seq124,r_104_81_67,1.0,0,67,67,75
15,r_215_187_106,r_18_21_124,r_57_163_82,r_18_21_124,1.0,-18,106,124,75
48,r_18_21_124,r_132_5_124,seq109,r_18_21_124,1.0,0,124,124,75
4,r_49_175_161,r_64_48_59,seq174,r_49_175_161,0.95,2,163,161,75
57,r_88_56_141,seq174,r_188_110_46,r_88_56_141,0.77,0,141,141,75
6,r_103_160_104,r_171_53_188,r_140_114_30,r_171_53_188,0.72,-84,104,188,75
141,seq109,r_153_143_156,r_18_21_124,r_18_21_124,0.99,1,125,124,75
16,r_125_12_32,seq209,seq137,r_125_12_32,0.94,2,34,32,75
10,r_64_48_59,r_49_175_161,seq161,r_49_175_161,0.93,2,163,161,75
33,r_149_38_31,seq145,seq33,r_149_38_31,1.0,0,31,31,75
1,r_78_36_12,r_206_101_23,r_141_208_198,r_78_36_12,0.95,0,12,12,75
10,r_64_48_59,r_148_24_135,r_49_175_161,r_64_48_59,1.0,0,59,59,75
7,r_188_110_46,r_58_76_73,r_66_223_156,r_188_110_46,0.86,1,47,46,75
38,r_135_212_22,r_189_46_198,seq209,r_135_212_22,1.0,0,22,22,75
40,r_57_163_82,seq80,seq192,r_57_163_82,1.0,0,82,82,75
74,r_72_43_166,seq26,r_14_95_166,r_72_43_166,0.56,-1,165,166,75
29,r_112_119_180,r_132_5_124,seq15,r_132_5_124,0.38,56,180,124,75
66,r_141_208_198,seq39,r_78_36_12,r_78_36_12,0.95,19,31,12,75
24,r_173_177_122,r_60_30_194,r_151_37_77,r_173_177_122,0.82,0,122,122,75
63,r_148_24_135,r_64_48_59,r_67_150_9,r_64_48_59,1.0,-23,36,59,75
25,r_210_166_121,r_66_223_156,seq44,r_66_223_156,0.99,-33,123,156,75
64,r_136_131_83,seq195,seq128,r_136_131_83,1.0,0,83,83,75
70,r_4_134_190,seq20,r_49_175_161,r_49_175_161,0.92,29,190,161,75
68,r_61_85_44,r_189_46_198,r_151_37_77,r_151_37_77,1.0,5,82,77,75
127,seq209,r_125_12_32,r_70_216_36,r_70_216_36,0.99,4,40,36,75
52,r_140_114_30,r_68_199_181,seq174,r_140_114_30,0.99,0,30,30,75
34,r_121_165_155,seq201,r_132_5_124,r_121_165_155,0.86,0,155,155,75
36,r_152_105_36,r_210_166_121,seq15,r_210_166_121,0.71,-74,47,121,75
28,r_22_45_46,r_196_221_124,seq10,r_196_221_124,0.99,-74,50,124,75
21,r_183_102_34,r_214_129_89,seq75,r_183_102_34,1.0,1,35,34,75
45,r_67_150_9,r_148_24_135,r_159_97_122,r_159_97_122,0.61,14,136,122,75
17,r_171_53_188,r_103_160_104,seq15,r_103_160_104,1.0,-6,98,104,75
140,seq195,r_210_166_121,r_107_0_115,r_107_0_115,0.92,55,170,115,75
22,r_83_55_28,r_183_102_34,seq115,r_83_55_28,1.0,0,28,28,75
63,r_148_24_135,r_67_150_9,seq65,r_148_24_135,0.93,1,136,135,75
53,r_197_138_42,seq120,seq50,r_197_138_42,1.0,0,42,42,75
37,r_66_223_156,r_188_110_46,r_77_3_34,r_66_223_156,1.0,0,156,156,75
91,seq26,r_72_43_166,r_25_167_32,r_25_167_32,0.71,134,166,32,75
140,seq195,r_136_131_83,r_210_166_121,r_136_131_83,1.0,-1,82,83,75
56,r_99_156_80,seq31,seq145,r_99_156_80,1.0,0,80,80,75
44,r_159_97_122,seq82,r_67_150_9,r_159_97_122,1.0,1,123,122,75
18,r_202_157_38,r_210_166_121,r_60_30_194,r_202_157_38,1.0,2,40,38,75
138,seq224,r_69_111_157,r_34_32_76,r_34_32_76,0.94,81,157,76,75
17,r_171_53_188,seq15,r_106_62_123,r_171_53_188,0.4,0,188,188,75
60,r_19_74_8,seq27,r_51_2_146,r_51_2_146,1.0,6,152,146,75
35,r_91_40_61,seq211,r_113_184_60,r_113_184_60,1.0,6,66,60,75
12,r_34_32_76,r_189_46_198,seq75,r_34_32_76,1.0,0,76,76,75
39,r_70_216_36,r_49_175_161,seq209,r_70_216_36,1.0,0,36,36,75
30,r_163_116_138,seq103,r_193_44_4,r_163_116_138,0.82,0,138,138,76
59,r_212_104_118,r_163_116_138,r_112_28_154,r_163_116_138,0.68,-121,17,138,76
36,r_165_10_154,r_201_161_164,seq3,r_201_161_164,0.59,-4,160,164,76
14,r_68_121_132,seq46,r_18_52_112,r_68_121_132,1.0,0,132,132,76
8,r_53_158_97,r_176_184_103,r_212_104_118,r_53_158_97,0.85,0,97,97,76
53,r_15_16_95,seq21,seq199,r_15_16_95,1.0,0,95,95,76
43,r_25_223_172,seq107,r_96_77_41,r_96_77_41,1.0,133,174,41,76
146,seq147,r_113_120_178,r_194_37_73,r_113_120_178,0.48,0,178,178,76
125,seq80,r_201_161_164,r_205_75_47,r_205_75_47,0.91,119,166,47,76
21,r_97_99_130,seq51,seq0,r_97_99_130,1.0,0,130,130,76
1,r_24_180_70,r_213_2_139,seq31,r_24_180_70,1.0,0,70,70,76
5,r_128_42_124,seq94,seq95,r_128_42_124,1.0,0,124,124,76
46,r_79_123_186,seq26,r_86_76_94,r_86_76_94,1.0,92,186,94,76
111,seq55,r_18_52_112,r_23_169_75,r_18_52_112,0.77,-26,86,112,76
69,r_134_81_153,r_79_123_186,seq94,r_79_123_186,0.48,-34,152,186,76
33,r_96_77_41,seq51,seq133,r_96_77_41,1.0,1,42,41,76
28,r_90_115_58,r_11_170_58,r_176_184_103,r_176_184_103,1.0,0,103,103,76
19,r_194_37_73,seq218,seq101,r_194_37_73,0.64,41,114,73,76
28,r_90_115_58,r_68_121_132,r_11_170_58,r_90_115_58,1.0,0,58,58,76
66,r_124_105_177,seq94,r_165_10_154,r_165_10_154,0.63,25,179,154,76
3,r_192_220_97,seq222,r_60_74_84,r_192_220_97,0.82,0,97,97,76
10,r_155_20_117,r_73_217_56,seq215,r_155_20_117,0.77,14,131,117,76
90,seq148,seq34,r_5_198_100,r_5_198_100,0.93,-1,99,100,76
115,seq189,r_224_111_144,seq30,r_224_111_144,1.0,1,145,144,76
26,r_154_150_71,r_151_108_198,seq51,r_154_150_71,1.0,0,71,71,76
139,seq102,seq103,r_139_171_131,r_139_171_131,1.0,11,142,131,76
0,r_43_71_183,seq80,r_113_120_178,r_113_120_178,0.64,8,186,178,76
63,r_166_8_113,seq189,r_73_217_56,r_166_8_113,1.0,0,113,113,76
73,r_72_14_90,r_18_52_112,r_126_36_76,r_18_52_112,0.81,-22,90,112,76
11,r_208_207_116,r_128_42_124,r_58_183_32,r_128_42_124,0.7,-7,117,124,76
13,r_152_66_63,seq102,seq199,r_152_66_63,1.0,5,68,63,76
15,r_139_171_131,seq46,seq102,r_139_171_131,0.94,0,131,131,76
16,r_58_183_32,r_86_76_94,seq54,r_58_183_32,1.0,0,32,32,76
57,r_70_178_151,seq135,seq0,r_70_178_151,0.58,0,151,151,76
6,r_113_120_178,seq147,seq159,r_113_120_178,0.43,0,178,178,76
62,r_112_28_154,seq202,seq103,r_112_28_154,0.8,1,155,154,76
141,seq107,r_25_223_172,r_221_132_146,r_221_132_146,0.56,28,174,146,76
85,seq141,r_63_173_180,r_96_77_41,r_96_77_41,1.0,139,180,41,76
134,seq94,r_128_42_124,seq138,r_128_42_124,1.0,0,124,124,76
27,r_201_161_164,seq80,seq85,r_201_161_164,0.5,2,166,164,76
47,r_7_143_113,seq54,r_90_115_58,r_7_143_113,0.72,-1,112,113,76
59,r_212_104_118,r_112_28_154,r_53_158_97,r_53_158_97,0.92,1,98,97,76
40,r_160_140_132,seq187,seq94,r_160_140_132,0.49,3,135,132,76
71,r_60_74_84,r_25_223_172,seq27,r_60_74_84,0.61,-52,32,84,76
126,seq82,r_176_184_103,seq118,r_176_184_103,0.69,5,108,103,76
58,r_9_78_28,r_152_66_63,seq3,r_9_78_28,1.0,0,28,28,76
18,r_5_198_100,seq26,seq148,r_5_198_100,0.81,-1,99,100,76
59,r_212_104_118,r_53_158_97,r_205_75_47,r_212_104_118,0.97,0,118,118,76
71,r_60_74_84,r_203_29_187,r_192_220_97,r_192_220_97,0.95,6,103,97,76
12,r_153_167_32,r_188_88_74,seq197,r_153_167_32,0.51,0,32,32,76
70,r_23_169_75,seq69,seq55,r_23_169_75,0.62,4,79,75,76
51,r_11_170_58,r_203_29_187,r_90_115_58,r_11_170_58,0.52,1,59,58,76
65,r_200_129_143,seq103,r_192_220_97,r_200_129_143,0.57,0,143,143,76
67,r_50_61_38,r_68_121_132,seq26,r_50_61_38,0.97,0,38,38,76
61,r_126_36_76,r_57_35_92,seq146,r_126_36_76,1.0,0,76,76,76
38,r_18_52_112,seq55,r_40_33_7,r_18_52_112,0.64,1,113,112,76
52,r_151_108_198,r_154_150_71,seq6,r_154_150_71,1.0,0,71,71,76
34,r_176_184_103,seq82,r_90_115_58,r_90_115_58,0.96,50,108,58,76
71,r_60_74_84,seq27,r_203_29_187,r_60_74_84,0.94,0,84,84,76
64,r_40_33_7,seq107,r_18_52_112,r_18_52_112,0.99,6,118,112,76
60,r_56_119_176,seq85,seq107,r_56_119_176,0.46,2,178,176,76
81,seq156,r_203_29_187,r_163_116_138,r_163_116_138,0.99,14,152,138,76
17,r_63_173_180,seq141,r_59_196_9,r_63_173_180,0.67,0,180,180,76
9,r_221_132_146,r_201_161_164,r_68_121_132,r_68_121_132,0.97,14,146,132,76
8,r_53_158_97,r_212_104_118,r_154_150_71,r_212_104_118,0.76,0,118,118,76
48,r_62_67_42,r_68_121_132,seq87,r_62_67_42,1.0,1,43,42,76
22,r_100_93_149,seq107,r_117_64_96,r_117_64_96,0.74,55,151,96,76
49,r_214_48_51,r_70_178_151,seq187,r_214_48_51,0.96,1,52,51,76
140,seq103,r_163_116_138,seq102,r_163_116_138,1.0,0,138,138,76
4,r_211_210_44,r_203_29_187,seq187,r_211_210_44,0.96,1,45,44,76
54,r_205_75_47,r_203_29_187,seq92,r_205_75_47,0.96,5,52,47,76
7,r_117_64_96,r_83_91_146,seq142,r_117_64_96,0.97,2,98,96,76
44,r_181_45_106,seq26,seq197,r_181_45_106,0.98,0,106,106,76
23,r_130_162_86,r_208_207_116,seq26,r_208_207_116,0.93,-27,89,116,76
138,seq101,seq185,r_194_37_73,r_194_37_73,0.65,35,108,73,76
30,r_203_148_139,seq14,r_116_224_43,r_203_148_139,0.98,0,139,139,77
138,seq97,r_16_163_96,r_43_113_32,r_43_113_32,1.0,-2,30,32,77
36,r_153_118_101,r_63_39_197,r_31_213_193,r_153_118_101,0.98,1,102,101,77
122,seq77,r_10_142_133,seq83,r_10_142_133,1.0,-55,78,133,77
8,r_23_79_146,seq112,r_153_118_101,r_23_79_146,0.66,0,146,146,77
73,r_116_224_43,r_132_47_54,r_203_148_139,r_203_148_139,0.59,0,139,139,77
55,r_8_78_157,r_22_29_37,seq75,r_22_29_37,0.45,121,158,37,77
71,r_190_35_80,seq194,r_138_89_81,r_190_35_80,0.95,2,82,80,77
70,r_127_108_18,seq6,seq151,r_127_108_18,0.65,3,21,18,77
16,r_164_123_92,seq220,r_22_29_37,r_164_123_92,0.65,-20,72,92,77
39,r_135_110_107,seq33,seq159,r_135_110_107,1.0,1,108,107,77
46,r_102_104_63,r_53_186_147,seq205,r_102_104_63,1.0,0,63,63,77
42,r_10_142_133,seq77,seq220,r_10_142_133,1.0,0,133,133,77
111,seq202,r_4_105_2,r_145_37_172,r_145_37_172,0.94,10,182,172,77
65,r_106_67_47,r_0_223_71,seq50,r_106_67_47,1.0,0,47,47,77
19,r_65_216_128,seq204,seq187,r_65_216_128,0.89,0,128,128,77
11,r_221_87_183,r_70_169_71,r_62_181_18,r_70_169_71,0.56,112,183,71,77
27,r_178_91_126,r_116_224_43,r_138_89_81,r_178_91_126,0.68,0,126,126,77
76,seq5,r_184_155_196,r_100_72_81,r_100_72_81,1.0,9,90,81,77
31,r_179_126_78,r_162_121_87,seq51,r_179_126_78,0.73,-1,77,78,77
41,r_57_13_80,r_178_91_126,seq36,r_57_13_80,1.0,1,81,80,77
67,r_30_177_150,seq222,seq111,r_30_177_150,0.69,0,150,150,77
68,r_62_181_18,r_99_64_155,seq83,r_62_181_18,0.98,1,19,18,77
27,r_178_91_126,r_57_13_80,r_116_224_43,r_116_224_43,0.48,0,43,43,77
10,r_99_64_155,seq143,seq220,r_99_64_155,0.57,0,155,155,77
43,r_11_166_25,seq96,seq134,r_11_166_25,1.0,-1,24,25,77
72,r_131_207_85,r_178_91_126,seq217,r_178_91_126,0.98,-25,101,126,77
51,r_60_25_19,r_69_12_152,seq24,r_60_25_19,0.66,1,20,19,77
4,r_69_12_152,r_160_1_184,seq167,r_69_12_152,0.62,0,152,152,77
63,r_70_169_71,seq133,seq209,r_70_169_71,1.0,0,71,71,77
11,r_221_87_183,r_138_89_81,r_70_169_71,r_221_87_183,1.0,-112,71,183,77
3,r_176_27_13,r_125_129_134,r_127_108_18,r_176_27_13,0.99,0,13,13,77
20,r_86_103_127,r_183_61_168,r_184_155_196,r_86_103_127,0.86,0,127,127,77
13,r_22_29_37,r_4_105_2,r_164_123_92,r_22_29_37,0.72,31,68,37,77
133,seq219,seq174,r_109_139_40,r_109_139_40,0.95,-4,36,40,77
48,r_199_21_94,r_145_37_172,seq5,r_199_21_94,1.0,1,95,94,77
6,r_141_149_178,seq217,seq18,r_141_149_178,0.42,0,178,178,77
62,r_183_61_168,seq6,r_179_126_78,r_179_126_78,1.0,90,168,78,77
2,r_53_186_147,r_137_185_2,r_212_175_23,r_53_186_147,0.85,0,147,147,77
59,r_156_56_63,seq75,seq52,r_156_56_63,0.72,-16,47,63,77
36,r_153_118_101,r_31_213_193,r_23_79_146,r_23_79_146,0.89,9,155,146,77
2,r_53_186_147,r_182_15_131,r_137_185_2,r_182_15_131,0.63,0,131,131,77
21,r_63_39_197,r_153_118_101,seq83,r_153_118_101,1.0,-42,59,101,77
47,r_147_44_135,r_66_93_2,r_62_181_18,r_147_44_135,0.99,0,135,135,77
17,r_73_42_29,r_98_34_30,seq17,r_73_42_29,0.81,-2,27,29,77
18,r_182_15_131,r_53_186_147,r_116_224_43,r_182_15_131,0.86,0,131,131,77
29,r_92_197_182,seq82,r_71_189_154,r_92_197_182,0.48,0,182,182,77
24,r_138_89_81,seq173,r_190_35_80,r_138_89_81,1.0,0,81,81,77
25,r_208_161_89,r_66_93_2,seq194,r_208_161_89,0.95,1,90,89,77
33,r_48_9_125,seq124,r_38_55_191,r_48_9_125,0.99,0,125,125,77
64,r_16_163_96,seq97,r_60_25_19,r_16_163_96,0.79,2,98,96,77
50,r_71_189_154,r_53_186_147,seq45,r_53_186_147,0.38,-14,133,147,77
58,r_150_206_146,seq180,r_43_113_32,r_43_113_32,0.98,120,152,32,77
38,r_85_157_187,seq191,r_208_161_89,r_208_161_89,0.63,98,187,89,77
52,r_41_140_186,seq152,r_198_54_42,r_198_54_42,0.73,144,186,42,77
0,r_128_196_42,seq112,r_38_55_191,r_128_196_42,0.86,0,42,42,77
73,r_116_224_43,r_66_93_2,r_178_91_126,r_116_224_43,1.0,0,43,43,77
34,r_146_130_157,seq83,r_58_117_30,r_146_130_157,0.87,0,157,157,77
15,r_98_34_30,r_73_42_29,seq124,r_98_34_30,1.0,1,31,30,77
26,r_109_139_40,r_66_93_2,seq219,r_109_139_40,0.91,-1,39,40,77
60,r_192_2_79,r_199_21_94,seq33,r_192_2_79,0.89,0,79,79,77
40,r_58_117_30,r_92_197_182,seq50,r_58_117_30,0.99,0,30,30,77
9,r_172_88_160,r_38_55_191,seq80,r_172_88_160,0.86,0,160,160,77
50,r_71_189_154,seq45,seq124,r_71_189_154,0.96,0,154,154,77
14,r_43_113_32,seq40,seq97,r_43_113_32,0.99,0,32,32,77
28,r_212_175_23,r_66_93_2,seq143,r_212_175_23,0.78,0,23,23,77
73,r_116_224_43,r_178_91_126,r_132_47_54,r_116_224_43,0.47,83,126,43,77
49,r_218_90_149,r_30_177_150,seq40,r_218_90_149,0.93,0,149,149,77
149,seq124,r_48_9_125,seq168,r_48_9_125,1.0,0,125,125,77
56,r_94_107_137,seq3,seq168,r_94_107_137,1.0,0,137,137,77
7,r_100_72_81,seq111,seq5,r_100_72_81,0.98,1,82,81,77
44,r_125_129_134,seq80,r_102_104_63,r_125_129_134,1.0,0,134,134,77
131,seq217,r_141_149_178,seq222,r_141_149_178,1.0,0,178,178,77
35,r_160_1_184,r_38_55_191,r_119_101_58,r_38_55_191,0.19,-7,184,191,77
54,r_119_101_58,r_99_64_155,r_127_108_18,r_99_64_155,0.53,-100,55,155,77
22,r_0_223_71,r_106_67_47,seq200,r_106_67_47,0.89,0,47,47,77
30,r_113_197_94,r_10_105_185,seq50,r_113_197_94,1.0,1,95,94,78
110,seq136,seq58,r_120_154_8,r_120_154_8,0.99,10,18,8,78
36,r_178_190_130,seq61,r_55_163_111,r_178_190_130,0.83,0,130,130,78
54,r_104_169_58,seq93,seq168,r_104_169_58,1.0,0,58,58,78
8,r_174_221_124,seq138,r_13_54_123,r_174_221_124,0.99,0,124,124,78
53,r_127_16_187,r_144_186_98,seq224,r_144_186_98,0.93,0,98,98,78
43,r_194_159_101,r_173_62_132,seq148,r_194_159_101,1.0,0,101,101,78
146,seq114,seq31,r_198_111_46,r_198_111_46,1.0,16,62,46,78
37,r_60_123_81,seq87,r_129_85_7,r_60_123_81,0.98,0,81,81,78
55,r_146_20_102,seq2,r_129_85_7,r_146_20_102,1.0,0,102,102,78
71,r_39_49_172,r_109_38_135,r_212_158_121,r_212_158_121,0.86,2,123,121,78
16,r_65_210_123,r_75_96_184,r_194_159_101,r_75_96_184,1.0,-61,123,184,78
39,r_202_45_103,r_173_62_132,r_129_85_7,r_202_45_103,1.0,0,103,103,78
46,r_109_38_135,r_10_105_185,seq77,r_109_38_135,0.95,0,135,135,78
80,seq150,r_6_189_111,seq76,r_6_189_111,1.0,-19,92,111,78
69,r_110_21_162,r_51_59_173,seq145,r_110_21_162,0.88,0,162,162,78
19,r_75_96_184,r_133_28_187,seq31,r_133_28_187,0.5,-2,185,187,78
10,r_170_126_46,seq180,seq37,r_170_126_46,0.75,0,46,46,78
31,r_26_139_38,seq142,seq131,r_26_139_38,1.0,0,38,38,78
14,r_107_48_14,r_213_119_194,seq180,r_107_48_14,1.0,0,14,14,78
41,r_19_214_73,r_194_159_101,r_12_192_25,r_194_159_101,0.69,-30,71,101,78
45,r_132_5_21,r_55_163_111,seq222,r_132_5_21,0.99,0,21,21,78
26,r_55_163_111,seq72,seq93,r_55_163_111,0.94,0,111,111,78
72,r_206_184_132,seq128,r_102_219_43,r_206_184_132,1.0,0,132,132,78
4,r_6_189_111,seq150,r_15_81_7,r_6_189_111,0.88,0,111,111,78
63,r_35_205_105,r_109_38_135,r_194_159_101,r_35_205_105,1.0,3,108,105,78
73,r_115_98_178,seq188,r_68_33_107,r_68_33_107,0.97,71,178,107,78
2,r_102_219_43,r_122_172_98,seq87,r_102_219_43,1.0,0,43,43,78
107,seq46,r_24_67_176,r_70_106_140,r_70_106_140,0.81,10,150,140,78
13,r_68_33_107,r_94_103_51,r_137_40_53,r_68_33_107,0.38,-23,84,107,78
98,seq30,r_118_218_119,seq73,r_118_218_119,1.0,1,120,119,78
49,r_212_158_121,r_39_49_172,r_110_21_162,r_212_158_121,0.93,51,172,121,78
15,r_124_143_80,seq22,seq224,r_124_143_80,1.0,0,80,80,78
50,r_137_40_53,r_198_111_46,r_12_192_25,r_137_40_53,0.88,-30,23,53,78
57,r_118_218_119,seq30,r_90_156_71,r_118_218_119,0.95,1,120,119,78
6,r_24_67_176,seq46,r_65_210_123,r_65_210_123,0.53,54,177,123,78
62,r_173_62_132,seq167,seq179,r_173_62_132,0.69,3,135,132,78
18,r_12_192_25,seq175,r_107_48_14,r_107_48_14,0.56,8,22,14,78
52,r_51_59_173,seq217,seq220,r_51_59_173,0.98,1,174,173,78
53,r_127_16_187,seq224,r_102_219_43,r_127_16_187,0.55,0,187,187,78
50,r_137_40_53,r_12_192_25,seq142,r_137_40_53,0.77,12,65,53,78
70,r_164_141_61,seq95,seq72,r_164_141_61,0.92,-3,58,61,78
48,r_208_101_22,r_13_54_123,seq180,r_208_101_22,1.0,0,22,22,78
47,r_135_203_81,seq37,seq217,r_135_203_81,0.55,0,81,81,78
40,r_211_108_128,r_51_59_173,r_39_49_172,r_211_108_128,0.77,46,174,128,78
29,r_122_172_98,r_178_190_130,seq177,r_122_172_98,0.95,0,98,98,78
25,r_161_71_106,r_178_190_130,seq27,r_161_71_106,1.0,2,108,106,78
33,r_90_156_71,seq179,seq7,r_90_156_71,0.98,0,71,71,78
127,seq73,r_66_32_120,r_68_33_107,r_68_33_107,0.48,14,121,107,78
64,r_151_153_69,seq134,seq142,r_151_153_69,1.0,-2,67,69,78
58,r_193_176_73,r_70_106_140,r_15_81_7,r_15_81_7,0.58,66,73,7,78
21,r_199_17_11,r_24_67_176,r_91_160_193,r_199_17_11,0.72,0,11,11,78
68,r_165_34_173,r_10_105_185,r_55_163_111,r_165_34_173,0.16,2,175,173,78
61,r_56_74_173,seq52,seq30,r_56_74_173,0.62,2,175,173,78
38,r_1_157_84,r_213_119_194,seq37,r_1_157_84,0.86,-9,75,84,78
52,r_51_59_173,r_110_21_162,seq217,r_110_21_162,0.71,-66,96,162,78
77,seq2,r_146_20_102,seq217,r_146_20_102,1.0,0,102,102,78
13,r_68_33_107,r_137_40_53,seq73,r_68_33_107,0.96,0,107,107,78
71,r_39_49_172,r_212_158_121,r_91_160_193,r_39_49_172,0.98,0,172,172,78
60,r_166_121_156,seq0,r_173_62_132,r_166_121_156,0.9,0,156,156,78
17,r_66_32_120,seq73,seq147,r_66_32_120,0.87,1,121,120,78
3,r_198_111_46,r_170_126_46,seq114,r_198_111_46,1.0,0,46,46,78
27,r_149_99_57,r_70_106_140,seq93,r_149_99_57,1.0,0,57,57,78
22,r_13_54_123,seq131,r_174_221_124,r_13_54_123,0.99,0,123,123,78
28,r_70_106_140,seq224,seq46,r_70_106_140,0.98,1,141,140,78
49,r_212_158_121,seq222,r_39_49_172,r_212_158_121,0.92,0,121,121,78
74,r_44_14_19,r_66_32_120,r_199_17_11,r_44_14_19,1.0,0,19,19,78
56,r_144_186_98,r_127_16_187,seq31,r_127_16_187,0.5,-76,111,187,78
18,r_12_192_25,r_107_48_14,r_19_214_73,r_19_214_73,0.73,19,92,73,78
44,r_223_191_164,seq142,r_161_71_106,r_161_71_106,0.67,58,164,106,78
82,seq7,seq134,r_90_156_71,r_90_156_71,1.0,0,71,71,78
101,seq37,r_135_203_81,r_1_157_84,r_135_203_81,0.97,-6,75,81,78
126,seq72,r_55_163_111,r_164_141_61,r_55_163_111,0.74,-66,45,111,78
35,r_23_117_70,r_216_162_159,r_129_85_7,r_23_117_70,1.0,0,70,70,78
51,r_166_198_77,r_183_178_154,seq43,r_166_198_77,1.0,0,77,77,79
92,seq156,r_220_17_150,r_96_16_5,r_220_17_150,0.6,0,150,150,79
8,r_124_5_65,seq9,seq64,r_124_5_65,1.0,0,65,65,79
58,r_214_151_190,seq144,r_157_142_98,r_214_151_190,0.32,0,190,190,79
53,r_90_82_49,r_49_94_53,r_96_16_5,r_90_82_49,0.97,7,56,49,79
125,seq84,r_42_121_78,r_61_70_16,r_42_121_78,1.0,0,78,78,79
42,r_96_16_5,r_220_17_150,r_90_82_49,r_96_16_5,0.64,47,52,5,79
55,r_163_182_90,r_52_54_158,seq173,r_163_182_90,0.61,1,91,90,79
71,r_53_191_122,seq144,r_197_62_9,r_53_191_122,0.83,0,122,122,79
16,r_141_47_82,r_52_54_158,r_209_181_199,r_141_47_82,0.96,3,85,82,79
21,r_131_108_132,r_35_48_163,r_162_195_29,r_35_48_163,0.58,-30,133,163,79
39,r_126_58_154,seq111,r_165_91_74,r_165_91_74,0.97,81,155,74,79
25,r_110_57_40,r_28_205_153,seq212,r_110_57_40,1.0,0,40,40,79
1,r_93_26_59,seq176,seq34,r_93_26_59,1.0,1,60,59,79
97,seq34,seq206,r_93_26_59,r_93_26_59,1.0,31,90,59,79
143,seq115,r_35_48_163,seq68,r_35_48_163,0.94,0,163,163,79
56,r_217_95_54,seq196,r_28_205_153,r_217_95_54,1.0,0,54,54,79
111,seq64,seq216,r_124_5_65,r_124_5_65,1.0,0,65,65,79
35,r_105_146_18,r_93_26_59,seq25,r_105_146_18,0.69,0,18,18,79
59,r_167_92_31,seq68,r_177_221_110,r_167_92_31,1.0,0,31,31,79
69,r_220_17_150,seq156,r_154_89_97,r_220_17_150,0.62,0,150,150,79
45,r_138_145_81,r_209_181_199,r_77_8_82,r_138_145_81,0.98,4,85,81,79
19,r_21_74_43,r_23_11_163,r_42_121_78,r_42_121_78,0.94,61,139,78,79
27,r_177_221_110,r_167_92_31,r_15_67_195,r_177_221_110,1.0,0,110,110,79
31,r_179_143_64,seq208,seq216,r_179_143_64,1.0,0,64,64,79
41,r_23_11_163,r_21_74_43,seq140,r_23_11_163,0.52,0,163,163,79
67,r_215_83_104,r_39_1_166,r_42_121_78,r_39_1_166,0.75,-62,104,166,79
20,r_87_184_16,r_42_121_78,seq29,r_87_184_16,0.7,0,16,16,79
3,r_40_31_106,r_75_13_123,seq85,r_75_13_123,0.71,-17,106,123,79
109,seq56,seq4,r_160_2_63,r_160_2_63,1.0,13,76,63,79
4,r_171_186_7,r_71_147_3,seq118,r_71_147_3,0.6,123,126,3,79
63,r_39_1_166,r_215_83_104,r_162_195_29,r_215_83_104,0.71,0,104,104,79
73,r_168_190_122,r_73_172_135,seq136,r_168_190_122,0.57,0,122,122,79
11,r_158_14_81,r_63_76_90,seq36,r_158_14_81,0.81,0,81,81,79
56,r_217_95_54,r_28_205_153,r_73_172_135,r_217_95_54,1.0,96,150,54,79
6,r_149_128_155,seq170,r_174_150_113,r_149_128_155,0.56,1,156,155,79
62,r_183_178_154,seq208,r_141_47_82,r_141_47_82,0.69,72,154,82,79
2,r_209_181_199,r_138_145_81,r_141_47_82,r_209_181_199,0.97,-114,85,199,79
59,r_167_92_31,r_177_221_110,seq144,r_177_221_110,1.0,0,110,110,79
47,r_79_202_79,r_10_127_50,r_158_14_81,r_10_127_50,0.91,3,53,50,79
74,r_22_201_184,seq193,seq133,r_22_201_184,0.42,-1,183,184,79
18,r_63_76_90,r_28_205_153,r_163_182_90,r_63_76_90,0.99,0,90,90,79
29,r_42_121_78,seq84,r_21_74_43,r_42_121_78,1.0,0,78,78,79
24,r_114_80_162,r_185_88_161,seq208,r_114_80_162,0.57,2,164,162,79
7,r_154_89_97,r_137_148_199,r_220_17_150,r_154_89_97,0.73,57,154,97,79
33,r_165_91_74,seq153,seq98,r_165_91_74,1.0,0,74,74,79
64,r_174_150_113,seq36,seq111,r_174_150_113,0.61,6,119,113,79
37,r_33_223_38,r_139_102_38,seq122,r_33_223_38,1.0,0,38,38,79
54,r_139_102_38,r_33_223_38,seq208,r_139_102_38,0.97,0,38,38,79
50,r_75_13_123,seq130,r_61_70_16,r_75_13_123,0.72,0,123,123,79
58,r_214_151_190,r_119_123_163,seq144,r_119_123_163,0.4,-74,89,163,79
70,r_194_192_95,seq84,r_163_182_90,r_194_192_95,0.86,2,97,95,79
65,r_6_60_106,r_131_108_132,seq25,r_6_60_106,0.95,0,106,106,79
68,r_160_2_63,seq3,seq56,r_160_2_63,0.98,0,63,63,79
38,r_101_19_186,seq212,r_157_142_98,r_101_19_186,0.29,4,190,186,79
52,r_185_88_161,r_114_80_162,r_71_147_3,r_185_88_161,0.45,0,161,161,79
77,seq3,r_77_8_82,r_79_202_79,r_79_202_79,0.68,13,92,79,79
22,r_50_152_14,r_126_58_154,seq100,r_50_152_14,0.71,0,14,14,79
34,r_78_41_172,seq7,r_158_14_81,r_158_14_81,0.99,93,174,81,79
57,r_10_127_50,r_79_202_79,r_49_94_53,r_49_94_53,0.56,-1,52,53,79
81,seq7,r_78_41_172,seq20,r_78_41_172,0.95,-2,170,172,79
15,r_49_94_53,seq219,seq27,r_49_94_53,0.96,-1,52,53,79
17,r_157_142_98,seq133,r_96_16_5,r_157_142_98,0.95,0,98,98,79
121,seq208,r_179_143_64,r_139_102_38,r_179_143_64,0.67,0,64,64,79
9,r_38_117_69,r_40_31_106,seq213,r_38_117_69,1.0,0,69,69,79
36,r_162_195_29,r_124_5_65,seq219,r_162_195_29,0.76,1,30,29,79
135,seq100,seq27,r_50_152_14,r_50_152_14,0.99,0,14,14,79
133,seq98,seq18,r_165_91_74,r_165_91_74,1.0,22,96,74,79
28,r_77_8_82,seq3,r_138_145_81,r_77_8_82,0.97,2,84,82,79
91,seq27,seq100,r_49_94_53,r_49_94_53,1.0,18,71,53,79
49,r_119_123_163,seq213,r_21_74_43,r_119_123_163,0.49,11,174,163,79
140,seq111,r_126_58_154,r_149_128_155,r_126_58_154,0.57,1,155,154,79
149,seq213,r_119_123_163,r_38_117_69,r_38_117_69,1.0,105,174,69,79
7,r_154_89_97,r_53_191_122,r_137_148_199,r_154_89_97,0.63,1,98,97,79
108,seq55,seq133,r_72_37_153,r_72_37_153,0.97,17,170,153,79
27,r_177_221_110,r_214_151_190,r_167_92_31,r_167_92_31,0.99,8,39,31,79
12,r_175_207_125,r_52_54_158,seq99,r_175_207_125,0.91,0,125,125,79
128,seq216,seq222,r_179_143_64,r_179_143_64,1.0,21,85,64,79
93,seq147,seq59,r_175_106_97,r_175_106_97,1.0,4,101,97,80
51,r_57_87_66,seq178,seq92,r_57_87_66,1.0,0,66,66,80
36,r_157_201_159,seq153,r_166_159_53,r_166_159_53,0.99,106,159,53,80
14,r_118_86_161,r_184_221_185,seq66,r_184_221_185,0.66,-24,161,185,80
8,r_9_194_109,seq56,seq42,r_9_194_109,1.0,0,109,109,80
58,r_136_119_12,r_179_88_178,r_210_197_30,r_210_197_30,0.54,73,103,30,80
125,seq207,r_145_91_168,r_26_2_132,r_26_2_132,0.87,35,167,132,80
78,seq135,seq30,r_199_182_27,r_199_182_27,1.0,0,27,27,80
53,r_40_50_32,r_55_165_60,seq54,r_40_50_32,1.0,1,33,32,80
54,r_145_91_168,seq207,seq60,r_145_91_168,0.72,-1,167,168,80
65,r_173_103_41,r_36_46_137,r_117_8_26,r_36_46_137,0.53,-96,41,137,80
50,r_21_149_169,seq115,r_143_124_148,r_21_149_169,0.66,-21,148,169,80
55,r_38_28_137,r_64_196_199,r_188_101_111,r_38_28_137,0.93,0,137,137,80
16,r_61_116_24,seq44,r_141_99_99,r_61_116_24,0.88,1,25,24,80
71,r_223_126_128,seq135,seq195,r_223_126_128,0.79,0,128,128,80
86,seq150,r_52_206_159,r_72_177_2,r_52_206_159,0.93,-8,151,159,80
21,r_213_161_60,r_215_181_136,seq59,r_213_161_60,1.0,0,60,60,80
1,r_52_206_159,seq150,r_188_101_111,r_52_206_159,0.59,0,159,159,80
143,seq109,r_143_124_148,seq81,r_143_124_148,0.66,0,148,148,80
5,r_110_12_62,seq162,seq56,r_110_12_62,1.0,0,62,62,80
46,r_17_151_153,seq4,seq205,r_17_151_153,0.64,7,160,153,80
19,r_215_181_136,r_200_11_183,seq56,r_215_181_136,0.45,5,141,136,80
31,r_191_183_44,r_102_132_123,seq125,r_191_183_44,1.0,0,44,44,80
100,seq44,seq160,r_220_171_59,r_220_171_59,1.0,19,78,59,80
129,seq84,r_168_32_180,r_1_100_10,r_1_100_10,0.79,170,180,10,80
67,r_200_11_183,r_215_181_136,r_36_46_137,r_36_46_137,1.0,4,141,137,80
30,r_15_6_5,r_210_197_30,r_1_100_10,r_15_6_5,0.61,25,30,5,80
89,seq153,r_157_201_159,r_47_53_160,r_157_201_159,1.0,0,159,159,80
3,r_128_22_126,r_51_216_134,seq185,r_128_22_126,0.95,1,127,126,80
10,r_26_2_132,seq125,seq152,r_26_2_132,0.99,0,132,132,80
87,seq217,seq107,r_166_159_53,r_166_159_53,1.0,0,53,53,80
72,r_0_95_178,seq169,seq133,r_0_95_178,0.57,0,178,178,80
16,r_61_116_24,r_141_99_99,r_55_165_60,r_61_116_24,0.82,77,101,24,80
60,r_210_197_30,r_15_6_5,r_136_119_12,r_210_197_30,1.0,0,30,30,80
4,r_141_99_99,r_224_214_161,seq211,r_141_99_99,1.0,2,101,99,80
0,r_36_46_137,seq83,r_200_11_183,r_200_11_183,0.59,-46,137,183,80
63,r_67_33_174,seq48,seq30,r_67_33_174,0.67,0,174,174,80
73,r_224_214_161,r_141_99_99,r_39_123_103,r_224_214_161,0.67,-60,101,161,80
58,r_136_119_12,r_1_100_10,r_179_88_178,r_136_119_12,0.97,0,12,12,80
23,r_179_88_178,r_102_132_123,r_136_119_12,r_136_119_12,0.94,12,24,12,80
112,seq189,seq59,r_71_5_90,r_71_5_90,0.96,3,93,90,80
62,r_71_5_90,seq154,seq189,r_71_5_90,1.0,0,90,90,80
15,r_65_43_55,r_19_14_85,r_155_80_56,r_65_43_55,0.98,1,56,55,80
99,seq42,seq217,r_9_194_109,r_9_194_109,1.0,0,109,109,80
9,r_220_171_59,r_141_99_99,seq44,r_220_171_59,0.86,0,59,59,80
29,r_29_108_50,r_19_14_85,seq44,r_29_108_50,1.0,0,50,50,80
70,r_117_8_26,r_36_46_137,r_72_177_2,r_117_8_26,0.98,0,26,26,80
27,r_204_156_121,seq104,r_71_5_90,r_204_156_121,0.75,1,122,121,80
59,r_72_177_2,r_52_206_159,r_117_8_26,r_117_8_26,1.0,0,26,26,80
30,r_15_6_5,r_1_100_10,r_157_201_159,r_157_201_159,0.62,24,183,159,80
39,r_23_137_35,r_9_194_109,seq195,r_23_137_35,1.0,0,35,35,80
35,r_155_80_56,seq150,r_65_43_55,r_155_80_56,1.0,0,56,56,80
2,r_55_165_60,r_188_101_111,r_61_116_24,r_55_165_60,1.0,0,60,60,80
47,r_39_123_103,seq195,r_7_130_108,r_39_123_103,0.92,5,108,103,80
105,seq158,r_25_172_87,r_120_113_117,r_25_172_87,1.0,2,89,87,80
17,r_208_139_55,seq62,seq83,r_208_139_55,0.99,0,55,55,80
24,r_51_216_134,seq59,r_55_165_60,r_51_216_134,0.93,0,134,134,80
25,r_168_32_180,seq84,r_26_2_132,r_168_32_180,0.47,0,180,180,80
33,r_184_221_185,r_45_192_114,seq63,r_45_192_114,0.62,2,116,114,80
64,r_96_193_99,r_93_144_90,seq186,r_96_193_99,0.94,2,101,99,80
42,r_1_100_10,r_136_119_12,seq84,r_1_100_10,1.0,0,10,10,80
68,r_35_70_93,r_64_196_199,seq152,r_35_70_93,1.0,1,94,93,80
61,r_73_49_146,seq63,seq127,r_73_49_146,1.0,0,146,146,80
32,r_93_144_90,r_96_193_99,seq90,r_93_144_90,0.95,2,92,90,80
38,r_19_14_85,seq133,r_208_139_55,r_19_14_85,0.9,1,86,85,80
52,r_7_130_108,r_31_167_124,r_39_123_103,r_7_130_108,0.56,0,108,108,80
50,r_21_149_169,r_36_46_137,seq115,r_21_149_169,0.57,-76,93,169,80
20,r_199_182_27,seq76,seq135,r_199_182_27,1.0,0,27,27,80
34,r_112_94_153,seq146,r_55_165_60,r_55_165_60,0.65,93,153,60,80
18,r_143_124_148,r_21_149_169,r_120_113_117,r_21_149_169,0.85,4,173,169,80
45,r_166_159_53,r_204_156_121,seq217,r_166_159_53,1.0,0,53,53,80
28,r_142_78_144,seq195,r_58_176_129,r_142_78_144,0.96,0,144,144,80
73,r_224_214_161,r_39_123_103,r_82_74_127,r_224_214_161,0.92,2,163,161,80
49,r_25_172_87,seq158,r_55_165_60,r_25_172_87,0.92,2,89,87,80
50,r_21_149_169,r_143_124_148,r_73_49_146,r_143_124_148,0.47,21,169,148,80
56,r_89_122_178,r_10_41_175,r_57_87_66,r_89_122_178,0.48,0,178,178,80
7,r_175_106_97,r_96_193_99,seq147,r_175_106_97,1.0,0,97,97,80
44,r_45_192_114,r_184_221_185,seq154,r_184_221_185,0.81,-69,116,185,80
23,r_179_88_178,r_136_119_12,r_47_53_160,r_136_119_12,0.57,167,179,12,80
128,seq83,r_36_46_137,r_208_139_55,r_208_139_55,0.83,82,137,55,80
30,r_170_19_63,seq187,r_172_10_40,r_170_19_63,1.0,0,63,63,81
149,seq125,r_158_159_16,r_132_185_29,r_132_185_29,1.0,2,31,29,81
14,r_84_211_83,seq43,seq201,r_84_211_83,1.0,0,83,83,81
53,r_0_44_199,r_115_186_136,r_200_80_31,r_0_44_199,0.63,-99,100,199,81
43,r_48_53_87,r_26_224_89,seq221,r_48_53_87,0.97,0,87,87,81
19,r_160_66_16,r_132_185_29,seq40,r_160_66_16,0.99,0,16,16,81
55,r_143_140_87,seq136,r_172_10_40,r_143_140_87,0.9,1,88,87,81
71,r_114_206_186,r_135_108_25,r_45_107_121,r_45_107_121,1.0,65,186,121,81
16,r_154_81_164,r_0_44_199,r_45_107_121,r_0_44_199,0.91,-35,164,199,81
21,r_16_175_107,seq3,r_222_76_23,r_16_175_107,1.0,0,107,107,81
65,r_42_33_26,r_170_19_63,seq43,r_170_19_63,0.95,-21,42,63,81
1,r_202_47_113,r_15_207_188,r_69_94_83,r_202_47_113,0.69,3,116,113,81
5,r_142_167_183,r_177_68_134,r_160_66_16,r_142_167_183,0.9,-48,135,183,81
104,seq174,r_69_94_83,seq187,r_69_94_83,1.0,1,84,83,81
46,r_177_68_134,r_142_167_183,r_38_181_80,r_177_68_134,0.86,1,135,134,81
42,r_198_9_81,r_84_211_83,seq3,r_198_9_81,1.0,1,82,81,81
7,r_88_98_172,r_18_6_30,seq178,r_88_98_172,0.57,0,172,172,81
69,r_74_203_61,r_165_101_91,seq13,r_74_203_61,0.53,0,61,61,81
29,r_18_6_30,seq179,r_88_98_172,r_18_6_30,0.99,0,30,30,81
45,r_104_214_32,seq83,r_155_137_128,r_104_214_32,0.99,0,32,32,81
66,r_130_64_86,seq79,r_38_181_80,r_130_64_86,0.97,2,88,86,81
38,r_191_46_183,r_23_129_79,r_160_66_16,r_191_46_183,0.44,1,184,183,81
31,r_23_129_79,r_15_207_188,r_191_46_183,r_23_129_79,0.49,6,85,79,81
41,r_134_149_124,seq164,r_126_113_7,r_134_149_124,0.93,0,124,124,81
67,r_15_207_188,seq105,r_205_127_59,r_15_207_188,0.29,1,189,188,81
10,r_45_107_121,r_165_101_91,r_154_81_164,r_154_81_164,1.0,2,166,164,81
110,seq182,seq147,r_11_56_63,r_11_56_63,1.0,27,90,63,81
3,r_163_208_58,seq201,seq215,r_163_208_58,1.0,2,60,58,81
10,r_45_107_121,r_114_206_186,r_165_101_91,r_114_206_186,0.94,-65,121,186,81
90,seq24,r_157_49_121,seq193,r_157_49_121,1.0,0,121,121,81
5,r_142_167_183,r_160_66_16,r_220_36_154,r_142_167_183,0.92,0,183,183,81
109,seq52,r_220_36_154,r_138_87_7,r_220_36_154,0.44,0,154,154,81
26,r_131_145_182,seq188,r_88_98_172,r_88_98_172,0.82,10,182,172,81
72,r_22_91_95,r_27_86_185,r_222_76_23,r_27_86_185,0.58,-89,96,185,81
13,r_222_76_23,r_45_107_121,seq120,r_45_107_121,0.54,-96,25,121,81
4,r_63_100_148,seq103,seq41,r_63_100_148,0.41,0,148,148,81
0,r_77_110_93,r_134_149_124,r_106_209_37,r_134_149_124,0.86,-20,104,124,81
63,r_157_49_121,seq24,r_222_76_23,r_157_49_121,0.78,0,121,121,81
11,r_27_86_185,seq179,r_97_219_135,r_97_219_135,0.66,50,185,135,81
107,seq178,r_17_54_129,seq139,r_17_54_129,0.85,0,129,129,81
146,seq120,seq12,r_222_76_23,r_222_76_23,0.81,16,39,23,81
20,r_71_30_147,r_63_100_148,r_89_37_117,r_63_100_148,0.9,-1,147,148,81
15,r_97_219_135,seq1,r_205_127_59,r_97_219_135,0.82,0,135,135,81
48,r_69_94_83,seq174,r_45_107_121,r_69_94_83,0.77,1,84,83,81
57,r_122_70_86,seq196,seq117,r_122_70_86,1.0,0,86,86,81
106,seq136,r_14_199_169,r_26_224_89,r_26_224_89,0.51,11,100,89,81
117,seq65,seq218,r_180_223_121,r_180_223_121,0.8,9,130,121,81
6,r_11_56_63,r_27_86_185,seq182,r_11_56_63,1.0,0,63,63,81
62,r_155_137_128,r_184_62_126,seq24,r_155_137_128,0.94,-1,127,128,81
56,r_4_116_133,r_165_101_91,r_106_209_37,r_4_116_133,0.94,0,133,133,81
23,r_165_101_91,r_38_181_80,seq148,r_165_101_91,0.96,0,91,91,81
17,r_205_127_59,r_4_116_133,seq166,r_205_127_59,1.0,0,59,59,81
27,r_184_62_126,r_155_137_128,seq147,r_184_62_126,0.98,1,127,126,81
2,r_38_181_80,seq123,seq1,r_38_181_80,0.98,1,81,80,81
47,r_89_37_117,r_45_107_121,r_96_152_7,r_89_37_117,0.99,0,117,117,81
59,r_96_152_7,r_162_151_163,r_89_37_117,r_89_37_117,0.94,6,123,117,81
40,r_146_189_92,seq117,seq201,r_146_189_92,0.74,1,93,92,81
105,seq176,r_2_204_167,seq79,r_2_204_167,0.75,2,169,167,81
74,r_183_78_113,seq13,r_160_66_16,r_160_66_16,0.58,106,122,16,81
18,r_220_36_154,seq52,seq39,r_220_36_154,0.94,0,154,154,81
34,r_162_151_163,r_96_152_7,r_160_66_16,r_162_151_163,0.84,1,164,163,81
25,r_156_195_106,r_4_116_133,r_104_214_32,r_156_195_106,0.97,2,108,106,81
33,r_115_186_136,seq1,r_158_159_16,r_115_186_136,0.76,6,142,136,81
64,r_190_217_63,seq136,seq32,r_190_217_63,0.96,3,66,63,81
88,seq150,r_114_206_186,r_106_209_37,r_114_206_186,0.68,-101,85,186,81
50,r_17_54_129,seq178,seq99,r_17_54_129,0.57,0,129,129,81
54,r_172_10_40,r_191_46_183,seq1,r_172_10_40,0.95,2,42,40,81
137,seq103,r_63_100_148,seq164,r_63_100_148,0.72,5,153,148,81
130,seq90,r_180_223_121,seq193,r_180_223_121,0.98,-13,108,121,81
32,r_26_224_89,r_115_186_136,seq136,r_26_224_89,0.48,5,94,89,81
38,r_191_46_183,r_172_10_40,r_23_129_79,r_191_46_183,0.81,-105,78,183,81
52,r_212_119_187,seq120,r_160_66_16,r_160_66_16,0.64,171,187,16,81
48,r_69_94_83,r_45_107_121,r_202_47_113,r_45_107_121,0.87,0,121,121,81
124,seq79,r_130_64_86,seq176,r_130_64_86,0.99,2,88,86,81
44,r_132_185_29,seq153,seq125,r_132_185_29,1.0,0,29,29,81
60,r_2_204_167,seq176,seq83,r_2_204_167,0.53,2,169,167,81
45,r_104_214_32,r_155_137_128,r_156_195_106,r_104_214_32,0.59,79,111,32,81
119,seq196,r_88_98_172,r_18_6_30,r_18_6_30,0.88,119,149,30,81
144,seq117,r_146_189_92,r_122_70_86,r_122_70_86,0.78,7,93,86,81
9,r_192_50_4,seq136,r_132_185_29,r_132_185_29,0.99,76,105,29,81
31,r_23_129_79,r_191_46_183,seq105,r_191_46_183,0.67,1,184,183,81
29,r_18_6_30,r_88_98_172,seq196,r_88_98_172,0.77,0,172,172,81
28,r_28_20_127,r_0_44_199,seq187,r_28_20_127,0.96,0,127,127,81
102,seq43,r_84_211_83,r_42_33_26,r_84_211_83,1.0,0,83,83,81
37,r_200_80_31,r_155_137_128,r_0_44_199,r_200_80_31,0.99,0,31,31,81
49,r_72_124_65,seq221,r_160_66_16,r_72_124_65,0.77,8,73,65,81
56,r_4_116_133,r_156_195_106,r_165_101_91,r_4_116_133,0.4,-25,108,133,81
7,r_88_98_172,seq196,r_18_6_30,r_18_6_30,0.97,53,83,30,81
23,r_165_101_91,r_74_203_61,r_38_181_80,r_74_203_61,0.65,0,61,61,81
35,r_14_199_169,r_158_159_16,r_198_9_81,r_14_199_169,0.65,0,169,169,81
12,r_161_93_100,seq148,seq31,r_161_93_100,0.99,0,100,100,81
58,r_35_34_45,r_216_5_197,r_132_185_29,r_35_34_45,1.0,0,45,45,81
36,r_201_86_3,r_101_193_145,r_61_142_155,r_101_193_145,0.72,2,147,145,82
6,r_135_115_48,r_205_113_165,r_17_169_154,r_135_115_48,1.0,-2,46,48,82
115,seq59,r_6_50_197,r_67_206_23,r_67_206_23,0.9,-8,15,23,82
92,seq154,seq35,r_198_176_121,r_198_176_121,0.37,-37,84,121,82
147,seq211,r_116_74_75,seq13,r_116_74_75,1.0,0,75,75,82
43,r_190_16_165,seq40,r_157_55_33,r_157_55_33,0.72,133,166,33,82
5,r_25_148_181,r_71_53_107,r_198_176_121,r_25_148_181,1.0,0,181,181,82
42,r_162_34_56,r_56_222_102,r_67_206_23,r_67_206_23,0.74,34,57,23,82
54,r_71_53_107,seq23,r_25_148_181,r_71_53_107,1.0,0,107,107,82
83,seq10,r_159_217_121,seq221,r_159_217_121,0.99,0,121,121,82
30,r_183_134_55,seq174,seq92,r_183_134_55,1.0,0,55,55,82
54,r_71_53_107,r_25_148_181,r_185_19_193,r_25_148_181,0.99,0,181,181,82
52,r_62_161_47,seq132,seq48,r_62_161_47,1.0,-1,46,47,82
55,r_82_20_134,seq199,seq69,r_82_20_134,0.7,2,136,134,82
16,r_205_113_165,seq155,seq2,r_205_113_165,0.96,0,165,165,82
39,r_37_196_80,r_99_131_178,seq172,r_37_196_80,1.0,0,80,80,82
5,r_25_148_181,seq18,r_71_53_107,r_71_53_107,1.0,17,124,107,82
46,r_149_105_183,seq48,r_185_19_193,r_149_105_183,0.34,0,183,183,82
69,r_164_11_75,seq80,seq199,r_164_11_75,1.0,0,75,75,82
3,r_87_89_173,r_207_117_102,r_66_220_34,r_87_89_173,0.79,-139,34,173,82
51,r_84_122_93,r_6_50_197,r_186_94_4,r_84_122_93,0.66,-69,24,93,82
45,r_210_68_124,r_39_5_51,r_26_30_199,r_39_5_51,0.87,0,51,51,82
19,r_56_222_102,seq187,r_70_77_63,r_56_222_102,0.85,0,102,102,82
58,r_73_98_54,r_60_128_121,r_123_218_44,r_73_98_54,1.0,0,54,54,82
41,r_97_136_70,r_54_197_196,r_100_27_147,r_54_197_196,0.85,-126,70,196,82
72,r_116_74_75,seq211,r_157_55_33,r_116_74_75,1.0,0,75,75,82
4,r_93_57_143,r_87_89_173,r_150_51_62,r_150_51_62,1.0,8,70,62,82
0,r_6_50_197,r_200_139_146,seq79,r_200_139_146,1.0,0,146,146,82
73,r_107_95_80,r_111_28_136,r_66_220_34,r_107_95_80,0.99,-4,76,80,82
11,r_101_193_145,r_201_86_3,seq58,r_101_193_145,0.68,2,147,145,82
13,r_146_49_97,r_185_19_193,seq180,r_146_49_97,0.85,0,97,97,82
15,r_120_209_188,seq92,r_38_104_53,r_38_104_53,0.94,135,188,53,82
4,r_93_57_143,r_150_51_62,seq202,r_93_57_143,1.0,0,143,143,82
57,r_130_177_186,seq224,r_81_153_162,r_130_177_186,0.37,0,186,186,82
12,r_150_51_62,r_93_57_143,r_6_50_197,r_93_57_143,1.0,0,143,143,82
70,r_66_220_34,r_215_191_59,r_87_89_173,r_66_220_34,1.0,0,34,34,82
141,seq187,r_56_222_102,seq109,r_56_222_102,0.94,2,104,102,82
61,r_91_203_98,r_38_104_53,r_56_222_102,r_38_104_53,0.97,1,54,53,82
10,r_38_104_53,r_91_203_98,seq32,r_38_104_53,1.0,1,54,53,82
62,r_173_14_55,r_6_50_197,seq219,r_173_14_55,0.73,-28,27,55,82
51,r_84_122_93,r_186_94_4,r_56_222_102,r_56_222_102,0.83,-1,101,102,82
37,r_17_169_154,r_116_74_75,r_135_115_48,r_17_169_154,1.0,-110,44,154,82
2,r_125_108_86,seq24,r_70_77_63,r_125_108_86,0.56,0,86,86,82
41,r_97_136_70,r_100_27_147,r_164_11_75,r_100_27_147,1.0,0,147,147,82
106,seq48,r_149_105_183,r_62_161_47,r_62_161_47,1.0,7,54,47,82
18,r_175_168_96,r_145_64_138,seq223,r_175_168_96,1.0,0,96,96,82
29,r_212_141_87,r_130_177_186,seq18,r_212_141_87,1.0,0,87,87,82
24,r_198_176_121,seq138,seq137,r_198_176_121,0.95,0,121,121,82
67,r_22_143_61,seq174,seq219,r_22_143_61,0.88,-3,58,61,82
25,r_207_117_102,r_54_197_196,r_135_115_48,r_207_117_102,1.0,0,102,102,82
116,seq188,r_147_12_181,r_39_5_51,r_39_5_51,1.0,0,51,51,82
64,r_200_139_146,r_6_50_197,seq199,r_200_139_146,0.99,0,146,146,82
65,r_100_27_147,r_97_136_70,seq79,r_100_27_147,1.0,0,147,147,82
6,r_135_115_48,r_17_169_154,r_207_117_102,r_135_115_48,0.96,59,107,48,82
65,r_100_27_147,seq138,r_97_136_70,r_97_136_70,1.0,2,72,70,82
68,r_126_8_168,r_54_197_196,r_145_64_138,r_145_64_138,0.35,31,169,138,82
21,r_119_165_33,seq184,seq219,r_119_165_33,1.0,0,33,33,82
44,r_41_182_26,seq219,seq58,r_41_182_26,0.91,0,26,26,82
137,seq221,r_163_144_154,seq10,r_163_144_154,0.92,1,155,154,82
96,seq32,r_123_218_44,r_38_104_53,r_38_104_53,1.0,0,53,53,82
32,r_215_191_59,seq172,seq32,r_215_191_59,1.0,1,60,59,82
74,r_88_43_61,seq42,seq195,r_88_43_61,0.81,-3,58,61,82
34,r_99_131_178,seq110,r_6_50_197,r_99_131_178,0.66,0,178,178,82
60,r_111_28_136,seq219,seq80,r_111_28_136,0.99,0,136,136,82
45,r_210_68_124,r_26_30_199,seq114,r_210_68_124,1.0,0,124,124,82
61,r_91_203_98,r_56_222_102,seq65,r_91_203_98,1.0,0,98,98,82
112,seq184,r_81_153_162,r_215_191_59,r_215_191_59,0.99,103,162,59,82
40,r_157_55_33,r_190_16_165,seq21,r_157_55_33,0.74,-3,30,33,82
53,r_76_31_55,seq58,seq23,r_76_31_55,1.0,0,55,55,82
9,r_67_206_23,r_61_142_155,seq59,r_67_206_23,0.51,-8,15,23,82
26,r_61_142_155,r_201_86_3,r_212_141_87,r_212_141_87,0.99,76,163,87,82
37,r_17_169_154,r_135_115_48,r_145_64_138,r_17_169_154,0.83,3,157,154,82
22,r_60_128_121,r_127_213_187,seq109,r_127_213_187,0.54,-61,126,187,82
28,r_124_72_103,seq23,seq4,r_124_72_103,1.0,0,103,103,82
49,r_70_77_63,r_61_142_155,r_39_5_51,r_39_5_51,0.99,12,63,51,82
140,seq208,seq3,r_61_142_155,r_61_142_155,0.34,-21,134,155,82
35,r_194_170_158,seq0,r_123_218_44,r_194_170_158,0.53,0,158,158,82
12,r_150_51_62,seq1,r_93_57_143,r_150_51_62,1.0,0,62,62,82
26,r_61_142_155,r_70_77_63,r_201_86_3,r_70_77_63,0.91,-5,58,63,82
7,r_133_103_48,r_160_167_195,seq114,r_160_167_195,0.83,-149,46,195,82
66,r_189_36_39,r_147_12_181,seq52,r_189_36_39,1.0,0,39,39,82
51,r_91_158_119,seq209,r_119_41_103,r_91_158_119,0.78,1,120,119,83
92,seq156,seq16,r_195_154_9,r_195_154_9,0.66,101,110,9,83
8,r_56_64_74,seq175,seq206,r_56_64_74,1.0,0,74,74,83
32,r_32_207_14,seq130,seq38,r_32_207_14,0.97,0,14,14,83
54,r_196_159_129,seq134,r_97_1_118,r_196_159_129,0.87,0,129,129,83
14,r_150_52_34,r_203_98_133,seq16,r_150_52_34,0.96,0,34,34,83
2,r_219_129_56,seq71,seq42,r_219_129_56,1.0,2,58,56,83
55,r_180_190_75,r_167_21_182,seq70,r_180_190_75,0.99,3,78,75,83
86,seq16,r_208_49_151,r_107_27_121,r_208_49_151,0.73,2,153,151,83
16,r_174_201_133,seq117,seq50,r_174_201_133,0.97,0,133,133,83
1,r_89_68_109,seq38,r_55_22_4,r_89_68_109,0.99,0,109,109,83
104,seq177,r_167_21_182,r_32_207_14,r_32_207_14,1.0,168,182,14,83
46,r_44_163_81,seq31,seq57,r_44_163_81,1.0,0,81,81,83
42,r_14_187_122,r_172_171_177,seq122,r_14_187_122,0.96,0,122,122,83
57,r_140_116_33,seq178,r_141_162_183,r_140_116_33,1.0,0,33,33,83
69,r_142_111_155,seq218,seq153,r_142_111_155,0.58,0,155,155,83
19,r_119_41_103,seq146,r_33_157_11,r_119_41_103,0.92,7,110,103,83
66,r_109_166_168,r_196_159_129,seq165,r_109_166_168,0.38,-104,64,168,83
61,r_169_58_45,r_155_20_154,seq71,r_169_58_45,1.0,0,45,45,83
39,r_208_49_151,r_150_52_34,r_75_118_6,r_208_49_151,0.72,0,151,151,83
31,r_69_222_103,r_76_194_181,r_186_133_30,r_69_222_103,0.92,0,103,103,83
67,r_124_168_172,seq218,r_54_95_147,r_54_95_147,0.8,25,172,147,83
23,r_106_59_26,r_8_65_107,r_213_26_144,r_106_59_26,1.0,0,26,26,83
30,r_186_133_30,r_147_93_146,r_54_95_147,r_186_133_30,1.0,0,30,30,83
3,r_39_12_174,seq188,r_198_173_109,r_198_173_109,1.0,63,172,109,83
28,r_46_62_42,seq144,r_106_59_26,r_46_62_42,1.0,0,42,42,83
10,r_45_82_139,seq117,r_48_108_123,r_45_82_139,0.97,0,139,139,83
90,seq153,r_43_215_183,r_142_111_155,r_142_111_155,0.98,28,183,155,83
129,seq90,seq209,r_75_118_6,r_75_118_6,0.83,41,47,6,83
113,seq192,r_8_65_107,r_55_22_4,r_8_65_107,1.0,0,107,107,83
26,r_80_23_67,r_54_95_147,r_55_22_4,r_80_23_67,1.0,0,67,67,83
72,r_61_17_65,r_208_49_151,seq117,r_61_17_65,1.0,0,65,65,83
78,seq4,seq18,r_97_1_118,r_97_1_118,1.0,7,125,118,83
0,r_203_98_133,seq7,r_89_68_109,r_203_98_133,0.69,0,133,133,83
23,r_106_59_26,r_213_26_144,r_46_62_42,r_106_59_26,0.92,37,63,26,83
20,r_43_215_183,seq153,r_150_52_34,r_150_52_34,1.0,149,183,34,83
98,seq40,seq112,r_183_126_91,r_183_126_91,0.96,-5,86,91,83
15,r_125_66_152,seq136,r_119_41_103,r_119_41_103,0.79,52,155,103,83
48,r_160_29_93,seq71,r_54_95_147,r_160_29_93,0.97,1,94,93,83
4,r_33_157_11,seq188,r_221_100_65,r_221_100_65,1.0,25,90,65,83
6,r_107_27_121,r_200_148_196,r_121_79_3,r_107_27_121,0.77,1,122,121,83
62,r_170_3_137,seq218,r_212_184_113,r_212_184_113,1.0,25,138,113,83
52,r_195_154_9,seq113,r_212_184_113,r_212_184_113,1.0,22,135,113,83
27,r_172_171_177,r_14_187_122,r_75_118_6,r_172_171_177,0.56,-55,122,177,83
73,r_151_72_45,seq16,seq86,r_151_72_45,0.98,0,45,45,83
59,r_139_60_58,r_213_26_144,seq161,r_139_60_58,1.0,0,58,58,83
47,r_103_0_79,seq78,seq102,r_103_0_79,0.95,1,80,79,83
40,r_183_126_91,seq50,seq40,r_183_126_91,0.93,0,91,91,83
105,seq50,r_141_162_183,r_140_116_33,r_140_116_33,1.0,114,147,33,83
126,seq85,seq188,r_119_41_103,r_119_41_103,0.9,9,112,103,83
29,r_204_37_83,seq188,seq134,r_204_37_83,1.0,0,83,83,83
63,r_87_210_23,r_141_162_183,r_53_181_26,r_87_210_23,0.97,3,26,23,83
49,r_53_181_26,seq161,r_87_210_23,r_53_181_26,0.99,0,26,26,83
24,r_221_100_65,seq117,r_33_157_11,r_221_100_65,1.0,0,65,65,83
25,r_147_93_146,seq128,seq131,r_147_93_146,0.79,2,148,146,83
33,r_99_94_115,seq86,r_89_68_109,r_89_68_109,0.96,8,117,109,83
64,r_97_1_118,r_142_111_155,seq4,r_97_1_118,0.94,1,119,118,83
50,r_121_79_3,seq16,r_107_27_121,r_107_27_121,0.69,5,126,121,83
58,r_213_26_144,seq86,r_204_37_83,r_213_26_144,0.85,0,144,144,83
70,r_10_164_115,seq146,r_140_116_33,r_10_164_115,0.72,0,115,115,83
65,r_6_185_146,seq117,seq24,r_6_185_146,0.89,1,147,146,83
38,r_205_2_75,seq206,seq4,r_205_2_75,1.0,0,75,75,83
34,r_212_184_113,r_167_21_182,r_195_154_9,r_212_184_113,0.85,0,113,113,83
39,r_208_49_151,r_61_17_65,r_150_52_34,r_208_49_151,0.98,-117,34,151,83
60,r_141_162_183,seq50,r_140_116_33,r_140_116_33,1.0,44,77,33,83
27,r_172_171_177,r_75_118_6,seq110,r_172_171_177,0.97,1,178,177,83
81,seq136,r_125_66_152,r_149_5_124,r_149_5_124,1.0,31,155,124,83
9,r_198_173_109,seq101,r_140_116_33,r_198_173_109,1.0,0,109,109,83
145,seq117,r_6_185_146,r_61_17_65,r_61_17_65,1.0,64,129,65,83
140,seq146,r_119_41_103,r_89_68_109,r_89_68_109,0.75,3,112,109,83
56,r_74_77_71,r_48_108_123,seq78,r_74_77_71,0.97,1,72,71,83
7,r_63_182_122,seq42,seq18,r_63_182_122,0.98,0,122,122,83
60,r_141_162_183,r_140_116_33,r_53_181_26,r_53_181_26,0.82,158,184,26,83
35,r_214_114_164,seq122,r_10_164_115,r_214_114_164,0.68,0,164,164,83
51,r_78_118_98,seq113,seq148,r_78_118_98,0.98,0,98,98,84
53,r_38_210_166,seq127,seq36,r_38_210_166,0.75,1,167,166,84
43,r_122_94_167,r_97_64_178,r_23_74_140,r_122_94_167,0.53,0,167,167,84
37,r_136_115_24,r_33_131_117,seq214,r_136_115_24,1.0,0,24,24,84
3,r_114_81_165,r_159_5_171,seq30,r_159_5_171,0.99,-6,165,171,84
86,seq18,r_69_156_85,seq193,r_69_156_85,1.0,0,85,85,84
39,r_189_82_159,seq50,r_56_132_45,r_56_132_45,0.67,115,160,45,84
97,seq165,r_49_59_98,r_105_43_183,r_49_59_98,1.0,0,98,98,84
5,r_92_2_102,r_108_154_175,seq207,r_92_2_102,0.88,1,103,102,84
42,r_111_163_113,seq142,seq165,r_111_163_113,0.4,6,119,113,84
56,r_17_85_40,seq195,r_23_74_140,r_17_85_40,0.97,0,40,40,84
69,r_176_32_83,seq219,seq109,r_176_32_83,1.0,0,83,83,84
19,r_71_90_145,seq145,r_141_221_96,r_141_221_96,0.7,51,147,96,84
8,r_120_63_27,r_17_85_40,seq113,r_120_63_27,1.0,0,27,27,84
10,r_56_132_45,r_33_131_117,seq146,r_56_132_45,0.96,1,46,45,84
103,seq172,r_79_102_150,seq157,r_79_102_150,1.0,-74,76,150,84
31,r_96_0_100,seq193,r_21_223_39,r_96_0_100,1.0,0,100,100,84
41,r_108_154_175,seq168,r_105_43_183,r_108_154_175,0.54,0,175,175,84
67,r_179_93_111,seq144,r_65_57_35,r_179_93_111,0.98,0,111,111,84
3,r_114_81_165,r_175_95_98,r_159_5_171,r_175_95_98,1.0,-1,97,98,84
17,r_23_74_140,r_55_128_60,seq145,r_23_74_140,1.0,0,140,140,84
115,seq193,r_96_0_100,seq145,r_96_0_100,1.0,-3,97,100,84
26,r_110_35_99,seq18,r_11_150_24,r_110_35_99,0.61,0,99,99,84
72,r_158_220_67,r_33_131_117,r_65_57_35,r_65_57_35,0.9,33,68,35,84
139,seq106,r_152_45_137,r_205_101_194,r_152_45_137,0.56,0,137,137,84
0,r_175_95_98,r_114_81_165,r_58_24_177,r_175_95_98,0.99,0,98,98,84
63,r_159_5_171,r_28_61_193,r_100_171_160,r_100_171_160,0.75,11,171,160,84
73,r_60_133_189,seq183,r_8_15_160,r_8_15_160,0.94,29,189,160,84
11,r_100_171_160,r_87_76_139,r_65_57_35,r_87_76_139,0.98,0,139,139,84
139,seq106,r_205_101_194,r_8_15_160,r_8_15_160,0.95,1,161,160,84
20,r_218_138_166,seq135,r_79_102_150,r_218_138_166,0.6,0,166,166,84
56,r_17_85_40,r_23_74_140,r_55_128_60,r_17_85_40,0.63,100,140,40,84
15,r_181_173_112,r_23_74_140,r_92_2_102,r_181_173_112,0.98,0,112,112,84
48,r_185_107_138,r_31_182_92,seq146,r_185_107_138,0.7,0,138,138,84
57,r_87_76_139,r_100_171_160,seq219,r_87_76_139,0.82,0,139,139,84
62,r_37_46_173,seq177,r_34_1_199,r_37_46_173,0.64,0,173,173,84
0,r_175_95_98,r_58_24_177,r_16_164_158,r_16_164_158,0.68,3,161,158,84
6,r_75_6_29,r_159_5_171,seq169,r_75_6_29,1.0,0,29,29,84
59,r_11_150_24,r_218_138_166,seq80,r_11_150_24,0.99,0,24,24,84
10,r_56_132_45,seq146,r_189_82_159,r_189_82_159,1.0,2,161,159,84
27,r_161_155_136,r_51_140_199,r_11_150_24,r_161_155_136,0.92,0,136,136,84
2,r_79_102_150,seq172,r_126_3_8,r_79_102_150,0.98,1,151,150,84
47,r_124_201_170,seq68,seq177,r_124_201_170,0.66,1,171,170,84
40,r_196_178_75,r_53_162_120,r_41_77_10,r_53_162_120,0.8,-44,76,120,84
74,r_54_160_60,seq148,seq142,r_54_160_60,1.0,0,60,60,84
18,r_58_24_177,seq109,r_117_91_67,r_117_91_67,1.0,110,177,67,84
29,r_97_64_178,r_122_94_167,r_110_35_99,r_110_35_99,0.7,68,167,99,84
24,r_55_128_60,seq80,r_17_85_40,r_55_128_60,1.0,0,60,60,84
25,r_105_43_183,r_8_15_160,r_111_163_113,r_8_15_160,0.93,0,160,160,84
33,r_137_147_172,r_60_133_189,r_75_6_29,r_137_147_172,0.57,0,172,172,84
64,r_187_199_100,r_203_67_193,r_29_222_186,r_187_199_100,0.94,2,102,100,84
88,seq20,r_16_164_158,r_181_173_112,r_181_173_112,0.74,46,158,112,84
50,r_117_91_67,seq166,seq113,r_117_91_67,1.0,-1,66,67,84
58,r_69_156_85,seq18,seq119,r_69_156_85,1.0,0,85,85,84
70,r_170_73_63,r_58_24_177,seq12,r_170_73_63,1.0,0,63,63,84
65,r_139_98_183,seq207,r_136_115_24,r_136_115_24,0.56,159,183,24,84
22,r_21_223_39,r_181_173_112,seq200,r_21_223_39,1.0,-1,38,39,84
91,seq151,seq30,r_153_129_9,r_153_129_9,0.98,7,16,9,84
61,r_141_221_96,r_104_44_166,seq66,r_141_221_96,0.97,1,97,96,84
32,r_8_15_160,r_105_43_183,seq106,r_8_15_160,0.91,0,160,160,84
38,r_53_162_120,r_105_43_183,r_92_2_102,r_53_162_120,0.61,0,120,120,84
52,r_211_99_180,r_34_1_199,r_105_43_183,r_211_99_180,0.65,2,182,180,84
34,r_197_4_166,seq86,r_79_102_150,r_197_4_166,0.73,0,166,166,84
46,r_41_77_10,r_97_64_178,seq142,r_41_77_10,0.93,0,10,10,84
60,r_7_208_113,r_124_201_170,seq148,r_7_208_113,0.96,0,113,113,84
17,r_23_74_140,r_181_173_112,r_55_128_60,r_55_128_60,0.98,37,97,60,84
9,r_104_44_166,seq25,r_176_32_83,r_104_44_166,0.69,0,166,166,84
145,seq119,r_152_45_137,r_69_156_85,r_69_156_85,1.0,14,99,85,84
11,r_100_171_160,r_65_57_35,seq148,r_100_171_160,0.87,0,160,160,84
49,r_49_59_98,seq165,seq30,r_49_59_98,0.94,0,98,98,84
149,seq127,r_38_210_166,r_75_6_29,r_75_6_29,0.83,140,169,29,84
7,r_33_131_117,seq177,r_65_57_35,r_33_131_117,0.99,0,117,117,84
118,seq68,r_124_201_170,r_75_6_29,r_75_6_29,0.99,142,171,29,84
23,r_31_182_92,r_185_107_138,seq143,r_185_107_138,1.0,-41,97,138,84
108,seq183,r_137_147_172,r_105_43_183,r_137_147_172,0.78,0,172,172,84
35,r_152_45_137,seq106,seq72,r_152_45_137,0.53,0,137,137,84
128,seq86,r_197_4_166,r_75_6_29,r_75_6_29,0.82,68,97,29,84
30,r_166_220_157,seq4,r_122_212_143,r_122_212_143,0.9,16,159,143,85
108,seq179,r_177_85_57,r_193_159_6,r_177_85_57,0.98,-10,47,57,85
36,r_175_151_155,seq174,r_181_188_31,r_175_151_155,0.9,0,155,155,85
92,seq29,r_54_173_194,r_77_26_84,r_77_26_84,1.0,1,85,84,85
8,r_108_37_11,seq190,r_25_86_3,r_108_37_11,1.0,0,11,11,85
43,r_77_26_84,r_17_51_176,seq29,r_77_26_84,1.0,1,85,84,85
54,r_153_19_139,seq73,seq0,r_153_19_139,0.97,0,139,139,85
37,r_163_170_81,seq42,seq38,r_163_170_81,0.9,5,86,81,85
71,r_224_218_40,seq18,seq113,r_224_218_40,1.0,0,40,40,85
59,r_56_63_180,r_168_209_190,r_122_212_143,r_168_209_190,0.71,-9,181,190,85
3,r_25_86_3,r_143_66_27,r_108_37_11,r_25_86_3,0.9,8,11,3,85
21,r_81_187_62,seq53,seq174,r_81_187_62,1.0,0,62,62,85
39,r_186_196_67,seq120,r_117_16_33,r_186_196_67,0.99,1,68,67,85
53,r_60_79_19,r_109_21_36,r_132_28_186,r_60_79_19,0.68,0,19,19,85
42,r_8_43_83,seq114,seq118,r_8_43_83,1.0,0,83,83,85
7,r_122_212_143,r_182_72_22,seq103,r_122_212_143,0.76,0,143,143,85
69,r_68_65_162,seq24,seq160,r_68_65_162,0.82,1,163,162,85
45,r_58_100_62,seq61,seq223,r_58_100_62,1.0,0,62,62,85
19,r_64_215_145,seq200,r_5_123_68,r_5_123_68,1.0,26,94,68,85
129,seq90,r_2_9_170,r_130_217_77,r_130_217_77,1.0,-5,72,77,85
41,r_48_124_189,r_219_129_120,r_198_139_82,r_48_124_189,1.0,-69,120,189,85
23,r_126_95_116,r_163_170_81,r_30_184_123,r_126_95_116,0.57,17,133,116,85
10,r_36_74_171,seq189,r_199_180_50,r_36_74_171,0.45,6,177,171,85
16,r_109_21_36,seq147,seq61,r_109_21_36,0.78,0,36,36,85
9,r_116_52_49,seq38,seq35,r_116_52_49,1.0,0,49,49,85
114,seq67,seq127,r_22_71_160,r_22_71_160,0.4,-55,105,160,85
7,r_122_212_143,r_15_207_104,r_182_72_22,r_182_72_22,0.97,0,22,22,85
26,r_11_76_111,r_41_59_110,seq140,r_11_76_111,1.0,0,111,111,85
16,r_109_21_36,seq61,r_150_222_103,r_150_222_103,1.0,4,107,103,85
4,r_5_123_68,seq67,r_64_215_145,r_5_123_68,1.0,3,71,68,85
0,r_198_139_82,seq31,r_119_208_7,r_198_139_82,1.0,0,82,82,85
63,r_148_92_84,r_175_151_155,seq4,r_148_92_84,1.0,0,84,84,85
73,r_142_162_188,seq112,r_135_13_184,r_135_13_184,0.61,4,188,184,85
11,r_15_207_104,seq35,r_58_100_62,r_15_207_104,1.0,0,104,104,85
31,r_83_121_162,r_195_39_139,r_143_66_27,r_143_66_27,1.0,0,27,27,85
20,r_30_184_123,r_133_171_143,r_126_95_116,r_30_184_123,0.72,2,125,123,85
62,r_75_214_38,r_2_9_170,r_216_149_198,r_75_214_38,1.0,2,40,38,85
13,r_201_213_94,seq134,seq152,r_201_213_94,1.0,0,94,94,85
46,r_143_66_27,r_195_39_139,r_116_52_49,r_116_52_49,0.65,91,140,49,85
22,r_211_33_33,r_56_63_180,r_2_9_170,r_211_33_33,0.99,-1,32,33,85
4,r_5_123_68,r_64_215_145,r_11_76_111,r_5_123_68,0.99,78,146,68,85
6,r_150_222_103,r_34_156_85,r_8_43_83,r_150_222_103,0.61,-18,85,103,85
40,r_23_128_53,seq49,seq115,r_23_128_53,0.92,0,53,53,85
49,r_199_180_50,seq145,seq12,r_199_180_50,0.86,1,51,50,85
27,r_131_6_101,r_17_51_176,seq146,r_131_6_101,0.93,2,103,101,85
53,r_60_79_19,r_132_28_186,r_34_156_85,r_34_156_85,1.0,44,129,85,85
148,seq120,seq62,r_64_215_145,r_64_215_145,0.97,24,169,145,85
24,r_50_3_56,r_216_149_198,seq223,r_50_3_56,0.98,0,56,56,85
102,seq42,r_14_93_32,r_117_16_33,r_14_93_32,0.57,0,32,32,85
2,r_206_46_179,seq147,seq200,r_206_46_179,0.51,1,180,179,85
47,r_22_71_160,seq113,seq82,r_22_71_160,0.44,6,166,160,85
67,r_57_80_30,r_11_76_111,seq134,r_57_80_30,1.0,1,31,30,85
74,r_34_156_85,r_150_222_103,r_60_79_19,r_60_79_19,0.92,66,85,19,85
18,r_41_59_110,r_11_76_111,seq155,r_11_76_111,0.98,-3,108,111,85
29,r_195_39_139,r_83_121_162,r_182_72_22,r_195_39_139,0.93,1,140,139,85
35,r_177_85_57,seq179,r_116_52_49,r_177_85_57,1.0,0,57,57,85
61,r_101_70_22,r_64_215_145,r_102_69_199,r_101_70_22,1.0,0,22,22,85
66,r_14_93_32,r_142_162_188,r_193_159_6,r_14_93_32,1.0,0,32,32,85
50,r_172_89_157,seq31,r_122_212_143,r_172_89_157,0.93,3,160,157,85
58,r_219_129_120,r_48_124_189,r_20_94_6,r_48_124_189,0.6,-69,120,189,85
70,r_17_51_176,seq204,r_64_215_145,r_64_215_145,0.68,32,177,145,85
68,r_107_158_96,seq1,r_181_188_31,r_107_158_96,0.97,1,97,96,85
38,r_133_171_143,seq137,seq179,r_133_171_143,0.99,0,143,143,85
57,r_182_72_22,r_122_212_143,r_195_39_139,r_122_212_143,1.0,0,143,143,85
6,r_150_222_103,r_8_43_83,r_109_21_36,r_150_222_103,0.97,1,104,103,85
57,r_182_72_22,r_224_218_40,r_122_212_143,r_182_72_22,1.0,0,22,22,85
60,r_165_221_149,r_216_149_198,r_57_80_30,r_165_221_149,0.92,0,149,149,85
81,seq137,r_133_171_143,r_192_32_74,r_133_171_143,1.0,0,143,143,85
17,r_132_28_186,r_60_79_19,r_135_13_184,r_135_13_184,0.48,2,186,184,85
121,seq204,r_17_51_176,seq53,r_17_51_176,0.7,6,182,176,85
14,r_117_16_33,seq61,seq42,r_117_16_33,0.99,-1,32,33,85
28,r_102_69_199,r_224_218_40,r_101_70_22,r_102_69_199,1.0,-176,23,199,85
31,r_83_121_162,r_143_66_27,r_192_32_74,r_83_121_162,0.91,1,163,162,85
34,r_84_10_21,r_122_212_143,r_168_209_190,r_84_10_21,0.57,0,21,21,85
123,seq189,r_36_74_171,r_198_139_82,r_198_139_82,1.0,95,177,82,85
56,r_168_209_190,r_56_63_180,r_20_94_6,r_168_209_190,0.62,-118,72,190,85
5,r_181_188_31,r_130_217_77,seq88,r_181_188_31,1.0,0,31,31,85
131,seq223,r_135_13_184,r_15_207_104,r_15_207_104,1.0,80,184,104,85
19,r_64_215_145,r_5_123_68,seq120,r_64_215_145,1.0,0,145,145,85
12,r_130_217_77,seq4,seq90,r_130_217_77,1.0,-4,73,77,85
46,r_143_66_27,r_47_191_197,r_195_39_139,r_143_66_27,1.0,0,27,27,85
23,r_126_95_116,seq67,r_163_170_81,r_163_170_81,0.53,37,118,81,85
51,r_83_45_78,seq30,r_5_204_3,r_83_45_78,0.93,1,79,78,86
72,r_150_197_52,r_2_27_55,seq0,r_150_197_52,1.0,0,52,52,86
81,seq10,r_131_98_37,r_153_183_140,r_131_98_37,0.62,0,37,37,86
60,r_2_27_55,r_158_102_85,seq92,r_2_27_55,0.94,0,55,55,86
53,r_29_117_49,r_148_115_99,r_31_72_199,r_29_117_49,0.9,7,56,49,86
37,r_90_41_83,seq4,r_31_72_199,r_90_41_83,0.74,7,90,83,86
41,r_82_196_16,r_177_108_64,seq104,r_82_196_16,0.98,2,18,16,86
59,r_56_16_94,seq210,seq0,r_56_16_94,0.88,3,97,94,86
71,r_58_190_144,seq21,r_109_185_44,r_58_190_144,0.6,0,144,144,86
16,r_160_25_132,seq47,seq192,r_160_25_132,0.97,1,133,132,86
1,r_118_166_65,r_215_122_143,r_14_43_58,r_118_166_65,0.97,1,66,65,86
5,r_155_186_48,r_57_39_196,r_111_35_140,r_155_186_48,1.0,0,48,48,86
45,r_215_122_143,seq15,seq169,r_215_122_143,0.96,1,144,143,86
66,r_129_23_161,r_78_172_167,r_141_159_74,r_141_159_74,1.0,1,75,74,86
31,r_13_95_175,seq65,r_59_22_100,r_13_95_175,0.7,0,175,175,86
67,r_78_172_167,seq133,seq207,r_78_172_167,0.73,0,167,167,86
68,r_205_86_150,r_177_108_64,r_62_89_21,r_62_89_21,1.0,-2,19,21,86
43,r_161_156_28,r_31_72_199,r_129_23_161,r_161_156_28,0.99,1,29,28,86
55,r_131_98_37,seq10,r_132_80_39,r_131_98_37,1.0,0,37,37,86
26,r_222_151_90,seq214,seq79,r_222_151_90,0.68,0,90,90,86
14,r_111_35_140,r_155_186_48,seq42,r_111_35_140,0.98,1,141,140,86
78,seq133,r_96_48_103,seq75,r_96_48_103,1.0,-4,99,103,86
73,r_36_69_162,seq46,seq21,r_36_69_162,0.76,1,163,162,86
11,r_162_81_122,seq110,seq119,r_162_81_122,0.98,1,123,122,86
54,r_8_149_19,seq188,seq34,r_8_149_19,0.98,2,21,19,86
20,r_99_147_174,seq19,r_20_94_81,r_99_147_174,0.38,3,177,174,86
62,r_32_17_37,seq187,r_31_72_199,r_32_17_37,0.72,3,40,37,86
13,r_106_189_63,seq79,seq7,r_106_189_63,1.0,0,63,63,86
56,r_62_89_21,r_205_86_150,r_203_50_110,r_62_89_21,0.93,129,150,21,86
48,r_6_209_80,r_121_97_88,r_2_27_55,r_6_209_80,0.9,0,80,80,86
85,seq15,r_215_122_143,seq210,r_215_122_143,1.0,-48,95,143,86
8,r_109_185_44,seq194,r_148_115_99,r_109_185_44,1.0,0,44,44,86
5,r_155_186_48,r_111_35_140,r_26_208_42,r_111_35_140,1.0,1,141,140,86
56,r_62_89_21,seq210,r_205_86_150,r_62_89_21,0.99,-2,19,21,86
9,r_26_208_42,seq40,seq79,r_26_208_42,1.0,0,42,42,86
148,seq125,r_31_72_199,r_51_18_78,r_51_18_78,1.0,35,113,78,86
29,r_112_100_19,r_57_39_196,seq19,r_112_100_19,1.0,0,19,19,86
38,r_132_80_39,seq119,r_131_98_37,r_131_98_37,0.89,5,42,37,86
47,r_121_97_88,r_78_172_167,seq169,r_121_97_88,1.0,0,88,88,86
40,r_33_176_134,seq165,seq40,r_33_176_134,0.96,0,134,134,86
18,r_59_22_100,r_203_50_110,seq37,r_59_22_100,0.93,0,100,100,86
28,r_84_9_57,seq140,seq46,r_84_9_57,1.0,0,57,57,86
25,r_68_103_161,seq7,r_158_102_85,r_68_103_161,0.71,0,161,161,86
43,r_161_156_28,r_129_23_161,r_53_144_100,r_53_144_100,1.0,12,112,100,86
33,r_141_159_74,seq88,r_129_23_161,r_141_159_74,1.0,0,74,74,86
64,r_158_102_85,r_1_175_2,seq140,r_158_102_85,1.0,1,86,85,86
32,r_14_43_58,r_33_176_134,r_150_197_52,r_14_43_58,0.82,0,58,58,86
6,r_152_179_25,r_160_25_132,seq128,r_152_179_25,0.98,0,25,25,86
50,r_203_50_110,r_59_22_100,r_62_89_21,r_203_50_110,0.61,-10,100,110,86
58,r_180_142_177,seq37,r_203_50_110,r_180_142_177,0.58,0,177,177,86
70,r_130_49_72,r_158_102_85,r_5_204_3,r_130_49_72,0.67,0,72,72,86
65,r_20_94_81,seq55,seq88,r_20_94_81,0.88,1,82,81,86
4,r_148_115_99,r_109_185_44,seq10,r_148_115_99,0.98,1,100,99,86
106,seq60,r_53_144_100,r_216_163_14,r_216_163_14,0.61,0,14,14,86
52,r_146_170_93,r_111_35_140,r_161_156_28,r_146_170_93,0.99,0,93,93,86
76,seq128,r_136_167_64,r_152_179_25,r_152_179_25,1.0,11,36,25,86
68,r_205_86_150,r_62_89_21,seq61,r_205_86_150,1.0,0,150,150,86
34,r_73_3_77,r_219_134_96,r_141_159_74,r_73_3_77,0.98,0,77,77,86
61,r_181_164_53,r_73_3_77,seq207,r_181_164_53,0.97,0,53,53,86
30,r_77_198_29,r_73_3_77,seq187,r_73_3_77,0.76,-45,32,77,86
17,r_171_184_157,seq200,r_113_206_57,r_113_206_57,1.0,100,157,57,86
27,r_113_206_57,r_129_23_161,seq110,r_113_206_57,1.0,0,57,57,86
123,seq212,seq40,r_131_98_37,r_131_98_37,1.0,78,115,37,86
36,r_127_54_40,r_2_27_55,seq217,r_127_54_40,1.0,1,41,40,86
44,r_219_134_96,r_180_142_177,r_109_185_44,r_109_185_44,0.7,52,96,44,86
138,seq104,r_36_69_162,r_82_196_16,r_82_196_16,1.0,2,18,16,86
23,r_136_167_64,seq128,seq85,r_136_167_64,0.64,0,64,64,86
8,r_109_185_44,r_148_115_99,r_219_134_96,r_109_185_44,0.91,56,100,44,86
14,r_111_35_140,r_106_189_63,r_155_186_48,r_111_35_140,1.0,-86,54,140,86
35,r_153_183_140,r_193_173_5,r_112_100_19,r_112_100_19,0.91,121,140,19,86
12,r_138_114_121,seq19,r_14_43_58,r_138_114_121,0.98,3,124,121,86
4,r_148_115_99,r_29_117_49,r_109_185_44,r_148_115_99,0.59,-43,56,99,86
40,r_216_158_32,r_3_166_143,r_133_79_145,r_216_158_32,0.84,112,144,32,87
30,r_42_135_143,seq67,seq2,r_42_135_143,0.97,0,143,143,87
51,r_43_100_199,r_147_219_94,r_29_23_103,r_147_219_94,0.99,0,94,94,87
36,r_102_167_90,seq160,seq88,r_102_167_90,0.69,0,90,90,87
122,seq181,r_7_202_140,seq10,r_7_202_140,1.0,1,141,140,87
52,r_136_112_52,r_144_129_148,seq132,r_144_129_148,0.56,-97,51,148,87
8,r_12_56_151,r_74_152_180,r_22_127_79,r_12_56_151,0.78,0,151,151,87
53,r_217_70_85,seq93,seq140,r_217_70_85,0.93,0,85,85,87
18,r_3_166_143,r_145_126_126,r_216_158_32,r_216_158_32,1.0,0,32,32,87
54,r_101_85_75,r_218_143_154,seq161,r_101_85_75,1.0,1,76,75,87
46,r_36_179_11,r_106_65_189,r_137_28_61,r_36_179_11,0.99,0,11,11,87
37,r_14_50_67,r_221_188_149,seq157,r_14_50_67,1.0,-1,66,67,87
59,r_144_129_148,seq192,r_151_130_78,r_151_130_78,0.91,70,148,78,87
45,r_109_220_28,r_147_219_94,seq53,r_109_220_28,1.0,-1,27,28,87
71,r_191_182_152,r_144_129_148,r_187_173_59,r_187_173_59,0.76,75,134,59,87
16,r_96_155_106,seq1,r_102_167_90,r_96_155_106,0.98,0,106,106,87
21,r_114_146_179,seq61,r_84_174_96,r_114_146_179,0.56,0,179,179,87
1,r_209_58_63,seq53,seq104,r_209_58_63,1.0,0,63,63,87
42,r_222_124_164,seq69,seq5,r_222_124_164,0.76,1,165,164,87
24,r_45_197_27,seq148,r_118_207_144,r_45_197_27,1.0,0,27,27,87
69,r_171_57_79,r_96_155_106,seq80,r_171_57_79,0.54,4,83,79,87
19,r_35_149_141,r_25_77_8,r_136_112_52,r_35_149_141,0.76,0,141,141,87
11,r_117_68_13,seq63,r_38_194_92,r_38_194_92,1.0,0,92,92,87
0,r_120_162_43,r_72_163_127,seq168,r_120_162_43,0.97,0,43,43,87
11,r_117_68_13,r_137_28_61,seq63,r_117_68_13,0.97,0,13,13,87
27,r_29_23_103,r_223_99_125,r_7_202_140,r_7_202_140,0.53,0,140,140,87
40,r_216_158_32,seq10,r_3_166_143,r_216_158_32,1.0,0,32,32,87
46,r_36_179_11,r_137_28_61,r_105_156_31,r_36_179_11,0.67,52,63,11,87
3,r_40_83_76,seq131,r_113_18_123,r_40_83_76,1.0,0,76,76,87
113,seq180,r_195_108_150,r_151_130_78,r_151_130_78,0.99,72,150,78,87
26,r_212_110_96,seq61,r_22_127_79,r_22_127_79,0.71,72,151,79,87
72,r_201_116_168,r_106_65_189,seq21,r_201_116_168,0.45,3,171,168,87
35,r_177_94_42,r_209_58_63,seq48,r_177_94_42,1.0,0,42,42,87
4,r_137_28_61,r_84_174_96,seq176,r_137_28_61,1.0,2,63,61,87
73,r_54_119_61,r_84_174_96,r_159_24_92,r_54_119_61,1.0,1,62,61,87
13,r_26_6_189,r_218_143_154,r_191_182_152,r_26_6_189,0.68,-33,156,189,87
57,r_31_175_13,r_87_19_188,seq48,r_31_175_13,1.0,1,14,13,87
44,r_147_219_94,r_113_18_123,r_95_170_120,r_147_219_94,0.91,29,123,94,87
106,seq48,r_74_152_180,r_72_163_127,r_72_163_127,1.0,53,180,127,87
12,r_72_163_127,r_133_79_145,r_47_164_107,r_72_163_127,1.0,0,127,127,87
6,r_178_142_165,seq141,seq80,r_178_142_165,0.76,0,165,165,87
62,r_38_194_92,r_223_99_125,r_117_68_13,r_38_194_92,1.0,0,92,92,87
103,seq168,r_122_60_35,r_40_83_76,r_122_60_35,0.65,-5,30,35,87
63,r_103_115_165,r_29_23_103,seq44,r_103_115_165,0.5,-140,25,165,87
5,r_92_33_50,r_96_155_106,seq157,r_92_33_50,0.76,0,50,50,87
70,r_218_143_154,r_101_85_75,r_187_173_59,r_101_85_75,0.83,-16,59,75,87
27,r_29_23_103,r_95_170_120,r_223_99_125,r_95_170_120,0.71,-14,106,120,87
55,r_84_174_96,r_54_119_61,r_36_179_11,r_84_174_96,0.87,-70,26,96,87
51,r_43_100_199,r_29_23_103,r_195_108_150,r_195_108_150,1.0,12,162,150,87
74,r_7_202_140,seq181,r_29_23_103,r_7_202_140,0.86,0,140,140,87
29,r_145_126_126,seq44,seq199,r_145_126_126,0.92,0,126,126,87
25,r_47_164_107,seq138,r_177_94_42,r_177_94_42,0.99,67,109,42,87
70,r_218_143_154,r_187_173_59,r_25_77_8,r_218_143_154,0.94,2,156,154,87
64,r_165_34_136,seq198,r_133_79_145,r_133_79_145,0.77,5,150,145,87
47,r_113_18_123,r_40_83_76,r_151_130_78,r_151_130_78,0.87,45,123,78,87
47,r_113_18_123,r_105_156_31,r_40_83_76,r_113_18_123,0.55,-92,31,123,87
50,r_133_79_145,r_90_15_199,r_216_158_32,r_216_158_32,0.69,113,145,32,87
58,r_64_82_88,seq128,seq63,r_64_82_88,1.0,1,89,88,87
32,r_25_77_8,r_46_86_124,seq198,r_46_86_124,1.0,0,124,124,87
68,r_187_173_59,r_218_143_154,r_191_182_152,r_187_173_59,0.96,97,156,59,87
34,r_87_19_188,seq73,seq138,r_87_19_188,0.42,2,190,188,87
3,r_40_83_76,r_113_18_123,r_95_170_120,r_40_83_76,0.98,47,123,76,87
17,r_214_51_123,r_74_152_180,seq128,r_214_51_123,0.9,0,123,123,87
43,r_122_60_35,seq168,seq1,r_122_60_35,0.99,0,35,35,87
121,seq69,r_222_124_164,seq193,r_222_124_164,1.0,1,165,164,87
9,r_184_75_162,seq176,r_109_220_28,r_184_75_162,0.76,0,162,162,87
63,r_103_115_165,seq44,seq140,r_103_115_165,0.93,-1,164,165,87
14,r_105_156_31,r_159_24_92,seq93,r_105_156_31,1.0,0,31,31,87
48,r_71_111_43,r_120_162_43,r_36_179_11,r_71_111_43,0.98,0,43,43,87
12,r_72_163_127,r_120_162_43,r_133_79_145,r_120_162_43,1.0,2,45,43,87
22,r_46_86_124,r_35_149_141,seq140,r_46_86_124,1.0,0,124,124,87
49,r_223_99_125,r_38_194_92,r_29_23_103,r_38_194_92,1.0,0,92,92,87
56,r_74_152_180,seq48,r_35_149_141,r_74_152_180,0.8,0,180,180,87
7,r_22_127_79,r_66_9_199,seq192,r_22_127_79,0.55,2,81,79,87
18,r_3_166_143,r_216_158_32,r_47_164_107,r_3_166_143,0.66,1,144,143,87
44,r_147_219_94,r_43_100_199,r_113_18_123,r_147_219_94,0.63,0,94,94,87
23,r_200_76_120,r_90_15_199,seq140,r_200_76_120,1.0,0,120,120,87
49,r_223_99_125,r_29_23_103,seq32,r_29_23_103,0.49,27,130,103,87
68,r_187_173_59,r_22_127_79,r_218_143_154,r_187_173_59,0.99,0,59,59,87
55,r_84_174_96,r_36_179_11,seq20,r_84_174_96,1.0,1,97,96,87
93,seq33,r_102_214_184,r_145_41_66,r_145_41_66,1.0,44,110,66,88
30,r_140_43_125,seq91,seq153,r_140_43_125,0.91,8,133,125,88
51,r_103_189_166,seq105,r_16_64_73,r_103_189_166,0.53,0,166,166,88
12,r_121_183_31,r_203_193_44,seq105,r_203_193_44,0.85,1,45,44,88
102,seq47,r_217_224_27,r_134_149_90,r_217_224_27,0.83,0,27,27,88
147,seq122,r_201_15_152,seq36,r_201_15_152,1.0,0,152,152,88
43,r_38_55_156,seq192,r_51_108_139,r_38_55_156,0.89,0,156,156,88
32,r_203_193_44,r_85_139_161,r_121_183_31,r_121_183_31,0.56,0,31,31,88
54,r_156_142_109,r_102_214_184,seq197,r_156_142_109,0.66,0,109,109,88
37,r_134_149_90,r_145_41_66,seq47,r_145_41_66,0.89,0,66,66,88
23,r_4_184_31,r_166_83_66,seq128,r_4_184_31,1.0,1,32,31,88
55,r_112_88_63,seq32,r_168_177_12,r_112_88_63,1.0,0,63,63,88
86,seq24,r_7_45_95,r_99_107_174,r_7_45_95,0.71,1,96,95,88
1,r_166_83_66,seq146,seq197,r_166_83_66,1.0,0,66,66,88
10,r_218_212_72,r_11_182_165,r_0_18_87,r_218_212_72,0.62,49,121,72,88
7,r_11_182_165,r_218_212_72,r_10_60_13,r_11_182_165,0.99,1,166,165,88
19,r_168_177_12,r_62_118_101,seq9,r_168_177_12,1.0,0,12,12,88
21,r_222_154_32,r_206_190_165,r_114_150_128,r_222_154_32,1.0,0,32,32,88
71,r_208_5_45,r_112_88_63,r_176_188_11,r_208_5_45,1.0,2,47,45,88
2,r_34_198_42,r_166_83_66,r_164_22_36,r_34_198_42,0.87,7,49,42,88
66,r_213_40_153,r_157_141_149,seq105,r_213_40_153,1.0,-2,151,153,88
12,r_121_183_31,seq113,r_203_193_44,r_121_183_31,0.86,0,31,31,88
31,r_100_194_135,seq56,seq223,r_100_194_135,0.98,0,135,135,88
41,r_157_141_149,r_213_40_153,seq120,r_157_141_149,0.97,0,149,149,88
67,r_129_3_106,r_103_189_166,r_69_106_10,r_129_3_106,1.0,2,108,106,88
3,r_206_190_165,seq1,r_207_61_25,r_206_190_165,0.66,0,165,165,88
10,r_218_212_72,seq36,r_11_182_165,r_218_212_72,0.97,0,72,72,88
109,seq56,r_100_194_135,seq93,r_100_194_135,0.91,-12,123,135,88
26,r_2_76_67,seq192,seq9,r_2_76_67,1.0,4,71,67,88
72,r_163_144_151,seq82,seq113,r_163_144_151,0.79,0,151,151,88
4,r_66_57_144,r_159_89_193,seq59,r_159_89_193,0.77,-44,149,193,88
59,r_173_191_54,seq87,r_94_97_146,r_173_191_54,1.0,1,55,54,88
0,r_7_45_95,seq24,r_222_154_32,r_7_45_95,0.85,0,95,95,88
63,r_27_215_170,seq131,seq219,r_27_215_170,0.77,0,170,170,88
11,r_53_71_116,seq82,r_173_191_54,r_53_71_116,0.99,0,116,116,88
62,r_20_50_49,seq82,r_168_177_12,r_20_50_49,1.0,0,49,49,88
28,r_109_165_26,r_134_149_90,r_213_40_153,r_109_165_26,1.0,0,26,26,88
13,r_99_107_174,seq82,r_103_189_166,r_99_107_174,0.4,-1,173,174,88
15,r_85_139_161,seq105,r_34_198_42,r_85_139_161,0.91,1,162,161,88
61,r_207_61_25,r_11_182_165,seq90,r_207_61_25,0.96,1,26,25,88
6,r_110_80_117,seq49,seq24,r_110_80_117,1.0,0,117,117,88
5,r_69_106_10,r_140_43_125,r_129_3_106,r_69_106_10,0.52,99,109,10,88
42,r_164_22_36,r_196_72_164,seq63,r_164_22_36,0.98,0,36,36,88
53,r_123_8_25,r_210_29_146,r_109_165_26,r_210_29_146,1.0,0,146,146,88
69,r_176_188_11,r_136_170_15,r_10_60_13,r_176_188_11,0.96,3,14,11,88
52,r_25_126_38,seq115,seq116,r_25_126_38,1.0,0,38,38,88
16,r_161_178_38,r_134_149_90,r_109_165_26,r_134_149_90,0.72,-51,39,90,88
87,seq153,seq31,r_217_224_27,r_217_224_27,0.88,79,106,27,88
39,r_86_151_18,r_66_57_144,r_10_60_13,r_86_151_18,0.51,-2,16,18,88
47,r_181_119_131,r_201_15_152,r_156_142_109,r_181_119_131,0.99,0,131,131,88
14,r_217_224_27,seq47,seq153,r_217_224_27,0.82,0,27,27,88
59,r_173_191_54,r_94_97_146,r_53_71_116,r_173_191_54,1.0,74,128,54,88
29,r_46_130_137,r_38_55_156,r_109_165_26,r_46_130_137,0.93,0,137,137,88
5,r_69_106_10,seq92,r_140_43_125,r_69_106_10,0.96,0,10,10,88
34,r_210_29_146,r_123_8_25,r_124_77_49,r_210_29_146,0.97,0,146,146,88
53,r_123_8_25,r_11_182_165,r_210_29_146,r_123_8_25,1.0,0,25,25,88
25,r_94_97_146,r_103_189_166,r_7_45_95,r_94_97_146,0.69,0,146,146,88
64,r_201_15_152,seq122,seq14,r_201_15_152,0.46,0,152,152,88
27,r_135_155_15,r_53_71_116,r_10_60_13,r_135_155_15,0.95,3,18,15,88
50,r_145_41_66,r_134_149_90,seq33,r_145_41_66,1.0,0,66,66,88
70,r_169_133_111,r_103_189_166,seq152,r_169_133_111,1.0,1,112,111,88
68,r_0_18_87,seq70,r_218_212_72,r_0_18_87,1.0,0,87,87,88
130,seq91,r_140_43_125,r_134_149_90,r_134_149_90,0.71,35,125,90,88
38,r_23_137_157,r_143_185_190,seq39,r_23_137_157,0.83,0,157,157,88
37,r_134_149_90,seq47,seq91,r_134_149_90,0.92,0,90,90,88
22,r_10_60_13,r_62_118_101,seq192,r_10_60_13,0.98,1,14,13,88
46,r_78_13_48,r_210_29_146,r_114_150_128,r_78_13_48,1.0,1,49,48,88
75,seq128,r_205_21_169,r_37_12_72,r_37_12_72,0.98,98,170,72,88
60,r_102_214_184,seq33,r_124_77_49,r_102_214_184,0.55,0,184,184,88
40,r_216_162_41,r_35_75_186,seq67,r_216_162_41,1.0,1,42,41,88
16,r_161_178_38,r_109_165_26,r_17_68_45,r_17_68_45,0.53,42,87,45,88
17,r_204_19_178,seq220,r_53_71_116,r_53_71_116,0.6,62,178,116,88
9,r_196_72_164,seq192,r_110_80_117,r_196_72_164,0.88,0,164,164,88
86,seq24,r_99_107_174,r_110_80_117,r_110_80_117,0.65,3,120,117,88
28,r_109_165_26,r_213_40_153,r_46_130_137,r_109_165_26,0.91,127,153,26,88
34,r_210_29_146,r_78_13_48,r_123_8_25,r_210_29_146,0.99,-109,37,146,88
49,r_37_12_72,seq32,seq1,r_37_12_72,1.0,0,72,72,88
32,r_203_193_44,r_121_183_31,seq219,r_203_193_44,0.73,1,45,44,88
33,r_124_77_49,seq39,seq105,r_124_77_49,1.0,0,49,49,88
56,r_16_64_73,seq56,seq47,r_16_64_73,0.94,1,74,73,88
7,r_11_182_165,seq219,r_218_212_72,r_218_212_72,1.0,20,92,72,88
57,r_221_26_34,seq175,seq79,r_221_26_34,1.0,0,34,34,88
51,r_81_190_125,r_94_166_164,r_28_17_40,r_28_17_40,0.62,88,128,40,89
36,r_208_64_114,r_19_90_103,seq122,r_208_64_114,0.75,7,121,114,89
49,r_47_168_94,r_123_69_121,r_146_132_26,r_146_132_26,0.56,18,44,26,89
147,seq122,seq129,r_208_64_114,r_208_64_114,1.0,14,128,114,89
43,r_26_186_168,r_138_215_167,r_135_184_101,r_26_186_168,0.5,7,175,168,89
54,r_14_86_156,r_30_201_127,r_95_62_45,r_95_62_45,1.0,81,126,45,89
35,r_4_209_10,r_138_215_167,seq185,r_4_209_10,0.92,0,10,10,89
111,seq54,r_95_62_45,r_81_190_125,r_95_62_45,0.98,3,48,45,89
37,r_98_164_81,seq43,r_216_176_98,r_98_164_81,1.0,0,81,81,89
10,r_188_58_25,r_196_29_139,r_167_169_20,r_188_58_25,0.82,6,31,25,89
55,r_121_150_91,seq206,seq80,r_121_150_91,0.62,9,100,91,89
71,r_187_218_91,seq55,r_100_97_64,r_187_218_91,0.91,3,94,91,89
16,r_131_38_88,seq68,seq54,r_131_38_88,1.0,0,88,88,89
1,r_20_219_62,r_100_97_64,r_92_142_48,r_20_219_62,1.0,0,62,62,89
143,seq112,r_191_111_67,r_51_105_17,r_191_111_67,1.0,1,68,67,89
5,r_138_215_167,r_26_186_168,seq202,r_138_215_167,0.47,8,175,167,89
42,r_7_139_157,seq217,r_135_184_101,r_7_139_157,0.63,10,167,157,89
49,r_47_168_94,r_85_178_149,r_183_108_98,r_85_178_149,1.0,1,150,149,89
69,r_96_170_153,seq213,seq156,r_96_170_153,0.57,1,154,153,89
45,r_115_162_59,seq185,r_89_109_156,r_115_162_59,0.56,1,60,59,89
54,r_14_86_156,r_95_62_45,r_121_150_91,r_95_62_45,0.71,113,158,45,89
19,r_123_69_121,r_134_214_128,seq193,r_123_69_121,0.9,0,121,121,89
28,r_84_79_58,seq129,seq210,r_84_79_58,1.0,0,58,58,89
44,r_60_40_31,seq33,seq71,r_60_40_31,0.9,3,34,31,89
76,seq1,r_194_195_83,seq199,r_194_195_83,0.99,-9,74,83,89
110,seq222,r_134_214_128,r_92_142_48,r_92_142_48,0.89,79,127,48,89
3,r_144_127_159,r_99_136_177,r_174_0_172,r_144_127_159,0.44,14,173,159,89
47,r_28_17_40,r_196_29_139,seq11,r_28_17_40,0.76,0,40,40,89
62,r_67_73_50,seq182,seq193,r_67_73_50,1.0,0,50,50,89
34,r_95_62_45,seq54,seq82,r_95_62_45,1.0,3,48,45,89
26,r_153_224_164,r_24_118_169,seq1,r_153_224_164,0.63,0,164,164,89
72,r_18_72_182,seq101,r_152_130_160,r_18_72_182,0.42,1,183,182,89
4,r_152_130_160,seq71,r_36_103_2,r_152_130_160,0.6,3,163,160,89
63,r_135_184_101,seq112,seq59,r_135_184_101,0.99,0,101,101,89
73,r_196_29_139,seq154,r_88_3_106,r_196_29_139,0.74,2,141,139,89
31,r_91_53_32,seq210,seq70,r_91_53_32,0.99,0,32,32,89
49,r_47_168_94,r_146_132_26,r_85_178_149,r_47_168_94,1.0,1,95,94,89
15,r_174_0_172,r_27_197_102,r_144_127_159,r_174_0_172,0.43,-3,169,172,89
57,r_66_203_108,seq75,r_60_40_31,r_66_203_108,1.0,0,108,108,89
24,r_173_37_58,r_116_155_113,r_141_147_112,r_173_37_58,0.97,56,114,58,89
6,r_141_147_112,r_18_72_182,r_173_37_58,r_141_147_112,0.82,2,114,112,89
18,r_167_169_20,r_123_69_121,r_188_58_25,r_167_169_20,0.92,3,23,20,89
21,r_146_132_26,r_47_168_94,r_74_32_92,r_47_168_94,0.76,1,95,94,89
111,seq54,r_81_190_125,r_131_38_88,r_131_38_88,0.99,3,91,88,89
33,r_119_126_37,r_124_223_174,seq1,r_119_126_37,1.0,0,37,37,89
46,r_93_204_35,seq193,seq159,r_93_204_35,0.97,5,40,35,89
21,r_146_132_26,seq202,r_47_168_94,r_146_132_26,0.89,2,28,26,89
40,r_124_223_174,r_171_56_59,r_183_108_98,r_183_108_98,0.69,77,175,98,89
74,r_25_200_115,r_161_157_192,seq10,r_25_200_115,0.66,-1,114,115,89
29,r_134_214_128,seq222,seq182,r_134_214_128,0.66,-1,127,128,89
61,r_88_3_106,r_60_40_31,r_196_29_139,r_88_3_106,0.56,39,145,106,89
25,r_191_111_67,seq112,seq75,r_191_111_67,1.0,1,68,67,89
64,r_46_61_129,r_24_118_169,seq129,r_46_61_129,0.95,0,129,129,89
58,r_106_165_73,r_74_32_92,seq23,r_106_165_73,1.0,0,73,73,89
70,r_85_178_149,seq180,r_47_168_94,r_47_168_94,0.99,2,96,94,89
38,r_94_166_164,r_81_190_125,r_88_3_106,r_94_166_164,0.51,-36,128,164,89
60,r_87_207_34,r_191_111_67,seq206,r_191_111_67,0.87,-33,34,67,89
70,r_85_178_149,r_47_168_94,seq129,r_85_178_149,1.0,1,150,149,89
65,r_181_179_45,r_77_198_40,r_92_142_48,r_77_198_40,0.47,-8,32,40,89
45,r_115_162_59,r_89_109_156,r_173_37_58,r_89_109_156,0.95,10,166,156,89
61,r_88_3_106,r_152_130_160,r_60_40_31,r_60_40_31,0.99,12,43,31,89
17,r_194_195_83,seq1,seq213,r_194_195_83,0.96,0,83,83,89
9,r_116_155_113,seq210,r_173_37_58,r_173_37_58,1.0,7,65,58,89
48,r_34_114_41,r_98_164_81,seq8,r_98_164_81,0.59,-38,43,81,89
38,r_94_166_164,r_88_3_106,seq71,r_94_166_164,0.53,-5,159,164,89
24,r_173_37_58,seq76,r_116_155_113,r_173_37_58,1.0,0,58,58,89
0,r_92_142_48,r_196_29_139,seq222,r_92_142_48,0.97,5,53,48,89
56,r_74_32_92,seq158,r_146_132_26,r_74_32_92,0.93,12,104,92,89
9,r_116_155_113,r_173_37_58,r_91_53_32,r_116_155_113,0.98,1,114,113,89
12,r_100_97_64,seq11,seq210,r_100_97_64,1.0,0,64,64,89
51,r_161_62_99,seq51,r_174_47_62,r_161_62_99,0.96,1,100,99,90
122,seq215,r_38_54_145,r_36_132_123,r_38_54_145,1.0,0,145,145,90
61,r_28_173_24,r_6_53_60,r_32_149_94,r_28_173_24,0.81,1,25,24,90
14,r_25_118_84,seq207,seq116,r_25_118_84,0.99,0,84,84,90
8,r_32_149_94,r_170_39_107,r_13_154_61,r_32_149_94,1.0,0,94,94,90
53,r_177_72_157,seq101,r_69_150_152,r_177_72_157,0.58,0,157,157,90
43,r_17_142_172,seq190,r_113_49_37,r_113_49_37,0.85,135,172,37,90
54,r_152_181_127,r_203_5_186,seq223,r_152_181_127,0.99,0,127,127,90
59,r_83_59_163,seq201,r_25_118_84,r_25_118_84,1.0,83,167,84,90
31,r_11_193_15,r_95_77_166,r_44_213_31,r_11_193_15,0.71,0,15,15,90
71,r_120_71_123,seq40,r_137_60_121,r_120_71_123,1.0,0,123,123,90
21,r_160_219_75,seq97,r_44_213_31,r_160_219_75,1.0,0,75,75,90
1,r_170_39_107,seq222,r_6_53_60,r_6_53_60,1.0,48,108,60,90
25,r_23_34_16,r_200_31_27,seq197,r_23_34_16,0.98,-1,15,16,90
32,r_139_68_48,r_133_43_157,seq96,r_139_68_48,0.93,2,50,48,90
42,r_176_180_163,seq192,r_206_198_71,r_206_198_71,1.0,100,171,71,90
31,r_11_193_15,r_44_213_31,r_78_81_28,r_11_193_15,0.97,17,32,15,90
7,r_212_112_11,seq116,r_26_109_43,r_26_109_43,0.99,32,75,43,90
69,r_111_220_86,r_211_199_192,seq143,r_111_220_86,0.99,0,86,86,90
19,r_69_150_152,seq222,r_177_72_157,r_177_72_157,0.78,4,161,157,90
65,r_106_127_165,r_95_77_166,seq123,r_106_127_165,0.83,0,165,165,90
57,r_151_115_100,r_172_75_130,r_126_0_90,r_151_115_100,1.0,0,100,100,90
44,r_1_224_42,seq88,seq92,r_1_224_42,1.0,4,46,42,90
30,r_200_31_27,r_137_60_121,seq186,r_200_31_27,1.0,0,27,27,90
2,r_44_213_31,r_170_39_107,seq46,r_44_213_31,0.98,1,32,31,90
67,r_171_214_79,r_20_141_140,seq42,r_171_214_79,1.0,1,80,79,90
110,seq65,r_36_132_123,r_52_30_84,r_52_30_84,1.0,45,129,84,90
3,r_95_77_166,seq131,seq192,r_95_77_166,0.57,1,167,166,90
10,r_162_14_79,r_172_75_130,seq18,r_162_14_79,1.0,3,82,79,90
72,r_20_141_140,r_15_64_36,seq29,r_20_141_140,0.9,0,140,140,90
74,r_172_75_130,r_162_14_79,r_151_115_100,r_162_14_79,0.99,-28,51,79,90
4,r_126_0_90,r_20_141_140,seq40,r_126_0_90,1.0,0,90,90,90
78,seq134,r_23_34_16,seq135,r_23_34_16,0.46,58,74,16,90
63,r_87_73_81,seq117,seq164,r_87_73_81,1.0,0,81,81,90
11,r_27_205_147,r_106_127_165,seq197,r_27_205_147,0.49,5,152,147,90
107,seq190,r_17_142_172,r_167_102_87,r_167_102_87,1.0,85,172,87,90
13,r_174_47_62,r_138_61_196,r_1_224_42,r_174_47_62,0.98,2,64,62,90
15,r_8_182_189,seq209,r_26_109_43,r_26_109_43,0.99,147,190,43,90
66,r_56_107_35,r_161_62_99,seq136,r_56_107_35,1.0,1,36,35,90
31,r_11_193_15,r_78_81_28,r_156_2_137,r_156_2_137,0.81,-1,136,137,90
33,r_113_49_37,seq40,seq131,r_113_49_37,1.0,0,37,37,90
85,seq18,r_24_122_189,r_162_14_79,r_162_14_79,1.0,6,85,79,90
134,seq131,r_95_77_166,r_48_41_46,r_48_41_46,0.95,52,98,46,90
27,r_138_61_196,r_174_47_62,r_79_119_122,r_174_47_62,0.99,2,64,62,90
47,r_79_119_122,seq98,r_90_130_129,r_90_130_129,0.99,0,129,129,90
40,r_137_60_121,seq143,seq145,r_137_60_121,1.0,0,121,121,90
18,r_70_147_84,seq116,r_139_68_48,r_70_147_84,0.91,0,84,84,90
29,r_206_198_71,seq35,seq187,r_206_198_71,1.0,0,71,71,90
61,r_28_173_24,r_32_149_94,seq50,r_32_149_94,1.0,0,94,94,90
41,r_163_84_10,r_179_169_136,seq157,r_163_84_10,0.99,0,10,10,90
6,r_26_109_43,r_36_132_123,r_212_112_11,r_26_109_43,1.0,0,43,43,90
64,r_191_194_157,seq216,r_170_39_107,r_191_194_157,0.93,0,157,157,90
37,r_221_94_33,seq74,seq76,r_221_94_33,0.94,5,38,33,90
50,r_4_58_94,seq55,r_126_0_90,r_4_58_94,1.0,0,94,94,90
58,r_86_188_68,seq128,seq57,r_86_188_68,1.0,0,68,68,90
74,r_172_75_130,r_151_115_100,seq104,r_151_115_100,0.71,0,100,100,90
70,r_90_130_129,seq210,r_79_119_122,r_90_130_129,1.0,1,130,129,90
65,r_106_127_165,r_27_205_147,r_95_77_166,r_27_205_147,0.87,5,152,147,90
68,r_185_148_138,seq215,r_163_84_10,r_185_148_138,0.77,1,139,138,90
38,r_13_154_61,r_24_122_189,seq3,r_13_154_61,1.0,0,61,61,90
52,r_9_175_105,seq101,r_163_84_10,r_9_175_105,0.99,0,105,105,90
34,r_167_102_87,seq157,seq190,r_167_102_87,1.0,0,87,87,90
39,r_146_155_50,seq153,seq186,r_146_155_50,1.0,1,51,50,90
94,seq40,r_120_71_123,r_126_0_90,r_126_0_90,0.51,34,124,90,90
9,r_156_2_137,seq16,r_11_193_15,r_156_2_137,0.65,-1,136,137,90
55,r_78_81_28,seq104,r_32_149_94,r_78_81_28,1.0,0,28,28,90
123,seq88,seq66,r_33_85_46,r_33_85_46,0.97,30,76,46,90
35,r_196_37_14,r_179_169_136,seq101,r_196_37_14,0.99,1,15,14,90
28,r_6_53_60,r_24_122_189,seq158,r_6_53_60,1.0,0,60,60,90
57,r_151_115_100,r_48_41_46,r_172_75_130,r_48_41_46,1.0,0,46,46,90
135,seq101,r_9_175_105,r_196_37_14,r_9_175_105,0.76,-7,98,105,90
49,r_140_89_147,r_177_72_157,r_139_68_48,r_139_68_48,0.9,104,152,48,90
60,r_33_85_46,r_162_14_79,seq88,r_162_14_79,0.62,-31,48,79,90
140,seq108,r_183_202_116,seq19,r_183_202_116,0.92,4,120,116,90
56,r_121_189_100,seq96,seq92,r_121_189_100,0.71,0,100,100,90
23,r_12_204_131,seq208,seq18,r_12_204_131,0.78,0,131,131,90
138,seq104,seq105,r_172_75_130,r_172_75_130,0.75,15,145,130,90
24,r_217_144_31,seq157,seq105,r_217_144_31,1.0,0,31,31,90
12,r_52_30_84,seq223,seq65,r_52_30_84,1.0,0,84,84,90
46,r_48_41_46,r_151_115_100,seq131,r_48_41_46,0.92,0,46,46,90
55,r_78_81_28,r_32_149_94,r_69_150_152,r_32_149_94,1.0,0,94,94,90
68,r_210_187_19,r_160_83_166,r_12_79_179,r_210_187_19,0.92,-1,18,19,91
51,r_129_127_84,r_159_177_41,seq188,r_159_177_41,0.52,19,60,41,91
9,r_46_135_117,r_141_40_13,r_77_168_54,r_46_135_117,0.57,0,117,117,91
14,r_54_170_84,r_114_15_93,seq200,r_114_15_93,1.0,1,94,93,91
8,r_154_80_123,r_160_83_166,r_139_198_26,r_154_80_123,0.8,0,123,123,91
54,r_25_207_147,seq24,r_157_96_14,r_25_207_147,0.98,0,147,147,91
37,r_35_21_135,r_148_58_174,r_45_201_105,r_35_21_135,0.95,0,135,135,91
30,r_181_11_55,seq91,seq70,r_181_11_55,1.0,0,55,55,91
59,r_94_161_107,seq200,seq62,r_94_161_107,0.89,1,108,107,91
71,r_151_86_50,r_19_190_147,r_81_191_19,r_81_191_19,0.99,-2,17,19,91
55,r_159_177_41,r_129_127_84,seq182,r_129_127_84,1.0,-24,60,84,91
9,r_46_135_117,r_118_87_30,r_141_40_13,r_46_135_117,0.97,-103,14,117,91
16,r_126_144_73,r_176_212_83,seq115,r_126_144_73,1.0,1,74,73,91
21,r_183_145_95,r_189_206_192,r_99_0_52,r_183_145_95,0.91,0,95,95,91
39,r_112_98_60,r_47_222_93,r_141_40_13,r_47_222_93,0.64,-33,60,93,91
1,r_43_123_94,seq23,seq108,r_43_123_94,0.91,0,94,94,91
143,seq110,r_12_79_179,r_160_83_166,r_12_79_179,0.34,0,179,179,91
53,r_84_136_20,seq195,seq24,r_84_136_20,0.95,-1,19,20,91
5,r_69_95_116,seq140,seq172,r_69_95_116,0.86,1,117,116,91
51,r_129_127_84,seq188,seq219,r_129_127_84,1.0,0,84,84,91
111,seq59,r_45_201_105,seq105,r_45_201_105,1.0,6,111,105,91
25,r_148_58_174,seq48,r_54_170_84,r_148_58_174,0.99,1,175,174,91
80,seq137,r_176_212_83,seq158,r_176_212_83,1.0,0,83,83,91
45,r_199_27_163,seq62,r_157_96_14,r_199_27_163,0.89,0,163,163,91
71,r_151_86_50,r_81_191_19,seq36,r_151_86_50,1.0,0,50,50,91
19,r_174_56_139,seq195,seq33,r_174_56_139,0.75,1,140,139,91
2,r_45_201_105,seq93,r_35_21_135,r_35_21_135,0.78,15,150,135,91
66,r_175_29_156,r_189_206_192,r_63_134_71,r_175_29_156,0.76,0,156,156,91
31,r_2_194_189,seq110,r_103_53_1,r_103_53_1,0.6,188,189,1,91
33,r_77_168_54,r_133_57_143,seq10,r_133_57_143,0.88,-86,57,143,91
67,r_52_119_177,seq104,r_218_92_141,r_218_92_141,0.87,36,177,141,91
10,r_68_138_70,seq140,seq193,r_68_138_70,0.96,1,71,70,91
20,r_160_83_166,seq188,r_99_0_52,r_160_83_166,0.96,2,168,166,91
115,seq64,seq220,r_120_147_56,r_120_147_56,1.0,20,76,56,91
26,r_146_121_87,seq55,seq172,r_146_121_87,0.82,9,96,87,91
72,r_26_39_107,seq82,seq220,r_26_39_107,0.95,9,116,107,91
139,seq104,r_52_119_177,r_60_217_60,r_60_217_60,1.0,15,75,60,91
43,r_171_131_35,r_218_92_141,seq158,r_171_131_35,1.0,1,36,35,91
4,r_166_89_181,seq163,r_218_92_141,r_218_92_141,0.61,40,181,141,91
112,seq188,seq182,r_164_128_122,r_164_128_122,1.0,3,125,122,91
73,r_60_217_60,seq186,seq104,r_60_217_60,0.96,1,61,60,91
11,r_176_212_83,seq137,r_5_32_70,r_176_212_83,1.0,0,83,83,91
20,r_160_83_166,r_154_80_123,seq188,r_154_80_123,0.92,0,123,123,91
15,r_61_169_172,seq3,seq91,r_61_169_172,0.4,0,172,172,91
49,r_141_40_13,r_46_135_117,r_112_98_60,r_46_135_117,0.84,0,117,117,91
13,r_164_128_122,r_61_169_172,seq188,r_164_128_122,0.63,1,123,122,91
6,r_103_53_1,seq100,r_114_15_93,r_114_15_93,0.92,1,94,93,91
62,r_133_57_143,seq64,seq104,r_133_57_143,0.75,0,143,143,91
68,r_210_187_19,r_12_79_179,r_99_0_52,r_210_187_19,0.54,53,72,19,91
87,seq23,seq186,r_113_8_162,r_113_8_162,0.83,5,167,162,91
49,r_141_40_13,seq124,r_46_135_117,r_141_40_13,0.95,1,14,13,91
87,seq23,r_45_201_105,seq186,r_45_201_105,0.98,-15,90,105,91
3,r_81_191_19,r_151_86_50,r_84_136_20,r_151_86_50,1.0,0,50,50,91
2,r_45_201_105,seq59,seq93,r_45_201_105,0.81,6,111,105,91
47,r_216_203_100,seq10,r_54_170_84,r_216_203_100,0.92,0,100,100,91
40,r_113_8_162,seq42,seq23,r_113_8_162,0.55,0,162,162,91
126,seq78,r_38_30_63,seq33,r_38_30_63,1.0,0,63,63,91
18,r_143_196_124,r_73_152_124,seq100,r_143_196_124,1.0,0,124,124,91
29,r_17_156_82,seq163,seq64,r_17_156_82,0.98,0,82,82,91
63,r_139_198_26,r_162_31_192,r_84_136_20,r_139_198_26,1.0,0,26,26,91
38,r_132_153_28,r_118_87_30,r_72_215_70,r_118_87_30,1.0,0,30,30,91
24,r_37_20_68,r_45_201_105,seq165,r_37_20_68,0.55,1,69,68,91
25,r_148_58_174,r_35_21_135,seq48,r_35_21_135,1.0,0,135,135,91
28,r_118_87_30,seq18,seq116,r_118_87_30,1.0,0,30,30,91
42,r_157_96_14,r_47_222_93,seq36,r_157_96_14,1.0,0,14,14,91
32,r_120_147_56,r_113_8_162,seq64,r_120_147_56,1.0,1,57,56,91
50,r_149_178_128,seq116,r_126_144_73,r_126_144_73,0.54,58,131,73,91
58,r_114_15_93,r_54_170_84,r_103_53_1,r_114_15_93,1.0,1,94,93,91
137,seq100,seq219,r_143_196_124,r_143_196_124,1.0,20,144,124,91
64,r_19_190_147,r_117_130_37,r_81_191_19,r_19_190_147,0.89,-119,28,147,91
52,r_209_107_126,r_97_106_168,r_141_40_13,r_209_107_126,0.75,2,128,126,91
34,r_179_65_116,seq36,seq213,r_179_65_116,0.91,0,116,116,91
64,r_19_190_147,r_81_191_19,seq51,r_19_190_147,0.77,0,147,147,91
133,seq91,r_181_11_55,seq108,r_181_11_55,0.98,0,55,55,91
65,r_102_223_18,r_97_106_168,seq158,r_102_223_18,1.0,0,18,18,91
17,r_47_222_93,seq51,seq105,r_47_222_93,0.69,0,93,93,91
112,seq188,r_129_127_84,seq182,r_129_127_84,1.0,-21,63,84,91
63,r_139_198_26,r_84_136_20,r_16_67_136,r_16_67_136,0.99,1,137,136,91
22,r_38_30_63,seq78,r_157_96_14,r_38_30_63,0.98,0,63,63,91
3,r_81_191_19,r_148_58_174,r_151_86_50,r_81_191_19,0.98,0,19,19,91
56,r_73_152_124,r_143_196_124,r_69_95_116,r_143_196_124,1.0,0,124,124,91
7,r_90_204_83,r_125_13_109,r_132_153_28,r_90_204_83,1.0,0,83,83,91
57,r_117_130_37,r_25_207_147,seq51,r_117_130_37,0.96,2,39,37,91
13,r_164_128_122,r_5_32_70,r_61_169_172,r_61_169_172,0.64,-134,38,172,91
23,r_99_0_52,seq200,r_210_187_19,r_99_0_52,0.81,8,60,52,91
12,r_63_134_71,r_12_79_179,seq3,r_63_134_71,0.99,-3,68,71,91
30,r_171_93_132,seq222,seq15,r_171_93_132,0.49,5,137,132,92
51,r_14_9_96,seq169,seq10,r_14_9_96,0.99,0,96,96,92
14,r_81_44_153,r_118_150_165,r_89_196_89,r_81_44_153,0.96,0,153,153,92
147,seq148,r_52_70_116,r_127_66_96,r_127_66_96,0.94,-2,94,96,92
8,r_224_141_88,seq160,r_163_39_31,r_224_141_88,0.6,1,89,88,92
54,r_133_47_75,r_91_114_169,seq1,r_133_47_75,1.0,0,75,75,92
37,r_210_195_50,r_91_114_169,seq104,r_210_195_50,1.0,0,50,50,92
55,r_71_23_74,r_211_154_199,r_142_223_20,r_71_23_74,1.0,0,74,74,92
86,seq18,r_166_92_174,r_7_57_165,r_7_57_165,0.7,-7,158,165,92
39,r_89_196_89,r_2_221_152,seq86,r_89_196_89,1.0,0,89,89,92
1,r_75_12_81,seq3,seq110,r_75_12_81,1.0,1,82,81,92
42,r_203_35_68,seq1,r_126_217_126,r_203_35_68,1.0,0,68,68,92
111,seq53,r_6_0_165,r_173_202_55,r_6_0_165,0.68,5,170,165,92
80,seq10,seq46,r_14_9_96,r_14_9_96,1.0,5,101,96,92
18,r_80_140_33,r_55_102_70,r_117_124_45,r_55_102_70,0.91,-35,35,70,92
69,r_200_100_113,r_117_124_45,seq208,r_200_100_113,0.63,5,118,113,92
3,r_74_103_13,r_121_51_132,r_118_150_165,r_74_103_13,0.94,1,14,13,92
134,seq165,r_129_58_128,seq131,r_129_58_128,0.6,-87,41,128,92
19,r_170_26_156,seq86,r_27_158_30,r_27_158_30,1.0,130,160,30,92
43,r_73_77_52,r_173_202_55,seq179,r_73_77_52,1.0,0,52,52,92
95,seq31,r_172_67_100,seq164,r_172_67_100,1.0,1,101,100,92
66,r_127_66_96,seq189,seq148,r_127_66_96,0.95,0,96,96,92
41,r_6_0_165,seq53,r_163_39_31,r_163_39_31,0.99,139,170,31,92
60,r_109_88_39,seq34,r_191_136_152,r_109_88_39,1.0,0,39,39,92
115,seq189,r_90_30_186,r_143_186_164,r_143_186_164,0.87,19,183,164,92
26,r_126_217_126,r_211_154_199,seq145,r_126_217_126,0.97,2,128,126,92
72,r_197_147_175,r_43_213_179,seq206,r_197_147_175,0.66,0,175,175,92
0,r_105_182_118,seq68,r_55_102_70,r_105_182_118,0.85,0,118,118,92
63,r_25_82_142,r_54_24_49,r_163_39_31,r_25_82_142,0.93,1,143,142,92
73,r_130_19_107,r_193_50_111,r_185_63_29,r_193_50_111,0.62,-3,108,111,92
11,r_121_51_132,r_171_93_132,r_91_114_169,r_121_51_132,1.0,0,132,132,92
20,r_142_223_20,seq207,r_71_23_74,r_71_23_74,1.0,22,96,74,92
13,r_166_92_174,seq155,r_224_141_88,r_166_92_174,0.44,1,175,174,92
15,r_129_58_128,r_8_22_182,seq20,r_129_58_128,1.0,1,129,128,92
57,r_117_124_45,r_200_100_113,r_80_140_33,r_117_124_45,0.9,73,118,45,92
6,r_13_199_161,seq72,r_74_103_13,r_13_199_161,0.81,0,161,161,92
27,r_118_150_165,r_52_70_116,r_74_103_13,r_74_103_13,1.0,0,13,13,92
134,seq165,seq131,r_130_19_107,r_130_19_107,1.0,9,116,107,92
36,r_185_63_29,seq37,r_172_67_100,r_172_67_100,1.0,5,105,100,92
48,r_62_146_20,r_43_213_179,seq87,r_62_146_20,1.0,2,22,20,92
2,r_85_178_13,r_7_57_165,r_79_175_170,r_85_178_13,0.36,159,172,13,92
40,r_107_177_132,r_191_136_152,seq46,r_191_136_152,1.0,-19,133,152,92
126,seq208,r_211_154_199,r_200_100_113,r_200_100_113,0.91,-21,92,113,92
29,r_55_102_70,r_211_154_199,r_116_214_33,r_55_102_70,1.0,0,70,70,92
24,r_220_76_62,r_55_102_70,r_181_198_26,r_55_102_70,0.97,-10,60,70,92
25,r_191_136_152,r_107_177_132,r_138_120_197,r_191_136_152,0.96,0,152,152,92
136,seq97,seq104,r_216_38_8,r_216_38_8,1.0,2,10,8,92
64,r_79_175_170,r_99_78_107,seq222,r_99_78_107,1.0,-30,77,107,92
50,r_32_134_107,r_170_26_156,r_174_194_51,r_32_134_107,0.83,2,109,107,92
58,r_65_167_104,r_2_221_152,r_55_102_70,r_65_167_104,0.98,5,109,104,92
70,r_99_78_107,r_79_175_170,seq208,r_99_78_107,0.99,1,108,107,92
65,r_41_184_154,r_7_57_165,r_173_202_55,r_173_202_55,0.85,102,157,55,92
98,seq34,r_109_88_39,seq219,r_109_88_39,0.95,5,44,39,92
68,r_172_67_100,seq31,r_185_63_29,r_172_67_100,0.99,1,101,100,92
42,r_203_35_68,r_126_217_126,r_224_141_88,r_126_217_126,1.0,2,128,126,92
61,r_84_61_189,seq68,r_105_182_118,r_105_182_118,1.0,71,189,118,92
52,r_29_180_94,r_209_152_175,seq212,r_29_180_94,1.0,0,94,94,92
34,r_83_106_122,seq164,r_127_66_96,r_83_106_122,1.0,0,122,122,92
64,r_79_175_170,seq222,r_75_12_81,r_79_175_170,0.79,0,170,170,92
124,seq206,r_166_92_174,r_197_147_175,r_197_147_175,0.72,0,175,175,92
17,r_16_17_66,r_170_26_156,seq60,r_16_17_66,1.0,0,66,66,92
121,seq201,r_183_144_172,r_43_213_179,r_183_144_172,0.95,-11,161,172,92
36,r_185_63_29,r_220_76_62,seq37,r_185_63_29,0.98,1,30,29,92
96,seq160,r_224_141_88,r_118_150_165,r_224_141_88,0.96,1,89,88,92
98,seq34,seq219,r_210_195_50,r_210_195_50,0.9,115,165,50,92
22,r_11_187_174,r_211_154_199,r_52_70_116,r_211_154_199,0.49,-24,175,199,92
10,r_174_194_51,r_105_182_118,seq219,r_174_194_51,1.0,0,51,51,92
28,r_209_152_175,seq60,r_52_70_116,r_209_152_175,0.46,0,175,175,92
49,r_95_128_140,seq64,r_174_194_51,r_174_194_51,0.61,89,140,51,92
7,r_52_70_116,r_7_57_165,r_11_187_174,r_52_70_116,0.72,56,172,116,92
31,r_27_158_30,r_2_221_152,seq46,r_27_158_30,1.0,1,31,30,92
56,r_90_30_186,seq189,r_173_202_55,r_173_202_55,0.64,133,188,55,92
7,r_52_70_116,seq148,r_7_57_165,r_52_70_116,0.66,2,118,116,92
35,r_116_214_33,r_79_175_170,seq162,r_79_175_170,0.93,-138,32,170,92
32,r_181_198_26,r_166_92_174,r_220_76_62,r_181_198_26,0.92,26,52,26,92
23,r_2_221_152,seq219,r_200_100_113,r_2_221_152,0.95,1,153,152,92
60,r_109_88_39,r_191_136_152,seq5,r_191_136_152,1.0,0,152,152,92
12,r_8_22_182,seq15,seq31,r_8_22_182,0.58,0,182,182,92
128,seq86,r_170_26_156,r_89_196_89,r_89_196_89,1.0,0,89,89,92
30,r_61_55_182,seq90,r_159_135_7,r_61_55_182,0.49,0,182,182,93
19,r_119_158_42,seq136,seq101,r_119_158_42,0.98,1,43,42,93
47,r_134_209_22,seq186,seq147,r_134_209_22,0.98,0,22,22,93
51,r_191_105_65,seq14,seq39,r_191_105_65,1.0,0,65,65,93
117,seq195,seq185,r_193_50_26,r_193_50_26,1.0,22,48,26,93
36,r_11_107_169,r_150_27_197,r_24_184_42,r_11_107_169,0.52,0,169,169,93
58,r_13_154_36,r_123_204_62,seq73,r_13_154_36,0.95,0,36,36,93
66,r_175_100_38,r_20_53_142,seq187,r_20_53_142,1.0,0,142,142,93
14,r_80_42_148,r_168_138_114,r_208_179_52,r_208_179_52,1.0,47,99,52,93
53,r_66_223_155,seq65,seq155,r_66_223_155,0.29,17,172,155,93
54,r_69_23_99,r_47_163_87,r_199_111_119,r_199_111_119,0.97,12,131,119,93
54,r_69_23_99,r_143_77_149,r_47_163_87,r_69_23_99,0.88,1,100,99,93
13,r_24_184_42,r_32_48_153,seq114,r_24_184_42,1.0,1,43,42,93
116,seq65,r_66_223_155,r_31_93_27,r_31_93_27,1.0,145,172,27,93
23,r_20_53_142,seq187,r_175_100_38,r_175_100_38,1.0,16,54,38,93
20,r_4_84_36,seq185,r_199_111_119,r_4_84_36,0.96,0,36,36,93
104,seq178,r_177_58_35,seq155,r_177_58_35,1.0,2,37,35,93
55,r_16_133_125,seq187,r_103_7_4,r_16_133_125,0.95,1,126,125,93
21,r_150_27_197,r_11_107_169,seq149,r_11_107_169,0.89,0,169,169,93
60,r_126_141_21,r_119_158_42,r_40_152_198,r_126_141_21,0.96,0,21,21,93
1,r_143_77_149,r_2_37_189,seq0,r_143_77_149,0.96,0,149,149,93
5,r_91_104_167,r_89_160_67,seq14,r_89_160_67,0.8,2,69,67,93
42,r_180_176_169,seq144,r_34_45_128,r_34_45_128,0.85,42,170,128,93
24,r_117_38_11,r_80_42_148,seq145,r_117_38_11,0.72,0,11,11,93
8,r_151_9_24,r_40_152_198,seq222,r_151_9_24,1.0,0,24,24,93
73,r_172_18_35,r_61_55_182,seq162,r_172_18_35,1.0,2,37,35,93
100,seq39,seq63,r_67_122_84,r_67_122_84,1.0,47,131,84,93
71,r_30_98_47,seq182,seq129,r_30_98_47,1.0,1,48,47,93
41,r_41_75_73,r_43_224_195,seq0,r_41_75_73,0.88,0,73,73,93
3,r_10_88_62,seq131,r_151_9_24,r_10_88_62,1.0,2,64,62,93
10,r_47_163_87,seq181,seq90,r_47_163_87,0.98,0,87,87,93
72,r_153_207_158,r_40_152_198,r_32_48_153,r_153_207_158,0.54,-1,157,158,93
61,r_199_111_119,seq178,r_4_84_36,r_4_84_36,0.98,2,38,36,93
4,r_82_156_99,seq217,r_146_140_178,r_82_156_99,1.0,0,99,99,93
0,r_68_202_74,seq142,r_143_77_149,r_68_202_74,1.0,0,74,74,93
63,r_36_170_126,r_150_27_197,r_106_121_8,r_36_170_126,0.92,6,132,126,93
11,r_85_49_104,r_206_94_158,seq182,r_85_49_104,0.99,0,104,104,93
6,r_193_50_26,r_196_81_69,seq195,r_193_50_26,1.0,0,26,26,93
48,r_188_200_95,seq29,seq54,r_188_200_95,1.0,1,96,95,93
57,r_211_44_128,r_146_140_178,r_24_184_42,r_24_184_42,1.0,95,137,42,93
56,r_177_58_35,seq178,seq108,r_177_58_35,0.97,2,37,35,93
5,r_91_104_167,seq14,r_194_71_131,r_91_104_167,0.64,1,168,167,93
0,r_68_202_74,r_143_77_149,r_34_45_128,r_143_77_149,0.57,-4,145,149,93
87,seq14,r_91_104_167,seq149,r_91_104_167,0.61,1,168,167,93
87,seq14,r_191_105_65,r_91_104_167,r_191_105_65,1.0,0,65,65,93
2,r_123_204_62,r_143_77_149,r_15_221_23,r_123_204_62,0.97,2,64,62,93
142,seq113,r_34_45_128,r_194_71_131,r_194_71_131,1.0,1,132,131,93
14,r_80_42_148,r_208_179_52,r_89_160_67,r_80_42_148,0.99,0,148,148,93
18,r_28_198_187,seq147,r_13_154_36,r_13_154_36,0.83,151,187,36,93
29,r_34_45_128,seq113,r_68_202_74,r_68_202_74,1.0,55,129,74,93
61,r_199_111_119,r_4_84_36,r_69_23_99,r_199_111_119,0.99,0,119,119,93
43,r_102_21_18,r_10_88_62,seq39,r_102_21_18,1.0,0,18,18,93
64,r_194_71_131,seq145,seq113,r_194_71_131,0.98,0,131,131,93
88,seq144,r_180_176_169,r_219_110_61,r_180_176_169,0.44,4,173,169,93
50,r_196_81_69,seq169,seq145,r_196_81_69,0.94,3,72,69,93
70,r_87_164_171,r_22_212_96,seq29,r_22_212_96,1.0,0,96,96,93
6,r_193_50_26,seq195,r_95_190_113,r_95_190_113,1.0,11,124,113,93
65,r_210_220_70,r_25_201_45,seq197,r_210_220_70,1.0,0,70,70,93
20,r_4_84_36,r_199_111_119,seq155,r_199_111_119,1.0,0,119,119,93
68,r_168_138_114,r_80_42_148,r_191_105_65,r_168_138_114,0.77,5,119,114,93
32,r_89_160_67,r_91_104_167,seq60,r_89_160_67,0.99,2,69,67,93
38,r_2_37_189,r_143_77_149,r_68_202_74,r_68_202_74,0.94,77,151,74,93
52,r_95_190_113,seq6,r_193_50_26,r_95_190_113,1.0,1,114,113,93
34,r_26_19_110,seq46,r_103_7_4,r_26_19_110,0.94,0,110,110,93
26,r_15_221_23,r_208_179_52,seq1,r_15_221_23,0.69,-1,22,23,93
17,r_8_130_11,r_15_221_23,seq137,r_8_130_11,0.98,0,11,11,93
46,r_165_59_38,seq6,seq181,r_165_59_38,1.0,0,38,38,93
9,r_219_110_61,r_211_44_128,r_208_179_52,r_208_179_52,1.0,28,80,52,93
45,r_208_179_52,seq73,r_219_110_61,r_208_179_52,1.0,1,53,52,93
22,r_22_212_96,r_87_164_171,seq145,r_22_212_96,1.0,-2,94,96,93
28,r_83_125_126,seq127,r_31_93_27,r_83_125_126,0.91,0,126,126,93
149,seq127,r_83_125_126,seq113,r_83_125_126,1.0,0,126,126,93
7,r_32_48_153,seq222,r_206_94_158,r_32_48_153,0.88,1,154,153,93
40,r_31_93_27,r_219_110_61,seq65,r_31_93_27,1.0,0,27,27,93
75,seq0,r_41_75_73,r_143_77_149,r_143_77_149,1.0,11,160,149,93
23,r_20_53_142,r_175_100_38,seq169,r_20_53_142,1.0,0,142,142,93
84,seq128,r_216_72_106,seq181,r_216_72_106,1.0,0,106,106,93
66,r_175_100_38,seq99,r_20_53_142,r_175_100_38,1.0,1,39,38,93
40,r_0_54_162,r_194_208_65,r_223_1_165,r_0_54_162,0.93,0,162,162,94
30,r_194_208_65,seq20,r_0_54_162,r_194_208_65,0.98,0,65,65,94
8,r_178_219_66,r_212_83_100,r_135_55_53,r_178_219_66,1.0,0,66,66,94
53,r_126_82_72,r_97_65_174,r_31_188_100,r_126_82_72,0.94,-1,71,72,94
67,r_156_150_143,r_109_163_41,r_199_195_150,r_109_163_41,1.0,-14,27,41,94
146,seq116,r_118_57_75,r_91_145_109,r_118_57_75,1.0,-9,66,75,94
83,seq138,r_97_65_174,r_72_121_161,r_97_65_174,0.67,1,175,174,94
37,r_99_224_103,seq9,seq22,r_99_224_103,1.0,0,103,103,94
43,r_125_28_28,r_167_149_94,seq157,r_125_28_28,0.53,2,30,28,94
55,r_204_119_113,r_180_134_142,seq12,r_180_134_142,0.67,-29,113,142,94
86,seq14,r_223_1_165,r_27_186_68,r_27_186_68,0.83,-1,67,68,94
16,r_159_217_109,r_61_16_165,r_31_188_100,r_159_217_109,0.95,0,109,109,94
21,r_187_17_83,r_59_76_127,seq79,r_187_17_83,1.0,0,83,83,94
39,r_167_149_94,seq98,seq64,r_167_149_94,1.0,0,94,94,94
1,r_122_171_138,r_92_161_166,r_127_220_60,r_122_171_138,0.98,0,138,138,94
46,r_97_65_174,seq138,seq13,r_97_65_174,0.74,1,175,174,94
45,r_8_173_22,r_72_121_161,seq18,r_8_173_22,0.99,0,22,22,94
62,r_72_121_161,r_95_73_85,seq138,r_72_121_161,1.0,0,161,161,94
31,r_92_161_166,r_122_171_138,r_109_163_41,r_109_163_41,1.0,1,42,41,94
19,r_4_53_91,r_159_217_109,seq98,r_159_217_109,0.46,-13,96,109,94
34,r_181_86_77,r_176_24_34,r_164_216_97,r_164_216_97,1.0,9,106,97,94
33,r_7_148_12,r_180_134_142,r_56_170_102,r_7_148_12,0.65,124,136,12,94
11,r_95_73_85,r_72_121_161,r_26_196_129,r_95_73_85,0.92,76,161,85,94
47,r_109_163_41,r_156_150_143,r_92_161_166,r_109_163_41,1.0,0,41,41,94
41,r_118_57_75,seq116,seq211,r_118_57_75,0.98,0,75,75,94
57,r_112_183_40,r_62_107_186,seq6,r_112_183_40,1.0,0,40,40,94
67,r_156_150_143,r_199_195_150,r_194_208_65,r_199_195_150,0.99,-7,143,150,94
3,r_191_198_167,seq190,r_187_17_83,r_191_198_167,0.7,0,167,167,94
72,r_164_216_97,r_31_188_100,r_181_86_77,r_164_216_97,0.52,0,97,97,94
4,r_56_170_102,seq68,r_7_148_12,r_56_170_102,0.97,1,103,102,94
0,r_127_220_60,seq104,r_153_78_36,r_127_220_60,1.0,0,60,60,94
63,r_103_101_185,r_42_214_197,seq146,r_42_214_197,0.25,-11,186,197,94
73,r_85_177_189,seq51,r_127_220_60,r_127_220_60,1.0,129,189,60,94
11,r_95_73_85,seq22,r_72_121_161,r_95_73_85,0.87,0,85,85,94
20,r_15_38_184,seq175,r_178_219_66,r_15_38_184,0.51,0,184,184,94
13,r_26_196_129,seq165,seq157,r_26_196_129,0.8,0,129,129,94
15,r_199_195_150,seq141,r_99_224_103,r_99_224_103,1.0,49,152,103,94
48,r_67_2_142,r_0_54_162,r_46_87_198,r_0_54_162,0.53,-20,142,162,94
10,r_176_24_34,seq132,seq213,r_176_24_34,1.0,0,34,34,94
62,r_72_121_161,r_159_217_109,r_95_73_85,r_95_73_85,0.84,0,85,85,94
27,r_200_154_61,seq143,seq166,r_200_154_61,1.0,0,61,61,94
59,r_169_35_26,r_122_171_138,seq50,r_169_35_26,1.0,0,26,26,94
30,r_194_208_65,r_0_54_162,r_156_150_143,r_194_208_65,0.67,97,162,65,94
36,r_135_55_53,r_27_186_68,seq165,r_135_55_53,1.0,-2,51,53,94
26,r_58_23_15,r_199_195_150,seq6,r_58_23_15,0.95,0,15,15,94
2,r_43_48_85,seq132,r_112_183_40,r_43_48_85,1.0,0,85,85,94
40,r_0_54_162,r_67_2_142,r_194_208_65,r_194_208_65,1.0,1,66,65,94
74,r_131_162_82,r_59_76_127,seq221,r_131_162_82,0.93,1,83,82,94
18,r_10_158_197,seq115,r_105_182_37,r_105_182_37,1.0,37,74,37,94
29,r_71_25_107,seq155,seq115,r_71_25_107,1.0,0,107,107,94
62,r_72_121_161,r_8_173_22,r_159_217_109,r_8_173_22,0.85,24,46,22,94
56,r_210_96_57,r_71_25_107,seq142,r_210_96_57,0.83,0,57,57,94
24,r_223_1_165,seq14,r_0_54_162,r_0_54_162,0.93,5,167,162,94
25,r_212_83_100,r_85_177_189,seq133,r_212_83_100,1.0,0,100,100,94
64,r_62_107_186,seq142,r_178_219_66,r_62_107_186,0.2,0,186,186,94
47,r_109_163_41,r_92_161_166,seq143,r_92_161_166,0.74,1,167,166,94
61,r_105_182_37,r_160_174_83,seq40,r_105_182_37,1.0,0,37,37,94
65,r_59_76_127,seq142,r_147_88_55,r_147_88_55,1.0,70,125,55,94
32,r_63_44_127,r_89_84_59,r_56_170_102,r_63_44_127,0.93,0,127,127,94
54,r_147_88_55,r_151_102_81,r_59_76_127,r_147_88_55,0.98,-1,54,55,94
38,r_120_110_113,seq111,seq40,r_120_110_113,0.99,0,113,113,94
6,r_153_78_36,r_71_25_107,r_8_173_22,r_8_173_22,0.75,14,36,22,94
34,r_181_86_77,r_91_145_109,r_176_24_34,r_181_86_77,1.0,-1,76,77,94
132,seq205,r_27_186_68,r_181_86_77,r_181_86_77,1.0,90,167,77,94
33,r_7_148_12,r_63_44_127,r_180_134_142,r_7_148_12,1.0,0,12,12,94
60,r_27_186_68,seq205,seq14,r_27_186_68,0.73,-1,67,68,94
17,r_151_102_81,r_181_86_77,r_153_78_36,r_151_102_81,0.82,-15,66,81,94
145,seq115,r_3_69_149,r_71_25_107,r_71_25_107,1.0,42,149,107,94
120,seq175,r_15_38_184,seq5,r_15_38_184,0.5,0,184,184,94
31,r_92_161_166,r_109_163_41,r_160_174_83,r_92_161_166,0.76,0,166,166,94
88,seq141,r_199_195_150,r_81_11_26,r_81_11_26,1.0,0,26,26,94
28,r_180_134_142,r_66_123_156,r_178_219_66,r_66_123_156,0.94,-13,143,156,94
102,seq166,seq132,r_200_154_61,r_200_154_61,1.0,2,63,61,94
53,r_126_82_72,r_31_188_100,r_194_208_65,r_31_188_100,0.88,1,101,100,94
49,r_61_16_165,seq189,seq136,r_61_16_165,0.56,0,165,165,94
7,r_80_140_172,seq50,r_199_195_150,r_80_140_172,0.56,1,173,172,94
23,r_160_174_83,r_180_134_142,r_27_186_68,r_160_174_83,1.0,-2,81,83,94
108,seq49,r_0_54_162,r_194_208_65,r_194_208_65,1.0,97,162,65,94
35,r_184_201_85,seq18,seq155,r_184_201_85,1.0,0,85,85,94
42,r_124_29_12,r_223_1_165,seq9,r_124_29_12,1.0,0,12,12,94
12,r_31_188_100,r_164_216_97,r_89_84_59,r_31_188_100,1.0,-3,97,100,94
93,seq155,r_38_189_125,seq80,r_38_189_125,1.0,0,125,125,95
33,r_73_102_47,r_204_154_54,seq34,r_73_102_47,1.0,-2,45,47,95
30,r_2_93_75,r_47_83_158,seq216,r_2_93_75,1.0,0,75,75,95
14,r_223_48_91,seq30,seq29,r_223_48_91,1.0,0,91,91,95
54,r_95_153_137,r_14_96_197,seq142,r_95_153_137,0.92,0,137,137,95
37,r_32_214_79,seq37,seq216,r_32_214_79,1.0,0,79,79,95
59,r_14_96_197,r_95_153_137,r_60_123_61,r_14_96_197,0.9,-60,137,197,95
55,r_27_116_143,r_181_106_145,seq176,r_27_116_143,0.95,4,147,143,95
71,r_10_118_179,seq42,r_31_175_5,r_10_118_179,0.75,0,179,179,95
16,r_149_91_41,seq59,seq210,r_149_91_41,0.99,0,41,41,95
21,r_111_215_74,r_206_69_170,seq29,r_111_215_74,0.96,1,75,74,95
39,r_174_193_120,seq126,r_184_6_88,r_174_193_120,1.0,0,120,120,95
1,r_220_17_110,seq71,r_2_93_75,r_220_17_110,0.99,0,110,110,95
97,seq160,seq15,r_165_125_75,r_165_125_75,1.0,8,83,75,95
5,r_19_74_65,seq0,seq59,r_19_74_65,1.0,0,65,65,95
46,r_1_64_75,r_220_17_110,seq11,r_1_64_75,0.95,0,75,75,95
42,r_92_43_64,r_206_69_170,seq136,r_92_43_64,0.99,0,64,64,95
69,r_199_185_114,seq101,r_14_96_197,r_199_185_114,0.99,0,114,114,95
45,r_68_35_170,seq217,r_27_116_143,r_68_35_170,0.61,0,170,170,95
10,r_121_194_43,r_45_110_160,r_23_75_77,r_121_194_43,1.0,0,43,43,95
19,r_169_9_144,seq203,r_31_175_5,r_169_9_144,0.97,0,144,144,95
76,seq128,r_180_100_191,r_204_154_54,r_204_154_54,1.0,2,56,54,95
90,seq217,r_68_35_170,r_124_131_50,r_124_131_50,0.46,-5,45,50,95
66,r_89_137_154,r_180_100_191,r_223_48_91,r_223_48_91,0.92,68,159,91,95
110,seq200,seq85,r_105_144_33,r_105_144_33,1.0,0,33,33,95
29,r_204_154_54,r_67_122_169,seq128,r_204_154_54,1.0,0,54,54,95
67,r_170_191_162,r_222_152_157,seq160,r_170_191_162,0.74,0,162,162,95
17,r_183_82_32,r_70_98_94,seq163,r_183_82_32,1.0,0,32,32,95
109,seq176,seq15,r_27_116_143,r_27_116_143,1.0,30,173,143,95
72,r_181_106_145,r_27_116_143,r_4_58_93,r_181_106_145,0.6,2,147,145,95
16,r_149_91_41,seq210,r_81_168_138,r_81_168_138,1.0,13,151,138,95
116,seq59,r_149_91_41,r_77_151_189,r_149_91_41,0.81,0,41,41,95
4,r_78_53_189,seq130,r_95_153_137,r_95_153_137,0.78,52,189,137,95
0,r_70_98_94,seq192,seq37,r_70_98_94,0.92,0,94,94,95
63,r_167_147_66,r_67_122_169,seq101,r_167_147_66,0.97,0,66,66,95
73,r_132_157_100,r_180_100_191,r_223_48_91,r_223_48_91,0.73,12,103,91,95
2,r_186_197_58,r_220_17_110,seq29,r_220_17_110,0.77,-54,56,110,95
13,r_76_113_161,r_23_75_77,seq66,r_23_75_77,0.51,78,155,77,95
53,r_23_75_77,r_76_113_161,r_121_194_43,r_121_194_43,1.0,2,45,43,95
8,r_79_208_52,r_199_185_114,seq46,r_79_208_52,0.98,0,52,52,95
15,r_38_189_125,seq155,r_140_139_55,r_140_139_55,0.63,70,125,55,95
48,r_182_49_103,r_27_116_143,seq192,r_182_49_103,1.0,0,103,103,95
6,r_207_3_178,r_97_198_187,seq36,r_207_3_178,0.54,0,178,178,95
62,r_45_110_160,r_8_177_174,seq20,r_8_177_174,0.69,-13,161,174,95
141,seq104,r_81_168_138,r_167_147_66,r_167_147_66,0.64,74,140,66,95
31,r_124_131_50,r_32_214_79,seq217,r_32_214_79,0.78,-31,48,79,95
116,seq59,r_77_151_189,r_19_74_65,r_19_74_65,0.96,18,83,65,95
27,r_8_177_174,r_14_96_197,r_19_74_65,r_8_177_174,0.46,0,174,174,95
57,r_44_61_35,r_76_113_161,seq202,r_44_61_35,1.0,0,35,35,95
105,seq42,r_10_118_179,r_40_84_69,r_40_84_69,1.0,110,179,69,95
24,r_12_117_129,r_141_129_171,r_109_162_32,r_12_117_129,0.81,4,133,129,95
25,r_165_125_75,seq30,seq160,r_165_125_75,1.0,0,75,75,95
43,r_50_209_56,r_27_116_143,r_222_152_157,r_27_116_143,0.61,4,147,143,95
50,r_145_24_148,seq146,r_220_17_110,r_220_17_110,0.41,37,147,110,95
58,r_166_63_2,r_127_5_177,r_219_55_12,r_166_63_2,0.69,175,177,2,95
70,r_188_16_99,seq52,seq51,r_188_16_99,0.92,2,101,99,95
65,r_97_198_187,seq192,seq104,r_97_198_187,0.25,0,187,187,95
68,r_4_58_93,seq25,seq224,r_4_58_93,0.99,0,93,93,95
137,seq224,r_76_113_161,r_4_58_93,r_4_58_93,1.0,9,102,93,95
32,r_159_54_114,seq37,seq192,r_159_54_114,0.57,7,121,114,95
38,r_127_5_177,r_166_63_2,r_73_102_47,r_127_5_177,0.61,0,177,177,95
52,r_141_129_171,seq161,seq39,r_141_129_171,0.61,1,172,171,95
34,r_120_221_113,seq37,r_44_61_35,r_120_221_113,0.98,0,113,113,95
47,r_105_144_33,seq101,seq200,r_105_144_33,1.0,-1,32,33,95
60,r_222_152_157,seq218,r_50_209_56,r_50_209_56,1.0,131,187,56,95
49,r_114_99_40,seq176,r_183_82_32,r_114_99_40,1.0,0,40,40,95
112,seq51,seq136,r_188_16_99,r_188_16_99,1.0,24,123,99,95
144,seq146,r_145_24_148,r_31_175_5,r_145_24_148,0.85,-1,147,148,95
9,r_60_123_61,r_70_98_94,r_14_96_197,r_60_123_61,1.0,0,61,61,95
43,r_50_209_56,seq39,r_27_116_143,r_50_209_56,0.98,0,56,56,95
96,seq30,r_165_125_75,seq218,r_165_125_75,1.0,-1,74,75,95
22,r_81_168_138,seq104,r_184_6_88,r_81_168_138,0.71,2,140,138,95
28,r_196_150_52,r_38_189_125,r_167_147_66,r_196_150_52,0.93,14,66,52,95
149,seq126,r_174_193_120,seq192,r_174_193_120,1.0,-26,94,120,95
7,r_40_84_69,seq163,seq115,r_40_84_69,1.0,0,69,69,95
44,r_184_6_88,r_27_116_143,r_81_168_138,r_184_6_88,0.83,59,147,88,95
11,r_109_162_32,r_47_83_158,r_183_82_32,r_109_162_32,0.86,0,32,32,95
23,r_133_26_70,r_165_125_75,seq7,r_165_125_75,0.89,-7,68,75,95
12,r_22_94_96,seq56,seq136,r_22_94_96,0.99,1,97,96,95
51,r_61_106_122,r_160_110_78,r_117_89_17,r_61_106_122,0.55,-43,79,122,96
58,r_7_204_35,r_126_38_48,seq194,r_7_204_35,0.86,1,36,35,96
122,seq200,r_136_86_145,r_139_170_106,r_139_170_106,1.0,39,145,106,96
14,r_74_19_168,seq128,r_126_38_48,r_126_38_48,0.69,121,169,48,96
53,r_160_110_78,r_61_106_122,seq115,r_160_110_78,0.99,1,79,78,96
146,seq120,r_46_102_146,seq163,r_46_102_146,0.89,1,147,146,96
83,seq10,seq132,r_210_181_48,r_210_181_48,1.0,39,87,48,96
37,r_39_100_139,r_104_166_189,r_49_92_21,r_49_92_21,0.66,122,143,21,96
59,r_161_63_70,r_31_11_172,seq44,r_161_63_70,0.98,0,70,70,96
55,r_202_79_66,seq83,seq182,r_202_79_66,0.78,0,66,66,96
71,r_57_16_127,seq64,r_179_203_25,r_57_16_127,0.95,0,127,127,96
24,r_148_17_22,r_61_106_122,seq42,r_148_17_22,0.6,-6,16,22,96
21,r_137_186_186,seq189,r_141_30_7,r_137_186_186,0.38,0,186,186,96
39,r_111_32_111,seq59,seq212,r_111_32_111,0.9,3,114,111,96
1,r_113_14_141,seq212,seq150,r_113_14_141,0.78,0,141,141,96
46,r_98_80_178,seq42,r_113_14_141,r_113_14_141,0.62,37,178,141,96
42,r_107_99_154,r_90_29_179,r_139_170_106,r_107_99_154,0.58,0,154,154,96
6,r_126_38_48,r_48_66_172,r_193_183_155,r_126_38_48,0.98,1,49,48,96
48,r_192_171_39,r_85_143_96,seq26,r_192_171_39,0.97,-3,36,39,96
69,r_45_51_171,seq200,r_190_28_63,r_190_28_63,0.57,110,173,63,96
45,r_173_87_86,seq140,r_117_89_17,r_173_87_86,0.81,3,89,86,96
7,r_134_155_54,r_191_65_176,r_7_204_35,r_191_65_176,0.99,-122,54,176,96
56,r_147_121_23,r_5_0_46,seq124,r_5_0_46,0.83,-20,26,46,96
66,r_138_116_60,seq150,seq115,r_138_116_60,1.0,0,60,60,96
80,seq6,r_190_28_63,r_125_205_23,r_125_205_23,0.99,0,23,23,96
35,r_207_94_22,r_161_63_70,r_157_72_11,r_207_94_22,0.86,0,22,22,96
129,seq83,r_202_79_66,seq187,r_202_79_66,0.96,0,66,66,96
41,r_101_176_194,r_85_143_96,r_40_73_113,r_85_143_96,1.0,1,97,96,96
3,r_46_102_146,seq120,seq118,r_46_102_146,0.6,1,147,146,96
10,r_96_185_113,r_197_77_161,r_164_58_6,r_96_185_113,0.54,1,114,113,96
26,r_62_213_129,seq145,seq64,r_62_213_129,0.91,6,135,129,96
72,r_139_170_106,r_129_199_152,seq200,r_139_170_106,1.0,0,106,106,96
98,seq36,r_210_181_48,r_157_72_11,r_210_181_48,0.9,-10,38,48,96
54,r_117_89_17,r_25_24_102,seq178,r_117_89_17,0.97,-1,16,17,96
4,r_23_71_130,r_197_77_161,r_177_149_188,r_23_71_130,0.96,3,133,130,96
11,r_175_208_161,r_214_152_4,r_119_108_61,r_214_152_4,0.77,158,162,4,96
40,r_104_166_189,r_196_112_189,r_156_144_61,r_104_166_189,0.98,0,189,189,96
20,r_25_24_102,r_62_213_129,r_70_105_37,r_25_24_102,0.93,0,102,102,96
15,r_119_108_61,r_107_99_154,seq21,r_119_108_61,0.99,0,61,61,96
49,r_215_209_23,r_40_73_113,seq37,r_215_209_23,0.8,9,32,23,96
62,r_125_205_23,r_129_199_152,seq6,r_125_205_23,1.0,0,23,23,96
85,seq130,r_197_77_161,r_190_28_63,r_190_28_63,0.93,22,85,63,96
6,r_126_38_48,r_12_222_8,r_74_19_168,r_74_19_168,0.87,8,176,168,96
70,r_109_162_41,r_137_186_186,seq42,r_109_162_41,1.0,0,41,41,96
9,r_190_28_63,seq6,seq64,r_190_28_63,0.72,-43,20,63,96
2,r_197_77_161,seq172,r_40_73_113,r_197_77_161,0.56,1,162,161,96
47,r_82_159_110,seq18,seq103,r_82_159_110,1.0,0,110,110,96
40,r_104_166_189,r_39_100_139,r_196_112_189,r_39_100_139,0.7,4,143,139,96
29,r_129_199_152,seq184,seq54,r_129_199_152,0.8,0,152,152,96
9,r_190_28_63,seq64,seq130,r_190_28_63,0.99,2,65,63,96
25,r_48_66_172,seq59,r_68_174_50,r_68_174_50,0.9,131,181,50,96
64,r_90_29_179,r_107_99_154,r_126_38_48,r_90_29_179,0.69,-25,154,179,96
65,r_193_183_155,seq41,r_97_131_136,r_193_183_155,0.48,-19,136,155,96
50,r_97_131_136,r_48_66_172,r_12_222_8,r_97_131_136,0.98,1,137,136,96
140,seq187,r_129_199_152,seq83,r_129_199_152,0.95,-54,98,152,96
6,r_126_38_48,r_193_183_155,r_12_222_8,r_193_183_155,0.92,-30,125,155,96
68,r_22_180_69,r_46_102_146,seq135,r_22_180_69,0.98,1,70,69,96
61,r_31_11_172,r_161_63_70,seq76,r_161_63_70,0.96,0,70,70,96
38,r_223_216_97,seq4,r_22_180_69,r_223_216_97,0.74,1,98,97,96
57,r_68_174_50,r_25_24_102,seq95,r_68_174_50,0.99,2,52,50,96
43,r_49_92_21,r_82_159_110,r_154_91_9,r_49_92_21,0.94,0,21,21,96
17,r_127_52_118,r_114_224_20,seq140,r_127_52_118,0.97,-2,116,118,96
13,r_5_0_46,seq88,r_157_72_11,r_5_0_46,1.0,0,46,46,96
22,r_85_143_96,r_101_176_194,r_134_155_54,r_101_176_194,1.0,-98,96,194,96
28,r_191_65_176,seq115,r_175_208_161,r_175_208_161,0.95,16,177,161,96
65,r_193_183_155,r_97_131_136,r_1_8_2,r_193_183_155,0.77,0,155,155,96
34,r_12_222_8,r_193_183_155,seq43,r_193_183_155,0.61,-120,35,155,96
118,seq194,r_158_146_191,r_134_155_54,r_134_155_54,1.0,94,148,54,96
23,r_40_73_113,seq2,seq140,r_40_73_113,0.52,10,123,113,96
138,seq95,seq81,r_68_174_50,r_68_174_50,1.0,11,61,50,96
19,r_70_105_37,r_40_73_113,seq172,r_70_105_37,0.95,3,40,37,96
27,r_157_72_11,seq140,seq36,r_157_72_11,0.95,0,11,11,96
63,r_103_184_92,seq191,r_51_122_138,r_51_122_138,1.0,1,139,138,97
30,r_199_9_170,seq144,r_44_31_79,r_199_9_170,0.39,1,171,170,97
55,r_28_139_33,r_145_50_95,seq62,r_28_139_33,1.0,0,33,33,97
75,seq0,r_99_143_123,r_207_198_180,r_99_143_123,0.44,-77,46,123,97
51,r_220_54_151,seq147,seq2,r_220_54_151,0.92,0,151,151,97
6,r_185_10_20,r_187_85_175,r_51_122_138,r_185_10_20,0.99,0,20,20,97
14,r_119_19_171,seq166,seq149,r_119_19_171,0.62,0,171,171,97
8,r_133_115_139,seq129,r_88_59_119,r_88_59_119,0.7,20,139,119,97
60,r_13_98_13,r_161_67_186,r_4_121_26,r_13_98_13,0.87,0,13,13,97
53,r_72_127_99,seq2,seq179,r_72_127_99,1.0,0,99,99,97
58,r_51_122_138,r_185_10_20,r_103_184_92,r_51_122_138,0.94,0,138,138,97
54,r_110_25_129,seq109,r_103_184_92,r_110_25_129,0.95,3,132,129,97
59,r_64_210_145,seq101,r_185_10_20,r_64_210_145,0.92,1,146,145,97
86,seq147,r_220_54_151,r_209_35_124,r_209_35_124,0.56,27,151,124,97
16,r_164_24_167,r_173_83_158,seq43,r_164_24_167,0.73,-8,159,167,97
39,r_211_156_92,r_17_118_127,seq179,r_211_156_92,1.0,0,92,92,97
5,r_159_91_141,r_124_105_166,r_114_216_72,r_124_105_166,0.9,-25,141,166,97
46,r_205_36_86,seq29,r_161_67_186,r_205_36_86,0.96,5,91,86,97
32,r_187_85_175,r_12_169_18,r_137_130_94,r_137_130_94,0.94,81,175,94,97
69,r_135_66_85,r_51_122_138,seq148,r_135_66_85,1.0,0,85,85,97
45,r_186_37_180,seq104,seq5,r_186_37_180,0.42,0,180,180,97
66,r_42_188_4,seq125,r_99_143_123,r_42_188_4,0.51,115,119,4,97
21,r_12_169_18,r_133_115_139,r_187_85_175,r_12_169_18,1.0,1,19,18,97
31,r_201_3_142,r_152_163_145,r_211_156_92,r_201_3_142,0.97,0,142,142,97
41,r_18_79_114,r_164_24_167,seq138,r_18_79_114,1.0,0,114,114,97
113,seq62,seq128,r_28_139_33,r_28_139_33,1.0,11,44,33,97
110,seq58,seq132,r_17_118_127,r_17_118_127,0.99,36,163,127,97
27,r_48_74_25,r_119_19_171,r_165_172_31,r_48_74_25,0.98,6,31,25,97
17,r_165_172_31,r_141_136_80,r_48_74_25,r_165_172_31,1.0,1,32,31,97
10,r_161_67_186,r_120_181_189,r_205_36_86,r_205_36_86,1.0,10,96,86,97
90,seq153,seq166,r_88_59_119,r_88_59_119,1.0,8,127,119,97
58,r_51_122_138,r_178_224_49,r_185_10_20,r_51_122_138,0.6,-89,49,138,97
109,seq57,seq33,r_51_122_138,r_51_122_138,0.93,29,167,138,97
26,r_46_71_171,seq179,r_223_78_124,r_46_71_171,0.57,0,171,171,97
4,r_49_177_65,r_126_87_104,seq65,r_49_177_65,0.88,1,66,65,97
46,r_205_36_86,r_161_67_186,r_134_212_110,r_205_36_86,0.76,58,144,86,97
63,r_103_184_92,r_17_118_127,seq191,r_103_184_92,0.83,1,93,92,97
73,r_52_55_177,seq32,r_194_93_61,r_194_93_61,0.93,116,177,61,97
11,r_209_35_124,seq89,r_185_10_20,r_209_35_124,0.99,1,125,124,97
107,seq180,r_120_181_189,r_134_212_110,r_134_212_110,1.0,79,189,110,97
20,r_134_212_110,r_164_24_167,seq180,r_134_212_110,0.89,1,111,110,97
13,r_44_31_79,seq153,seq221,r_44_31_79,0.99,0,79,79,97
15,r_141_136_80,r_17_118_127,seq109,r_141_136_80,1.0,1,81,80,97
48,r_69_56_132,r_17_118_127,r_209_35_124,r_69_56_132,0.97,0,132,132,97
25,r_60_195_56,seq14,seq125,r_60_195_56,1.0,0,56,56,97
57,r_126_87_104,r_171_39_61,seq38,r_126_87_104,1.0,0,104,104,97
117,seq197,r_176_170_151,r_114_216_72,r_114_216_72,0.82,0,72,72,97
3,r_27_140_39,r_194_93_61,r_204_157_19,r_204_157_19,1.0,20,39,19,97
62,r_151_192_111,r_51_122_138,seq53,r_151_192_111,1.0,0,111,111,97
21,r_12_169_18,r_187_85_175,seq175,r_187_85_175,1.0,0,175,175,97
97,seq191,r_194_93_61,r_103_184_92,r_194_93_61,0.93,-2,59,61,97
99,seq167,seq142,r_217_6_60,r_217_6_60,1.0,3,63,60,97
0,r_100_200_42,r_131_102_151,r_207_198_180,r_131_102_151,0.62,-7,144,151,97
134,seq221,seq117,r_44_31_79,r_44_31_79,1.0,1,80,79,97
10,r_161_67_186,r_205_36_86,r_131_102_151,r_161_67_186,0.69,0,186,186,97
37,r_131_102_151,r_199_9_170,r_100_200_42,r_100_200_42,1.0,2,44,42,97
2,r_194_93_61,seq33,r_81_206_53,r_194_93_61,1.0,0,61,61,97
47,r_88_59_119,seq149,seq153,r_88_59_119,1.0,0,119,119,97
40,r_217_6_60,r_99_143_123,seq167,r_217_6_60,1.0,1,61,60,97
105,seq175,seq94,r_12_169_18,r_12_169_18,0.59,60,78,18,97
74,r_145_50_95,seq45,r_141_136_80,r_145_50_95,0.83,0,95,95,97
18,r_183_20_67,r_176_170_151,seq104,r_183_20_67,0.99,0,67,67,97
29,r_47_11_133,r_16_34_146,r_96_22_46,r_96_22_46,0.97,87,133,46,97
24,r_174_61_72,r_46_71_171,seq5,r_174_61_72,0.96,0,72,72,97
33,r_17_118_127,r_52_55_177,seq58,r_17_118_127,0.97,8,135,127,97
65,r_204_157_19,seq221,seq30,r_204_157_19,0.9,1,20,19,97
50,r_208_106_70,seq43,seq166,r_208_106_70,1.0,0,70,70,97
6,r_185_10_20,r_51_122_138,r_209_35_124,r_185_10_20,0.96,118,138,20,97
72,r_81_206_53,seq5,r_171_39_61,r_81_206_53,1.0,0,53,53,97
56,r_96_22_46,r_47_11_133,seq129,r_96_22_46,1.0,5,51,46,97
38,r_173_83_158,r_164_24_167,seq29,r_173_83_158,0.7,1,159,158,97
52,r_120_181_189,seq180,r_28_139_33,r_120_181_189,0.37,0,189,189,97
77,seq2,r_4_121_26,r_220_54_151,r_220_54_151,1.0,29,180,151,97
0,r_100_200_42,seq148,r_131_102_151,r_100_200_42,1.0,0,42,42,97
32,r_187_85_175,r_185_10_20,r_12_169_18,r_187_85_175,0.93,-156,19,175,97
9,r_223_78_124,seq190,seq144,r_223_78_124,0.42,4,128,124,97
28,r_178_224_49,r_151_192_111,r_164_24_167,r_164_24_167,0.55,-118,49,167,97
37,r_131_102_151,r_100_200_42,seq7,r_131_102_151,0.63,2,153,151,97
12,r_158_21_45,seq30,r_150_23_8,r_158_21_45,0.93,0,45,45,97
28,r_178_224_49,r_164_24_167,seq15,r_164_24_167,0.95,0,167,167,97
22,r_152_163_145,r_201_3_142,r_194_93_61,r_152_163_145,0.86,-3,142,145,97
135,seq94,seq175,r_12_169_18,r_12_169_18,0.72,68,86,18,97
149,seq166,seq153,r_208_106_70,r_208_106_70,1.0,28,98,70,97
44,r_114_216_72,r_223_78_124,seq197,r_114_216_72,1.0,0,72,72,97
23,r_137_130_94,seq43,seq179,r_137_130_94,1.0,0,94,94,97
138,seq104,r_186_37_180,r_183_20_67,r_183_20_67,1.0,1,68,67,97
35,r_80_95_142,seq101,r_158_21_45,r_80_95_142,0.96,1,143,142,97
14,r_223_194_29,r_93_99_132,seq186,r_223_194_29,1.0,0,29,29,98
36,r_65_38_194,seq43,r_188_69_106,r_188_69_106,1.0,5,111,106,98
8,r_219_68_98,seq15,seq128,r_219_68_98,1.0,0,98,98,98
43,r_97_109_105,seq215,r_145_211_159,r_97_109_105,0.79,-7,98,105,98
54,r_96_80_107,seq136,r_102_41_46,r_96_80_107,0.97,0,107,107,98
71,r_77_75_17,seq132,seq136,r_77_75_17,0.99,0,17,17,98
26,r_87_104_49,seq43,seq133,r_87_104_49,1.0,3,52,49,98
16,r_174_210_110,seq192,seq116,r_174_210_110,0.97,0,110,110,98
21,r_151_60_177,seq152,r_53_61_163,r_151_60_177,0.68,0,177,177,98
57,r_200_163_60,r_115_123_18,r_64_67_83,r_64_67_83,1.0,5,88,83,98
39,r_115_123_18,r_90_0_164,seq32,r_115_123_18,1.0,0,18,18,98
42,r_164_71_92,seq120,r_118_8_12,r_164_71_92,0.96,0,92,92,98
15,r_102_41_46,seq46,r_13_92_7,r_102_41_46,0.65,2,48,46,98
45,r_155_28_82,r_149_208_84,r_187_108_83,r_187_108_83,0.7,-1,82,83,98
72,r_134_85_47,r_106_44_47,seq191,r_134_85_47,1.0,0,47,47,98
31,r_18_154_41,r_155_28_82,seq112,r_18_154_41,1.0,1,42,41,98
19,r_73_138_100,seq22,r_14_137_81,r_14_137_81,0.99,26,107,81,98
100,seq162,r_53_61_163,r_184_21_119,r_184_21_119,0.73,45,164,119,98
41,r_14_137_81,r_93_99_132,r_73_138_100,r_73_138_100,0.95,-15,85,100,98
110,seq46,r_102_41_46,r_97_109_105,r_97_109_105,0.9,-30,75,105,98
3,r_127_205_133,r_142_72_194,seq100,r_127_205_133,0.84,0,133,133,98
109,seq45,r_213_221_190,r_89_224_185,r_213_221_190,0.47,0,190,190,98
0,r_184_21_119,r_206_17_162,seq128,r_184_21_119,0.78,0,119,119,98
73,r_29_146_162,seq91,r_184_21_119,r_29_146_162,0.82,0,162,162,98
13,r_158_175_103,seq79,seq62,r_158_175_103,0.7,6,109,103,98
49,r_218_119_125,r_183_143_151,seq78,r_218_119_125,0.94,0,125,125,98
48,r_54_178_151,r_206_17_162,r_130_81_7,r_206_17_162,0.79,-11,151,162,98
57,r_200_163_60,r_94_185_153,r_115_123_18,r_200_163_60,0.97,0,60,60,98
62,r_4_220_132,seq195,seq33,r_4_220_132,0.68,1,133,132,98
55,r_118_8_12,seq157,r_94_185_153,r_118_8_12,0.94,0,12,12,98
99,seq33,r_127_205_133,r_4_220_132,r_127_205_133,0.61,0,133,133,98
1,r_19_165_48,seq122,r_20_24_46,r_20_24_46,0.87,3,49,46,98
2,r_199_189_137,seq128,seq186,r_199_189_137,0.77,0,137,137,98
47,r_7_39_73,seq167,r_180_161_4,r_7_39_73,1.0,0,73,73,98
40,r_50_197_127,seq133,seq171,r_50_197_127,0.99,0,127,127,98
74,r_201_105_57,r_218_119_125,r_223_194_29,r_201_105_57,1.0,21,78,57,98
29,r_90_0_164,r_11_147_151,r_106_44_47,r_106_44_47,1.0,20,67,47,98
25,r_145_211_159,seq46,r_97_109_105,r_97_109_105,0.99,15,120,105,98
43,r_97_109_105,r_145_211_159,r_182_56_158,r_97_109_105,1.0,54,159,105,98
127,seq78,r_196_173_194,r_218_119_125,r_218_119_125,1.0,23,148,125,98
64,r_94_185_153,r_29_146_162,r_183_143_151,r_94_185_153,0.9,0,153,153,98
66,r_106_44_47,seq204,r_11_147_151,r_106_44_47,1.0,0,47,47,98
50,r_206_17_162,r_54_178_151,r_180_161_4,r_54_178_151,0.55,11,162,151,98
65,r_76_126_145,r_94_185_153,r_218_119_125,r_76_126_145,0.69,0,145,145,98
68,r_5_179_65,r_114_169_146,seq216,r_5_179_65,1.0,0,65,65,98
137,seq91,r_29_146_162,seq171,r_29_146_162,0.96,-14,148,162,98
61,r_35_160_128,seq135,seq49,r_35_160_128,0.78,1,129,128,98
52,r_182_56_158,seq22,r_97_109_105,r_182_56_158,0.85,0,158,158,98
60,r_124_177_105,seq120,r_87_104_49,r_124_177_105,0.85,0,105,105,98
81,seq136,seq22,r_77_75_17,r_77_75_17,0.89,57,74,17,98
17,r_149_208_84,r_50_197_127,r_107_139_10,r_149_208_84,1.0,1,85,84,98
119,seq62,seq3,r_158_175_103,r_158_175_103,0.71,-1,102,103,98
145,seq116,r_125_52_197,r_174_210_110,r_174_210_110,0.99,53,163,110,98
123,seq195,r_4_220_132,r_1_121_184,r_4_220_132,0.97,1,133,132,98
29,r_90_0_164,r_106_44_47,r_187_108_83,r_90_0_164,0.9,0,164,164,98
22,r_89_224_185,seq209,r_50_197_127,r_50_197_127,0.65,59,186,127,98
28,r_188_69_106,seq171,r_65_38_194,r_188_69_106,0.94,0,106,106,98
91,seq22,r_73_138_100,r_149_208_84,r_149_208_84,1.0,23,107,84,98
59,r_144_214_22,r_174_210_110,r_142_72_194,r_144_214_22,0.86,0,22,22,98
34,r_20_24_46,r_188_69_106,r_19_165_48,r_20_24_46,1.0,0,46,46,98
49,r_218_119_125,r_201_105_57,r_183_143_151,r_201_105_57,0.71,21,78,57,98
33,r_107_139_10,r_27_10_187,seq22,r_107_139_10,0.99,0,10,10,98
7,r_93_99_132,r_142_72_194,r_73_138_100,r_93_99_132,0.99,0,132,132,98
44,r_11_147_151,r_90_0_164,seq171,r_11_147_151,0.68,0,151,151,98
25,r_145_211_159,r_97_109_105,r_184_21_119,r_145_211_159,1.0,0,159,159,98
23,r_187_108_83,r_94_185_153,r_155_28_82,r_187_108_83,1.0,0,83,83,98
138,seq186,r_88_129_164,r_199_189_137,r_199_189_137,0.95,30,167,137,98
35,r_53_61_163,seq162,r_19_165_48,r_53_61_163,0.82,1,164,163,98
12,r_183_143_151,seq157,r_156_101_36,r_183_143_151,0.93,0,151,151,98
55,r_118_8_12,r_94_185_153,r_164_71_92,r_118_8_12,0.68,136,148,12,98
30,r_217_204_64,r_148_13_73,r_58_11_197,r_217_204_64,1.0,0,64,64,99
44,r_199_140_44,r_160_175_189,seq211,r_199_140_44,0.67,112,156,44,99
19,r_193_218_43,seq149,seq128,r_193_218_43,1.0,0,43,43,99
36,r_49_1_175,seq89,r_151_90_142,r_49_1_175,0.52,0,175,175,99
122,seq82,r_197_145_94,r_84_105_67,r_84_105_67,1.0,41,108,67,99
70,r_114_76_120,r_142_158_56,r_28_40_29,r_114_76_120,0.79,-64,56,120,99
8,r_148_13_73,r_217_204_64,seq203,r_217_204_64,1.0,0,64,64,99
53,r_165_30_114,seq108,seq123,r_165_30_114,0.76,0,114,114,99
43,r_160_175_189,r_215_125_106,r_199_140_44,r_160_175_189,0.99,-83,106,189,99
125,seq89,r_49_1_175,r_42_136_101,r_42_136_101,1.0,74,175,101,99
54,r_65_66_165,seq29,seq101,r_65_66_165,0.84,1,166,165,99
83,seq15,r_16_24_199,r_83_159_115,r_83_159_115,1.0,0,115,115,99
37,r_23_223_84,seq72,r_28_40_29,r_23_223_84,0.78,0,84,84,99
60,r_144_133_153,r_122_216_3,r_91_157_15,r_144_133_153,1.0,0,153,153,99
55,r_79_38_174,seq135,r_91_157_15,r_91_157_15,0.78,159,174,15,99
71,r_141_212_113,seq7,r_86_87_40,r_141_212_113,0.99,0,113,113,99
21,r_75_168_113,r_185_150_116,r_6_219_14,r_75_168_113,0.55,1,114,113,99
16,r_139_85_27,r_16_24_199,seq187,r_139_85_27,0.95,-1,26,27,99
2,r_62_104_26,r_206_119_53,r_18_131_10,r_206_119_53,0.87,-25,28,53,99
14,r_80_100_44,r_146_164_199,r_155_73_1,r_80_100_44,1.0,0,44,44,99
46,r_84_105_67,seq10,seq7,r_84_105_67,1.0,0,67,67,99
59,r_28_40_29,r_80_100_44,seq10,r_80_100_44,0.98,-13,31,44,99
69,r_58_11_197,seq55,r_217_204_64,r_217_204_64,1.0,24,88,64,99
31,r_74_181_198,r_154_14_189,r_193_218_43,r_193_218_43,1.0,135,178,43,99
89,seq29,r_65_66_165,r_117_171_9,r_65_66_165,0.9,1,166,165,99
60,r_144_133_153,r_107_34_192,r_122_216_3,r_144_133_153,0.72,-54,99,153,99
3,r_4_214_142,seq169,seq172,r_4_214_142,1.0,0,142,142,99
0,r_197_145_94,seq82,r_0_27_58,r_0_27_58,1.0,39,97,58,99
73,r_56_39_91,seq98,seq10,r_56_39_91,1.0,0,91,91,99
11,r_180_178_86,r_83_159_115,seq203,r_180_178_86,1.0,0,86,86,99
20,r_115_137_82,seq63,seq123,r_115_137_82,0.99,1,83,82,99
13,r_53_51_63,seq46,seq203,r_53_51_63,1.0,0,63,63,99
57,r_185_150_116,seq113,r_197_145_94,r_185_150_116,1.0,0,116,116,99
106,seq186,r_32_94_97,seq123,r_32_94_97,1.0,0,97,97,99
7,r_86_87_40,seq106,r_202_54_43,r_86_87_40,0.98,4,44,40,99
27,r_83_159_115,r_180_178_86,seq211,r_180_178_86,1.0,0,86,86,99
61,r_221_33_11,r_62_104_26,seq10,r_221_33_11,0.83,1,12,11,99
136,seq103,seq81,r_142_158_56,r_142_158_56,0.85,11,67,56,99
5,r_206_119_53,r_160_175_189,seq99,r_206_119_53,1.0,0,53,53,99
27,r_83_159_115,seq211,seq15,r_83_159_115,1.0,0,115,115,99
87,seq152,seq203,r_21_205_79,r_21_205_79,0.43,65,144,79,99
22,r_42_136_101,r_49_1_175,seq89,r_49_1_175,1.0,0,175,175,99
39,r_142_158_56,r_114_76_120,seq103,r_114_76_120,0.58,-64,56,120,99
18,r_93_188_63,r_21_205_79,r_2_37_64,r_93_188_63,1.0,1,64,63,99
29,r_162_35_75,r_167_5_82,seq135,r_162_35_75,1.0,0,75,75,99
24,r_21_205_79,r_93_188_63,seq128,r_93_188_63,1.0,-2,61,63,99
25,r_156_195_139,r_154_14_189,r_91_157_15,r_156_195_139,0.94,0,139,139,99
43,r_160_175_189,r_199_140_44,r_80_100_44,r_80_100_44,0.65,145,189,44,99
33,r_118_124_110,seq203,r_6_219_14,r_118_124_110,1.0,0,110,110,99
70,r_114_76_120,r_28_40_29,seq95,r_114_76_120,0.99,1,121,120,99
72,r_202_54_43,r_165_30_114,seq12,r_202_54_43,1.0,0,43,43,99
58,r_109_201_90,seq108,seq121,r_109_201_90,0.87,2,92,90,99
65,r_167_5_82,r_141_212_113,seq203,r_167_5_82,1.0,-1,81,82,99
32,r_32_94_97,seq186,r_18_131_10,r_32_94_97,0.97,0,97,97,99
38,r_25_52_78,r_42_136_101,r_221_33_11,r_25_52_78,1.0,0,78,78,99
52,r_215_125_106,r_160_175_189,r_167_5_82,r_215_125_106,1.0,0,106,106,99
74,r_176_88_58,r_160_175_189,seq177,r_176_88_58,1.0,0,58,58,99
68,r_0_27_58,r_139_85_27,r_197_145_94,r_0_27_58,0.6,50,108,58,99
34,r_151_90_142,seq220,seq203,r_151_90_142,0.91,0,142,142,99
75,seq128,seq106,r_21_205_79,r_21_205_79,0.99,19,98,79,99
132,seq98,r_56_39_91,r_155_73_1,r_56_39_91,0.99,0,91,91,99
60,r_144_133_153,r_83_159_115,r_107_34_192,r_144_133_153,0.32,-72,81,153,99
146,seq121,r_107_34_192,r_114_76_120,r_107_34_192,0.64,-150,42,192,99
17,r_213_48_192,seq135,r_130_127_123,r_130_127_123,0.99,15,138,123,99
9,r_210_222_120,seq166,r_115_137_82,r_210_222_120,0.98,0,120,120,99
26,r_183_3_19,seq57,seq108,r_183_3_19,0.65,-1,18,19,99
22,r_42_136_101,r_74_181_198,r_49_1_175,r_42_136_101,1.0,0,101,101,99
28,r_17_78_123,seq169,seq99,r_17_78_123,0.98,0,123,123,99
44,r_199_140_44,r_191_173_48,r_160_175_189,r_199_140_44,1.0,0,44,44,99
41,r_184_179_17,r_144_133_153,r_224_198_193,r_184_179_17,0.46,-1,16,17,99
56,r_129_132_93,r_118_124_110,r_117_171_9,r_118_124_110,0.7,-17,93,110,99
68,r_0_27_58,seq81,r_139_85_27,r_0_27_58,1.0,0,58,58,99
23,r_130_127_123,seq169,r_213_48_192,r_130_127_123,0.72,2,125,123,99
101,seq177,r_65_66_165,r_176_88_58,r_176_88_58,1.0,20,78,58,99
35,r_19_71_96,r_138_41_185,r_117_171_9,r_19_71_96,1.0,0,96,96,99
12,r_154_14_189,r_74_181_198,r_138_41_185,r_154_14_189,0.51,0,189,189,99
42,r_182_20_37,r_206_119_53,r_74_181_198,r_182_20_37,1.0,0,37,37,99
