28,r_329_18_173,seq296,r_119_316_19,r_329_18_173,0.96,0,173,173,0
213,seq261,r_24_243_81,r_56_366_78,r_24_243_81,1.0,0,81,81,0
20,r_45_201_90,r_48_272_186,r_47_330_21,r_45_201_90,1.0,0,90,90,0
110,r_23_223_147,r_341_129_189,r_251_324_64,r_23_223_147,0.88,1,148,147,0
44,r_6_239_59,r_45_201_90,seq140,r_6_239_59,1.0,0,59,59,0
211,seq257,r_102_58_103,seq262,r_102_58_103,0.74,0,103,103,0
86,r_116_256_90,seq261,r_93_158_50,r_116_256_90,1.0,0,90,90,0
80,r_249_323_133,seq115,seq68,r_249_323_133,0.99,6,139,133,0
29,r_26_182_136,r_299_331_173,r_42_78_198,r_26_182_136,0.79,0,136,136,0
48,r_259_362_118,seq257,r_55_196_79,r_259_362_118,1.0,0,118,118,0
34,r_56_366_78,seq161,seq261,r_56_366_78,0.95,18,96,78,0
90,r_93_158_50,seq166,seq218,r_93_158_50,1.0,0,50,50,0
81,r_118_355_48,r_126_39_107,r_123_320_89,r_118_355_48,0.96,60,108,48,0
43,r_55_196_79,seq110,r_259_362_118,r_259_362_118,1.0,0,118,118,0
57,r_314_36_129,seq38,r_290_107_61,r_314_36_129,1.0,0,129,129,0
37,r_202_87_169,r_75_162_198,r_19_280_160,r_75_162_198,0.97,-29,169,198,0
67,r_244_307_97,seq337,r_336_216_40,r_244_307_97,1.0,0,97,97,0
73,r_336_216_40,seq63,r_186_279_28,r_336_216_40,1.0,1,41,40,0
63,r_208_86_66,r_84_240_53,r_152_50_23,r_208_86_66,0.85,1,67,66,0
47,r_227_358_151,r_213_188_155,r_305_144_99,r_305_144_99,1.0,52,151,99,0
59,r_152_50_23,r_104_20_60,r_325_354_10,r_152_50_23,0.81,0,23,23,0
116,r_301_270_55,r_248_181_109,r_42_78_198,r_301_270_55,1.0,0,55,55,0
27,r_342_73_20,r_299_331_173,seq96,r_342_73_20,0.76,5,25,20,0
39,r_16_167_87,r_44_89_138,r_313_197_88,r_16_167_87,1.0,0,87,87,0
107,r_238_365_148,seq8,r_3_149_1,r_238_365_148,0.98,1,149,148,0
95,r_131_34_152,seq165,r_249_323_133,r_131_34_152,1.0,1,153,152,0
8,r_255_79_19,r_12_212_150,seq111,r_255_79_19,1.0,-1,18,19,0
123,r_70_309_141,seq22,r_203_46_33,r_70_309_141,0.76,8,149,141,0
65,r_119_316_19,r_338_83_130,seq165,r_119_316_19,0.9,-5,14,19,0
109,r_225_339_99,r_17_127_136,r_290_107_61,r_225_339_99,0.91,0,99,99,0
87,r_47_330_21,r_329_18_173,seq368,r_47_330_21,1.0,0,21,21,0
42,r_352_31_54,r_70_309_141,seq5,r_352_31_54,0.91,-1,53,54,0
64,r_59_274_105,seq242,r_40_72_67,r_59_274_105,0.89,0,105,105,0
76,r_179_322_70,seq289,seq166,r_179_322_70,1.0,0,70,70,0
11,r_104_20_60,r_220_30_101,r_283_232_48,r_104_20_60,0.99,3,63,60,0
30,r_67_319_20,r_299_331_173,seq135,r_67_319_20,0.84,0,20,20,0
105,r_19_280_160,seq172,r_203_46_33,r_19_280_160,1.0,0,160,160,0
38,r_24_243_81,seq261,seq278,r_24_243_81,1.0,0,81,81,0
97,r_15_350_68,seq115,r_47_330_21,r_15_350_68,1.0,0,68,68,0
101,r_252_308_89,r_102_58_103,seq161,r_252_308_89,1.0,0,89,89,0
43,r_55_196_79,seq303,seq110,r_55_196_79,1.0,0,79,79,0
3,r_62_99_146,seq318,r_325_354_10,r_62_99_146,0.7,-61,85,146,0
195,seq200,r_329_18_173,r_117_265_31,r_117_265_31,0.96,30,61,31,0
88,r_287_156_180,seq5,r_299_331_173,r_287_156_180,0.71,0,180,180,0
100,r_345_205_47,r_341_129_189,seq344,r_345_205_47,1.0,0,47,47,0
120,r_187_9_68,r_277_349_196,seq153,r_277_349_196,0.49,-120,76,196,0
81,r_118_355_48,seq88,r_126_39_107,r_118_355_48,1.0,0,48,48,0
200,seq218,r_220_30_101,r_93_158_50,r_220_30_101,0.99,-8,93,101,0
31,r_17_127_136,r_225_339_99,seq262,r_225_339_99,1.0,-1,98,99,0
61,r_369_92_128,r_266_138_145,seq8,r_266_138_145,0.93,-12,133,145,0
184,seq166,seq184,r_179_322_70,r_179_322_70,1.0,59,129,70,0
158,seq110,r_277_349_196,r_294_157_117,r_294_157_117,1.0,17,134,117,0
103,r_80_315_148,seq35,r_224_327_2,r_80_315_148,0.99,0,148,148,0
77,r_44_89_138,seq111,r_224_327_2,r_44_89_138,1.0,1,139,138,0
3,r_62_99_146,r_325_354_10,r_42_78_198,r_62_99_146,0.88,1,147,146,0
121,r_220_30_101,seq153,r_342_73_20,r_220_30_101,1.0,0,101,101,0
49,r_332_361_57,r_155_210_140,seq269,r_332_361_57,1.0,0,57,57,0
170,seq140,r_114_10_133,r_6_239_59,r_114_10_133,0.9,-1,132,133,0
75,r_359_260_29,r_254_214_176,r_152_50_23,r_359_260_29,0.99,11,40,29,0
50,r_155_210_140,r_19_280_160,seq150,r_155_210_140,0.56,0,140,140,0
58,r_183_66_106,r_176_306_176,r_290_107_61,r_183_66_106,0.96,0,106,106,0
74,r_122_136_153,r_341_129_189,seq193,r_122_136_153,0.99,0,153,153,0
169,seq137,seq292,r_281_57_116,r_281_57_116,1.0,10,126,116,0
45,r_328_170_91,r_176_306_176,seq300,r_328_170_91,0.74,3,94,91,0
119,r_94_246_108,r_75_162_198,seq311,r_94_246_108,1.0,0,108,108,0
92,r_305_144_99,r_84_240_53,seq159,r_305_144_99,0.94,2,101,99,0
91,r_317_275_40,r_299_331_173,r_213_188_155,r_213_188_155,0.93,12,167,155,0
146,seq68,seq148,r_249_323_133,r_249_323_133,0.74,12,145,133,0
117,r_125_65_124,seq234,seq337,r_125_65_124,1.0,0,124,124,0
79,r_290_107_61,r_126_39_107,seq172,r_290_107_61,0.99,0,61,61,0
226,seq296,r_329_18_173,r_117_265_31,r_329_18_173,0.86,0,173,173,0
23,r_126_39_107,seq337,r_17_127_136,r_17_127_136,1.0,4,140,136,0
18,r_171_139_58,r_176_306_176,seq229,r_171_139_58,0.85,2,60,58,0
108,r_325_354_10,r_62_99_146,r_152_50_23,r_152_50_23,0.9,29,52,23,0
16,r_12_212_150,r_206_173_186,r_332_361_57,r_332_361_57,0.54,96,153,57,0
219,seq276,r_176_306_176,r_342_73_20,r_176_306_176,1.0,0,176,176,0
237,seq337,r_55_196_79,r_125_65_124,r_125_65_124,1.0,1,125,124,0
181,seq161,r_56_366_78,r_252_308_89,r_252_308_89,1.0,7,96,89,0
36,r_189_326_172,seq321,seq0,r_189_326_172,1.0,0,172,172,0
23,r_126_39_107,r_189_326_172,seq337,r_126_39_107,0.99,1,108,107,0
89,r_335_304_167,seq51,r_119_316_19,r_335_304_167,0.71,0,167,167,0
112,r_61_293_181,seq200,r_62_99_146,r_61_293_181,0.96,0,181,181,0
2,r_185_53_147,r_370_221_159,seq318,r_370_221_159,0.91,-12,147,159,0
13,r_266_138_145,r_131_34_152,r_219_284_141,r_266_138_145,0.99,0,145,145,0
85,r_41_134_93,r_84_240_53,seq271,r_41_134_93,1.0,0,93,93,0
12,r_299_331_173,seq150,r_203_46_33,r_299_331_173,0.84,2,175,173,0
114,r_37_288_105,seq97,seq312,r_37_288_105,1.0,0,105,105,0
14,r_363_168_30,r_177_154_164,seq334,r_363_168_30,1.0,0,30,30,0
98,r_4_192_83,r_238_365_148,r_317_275_40,r_4_192_83,0.9,10,93,83,0
53,r_40_72_67,r_155_210_140,r_132_371_15,r_40_72_67,0.98,0,67,67,0
69,r_29_228_38,seq128,r_3_149_1,r_29_228_38,1.0,0,38,38,0
51,r_373_60_186,seq153,r_254_214_176,r_254_214_176,0.98,3,179,176,0
83,r_241_91_37,r_189_326_172,seq234,r_241_91_37,0.99,0,37,37,0
94,r_294_157_117,seq124,seq110,r_294_157_117,1.0,0,117,117,0
96,r_142_204_102,seq337,r_119_316_19,r_142_204_102,1.0,0,102,102,0
56,r_346_233_187,seq164,r_352_31_54,r_346_233_187,1.0,0,187,187,0
6,r_281_57_116,seq97,seq137,r_281_57_116,1.0,0,116,116,0
5,r_213_188_155,seq199,r_317_275_40,r_213_188_155,1.0,0,155,155,0
68,r_7_106_148,seq145,r_314_36_129,r_7_106_148,1.0,0,148,148,0
10,r_341_129_189,seq312,seq28,r_341_129_189,0.78,0,189,189,0
32,r_175_291_85,seq235,r_101_108_198,r_175_291_85,1.0,0,85,85,0
82,r_251_324_64,r_299_331_173,seq115,r_251_324_64,1.0,0,64,64,0
33,r_75_162_198,r_202_87_169,r_116_256_90,r_202_87_169,0.57,0,169,169,0
52,r_123_320_89,seq217,r_118_355_48,r_123_320_89,1.0,0,89,89,0
31,r_17_127_136,seq262,r_126_39_107,r_17_127_136,1.0,0,136,136,0
122,r_147_105_93,r_225_339_99,seq166,r_225_339_99,0.87,-3,96,99,0
240,seq344,r_294_157_117,r_345_205_47,r_345_205_47,0.74,8,55,47,0
72,r_347_298_128,r_213_188_155,r_277_349_196,r_213_188_155,0.98,-23,132,155,0
91,r_317_275_40,r_266_138_145,r_299_331_173,r_266_138_145,0.58,-98,47,145,0
22,r_203_46_33,r_62_99_146,seq285,r_203_46_33,0.92,4,37,33,0
104,r_117_265_31,seq372,seq200,r_117_265_31,1.0,0,31,31,0
17,r_338_83_130,r_238_365_148,seq296,r_338_83_130,1.0,0,130,130,0
124,r_353_264_116,seq191,seq150,r_353_264_116,1.0,0,116,116,0
55,r_313_197_88,r_126_39_107,r_56_366_78,r_126_39_107,1.0,-14,93,107,0
1,r_277_349_196,seq21,r_347_298_128,r_347_298_128,0.67,12,140,128,0
0,r_263_195_36,r_294_157_117,r_47_330_21,r_263_195_36,1.0,0,36,36,0
132,seq21,r_277_349_196,r_259_362_118,r_259_362_118,0.98,38,156,118,0
102,r_283_232_48,r_352_31_54,seq199,r_283_232_48,1.0,0,48,48,0
205,seq235,r_175_291_85,seq268,r_175_291_85,1.0,0,85,85,0
111,r_102_58_103,seq257,seq209,r_102_58_103,0.98,0,103,103,0
118,r_48_272_186,seq28,r_352_31_54,r_48_272_186,0.94,0,186,186,0
84,r_90_100_86,seq143,r_42_78_198,r_90_100_86,0.94,13,99,86,0
71,r_219_284_141,r_341_129_189,r_338_83_130,r_219_284_141,0.93,0,141,141,0
25,r_177_154_164,r_287_156_180,r_314_36_129,r_177_154_164,0.82,0,164,164,0
99,r_132_371_15,r_332_361_57,seq348,r_132_371_15,0.79,0,15,15,0
46,r_370_221_159,seq300,seq340,r_370_221_159,1.0,0,159,159,0
113,r_248_181_109,seq98,seq110,r_248_181_109,0.96,4,113,109,0
205,seq207,r_194_63_66,r_42_329_113,r_42_329_113,1.0,3,116,113,1
121,r_335_162_89,r_7_285_123,seq32,r_335_162_89,1.0,0,89,89,1
131,seq19,r_36_308_183,seq221,r_36_308_183,0.99,-35,148,183,1
91,r_332_363_124,r_370_313_131,r_70_249_102,r_332_363_124,1.0,3,127,124,1
41,r_370_313_131,seq66,r_145_29_145,r_145_29_145,0.97,8,153,145,1
81,r_57_266_95,r_206_168_123,seq44,r_57_266_95,1.0,0,95,95,1
89,r_210_287_171,seq216,r_212_227_52,r_210_287_171,1.0,1,172,171,1
25,r_118_55_17,r_200_225_125,seq84,r_118_55_17,0.66,1,18,17,1
11,r_81_250_161,seq8,r_262_317_103,r_81_250_161,1.0,0,161,161,1
53,r_96_359_45,r_18_119_152,seq261,r_96_359_45,0.84,11,56,45,1
115,r_76_274_143,seq14,seq94,r_76_274_143,1.0,0,143,143,1
17,r_15_372_86,seq112,r_24_226_6,r_15_372_86,1.0,0,86,86,1
13,r_141_318_94,r_210_287_171,r_301_6_180,r_141_318_94,1.0,0,94,94,1
58,r_145_29_145,seq143,r_370_313_131,r_145_29_145,1.0,0,145,145,1
16,r_296_180_186,seq54,r_265_137_44,r_296_180_186,0.95,0,186,186,1
26,r_319_356_55,seq54,seq14,r_319_356_55,0.79,-3,52,55,1
54,r_136_369_44,seq286,seq283,r_136_369_44,1.0,0,44,44,1
63,r_95_326_22,r_111_232_153,seq102,r_95_326_22,1.0,0,22,22,1
70,r_100_364_42,r_189_121_63,r_272_165_1,r_100_364_42,1.0,0,42,42,1
6,r_268_13_56,r_144_40_134,r_341_322_159,r_268_13_56,0.95,0,56,56,1
55,r_89_199_176,seq205,seq256,r_89_199_176,0.96,0,176,176,1
127,seq8,r_81_250_161,r_7_285_123,r_81_250_161,1.0,0,161,161,1
10,r_220_328_163,seq37,seq56,r_220_328_163,0.99,1,164,163,1
20,r_206_168_123,r_258_43_155,r_135_33_63,r_206_168_123,0.59,3,126,123,1
48,r_184_123_112,seq22,seq54,r_184_123_112,1.0,0,112,112,1
98,r_202_182_105,seq34,seq237,r_202_182_105,0.65,1,106,105,1
27,r_70_249_102,seq281,r_282_300_22,r_282_300_22,0.91,82,104,22,1
43,r_160_243_92,r_142_5_156,r_64_293_11,r_160_243_92,1.0,0,92,92,1
34,r_212_227_52,seq323,seq58,r_212_227_52,0.97,0,52,52,1
67,r_183_276_180,seq51,r_298_83_37,r_183_276_180,1.0,1,181,180,1
2,r_330_90_21,r_36_308_183,seq205,r_330_90_21,1.0,0,21,21,1
103,r_282_300_22,r_152_247_93,seq10,r_282_300_22,1.0,0,22,22,1
114,r_0_360_82,r_296_180_186,r_268_13_56,r_0_360_82,0.94,0,82,82,1
7,r_142_5_156,seq283,r_201_337_34,r_142_5_156,0.73,0,156,156,1
18,r_200_225_125,seq188,seq4,r_200_225_125,1.0,0,125,125,1
9,r_222_310_82,r_202_182_105,seq41,r_222_310_82,1.0,0,82,82,1
116,r_178_374_96,seq278,r_117_342_49,r_178_374_96,0.75,0,96,96,1
101,r_290_275_52,r_18_119_152,r_86_172_27,r_290_275_52,1.0,0,52,52,1
97,r_140_233_32,r_220_328_163,seq281,r_140_233_32,0.96,0,32,32,1
29,r_309_190_100,r_35_73_135,seq62,r_309_190_100,1.0,-8,92,100,1
78,r_127_371_113,seq31,r_135_33_63,r_127_371_113,0.82,0,113,113,1
44,r_340_104_179,r_193_125_85,seq8,r_193_125_85,1.0,-1,84,85,1
42,r_74_367_115,r_111_232_153,seq31,r_74_367_115,0.9,1,116,115,1
40,r_193_125_85,r_340_104_179,r_86_172_27,r_193_125_85,1.0,0,85,85,1
93,r_135_33_63,seq286,seq124,r_135_33_63,1.0,0,63,63,1
57,r_42_329_113,seq230,seq34,r_42_329_113,1.0,0,113,113,1
84,r_349_235_162,seq259,r_81_250_161,r_349_235_162,0.99,2,164,162,1
100,r_272_165_1,r_12_159_69,r_100_364_42,r_272_165_1,1.0,41,42,1,1
39,r_87_336_167,seq153,r_307_343_7,r_87_336_167,1.0,0,167,167,1
6,r_268_13_56,r_341_322_159,r_0_360_82,r_268_13_56,0.96,33,89,56,1
107,r_333_158_71,r_311_146_150,seq66,r_333_158_71,0.9,0,71,71,1
77,r_18_119_152,seq94,r_307_343_7,r_18_119_152,1.0,0,152,152,1
65,r_314_325_37,seq23,r_86_172_27,r_314_325_37,1.0,0,37,37,1
19,r_334_155_128,r_76_274_143,seq211,r_76_274_143,1.0,-13,130,143,1
22,r_251_305_14,r_341_322_159,seq321,r_251_305_14,0.96,-3,11,14,1
47,r_189_121_63,seq91,seq271,r_189_121_63,1.0,1,64,63,1
120,r_167_345_22,r_341_322_159,seq362,r_167_345_22,0.9,0,22,22,1
102,r_169_260_73,seq47,r_157_255_49,r_169_260_73,1.0,-1,72,73,1
51,r_240_77_23,r_156_348_6,seq195,r_240_77_23,1.0,0,23,23,1
173,seq113,seq98,r_144_40_134,r_144_40_134,1.0,0,134,134,1
99,r_85_264_34,r_111_232_153,seq113,r_85_264_34,1.0,1,35,34,1
59,r_79_105_117,r_81_250_161,r_222_310_82,r_79_105_117,1.0,0,117,117,1
118,r_36_308_183,seq19,r_142_5_156,r_36_308_183,1.0,0,183,183,1
60,r_252_236_163,seq84,r_333_158_71,r_252_236_163,1.0,0,163,163,1
15,r_35_73_135,r_67_61_133,seq47,r_35_73_135,1.0,0,135,135,1
75,r_218_82_65,seq22,r_370_313_131,r_218_82_65,0.65,103,168,65,1
92,r_208_292_147,r_107_238_155,r_70_249_102,r_70_249_102,1.0,45,147,102,1
72,r_179_361_70,seq122,r_194_63_66,r_179_361_70,1.0,0,70,70,1
82,r_312_27_186,r_263_215_183,r_156_348_6,r_312_27_186,0.98,0,186,186,1
69,r_52_217_120,r_349_235_162,r_209_130_88,r_52_217_120,1.0,1,121,120,1
113,r_20_131_103,seq283,r_268_13_56,r_20_131_103,0.65,3,106,103,1
71,r_254_203_30,r_240_77_23,r_265_137_44,r_254_203_30,0.75,78,108,30,1
16,r_296_180_186,r_301_6_180,seq54,r_301_6_180,0.73,-73,107,180,1
20,r_206_168_123,r_57_266_95,r_258_43_155,r_57_266_95,0.98,-22,73,95,1
94,r_12_159_69,r_272_165_1,r_353_108_70,r_272_165_1,0.88,66,67,1,1
108,r_209_130_88,seq45,seq338,r_209_130_88,1.0,0,88,88,1
80,r_86_172_27,r_220_328_163,seq270,r_86_172_27,1.0,0,27,27,1
64,r_16_9_118,r_303_80_130,r_279_99_54,r_279_99_54,1.0,1,55,54,1
128,seq10,r_341_322_159,r_70_249_102,r_341_322_159,1.0,0,159,159,1
79,r_357_30_183,seq344,r_303_80_130,r_357_30_183,1.0,0,183,183,1
124,r_110_297_109,seq17,seq54,r_110_297_109,0.96,2,111,109,1
38,r_368_92_38,r_306_245_199,r_201_337_34,r_201_337_34,1.0,2,36,34,1
74,r_157_255_49,r_141_318_94,seq278,r_157_255_49,0.66,-1,48,49,1
50,r_358_28_69,r_244_164_192,r_282_300_22,r_358_28_69,0.99,0,69,69,1
96,r_353_108_70,r_110_297_109,r_12_159_69,r_110_297_109,0.77,-39,70,109,1
46,r_152_247_93,seq211,r_222_310_82,r_222_310_82,1.0,14,96,82,1
106,r_204_284_107,seq281,seq128,r_204_284_107,1.0,3,110,107,1
83,r_258_43_155,r_341_322_159,r_251_305_14,r_341_322_159,0.56,-3,156,159,1
49,r_144_40_134,seq84,seq113,r_144_40_134,1.0,0,134,134,1
73,r_291_234_143,r_311_146_150,seq132,r_291_234_143,1.0,2,145,143,1
5,r_341_322_159,seq10,seq54,r_341_322_159,1.0,0,159,159,1
14,r_111_232_153,r_262_317_103,r_327_88_7,r_327_88_7,0.97,3,10,7,1
123,r_117_342_49,r_42_329_113,seq112,r_117_342_49,0.94,-1,48,49,1
4,r_265_137_44,r_142_5_156,r_254_203_30,r_254_203_30,0.65,14,44,30,1
105,r_298_83_37,seq304,seq143,r_298_83_37,0.78,-3,34,37,1
249,seq365,r_187_11_176,r_303_80_130,r_187_11_176,1.0,0,176,176,1
61,r_301_6_180,seq59,r_141_318_94,r_141_318_94,1.0,13,107,94,1
122,r_192_231_152,seq72,r_136_369_44,r_192_231_152,0.95,0,152,152,1
28,r_355_213_117,seq69,r_96_359_45,r_355_213_117,1.0,0,117,117,1
114,r_0_360_82,r_170_3_52,r_296_180_186,r_170_3_52,0.99,4,56,52,1
76,r_273_228_142,r_272_165_1,seq22,r_273_228_142,1.0,0,142,142,1
86,r_107_238_155,r_303_80_130,r_279_99_54,r_107_238_155,0.47,-59,96,155,1
8,r_303_80_130,r_107_238_155,r_222_310_82,r_303_80_130,1.0,1,131,130,1
14,r_111_232_153,r_327_88_7,seq23,r_111_232_153,1.0,0,153,153,1
68,r_194_63_66,r_265_137_44,seq50,r_265_137_44,0.84,-4,40,44,1
90,r_350_224_168,seq58,r_100_364_42,r_350_224_168,0.97,8,176,168,1
13,r_141_318_94,r_301_6_180,r_106_277_15,r_301_6_180,0.98,-5,175,180,1
33,r_170_3_52,r_0_360_82,r_64_293_11,r_170_3_52,1.0,0,52,52,1
86,r_107_238_155,r_279_99_54,r_355_213_117,r_107_238_155,0.99,0,155,155,1
148,seq50,r_133_148_111,r_194_63_66,r_133_148_111,0.89,-71,40,111,1
12,r_177_295_176,seq72,r_142_5_156,r_177_295_176,0.82,0,176,176,1
37,r_262_317_103,r_111_232_153,r_157_255_49,r_262_317_103,0.7,0,103,103,1
198,seq188,r_200_225_125,seq41,r_200_225_125,1.0,-45,80,125,1
21,r_201_337_34,r_350_224_168,seq198,r_201_337_34,1.0,0,34,34,1
71,r_254_203_30,seq25,r_240_77_23,r_254_203_30,0.8,0,30,30,1
61,r_301_6_180,r_141_318_94,r_189_121_63,r_301_6_180,0.99,1,181,180,1
31,r_64_293_11,r_81_250_161,seq84,r_64_293_11,1.0,0,11,11,1
62,r_133_148_111,seq50,r_335_162_89,r_133_148_111,0.99,0,111,111,1
210,seq230,r_42_329_113,r_279_99_54,r_42_329_113,0.98,-17,96,113,1
220,seq261,r_26_366_31,r_96_359_45,r_26_366_31,0.54,-3,28,31,1
30,r_279_99_54,seq197,seq230,r_279_99_54,0.94,0,54,54,1
32,r_67_61_133,r_89_199_176,r_18_119_152,r_67_61_133,0.99,20,153,133,1
104,r_223_229_125,r_81_250_161,r_170_3_52,r_223_229_125,1.0,0,125,125,1
0,r_311_146_150,r_183_276_180,r_206_168_123,r_183_276_180,0.97,-28,152,180,1
200,seq195,r_311_146_150,r_240_77_23,r_240_77_23,1.0,0,23,23,1
36,r_7_285_123,seq271,seq8,r_7_285_123,0.79,3,126,123,1
208,seq216,r_210_287_171,r_138_78_18,r_210_287_171,1.0,1,172,171,1
1,r_147_103_70,r_15_372_86,r_64_293_11,r_147_103_70,1.0,0,70,70,1
64,r_16_9_118,r_279_99_54,seq151,r_16_9_118,1.0,1,119,118,1
88,r_26_366_31,seq261,seq324,r_26_366_31,0.99,0,31,31,1
56,r_106_277_15,r_306_245_199,seq44,r_106_277_15,1.0,0,15,15,1
87,r_187_11_176,seq365,r_263_215_183,r_187_11_176,1.0,0,176,176,1
111,r_257_126_167,seq112,r_200_225_125,r_200_225_125,0.92,45,170,125,1
119,r_373_53_64,r_133_148_111,seq102,r_133_148_111,0.9,-47,64,111,1
110,r_48_186_145,seq101,r_144_40_134,r_48_186_145,1.0,0,145,145,1
163,seq84,r_252_236_163,r_64_293_11,r_252_236_163,1.0,0,163,163,1
225,seq317,r_118_38_156,r_53_249_23,r_118_38_156,1.0,0,156,156,2
73,r_138_35_152,seq372,r_167_87_5,r_138_35_152,0.97,4,156,152,2
44,r_323_8_88,r_33_40_154,r_100_355_7,r_33_40_154,1.0,1,155,154,2
229,seq324,r_122_16_176,seq9,r_122_16_176,0.64,-61,115,176,2
4,r_260_359_121,seq225,seq188,r_260_359_121,1.0,2,123,121,2
67,r_74_256_174,seq141,seq207,r_74_256_174,0.98,0,174,174,2
98,r_250_212_152,seq88,r_362_60_67,r_250_212_152,0.53,8,160,152,2
118,r_165_354_38,r_251_149_166,seq115,r_165_354_38,1.0,0,38,38,2
65,r_129_257_149,seq189,seq139,r_129_257_149,1.0,1,150,149,2
10,r_362_60_67,r_76_24_186,seq348,r_362_60_67,1.0,2,69,67,2
31,r_286_187_15,r_370_208_163,seq0,r_286_187_15,0.74,0,15,15,2
40,r_235_314_86,r_339_261_144,seq200,r_235_314_86,1.0,0,86,86,2
37,r_199_75_181,seq296,seq367,r_199_75_181,1.0,0,181,181,2
26,r_304_85_154,seq236,r_293_183_149,r_304_85_154,1.0,0,154,154,2
111,r_120_222_82,r_247_248_90,r_313_269_36,r_120_222_82,0.97,0,82,82,2
5,r_90_80_42,seq152,seq325,r_90_80_42,0.99,1,43,42,2
123,r_14_41_171,seq48,r_61_30_101,r_14_41_171,0.94,0,171,171,2
93,r_23_25_133,seq349,seq326,r_23_25_133,1.0,-1,132,133,2
78,r_361_301_71,r_34_358_143,seq12,r_361_301_71,1.0,0,71,71,2
59,r_58_263_176,seq131,r_247_248_90,r_58_263_176,1.0,0,176,176,2
95,r_298_282_54,r_332_63_102,seq245,r_298_282_54,1.0,3,57,54,2
90,r_289_364_84,seq139,r_79_17_90,r_79_17_90,0.98,-4,86,90,2
56,r_271_96_49,seq32,seq217,r_271_96_49,1.0,0,49,49,2
127,seq6,seq12,r_29_127_47,r_29_127_47,1.0,0,47,47,2
116,r_211_346_136,r_173_103_164,seq348,r_211_346_136,0.96,0,136,136,2
246,seq367,r_10_99_181,r_344_255_60,r_344_255_60,1.0,0,60,60,2
30,r_2_144_59,r_18_186_107,seq89,r_2_144_59,0.67,0,59,59,2
61,r_244_267_158,seq49,r_124_221_171,r_244_267_158,0.48,14,172,158,2
108,r_342_68_135,seq172,seq46,r_342_68_135,1.0,-1,134,135,2
115,r_45_105_142,r_91_297_161,r_292_206_19,r_45_105_142,1.0,0,142,142,2
83,r_192_308_172,seq198,r_298_282_54,r_192_308_172,0.99,0,172,172,2
110,r_203_270_82,seq89,seq69,r_203_270_82,1.0,0,82,82,2
113,r_107_205_13,seq352,r_100_355_7,r_107_205_13,0.57,1,14,13,2
63,r_275_272_121,seq7,r_133_73_199,r_275_272_121,1.0,1,122,121,2
77,r_268_31_160,seq300,seq115,r_268_31_160,1.0,0,160,160,2
25,r_316_277_140,r_173_103_164,r_214_182_86,r_316_277_140,0.82,0,140,140,2
14,r_285_147_73,seq246,seq172,r_285_147_73,0.79,13,86,73,2
213,seq288,r_229_227_158,r_18_186_107,r_229_227_158,0.98,1,159,158,2
53,r_209_291_49,seq78,seq64,r_209_291_49,1.0,0,49,49,2
36,r_142_93_26,r_128_233_71,seq347,r_142_93_26,1.0,0,26,26,2
52,r_176_146_112,seq315,r_299_11_18,r_176_146_112,1.0,0,112,112,2
66,r_76_24_186,seq67,seq178,r_76_24_186,1.0,0,186,186,2
80,r_137_259_187,seq95,seq67,r_137_259_187,0.96,0,187,187,2
97,r_79_17_90,r_124_221_171,r_289_364_84,r_79_17_90,0.85,4,94,90,2
117,r_309_39_122,seq274,r_247_248_90,r_309_39_122,1.0,0,122,122,2
102,r_313_269_36,seq178,r_120_222_82,r_120_222_82,0.96,53,135,82,2
188,seq217,seq226,r_271_96_49,r_271_96_49,1.0,14,63,49,2
114,r_191_81_14,r_342_68_135,seq184,r_191_81_14,1.0,0,14,14,2
74,r_339_261_144,r_235_314_86,seq288,r_235_314_86,1.0,0,86,86,2
20,r_94_175_79,seq151,seq240,r_94_175_79,1.0,0,79,79,2
29,r_332_63_102,r_298_282_54,r_304_85_154,r_298_282_54,0.99,3,57,54,2
61,r_244_267_158,seq110,seq49,r_244_267_158,0.76,0,158,158,2
29,r_332_63_102,r_304_85_154,seq253,r_332_63_102,0.85,3,105,102,2
219,seq305,r_140_123_87,r_42_220_63,r_42_220_63,0.95,0,63,63,2
215,seq295,r_251_149_166,r_285_147_73,r_251_149_166,1.0,0,166,166,2
44,r_323_8_88,r_23_25_133,r_33_40_154,r_323_8_88,0.98,2,90,88,2
32,r_214_182_86,seq0,seq349,r_214_182_86,0.92,3,89,86,2
82,r_369_102_73,r_94_175_79,r_90_80_42,r_90_80_42,0.68,31,73,42,2
172,seq168,seq325,r_342_68_135,r_342_68_135,0.91,2,137,135,2
86,r_118_38_156,seq317,seq356,r_118_38_156,1.0,0,156,156,2
81,r_299_11_18,seq12,seq373,r_299_11_18,1.0,0,18,18,2
179,seq190,r_42_220_63,seq295,r_42_220_63,1.0,0,63,63,2
92,r_223_13_119,seq334,r_18_186_107,r_223_13_119,1.0,-1,118,119,2
209,seq279,r_135_181_171,r_50_202_170,r_135_181_171,0.94,0,171,171,2
173,seq172,r_342_68_135,r_285_147_73,r_342_68_135,1.0,-1,134,135,2
103,r_42_220_63,seq190,seq305,r_42_220_63,1.0,0,63,63,2
17,r_370_208_163,seq372,r_293_183_149,r_370_208_163,0.77,8,171,163,2
23,r_33_40_154,r_304_85_154,r_107_205_13,r_107_205_13,0.99,-1,12,13,2
107,r_265_213_174,seq184,seq152,r_265_213_174,1.0,0,174,174,2
47,r_117_368_83,seq55,r_285_147_73,r_117_368_83,1.0,2,85,83,2
99,r_204_72_191,r_122_16_176,r_275_272_121,r_204_72_191,0.72,-35,156,191,2
203,seq253,r_10_99_181,r_332_63_102,r_10_99_181,0.8,0,181,181,2
84,r_247_248_90,seq27,seq224,r_247_248_90,0.85,5,95,90,2
11,r_194_112_18,r_124_221_171,r_153_119_11,r_194_112_18,1.0,0,18,18,2
51,r_92_65_53,r_173_103_164,r_331_5_52,r_92_65_53,1.0,0,53,53,2
68,r_238_126_178,r_293_183_149,r_298_282_54,r_238_126_178,0.91,-16,162,178,2
91,r_328_169_123,seq49,seq82,r_328_169_123,1.0,-1,122,123,2
42,r_357_83_31,r_304_85_154,r_100_355_7,r_357_83_31,0.8,10,41,31,2
45,r_44_106_25,r_42_220_63,seq0,r_44_106_25,1.0,0,25,25,2
2,r_174_281_129,seq356,seq217,r_174_281_129,1.0,-2,127,129,2
89,r_143_264_142,r_10_99_181,r_92_65_53,r_143_264_142,1.0,1,143,142,2
55,r_336_43_31,seq131,seq77,r_336_43_31,1.0,0,31,31,2
9,r_29_127_47,r_174_281_129,seq6,r_29_127_47,1.0,0,47,47,2
75,r_164_330_30,r_157_338_188,r_191_81_14,r_164_330_30,0.95,0,30,30,2
38,r_86_228_124,seq71,r_271_96_49,r_86_228_124,0.95,0,124,124,2
72,r_114_365_14,seq168,seq360,r_114_365_14,0.84,0,14,14,2
33,r_121_47_177,r_155_37_187,r_135_181_171,r_121_47_177,0.96,0,177,177,2
43,r_371_66_130,r_244_267_158,r_162_307_77,r_371_66_130,0.91,0,130,130,2
101,r_335_19_186,seq141,r_135_181_171,r_335_19_186,0.64,0,186,186,2
1,r_163_70_26,r_180_215_95,seq287,r_163_70_26,0.84,3,29,26,2
94,r_331_5_52,r_223_13_119,seq296,r_331_5_52,0.93,0,52,52,2
24,r_61_30_101,r_122_16_176,r_361_301_71,r_61_30_101,0.94,0,101,101,2
178,seq189,r_129_257_149,r_275_272_121,r_129_257_149,0.99,1,150,149,2
7,r_293_183_149,r_238_126_178,seq201,r_293_183_149,0.91,3,152,149,2
23,r_33_40_154,r_107_205_13,r_323_8_88,r_323_8_88,1.0,12,100,88,2
49,r_252_341_88,r_292_206_19,seq318,r_252_341_88,1.0,0,88,88,2
74,r_339_261_144,seq288,seq236,r_339_261_144,0.85,1,145,144,2
147,seq82,seq318,r_328_169_123,r_328_169_123,1.0,13,136,123,2
2,r_174_281_129,r_29_127_47,seq356,r_29_127_47,1.0,0,47,47,2
58,r_62_239_26,r_136_170_124,seq374,r_62_239_26,0.5,3,29,26,2
120,r_262_303_87,r_173_103_164,r_29_127_47,r_262_303_87,1.0,0,87,87,2
41,r_162_307_77,r_323_8_88,seq69,r_162_307_77,0.91,0,77,77,2
71,r_322_52_122,seq279,r_278_185_72,r_322_52_122,1.0,0,122,122,2
23,r_33_40_154,r_323_8_88,r_59_337_4,r_33_40_154,1.0,1,155,154,2
62,r_140_123_87,seq226,seq151,r_140_123_87,1.0,0,87,87,2
124,r_251_149_166,seq295,r_275_272_121,r_251_149_166,1.0,0,166,166,2
3,r_135_181_171,seq279,r_94_175_79,r_135_181_171,0.98,0,171,171,2
19,r_128_233_71,seq295,seq226,r_128_233_71,1.0,1,72,71,2
54,r_57_56_179,seq225,r_366_15_41,r_57_56_179,0.95,0,179,179,2
21,r_166_350_135,r_124_221_171,r_366_15_41,r_166_350_135,0.99,-1,134,135,2
46,r_132_280_22,seq64,r_100_355_7,r_132_280_22,0.78,2,24,22,2
60,r_157_338_188,seq159,r_90_80_42,r_157_338_188,0.98,1,189,188,2
96,r_230_3_171,r_204_72_191,r_61_30_101,r_204_72_191,0.76,-20,171,191,2
0,r_180_215_95,seq258,seq312,r_180_215_95,0.98,0,95,95,2
85,r_21_195_22,r_366_15_41,r_153_119_11,r_21_195_22,0.86,1,23,22,2
121,r_1_343_56,r_162_307_77,r_298_282_54,r_298_282_54,0.79,8,62,54,2
34,r_18_186_107,seq178,r_191_81_14,r_18_186_107,1.0,-1,106,107,2
249,seq374,seq46,r_62_239_26,r_62_239_26,0.95,4,30,26,2
18,r_134_158_163,seq178,seq110,r_134_158_163,0.97,1,164,163,2
50,r_266_22_114,seq20,seq201,r_266_22_114,0.93,1,115,114,2
70,r_10_99_181,seq253,seq236,r_10_99_181,0.94,0,181,181,2
15,r_124_221_171,r_199_75_181,r_244_267_158,r_124_221_171,1.0,0,171,171,2
106,r_136_170_124,seq200,seq188,r_136_170_124,1.0,0,124,124,2
164,seq141,r_74_256_174,r_339_261_144,r_74_256_174,0.55,0,174,174,2
35,r_113_104_43,r_265_213_174,r_153_119_11,r_113_104_43,1.0,0,43,43,2
48,r_122_16_176,r_204_72_191,seq198,r_122_16_176,0.71,0,176,176,2
12,r_173_103_164,r_50_202_170,r_34_358_143,r_173_103_164,0.86,3,167,164,2
13,r_50_202_170,seq95,r_275_272_121,r_50_202_170,0.92,0,170,170,2
28,r_91_297_161,seq274,seq97,r_91_297_161,0.98,1,162,161,2
6,r_34_358_143,seq312,r_292_206_19,r_34_358_143,0.78,7,150,143,2
88,r_229_227_158,seq288,r_33_40_154,r_229_227_158,0.81,1,159,158,2
18,r_174_132_97,seq107,seq75,r_174_132_97,1.0,0,97,97,3
120,r_82_280_127,seq34,r_319_248_66,r_319_248_66,1.0,17,83,66,3
26,r_148_78_26,r_328_330_131,r_177_317_21,r_148_78_26,0.98,0,26,26,3
97,r_355_313_59,r_122_195_114,r_130_318_68,r_122_195_114,1.0,2,116,114,3
234,seq331,r_27_150_162,r_96_68_188,r_27_150_162,1.0,-38,124,162,3
188,seq206,r_321_374_173,r_179_102_62,r_321_374_173,1.0,1,174,173,3
23,r_137_343_155,seq193,r_123_277_105,r_137_343_155,1.0,0,155,155,3
83,r_224_197_135,seq206,r_266_86_147,r_266_86_147,1.0,14,161,147,3
8,r_79_334_124,seq28,r_226_23_75,r_79_334_124,0.93,0,124,124,3
17,r_64_93_68,r_80_26_85,seq116,r_64_93_68,1.0,0,68,68,3
38,r_333_234_93,r_201_33_68,r_186_309_47,r_333_234_93,0.97,0,93,93,3
41,r_328_330_131,seq314,r_79_334_124,r_328_330_131,1.0,0,131,131,3
6,r_110_312_61,r_8_151_175,seq28,r_110_312_61,1.0,0,61,61,3
46,r_186_309_47,r_232_47_161,r_187_99_130,r_232_47_161,1.0,0,161,161,3
22,r_279_22_79,seq11,seq146,r_279_22_79,0.96,1,80,79,3
39,r_258_290_128,seq60,seq240,r_258_290_128,0.98,0,128,128,3
13,r_134_70_94,r_88_30_152,seq166,r_88_30_152,0.5,-58,94,152,3
43,r_2_371_199,r_134_70_94,r_7_259_11,r_2_371_199,0.9,-185,14,199,3
117,r_285_73_112,seq75,r_271_131_29,r_285_73_112,1.0,0,112,112,3
155,seq83,r_349_222_177,r_169_208_38,r_349_222_177,0.97,0,177,177,3
72,r_27_150_162,r_329_227_84,seq331,r_329_227_84,1.0,3,87,84,3
87,r_339_21_137,seq115,r_169_208_38,r_339_21_137,0.98,-1,136,137,3
32,r_87_112_185,seq17,r_44_50_85,r_87_112_185,1.0,-3,182,185,3
74,r_94_126_80,r_178_296_141,seq214,r_94_126_80,0.86,-1,79,80,3
106,r_179_102_62,seq240,seq91,r_179_102_62,0.84,0,62,62,3
118,r_42_196_138,seq326,seq3,r_42_196_138,1.0,1,139,138,3
86,r_218_247_66,seq138,seq29,r_218_247_66,1.0,0,66,66,3
15,r_44_50_85,seq89,seq71,r_44_50_85,1.0,0,85,85,3
110,r_212_228_163,seq242,seq243,r_212_228_163,0.94,0,163,163,3
111,r_319_248_66,seq204,r_82_280_127,r_319_248_66,1.0,0,66,66,3
61,r_249_320_130,seq252,seq211,r_249_320_130,1.0,1,131,130,3
99,r_245_225_148,seq16,seq146,r_245_225_148,1.0,1,149,148,3
120,r_82_280_127,r_319_248_66,seq344,r_82_280_127,1.0,0,127,127,3
98,r_31_373_120,seq301,seq216,r_31_373_120,1.0,0,120,120,3
51,r_322_161_66,r_333_234_93,r_335_24_53,r_322_161_66,0.9,0,66,66,3
9,r_106_57_70,r_141_203_104,r_218_247_66,r_106_57_70,0.63,-1,69,70,3
77,r_136_336_85,r_137_343_155,seq54,r_136_336_85,1.0,0,85,85,3
7,r_250_114_59,seq158,seq128,r_250_114_59,1.0,0,59,59,3
72,r_27_150_162,seq331,r_100_103_44,r_27_150_162,1.0,0,162,162,3
5,r_340_81_76,r_137_343_155,seq48,r_340_81_76,1.0,0,76,76,3
73,r_200_293_30,r_178_296_141,seq83,r_200_293_30,1.0,0,30,30,3
123,r_8_151_175,seq120,r_160_323_68,r_8_151_175,1.0,0,175,175,3
1,r_352_125_186,seq210,r_129_288_1,r_352_125_186,0.98,2,188,186,3
115,r_181_303_54,r_122_195_114,r_167_244_25,r_181_303_54,0.99,0,54,54,3
116,r_241_135_119,r_137_343_155,seq34,r_137_343_155,0.98,-65,90,155,3
67,r_215_213_50,r_329_227_84,r_276_58_65,r_215_213_50,0.93,-1,49,50,3
55,r_300_147_190,seq146,r_366_142_156,r_300_147_190,0.9,0,190,190,3
69,r_55_104_154,r_276_58_65,r_88_30_152,r_276_58_65,0.53,89,154,65,3
49,r_232_47_161,seq154,r_79_334_124,r_232_47_161,1.0,0,161,161,3
84,r_105_356_165,seq214,seq12,r_105_356_165,0.99,-1,164,165,3
47,r_6_361_129,seq17,r_118_95_114,r_6_361_129,1.0,0,129,129,3
78,r_191_268_142,r_111_369_197,r_215_213_50,r_191_268_142,1.0,0,142,142,3
20,r_4_165_164,seq91,r_123_277_105,r_4_165_164,0.97,0,164,164,3
56,r_246_140_103,seq108,seq315,r_246_140_103,1.0,0,103,103,3
121,r_198_127_167,r_74_238_194,seq53,r_198_127_167,1.0,0,167,167,3
111,r_319_248_66,r_82_280_127,seq310,r_82_280_127,1.0,0,127,127,3
46,r_186_309_47,r_44_50_85,r_232_47_161,r_186_309_47,1.0,0,47,47,3
76,r_307_358_187,seq12,r_332_289_50,r_307_358_187,0.99,0,187,187,3
185,seq193,r_137_343_155,r_229_170_36,r_137_343_155,0.98,-1,154,155,3
97,r_355_313_59,r_52_261_191,r_122_195_114,r_355_313_59,1.0,0,59,59,3
103,r_69_180_89,r_362_304_127,seq214,r_69_180_89,0.98,-3,86,89,3
113,r_189_364_147,r_212_228_163,r_239_194_7,r_189_364_147,1.0,0,147,147,3
9,r_106_57_70,r_176_162_62,r_141_203_104,r_106_57_70,0.7,-24,46,70,3
29,r_332_289_50,r_263_341_83,seq76,r_332_289_50,1.0,0,50,50,3
124,r_256_159_120,seq233,r_123_277_105,r_123_277_105,0.92,16,121,105,3
63,r_118_95_114,seq272,seq9,r_118_95_114,1.0,3,117,114,3
28,r_141_203_104,seq236,r_69_180_89,r_141_203_104,0.99,0,104,104,3
101,r_97_62_134,r_149_302_107,r_6_361_129,r_97_62_134,1.0,0,134,134,3
115,r_181_303_54,r_167_244_25,r_122_195_114,r_122_195_114,1.0,3,117,114,3
21,r_271_131_29,r_87_112_185,r_149_302_107,r_271_131_29,0.99,0,29,29,3
27,r_130_318_68,seq284,seq75,r_130_318_68,1.0,0,68,68,3
119,r_368_172_100,r_137_343_155,r_177_317_21,r_368_172_100,0.99,-9,91,100,3
12,r_219_40_82,r_249_320_130,r_67_43_75,r_219_40_82,1.0,-4,78,82,3
100,r_51_171_173,seq60,r_110_312_61,r_51_171_173,0.98,2,175,173,3
112,r_67_43_75,seq34,seq251,r_67_43_75,1.0,0,75,75,3
125,seq1,r_230_262_147,r_129_288_1,r_230_262_147,1.0,0,147,147,3
62,r_370_199_185,seq251,seq152,r_370_199_185,1.0,0,185,185,3
75,r_366_142_156,seq287,r_88_30_152,r_366_142_156,1.0,0,156,156,3
104,r_168_36_160,seq56,seq60,r_168_36_160,0.65,2,162,160,3
90,r_0_25_145,seq9,r_249_320_130,r_0_25_145,0.68,1,146,145,3
214,seq281,r_366_142_156,r_41_325_50,r_41_325_50,1.0,1,51,50,3
244,seq353,r_98_121_96,seq310,r_98_121_96,1.0,-25,71,96,3
3,r_349_222_177,seq83,seq89,r_349_222_177,1.0,0,177,177,3
166,seq144,r_333_234_93,r_201_33_68,r_333_234_93,1.0,0,93,93,3
232,seq326,r_42_196_138,r_273_15_38,r_273_15_38,0.95,0,38,38,3
31,r_187_99_130,r_100_103_44,r_333_234_93,r_187_99_130,0.65,40,170,130,3
143,seq53,r_300_147_190,r_198_127_167,r_198_127_167,0.71,2,169,167,3
68,r_229_170_36,r_217_306_193,seq193,r_229_170_36,0.99,-1,35,36,3
2,r_123_277_105,r_149_302_107,seq166,r_123_277_105,1.0,0,105,105,3
196,seq233,r_256_159_120,r_90_316_69,r_90_316_69,1.0,0,69,69,3
66,r_263_341_83,r_51_171_173,seq286,r_263_341_83,1.0,-1,82,83,3
37,r_117_235_144,seq326,r_64_93_68,r_117_235_144,1.0,0,144,144,3
94,r_329_227_84,r_27_150_162,r_355_313_59,r_329_227_84,1.0,3,87,84,3
53,r_109_119_181,seq3,r_322_161_66,r_109_119_181,0.98,0,181,181,3
35,r_202_207_156,seq153,r_229_170_36,r_202_207_156,1.0,2,158,156,3
16,r_49_354_129,seq153,seq155,r_49_354_129,0.93,3,132,129,3
246,seq359,seq29,r_176_162_62,r_176_162_62,1.0,0,62,62,3
85,r_124_145_92,r_328_330_131,seq324,r_124_145_92,0.96,0,92,92,3
4,r_177_317_21,r_332_289_50,seq298,r_177_317_21,1.0,0,21,21,3
238,seq344,seq29,r_82_280_127,r_82_280_127,1.0,13,140,127,3
10,r_169_208_38,r_179_102_62,seq83,r_169_208_38,0.95,-3,35,38,3
65,r_221_190_81,seq48,seq220,r_221_190_81,0.67,-14,67,81,3
109,r_65_254_27,r_294_133_64,seq242,r_65_254_27,0.97,0,27,27,3
60,r_350_299_63,r_219_40_82,seq284,r_350_299_63,1.0,0,63,63,3
107,r_372_264_140,r_276_58_65,seq253,r_372_264_140,1.0,0,140,140,3
30,r_294_133_64,r_67_43_75,seq61,r_294_133_64,1.0,0,64,64,3
34,r_226_23_75,seq314,seq59,r_226_23_75,1.0,0,75,75,3
44,r_230_262_147,seq1,r_123_277_105,r_230_262_147,1.0,0,147,147,3
59,r_80_26_85,r_328_330_131,seq210,r_80_26_85,1.0,1,86,85,3
210,seq272,r_118_95_114,seq37,r_118_95_114,1.0,3,117,114,3
59,r_80_26_85,r_64_93_68,r_328_330_131,r_64_93_68,0.9,-14,54,68,3
25,r_178_296_141,r_276_58_65,r_64_93_68,r_64_93_68,0.98,76,144,68,3
82,r_7_259_11,r_94_126_80,r_2_371_199,r_7_259_11,0.84,3,14,11,3
48,r_77_113_42,seq108,r_2_371_199,r_77_113_42,1.0,0,42,42,3
57,r_201_33_68,r_276_58_65,seq144,r_276_58_65,0.58,2,67,65,3
89,r_122_195_114,seq75,r_181_303_54,r_122_195_114,0.5,2,116,114,3
201,seq243,r_80_26_85,seq1,r_80_26_85,1.0,1,86,85,3
93,r_32_84_115,r_212_228_163,seq35,r_32_84_115,0.97,1,116,115,3
108,r_41_325_50,seq16,seq281,r_41_325_50,1.0,0,50,50,3
36,r_143_269_67,r_285_73_112,seq242,r_143_269_67,1.0,0,67,67,3
95,r_149_302_107,r_123_277_105,r_271_131_29,r_149_302_107,0.56,-78,29,107,3
92,r_321_374_173,seq206,r_322_161_66,r_321_374_173,1.0,1,174,173,3
19,r_266_86_147,r_111_369_197,r_224_197_135,r_266_86_147,1.0,0,147,147,3
38,r_333_234_93,r_322_161_66,r_201_33_68,r_322_161_66,1.0,0,66,66,3
49,r_6_126_178,seq204,r_100_174_66,r_6_126_178,0.97,0,178,178,4
28,r_80_350_40,seq60,r_193_307_130,r_80_350_40,0.6,141,181,40,4
20,r_84_112_165,r_229_295_52,r_102_117_35,r_102_117_35,0.76,0,35,35,4
106,r_78_206_128,seq127,seq319,r_78_206_128,1.0,0,128,128,4
97,r_222_297_114,seq17,seq186,r_222_297_114,1.0,2,116,114,4
120,r_156_192_126,seq148,r_309_283_66,r_156_192_126,0.84,2,128,126,4
109,r_213_280_68,seq19,seq195,r_213_280_68,1.0,0,68,68,4
40,r_318_51_92,r_199_254_86,seq96,r_318_51_92,1.0,-1,91,92,4
43,r_87_203_168,r_259_22_195,r_302_24_58,r_87_203_168,1.0,0,168,168,4
46,r_316_143_142,r_374_211_159,r_39_30_94,r_374_211_159,0.54,-17,142,159,4
45,r_324_205_172,seq304,r_139_36_88,r_324_205_172,0.51,3,175,172,4
51,r_157_284_157,seq158,r_309_283_66,r_157_284_157,1.0,0,157,157,4
50,r_333_5_124,seq296,seq291,r_333_5_124,1.0,0,124,124,4
107,r_108_44_30,r_313_225_166,seq277,r_108_44_30,0.99,0,30,30,4
139,seq34,seq64,r_79_208_166,r_79_208_166,0.98,5,171,166,4
5,r_343_221_48,seq237,seq49,r_343_221_48,1.0,0,48,48,4
101,r_341_91_47,r_88_123_172,seq339,r_341_91_47,1.0,0,47,47,4
86,r_160_290_183,seq55,seq182,r_160_290_183,0.98,0,183,183,4
139,seq34,r_178_41_56,seq64,r_178_41_56,1.0,-2,54,56,4
56,r_219_354_66,r_309_283_66,seq158,r_219_354_66,1.0,0,66,66,4
16,r_172_106_41,r_20_144_54,seq61,r_172_106_41,1.0,1,42,41,4
31,r_229_295_52,r_84_112_165,seq277,r_229_295_52,1.0,0,52,52,4
53,r_85_344_63,r_337_86_136,r_374_211_159,r_337_86_136,0.98,-73,63,136,4
22,r_15_257_36,r_89_349_118,r_246_180_13,r_15_257_36,0.6,0,36,36,4
75,r_338_40_38,r_259_22_195,seq315,r_338_40_38,1.0,0,38,38,4
63,r_122_173_6,r_172_106_41,r_181_183_17,r_122_173_6,0.86,11,17,6,4
25,r_42_332_181,seq171,r_128_248_85,r_42_332_181,0.93,0,181,181,4
80,r_242_164_86,seq168,seq61,r_242_164_86,0.99,0,86,86,4
90,r_59_151_167,seq339,r_84_112_165,r_59_151_167,0.99,1,168,167,4
20,r_84_112_165,r_102_117_35,r_39_30_94,r_84_112_165,1.0,1,166,165,4
33,r_66_289_104,seq270,seq296,r_66_289_104,1.0,0,104,104,4
69,r_79_208_166,r_88_123_172,seq34,r_79_208_166,0.98,0,166,166,4
113,r_102_117_35,r_198_356_117,r_84_112_165,r_102_117_35,1.0,0,35,35,4
166,seq125,seq14,r_352_327_142,r_352_327_142,1.0,1,143,142,4
112,r_95_77_190,r_230_340_199,r_241_351_74,r_95_77_190,0.98,0,190,190,4
84,r_268_269_123,seq31,seq169,r_268_269_123,1.0,2,125,123,4
71,r_247_345_90,seq195,r_309_283_66,r_247_345_90,1.0,0,90,90,4
13,r_89_349_118,seq23,r_311_238_40,r_89_349_118,1.0,0,118,118,4
214,seq277,seq28,r_229_295_52,r_229_295_52,1.0,2,54,52,4
38,r_255_135_136,seq61,r_337_86_136,r_255_135_136,1.0,0,136,136,4
76,r_29_363_140,seq169,r_370_63_125,r_29_363_140,1.0,-1,139,140,4
14,r_18_275_189,seq70,r_346_76_82,r_18_275_189,0.85,1,190,189,4
3,r_139_36_88,seq12,seq90,r_139_36_88,0.99,-1,87,88,4
61,r_83_159_52,r_285_330_86,r_67_11_25,r_83_159_52,0.9,-2,50,52,4
116,r_184_292_29,seq7,seq373,r_184_292_29,1.0,0,29,29,4
83,r_1_129_105,r_347_118_184,r_338_40_38,r_1_129_105,1.0,1,106,105,4
15,r_136_155_20,r_21_197_180,seq25,r_136_155_20,1.0,-1,19,20,4
208,seq262,r_177_165_75,seq194,r_177_165_75,0.99,-16,59,75,4
74,r_98_48_50,r_198_356_117,r_259_22_195,r_98_48_50,1.0,1,51,50,4
189,seq186,r_207_140_193,r_222_297_114,r_222_297_114,0.91,9,123,114,4
68,r_82_201_81,r_107_4_197,r_136_155_20,r_82_201_81,1.0,1,82,81,4
134,seq25,r_266_368_197,r_136_155_20,r_136_155_20,1.0,-1,19,20,4
81,r_147_111_18,r_198_356_117,r_241_351_74,r_147_111_18,0.65,98,116,18,4
124,r_258_124_122,r_337_86_136,r_122_173_6,r_258_124_122,0.72,1,123,122,4
249,seq373,r_81_57_190,r_184_292_29,r_184_292_29,1.0,0,29,29,4
55,r_56_202_121,seq32,seq167,r_56_202_121,1.0,0,121,121,4
65,r_20_144_54,r_213_280_68,seq7,r_20_144_54,0.99,0,54,54,4
122,r_131_101_198,seq130,r_370_63_125,r_370_63_125,1.0,15,140,125,4
117,r_181_183_17,seq305,r_122_173_6,r_181_183_17,0.97,0,17,17,4
7,r_128_248_85,r_365_62_131,r_15_257_36,r_128_248_85,1.0,0,85,85,4
73,r_200_232_107,r_3_99_137,seq270,r_200_232_107,0.67,5,112,107,4
52,r_10_359_62,r_39_30_94,r_342_298_50,r_39_30_94,0.96,-32,62,94,4
207,seq253,r_243_212_164,r_38_134_51,r_38_134_51,0.51,9,60,51,4
81,r_147_111_18,r_75_166_113,r_198_356_117,r_147_111_18,0.99,0,18,18,4
211,seq270,r_66_289_104,seq46,r_66_289_104,1.0,-26,78,104,4
94,r_281_115_64,r_246_180_13,r_10_359_62,r_246_180_13,1.0,52,65,13,4
70,r_88_123_172,seq110,r_333_5_124,r_88_123_172,1.0,0,172,172,4
114,r_372_362_108,r_75_166_113,r_343_221_48,r_372_362_108,0.99,0,108,108,4
0,r_193_307_130,seq0,r_75_166_113,r_75_166_113,0.68,19,132,113,4
123,r_27_97_112,seq194,seq249,r_27_97_112,1.0,0,112,112,4
150,seq64,r_119_278_57,seq296,r_119_278_57,0.99,-27,30,57,4
72,r_189_214_70,seq187,r_98_48_50,r_189_214_70,0.8,0,70,70,4
4,r_75_166_113,r_309_283_66,r_193_307_130,r_193_307_130,0.69,6,136,130,4
119,r_256_52_1,r_33_267_119,r_264_261_57,r_33_267_119,0.73,-64,55,119,4
18,r_188_35_188,seq182,r_189_214_70,r_188_35_188,0.89,0,188,188,4
66,r_288_69_57,seq9,r_309_283_66,r_288_69_57,1.0,-1,56,57,4
127,seq7,seq175,r_20_144_54,r_20_144_54,1.0,0,54,54,4
6,r_259_22_195,r_87_203_168,r_98_48_50,r_98_48_50,1.0,0,50,50,4
4,r_75_166_113,r_300_245_172,r_309_283_66,r_75_166_113,1.0,0,113,113,4
39,r_317_13_74,r_324_205_172,seq176,r_317_13_74,1.0,0,74,74,4
3,r_139_36_88,seq90,r_89_349_118,r_89_349_118,0.85,4,122,118,4
35,r_39_30_94,seq231,seq54,r_39_30_94,1.0,0,94,94,4
161,seq104,r_331_274_140,r_67_11_25,r_331_274_140,0.96,0,140,140,4
192,seq194,r_21_197_180,r_198_356_117,r_198_356_117,1.0,4,121,117,4
118,r_273_153_108,seq369,seq334,r_273_153_108,1.0,0,108,108,4
10,r_33_267_119,r_18_275_189,seq45,r_33_267_119,1.0,0,119,119,4
104,r_177_165_75,seq262,r_309_283_66,r_177_165_75,0.67,-4,71,75,4
103,r_302_24_58,seq65,seq150,r_302_24_58,1.0,0,58,58,4
57,r_337_86_136,r_258_124_122,r_93_308_95,r_337_86_136,0.67,-26,110,136,4
77,r_179_360_146,seq296,r_331_274_140,r_179_360_146,1.0,1,147,146,4
62,r_285_330_86,r_93_308_95,r_15_257_36,r_15_257_36,1.0,50,86,36,4
98,r_114_252_181,seq315,r_128_248_85,r_114_252_181,0.68,6,187,181,4
19,r_38_134_51,r_331_274_140,seq196,r_38_134_51,0.98,0,51,51,4
121,r_347_118_184,r_207_140_193,r_33_267_119,r_347_118_184,0.98,0,184,184,4
190,seq187,r_189_214_70,seq64,r_189_214_70,1.0,0,70,70,4
27,r_81_57_190,seq55,r_188_35_188,r_81_57_190,0.98,0,190,190,4
188,seq182,r_188_35_188,r_193_307_130,r_188_35_188,0.62,-1,187,188,4
3,r_139_36_88,r_89_349_118,r_324_205_172,r_139_36_88,0.61,74,162,88,4
91,r_374_211_159,r_316_143_142,r_43_293_10,r_316_143_142,1.0,0,142,142,4
195,seq204,r_216_191_149,r_346_76_82,r_346_76_82,0.99,-3,79,82,4
44,r_43_293_10,r_179_360_146,seq37,r_43_293_10,0.99,0,10,10,4
8,r_217_234_112,seq14,r_93_308_95,r_217_234_112,1.0,-1,111,112,4
42,r_322_73_23,seq149,seq72,r_322_73_23,1.0,0,23,23,4
95,r_250_276_52,r_193_307_130,seq339,r_250_276_52,0.9,-2,50,52,4
28,r_80_350_40,r_193_307_130,seq60,r_80_350_40,0.7,-5,35,40,4
79,r_50_142_96,r_218_152_129,seq253,r_218_152_129,1.0,-34,95,129,4
113,r_102_117_35,r_84_112_165,r_10_359_62,r_84_112_165,0.92,0,165,165,4
87,r_121_320_70,r_365_62_131,r_15_257_36,r_121_320_70,1.0,0,70,70,4
99,r_93_308_95,r_337_86_136,r_217_234_112,r_337_86_136,0.94,0,136,136,4
47,r_352_327_142,seq231,seq125,r_352_327_142,1.0,0,142,142,4
238,seq339,r_59_151_167,r_341_91_47,r_341_91_47,1.0,-1,46,47,4
59,r_119_278_57,seq64,seq306,r_119_278_57,1.0,0,57,57,4
111,r_210_335_85,r_321_154_174,seq14,r_210_335_85,1.0,0,85,85,4
100,r_260_239_157,r_313_225_166,r_39_30_94,r_260_239_157,0.98,2,159,157,4
30,r_370_63_125,seq64,r_131_101_198,r_370_63_125,1.0,0,125,125,4
24,r_223_235_58,r_317_13_74,seq70,r_223_235_58,0.78,-4,54,58,4
57,r_337_86_136,r_93_308_95,r_255_135_136,r_337_86_136,0.95,0,136,136,4
108,r_313_225_166,r_260_239_157,r_193_307_130,r_313_225_166,0.98,-6,160,166,4
99,r_93_308_95,seq303,r_337_86_136,r_93_308_95,1.0,0,95,95,4
82,r_342_298_50,seq94,seq303,r_342_298_50,1.0,0,50,50,4
29,r_198_356_117,seq132,seq194,r_198_356_117,1.0,0,117,117,4
48,r_3_99_137,r_331_274_140,seq14,r_3_99_137,0.45,1,138,137,4
41,r_264_261_57,r_6_126_178,r_256_52_1,r_264_261_57,0.94,-3,54,57,4
58,r_178_41_56,seq34,seq23,r_178_41_56,1.0,1,57,56,4
92,r_321_154_174,r_114_252_181,r_10_359_62,r_321_154_174,0.84,0,174,174,4
21,r_241_351_74,seq74,r_147_111_18,r_241_351_74,1.0,0,74,74,4
88,r_218_152_129,r_230_340_199,seq74,r_218_152_129,1.0,0,129,129,4
96,r_68_145_170,seq32,r_98_48_50,r_68_145_170,1.0,0,170,170,4
114,r_254_341_52,seq118,r_154_163_19,r_254_341_52,1.0,0,52,52,5
32,r_28_273_178,seq284,seq372,r_28_273_178,1.0,0,178,178,5
46,r_242_120_17,r_153_158_130,seq159,r_242_120_17,1.0,1,18,17,5
180,seq159,r_164_41_188,r_242_120_17,r_242_120_17,1.0,0,17,17,5
56,r_87_81_102,r_221_329_14,seq321,r_87_81_102,1.0,2,104,102,5
65,r_210_176_119,r_243_173_141,r_271_161_37,r_210_176_119,1.0,0,119,119,5
6,r_164_41_188,seq324,r_272_318_138,r_164_41_188,0.92,0,188,188,5
28,r_117_65_75,r_210_176_119,r_332_280_33,r_117_65_75,1.0,0,75,75,5
12,r_343_338_3,seq90,r_198_12_97,r_198_12_97,1.0,2,99,97,5
172,seq133,r_151_232_161,seq179,r_151_232_161,1.0,0,161,161,5
83,r_125_203_29,r_37_102_34,seq128,r_125_203_29,1.0,0,29,29,5
74,r_74_146_148,r_369_149_189,r_266_359_101,r_74_146_148,1.0,-1,147,148,5
67,r_208_33_126,seq63,seq170,r_208_33_126,1.0,2,128,126,5
96,r_198_12_97,r_304_119_170,r_343_338_3,r_198_12_97,1.0,1,98,97,5
80,r_115_187_40,seq36,seq234,r_115_187_40,1.0,0,40,40,5
98,r_227_250_83,r_175_137_101,seq25,r_227_250_83,1.0,0,83,83,5
122,r_99_259_32,seq78,seq206,r_99_259_32,1.0,0,32,32,5
34,r_34_183_24,r_98_42_161,r_61_344_131,r_34_183_24,0.89,1,25,24,5
108,r_131_169_13,r_134_19_158,seq237,r_131_169_13,1.0,0,13,13,5
87,r_192_207_38,r_358_132_175,seq347,r_192_207_38,1.0,0,38,38,5
41,r_304_119_170,r_182_299_58,seq206,r_304_119_170,1.0,2,172,170,5
58,r_224_50_30,r_182_299_58,seq70,r_224_50_30,0.95,0,30,30,5
118,r_104_290_168,seq284,r_285_305_14,r_104_290_168,0.87,4,172,168,5
94,r_264_333_131,r_38_328_151,seq374,r_264_333_131,1.0,1,132,131,5
79,r_252_147_112,seq191,r_34_183_24,r_252_147_112,0.54,0,112,112,5
23,r_332_280_33,r_37_102_34,r_117_65_75,r_117_65_75,1.0,2,77,75,5
1,r_35_353_36,r_254_341_52,seq138,r_35_353_36,0.89,0,36,36,5
51,r_251_79_118,r_154_163_19,r_20_92_112,r_154_163_19,1.0,100,119,19,5
35,r_221_329_14,r_87_81_102,r_66_214_1,r_87_81_102,1.0,2,104,102,5
47,r_266_359_101,r_2_279_18,r_74_146_148,r_74_146_148,0.99,3,151,148,5
10,r_160_364_48,seq80,seq148,r_160_364_48,1.0,0,48,48,5
2,r_143_220_133,seq196,r_126_123_100,r_126_123_100,0.87,33,133,100,5
216,seq277,r_313_307_153,r_358_132_175,r_313_307_153,1.0,0,153,153,5
52,r_276_269_160,seq201,r_267_222_71,r_267_222_71,1.0,21,92,71,5
110,r_260_103_62,r_116_89_50,seq311,r_260_103_62,1.0,1,63,62,5
106,r_122_319_184,seq256,r_98_42_161,r_122_319_184,0.68,0,184,184,5
17,r_20_92_112,r_219_310_63,r_265_317_24,r_219_310_63,0.53,0,63,63,5
78,r_108_39_98,seq262,r_308_45_25,r_308_45_25,0.73,73,98,25,5
41,r_304_119_170,r_198_12_97,r_182_299_58,r_304_119_170,1.0,-90,80,170,5
150,seq70,seq24,r_224_50_30,r_224_50_30,0.95,1,31,30,5
72,r_69_73_90,r_216_8_129,r_239_142_129,r_69_73_90,1.0,39,129,90,5
57,r_195_346_176,seq156,r_291_342_55,r_195_346_176,1.0,0,176,176,5
40,r_184_140_120,seq80,r_251_79_118,r_184_140_120,0.55,-61,59,120,5
56,r_87_81_102,r_69_73_90,r_221_329_14,r_221_329_14,0.97,0,14,14,5
5,r_151_232_161,seq133,seq106,r_151_232_161,1.0,0,161,161,5
35,r_221_329_14,r_153_158_130,r_87_81_102,r_221_329_14,0.83,0,14,14,5
47,r_266_359_101,seq9,r_2_279_18,r_266_359_101,1.0,3,104,101,5
16,r_121_72_138,r_369_149_189,r_34_183_24,r_121_72_138,1.0,0,138,138,5
19,r_356_240_105,r_85_202_176,r_336_5_40,r_356_240_105,1.0,0,105,105,5
160,seq96,r_112_6_137,seq372,r_112_6_137,1.0,0,137,137,5
23,r_332_280_33,seq63,r_37_102_34,r_332_280_33,1.0,1,34,33,5
128,seq15,r_91_17_134,r_336_5_40,r_336_5_40,1.0,5,45,40,5
97,r_10_100_39,r_287_83_100,r_66_214_1,r_10_100_39,1.0,1,40,39,5
107,r_127_177_113,seq306,r_235_315_108,r_127_177_113,1.0,0,113,113,5
85,r_23_323_161,seq63,r_210_176_119,r_210_176_119,0.99,42,161,119,5
76,r_308_45_25,r_61_344_131,seq13,r_308_45_25,1.0,0,25,25,5
62,r_211_7_19,r_227_250_83,seq58,r_211_7_19,1.0,0,19,19,5
99,r_180_335_182,seq27,seq190,r_180_335_182,0.97,0,182,182,5
17,r_20_92_112,r_265_317_24,r_235_315_108,r_20_92_112,0.99,0,112,112,5
25,r_291_342_55,r_165_352_150,r_115_187_40,r_291_342_55,0.97,1,56,55,5
11,r_153_158_130,seq262,r_212_4_85,r_153_158_130,1.0,0,130,130,5
38,r_219_310_63,r_20_92_112,seq130,r_219_310_63,1.0,6,69,63,5
44,r_322_257_63,seq170,seq215,r_322_257_63,1.0,0,63,63,5
203,seq234,seq9,r_249_101_118,r_249_101_118,1.0,44,162,118,5
43,r_2_279_18,r_271_161_37,seq360,r_2_279_18,1.0,-1,17,18,5
37,r_336_5_40,seq283,seq15,r_336_5_40,0.99,0,40,40,5
198,seq206,r_289_270_164,r_99_259_32,r_289_270_164,0.94,2,166,164,5
49,r_362_95_182,r_99_259_32,r_294_167_173,r_362_95_182,1.0,1,183,182,5
26,r_29_286_127,r_151_232_161,seq21,r_29_286_127,1.0,0,127,127,5
191,seq193,seq178,r_246_226_57,r_246_226_57,1.0,1,58,57,5
89,r_289_270_164,seq206,seq129,r_289_270_164,1.0,2,166,164,5
109,r_313_307_153,seq277,r_356_240_105,r_313_307_153,1.0,0,153,153,5
48,r_85_202_176,r_356_240_105,r_105_245_174,r_356_240_105,1.0,0,105,105,5
88,r_340_174_190,seq55,r_332_280_33,r_340_174_190,1.0,0,190,190,5
73,r_212_4_85,r_116_89_50,r_150_124_82,r_116_89_50,0.58,35,85,50,5
84,r_373_47_52,seq253,r_160_364_48,r_373_47_52,0.95,11,63,52,5
101,r_105_245_174,seq114,r_160_364_48,r_105_245_174,1.0,1,175,174,5
72,r_69_73_90,r_217_186_145,r_216_8_129,r_69_73_90,1.0,2,92,90,5
120,r_249_101_118,r_248_229_181,seq234,r_249_101_118,1.0,-1,117,118,5
102,r_139_368_139,r_313_307_153,r_208_33_126,r_139_368_139,1.0,3,142,139,5
31,r_150_124_82,r_362_95_182,seq196,r_150_124_82,1.0,0,82,82,5
121,r_61_344_131,r_308_45_25,r_34_183_24,r_61_344_131,0.84,-106,25,131,5
53,r_157_67_10,r_184_140_120,seq201,r_157_67_10,0.97,0,10,10,5
220,seq284,r_104_290_168,seq77,r_104_290_168,0.99,4,172,168,5
111,r_225_309_178,seq284,r_343_338_3,r_225_309_178,1.0,0,178,178,5
82,r_172_32_125,seq179,r_34_183_24,r_172_32_125,0.99,6,131,125,5
13,r_154_163_19,r_126_123_100,r_251_79_118,r_154_163_19,0.81,1,20,19,5
59,r_302_213_51,seq231,seq274,r_302_213_51,1.0,0,51,51,5
61,r_246_226_57,r_276_269_160,seq193,r_246_226_57,1.0,3,60,57,5
60,r_239_142_129,r_143_220_133,r_69_73_90,r_239_142_129,1.0,0,129,129,5
4,r_14_275_168,r_3_361_165,r_22_316_108,r_14_275_168,1.0,0,168,168,5
7,r_235_315_108,r_104_290_168,r_66_214_1,r_235_315_108,0.99,0,108,108,5
68,r_265_317_24,seq193,r_20_92_112,r_265_317_24,0.98,0,24,24,5
75,r_298_49_118,r_172_32_125,seq206,r_298_49_118,0.52,0,118,118,5
119,r_287_83_100,seq372,r_285_305_14,r_287_83_100,1.0,0,100,100,5
45,r_189_223_134,seq36,r_131_169_13,r_189_223_134,0.96,0,134,134,5
34,r_34_183_24,r_61_344_131,r_172_32_125,r_61_344_131,0.78,0,131,131,5
105,r_182_299_58,seq1,r_271_161_37,r_182_299_58,1.0,0,58,58,5
123,r_175_137_101,seq360,seq36,r_175_137_101,1.0,1,102,101,5
124,r_110_136_165,seq109,r_204_166_127,r_110_136_165,1.0,1,166,165,5
42,r_134_19_158,seq162,seq168,r_134_19_158,1.0,0,158,158,5
200,seq215,seq201,r_322_257_63,r_322_257_63,1.0,15,78,63,5
20,r_37_102_34,r_266_359_101,r_332_280_33,r_37_102_34,1.0,0,34,34,5
33,r_288_295_141,seq311,r_116_89_50,r_288_295_141,1.0,0,141,141,5
17,r_20_92_112,r_235_315_108,r_251_79_118,r_251_79_118,0.8,11,129,118,5
27,r_88_230_57,r_91_17_134,r_314_64_2,r_88_230_57,1.0,0,57,57,5
9,r_62_94_10,r_121_72_138,seq60,r_62_94_10,0.99,0,10,10,5
113,r_327_171_104,r_127_177_113,r_242_120_17,r_327_171_104,1.0,0,104,104,5
13,r_154_163_19,r_251_79_118,r_254_341_52,r_251_79_118,0.98,1,119,118,5
196,seq201,r_153_158_130,r_157_67_10,r_157_67_10,0.75,0,10,10,5
24,r_349_241_115,r_112_6_137,r_224_50_30,r_349_241_115,0.83,0,115,115,5
14,r_126_123_100,r_145_292_188,seq181,r_126_123_100,1.0,0,100,100,5
22,r_3_361_165,r_14_275_168,r_35_353_36,r_3_361_165,1.0,0,165,165,5
68,r_265_317_24,r_20_92_112,seq128,r_20_92_112,1.0,0,112,112,5
77,r_303_11_178,seq129,r_356_240_105,r_303_11_178,1.0,0,178,178,5
69,r_59_93_134,r_134_19_158,r_235_315_108,r_59_93_134,1.0,1,135,134,5
18,r_22_316_108,seq321,r_211_7_19,r_22_316_108,1.0,0,108,108,5
71,r_165_352_150,seq306,r_235_315_108,r_165_352_150,1.0,1,151,150,5
131,seq21,r_110_136_165,r_29_286_127,r_29_286_127,0.67,2,129,127,5
40,r_184_140_120,r_251_79_118,seq109,r_184_140_120,0.88,0,120,120,5
100,r_38_328_151,r_255_354_199,r_356_240_105,r_38_328_151,1.0,0,151,151,5
191,seq193,r_265_317_24,seq178,r_265_317_24,0.92,0,24,24,5
81,r_285_305_14,r_242_120_17,seq371,r_285_305_14,1.0,0,14,14,5
50,r_204_166_127,seq16,r_246_226_57,r_204_166_127,0.78,0,127,127,5
36,r_369_149_189,seq350,r_153_158_130,r_369_149_189,0.69,1,190,189,5
49,r_362_95_182,r_373_47_52,r_99_259_32,r_362_95_182,1.0,-136,46,182,5
54,r_267_222_71,r_314_64_2,r_276_269_160,r_267_222_71,1.0,0,71,71,5
3,r_243_173_141,r_210_176_119,seq129,r_210_176_119,0.97,0,119,119,5
90,r_282_330_166,seq51,r_125_203_29,r_282_330_166,0.77,6,172,166,5
8,r_112_6_137,seq96,seq365,r_112_6_137,1.0,0,137,137,5
177,seq148,seq90,r_160_364_48,r_160_364_48,1.0,2,50,48,5
104,r_216_8_129,seq54,seq311,r_216_8_129,1.0,0,129,129,5
121,r_61_344_131,r_34_183_24,r_235_315_108,r_61_344_131,0.99,0,131,131,5
70,r_320_56_77,r_110_136_165,r_255_354_199,r_320_56_77,1.0,1,78,77,5
91,r_228_345_116,r_204_166_127,r_276_269_160,r_204_166_127,1.0,-4,123,127,5
31,r_85_332_189,r_331_143_144,r_300_12_42,r_331_143_144,1.0,0,144,144,6
176,seq150,r_55_74_72,r_44_47_120,r_55_74_72,1.0,-12,60,72,6
107,r_160_64_29,r_207_201_165,r_216_357_35,r_160_64_29,1.0,-1,28,29,6
59,r_33_213_152,seq197,r_286_256_103,r_33_213_152,0.79,0,152,152,6
17,r_194_136_29,r_67_188_178,seq197,r_194_136_29,1.0,0,29,29,6
84,r_113_225_101,seq93,seq26,r_113_225_101,0.96,6,107,101,6
51,r_152_254_186,r_303_56_41,r_300_12_42,r_152_254_186,1.0,0,186,186,6
65,r_36_164_188,seq234,r_141_355_132,r_36_164_188,0.79,0,188,188,6
101,r_13_163_77,r_9_281_144,seq84,r_13_163_77,1.0,0,77,77,6
51,r_152_254_186,r_59_287_174,r_303_56_41,r_303_56_41,0.92,-4,37,41,6
105,r_350_37_175,seq71,seq31,r_350_37_175,0.96,0,175,175,6
60,r_6_285_51,r_248_258_148,r_238_65_51,r_6_285_51,0.95,-2,49,51,6
48,r_200_221_21,r_345_360_153,seq14,r_200_221_21,0.84,-1,20,21,6
54,r_10_149_41,seq210,seq94,r_10_149_41,0.83,-1,40,41,6
118,r_40_228_189,r_21_186_197,r_36_164_188,r_40_228_189,0.52,0,189,189,6
0,r_166_30_162,r_187_246_50,r_304_72_100,r_166_30_162,1.0,1,163,162,6
121,r_289_142_28,r_313_294_80,seq159,r_289_142_28,1.0,0,28,28,6
74,r_96_54_75,r_121_219_79,seq190,r_96_54_75,1.0,0,75,75,6
92,r_373_102_89,r_363_325_145,r_101_63_22,r_373_102_89,0.95,0,89,89,6
16,r_115_362_156,seq275,r_145_314_2,r_115_362_156,1.0,0,156,156,6
77,r_132_295_80,seq8,r_361_298_38,r_132_295_80,1.0,-7,73,80,6
27,r_261_335_89,r_202_356_106,seq45,r_261_335_89,0.93,-1,88,89,6
85,r_305_171_13,r_296_310_172,r_21_186_197,r_305_171_13,1.0,0,13,13,6
4,r_307_233_138,r_361_298_38,r_17_146_28,r_307_233_138,1.0,0,138,138,6
210,seq231,r_317_340_30,r_311_118_13,r_317_340_30,0.97,-10,20,30,6
73,r_21_186_197,r_40_228_189,r_321_41_188,r_40_228_189,0.99,0,189,189,6
244,seq364,r_34_292_120,r_261_335_89,r_34_292_120,0.87,0,120,120,6
76,r_69_365_53,seq42,r_263_15_118,r_69_365_53,0.97,0,53,53,6
204,seq217,r_180_144_158,r_286_256_103,r_180_144_158,0.8,0,158,158,6
68,r_141_355_132,seq351,r_155_366_127,r_141_355_132,1.0,0,132,132,6
70,r_155_366_127,seq2,r_141_355_132,r_141_355_132,0.91,0,132,132,6
50,r_104_105_30,r_189_236_185,seq28,r_104_105_30,1.0,0,30,30,6
122,r_312_338_46,seq28,r_10_149_41,r_312_338_46,0.72,1,47,46,6
123,r_110_277_80,seq208,r_20_77_198,r_110_277_80,1.0,0,80,80,6
109,r_44_47_120,seq150,r_126_100_53,r_44_47_120,0.97,0,120,120,6
63,r_348_131_46,r_345_360_153,seq364,r_348_131_46,0.99,0,46,46,6
87,r_331_143_144,r_85_332_189,r_5_342_93,r_331_143_144,1.0,0,144,144,6
69,r_240_308_9,seq210,r_0_215_54,r_0_215_54,1.0,14,68,54,6
64,r_18_167_23,r_126_100_53,seq23,r_126_100_53,0.84,-33,20,53,6
24,r_198_326_95,r_87_282_199,seq122,r_198_326_95,1.0,0,95,95,6
45,r_175_230_163,r_126_100_53,r_101_63_22,r_175_230_163,1.0,-142,21,163,6
28,r_9_281_144,seq147,seq252,r_9_281_144,1.0,0,144,144,6
61,r_17_146_28,r_189_236_185,seq151,r_17_146_28,1.0,0,28,28,6
230,seq329,r_238_65_51,r_135_267_3,r_238_65_51,1.0,-5,46,51,6
42,r_0_215_54,r_73_3_102,r_240_308_9,r_0_215_54,1.0,0,54,54,6
162,seq106,r_247_90_107,seq97,r_247_90_107,1.0,-18,89,107,6
62,r_25_112_92,seq51,r_311_118_13,r_25_112_92,1.0,0,92,92,6
47,r_158_306_18,r_155_366_127,seq147,r_158_306_18,1.0,0,18,18,6
29,r_88_372_111,seq275,r_264_336_44,r_88_372_111,0.95,0,111,111,6
89,r_4_68_109,seq220,r_145_314_2,r_4_68_109,1.0,0,109,109,6
10,r_303_56_41,r_152_254_186,r_104_105_30,r_152_254_186,1.0,0,186,186,6
141,seq57,seq103,r_223_133_168,r_223_133_168,0.93,10,178,168,6
163,seq109,r_350_37_175,r_371_127_23,r_371_127_23,1.0,1,24,23,6
7,r_363_325_145,r_21_186_197,r_132_295_80,r_363_325_145,0.7,2,147,145,6
208,seq226,r_255_138_90,seq106,r_255_138_90,1.0,-1,89,90,6
15,r_161_324_54,r_166_30_162,seq364,r_161_324_54,1.0,1,55,54,6
37,r_290_107_125,seq92,seq150,r_290_107_125,1.0,7,132,125,6
95,r_214_237_164,seq147,r_110_277_80,r_214_237_164,1.0,0,164,164,6
93,r_121_219_79,r_96_54_75,seq97,r_121_219_79,1.0,-4,75,79,6
52,r_52_16_62,r_265_353_180,seq2,r_52_16_62,1.0,0,62,62,6
26,r_49_86_150,seq212,r_194_136_29,r_49_86_150,1.0,0,150,150,6
23,r_263_15_118,seq26,seq203,r_263_15_118,1.0,1,119,118,6
104,r_187_246_50,r_222_249_189,r_166_30_162,r_187_246_50,1.0,1,51,50,6
25,r_304_72_100,seq346,seq227,r_304_72_100,1.0,2,102,100,6
168,seq122,seq274,r_358_193_134,r_358_193_134,0.77,-1,133,134,6
119,r_358_193_134,seq364,seq122,r_358_193_134,1.0,0,134,134,6
180,seq159,r_265_353_180,r_289_142_28,r_289_142_28,1.0,0,28,28,6
20,r_50_39_113,r_361_298_38,r_55_74_72,r_50_39_113,1.0,0,113,113,6
79,r_301_278_30,r_216_357_35,seq154,r_301_278_30,1.0,0,30,30,6
111,r_29_271_110,seq205,seq349,r_29_271_110,1.0,0,110,110,6
78,r_273_108_158,seq147,r_243_184_149,r_273_108_158,0.91,1,159,158,6
21,r_5_342_93,seq190,seq205,r_5_342_93,1.0,1,94,93,6
132,seq26,r_263_15_118,r_113_225_101,r_263_15_118,1.0,-12,106,118,6
116,r_300_12_42,seq91,seq62,r_300_12_42,0.98,0,42,42,6
113,r_341_319_124,seq151,seq190,r_341_319_124,1.0,0,124,124,6
124,r_123_270_61,seq114,seq212,r_123_270_61,1.0,0,61,61,6
106,r_251_269_162,r_323_48_174,r_139_259_112,r_323_48_174,1.0,-12,162,174,6
58,r_59_287_174,r_152_254_186,r_139_259_112,r_59_287_174,0.99,0,174,174,6
200,seq208,r_318_176_155,r_317_340_30,r_317_340_30,0.97,2,32,30,6
3,r_126_100_53,r_322_99_154,r_305_171_13,r_126_100_53,1.0,0,53,53,6
45,r_175_230_163,r_101_63_22,r_216_357_35,r_175_230_163,1.0,0,163,163,6
9,r_265_353_180,seq159,r_161_324_54,r_265_353_180,0.91,-1,179,180,6
2,r_309_119_120,seq70,seq262,r_309_119_120,1.0,0,120,120,6
1,r_323_48_174,seq239,seq8,r_323_48_174,1.0,0,174,174,6
94,r_311_118_13,r_34_292_120,seq231,r_311_118_13,0.57,1,14,13,6
33,r_248_258_148,seq280,seq157,r_248_258_148,0.99,1,149,148,6
12,r_243_184_149,seq31,r_34_292_120,r_243_184_149,1.0,0,149,149,6
76,r_69_365_53,r_263_15_118,r_17_146_28,r_263_15_118,0.89,-23,95,118,6
44,r_189_236_185,seq120,r_187_246_50,r_189_236_185,1.0,1,186,185,6
90,r_60_35_157,seq62,r_9_281_144,r_60_35_157,1.0,0,157,157,6
86,r_232_266_77,r_34_292_120,r_272_130_9,r_232_266_77,1.0,0,77,77,6
30,r_247_90_107,seq106,seq250,r_247_90_107,1.0,0,107,107,6
88,r_178_153_77,seq45,r_272_130_9,r_178_153_77,0.99,0,77,77,6
120,r_209_245_40,r_248_258_148,r_18_167_23,r_209_245_40,1.0,1,41,40,6
34,r_73_3_102,r_304_72_100,r_216_357_35,r_216_357_35,1.0,83,118,35,6
31,r_85_332_189,r_300_12_42,r_265_353_180,r_85_332_189,0.88,1,190,189,6
96,r_7_38_39,r_243_184_149,seq162,r_7_38_39,1.0,0,39,39,6
0,r_166_30_162,r_161_324_54,r_187_246_50,r_166_30_162,0.79,-110,52,162,6
198,seq204,seq227,r_216_357_35,r_216_357_35,0.97,5,40,35,6
112,r_296_310_172,seq262,r_247_90_107,r_296_310_172,1.0,4,176,172,6
35,r_264_336_44,r_49_86_150,r_158_306_18,r_264_336_44,0.91,0,44,44,6
10,r_303_56_41,r_49_86_150,r_152_254_186,r_303_56_41,1.0,-3,38,41,6
127,seq8,r_132_295_80,r_187_246_50,r_187_246_50,0.98,12,62,50,6
32,r_27_156_78,r_9_281_144,seq26,r_27_156_78,0.99,0,78,78,6
19,r_139_259_112,seq84,seq218,r_139_259_112,1.0,0,112,112,6
110,r_11_229_57,r_313_294_80,r_317_340_30,r_317_340_30,0.94,26,56,30,6
49,r_371_127_23,r_9_281_144,seq109,r_371_127_23,0.97,0,23,23,6
55,r_286_256_103,r_58_185_195,seq337,r_286_256_103,1.0,0,103,103,6
91,r_284_279_73,r_243_184_149,seq147,r_284_279_73,1.0,0,73,73,6
43,r_244_291_153,r_175_230_163,seq31,r_244_291_153,0.96,0,153,153,6
66,r_89_257_106,r_206_299_175,seq231,r_89_257_106,1.0,2,108,106,6
56,r_321_41_188,r_361_298_38,r_44_47_120,r_321_41_188,0.89,2,190,188,6
39,r_180_144_158,seq217,r_345_360_153,r_180_144_158,1.0,0,158,158,6
14,r_216_357_35,r_301_278_30,r_160_64_29,r_216_357_35,1.0,-4,31,35,6
46,r_34_292_120,seq364,r_13_163_77,r_34_292_120,1.0,0,120,120,6
108,r_222_249_189,seq14,r_27_156_78,r_222_249_189,0.97,0,189,189,6
11,r_55_74_72,r_216_357_35,r_50_39_113,r_50_39_113,0.58,0,113,113,6
117,r_206_299_175,seq374,seq274,r_206_299_175,0.63,-15,160,175,6
38,r_202_356_106,seq92,r_123_270_61,r_202_356_106,1.0,0,106,106,6
81,r_24_195_171,seq120,seq125,r_24_195_171,1.0,0,171,171,6
36,r_67_188_178,seq337,r_243_184_149,r_67_188_178,0.99,0,178,178,6
97,r_361_298_38,seq46,r_132_295_80,r_132_295_80,1.0,-7,73,80,6
71,r_170_260_97,seq208,r_13_163_77,r_170_260_97,1.0,0,97,97,6
100,r_317_340_30,seq227,seq208,r_317_340_30,1.0,0,30,30,6
72,r_238_65_51,seq329,r_6_285_51,r_238_65_51,0.99,-1,50,51,6
115,r_235_124_48,r_238_65_51,r_101_63_22,r_235_124_48,0.94,0,48,48,6
80,r_313_294_80,r_9_281_144,seq79,r_313_294_80,1.0,-1,79,80,6
82,r_101_63_22,r_175_230_163,r_247_90_107,r_101_63_22,0.86,141,163,22,6
75,r_293_81_120,r_363_325_145,seq42,r_293_81_120,0.98,0,120,120,6
5,r_207_201_165,r_223_133_168,seq275,r_207_201_165,1.0,1,166,165,6
40,r_181_328_156,seq231,r_247_90_107,r_181_328_156,1.0,0,156,156,6
13,r_255_138_90,seq226,seq22,r_255_138_90,1.0,0,90,90,6
22,r_318_176_155,seq352,r_137_334_74,r_318_176_155,1.0,0,155,155,6
104,r_187_246_50,r_166_30_162,seq8,r_166_30_162,1.0,1,163,162,6
114,r_223_133_168,seq174,seq57,r_223_133_168,0.99,0,168,168,6
82,r_101_63_22,r_265_353_180,r_175_230_163,r_101_63_22,1.0,-1,21,22,6
41,r_137_334_74,seq84,seq349,r_137_334_74,1.0,0,74,74,6
130,seq22,seq190,r_255_138_90,r_255_138_90,0.96,72,162,90,6
61,r_157_300_73,r_28_180_2,seq347,r_157_300_73,1.0,0,73,73,7
78,r_294_132_74,r_244_130_149,seq39,r_294_132_74,1.0,2,76,74,7
146,seq77,seq177,r_331_88_123,r_331_88_123,0.95,0,123,123,7
100,r_3_11_12,r_241_200_35,seq357,r_3_11_12,0.87,1,13,12,7
86,r_288_36_118,seq238,r_153_67_20,r_288_36_118,1.0,0,118,118,7
5,r_319_139_65,r_34_303_195,r_229_144_75,r_319_139_65,0.69,-2,63,65,7
29,r_287_131_134,r_171_305_176,r_292_10_136,r_287_131_134,0.72,2,136,134,7
39,r_5_246_96,seq304,seq17,r_5_246_96,0.95,0,96,96,7
229,seq314,r_360_185_187,r_89_79_116,r_89_79_116,0.61,46,162,116,7
44,r_211_279_188,r_207_161_83,r_84_119_97,r_207_161_83,0.62,105,188,83,7
15,r_368_108_41,r_221_6_162,seq125,r_221_6_162,0.53,-118,44,162,7
153,seq102,r_328_358_194,r_286_307_152,r_286_307_152,1.0,1,153,152,7
114,r_140_142_124,seq192,seq346,r_140_142_124,0.99,0,124,124,7
10,r_166_138_157,r_84_119_97,seq111,r_166_138_157,0.99,1,158,157,7
135,seq47,r_243_264_91,seq178,r_243_264_91,1.0,0,91,91,7
46,r_355_9_137,r_22_70_31,seq205,r_355_9_137,1.0,0,137,137,7
49,r_158_369_144,r_19_343_163,seq115,r_158_369_144,1.0,2,146,144,7
37,r_244_130_149,seq230,r_22_70_31,r_244_130_149,1.0,0,149,149,7
17,r_41_235_190,seq325,r_169_359_104,r_41_235_190,0.49,0,190,190,7
58,r_19_343_163,r_158_369_144,r_331_88_123,r_158_369_144,0.96,-2,142,144,7
89,r_84_119_97,r_166_138_157,seq57,r_166_138_157,0.98,0,157,157,7
157,seq111,seq321,r_166_138_157,r_166_138_157,1.0,0,157,157,7
60,r_45_156_199,r_4_344_184,seq164,r_4_344_184,0.73,-73,111,184,7
10,r_166_138_157,seq57,r_84_119_97,r_84_119_97,1.0,8,105,97,7
105,r_265_16_106,r_41_235_190,r_368_108_41,r_265_16_106,1.0,0,106,106,7
111,r_114_199_33,r_271_21_123,r_48_134_4,r_114_199_33,1.0,1,34,33,7
218,seq282,r_165_37_171,seq267,r_165_37_171,1.0,0,171,171,7
91,r_71_228_34,r_271_21_123,seq149,r_271_21_123,0.78,-86,37,123,7
242,seq346,r_34_303_195,r_140_142_124,r_140_142_124,0.96,0,124,124,7
186,seq205,r_171_305_176,r_221_6_162,r_171_305_176,1.0,0,176,176,7
73,r_153_67_20,r_5_246_96,seq209,r_153_67_20,1.0,2,22,20,7
87,r_100_44_62,r_54_353_119,seq224,r_100_44_62,1.0,2,64,62,7
28,r_159_53_120,r_55_60_155,r_129_242_122,r_129_242_122,1.0,-1,121,122,7
4,r_54_353_119,r_207_161_83,r_366_137_78,r_54_353_119,0.63,-1,118,119,7
121,r_89_79_116,seq1,seq314,r_89_79_116,1.0,0,116,116,7
176,seq188,r_28_180_2,r_64_173_85,r_64_173_85,0.96,3,88,85,7
108,r_29_109_33,r_45_156_199,seq304,r_29_109_33,1.0,2,35,33,7
85,r_333_167_41,seq113,r_373_363_24,r_373_363_24,0.77,21,45,24,7
26,r_175_163_94,r_123_105_119,seq201,r_175_163_94,0.87,6,100,94,7
83,r_312_367_18,r_329_117_129,seq266,r_312_367_18,1.0,0,18,18,7
40,r_220_296_98,r_225_124_165,r_158_369_144,r_220_296_98,1.0,0,98,98,7
1,r_272_43_166,seq125,seq39,r_272_43_166,1.0,5,171,166,7
51,r_94_248_156,seq266,seq15,r_94_248_156,1.0,0,156,156,7
40,r_220_296_98,r_158_369_144,seq69,r_158_369_144,0.94,-2,142,144,7
16,r_135_306_131,seq56,r_340_145_117,r_135_306_131,0.83,0,131,131,7
95,r_329_117_129,seq321,seq104,r_329_117_129,0.92,1,130,129,7
117,r_302_136_64,seq283,r_23_194_45,r_302_136_64,1.0,0,64,64,7
12,r_373_363_24,r_18_133_196,seq350,r_373_363_24,1.0,0,24,24,7
92,r_285_120_124,r_123_105_119,seq69,r_285_120_124,1.0,0,124,124,7
24,r_7_154_41,r_275_268_92,seq266,r_275_268_92,0.91,60,152,92,7
191,seq215,r_129_242_122,r_298_182_88,r_129_242_122,0.93,-10,112,122,7
113,r_349_334_119,r_287_131_134,r_71_228_34,r_349_334_119,1.0,0,119,119,7
123,r_61_25_29,r_140_142_124,seq290,r_61_25_29,0.92,2,31,29,7
59,r_335_82_174,r_360_185_187,r_140_142_124,r_335_82_174,0.85,0,174,174,7
69,r_179_172_23,r_7_154_41,seq230,r_179_172_23,1.0,1,24,23,7
35,r_327_255_80,seq370,seq58,r_327_255_80,1.0,0,80,80,7
122,r_239_38_48,r_244_130_149,seq236,r_239_38_48,1.0,0,48,48,7
33,r_121_250_125,seq277,r_229_144_75,r_121_250_125,1.0,1,126,125,7
63,r_206_259_24,r_41_235_190,seq295,r_206_259_24,1.0,1,25,24,7
64,r_86_251_131,r_328_358_194,r_3_11_12,r_86_251_131,1.0,0,131,131,7
74,r_64_173_85,r_272_43_166,seq188,r_64_173_85,0.97,2,87,85,7
102,r_74_301_28,r_329_117_129,seq81,r_74_301_28,0.95,3,31,28,7
216,seq280,r_273_42_127,seq164,r_273_42_127,0.82,0,127,127,7
76,r_72_122_152,r_317_219_168,r_23_194_45,r_72_122_152,0.95,0,152,152,7
124,r_171_305_176,seq205,r_243_264_91,r_171_305_176,0.98,0,176,176,7
11,r_271_21_123,r_55_60_155,r_54_353_119,r_271_21_123,1.0,1,124,123,7
82,r_223_372_113,r_272_43_166,seq77,r_223_372_113,1.0,0,113,113,7
60,r_45_156_199,r_29_109_33,r_4_344_184,r_29_109_33,1.0,2,35,33,7
88,r_128_80_75,r_349_334_119,r_76_291_167,r_349_334_119,0.92,-37,82,119,7
120,r_85_222_113,r_158_369_144,seq1,r_158_369_144,1.0,-27,117,144,7
23,r_241_200_35,r_351_193_12,r_365_233_87,r_365_233_87,1.0,17,104,87,7
53,r_275_268_92,seq341,r_153_67_20,r_153_67_20,0.9,64,84,20,7
45,r_237_293_154,seq254,r_368_108_41,r_237_293_154,1.0,0,154,154,7
70,r_23_194_45,r_7_154_41,seq26,r_23_194_45,1.0,0,45,45,7
94,r_315_97_141,r_28_180_2,r_207_161_83,r_315_97_141,1.0,1,142,141,7
21,r_103_2_36,r_368_108_41,r_28_180_2,r_103_2_36,0.94,1,37,36,7
90,r_129_242_122,seq215,r_159_53_120,r_159_53_120,0.74,9,129,120,7
80,r_118_95_51,r_170_90_114,seq49,r_118_95_51,1.0,0,51,51,7
98,r_298_182_88,r_146_216_107,seq215,r_146_216_107,1.0,3,110,107,7
34,r_356_168_100,r_34_303_195,seq260,r_356_168_100,1.0,0,100,100,7
243,seq347,r_352_155_194,r_157_300_73,r_157_300_73,1.0,50,123,73,7
18,r_336_348_48,seq274,seq325,r_336_348_48,1.0,-2,46,48,7
118,r_186_62_175,seq198,r_232_183_48,r_186_62_175,0.97,2,177,175,7
132,seq27,r_101_143_155,r_20_46_196,r_101_143_155,1.0,0,155,155,7
103,r_146_216_107,r_298_182_88,r_234_162_4,r_146_216_107,0.94,3,110,107,7
109,r_338_308_168,seq96,seq178,r_338_308_168,0.95,0,168,168,7
55,r_320_59_165,seq191,seq1,r_320_59_165,0.88,-1,164,165,7
107,r_351_193_12,r_68_66_73,r_241_200_35,r_68_66_73,1.0,-6,67,73,7
101,r_170_90_114,r_118_95_51,seq69,r_118_95_51,1.0,0,51,51,7
66,r_317_219_168,seq112,r_121_250_125,r_317_219_168,1.0,0,168,168,7
104,r_165_37_171,seq282,r_286_307_152,r_165_37_171,0.64,0,171,171,7
101,r_170_90_114,seq69,r_153_67_20,r_170_90_114,1.0,0,114,114,7
139,seq52,r_146_216_107,r_232_183_48,r_146_216_107,0.58,2,109,107,7
107,r_351_193_12,r_271_21_123,r_68_66_73,r_351_193_12,0.95,0,12,12,7
89,r_84_119_97,r_123_105_119,r_166_138_157,r_84_119_97,1.0,0,97,97,7
50,r_232_183_48,r_33_14_127,seq52,r_232_183_48,0.93,0,48,48,7
71,r_195_354_153,r_338_308_168,r_107_174_8,r_195_354_153,1.0,0,153,153,7
116,r_73_249_165,seq325,r_368_108_41,r_73_249_165,1.0,0,165,165,7
68,r_226_92_40,r_237_293_154,seq96,r_226_92_40,1.0,0,40,40,7
58,r_19_343_163,r_331_88_123,r_294_132_74,r_19_343_163,0.92,0,163,163,7
112,r_13_278_117,seq15,r_48_134_4,r_13_278_117,1.0,0,117,117,7
115,r_221_6_162,seq210,seq205,r_221_6_162,0.76,6,168,162,7
97,r_292_10_136,r_123_105_119,r_287_131_134,r_292_10_136,0.95,0,136,136,7
106,r_227_63_67,r_366_137_78,seq24,r_227_63_67,1.0,0,67,67,7
2,r_243_264_91,seq47,seq51,r_243_264_91,1.0,0,91,91,7
32,r_76_291_167,r_272_43_166,r_128_80_75,r_76_291_167,0.78,-45,122,167,7
54,r_33_14_127,r_121_250_125,r_206_259_24,r_33_14_127,1.0,0,127,127,7
20,r_340_145_117,r_121_250_125,seq58,r_340_145_117,1.0,0,117,117,7
36,r_0_190_39,r_271_21_123,r_74_301_28,r_271_21_123,0.66,-82,41,123,7
84,r_331_88_123,r_237_293_154,seq77,r_237_293_154,0.68,-32,122,154,7
67,r_68_66_73,r_18_133_196,r_351_193_12,r_351_193_12,0.94,12,24,12,7
81,r_299_257_119,r_186_62_175,r_206_259_24,r_299_257_119,0.89,1,120,119,7
99,r_99_93_76,r_147_176_161,seq56,r_99_93_76,1.0,0,76,76,7
41,r_32_141_64,r_147_176_161,seq321,r_32_141_64,1.0,0,64,64,7
0,r_365_233_87,r_4_344_184,r_241_200_35,r_365_233_87,0.94,0,87,87,7
244,seq350,r_328_358_194,r_373_363_24,r_373_363_24,1.0,23,47,24,7
77,r_35_98_107,seq65,seq201,r_35_98_107,1.0,0,107,107,7
7,r_101_143_155,seq27,seq160,r_101_143_155,1.0,0,155,155,7
38,r_147_176_161,r_360_185_187,seq289,r_147_176_161,0.99,-1,160,161,7
30,r_4_344_184,seq112,r_298_182_88,r_4_344_184,0.99,0,184,184,7
25,r_286_307_152,seq115,r_29_109_33,r_286_307_152,0.99,0,152,152,7
23,r_241_200_35,r_244_130_149,r_351_193_12,r_241_200_35,0.95,4,39,35,7
47,r_366_137_78,seq332,seq152,r_366_137_78,1.0,-3,75,78,7
67,r_68_66_73,r_351_193_12,seq192,r_68_66_73,0.79,0,73,73,7
57,r_371_40_83,r_169_359_104,seq323,r_169_359_104,0.68,-17,87,104,7
31,r_169_359_104,seq240,seq77,r_169_359_104,1.0,0,104,104,7
119,r_273_42_127,seq280,seq201,r_273_42_127,0.79,0,127,127,7
94,r_315_331_179,r_147_350_58,r_1_212_42,r_315_331_179,1.0,0,179,179,8
11,r_337_311_95,r_226_333_191,r_108_265_12,r_337_311_95,0.96,2,97,95,8
43,r_25_124_160,r_300_303_78,r_275_186_19,r_25_124_160,1.0,0,160,160,8
41,r_195_64_23,seq75,r_59_255_103,r_195_64_23,0.73,155,178,23,8
99,r_285_324_84,seq45,seq144,r_285_324_84,0.76,0,84,84,8
5,r_116_240_63,r_148_183_188,r_131_253_2,r_116_240_63,1.0,0,63,63,8
22,r_104_184_59,r_10_24_151,seq348,r_104_184_59,1.0,0,59,59,8
92,r_112_177_60,r_28_172_90,r_346_247_52,r_112_177_60,1.0,2,62,60,8
119,r_263_268_32,r_135_91_87,r_127_243_85,r_127_243_85,1.0,4,89,85,8
8,r_332_355_132,r_95_128_171,seq39,r_95_128_171,0.83,-36,135,171,8
121,r_23_276_96,r_204_294_160,seq107,r_23_276_96,1.0,0,96,96,8
72,r_214_271_35,r_106_134_98,seq142,r_214_271_35,0.99,0,35,35,8
241,seq361,r_88_13_133,r_109_129_120,r_109_129_120,0.7,9,129,120,8
59,r_109_129_120,seq171,seq361,r_109_129_120,0.99,0,120,120,8
9,r_236_307_112,seq136,r_94_170_5,r_236_307_112,0.82,1,113,112,8
123,r_235_119_47,r_25_124_160,r_214_271_35,r_235_119_47,0.85,0,47,47,8
88,r_273_159_75,seq90,r_108_265_12,r_273_159_75,0.87,1,76,75,8
101,r_154_284_140,r_41_244_193,seq367,r_154_284_140,1.0,1,141,140,8
28,r_65_270_87,r_356_343_91,seq45,r_356_343_91,0.96,1,92,91,8
27,r_339_89_25,r_320_132_124,seq29,r_339_89_25,0.9,0,25,25,8
65,r_231_336_73,seq316,seq137,r_231_336_73,0.97,0,73,73,8
82,r_88_13_133,seq361,r_94_170_5,r_88_13_133,0.87,0,133,133,8
36,r_227_368_131,seq17,r_66_215_75,r_227_368_131,0.99,0,131,131,8
156,seq99,r_93_189_96,r_94_170_5,r_93_189_96,1.0,0,96,96,8
110,r_9_241_179,r_101_33_198,r_332_355_132,r_9_241_179,1.0,0,179,179,8
49,r_133_157_72,r_283_200_88,r_346_247_52,r_283_200_88,0.86,-16,72,88,8
79,r_233_96_31,r_315_331_179,r_147_350_58,r_315_331_179,1.0,-7,172,179,8
0,r_321_274_69,seq75,r_19_208_66,r_321_274_69,1.0,0,69,69,8
50,r_123_282_152,r_80_37_64,r_354_211_123,r_80_37_64,0.93,0,64,64,8
14,r_135_91_87,seq201,r_346_247_52,r_346_247_52,0.93,36,88,52,8
118,r_32_117_97,r_226_333_191,r_275_186_19,r_32_117_97,1.0,0,97,97,8
80,r_127_243_85,seq165,r_101_33_198,r_127_243_85,1.0,0,85,85,8
107,r_191_168_163,seq122,r_84_151_42,r_191_168_163,1.0,2,165,163,8
62,r_69_61_105,seq121,r_323_26_192,r_69_61_105,0.97,1,106,105,8
37,r_108_265_12,r_161_100_102,r_337_311_95,r_161_100_102,0.49,0,102,102,8
20,r_101_33_198,r_9_241_179,r_127_243_85,r_127_243_85,1.0,7,92,85,8
68,r_202_370_120,seq39,seq194,r_202_370_120,0.51,9,129,120,8
44,r_1_212_42,r_28_172_90,seq319,r_1_212_42,0.92,1,43,42,8
30,r_180_252_160,r_204_294_160,seq107,r_180_252_160,1.0,0,160,160,8
112,r_262_288_173,seq145,seq68,r_262_288_173,0.95,2,175,173,8
97,r_10_24_151,seq152,r_214_271_35,r_10_24_151,0.88,1,152,151,8
54,r_300_303_78,r_25_124_160,r_344_49_187,r_25_124_160,1.0,0,160,160,8
67,r_141_342_90,r_226_333_191,r_321_274_69,r_141_342_90,0.94,0,90,90,8
109,r_31_218_149,r_344_49_187,seq111,r_31_218_149,1.0,0,149,149,8
42,r_95_128_171,r_161_100_102,seq122,r_95_128_171,0.8,0,171,171,8
122,r_330_40_91,r_131_253_2,r_147_350_58,r_330_40_91,1.0,0,91,91,8
34,r_175_8_29,r_323_26_192,seq156,r_175_8_29,1.0,1,30,29,8
46,r_59_255_103,seq299,seq63,r_59_255_103,1.0,0,103,103,8
115,r_174_110_86,seq125,seq229,r_174_110_86,1.0,3,89,86,8
65,r_231_336_73,seq137,r_320_132_124,r_320_132_124,1.0,2,126,124,8
35,r_173_71_75,r_148_183_188,seq248,r_173_71_75,0.99,0,75,75,8
102,r_254_79_37,seq228,seq53,r_254_79_37,1.0,0,37,37,8
52,r_225_5_130,r_10_24_151,seq2,r_225_5_130,1.0,0,130,130,8
19,r_277_76_59,seq75,r_52_205_3,r_277_76_59,1.0,0,59,59,8
38,r_46_266_135,seq75,r_85_223_99,r_46_266_135,0.87,2,137,135,8
111,r_326_221_76,r_332_355_132,r_206_36_65,r_326_221_76,1.0,1,77,76,8
74,r_371_114_35,r_256_193_92,seq246,r_371_114_35,0.7,3,38,35,8
63,r_356_343_91,r_65_270_87,seq248,r_356_343_91,0.98,1,92,91,8
90,r_48_238_144,seq319,r_93_189_96,r_48_238_144,1.0,0,144,144,8
105,r_206_36_65,seq201,r_120_304_89,r_206_36_65,1.0,0,65,65,8
54,r_300_303_78,r_256_193_92,r_25_124_160,r_25_124_160,0.67,-82,78,160,8
33,r_14_92_50,seq70,seq196,r_14_92_50,1.0,0,50,50,8
1,r_84_151_42,r_312_369_132,r_214_271_35,r_84_151_42,0.47,3,45,42,8
71,r_126_181_132,seq158,r_192_30_49,r_126_181_132,0.94,1,133,132,8
96,r_309_351_152,seq160,r_256_193_92,r_309_351_152,0.97,0,152,152,8
70,r_341_291_126,seq220,r_232_130_114,r_341_291_126,0.99,2,128,126,8
56,r_352_153_50,r_28_172_90,seq259,r_352_153_50,0.88,0,50,50,8
26,r_204_294_160,r_192_30_49,r_225_5_130,r_204_294_160,0.97,0,160,160,8
93,r_7_44_165,r_222_54_197,seq57,r_7_44_165,1.0,0,165,165,8
41,r_195_64_23,seq107,seq75,r_195_64_23,1.0,0,23,23,8
16,r_320_132_124,seq58,r_231_336_73,r_320_132_124,1.0,0,124,124,8
77,r_187_6_115,r_225_5_130,r_127_243_85,r_187_6_115,1.0,4,119,115,8
18,r_234_20_83,r_41_244_193,seq47,r_234_20_83,1.0,2,85,83,8
117,r_239_35_69,r_204_294_160,r_293_118_11,r_239_35_69,0.98,-1,68,69,8
7,r_155_87_78,r_278_176_118,seq136,r_155_87_78,1.0,1,79,78,8
61,r_3_12_86,r_360_82_172,seq78,r_3_12_86,1.0,1,87,86,8
105,r_206_36_65,r_120_304_89,r_326_221_76,r_120_304_89,0.63,0,89,89,8
75,r_19_208_66,r_28_172_90,r_321_274_69,r_19_208_66,1.0,3,69,66,8
37,r_108_265_12,seq42,r_161_100_102,r_108_265_12,0.88,-2,10,12,8
39,r_147_350_58,seq58,r_233_96_31,r_147_350_58,1.0,0,58,58,8
87,r_357_374_67,r_202_370_120,r_192_30_49,r_357_374_67,1.0,1,68,67,8
68,r_202_370_120,r_357_374_67,seq39,r_357_374_67,1.0,1,68,67,8
42,r_95_128_171,r_332_355_132,r_161_100_102,r_161_100_102,0.66,33,135,102,8
116,r_131_253_2,r_330_40_91,r_116_240_63,r_131_253_2,0.93,89,91,2,8
79,r_233_96_31,r_25_124_160,r_315_331_179,r_233_96_31,1.0,0,31,31,8
104,r_222_54_197,r_7_44_165,r_256_193_92,r_256_193_92,0.9,22,114,92,8
17,r_281_242_38,r_14_92_50,seq17,r_281_242_38,1.0,0,38,38,8
4,r_323_26_192,seq150,r_69_61_105,r_323_26_192,0.51,-96,96,192,8
50,r_123_282_152,r_354_211_123,r_277_76_59,r_123_282_152,1.0,3,155,152,8
94,r_315_331_179,r_256_193_92,r_147_350_58,r_256_193_92,0.73,0,92,92,8
83,r_169_198_93,seq60,r_261_27_129,r_261_27_129,1.0,0,129,129,8
197,seq220,r_341_291_126,r_84_151_42,r_341_291_126,1.0,2,128,126,8
40,r_317_219_143,seq258,r_174_110_86,r_317_219_143,1.0,0,143,143,8
53,r_143_50_189,seq67,r_234_20_83,r_143_50_189,0.92,0,189,189,8
24,r_28_172_90,seq366,r_120_304_89,r_28_172_90,0.53,0,90,90,8
25,r_86_103_129,seq102,r_84_151_42,r_86_103_129,1.0,0,129,129,8
128,seq15,r_332_355_132,r_146_83_62,r_146_83_62,1.0,2,64,62,8
57,r_312_369_132,r_84_151_42,r_155_87_78,r_312_369_132,0.99,0,132,132,8
113,r_278_176_118,seq29,r_344_49_187,r_278_176_118,0.92,2,120,118,8
89,r_305_295_140,seq322,r_141_342_90,r_305_295_140,1.0,1,141,140,8
13,r_298_98_120,r_354_211_123,r_116_240_63,r_298_98_120,0.96,0,120,120,8
86,r_232_130_114,seq297,r_94_170_5,r_232_130_114,0.96,1,115,114,8
120,r_167_199_7,r_146_83_62,r_14_92_50,r_167_199_7,0.62,55,62,7,8
2,r_106_134_98,seq102,seq190,r_106_134_98,1.0,0,98,98,8
21,r_161_100_102,r_123_282_152,seq15,r_161_100_102,1.0,0,102,102,8
64,r_290_73_48,r_344_49_187,seq267,r_290_73_48,1.0,0,48,48,8
76,r_275_186_19,r_236_307_112,r_286_230_3,r_275_186_19,1.0,0,19,19,8
78,r_38_140_60,r_227_368_131,seq248,r_38_140_60,0.84,2,62,60,8
48,r_314_11_46,r_226_333_191,seq18,r_314_11_46,0.99,0,46,46,8
191,seq201,r_206_36_65,r_101_33_198,r_206_36_65,1.0,0,65,65,8
91,r_66_215_75,seq115,seq322,r_66_215_75,0.99,0,75,75,8
73,r_192_30_49,r_204_294_160,r_357_374_67,r_204_294_160,0.54,0,160,160,8
81,r_353_55_148,seq111,r_352_153_50,r_353_55_148,1.0,1,149,148,8
95,r_80_37_64,r_123_282_152,seq248,r_80_37_64,0.98,0,64,64,8
124,r_120_304_89,r_256_193_92,r_28_172_90,r_28_172_90,1.0,0,90,90,8
108,r_85_223_99,r_344_49_187,seq216,r_85_223_99,0.73,3,102,99,8
23,r_256_193_92,r_315_331_179,r_222_54_197,r_256_193_92,1.0,0,92,92,8
12,r_21_308_134,seq125,r_187_6_115,r_21_308_134,0.97,2,136,134,8
103,r_93_189_96,seq99,r_231_336_73,r_93_189_96,1.0,0,96,96,8
6,r_293_118_11,seq115,r_239_35_69,r_239_35_69,0.96,21,90,69,8
31,r_148_183_188,seq45,r_1_212_42,r_148_183_188,0.97,-1,187,188,8
83,r_169_198_93,r_344_49_187,seq60,r_169_198_93,1.0,0,93,93,8
6,r_293_118_11,r_106_134_98,seq115,r_293_118_11,0.97,0,11,11,8
32,r_72_34_61,r_234_20_83,seq248,r_72_34_61,0.71,1,62,61,8
4,r_323_26_192,r_175_8_29,seq150,r_175_8_29,0.88,4,33,29,8
114,r_217_162_25,r_155_87_78,seq125,r_217_162_25,1.0,0,25,25,8
3,r_360_82_172,seq142,r_146_83_62,r_360_82_172,1.0,0,172,172,8
58,r_329_250_58,r_317_219_143,seq58,r_329_250_58,1.0,0,58,58,8
55,r_283_200_88,seq18,seq366,r_283_200_88,1.0,0,88,88,8
100,r_213_338_181,seq194,seq138,r_213_338_181,1.0,0,181,181,8
162,seq115,r_360_82_172,r_293_118_11,r_293_118_11,0.93,0,11,11,8
43,r_25_124_160,seq165,r_300_303_78,r_300_303_78,1.0,4,82,78,8
211,seq267,r_340_149_20,r_290_73_48,r_290_73_48,1.0,7,55,48,8
178,seq155,r_103_296_67,seq291,r_103_296_67,0.85,-25,42,67,9
96,r_133_67_31,r_5_159_149,r_109_161_142,r_5_159_149,0.87,0,149,149,9
97,r_290_286_52,r_138_253_161,r_53_248_16,r_290_286_52,0.87,0,52,52,9
92,r_3_222_185,seq308,r_133_67_31,r_3_222_185,0.46,1,186,185,9
23,r_346_324_30,r_319_330_111,seq4,r_319_330_111,1.0,-73,38,111,9
42,r_214_149_116,r_109_161_142,seq111,r_109_161_142,0.91,1,143,142,9
86,r_182_136_70,r_201_7_171,r_84_185_66,r_182_136_70,1.0,0,70,70,9
115,r_84_185_66,seq169,r_182_136_70,r_182_136_70,0.62,3,73,70,9
62,r_156_331_76,r_229_237_189,r_103_296_67,r_156_331_76,0.99,0,76,76,9
40,r_366_107_180,seq194,r_27_247_128,r_366_107_180,0.88,0,180,180,9
61,r_282_30_51,r_138_253_161,seq323,r_282_30_51,0.98,0,51,51,9
109,r_109_161_142,r_89_328_50,r_20_279_163,r_89_328_50,0.97,-10,40,50,9
104,r_49_326_16,r_114_65_119,seq263,r_49_326_16,1.0,0,16,16,9
41,r_99_52_189,seq265,r_302_45_15,r_99_52_189,0.96,-1,188,189,9
141,seq55,r_350_37_91,seq34,r_350_37_91,1.0,0,91,91,9
78,r_353_273_35,seq164,seq178,r_353_273_35,1.0,0,35,35,9
227,seq278,r_104_288_100,seq0,r_104_288_100,1.0,-18,82,100,9
42,r_214_149_116,seq344,r_109_161_142,r_214_149_116,0.94,2,118,116,9
84,r_209_6_81,r_51_38_104,seq230,r_209_6_81,1.0,0,81,81,9
28,r_96_83_170,r_5_159_149,r_133_67_31,r_5_159_149,1.0,0,149,149,9
28,r_96_83_170,r_133_67_31,seq365,r_96_83_170,0.91,0,170,170,9
66,r_336_184_180,r_124_276_75,seq363,r_124_276_75,1.0,1,76,75,9
109,r_109_161_142,r_20_279_163,r_214_149_116,r_109_161_142,0.73,-27,115,142,9
99,r_170_232_31,r_158_64_185,seq203,r_170_232_31,0.94,2,33,31,9
235,seq323,r_158_64_185,r_282_30_51,r_282_30_51,1.0,9,60,51,9
185,seq169,r_84_185_66,seq134,r_84_185_66,1.0,7,73,66,9
105,r_192_204_180,seq39,r_297_294_34,r_192_204_180,1.0,0,180,180,9
81,r_315_42_178,seq255,r_27_247_128,r_27_247_128,0.53,50,178,128,9
37,r_98_75_92,r_153_274_149,seq135,r_98_75_92,0.97,4,96,92,9
227,seq278,seq0,r_271_268_151,r_271_268_151,1.0,1,152,151,9
111,r_11_154_63,r_287_9_161,seq277,r_11_154_63,1.0,7,70,63,9
226,seq277,r_229_237_189,r_11_154_63,r_11_154_63,0.8,5,68,63,9
8,r_190_61_99,seq252,r_105_116_57,r_190_61_99,1.0,0,99,99,9
21,r_35_174_64,r_258_295_123,seq265,r_35_174_64,1.0,0,64,64,9
168,seq122,r_36_280_136,seq92,r_36_280_136,1.0,0,136,136,9
63,r_240_127_64,seq24,seq220,r_240_127_64,1.0,0,64,64,9
88,r_63_238_83,r_201_7_171,seq73,r_63_238_83,1.0,1,84,83,9
132,seq24,r_201_7_171,r_319_330_111,r_319_330_111,0.94,0,111,111,9
77,r_322_338_93,r_336_184_180,seq266,r_322_338_93,0.99,7,100,93,9
51,r_283_270_45,r_287_9_161,r_25_12_20,r_283_270_45,0.99,0,45,45,9
44,r_105_116_57,r_350_37_91,seq187,r_105_116_57,1.0,0,57,57,9
19,r_145_110_21,r_240_127_64,seq66,r_145_110_21,0.98,2,23,21,9
64,r_256_343_93,seq291,r_297_294_34,r_256_343_93,0.99,0,93,93,9
68,r_301_176_61,r_229_237_189,r_105_116_57,r_301_176_61,0.74,0,61,61,9
91,r_229_237_189,seq111,r_353_273_35,r_229_237_189,1.0,0,189,189,9
107,r_368_259_168,r_82_262_186,r_144_251_83,r_368_259_168,1.0,0,168,168,9
47,r_51_38_104,seq344,seq40,r_51_38_104,1.0,0,104,104,9
33,r_27_247_128,r_196_358_195,r_332_327_58,r_27_247_128,1.0,0,128,128,9
56,r_76_17_160,seq86,r_18_311_199,r_76_17_160,0.99,1,161,160,9
55,r_147_264_165,seq92,r_132_78_105,r_147_264_165,0.91,3,168,165,9
108,r_43_137_83,r_271_268_151,seq93,r_43_137_83,1.0,0,83,83,9
70,r_26_197_103,r_201_7_171,r_374_236_94,r_26_197_103,1.0,0,103,103,9
73,r_71_106_84,seq210,seq93,r_71_106_84,0.99,0,84,84,9
30,r_319_330_111,seq166,seq24,r_319_330_111,1.0,0,111,111,9
119,r_208_175_50,seq79,seq80,r_208_175_50,1.0,0,50,50,9
94,r_242_151_180,seq186,r_362_60_95,r_242_151_180,0.99,0,180,180,9
46,r_132_78_105,seq230,seq10,r_132_78_105,1.0,0,105,105,9
205,seq220,seq87,r_240_127_64,r_240_127_64,1.0,31,95,64,9
36,r_144_251_83,r_371_359_175,r_231_142_11,r_144_251_83,1.0,0,83,83,9
96,r_133_67_31,seq93,r_5_159_149,r_133_67_31,0.73,4,35,31,9
34,r_275_250_146,r_3_222_185,seq267,r_275_250_146,1.0,2,148,146,9
25,r_94_310_33,r_119_44_191,seq291,r_94_310_33,0.99,0,33,33,9
71,r_36_280_136,seq122,r_105_116_57,r_36_280_136,1.0,0,136,136,9
79,r_349_146_90,r_235_354_109,seq74,r_349_146_90,0.49,0,90,90,9
101,r_227_8_49,r_256_343_93,seq351,r_227_8_49,1.0,0,49,49,9
10,r_23_289_174,r_70_16_193,r_153_274_149,r_23_289_174,1.0,0,174,174,9
13,r_371_359_175,seq128,seq122,r_371_359_175,0.99,0,175,175,9
121,r_284_171_61,seq129,r_54_213_60,r_54_213_60,0.74,23,83,60,9
124,r_103_296_67,seq212,seq221,r_103_296_67,1.0,0,67,67,9
27,r_130_337_48,seq58,seq252,r_130_337_48,1.0,0,48,48,9
90,r_347_15_144,r_320_317_151,r_105_116_57,r_347_15_144,1.0,0,144,144,9
48,r_57_307_121,r_315_42_178,seq173,r_57_307_121,0.98,-1,120,121,9
12,r_124_276_75,r_336_184_180,r_282_30_51,r_124_276_75,1.0,1,76,75,9
49,r_321_32_178,seq41,r_132_78_105,r_321_32_178,0.97,1,179,178,9
221,seq265,r_119_44_191,r_35_174_64,r_35_174_64,1.0,-1,63,64,9
50,r_234_312_97,r_132_78_105,r_180_304_59,r_234_312_97,1.0,0,97,97,9
52,r_97_334_38,r_103_296_67,seq360,r_97_334_38,0.9,0,38,38,9
128,seq10,r_85_306_162,r_132_78_105,r_85_306_162,0.62,-2,160,162,9
6,r_89_328_50,r_109_161_142,seq252,r_89_328_50,1.0,0,50,50,9
29,r_245_202_36,r_369_200_119,seq128,r_245_202_36,1.0,0,36,36,9
158,seq92,r_147_264_165,seq122,r_147_264_165,1.0,3,168,165,9
102,r_287_9_161,seq21,r_54_213_60,r_287_9_161,0.97,0,161,161,9
109,r_109_161_142,r_214_149_116,r_133_67_31,r_109_161_142,0.96,0,142,142,9
87,r_254_314_121,r_158_64_185,r_94_310_33,r_254_314_121,1.0,0,121,121,9
249,seq373,seq66,r_20_279_163,r_20_279_163,1.0,3,166,163,9
218,seq260,r_215_168_155,r_153_274_149,r_215_168_155,1.0,-1,154,155,9
67,r_348_345_162,r_321_32_178,r_153_274_149,r_348_345_162,1.0,0,162,162,9
60,r_215_168_155,seq260,r_231_142_11,r_215_168_155,1.0,-1,154,155,9
122,r_352_211_74,r_335_179_174,r_370_165_32,r_352_211_74,0.92,1,75,74,9
114,r_369_200_119,seq77,seq139,r_369_200_119,1.0,0,119,119,9
26,r_47_300_86,seq308,seq68,r_47_300_86,1.0,0,86,86,9
120,r_271_268_151,seq91,seq278,r_271_268_151,1.0,0,151,151,9
138,seq40,r_235_354_109,r_51_38_104,r_235_354_109,0.49,1,110,109,9
157,seq91,r_271_268_151,r_47_300_86,r_271_268_151,0.58,0,151,151,9
113,r_126_226_130,seq79,r_27_247_128,r_126_226_130,0.9,0,130,130,9
176,seq141,r_163_62_154,r_329_121_12,r_163_62_154,1.0,8,162,154,9
89,r_56_292_21,r_371_359_175,seq111,r_56_292_21,0.88,0,21,21,9
98,r_235_354_109,seq40,r_297_294_34,r_235_354_109,1.0,1,110,109,9
93,r_82_262_186,seq223,r_190_61_99,r_82_262_186,0.98,0,186,186,9
24,r_374_236_94,seq21,r_370_165_32,r_374_236_94,1.0,3,97,94,9
59,r_193_305_152,seq157,r_100_299_143,r_193_305_152,0.93,1,153,152,9
82,r_148_356_149,r_158_64_185,seq164,r_148_356_149,1.0,0,149,149,9
14,r_20_279_163,r_315_42_178,seq373,r_20_279_163,1.0,0,163,163,9
20,r_131_281_122,seq244,seq223,r_131_281_122,1.0,0,122,122,9
65,r_53_248_16,r_346_324_30,seq90,r_346_324_30,0.58,-15,15,30,9
53,r_183_367_174,seq221,r_71_106_84,r_183_367_174,0.96,0,174,174,9
4,r_138_253_161,r_147_264_165,seq267,r_138_253_161,0.99,-1,160,161,9
7,r_335_179_174,seq272,r_347_15_144,r_335_179_174,0.65,1,175,174,9
31,r_246_342_116,r_148_356_149,r_105_116_57,r_246_342_116,1.0,0,116,116,9
35,r_14_233_119,seq139,r_98_75_92,r_14_233_119,1.0,1,120,119,9
132,seq24,r_240_127_64,r_201_7_171,r_240_127_64,0.64,1,65,64,9
15,r_5_159_149,r_96_83_170,seq88,r_5_159_149,1.0,0,149,149,9
12,r_124_276_75,r_282_30_51,r_225_102_100,r_225_102_100,0.99,20,120,100,9
3,r_158_64_185,seq113,r_371_359_175,r_158_64_185,0.92,1,186,185,9
80,r_54_213_60,seq223,r_208_175_50,r_54_213_60,0.98,2,62,60,9
39,r_370_165_32,r_346_324_30,seq344,r_370_165_32,0.98,1,33,32,9
123,r_69_115_58,seq313,seq128,r_69_115_58,1.0,0,58,58,9
85,r_332_327_58,r_192_204_180,r_140_177_7,r_332_327_58,1.0,0,58,58,9
117,r_25_12_20,r_145_110_21,seq31,r_25_12_20,1.0,0,20,20,9
83,r_258_295_123,seq29,r_54_213_60,r_258_295_123,1.0,0,123,123,9
57,r_50_33_86,seq86,seq90,r_50_33_86,1.0,1,87,86,9
66,r_336_184_180,seq363,r_50_33_86,r_336_184_180,1.0,0,180,180,9
16,r_201_7_171,seq81,r_63_238_83,r_201_7_171,0.56,0,171,171,9
17,r_180_304_59,r_201_7_171,seq265,r_180_304_59,1.0,2,61,59,9
18,r_333_361_132,r_298_118_197,r_132_78_105,r_333_361_132,1.0,0,132,132,9
1,r_195_51_174,seq325,r_105_252_27,r_195_51_174,0.96,1,175,174,10
3,r_207_144_100,seq56,seq214,r_207_144_100,1.0,0,100,100,10
114,r_167_140_112,seq347,r_311_364_34,r_167_140_112,1.0,0,112,112,10
236,seq332,r_145_32_172,r_244_368_16,r_145_32_172,0.72,3,175,172,10
42,r_12_123_187,seq23,r_320_50_49,r_12_123_187,1.0,0,187,187,10
53,r_7_33_51,r_101_363_96,seq151,r_101_363_96,0.85,-40,56,96,10
25,r_276_44_64,seq132,seq93,r_276_44_64,0.94,0,64,64,10
81,r_204_62_79,seq77,r_31_133_56,r_204_62_79,1.0,0,79,79,10
130,seq23,r_12_123_187,r_110_302_31,r_12_123_187,1.0,0,187,187,10
22,r_41_297_80,r_231_118_114,seq369,r_41_297_80,0.8,0,80,80,10
79,r_66_208_37,r_100_90_121,seq175,r_66_208_37,1.0,0,37,37,10
69,r_193_324_132,r_349_285_134,r_121_268_88,r_193_324_132,0.8,0,132,132,10
201,seq243,seq71,r_202_299_74,r_202_299_74,1.0,-1,73,74,10
5,r_263_120_175,r_115_221_188,r_121_268_88,r_263_120_175,0.96,0,175,175,10
14,r_254_69_41,r_261_327_129,r_219_67_105,r_254_69_41,1.0,88,129,41,10
118,r_227_11_93,r_195_51_174,seq367,r_227_11_93,0.82,0,93,93,10
38,r_292_139_39,seq243,r_372_255_136,r_292_139_39,0.99,0,39,39,10
2,r_36_99_77,seq135,seq4,r_36_99_77,0.93,5,82,77,10
15,r_320_50_49,seq116,seq272,r_320_50_49,1.0,1,50,49,10
116,r_341_83_43,r_231_118_114,r_228_152_155,r_341_83_43,0.91,0,43,43,10
14,r_254_69_41,r_290_114_119,r_261_327_129,r_254_69_41,1.0,0,41,41,10
20,r_231_118_114,r_104_134_25,r_191_218_50,r_231_118_114,1.0,0,114,114,10
32,r_97_79_63,r_157_222_128,r_291_14_47,r_291_14_47,0.8,16,63,47,10
13,r_172_374_42,r_122_240_132,r_163_233_17,r_172_374_42,0.51,0,42,42,10
65,r_87_306_75,r_195_51_174,r_172_374_42,r_87_306_75,1.0,0,75,75,10
74,r_198_271_165,seq281,r_204_62_79,r_198_271_165,1.0,0,165,165,10
23,r_103_330_162,seq22,r_81_309_38,r_103_330_162,0.57,2,164,162,10
113,r_211_177_13,r_180_355_51,r_5_52_3,r_211_177_13,0.93,0,13,13,10
84,r_149_329_28,r_231_118_114,seq343,r_149_329_28,1.0,0,28,28,10
43,r_127_88_176,seq57,seq34,r_127_88_176,1.0,0,176,176,10
115,r_130_257_79,r_43_342_103,seq281,r_43_342_103,1.0,-23,80,103,10
72,r_180_355_51,seq192,seq39,r_180_355_51,1.0,0,51,51,10
59,r_372_255_136,r_251_266_84,r_292_139_39,r_372_255_136,0.83,-52,84,136,10
37,r_101_363_96,r_349_285_134,seq39,r_101_363_96,1.0,0,96,96,10
48,r_205_19_72,r_43_342_103,seq196,r_205_19_72,0.66,0,72,72,10
117,r_298_26_159,seq343,r_227_11_93,r_298_26_159,1.0,0,159,159,10
70,r_27_321_120,seq293,r_30_106_8,r_27_321_120,1.0,0,120,120,10
62,r_197_146_163,seq131,r_121_268_88,r_197_146_163,0.92,0,163,163,10
24,r_157_222_128,seq141,seq153,r_157_222_128,0.99,2,130,128,10
64,r_313_194_57,seq281,seq189,r_313_194_57,0.87,0,57,57,10
63,r_105_252_27,r_101_363_96,seq135,r_105_252_27,0.92,0,27,27,10
98,r_279_319_74,r_55_158_77,seq166,r_55_158_77,0.97,0,77,77,10
28,r_290_114_119,seq18,r_112_89_104,r_290_114_119,1.0,0,119,119,10
102,r_336_217_120,seq312,r_373_223_23,r_336_217_120,1.0,1,121,120,10
20,r_231_118_114,r_41_297_80,r_104_134_25,r_231_118_114,0.67,-53,61,114,10
123,r_68_354_157,r_229_225_104,r_180_355_51,r_229_225_104,0.57,0,104,104,10
249,seq370,r_349_285_134,r_361_270_25,r_349_285_134,0.64,3,137,134,10
38,r_292_139_39,r_372_255_136,r_43_342_103,r_292_139_39,0.7,97,136,39,10
44,r_60_206_108,seq155,seq15,r_60_206_108,0.85,11,119,108,10
76,r_104_134_25,r_64_215_177,r_345_78_7,r_104_134_25,1.0,0,25,25,10
121,r_291_14_47,r_229_225_104,seq159,r_291_14_47,1.0,0,47,47,10
86,r_357_20_108,r_81_309_38,seq183,r_357_20_108,1.0,0,108,108,10
9,r_228_152_155,r_338_284_98,r_341_83_43,r_228_152_155,1.0,-82,73,155,10
11,r_289_359_149,r_264_119_62,r_373_223_23,r_289_359_149,1.0,-1,148,149,10
35,r_244_368_16,seq166,seq332,r_244_368_16,0.82,0,16,16,10
88,r_165_273_33,r_372_255_136,seq370,r_165_273_33,0.87,2,35,33,10
77,r_269_366_65,seq53,seq326,r_269_366_65,0.99,4,69,65,10
95,r_373_223_23,r_264_119_62,seq192,r_373_223_23,1.0,0,23,23,10
105,r_351_241_74,seq272,r_30_106_8,r_351_241_74,1.0,0,74,74,10
59,r_372_255_136,r_292_139_39,r_244_368_16,r_372_255_136,1.0,0,136,136,10
104,r_138_142_145,r_64_215_177,r_276_44_64,r_138_142_145,1.0,0,145,145,10
99,r_31_133_56,r_290_114_119,seq369,r_290_114_119,0.92,-62,57,119,10
185,seq188,seq335,r_170_337_36,r_170_337_36,1.0,21,57,36,10
94,r_163_233_17,seq4,seq192,r_163_233_17,1.0,0,17,17,10
56,r_358_181_163,seq187,r_207_144_100,r_358_181_163,0.98,0,163,163,10
112,r_58_239_151,seq304,r_361_270_25,r_58_239_151,1.0,4,155,151,10
7,r_150_38_88,r_231_118_114,r_251_266_84,r_150_38_88,0.66,1,89,88,10
30,r_352_178_58,r_231_118_114,r_109_47_28,r_352_178_58,0.58,0,58,58,10
47,r_145_32_172,seq332,r_101_363_96,r_101_363_96,0.77,79,175,96,10
39,r_283_256_161,r_156_365_106,r_207_144_100,r_283_256_161,0.96,-55,106,161,10
39,r_283_256_161,r_207_144_100,seq201,r_283_256_161,0.59,-17,144,161,10
187,seq192,r_180_355_51,r_373_223_23,r_180_355_51,0.61,0,51,51,10
144,seq61,r_315_234_157,r_311_364_34,r_315_234_157,1.0,0,157,157,10
109,r_170_337_36,seq250,seq188,r_170_337_36,1.0,1,37,36,10
111,r_210_46_42,r_290_114_119,seq304,r_290_114_119,0.66,-74,45,119,10
92,r_55_158_77,r_279_319_74,seq347,r_55_158_77,1.0,0,77,77,10
110,r_331_76_139,seq318,r_209_147_34,r_331_76_139,1.0,0,139,139,10
90,r_261_327_129,r_254_69_41,r_100_90_121,r_261_327_129,1.0,0,129,129,10
83,r_345_78_7,r_150_38_88,r_104_134_25,r_150_38_88,1.0,1,89,88,10
33,r_349_285_134,seq370,r_191_218_50,r_349_285_134,0.98,3,137,134,10
68,r_251_266_84,r_372_255_136,r_361_270_25,r_251_266_84,0.92,0,84,84,10
78,r_315_234_157,seq61,r_200_160_93,r_315_234_157,0.85,0,157,157,10
181,seq179,seq59,r_249_45_66,r_249_45_66,1.0,20,86,66,10
0,r_154_267_184,seq22,r_228_152_155,r_154_267_184,0.92,0,184,184,10
57,r_219_67_105,seq116,r_101_363_96,r_219_67_105,1.0,1,106,105,10
18,r_288_54_38,r_24_333_188,seq126,r_288_54_38,0.99,0,38,38,10
52,r_25_129_30,seq111,seq59,r_25_129_30,1.0,0,30,30,10
6,r_191_218_50,r_228_152_155,seq253,r_191_218_50,0.69,1,51,50,10
107,r_110_302_31,r_24_333_188,r_288_54_38,r_24_333_188,0.78,0,188,188,10
93,r_21_9_66,r_121_268_88,r_361_270_25,r_21_9_66,0.93,6,72,66,10
34,r_16_48_77,seq107,seq189,r_16_48_77,0.89,13,90,77,10
147,seq77,r_204_62_79,seq116,r_204_62_79,1.0,0,79,79,10
82,r_260_95_98,seq224,r_264_119_62,r_260_95_98,1.0,0,98,98,10
85,r_94_346_40,seq35,seq40,r_94_346_40,1.0,0,40,40,10
107,r_110_302_31,seq15,r_24_333_188,r_110_302_31,1.0,0,31,31,10
49,r_338_284_98,seq132,seq224,r_338_284_98,1.0,0,98,98,10
51,r_24_333_188,r_288_54_38,r_110_302_31,r_24_333_188,1.0,-153,35,188,10
51,r_24_333_188,r_110_302_31,r_103_330_162,r_24_333_188,0.99,0,188,188,10
90,r_261_327_129,r_17_70_199,r_254_69_41,r_254_69_41,0.96,-1,40,41,10
61,r_202_299_74,r_73_232_155,seq243,r_202_299_74,0.98,0,74,74,10
46,r_249_45_66,seq116,seq179,r_249_45_66,1.0,0,66,66,10
31,r_308_296_132,seq259,r_13_63_55,r_308_296_132,0.9,1,133,132,10
26,r_156_365_106,r_283_256_161,r_264_119_62,r_156_365_106,1.0,0,106,106,10
67,r_43_342_103,r_27_321_120,r_292_139_39,r_43_342_103,0.91,0,103,103,10
16,r_100_90_121,seq348,r_279_319_74,r_100_90_121,1.0,0,121,121,10
29,r_229_225_104,r_68_354_157,seq272,r_229_225_104,1.0,0,104,104,10
40,r_121_268_88,seq362,seq37,r_121_268_88,1.0,0,88,88,10
19,r_112_89_104,seq323,seq57,r_112_89_104,0.87,0,104,104,10
41,r_161_136_104,r_127_88_176,seq362,r_161_136_104,0.99,0,104,104,10
240,seq343,r_122_240_132,r_149_329_28,r_122_240_132,1.0,0,132,132,10
106,r_334_226_85,r_73_232_155,r_7_33_51,r_334_226_85,1.0,0,85,85,10
54,r_361_270_25,r_154_267_184,seq370,r_361_270_25,1.0,0,25,25,10
119,r_203_162_64,r_195_51_174,seq168,r_203_162_64,0.95,0,64,64,10
40,r_349_354_110,r_252_84_150,seq359,r_349_354_110,1.0,0,110,110,11
22,r_197_156_143,seq133,seq238,r_197_156_143,1.0,0,143,143,11
204,seq238,r_184_104_81,r_313_167_45,r_184_104_81,0.45,0,81,81,11
91,r_15_154_19,r_74_339_134,r_366_299_30,r_15_154_19,0.92,1,20,19,11
80,r_2_341_173,seq359,seq217,r_2_341_173,1.0,0,173,173,11
88,r_223_73_30,r_361_162_99,r_70_131_88,r_223_73_30,1.0,62,92,30,11
27,r_368_279_35,r_140_83_156,r_0_196_58,r_368_279_35,0.83,71,106,35,11
23,r_364_314_110,seq135,seq138,r_364_314_110,0.99,0,110,110,11
5,r_12_98_122,seq333,seq274,r_12_98_122,1.0,0,122,122,11
7,r_107_145_144,seq126,seq323,r_107_145_144,1.0,1,145,144,11
42,r_222_174_29,seq173,seq215,r_222_174_29,0.99,1,30,29,11
72,r_318_19_36,r_5_350_182,r_368_279_35,r_318_19_36,0.98,0,36,36,11
69,r_166_282_157,r_2_341_173,r_310_90_153,r_166_282_157,0.99,0,157,157,11
157,seq101,r_140_83_156,r_368_279_35,r_140_83_156,1.0,1,157,156,11
76,r_142_96_33,r_184_104_81,seq116,r_142_96_33,1.0,0,33,33,11
49,r_150_132_143,r_66_143_120,seq30,r_150_132_143,0.7,-38,105,143,11
112,r_182_60_77,seq278,r_122_55_8,r_182_60_77,1.0,0,77,77,11
123,r_315_321_80,seq272,seq53,r_315_321_80,1.0,0,80,80,11
53,r_289_261_69,r_346_11_179,seq177,r_289_261_69,0.31,0,69,69,11
65,r_267_67_161,r_233_319_151,r_260_285_18,r_267_67_161,1.0,-1,160,161,11
96,r_336_219_126,seq262,seq272,r_336_219_126,1.0,0,126,126,11
109,r_188_86_120,seq317,r_367_212_62,r_188_86_120,1.0,0,120,120,11
38,r_305_257_115,r_332_224_197,r_322_169_4,r_305_257_115,1.0,0,115,115,11
19,r_35_21_84,r_197_156_143,seq300,r_35_21_84,1.0,0,84,84,11
28,r_225_294_120,seq262,r_349_354_110,r_225_294_120,1.0,1,121,120,11
48,r_65_180_123,r_366_299_30,seq59,r_65_180_123,1.0,0,123,123,11
3,r_270_373_143,seq274,seq246,r_270_373_143,1.0,0,143,143,11
17,r_260_285_18,seq215,seq56,r_260_285_18,1.0,2,20,18,11
104,r_31_168_85,r_33_87_102,seq120,r_31_168_85,1.0,0,85,85,11
27,r_368_279_35,r_14_218_113,r_140_83_156,r_368_279_35,1.0,0,35,35,11
90,r_26_237_9,r_346_11_179,seq333,r_26_237_9,1.0,1,10,9,11
51,r_99_227_183,seq127,r_102_80_164,r_99_227_183,0.93,2,185,183,11
77,r_46_290_79,r_226_163_9,seq6,r_46_290_79,0.92,0,79,79,11
10,r_276_247_163,seq37,seq81,r_276_247_163,1.0,0,163,163,11
106,r_316_95_150,seq18,r_112_89_119,r_316_95_150,1.0,0,150,150,11
153,seq79,r_207_105_142,r_159_244_29,r_207_105_142,0.95,1,143,142,11
113,r_287_221_30,r_270_373_143,seq18,r_287_221_30,1.0,1,31,30,11
122,r_288_241_136,r_141_235_146,r_280_248_115,r_288_241_136,1.0,2,138,136,11
26,r_108_8_92,r_2_341_173,seq53,r_108_8_92,0.99,0,92,92,11
61,r_20_160_90,r_303_97_193,r_70_131_88,r_303_97_193,1.0,-103,90,193,11
59,r_5_350_182,seq40,seq134,r_5_350_182,0.97,0,182,182,11
97,r_29_77_176,seq9,r_62_239_44,r_29_77_176,0.83,0,176,176,11
111,r_76_69_130,seq42,seq337,r_76_69_130,1.0,0,130,130,11
43,r_106_179_95,r_22_190_152,r_335_201_79,r_22_190_152,0.9,-57,95,152,11
12,r_14_218_113,seq216,r_226_163_9,r_14_218_113,1.0,2,115,113,11
11,r_253_256_87,r_27_161_167,seq133,r_253_256_87,1.0,0,87,87,11
110,r_297_193_157,seq115,r_280_248_115,r_297_193_157,1.0,2,159,157,11
127,seq6,r_344_312_121,r_46_290_79,r_344_312_121,0.9,0,121,121,11
79,r_64_311_43,seq134,seq120,r_64_311_43,1.0,0,43,43,11
21,r_191_363_84,seq153,r_182_60_77,r_191_363_84,1.0,0,84,84,11
58,r_281_284_82,seq59,seq119,r_281_284_82,1.0,0,82,82,11
230,seq323,seq113,r_107_145_144,r_107_145_144,1.0,7,151,144,11
136,seq37,r_276_247_163,r_137_208_30,r_276_247_163,1.0,0,163,163,11
56,r_3_296_19,r_12_98_122,seq47,r_3_296_19,1.0,0,19,19,11
14,r_152_181_156,r_276_247_163,r_159_244_29,r_152_181_156,0.87,0,156,156,11
60,r_234_243_70,r_288_241_136,seq331,r_234_243_70,0.96,1,71,70,11
71,r_100_45_37,r_0_196_58,seq37,r_100_45_37,1.0,0,37,37,11
94,r_355_250_64,r_204_10_158,r_332_224_197,r_355_250_64,1.0,3,67,64,11
37,r_184_104_81,seq238,seq269,r_184_104_81,0.99,0,81,81,11
99,r_39_103_167,seq127,r_102_80_164,r_39_103_167,0.99,0,167,167,11
67,r_62_239_44,seq75,r_110_325_144,r_62_239_44,0.95,2,46,44,11
83,r_51_199_34,r_182_60_77,r_226_163_9,r_51_199_34,0.99,-1,33,34,11
118,r_292_187_107,seq262,r_50_82_18,r_292_187_107,1.0,1,108,107,11
115,r_236_147_36,r_315_321_80,r_137_208_30,r_315_321_80,1.0,-36,44,80,11
98,r_343_54_178,seq374,r_277_353_25,r_343_54_178,0.99,0,178,178,11
103,r_0_196_58,r_107_145_144,r_368_279_35,r_0_196_58,1.0,0,58,58,11
16,r_313_167_45,r_29_77_176,r_287_221_30,r_313_167_45,0.64,0,45,45,11
107,r_207_105_142,seq79,r_3_296_19,r_207_105_142,0.97,1,143,142,11
9,r_33_87_102,r_265_123_195,seq115,r_33_87_102,0.52,13,115,102,11
57,r_277_353_25,r_204_10_158,seq262,r_277_353_25,1.0,1,26,25,11
82,r_252_84_150,seq48,r_332_224_197,r_252_84_150,1.0,0,150,150,11
20,r_259_301_148,r_245_24_64,r_223_73_30,r_259_301_148,0.99,-93,55,148,11
47,r_254_271_90,seq262,seq59,r_254_271_90,0.99,0,90,90,11
116,r_200_176_133,seq119,seq30,r_200_176_133,0.92,0,133,133,11
117,r_85_178_180,seq211,seq40,r_85_178_180,0.87,1,181,180,11
93,r_204_10_158,seq63,r_220_136_74,r_204_10_158,0.95,0,158,158,11
50,r_41_44_73,seq347,r_100_45_37,r_41_44_73,0.96,0,73,73,11
35,r_310_90_153,r_366_299_30,seq307,r_310_90_153,0.87,2,155,153,11
84,r_66_143_120,r_150_132_143,r_106_179_95,r_66_143_120,1.0,0,120,120,11
33,r_264_124_136,seq38,r_327_229_71,r_264_124_136,1.0,1,137,136,11
25,r_280_248_115,seq251,seq374,r_280_248_115,1.0,0,115,115,11
29,r_170_326_87,r_361_162_99,r_191_363_84,r_170_326_87,0.89,0,87,87,11
34,r_361_162_99,r_188_86_120,seq374,r_361_162_99,1.0,1,100,99,11
13,r_112_89_119,seq185,r_348_114_55,r_112_89_119,1.0,1,120,119,11
64,r_128_308_131,r_148_370_145,seq4,r_128_308_131,0.69,1,132,131,11
24,r_13_273_158,r_122_55_8,r_130_88_41,r_13_273_158,1.0,0,158,158,11
108,r_22_190_152,r_233_319_151,r_106_179_95,r_233_319_151,0.66,1,152,151,11
41,r_164_340_114,seq165,r_74_339_134,r_164_340_114,0.93,0,114,114,11
85,r_159_244_29,seq347,seq79,r_159_244_29,0.92,0,29,29,11
62,r_57_25_175,seq81,r_121_213_130,r_57_25_175,0.98,0,175,175,11
31,r_348_114_55,seq47,seq300,r_348_114_55,0.78,3,58,55,11
46,r_233_319_151,r_267_67_161,seq251,r_233_319_151,0.72,2,153,151,11
95,r_50_82_18,r_108_8_92,seq135,r_50_82_18,0.89,0,18,18,11
4,r_102_80_164,seq111,r_322_169_4,r_102_80_164,1.0,1,165,164,11
120,r_74_339_134,r_140_83_156,r_65_180_123,r_74_339_134,0.8,-2,132,134,11
87,r_189_351_170,seq129,r_137_208_30,r_189_351_170,1.0,0,170,170,11
102,r_110_325_144,seq81,r_62_239_44,r_62_239_44,0.85,1,45,44,11
75,r_49_345_170,r_303_97_193,seq317,r_49_345_170,1.0,3,173,170,11
105,r_245_24_64,r_259_301_148,seq151,r_245_24_64,0.87,0,64,64,11
45,r_344_312_121,seq6,r_322_169_4,r_344_312_121,1.0,0,121,121,11
32,r_36_171_87,r_20_160_90,seq210,r_36_171_87,1.0,0,87,87,11
30,r_70_131_88,seq198,r_223_73_30,r_70_131_88,1.0,0,88,88,11
63,r_140_83_156,seq101,r_128_308_131,r_140_83_156,1.0,1,157,156,11
20,r_259_301_148,r_223_73_30,seq115,r_259_301_148,0.99,0,148,148,11
49,r_150_132_143,seq30,r_108_8_92,r_150_132_143,0.74,0,143,143,11
52,r_202_183_185,seq133,r_364_314_110,r_202_183_185,0.98,4,189,185,11
124,r_283_158_130,seq23,seq75,r_283_158_130,1.0,0,130,130,11
55,r_141_235_146,seq16,seq9,r_141_235_146,1.0,1,147,146,11
66,r_367_212_62,r_346_11_179,seq68,r_346_11_179,0.99,-114,65,179,11
73,r_230_255_124,seq209,r_108_8_92,r_230_255_124,1.0,0,124,124,11
89,r_148_370_145,seq356,seq151,r_148_370_145,1.0,0,145,145,11
54,r_335_201_79,r_371_93_152,seq205,r_335_201_79,1.0,0,79,79,11
78,r_130_88_41,r_184_104_81,seq38,r_130_88_41,1.0,0,41,41,11
88,r_223_73_30,seq58,r_361_162_99,r_223_73_30,1.0,0,30,30,11
36,r_121_213_130,r_200_176_133,r_336_219_126,r_121_213_130,1.0,0,130,130,11
110,r_362_224_180,r_331_334_124,r_207_177_120,r_362_224_180,0.97,-56,124,180,12
26,r_333_221_140,seq56,seq173,r_333_221_140,0.68,7,147,140,12
121,r_157_11_129,seq93,r_300_140_71,r_157_11_129,1.0,2,131,129,12
84,r_250_50_132,r_38_290_148,r_203_208_72,r_250_50_132,0.95,0,132,132,12
115,r_300_140_71,seq346,seq230,r_300_140_71,1.0,2,73,71,12
112,r_331_334_124,r_362_224_180,r_128_137_62,r_331_334_124,1.0,0,124,124,12
110,r_362_224_180,r_207_177_120,r_316_255_135,r_362_224_180,0.85,0,180,180,12
147,seq62,r_144_33_178,r_342_102_91,r_144_33_178,1.0,0,178,178,12
55,r_324_59_22,r_152_256_197,seq138,r_324_59_22,0.77,1,23,22,12
119,r_12_78_88,seq92,r_340_165_59,r_12_78_88,0.99,0,88,88,12
29,r_176_154_137,r_196_320_177,seq146,r_176_154_137,0.95,3,140,137,12
126,seq6,r_216_69_140,r_215_322_80,r_216_69_140,1.0,0,140,140,12
38,r_273_367_25,seq180,seq227,r_273_367_25,1.0,0,25,25,12
58,r_44_133_128,r_333_221_140,seq118,r_44_133_128,0.98,0,128,128,12
68,r_7_374_168,seq126,seq64,r_7_374_168,0.92,0,168,168,12
46,r_216_69_140,seq6,r_238_274_96,r_216_69_140,1.0,0,140,140,12
113,r_318_261_158,seq304,r_24_352_92,r_318_261_158,1.0,0,158,158,12
2,r_10_86_104,seq40,seq64,r_10_86_104,0.99,-1,103,104,12
32,r_139_336_120,seq34,r_246_351_134,r_139_336_120,0.99,1,121,120,12
7,r_187_213_112,seq230,seq73,r_187_213_112,0.96,0,112,112,12
200,seq218,seq8,r_354_182_58,r_354_182_58,1.0,65,123,58,12
241,seq346,r_344_3_188,r_294_13_102,r_294_13_102,1.0,27,129,102,12
123,r_234_287_57,seq223,seq127,r_234_287_57,1.0,4,61,57,12
158,seq92,r_12_78_88,r_312_99_15,r_12_78_88,1.0,0,88,88,12
62,r_288_295_42,r_183_122_155,r_28_186_3,r_288_295_42,1.0,0,42,42,12
96,r_253_263_10,r_89_42_176,r_342_102_91,r_89_42_176,0.99,0,176,176,12
105,r_309_305_85,r_268_31_156,r_247_51_43,r_268_31_156,1.0,0,156,156,12
9,r_294_13_102,seq61,seq346,r_294_13_102,1.0,0,102,102,12
65,r_203_208_72,r_344_3_188,r_321_113_134,r_203_208_72,1.0,1,73,72,12
20,r_68_66_62,r_176_154_137,seq355,r_68_66_62,0.99,6,68,62,12
95,r_283_91_25,seq127,seq6,r_283_91_25,1.0,0,25,25,12
70,r_326_341_25,r_207_177_120,seq80,r_326_341_25,1.0,0,25,25,12
25,r_222_373_118,r_100_338_184,r_243_153_22,r_222_373_118,0.95,4,122,118,12
111,r_306_357_43,seq8,r_372_43_126,r_372_43_126,1.0,1,127,126,12
54,r_89_42_176,seq291,r_342_102_91,r_342_102_91,0.95,10,101,91,12
105,r_309_305_85,seq94,r_268_31_156,r_309_305_85,1.0,1,86,85,12
111,r_306_357_43,r_358_142_65,seq8,r_306_357_43,1.0,0,43,43,12
120,r_254_233_103,seq101,r_111_121_112,r_254_233_103,0.99,3,106,103,12
66,r_268_31_156,r_58_2_109,r_238_274_96,r_268_31_156,1.0,-56,100,156,12
40,r_205_45_31,r_268_31_156,seq5,r_205_45_31,1.0,1,32,31,12
90,r_120_332_135,r_96_131_4,seq106,r_120_332_135,0.99,0,135,135,12
81,r_307_329_14,seq35,seq166,r_307_329_14,0.87,-2,12,14,12
5,r_54_115_97,r_277_70_106,r_98_160_67,r_54_115_97,0.84,9,106,97,12
232,seq304,r_318_261_158,r_316_255_135,r_318_261_158,1.0,0,158,158,12
102,r_161_84_66,seq265,seq180,r_161_84_66,1.0,0,66,66,12
14,r_164_339_87,r_96_131_4,seq219,r_164_339_87,1.0,0,87,87,12
91,r_269_60_175,r_100_338_184,r_192_123_87,r_269_60_175,0.98,0,175,175,12
44,r_354_182_58,r_188_37_183,r_327_249_159,r_354_182_58,1.0,126,184,58,12
104,r_100_338_184,seq138,r_48_26_25,r_100_338_184,0.95,1,185,184,12
1,r_183_122_155,seq5,seq75,r_183_122_155,1.0,0,155,155,12
27,r_188_37_183,r_354_182_58,seq184,r_188_37_183,0.99,1,184,183,12
47,r_312_99_15,r_58_2_109,seq281,r_312_99_15,1.0,0,15,15,12
6,r_207_177_120,seq171,r_231_90_113,r_207_177_120,0.56,0,120,120,12
97,r_128_137_62,r_207_177_120,r_268_31_156,r_128_137_62,1.0,0,62,62,12
33,r_311_257_143,r_168_330_195,r_358_142_65,r_311_257_143,0.6,0,143,143,12
52,r_372_43_126,seq105,r_306_357_43,r_372_43_126,1.0,0,126,126,12
97,r_128_137_62,r_268_31_156,r_331_334_124,r_128_137_62,0.77,64,126,62,12
44,r_354_182_58,seq193,r_188_37_183,r_354_182_58,1.0,0,58,58,12
194,seq193,r_354_182_58,r_333_221_140,r_354_182_58,1.0,0,58,58,12
109,r_119_116_154,seq55,r_207_177_120,r_119_116_154,1.0,0,154,154,12
45,r_134_162_56,r_333_221_140,seq35,r_134_162_56,1.0,0,56,56,12
24,r_1_275_61,seq251,r_71_353_24,r_1_275_61,0.78,0,61,61,12
107,r_178_239_57,r_252_16_176,r_243_153_22,r_252_16_176,1.0,0,176,176,12
11,r_202_169_158,r_229_30_169,r_139_336_120,r_139_336_120,0.48,38,158,120,12
88,r_21_79_22,r_1_275_61,seq272,r_21_79_22,0.8,-1,21,22,12
21,r_277_70_106,r_54_115_97,seq143,r_277_70_106,0.96,0,106,106,12
78,r_211_349_36,r_207_177_120,seq25,r_211_349_36,1.0,0,36,36,12
54,r_89_42_176,r_342_102_91,seq258,r_89_42_176,1.0,0,176,176,12
239,seq337,r_195_145_157,r_231_90_113,r_231_90_113,1.0,1,114,113,12
79,r_252_16_176,seq359,r_178_239_57,r_178_239_57,1.0,2,59,57,12
91,r_269_60_175,r_327_249_159,r_100_338_184,r_327_249_159,0.94,-21,138,159,12
71,r_20_225_133,r_216_69_140,r_231_90_113,r_20_225_133,1.0,0,133,133,12
0,r_264_364_18,r_97_348_34,seq61,r_264_364_18,1.0,0,18,18,12
79,r_252_16_176,r_178_239_57,r_4_200_130,r_252_16_176,0.9,0,176,176,12
59,r_103_217_127,seq265,seq286,r_103_217_127,1.0,0,127,127,12
67,r_366_87_61,seq101,seq166,r_366_87_61,0.53,10,71,61,12
19,r_370_174_179,r_335_350_188,r_327_249_159,r_370_174_179,0.57,0,179,179,12
63,r_215_322_80,r_12_78_88,r_283_91_25,r_12_78_88,0.86,-8,80,88,12
114,r_325_23_199,r_10_86_104,r_71_353_24,r_10_86_104,1.0,-7,97,104,12
80,r_340_165_59,r_269_60_175,r_247_51_43,r_340_165_59,1.0,0,59,59,12
220,seq281,r_202_169_158,r_312_99_15,r_312_99_15,1.0,1,16,15,12
122,r_192_123_87,r_372_43_126,seq126,r_192_123_87,1.0,0,87,87,12
83,r_302_345_146,seq106,seq82,r_302_345_146,0.99,1,147,146,12
56,r_71_353_24,r_89_42_176,r_325_23_199,r_71_353_24,1.0,0,24,24,12
72,r_144_33_178,seq62,r_372_43_126,r_144_33_178,1.0,0,178,178,12
249,seq371,r_52_245_125,seq304,r_52_245_125,1.0,0,125,125,12
194,seq193,r_333_221_140,r_237_197_95,r_237_197_95,1.0,6,101,95,12
28,r_231_90_113,r_7_374_168,r_20_225_133,r_231_90_113,1.0,1,114,113,12
94,r_237_197_95,seq297,seq193,r_237_197_95,1.0,0,95,95,12
60,r_243_153_22,r_206_235_193,seq159,r_243_153_22,0.96,0,22,22,12
85,r_38_290_148,seq6,seq193,r_38_290_148,1.0,0,148,148,12
106,r_321_113_134,r_203_208_72,r_111_121_112,r_321_113_134,1.0,1,135,134,12
77,r_85_77_181,r_206_235_193,r_89_42_176,r_85_77_181,0.56,0,181,181,12
100,r_282_212_22,r_110_191_111,seq143,r_282_212_22,0.85,1,23,22,12
35,r_147_83_155,seq41,seq218,r_147_83_155,0.97,0,155,155,12
31,r_39_248_30,r_167_151_57,r_97_348_34,r_39_248_30,1.0,0,30,30,12
185,seq171,r_207_177_120,seq146,r_207_177_120,1.0,0,120,120,12
23,r_270_67_101,r_252_16_176,r_312_99_15,r_270_67_101,1.0,1,102,101,12
117,r_303_81_197,r_206_235_193,r_139_336_120,r_139_336_120,0.94,29,149,120,12
66,r_268_31_156,r_238_274_96,seq18,r_268_31_156,1.0,0,156,156,12
89,r_365_156_58,seq61,r_312_99_15,r_365_156_58,1.0,1,59,58,12
82,r_199_210_149,r_97_348_34,seq148,r_199_210_149,0.92,0,149,149,12
41,r_247_51_43,r_10_86_104,seq293,r_247_51_43,1.0,0,43,43,12
30,r_189_323_24,seq259,r_326_341_25,r_326_341_25,1.0,18,43,25,12
8,r_167_151_57,r_321_113_134,seq219,r_167_151_57,1.0,1,58,57,12
51,r_238_274_96,r_144_33_178,r_309_305_85,r_144_33_178,0.92,-81,97,178,12
22,r_98_160_67,seq272,r_39_248_30,r_98_160_67,0.98,7,74,67,12
107,r_178_239_57,seq8,r_252_16_176,r_178_239_57,1.0,0,57,57,12
13,r_327_249_159,r_269_60_175,seq8,r_327_249_159,0.99,0,159,159,12
75,r_58_2_109,seq293,r_205_45_31,r_58_2_109,0.54,0,109,109,12
124,r_204_155_103,seq46,r_220_179_199,r_204_155_103,1.0,1,104,103,12
171,seq127,r_246_351_134,r_234_287_57,r_234_287_57,1.0,24,81,57,12
92,r_196_320_177,seq242,r_111_121_112,r_196_320_177,0.9,2,179,177,12
36,r_358_142_65,r_302_345_146,seq271,r_358_142_65,0.98,0,65,65,12
37,r_229_30_169,seq281,r_324_59_22,r_229_30_169,0.99,1,170,169,12
12,r_48_26_25,r_372_43_126,seq149,r_48_26_25,0.77,0,25,25,12
49,r_266_109_158,seq371,seq61,r_266_109_158,1.0,0,158,158,12
64,r_110_191_111,seq149,seq108,r_110_191_111,1.0,1,112,111,12
73,r_316_255_135,seq72,seq304,r_316_255_135,1.0,0,135,135,12
116,r_107_130_48,r_207_177_120,seq175,r_107_130_48,0.97,0,48,48,12
34,r_342_102_91,seq132,r_253_263_10,r_342_102_91,0.94,0,91,91,12
118,r_0_241_107,r_119_116_154,seq40,r_0_241_107,1.0,0,107,107,12
27,r_188_37_183,seq8,r_354_182_58,r_354_182_58,1.0,25,83,58,12
65,r_203_208_72,r_321_113_134,r_250_50_132,r_203_208_72,1.0,63,135,72,12
69,r_49_228_85,r_7_374_168,r_134_162_56,r_7_374_168,0.74,-83,85,168,12
76,r_347_27_69,r_139_336_120,r_96_131_4,r_347_27_69,0.98,0,69,69,12
108,r_112_129_82,seq73,seq106,r_112_129_82,1.0,0,82,82,12
86,r_52_245_125,seq371,seq73,r_52_245_125,1.0,0,125,125,12
18,r_4_200_130,r_318_261_158,seq218,r_4_200_130,1.0,2,132,130,12
106,r_321_113_134,r_183_122_155,r_203_208_72,r_203_208_72,1.0,14,86,72,12
64,r_27_32_62,seq282,r_351_82_35,r_27_32_62,1.0,0,62,62,13
82,r_33_314_198,r_179_350_167,r_286_275_114,r_33_314_198,0.99,-31,167,198,13
109,r_260_139_94,seq38,seq282,r_260_139_94,1.0,0,94,94,13
122,r_127_181_168,r_51_167_172,r_265_26_51,r_127_181_168,1.0,0,168,168,13
85,r_373_205_167,seq42,r_351_82_35,r_373_205_167,0.99,1,168,167,13
50,r_102_364_181,seq352,r_85_73_96,r_102_364_181,0.88,0,181,181,13
26,r_222_3_84,r_281_327_120,r_107_62_26,r_222_3_84,1.0,0,84,84,13
39,r_238_208_91,r_14_204_141,r_107_62_26,r_238_208_91,0.84,5,96,91,13
106,r_239_28_7,r_213_88_85,r_186_338_28,r_213_88_85,0.79,-14,71,85,13
130,seq11,r_134_184_185,r_249_148_95,r_134_184_185,0.57,2,187,185,13
38,r_210_214_72,r_113_61_80,r_157_341_188,r_210_214_72,1.0,0,72,72,13
67,r_126_248_102,seq55,r_249_148_95,r_249_148_95,0.76,1,96,95,13
118,r_297_8_35,seq93,seq307,r_297_8_35,1.0,0,35,35,13
84,r_83_295_89,seq16,r_96_131_56,r_83_295_89,1.0,0,89,89,13
46,r_320_160_25,r_168_110_182,r_116_54_10,r_168_110_182,0.56,-157,25,182,13
44,r_50_276_47,seq34,r_312_224_2,r_50_276_47,1.0,0,47,47,13
56,r_228_137_26,r_85_73_96,r_66_29_92,r_228_137_26,1.0,70,96,26,13
74,r_159_149_88,r_120_267_143,r_118_232_27,r_159_149_88,1.0,0,88,88,13
5,r_156_255_175,seq21,r_75_319_86,r_156_255_175,1.0,0,175,175,13
119,r_236_19_75,r_310_7_118,seq176,r_236_19_75,1.0,1,76,75,13
77,r_229_72_138,r_15_68_193,seq119,r_229_72_138,1.0,0,138,138,13
19,r_182_172_80,r_89_336_194,seq36,r_182_172_80,1.0,0,80,80,13
110,r_245_262_27,seq359,seq55,r_245_262_27,0.93,0,27,27,13
114,r_326_114_197,r_290_187_37,r_107_62_26,r_326_114_197,1.0,-161,36,197,13
89,r_198_80_13,r_50_276_47,seq38,r_198_80_13,1.0,1,14,13,13
59,r_22_202_30,seq36,seq49,r_22_202_30,0.75,1,31,30,13
2,r_116_54_10,r_14_204_141,seq144,r_116_54_10,0.98,0,10,10,13
12,r_75_319_86,seq47,seq230,r_75_319_86,1.0,0,86,86,13
34,r_272_162_29,r_14_204_141,seq91,r_272_162_29,0.86,0,29,29,13
3,r_157_341_188,r_51_167_172,r_210_214_72,r_210_214_72,1.0,2,74,72,13
36,r_134_184_185,seq11,r_296_277_96,r_134_184_185,0.96,2,187,185,13
56,r_228_137_26,r_50_276_47,r_85_73_96,r_228_137_26,1.0,0,26,26,13
22,r_106_348_73,r_155_64_94,r_198_80_13,r_198_80_13,1.0,60,73,13,13
45,r_360_258_22,seq146,seq191,r_360_258_22,0.78,1,23,22,13
21,r_158_53_101,r_10_37_160,r_113_61_80,r_158_53_101,1.0,0,101,101,13
60,r_288_35_29,r_213_88_85,seq191,r_213_88_85,0.76,-54,31,85,13
9,r_66_29_92,seq122,seq42,r_66_29_92,1.0,0,92,92,13
51,r_257_358_179,r_77_109_146,r_304_357_7,r_77_109_146,1.0,7,153,146,13
27,r_265_26_51,r_168_110_182,seq183,r_265_26_51,1.0,0,51,51,13
57,r_56_153_199,r_12_87_123,seq322,r_12_87_123,1.0,0,123,123,13
35,r_190_226_22,r_138_365_155,r_95_44_6,r_190_226_22,1.0,0,22,22,13
1,r_227_112_108,r_103_90_184,r_259_20_188,r_227_112_108,1.0,0,108,108,13
75,r_306_343_62,r_10_37_160,seq165,r_306_343_62,1.0,0,62,62,13
97,r_292_354_166,seq374,seq67,r_292_354_166,1.0,0,166,166,13
241,seq347,r_70_41_124,seq129,r_70_41_124,1.0,0,124,124,13
93,r_70_41_124,seq347,r_190_226_22,r_70_41_124,1.0,0,124,124,13
40,r_98_333_113,seq145,seq99,r_98_333_113,1.0,2,115,113,13
16,r_369_280_151,seq176,r_329_339_50,r_369_280_151,1.0,0,151,151,13
159,seq91,seq39,r_272_162_29,r_272_162_29,1.0,6,35,29,13
11,r_256_371_185,seq40,r_369_280_151,r_256_371_185,1.0,0,185,185,13
81,r_164_241_138,seq59,r_329_339_50,r_164_241_138,1.0,1,139,138,13
111,r_163_166_177,r_104_284_1,r_313_133_183,r_163_166_177,1.0,5,182,177,13
48,r_30_189_133,r_15_68_193,r_239_28_7,r_30_189_133,0.9,3,136,133,13
10,r_24_123_62,r_1_332_96,r_320_160_25,r_1_332_96,0.74,-31,65,96,13
105,r_330_161_173,r_75_319_86,seq17,r_330_161_173,1.0,5,178,173,13
115,r_107_62_26,r_308_366_41,r_326_114_197,r_326_114_197,0.74,-171,26,197,13
83,r_279_200_63,seq57,seq25,r_279_200_63,1.0,0,63,63,13
32,r_362_368_120,seq16,r_238_208_91,r_362_368_120,0.97,3,123,120,13
120,r_111_46_75,r_253_48_127,seq273,r_111_46_75,1.0,1,76,75,13
25,r_155_64_94,r_310_7_118,r_1_332_96,r_155_64_94,1.0,0,94,94,13
71,r_299_264_145,seq266,r_360_258_22,r_299_264_145,1.0,0,145,145,13
117,r_312_224_2,r_14_204_141,r_50_276_47,r_312_224_2,0.88,119,121,2,13
76,r_325_235_161,seq47,seq188,r_325_235_161,1.0,0,161,161,13
108,r_186_338_28,seq176,r_239_28_7,r_186_338_28,1.0,1,29,28,13
6,r_85_73_96,seq335,r_228_137_26,r_228_137_26,0.97,34,60,26,13
90,r_296_277_96,r_227_112_108,r_96_131_56,r_296_277_96,1.0,0,96,96,13
183,seq165,r_362_368_120,r_306_343_62,r_306_343_62,1.0,4,66,62,13
92,r_340_345_163,r_33_314_198,r_252_71_17,r_340_345_163,1.0,0,163,163,13
8,r_281_327_120,seq243,r_195_141_129,r_281_327_120,1.0,0,120,120,13
124,r_351_82_35,r_286_275_114,r_316_128_26,r_286_275_114,0.72,-79,35,114,13
73,r_151_321_73,r_337_136_137,r_259_20_188,r_151_321_73,1.0,0,73,73,13
6,r_85_73_96,r_228_137_26,r_210_214_72,r_85_73_96,1.0,0,96,96,13
232,seq309,r_373_205_167,r_177_323_88,r_177_323_88,1.0,0,88,88,13
54,r_253_48_127,seq0,r_286_275_114,r_286_275_114,1.0,34,148,114,13
62,r_135_334_69,seq117,seq93,r_135_334_69,1.0,2,71,69,13
113,r_1_332_96,seq47,r_155_64_94,r_1_332_96,1.0,0,96,96,13
149,seq55,r_126_248_102,r_245_262_27,r_126_248_102,0.6,-6,96,102,13
116,r_12_87_123,r_56_153_199,r_308_366_41,r_12_87_123,1.0,0,123,123,13
121,r_290_187_37,r_326_114_197,seq122,r_290_187_37,1.0,0,37,37,13
79,r_194_196_12,r_373_205_167,seq9,r_194_196_12,0.93,1,13,12,13
80,r_179_350_167,r_33_314_198,r_263_197_142,r_179_350_167,1.0,0,167,167,13
105,r_330_161_173,r_301_209_91,r_75_319_86,r_330_161_173,1.0,-81,92,173,13
98,r_270_105_35,r_286_275_114,r_304_357_7,r_270_105_35,0.98,0,35,35,13
28,r_308_366_41,seq117,seq298,r_308_366_41,0.88,0,41,41,13
72,r_301_209_91,r_330_161_173,seq78,r_301_209_91,1.0,1,92,91,13
102,r_192_250_59,seq254,r_118_232_27,r_192_250_59,0.98,0,59,59,13
13,r_263_197_142,seq303,r_116_54_10,r_263_197_142,0.56,1,143,142,13
95,r_316_128_26,r_15_68_193,r_351_82_35,r_351_82_35,0.74,14,49,35,13
42,r_108_318_168,seq150,seq93,r_108_318_168,1.0,0,168,168,13
61,r_213_88_85,r_126_248_102,r_236_19_75,r_213_88_85,1.0,0,85,85,13
107,r_51_167_172,seq199,seq97,r_51_167_172,0.98,0,172,172,13
49,r_252_71_17,seq39,seq242,r_252_71_17,0.93,0,17,17,13
29,r_174_81_79,r_168_110_182,seq0,r_174_81_79,0.68,12,91,79,13
201,seq218,r_207_278_137,r_107_62_26,r_207_278_137,1.0,-1,136,137,13
38,r_210_214_72,r_157_341_188,r_85_73_96,r_210_214_72,0.89,102,174,72,13
186,seq176,r_369_280_151,r_213_88_85,r_369_280_151,0.65,0,151,151,13
123,r_294_170_66,r_286_275_114,r_329_339_50,r_329_339_50,0.78,17,67,50,13
87,r_244_69_153,seq289,seq246,r_244_69_153,1.0,0,153,153,13
100,r_249_148_95,r_179_350_167,seq97,r_249_148_95,1.0,0,95,95,13
70,r_177_323_88,r_98_333_113,seq309,r_177_323_88,1.0,0,88,88,13
3,r_157_341_188,r_210_214_72,r_227_112_108,r_227_112_108,0.97,80,188,108,13
20,r_346_142_34,r_168_110_182,r_245_262_27,r_346_142_34,1.0,0,34,34,13
78,r_193_311_51,r_256_371_185,r_107_62_26,r_193_311_51,1.0,-1,50,51,13
94,r_355_225_128,r_195_141_129,seq117,r_355_225_128,1.0,0,128,128,13
51,r_257_358_179,r_304_357_7,r_50_276_47,r_257_358_179,0.69,0,179,179,13
99,r_118_232_27,r_362_368_120,seq94,r_118_232_27,0.8,2,29,27,13
43,r_304_357_7,r_77_109_146,r_270_105_35,r_77_109_146,1.0,7,153,146,13
140,seq36,seq2,r_182_172_80,r_182_172_80,0.72,89,169,80,13
41,r_207_278_137,seq218,r_370_65_57,r_207_278_137,0.97,0,137,137,13
4,r_286_275_114,seq303,seq220,r_286_275_114,0.99,1,115,114,13
103,r_104_284_1,r_163_166_177,r_116_54_10,r_163_166_177,1.0,5,182,177,13
18,r_240_52_84,r_120_267_143,seq178,r_240_52_84,1.0,0,84,84,13
55,r_237_287_102,r_259_20_188,r_297_8_35,r_237_287_102,1.0,0,102,102,13
37,r_10_37_160,seq183,seq42,r_10_37_160,1.0,0,160,160,13
95,r_316_128_26,r_138_365_155,r_15_68_193,r_316_128_26,0.9,0,26,26,13
177,seq145,r_98_333_113,r_195_141_129,r_98_333_113,1.0,4,117,113,13
65,r_171_331_78,seq344,r_279_200_63,r_171_331_78,1.0,0,78,78,13
63,r_76_132_189,seq191,r_286_275_114,r_76_132_189,1.0,0,189,189,13
7,r_77_109_146,r_304_357_7,r_213_88_85,r_77_109_146,0.98,7,153,146,13
15,r_120_267_143,seq271,r_281_327_120,r_120_267_143,1.0,1,144,143,13
86,r_124_302_155,seq242,r_66_29_92,r_124_302_155,0.72,2,157,155,13
88,r_96_131_56,r_134_184_185,seq47,r_96_131_56,1.0,2,58,56,13
148,seq49,r_14_204_141,r_22_202_30,r_14_204_141,1.0,-35,106,141,13
91,r_249_50_155,r_306_292_58,r_244_158_125,r_249_50_155,0.99,0,155,155,14
77,r_368_14_31,r_130_28_159,seq137,r_368_14_31,0.99,3,34,31,14
21,r_371_86_48,r_244_158_125,seq42,r_371_86_48,1.0,0,48,48,14
14,r_263_157_59,seq359,seq174,r_263_157_59,0.86,1,60,59,14
108,r_273_58_161,seq8,r_17_347_121,r_17_347_121,0.89,43,164,121,14
18,r_226_173_2,seq135,r_326_255_172,r_326_255_172,0.82,-6,166,172,14
238,seq340,r_237_298_128,r_284_236_48,r_237_298_128,0.69,18,146,128,14
70,r_161_49_90,r_342_208_176,seq68,r_161_49_90,0.99,0,90,90,14
74,r_146_75_84,r_163_367_95,seq287,r_163_367_95,0.61,-7,88,95,14
86,r_372_36_181,seq314,seq294,r_372_36_181,0.99,0,181,181,14
29,r_310_102_122,r_201_369_170,r_284_236_48,r_310_102_122,1.0,-1,121,122,14
33,r_144_302_199,r_222_275_163,r_134_305_81,r_222_275_163,0.64,0,163,163,14
102,r_209_69_139,seq313,r_146_75_84,r_209_69_139,0.96,0,139,139,14
188,seq177,r_72_47_175,r_129_285_24,r_72_47_175,1.0,0,175,175,14
113,r_337_338_130,r_26_11_194,r_221_193_153,r_26_11_194,0.65,-4,190,194,14
47,r_138_180_73,r_365_329_117,r_198_13_160,r_138_180_73,1.0,0,73,73,14
35,r_306_292_58,r_351_344_87,r_249_50_155,r_306_292_58,1.0,1,59,58,14
32,r_326_255_172,seq243,r_226_173_2,r_326_255_172,0.96,0,172,172,14
117,r_118_266_66,r_29_295_187,seq33,r_118_266_66,1.0,0,66,66,14
118,r_206_253_190,r_35_103_161,r_365_329_117,r_206_253_190,0.95,-29,161,190,14
56,r_260_114_49,r_274_270_58,seq92,r_260_114_49,0.73,3,52,49,14
35,r_306_292_58,r_249_50_155,r_221_193_153,r_249_50_155,0.9,0,155,155,14
115,r_172_128_80,r_191_276_20,r_202_59_16,r_172_128_80,1.0,0,80,80,14
92,r_198_13_160,r_96_10_184,r_185_155_66,r_198_13_160,1.0,0,160,160,14
30,r_210_142_173,r_127_355_128,r_254_251_139,r_210_142_173,0.99,-34,139,173,14
192,seq189,r_254_251_139,r_284_236_48,r_254_251_139,1.0,2,141,139,14
88,r_82_312_75,r_231_333_179,seq194,r_82_312_75,1.0,0,75,75,14
9,r_200_268_2,r_151_78_149,seq71,r_151_78_149,1.0,0,149,149,14
138,seq42,r_29_295_187,r_221_193_153,r_29_295_187,1.0,0,187,187,14
126,seq4,seq117,r_262_235_64,r_262_235_64,0.64,8,72,64,14
46,r_93_27_141,r_289_101_185,seq136,r_93_27_141,1.0,0,141,141,14
185,seq165,r_17_347_121,r_77_15_45,r_17_347_121,1.0,0,121,121,14
184,seq164,r_171_39_182,r_17_347_121,r_171_39_182,0.48,1,183,182,14
51,r_185_155_66,r_60_212_151,seq186,r_185_155_66,1.0,0,66,66,14
54,r_110_245_98,seq297,seq33,r_110_245_98,1.0,3,101,98,14
123,r_96_10_184,r_198_13_160,r_138_180_73,r_198_13_160,0.99,0,160,160,14
55,r_176_40_27,r_372_36_181,seq115,r_176_40_27,0.89,0,27,27,14
52,r_321_267_108,r_310_102_122,r_341_54_5,r_310_102_122,0.94,-14,108,122,14
62,r_108_3_68,r_17_347_121,seq252,r_108_3_68,0.98,0,68,68,14
122,r_204_360_171,r_198_13_160,r_163_367_95,r_204_360_171,0.91,-20,151,171,14
173,seq137,seq309,r_368_14_31,r_368_14_31,0.69,43,74,31,14
199,seq218,seq287,r_84_259_77,r_84_259_77,1.0,1,78,77,14
28,r_183_332_20,r_274_270_58,r_341_54_5,r_183_332_20,0.97,0,20,20,14
90,r_169_150_62,seq149,seq373,r_169_150_62,1.0,0,62,62,14
107,r_291_239_91,seq117,r_232_45_82,r_291_239_91,1.0,2,93,91,14
81,r_254_251_139,seq189,seq105,r_254_251_139,1.0,0,139,139,14
36,r_30_256_164,seq165,r_207_175_37,r_30_256_164,1.0,0,164,164,14
123,r_96_10_184,r_138_180_73,r_30_256_164,r_96_10_184,0.96,0,184,184,14
44,r_348_299_84,r_221_193_153,r_331_334_66,r_348_299_84,1.0,0,84,84,14
25,r_70_327_166,r_363_320_46,r_343_79_9,r_70_327_166,1.0,1,167,166,14
142,seq57,seq123,r_331_334_66,r_331_334_66,1.0,21,87,66,14
79,r_107_216_24,r_37_356_44,seq139,r_107_216_24,0.56,0,24,24,14
76,r_152_227_32,r_19_0_150,seq240,r_152_227_32,0.84,2,34,32,14
30,r_210_142_173,r_254_251_139,seq41,r_210_142_173,1.0,-1,172,173,14
16,r_231_333_179,seq132,r_70_327_166,r_231_333_179,0.69,0,179,179,14
13,r_83_113_60,r_238_23_113,seq199,r_83_113_60,0.91,0,60,60,14
82,r_341_54_5,r_81_187_45,r_183_332_20,r_341_54_5,0.74,40,45,5,14
6,r_111_308_182,r_304_324_188,r_226_173_2,r_111_308_182,1.0,0,182,182,14
37,r_351_344_87,r_316_121_145,seq213,r_351_344_87,0.56,7,94,87,14
109,r_237_298_128,seq340,r_226_173_2,r_237_298_128,0.96,2,130,128,14
45,r_156_122_79,r_22_317_157,seq145,r_22_317_157,0.77,-78,79,157,14
47,r_138_180_73,r_198_13_160,r_238_23_113,r_198_13_160,0.63,-9,151,160,14
72,r_100_179_54,seq53,seq248,r_100_179_54,1.0,0,54,54,14
1,r_284_236_48,r_163_367_95,seq80,r_163_367_95,0.86,-47,48,95,14
118,r_206_253_190,r_365_329_117,r_171_39_182,r_206_253_190,0.89,0,190,190,14
74,r_146_75_84,seq287,r_209_69_139,r_209_69_139,0.94,-6,133,139,14
5,r_304_324_188,r_111_308_182,r_274_270_58,r_111_308_182,0.95,0,182,182,14
228,seq311,r_221_193_153,r_316_121_145,r_316_121_145,1.0,8,153,145,14
39,r_97_353_112,r_330_167_168,seq131,r_97_353_112,0.99,1,113,112,14
11,r_290_24_44,r_144_302_199,seq148,r_290_24_44,0.91,0,44,44,14
147,seq71,r_65_217_93,r_371_86_48,r_65_217_93,0.71,1,94,93,14
174,seq139,r_225_300_137,r_107_216_24,r_107_216_24,0.94,64,88,24,14
57,r_225_300_137,seq139,r_108_3_68,r_108_3_68,0.84,75,143,68,14
112,r_116_203_156,seq322,r_290_24_44,r_116_203_156,0.92,1,157,156,14
23,r_46_223_45,r_225_300_137,seq233,r_46_223_45,1.0,1,46,45,14
59,r_65_217_93,seq71,seq250,r_65_217_93,1.0,0,93,93,14
94,r_56_63_156,r_342_208_176,r_348_299_84,r_56_63_156,0.99,4,160,156,14
121,r_60_212_151,seq18,r_225_300_137,r_60_212_151,1.0,1,152,151,14
89,r_331_334_66,r_111_308_182,seq57,r_331_334_66,1.0,0,66,66,14
15,r_258_119_174,seq33,r_254_251_139,r_258_119_174,0.95,0,174,174,14
120,r_2_303_152,r_222_275_163,r_365_329_117,r_2_303_152,1.0,0,152,152,14
103,r_178_220_58,r_130_28_159,r_271_335_2,r_178_220_58,1.0,0,58,58,14
124,r_129_285_24,seq33,seq177,r_129_285_24,0.96,0,24,24,14
83,r_190_21_130,seq74,seq293,r_190_21_130,1.0,1,131,130,14
91,r_249_50_155,r_229_257_93,r_306_292_58,r_249_50_155,0.66,-62,93,155,14
27,r_342_208_176,seq80,r_371_86_48,r_342_208_176,0.79,0,176,176,14
98,r_196_133_27,r_274_270_58,seq98,r_196_133_27,0.91,0,27,27,14
4,r_221_193_153,seq311,r_306_292_58,r_306_292_58,0.95,95,153,58,14
22,r_151_78_149,r_200_268_2,r_196_133_27,r_151_78_149,1.0,0,149,149,14
116,r_232_45_82,r_310_102_122,seq279,r_232_45_82,1.0,0,82,82,14
135,seq34,r_6_272_3,r_182_195_23,r_182_195_23,1.0,-2,21,23,14
7,r_35_103_161,r_206_253_190,seq74,r_35_103_161,0.94,0,161,161,14
34,r_191_276_20,seq149,r_307_12_103,r_307_12_103,1.0,5,108,103,14
64,r_238_23_113,seq115,r_138_180_73,r_238_23_113,0.99,0,113,113,14
113,r_337_338_130,r_127_355_128,r_26_11_194,r_337_338_130,1.0,0,130,130,14
97,r_168_354_121,r_130_28_159,r_343_79_9,r_168_354_121,0.98,0,121,121,14
61,r_22_317_157,seq141,r_65_217_93,r_22_317_157,1.0,3,160,157,14
26,r_229_257_93,r_249_50_155,seq301,r_229_257_93,1.0,0,93,93,14
63,r_134_305_81,r_70_327_166,r_144_302_199,r_134_305_81,0.97,7,88,81,14
42,r_19_0_150,seq170,r_371_86_48,r_19_0_150,0.86,2,152,150,14
106,r_26_11_194,seq71,r_337_338_130,r_337_338_130,1.0,7,137,130,14
12,r_37_356_44,r_151_78_149,seq286,r_37_356_44,0.96,0,44,44,14
34,r_191_276_20,r_172_128_80,seq149,r_172_128_80,0.69,-20,60,80,14
60,r_72_47_175,seq177,r_374_66_80,r_72_47_175,1.0,0,175,175,14
69,r_330_167_168,r_72_47_175,r_304_324_188,r_330_167_168,1.0,1,169,168,14
50,r_162_269_86,r_35_103_161,r_182_195_23,r_162_269_86,1.0,2,88,86,14
2,r_211_228_52,seq340,seq297,r_211_228_52,0.99,0,52,52,14
0,r_171_39_182,seq164,r_163_367_95,r_171_39_182,0.82,0,182,182,14
58,r_222_275_163,r_2_303_152,r_176_40_27,r_222_275_163,0.7,-10,153,163,14
40,r_85_247_121,r_342_208_176,r_262_235_64,r_85_247_121,0.66,0,121,121,14
234,seq322,r_116_203_156,r_81_187_45,r_116_203_156,0.85,-24,132,156,14
101,r_109_126_159,r_363_320_46,r_371_86_48,r_109_126_159,1.0,0,159,159,14
19,r_163_367_95,r_289_101_185,r_169_150_62,r_289_101_185,0.76,-90,95,185,14
8,r_274_270_58,r_351_344_87,r_290_24_44,r_274_270_58,0.91,0,58,58,14
87,r_84_259_77,r_351_344_87,seq218,r_84_259_77,0.96,0,77,77,14
20,r_17_347_121,seq165,seq278,r_17_347_121,1.0,0,121,121,14
99,r_147_366_116,r_342_208_176,seq294,r_342_208_176,0.62,-56,120,176,14
122,r_204_360_171,r_163_367_95,r_97_353_112,r_204_360_171,0.97,0,171,171,14
17,r_182_195_23,seq370,seq34,r_182_195_23,0.91,3,26,23,14
3,r_244_158_125,r_342_208_176,seq53,r_244_158_125,1.0,0,125,125,14
95,r_316_121_145,seq62,seq18,r_316_121_145,1.0,0,145,145,14
68,r_127_355_128,r_337_338_130,seq346,r_127_355_128,1.0,2,130,128,14
80,r_262_235_64,seq1,seq4,r_262_235_64,0.91,3,67,64,14
119,r_51_242_68,seq286,r_341_54_5,r_51_242_68,1.0,0,68,68,14
100,r_81_187_45,r_341_54_5,seq322,r_81_187_45,0.61,0,45,45,14
75,r_77_15_45,seq294,seq165,r_77_15_45,0.98,0,45,45,14
84,r_307_12_103,seq136,r_191_276_20,r_307_12_103,0.98,1,104,103,14
31,r_289_101_185,r_166_48_189,r_183_332_20,r_289_101_185,0.95,2,187,185,14
48,r_192_325_32,r_100_179_54,r_264_219_9,r_192_325_32,0.61,0,32,32,14
114,r_124_358_47,seq248,seq1,r_124_358_47,1.0,0,47,47,14
85,r_31_214_165,seq25,r_321_267_108,r_31_214_165,0.68,1,166,165,14
78,r_202_59_16,r_129_285_24,seq91,r_202_59_16,0.75,0,16,16,14
38,r_207_175_37,seq7,r_368_14_31,r_207_175_37,0.82,4,41,37,14
53,r_365_329_117,seq105,r_161_49_90,r_365_329_117,1.0,2,119,117,14
104,r_374_66_80,r_225_300_137,seq41,r_374_66_80,1.0,2,82,80,14
179,seq149,r_169_150_62,r_191_276_20,r_169_150_62,1.0,0,62,62,14
93,r_130_28_159,seq91,seq140,r_130_28_159,1.0,1,160,159,14
110,r_29_295_187,seq42,seq170,r_29_295_187,1.0,0,187,187,14
65,r_352_55_54,r_17_347_121,seq43,r_352_55_54,1.0,1,55,54,14
36,r_312_248_90,r_143_16_105,seq9,r_312_248_90,1.0,0,90,90,15
67,r_143_16_105,r_312_248_90,r_244_228_74,r_143_16_105,0.93,-22,83,105,15
12,r_7_148_54,r_91_366_167,seq44,r_7_148_54,0.96,3,57,54,15
54,r_372_335_45,r_240_211_66,r_300_306_13,r_300_306_13,0.62,32,45,13,15
23,r_73_183_28,r_68_203_145,seq313,r_73_183_28,1.0,0,28,28,15
86,r_206_373_37,r_318_120_2,seq224,r_206_373_37,0.96,3,40,37,15
50,r_280_176_104,r_131_223_194,r_225_208_27,r_280_176_104,1.0,0,104,104,15
29,r_226_63_86,seq34,r_188_319_78,r_226_63_86,1.0,0,86,86,15
43,r_28_129_73,seq86,seq98,r_28_129_73,1.0,-1,72,73,15
67,r_143_16_105,r_244_228_74,seq30,r_143_16_105,0.68,3,108,105,15
0,r_259_165_173,seq25,seq107,r_259_165_173,1.0,0,173,173,15
116,r_243_192_32,r_205_29_103,seq57,r_243_192_32,1.0,0,32,32,15
2,r_205_29_103,r_49_336_120,seq95,r_205_29_103,1.0,0,103,103,15
69,r_19_172_54,seq50,seq268,r_19_172_54,1.0,0,54,54,15
38,r_221_343_47,r_85_371_153,seq35,r_221_343_47,1.0,1,48,47,15
61,r_358_296_69,seq17,seq53,r_358_296_69,1.0,0,69,69,15
93,r_70_93_40,r_304_187_117,r_84_298_31,r_70_93_40,1.0,9,49,40,15
85,r_329_130_83,r_131_223_194,seq167,r_329_130_83,1.0,0,83,83,15
227,seq317,r_156_89_176,seq173,r_156_89_176,1.0,1,177,176,15
11,r_85_371_153,seq275,seq293,r_85_371_153,0.97,0,153,153,15
70,r_337_108_14,r_143_16_105,seq83,r_337_108_14,0.88,0,14,14,15
39,r_31_247_9,seq123,r_158_370_94,r_158_370_94,0.96,-7,87,94,15
42,r_209_368_80,r_318_120_2,r_253_200_36,r_209_368_80,1.0,4,84,80,15
88,r_233_227_185,r_252_308_187,seq69,r_233_227_185,1.0,0,185,185,15
75,r_5_199_96,seq197,seq179,r_5_199_96,1.0,0,96,96,15
106,r_162_134_115,r_124_58_8,r_150_242_113,r_162_134_115,1.0,0,115,115,15
17,r_311_290_162,seq322,seq269,r_311_290_162,1.0,1,163,162,15
95,r_67_213_161,seq103,r_318_120_2,r_67_213_161,1.0,0,161,161,15
62,r_87_62_14,r_67_213_161,seq346,r_87_62_14,0.88,0,14,14,15
94,r_138_330_45,seq44,seq69,r_138_330_45,1.0,5,50,45,15
49,r_234_291_111,r_190_316_178,r_177_166_51,r_234_291_111,1.0,0,111,111,15
84,r_295_320_118,seq182,r_78_263_154,r_295_320_118,1.0,0,118,118,15
6,r_348_76_147,r_345_8_187,r_87_62_14,r_348_76_147,1.0,4,151,147,15
74,r_254_160_39,r_294_207_177,seq101,r_254_160_39,1.0,0,39,39,15
83,r_286_352_155,r_294_207_177,r_22_278_62,r_286_352_155,1.0,0,155,155,15
63,r_225_208_27,r_72_61_118,seq123,r_72_61_118,0.81,-91,27,118,15
208,seq258,seq346,r_219_284_87,r_219_284_87,1.0,0,87,87,15
96,r_193_249_153,r_140_110_85,r_226_63_86,r_193_249_153,1.0,0,153,153,15
113,r_47_302_176,r_23_151_71,r_209_368_80,r_23_151_71,0.81,1,72,71,15
66,r_149_241_83,seq112,seq18,r_149_241_83,1.0,0,83,83,15
73,r_361_145_131,seq331,r_363_40_100,r_361_145_131,1.0,3,134,131,15
21,r_150_242_113,seq18,r_162_134_115,r_162_134_115,1.0,1,116,115,15
41,r_324_301_63,r_280_176_104,seq55,r_280_176_104,1.0,-18,86,104,15
35,r_321_175_170,seq27,r_177_166_51,r_321_175_170,1.0,0,170,170,15
232,seq331,r_361_145_131,seq51,r_361_145_131,1.0,3,134,131,15
56,r_52_185_99,r_282_142_177,r_124_58_8,r_52_185_99,1.0,0,99,99,15
87,r_239_147_148,r_233_227_185,r_333_3_35,r_239_147_148,0.74,9,157,148,15
18,r_164_327_22,seq38,seq157,r_164_327_22,0.99,0,22,22,15
7,r_276_271_97,seq98,r_149_241_83,r_149_241_83,0.95,14,97,83,15
113,r_47_302_176,r_209_368_80,r_363_40_100,r_47_302_176,0.98,-71,105,176,15
28,r_190_316_178,r_143_16_105,r_276_271_97,r_190_316_178,0.92,0,178,178,15
109,r_124_58_8,r_162_134_115,r_52_185_99,r_124_58_8,1.0,107,115,8,15
107,r_253_200_36,r_201_250_168,r_209_368_80,r_253_200_36,0.8,54,90,36,15
100,r_219_284_87,r_150_242_113,seq258,r_219_284_87,0.99,0,87,87,15
131,seq18,r_219_284_87,r_149_241_83,r_149_241_83,1.0,4,87,83,15
72,r_23_151_71,r_47_302_176,seq122,r_23_151_71,1.0,0,71,71,15
14,r_232_79_160,seq351,r_164_327_22,r_232_79_160,1.0,-1,159,160,15
91,r_12_128_99,r_321_175_170,r_49_336_120,r_49_336_120,0.5,3,123,120,15
53,r_272_256_134,seq86,seq182,r_272_256_134,1.0,0,134,134,15
31,r_48_13_14,r_52_185_99,r_239_147_148,r_48_13_14,1.0,0,14,14,15
108,r_10_114_153,r_321_175_170,r_229_270_12,r_10_114_153,1.0,0,153,153,15
55,r_90_94_120,seq77,seq267,r_90_94_120,1.0,-1,119,120,15
27,r_125_4_187,r_318_120_2,r_265_121_113,r_125_4_187,0.83,0,187,187,15
117,r_37_135_124,r_282_142_177,seq169,r_37_135_124,0.72,0,124,124,15
111,r_292_104_44,r_252_308_187,r_212_255_9,r_292_104_44,1.0,1,45,44,15
60,r_68_203_145,seq170,r_72_61_118,r_72_61_118,0.99,27,145,118,15
96,r_193_249_153,r_282_142_177,r_140_110_85,r_140_110_85,1.0,8,93,85,15
123,r_91_366_167,seq2,r_356_365_8,r_91_366_167,1.0,0,167,167,15
8,r_133_251_145,seq33,r_78_263_154,r_133_251_145,1.0,0,145,145,15
107,r_253_200_36,r_102_374_197,r_201_250_168,r_253_200_36,1.0,0,36,36,15
3,r_262_14_122,seq267,r_143_16_105,r_262_14_122,1.0,0,122,122,15
118,r_252_308_187,seq39,r_150_242_113,r_252_308_187,0.79,0,187,187,15
10,r_304_187_117,seq141,r_6_109_7,r_304_187_117,1.0,-1,116,117,15
80,r_49_336_120,seq64,r_12_128_99,r_49_336_120,0.76,0,120,120,15
91,r_12_128_99,seq9,r_321_175_170,r_12_128_99,0.94,0,99,99,15
105,r_210_132_28,r_358_296_69,seq1,r_210_132_28,0.99,0,28,28,15
52,r_74_115_182,seq1,r_117_367_15,r_74_115_182,1.0,2,184,182,15
64,r_168_184_28,r_303_354_184,seq38,r_168_184_28,1.0,0,28,28,15
22,r_216_325_77,r_140_110_85,r_164_327_22,r_164_327_22,0.81,55,77,22,15
24,r_177_166_51,r_312_248_90,seq1,r_177_166_51,1.0,0,51,51,15
31,r_48_13_14,r_239_147_148,r_181_99_34,r_48_13_14,0.53,143,157,14,15
102,r_310_195_43,seq18,seq25,r_310_195_43,0.95,3,46,43,15
112,r_24_66_28,r_282_142_177,seq173,r_282_142_177,1.0,0,177,177,15
67,r_143_16_105,seq30,r_262_14_122,r_262_14_122,0.66,22,144,122,15
57,r_36_266_106,r_315_307_126,seq98,r_36_266_106,1.0,0,106,106,15
103,r_305_26_115,seq101,r_280_176_104,r_305_26_115,1.0,0,115,115,15
173,seq122,r_264_163_175,r_23_151_71,r_264_163_175,0.94,0,175,175,15
37,r_81_217_177,seq167,r_177_166_51,r_81_217_177,1.0,0,177,177,15
207,seq246,r_282_142_177,seq173,r_282_142_177,0.98,-59,118,177,15
48,r_21_15_79,r_74_115_182,r_7_148_54,r_74_115_182,0.77,-102,80,182,15
81,r_244_228_74,seq146,r_212_255_9,r_244_228_74,1.0,1,75,74,15
99,r_22_278_62,seq80,r_78_263_154,r_22_278_62,1.0,-1,61,62,15
44,r_96_189_140,seq344,seq50,r_96_189_140,1.0,0,140,140,15
101,r_88_204_123,r_333_3_35,r_226_63_86,r_88_204_123,0.94,0,123,123,15
9,r_156_89_176,seq317,r_226_63_86,r_156_89_176,1.0,1,177,176,15
112,r_24_66_28,r_303_354_184,r_282_142_177,r_24_66_28,1.0,0,28,28,15
89,r_139_111_31,r_304_187_117,seq2,r_139_111_31,1.0,0,31,31,15
19,r_282_142_177,seq246,r_28_129_73,r_282_142_177,1.0,0,177,177,15
79,r_82_309_46,r_303_354_184,seq342,r_82_309_46,1.0,0,46,46,15
240,seq344,r_96_189_140,seq107,r_96_189_140,1.0,-1,139,140,15
16,r_72_61_118,seq2,r_244_228_74,r_72_61_118,1.0,0,118,118,15
115,r_201_250_168,seq293,r_312_248_90,r_201_250_168,0.99,0,168,168,15
34,r_212_255_9,seq69,r_292_104_44,r_292_104_44,1.0,4,48,44,15
81,r_244_228_74,r_212_255_9,r_72_61_118,r_72_61_118,1.0,6,124,118,15
163,seq101,r_305_26_115,r_254_160_39,r_305_26_115,0.77,-1,114,115,15
25,r_140_110_85,r_81_217_177,r_193_249_153,r_140_110_85,1.0,0,85,85,15
25,r_140_110_85,r_193_249_153,r_363_40_100,r_193_249_153,1.0,0,153,153,15
168,seq112,r_149_241_83,r_356_365_8,r_149_241_83,1.0,0,83,83,15
124,r_117_367_15,r_181_99_34,seq174,r_181_99_34,0.69,-19,15,34,15
32,r_158_370_94,r_90_94_120,r_31_247_9,r_158_370_94,0.53,0,94,94,15
78,r_84_298_31,r_226_63_86,seq186,r_84_298_31,1.0,0,31,31,15
97,r_345_8_187,seq169,r_221_343_47,r_345_8_187,0.98,0,187,187,15
120,r_196_257_184,seq116,r_262_14_122,r_196_257_184,1.0,0,184,184,15
136,seq34,r_226_63_86,seq11,r_226_63_86,1.0,-1,85,86,15
203,seq224,seq119,r_206_373_37,r_206_373_37,0.97,21,58,37,15
15,r_215_32_172,seq46,r_356_365_8,r_215_32_172,1.0,0,172,172,15
114,r_240_211_66,r_201_250_168,seq197,r_240_211_66,1.0,1,67,66,15
28,r_190_316_178,r_234_291_111,r_143_16_105,r_234_291_111,0.49,0,111,111,15
113,r_47_302_176,r_363_40_100,r_259_165_173,r_47_302_176,0.94,-1,175,176,15
114,r_93_109_57,r_347_171_141,r_238_342_20,r_93_109_57,1.0,0,57,57,16
5,r_297_214_108,seq282,r_197_208_45,r_297_214_108,0.98,2,110,108,16
17,r_23_83_64,seq276,seq216,r_23_83_64,1.0,2,66,64,16
15,r_97_271_179,seq174,r_98_284_50,r_97_271_179,0.96,0,179,179,16
23,r_261_371_161,seq298,seq276,r_261_371_161,0.69,11,172,161,16
20,r_226_308_148,seq278,seq100,r_226_308_148,1.0,0,148,148,16
93,r_229_176_114,r_220_289_180,seq174,r_229_176_114,1.0,0,114,114,16
120,r_185_327_177,seq170,r_219_160_76,r_185_327_177,0.95,0,177,177,16
196,seq233,seq282,r_69_3_125,r_69_3_125,0.99,22,147,125,16
35,r_353_74_20,r_297_214_108,seq129,r_353_74_20,1.0,0,20,20,16
41,r_134_77_182,r_202_11_150,r_290_343_99,r_134_77_182,1.0,-32,150,182,16
77,r_182_94_163,seq272,r_258_263_157,r_182_94_163,1.0,1,164,163,16
42,r_290_343_99,r_156_325_163,r_172_198_40,r_290_343_99,0.99,1,100,99,16
82,r_328_183_111,seq85,r_87_26_52,r_328_183_111,1.0,0,111,111,16
45,r_149_192_172,r_55_78_195,r_17_255_155,r_149_192_172,0.61,0,172,172,16
36,r_345_4_114,r_37_317_170,seq91,r_345_4_114,1.0,0,114,114,16
53,r_348_136_68,r_164_311_191,r_243_34_65,r_164_311_191,1.0,-123,68,191,16
100,r_126_92_14,r_258_263_157,r_373_27_118,r_126_92_14,0.64,105,119,14,16
85,r_155_30_13,r_123_140_61,seq210,r_155_30_13,0.99,0,13,13,16
200,seq237,r_105_331_2,r_14_242_12,r_14_242_12,1.0,9,21,12,16
109,r_254_19_166,seq319,r_202_11_150,r_254_19_166,0.97,0,166,166,16
56,r_260_201_52,seq350,seq89,r_260_201_52,1.0,0,52,52,16
14,r_262_72_103,seq253,seq51,r_262_72_103,0.92,1,104,103,16
10,r_219_160_76,r_261_371_161,seq42,r_219_160_76,1.0,0,76,76,16
41,r_134_77_182,r_290_343_99,r_28_292_119,r_134_77_182,0.82,0,182,182,16
118,r_24_12_139,seq64,seq366,r_24_12_139,1.0,0,139,139,16
204,seq249,seq56,r_340_127_79,r_340_127_79,1.0,19,98,79,16
55,r_203_29_108,seq47,r_205_188_34,r_203_29_108,0.96,1,109,108,16
75,r_148_118_114,r_280_33_125,r_290_343_99,r_148_118_114,0.99,0,114,114,16
43,r_202_11_150,r_134_77_182,r_203_29_108,r_202_11_150,0.92,0,150,150,16
39,r_369_227_102,seq42,r_238_342_20,r_369_227_102,1.0,1,103,102,16
38,r_220_289_180,seq65,r_168_277_1,r_220_289_180,1.0,0,180,180,16
27,r_206_223_96,r_103_116_145,seq163,r_206_223_96,1.0,0,96,96,16
74,r_218_135_187,seq268,r_138_364_73,r_218_135_187,0.98,0,187,187,16
213,seq276,r_23_83_64,r_261_371_161,r_23_83_64,1.0,2,66,64,16
107,r_32_161_54,r_69_3_125,seq314,r_32_161_54,1.0,0,54,54,16
119,r_69_3_125,seq222,r_23_83_64,r_69_3_125,1.0,0,125,125,16
61,r_28_292_119,seq36,seq298,r_28_292_119,1.0,0,119,119,16
103,r_54_62_41,r_139_221_121,seq247,r_54_62_41,0.76,3,44,41,16
2,r_70_142_147,r_244_239_162,seq35,r_244_239_162,1.0,-7,155,162,16
44,r_6_63_119,seq274,seq279,r_6_63_119,1.0,1,120,119,16
106,r_166_246_137,r_340_127_79,r_70_142_147,r_166_246_137,0.88,15,152,137,16
4,r_252_212_37,r_158_335_140,seq65,r_252_212_37,0.99,4,41,37,16
78,r_37_317_170,seq36,r_6_63_119,r_37_317_170,0.98,0,170,170,16
65,r_280_33_125,seq150,r_98_284_50,r_280_33_125,0.88,3,128,125,16
230,seq319,r_172_198_40,r_14_242_12,r_172_198_40,0.83,3,43,40,16
212,seq274,r_6_63_119,r_204_120_107,r_6_63_119,0.94,1,120,119,16
1,r_17_255_155,r_121_257_162,r_199_309_38,r_17_255_155,1.0,0,155,155,16
46,r_224_370_128,r_102_225_132,seq81,r_224_370_128,1.0,0,128,128,16
8,r_102_225_132,r_224_370_128,seq186,r_102_225_132,1.0,2,134,132,16
25,r_123_140_61,r_53_137_64,seq222,r_123_140_61,0.93,1,62,61,16
111,r_46_128_41,seq49,seq274,r_46_128_41,1.0,1,42,41,16
64,r_300_22_107,seq1,seq268,r_300_22_107,1.0,0,107,107,16
79,r_173_5_179,seq36,seq145,r_173_5_179,0.93,0,179,179,16
9,r_138_364_73,r_328_183_111,seq48,r_138_364_73,0.77,0,73,73,16
16,r_144_187_122,r_280_33_125,r_107_287_148,r_144_187_122,1.0,5,127,122,16
122,r_25_15_30,r_168_277_1,seq90,r_25_15_30,1.0,1,31,30,16
87,r_281_147_147,seq189,r_296_231_101,r_281_147_147,1.0,0,147,147,16
28,r_168_277_1,seq324,r_251_40_163,r_251_40_163,0.97,8,171,163,16
123,r_82_330_112,seq79,seq282,r_82_330_112,1.0,0,112,112,16
90,r_321_61_59,r_23_83_64,seq90,r_321_61_59,1.0,0,59,59,16
124,r_156_325_163,seq216,r_219_160_76,r_156_325_163,1.0,1,164,163,16
0,r_258_263_157,seq145,seq125,r_258_263_157,1.0,2,159,157,16
29,r_204_120_107,r_280_33_125,r_46_128_41,r_204_120_107,0.8,5,112,107,16
106,r_166_246_137,seq56,r_340_127_79,r_340_127_79,1.0,16,95,79,16
80,r_199_309_38,seq170,r_17_255_155,r_17_255_155,1.0,1,156,155,16
54,r_153_312_26,r_345_4_114,r_86_329_1,r_153_312_26,1.0,0,26,26,16
89,r_87_26_52,seq50,r_139_221_121,r_87_26_52,1.0,0,52,52,16
102,r_334_217_106,seq268,r_73_159_70,r_334_217_106,1.0,1,107,106,16
151,seq90,r_75_20_3,r_25_15_30,r_25_15_30,1.0,4,34,30,16
69,r_53_137_64,r_179_57_84,r_87_26_52,r_179_57_84,0.99,-19,65,84,16
3,r_76_165_97,seq1,seq79,r_76_165_97,0.99,1,98,97,16
81,r_179_57_84,seq207,r_138_364_73,r_179_57_84,1.0,3,87,84,16
50,r_193_306_105,r_149_192_172,seq174,r_193_306_105,1.0,0,105,105,16
192,seq216,r_156_325_163,r_23_83_64,r_156_325_163,0.8,-15,148,163,16
12,r_41_302_137,seq59,r_138_364_73,r_41_302_137,0.92,6,143,137,16
100,r_126_92_14,r_32_161_54,r_258_263_157,r_126_92_14,1.0,0,14,14,16
73,r_243_34_65,seq56,seq207,r_243_34_65,1.0,0,65,65,16
144,seq65,r_220_289_180,r_252_212_37,r_220_289_180,0.99,0,180,180,16
22,r_349_363_49,r_87_26_52,r_355_241_24,r_349_363_49,1.0,0,49,49,16
83,r_213_16_163,seq274,r_138_364_73,r_213_16_163,0.94,1,164,163,16
171,seq150,r_280_33_125,r_106_211_21,r_280_33_125,1.0,3,128,125,16
105,r_184_10_85,seq113,seq346,r_184_10_85,1.0,0,85,85,16
84,r_244_239_162,seq313,r_102_225_132,r_244_239_162,1.0,0,162,162,16
169,seq145,r_258_263_157,r_126_92_14,r_258_263_157,1.0,2,159,157,16
88,r_80_374_156,seq91,seq56,r_80_374_156,0.99,0,156,156,16
70,r_296_231_101,r_58_31_161,r_119_339_78,r_296_231_101,0.96,0,101,101,16
110,r_373_27_118,r_144_187_122,r_126_92_14,r_126_92_14,1.0,105,119,14,16
24,r_101_283_156,seq124,seq194,r_101_283_156,1.0,0,156,156,16
48,r_251_40_163,seq279,r_168_277_1,r_251_40_163,1.0,1,164,163,16
57,r_341_240_131,r_347_171_141,r_105_331_2,r_341_240_131,0.97,0,131,131,16
59,r_355_241_24,r_23_83_64,seq85,r_355_241_24,0.95,1,25,24,16
33,r_14_242_12,r_206_223_96,seq319,r_14_242_12,0.99,0,12,12,16
121,r_38_232_21,r_106_211_21,seq313,r_38_232_21,1.0,0,21,21,16
30,r_362_2_48,r_55_78_195,r_25_15_30,r_362_2_48,1.0,0,48,48,16
37,r_158_335_140,seq318,seq88,r_158_335_140,1.0,0,140,140,16
47,r_121_257_162,seq141,r_219_160_76,r_121_257_162,1.0,0,162,162,16
52,r_162_259_159,seq295,seq146,r_162_259_159,0.99,0,159,159,16
94,r_238_342_20,r_75_20_3,seq196,r_238_342_20,1.0,0,20,20,16
115,r_71_250_100,r_58_31_161,seq141,r_71_250_100,1.0,1,101,100,16
101,r_172_198_40,seq319,r_134_77_182,r_172_198_40,0.97,3,43,40,16
99,r_336_200_95,r_261_371_161,r_184_10_85,r_336_200_95,1.0,0,95,95,16
117,r_301_169_33,r_367_110_169,seq352,r_301_169_33,1.0,0,33,33,16
97,r_131_351_41,seq88,seq295,r_131_351_41,1.0,0,41,41,16
80,r_199_309_38,r_258_263_157,seq170,r_258_263_157,0.58,-119,38,157,16
108,r_360_39_185,seq274,r_193_306_105,r_360_39_185,0.87,0,185,185,16
113,r_288_180_115,r_70_142_147,r_14_242_12,r_288_180_115,1.0,0,115,115,16
66,r_99_361_32,r_367_110_169,seq346,r_99_361_32,1.0,1,33,32,16
34,r_340_127_79,r_86_329_1,seq36,r_340_127_79,1.0,0,79,79,16
92,r_307_266_154,r_213_16_163,r_28_292_119,r_307_266_154,0.96,2,156,154,16
40,r_44_310_86,r_334_217_106,seq132,r_334_217_106,1.0,-23,83,106,16
32,r_291_264_186,r_294_320_167,r_144_187_122,r_291_264_186,0.9,1,187,186,16
58,r_18_108_15,r_340_127_79,seq8,r_18_108_15,0.86,0,15,15,16
62,r_205_188_34,seq354,seq8,r_205_188_34,1.0,0,34,34,16
71,r_347_171_141,seq95,seq64,r_347_171_141,1.0,0,141,141,16
68,r_303_215_59,seq210,seq122,r_303_215_59,1.0,0,59,59,16
95,r_7_68_100,seq319,r_238_342_20,r_7_68_100,1.0,0,100,100,16
7,r_197_208_45,seq1,seq365,r_197_208_45,0.98,0,45,45,16
19,r_367_110_169,seq48,r_17_255_155,r_367_110_169,0.92,0,169,169,16
220,seq295,r_162_259_159,r_131_351_41,r_162_259_159,0.72,0,159,159,16
101,r_172_198_40,r_134_77_182,r_290_343_99,r_172_198_40,0.85,141,181,40,16
63,r_58_31_161,seq122,r_341_240_131,r_58_31_161,1.0,3,164,161,16
21,r_73_159_70,seq170,seq194,r_73_159_70,1.0,1,71,70,16
70,r_257_35_118,seq193,r_311_55_75,r_257_35_118,0.99,0,118,118,17
109,r_299_87_112,r_245_197_199,seq34,r_299_87_112,0.94,6,118,112,17
3,r_1_94_74,r_224_142_123,r_118_235_104,r_118_235_104,0.67,11,115,104,17
54,r_287_292_50,r_280_7_131,seq43,r_287_292_50,1.0,0,50,50,17
55,r_234_29_131,r_200_74_194,r_41_5_163,r_234_29_131,0.88,0,131,131,17
159,seq91,r_93_354_141,r_216_262_14,r_93_354_141,1.0,0,141,141,17
52,r_25_90_48,seq42,seq323,r_25_90_48,0.98,3,51,48,17
65,r_363_123_178,r_233_20_197,r_130_110_18,r_363_123_178,1.0,0,178,178,17
57,r_28_122_188,r_137_362_163,r_41_5_163,r_28_122_188,1.0,-24,164,188,17
123,r_64_194_17,r_328_155_120,seq79,r_64_194_17,0.83,0,17,17,17
182,seq169,r_175_83_44,r_350_106_122,r_350_106_122,0.73,32,154,122,17
12,r_113_306_81,seq286,r_241_270_20,r_113_306_81,1.0,0,81,81,17
15,r_16_373_44,r_67_359_110,seq293,r_16_373_44,1.0,0,44,44,17
114,r_65_24_182,seq79,r_219_159_33,r_65_24_182,1.0,1,183,182,17
187,seq177,r_360_274_135,r_374_228_91,r_374_228_91,1.0,48,139,91,17
55,r_234_29_131,r_41_5_163,r_321_30_161,r_41_5_163,1.0,-1,162,163,17
115,r_333_33_110,r_285_31_155,r_191_268_8,r_333_33_110,0.83,0,110,110,17
71,r_48_240_60,r_315_121_79,r_233_20_197,r_48_240_60,1.0,0,60,60,17
56,r_144_290_96,seq215,r_84_195_31,r_144_290_96,1.0,0,96,96,17
86,r_37_296_41,r_246_336_86,r_1_94_74,r_1_94_74,0.95,-33,41,74,17
81,r_313_326_157,r_245_197_199,r_230_129_50,r_313_326_157,1.0,0,157,157,17
50,r_330_256_171,r_32_369_143,r_26_218_172,r_32_369_143,1.0,2,145,143,17
50,r_330_256_171,r_26_218_172,r_212_60_164,r_330_256_171,0.94,0,171,171,17
11,r_213_107_65,seq69,r_230_129_50,r_213_107_65,1.0,0,65,65,17
113,r_86_281_35,seq50,seq98,r_86_281_35,1.0,3,38,35,17
68,r_217_52_30,r_345_134_96,seq338,r_217_52_30,1.0,0,30,30,17
46,r_58_316_131,seq145,r_16_373_44,r_58_316_131,0.97,0,131,131,17
20,r_130_110_18,seq145,r_64_194_17,r_130_110_18,0.94,2,20,18,17
120,r_114_346_171,seq109,r_185_46_101,r_185_46_101,1.0,1,102,101,17
82,r_103_340_118,r_302_267_134,r_222_111_20,r_103_340_118,1.0,0,118,118,17
83,r_198_68_174,seq223,r_351_309_8,r_198_68_174,1.0,0,174,174,17
35,r_190_337_95,seq136,seq143,r_190_337_95,1.0,0,95,95,17
28,r_181_97_121,r_151_357_179,seq145,r_181_97_121,1.0,0,121,121,17
98,r_151_357_179,seq77,r_16_373_44,r_151_357_179,1.0,0,179,179,17
27,r_108_225_36,r_186_304_197,r_229_204_97,r_229_204_97,0.83,5,102,97,17
99,r_321_30_161,r_165_355_196,r_234_29_131,r_234_29_131,0.76,30,161,131,17
135,seq36,r_315_121_79,r_167_160_27,r_167_160_27,0.97,7,34,27,17
62,r_276_291_134,seq172,seq338,r_276_291_134,1.0,2,136,134,17
38,r_302_267_134,r_100_334_144,r_311_55_75,r_302_267_134,1.0,1,135,134,17
69,r_311_55_75,r_234_29_131,seq99,r_311_55_75,1.0,1,76,75,17
13,r_345_134_96,seq239,r_48_240_60,r_345_134_96,1.0,0,96,96,17
110,r_350_106_122,r_360_274_135,seq112,r_350_106_122,1.0,0,122,122,17
8,r_341_365_132,seq117,seq288,r_341_365_132,0.99,2,134,132,17
31,r_125_17_109,seq227,r_16_373_44,r_125_17_109,1.0,5,114,109,17
165,seq109,r_285_31_155,r_84_195_31,r_285_31_155,1.0,0,155,155,17
73,r_119_282_158,seq338,r_259_53_16,r_119_282_158,1.0,0,158,158,17
95,r_21_347_179,seq308,r_191_268_8,r_21_347_179,0.63,-1,178,179,17
49,r_219_159_33,r_25_90_48,seq261,r_219_159_33,1.0,1,34,33,17
10,r_349_40_122,seq3,r_25_90_48,r_349_40_122,1.0,1,123,122,17
105,r_96_272_12,r_41_5_163,seq81,r_96_272_12,1.0,0,12,12,17
25,r_241_270_20,r_330_256_171,seq278,r_241_270_20,1.0,0,20,20,17
4,r_366_76_151,r_119_282_158,r_364_189_59,r_366_76_151,0.92,0,151,151,17
34,r_238_201_159,seq61,r_315_121_79,r_238_201_159,1.0,2,161,159,17
93,r_207_325_177,seq136,r_191_268_8,r_207_325_177,0.81,1,178,177,17
122,r_100_334_144,seq305,r_259_53_16,r_100_334_144,1.0,0,144,144,17
96,r_44_138_106,r_80_89_146,seq2,r_44_138_106,0.9,10,116,106,17
53,r_224_142_123,r_59_47_152,r_127_156_51,r_59_47_152,0.93,-19,133,152,17
47,r_303_251_150,seq43,r_217_52_30,r_303_251_150,1.0,3,153,150,17
5,r_230_129_50,r_366_76_151,seq3,r_230_129_50,1.0,0,50,50,17
210,seq249,r_58_316_131,r_315_121_79,r_58_316_131,0.98,-16,115,131,17
121,r_175_83_44,seq318,seq72,r_175_83_44,1.0,1,45,44,17
119,r_161_203_145,r_212_60_164,seq352,r_161_203_145,1.0,0,145,145,17
89,r_80_89_146,r_220_105_161,seq318,r_80_89_146,0.84,1,147,146,17
94,r_280_7_131,seq79,seq75,r_280_7_131,1.0,0,131,131,17
120,r_114_346_171,r_185_46_101,r_358_266_35,r_114_346_171,1.0,0,171,171,17
37,r_283_168_81,seq109,r_241_270_20,r_283_168_81,0.99,0,81,81,17
75,r_67_359_110,seq109,r_311_55_75,r_67_359_110,1.0,0,110,110,17
85,r_328_155_120,seq78,r_358_266_35,r_328_155_120,1.0,0,120,120,17
101,r_322_12_62,seq338,r_171_54_7,r_322_12_62,1.0,1,63,62,17
40,r_259_53_16,r_48_240_60,r_356_327_4,r_259_53_16,0.93,0,16,16,17
27,r_108_225_36,r_165_355_196,r_186_304_197,r_108_225_36,1.0,2,38,36,17
21,r_265_202_80,seq112,r_205_154_51,r_265_202_80,1.0,0,80,80,17
164,seq104,r_372_170_38,r_37_296_41,r_37_296_41,1.0,1,42,41,17
117,r_307_371_29,seq342,seq143,r_307_371_29,0.97,0,29,29,17
91,r_163_27_148,seq98,seq248,r_163_27_148,1.0,3,151,148,17
66,r_162_92_31,r_144_290_96,r_96_272_12,r_162_92_31,0.97,0,31,31,17
155,seq81,seq49,r_162_92_31,r_162_92_31,0.99,0,31,31,17
111,r_222_111_20,r_328_155_120,seq361,r_222_111_20,0.74,0,20,20,17
116,r_374_228_91,r_135_243_119,seq177,r_374_228_91,1.0,0,91,91,17
63,r_185_46_101,r_114_346_171,r_41_5_163,r_185_46_101,1.0,70,171,101,17
77,r_150_247_106,seq368,r_25_90_48,r_150_247_106,1.0,2,108,106,17
0,r_146_329_170,seq293,seq223,r_146_329_170,1.0,0,170,170,17
42,r_157_209_178,seq176,r_324_289_13,r_157_209_178,0.9,0,178,178,17
182,seq169,r_185_46_101,r_175_83_44,r_185_46_101,0.83,3,104,101,17
30,r_178_264_99,r_366_76_151,r_64_194_17,r_178_264_99,1.0,0,99,99,17
2,r_26_218_172,r_21_347_179,r_84_195_31,r_84_195_31,0.94,141,172,31,17
51,r_271_148_69,r_41_5_163,r_324_289_13,r_271_148_69,1.0,0,69,69,17
118,r_93_354_141,seq91,r_66_128_114,r_93_354_141,1.0,0,141,141,17
72,r_335_263_45,r_149_13_194,r_171_54_7,r_335_263_45,1.0,0,45,45,17
61,r_184_226_127,seq6,r_216_262_14,r_184_226_127,1.0,0,127,127,17
39,r_205_154_51,seq297,seq69,r_205_154_51,0.97,0,51,51,17
48,r_9_39_80,seq45,seq42,r_9_39_80,1.0,0,80,80,17
43,r_324_289_13,r_345_134_96,seq214,r_324_289_13,0.9,0,13,13,17
26,r_229_204_97,r_26_218_172,r_108_225_36,r_229_204_97,0.86,0,97,97,17
58,r_285_31_155,seq109,r_18_250_95,r_285_31_155,1.0,0,155,155,17
78,r_216_262_14,r_157_209_178,r_165_355_196,r_216_262_14,1.0,0,14,14,17
19,r_18_250_95,seq261,r_86_281_35,r_18_250_95,1.0,0,95,95,17
59,r_164_139_87,r_149_13_194,r_364_189_59,r_164_139_87,1.0,0,87,87,17
18,r_233_20_197,r_363_123_178,r_48_240_60,r_48_240_60,0.96,13,73,60,17
23,r_118_235_104,seq72,r_1_94_74,r_118_235_104,1.0,0,104,104,17
100,r_319_260_80,seq239,seq51,r_319_260_80,1.0,0,80,80,17
204,seq232,r_59_47_152,r_212_60_164,r_59_47_152,1.0,0,152,152,17
41,r_255_57_24,r_58_316_131,seq188,r_255_57_24,1.0,0,24,24,17
106,r_212_60_164,r_161_203_145,r_259_53_16,r_161_203_145,1.0,0,145,145,17
84,r_95_370_110,r_302_267_134,r_216_262_14,r_95_370_110,1.0,0,110,110,17
92,r_22_206_122,r_276_291_134,r_254_242_2,r_22_206_122,1.0,1,123,122,17
67,r_59_47_152,seq232,r_181_97_121,r_59_47_152,1.0,0,152,152,17
36,r_124_367_68,seq239,seq88,r_124_367_68,0.68,3,71,68,17
29,r_192_166_112,r_163_27_148,r_190_337_95,r_192_166_112,1.0,5,117,112,17
7,r_246_336_86,seq0,r_16_373_44,r_246_336_86,1.0,7,93,86,17
63,r_185_46_101,seq169,r_114_346_171,r_185_46_101,1.0,0,101,101,17
207,seq239,r_345_134_96,r_216_262_14,r_345_134_96,1.0,0,96,96,17
198,seq214,r_144_290_96,r_324_289_13,r_324_289_13,0.52,0,13,13,17
112,r_131_277_32,r_358_266_35,seq6,r_131_277_32,1.0,1,33,32,17
149,seq72,r_118_235_104,r_175_83_44,r_118_235_104,0.71,0,104,104,17
16,r_84_195_31,r_200_74_194,seq223,r_84_195_31,1.0,0,31,31,17
102,r_32_369_143,r_330_256_171,seq210,r_32_369_143,0.97,2,145,143,17
80,r_315_121_79,seq182,seq249,r_315_121_79,0.76,1,80,79,17
44,r_137_362_163,r_28_122_188,seq317,r_137_362_163,1.0,1,164,163,17
17,r_358_266_35,r_190_337_95,seq361,r_358_266_35,1.0,1,36,35,17
123,r_292_356_95,seq12,r_187_348_191,r_292_356_95,1.0,0,95,95,18
34,r_240_116_72,r_132_22_117,seq242,r_240_116_72,1.0,1,73,72,18
63,r_264_79_147,seq3,r_233_50_81,r_264_79_147,0.76,2,149,147,18
9,r_75_21_139,r_264_79_147,seq86,r_75_21_139,1.0,0,139,139,18
107,r_187_348_191,r_238_61_101,r_292_356_95,r_292_356_95,1.0,7,102,95,18
62,r_136_357_139,r_340_286_102,r_314_193_42,r_314_193_42,1.0,3,45,42,18
38,r_287_322_67,r_313_44_193,seq224,r_287_322_67,1.0,0,67,67,18
165,seq113,r_304_54_165,r_337_258_40,r_304_54_165,1.0,0,165,165,18
28,r_267_1_179,seq207,seq7,r_267_1_179,0.96,2,181,179,18
11,r_74_26_88,r_271_347_188,seq242,r_74_26_88,1.0,0,88,88,18
29,r_25_156_73,r_19_174_194,r_147_35_37,r_25_156_73,0.75,5,78,73,18
117,r_308_349_111,seq350,r_295_355_50,r_308_349_111,1.0,1,112,111,18
90,r_166_203_188,seq105,r_160_153_126,r_166_203_188,0.74,0,188,188,18
16,r_354_46_181,seq350,r_293_121_174,r_354_46_181,0.95,0,181,181,18
81,r_209_10_42,r_66_126_56,r_269_52_156,r_269_52_156,0.98,-114,42,156,18
164,seq109,r_276_146_118,r_344_78_52,r_344_78_52,1.0,11,63,52,18
12,r_55_4_28,seq296,seq272,r_55_4_28,0.5,88,116,28,18
100,r_367_300_81,r_335_31_122,seq63,r_367_300_81,1.0,1,82,81,18
207,seq265,seq42,r_295_355_50,r_295_355_50,1.0,2,52,50,18
39,r_186_197_27,r_308_349_111,seq362,r_186_197_27,1.0,0,27,27,18
101,r_158_165_82,r_231_374_181,r_120_212_8,r_158_165_82,1.0,1,83,82,18
119,r_107_38_23,r_2_40_55,seq360,r_2_40_55,0.61,-31,24,55,18
153,seq89,r_293_121_174,r_169_205_48,r_169_205_48,1.0,10,58,48,18
106,r_261_83_183,r_184_325_67,r_55_4_28,r_261_83_183,1.0,1,184,183,18
26,r_106_47_98,seq94,seq207,r_106_47_98,0.93,6,104,98,18
95,r_90_318_65,seq336,r_337_258_40,r_90_318_65,0.97,0,65,65,18
41,r_147_35_37,seq369,r_329_270_49,r_147_35_37,1.0,0,37,37,18
83,r_304_54_165,seq113,r_263_235_47,r_304_54_165,1.0,0,165,165,18
58,r_340_286_102,r_136_357_139,seq310,r_340_286_102,1.0,0,102,102,18
110,r_371_256_112,r_335_31_122,r_30_80_13,r_371_256_112,1.0,0,112,112,18
16,r_354_46_181,r_106_47_98,r_90_318_65,r_106_47_98,0.89,-68,30,98,18
66,r_9_317_81,r_132_22_117,r_136_357_139,r_9_317_81,0.72,3,84,81,18
96,r_66_126_56,r_53_114_184,r_209_10_42,r_53_114_184,1.0,-128,56,184,18
36,r_142_68_158,r_271_347_188,r_340_286_102,r_142_68_158,0.99,0,158,158,18
23,r_305_152_93,r_292_356_95,r_279_215_93,r_279_215_93,1.0,0,93,93,18
35,r_344_78_52,seq93,seq109,r_344_78_52,1.0,0,52,52,18
85,r_81_183_72,seq316,seq138,r_81_183_72,1.0,1,73,72,18
41,r_147_35_37,r_329_270_49,r_25_156_73,r_147_35_37,0.74,41,78,37,18
81,r_209_10_42,r_269_52_156,r_66_126_56,r_209_10_42,0.89,31,73,42,18
114,r_20_133_117,r_343_110_180,seq87,r_20_133_117,1.0,0,117,117,18
61,r_160_153_126,r_302_358_182,r_209_10_42,r_160_153_126,1.0,0,126,126,18
67,r_95_179_168,r_53_114_184,r_43_338_20,r_95_179_168,0.79,0,168,168,18
69,r_333_65_44,seq159,r_282_134_2,r_333_65_44,1.0,0,44,44,18
13,r_184_325_67,r_261_83_183,r_324_148_35,r_261_83_183,1.0,1,184,183,18
82,r_122_45_73,r_19_174_194,r_120_212_8,r_122_45_73,1.0,0,73,73,18
37,r_279_215_93,r_194_180_163,r_145_71_24,r_279_215_93,1.0,1,94,93,18
15,r_188_332_36,r_60_182_185,seq249,r_188_332_36,0.98,1,37,36,18
18,r_176_5_42,r_275_135_196,r_219_247_155,r_219_247_155,0.99,5,160,155,18
21,r_155_190_162,seq101,r_279_215_93,r_155_190_162,0.62,0,162,162,18
93,r_60_182_185,seq189,r_176_5_42,r_60_182_185,1.0,0,185,185,18
220,seq296,seq88,r_2_40_55,r_2_40_55,1.0,10,65,55,18
104,r_195_359_138,seq189,r_324_148_35,r_195_359_138,1.0,1,139,138,18
25,r_43_338_20,r_302_358_182,seq59,r_43_338_20,1.0,0,20,20,18
5,r_269_52_156,r_132_22_117,r_209_10_42,r_132_22_117,0.95,0,117,117,18
40,r_293_121_174,seq89,r_255_257_1,r_293_121_174,0.99,4,178,174,18
1,r_263_235_47,r_278_239_101,seq3,r_263_235_47,1.0,1,48,47,18
22,r_278_239_101,seq360,seq306,r_278_239_101,1.0,0,101,101,18
48,r_132_22_117,r_269_52_156,seq57,r_132_22_117,1.0,0,117,117,18
71,r_92_112_51,seq280,seq105,r_92_112_51,1.0,0,51,51,18
6,r_324_148_35,seq125,seq237,r_324_148_35,0.87,3,38,35,18
86,r_194_180_163,r_150_250_141,r_251_131_88,r_194_180_163,0.98,-21,142,163,18
51,r_323_342_29,r_145_71_24,seq280,r_323_342_29,0.99,1,30,29,18
14,r_314_193_42,seq69,r_136_357_139,r_314_193_42,1.0,0,42,42,18
12,r_55_4_28,r_74_26_88,seq296,r_55_4_28,0.7,0,28,28,18
79,r_244_162_127,seq12,seq228,r_244_162_127,0.98,3,130,127,18
2,r_232_226_142,seq224,seq253,r_232_226_142,1.0,1,143,142,18
91,r_320_34_122,seq94,r_173_170_121,r_320_34_122,0.82,0,122,122,18
121,r_173_170_121,seq207,r_320_34_122,r_173_170_121,0.96,1,122,121,18
31,r_311_117_182,seq298,r_163_326_119,r_311_117_182,0.43,0,182,182,18
184,seq202,r_132_22_117,seq86,r_132_22_117,1.0,-3,114,117,18
60,r_245_13_78,seq285,r_120_212_8,r_245_13_78,0.99,2,80,78,18
50,r_163_326_119,seq284,r_201_149_7,r_163_326_119,0.99,0,119,119,18
243,seq360,r_278_239_101,r_364_137_54,r_278_239_101,1.0,0,101,101,18
56,r_225_161_182,seq229,r_175_200_11,r_225_161_182,1.0,0,182,182,18
113,r_346_141_26,r_267_1_179,r_175_200_11,r_346_141_26,0.89,2,28,26,18
10,r_231_374_181,seq218,r_84_164_155,r_231_374_181,0.99,0,181,181,18
32,r_238_61_101,r_187_348_191,r_74_26_88,r_74_26_88,0.97,14,102,88,18
5,r_269_52_156,r_209_10_42,seq334,r_269_52_156,0.95,0,156,156,18
157,seq98,r_371_256_112,r_192_260_31,r_371_256_112,1.0,-13,99,112,18
175,seq159,r_333_65_44,r_188_332_36,r_333_65_44,0.95,0,44,44,18
120,r_234_41_138,r_271_347_188,r_263_235_47,r_234_41_138,0.95,10,148,138,18
30,r_302_358_182,r_192_260_31,r_337_258_40,r_302_358_182,0.94,0,182,182,18
99,r_67_321_169,seq3,r_209_10_42,r_67_321_169,1.0,0,169,169,18
103,r_91_111_151,seq7,r_282_134_2,r_91_111_151,0.95,0,151,151,18
19,r_30_80_13,r_84_164_155,seq178,r_30_80_13,0.9,0,13,13,18
194,seq224,r_232_226_142,r_287_322_67,r_232_226_142,1.0,1,143,142,18
77,r_2_40_55,seq339,seq296,r_2_40_55,1.0,0,55,55,18
108,r_51_154_25,r_163_326_119,r_107_38_23,r_163_326_119,0.77,-93,26,119,18
45,r_16_254_118,r_271_347_188,seq220,r_16_254_118,0.54,7,125,118,18
49,r_266_49_154,seq259,seq63,r_266_49_154,1.0,0,154,154,18
80,r_222_76_189,seq283,r_329_270_49,r_222_76_189,0.98,0,189,189,18
73,r_201_149_7,r_185_217_102,r_169_205_48,r_201_149_7,0.6,47,54,7,18
62,r_136_357_139,r_314_193_42,r_9_317_81,r_9_317_81,1.0,13,94,81,18
20,r_251_131_88,r_305_152_93,seq8,r_251_131_88,1.0,0,88,88,18
0,r_84_164_155,r_166_203_188,seq124,r_84_164_155,0.99,0,155,155,18
75,r_295_355_50,r_278_239_101,seq265,r_295_355_50,0.85,1,51,50,18
7,r_157_96_43,r_231_374_181,r_185_217_102,r_185_217_102,0.97,-1,101,102,18
4,r_274_368_184,seq259,r_144_23_190,r_274_368_184,0.63,0,184,184,18
76,r_169_205_48,seq330,seq89,r_169_205_48,1.0,0,48,48,18
13,r_184_325_67,r_225_161_182,r_261_83_183,r_225_161_182,0.9,-115,67,182,18
97,r_129_115_134,r_75_21_139,r_11_32_125,r_129_115_134,1.0,2,136,134,18
55,r_53_114_184,seq297,r_282_134_2,r_53_114_184,1.0,0,184,184,18
64,r_309_214_148,r_264_79_147,r_216_140_36,r_264_79_147,1.0,1,148,147,18
16,r_354_46_181,r_232_226_142,seq350,r_232_226_142,0.58,-42,100,142,18
122,r_37_62_96,seq253,seq101,r_37_62_96,1.0,0,96,96,18
89,r_262_372_117,seq353,r_30_80_13,r_262_372_117,1.0,0,117,117,18
27,r_24_223_86,seq73,r_2_40_55,r_24_223_86,1.0,1,87,86,18
43,r_100_241_146,seq227,r_43_338_20,r_100_241_146,1.0,0,146,146,18
18,r_176_5_42,r_304_54_165,r_275_135_196,r_176_5_42,1.0,0,42,42,18
109,r_233_50_81,r_293_121_174,r_240_116_72,r_233_50_81,1.0,0,81,81,18
16,r_354_46_181,r_90_318_65,r_232_226_142,r_354_46_181,0.77,-109,72,181,18
116,r_150_250_141,r_194_180_163,r_240_116_72,r_150_250_141,1.0,1,142,141,18
102,r_373_303_131,seq199,seq101,r_373_303_131,1.0,-1,130,131,18
197,seq229,r_225_161_182,r_329_270_49,r_225_161_182,1.0,0,182,182,18
53,r_99_56_113,r_84_164_155,r_169_205_48,r_99_56_113,0.76,0,113,113,18
98,r_219_247_155,r_19_174_194,r_176_5_42,r_219_247_155,1.0,1,156,155,18
47,r_281_208_127,r_271_347_188,r_74_26_88,r_271_347_188,0.84,-61,127,188,18
70,r_343_110_180,seq73,r_329_270_49,r_343_110_180,0.9,0,180,180,18
46,r_364_137_54,r_251_131_88,r_51_154_25,r_251_131_88,0.53,-32,56,88,18
123,r_292_356_95,r_187_348_191,r_240_116_72,r_187_348_191,1.0,-8,183,191,18
44,r_185_217_102,r_293_121_174,r_157_96_43,r_185_217_102,1.0,0,102,102,18
88,r_243_168_129,r_155_190_162,r_43_338_20,r_243_168_129,0.66,0,129,129,18
124,r_335_31_122,seq307,r_245_13_78,r_245_13_78,0.73,47,125,78,18
14,r_297_230_29,r_242_362_183,seq2,r_297_230_29,0.99,0,29,29,19
17,r_237_306_101,r_304_293_110,r_274_217_33,r_274_217_33,1.0,68,101,33,19
101,r_219_315_78,r_144_7_41,r_96_223_86,r_144_7_41,0.99,1,42,41,19
77,r_177_10_22,r_361_373_66,seq148,r_177_10_22,0.9,2,24,22,19
16,r_70_141_72,seq107,seq17,r_70_141_72,1.0,0,72,72,19
99,r_124_176_36,r_242_362_183,seq153,r_124_176_36,1.0,0,36,36,19
54,r_365_53_57,r_197_280_124,r_318_267_40,r_365_53_57,1.0,0,57,57,19
58,r_259_247_107,seq148,r_179_286_38,r_259_247_107,0.58,5,112,107,19
44,r_324_192_95,r_222_209_139,r_50_337_62,r_222_209_139,1.0,-41,98,139,19
87,r_175_167_145,seq249,r_146_193_77,r_175_167_145,1.0,0,145,145,19
214,seq270,r_26_170_71,seq90,r_26_170_71,1.0,0,71,71,19
56,r_213_27_80,r_361_373_66,r_138_366_46,r_213_27_80,1.0,2,82,80,19
29,r_146_193_77,r_243_85_180,r_182_191_28,r_146_193_77,1.0,1,78,77,19
91,r_358_239_84,r_160_89_198,seq25,r_358_239_84,1.0,0,84,84,19
20,r_130_301_80,seq118,seq116,r_130_301_80,1.0,1,81,80,19
98,r_87_314_88,r_370_40_182,seq284,r_87_314_88,1.0,0,88,88,19
116,r_320_309_30,seq321,seq151,r_320_309_30,0.99,2,32,30,19
40,r_346_112_15,r_11_15_162,seq122,r_346_112_15,0.76,0,15,15,19
86,r_188_296_180,seq305,r_161_225_81,r_188_296_180,1.0,1,181,180,19
2,r_161_225_81,r_300_329_77,r_71_279_71,r_161_225_81,0.83,2,83,81,19
71,r_222_209_139,seq184,r_104_310_86,r_222_209_139,1.0,0,139,139,19
22,r_197_280_124,seq122,r_213_27_80,r_213_27_80,0.7,45,125,80,19
124,r_235_282_99,seq3,r_273_288_34,r_235_282_99,1.0,0,99,99,19
63,r_325_80_24,r_50_337_62,seq86,r_325_80_24,0.73,17,41,24,19
104,r_203_171_96,r_183_195_136,seq45,r_203_171_96,0.45,1,97,96,19
105,r_138_366_46,seq316,seq187,r_138_366_46,0.67,1,47,46,19
68,r_162_303_132,seq2,r_199_262_102,r_162_303_132,1.0,0,132,132,19
110,r_39_98_63,r_23_77_115,seq178,r_39_98_63,0.74,0,63,63,19
3,r_50_337_62,r_165_97_91,seq277,r_165_97_91,1.0,-13,78,91,19
109,r_23_77_115,r_359_88_125,r_361_373_66,r_23_77_115,0.69,5,120,115,19
94,r_96_223_86,seq74,seq118,r_96_223_86,1.0,0,86,86,19
47,r_132_254_79,r_188_296_180,seq238,r_132_254_79,1.0,0,79,79,19
35,r_243_85_180,seq60,r_32_52_18,r_243_85_180,0.94,0,180,180,19
102,r_111_353_175,r_335_181_198,r_304_293_110,r_111_353_175,0.81,1,176,175,19
117,r_180_231_182,seq338,r_143_334_34,r_180_231_182,0.98,0,182,182,19
51,r_292_57_131,r_162_303_132,r_104_310_86,r_292_57_131,1.0,0,131,131,19
132,seq19,seq93,r_173_9_65,r_173_9_65,1.0,30,95,65,19
15,r_47_264_82,r_16_349_99,r_161_225_81,r_16_349_99,0.76,-48,51,99,19
48,r_216_257_16,r_55_109_198,seq142,r_216_257_16,0.97,-1,15,16,19
18,r_186_126_168,seq178,r_104_310_86,r_186_126_168,1.0,2,170,168,19
36,r_102_129_102,seq305,seq294,r_102_129_102,1.0,0,102,102,19
65,r_241_276_108,seq22,r_59_200_69,r_241_276_108,1.0,0,108,108,19
107,r_140_113_97,r_16_349_99,r_130_301_80,r_140_113_97,1.0,1,98,97,19
179,seq153,seq227,r_124_176_36,r_124_176_36,1.0,24,60,36,19
75,r_76_51_126,seq319,seq54,r_76_51_126,1.0,0,126,126,19
30,r_59_200_69,r_95_289_79,r_189_345_50,r_59_200_69,1.0,0,69,69,19
31,r_72_20_127,seq100,r_213_27_80,r_72_20_127,1.0,0,127,127,19
123,r_298_236_4,r_285_172_111,r_194_287_35,r_298_236_4,0.6,107,111,4,19
23,r_370_40_182,r_166_272_137,r_70_141_72,r_370_40_182,1.0,0,182,182,19
39,r_165_97_91,r_50_337_62,r_128_106_12,r_165_97_91,1.0,0,91,91,19
100,r_26_170_71,seq270,r_173_9_65,r_26_170_71,1.0,21,92,71,19
41,r_361_373_66,r_292_57_131,r_219_315_78,r_361_373_66,1.0,20,86,66,19
218,seq290,r_165_97_91,r_259_247_107,r_165_97_91,1.0,0,91,91,19
6,r_84_66_33,r_76_51_126,seq65,r_84_66_33,0.96,4,37,33,19
90,r_139_374_58,r_259_247_107,r_32_52_18,r_139_374_58,1.0,0,58,58,19
80,r_269_75_10,r_203_171_96,r_99_64_91,r_269_75_10,1.0,87,97,10,19
81,r_42_37_51,seq19,seq253,r_42_37_51,0.98,0,51,51,19
62,r_199_262_102,seq58,seq22,r_199_262_102,1.0,0,102,102,19
221,seq295,r_367_252_176,r_206_82_53,r_206_82_53,0.99,22,75,53,19
29,r_146_193_77,r_182_191_28,r_175_167_145,r_175_167_145,1.0,1,146,145,19
4,r_11_15_162,seq145,r_76_51_126,r_11_15_162,1.0,2,164,162,19
64,r_12_157_92,r_259_247_107,r_300_329_77,r_300_329_77,0.98,10,87,77,19
101,r_219_315_78,r_96_223_86,r_361_373_66,r_219_315_78,0.99,-1,77,78,19
89,r_6_28_80,r_186_126_168,seq0,r_6_28_80,1.0,2,82,80,19
66,r_342_308_71,seq125,r_32_52_18,r_32_52_18,0.74,85,103,18,19
96,r_350_351_156,seq65,r_266_263_33,r_350_351_156,1.0,0,156,156,19
172,seq134,r_95_289_79,r_14_368_33,r_95_289_79,0.59,-19,60,79,19
26,r_229_119_65,r_183_195_136,r_138_366_46,r_229_119_65,1.0,2,67,65,19
70,r_103_234_23,seq93,seq122,r_103_234_23,0.94,0,23,23,19
9,r_206_82_53,r_285_172_111,r_369_136_47,r_206_82_53,0.96,0,53,53,19
53,r_62_46_18,r_96_223_86,seq317,r_62_46_18,1.0,0,18,18,19
52,r_137_208_175,seq354,r_229_119_65,r_137_208_175,1.0,0,175,175,19
55,r_173_9_65,seq322,seq19,r_173_9_65,0.99,0,65,65,19
27,r_242_362_183,seq8,r_6_28_80,r_242_362_183,1.0,4,187,183,19
45,r_285_172_111,r_298_236_4,r_273_288_34,r_285_172_111,0.99,0,111,111,19
88,r_13_1_108,seq43,r_199_262_102,r_13_1_108,1.0,0,108,108,19
57,r_304_293_110,seq244,seq90,r_304_293_110,1.0,0,110,110,19
228,seq317,r_138_366_46,r_62_46_18,r_62_46_18,1.0,2,20,18,19
0,r_183_195_136,seq120,r_32_52_18,r_183_195_136,1.0,0,136,136,19
141,seq54,seq149,r_76_51_126,r_76_51_126,1.0,21,147,126,19
74,r_182_191_28,r_183_195_136,seq322,r_182_191_28,1.0,0,28,28,19
10,r_233_78_186,seq17,r_212_79_5,r_233_78_186,0.92,0,186,186,19
95,r_273_288_34,seq253,r_177_10_22,r_273_288_34,1.0,0,34,34,19
28,r_363_364_137,seq196,r_161_225_81,r_363_364_137,1.0,0,137,137,19
69,r_204_275_118,r_243_85_180,r_304_293_110,r_204_275_118,1.0,1,119,118,19
119,r_194_287_35,seq116,r_298_236_4,r_194_287_35,1.0,0,35,35,19
11,r_352_38_59,seq238,seq155,r_352_38_59,1.0,0,59,59,19
92,r_95_289_79,r_203_171_96,r_103_234_23,r_95_289_79,1.0,0,79,79,19
83,r_300_329_77,r_161_225_81,r_12_157_92,r_12_157_92,0.98,6,98,92,19
12,r_61_4_68,r_127_332_141,seq90,r_61_4_68,1.0,0,68,68,19
59,r_274_217_33,r_370_40_182,seq319,r_274_217_33,1.0,0,33,33,19
84,r_143_334_34,seq344,r_62_46_18,r_143_334_34,1.0,0,34,34,19
112,r_278_133_104,seq153,r_166_272_137,r_278_133_104,1.0,1,105,104,19
78,r_36_150_20,r_161_225_81,seq305,r_36_150_20,0.99,1,21,20,19
121,r_34_185_38,r_206_82_53,r_143_334_34,r_34_185_38,0.99,0,38,38,19
93,r_159_255_73,r_258_147_197,r_39_98_63,r_159_255_73,1.0,3,76,73,19
60,r_104_310_86,r_243_85_180,r_96_223_86,r_243_85_180,1.0,-94,86,180,19
50,r_32_52_18,seq265,seq169,r_32_52_18,0.95,1,19,18,19
108,r_226_174_152,r_242_362_183,r_360_35_62,r_226_174_152,0.93,0,152,152,19
33,r_311_268_114,r_135_341_145,r_128_106_12,r_311_268_114,1.0,1,115,114,19
1,r_16_349_99,r_135_341_145,seq354,r_16_349_99,1.0,0,99,99,19
113,r_63_67_145,seq319,seq149,r_63_67_145,1.0,0,145,145,19
38,r_367_252_176,seq295,r_135_341_145,r_367_252_176,1.0,0,176,176,19
32,r_327_31_36,seq284,seq105,r_327_31_36,1.0,0,36,36,19
72,r_164_271_30,r_173_9_65,seq249,r_164_271_30,0.99,0,30,30,19
122,r_33_158_40,r_130_301_80,seq60,r_33_158_40,1.0,0,40,40,19
120,r_99_64_91,r_186_126_168,r_269_75_10,r_99_64_91,1.0,0,91,91,19
181,seq155,r_325_80_24,r_352_38_59,r_352_38_59,1.0,22,81,59,19
34,r_114_108_110,seq261,r_352_38_59,r_352_38_59,1.0,54,113,59,19
7,r_189_345_50,r_11_15_162,r_23_77_115,r_189_345_50,0.89,0,50,50,19
43,r_48_202_33,r_350_351_156,r_166_272_137,r_48_202_33,0.99,0,33,33,19
37,r_221_30_151,r_242_362_183,seq41,r_221_30_151,0.99,0,151,151,19
76,r_256_220_15,seq265,seq224,r_256_220_15,0.94,-1,14,15,19
223,seq305,r_188_296_180,r_36_150_20,r_188_296_180,0.98,-18,162,180,19
148,seq74,r_96_223_86,seq22,r_96_223_86,1.0,2,88,86,19
8,r_266_263_33,seq153,seq58,r_266_263_33,1.0,0,33,33,19
82,r_211_29_40,r_13_1_108,seq73,r_211_29_40,1.0,0,40,40,19
25,r_128_106_12,r_233_78_186,seq122,r_128_106_12,0.78,0,12,12,19
7,r_189_345_50,r_23_77_115,r_59_200_69,r_59_200_69,0.98,3,72,69,19
7,r_336_353_115,seq105,seq136,r_336_353_115,1.0,0,115,115,20
109,r_202_152_48,seq42,seq280,r_202_152_48,1.0,0,48,48,20
114,r_61_245_52,r_221_312_161,r_126_311_37,r_61_245_52,0.63,0,52,52,20
37,r_70_293_56,r_338_259_147,seq100,r_70_293_56,0.95,0,56,56,20
52,r_315_157_31,r_221_312_161,seq304,r_315_157_31,1.0,0,31,31,20
228,seq309,seq107,r_177_72_27,r_177_72_27,0.8,-8,19,27,20
18,r_0_251_15,r_358_301_90,seq257,r_0_251_15,1.0,0,15,15,20
65,r_247_24_94,r_174_95_122,r_96_149_89,r_247_24_94,1.0,0,94,94,20
115,r_1_334_73,r_163_48_111,r_269_145_34,r_1_334_73,0.99,0,73,73,20
119,r_22_314_61,r_275_258_181,r_14_185_110,r_275_258_181,0.68,1,182,181,20
75,r_338_259_147,r_355_337_36,r_41_373_25,r_338_259_147,0.87,2,149,147,20
108,r_306_294_111,seq227,seq58,r_306_294_111,1.0,0,111,111,20
81,r_254_370_170,seq35,r_300_82_32,r_254_370_170,1.0,0,170,170,20
99,r_360_184_24,r_164_308_181,seq90,r_360_184_24,0.99,0,24,24,20
72,r_305_234_122,seq225,seq87,r_305_234_122,1.0,0,122,122,20
123,r_151_307_24,seq58,seq283,r_151_307_24,0.99,0,24,24,20
24,r_115_324_89,r_221_312_161,r_155_244_57,r_115_324_89,0.57,2,91,89,20
68,r_260_85_197,r_339_33_109,r_155_244_57,r_260_85_197,0.98,-84,113,197,20
59,r_211_270_29,r_176_200_104,r_128_169_67,r_211_270_29,1.0,37,66,29,20
104,r_203_363_59,r_336_353_115,seq191,r_203_363_59,0.81,1,60,59,20
19,r_43_44_80,r_113_212_196,seq283,r_43_44_80,1.0,0,80,80,20
80,r_272_119_176,seq87,r_178_26_64,r_272_119_176,1.0,0,176,176,20
49,r_339_33_109,r_260_85_197,r_92_148_24,r_339_33_109,0.95,3,112,109,20
51,r_103_159_156,seq71,seq134,r_103_159_156,0.97,2,158,156,20
28,r_89_364_70,r_275_258_181,seq216,r_89_364_70,1.0,0,70,70,20
31,r_170_9_145,seq188,r_347_342_48,r_170_9_145,1.0,0,145,145,20
29,r_164_308_181,seq345,r_347_342_48,r_164_308_181,0.93,0,181,181,20
78,r_267_220_155,seq231,r_347_342_48,r_267_220_155,1.0,0,155,155,20
247,seq354,r_267_220_155,seq193,r_267_220_155,0.96,-56,99,155,20
2,r_358_301_90,seq25,seq100,r_358_301_90,0.88,-5,85,90,20
35,r_57_81_104,seq225,seq296,r_57_81_104,1.0,0,104,104,20
20,r_177_72_27,r_89_364_70,seq309,r_89_364_70,0.94,-49,21,70,20
4,r_265_236_187,seq261,r_155_244_57,r_265_236_187,1.0,1,188,187,20
204,seq239,r_175_80_190,r_275_258_181,r_175_80_190,0.76,-1,189,190,20
112,r_60_137_102,r_374_276_38,r_359_135_16,r_60_137_102,1.0,0,102,102,20
86,r_108_4_182,seq87,r_178_26_64,r_108_4_182,1.0,0,182,182,20
105,r_67_228_116,r_99_340_134,seq223,r_67_228_116,1.0,0,116,116,20
26,r_278_101_174,r_290_208_190,r_0_251_15,r_278_101_174,1.0,2,176,174,20
1,r_290_208_190,seq147,r_89_364_70,r_290_208_190,1.0,0,190,190,20
62,r_126_311_37,r_290_208_190,r_272_119_176,r_126_311_37,1.0,0,37,37,20
95,r_249_313_89,r_275_258_181,r_355_337_36,r_249_313_89,0.99,3,92,89,20
39,r_163_48_111,seq136,seq58,r_163_48_111,1.0,0,111,111,20
48,r_128_169_67,seq37,r_211_270_29,r_128_169_67,1.0,-2,65,67,20
32,r_275_258_181,r_89_364_70,r_22_314_61,r_275_258_181,1.0,-120,61,181,20
60,r_65_209_144,r_267_220_155,r_215_238_91,r_65_209_144,1.0,0,144,144,20
25,r_302_11_59,r_215_238_91,r_269_145_34,r_302_11_59,0.89,0,59,59,20
106,r_175_80_190,seq239,r_325_232_119,r_175_80_190,1.0,0,190,190,20
76,r_182_285_109,r_99_340_134,r_102_210_178,r_99_340_134,0.98,-13,121,134,20
56,r_291_132_124,seq20,seq243,r_291_132_124,1.0,1,125,124,20
11,r_214_79_178,seq2,r_339_33_109,r_214_79_178,1.0,1,179,178,20
21,r_176_200_104,r_211_270_29,r_115_324_89,r_176_200_104,1.0,-2,102,104,20
62,r_126_311_37,r_272_119_176,r_61_245_52,r_272_119_176,1.0,0,176,176,20
125,seq2,r_214_79_178,r_163_48_111,r_214_79_178,0.58,1,179,178,20
23,r_93_357_106,r_67_228_116,r_69_16_24,r_93_357_106,1.0,5,111,106,20
45,r_28_281_64,seq187,seq136,r_28_281_64,1.0,0,64,64,20
97,r_27_47_112,r_29_171_174,seq261,r_27_47_112,1.0,0,112,112,20
21,r_176_200_104,r_164_308_181,r_211_270_29,r_211_270_29,0.98,-1,28,29,20
122,r_237_230_153,seq74,r_178_26_64,r_237_230_153,1.0,0,153,153,20
111,r_233_143_38,r_356_344_72,r_327_335_11,r_233_143_38,0.99,0,38,38,20
243,seq348,seq345,r_168_323_84,r_168_323_84,1.0,14,98,84,20
22,r_14_185_110,seq84,seq287,r_14_185_110,1.0,1,111,110,20
149,seq74,r_237_230_153,r_109_268_43,r_237_230_153,1.0,0,153,153,20
54,r_123_56_170,seq37,r_156_15_11,r_123_56_170,1.0,0,170,170,20
218,seq283,seq188,r_43_44_80,r_43_44_80,1.0,8,88,80,20
107,r_295_38_29,r_349_106_191,r_321_50_109,r_321_50_109,0.92,-4,105,109,20
200,seq225,r_199_341_69,r_117_5_62,r_199_341_69,1.0,-5,64,69,20
75,r_338_259_147,r_70_293_56,r_355_337_36,r_355_337_36,0.63,8,44,36,20
57,r_142_94_110,seq58,seq190,r_142_94_110,1.0,0,110,110,20
96,r_66_162_51,r_246_368_88,seq21,r_66_162_51,1.0,0,51,51,20
64,r_199_341_69,seq225,seq34,r_199_341_69,1.0,0,69,69,20
42,r_332_116_78,seq91,seq42,r_332_116_78,1.0,-1,77,78,20
103,r_327_335_11,r_115_324_89,seq144,r_327_335_11,0.91,0,11,11,20
44,r_146_219_38,r_339_33_109,r_155_244_57,r_146_219_38,0.96,48,86,38,20
55,r_117_5_62,r_374_276_38,seq225,r_117_5_62,0.85,0,62,62,20
34,r_39_206_116,seq35,seq167,r_39_206_116,1.0,0,116,116,20
14,r_325_232_119,seq227,seq86,r_325_232_119,1.0,0,119,119,20
44,r_146_219_38,r_163_48_111,r_339_33_109,r_146_219_38,1.0,2,40,38,20
6,r_347_342_48,seq21,r_109_268_43,r_109_268_43,0.79,-2,41,43,20
71,r_88_224_135,r_160_286_90,r_246_368_88,r_160_286_90,1.0,45,135,90,20
5,r_96_149_89,r_374_276_38,seq25,r_96_149_89,1.0,0,89,89,20
94,r_355_337_36,r_338_259_147,r_249_313_89,r_355_337_36,0.66,112,148,36,20
119,r_22_314_61,r_374_276_38,r_275_258_181,r_22_314_61,1.0,0,61,61,20
17,r_356_344_72,r_291_132_124,seq55,r_356_344_72,1.0,0,72,72,20
33,r_13_298_167,seq136,r_215_238_91,r_13_298_167,0.82,0,167,167,20
15,r_155_244_57,r_226_150_186,r_146_219_38,r_155_244_57,1.0,0,57,57,20
87,r_69_16_24,r_356_344_72,seq23,r_69_16_24,0.99,0,24,24,20
117,r_30_118_89,r_256_173_125,seq165,r_256_173_125,1.0,-37,88,125,20
67,r_300_82_32,r_374_276_38,seq165,r_300_82_32,1.0,0,32,32,20
100,r_153_263_14,r_374_276_38,seq188,r_153_263_14,0.99,0,14,14,20
59,r_211_270_29,r_39_206_116,r_176_200_104,r_211_270_29,0.97,-1,28,29,20
89,r_131_204_156,seq161,r_89_364_70,r_131_204_156,1.0,0,156,156,20
73,r_183_112_87,r_99_340_134,seq83,r_183_112_87,1.0,2,89,87,20
40,r_109_268_43,r_123_56_170,r_347_342_48,r_109_268_43,0.99,-2,41,43,20
50,r_299_194_122,seq196,r_359_135_16,r_299_194_122,1.0,0,122,122,20
84,r_207_52_39,seq32,r_153_263_14,r_207_52_39,0.98,4,43,39,20
47,r_36_3_134,r_349_106_191,seq71,r_36_3_134,1.0,0,134,134,20
61,r_367_17_23,r_177_72_27,seq266,r_367_17_23,0.98,1,24,23,20
91,r_6_75_159,seq227,r_321_50_109,r_6_75_159,1.0,1,160,159,20
0,r_215_238_91,r_237_230_153,seq154,r_215_238_91,1.0,1,92,91,20
8,r_29_171_174,seq243,r_246_368_88,r_29_171_174,0.99,0,174,174,20
43,r_41_373_25,r_215_238_91,seq19,r_41_373_25,0.98,-2,23,25,20
74,r_235_63_66,r_103_159_156,seq348,r_235_63_66,1.0,0,66,66,20
121,r_274_130_107,seq296,r_246_368_88,r_246_368_88,0.9,23,111,88,20
85,r_59_252_182,seq190,r_300_82_32,r_59_252_182,0.99,1,183,182,20
9,r_78_318_30,seq309,seq326,r_78_318_30,0.98,-1,29,30,20
83,r_362_372_87,seq296,r_92_148_24,r_362_372_87,0.79,1,88,87,20
27,r_99_340_134,seq25,r_70_293_56,r_99_340_134,0.6,4,138,134,20
137,seq37,r_123_56_170,seq134,r_123_56_170,1.0,-43,127,170,20
46,r_240_54_90,seq284,r_96_149_89,r_96_149_89,0.91,0,89,89,20
41,r_250_31_95,r_113_212_196,r_199_341_69,r_250_31_95,0.75,1,96,95,20
10,r_168_323_84,seq58,r_235_63_66,r_168_323_84,1.0,0,84,84,20
94,r_355_337_36,r_215_238_91,r_338_259_147,r_355_337_36,1.0,0,36,36,20
93,r_269_145_34,seq32,seq343,r_269_145_34,0.99,0,34,34,20
38,r_174_95_122,seq90,r_325_232_119,r_174_95_122,1.0,1,123,122,20
90,r_221_312_161,seq100,seq25,r_221_312_161,0.95,4,165,161,20
12,r_226_150_186,seq216,r_246_368_88,r_226_150_186,1.0,0,186,186,20
113,r_92_148_24,r_273_122_33,seq111,r_92_148_24,0.98,0,24,24,20
58,r_178_26_64,r_123_56_170,seq197,r_123_56_170,0.75,-113,57,170,20
63,r_18_264_56,r_374_276_38,r_155_244_57,r_18_264_56,1.0,1,57,56,20
66,r_279_77_20,r_115_324_89,seq197,r_279_77_20,0.93,0,20,20,20
32,r_275_258_181,r_22_314_61,seq239,r_275_258_181,0.93,1,182,181,20
70,r_46_366_98,seq198,seq37,r_46_366_98,1.0,0,98,98,20
98,r_319_201_67,seq197,r_199_341_69,r_319_201_67,1.0,2,69,67,20
124,r_321_50_109,r_256_173_125,r_295_38_29,r_256_173_125,0.63,-16,109,125,20
211,seq249,r_134_263_168,seq83,r_134_263_168,1.0,0,168,168,21
50,r_212_256_157,r_194_248_180,r_34_226_153,r_212_256_157,1.0,0,157,157,21
106,r_3_77_131,seq133,r_86_196_60,r_86_196_60,0.58,73,133,60,21
81,r_319_181_37,r_212_256_157,seq191,r_319_181_37,1.0,0,37,37,21
51,r_102_175_37,r_298_269_84,seq251,r_102_175_37,1.0,0,37,37,21
77,r_163_300_74,r_311_174_152,seq63,r_163_300_74,1.0,0,74,74,21
41,r_6_369_99,seq5,seq372,r_6_369_99,1.0,1,100,99,21
115,r_10_59_45,r_356_230_197,seq156,r_10_59_45,0.95,0,45,45,21
92,r_260_327_51,seq133,r_102_175_37,r_260_327_51,1.0,0,51,51,21
20,r_221_64_118,seq293,r_240_217_59,r_221_64_118,0.88,0,118,118,21
91,r_272_237_42,r_2_153_104,r_314_359_11,r_272_237_42,0.89,1,43,42,21
167,seq118,r_152_111_139,seq90,r_152_111_139,1.0,0,139,139,21
121,r_351_215_32,r_374_284_35,r_87_328_8,r_87_328_8,1.0,24,32,8,21
39,r_18_88_60,r_282_32_122,r_110_79_61,r_110_79_61,0.95,-1,60,61,21
59,r_343_150_100,r_131_323_162,seq1,r_131_323_162,0.54,-51,111,162,21
37,r_115_103_169,seq74,r_152_111_139,r_115_103_169,1.0,0,169,169,21
18,r_134_263_168,seq249,r_213_62_110,r_134_263_168,0.98,0,168,168,21
116,r_109_302_22,r_128_337_100,r_236_289_42,r_128_337_100,1.0,0,100,100,21
108,r_140_270_152,seq295,seq118,r_140_270_152,0.88,-6,146,152,21
45,r_112_20_160,r_137_280_104,r_12_232_28,r_112_20_160,0.69,-18,142,160,21
19,r_282_32_122,r_193_38_192,r_110_79_61,r_282_32_122,1.0,0,122,122,21
102,r_231_279_172,seq372,seq205,r_231_279_172,1.0,2,174,172,21
215,seq255,r_51_169_146,r_195_154_145,r_51_169_146,0.76,2,148,146,21
112,r_357_164_33,seq224,seq94,r_357_164_33,1.0,1,34,33,21
2,r_362_322_143,r_112_20_160,seq73,r_362_322_143,0.96,1,144,143,21
124,r_325_344_153,r_129_287_162,seq224,r_325_344_153,1.0,0,153,153,21
7,r_92_30_176,seq96,r_362_322_143,r_92_30_176,0.85,0,176,176,21
23,r_311_174_152,r_149_349_63,seq7,r_311_174_152,0.99,0,152,152,21
78,r_298_269_84,seq1,r_149_349_63,r_298_269_84,1.0,0,84,84,21
30,r_16_27_95,seq146,seq312,r_16_27_95,0.87,3,98,95,21
95,r_219_294_105,seq39,seq162,r_219_294_105,1.0,3,108,105,21
136,seq31,seq255,r_266_283_102,r_266_283_102,0.99,-4,98,102,21
34,r_341_350_30,r_240_217_59,r_235_101_55,r_341_350_30,0.98,30,60,30,21
226,seq303,r_167_124_192,r_138_335_95,r_167_124_192,0.74,-10,182,192,21
0,r_374_284_35,r_356_230_197,r_183_28_187,r_374_284_35,1.0,0,35,35,21
82,r_182_245_189,r_331_320_19,r_112_20_160,r_182_245_189,1.0,0,189,189,21
15,r_65_199_59,seq84,seq74,r_65_199_59,1.0,0,59,59,21
52,r_78_326_96,seq168,seq261,r_78_326_96,1.0,2,98,96,21
66,r_141_185_90,seq136,r_296_72_55,r_141_185_90,0.83,0,90,90,21
43,r_152_111_139,seq118,seq84,r_152_111_139,1.0,0,139,139,21
26,r_130_180_100,r_182_245_189,r_308_190_59,r_130_180_100,1.0,0,100,100,21
35,r_296_72_55,seq177,r_340_342_122,r_296_72_55,1.0,0,55,55,21
113,r_340_342_122,r_325_344_153,r_296_72_55,r_296_72_55,1.0,17,72,55,21
17,r_49_216_119,seq97,seq306,r_49_216_119,1.0,0,119,119,21
47,r_238_363_40,r_6_369_99,seq299,r_238_363_40,0.65,0,40,40,21
35,r_296_72_55,r_340_342_122,r_141_185_90,r_296_72_55,0.49,67,122,55,21
63,r_308_190_59,r_355_41_62,seq209,r_308_190_59,1.0,1,60,59,21
10,r_297_188_127,seq48,r_119_125_107,r_119_125_107,0.69,28,135,107,21
22,r_241_50_78,r_219_294_105,r_374_284_35,r_241_50_78,0.73,-2,76,78,21
13,r_105_252_186,seq191,r_242_227_12,r_105_252_186,0.94,1,187,186,21
163,seq98,r_370_262_178,r_297_188_127,r_370_262_178,1.0,0,178,178,21
212,seq251,r_2_153_104,r_102_175_37,r_2_153_104,0.52,-16,88,104,21
8,r_42_19_82,seq224,r_277_45_189,r_42_19_82,1.0,0,82,82,21
48,r_240_217_59,r_343_150_100,r_319_181_37,r_240_217_59,1.0,1,60,59,21
111,r_36_264_127,r_15_106_154,r_352_4_67,r_36_264_127,0.81,3,130,127,21
64,r_250_305_119,r_76_143_166,r_357_164_33,r_250_305_119,1.0,0,119,119,21
57,r_119_125_107,seq209,seq98,r_119_125_107,1.0,0,107,107,21
216,seq261,r_206_278_170,r_129_287_162,r_129_287_162,0.9,12,174,162,21
62,r_86_196_60,r_297_188_127,seq339,r_86_196_60,1.0,0,60,60,21
42,r_40_160_163,seq293,r_236_289_42,r_40_160_163,1.0,0,163,163,21
99,r_206_278_170,seq261,r_346_126_114,r_346_126_114,0.58,60,174,114,21
44,r_93_373_104,r_134_263_168,r_138_335_95,r_93_373_104,1.0,0,104,104,21
55,r_178_81_153,r_149_349_63,seq360,r_178_81_153,1.0,0,153,153,21
120,r_213_62_110,seq244,seq292,r_213_62_110,1.0,0,110,110,21
73,r_223_275_45,r_285_127_66,seq158,r_223_275_45,1.0,0,45,45,21
36,r_345_334_15,r_141_185_90,seq291,r_345_334_15,0.97,0,15,15,21
45,r_112_20_160,r_12_232_28,r_192_229_166,r_112_20_160,0.65,5,165,160,21
32,r_204_246_150,seq339,r_195_154_145,r_204_246_150,1.0,0,150,150,21
118,r_239_148_149,r_34_226_153,r_152_111_139,r_239_148_149,0.65,0,149,149,21
146,seq60,r_170_198_142,r_316_267_36,r_170_198_142,1.0,0,142,142,21
122,r_366_89_60,r_219_294_105,seq26,r_366_89_60,0.78,2,62,60,21
94,r_276_114_166,seq304,r_9_43_164,r_276_114_166,1.0,0,166,166,21
85,r_15_106_154,seq162,r_87_328_8,r_15_106_154,0.78,0,154,154,21
228,seq306,r_51_169_146,r_49_216_119,r_49_216_119,1.0,-5,114,119,21
176,seq146,r_16_27_95,r_352_4_67,r_16_27_95,0.52,3,98,95,21
28,r_128_337_100,r_82_54_136,seq69,r_128_337_100,1.0,0,100,100,21
25,r_85_104_179,seq144,r_170_198_142,r_85_104_179,1.0,0,179,179,21
11,r_12_232_28,r_112_20_160,r_219_294_105,r_112_20_160,0.84,4,164,160,21
168,seq120,r_285_127_66,r_11_35_91,r_11_35_91,0.5,-37,54,91,21
33,r_76_143_166,seq233,r_87_328_8,r_76_143_166,1.0,1,167,166,21
153,seq74,r_192_229_166,r_65_199_59,r_192_229_166,1.0,-5,161,166,21
61,r_266_283_102,seq91,seq31,r_266_283_102,0.99,0,102,102,21
113,r_340_342_122,r_296_72_55,r_357_164_33,r_340_342_122,1.0,0,122,122,21
16,r_51_169_146,seq255,seq144,r_51_169_146,0.69,2,148,146,21
76,r_236_289_42,r_347_33_85,seq116,r_236_289_42,1.0,0,42,42,21
97,r_370_262_178,seq98,seq90,r_370_262_178,1.0,0,178,178,21
14,r_110_79_61,r_113_286_133,seq156,r_113_286_133,0.74,-71,62,133,21
68,r_25_315_82,r_330_257_183,seq225,r_25_315_82,0.64,2,84,82,21
11,r_12_232_28,r_80_67_31,r_112_20_160,r_12_232_28,1.0,0,28,28,21
93,r_197_70_177,r_357_164_33,r_163_300_74,r_197_70_177,0.92,0,177,177,21
86,r_192_229_166,seq74,r_112_20_160,r_192_229_166,1.0,0,166,166,21
54,r_355_41_62,seq31,seq186,r_355_41_62,1.0,0,62,62,21
79,r_137_280_104,r_112_20_160,r_242_227_12,r_112_20_160,0.99,-18,142,160,21
90,r_316_267_36,seq306,seq60,r_316_267_36,1.0,0,36,36,21
29,r_11_35_91,r_121_208_111,r_12_232_28,r_11_35_91,0.99,0,91,91,21
110,r_46_259_148,r_182_245_189,r_170_198_142,r_170_198_142,0.47,10,152,142,21
80,r_235_101_55,r_211_187_66,r_341_350_30,r_211_187_66,0.58,-8,58,66,21
21,r_34_226_153,seq159,r_266_283_102,r_34_226_153,1.0,0,153,153,21
58,r_324_44_155,seq186,r_242_227_12,r_324_44_155,1.0,0,155,155,21
53,r_346_126_114,r_85_104_179,r_236_289_42,r_346_126_114,1.0,0,114,114,21
168,seq120,r_11_35_91,r_352_4_67,r_352_4_67,0.46,97,164,67,21
6,r_80_67_31,r_42_19_82,r_341_350_30,r_341_350_30,0.65,3,33,30,21
40,r_330_257_183,seq339,seq5,r_330_257_183,1.0,0,183,183,21
60,r_113_286_133,seq299,r_223_275_45,r_113_286_133,1.0,0,133,133,21
65,r_211_187_66,seq310,r_258_268_25,r_211_187_66,1.0,1,67,66,21
34,r_341_350_30,r_211_187_66,r_240_217_59,r_341_350_30,1.0,1,31,30,21
9,r_285_127_66,seq63,r_82_54_136,r_285_127_66,0.78,85,151,66,21
89,r_314_359_11,r_311_174_152,seq151,r_314_359_11,0.97,0,11,11,21
137,seq37,r_241_50_78,r_163_300_74,r_163_300_74,1.0,19,93,74,21
49,r_247_265_39,r_6_369_99,seq304,r_247_265_39,0.59,4,43,39,21
3,r_352_4_67,seq312,seq146,r_352_4_67,0.94,1,68,67,21
46,r_121_208_111,r_167_124_192,r_316_267_36,r_121_208_111,0.98,9,120,111,21
93,r_197_70_177,r_362_322_143,r_357_164_33,r_357_164_33,0.7,50,83,33,21
56,r_288_368_20,r_51_169_146,seq52,r_288_368_20,1.0,0,20,20,21
12,r_170_198_142,seq60,r_211_187_66,r_170_198_142,0.97,0,142,142,21
83,r_347_33_85,seq14,r_247_265_39,r_347_33_85,1.0,0,85,85,21
116,r_109_302_22,seq99,r_128_337_100,r_109_302_22,1.0,0,22,22,21
69,r_290_107_190,seq155,r_362_322_143,r_290_107_190,0.99,0,190,190,21
100,r_173_117_79,r_221_64_118,seq271,r_221_64_118,1.0,-30,88,118,21
84,r_2_153_104,seq251,seq177,r_2_153_104,1.0,0,104,104,21
109,r_194_248_180,seq52,r_242_227_12,r_194_248_180,1.0,0,180,180,21
1,r_129_287_162,seq171,seq261,r_129_287_162,1.0,1,163,162,21
72,r_82_54_136,seq116,r_285_127_66,r_82_54_136,0.92,0,136,136,21
9,r_285_127_66,seq151,seq63,r_285_127_66,0.95,0,66,66,21
96,r_131_323_162,seq353,seq74,r_131_323_162,0.81,1,163,162,21
31,r_138_335_95,r_152_111_139,seq303,r_152_111_139,0.67,-43,96,139,21
27,r_147_201_165,r_192_229_166,r_314_359_11,r_147_201_165,0.66,0,165,165,21
200,seq205,seq39,r_231_279_172,r_231_279_172,1.0,2,174,172,21
101,r_222_365_168,seq61,r_170_198_142,r_170_198_142,0.88,25,167,142,21
70,r_58_123_94,seq253,seq48,r_58_123_94,0.97,4,98,94,21
103,r_333_22_147,seq339,seq26,r_333_22_147,1.0,0,147,147,21
105,r_210_24_143,r_231_279_172,r_87_328_8,r_210_24_143,0.97,0,143,143,21
161,seq86,r_222_204_165,seq101,r_222_204_165,0.93,-99,66,165,22
3,r_269_249_174,seq314,r_262_309_139,r_269_249_174,0.85,2,176,174,22
122,r_65_81_121,r_169_230_166,r_231_292_52,r_65_81_121,1.0,0,121,121,22
159,seq83,seq77,r_10_150_95,r_10_150_95,1.0,2,97,95,22
28,r_260_153_76,seq200,seq225,r_260_153_76,1.0,0,76,76,22
63,r_374_285_42,seq166,seq329,r_374_285_42,0.93,1,43,42,22
81,r_97_336_132,seq276,r_40_271_132,r_97_336_132,1.0,0,132,132,22
42,r_174_138_149,seq256,r_190_7_61,r_174_138_149,0.98,0,149,149,22
109,r_300_20_35,r_61_189_137,seq178,r_300_20_35,1.0,0,35,35,22
29,r_318_257_134,seq89,r_319_152_39,r_318_257_134,0.7,6,140,134,22
56,r_67_351_154,seq114,r_54_46_73,r_67_351_154,1.0,1,155,154,22
84,r_287_293_71,r_169_230_166,seq353,r_287_293_71,1.0,0,71,71,22
61,r_47_320_171,r_167_84_91,r_181_142_69,r_47_320_171,1.0,-80,91,171,22
40,r_227_209_39,r_201_82_172,r_191_349_4,r_227_209_39,0.99,0,39,39,22
59,r_332_146_61,seq165,seq134,r_332_146_61,1.0,0,61,61,22
80,r_129_253_72,seq39,r_299_324_197,r_129_253_72,1.0,0,72,72,22
134,seq17,r_345_16_152,r_171_211_75,r_345_16_152,0.54,0,152,152,22
15,r_333_315_143,seq118,seq32,r_333_315_143,1.0,0,143,143,22
124,r_306_49_53,r_67_351_154,r_76_154_35,r_306_49_53,0.94,0,53,53,22
101,r_179_268_133,r_229_117_144,r_59_123_77,r_179_268_133,1.0,0,133,133,22
139,seq26,r_95_233_187,r_24_192_31,r_95_233_187,1.0,0,187,187,22
12,r_220_298_84,r_262_309_139,r_108_116_48,r_108_116_48,0.81,41,89,48,22
22,r_31_12_149,r_126_334_42,seq3,r_31_12_149,1.0,0,149,149,22
211,seq238,r_181_142_69,seq353,r_181_142_69,1.0,0,69,69,22
24,r_40_271_132,r_299_324_197,r_289_368_5,r_40_271_132,0.97,1,133,132,22
39,r_235_1_94,r_31_12_149,seq184,r_235_1_94,1.0,1,95,94,22
19,r_107_207_151,seq3,r_21_317_46,r_107_207_151,1.0,2,153,151,22
62,r_297_291_161,seq32,r_288_313_4,r_297_291_161,1.0,0,161,161,22
10,r_171_211_75,seq134,seq89,r_171_211_75,1.0,1,76,75,22
208,seq228,r_229_117_144,r_235_1_94,r_235_1_94,0.98,55,149,94,22
102,r_226_102_74,r_31_12_149,r_299_324_197,r_226_102_74,1.0,0,74,74,22
96,r_331_71_101,seq37,r_108_116_48,r_331_71_101,0.92,0,101,101,22
13,r_338_132_175,r_370_275_185,r_299_324_197,r_370_275_185,0.88,-5,180,185,22
82,r_265_259_78,r_169_230_166,r_213_159_63,r_169_230_166,0.52,-80,86,166,22
218,seq256,r_174_138_149,r_24_192_31,r_174_138_149,1.0,0,149,149,22
34,r_231_292_52,r_66_168_146,seq22,r_231_292_52,0.92,0,52,52,22
85,r_369_264_22,r_169_230_166,seq137,r_369_264_22,0.65,0,22,22,22
45,r_352_195_146,r_172_357_164,r_51_157_79,r_51_157_79,0.96,68,147,79,22
119,r_234_206_140,r_158_6_120,r_59_123_77,r_234_206_140,0.99,0,140,140,22
48,r_319_152_39,r_267_151_157,seq166,r_319_152_39,1.0,0,39,39,22
99,r_105_58_145,seq343,r_59_123_77,r_105_58_145,1.0,0,145,145,22
9,r_190_7_61,r_295_177_84,seq15,r_190_7_61,1.0,0,61,61,22
35,r_64_224_168,seq91,r_76_154_35,r_64_224_168,0.72,12,180,168,22
6,r_316_163_173,seq263,r_191_349_4,r_316_163_173,1.0,1,174,173,22
89,r_212_261_19,r_135_373_33,r_50_327_8,r_212_261_19,1.0,0,19,19,22
78,r_176_362_35,r_355_63_124,r_9_242_96,r_355_63_124,1.0,0,124,124,22
14,r_355_63_124,r_299_324_197,r_176_362_35,r_176_362_35,0.93,-19,16,35,22
90,r_147_197_52,r_36_272_194,seq343,r_147_197_52,1.0,0,52,52,22
55,r_167_84_91,r_47_320_171,seq238,r_167_84_91,1.0,0,91,91,22
226,seq284,seq178,r_181_142_69,r_181_142_69,1.0,18,87,69,22
36,r_361_180_10,r_169_230_166,r_191_349_4,r_361_180_10,1.0,2,12,10,22
4,r_29_110_14,r_135_373_33,seq3,r_29_110_14,0.94,0,14,14,22
49,r_216_274_173,r_162_144_6,r_126_334_42,r_216_274_173,0.98,0,173,173,22
61,r_47_320_171,r_181_142_69,r_246_203_21,r_47_320_171,0.99,0,171,171,22
198,seq200,r_260_153_76,r_50_327_8,r_260_153_76,1.0,1,77,76,22
113,r_250_73_151,seq186,r_332_146_61,r_250_73_151,1.0,0,151,151,22
31,r_24_192_31,r_112_90_74,r_156_241_6,r_24_192_31,0.62,1,32,31,22
202,seq215,seq134,r_126_334_42,r_126_334_42,0.99,41,83,42,22
116,r_247_38_102,seq93,r_325_111_22,r_247_38_102,1.0,0,102,102,22
88,r_295_177_84,r_169_230_166,seq19,r_295_177_84,1.0,1,85,84,22
127,seq3,r_72_312_177,r_29_110_14,r_29_110_14,1.0,2,16,14,22
33,r_135_373_33,seq358,seq276,r_135_373_33,0.81,6,39,33,22
106,r_175_303_108,seq4,r_287_293_71,r_175_303_108,0.99,0,108,108,22
8,r_54_46_73,seq60,r_258_366_17,r_54_46_73,1.0,0,73,73,22
26,r_173_273_24,seq34,r_288_313_4,r_173_273_24,0.97,1,25,24,22
67,r_229_117_144,seq228,r_288_313_4,r_229_117_144,0.7,5,149,144,22
71,r_267_151_157,r_319_152_39,r_29_110_14,r_267_151_157,0.81,-118,39,157,22
118,r_52_348_27,r_318_257_134,r_50_327_8,r_52_348_27,0.97,1,28,27,22
92,r_172_357_164,r_54_46_73,r_337_143_126,r_172_357_164,0.86,0,164,164,22
115,r_325_111_22,seq114,r_31_12_149,r_325_111_22,1.0,0,22,22,22
103,r_322_121_47,r_48_92_138,seq186,r_48_92_138,0.86,-86,52,138,22
76,r_41_68_66,r_355_63_124,r_213_159_63,r_41_68_66,1.0,0,66,66,22
115,r_325_111_22,r_31_12_149,r_247_38_102,r_325_111_22,1.0,96,118,22,22
66,r_30_130_133,r_370_275_185,r_337_143_126,r_337_143_126,0.61,11,137,126,22
94,r_258_366_17,r_365_62_164,r_277_350_4,r_258_366_17,0.79,0,17,17,22
37,r_305_307_175,seq124,seq91,r_305_307_175,1.0,0,175,175,22
27,r_337_143_126,seq3,r_280_88_36,r_337_143_126,0.95,0,126,126,22
92,r_172_357_164,r_352_195_146,r_54_46_73,r_172_357_164,0.55,-17,147,164,22
112,r_363_236_20,r_167_84_91,seq301,r_363_236_20,0.84,0,20,20,22
70,r_280_88_36,r_107_207_151,seq98,r_280_88_36,0.66,1,37,36,22
111,r_95_233_187,seq26,r_220_298_84,r_95_233_187,0.98,0,187,187,22
72,r_96_359_15,r_169_230_166,seq358,r_96_359_15,0.55,1,16,15,22
74,r_321_8_139,seq45,r_252_183_30,r_321_8_139,1.0,0,139,139,22
108,r_365_62_164,r_76_154_35,r_235_1_94,r_365_62_164,1.0,0,164,164,22
211,seq238,seq353,r_167_84_91,r_167_84_91,1.0,9,100,91,22
0,r_160_196_156,r_172_357_164,r_107_207_151,r_160_196_156,1.0,0,156,156,22
246,seq353,seq193,r_287_293_71,r_287_293_71,1.0,15,86,71,22
50,r_158_6_120,r_234_206_140,r_288_313_4,r_234_206_140,1.0,-20,120,140,22
110,r_44_109_77,r_299_324_197,r_59_123_77,r_44_109_77,0.61,1,78,77,22
58,r_213_159_63,seq13,seq2,r_213_159_63,0.99,0,63,63,22
71,r_267_151_157,r_29_110_14,r_337_143_126,r_29_110_14,0.71,136,150,14,22
133,seq15,seq60,r_190_7_61,r_190_7_61,1.0,5,66,61,22
65,r_181_142_69,seq238,seq284,r_181_142_69,1.0,0,69,69,22
30,r_74_43_85,r_318_257_134,r_36_272_194,r_74_43_85,0.85,5,90,85,22
123,r_10_150_95,r_299_324_197,seq83,r_10_150_95,1.0,1,96,95,22
5,r_169_230_166,r_367_302_196,r_120_100_50,r_169_230_166,0.98,3,169,166,22
202,seq215,r_126_334_42,r_94_245_129,r_126_334_42,0.54,128,170,42,22
2,r_72_312_177,seq25,r_190_7_61,r_72_312_177,1.0,5,182,177,22
108,r_365_62_164,r_250_73_151,r_76_154_35,r_76_154_35,0.63,4,39,35,22
93,r_246_203_21,r_61_189_137,r_277_350_4,r_246_203_21,1.0,0,21,21,22
95,r_106_188_88,seq22,seq165,r_106_188_88,1.0,0,88,88,22
14,r_355_63_124,r_176_362_35,seq22,r_355_63_124,1.0,0,124,124,22
79,r_222_204_165,seq86,r_162_144_6,r_222_204_165,1.0,0,165,165,22
100,r_9_242_96,r_36_272_194,r_176_362_35,r_9_242_96,0.79,-6,90,96,22
47,r_252_183_30,r_318_257_134,seq2,r_252_183_30,1.0,0,30,30,22
114,r_347_364_81,seq125,r_306_49_53,r_347_364_81,0.98,0,81,81,22
104,r_205_346_61,r_181_142_69,seq127,r_205_346_61,1.0,0,61,61,22
83,r_51_157_79,r_262_309_139,seq70,r_51_157_79,1.0,0,79,79,22
46,r_120_100_50,r_21_317_46,seq314,r_120_100_50,1.0,-1,49,50,22
41,r_119_103_170,seq223,r_171_211_75,r_119_103_170,1.0,0,170,170,22
22,r_31_12_149,r_226_102_74,r_126_334_42,r_226_102_74,0.96,0,74,74,22
60,r_370_275_185,seq283,r_316_163_173,r_370_275_185,0.76,2,187,185,22
7,r_76_154_35,r_365_62_164,r_306_49_53,r_365_62_164,0.74,-46,118,164,22
120,r_108_116_48,r_48_92_138,r_96_359_15,r_108_116_48,1.0,0,48,48,22
128,seq4,r_175_303_108,seq256,r_175_303_108,1.0,0,108,108,22
136,seq19,seq134,r_295_177_84,r_295_177_84,1.0,-1,83,84,22
97,r_149_344_130,seq22,r_287_293_71,r_149_344_130,1.0,3,133,130,22
73,r_345_16_152,seq17,r_201_82_172,r_345_16_152,1.0,0,152,152,22
7,r_76_154_35,seq244,r_365_62_164,r_76_154_35,0.91,0,35,35,22
43,r_48_92_138,seq104,seq263,r_48_92_138,1.0,0,138,138,22
51,r_113_304_152,seq239,r_185_214_1,r_113_304_152,1.0,0,152,152,22
54,r_94_245_129,seq0,r_332_146_61,r_94_245_129,0.97,0,129,129,22
69,r_112_90_74,r_370_275_185,seq125,r_112_90_74,1.0,0,74,74,22
98,r_21_317_46,r_120_100_50,seq127,r_21_317_46,1.0,3,49,46,22
78,r_176_362_35,r_318_257_134,r_355_63_124,r_355_63_124,0.72,-108,16,124,22
11,r_194_372_50,r_174_138_149,r_176_362_35,r_194_372_50,0.99,2,52,50,22
172,seq124,r_305_307_175,r_185_214_1,r_305_307_175,1.0,0,175,175,22
77,r_354_57_140,r_61_189_137,seq310,r_354_57_140,1.0,0,140,140,22
68,r_281_254_143,seq137,r_94_245_129,r_281_254_143,0.99,0,143,143,22
17,r_126_334_42,r_95_233_187,r_325_111_22,r_126_334_42,1.0,0,42,42,22
105,r_162_144_6,r_216_274_173,seq240,r_216_274_173,1.0,0,173,173,22
9,r_353_371_183,r_231_37_197,r_27_230_110,r_353_371_183,0.99,0,183,183,23
96,r_198_121_172,seq23,r_162_331_147,r_198_121_172,0.98,1,173,172,23
55,r_343_31_170,r_229_304_152,r_66_325_17,r_343_31_170,1.0,0,170,170,23
123,r_287_270_86,r_200_160_198,seq35,r_200_160_198,0.93,-103,95,198,23
186,seq187,r_22_206_166,r_172_94_41,r_172_94_41,0.87,5,46,41,23
14,r_302_83_111,r_111_158_131,seq114,r_302_83_111,1.0,0,111,111,23
113,r_147_363_50,r_12_273_181,seq17,r_147_363_50,1.0,0,50,50,23
49,r_318_18_157,seq157,r_3_38_38,r_318_18_157,1.0,0,157,157,23
107,r_151_307_188,seq14,r_237_244_30,r_151_307_188,1.0,0,188,188,23
34,r_32_126_146,r_344_240_162,seq252,r_32_126_146,1.0,0,146,146,23
7,r_358_260_74,r_186_279_160,r_225_53_20,r_186_279_160,1.0,0,160,160,23
17,r_282_92_148,seq49,r_287_270_86,r_282_92_148,1.0,1,149,148,23
18,r_345_267_51,r_32_126_146,seq106,r_345_267_51,1.0,0,51,51,23
59,r_245_88_69,r_165_238_194,seq259,r_245_88_69,1.0,0,69,69,23
60,r_339_130_134,seq41,r_22_206_166,r_339_130_134,0.86,3,137,134,23
28,r_207_76_166,seq21,r_216_285_125,r_207_76_166,1.0,0,166,166,23
27,r_359_239_140,r_40_102_8,r_265_210_142,r_359_239_140,1.0,0,140,140,23
80,r_84_361_129,seq63,seq14,r_84_361_129,1.0,0,129,129,23
142,seq49,r_282_92_148,r_80_55_17,r_282_92_148,1.0,1,149,148,23
108,r_71_234_170,r_231_37_197,seq211,r_71_234_170,0.98,0,170,170,23
51,r_131_1_93,r_64_362_148,r_174_219_67,r_131_1_93,1.0,0,93,93,23
83,r_312_135_46,seq306,seq243,r_312_135_46,1.0,2,48,46,23
70,r_67_62_74,r_253_167_88,seq11,r_67_62_74,1.0,0,74,74,23
84,r_229_304_152,r_344_240_162,r_181_96_44,r_344_240_162,0.61,-3,159,162,23
117,r_146_255_143,r_25_171_148,seq269,r_146_255_143,0.96,4,147,143,23
48,r_303_152_25,r_32_126_146,seq252,r_303_152_25,0.98,9,34,25,23
22,r_216_285_125,seq17,seq14,r_216_285_125,1.0,0,125,125,23
52,r_36_86_110,r_191_93_185,r_129_190_16,r_36_86_110,1.0,0,110,110,23
71,r_321_189_34,r_29_26_122,seq328,r_321_189_34,1.0,1,35,34,23
19,r_29_26_122,seq298,seq159,r_29_26_122,1.0,0,122,122,23
171,seq150,r_165_238_194,seq374,r_165_238_194,0.62,-105,89,194,23
102,r_347_337_138,r_236_299_73,r_79_357_15,r_347_337_138,1.0,0,138,138,23
4,r_224_316_96,r_153_249_190,seq128,r_224_316_96,0.86,8,104,96,23
8,r_228_268_108,seq195,seq284,r_228_268_108,1.0,2,110,108,23
140,seq41,r_339_130_134,seq233,r_339_130_134,0.99,3,137,134,23
37,r_39_4_190,seq178,r_237_244_30,r_39_4_190,0.98,0,190,190,23
11,r_66_325_17,r_140_142_87,r_67_62_74,r_66_325_17,1.0,72,89,17,23
39,r_367_48_125,seq218,r_29_26_122,r_367_48_125,0.89,9,134,125,23
114,r_80_55_17,r_257_16_83,seq175,r_80_55_17,1.0,0,17,17,23
53,r_25_171_148,r_146_255_143,r_74_98_19,r_25_171_148,0.97,-4,144,148,23
58,r_162_331_147,seq298,r_204_346_180,r_162_331_147,1.0,1,148,147,23
44,r_174_219_67,r_216_285_125,seq157,r_174_219_67,0.99,0,67,67,23
65,r_184_52_122,r_275_290_10,r_122_248_7,r_184_52_122,0.99,-1,121,122,23
99,r_274_365_98,seq59,seq305,r_274_365_98,1.0,0,98,98,23
0,r_12_273_181,seq211,r_146_255_143,r_12_273_181,1.0,0,181,181,23
50,r_235_326_35,r_282_92_148,r_119_332_17,r_235_326_35,0.8,6,41,35,23
42,r_82_13_138,seq60,r_74_98_19,r_82_13_138,0.93,0,138,138,23
2,r_262_100_183,seq138,r_302_83_111,r_262_100_183,0.98,2,185,183,23
57,r_272_342_97,r_39_4_190,r_119_332_17,r_272_342_97,1.0,0,97,97,23
69,r_186_279_160,r_140_142_87,r_358_260_74,r_358_260_74,0.69,2,76,74,23
78,r_341_370_127,seq221,r_174_219_67,r_341_370_127,1.0,0,127,127,23
15,r_79_357_15,seq17,seq369,r_79_357_15,0.98,0,15,15,23
72,r_236_299_73,seq70,r_347_337_138,r_236_299_73,0.88,1,74,73,23
124,r_300_143_147,r_226_110_150,r_148_77_7,r_300_143_147,0.51,4,151,147,23
1,r_15_90_16,r_216_285_125,r_64_362_148,r_15_90_16,0.99,0,16,16,23
12,r_2_8_131,r_318_18_157,r_43_197_8,r_2_8_131,1.0,0,131,131,23
38,r_344_240_162,r_343_31_170,r_40_102_8,r_344_240_162,1.0,0,162,162,23
76,r_309_261_13,r_39_4_190,seq138,r_309_261_13,1.0,0,13,13,23
58,r_162_331_147,r_204_346_180,r_198_121_172,r_162_331_147,0.52,34,181,147,23
206,seq243,seq10,r_312_135_46,r_312_135_46,1.0,52,98,46,23
66,r_349_324_120,r_109_46_122,r_303_152_25,r_349_324_120,1.0,1,121,120,23
183,seq179,r_141_57_91,seq87,r_141_57_91,1.0,0,91,91,23
103,r_275_290_10,r_169_50_57,r_250_283_120,r_250_283_120,1.0,0,120,120,23
166,seq128,seq63,r_224_316_96,r_224_316_96,0.62,8,104,96,23
65,r_184_52_122,r_359_239_140,r_275_290_10,r_275_290_10,0.79,0,10,10,23
236,seq328,r_148_77_7,r_321_189_34,r_321_189_34,0.85,7,41,34,23
112,r_140_142_87,r_66_325_17,r_40_102_8,r_140_142_87,1.0,2,89,87,23
68,r_118_91_22,seq179,seq14,r_118_91_22,0.94,0,22,22,23
103,r_275_290_10,r_184_52_122,r_169_50_57,r_169_50_57,0.92,7,64,57,23
40,r_191_93_185,seq241,r_228_268_108,r_191_93_185,0.99,0,185,185,23
91,r_141_57_91,seq179,r_200_160_198,r_141_57_91,1.0,0,91,91,23
102,r_347_337_138,r_196_352_47,r_236_299_73,r_196_352_47,0.98,0,47,47,23
82,r_329_203_113,r_12_273_181,r_312_135_46,r_329_203_113,1.0,0,113,113,23
63,r_360_297_151,seq60,r_237_244_30,r_237_244_30,0.57,124,154,30,23
93,r_124_193_140,seq306,r_339_130_134,r_124_193_140,1.0,1,141,140,23
167,seq134,r_129_190_16,r_119_332_17,r_129_190_16,0.59,23,39,16,23
72,r_236_299_73,r_347_337_138,r_225_53_20,r_347_337_138,0.97,0,138,138,23
150,seq70,r_236_299_73,r_277_350_73,r_277_350_73,0.99,1,74,73,23
79,r_294_7_139,seq20,r_89_180_88,r_89_180_88,0.58,57,145,88,23
35,r_204_346_180,r_343_31_170,r_148_77_7,r_343_31_170,1.0,1,171,170,23
62,r_85_105_46,r_282_92_148,r_172_94_41,r_85_105_46,0.95,0,46,46,23
212,seq259,r_262_100_183,r_245_88_69,r_245_88_69,1.0,14,83,69,23
41,r_54_44_117,seq242,r_366_133_4,r_54_44_117,0.97,6,123,117,23
95,r_177_320_43,r_359_239_140,r_172_94_41,r_177_320_43,1.0,0,43,43,23
6,r_292_182_72,seq73,seq348,r_292_182_72,1.0,-1,71,72,23
54,r_75_333_22,r_25_171_148,seq227,r_75_333_22,0.88,0,22,22,23
16,r_97_201_172,seq322,r_15_90_16,r_97_201_172,1.0,0,172,172,23
97,r_265_210_142,r_344_240_162,r_359_239_140,r_265_210_142,1.0,1,143,142,23
10,r_172_94_41,r_207_76_166,seq187,r_207_76_166,0.76,-122,44,166,23
31,r_19_276_120,r_22_206_166,r_89_180_88,r_89_180_88,0.92,33,121,88,23
7,r_358_260_74,r_277_350_73,r_186_279_160,r_186_279_160,1.0,-82,78,160,23
105,r_78_65_151,seq63,r_302_83_111,r_78_65_151,0.99,0,151,151,23
45,r_3_38_38,seq175,seq28,r_3_38_38,1.0,0,38,38,23
75,r_200_160_198,r_287_270_86,r_141_57_91,r_141_57_91,1.0,4,95,91,23
104,r_0_136_143,seq310,r_75_333_22,r_0_136_143,1.0,0,143,143,23
21,r_257_16_83,r_131_1_93,r_245_88_69,r_257_16_83,0.93,3,86,83,23
116,r_169_50_57,seq114,r_275_290_10,r_169_50_57,1.0,1,58,57,23
29,r_89_180_88,r_2_8_131,seq247,r_89_180_88,0.99,1,89,88,23
46,r_109_46_122,seq35,seq63,r_109_46_122,1.0,1,123,122,23
115,r_319_256_180,seq328,r_148_77_7,r_319_256_180,0.62,-29,151,180,23
103,r_275_290_10,r_294_7_139,r_184_52_122,r_275_290_10,0.93,0,10,10,23
13,r_181_96_44,r_192_176_5,seq348,r_181_96_44,1.0,0,44,44,23
47,r_208_336_25,r_165_238_194,r_366_133_4,r_208_336_25,0.93,0,25,25,23
27,r_359_239_140,r_177_320_43,r_40_102_8,r_359_239_140,0.51,-118,22,140,23
33,r_196_352_47,r_347_337_138,seq252,r_196_352_47,1.0,0,47,47,23
147,seq63,seq108,r_232_42_85,r_232_42_85,1.0,5,90,85,23
168,seq138,r_262_100_183,r_225_53_20,r_225_53_20,0.7,-1,19,20,23
69,r_186_279_160,r_358_260_74,r_109_46_122,r_186_279_160,0.73,0,160,160,23
81,r_250_283_120,r_25_171_148,r_275_290_10,r_250_283_120,1.0,0,120,120,23
87,r_253_167_88,seq306,seq20,r_253_167_88,1.0,1,89,88,23
43,r_354_209_51,seq183,seq63,r_354_209_51,1.0,0,51,51,23
25,r_74_98_19,r_147_363_50,r_79_357_15,r_74_98_19,1.0,0,19,19,23
100,r_40_102_8,r_359_239_140,r_140_142_87,r_40_102_8,0.72,123,131,8,23
111,r_111_158_131,seq9,r_109_46_122,r_109_46_122,0.83,9,131,122,23
56,r_27_230_110,seq195,seq154,r_27_230_110,0.86,5,115,110,23
121,r_246_215_166,seq28,r_146_255_143,r_246_215_166,1.0,0,166,166,23
67,r_225_53_20,r_168_103_71,seq138,r_168_103_71,0.88,-52,19,71,23
61,r_148_347_191,r_352_257_128,seq170,r_352_257_128,1.0,0,128,128,24
92,r_339_25_128,seq123,seq59,r_339_25_128,0.99,3,131,128,24
47,r_16_240_106,seq366,r_192_252_176,r_16_240_106,1.0,0,106,106,24
5,r_259_370_100,r_184_357_56,r_242_153_52,r_184_357_56,0.98,0,56,56,24
231,seq295,r_329_93_81,seq156,r_329_93_81,1.0,2,83,81,24
42,r_227_333_86,r_278_26_91,r_0_32_83,r_278_26_91,1.0,-5,86,91,24
4,r_187_193_76,r_278_26_91,r_232_342_4,r_187_193_76,1.0,0,76,76,24
79,r_113_185_149,seq368,r_215_3_112,r_113_185_149,1.0,0,149,149,24
225,seq287,r_237_117_196,r_4_269_52,r_4_269_52,0.59,97,149,52,24
90,r_99_251_164,r_103_107_101,r_97_361_48,r_99_251_164,1.0,-90,74,164,24
81,r_81_372_32,r_181_218_161,seq45,r_81_372_32,1.0,0,32,32,24
29,r_179_306_131,r_137_255_155,r_241_68_90,r_179_306_131,1.0,0,131,131,24
59,r_0_32_83,r_241_68_90,r_164_64_53,r_0_32_83,0.9,0,83,83,24
104,r_215_3_112,seq165,r_152_204_127,r_215_3_112,0.6,3,115,112,24
94,r_166_282_78,seq112,seq246,r_166_282_78,1.0,-1,77,78,24
43,r_217_106_107,r_24_254_183,r_301_146_79,r_217_106_107,1.0,0,107,107,24
76,r_330_27_62,seq72,seq298,r_330_27_62,1.0,0,62,62,24
138,seq36,r_302_75_195,r_213_151_133,r_302_75_195,0.97,-10,185,195,24
64,r_340_288_67,seq47,r_220_203_20,r_340_288_67,1.0,0,67,67,24
51,r_183_198_22,r_137_255_155,seq202,r_183_198_22,1.0,0,22,22,24
101,r_103_107_101,r_99_251_164,seq246,r_103_107_101,1.0,2,103,101,24
108,r_169_221_168,seq368,r_20_41_1,r_169_221_168,0.95,1,169,168,24
119,r_120_312_142,r_97_361_48,r_220_203_20,r_120_312_142,0.99,-120,22,142,24
89,r_374_266_14,r_244_356_45,r_250_359_10,r_374_266_14,0.74,0,14,14,24
77,r_277_373_88,r_339_25_128,seq366,r_277_373_88,1.0,0,88,88,24
62,r_144_110_21,r_13_52_146,r_90_280_4,r_144_110_21,0.99,0,21,21,24
105,r_367_229_179,seq249,r_164_64_53,r_367_229_179,0.9,0,179,179,24
209,seq246,r_235_17_114,r_242_153_52,r_235_17_114,1.0,-22,92,114,24
110,r_314_44_92,r_276_211_169,seq54,r_314_44_92,0.96,1,93,92,24
57,r_116_141_187,seq88,r_164_64_53,r_116_141_187,1.0,0,187,187,24
96,r_138_15_57,r_190_308_12,r_134_360_51,r_138_15_57,1.0,6,63,57,24
66,r_194_316_170,r_192_252_176,r_55_109_88,r_194_316_170,1.0,0,170,170,24
40,r_184_357_56,r_259_370_100,seq36,r_184_357_56,1.0,0,56,56,24
83,r_163_79_165,seq253,r_164_64_53,r_163_79_165,0.97,0,165,165,24
120,r_293_114_86,r_217_106_107,r_329_93_81,r_293_114_86,0.5,4,90,86,24
233,seq299,r_155_268_159,seq74,r_155_268_159,1.0,0,159,159,24
33,r_182_364_137,r_207_2_111,r_278_26_91,r_182_364_137,0.76,-16,121,137,24
97,r_220_203_20,r_120_312_142,r_340_288_67,r_120_312_142,0.95,-1,141,142,24
112,r_328_304_31,seq354,r_18_53_100,r_18_53_100,1.0,43,143,100,24
44,r_1_136_125,seq45,seq285,r_1_136_125,1.0,0,125,125,24
82,r_315_139_123,seq45,r_20_41_1,r_315_139_123,1.0,0,123,123,24
71,r_278_26_91,r_215_3_112,r_182_364_137,r_278_26_91,1.0,1,92,91,24
10,r_230_200_157,seq275,r_369_318_51,r_230_200_157,1.0,2,159,157,24
139,seq39,r_11_87_168,r_300_307_2,r_11_87_168,1.0,0,168,168,24
121,r_118_133_70,r_81_372_32,seq173,r_118_133_70,1.0,0,70,70,24
87,r_262_327_125,seq104,r_250_359_10,r_262_327_125,0.75,13,138,125,24
69,r_302_75_195,r_18_53_100,r_184_357_56,r_302_75_195,1.0,-134,61,195,24
31,r_91_145_155,seq23,r_241_68_90,r_91_145_155,0.71,0,155,155,24
142,seq45,r_1_136_125,seq9,r_1_136_125,1.0,0,125,125,24
37,r_329_93_81,seq295,r_293_114_86,r_329_93_81,0.97,13,94,81,24
114,r_301_146_79,r_242_153_52,seq50,r_301_146_79,1.0,-4,75,79,24
227,seq290,r_111_205_112,seq74,r_111_205_112,1.0,2,114,112,24
30,r_97_361_48,r_99_251_164,r_34_332_109,r_97_361_48,0.97,119,167,48,24
27,r_4_269_52,r_152_204_127,seq71,r_4_269_52,1.0,3,55,52,24
6,r_181_218_161,seq212,seq104,r_181_218_161,1.0,2,163,161,24
97,r_220_203_20,r_187_193_76,r_120_312_142,r_220_203_20,1.0,1,21,20,24
113,r_69_124_128,r_20_41_1,seq7,r_69_124_128,1.0,0,128,128,24
112,r_328_304_31,r_187_193_76,seq354,r_328_304_31,1.0,0,31,31,24
46,r_134_360_51,r_334_168_56,seq287,r_134_360_51,0.52,0,51,51,24
67,r_108_65_47,r_49_77_158,seq86,r_108_65_47,0.96,0,47,47,24
19,r_369_318_51,r_90_280_4,seq21,r_369_318_51,1.0,4,55,51,24
71,r_278_26_91,r_182_364_137,seq225,r_182_364_137,1.0,0,137,137,24
65,r_303_177_64,r_237_117_196,r_330_27_62,r_303_177_64,0.98,0,64,64,24
21,r_352_257_128,r_148_347_191,r_118_133_70,r_352_257_128,1.0,0,128,128,24
5,r_259_370_100,r_242_153_52,seq219,r_259_370_100,0.99,0,100,100,24
72,r_323_6_18,r_192_252_176,seq72,r_323_6_18,0.76,-2,16,18,24
75,r_226_320_141,seq180,seq9,r_226_320_141,1.0,4,145,141,24
0,r_241_68_90,r_283_127_191,seq35,r_241_68_90,1.0,-1,89,90,24
121,r_118_133_70,seq222,r_81_372_32,r_81_372_32,0.83,7,39,32,24
36,r_326_358_75,seq54,seq104,r_326_358_75,1.0,1,76,75,24
35,r_334_168_56,r_34_332_109,seq43,r_334_168_56,1.0,0,56,56,24
63,r_60_273_182,r_97_361_48,r_217_106_107,r_60_273_182,0.98,0,182,182,24
117,r_11_87_168,seq39,r_182_364_137,r_11_87_168,1.0,0,168,168,24
34,r_135_128_92,seq157,seq150,r_135_128_92,1.0,1,93,92,24
13,r_213_151_133,seq291,seq36,r_213_151_133,0.78,2,135,133,24
18,r_137_255_155,r_179_306_131,r_18_53_100,r_137_255_155,1.0,-24,131,155,24
123,r_235_17_114,r_55_109_88,r_4_269_52,r_235_17_114,1.0,0,114,114,24
41,r_270_206_67,seq47,r_4_269_52,r_270_206_67,0.96,2,69,67,24
116,r_234_284_51,r_187_193_76,seq62,r_234_284_51,1.0,0,51,51,24
124,r_245_233_95,seq263,r_241_68_90,r_245_233_95,1.0,1,96,95,24
95,r_98_131_122,r_267_199_173,r_49_77_158,r_98_131_122,0.85,39,161,122,24
60,r_18_53_100,r_302_75_195,r_328_304_31,r_18_53_100,0.99,0,100,100,24
58,r_260_189_86,seq186,r_319_341_64,r_260_189_86,1.0,2,88,86,24
63,r_60_273_182,r_164_64_53,r_97_361_48,r_60_273_182,0.99,-130,52,182,24
84,r_242_153_52,r_331_28_127,seq246,r_242_153_52,0.99,2,54,52,24
74,r_95_231_125,r_226_320_141,seq305,r_95_231_125,1.0,0,125,125,24
168,seq112,r_166_282_78,r_108_65_47,r_166_282_78,0.81,-1,77,78,24
70,r_353_176_49,r_270_206_67,seq43,r_353_176_49,0.58,0,49,49,24
18,r_137_255_155,r_18_53_100,r_103_107_101,r_137_255_155,0.67,1,156,155,24
32,r_313_355_197,r_181_218_161,r_227_333_86,r_313_355_197,0.8,-100,97,197,24
11,r_164_64_53,r_103_107_101,seq43,r_164_64_53,0.97,0,53,53,24
166,seq104,r_262_327_125,r_326_358_75,r_326_358_75,0.9,63,138,75,24
196,seq202,r_230_200_157,r_183_198_22,r_183_198_22,1.0,0,22,22,24
30,r_97_361_48,r_120_312_142,r_99_251_164,r_97_361_48,1.0,0,48,48,24
20,r_346_311_119,r_20_41_1,seq246,r_346_311_119,0.99,3,122,119,24
106,r_228_132_124,seq239,r_34_332_109,r_228_132_124,0.8,2,126,124,24
85,r_24_254_183,seq35,r_49_77_158,r_24_254_183,0.97,0,183,183,24
56,r_34_332_109,seq298,r_97_361_48,r_34_332_109,0.92,0,109,109,24
73,r_325_154_136,seq42,r_241_68_90,r_325_154_136,1.0,0,136,136,24
22,r_363_73_130,r_20_41_1,r_346_311_119,r_20_41_1,1.0,129,130,1,24
115,r_40_100_141,seq82,seq12,r_40_100_141,1.0,0,141,141,24
86,r_8_158_24,r_230_200_157,seq247,r_8_158_24,0.92,-2,22,24,24
155,seq72,r_230_200_157,r_323_6_18,r_323_6_18,0.52,-2,16,18,24
14,r_319_341_64,r_228_132_124,seq22,r_319_341_64,1.0,0,64,64,24
90,r_99_251_164,r_97_361_48,r_226_320_141,r_99_251_164,0.99,0,164,164,24
25,r_19_67_114,seq31,r_227_333_86,r_19_67_114,1.0,0,114,114,24
16,r_207_2_111,r_182_364_137,seq305,r_182_364_137,0.87,-16,121,137,24
170,seq119,r_63_272_146,r_346_311_119,r_63_272_146,1.0,1,147,146,24
33,r_182_364_137,r_278_26_91,r_16_240_106,r_182_364_137,0.88,0,137,137,24
98,r_13_52_146,seq51,r_184_357_56,r_13_52_146,1.0,0,146,146,24
107,r_111_205_112,seq290,r_89_96_12,r_111_205_112,1.0,0,112,112,24
39,r_276_211_169,seq22,r_188_201_4,r_276_211_169,1.0,0,169,169,24
2,r_49_77_158,seq71,r_207_2_111,r_49_77_158,1.0,1,159,158,24
102,r_350_37_138,seq12,r_4_269_52,r_350_37_138,1.0,0,138,138,24
162,seq86,seq112,r_108_65_47,r_108_65_47,1.0,-1,46,47,24
127,seq10,r_260_189_86,r_188_201_4,r_260_189_86,0.99,-36,50,86,24
163,seq88,r_116_141_187,r_244_356_45,r_116_141_187,0.94,0,187,187,24
119,r_120_312_142,r_220_203_20,r_90_280_4,r_120_312_142,1.0,-1,141,142,24
1,r_55_109_88,r_235_17_114,seq126,r_235_17_114,0.72,-27,87,114,24
191,seq180,r_226_320_141,seq170,r_226_320_141,1.0,4,145,141,24
55,r_63_272_146,seq119,r_241_68_90,r_63_272_146,1.0,1,147,146,24
12,r_226_159_47,seq139,seq167,r_226_159_47,1.0,0,47,47,25
35,r_283_309_148,r_60_75_155,r_240_333_86,r_283_309_148,1.0,0,148,148,25
44,r_301_34_67,r_22_65_135,r_19_304_41,r_301_34_67,1.0,1,68,67,25
112,r_195_353_145,seq90,r_313_143_73,r_195_353_145,0.98,0,145,145,25
177,seq163,r_13_41_187,r_156_347_44,r_156_347_44,1.0,29,73,44,25
68,r_245_121_154,seq73,r_176_11_105,r_245_121_154,0.47,17,171,154,25
117,r_321_264_172,seq147,r_261_196_98,r_321_264_172,1.0,0,172,172,25
104,r_327_51_16,r_137_218_108,seq131,r_327_51_16,0.93,0,16,16,25
33,r_286_354_136,r_35_274_178,r_45_171_56,r_286_354_136,1.0,0,136,136,25
42,r_13_41_187,seq163,r_211_8_76,r_13_41_187,0.99,0,187,187,25
123,r_7_118_46,seq108,seq173,r_7_118_46,1.0,0,46,46,25
79,r_322_77_161,seq4,r_142_117_21,r_322_77_161,0.91,6,167,161,25
25,r_129_59_54,r_238_116_90,r_81_223_48,r_81_223_48,1.0,7,55,48,25
74,r_319_205_180,seq131,r_283_309_148,r_319_205_180,0.95,1,181,180,25
87,r_57_1_42,r_334_123_184,r_62_112_36,r_334_123_184,0.75,-142,42,184,25
65,r_242_227_102,r_334_123_184,r_138_12_14,r_242_227_102,0.99,3,105,102,25
244,seq363,r_211_8_76,r_102_153_56,r_211_8_76,1.0,-11,65,76,25
76,r_81_223_48,r_317_61_56,r_187_300_5,r_317_61_56,0.55,-4,52,56,25
36,r_98_184_118,seq29,seq52,r_98_184_118,1.0,9,127,118,25
57,r_46_239_38,r_263_373_151,seq305,r_263_373_151,1.0,-12,139,151,25
140,seq44,r_111_17_191,r_177_282_79,r_177_282_79,1.0,2,81,79,25
100,r_228_170_29,r_341_154_8,r_146_252_81,r_146_252_81,1.0,23,104,81,25
18,r_255_10_178,seq236,r_71_234_79,r_71_234_79,1.0,35,114,79,25
11,r_177_282_79,seq127,seq44,r_177_282_79,1.0,0,79,79,25
16,r_5_357_165,seq50,r_201_157_161,r_5_357_165,0.56,1,166,165,25
102,r_254_94_164,seq18,r_343_295_47,r_254_94_164,1.0,2,166,164,25
30,r_138_12_14,r_23_148_122,seq106,r_138_12_14,0.8,-1,13,14,25
27,r_296_246_27,r_334_123_184,seq285,r_296_246_27,0.92,0,27,27,25
72,r_142_117_21,r_162_292_108,r_138_12_14,r_142_117_21,1.0,0,21,21,25
151,seq85,r_47_338_157,seq202,r_47_338_157,1.0,-5,152,157,25
82,r_233_269_186,seq136,r_176_11_105,r_233_269_186,0.89,3,189,186,25
107,r_331_158_157,r_335_152_192,r_2_109_85,r_331_158_157,1.0,1,158,157,25
1,r_62_112_36,r_181_84_35,r_57_1_42,r_57_1_42,0.65,25,67,42,25
60,r_328_259_196,r_23_148_122,r_43_278_110,r_328_259_196,0.96,-74,122,196,25
20,r_133_267_16,r_13_41_187,seq168,r_133_267_16,0.71,0,16,16,25
147,seq67,seq168,r_71_234_79,r_71_234_79,1.0,-1,78,79,25
66,r_349_213_41,r_81_223_48,seq340,r_349_213_41,0.92,1,42,41,25
62,r_330_6_4,r_120_188_84,seq155,r_120_188_84,1.0,8,92,84,25
3,r_211_8_76,seq363,seq175,r_211_8_76,1.0,0,76,76,25
111,r_244_253_118,seq356,r_203_198_48,r_244_253_118,0.97,1,119,118,25
5,r_180_54_15,r_102_153_56,r_258_251_24,r_258_251_24,1.0,6,30,24,25
100,r_228_170_29,seq106,r_341_154_8,r_228_170_29,0.99,0,29,29,25
47,r_280_185_116,seq324,r_23_148_122,r_280_185_116,0.93,1,117,116,25
121,r_22_65_135,r_286_354_136,r_211_8_76,r_22_65_135,1.0,1,136,135,25
78,r_320_27_119,seq92,r_98_184_118,r_320_27_119,0.94,1,120,119,25
73,r_76_216_83,r_369_303_159,seq66,r_76_216_83,0.99,1,84,83,25
110,r_120_188_84,r_330_6_4,r_138_12_14,r_120_188_84,1.0,8,92,84,25
13,r_89_88_22,r_111_17_191,seq14,r_89_88_22,0.99,3,25,22,25
93,r_47_338_157,seq85,r_286_354_136,r_47_338_157,1.0,0,157,157,25
92,r_103_80_91,seq131,r_245_121_154,r_103_80_91,1.0,0,91,91,25
32,r_310_104_164,r_369_303_159,r_348_342_62,r_310_104_164,0.85,6,170,164,25
109,r_203_198_48,seq174,seq182,r_203_198_48,1.0,1,49,48,25
122,r_297_149_92,r_286_354_136,seq284,r_297_149_92,1.0,1,93,92,25
114,r_262_288_14,r_62_112_36,r_341_154_8,r_262_288_14,0.5,1,15,14,25
41,r_82_64_117,r_98_184_118,r_62_112_36,r_82_64_117,1.0,0,117,117,25
67,r_261_196_98,r_233_269_186,seq221,r_261_196_98,1.0,1,99,98,25
26,r_232_364_82,seq237,seq371,r_232_364_82,1.0,0,82,82,25
34,r_176_11_105,r_49_21_191,r_183_323_52,r_176_11_105,1.0,0,105,105,25
51,r_56_287_44,seq285,r_298_110_3,r_56_287_44,0.93,2,46,44,25
88,r_26_208_130,seq101,r_211_8_76,r_26_208_130,1.0,3,133,130,25
9,r_137_218_108,r_119_273_175,seq355,r_137_218_108,0.92,0,108,108,25
22,r_334_123_184,seq115,r_211_8_76,r_334_123_184,0.99,0,184,184,25
105,r_187_300_5,r_320_27_119,r_81_223_48,r_320_27_119,0.94,-38,81,119,25
124,r_140_189_73,r_162_292_108,r_142_117_21,r_140_189_73,1.0,0,73,73,25
71,r_24_332_83,r_47_338_157,r_19_304_41,r_24_332_83,1.0,0,83,83,25
58,r_2_109_85,r_137_218_108,seq337,r_2_109_85,1.0,0,85,85,25
2,r_209_151_138,seq362,seq31,r_209_151_138,0.85,1,139,138,25
222,seq305,r_263_373_151,seq285,r_263_373_151,1.0,-37,114,151,25
81,r_343_295_47,r_211_8_76,r_22_65_135,r_343_295_47,1.0,0,47,47,25
80,r_128_30_43,r_244_253_118,seq0,r_128_30_43,0.99,0,43,43,25
116,r_270_289_163,seq172,r_262_288_14,r_270_289_163,1.0,0,163,163,25
38,r_156_347_44,r_271_114_172,seq163,r_156_347_44,1.0,0,44,44,25
64,r_132_316_99,seq236,seq107,r_132_316_99,1.0,0,99,99,25
49,r_23_148_122,r_328_259_196,r_280_185_116,r_23_148_122,0.93,5,127,122,25
37,r_97_370_151,seq155,r_39_91_3,r_97_370_151,0.99,2,153,151,25
86,r_43_278_110,r_280_185_116,seq78,r_43_278_110,0.98,1,111,110,25
56,r_145_359_67,seq18,seq243,r_145_359_67,0.98,0,67,67,25
229,seq325,r_102_153_56,r_39_91_3,r_102_153_56,0.87,9,65,56,25
204,seq231,r_71_234_79,r_141_178_143,r_141_178_143,0.99,19,162,143,25
81,r_343_295_47,r_22_65_135,r_240_333_86,r_343_295_47,0.96,40,87,47,25
96,r_141_178_143,seq193,seq231,r_141_178_143,1.0,2,145,143,25
69,r_35_274_178,r_69_229_148,r_283_309_148,r_35_274_178,1.0,-30,148,178,25
91,r_19_304_41,r_141_178_143,r_301_34_67,r_19_304_41,0.98,37,78,41,25
31,r_68_219_44,seq291,seq107,r_68_219_44,0.95,2,46,44,25
94,r_69_229_148,r_35_274_178,r_137_218_108,r_69_229_148,1.0,0,148,148,25
77,r_45_171_56,seq166,seq50,r_45_171_56,1.0,3,59,56,25
28,r_124_315_144,seq113,r_279_281_141,r_279_281_141,1.0,10,151,141,25
91,r_19_304_41,r_245_121_154,r_141_178_143,r_19_304_41,0.9,1,42,41,25
157,seq96,r_349_213_41,seq356,r_349_213_41,0.58,-8,33,41,25
7,r_256_20_88,seq231,r_9_214_15,r_256_20_88,1.0,0,88,88,25
128,seq14,seq329,r_89_88_22,r_89_88_22,0.94,11,33,22,25
46,r_190_25_49,r_334_123_184,seq308,r_190_25_49,1.0,0,49,49,25
174,seq155,r_97_370_151,r_245_121_154,r_97_370_151,1.0,-7,144,151,25
8,r_102_153_56,seq325,seq363,r_102_153_56,0.54,7,63,56,25
84,r_119_273_175,r_224_294_188,seq210,r_119_273_175,1.0,0,175,175,25
118,r_72_222_142,r_233_269_186,r_140_189_73,r_140_189_73,0.59,74,147,73,25
45,r_238_116_90,r_201_157_161,seq360,r_238_116_90,1.0,0,90,90,25
23,r_307_100_151,seq160,r_7_118_46,r_307_100_151,1.0,7,158,151,25
0,r_279_281_141,seq217,r_124_315_144,r_279_281_141,0.78,0,141,141,25
63,r_207_164_143,seq249,seq236,r_207_164_143,1.0,0,143,143,25
53,r_248_275_105,seq311,seq15,r_248_275_105,1.0,0,105,105,25
17,r_71_234_79,seq40,r_255_10_178,r_71_234_79,1.0,0,79,79,25
48,r_60_75_155,seq329,r_177_282_79,r_60_75_155,0.98,3,158,155,25
85,r_191_86_129,r_245_121_154,r_150_268_26,r_191_86_129,0.99,2,131,129,25
90,r_70_277_147,seq0,seq18,r_70_277_147,0.65,0,147,147,25
21,r_271_114_172,seq202,r_62_112_36,r_271_114_172,1.0,0,172,172,25
55,r_369_303_159,seq165,r_279_281_141,r_369_303_159,0.68,8,167,159,25
39,r_162_292_108,r_335_152_192,r_129_59_54,r_162_292_108,1.0,0,108,108,25
106,r_265_351_134,seq324,r_211_8_76,r_265_351_134,1.0,0,134,134,25
99,r_240_333_86,seq285,r_343_295_47,r_240_333_86,0.95,0,86,86,25
40,r_263_373_151,seq305,r_46_239_38,r_46_239_38,0.83,21,59,38,25
18,r_255_10_178,r_71_234_79,r_348_342_62,r_255_10_178,0.98,0,178,178,25
15,r_348_342_62,seq260,r_37_241_166,r_348_342_62,0.99,1,63,62,25
43,r_215_368_185,seq18,r_35_274_178,r_215_368_185,1.0,0,185,185,25
17,r_71_234_79,r_255_10_178,r_211_8_76,r_255_10_178,1.0,0,178,178,25
57,r_46_239_38,seq38,r_263_373_151,r_46_239_38,0.89,1,39,38,25
61,r_201_157_161,seq337,r_132_316_99,r_201_157_161,0.99,0,161,161,25
10,r_146_252_81,r_280_185_116,r_228_170_29,r_146_252_81,1.0,0,81,81,25
98,r_318_186_171,seq308,r_176_11_105,r_318_186_171,1.0,1,172,171,25
40,r_263_373_151,r_46_239_38,r_190_25_49,r_263_373_151,1.0,1,152,151,25
146,seq66,seq237,r_76_216_83,r_76_216_83,0.97,10,93,83,25
103,r_358_79_89,seq290,r_58_28_1,r_358_79_89,1.0,1,90,89,25
19,r_258_251_24,r_207_164_143,r_180_54_15,r_258_251_24,0.97,-3,21,24,25
97,r_126_192_96,r_47_338_157,seq107,r_126_192_96,1.0,0,96,96,25
7,r_348_156_75,r_23_366_156,r_309_186_39,r_348_156_75,0.62,0,75,75,26
106,r_94_198_102,r_332_371_188,r_256_129_10,r_94_198_102,0.88,5,107,102,26
47,r_41_299_150,seq226,r_234_207_28,r_41_299_150,1.0,0,150,150,26
70,r_190_308_51,r_264_179_121,seq252,r_190_308_51,1.0,0,51,51,26
65,r_82_261_187,seq22,r_281_236_57,r_82_261_187,0.85,0,187,187,26
109,r_204_116_26,r_281_236_57,seq224,r_204_116_26,1.0,0,26,26,26
97,r_115_91_72,seq270,seq140,r_115_91_72,0.94,5,77,72,26
11,r_164_3_98,r_181_295_140,r_290_8_2,r_164_3_98,1.0,4,102,98,26
43,r_256_129_10,r_121_298_141,r_94_198_102,r_121_298_141,1.0,-11,130,141,26
76,r_286_52_114,seq262,r_93_227_94,r_286_52_114,1.0,0,114,114,26
96,r_293_9_46,r_72_283_102,seq140,r_293_9_46,0.7,0,46,46,26
88,r_197_62_162,seq11,r_69_323_70,r_197_62_162,0.95,1,163,162,26
85,r_131_35_158,seq133,r_121_298_141,r_131_35_158,1.0,0,158,158,26
118,r_2_314_35,r_86_15_114,seq269,r_2_314_35,0.91,0,35,35,26
238,seq330,r_183_296_95,r_146_217_82,r_183_296_95,1.0,0,95,95,26
227,seq303,r_37_58_166,seq184,r_37_58_166,1.0,-15,151,166,26
75,r_59_163_15,r_205_313_152,seq11,r_59_163_15,0.93,0,15,15,26
40,r_363_317_74,seq60,r_260_345_40,r_363_317_74,0.76,0,74,74,26
100,r_93_227_94,r_159_155_154,seq199,r_93_227_94,1.0,0,94,94,26
99,r_78_39_62,r_332_371_188,seq141,r_78_39_62,1.0,0,62,62,26
71,r_271_170_153,seq253,seq195,r_271_170_153,0.99,3,156,153,26
45,r_143_338_120,r_171_83_73,r_280_292_84,r_171_83_73,0.82,2,75,73,26
101,r_23_366_156,seq148,r_72_283_102,r_23_366_156,0.98,0,156,156,26
1,r_222_98_81,r_288_247_142,seq66,r_288_247_142,0.54,-61,81,142,26
103,r_114_254_88,seq224,r_122_36_7,r_114_254_88,1.0,0,88,88,26
117,r_336_265_19,seq253,seq46,r_336_265_19,0.86,-3,16,19,26
39,r_239_357_68,seq81,seq294,r_239_357_68,1.0,0,68,68,26
92,r_169_208_46,seq104,seq76,r_169_208_46,0.98,1,47,46,26
31,r_45_333_169,r_360_347_197,r_288_247_142,r_45_333_169,1.0,0,169,169,26
87,r_144_40_165,r_250_48_194,r_336_265_19,r_144_40_165,0.79,-1,164,165,26
42,r_280_292_84,r_288_247_142,r_143_338_120,r_280_292_84,0.87,0,84,84,26
68,r_365_268_78,r_159_155_154,r_336_265_19,r_365_268_78,1.0,0,78,78,26
28,r_356_344_139,seq275,r_146_217_82,r_356_344_139,0.7,0,139,139,26
41,r_145_61_142,seq106,r_189_232_104,r_145_61_142,1.0,0,142,142,26
105,r_341_84_186,seq46,r_146_217_82,r_341_84_186,0.67,1,187,186,26
14,r_127_370_169,seq6,r_260_345_40,r_127_370_169,1.0,0,169,169,26
72,r_223_362_51,r_281_236_57,seq66,r_223_362_51,1.0,0,51,51,26
27,r_210_259_19,r_187_152_84,seq6,r_210_259_19,1.0,0,19,19,26
210,seq253,r_271_170_153,seq277,r_271_170_153,1.0,0,153,153,26
5,r_257_284_63,r_32_182_96,seq289,r_257_284_63,0.97,2,65,63,26
9,r_359_238_171,r_153_21_141,seq57,r_153_21_141,0.56,32,173,141,26
36,r_266_13_158,seq212,seq24,r_266_13_158,1.0,0,158,158,26
116,r_225_233_67,r_171_83_73,r_360_347_197,r_225_233_67,1.0,0,67,67,26
190,seq188,r_42_255_141,r_196_109_136,r_42_255_141,1.0,-35,106,141,26
35,r_171_83_73,r_143_338_120,r_157_216_49,r_171_83_73,1.0,0,73,73,26
74,r_320_202_98,r_206_14_190,r_93_227_94,r_206_14_190,1.0,-92,98,190,26
170,seq128,r_42_255_141,r_240_101_36,r_42_255_141,0.98,-24,117,141,26
181,seq151,r_150_134_124,seq43,r_150_134_124,1.0,0,124,124,26
84,r_193_44_49,r_359_238_171,seq229,r_193_44_49,1.0,0,49,49,26
193,seq195,r_358_372_100,r_271_170_153,r_271_170_153,0.99,1,154,153,26
59,r_274_161_159,r_185_191_2,seq262,r_274_161_159,0.99,0,159,159,26
121,r_30_237_23,r_51_361_49,seq67,r_30_237_23,0.82,1,24,23,26
241,seq342,r_258_87_153,r_159_155_154,r_159_155_154,0.99,2,156,154,26
107,r_203_149_59,r_205_313_152,seq126,r_203_149_59,1.0,1,60,59,26
3,r_240_101_36,r_334_355_131,seq128,r_240_101_36,1.0,0,36,36,26
20,r_159_155_154,seq5,r_78_39_62,r_159_155_154,1.0,0,154,154,26
33,r_288_247_142,seq301,r_358_372_100,r_288_247_142,1.0,1,143,142,26
110,r_315_137_127,seq331,seq275,r_315_137_127,1.0,0,127,127,26
52,r_373_287_114,r_264_179_121,r_146_217_82,r_373_287_114,1.0,0,114,114,26
64,r_307_88_135,r_205_313_152,r_286_52_114,r_307_88_135,1.0,2,137,135,26
9,r_359_238_171,r_196_109_136,r_153_21_141,r_153_21_141,0.75,17,158,141,26
73,r_246_251_179,seq4,r_332_371_188,r_246_251_179,0.86,3,182,179,26
94,r_16_166_143,r_335_49_152,r_307_88_135,r_335_49_152,1.0,-7,145,152,26
24,r_334_355_131,r_245_99_186,seq73,r_334_355_131,1.0,0,131,131,26
91,r_358_372_100,seq38,seq1,r_358_372_100,1.0,0,100,100,26
55,r_121_298_141,r_256_129_10,r_51_361_49,r_121_298_141,1.0,0,141,141,26
61,r_108_112_53,r_37_58_166,seq5,r_108_112_53,0.61,1,54,53,26
122,r_154_305_97,seq270,r_318_160_9,r_154_305_97,1.0,0,97,97,26
124,r_165_340_92,r_288_247_142,r_146_217_82,r_165_340_92,1.0,0,92,92,26
108,r_200_230_16,r_187_152_84,seq374,r_200_230_16,0.74,-2,14,16,26
89,r_354_162_140,seq126,r_143_338_120,r_143_338_120,0.9,23,143,120,26
93,r_42_255_141,seq128,seq342,r_42_255_141,1.0,0,141,141,26
38,r_177_70_53,r_320_202_98,seq339,r_320_202_98,1.0,-42,56,98,26
112,r_90_267_119,r_213_321_196,r_122_36_7,r_90_267_119,1.0,1,120,119,26
80,r_86_15_114,seq68,seq342,r_86_15_114,0.99,1,115,114,26
6,r_205_313_152,seq242,r_290_8_2,r_205_313_152,1.0,1,153,152,26
19,r_63_80_89,seq133,seq66,r_63_80_89,1.0,0,89,89,26
129,seq6,r_127_370_169,r_210_259_19,r_127_370_169,1.0,0,169,169,26
90,r_37_58_166,seq303,seq180,r_37_58_166,1.0,0,166,166,26
17,r_113_316_38,seq73,r_356_344_139,r_113_316_38,1.0,0,38,38,26
8,r_189_232_104,seq0,r_280_292_84,r_189_232_104,1.0,0,104,104,26
79,r_360_347_197,r_45_333_169,r_225_233_67,r_45_333_169,0.81,-18,151,169,26
209,seq252,seq277,r_190_308_51,r_190_308_51,1.0,1,52,51,26
113,r_285_241_12,r_171_83_73,seq289,r_285_241_12,0.49,0,12,12,26
193,seq195,r_187_152_84,r_358_372_100,r_358_372_100,0.94,18,118,100,26
98,r_185_191_2,r_274_161_159,r_266_13_158,r_185_191_2,1.0,157,159,2,26
151,seq67,r_264_179_121,r_30_237_23,r_264_179_121,0.98,17,138,121,26
15,r_51_361_49,seq141,seq97,r_51_361_49,0.95,8,57,49,26
34,r_234_207_28,r_51_361_49,seq4,r_234_207_28,0.76,0,28,28,26
51,r_369_33_117,seq7,r_72_283_102,r_369_33_117,1.0,0,117,117,26
13,r_146_217_82,r_215_218_162,seq330,r_215_218_162,0.97,-77,85,162,26
119,r_176_56_54,r_63_80_89,r_47_325_199,r_47_325_199,0.64,-145,54,199,26
120,r_206_14_190,seq24,r_17_132_108,r_206_14_190,0.66,0,190,190,26
242,seq343,seq104,r_111_96_84,r_111_96_84,1.0,12,96,84,26
115,r_258_87_153,seq342,r_293_9_46,r_293_9_46,0.66,110,156,46,26
114,r_196_109_136,r_359_238_171,seq188,r_359_238_171,0.97,-33,138,171,26
56,r_249_77_169,r_213_321_196,r_285_241_12,r_249_77_169,0.94,0,169,169,26
161,seq104,r_169_208_46,seq343,r_169_208_46,1.0,4,50,46,26
66,r_264_179_121,seq67,seq97,r_264_179_121,0.66,17,138,121,26
16,r_17_132_108,r_274_161_159,r_276_272_7,r_17_132_108,1.0,0,108,108,26
45,r_143_338_120,r_280_292_84,seq248,r_143_338_120,1.0,-1,119,120,26
60,r_120_27_124,r_213_321_196,seq278,r_120_27_124,1.0,0,124,124,26
153,seq71,r_349_243_187,r_171_83_73,r_349_243_187,0.56,0,187,187,26
48,r_26_118_79,r_281_236_57,r_2_314_35,r_26_118_79,1.0,0,79,79,26
69,r_111_96_84,r_332_371_188,seq343,r_111_96_84,1.0,0,84,84,26
86,r_150_134_124,seq151,r_157_216_49,r_150_134_124,1.0,0,124,124,26
63,r_201_92_186,seq57,seq104,r_201_92_186,0.91,2,188,186,26
18,r_100_367_10,r_257_284_63,seq244,r_100_367_10,0.99,0,10,10,26
221,seq289,r_205_313_152,r_285_241_12,r_285_241_12,0.69,18,30,12,26
17,r_113_316_38,r_356_344_139,r_171_83_73,r_171_83_73,0.67,32,105,73,26
54,r_55_172_129,r_332_371_188,seq301,r_55_172_129,1.0,0,129,129,26
32,r_153_21_141,seq199,seq95,r_153_21_141,1.0,1,142,141,26
77,r_167_125_36,r_373_287_114,seq342,r_373_287_114,0.53,-78,36,114,26
102,r_215_218_162,r_171_83_73,r_348_156_75,r_215_218_162,1.0,0,162,162,26
55,r_121_298_141,r_281_236_57,r_256_129_10,r_256_129_10,0.57,19,29,10,26
0,r_335_49_152,seq46,seq262,r_335_49_152,0.99,0,152,152,26
95,r_245_99_186,seq107,r_205_313_152,r_205_313_152,0.92,34,186,152,26
42,r_280_292_84,r_143_338_120,r_189_232_104,r_143_338_120,0.99,-1,119,120,26
43,r_256_129_10,r_108_112_53,r_121_298_141,r_256_129_10,0.98,0,10,10,26
2,r_187_152_84,r_41_299_150,r_51_361_49,r_41_299_150,0.76,-66,84,150,26
57,r_183_296_95,seq330,r_210_259_19,r_183_296_95,1.0,0,95,95,26
102,r_215_218_162,r_146_217_82,r_171_83_73,r_171_83_73,1.0,12,85,73,26
29,r_260_345_40,r_51_361_49,seq10,r_260_345_40,1.0,0,40,40,26
83,r_349_243_187,seq71,r_17_132_108,r_349_243_187,0.8,0,187,187,26
22,r_72_283_102,seq50,seq226,r_72_283_102,1.0,0,102,102,26
58,r_309_186_39,r_281_236_57,seq279,r_309_186_39,1.0,0,39,39,26
211,seq262,r_286_52_114,seq124,r_286_52_114,1.0,-1,113,114,26
46,r_18_209_110,seq327,r_69_323_70,r_18_209_110,0.88,0,110,110,26
62,r_181_295_140,seq133,seq194,r_181_295_140,1.0,0,140,140,26
194,seq199,r_153_21_141,r_307_88_135,r_153_21_141,0.77,0,141,141,26
49,r_368_103_79,r_187_152_84,seq12,r_368_103_79,1.0,0,79,79,26
112,r_371_248_96,seq104,seq293,r_371_248_96,1.0,0,96,96,27
128,seq18,r_264_121_38,seq104,r_264_121_38,1.0,-1,37,38,27
91,r_290_19_59,r_136_79_179,r_82_224_35,r_290_19_59,0.92,0,59,59,27
67,r_321_154_116,seq173,r_211_26_95,r_321_154_116,1.0,0,116,116,27
107,r_211_26_95,r_349_142_129,seq21,r_349_142_129,1.0,-34,95,129,27
0,r_310_297_55,r_91_317_73,seq45,r_310_297_55,1.0,0,55,55,27
190,seq185,r_233_366_112,seq173,r_233_366_112,1.0,1,113,112,27
189,seq184,r_3_343_134,r_333_32_34,r_333_32_34,0.88,-3,31,34,27
6,r_136_79_179,seq351,seq246,r_136_79_179,0.64,1,180,179,27
15,r_24_59_97,seq55,r_269_206_76,r_269_206_76,0.85,23,99,76,27
42,r_176_182_57,seq2,r_12_204_180,r_176_182_57,1.0,0,57,57,27
184,seq173,r_321_154_116,seq185,r_321_154_116,1.0,-21,95,116,27
106,r_298_126_96,r_47_295_120,r_169_8_198,r_298_126_96,1.0,0,96,96,27
37,r_72_13_172,seq373,r_139_128_135,r_72_13_172,0.66,0,172,172,27
101,r_189_27_180,seq134,r_6_52_45,r_189_27_180,0.68,0,180,180,27
64,r_220_95_196,r_341_110_84,r_257_219_18,r_341_110_84,1.0,1,85,84,27
21,r_139_128_135,r_14_11_140,r_135_267_115,r_139_128_135,0.97,1,136,135,27
20,r_151_342_81,r_222_43_177,seq299,r_151_342_81,1.0,0,81,81,27
47,r_162_322_114,seq106,seq122,r_162_322_114,0.99,0,114,114,27
5,r_12_204_180,seq345,r_176_182_57,r_176_182_57,1.0,3,60,57,27
230,seq305,r_60_152_68,r_337_160_161,r_337_160_161,0.84,8,169,161,27
57,r_221_35_32,seq112,r_169_8_198,r_221_35_32,1.0,1,33,32,27
96,r_99_180_176,r_231_328_169,r_268_5_41,r_99_180_176,1.0,0,176,176,27
63,r_103_44_113,r_80_344_179,r_257_219_18,r_103_44_113,0.97,0,113,113,27
98,r_14_11_140,seq37,r_143_198_127,r_14_11_140,1.0,0,140,140,27
32,r_264_121_38,seq18,r_178_282_25,r_264_121_38,1.0,0,38,38,27
143,seq55,r_24_59_97,r_170_61_173,r_24_59_97,1.0,2,99,97,27
69,r_170_61_173,seq55,r_22_92_109,r_170_61_173,0.84,-1,172,173,27
17,r_306_207_2,r_213_275_111,r_214_100_73,r_306_207_2,1.0,71,73,2,27
89,r_318_240_94,r_300_365_108,r_333_32_34,r_318_240_94,1.0,0,94,94,27
86,r_277_48_62,r_260_301_80,seq373,r_260_301_80,1.0,-14,66,80,27
97,r_356_278_169,seq45,r_178_282_25,r_356_278_169,0.83,1,170,169,27
100,r_144_165_143,r_332_289_102,r_24_59_97,r_144_165_143,0.99,2,145,143,27
27,r_178_282_25,r_82_224_35,seq243,r_178_282_25,0.93,2,27,25,27
12,r_97_315_17,r_138_133_164,seq329,r_97_315_17,0.74,0,17,17,27
117,r_236_67_185,r_16_286_165,r_321_154_116,r_236_67_185,0.78,-19,166,185,27
19,r_241_62_124,r_332_289_102,seq18,r_241_62_124,1.0,0,124,124,27
38,r_135_267_115,r_47_295_120,r_214_100_73,r_135_267_115,1.0,0,115,115,27
108,r_217_212_23,r_111_64_52,seq145,r_217_212_23,1.0,0,23,23,27
7,r_47_295_120,seq134,r_261_352_122,r_47_295_120,1.0,3,123,120,27
77,r_341_110_84,r_220_95_196,r_218_168_33,r_341_110_84,1.0,1,85,84,27
3,r_164_357_136,seq177,r_233_366_112,r_164_357_136,0.98,0,136,136,27
49,r_291_314_101,r_150_96_157,r_192_7_12,r_291_314_101,0.98,0,101,101,27
78,r_50_296_61,r_22_92_109,r_333_32_34,r_50_296_61,0.89,0,61,61,27
48,r_237_361_135,seq25,r_97_315_17,r_237_361_135,1.0,1,136,135,27
70,r_148_265_144,seq329,r_256_131_63,r_148_265_144,1.0,0,144,144,27
87,r_374_360_154,r_367_209_159,seq39,r_374_360_154,0.96,0,154,154,27
29,r_53_249_176,r_332_289_102,r_183_245_93,r_53_249_176,0.99,0,176,176,27
95,r_338_115_169,r_356_278_169,r_22_92_109,r_338_115_169,0.78,0,169,169,27
76,r_77_253_130,seq370,r_330_156_7,r_77_253_130,0.67,8,138,130,27
30,r_213_275_111,r_306_207_2,r_332_289_102,r_213_275_111,1.0,0,111,111,27
94,r_80_344_179,r_29_40_183,r_257_219_18,r_257_219_18,0.73,162,180,18,27
61,r_4_273_158,seq205,r_158_76_120,r_4_273_158,1.0,0,158,158,27
83,r_98_232_43,r_241_62_124,r_337_160_161,r_98_232_43,1.0,0,43,43,27
109,r_143_198_127,seq173,seq45,r_143_198_127,1.0,2,129,127,27
83,r_98_232_43,r_337_160_161,r_139_128_135,r_98_232_43,1.0,114,157,43,27
115,r_307_340_89,seq84,r_218_168_33,r_307_340_89,0.86,0,89,89,27
50,r_3_343_134,seq184,r_146_34_128,r_3_343_134,1.0,0,134,134,27
52,r_102_186_69,seq83,seq159,r_102_186_69,1.0,0,69,69,27
35,r_90_172_130,seq17,r_349_142_129,r_90_172_130,1.0,1,131,130,27
10,r_22_92_109,seq39,seq137,r_22_92_109,1.0,4,113,109,27
73,r_199_125_111,r_47_295_120,seq57,r_199_125_111,1.0,0,111,111,27
117,r_236_67_185,r_321_154_116,r_178_282_25,r_236_67_185,0.6,2,187,185,27
79,r_337_160_161,r_138_133_164,seq305,r_337_160_161,0.99,0,161,161,27
53,r_73_119_150,seq251,r_60_152_68,r_73_119_150,1.0,0,150,150,27
113,r_93_42_87,seq166,seq37,r_93_42_87,1.0,0,87,87,27
66,r_113_358_102,r_72_13_172,r_82_224_35,r_113_358_102,1.0,1,103,102,27
218,seq271,seq147,r_1_266_84,r_1_266_84,1.0,1,85,84,27
88,r_158_76_120,r_3_343_134,seq185,r_158_76_120,0.95,0,120,120,27
162,seq112,r_313_46_171,r_146_34_128,r_146_34_128,0.71,5,133,128,27
36,r_175_36_64,r_143_198_127,r_108_167_58,r_175_36_64,0.96,2,66,64,27
99,r_214_100_73,r_318_240_94,seq193,r_214_100_73,0.98,0,73,73,27
243,seq351,r_136_79_179,r_257_219_18,r_136_79_179,0.94,1,180,179,27
123,r_188_191_34,r_22_92_109,seq15,r_188_191_34,0.73,1,35,34,27
9,r_257_219_18,r_338_115_169,r_220_95_196,r_257_219_18,0.98,1,19,18,27
23,r_146_34_128,r_284_127_193,seq112,r_146_34_128,1.0,0,128,128,27
18,r_150_96_157,seq243,r_257_219_18,r_150_96_157,0.98,0,157,157,27
119,r_362_308_120,seq149,r_339_81_77,r_362_308_120,0.89,1,121,120,27
167,seq122,seq104,r_162_322_114,r_162_322_114,0.73,10,124,114,27
11,r_354_71_40,r_139_128_135,seq216,r_139_128_135,0.94,-92,43,135,27
26,r_312_153_152,seq141,r_117_355_2,r_312_153_152,0.89,-3,149,152,27
71,r_197_335_129,seq243,r_277_48_62,r_197_335_129,1.0,2,131,129,27
93,r_192_7_12,r_117_355_2,r_97_315_17,r_192_7_12,0.99,0,12,12,27
14,r_91_317_73,r_75_336_171,r_111_64_52,r_91_317_73,1.0,0,73,73,27
65,r_247_262_60,seq15,r_332_289_102,r_247_262_60,1.0,0,60,60,27
22,r_0_324_64,r_203_258_144,r_290_19_59,r_0_324_64,0.87,0,64,64,27
46,r_111_64_52,r_93_42_87,seq112,r_111_64_52,1.0,1,53,52,27
59,r_333_32_34,r_82_224_35,seq184,r_333_32_34,0.92,-1,33,34,27
110,r_16_286_165,r_236_67_185,r_113_358_102,r_16_286_165,1.0,1,166,165,27
75,r_108_167_58,r_4_273_158,seq17,r_108_167_58,1.0,0,58,58,27
44,r_230_334_169,seq287,seq17,r_230_334_169,0.7,0,169,169,27
34,r_138_133_164,r_337_160_161,r_22_92_109,r_138_133_164,0.99,0,164,164,27
55,r_222_43_177,r_332_289_102,r_102_186_69,r_222_43_177,0.99,0,177,177,27
51,r_300_365_108,r_318_240_94,r_268_5_41,r_300_365_108,1.0,-14,94,108,27
81,r_269_206_76,r_3_343_134,seq134,r_269_206_76,1.0,-1,75,76,27
104,r_313_46_171,seq112,seq114,r_313_46_171,1.0,0,171,171,27
120,r_261_352_122,r_150_96_157,r_47_295_120,r_261_352_122,0.87,2,124,122,27
116,r_9_155_39,seq177,r_306_207_2,r_9_155_39,1.0,0,39,39,27
41,r_363_226_93,r_197_335_129,seq18,r_363_226_93,1.0,0,93,93,27
62,r_272_228_84,r_349_142_129,seq132,r_272_228_84,1.0,3,87,84,27
25,r_82_224_35,seq20,seq38,r_82_224_35,0.99,0,35,35,27
28,r_60_152_68,seq331,seq123,r_60_152_68,1.0,0,68,68,27
143,seq55,r_170_61_173,r_80_344_179,r_80_344_179,0.57,-7,172,179,27
84,r_285_109_110,seq305,r_330_156_7,r_285_109_110,1.0,0,110,110,27
82,r_58_130_33,r_75_336_171,seq134,r_58_130_33,1.0,0,33,33,27
1,r_268_5_41,r_73_119_150,seq194,r_268_5_41,0.99,0,41,41,27
16,r_327_105_53,seq129,r_364_234_54,r_327_105_53,1.0,0,53,53,27
105,r_316_279_132,seq159,seq263,r_316_279_132,1.0,0,132,132,27
209,seq243,r_197_335_129,r_178_282_25,r_197_335_129,0.99,-34,95,129,27
122,r_304_208_106,r_231_328_169,r_169_8_198,r_231_328_169,0.71,-57,112,169,27
68,r_364_234_54,r_241_62_124,r_327_105_53,r_364_234_54,1.0,1,55,54,27
103,r_171_101_180,seq123,r_9_155_39,r_171_101_180,1.0,0,180,180,27
24,r_218_168_33,r_14_11_140,seq299,r_218_168_33,1.0,-1,32,33,27
58,r_256_131_63,seq276,seq177,r_256_131_63,0.96,2,65,63,27
124,r_183_245_93,r_148_265_144,r_60_152_68,r_183_245_93,1.0,15,108,93,27
114,r_326_54_85,r_93_42_87,seq94,r_326_54_85,1.0,0,85,85,27
74,r_233_366_112,seq185,r_10_280_26,r_233_366_112,1.0,1,113,112,27
178,seq149,r_362_308_120,r_306_207_2,r_362_308_120,1.0,1,121,120,27
128,seq18,seq104,r_363_226_93,r_363_226_93,1.0,0,93,93,27
111,r_367_209_159,seq25,r_14_11_140,r_367_209_159,1.0,0,159,159,27
80,r_339_81_77,r_148_265_144,seq104,r_339_81_77,1.0,3,80,77,27
102,r_10_280_26,r_241_62_124,r_217_212_23,r_10_280_26,0.88,-1,25,26,27
138,seq39,r_22_92_109,seq51,r_22_92_109,1.0,4,113,109,27
43,r_75_336_171,seq41,r_312_153_152,r_75_336_171,1.0,0,171,171,27
14,r_91_317_73,r_310_297_55,r_75_336_171,r_310_297_55,1.0,0,55,55,27
121,r_203_258_144,seq15,r_330_156_7,r_203_258_144,1.0,1,145,144,27
2,r_6_52_45,seq23,seq210,r_6_52_45,0.99,0,45,45,27
4,r_349_142_129,r_169_8_198,r_90_172_130,r_349_142_129,1.0,2,131,129,27
92,r_260_301_80,seq263,seq94,r_260_301_80,1.0,0,80,80,27
8,r_274_350_150,seq194,seq238,r_274_350_150,1.0,0,150,150,27
112,r_123_30_95,seq38,r_344_213_18,r_123_30_95,1.0,1,96,95,28
20,r_66_167_35,seq265,seq10,r_66_167_35,0.99,0,35,35,28
101,r_87_236_98,r_325_33_89,r_162_175_35,r_87_236_98,1.0,0,98,98,28
60,r_160_357_34,r_23_53_92,r_121_129_54,r_160_357_34,0.66,65,99,34,28
86,r_209_343_70,r_177_249_71,seq257,r_209_343_70,1.0,0,70,70,28
105,r_239_92_70,r_37_368_124,seq323,r_239_92_70,1.0,0,70,70,28
76,r_23_53_92,r_154_76_167,seq205,r_23_53_92,0.94,7,99,92,28
23,r_340_13_154,seq319,r_117_84_106,r_340_13_154,1.0,1,155,154,28
98,r_282_229_3,r_273_277_104,r_123_30_95,r_282_229_3,1.0,101,104,3,28
45,r_29_276_10,r_121_129_54,seq72,r_29_276_10,0.92,0,10,10,28
46,r_36_98_80,r_95_228_135,r_264_232_26,r_36_98_80,0.99,0,80,80,28
95,r_86_39_172,seq56,seq32,r_86_39_172,0.6,-97,75,172,28
89,r_241_220_146,r_295_69_149,seq110,r_241_220_146,1.0,0,146,146,28
221,seq284,r_289_322_171,r_293_3_76,r_289_322_171,0.99,-34,137,171,28
71,r_243_203_17,r_122_186_135,seq14,r_243_203_17,1.0,0,17,17,28
22,r_225_311_190,seq330,r_146_254_46,r_225_311_190,0.99,0,190,190,28
121,r_318_338_32,r_250_70_124,seq46,r_318_338_32,1.0,0,32,32,28
79,r_101_181_135,r_351_367_183,seq234,r_101_181_135,0.92,2,137,135,28
102,r_286_170_21,r_240_262_28,seq268,r_286_170_21,1.0,0,21,21,28
99,r_355_150_126,r_208_306_179,r_281_17_193,r_355_150_126,0.93,3,129,126,28
104,r_130_347_176,seq110,r_355_150_126,r_130_347_176,0.92,0,176,176,28
52,r_166_224_110,r_196_134_186,seq212,r_166_224_110,1.0,0,110,110,28
63,r_222_54_111,seq326,seq310,r_222_54_111,1.0,2,113,111,28
111,r_215_24_20,r_241_220_146,seq0,r_215_24_20,0.99,1,21,20,28
18,r_184_126_113,seq10,r_252_45_99,r_184_126_113,1.0,1,114,113,28
64,r_177_249_71,r_209_343_70,seq319,r_177_249_71,1.0,0,71,71,28
156,seq85,r_204_57_190,r_152_4_100,r_152_4_100,1.0,10,110,100,28
8,r_153_96_83,r_354_149_108,r_139_206_92,r_153_96_83,1.0,0,83,83,28
14,r_37_368_124,r_102_5_182,r_152_4_100,r_37_368_124,0.96,0,124,124,28
97,r_255_51_91,r_364_79_109,r_88_93_178,r_255_51_91,0.98,2,93,91,28
107,r_35_291_123,r_59_314_189,r_336_151_4,r_35_291_123,1.0,0,123,123,28
65,r_2_133_153,seq124,r_169_331_22,r_2_133_153,1.0,0,153,153,28
57,r_82_337_101,r_117_84_106,seq143,r_117_84_106,1.0,-5,101,106,28
113,r_97_341_34,r_225_311_190,seq217,r_97_341_34,0.99,1,35,34,28
196,seq199,r_122_186_135,r_288_245_193,r_122_186_135,1.0,0,135,135,28
88,r_274_200_84,r_37_368_124,seq332,r_274_200_84,1.0,0,84,84,28
118,r_344_213_18,r_273_277_104,r_123_30_95,r_344_213_18,1.0,86,104,18,28
17,r_250_70_124,seq302,seq280,r_250_70_124,1.0,0,124,124,28
62,r_117_84_106,r_82_337_101,seq265,r_117_84_106,1.0,0,106,106,28
74,r_271_172_93,r_281_17_193,seq195,r_271_172_93,0.99,5,98,93,28
237,seq326,r_123_30_95,r_50_164_132,r_50_164_132,0.59,17,149,132,28
156,seq85,r_68_67_21,r_204_57_190,r_68_67_21,0.92,0,21,21,28
47,r_132_261_65,r_273_277_104,seq115,r_132_261_65,1.0,0,65,65,28
2,r_240_262_28,r_161_270_133,seq58,r_240_262_28,0.97,1,29,28,28
209,seq238,r_73_214_103,r_184_126_113,r_184_126_113,1.0,2,115,113,28
141,seq52,r_102_5_182,r_36_98_80,r_36_98_80,0.56,58,138,80,28
99,r_355_150_126,r_281_17_193,r_130_347_176,r_355_150_126,0.71,50,176,126,28
38,r_373_137_103,seq106,seq216,r_373_137_103,1.0,0,103,103,28
1,r_21_304_27,r_225_311_190,r_286_170_21,r_21_304_27,1.0,0,27,27,28
48,r_83_20_170,r_289_322_171,r_66_167_35,r_83_20_170,1.0,0,170,170,28
26,r_272_296_81,r_208_306_179,r_68_67_21,r_272_296_81,1.0,0,81,81,28
10,r_95_228_135,seq46,seq168,r_95_228_135,0.99,0,135,135,28
73,r_204_57_190,r_146_254_46,r_350_363_58,r_350_363_58,1.0,2,60,58,28
27,r_273_277_104,r_132_261_65,r_344_213_18,r_132_261_65,1.0,0,65,65,28
229,seq310,r_88_93_178,r_219_260_115,r_219_260_115,0.89,19,134,115,28
21,r_50_164_132,r_161_270_133,seq326,r_50_164_132,1.0,0,132,132,28
49,r_157_202_34,seq332,r_243_203_17,r_157_202_34,0.99,0,34,34,28
59,r_354_149_108,seq18,r_255_51_91,r_354_149_108,1.0,0,108,108,28
55,r_294_27_160,seq283,seq258,r_294_27_160,0.78,0,160,160,28
54,r_325_33_89,r_87_236_98,seq91,r_87_236_98,0.95,0,98,98,28
87,r_141_267_157,seq61,r_293_3_76,r_141_267_157,1.0,0,157,157,28
97,r_255_51_91,r_88_93_178,r_354_149_108,r_255_51_91,0.73,21,112,91,28
116,r_34_352_172,seq103,seq199,r_34_352_172,1.0,4,176,172,28
31,r_279_298_148,seq120,r_373_137_103,r_279_298_148,1.0,0,148,148,28
28,r_289_322_171,r_83_20_170,r_6_227_136,r_289_322_171,1.0,0,171,171,28
32,r_219_260_115,r_161_270_133,seq310,r_219_260_115,1.0,0,115,115,28
56,r_242_135_183,seq52,r_273_277_104,r_242_135_183,1.0,0,183,183,28
171,seq124,r_275_303_193,r_68_67_21,r_68_67_21,1.0,0,21,21,28
36,r_122_186_135,r_191_290_134,r_166_224_110,r_122_186_135,1.0,0,135,135,28
115,r_295_69_149,r_241_220_146,seq316,r_241_220_146,0.88,0,146,146,28
73,r_204_57_190,r_350_363_58,r_355_150_126,r_204_57_190,0.98,0,190,190,28
9,r_259_226_13,r_118_201_185,seq14,r_259_226_13,0.81,0,13,13,28
120,r_73_214_103,seq238,r_253_248_21,r_73_214_103,0.64,4,107,103,28
239,seq329,r_196_134_186,r_324_47_82,r_324_47_82,1.0,5,87,82,28
84,r_191_290_134,r_122_186_135,r_189_48_118,r_191_290_134,1.0,0,134,134,28
3,r_247_315_153,r_210_211_199,r_264_232_26,r_247_315_153,1.0,0,153,153,28
122,r_335_174_83,seq199,r_350_363_58,r_335_174_83,1.0,4,87,83,28
12,r_162_175_35,r_86_39_172,seq187,r_162_175_35,0.96,5,40,35,28
58,r_264_232_26,seq90,seq52,r_264_232_26,1.0,0,26,26,28
75,r_152_4_100,r_250_70_124,seq85,r_152_4_100,1.0,0,100,100,28
27,r_273_277_104,r_344_213_18,r_89_353_82,r_273_277_104,1.0,0,104,104,28
81,r_59_314_189,seq319,r_358_371_7,r_59_314_189,0.99,0,189,189,28
40,r_154_76_167,r_23_53_92,r_43_278_84,r_43_278_84,1.0,15,99,84,28
53,r_300_334_21,seq305,seq231,r_300_334_21,1.0,0,21,21,28
0,r_121_129_54,r_147_362_61,r_160_357_34,r_121_129_54,1.0,0,54,54,28
44,r_147_362_61,r_121_129_54,r_208_306_179,r_121_129_54,0.97,1,55,54,28
42,r_169_331_22,r_6_227_136,seq235,r_169_331_22,1.0,0,22,22,28
33,r_252_45_99,seq109,r_223_230_33,r_223_230_33,0.97,66,99,33,28
13,r_293_3_76,r_340_13_154,seq284,r_293_3_76,0.85,9,85,76,28
83,r_176_198_97,seq140,seq120,r_176_198_97,1.0,1,98,97,28
123,r_308_114_164,seq313,seq110,r_308_114_164,0.92,0,164,164,28
183,seq159,r_88_93_178,r_36_98_80,r_36_98_80,0.49,53,133,80,28
90,r_208_306_179,r_355_150_126,r_147_362_61,r_355_150_126,0.8,3,129,126,28
60,r_160_357_34,r_73_214_103,r_23_53_92,r_160_357_34,1.0,0,34,34,28
118,r_344_213_18,r_177_249_71,r_273_277_104,r_344_213_18,0.92,-2,16,18,28
16,r_196_134_186,seq329,r_41_370_105,r_196_134_186,1.0,2,188,186,28
190,seq187,seq120,r_162_175_35,r_162_175_35,1.0,21,56,35,28
203,seq221,r_327_374_103,r_42_15_53,r_327_374_103,1.0,0,103,103,28
44,r_147_362_61,r_208_306_179,r_82_337_101,r_208_306_179,1.0,-1,178,179,28
35,r_301_100_149,seq193,seq14,r_301_100_149,1.0,0,149,149,28
109,r_42_15_53,r_154_76_167,seq221,r_42_15_53,0.9,3,56,53,28
30,r_6_227_136,seq105,seq234,r_6_227_136,1.0,0,136,136,28
4,r_364_79_109,r_255_51_91,r_271_172_93,r_364_79_109,0.61,-16,93,109,28
72,r_41_370_105,seq128,seq0,r_41_370_105,1.0,1,106,105,28
181,seq155,r_266_345_110,r_336_151_4,r_266_345_110,1.0,0,110,110,28
40,r_154_76_167,r_43_278_84,r_68_67_21,r_154_76_167,0.64,1,168,167,28
124,r_327_374_103,seq221,r_239_92_70,r_327_374_103,1.0,0,103,103,28
51,r_163_28_151,seq155,r_301_100_149,r_163_28_151,1.0,0,151,151,28
114,r_188_94_180,seq148,r_358_371_7,r_188_94_180,1.0,1,181,180,28
6,r_161_270_133,r_50_164_132,r_253_248_21,r_161_270_133,1.0,-1,132,133,28
34,r_68_67_21,seq85,seq124,r_68_67_21,0.95,0,21,21,28
4,r_364_79_109,r_271_172_93,r_372_194_9,r_364_79_109,0.99,1,110,109,28
110,r_43_278_84,r_325_33_89,r_154_76_167,r_43_278_84,1.0,1,85,84,28
94,r_118_201_185,seq366,r_37_368_124,r_118_201_185,0.94,2,187,185,28
91,r_131_144_60,r_37_368_124,seq316,r_131_144_60,0.93,0,60,60,28
15,r_266_345_110,seq155,seq56,r_266_345_110,1.0,0,110,110,28
78,r_350_363_58,seq233,r_321_11_41,r_350_363_58,1.0,1,59,58,28
117,r_31_361_100,seq192,r_108_111_75,r_31_361_100,1.0,0,100,100,28
24,r_19_158_161,r_118_201_185,r_209_343_70,r_209_343_70,0.97,93,163,70,28
119,r_189_48_118,r_118_201_185,seq38,r_189_48_118,1.0,0,118,118,28
80,r_365_81_79,seq205,seq173,r_365_81_79,1.0,0,79,79,28
213,seq257,r_247_315_153,r_209_343_70,r_209_343_70,1.0,0,70,70,28
234,seq319,r_59_314_189,r_177_249_71,r_177_249_71,0.86,37,108,71,28
77,r_223_230_33,r_250_70_124,seq309,r_223_230_33,0.97,0,33,33,28
149,seq71,seq155,r_35_291_123,r_35_291_123,1.0,13,136,123,28
66,r_108_111_75,seq0,r_339_8_9,r_108_111_75,1.0,0,75,75,28
25,r_88_93_178,r_37_368_124,seq310,r_37_368_124,1.0,-23,101,124,28
166,seq110,r_130_347_176,r_241_220_146,r_241_220_146,1.0,0,146,146,28
95,r_86_39_172,seq32,r_161_270_133,r_161_270_133,0.47,35,168,133,28
43,r_89_353_82,seq148,r_29_276_10,r_89_353_82,1.0,0,82,82,28
90,r_208_306_179,r_147_362_61,r_122_186_135,r_208_306_179,0.98,0,179,179,28
180,seq148,r_188_94_180,seq7,r_188_94_180,1.0,1,181,180,28
118,r_244_25_84,seq88,seq178,r_244_25_84,1.0,0,84,84,29
18,r_331_143_59,seq35,r_119_70_58,r_331_143_59,0.99,0,59,59,29
130,seq20,r_290_314_137,r_299_341_12,r_290_314_137,1.0,0,137,137,29
0,r_293_335_123,seq156,r_113_78_92,r_293_335_123,1.0,0,123,123,29
70,r_27_177_117,seq247,r_312_118_23,r_27_177_117,1.0,1,118,117,29
5,r_306_236_50,r_258_84_148,r_145_333_28,r_306_236_50,0.96,1,51,50,29
7,r_158_337_31,r_24_162_96,seq372,r_158_337_31,0.99,0,31,31,29
57,r_231_41_195,r_101_195_163,r_190_131_148,r_101_195_163,1.0,2,165,163,29
168,seq132,r_199_210_100,r_145_333_28,r_199_210_100,1.0,0,100,100,29
104,r_52_373_54,r_154_272_118,r_302_254_130,r_302_254_130,1.0,14,144,130,29
69,r_363_55_25,r_364_43_155,r_36_128_6,r_363_55_25,0.9,0,25,25,29
155,seq92,seq201,r_219_194_77,r_219_194_77,1.0,4,81,77,29
66,r_328_96_76,r_159_168_181,r_28_344_9,r_328_96_76,1.0,1,77,76,29
122,r_53_161_130,seq39,seq63,r_53_161_130,1.0,0,130,130,29
4,r_209_147_58,r_15_29_101,seq92,r_209_147_58,1.0,1,59,58,29
75,r_65_87_74,seq33,seq141,r_65_87_74,1.0,1,75,74,29
89,r_200_46_138,r_287_278_167,r_82_251_122,r_287_278_167,0.51,-23,144,167,29
102,r_368_266_121,seq108,seq247,r_368_266_121,0.99,1,122,121,29
20,r_167_130_25,r_330_54_176,r_159_168_181,r_167_130_25,0.91,-5,20,25,29
61,r_184_90_113,r_264_323_120,seq129,r_184_90_113,0.99,0,113,113,29
43,r_59_235_92,seq360,seq1,r_59_235_92,1.0,0,92,92,29
53,r_82_251_122,seq69,r_208_4_53,r_82_251_122,0.99,0,122,122,29
210,seq255,r_21_359_188,r_229_9_22,r_21_359_188,0.97,1,189,188,29
99,r_374_339_52,seq0,r_11_243_22,r_374_339_52,1.0,0,52,52,29
108,r_361_105_61,r_97_345_168,seq16,r_361_105_61,1.0,1,62,61,29
91,r_267_365_132,seq259,r_306_236_50,r_267_365_132,1.0,1,133,132,29
81,r_101_195_163,r_231_41_195,r_59_235_92,r_101_195_163,1.0,2,165,163,29
56,r_62_240_184,seq175,r_209_147_58,r_62_240_184,1.0,0,184,184,29
38,r_145_333_28,r_119_70_58,seq132,r_145_333_28,0.92,3,31,28,29
39,r_15_29_101,seq64,r_80_370_57,r_15_29_101,0.97,1,102,101,29
142,seq60,r_154_272_118,r_66_313_38,r_66_313_38,0.83,31,69,38,29
94,r_353_95_176,seq16,seq283,r_353_95_176,1.0,1,177,176,29
111,r_252_292_156,seq358,r_124_135_119,r_252_292_156,1.0,2,158,156,29
23,r_219_194_77,r_36_128_6,r_209_147_58,r_219_194_77,0.98,0,77,77,29
15,r_352_233_51,r_27_177_117,seq104,r_352_233_51,1.0,0,51,51,29
13,r_302_254_130,seq49,r_321_288_80,r_302_254_130,1.0,0,130,130,29
113,r_18_81_189,seq248,r_102_271_65,r_18_81_189,0.59,1,190,189,29
93,r_234_146_88,r_27_177_117,seq285,r_234_146_88,1.0,0,88,88,29
27,r_221_157_17,r_352_233_51,seq35,r_221_157_17,0.6,-2,15,17,29
2,r_300_176_138,r_154_272_118,seq3,r_300_176_138,1.0,0,138,138,29
45,r_332_86_138,r_101_195_163,r_27_177_117,r_332_86_138,0.99,8,146,138,29
77,r_207_204_37,seq107,seq61,r_207_204_37,0.92,3,40,37,29
46,r_51_356_105,seq63,r_350_257_76,r_51_356_105,1.0,0,105,105,29
52,r_37_203_34,seq322,seq369,r_37_203_34,0.99,1,35,34,29
121,r_169_164_158,seq72,r_221_157_17,r_169_164_158,1.0,0,158,158,29
103,r_117_349_46,r_268_110_175,r_28_344_9,r_117_349_46,1.0,0,46,46,29
8,r_32_187_51,r_62_240_184,seq63,r_32_187_51,1.0,0,51,51,29
37,r_371_286_162,seq317,r_22_74_112,r_371_286_162,0.67,6,168,162,29
10,r_119_70_58,r_53_161_130,r_331_143_59,r_53_161_130,0.97,-6,124,130,29
78,r_21_359_188,seq255,r_24_162_96,r_21_359_188,0.98,1,189,188,29
41,r_14_263_20,r_293_335_123,seq320,r_14_263_20,0.78,0,20,20,29
197,seq213,r_290_314_137,seq253,r_290_314_137,1.0,-15,122,137,29
34,r_327_155_74,r_227_98_98,r_268_110_175,r_327_155_74,1.0,0,74,74,29
96,r_297_103_28,r_302_254_130,seq303,r_297_103_28,1.0,0,28,28,29
21,r_364_43_155,r_68_2_188,r_276_121_92,r_364_43_155,0.97,0,155,155,29
16,r_85_139_146,r_66_313_38,seq301,r_85_139_146,1.0,0,146,146,29
25,r_227_98_98,r_17_48_98,seq354,r_227_98_98,1.0,4,102,98,29
51,r_45_144_80,r_100_222_154,seq322,r_45_144_80,0.99,2,82,80,29
246,seq360,r_237_250_189,r_24_162_96,r_237_250_189,0.87,1,190,189,29
135,seq35,seq57,r_324_241_85,r_324_241_85,1.0,4,89,85,29
62,r_298_179_106,r_290_314_137,r_158_337_31,r_298_179_106,0.97,-1,105,106,29
98,r_230_277_17,r_293_335_123,seq178,r_230_277_17,0.81,0,17,17,29
59,r_330_54_176,seq178,r_332_86_138,r_330_54_176,0.95,2,178,176,29
73,r_310_76_45,r_268_110_175,r_190_131_148,r_310_76_45,1.0,0,45,45,29
65,r_276_121_92,r_353_95_176,seq261,r_276_121_92,1.0,0,92,92,29
33,r_120_150_74,r_302_254_130,seq35,r_120_150_74,0.97,1,75,74,29
44,r_202_12_101,r_21_359_188,seq284,r_202_12_101,0.98,2,103,101,29
194,seq201,seq92,r_219_194_77,r_219_194_77,1.0,38,115,77,29
71,r_287_278_167,r_22_74_112,r_352_233_51,r_287_278_167,0.63,0,167,167,29
76,r_269_160_99,r_371_286_162,seq16,r_269_160_99,1.0,1,100,99,29
115,r_5_116_63,seq73,seq69,r_5_116_63,0.75,0,63,63,29
212,seq259,r_267_365_132,r_202_12_101,r_267_365_132,1.0,1,133,132,29
31,r_351_245_126,r_119_70_58,r_328_96_76,r_351_245_126,1.0,0,126,126,29
152,seq88,r_244_25_84,r_196_334_27,r_244_25_84,1.0,1,85,84,29
116,r_183_214_156,seq63,seq360,r_183_214_156,1.0,2,158,156,29
12,r_191_142_117,r_311_242_194,r_207_204_37,r_191_142_117,1.0,0,117,117,29
120,r_362_274_34,r_300_176_138,seq149,r_300_176_138,0.48,-103,35,138,29
28,r_102_271_65,r_287_278_167,seq246,r_102_271_65,0.55,1,66,65,29
74,r_93_182_158,seq273,seq60,r_93_182_158,1.0,0,158,158,29
84,r_100_222_154,seq307,r_219_194_77,r_100_222_154,0.97,1,155,154,29
32,r_290_314_137,seq20,r_119_70_58,r_290_314_137,1.0,0,137,137,29
86,r_8_232_80,r_27_177_117,r_14_263_20,r_8_232_80,1.0,0,80,80,29
54,r_11_243_22,r_80_370_57,seq186,r_11_243_22,1.0,0,22,22,29
92,r_299_341_12,seq129,seq20,r_299_341_12,0.74,-1,11,12,29
234,seq322,seq153,r_45_144_80,r_45_144_80,0.98,17,97,80,29
218,seq280,seq73,r_56_197_126,r_56_197_126,1.0,1,127,126,29
1,r_124_135_119,seq175,r_174_291_13,r_124_135_119,1.0,0,119,119,29
64,r_112_6_113,seq175,r_158_337_31,r_112_6_113,1.0,0,113,113,29
6,r_7_163_118,seq217,r_350_257_76,r_7_163_118,1.0,1,119,118,29
48,r_196_334_27,r_361_105_61,seq88,r_196_334_27,1.0,0,27,27,29
110,r_229_9_22,r_290_314_137,seq156,r_229_9_22,0.99,0,22,22,29
36,r_264_323_120,seq347,seq133,r_264_323_120,1.0,2,122,120,29
17,r_258_84_148,seq83,seq0,r_258_84_148,1.0,0,148,148,29
90,r_321_288_80,seq20,r_52_373_54,r_321_288_80,1.0,0,80,80,29
226,seq303,seq20,r_297_103_28,r_297_103_28,1.0,22,50,28,29
79,r_208_4_53,r_79_109_195,seq136,r_208_4_53,0.98,0,53,53,29
35,r_238_316_136,r_348_58_163,r_227_98_98,r_238_316_136,1.0,1,137,136,29
78,r_21_359_188,r_202_12_101,seq255,r_202_12_101,1.0,2,103,101,29
50,r_99_198_165,seq50,r_331_143_59,r_99_198_165,1.0,0,165,165,29
191,seq186,r_290_314_137,r_11_243_22,r_11_243_22,0.79,0,22,22,29
106,r_348_58_163,seq284,r_352_233_51,r_348_58_163,1.0,0,163,163,29
30,r_42_265_186,seq315,r_159_168_181,r_42_265_186,0.99,0,186,186,29
60,r_304_305_55,r_330_54_176,r_23_10_21,r_304_305_55,0.87,8,63,55,29
85,r_192_249_29,r_366_295_181,r_159_168_181,r_192_249_29,0.93,2,31,29,29
14,r_270_31_54,r_332_86_138,seq247,r_270_31_54,0.88,4,58,54,29
87,r_17_48_98,r_227_98_98,seq367,r_17_48_98,1.0,4,102,98,29
58,r_325_205_78,r_293_335_123,seq315,r_325_205_78,1.0,0,78,78,29
117,r_97_345_168,seq246,r_221_157_17,r_97_345_168,0.98,2,170,168,29
112,r_312_118_23,seq367,seq64,r_312_118_23,1.0,1,24,23,29
109,r_66_313_38,r_119_70_58,r_192_249_29,r_119_70_58,0.75,-20,38,58,29
29,r_23_10_21,r_331_143_59,seq69,r_23_10_21,0.89,-1,20,21,29
119,r_22_74_112,r_302_254_130,r_371_286_162,r_302_254_130,0.99,-7,123,130,29
42,r_185_281_33,seq69,seq296,r_185_281_33,0.89,2,35,33,29
9,r_24_162_96,r_191_142_117,seq360,r_24_162_96,0.48,0,96,96,29
221,seq284,r_56_197_126,r_202_12_101,r_56_197_126,0.97,0,126,126,29
71,r_287_278_167,r_200_46_138,r_22_74_112,r_287_278_167,0.66,-23,144,167,29
100,r_47_218_154,seq72,r_102_271_65,r_47_218_154,1.0,1,155,154,29
16,r_85_139_146,r_300_176_138,r_66_313_38,r_85_139_146,0.58,-77,69,146,29
97,r_324_241_85,r_330_54_176,seq35,r_324_241_85,1.0,0,85,85,29
95,r_199_210_100,seq132,r_361_105_61,r_199_210_100,1.0,0,100,100,29
49,r_56_197_126,seq284,seq280,r_56_197_126,1.0,0,126,126,29
113,r_116_90_17,r_339_296_146,r_312_243_162,r_116_90_17,1.0,0,17,17,30
236,seq336,r_159_369_108,seq341,r_159_369_108,1.0,0,108,108,30
75,r_117_281_55,r_179_172_196,seq37,r_117_281_55,1.0,0,55,55,30
122,r_96_345_181,seq257,r_271_278_65,r_96_345_181,0.99,0,181,181,30
170,seq147,seq36,r_276_222_7,r_276_222_7,0.93,12,19,7,30
19,r_68_135_126,seq319,seq119,r_68_135_126,1.0,0,126,126,30
86,r_175_289_24,r_113_101_97,seq105,r_175_289_24,1.0,0,24,24,30
37,r_136_150_128,seq323,r_133_128_41,r_136_150_128,0.98,0,128,128,30
32,r_28_38_90,seq258,r_117_281_55,r_28_38_90,1.0,0,90,90,30
38,r_141_180_172,seq371,r_134_374_54,r_141_180_172,1.0,0,172,172,30
66,r_33_139_91,seq326,r_104_67_103,r_104_67_103,1.0,6,109,103,30
92,r_62_4_58,r_108_364_102,seq238,r_62_4_58,1.0,-2,56,58,30
159,seq105,r_92_12_165,r_175_289_24,r_175_289_24,0.89,23,47,24,30
18,r_108_364_102,r_361_2_125,seq232,r_108_364_102,0.95,1,103,102,30
10,r_163_55_30,seq118,seq31,r_163_55_30,1.0,0,30,30,30
77,r_282_228_161,seq341,r_62_4_58,r_282_228_161,1.0,3,164,161,30
73,r_279_359_51,r_68_135_126,seq99,r_279_359_51,1.0,0,51,51,30
171,seq151,r_358_75_154,seq323,r_358_75_154,1.0,0,154,154,30
55,r_165_218_104,seq37,seq291,r_165_218_104,1.0,0,104,104,30
69,r_167_30_154,r_78_39_31,r_175_289_24,r_167_30_154,0.89,0,154,154,30
85,r_178_13_28,seq80,seq371,r_178_13_28,1.0,0,28,28,30
141,seq47,r_260_156_82,seq329,r_260_156_82,1.0,-36,46,82,30
26,r_358_75_154,seq151,r_33_139_91,r_358_75_154,1.0,0,154,154,30
8,r_334_349_127,seq22,r_78_39_31,r_334_349_127,1.0,0,127,127,30
58,r_272_57_178,seq329,seq121,r_272_57_178,0.98,0,178,178,30
40,r_339_296_146,seq238,seq233,r_339_296_146,1.0,2,148,146,30
206,seq267,r_177_226_68,r_277_125_83,r_277_125_83,0.65,-25,58,83,30
108,r_103_106_146,seq360,r_24_59_116,r_103_106_146,0.6,0,146,146,30
67,r_241_98_75,r_214_306_91,seq11,r_241_98_75,1.0,0,75,75,30
74,r_217_220_79,seq99,r_56_183_191,r_217_220_79,1.0,0,79,79,30
48,r_361_2_125,r_108_364_102,r_162_44_89,r_162_44_89,0.44,14,103,89,30
115,r_317_299_103,seq291,seq287,r_317_299_103,1.0,0,103,103,30
89,r_201_197_39,r_185_311_148,seq155,r_201_197_39,1.0,0,39,39,30
84,r_186_195_28,r_68_135_126,seq37,r_186_195_28,1.0,0,28,28,30
4,r_264_255_67,r_215_14_91,r_72_301_43,r_264_255_67,1.0,-3,64,67,30
124,r_353_15_71,seq319,seq351,r_353_15_71,1.0,1,72,71,30
111,r_63_338_66,r_50_221_171,seq329,r_63_338_66,1.0,0,66,66,30
97,r_19_275_180,seq79,r_312_243_162,r_312_243_162,0.86,22,184,162,30
21,r_56_183_191,seq326,r_217_220_79,r_217_220_79,1.0,10,89,79,30
51,r_254_187_18,r_134_374_54,r_160_327_5,r_254_187_18,1.0,1,19,18,30
119,r_174_245_145,seq210,r_305_342_68,r_174_245_145,1.0,3,148,145,30
3,r_271_278_65,r_48_40_105,r_9_328_36,r_271_278_65,0.71,0,65,65,30
44,r_127_240_36,r_282_228_161,r_149_146_59,r_127_240_36,1.0,-2,34,36,30
201,seq258,seq366,r_113_101_97,r_113_101_97,1.0,35,132,97,30
233,seq330,r_73_66_157,r_133_128_41,r_73_66_157,0.66,-12,145,157,30
17,r_219_158_142,r_167_30_154,r_361_2_125,r_361_2_125,0.56,17,142,125,30
6,r_114_157_79,r_347_145_175,r_149_146_59,r_114_157_79,1.0,-1,78,79,30
1,r_78_39_31,r_177_226_68,seq249,r_78_39_31,1.0,-1,30,31,30
5,r_32_142_154,seq151,r_234_203_41,r_234_203_41,0.64,116,157,41,30
174,seq168,r_340_17_135,r_225_213_24,r_225_213_24,0.73,2,26,24,30
50,r_234_203_41,seq331,seq5,r_234_203_41,1.0,2,43,41,30
41,r_184_194_11,r_361_2_125,seq79,r_184_194_11,0.68,2,13,11,30
95,r_64_8_182,seq291,r_113_101_97,r_64_8_182,0.83,0,182,182,30
63,r_104_67_103,r_185_311_148,r_33_139_91,r_104_67_103,1.0,0,103,103,30
0,r_123_49_162,seq291,r_127_240_36,r_123_49_162,1.0,0,162,162,30
114,r_356_208_38,r_114_157_79,seq170,r_356_208_38,1.0,0,38,38,30
100,r_97_111_77,r_24_59_116,r_279_359_51,r_97_111_77,0.84,-2,75,77,30
105,r_53_346_160,seq232,r_177_226_68,r_53_346_160,0.85,2,162,160,30
65,r_0_148_26,r_32_142_154,seq22,r_0_148_26,1.0,0,26,26,30
117,r_48_40_105,r_252_16_64,r_124_129_113,r_252_16_64,1.0,0,64,64,30
56,r_322_294_92,r_123_49_162,seq295,r_123_49_162,0.97,-87,75,162,30
20,r_304_248_88,r_361_2_125,r_202_204_126,r_202_204_126,0.87,1,127,126,30
68,r_368_3_84,seq366,seq291,r_368_3_84,0.99,-2,82,84,30
101,r_288_27_55,r_87_65_112,r_160_327_5,r_288_27_55,0.88,0,55,55,30
93,r_230_140_174,seq37,seq173,r_230_140_174,1.0,1,175,174,30
134,seq35,r_26_126_166,r_62_4_58,r_26_126_166,0.67,2,168,166,30
82,r_82_6_42,r_123_49_162,seq86,r_82_6_42,1.0,0,42,42,30
30,r_312_243_162,r_370_100_195,r_62_4_58,r_312_243_162,1.0,0,162,162,30
190,seq233,seq206,r_339_296_146,r_339_296_146,1.0,12,158,146,30
237,seq341,r_265_131_162,seq336,r_265_131_162,1.0,0,162,162,30
118,r_92_12_165,seq105,r_152_122_57,r_92_12_165,1.0,2,167,165,30
59,r_72_301_43,r_353_15_71,r_264_255_67,r_72_301_43,0.61,29,72,43,30
113,r_116_90_17,r_312_243_162,r_1_34_29,r_116_90_17,0.58,38,55,17,30
60,r_355_43_170,r_149_146_59,r_113_101_97,r_355_43_170,1.0,0,170,170,30
61,r_1_34_29,r_305_342_68,r_116_90_17,r_1_34_29,0.67,0,29,29,30
16,r_250_224_88,r_167_30_154,r_234_203_41,r_167_30_154,1.0,-1,153,154,30
112,r_162_44_89,seq21,r_361_2_125,r_162_44_89,1.0,0,89,89,30
189,seq232,r_53_346_160,r_160_327_5,r_160_327_5,0.71,14,19,5,30
24,r_23_154_35,r_114_157_79,r_186_195_28,r_23_154_35,0.89,0,35,35,30
64,r_318_29_158,seq329,r_23_154_35,r_318_29_158,1.0,0,158,158,30
102,r_207_297_31,seq93,seq20,r_207_297_31,1.0,0,31,31,30
14,r_305_342_68,seq295,r_112_367_5,r_305_342_68,1.0,-2,66,68,30
2,r_50_221_171,seq263,r_234_203_41,r_50_221_171,0.99,0,171,171,30
34,r_277_125_83,r_24_59_116,seq267,r_277_125_83,1.0,-24,59,83,30
25,r_209_268_116,seq74,r_368_3_84,r_209_268_116,1.0,0,116,116,30
7,r_214_306_91,seq70,r_1_34_29,r_214_306_91,1.0,0,91,91,30
112,r_162_44_89,r_361_2_125,r_48_40_105,r_162_44_89,0.86,38,127,89,30
107,r_215_14_91,r_244_333_158,r_225_213_24,r_244_333_158,1.0,0,158,158,30
72,r_373_188_16,r_88_76_183,r_112_367_5,r_373_188_16,0.96,0,16,16,30
16,r_250_224_88,r_214_306_91,r_167_30_154,r_250_224_88,1.0,0,88,88,30
36,r_348_164_77,seq70,seq61,r_348_164_77,1.0,-1,76,77,30
205,seq266,seq249,r_280_284_22,r_280_284_22,1.0,0,22,22,30
9,r_113_101_97,seq46,seq258,r_113_101_97,1.0,1,98,97,30
28,r_362_109_156,seq267,r_113_101_97,r_362_109_156,0.99,0,156,156,30
90,r_89_337_82,seq25,seq309,r_89_337_82,1.0,0,82,82,30
83,r_285_193_116,r_32_142_154,r_23_154_35,r_285_193_116,1.0,0,116,116,30
116,r_199_166_135,r_282_228_161,r_317_299_103,r_199_166_135,1.0,0,135,135,30
232,seq329,r_318_29_158,r_63_338_66,r_63_338_66,0.62,0,66,66,30
15,r_152_122_57,r_368_3_84,seq169,r_152_122_57,1.0,0,57,57,30
52,r_262_270_132,seq79,r_231_350_18,r_231_350_18,0.84,122,140,18,30
69,r_167_30_154,r_219_158_142,r_78_39_31,r_167_30_154,0.7,-12,142,154,30
215,seq292,r_244_333_158,r_225_213_24,r_244_333_158,0.99,-1,157,158,30
42,r_102_293_79,r_112_367_5,r_9_328_36,r_9_328_36,1.0,37,73,36,30
27,r_335_316_141,seq95,r_304_248_88,r_335_316_141,1.0,0,141,141,30
107,r_215_14_91,seq31,r_244_333_158,r_215_14_91,1.0,0,91,91,30
70,r_212_198_141,seq273,seq47,r_212_198_141,1.0,0,141,141,30
54,r_9_328_36,r_162_44_89,seq22,r_9_328_36,0.87,1,37,36,30
98,r_171_132_86,seq155,seq99,r_171_132_86,1.0,0,86,86,30
123,r_73_66_157,seq330,r_85_189_136,r_73_66_157,1.0,-1,156,157,30
121,r_138_242_55,r_162_44_89,seq170,r_138_242_55,1.0,0,55,55,30
53,r_256_300_90,r_253_94_116,r_82_6_42,r_82_6_42,0.6,49,91,42,30
13,r_252_16_64,r_48_40_105,seq46,r_252_16_64,1.0,0,64,64,30
78,r_260_156_82,seq47,r_23_154_35,r_260_156_82,1.0,0,82,82,30
61,r_1_34_29,r_116_90_17,r_214_306_91,r_214_306_91,1.0,59,150,91,30
20,r_304_248_88,r_32_142_154,r_361_2_125,r_304_248_88,1.0,0,88,88,30
11,r_134_374_54,r_28_38_90,seq273,r_134_374_54,1.0,-1,53,54,30
240,seq351,seq291,r_353_15_71,r_353_15_71,1.0,25,96,71,30
47,r_85_189_136,seq232,seq81,r_85_189_136,1.0,0,136,136,30
48,r_361_2_125,r_162_44_89,r_277_125_83,r_361_2_125,0.89,2,127,125,30
46,r_24_59_116,seq22,r_63_338_66,r_24_59_116,1.0,0,116,116,30
104,r_77_7_188,seq105,r_252_16_64,r_77_7_188,0.97,-1,187,188,30
106,r_202_204_126,r_136_150_128,r_304_248_88,r_136_150_128,0.88,-2,126,128,30
81,r_124_129_113,r_48_40_105,seq79,r_124_129_113,0.48,-21,92,113,30
110,r_231_350_18,r_113_101_97,seq60,r_231_350_18,0.95,1,19,18,30
45,r_133_128_41,r_50_221_171,seq168,r_133_128_41,1.0,1,42,41,30
117,r_48_40_105,r_124_129_113,r_162_44_89,r_48_40_105,1.0,1,106,105,30
31,r_253_94_116,r_73_66_157,r_254_187_18,r_253_94_116,1.0,0,116,116,30
22,r_347_145_175,seq313,r_264_255_67,r_347_145_175,1.0,1,176,175,30
88,r_190_216_111,r_347_145_175,seq210,r_190_216_111,1.0,-1,110,111,30
29,r_225_213_24,r_207_297_31,seq168,r_225_213_24,1.0,0,24,24,30
103,r_26_126_166,seq35,r_277_125_83,r_26_126_166,0.99,2,168,166,30
120,r_192_110_57,seq58,r_134_374_54,r_192_110_57,1.0,0,57,57,30
59,r_72_301_43,r_113_101_97,r_353_15_71,r_72_301_43,0.76,-1,42,43,30
81,r_124_129_113,seq79,seq210,r_124_129_113,0.71,0,113,113,30
94,r_177_226_68,seq267,seq360,r_177_226_68,0.77,-10,58,68,30
194,seq238,r_339_296_146,r_62_4_58,r_339_296_146,0.6,2,148,146,30
99,r_265_131_162,seq341,r_124_129_113,r_265_131_162,1.0,0,162,162,30
57,r_159_369_108,seq336,seq99,r_159_369_108,1.0,0,108,108,30
39,r_227_320_50,r_32_142_154,seq37,r_227_320_50,1.0,0,50,50,30
76,r_205_302_28,r_252_16_64,seq235,r_205_302_28,0.73,0,28,28,30
35,r_83_161_185,r_87_65_112,r_271_278_65,r_83_161_185,0.72,-1,184,185,30
230,seq324,r_285_286_97,r_259_374_38,r_285_286_97,1.0,0,97,97,31
55,r_369_24_14,r_208_313_155,seq3,r_208_313_155,0.54,-139,16,155,31
101,r_121_70_86,seq106,r_36_113_133,r_121_70_86,0.87,1,87,86,31
59,r_72_100_121,r_141_226_146,r_13_117_40,r_72_100_121,0.76,0,121,121,31
77,r_34_119_145,seq103,r_349_133_58,r_34_119_145,1.0,0,145,145,31
30,r_115_159_179,seq187,seq297,r_115_159_179,0.93,0,179,179,31
103,r_281_137_155,r_294_175_33,r_252_63_132,r_294_175_33,0.86,0,33,33,31
152,seq91,seq186,r_349_133_58,r_349_133_58,1.0,16,74,58,31
1,r_68_69_32,r_7_287_175,seq132,r_68_69_32,0.92,0,32,32,31
122,r_326_160_149,seq3,r_118_341_134,r_326_160_149,1.0,1,150,149,31
29,r_179_343_131,seq65,seq289,r_179_343_131,1.0,0,131,131,31
22,r_104_140_79,r_51_32_27,r_116_146_116,r_104_140_79,0.52,62,141,79,31
90,r_20_166_95,r_230_190_54,r_273_54_43,r_20_166_95,1.0,0,95,95,31
24,r_136_142_129,r_228_171_105,r_357_185_52,r_228_171_105,0.94,-14,91,105,31
10,r_141_226_146,seq277,r_294_175_33,r_141_226_146,1.0,0,146,146,31
72,r_191_14_72,seq144,seq199,r_191_14_72,1.0,0,72,72,31
62,r_296_244_23,r_120_188_160,r_338_66_33,r_296_244_23,1.0,1,24,23,31
110,r_228_171_105,r_136_142_129,seq319,r_228_171_105,1.0,0,105,105,31
245,seq361,r_76_101_59,seq138,r_76_101_59,1.0,-20,39,59,31
60,r_352_98_42,r_365_5_199,seq172,r_352_98_42,1.0,0,42,42,31
139,seq52,r_13_117_40,r_254_298_52,r_13_117_40,0.99,1,41,40,31
2,r_362_270_82,r_245_149_94,seq108,r_245_149_94,1.0,-12,82,94,31
69,r_250_202_103,seq203,seq329,r_250_202_103,1.0,0,103,103,31
6,r_208_313_155,r_150_350_163,r_207_170_34,r_207_170_34,1.0,1,35,34,31
33,r_248_114_86,r_210_256_187,r_369_24_14,r_210_256_187,0.99,0,187,187,31
124,r_50_243_190,seq122,r_208_313_155,r_50_243_190,0.97,0,190,190,31
123,r_46_246_31,r_31_125_79,seq122,r_46_246_31,0.94,2,33,31,31
79,r_10_218_154,r_123_278_152,seq138,r_10_218_154,1.0,0,154,154,31
91,r_358_167_78,seq148,r_23_197_58,r_358_167_78,1.0,2,80,78,31
44,r_105_241_88,r_285_286_97,seq261,r_105_241_88,1.0,1,89,88,31
120,r_269_253_51,seq87,r_368_315_12,r_269_253_51,1.0,0,51,51,31
98,r_80_304_41,r_153_60_199,seq33,r_80_304_41,1.0,0,41,41,31
109,r_236_335_85,r_44_92_129,seq65,r_236_335_85,0.99,3,88,85,31
21,r_227_303_86,r_110_265_100,r_76_101_59,r_227_303_86,1.0,4,90,86,31
119,r_371_156_125,seq83,seq132,r_371_156_125,1.0,0,125,125,31
92,r_9_275_175,seq112,seq152,r_9_275_175,1.0,1,176,175,31
85,r_8_99_121,seq40,r_195_216_25,r_8_99_121,1.0,0,121,121,31
70,r_88_364_116,r_7_287_175,seq19,r_88_364_116,1.0,0,116,116,31
118,r_62_53_94,r_250_202_103,seq87,r_250_202_103,1.0,-9,94,103,31
33,r_248_114_86,seq144,r_210_256_187,r_248_114_86,0.83,16,102,86,31
18,r_273_54_43,r_157_162_146,seq109,r_273_54_43,1.0,0,43,43,31
20,r_294_175_33,r_281_137_155,seq164,r_294_175_33,0.98,0,33,33,31
3,r_13_117_40,seq52,seq172,r_13_117_40,1.0,0,40,40,31
100,r_76_101_59,seq361,seq112,r_76_101_59,1.0,0,59,59,31
11,r_207_170_34,r_339_234_181,r_208_313_155,r_207_170_34,0.99,0,34,34,31
185,seq187,r_115_159_179,r_116_146_116,r_115_159_179,0.89,0,179,179,31
58,r_168_84_31,r_316_2_150,seq158,r_168_84_31,0.99,1,32,31,31
81,r_233_43_39,r_31_125_79,r_13_117_40,r_31_125_79,1.0,0,79,79,31
31,r_252_63_132,seq138,seq211,r_252_63_132,1.0,0,132,132,31
9,r_147_283_144,r_196_37_149,r_285_286_97,r_147_283_144,0.96,1,145,144,31
71,r_370_272_91,r_20_166_95,r_294_175_33,r_370_272_91,0.79,1,92,91,31
168,seq138,r_252_63_132,r_353_263_16,r_252_63_132,1.0,0,132,132,31
97,r_284_56_144,r_355_274_199,r_195_216_25,r_284_56_144,1.0,0,144,144,31
28,r_306_26_71,seq261,seq282,r_306_26_71,0.99,1,72,71,31
101,r_121_70_86,r_36_113_133,r_179_343_131,r_121_70_86,0.95,47,133,86,31
83,r_235_314_119,r_44_92_129,r_13_117_40,r_235_314_119,1.0,0,119,119,31
68,r_214_360_72,r_210_256_187,r_352_98_42,r_214_360_72,1.0,0,72,72,31
4,r_31_125_79,r_233_43_39,seq312,r_31_125_79,1.0,0,79,79,31
93,r_27_327_178,r_130_134_199,r_34_119_145,r_27_327_178,0.96,0,178,178,31
26,r_316_2_150,seq310,r_365_5_199,r_316_2_150,1.0,0,150,150,31
80,r_196_37_149,r_147_283_144,r_118_341_134,r_196_37_149,1.0,1,150,149,31
35,r_169_240_63,seq106,seq173,r_169_240_63,1.0,1,64,63,31
8,r_116_146_116,r_154_204_155,r_104_140_79,r_104_140_79,0.92,37,116,79,31
218,seq297,r_351_279_178,r_115_159_179,r_115_159_179,0.91,7,186,179,31
16,r_210_256_187,r_248_114_86,r_179_343_131,r_210_256_187,0.94,0,187,187,31
89,r_336_22_130,seq172,r_178_183_11,r_336_22_130,1.0,0,130,130,31
94,r_340_280_124,seq78,r_227_303_86,r_340_280_124,0.73,5,129,124,31
11,r_207_170_34,r_208_313_155,r_68_69_32,r_208_313_155,0.99,0,155,155,31
5,r_254_298_52,r_90_42_196,seq52,r_254_298_52,0.73,12,64,52,31
41,r_58_359_38,r_39_232_79,seq193,r_39_232_79,0.7,-41,38,79,31
86,r_36_113_133,r_121_70_86,r_168_84_31,r_36_113_133,0.99,0,133,133,31
22,r_104_140_79,r_336_22_130,r_51_32_27,r_104_140_79,1.0,0,79,79,31
82,r_373_135_113,seq282,r_330_77_113,r_373_135_113,1.0,0,113,113,31
88,r_285_286_97,seq324,seq3,r_285_286_97,1.0,0,97,97,31
112,r_349_133_58,r_141_226_146,seq91,r_349_133_58,1.0,1,59,58,31
74,r_12_262_185,seq297,r_209_73_77,r_12_262_185,1.0,0,185,185,31
125,seq0,r_357_185_52,r_200_176_16,r_200_176_16,0.96,9,25,16,31
4,r_31_125_79,r_104_140_79,r_233_43_39,r_233_43_39,0.93,8,47,39,31
14,r_120_188_160,seq94,seq354,r_120_188_160,1.0,0,160,160,31
34,r_23_197_58,r_254_298_52,r_296_244_23,r_23_197_58,1.0,0,58,58,31
40,r_308_155_93,r_150_350_163,seq193,r_308_155_93,0.76,0,93,93,31
127,seq4,r_339_234_181,r_93_129_160,r_339_234_181,0.99,0,181,181,31
63,r_200_176_16,r_209_73_77,seq0,r_200_176_16,0.99,0,16,16,31
95,r_79_293_83,seq309,seq186,r_79_293_83,0.97,0,83,83,31
57,r_131_307_104,r_281_137_155,r_10_218_154,r_131_307_104,0.98,53,157,104,31
61,r_30_322_171,seq203,r_121_70_86,r_30_322_171,0.99,1,172,171,31
12,r_7_287_175,seq297,r_168_84_31,r_7_287_175,1.0,0,175,175,31
103,r_281_137_155,r_131_307_104,r_230_190_54,r_281_137_155,0.99,0,155,155,31
65,r_85_206_59,r_7_287_175,r_97_215_4,r_85_206_59,1.0,1,60,59,31
113,r_51_32_27,r_299_6_190,r_338_66_33,r_51_32_27,1.0,0,27,27,31
46,r_212_48_151,seq312,r_254_298_52,r_212_48_151,1.0,0,151,151,31
32,r_195_216_25,r_31_125_79,seq203,r_195_216_25,0.54,0,25,25,31
7,r_339_234_181,seq4,r_62_53_94,r_339_234_181,0.96,0,181,181,31
6,r_208_313_155,r_207_170_34,r_340_280_124,r_207_170_34,0.62,121,155,34,31
45,r_357_185_52,seq220,seq291,r_357_185_52,0.94,20,72,52,31
75,r_318_59_159,seq108,r_80_304_41,r_318_59_159,0.93,0,159,159,31
57,r_131_307_104,r_231_321_106,r_281_137_155,r_231_321_106,0.87,0,106,106,31
116,r_295_28_98,seq173,r_209_73_77,r_295_28_98,1.0,0,98,98,31
101,r_121_70_86,r_179_343_131,r_30_322_171,r_30_322_171,0.93,1,172,171,31
56,r_222_64_116,r_34_119_145,seq258,r_222_64_116,1.0,1,117,116,31
76,r_353_263_16,r_230_190_54,seq193,r_353_263_16,0.96,0,16,16,31
53,r_118_341_134,r_93_129_160,seq4,r_118_341_134,0.71,6,140,134,31
66,r_245_149_94,seq81,r_292_267_1,r_245_149_94,1.0,0,94,94,31
208,seq261,seq67,r_105_241_88,r_105_241_88,1.0,2,90,88,31
78,r_95_21_115,r_259_374_38,seq86,r_95_21_115,1.0,0,115,115,31
181,seq173,r_295_28_98,seq174,r_295_28_98,1.0,0,98,98,31
130,seq19,seq345,r_88_364_116,r_88_364_116,1.0,1,117,116,31
24,r_136_142_129,r_357_185_52,r_369_24_14,r_136_142_129,1.0,0,129,129,31
37,r_17_276_137,seq65,r_195_216_25,r_17_276_137,1.0,0,137,137,31
134,seq40,r_8_99_121,r_369_24_14,r_8_99_121,0.99,0,121,121,31
184,seq186,seq288,r_79_293_83,r_79_293_83,0.99,15,98,83,31
111,r_177_223_118,r_123_278_152,r_294_175_33,r_177_223_118,1.0,0,118,118,31
117,r_143_217_49,r_115_159_179,r_259_374_38,r_143_217_49,0.89,0,49,49,31
47,r_154_204_155,seq329,r_308_155_93,r_154_204_155,0.68,0,155,155,31
107,r_153_60_199,r_80_304_41,seq139,r_80_304_41,1.0,0,41,41,31
106,r_231_321_106,r_131_307_104,r_233_43_39,r_231_321_106,1.0,0,106,106,31
50,r_157_162_146,seq3,r_222_64_116,r_157_162_146,1.0,0,146,146,31
51,r_330_77_113,seq145,seq89,r_330_77_113,1.0,0,113,113,31
103,r_281_137_155,r_252_63_132,r_131_307_104,r_281_137_155,0.88,-53,102,155,31
81,r_233_43_39,seq289,r_31_125_79,r_233_43_39,0.99,1,40,39,31
146,seq78,r_340_280_124,r_249_184_190,r_340_280_124,0.9,0,124,124,31
42,r_39_232_79,r_316_2_150,seq291,r_39_232_79,1.0,0,79,79,31
108,r_178_183_11,seq91,seq132,r_178_183_11,0.9,-1,10,11,31
86,r_36_113_133,seq347,r_121_70_86,r_121_70_86,0.53,1,87,86,31
104,r_18_38_54,seq128,r_168_84_31,r_168_84_31,0.97,88,119,31,31
16,r_210_256_187,seq3,r_248_114_86,r_210_256_187,0.72,-51,136,187,31
84,r_25_342_60,r_30_322_171,r_130_134_199,r_25_342_60,1.0,0,60,60,31
14,r_177_1_29,r_310_302_173,seq184,r_177_1_29,1.0,0,29,29,32
107,r_155_81_177,r_63_157_179,r_319_58_95,r_155_81_177,1.0,0,177,177,32
93,r_344_339_129,r_74_300_89,r_205_342_108,r_74_300_89,1.0,0,89,89,32
4,r_105_289_157,r_89_139_198,r_349_318_10,r_105_289_157,1.0,0,157,157,32
115,r_238_240_72,r_262_354_168,seq133,r_238_240_72,1.0,1,73,72,32
109,r_30_166_137,r_129_364_93,r_303_136_143,r_129_364_93,1.0,0,93,93,32
33,r_252_186_135,seq11,r_306_114_63,r_252_186_135,1.0,1,136,135,32
37,r_127_260_57,r_68_307_104,seq77,r_127_260_57,1.0,0,57,57,32
42,r_303_136_143,r_30_166_137,r_270_246_104,r_270_246_104,1.0,29,133,104,32
17,r_138_328_22,r_63_157_179,seq223,r_138_328_22,0.99,0,22,22,32
163,seq121,r_265_337_118,r_97_153_97,r_97_153_97,0.84,0,97,97,32
29,r_64_61_86,r_97_153_97,seq372,r_64_61_86,0.69,0,86,86,32
103,r_123_259_121,r_173_143_174,r_68_307_104,r_123_259_121,1.0,0,121,121,32
21,r_319_58_95,r_16_298_140,seq162,r_319_58_95,1.0,0,95,95,32
12,r_57_65_103,r_205_342_108,r_299_161_47,r_299_161_47,0.87,59,106,47,32
56,r_278_226_173,r_326_228_12,r_213_330_132,r_278_226_173,0.74,-1,172,173,32
69,r_125_353_132,seq27,r_115_14_96,r_125_353_132,1.0,0,132,132,32
101,r_326_228_12,r_79_54_98,r_278_226_173,r_326_228_12,0.98,0,12,12,32
41,r_213_330_132,r_310_302_173,r_242_263_5,r_213_330_132,1.0,0,132,132,32
10,r_73_329_111,r_89_139_198,r_109_251_62,r_89_139_198,0.83,-87,111,198,32
45,r_193_39_71,seq203,seq222,r_193_39_71,1.0,0,71,71,32
1,r_71_198_81,seq234,r_138_328_22,r_71_198_81,1.0,0,81,81,32
23,r_348_87_22,r_195_248_148,r_365_181_10,r_348_87_22,1.0,0,22,22,32
24,r_279_176_63,seq212,seq178,r_279_176_63,1.0,0,63,63,32
114,r_270_246_104,seq77,seq219,r_270_246_104,1.0,0,104,104,32
90,r_214_245_12,r_180_254_86,seq184,r_214_245_12,1.0,0,12,12,32
155,seq99,r_19_84_82,r_167_52_63,r_167_52_63,1.0,40,103,63,32
240,seq345,r_95_185_137,r_209_163_130,r_95_185_137,1.0,1,138,137,32
15,r_310_302_173,seq11,r_97_153_97,r_310_302_173,0.93,0,173,173,32
34,r_349_318_10,r_5_361_166,seq347,r_349_318_10,0.84,0,10,10,32
38,r_274_369_37,seq99,r_90_367_121,r_90_367_121,1.0,10,131,121,32
43,r_305_26_20,r_225_20_110,seq347,r_305_26_20,1.0,0,20,20,32
7,r_119_236_127,seq128,seq309,r_119_236_127,1.0,0,127,127,32
40,r_343_231_34,r_357_220_161,seq132,r_343_231_34,0.99,0,34,34,32
73,r_5_361_166,r_344_339_129,r_216_243_166,r_5_361_166,0.7,-97,69,166,32
2,r_247_201_51,seq290,seq18,r_247_201_51,1.0,0,51,51,32
62,r_357_220_161,seq282,seq101,r_357_220_161,1.0,2,163,161,32
25,r_277_112_14,seq323,r_370_224_2,r_277_112_14,1.0,0,14,14,32
5,r_264_189_184,seq184,r_319_58_95,r_264_189_184,0.97,0,184,184,32
76,r_129_364_93,r_30_166_137,seq130,r_129_364_93,1.0,0,93,93,32
74,r_205_342_108,r_57_65_103,r_214_245_12,r_205_342_108,0.64,-2,106,108,32
44,r_235_338_92,seq12,seq44,r_235_338_92,1.0,0,92,92,32
100,r_82_297_93,seq132,seq141,r_82_297_93,0.65,0,93,93,32
36,r_295_215_79,seq99,seq350,r_295_215_79,1.0,0,79,79,32
64,r_358_10_110,seq9,r_299_161_47,r_358_10_110,0.96,0,110,110,32
31,r_167_52_63,seq222,seq99,r_167_52_63,1.0,0,63,63,32
86,r_331_146_114,seq27,r_314_67_110,r_331_146_114,1.0,0,114,114,32
83,r_15_85_38,r_235_338_92,seq323,r_15_85_38,1.0,0,38,38,32
102,r_69_172_156,seq76,r_119_236_127,r_69_172_156,1.0,0,156,156,32
53,r_229_34_137,seq219,r_358_10_110,r_229_34_137,1.0,0,137,137,32
78,r_62_233_56,r_69_172_156,seq117,r_62_233_56,1.0,0,56,56,32
122,r_170_336_31,r_262_354_168,seq137,r_170_336_31,1.0,0,31,31,32
128,seq11,r_213_330_132,seq22,r_213_330_132,1.0,-16,116,132,32
52,r_249_145_42,r_281_83_118,r_365_181_10,r_249_145_42,1.0,0,42,42,32
237,seq332,seq116,r_266_165_82,r_266_165_82,1.0,67,149,82,32
105,r_55_230_74,r_262_354_168,r_102_36_71,r_55_230_74,1.0,0,74,74,32
97,r_227_43_153,seq60,r_167_52_63,r_227_43_153,1.0,0,153,153,32
28,r_63_157_179,seq206,r_71_198_81,r_63_157_179,1.0,0,179,179,32
66,r_286_217_140,seq316,r_266_165_82,r_286_217_140,1.0,0,140,140,32
51,r_210_301_155,r_64_61_86,r_68_307_104,r_210_301_155,0.89,0,155,155,32
27,r_266_165_82,r_356_333_175,r_286_217_140,r_266_165_82,0.73,92,174,82,32
51,r_210_301_155,r_126_315_133,r_64_61_86,r_210_301_155,1.0,-22,133,155,32
9,r_115_14_96,r_216_243_166,seq24,r_115_14_96,0.52,-25,71,96,32
88,r_72_373_175,seq174,seq46,r_72_373_175,1.0,0,175,175,32
20,r_314_67_110,r_69_172_156,seq35,r_314_67_110,0.96,3,113,110,32
87,r_8_75_36,r_279_176_63,seq46,r_8_75_36,1.0,0,36,36,32
60,r_360_293_87,seq154,seq223,r_360_293_87,1.0,0,87,87,32
65,r_92_110_31,r_180_254_86,seq203,r_180_254_86,1.0,-55,31,86,32
77,r_317_169_56,r_237_340_84,seq13,r_317_169_56,1.0,0,56,56,32
101,r_326_228_12,r_278_226_173,r_266_165_82,r_278_226_173,0.94,-1,172,173,32
58,r_74_300_89,r_344_339_129,seq133,r_74_300_89,1.0,0,89,89,32
110,r_66_362_28,r_239_208_120,seq76,r_66_362_28,0.99,0,28,28,32
57,r_182_56_195,r_32_142_175,r_295_215_79,r_182_56_195,0.69,-73,122,195,32
98,r_16_298_140,r_19_84_82,r_237_340_84,r_16_298_140,1.0,-1,139,140,32
46,r_356_333_175,r_196_108_179,r_278_226_173,r_196_108_179,1.0,-4,175,179,32
117,r_244_28_65,r_17_258_185,r_268_284_40,r_244_28_65,1.0,0,65,65,32
106,r_273_48_23,seq6,seq40,r_273_48_23,0.99,0,23,23,32
13,r_262_354_168,r_292_100_183,r_8_75_36,r_262_354_168,1.0,0,168,168,32
123,r_98_29_88,seq41,r_242_263_5,r_98_29_88,0.9,-1,87,88,32
89,r_126_315_133,r_210_301_155,seq148,r_126_315_133,1.0,0,133,133,32
11,r_237_340_84,seq116,r_277_112_14,r_237_340_84,1.0,0,84,84,32
3,r_79_54_98,seq347,r_214_245_12,r_79_54_98,1.0,0,98,98,32
116,r_107_23_135,r_86_50_199,r_252_186_135,r_107_23_135,1.0,0,135,135,32
143,seq46,seq162,r_8_75_36,r_8_75_36,1.0,2,38,36,32
222,seq288,r_216_243_166,seq6,r_216_243_166,1.0,0,166,166,32
84,r_306_114_63,r_262_354_168,seq40,r_306_114_63,1.0,1,64,63,32
19,r_180_254_86,r_281_83_118,r_62_233_56,r_180_254_86,1.0,0,86,86,32
111,r_255_313_13,r_113_42_105,seq219,r_255_313_13,0.99,0,13,13,32
18,r_195_248_148,seq308,r_102_36_71,r_195_248_148,1.0,0,148,148,32
249,seq372,r_210_301_155,r_64_61_86,r_64_61_86,0.67,1,87,86,32
98,r_16_298_140,r_319_58_95,r_19_84_82,r_319_58_95,0.99,-41,54,95,32
164,seq128,r_205_342_108,seq288,r_205_342_108,0.99,2,110,108,32
8,r_70_47_103,r_278_226_173,seq27,r_70_47_103,0.64,-1,102,103,32
228,seq309,r_102_36_71,r_119_236_127,r_119_236_127,0.44,7,134,127,32
94,r_268_284_40,r_314_67_110,seq200,r_268_284_40,0.79,0,40,40,32
165,seq130,seq80,r_129_364_93,r_129_364_93,1.0,44,137,93,32
73,r_5_361_166,r_216_243_166,r_17_258_185,r_216_243_166,0.96,-50,116,166,32
35,r_291_93_44,r_314_67_110,seq179,r_291_93_44,0.96,0,44,44,32
118,r_31_37_74,seq179,seq261,r_31_37_74,1.0,0,74,74,32
67,r_196_108_179,seq287,r_295_215_79,r_196_108_179,0.86,0,179,179,32
112,r_281_83_118,seq309,r_317_169_56,r_281_83_118,1.0,0,118,118,32
38,r_274_369_37,r_194_7_134,seq99,r_274_369_37,1.0,0,37,37,32
113,r_292_100_183,r_264_189_184,seq49,r_292_100_183,0.99,0,183,183,32
172,seq141,r_239_208_120,r_82_297_93,r_239_208_120,1.0,0,120,120,32
79,r_183_187_66,seq49,r_66_362_28,r_183_187_66,1.0,0,66,66,32
6,r_321_250_126,seq13,r_127_260_57,r_321_250_126,1.0,0,126,126,32
220,seq283,r_124_104_13,r_90_367_121,r_124_104_13,0.55,2,15,13,32
119,r_209_163_130,seq80,seq345,r_209_163_130,0.92,5,135,130,32
22,r_19_84_82,seq99,r_232_256_122,r_232_256_122,1.0,-1,121,122,32
55,r_232_256_122,seq133,r_19_84_82,r_232_256_122,1.0,0,122,122,32
56,r_278_226_173,r_70_47_103,r_326_228_12,r_70_47_103,0.68,-1,102,103,32
49,r_197_351_52,seq140,seq316,r_197_351_52,1.0,0,52,52,32
59,r_225_20_110,seq18,seq191,r_225_20_110,1.0,0,110,110,32
197,seq203,r_193_39_71,r_92_110_31,r_193_39_71,1.0,0,71,71,32
82,r_285_192_134,r_95_185_137,r_317_169_56,r_285_192_134,1.0,0,134,134,32
50,r_122_78_109,r_310_302_173,seq116,r_122_78_109,0.99,0,109,109,32
99,r_158_325_165,seq221,r_225_20_110,r_158_325_165,0.77,0,165,165,32
16,r_90_367_121,seq191,r_274_369_37,r_90_367_121,1.0,0,121,121,32
61,r_68_307_104,seq347,seq212,r_68_307_104,1.0,0,104,104,32
85,r_216_243_166,seq288,seq168,r_216_243_166,1.0,0,166,166,32
95,r_113_42_105,seq101,seq206,r_113_42_105,1.0,1,106,105,32
75,r_124_104_13,seq283,seq271,r_124_104_13,0.99,1,14,13,32
32,r_102_36_71,seq211,seq40,r_102_36_71,1.0,0,71,71,32
81,r_194_7_134,seq33,r_280_3_3,r_194_7_134,1.0,0,134,134,32
242,seq347,r_68_307_104,r_305_26_20,r_68_307_104,1.0,-30,74,104,32
26,r_97_153_97,seq371,seq121,r_97_153_97,1.0,1,98,97,32
71,r_95_185_137,r_285_192_134,seq312,r_95_185_137,1.0,0,137,137,32
13,r_262_354_168,r_55_230_74,r_292_100_183,r_55_230_74,1.0,0,74,74,32
91,r_374_96_74,seq38,seq111,r_374_96_74,1.0,0,74,74,32
54,r_32_142_175,r_182_56_195,r_357_220_161,r_32_142_175,1.0,0,175,175,32
27,r_266_165_82,seq223,r_356_333_175,r_266_165_82,1.0,0,82,82,32
163,seq121,seq287,r_265_337_118,r_265_337_118,0.61,-47,71,118,32
100,r_261_226_167,seq197,r_287_200_61,r_261_226_167,1.0,0,167,167,33
84,r_25_188_19,seq240,seq365,r_25_188_19,0.88,1,20,19,33
61,r_195_160_130,seq16,seq28,r_195_160_130,1.0,0,130,130,33
8,r_293_89_106,r_264_153_178,seq139,r_293_89_106,1.0,2,108,106,33
166,seq134,r_296_268_190,r_278_143_162,r_278_143_162,0.99,8,170,162,33
53,r_5_130_171,seq186,seq28,r_5_130_171,1.0,1,172,171,33
122,r_198_49_9,r_20_309_174,r_120_362_132,r_198_49_9,0.86,165,174,9,33
102,r_368_289_78,seq135,r_118_322_25,r_368_289_78,1.0,3,81,78,33
162,seq129,seq56,r_276_122_73,r_276_122_73,1.0,11,84,73,33
29,r_266_78_136,r_20_309_174,r_154_242_54,r_266_78_136,0.99,0,136,136,33
120,r_341_339_89,seq281,seq32,r_341_339_89,1.0,0,89,89,33
242,seq349,r_315_215_44,r_234_205_52,r_234_205_52,1.0,17,69,52,33
116,r_234_205_52,r_154_242_54,seq349,r_234_205_52,1.0,0,52,52,33
45,r_177_236_17,r_159_15_167,seq222,r_177_236_17,0.92,2,19,17,33
187,seq192,seq56,r_320_291_120,r_320_291_120,1.0,19,139,120,33
37,r_184_290_50,r_105_338_73,seq314,r_184_290_50,1.0,0,50,50,33
87,r_88_40_36,r_363_185_179,seq38,r_88_40_36,1.0,2,38,36,33
33,r_264_153_178,r_118_322_25,seq94,r_264_153_178,0.96,0,178,178,33
233,seq314,r_367_228_108,r_184_290_50,r_184_290_50,0.99,1,51,50,33
74,r_255_59_21,r_329_83_158,r_353_86_8,r_255_59_21,1.0,1,22,21,33
114,r_231_243_96,r_141_81_12,r_25_188_19,r_231_243_96,1.0,0,96,96,33
71,r_144_72_36,r_93_117_122,r_346_297_62,r_144_72_36,0.99,37,73,36,33
48,r_327_267_39,r_5_130_171,seq288,r_327_267_39,1.0,2,41,39,33
99,r_168_178_66,seq247,r_250_360_63,r_168_178_66,1.0,0,66,66,33
94,r_6_318_109,r_208_34_198,r_250_360_63,r_6_318_109,1.0,0,109,109,33
3,r_250_360_63,r_336_77_191,r_168_178_66,r_168_178_66,0.91,0,66,66,33
119,r_221_328_24,r_271_232_1,r_248_66_181,r_221_328_24,1.0,0,24,24,33
14,r_213_172_123,r_138_123_146,r_271_232_1,r_213_172_123,1.0,1,124,123,33
9,r_82_142_75,r_353_86_8,r_250_360_63,r_82_142_75,0.76,40,115,75,33
248,seq373,seq191,r_118_322_25,r_118_322_25,0.73,132,157,25,33
110,r_104_343_140,seq41,r_195_160_130,r_104_343_140,1.0,0,140,140,33
108,r_329_83_158,r_271_232_1,seq48,r_329_83_158,0.99,0,158,158,33
134,seq32,seq294,r_341_339_89,r_341_339_89,1.0,17,106,89,33
96,r_230_217_77,r_366_91_192,r_346_297_62,r_230_217_77,0.65,5,82,77,33
35,r_103_193_52,r_253_155_177,seq134,r_103_193_52,0.61,37,89,52,33
60,r_164_259_65,r_313_62_76,seq245,r_164_259_65,1.0,0,65,65,33
22,r_120_362_132,r_355_337_67,r_271_232_1,r_355_337_67,1.0,0,67,67,33
15,r_69_107_131,r_46_348_61,r_269_175_142,r_46_348_61,1.0,0,61,61,33
75,r_352_149_177,seq359,r_63_61_119,r_63_61_119,0.91,59,178,119,33
64,r_110_11_139,seq365,r_126_100_98,r_110_11_139,1.0,0,139,139,33
123,r_313_62_76,seq277,seq257,r_313_62_76,0.98,0,76,76,33
28,r_287_200_61,r_111_14_123,seq260,r_287_200_61,1.0,0,61,61,33
115,r_233_332_180,seq87,r_18_224_24,r_233_332_180,0.94,1,181,180,33
73,r_1_263_52,seq210,seq310,r_1_263_52,1.0,1,53,52,33
121,r_21_237_77,seq191,r_177_236_17,r_21_237_77,1.0,4,81,77,33
78,r_262_304_113,seq53,r_111_14_123,r_262_304_113,1.0,0,113,113,33
15,r_69_107_131,r_269_175_142,r_111_14_123,r_69_107_131,0.98,2,133,131,33
70,r_361_351_139,seq307,seq323,r_361_351_139,1.0,0,139,139,33
86,r_212_258_10,r_18_224_24,r_353_86_8,r_212_258_10,0.97,0,10,10,33
21,r_159_15_167,seq229,seq31,r_159_15_167,0.91,0,167,167,33
31,r_36_98_161,seq277,r_345_163_72,r_345_163_72,0.99,42,114,72,33
55,r_305_372_13,seq251,seq374,r_305_372_13,1.0,4,17,13,33
163,seq131,r_4_246_149,r_47_272_9,r_4_246_149,1.0,0,149,149,33
34,r_278_143_162,seq265,r_335_23_135,r_278_143_162,0.88,0,162,162,33
52,r_26_8_126,seq330,r_111_14_123,r_26_8_126,1.0,0,126,126,33
50,r_254_354_152,seq13,seq207,r_254_354_152,0.99,0,152,152,33
97,r_248_66_181,seq340,r_221_328_24,r_221_328_24,1.0,9,33,24,33
246,seq365,r_110_11_139,r_25_188_19,r_110_11_139,1.0,0,139,139,33
44,r_39_158_11,r_60_35_119,r_47_272_9,r_47_272_9,0.78,2,11,9,33
10,r_20_309_174,seq326,r_250_360_63,r_20_309_174,1.0,0,174,174,33
238,seq340,r_248_66_181,r_151_334_133,r_151_334_133,0.65,-6,127,133,33
40,r_345_163_72,r_220_371_180,r_198_49_9,r_345_163_72,1.0,1,73,72,33
49,r_151_334_133,seq245,seq340,r_151_334_133,0.97,2,135,133,33
72,r_271_232_1,r_329_83_158,r_213_172_123,r_271_232_1,0.98,157,158,1,33
80,r_7_99_22,seq115,seq359,r_7_99_22,0.79,0,22,22,33
54,r_10_0_148,r_336_77_191,r_88_40_36,r_10_0_148,1.0,0,148,148,33
117,r_312_50_20,r_250_360_63,seq140,r_312_50_20,0.64,4,24,20,33
65,r_346_297_62,r_141_81_12,r_144_72_36,r_346_297_62,1.0,2,64,62,33
9,r_82_142_75,r_357_102_22,r_353_86_8,r_353_86_8,0.62,20,28,8,33
112,r_317_176_16,r_293_89_106,r_271_232_1,r_317_176_16,0.97,4,20,16,33
27,r_55_179_46,seq48,seq350,r_55_179_46,1.0,1,47,46,33
105,r_182_125_77,seq257,seq169,r_182_125_77,0.99,3,80,77,33
11,r_93_117_122,r_71_119_161,seq190,r_93_117_122,1.0,0,122,122,33
38,r_54_204_42,r_296_268_190,r_18_224_24,r_296_268_190,0.56,-148,42,190,33
106,r_73_124_152,seq245,r_138_123_146,r_73_124_152,1.0,2,154,152,33
92,r_269_175_142,seq13,r_141_81_12,r_269_175_142,1.0,0,142,142,33
199,seq222,r_111_14_123,r_177_236_17,r_111_14_123,0.79,3,126,123,33
79,r_370_37_126,seq359,r_18_224_24,r_370_37_126,1.0,0,126,126,33
4,r_18_224_24,seq196,seq41,r_18_224_24,1.0,0,24,24,33
33,r_264_153_178,r_293_89_106,r_118_322_25,r_293_89_106,0.82,2,108,106,33
63,r_295_58_176,seq139,r_278_143_162,r_295_58_176,0.64,0,176,176,33
93,r_320_291_120,r_159_15_167,seq199,r_320_291_120,0.69,-83,37,120,33
18,r_276_122_73,seq109,seq129,r_276_122_73,1.0,3,76,73,33
13,r_256_279_107,r_220_371_180,r_358_316_7,r_256_279_107,1.0,0,107,107,33
19,r_60_35_119,seq30,seq24,r_60_35_119,1.0,0,119,119,33
62,r_355_337_67,r_120_362_132,seq52,r_355_337_67,0.99,0,67,67,33
7,r_4_246_149,seq131,r_189_218_5,r_4_246_149,1.0,0,149,149,33
25,r_111_14_123,seq222,seq298,r_111_14_123,0.82,3,126,123,33
227,seq302,seq209,r_358_316_7,r_358_316_7,0.84,32,39,7,33
119,r_221_328_24,r_248_66_181,r_18_224_24,r_248_66_181,0.95,0,181,181,33
20,r_189_218_5,r_19_27_71,r_4_246_149,r_4_246_149,0.94,3,152,149,33
30,r_105_338_73,r_76_280_178,r_29_300_2,r_105_338_73,1.0,0,73,73,33
6,r_152_324_116,seq302,seq307,r_152_324_116,0.95,-2,114,116,33
83,r_126_100_98,r_269_175_142,seq90,r_126_100_98,0.89,1,99,98,33
2,r_227_270_68,r_313_62_76,seq191,r_227_270_68,0.78,0,68,68,33
23,r_171_249_149,seq38,r_227_270_68,r_171_249_149,0.87,1,150,149,33
95,r_220_371_180,seq206,r_306_244_155,r_220_371_180,0.95,0,180,180,33
81,r_92_165_188,seq299,r_250_360_63,r_92_165_188,0.97,0,188,188,33
20,r_189_218_5,r_63_61_119,r_19_27_71,r_63_61_119,1.0,0,119,119,33
109,r_138_123_146,seq326,seq132,r_138_123_146,1.0,0,146,146,33
124,r_363_185_179,seq80,r_195_160_130,r_363_185_179,0.97,0,179,179,33
97,r_248_66_181,r_221_328_24,r_293_89_106,r_248_66_181,0.88,0,181,181,33
204,seq240,r_84_331_98,r_319_201_84,r_319_201_84,1.0,26,110,84,33
229,seq307,r_361_351_139,r_152_324_116,r_361_351_139,0.99,0,139,139,33
66,r_325_12_153,seq132,r_84_331_98,r_325_12_153,1.0,0,153,153,33
46,r_154_242_54,seq90,r_266_78_136,r_266_78_136,1.0,12,148,136,33
58,r_71_119_161,seq207,r_287_200_61,r_71_119_161,1.0,2,163,161,33
91,r_106_43_24,r_82_142_75,seq132,r_106_43_24,0.89,0,24,24,33
71,r_144_72_36,r_213_172_123,r_93_117_122,r_144_72_36,0.97,0,36,36,33
89,r_63_61_119,seq311,seq127,r_63_61_119,1.0,0,119,119,33
43,r_118_322_25,r_36_98_161,r_264_153_178,r_118_322_25,0.62,0,25,25,33
103,r_241_166_105,seq140,seq342,r_241_166_105,1.0,-4,101,105,33
39,r_57_96_108,seq30,seq209,r_57_96_108,1.0,0,108,108,33
167,seq135,r_368_289_78,seq257,r_368_289_78,1.0,3,81,78,33
98,r_147_128_116,seq113,r_106_43_24,r_147_128_116,1.0,0,116,116,33
36,r_76_280_178,seq133,r_278_143_162,r_278_143_162,0.96,16,178,162,33
46,r_154_242_54,r_234_205_52,seq90,r_154_242_54,1.0,0,54,54,33
190,seq199,r_278_143_162,r_183_148_50,r_183_148_50,0.93,2,52,50,33
69,r_335_23_135,r_208_34_198,r_46_348_61,r_335_23_135,1.0,0,135,135,33
216,seq281,r_341_339_89,r_85_239_21,r_341_339_89,1.0,0,89,89,33
111,r_367_228_108,seq41,r_85_239_21,r_367_228_108,0.98,0,108,108,33
22,r_120_362_132,r_271_232_1,seq133,r_120_362_132,1.0,0,132,132,33
67,r_194_238_24,r_2_42_105,seq109,r_194_238_24,1.0,0,24,24,33
118,r_67_101_61,r_336_77_191,r_85_239_21,r_67_101_61,0.99,0,61,61,33
16,r_183_148_50,seq51,seq199,r_183_148_50,1.0,2,52,50,33
90,r_74_3_173,seq298,r_250_360_63,r_74_3_173,1.0,0,173,173,33
101,r_364_203_58,r_269_175_142,seq65,r_364_203_58,1.0,2,60,58,33
104,r_357_102_22,r_63_61_119,r_19_27_71,r_63_61_119,1.0,0,119,119,33
47,r_306_244_155,seq288,seq121,r_306_244_155,0.87,1,156,155,33
51,r_2_42_105,r_110_11_139,r_7_99_22,r_2_42_105,1.0,0,105,105,33
170,seq139,r_295_58_176,r_293_89_106,r_295_58_176,1.0,0,176,176,33
82,r_64_75_81,seq210,r_54_204_42,r_64_75_81,1.0,0,81,81,33
93,r_320_291_120,seq199,seq192,r_320_291_120,1.0,-8,112,120,33
43,r_118_322_25,r_264_153_178,r_227_270_68,r_264_153_178,0.64,0,178,178,33
107,r_45_173_101,r_220_371_180,r_230_217_77,r_45_173_101,1.0,0,101,101,33
0,r_319_201_84,seq127,seq240,r_319_201_84,1.0,0,84,84,33
76,r_46_348_61,r_69_107_131,seq282,r_46_348_61,1.0,0,61,61,33
1,r_179_196_174,r_275_53_112,seq175,r_179_196_174,0.87,0,174,174,34
88,r_91_236_136,seq319,r_41_311_79,r_91_236_136,1.0,3,139,136,34
68,r_322_64_18,r_301_263_92,r_233_125_9,r_322_64_18,1.0,0,18,18,34
87,r_248_76_158,seq203,r_366_225_69,r_248_76_158,0.94,4,162,158,34
70,r_346_194_37,r_151_63_37,seq251,r_346_194_37,0.56,10,47,37,34
50,r_354_57_46,seq136,seq67,r_354_57_46,1.0,0,46,46,34
23,r_16_371_155,seq82,seq283,r_16_371_155,1.0,0,155,155,34
34,r_359_73_139,r_265_340_62,r_115_50_17,r_359_73_139,1.0,2,141,139,34
103,r_132_327_173,seq67,r_229_325_62,r_132_327_173,0.95,1,174,173,34
99,r_60_9_24,seq49,r_208_342_12,r_60_9_24,1.0,0,24,24,34
104,r_112_349_54,r_288_370_161,seq39,r_112_349_54,1.0,0,54,54,34
15,r_275_53_112,seq100,r_179_196_174,r_275_53_112,0.98,4,116,112,34
83,r_159_129_12,r_20_192_97,seq111,r_159_129_12,0.77,0,12,12,34
126,seq3,r_42_250_197,r_123_22_53,r_123_22_53,1.0,4,57,53,34
77,r_46_109_90,seq175,seq166,r_46_109_90,0.99,1,91,90,34
6,r_204_7_134,r_6_38_133,seq59,r_204_7_134,0.79,1,135,134,34
13,r_126_167_78,r_168_28_182,r_208_342_12,r_126_167_78,1.0,1,79,78,34
201,seq223,r_239_305_113,r_221_78_22,r_239_305_113,0.67,-18,95,113,34
118,r_229_325_62,r_16_371_155,r_252_56_129,r_16_371_155,0.98,-82,73,155,34
120,r_134_92_109,r_30_89_62,r_36_33_39,r_134_92_109,1.0,0,109,109,34
64,r_157_2_152,seq178,r_252_56_129,r_157_2_152,0.97,0,152,152,34
90,r_116_121_166,r_243_174_170,r_58_8_151,r_116_121_166,0.96,2,168,166,34
78,r_141_102_53,r_274_103_153,seq282,r_141_102_53,0.88,0,53,53,34
27,r_155_350_113,r_91_236_136,seq153,r_155_350_113,0.59,0,113,113,34
122,r_270_237_160,seq365,r_211_315_78,r_270_237_160,0.87,0,160,160,34
73,r_363_308_22,r_256_273_113,seq178,r_363_308_22,1.0,0,22,22,34
140,seq55,r_168_28_182,r_173_195_154,r_173_195_154,1.0,0,154,154,34
5,r_147_158_58,r_96_83_162,seq55,r_147_158_58,0.97,7,65,58,34
123,r_164_264_170,r_42_250_197,r_274_103_153,r_164_264_170,1.0,0,170,170,34
84,r_262_181_149,r_243_174_170,r_260_210_112,r_262_181_149,0.74,5,154,149,34
138,seq52,r_149_37_125,seq39,r_149_37_125,0.89,1,126,125,34
37,r_247_117_25,r_151_63_37,seq10,r_247_117_25,0.91,0,25,25,34
11,r_197_367_166,r_143_338_8,seq40,r_197_367_166,0.68,0,166,166,34
226,seq303,r_288_370_161,seq98,r_288_370_161,1.0,0,161,161,34
35,r_90_14_88,r_97_24_8,seq171,r_90_14_88,1.0,0,88,88,34
53,r_15_172_10,r_366_225_69,seq281,r_15_172_10,0.83,7,17,10,34
49,r_36_33_39,r_221_78_22,r_134_92_109,r_134_92_109,1.0,39,148,109,34
46,r_20_192_97,r_61_142_157,r_123_22_53,r_20_192_97,0.93,1,98,97,34
184,seq186,r_211_315_78,seq66,r_211_315_78,1.0,2,80,78,34
105,r_241_108_93,seq242,seq144,r_241_108_93,0.91,2,95,93,34
18,r_185_309_23,r_353_364_145,r_257_5_48,r_353_364_145,1.0,0,145,145,34
51,r_289_217_152,r_353_364_145,r_265_340_62,r_265_340_62,1.0,94,156,62,34
12,r_137_107_35,r_368_224_119,seq19,r_137_107_35,0.99,1,36,35,34
196,seq214,r_274_103_153,r_61_142_157,r_61_142_157,0.99,-2,155,157,34
10,r_23_26_81,seq39,seq278,r_23_26_81,0.9,15,96,81,34
29,r_118_156_10,r_204_7_134,seq332,r_204_7_134,0.96,1,135,134,34
57,r_256_273_113,seq160,r_230_187_69,r_256_273_113,1.0,0,113,113,34
59,r_61_142_157,seq198,seq214,r_61_142_157,0.93,2,159,157,34
101,r_368_224_119,seq71,seq203,r_368_224_119,0.89,1,120,119,34
2,r_6_38_133,r_204_7_134,r_20_192_97,r_6_38_133,0.99,2,135,133,34
44,r_266_11_143,seq87,r_133_138_6,r_266_11_143,1.0,0,143,143,34
74,r_228_193_72,r_25_161_175,seq88,r_228_193_72,0.95,2,74,72,34
52,r_149_37_125,seq52,seq218,r_149_37_125,1.0,1,126,125,34
116,r_45_343_170,seq345,r_58_8_151,r_45_343_170,0.98,1,171,170,34
55,r_145_330_160,seq66,r_288_370_161,r_145_330_160,1.0,0,160,160,34
30,r_189_177_141,r_128_182_2,r_369_347_24,r_189_177_141,0.84,0,141,141,34
14,r_280_122_44,r_36_33_39,seq165,r_280_122_44,0.65,4,48,44,34
118,r_229_325_62,r_252_56_129,r_132_327_173,r_229_325_62,0.77,93,155,62,34
95,r_260_210_112,r_145_330_160,seq171,r_145_330_160,1.0,-46,114,160,34
86,r_123_22_53,r_260_210_112,seq3,r_123_22_53,0.98,10,63,53,34
94,r_243_174_170,r_116_121_166,r_16_371_155,r_16_371_155,0.63,13,168,155,34
45,r_335_351_110,r_110_361_128,r_46_109_90,r_110_361_128,0.75,-13,115,128,34
7,r_25_161_175,r_257_5_48,r_211_315_78,r_211_315_78,0.88,99,177,78,34
65,r_31_339_170,seq165,seq303,r_31_339_170,1.0,2,172,170,34
113,r_320_85_66,r_221_78_22,r_15_172_10,r_15_172_10,0.55,0,10,10,34
66,r_77_114_111,r_335_351_110,seq152,r_77_114_111,0.99,9,120,111,34
31,r_301_263_92,seq324,seq345,r_301_263_92,1.0,1,93,92,34
1,r_179_196_174,r_47_298_104,r_275_53_112,r_179_196_174,0.91,-64,110,174,34
25,r_211_315_78,seq186,seq317,r_211_315_78,1.0,1,79,78,34
159,seq105,r_265_340_62,r_353_364_145,r_353_364_145,1.0,6,151,145,34
112,r_239_305_113,seq223,r_51_139_106,r_239_305_113,0.95,2,115,113,34
80,r_58_8_151,r_135_0_115,r_159_129_12,r_135_0_115,0.99,0,115,115,34
81,r_360_261_63,seq220,r_159_129_12,r_360_261_63,0.65,2,65,63,34
28,r_74_106_156,seq98,seq66,r_74_106_156,1.0,0,156,156,34
96,r_369_347_24,r_74_106_156,seq79,r_369_347_24,0.95,2,26,24,34
119,r_208_342_12,r_151_63_37,seq148,r_208_342_12,1.0,-1,11,12,34
106,r_96_83_162,r_31_339_170,r_51_139_106,r_31_339_170,0.58,-4,166,170,34
115,r_288_370_161,seq303,r_145_330_160,r_288_370_161,1.0,0,161,161,34
63,r_285_358_14,r_25_161_175,seq100,r_285_358_14,0.98,0,14,14,34
91,r_274_103_153,seq214,r_268_205_137,r_268_205_137,0.93,18,155,137,34
230,seq317,seq136,r_211_315_78,r_211_315_78,1.0,9,87,78,34
0,r_168_28_182,seq104,r_179_196_174,r_168_28_182,0.88,0,182,182,34
56,r_304_302_176,seq246,r_354_57_46,r_304_302_176,0.8,4,180,176,34
8,r_65_170_57,seq62,seq54,r_65_170_57,0.98,6,63,57,34
49,r_36_33_39,seq59,r_221_78_22,r_36_33_39,0.85,11,50,39,34
40,r_272_154_70,r_25_161_175,seq54,r_272_154_70,1.0,0,70,70,34
190,seq203,r_248_76_158,seq104,r_248_76_158,0.99,4,162,158,34
165,seq136,seq314,r_211_315_78,r_211_315_78,1.0,12,90,78,34
69,r_41_311_79,r_25_161_175,seq220,r_41_311_79,1.0,0,79,79,34
42,r_135_0_115,r_58_8_151,r_334_199_41,r_135_0_115,1.0,0,115,115,34
20,r_51_139_106,r_168_28_182,seq18,r_51_139_106,0.86,0,106,106,34
121,r_230_187_69,r_189_177_141,seq319,r_230_187_69,1.0,1,70,69,34
76,r_173_195_154,seq40,seq55,r_173_195_154,1.0,0,154,154,34
124,r_357_249_92,seq119,seq150,r_357_249_92,1.0,1,93,92,34
18,r_185_309_23,r_157_2_152,r_353_364_145,r_185_309_23,0.85,2,25,23,34
97,r_35_80_150,seq99,r_265_340_62,r_35_80_150,0.53,-2,148,150,34
107,r_188_130_162,seq67,r_133_138_6,r_188_130_162,0.95,1,163,162,34
41,r_221_78_22,r_135_0_115,seq223,r_135_0_115,0.56,-86,29,115,34
3,r_110_361_128,r_335_351_110,r_216_259_77,r_110_361_128,0.96,1,129,128,34
109,r_34_253_86,r_274_103_153,r_208_342_12,r_34_253_86,1.0,0,86,86,34
58,r_143_338_8,r_197_367_166,r_126_167_78,r_126_167_78,0.5,61,139,78,34
82,r_115_50_17,r_357_249_92,seq84,r_115_50_17,0.55,0,17,17,34
100,r_268_205_137,seq344,seq39,r_268_205_137,0.61,4,141,137,34
32,r_233_125_9,r_310_4_192,r_322_64_18,r_322_64_18,0.84,3,21,18,34
19,r_151_63_37,seq175,seq120,r_151_63_37,0.91,10,47,37,34
117,r_316_294_117,seq27,r_346_194_37,r_316_294_117,1.0,0,117,117,34
93,r_291_12_134,seq218,seq281,r_291_12_134,0.76,13,147,134,34
113,r_320_85_66,r_15_172_10,seq286,r_320_85_66,0.83,1,67,66,34
60,r_94_326_28,seq136,seq148,r_94_326_28,0.84,4,32,28,34
54,r_374_201_78,seq79,r_334_199_41,r_374_201_78,0.82,1,79,78,34
72,r_234_235_69,seq286,r_15_172_10,r_234_235_69,0.77,6,75,69,34
17,r_334_199_41,r_241_108_93,seq17,r_334_199_41,1.0,1,42,41,34
38,r_252_56_129,r_266_11_143,r_228_193_72,r_266_11_143,1.0,-14,129,143,34
39,r_366_225_69,r_262_181_149,seq282,r_366_225_69,0.98,6,75,69,34
43,r_32_227_171,seq100,r_74_106_156,r_74_106_156,0.75,15,171,156,34
15,r_275_53_112,r_179_196_174,r_274_103_153,r_179_196_174,0.74,0,174,174,34
71,r_101_306_131,seq223,r_280_122_44,r_101_306_131,0.96,1,132,131,34
68,r_271_198_144,seq140,seq286,r_271_198_144,1.0,0,144,144,35
111,r_278_301_96,seq288,seq131,r_278_301_96,1.0,0,96,96,35
86,r_30_94_118,r_77_68_134,r_181_74_13,r_181_74_13,0.71,105,118,13,35
10,r_225_266_40,r_2_262_180,seq40,r_225_266_40,1.0,0,40,40,35
93,r_287_336_171,r_326_175_58,r_367_366_92,r_287_336_171,0.96,0,171,171,35
44,r_163_209_145,seq20,seq188,r_163_209_145,0.79,5,150,145,35
89,r_342_152_147,seq27,seq44,r_342_152_147,0.99,1,148,147,35
103,r_370_258_64,seq126,r_280_215_39,r_370_258_64,1.0,0,64,64,35
118,r_33_138_114,seq35,r_309_204_15,r_33_138_114,1.0,1,115,114,35
176,seq140,r_271_198_144,r_193_120_18,r_271_198_144,1.0,0,144,144,35
217,seq281,r_235_115_69,r_192_265_35,r_235_115_69,1.0,0,69,69,35
92,r_276_87_157,r_15_223_89,r_146_219_89,r_276_87_157,1.0,-68,89,157,35
77,r_251_255_39,r_335_229_116,r_169_132_63,r_335_229_116,0.75,0,116,116,35
90,r_242_154_90,r_15_223_89,seq20,r_242_154_90,1.0,0,90,90,35
144,seq53,r_167_118_183,r_51_253_29,r_167_118_183,1.0,1,184,183,35
57,r_2_262_180,seq75,r_232_325_24,r_2_262_180,0.99,0,180,180,35
110,r_341_347_115,seq143,r_202_226_9,r_341_347_115,1.0,1,116,115,35
161,seq106,r_205_90_186,r_333_45_20,r_333_45_20,0.86,0,20,20,35
26,r_326_175_58,r_287_336_171,r_58_172_112,r_287_336_171,0.76,0,171,171,35
47,r_92_97_67,r_216_158_181,seq281,r_92_97_67,1.0,0,67,67,35
50,r_128_269_58,r_335_229_116,r_230_295_4,r_128_269_58,1.0,0,58,58,35
97,r_303_259_81,seq180,r_257_23_22,r_303_259_81,1.0,0,81,81,35
54,r_95_107_63,r_312_364_87,r_181_74_13,r_95_107_63,0.99,0,63,63,35
79,r_169_132_63,r_16_291_174,r_251_255_39,r_169_132_63,1.0,0,63,63,35
0,r_335_229_116,r_46_168_33,r_251_255_39,r_251_255_39,0.98,10,49,39,35
114,r_77_68_134,seq320,seq316,r_77_68_134,1.0,0,134,134,35
122,r_220_187_182,r_280_215_39,r_129_84_50,r_220_187_182,1.0,0,182,182,35
94,r_343_207_195,r_216_158_181,r_313_22_72,r_343_207_195,0.63,-28,167,195,35
63,r_374_171_194,r_6_25_117,r_37_314_52,r_374_171_194,0.96,-101,93,194,35
85,r_17_67_156,r_280_215_39,r_37_314_52,r_17_67_156,1.0,0,156,156,35
121,r_10_282_110,r_2_262_180,r_349_164_76,r_10_282_110,1.0,0,110,110,35
27,r_217_119_136,r_292_246_137,seq36,r_217_119_136,1.0,0,136,136,35
185,seq162,r_163_209_145,r_328_130_112,r_328_130_112,1.0,9,121,112,35
20,r_111_368_150,seq200,r_16_291_174,r_111_368_150,1.0,0,150,150,35
37,r_51_253_29,r_299_110_115,seq53,r_51_253_29,0.99,0,29,29,35
67,r_58_172_112,seq61,r_326_175_58,r_58_172_112,1.0,0,112,112,35
41,r_367_366_92,seq224,r_261_81_79,r_367_366_92,1.0,0,92,92,35
28,r_205_90_186,r_274_275_37,r_46_168_33,r_205_90_186,1.0,-1,185,186,35
105,r_65_289_188,seq26,r_235_115_69,r_65_289_188,0.91,0,188,188,35
124,r_177_182_168,seq185,r_230_295_4,r_177_182_168,1.0,0,168,168,35
42,r_6_25_117,r_374_171_194,r_309_204_15,r_6_25_117,0.99,5,122,117,35
70,r_349_164_76,r_264_199_113,r_144_310_62,r_349_164_76,0.81,0,76,76,35
31,r_252_85_28,r_38_227_39,seq365,r_252_85_28,0.99,0,28,28,35
91,r_43_91_188,seq53,r_267_136_95,r_43_91_188,0.92,0,188,188,35
46,r_3_318_81,r_290_50_194,r_300_304_47,r_3_318_81,1.0,0,81,81,35
7,r_83_103_63,seq346,r_37_314_52,r_83_103_63,0.97,0,63,63,35
13,r_235_115_69,seq281,seq320,r_235_115_69,1.0,0,69,69,35
6,r_86_100_145,seq184,seq238,r_86_100_145,0.98,0,145,145,35
173,seq131,seq183,r_278_301_96,r_278_301_96,1.0,7,103,96,35
23,r_124_166_91,r_86_100_145,r_280_215_39,r_124_166_91,1.0,0,91,91,35
101,r_231_156_85,r_335_229_116,seq29,r_231_156_85,0.98,0,85,85,35
84,r_39_279_145,seq302,seq27,r_39_279_145,1.0,1,146,145,35
157,seq89,r_109_321_177,r_80_147_74,r_109_321_177,1.0,0,177,177,35
108,r_317_96_53,r_86_100_145,r_333_45_20,r_317_96_53,0.99,0,53,53,35
116,r_55_0_38,r_351_344_35,r_93_361_125,r_93_361_125,0.95,21,146,125,35
33,r_239_173_54,seq286,r_280_215_39,r_239_173_54,1.0,0,54,54,35
35,r_211_60_186,seq354,r_274_275_37,r_211_60_186,0.87,0,186,186,35
29,r_146_219_89,r_276_87_157,r_342_152_147,r_146_219_89,0.78,68,157,89,35
48,r_193_120_18,r_232_325_24,seq224,r_193_120_18,0.98,0,18,18,35
71,r_261_81_79,r_111_368_150,seq189,r_261_81_79,1.0,0,79,79,35
45,r_142_148_64,seq320,seq186,r_142_148_64,1.0,1,65,64,35
16,r_109_321_177,seq89,r_102_254_8,r_109_321_177,0.99,0,177,177,35
82,r_137_9_35,seq155,seq49,r_137_9_35,1.0,0,35,35,35
93,r_287_336_171,r_299_110_115,r_326_175_58,r_287_336_171,0.98,-104,67,171,35
117,r_299_110_115,r_230_295_4,r_284_116_68,r_299_110_115,0.74,0,115,115,35
76,r_300_304_47,r_367_366_92,seq82,r_367_366_92,0.96,-42,50,92,35
60,r_328_130_112,seq285,seq162,r_328_130_112,1.0,0,112,112,35
38,r_323_165_30,r_242_154_90,seq228,r_323_165_30,1.0,0,30,30,35
98,r_284_116_68,r_2_262_180,seq40,r_284_116_68,0.98,0,68,68,35
96,r_333_45_20,r_251_255_39,seq106,r_251_255_39,0.75,-19,20,39,35
133,seq29,seq13,r_231_156_85,r_231_156_85,1.0,2,87,85,35
87,r_167_118_183,seq53,r_24_293_21,r_167_118_183,1.0,1,184,183,35
8,r_70_14_154,r_280_215_39,seq35,r_70_14_154,1.0,0,154,154,35
39,r_201_331_126,seq179,seq26,r_201_331_126,0.97,1,127,126,35
92,r_276_87_157,r_146_219_89,r_280_215_39,r_276_87_157,1.0,-1,156,157,35
22,r_267_136_95,seq311,seq41,r_267_136_95,1.0,2,97,95,35
80,r_351_344_35,r_3_318_81,r_24_293_21,r_351_344_35,1.0,1,36,35,35
34,r_218_332_86,seq176,r_370_258_64,r_218_332_86,1.0,0,86,86,35
113,r_144_310_62,r_163_209_145,seq21,r_144_310_62,1.0,0,62,62,35
36,r_129_84_50,seq237,r_77_68_134,r_129_84_50,1.0,0,50,50,35
12,r_274_275_37,seq122,r_333_45_20,r_274_275_37,1.0,0,37,37,35
100,r_15_223_89,r_242_154_90,seq281,r_15_223_89,1.0,1,90,89,35
81,r_216_158_181,r_343_207_195,seq78,r_216_158_181,0.94,2,183,181,35
28,r_205_90_186,seq106,r_274_275_37,r_274_275_37,1.0,8,45,37,35
115,r_308_134_139,seq157,r_249_42_99,r_308_134_139,1.0,0,139,139,35
40,r_181_74_13,r_274_275_37,r_280_215_39,r_181_74_13,0.98,1,14,13,35
55,r_93_361_125,r_280_215_39,r_55_0_38,r_93_361_125,1.0,0,125,125,35
4,r_192_265_35,seq28,seq151,r_192_265_35,0.88,1,36,35,35
29,r_146_219_89,r_359_214_186,r_276_87_157,r_146_219_89,1.0,0,89,89,35
104,r_369_98_12,r_274_275_37,r_52_1_1,r_369_98_12,0.9,0,12,12,35
65,r_24_293_21,r_76_273_173,seq228,r_24_293_21,1.0,0,21,21,35
74,r_313_22_72,seq170,r_343_207_195,r_313_22_72,1.0,0,72,72,35
106,r_362_315_49,seq61,seq250,r_362_315_49,1.0,0,49,49,35
77,r_251_255_39,seq228,r_335_229_116,r_251_255_39,1.0,0,39,39,35
117,r_299_110_115,r_249_42_99,r_230_295_4,r_249_42_99,0.98,0,99,99,35
119,r_141_69_23,r_59_160_180,seq200,r_141_69_23,1.0,0,23,23,35
25,r_244_149_182,seq57,r_251_255_39,r_244_149_182,0.91,0,182,182,35
43,r_37_314_52,r_211_60_186,r_263_8_54,r_37_314_52,0.69,4,56,52,35
229,seq316,r_109_321_177,r_77_68_134,r_77_68_134,0.59,4,138,134,35
52,r_56_104_183,seq40,r_46_168_33,r_56_104_183,0.98,0,183,183,35
73,r_257_23_22,r_192_265_35,r_333_45_20,r_257_23_22,0.96,1,23,22,35
24,r_19_221_88,r_76_273_173,r_137_9_35,r_19_221_88,1.0,0,88,88,35
61,r_80_147_74,r_278_301_96,seq346,r_278_301_96,1.0,-19,77,96,35
21,r_46_168_33,r_335_229_116,seq75,r_335_229_116,1.0,-67,49,116,35
75,r_298_5_117,r_163_209_145,seq61,r_298_5_117,0.81,0,117,117,35
51,r_4_339_152,seq48,seq365,r_4_339_152,1.0,0,152,152,35
3,r_356_212_19,r_129_84_50,seq34,r_356_212_19,0.97,0,19,19,35
56,r_263_8_54,r_3_318_81,r_37_314_52,r_263_8_54,0.62,1,55,54,35
2,r_203_247_181,seq357,seq28,r_203_247_181,1.0,0,181,181,35
116,r_55_0_38,r_362_315_49,r_351_344_35,r_351_344_35,0.85,3,38,35,35
36,r_129_84_50,r_77_68_134,r_235_115_69,r_77_68_134,1.0,0,134,134,35
107,r_153_243_55,r_86_100_145,seq53,r_153_243_55,0.99,0,55,55,35
145,seq57,r_244_149_182,r_230_295_4,r_244_149_182,1.0,0,182,182,35
5,r_232_325_24,r_326_175_58,r_373_222_2,r_232_325_24,1.0,0,24,24,35
220,seq286,r_239_173_54,seq329,r_239_173_54,1.0,0,54,54,35
30,r_372_245_184,r_280_215_39,r_367_366_92,r_372_245_184,0.95,0,184,184,35
0,r_335_229_116,r_251_255_39,r_137_9_35,r_335_229_116,1.0,0,116,116,35
26,r_326_175_58,r_342_152_147,r_287_336_171,r_326_175_58,1.0,0,58,58,35
1,r_264_199_113,r_280_215_39,r_3_318_81,r_264_199_113,1.0,0,113,113,35
248,seq365,r_167_118_183,r_252_85_28,r_252_85_28,0.86,43,71,28,35
11,r_292_246_137,seq329,seq126,r_292_246_137,1.0,0,137,137,35
66,r_38_227_39,seq224,r_54_327_80,r_38_227_39,1.0,0,39,39,35
233,seq329,r_292_246_137,seq305,r_292_246_137,1.0,0,137,137,35
61,r_223_302_123,r_100_359_2,r_320_260_86,r_223_302_123,1.0,0,123,123,36
238,seq339,seq318,r_312_227_123,r_312_227_123,0.86,7,130,123,36
144,seq42,r_304_317_188,r_265_60_182,r_304_317_188,1.0,0,188,188,36
70,r_83_49_115,seq271,r_346_112_104,r_83_49_115,1.0,3,118,115,36
67,r_337_209_10,r_156_245_158,seq286,r_337_209_10,0.96,0,10,10,36
36,r_5_24_60,r_152_240_141,r_308_157_11,r_5_24_60,1.0,0,60,60,36
35,r_6_118_97,seq172,r_102_231_29,r_6_118_97,0.78,3,100,97,36
5,r_248_133_56,seq250,seq82,r_248_133_56,1.0,0,56,56,36
92,r_26_65_167,r_156_245_158,seq220,r_26_65_167,1.0,0,167,167,36
99,r_191_291_148,seq293,r_262_353_36,r_191_291_148,1.0,4,152,148,36
16,r_105_372_42,r_5_24_60,seq41,r_105_372_42,1.0,1,43,42,36
104,r_113_213_145,seq206,seq360,r_113_213_145,1.0,-1,144,145,36
48,r_165_123_180,seq261,r_277_370_75,r_165_123_180,1.0,0,180,180,36
105,r_150_314_22,r_336_121_122,r_374_34_158,r_150_314_22,0.55,60,82,22,36
37,r_300_255_42,seq70,seq328,r_300_255_42,1.0,1,43,42,36
2,r_1_111_66,r_39_364_65,r_84_249_14,r_1_111_66,1.0,1,67,66,36
115,r_74_305_110,seq61,r_211_117_70,r_74_305_110,1.0,0,110,110,36
95,r_315_66_125,r_195_202_106,r_152_240_141,r_195_202_106,0.91,-1,105,106,36
79,r_312_227_123,r_165_123_180,seq339,r_312_227_123,1.0,1,124,123,36
23,r_168_296_14,r_62_307_144,r_347_355_136,r_168_296_14,0.99,131,145,14,36
8,r_246_146_144,r_46_331_184,r_239_259_26,r_246_146_144,1.0,-2,142,144,36
120,r_303_263_149,seq280,seq29,r_303_263_149,0.62,8,157,149,36
116,r_46_331_184,seq11,r_43_176_130,r_46_331_184,1.0,4,188,184,36
41,r_338_139_124,r_365_114_171,r_1_111_66,r_338_139_124,1.0,0,124,124,36
3,r_341_107_116,seq301,r_289_124_111,r_341_107_116,1.0,0,116,116,36
84,r_295_162_26,r_6_118_97,seq310,r_295_162_26,1.0,2,28,26,36
112,r_232_292_133,seq199,seq177,r_232_292_133,1.0,-1,132,133,36
57,r_262_353_36,r_78_77_45,r_277_370_75,r_277_370_75,0.95,2,77,75,36
14,r_16_13_107,r_238_25_153,seq210,r_16_13_107,0.78,1,108,107,36
102,r_175_134_64,r_268_153_192,r_53_254_74,r_53_254_74,1.0,4,78,74,36
46,r_182_122_27,r_329_12_102,seq32,r_182_122_27,0.94,2,29,27,36
25,r_247_76_46,seq286,seq108,r_247_76_46,0.99,1,47,46,36
4,r_304_317_188,seq42,r_160_148_57,r_304_317_188,0.85,0,188,188,36
11,r_181_128_65,seq339,seq0,r_181_128_65,0.99,1,66,65,36
30,r_266_23_110,seq177,r_62_307_144,r_62_307_144,0.99,2,146,144,36
58,r_354_17_153,r_62_307_144,r_174_89_170,r_354_17_153,1.0,-5,148,153,36
72,r_81_55_107,r_321_350_3,r_193_125_5,r_81_55_107,1.0,0,107,107,36
90,r_3_130_82,r_341_107_116,seq19,r_3_130_82,1.0,2,84,82,36
123,r_132_86_44,seq293,seq318,r_132_86_44,0.98,0,44,44,36
45,r_163_96_129,seq104,r_56_196_39,r_163_96_129,0.99,1,130,129,36
105,r_150_314_22,r_374_34_158,r_262_353_36,r_374_34_158,0.67,-43,115,158,36
107,r_346_112_104,r_265_60_182,r_221_106_70,r_265_60_182,0.85,-76,106,182,36
38,r_40_325_103,seq119,r_78_77_45,r_40_325_103,1.0,0,103,103,36
68,r_62_307_144,r_168_296_14,r_266_23_110,r_168_296_14,0.72,131,145,14,36
56,r_53_254_74,r_81_55_107,r_175_134_64,r_53_254_74,1.0,1,75,74,36
55,r_195_202_106,r_315_66_125,r_200_171_87,r_195_202_106,1.0,0,106,106,36
54,r_319_141_141,seq177,r_174_89_170,r_319_141_141,1.0,0,141,141,36
121,r_374_34_158,seq192,r_182_122_27,r_374_34_158,1.0,4,162,158,36
68,r_62_307_144,r_354_17_153,r_168_296_14,r_168_296_14,0.86,-4,10,14,36
224,seq309,r_68_99_64,seq51,r_68_99_64,1.0,0,64,64,36
40,r_345_85_82,seq363,seq250,r_345_85_82,1.0,0,82,82,36
53,r_98_71_134,r_365_114_171,r_236_151_31,r_98_71_134,0.86,7,141,134,36
7,r_156_245_158,r_26_65_167,r_9_15_86,r_156_245_158,0.93,-4,154,158,36
20,r_347_355_136,seq335,r_311_362_74,r_347_355_136,1.0,2,138,136,36
100,r_14_140_114,r_238_25_153,r_56_196_39,r_14_140_114,1.0,0,114,114,36
119,r_200_171_87,r_75_28_189,r_93_47_69,r_75_28_189,1.0,-1,188,189,36
108,r_87_183_146,seq228,r_276_194_64,r_87_183_146,0.88,4,150,146,36
15,r_242_72_99,r_165_123_180,r_320_260_86,r_242_72_99,1.0,1,100,99,36
26,r_221_106_70,r_272_344_124,seq208,r_221_106_70,1.0,0,70,70,36
76,r_75_28_189,seq104,r_195_202_106,r_195_202_106,1.0,2,108,106,36
87,r_43_176_130,r_365_114_171,seq51,r_43_176_130,1.0,0,130,130,36
39,r_217_361_135,r_274_269_170,r_342_30_126,r_217_361_135,0.58,1,136,135,36
95,r_315_66_125,r_152_240_141,seq11,r_315_66_125,0.71,1,126,125,36
124,r_167_155_113,seq360,r_235_281_62,r_167_155_113,1.0,1,114,113,36
49,r_69_237_13,r_341_107_116,seq0,r_341_107_116,0.72,-104,12,116,36
82,r_274_269_170,seq208,r_105_372_42,r_274_269_170,0.98,0,170,170,36
202,seq250,seq310,r_345_85_82,r_345_85_82,0.98,11,93,82,36
12,r_63_73_24,r_156_245_158,seq119,r_63_73_24,1.0,4,28,24,36
34,r_342_30_126,seq19,r_289_124_111,r_342_30_126,1.0,0,126,126,36
119,r_200_171_87,r_74_305_110,r_75_28_189,r_200_171_87,0.9,0,87,87,36
86,r_84_249_14,r_94_45_134,seq169,r_84_249_14,0.83,-1,13,14,36
32,r_93_47_69,seq36,seq104,r_93_47_69,0.99,0,69,69,36
43,r_308_157_11,r_256_241_124,seq91,r_308_157_11,0.58,0,11,11,36
23,r_168_296_14,r_347_355_136,r_352_88_167,r_352_88_167,0.87,2,169,167,36
117,r_272_344_124,r_320_260_86,seq116,r_272_344_124,0.99,0,124,124,36
110,r_97_137_100,r_268_153_192,r_289_124_111,r_289_124_111,1.0,-1,110,111,36
66,r_79_219_181,seq35,r_93_47_69,r_79_219_181,0.93,1,182,181,36
62,r_152_240_141,seq115,r_1_111_66,r_152_240_141,1.0,0,141,141,36
17,r_143_230_50,seq192,r_63_73_24,r_143_230_50,0.83,5,55,50,36
180,seq184,r_156_245_158,seq275,r_156_245_158,0.82,14,172,158,36
93,r_173_64_93,r_347_355_136,r_9_15_86,r_173_64_93,1.0,1,94,93,36
44,r_56_196_39,seq32,r_158_38_40,r_56_196_39,0.97,2,41,39,36
63,r_158_38_40,seq92,r_56_196_39,r_158_38_40,0.98,0,40,40,36
9,r_160_148_57,r_374_34_158,r_56_196_39,r_160_148_57,0.99,0,57,57,36
6,r_215_58_43,seq116,seq332,r_215_58_43,1.0,0,43,43,36
98,r_239_259_26,r_132_86_44,seq42,r_239_259_26,0.97,1,27,26,36
42,r_278_205_105,seq184,seq35,r_278_205_105,1.0,1,106,105,36
91,r_164_48_159,seq233,r_94_45_134,r_164_48_159,1.0,0,159,159,36
24,r_211_117_70,seq50,seq284,r_211_117_70,1.0,0,70,70,36
71,r_253_222_131,r_352_88_167,seq286,r_253_222_131,1.0,0,131,131,36
23,r_168_296_14,r_215_58_43,r_62_307_144,r_168_296_14,0.79,-4,10,14,36
146,seq50,r_211_117_70,r_102_231_29,r_211_117_70,1.0,0,70,70,36
22,r_276_194_64,r_93_47_69,r_290_135_63,r_93_47_69,1.0,-5,64,69,36
52,r_110_138_184,seq360,r_93_47_69,r_110_138_184,0.97,0,184,184,36
13,r_94_45_134,r_165_123_180,seq358,r_94_45_134,1.0,0,134,134,36
118,r_320_260_86,r_272_344_124,seq228,r_272_344_124,0.97,0,124,124,36
57,r_262_353_36,r_338_139_124,r_78_77_45,r_262_353_36,0.99,0,36,36,36
107,r_346_112_104,r_221_106_70,r_83_49_115,r_83_49_115,0.9,10,125,115,36
64,r_329_12_102,seq18,seq42,r_329_12_102,1.0,0,102,102,36
88,r_289_124_111,r_136_129_199,r_97_137_100,r_289_124_111,1.0,1,112,111,36
50,r_313_201_131,seq188,r_312_227_123,r_313_201_131,1.0,0,131,131,36
103,r_147_198_118,seq258,r_3_130_82,r_147_198_118,1.0,0,118,118,36
109,r_235_281_62,r_304_317_188,seq115,r_235_281_62,1.0,0,62,62,36
76,r_75_28_189,r_195_202_106,r_248_133_56,r_75_28_189,0.7,-1,188,189,36
19,r_149_207_76,r_232_292_133,r_235_281_62,r_149_207_76,0.99,0,76,76,36
59,r_101_244_83,seq285,seq61,r_101_244_83,1.0,2,85,83,36
238,seq339,r_181_128_65,seq318,r_181_128_65,0.94,1,66,65,36
89,r_336_121_122,seq103,seq261,r_336_121_122,1.0,-1,121,122,36
28,r_21_52_22,r_94_45_134,seq108,r_21_52_22,0.91,1,23,22,36
33,r_90_120_21,r_190_373_163,seq188,r_90_120_21,0.86,2,23,21,36
106,r_39_364_65,r_1_111_66,seq70,r_39_364_65,1.0,2,67,65,36
27,r_9_15_86,seq108,r_53_254_74,r_9_15_86,1.0,1,87,86,36
83,r_68_99_64,seq309,seq243,r_68_99_64,1.0,0,64,64,36
80,r_349_322_147,seq335,r_264_279_12,r_349_322_147,1.0,2,149,147,36
74,r_365_114_171,seq35,r_242_72_99,r_365_114_171,1.0,0,171,171,36
10,r_277_370_75,r_371_131_83,r_262_353_36,r_262_353_36,0.95,44,80,36,36
97,r_321_350_3,r_81_55_107,seq214,r_81_55_107,1.0,0,107,107,36
73,r_256_241_124,seq177,r_308_157_11,r_256_241_124,1.0,0,124,124,36
105,r_150_314_22,seq22,r_336_121_122,r_150_314_22,0.97,0,22,22,36
94,r_311_362_74,r_152_240_141,r_276_194_64,r_152_240_141,0.96,-67,74,141,36
75,r_270_185_106,seq187,r_247_76_46,r_270_185_106,1.0,2,108,106,36
85,r_236_151_31,r_329_12_102,seq126,r_236_151_31,0.58,1,32,31,36
30,r_266_23_110,r_268_153_192,seq177,r_266_23_110,0.99,0,110,110,36
114,r_352_88_167,seq108,r_168_296_14,r_352_88_167,1.0,1,168,167,36
65,r_224_212_56,r_242_72_99,r_100_359_2,r_224_212_56,1.0,1,57,56,36
216,seq286,r_247_76_46,r_337_209_10,r_247_76_46,0.91,3,49,46,36
67,r_59_44_116,r_185_96_165,seq127,r_59_44_116,1.0,0,116,116,37
37,r_47_283_105,r_222_184_119,r_20_36_199,r_47_283_105,1.0,0,105,105,37
6,r_117_359_61,seq101,seq329,r_117_359_61,0.73,-15,46,61,37
2,r_334_333_27,r_43_189_138,seq153,r_334_333_27,0.87,0,27,27,37
26,r_91_346_66,r_25_232_100,seq97,r_91_346_66,1.0,0,66,66,37
11,r_367_370_29,r_192_163_143,r_136_286_107,r_367_370_29,0.68,0,29,29,37
116,r_98_57_173,r_111_2_144,r_225_195_118,r_111_2_144,1.0,0,144,144,37
33,r_364_172_165,seq63,r_39_78_20,r_364_172_165,1.0,1,166,165,37
3,r_43_189_138,r_300_167_152,r_217_180_29,r_43_189_138,1.0,-1,137,138,37
237,seq341,r_223_308_77,seq45,r_223_308_77,1.0,-21,56,77,37
40,r_366_219_50,seq289,r_270_92_97,r_366_219_50,0.7,53,103,50,37
103,r_135_171_69,seq251,r_340_48_162,r_135_171_69,0.88,0,69,69,37
127,seq4,r_365_224_126,r_149_75_115,r_149_75_115,0.98,1,116,115,37
16,r_102_290_150,r_257_183_175,seq79,r_102_290_150,0.86,0,150,150,37
49,r_25_232_100,r_310_326_103,r_188_330_90,r_188_330_90,1.0,10,100,90,37
4,r_268_86_68,r_310_326_103,seq100,r_310_326_103,0.68,-35,68,103,37
41,r_30_90_145,seq150,r_361_291_27,r_30_90_145,0.74,10,155,145,37
73,r_95_354_127,seq110,r_323_84_103,r_95_354_127,1.0,0,127,127,37
25,r_18_106_181,seq251,r_261_66_14,r_18_106_181,0.73,5,186,181,37
56,r_179_255_174,seq239,r_193_121_12,r_179_255_174,0.94,1,175,174,37
90,r_298_104_126,seq153,r_268_86_68,r_298_104_126,1.0,0,126,126,37
103,r_135_171_69,r_340_48_162,r_225_195_118,r_340_48_162,1.0,-18,144,162,37
91,r_327_299_38,r_268_86_68,r_284_266_130,r_327_299_38,1.0,-4,34,38,37
87,r_340_48_162,r_135_171_69,r_261_66_14,r_340_48_162,1.0,0,162,162,37
22,r_284_266_130,r_162_11_154,r_327_299_38,r_327_299_38,0.79,20,58,38,37
93,r_278_316_132,r_256_231_143,r_117_359_61,r_117_359_61,1.0,71,132,61,37
23,r_208_81_174,seq281,r_300_167_152,r_208_81_174,1.0,0,174,174,37
200,seq207,r_9_262_177,r_117_359_61,r_9_262_177,0.82,0,177,177,37
55,r_254_210_114,seq37,seq176,r_254_210_114,1.0,0,114,114,37
112,r_279_23_34,r_136_286_107,seq74,r_279_23_34,1.0,0,34,34,37
57,r_223_308_77,r_142_227_186,r_271_293_1,r_223_308_77,1.0,0,77,77,37
70,r_140_144_129,r_238_304_166,seq58,r_238_304_166,0.65,-35,131,166,37
122,r_273_152_48,r_9_262_177,seq295,r_273_152_48,0.99,-1,47,48,37
102,r_55_338_12,r_268_86_68,seq94,r_55_338_12,1.0,0,12,12,37
60,r_126_315_30,r_311_187_158,seq7,r_126_315_30,0.95,1,31,30,37
35,r_52_113_89,seq0,r_351_32_178,r_52_113_89,1.0,0,89,89,37
46,r_285_72_141,seq21,r_322_250_66,r_285_72_141,1.0,0,141,141,37
113,r_335_116_129,seq7,seq368,r_335_116_129,1.0,0,129,129,37
98,r_355_339_112,seq68,r_322_250_66,r_355_339_112,1.0,0,112,112,37
52,r_225_195_118,r_20_36_199,r_135_171_69,r_135_171_69,1.0,49,118,69,37
91,r_327_299_38,r_162_11_154,r_16_69_1,r_162_11_154,0.67,9,163,154,37
77,r_175_14_38,r_320_358_161,seq17,r_175_14_38,0.91,0,38,38,37
121,r_365_224_126,seq64,r_273_152_48,r_365_224_126,0.75,0,126,126,37
22,r_284_266_130,r_327_299_38,r_234_237_39,r_284_266_130,1.0,0,130,130,37
14,r_67_88_26,seq204,seq138,r_67_88_26,1.0,0,26,26,37
11,r_367_370_29,r_136_286_107,r_350_134_56,r_367_370_29,0.97,42,71,29,37
101,r_249_345_63,seq289,seq28,r_249_345_63,0.77,-1,62,63,37
28,r_270_92_97,seq101,r_366_219_50,r_270_92_97,0.91,1,98,97,37
95,r_162_11_154,r_107_143_73,r_327_299_38,r_107_143_73,0.99,-1,72,73,37
45,r_263_220_15,r_43_189_138,seq289,r_263_220_15,1.0,1,16,15,37
117,r_93_173_122,seq306,r_334_333_27,r_93_173_122,1.0,0,122,122,37
118,r_337_65_117,r_347_154_174,seq181,r_337_65_117,1.0,1,118,117,37
82,r_217_180_29,r_114_245_102,seq259,r_217_180_29,1.0,0,29,29,37
105,r_149_75_115,seq27,seq4,r_149_75_115,1.0,0,115,115,37
54,r_185_96_165,seq19,r_254_210_114,r_254_210_114,0.53,51,165,114,37
72,r_29_169_74,r_256_231_143,r_146_87_58,r_256_231_143,0.99,-69,74,143,37
119,r_222_184_119,seq176,r_193_121_12,r_222_184_119,1.0,0,119,119,37
13,r_142_227_186,seq341,seq170,r_142_227_186,1.0,1,187,186,37
7,r_107_143_73,r_162_11_154,r_196_203_11,r_107_143_73,1.0,-1,72,73,37
236,seq332,r_192_163_143,r_38_131_67,r_38_131_67,1.0,2,69,67,37
116,r_98_57_173,r_225_195_118,r_43_189_138,r_98_57_173,0.97,0,173,173,37
222,seq281,r_208_81_174,seq118,r_208_81_174,0.9,1,175,174,37
68,r_350_134_56,seq170,r_367_370_29,r_350_134_56,0.96,0,56,56,37
115,r_264_85_19,r_5_325_159,r_137_50_113,r_264_85_19,0.98,0,19,19,37
91,r_327_299_38,r_284_266_130,r_162_11_154,r_284_266_130,1.0,0,130,130,37
160,seq89,r_178_246_143,r_320_358_161,r_178_246_143,0.98,0,143,143,37
44,r_22_360_63,r_77_174_101,seq79,r_22_360_63,0.74,0,63,63,37
124,r_38_131_67,r_285_72_141,seq332,r_38_131_67,0.99,0,67,67,37
106,r_317_258_67,seq70,seq27,r_317_258_67,1.0,1,68,67,37
58,r_178_246_143,seq89,r_22_360_63,r_178_246_143,1.0,0,143,143,37
95,r_162_11_154,r_327_299_38,r_38_131_67,r_162_11_154,1.0,1,155,154,37
18,r_292_182_23,r_77_174_101,seq306,r_292_182_23,1.0,-1,22,23,37
85,r_307_301_124,r_256_231_143,r_279_23_34,r_307_301_124,1.0,1,125,124,37
81,r_5_325_159,seq150,r_140_144_129,r_5_325_159,1.0,0,159,159,37
62,r_331_247_170,seq101,seq118,r_331_247_170,1.0,0,170,170,37
75,r_212_15_28,r_179_255_174,seq306,r_212_15_28,0.94,0,28,28,37
70,r_140_144_129,r_369_319_102,r_238_304_166,r_369_319_102,0.92,-32,70,102,37
29,r_282_303_189,seq156,r_334_333_27,r_282_303_189,0.95,-1,188,189,37
43,r_151_352_4,r_268_86_68,r_191_130_16,r_191_130_16,0.95,-1,15,16,37
31,r_226_186_89,seq348,seq241,r_226_186_89,1.0,0,89,89,37
99,r_347_154_174,r_334_333_27,r_253_235_2,r_347_154_174,0.95,0,174,174,37
176,seq129,r_111_2_144,seq243,r_111_2_144,1.0,-41,103,144,37
71,r_351_32_178,seq101,r_52_113_89,r_52_113_89,1.0,26,115,89,37
99,r_347_154_174,r_337_65_117,r_334_333_27,r_337_65_117,1.0,1,118,117,37
9,r_252_34_41,r_275_42_54,seq332,r_252_34_41,1.0,0,41,41,37
214,seq251,r_135_171_69,r_366_219_50,r_135_171_69,1.0,-7,62,69,37
97,r_373_6_165,r_9_262_177,r_214_199_96,r_214_199_96,0.65,71,167,96,37
63,r_214_199_96,seq281,r_249_345_63,r_214_199_96,1.0,0,96,96,37
12,r_257_183_175,seq45,r_300_167_152,r_257_183_175,1.0,0,175,175,37
114,r_165_155_99,r_120_31_148,seq176,r_165_155_99,1.0,0,99,99,37
78,r_201_148_156,seq82,r_29_169_74,r_201_148_156,1.0,1,157,156,37
19,r_193_121_12,r_294_200_126,r_137_50_113,r_193_121_12,0.73,1,13,12,37
8,r_300_167_152,r_321_209_136,seq243,r_321_209_136,1.0,0,136,136,37
8,r_300_167_152,seq243,r_279_23_34,r_300_167_152,0.97,0,152,152,37
82,r_217_180_29,seq259,r_43_189_138,r_43_189_138,1.0,18,156,138,37
94,r_275_42_54,r_347_154_174,seq230,r_347_154_174,0.7,-128,46,174,37
86,r_196_203_11,r_336_147_59,r_320_358_161,r_320_358_161,0.95,-150,11,161,37
87,r_340_48_162,r_111_2_144,r_135_171_69,r_135_171_69,1.0,1,70,69,37
69,r_323_84_103,seq218,r_317_258_67,r_323_84_103,0.92,-1,102,103,37
92,r_198_277_44,seq28,seq51,r_198_277_44,1.0,0,44,44,37
21,r_114_245_102,seq79,r_328_8_96,r_114_245_102,1.0,0,102,102,37
38,r_311_187_158,seq10,r_256_231_143,r_311_187_158,1.0,0,158,158,37
76,r_191_130_16,r_361_291_27,r_151_352_4,r_151_352_4,0.9,12,16,4,37
111,r_302_119_129,seq37,seq287,r_302_119_129,1.0,0,129,129,37
36,r_136_286_107,r_185_96_165,r_13_139_50,r_136_286_107,1.0,1,108,107,37
15,r_310_326_103,r_151_352_4,seq314,r_310_326_103,1.0,0,103,103,37
108,r_328_8_96,seq118,r_67_88_26,r_328_8_96,1.0,1,97,96,37
50,r_318_202_100,r_136_286_107,seq10,r_318_202_100,1.0,0,100,100,37
89,r_9_262_177,seq207,r_107_143_73,r_9_262_177,0.56,0,177,177,37
110,r_39_78_20,seq269,seq79,r_39_78_20,0.87,-1,19,20,37
51,r_234_237_39,seq309,seq19,r_234_237_39,1.0,0,39,39,37
35,r_52_113_89,r_351_32_178,r_336_147_59,r_351_32_178,0.94,5,183,178,37
64,r_105_26_112,seq63,r_223_308_77,r_105_26_112,1.0,0,112,112,37
5,r_361_291_27,r_208_81_174,seq353,r_361_291_27,1.0,0,27,27,37
107,r_111_2_144,r_98_57_173,seq372,r_111_2_144,1.0,0,144,144,37
0,r_336_147_59,r_16_69_1,seq101,r_336_147_59,1.0,0,59,59,37
84,r_369_319_102,r_140_144_129,seq49,r_369_319_102,1.0,2,104,102,37
65,r_141_280_164,seq166,r_318_202_100,r_141_280_164,0.66,0,164,164,37
17,r_192_163_143,seq353,seq129,r_192_163_143,1.0,0,143,143,37
83,r_146_87_58,r_25_232_100,r_29_169_74,r_25_232_100,0.99,0,100,100,37
74,r_1_159_153,seq313,r_240_248_31,r_1_159_153,1.0,2,155,153,37
48,r_294_200_126,seq158,seq207,r_294_200_126,1.0,0,126,126,37
170,seq122,r_216_71_190,r_337_65_117,r_337_65_117,1.0,14,131,117,37
34,r_238_304_166,r_137_50_113,r_192_163_143,r_238_304_166,1.0,0,166,166,37
30,r_322_250_66,seq74,r_271_293_1,r_322_250_66,0.93,5,71,66,37
83,r_146_87_58,seq127,r_25_232_100,r_146_87_58,0.97,0,58,58,37
125,seq0,r_52_113_89,seq49,r_52_113_89,1.0,-39,50,89,37
100,r_344_213_36,seq259,seq58,r_344_213_36,1.0,-1,35,36,37
1,r_256_231_143,seq51,r_284_266_130,r_256_231_143,1.0,0,143,143,37
53,r_321_209_136,r_300_167_152,r_294_200_126,r_321_209_136,1.0,0,136,136,37
80,r_295_76_119,seq132,seq146,r_295_76_119,1.0,0,119,119,38
4,r_11_278_153,seq72,seq116,r_11_278_153,1.0,-1,152,153,38
103,r_212_25_182,r_287_159_171,r_366_13_84,r_287_159_171,0.74,-34,137,171,38
7,r_6_357_189,seq22,r_33_136_158,r_6_357_189,0.62,0,189,189,38
89,r_3_137_33,r_295_76_119,r_41_165_96,r_3_137_33,0.99,83,116,33,38
70,r_53_368_13,r_109_47_191,r_156_161_97,r_53_368_13,0.61,-1,12,13,38
41,r_365_219_76,r_34_270_159,seq145,r_365_219_76,1.0,0,76,76,38
72,r_168_139_155,seq8,r_119_242_66,r_168_139_155,0.78,0,155,155,38
3,r_315_246_48,seq371,seq354,r_315_246_48,1.0,0,48,48,38
226,seq291,r_100_289_163,r_65_148_43,r_100_289_163,1.0,0,163,163,38
93,r_236_39_86,r_99_133_180,seq19,r_236_39_86,1.0,0,86,86,38
77,r_335_226_110,r_317_93_146,seq318,r_335_226_110,1.0,0,110,110,38
83,r_106_187_113,seq22,seq101,r_106_187_113,1.0,-1,112,113,38
120,r_366_13_84,seq258,r_330_228_109,r_330_228_109,1.0,6,115,109,38
100,r_99_133_180,seq146,r_177_220_107,r_177_220_107,0.65,75,182,107,38
109,r_213_46_75,r_358_189_105,seq2,r_213_46_75,1.0,1,76,75,38
98,r_77_370_190,seq364,r_6_357_189,r_77_370_190,0.99,0,190,190,38
32,r_131_233_63,r_120_313_171,seq267,r_131_233_63,1.0,0,63,63,38
245,seq362,r_323_347_65,r_194_55_28,r_323_347_65,1.0,0,65,65,38
110,r_10_70_74,r_361_344_64,r_209_206_13,r_10_70_74,0.97,0,74,74,38
82,r_38_346_143,seq258,r_285_182_92,r_38_346_143,1.0,-1,142,143,38
30,r_305_71_21,r_51_363_192,seq257,r_305_71_21,0.95,0,21,21,38
66,r_232_210_120,r_108_89_130,r_119_242_66,r_108_89_130,1.0,-1,129,130,38
8,r_109_47_191,seq267,r_366_13_84,r_109_47_191,0.83,-1,190,191,38
139,seq57,r_162_225_162,r_16_251_17,r_16_251_17,0.76,14,31,17,38
12,r_16_251_17,r_268_196_108,seq57,r_16_251_17,1.0,0,17,17,38
19,r_177_220_107,r_85_43_28,seq44,r_177_220_107,1.0,0,107,107,38
29,r_33_136_158,seq74,r_115_222_141,r_33_136_158,1.0,0,158,158,38
84,r_142_312_113,seq274,r_345_66_57,r_142_312_113,0.91,1,114,113,38
1,r_268_196_108,r_184_201_136,r_202_352_20,r_268_196_108,0.92,0,108,108,38
71,r_29_56_76,seq174,r_345_66_57,r_29_56_76,1.0,0,76,76,38
60,r_172_158_92,seq101,seq132,r_172_158_92,1.0,0,92,92,38
105,r_243_262_50,r_184_201_136,r_299_122_16,r_243_262_50,0.93,0,50,50,38
11,r_24_310_182,seq328,r_259_250_10,r_24_310_182,1.0,0,182,182,38
10,r_304_110_80,seq362,seq121,r_304_110_80,0.83,10,90,80,38
0,r_9_337_58,r_29_56_76,seq230,r_9_337_58,1.0,0,58,58,38
16,r_317_93_146,seq2,r_3_137_33,r_317_93_146,1.0,0,146,146,38
86,r_355_130_167,r_156_161_97,r_100_289_163,r_355_130_167,1.0,0,167,167,38
74,r_259_250_10,r_315_246_48,seq146,r_315_246_48,0.88,-38,10,48,38
31,r_195_58_185,seq199,r_87_341_6,r_195_58_185,0.86,0,185,185,38
55,r_17_52_68,seq50,seq253,r_17_52_68,0.99,1,69,68,38
38,r_324_265_86,r_31_0_188,seq203,r_324_265_86,1.0,0,86,86,38
99,r_252_256_147,seq173,r_317_93_146,r_252_256_147,1.0,0,147,147,38
111,r_21_350_185,seq4,r_84_54_69,r_21_350_185,0.85,0,185,185,38
89,r_3_137_33,r_238_151_125,r_295_76_119,r_3_137_33,1.0,0,33,33,38
92,r_81_367_46,r_115_222_141,r_78_329_15,r_81_367_46,1.0,0,46,46,38
122,r_209_206_13,r_237_343_198,r_156_161_97,r_209_206_13,0.99,-1,12,13,38
14,r_207_178_103,seq125,seq264,r_207_178_103,1.0,0,103,103,38
160,seq123,r_356_322_149,seq114,r_356_322_149,0.99,-11,138,149,38
68,r_202_352_20,r_358_189_105,seq4,r_202_352_20,0.77,1,21,20,38
119,r_15_260_56,r_317_93_146,r_119_242_66,r_15_260_56,1.0,0,56,56,38
51,r_287_159_171,r_212_25_182,r_34_270_159,r_287_159_171,1.0,0,171,171,38
50,r_261_59_42,r_169_360_182,seq4,r_261_59_42,1.0,0,42,42,38
88,r_35_23_20,r_184_201_136,seq101,r_35_23_20,0.93,1,21,20,38
64,r_372_113_46,r_171_88_83,seq214,r_372_113_46,1.0,0,46,46,38
19,r_177_220_107,r_24_310_182,r_85_43_28,r_85_43_28,0.5,1,29,28,38
20,r_100_289_163,seq291,r_238_151_125,r_100_289_163,1.0,0,163,163,38
63,r_361_344_64,r_10_70_74,seq79,r_10_70_74,1.0,-1,73,74,38
131,seq22,r_106_187_113,r_6_357_189,r_106_187_113,1.0,0,113,113,38
79,r_30_48_92,r_330_228_109,r_315_246_48,r_330_228_109,0.59,-17,92,109,38
114,r_190_160_108,seq229,r_213_46_75,r_190_160_108,1.0,0,108,108,38
97,r_345_66_57,r_156_161_97,seq180,r_345_66_57,1.0,0,57,57,38
246,seq364,r_77_370_190,r_237_343_198,r_77_370_190,1.0,0,190,190,38
33,r_120_313_171,seq143,r_17_52_68,r_120_313_171,0.99,0,171,171,38
205,seq247,r_98_1_115,seq267,r_98_1_115,1.0,0,115,115,38
22,r_301_40_93,r_252_256_147,seq72,r_301_40_93,1.0,0,93,93,38
58,r_95_306_21,r_361_344_64,r_49_216_153,r_95_306_21,0.99,0,21,21,38
40,r_34_270_159,seq101,r_194_55_28,r_34_270_159,1.0,0,159,159,38
108,r_152_104_140,seq253,r_9_337_58,r_152_104_140,1.0,0,140,140,38
47,r_358_189_105,r_108_89_130,r_315_246_48,r_358_189_105,0.86,0,105,105,38
95,r_7_193_132,seq253,seq32,r_7_193_132,1.0,0,132,132,38
15,r_31_0_188,r_302_349_9,r_317_93_146,r_31_0_188,0.96,0,188,188,38
58,r_95_306_21,r_49_216_153,r_90_80_96,r_95_306_21,0.58,131,152,21,38
103,r_212_25_182,r_366_13_84,r_372_113_46,r_212_25_182,0.94,0,182,182,38
25,r_327_235_154,r_34_270_159,seq124,r_327_235_154,0.64,0,154,154,38
62,r_51_363_192,r_49_216_153,r_95_306_21,r_51_363_192,0.88,-125,67,192,38
42,r_78_329_15,r_286_307_147,seq234,r_78_329_15,0.83,-1,14,15,38
28,r_171_88_83,r_142_312_113,seq153,r_171_88_83,1.0,0,83,83,38
53,r_323_347_65,seq362,seq166,r_323_347_65,1.0,0,65,65,38
101,r_353_241_179,seq297,r_259_250_10,r_353_241_179,0.99,0,179,179,38
124,r_41_165_96,r_316_311_184,r_3_137_33,r_41_165_96,1.0,0,96,96,38
69,r_115_222_141,seq105,r_324_265_86,r_115_222_141,1.0,0,141,141,38
106,r_49_216_153,r_51_363_192,r_194_55_28,r_49_216_153,1.0,-1,152,153,38
17,r_107_320_165,seq19,r_134_332_5,r_107_320_165,0.99,0,165,165,38
118,r_67_334_101,r_238_151_125,seq19,r_67_334_101,0.52,9,110,101,38
76,r_184_201_136,r_273_18_163,r_285_182_92,r_184_201_136,0.8,0,136,136,38
35,r_73_373_156,seq150,seq22,r_73_373_156,1.0,0,156,156,38
172,seq146,r_99_133_180,r_24_310_182,r_24_310_182,0.88,0,182,182,38
46,r_85_43_28,seq116,r_108_89_130,r_108_89_130,0.66,10,140,130,38
45,r_90_80_96,seq91,r_95_306_21,r_90_80_96,1.0,0,96,96,38
65,r_339_298_100,seq57,r_119_242_66,r_339_298_100,1.0,0,100,100,38
112,r_127_163_29,r_361_344_64,seq166,r_127_163_29,1.0,0,29,29,38
68,r_202_352_20,seq4,r_268_196_108,r_268_196_108,1.0,0,108,108,38
107,r_221_282_157,r_99_133_180,seq116,r_221_282_157,1.0,0,157,157,38
34,r_286_307_147,seq354,seq303,r_286_307_147,1.0,0,147,147,38
123,r_92_68_153,seq105,seq103,r_92_68_153,1.0,-1,152,153,38
37,r_208_321_155,seq154,r_300_147_2,r_208_321_155,0.99,7,162,155,38
87,r_269_167_173,r_316_311_184,r_324_265_86,r_269_167_173,1.0,0,173,173,38
121,r_112_191_123,seq214,r_17_52_68,r_112_191_123,0.92,2,125,123,38
91,r_194_55_28,r_31_0_188,seq362,r_194_55_28,0.94,0,28,28,38
113,r_138_224_111,seq264,seq297,r_138_224_111,1.0,0,111,111,38
49,r_65_148_43,r_245_97_139,seq102,r_65_148_43,1.0,0,43,43,38
48,r_119_242_66,r_107_320_165,r_15_260_56,r_15_260_56,0.99,23,79,56,38
46,r_85_43_28,r_177_220_107,seq116,r_177_220_107,0.95,0,107,107,38
27,r_238_151_125,seq154,r_78_329_15,r_238_151_125,0.93,8,133,125,38
104,r_164_149_86,r_301_40_93,r_300_147_2,r_300_147_2,0.54,84,86,2,38
21,r_84_54_69,r_316_311_184,seq369,r_84_54_69,1.0,3,72,69,38
46,r_85_43_28,r_237_343_198,r_177_220_107,r_85_43_28,0.97,0,28,28,38
61,r_285_182_92,seq338,seq318,r_285_182_92,1.0,0,92,92,38
169,seq143,r_120_313_171,r_365_219_76,r_120_313_171,0.77,0,171,171,38
54,r_330_228_109,seq203,r_366_13_84,r_330_228_109,1.0,0,109,109,38
96,r_281_325_31,r_162_225_162,r_300_147_2,r_281_325_31,1.0,0,31,31,38
78,r_162_225_162,seq203,seq280,r_162_225_162,1.0,0,162,162,38
57,r_108_89_130,seq197,r_85_43_28,r_108_89_130,0.98,0,130,130,38
90,r_157_198_127,seq319,seq214,r_157_198_127,1.0,0,127,127,38
102,r_62_205_159,r_77_370_190,r_11_278_153,r_77_370_190,0.86,-30,160,190,38
6,r_14_140_57,r_269_167_173,seq166,r_14_140_57,1.0,0,57,57,38
24,r_300_147_2,r_21_350_185,r_281_325_31,r_281_325_31,1.0,0,31,31,38
73,r_356_322_149,seq123,seq290,r_356_322_149,1.0,1,150,149,38
124,r_6_185_147,seq165,r_161_57_82,r_6_185_147,1.0,0,147,147,39
30,r_190_253_105,seq230,r_264_315_39,r_190_253_105,1.0,0,105,105,39
59,r_128_338_121,seq81,r_64_235_114,r_128_338_121,1.0,0,121,121,39
16,r_367_102_92,seq333,seq242,r_367_102_92,1.0,0,92,92,39
7,r_4_119_167,r_241_107_198,seq48,r_4_119_167,1.0,0,167,167,39
72,r_24_144_56,seq195,r_150_369_109,r_24_144_56,0.68,93,149,56,39
75,r_27_207_193,r_49_211_172,r_290_329_109,r_27_207_193,0.92,-21,172,193,39
94,r_308_7_93,seq42,seq164,r_308_7_93,1.0,1,94,93,39
180,seq162,r_5_101_193,r_100_269_24,r_100_269_24,0.99,66,90,24,39
198,seq205,seq362,r_135_256_61,r_135_256_61,1.0,9,70,61,39
39,r_234_55_86,seq153,seq41,r_234_55_86,0.97,0,86,86,39
41,r_69_114_99,r_76_63_188,seq332,r_69_114_99,1.0,1,100,99,39
25,r_76_63_188,r_69_114_99,seq35,r_76_63_188,0.52,-88,100,188,39
9,r_125_19_98,r_373_115_95,r_159_293_45,r_125_19_98,0.63,9,107,98,39
118,r_64_235_114,seq72,seq333,r_64_235_114,1.0,1,115,114,39
37,r_310_337_50,r_296_254_86,seq44,r_296_254_86,1.0,-36,50,86,39
1,r_83_203_157,r_21_326_156,r_159_293_45,r_83_203_157,1.0,2,159,157,39
120,r_264_315_39,r_150_369_109,seq236,r_264_315_39,0.99,0,39,39,39
53,r_215_197_97,r_73_301_68,r_186_31_56,r_215_197_97,1.0,-29,68,97,39
32,r_370_285_185,seq176,r_135_256_61,r_370_285_185,0.62,3,188,185,39
154,seq87,r_83_203_157,seq176,r_83_203_157,1.0,1,158,157,39
49,r_186_31_56,seq261,r_215_197_97,r_186_31_56,1.0,0,56,56,39
68,r_239_273_30,r_173_292_106,seq251,r_239_273_30,1.0,0,30,30,39
140,seq44,r_173_292_106,r_310_337_50,r_173_292_106,1.0,-25,81,106,39
105,r_327_214_18,r_126_170_187,seq129,r_327_214_18,1.0,1,19,18,39
79,r_297_47_184,r_233_156_144,r_100_269_24,r_233_156_144,1.0,0,144,144,39
114,r_37_257_153,r_357_304_47,seq218,r_37_257_153,1.0,0,153,153,39
60,r_252_275_166,seq148,r_159_293_45,r_252_275_166,1.0,1,167,166,39
108,r_233_156_144,r_297_47_184,r_82_142_1,r_233_156_144,0.99,0,144,144,39
25,r_76_63_188,r_172_51_149,r_150_369_109,r_76_63_188,0.65,0,188,188,39
70,r_260_136_123,seq87,r_351_16_30,r_260_136_123,1.0,0,123,123,39
95,r_314_258_124,seq261,r_118_279_42,r_118_279_42,0.93,82,124,42,39
81,r_303_117_162,r_296_254_86,r_266_320_54,r_303_117_162,0.79,-76,86,162,39
112,r_98_96_19,r_20_180_97,seq133,r_98_96_19,0.99,0,19,19,39
100,r_353_89_12,r_173_292_106,seq61,r_353_89_12,0.95,0,12,12,39
115,r_58_346_10,r_111_354_156,r_49_211_172,r_58_346_10,0.85,0,10,10,39
97,r_330_277_184,r_32_331_58,r_352_167_5,r_330_277_184,0.99,0,184,184,39
116,r_32_331_58,r_190_253_105,seq171,r_190_253_105,0.69,-46,59,105,39
22,r_323_91_134,seq363,r_128_338_121,r_323_91_134,1.0,0,134,134,39
35,r_40_237_87,seq362,r_266_320_54,r_40_237_87,1.0,0,87,87,39
46,r_105_108_92,seq152,seq146,r_105_108_92,0.98,6,98,92,39
114,r_37_257_153,r_93_198_162,r_357_304_47,r_357_304_47,1.0,6,53,47,39
113,r_70_122_190,seq137,r_150_369_109,r_70_122_190,0.97,0,190,190,39
170,seq133,seq225,r_98_96_19,r_98_96_19,0.94,58,77,19,39
107,r_8_250_179,seq65,r_135_256_61,r_8_250_179,0.95,2,181,179,39
71,r_309_259_88,r_359_232_182,seq187,r_309_259_88,1.0,0,88,88,39
77,r_339_276_178,seq79,r_111_354_156,r_339_276_178,0.95,2,180,178,39
69,r_224_321_99,seq50,seq148,r_224_321_99,1.0,0,99,99,39
91,r_340_364_126,seq61,r_69_114_99,r_340_364_126,1.0,4,130,126,39
171,seq137,r_70_122_190,r_278_356_82,r_70_122_190,0.71,0,190,190,39
80,r_151_112_146,r_49_211_172,r_255_17_67,r_151_112_146,1.0,0,146,146,39
109,r_341_175_18,r_359_232_182,r_161_57_82,r_341_175_18,0.9,155,173,18,39
183,seq165,r_6_185_147,r_159_293_45,r_6_185_147,0.97,0,147,147,39
96,r_355_318_148,seq14,r_224_321_99,r_355_318_148,1.0,0,148,148,39
109,r_341_175_18,r_40_237_87,r_359_232_182,r_359_232_182,0.59,-164,18,182,39
38,r_238_140_121,seq287,r_10_240_30,r_238_140_121,0.99,0,121,121,39
19,r_150_369_109,seq48,r_69_114_99,r_69_114_99,0.79,11,110,99,39
6,r_313_366_45,seq272,seq286,r_313_366_45,0.62,34,79,45,39
0,r_173_292_106,r_220_345_176,r_105_108_92,r_173_292_106,1.0,0,106,106,39
34,r_21_326_156,r_83_203_157,seq127,r_21_326_156,1.0,0,156,156,39
25,r_76_63_188,seq35,r_172_51_149,r_76_63_188,0.8,-44,144,188,39
223,seq272,r_313_366_45,r_294_1_71,r_294_1_71,1.0,8,79,71,39
49,r_186_31_56,r_215_197_97,r_10_240_30,r_215_197_97,1.0,0,97,97,39
51,r_255_17_67,r_312_267_115,seq230,r_255_17_67,1.0,0,67,67,39
85,r_193_86_132,seq106,r_46_157_66,r_193_86_132,1.0,0,132,132,39
15,r_290_329_109,seq187,seq148,r_290_329_109,1.0,0,109,109,39
122,r_204_328_102,seq65,r_373_115_95,r_204_328_102,0.86,1,103,102,39
86,r_131_281_161,seq66,r_215_197_97,r_215_197_97,0.65,66,163,97,39
53,r_215_197_97,r_186_31_56,r_310_337_50,r_215_197_97,0.88,0,97,97,39
4,r_270_75_66,seq116,r_46_157_66,r_270_75_66,0.89,1,67,66,39
33,r_351_16_30,r_103_348_146,seq38,r_351_16_30,1.0,0,30,30,39
76,r_312_267_115,seq146,r_309_259_88,r_312_267_115,1.0,0,115,115,39
5,r_20_180_97,seq71,seq48,r_20_180_97,0.91,11,108,97,39
18,r_179_97_157,r_82_142_1,r_323_91_134,r_179_97_157,1.0,0,157,157,39
88,r_15_45_169,seq129,r_98_96_19,r_15_45_169,1.0,1,170,169,39
117,r_294_1_71,r_93_198_162,r_327_214_18,r_294_1_71,1.0,0,71,71,39
73,r_266_320_54,r_238_140_121,r_359_232_182,r_266_320_54,1.0,0,54,54,39
40,r_168_30_151,seq14,seq153,r_168_30_151,1.0,1,152,151,39
121,r_358_347_139,seq148,seq242,r_358_347_139,1.0,0,139,139,39
103,r_274_216_65,r_307_23_170,seq74,r_274_216_65,1.0,0,65,65,39
11,r_143_59_84,seq61,r_100_269_24,r_143_59_84,1.0,0,84,84,39
192,seq191,seq123,r_95_25_101,r_95_25_101,0.99,8,109,101,39
104,r_357_304_47,r_215_197_97,r_37_257_153,r_357_304_47,1.0,0,47,47,39
54,r_73_301_68,r_215_197_97,r_201_229_62,r_73_301_68,1.0,0,68,68,39
90,r_118_279_42,r_60_228_144,seq50,r_118_279_42,1.0,0,42,42,39
98,r_298_139_70,seq199,seq299,r_298_139_70,1.0,0,70,70,39
110,r_296_254_86,r_303_117_162,r_282_3_164,r_296_254_86,1.0,0,86,86,39
20,r_278_356_82,r_290_329_109,seq106,r_278_356_82,1.0,0,82,82,39
36,r_134_372_151,seq222,r_172_51_149,r_134_372_151,1.0,1,152,151,39
115,r_58_346_10,r_49_211_172,r_98_96_19,r_49_211_172,1.0,0,172,172,39
2,r_135_256_61,r_172_51_149,seq205,r_135_256_61,1.0,1,62,61,39
106,r_52_36_54,r_179_97_157,seq247,r_52_36_54,1.0,1,55,54,39
62,r_172_51_149,seq187,r_134_372_151,r_172_51_149,1.0,0,149,149,39
143,seq61,r_143_59_84,r_353_89_12,r_143_59_84,1.0,0,84,84,39
104,r_357_304_47,r_37_257_153,r_374_149_134,r_357_304_47,1.0,108,155,47,39
50,r_359_232_182,seq66,r_111_354_156,r_359_232_182,0.93,3,185,182,39
73,r_266_320_54,r_359_232_182,r_40_237_87,r_266_320_54,0.7,51,105,54,39
79,r_297_47_184,r_100_269_24,r_296_254_86,r_297_47_184,0.76,0,184,184,39
43,r_28_174_49,r_173_292_106,r_32_331_58,r_173_292_106,0.72,-47,59,106,39
102,r_100_269_24,r_278_356_82,seq162,r_100_269_24,1.0,0,24,24,39
29,r_13_263_172,seq302,r_322_365_7,r_13_263_172,1.0,2,174,172,39
52,r_231_317_180,seq72,r_111_354_156,r_231_317_180,1.0,0,180,180,39
48,r_53_94_145,seq26,seq18,r_53_94_145,1.0,0,145,145,39
74,r_201_229_62,r_307_23_170,seq90,r_201_229_62,0.96,4,66,62,39
58,r_93_198_162,seq332,r_161_57_82,r_93_198_162,1.0,1,163,162,39
24,r_60_228_144,seq12,r_323_91_134,r_60_228_144,1.0,2,146,144,39
23,r_271_342_176,seq262,r_125_19_98,r_271_342_176,0.98,2,178,176,39
42,r_334_295_156,r_68_166_196,r_21_326_156,r_334_295_156,1.0,0,156,156,39
64,r_212_196_62,r_260_136_123,r_351_16_30,r_351_16_30,1.0,33,63,30,39
81,r_303_117_162,r_266_320_54,r_296_254_86,r_303_117_162,0.99,0,162,162,39
55,r_126_170_187,seq247,r_373_115_95,r_126_170_187,0.74,1,188,187,39
142,seq50,r_224_321_99,r_118_279_42,r_224_321_99,0.76,0,99,99,39
10,r_46_157_66,r_271_342_176,r_270_75_66,r_46_157_66,0.92,1,67,66,39
12,r_56_246_142,r_334_295_156,r_212_196_62,r_56_246_142,1.0,0,142,142,39
119,r_103_348_146,seq148,r_161_57_82,r_103_348_146,0.86,0,146,146,39
67,r_159_293_45,r_138_325_1,seq165,r_159_293_45,1.0,0,45,45,39
66,r_374_149_134,seq9,r_357_304_47,r_374_149_134,0.94,-1,133,134,39
111,r_95_25_101,seq242,seq191,r_95_25_101,1.0,0,101,101,39
87,r_10_240_30,r_359_232_182,seq243,r_10_240_30,0.99,0,30,30,39
57,r_177_182_100,r_11_77_154,seq137,r_177_182_100,1.0,0,100,100,39
208,seq225,seq183,r_58_346_10,r_58_346_10,0.96,43,53,10,39
72,r_24_144_56,r_5_101_193,seq195,r_24_144_56,1.0,0,56,56,39
63,r_43_283_148,seq113,r_118_279_42,r_43_283_148,1.0,0,148,148,39
201,seq209,seq145,r_32_331_58,r_32_331_58,0.99,35,93,58,39
47,r_33_62_38,r_215_197_97,r_82_142_1,r_82_142_1,1.0,37,38,1,39
8,r_335_192_58,r_64_235_114,seq65,r_335_192_58,0.95,3,61,58,39
17,r_49_211_172,r_27_207_193,r_238_140_121,r_49_211_172,1.0,0,172,172,39
130,seq18,r_132_219_192,r_53_94_145,r_53_94_145,0.81,9,154,145,39
97,r_330_277_184,seq145,r_32_331_58,r_32_331_58,0.9,27,85,58,39
83,r_234_60_160,seq147,r_182_188_95,r_234_60_160,0.78,0,160,160,40
47,r_250_84_179,r_362_220_3,r_267_65_62,r_267_65_62,0.68,117,179,62,40
40,r_363_177_173,r_16_32_38,seq100,r_363_177_173,0.98,1,174,173,40
195,seq205,r_118_116_152,seq183,r_118_116_152,0.99,1,153,152,40
122,r_154_341_144,seq23,r_97_240_95,r_154_341_144,0.97,3,147,144,40
21,r_261_31_96,r_256_254_158,seq104,r_256_254_158,0.55,-50,108,158,40
31,r_141_192_130,seq292,seq370,r_141_192_130,1.0,1,131,130,40
113,r_185_352_172,seq17,r_92_122_26,r_185_352_172,0.96,0,172,172,40
2,r_99_331_68,r_231_268_126,seq280,r_99_331_68,0.89,3,71,68,40
105,r_158_11_72,r_146_298_148,r_124_265_62,r_158_11_72,0.98,0,72,72,40
34,r_214_309_139,seq73,r_294_95_89,r_214_309_139,0.67,2,141,139,40
26,r_130_90_111,r_157_282_120,r_20_63_25,r_130_90_111,1.0,0,111,111,40
81,r_297_319_137,r_151_222_176,seq315,r_297_319_137,1.0,0,137,137,40
197,seq213,r_87_123_108,r_210_230_27,r_87_123_108,1.0,0,108,108,40
37,r_18_26_72,r_180_22_70,r_55_263_91,r_55_263_91,0.92,3,94,91,40
249,seq370,r_83_142_167,r_141_192_130,r_141_192_130,0.71,30,160,130,40
120,r_149_287_133,seq219,seq140,r_149_287_133,0.99,1,134,133,40
63,r_233_86_82,seq117,seq71,r_233_86_82,1.0,0,82,82,40
222,seq300,r_231_268_126,seq43,r_231_268_126,1.0,0,126,126,40
16,r_61_5_78,r_218_229_114,r_124_265_62,r_61_5_78,1.0,0,78,78,40
200,seq236,r_173_257_161,r_239_59_102,r_239_59_102,0.5,37,139,102,40
119,r_169_291_155,seq34,r_210_230_27,r_169_291_155,1.0,1,156,155,40
40,r_363_177_173,r_124_265_62,r_16_32_38,r_363_177_173,0.67,-111,62,173,40
65,r_316_302_51,r_169_291_155,r_286_168_131,r_169_291_155,1.0,1,156,155,40
85,r_80_290_83,seq33,seq145,r_80_290_83,1.0,0,83,83,40
75,r_332_42_156,seq315,seq117,r_332_42_156,0.95,1,157,156,40
53,r_139_345_149,r_242_368_199,seq76,r_139_345_149,1.0,0,149,149,40
57,r_335_207_164,seq357,r_297_319_137,r_297_319_137,0.99,34,171,137,40
89,r_16_32_38,seq112,r_363_177_173,r_16_32_38,1.0,1,39,38,40
65,r_316_302_51,r_155_8_182,r_169_291_155,r_316_302_51,1.0,0,51,51,40
153,seq76,r_248_289_181,r_139_345_149,r_139_345_149,0.94,32,181,149,40
90,r_256_254_158,seq43,r_174_47_133,r_256_254_158,1.0,0,158,158,40
207,seq260,r_83_142_167,r_141_192_130,r_141_192_130,0.79,37,167,130,40
109,r_15_361_20,r_253_249_157,seq264,r_15_361_20,1.0,0,20,20,40
172,seq137,r_344_307_115,seq162,r_344_307_115,1.0,0,115,115,40
88,r_92_122_26,r_275_178_183,r_237_232_100,r_92_122_26,1.0,1,27,26,40
123,r_111_131_110,r_50_194_190,seq354,r_111_131_110,1.0,0,110,110,40
114,r_211_98_126,seq280,r_283_314_47,r_211_98_126,0.99,0,126,126,40
98,r_296_170_120,r_348_338_158,seq246,r_296_170_120,1.0,0,120,120,40
38,r_294_95_89,r_253_249_157,r_99_331_68,r_294_95_89,0.63,0,89,89,40
133,seq17,r_185_352_172,r_204_374_105,r_185_352_172,0.95,0,172,172,40
88,r_92_122_26,r_237_232_100,r_293_195_90,r_92_122_26,1.0,74,100,26,40
62,r_157_282_120,r_35_78_178,r_121_209_31,r_157_282_120,1.0,0,120,120,40
15,r_118_116_152,r_342_327_114,seq205,r_342_327_114,1.0,3,117,114,40
163,seq104,seq251,r_261_31_96,r_261_31_96,1.0,-6,90,96,40
22,r_134_258_139,r_253_249_157,r_276_66_82,r_134_258_139,1.0,0,139,139,40
44,r_35_78_178,seq150,r_87_123_108,r_87_123_108,0.85,70,178,108,40
10,r_87_123_108,seq213,seq46,r_87_123_108,1.0,0,108,108,40
134,seq21,r_28_143_55,seq43,r_28_143_55,0.68,6,61,55,40
45,r_146_298_148,r_335_207_164,seq140,r_146_298_148,1.0,0,148,148,40
228,seq315,r_332_42_156,r_297_319_137,r_297_319_137,0.76,20,157,137,40
7,r_67_364_159,seq88,r_175_223_102,r_67_364_159,1.0,0,159,159,40
18,r_151_222_176,seq337,r_16_32_38,r_151_222_176,0.89,0,176,176,40
124,r_221_208_131,seq128,r_333_340_52,r_221_208_131,1.0,0,131,131,40
77,r_283_314_47,r_231_268_126,seq329,r_283_314_47,0.84,0,47,47,40
68,r_284_305_16,r_114_171_109,seq46,r_114_171_109,0.77,-93,16,109,40
106,r_163_89_149,r_363_177_173,r_296_170_120,r_163_89_149,1.0,0,149,149,40
41,r_7_58_59,r_322_164_76,r_77_54_38,r_7_58_59,0.86,0,59,59,40
54,r_262_372_24,r_308_72_181,seq346,r_262_372_24,0.89,3,27,24,40
3,r_55_263_91,seq128,r_18_26_72,r_55_263_91,0.58,0,91,91,40
52,r_239_59_102,seq9,seq236,r_239_59_102,1.0,0,102,102,40
112,r_225_226_39,r_7_58_59,r_52_184_183,r_52_184_183,1.0,-144,39,183,40
195,seq205,r_267_65_62,r_118_116_152,r_267_65_62,1.0,1,63,62,40
5,r_212_274_89,seq2,seq70,r_212_274_89,1.0,1,90,89,40
237,seq346,seq117,r_193_215_107,r_193_215_107,1.0,12,119,107,40
35,r_266_96_131,seq366,seq186,r_266_96_131,1.0,0,131,131,40
27,r_343_358_55,r_61_5_78,seq82,r_343_358_55,1.0,0,55,55,40
103,r_303_181_30,r_126_201_156,r_74_125_12,r_303_181_30,1.0,0,30,30,40
240,seq353,r_266_96_131,r_243_102_21,r_243_102_21,1.0,0,21,21,40
13,r_273_367_37,r_154_341_144,r_242_368_199,r_273_367_37,0.89,2,39,37,40
19,r_259_119_110,r_53_347_136,r_294_95_89,r_259_119_110,0.99,0,110,110,40
102,r_53_347_136,seq128,r_189_247_199,r_53_347_136,1.0,0,136,136,40
80,r_248_289_181,seq76,seq68,r_248_289_181,0.83,0,181,181,40
79,r_286_168_131,r_214_309_139,r_316_302_51,r_286_168_131,0.83,0,131,131,40
51,r_38_336_48,r_61_5_78,seq112,r_38_336_48,0.74,0,48,48,40
107,r_56_165_173,seq200,seq25,r_56_165_173,0.9,1,174,173,40
82,r_339_12_186,seq281,r_243_102_21,r_339_12_186,0.88,0,186,186,40
111,r_199_359_172,seq68,r_239_59_102,r_199_359_172,1.0,0,172,172,40
86,r_97_240_95,seq128,seq33,r_97_240_95,0.99,17,112,95,40
69,r_237_232_100,seq269,seq351,r_237_232_100,1.0,0,100,100,40
67,r_371_19_120,seq34,r_212_274_89,r_371_19_120,1.0,0,120,120,40
198,seq219,r_235_373_125,r_189_247_199,r_235_373_125,0.85,27,152,125,40
73,r_44_103_33,r_204_374_105,seq269,r_44_103_33,1.0,0,33,33,40
101,r_173_257_161,seq236,r_349_318_32,r_173_257_161,0.88,0,161,161,40
152,seq73,r_214_309_139,r_114_171_109,r_114_171_109,0.72,32,141,109,40
108,r_293_195_90,r_332_42_156,r_92_122_26,r_293_195_90,1.0,0,90,90,40
56,r_155_8_182,seq272,r_248_289_181,r_155_8_182,1.0,0,182,182,40
84,r_243_102_21,r_50_194_190,seq353,r_243_102_21,1.0,0,21,21,40
118,r_40_238_174,seq24,r_335_207_164,r_40_238_174,1.0,0,174,174,40
174,seq140,r_15_361_20,r_149_287_133,r_149_287_133,0.55,3,136,133,40
1,r_114_171_109,seq117,seq73,r_114_171_109,1.0,0,109,109,40
74,r_113_191_14,r_146_298_148,r_74_125_12,r_113_191_14,0.81,0,14,14,40
212,seq272,r_155_8_182,r_204_374_105,r_155_8_182,0.97,0,182,182,40
93,r_348_338_158,r_199_359_172,r_266_96_131,r_348_338_158,0.95,0,158,158,40
39,r_342_327_114,r_118_116_152,r_189_247_199,r_342_327_114,0.79,3,117,114,40
29,r_124_265_62,r_363_177_173,seq88,r_124_265_62,1.0,0,62,62,40
70,r_276_66_82,seq93,seq153,r_276_66_82,1.0,0,82,82,40
236,seq337,r_151_222_176,r_349_318_32,r_151_222_176,0.99,0,176,176,40
15,r_118_116_152,seq205,seq162,r_118_116_152,1.0,0,152,152,40
100,r_152_187_90,seq167,seq6,r_152_187_90,1.0,0,90,90,40
49,r_218_229_114,seq246,seq147,r_218_229_114,0.74,4,118,114,40
20,r_235_373_125,seq219,r_237_232_100,r_237_232_100,0.97,27,127,100,40
71,r_267_65_62,seq205,seq271,r_267_65_62,1.0,0,62,62,40
209,seq269,r_237_232_100,r_44_103_33,r_237_232_100,0.51,-14,86,100,40
66,r_210_230_27,r_173_257_161,seq213,r_210_230_27,0.66,0,27,27,40
60,r_20_63_25,r_40_238_174,seq64,r_20_63_25,1.0,0,25,25,40
89,r_16_32_38,r_363_177_173,r_151_222_176,r_16_32_38,0.98,138,176,38,40
215,seq280,r_211_98_126,r_99_331_68,r_211_98_126,0.54,1,127,126,40
241,seq354,seq76,r_111_131_110,r_111_131_110,1.0,6,116,110,40
50,r_224_108_25,r_273_367_37,seq24,r_224_108_25,0.97,0,25,25,40
87,r_174_47_133,seq357,r_105_10_78,r_105_10_78,0.83,61,139,78,40
91,r_49_159_55,seq68,r_13_301_84,r_49_159_55,1.0,3,58,55,40
12,r_106_326_59,r_182_188_95,r_77_54_38,r_182_188_95,0.84,-36,59,95,40
99,r_328_304_97,seq14,seq24,r_328_304_97,0.99,0,97,97,40
95,r_83_142_167,seq260,r_266_96_131,r_83_142_167,0.52,0,167,167,40
43,r_227_45_185,r_50_194_190,r_239_59_102,r_227_45_185,0.89,0,185,185,40
97,r_180_22_70,seq27,seq23,r_180_22_70,1.0,0,70,70,40
23,r_57_197_45,r_55_263_91,seq0,r_57_197_45,0.93,3,48,45,40
233,seq329,seq167,r_283_314_47,r_283_314_47,0.88,48,95,47,40
121,r_193_215_107,seq34,seq346,r_193_215_107,1.0,0,107,107,40
42,r_48_75_79,seq91,r_74_125_12,r_48_75_79,1.0,0,79,79,40
115,r_244_278_98,seq64,r_189_247_199,r_244_278_98,1.0,0,98,98,40
6,r_253_249_157,r_50_194_190,r_214_309_139,r_253_249_157,1.0,0,157,157,40
58,r_231_268_126,r_283_314_47,seq300,r_283_314_47,0.87,0,47,47,40
58,r_231_268_126,seq300,seq136,r_231_268_126,0.99,0,126,126,40
28,r_204_374_105,seq25,seq117,r_204_374_105,0.91,6,111,105,40
96,r_105_10_78,seq353,seq315,r_105_10_78,1.0,0,78,78,40
247,seq366,r_266_96_131,r_243_102_21,r_266_96_131,0.68,0,131,131,40
76,r_28_143_55,seq21,seq281,r_28_143_55,0.95,6,61,55,40
109,r_255_252_156,r_369_131_138,r_366_134_2,r_255_252_156,0.95,1,157,156,41
57,r_281_289_152,seq167,seq1,r_281_289_152,1.0,0,152,152,41
86,r_187_300_143,seq181,r_68_360_8,r_187_300_143,1.0,1,144,143,41
65,r_192_83_142,seq129,r_362_97_55,r_192_83_142,0.99,2,144,142,41
112,r_52_231_52,r_99_178_157,seq333,r_99_178_157,0.87,-112,45,157,41
47,r_49_324_167,seq154,r_371_277_28,r_49_324_167,0.99,0,167,167,41
49,r_225_108_44,seq193,r_32_373_1,r_225_108_44,1.0,0,44,44,41
114,r_146_141_181,r_162_345_44,r_244_332_101,r_146_141_181,0.99,1,182,181,41
213,seq242,r_371_277_28,r_259_135_30,r_371_277_28,0.79,-2,26,28,41
69,r_65_248_24,r_342_348_154,r_64_24_21,r_65_248_24,0.72,1,25,24,41
196,seq206,r_117_306_64,r_28_44_114,r_28_44_114,0.61,26,140,114,41
120,r_73_51_189,seq140,r_61_271_25,r_73_51_189,0.96,0,189,189,41
19,r_371_277_28,r_290_291_57,seq227,r_371_277_28,1.0,0,28,28,41
107,r_293_31_166,seq263,r_128_251_121,r_293_31_166,1.0,0,166,166,41
70,r_188_172_20,seq223,r_90_6_41,r_188_172_20,0.58,1,21,20,41
59,r_63_145_130,seq10,r_339_341_78,r_63_145_130,1.0,0,130,130,41
13,r_218_157_139,seq78,seq27,r_218_157_139,1.0,0,139,139,41
105,r_68_360_8,seq288,seq10,r_68_360_8,0.98,3,11,8,41
97,r_47_163_82,r_150_203_192,r_225_108_44,r_47_163_82,0.98,1,83,82,41
4,r_61_271_25,r_82_269_70,seq303,r_61_271_25,1.0,0,25,25,41
186,seq181,r_187_300_143,r_210_19_96,r_187_300_143,0.51,-50,93,143,41
10,r_321_241_57,r_42_266_180,seq166,r_321_241_57,1.0,0,57,57,41
22,r_149_38_56,seq1,seq129,r_149_38_56,1.0,0,56,56,41
40,r_219_358_26,r_307_352_69,r_366_134_2,r_219_358_26,0.71,-2,24,26,41
44,r_53_29_91,r_244_332_101,seq326,r_53_29_91,0.97,-2,89,91,41
46,r_25_349_155,seq125,r_52_231_52,r_25_349_155,1.0,1,156,155,41
3,r_0_284_145,seq74,r_188_172_20,r_0_284_145,1.0,0,145,145,41
121,r_329_81_149,seq35,r_301_254_67,r_329_81_149,1.0,2,151,149,41
37,r_57_147_158,r_32_373_1,seq120,r_57_147_158,0.86,1,159,158,41
15,r_310_249_121,r_192_83_142,seq154,r_310_249_121,1.0,0,121,121,41
20,r_278_121_33,r_307_352_69,seq240,r_278_121_33,0.95,0,33,33,41
62,r_113_318_78,r_369_131_138,r_34_20_70,r_113_318_78,1.0,-1,77,78,41
78,r_372_158_96,seq295,r_164_305_75,r_372_158_96,0.98,0,96,96,41
104,r_259_135_30,r_218_157_139,r_210_19_96,r_259_135_30,0.67,-4,26,30,41
114,r_146_141_181,r_350_123_106,r_162_345_44,r_162_345_44,0.85,1,45,44,41
104,r_259_135_30,r_210_19_96,seq242,r_210_19_96,0.88,21,117,96,41
68,r_268_48_64,seq152,seq288,r_268_48_64,0.78,-3,61,64,41
61,r_274_159_165,seq202,r_321_241_57,r_274_159_165,0.98,0,165,165,41
29,r_353_247_181,seq148,r_337_304_114,r_353_247_181,0.85,-1,180,181,41
70,r_188_172_20,r_90_6_41,r_0_284_145,r_0_284_145,1.0,5,150,145,41
58,r_207_233_48,r_90_6_41,seq148,r_207_233_48,1.0,-2,46,48,41
35,r_2_196_129,seq37,r_369_131_138,r_2_196_129,0.8,0,129,129,41
43,r_337_304_114,r_16_77_176,seq140,r_337_304_114,0.99,3,117,114,41
1,r_238_106_138,r_274_159_165,seq194,r_238_106_138,1.0,0,138,138,41
224,seq279,r_75_130_134,r_4_276_53,r_4_276_53,0.73,0,53,53,41
11,r_335_270_60,r_100_355_81,seq190,r_335_270_60,1.0,0,60,60,41
122,r_34_20_70,r_372_158_96,r_113_318_78,r_34_20_70,1.0,0,70,70,41
50,r_4_276_53,seq240,seq279,r_4_276_53,1.0,0,53,53,41
21,r_162_345_44,r_146_141_181,r_0_284_145,r_162_345_44,0.94,139,183,44,41
7,r_85_282_54,r_320_234_123,r_347_340_8,r_347_340_8,0.66,18,26,8,41
113,r_116_92_135,seq23,r_208_76_19,r_116_92_135,1.0,3,138,135,41
71,r_256_50_60,r_128_251_121,r_61_271_25,r_256_50_60,0.55,-11,49,60,41
94,r_175_365_101,r_137_138_104,seq272,r_175_365_101,1.0,0,101,101,41
124,r_3_287_17,r_344_323_74,seq161,r_3_287_17,0.93,1,18,17,41
56,r_320_234_123,seq327,r_268_48_64,r_320_234_123,0.98,2,125,123,41
8,r_307_352_69,seq235,seq74,r_307_352_69,0.96,1,70,69,41
66,r_246_95_110,seq262,seq199,r_246_95_110,1.0,1,111,110,41
38,r_7_133_110,r_353_247_181,r_61_271_25,r_7_133_110,1.0,2,112,110,41
209,seq235,r_307_352_69,seq140,r_307_352_69,1.0,1,70,69,41
173,seq152,seq84,r_164_305_75,r_164_305_75,1.0,13,88,75,41
52,r_11_101_52,seq124,seq223,r_11_101_52,1.0,1,53,52,41
36,r_297_338_161,seq72,seq154,r_297_338_161,0.98,0,161,161,41
117,r_228_180_27,r_346_177_188,r_16_77_176,r_228_180_27,0.74,-2,25,27,41
17,r_257_153_53,r_362_97_55,seq226,r_257_153_53,1.0,0,53,53,41
178,seq165,seq237,r_356_197_50,r_356_197_50,1.0,30,80,50,41
183,seq173,r_182_111_159,seq84,r_182_111_159,1.0,0,159,159,41
138,seq37,r_2_196_129,r_137_138_104,r_137_138_104,0.99,25,129,104,41
26,r_301_254_67,r_362_97_55,r_356_197_50,r_362_97_55,0.84,12,67,55,41
106,r_105_328_28,r_301_254_67,r_264_110_27,r_105_328_28,0.49,-2,26,28,41
80,r_186_211_139,seq260,r_320_234_123,r_186_211_139,0.97,1,140,139,41
27,r_14_261_69,seq114,r_3_287_17,r_14_261_69,0.92,-1,68,69,41
83,r_54_308_41,seq299,r_61_271_25,r_54_308_41,0.98,0,41,41,41
45,r_183_26_64,r_238_106_138,r_61_271_25,r_183_26_64,0.95,-2,62,64,41
123,r_112_204_106,seq209,seq265,r_112_204_106,1.0,0,106,106,41
174,seq154,r_49_324_167,r_297_338_161,r_49_324_167,0.94,-1,166,167,41
23,r_222_171_147,seq167,r_80_213_36,r_222_171_147,1.0,0,147,147,41
96,r_67_22_64,r_142_93_64,seq314,r_67_22_64,1.0,-2,62,64,41
34,r_16_77_176,r_337_304_114,r_53_29_91,r_337_304_114,0.74,3,117,114,41
218,seq260,r_186_211_139,r_117_306_64,r_186_211_139,0.98,1,140,139,41
116,r_64_24_21,r_321_241_57,seq331,r_321_241_57,0.54,-39,18,57,41
34,r_16_77_176,r_53_29_91,r_207_233_48,r_16_77_176,0.89,3,179,176,41
99,r_315_30_159,seq169,seq103,r_315_30_159,1.0,0,159,159,41
30,r_87_200_44,r_11_101_52,seq43,r_87_200_44,1.0,-2,42,44,41
64,r_151_127_134,seq56,r_63_145_130,r_151_127_134,1.0,1,135,134,41
88,r_339_341_78,seq84,seq275,r_339_341_78,1.0,-1,77,78,41
187,seq185,r_99_178_157,r_244_332_101,r_99_178_157,1.0,0,157,157,41
67,r_41_201_40,r_310_249_121,r_90_6_41,r_41_201_40,1.0,-2,38,40,41
82,r_142_93_64,r_290_291_57,r_52_231_52,r_290_291_57,0.87,0,57,57,41
119,r_239_273_38,r_346_177_188,r_8_354_72,r_239_273_38,0.86,0,38,38,41
92,r_311_94_71,seq37,seq202,r_311_94_71,0.79,0,71,71,41
89,r_214_317_140,seq56,r_301_254_67,r_214_317_140,1.0,1,141,140,41
111,r_198_285_58,r_57_147_158,seq224,r_198_285_58,1.0,-1,57,58,41
48,r_82_269_70,r_137_138_104,seq17,r_82_269_70,1.0,1,71,70,41
79,r_210_19_96,r_259_135_30,seq181,r_259_135_30,0.73,88,118,30,41
102,r_182_111_159,seq173,r_11_101_52,r_182_111_159,1.0,0,159,159,41
53,r_290_291_57,r_142_93_64,seq33,r_290_291_57,0.92,0,57,57,41
79,r_210_19_96,r_335_270_60,r_259_135_30,r_210_19_96,0.49,-70,26,96,41
14,r_75_130_134,seq279,seq40,r_75_130_134,1.0,0,134,134,41
108,r_356_197_50,r_238_106_138,seq165,r_356_197_50,1.0,-1,49,50,41
2,r_128_251_121,seq357,r_53_29_91,r_128_251_121,0.62,1,122,121,41
117,r_228_180_27,r_16_77_176,r_128_251_121,r_228_180_27,0.71,152,179,27,41
12,r_342_348_154,r_293_31_166,r_320_234_123,r_342_348_154,0.62,3,157,154,41
118,r_69_89_180,seq140,r_335_270_60,r_69_89_180,1.0,0,180,180,41
60,r_80_213_36,r_369_131_138,seq1,r_80_213_36,0.96,0,36,36,41
51,r_46_58_86,r_112_204_106,r_82_269_70,r_46_58_86,0.99,-1,85,86,41
93,r_100_355_81,seq55,r_64_24_21,r_100_355_81,0.92,-16,65,81,41
24,r_361_325_40,r_368_184_165,seq169,r_361_325_40,1.0,0,40,40,41
74,r_362_97_55,r_257_153_53,seq72,r_257_153_53,1.0,-4,49,53,41
90,r_18_292_177,seq194,r_128_251_121,r_18_292_177,1.0,1,178,177,41
25,r_369_131_138,r_255_252_156,r_2_196_129,r_255_252_156,0.63,-6,150,156,41
63,r_330_156_101,r_195_170_185,seq15,r_330_156_101,1.0,0,101,101,41
5,r_368_184_165,seq243,r_128_251_121,r_368_184_165,1.0,0,165,165,41
166,seq129,r_192_83_142,r_149_38_56,r_149_38_56,1.0,1,57,56,41
73,r_302_59_72,r_339_341_78,seq169,r_339_341_78,0.91,-7,71,78,41
0,r_195_170_185,seq98,r_307_352_69,r_195_170_185,0.82,1,186,185,41
72,r_164_305_75,r_63_145_130,seq152,r_164_305_75,1.0,0,75,75,41
32,r_350_123_106,r_146_141_181,seq224,r_350_123_106,1.0,0,106,106,41
103,r_60_245_77,seq303,r_264_110_27,r_60_245_77,0.91,0,77,77,41
21,r_162_345_44,r_182_111_159,r_146_141_181,r_162_345_44,1.0,0,44,44,41
55,r_367_217_188,seq202,r_353_247_181,r_367_217_188,0.82,1,189,188,41
41,r_344_323_74,r_46_58_86,seq169,r_344_323_74,1.0,0,74,74,41
77,r_271_187_72,seq334,r_29_362_30,r_271_187_72,1.0,0,72,72,42
114,r_15_34_52,r_92_323_162,seq298,r_15_34_52,1.0,0,52,52,42
64,r_236_44_62,r_58_20_148,seq4,r_236_44_62,1.0,0,62,62,42
13,r_33_75_72,r_78_333_195,r_131_308_104,r_78_333_195,1.0,-120,75,195,42
96,r_157_147_42,r_22_134_100,seq118,r_157_147_42,1.0,0,42,42,42
239,seq356,r_279_70_161,r_325_339_26,r_279_70_161,0.76,0,161,161,42
114,r_15_34_52,seq298,r_320_31_128,r_320_31_128,1.0,13,141,128,42
45,r_189_146_178,r_279_70_161,r_243_72_72,r_243_72_72,1.0,45,117,72,42
23,r_131_308_104,r_33_75_72,r_294_9_115,r_294_9_115,0.77,9,124,115,42
3,r_325_339_26,r_278_182_69,seq356,r_325_339_26,0.96,0,26,26,42
56,r_96_76_141,r_120_178_147,r_265_53_133,r_265_53_133,0.58,8,141,133,42
91,r_69_45_86,r_355_349_178,r_196_370_161,r_69_45_86,1.0,1,87,86,42
121,r_348_66_32,r_10_14_141,seq90,r_348_66_32,1.0,0,32,32,42
90,r_123_184_90,r_67_275_3,seq101,r_123_184_90,1.0,0,90,90,42
89,r_102_156_144,r_92_323_162,r_24_244_2,r_102_156_144,1.0,0,144,144,42
20,r_92_323_162,seq48,r_29_362_30,r_92_323_162,1.0,0,162,162,42
39,r_278_182_69,r_196_370_161,seq8,r_278_182_69,1.0,-1,68,69,42
76,r_293_36_173,r_22_134_100,r_168_216_30,r_22_134_100,1.0,-21,79,100,42
67,r_224_180_163,seq260,r_67_275_3,r_224_180_163,1.0,0,163,163,42
82,r_196_370_161,r_69_45_86,r_144_322_19,r_196_370_161,1.0,0,161,161,42
16,r_206_61_84,seq87,seq115,r_206_61_84,1.0,0,84,84,42
11,r_162_373_74,seq130,r_157_147_42,r_162_373_74,1.0,0,74,74,42
118,r_203_175_139,seq57,seq145,r_203_175_139,1.0,0,139,139,42
43,r_284_7_136,seq43,seq365,r_284_7_136,1.0,1,137,136,42
38,r_106_30_70,seq65,seq39,r_106_30_70,1.0,0,70,70,42
70,r_212_247_43,r_106_30_70,seq217,r_212_247_43,1.0,0,43,43,42
48,r_84_88_132,r_197_121_191,seq215,r_84_88_132,1.0,0,132,132,42
117,r_142_366_53,r_0_268_109,r_120_178_147,r_142_366_53,1.0,0,53,53,42
115,r_38_21_50,r_284_7_136,seq108,r_38_21_50,1.0,0,50,50,42
88,r_149_112_75,r_279_70_161,r_307_297_51,r_149_112_75,0.88,0,75,75,42
94,r_290_222_103,seq39,r_238_300_71,r_290_222_103,0.82,0,103,103,42
22,r_10_14_141,seq208,r_193_317_26,r_10_14_141,1.0,0,141,141,42
28,r_257_371_138,seq73,r_179_62_198,r_257_371_138,1.0,0,138,138,42
197,seq215,r_274_292_61,r_340_27_68,r_274_292_61,0.82,0,61,61,42
229,seq318,r_119_183_157,r_199_266_26,r_119_183_157,1.0,1,158,157,42
69,r_77_321_188,seq372,r_144_322_19,r_77_321_188,1.0,0,188,188,42
82,r_196_370_161,r_278_182_69,r_226_19_165,r_278_182_69,1.0,0,69,69,42
37,r_151_117_48,r_123_184_90,seq41,r_151_117_48,1.0,0,48,48,42
55,r_306_246_83,r_92_323_162,seq104,r_306_246_83,1.0,0,83,83,42
101,r_241_353_123,seq63,r_170_177_73,r_170_177_73,0.73,62,135,73,42
117,r_142_366_53,r_120_178_147,r_47_52_34,r_120_178_147,1.0,0,147,147,42
54,r_168_216_30,r_293_36_173,r_354_11_60,r_293_36_173,1.0,8,181,173,42
60,r_159_161_30,r_103_240_111,seq57,r_159_161_30,0.92,0,30,30,42
112,r_170_177_73,seq110,seq214,r_170_177_73,1.0,0,73,73,42
79,r_25_225_21,r_179_62_198,seq208,r_25_225_21,0.99,0,21,21,42
0,r_354_11_60,seq97,r_168_216_30,r_354_11_60,1.0,0,60,60,42
31,r_51_220_62,r_241_353_123,seq98,r_51_220_62,1.0,0,62,62,42
35,r_243_72_72,r_92_323_162,r_157_147_42,r_243_72_72,0.91,0,72,72,42
104,r_304_113_18,r_92_323_162,r_105_127_18,r_304_113_18,1.0,0,18,18,42
8,r_193_317_26,r_319_262_173,seq263,r_193_317_26,0.64,8,34,26,42
59,r_340_27_68,r_288_337_190,seq17,r_340_27_68,1.0,0,68,68,42
105,r_105_127_18,r_49_285_103,r_304_113_18,r_105_127_18,0.99,0,18,18,42
86,r_119_183_157,seq318,r_151_117_48,r_119_183_157,1.0,1,158,157,42
45,r_189_146_178,r_243_72_72,r_29_362_30,r_189_146_178,0.99,2,180,178,42
83,r_270_188_17,r_92_323_162,r_295_37_7,r_270_188_17,0.96,0,17,17,42
30,r_294_9_115,r_0_268_109,r_131_308_104,r_294_9_115,0.97,0,115,115,42
52,r_80_289_8,r_49_285_103,r_23_154_65,r_80_289_8,0.53,96,104,8,42
12,r_109_141_77,seq116,r_307_297_51,r_109_141_77,0.78,18,95,77,42
91,r_69_45_86,r_196_370_161,r_206_61_84,r_196_370_161,1.0,0,161,161,42
99,r_47_52_34,r_226_19_165,seq372,r_47_52_34,1.0,1,35,34,42
123,r_231_280_19,r_29_362_30,r_78_333_195,r_231_280_19,0.98,0,19,19,42
116,r_79_341_141,r_78_333_195,r_193_317_26,r_79_341_141,0.83,2,143,141,42
129,seq12,seq215,r_135_269_9,r_135_269_9,0.55,67,76,9,42
76,r_293_36_173,r_168_216_30,r_243_72_72,r_168_216_30,0.5,151,181,30,42
82,r_196_370_161,r_226_19_165,r_69_45_86,r_69_45_86,0.99,-1,85,86,42
21,r_124_251_128,seq86,seq16,r_124_251_128,1.0,0,128,128,42
29,r_288_337_190,seq8,r_162_373_74,r_288_337_190,0.67,0,190,190,42
122,r_120_178_147,r_96_76_141,r_142_366_53,r_142_366_53,1.0,0,53,53,42
87,r_228_259_50,r_124_251_128,r_32_313_5,r_228_259_50,1.0,0,50,50,42
19,r_279_70_161,seq356,r_40_264_128,r_279_70_161,0.77,0,161,161,42
72,r_281_126_70,seq90,r_94_345_40,r_94_345_40,0.71,31,71,40,42
54,r_168_216_30,r_261_254_189,r_293_36_173,r_168_216_30,0.49,5,35,30,42
80,r_94_345_40,seq118,r_270_188_17,r_94_345_40,0.62,-3,37,40,42
129,seq12,r_135_269_9,r_49_285_103,r_135_269_9,0.93,92,101,9,42
156,seq98,r_77_321_188,r_51_220_62,r_51_220_62,1.0,10,72,62,42
42,r_358_291_39,r_204_335_193,seq130,r_358_291_39,1.0,1,40,39,42
63,r_319_262_173,seq17,r_226_19_165,r_319_262_173,1.0,0,173,173,42
81,r_221_165_83,seq63,seq296,r_221_165_83,1.0,1,84,83,42
119,r_347_68_115,seq90,r_315_55_24,r_347_68_115,1.0,0,115,115,42
85,r_331_194_85,seq298,seq239,r_331_194_85,0.78,14,99,85,42
103,r_71_342_19,r_162_373_74,seq298,r_71_342_19,0.8,0,19,19,42
171,seq137,seq213,r_50_163_19,r_50_163_19,0.97,0,19,19,42
7,r_155_26_172,seq82,r_226_19_165,r_155_26_172,1.0,0,172,172,42
6,r_226_19_165,seq95,r_58_20_148,r_226_19_165,1.0,1,166,165,42
78,r_40_264_128,r_119_183_157,seq145,r_40_264_128,1.0,0,128,128,42
98,r_274_292_61,seq215,r_29_362_30,r_274_292_61,1.0,0,61,61,42
160,seq108,seq42,r_38_21_50,r_38_21_50,1.0,3,53,50,42
57,r_361_100_54,r_319_262_173,seq223,r_319_262_173,0.89,-116,57,173,42
65,r_114_171_130,r_235_211_195,seq277,r_114_171_130,1.0,0,130,130,42
84,r_234_237_97,r_124_251_128,seq364,r_234_237_97,1.0,0,97,97,42
211,seq258,r_0_268_109,seq365,r_0_268_109,0.55,19,128,109,42
36,r_103_240_111,seq217,seq74,r_103_240_111,1.0,0,111,111,42
17,r_46_83_157,seq360,r_307_297_51,r_307_297_51,0.76,110,161,51,42
47,r_22_134_100,r_157_147_42,r_293_36_173,r_157_147_42,0.98,0,42,42,42
10,r_192_344_86,seq65,r_78_333_195,r_192_344_86,1.0,0,86,86,42
92,r_301_186_133,seq16,r_331_194_85,r_301_186_133,1.0,2,135,133,42
9,r_307_297_51,r_281_126_70,r_59_99_19,r_307_297_51,0.82,0,51,51,42
68,r_133_81_109,seq207,seq65,r_133_81_109,1.0,0,109,109,42
15,r_167_250_77,seq4,seq137,r_167_250_77,1.0,0,77,77,42
122,r_120_178_147,r_142_366_53,seq158,r_120_178_147,0.99,0,147,147,42
33,r_199_266_26,r_92_323_162,r_304_113_18,r_199_266_26,0.67,1,27,26,42
27,r_238_300_71,r_221_165_83,r_281_126_70,r_238_300_71,1.0,0,71,71,42
108,r_265_53_133,r_288_337_190,seq356,r_265_53_133,0.95,-3,130,133,42
23,r_131_308_104,r_248_276_145,r_33_75_72,r_131_308_104,0.81,0,104,104,42
27,r_238_300_71,r_281_126_70,r_290_222_103,r_290_222_103,1.0,38,141,103,42
75,r_355_349_178,seq368,r_226_19_165,r_355_349_178,1.0,2,180,178,42
189,seq198,seq173,r_0_268_109,r_0_268_109,0.99,12,121,109,42
41,r_144_322_19,r_131_308_104,seq97,r_144_322_19,0.94,0,19,19,42
34,r_320_31_128,seq169,r_15_34_52,r_320_31_128,0.94,0,128,128,42
18,r_49_285_103,r_105_127_18,r_80_289_8,r_49_285_103,0.83,-93,10,103,42
128,seq8,r_288_337_190,r_278_182_69,r_278_182_69,1.0,61,130,69,42
46,r_261_254_189,seq104,r_29_362_30,r_261_254_189,0.92,0,189,189,42
62,r_129_343_91,r_131_308_104,r_78_333_195,r_131_308_104,0.97,-30,74,104,42
51,r_338_1_112,r_203_175_139,r_29_362_30,r_338_1_112,1.0,0,112,112,42
26,r_166_272_130,seq150,seq351,r_166_272_130,0.8,-7,123,130,42
47,r_22_134_100,r_293_36_173,r_29_362_30,r_22_134_100,1.0,0,100,100,42
248,seq372,r_77_321_188,r_47_52_34,r_77_321_188,1.0,0,188,188,42
18,r_49_285_103,r_80_289_8,seq17,r_49_285_103,0.75,0,103,103,42
97,r_315_55_24,r_320_31_128,seq185,r_315_55_24,1.0,0,24,24,42
95,r_18_195_51,r_283_327_192,r_23_154_65,r_18_195_51,1.0,0,51,51,42
5,r_29_362_30,r_238_300_71,seq260,r_238_300_71,1.0,-37,34,71,42
4,r_242_252_86,seq118,r_236_44_62,r_242_252_86,1.0,0,86,86,42
61,r_282_56_13,r_283_327_192,seq185,r_282_56_13,0.99,0,13,13,42
73,r_233_369_83,seq312,r_78_333_195,r_233_369_83,1.0,0,83,83,42
100,r_0_268_109,seq258,seq198,r_0_268_109,0.99,8,117,109,42
110,r_248_276_145,seq2,r_151_117_48,r_248_276_145,1.0,0,145,145,42
24,r_151_240_36,r_71_342_127,seq368,r_151_240_36,1.0,0,36,36,43
2,r_317_44_105,r_60_18_162,r_306_371_73,r_317_44_105,1.0,1,106,105,43
97,r_206_53_116,seq181,seq186,r_206_53_116,0.92,0,116,116,43
37,r_305_119_15,r_145_97_198,seq61,r_305_119_15,0.94,1,16,15,43
59,r_275_284_188,r_325_194_164,r_83_141_105,r_275_284_188,0.95,-24,164,188,43
231,seq302,r_1_352_150,r_114_40_54,r_1_352_150,0.69,-67,83,150,43
42,r_310_9_87,seq264,seq186,r_310_9_87,0.94,-1,86,87,43
77,r_299_175_17,seq30,seq131,r_299_175_17,1.0,1,18,17,43
19,r_71_342_127,seq373,seq30,r_71_342_127,1.0,-1,126,127,43
48,r_218_128_30,r_374_12_180,seq86,r_218_128_30,1.0,0,30,30,43
63,r_63_24_123,r_1_352_150,seq157,r_1_352_150,1.0,-23,127,150,43
201,seq220,r_144_280_166,r_304_262_33,r_144_280_166,0.94,0,166,166,43
67,r_111_326_169,seq193,r_27_249_161,r_111_326_169,1.0,1,170,169,43
79,r_295_316_78,seq199,r_305_119_15,r_295_316_78,0.9,-2,76,78,43
56,r_338_82_151,r_255_259_191,r_195_37_44,r_338_82_151,0.92,4,155,151,43
105,r_57_154_33,r_83_141_105,seq89,r_57_154_33,1.0,-1,32,33,43
66,r_147_127_115,r_206_53_116,r_135_214_88,r_147_127_115,1.0,0,115,115,43
122,r_161_221_15,r_356_236_57,seq30,r_161_221_15,1.0,1,16,15,43
50,r_325_194_164,r_275_284_188,r_356_236_57,r_325_194_164,1.0,0,164,164,43
39,r_150_269_69,r_320_319_155,r_247_294_32,r_150_269_69,1.0,0,69,69,43
65,r_67_257_105,r_102_308_107,seq105,r_67_257_105,0.99,0,105,105,43
107,r_87_323_49,r_42_79_195,seq91,r_87_323_49,1.0,0,49,49,43
160,seq108,r_362_253_190,r_296_292_115,r_296_292_115,0.57,75,190,115,43
111,r_366_353_175,r_14_5_193,r_136_234_171,r_366_353_175,1.0,0,175,175,43
61,r_258_369_7,r_347_25_171,r_81_170_7,r_258_369_7,0.57,3,10,7,43
21,r_33_238_46,r_362_253_190,r_242_148_36,r_33_238_46,1.0,-1,45,46,43
92,r_362_253_190,seq108,r_166_106_36,r_166_106_36,0.63,154,190,36,43
64,r_230_277_138,r_350_267_147,r_281_98_20,r_230_277_138,1.0,0,138,138,43
25,r_117_324_138,r_338_82_151,seq103,r_117_324_138,1.0,0,138,138,43
10,r_136_234_171,seq180,r_372_333_62,r_136_234_171,1.0,0,171,171,43
69,r_265_303_136,r_365_159_199,r_243_331_66,r_265_303_136,1.0,1,137,136,43
13,r_363_343_160,seq297,r_165_115_92,r_363_343_160,1.0,0,160,160,43
110,r_92_367_132,seq38,seq16,r_92_367_132,1.0,3,135,132,43
38,r_162_254_79,r_110_272_171,r_49_349_71,r_162_254_79,1.0,0,79,79,43
119,r_139_197_13,r_363_343_160,r_242_148_36,r_139_197_13,0.99,1,14,13,43
40,r_130_75_29,r_162_254_79,r_161_221_15,r_130_75_29,0.95,0,29,29,43
120,r_60_18_162,r_317_44_105,seq199,r_317_44_105,1.0,1,106,105,43
124,r_90_260_178,seq261,r_166_106_36,r_90_260_178,1.0,0,178,178,43
60,r_203_278_95,r_363_343_160,r_242_148_36,r_203_278_95,1.0,-3,92,95,43
83,r_250_95_85,seq172,seq6,r_250_95_85,0.47,-9,76,85,43
118,r_174_169_53,r_372_333_62,r_163_202_169,r_174_169_53,1.0,0,53,53,43
62,r_337_122_103,seq70,r_212_121_192,r_337_122_103,1.0,0,103,103,43
80,r_101_196_161,seq61,r_372_333_62,r_101_196_161,1.0,0,161,161,43
76,r_335_35_70,r_145_97_198,r_252_146_33,r_335_35_70,1.0,0,70,70,43
118,r_174_169_53,r_163_202_169,r_189_84_110,r_174_169_53,0.93,105,158,53,43
28,r_229_246_17,seq368,r_145_97_198,r_229_246_17,0.91,3,20,17,43
55,r_31_58_58,r_189_84_110,r_305_119_15,r_31_58_58,1.0,0,58,58,43
74,r_347_25_171,r_109_100_85,r_305_119_15,r_305_119_15,0.75,71,86,15,43
120,r_60_18_162,seq199,r_8_187_8,r_60_18_162,0.77,4,166,162,43
73,r_190_322_50,r_345_39_155,r_87_323_49,r_345_39_155,0.98,-105,50,155,43
27,r_102_308_107,seq233,seq108,r_102_308_107,1.0,1,108,107,43
7,r_212_121_192,seq6,r_337_122_103,r_337_122_103,0.95,8,111,103,43
81,r_360_13_158,r_330_116_172,r_114_40_54,r_360_13_158,1.0,0,158,158,43
96,r_357_29_36,r_42_79_195,seq4,r_357_29_36,1.0,0,36,36,43
1,r_83_141_105,r_358_46_170,r_49_349_71,r_83_141_105,1.0,1,106,105,43
122,r_161_221_15,seq30,r_346_51_83,r_346_51_83,1.0,3,86,83,43
6,r_73_167_120,seq273,r_300_329_27,r_73_167_120,1.0,1,121,120,43
51,r_49_349_71,seq200,seq4,r_49_349_71,1.0,0,71,71,43
46,r_50_312_48,r_28_191_49,r_8_187_8,r_8_187_8,1.0,40,48,8,43
116,r_374_12_180,r_362_253_190,r_346_51_83,r_374_12_180,0.95,0,180,180,43
36,r_69_164_131,r_43_332_177,r_81_170_7,r_69_164_131,0.81,4,135,131,43
52,r_328_226_67,seq126,seq309,r_328_226_67,0.98,-15,52,67,43
54,r_94_36_114,r_90_260_178,seq232,r_94_36_114,0.99,0,114,114,43
101,r_163_202_169,seq298,r_136_234_171,r_163_202_169,1.0,2,171,169,43
75,r_110_272_171,seq155,r_265_303_136,r_110_272_171,0.72,0,171,171,43
15,r_304_262_33,r_117_324_138,seq22,r_304_262_33,1.0,0,33,33,43
89,r_54_19_170,seq86,r_179_140_144,r_54_19_170,0.93,1,171,170,43
94,r_144_280_166,seq220,seq38,r_144_280_166,1.0,0,166,166,43
106,r_47_96_125,r_117_324_138,r_304_262_33,r_47_96_125,1.0,0,125,125,43
34,r_296_292_115,r_365_159_199,seq108,r_296_292_115,1.0,1,116,115,43
178,seq172,r_250_95_85,seq289,r_250_95_85,0.9,43,128,85,43
26,r_179_140_144,r_42_79_195,r_67_257_105,r_179_140_144,0.76,1,145,144,43
114,r_1_352_150,r_188_59_195,r_92_367_132,r_1_352_150,1.0,0,150,150,43
31,r_28_191_49,r_209_227_194,seq307,r_28_191_49,1.0,0,49,49,43
99,r_313_318_158,seq3,r_71_342_127,r_313_318_158,1.0,1,159,158,43
121,r_109_100_85,r_347_25_171,seq89,r_109_100_85,0.87,1,86,85,43
135,seq22,r_145_97_198,r_304_262_33,r_304_262_33,1.0,7,40,33,43
82,r_177_223_172,seq239,seq38,r_177_223_172,1.0,0,172,172,43
88,r_252_146_33,seq180,seq233,r_252_146_33,0.89,-1,32,33,43
74,r_347_25_171,r_305_119_15,r_136_234_171,r_347_25_171,1.0,0,171,171,43
85,r_43_332_177,seq291,r_27_249_161,r_43_332_177,1.0,1,178,177,43
33,r_120_215_100,r_276_228_128,r_130_75_29,r_130_75_29,0.54,72,101,29,43
117,r_327_26_46,r_330_116_172,seq32,r_327_26_46,0.98,0,46,46,43
29,r_123_138_144,seq34,r_304_262_33,r_123_138_144,1.0,2,146,144,43
108,r_45_52_191,r_17_137_112,seq244,r_17_137_112,1.0,0,112,112,43
44,r_345_39_155,seq15,r_57_154_33,r_345_39_155,0.69,3,158,155,43
0,r_118_10_74,seq6,r_41_270_2,r_118_10_74,1.0,-2,72,74,43
4,r_166_106_36,r_372_333_62,seq6,r_166_106_36,1.0,0,36,36,43
14,r_243_331_66,r_49_349_71,seq61,r_49_349_71,0.82,-20,51,71,43
53,r_276_228_128,seq4,seq132,r_276_228_128,1.0,0,128,128,43
49,r_350_267_147,seq341,r_305_119_15,r_350_267_147,1.0,0,147,147,43
115,r_256_134_178,r_248_315_186,r_177_223_172,r_256_134_178,0.99,2,180,178,43
43,r_143_198_143,seq72,seq160,r_143_198_143,0.92,0,143,143,43
70,r_135_214_88,r_145_97_198,seq180,r_135_214_88,1.0,0,88,88,43
112,r_248_315_186,seq88,seq160,r_248_315_186,1.0,0,186,186,43
17,r_372_333_62,seq16,r_242_148_36,r_372_333_62,1.0,-2,60,62,43
3,r_358_46_170,seq20,r_304_262_33,r_358_46_170,1.0,1,171,170,43
123,r_114_40_54,r_42_79_195,seq274,r_114_40_54,0.96,-3,51,54,43
9,r_346_51_83,r_276_228_128,r_161_221_15,r_161_221_15,0.58,68,83,15,43
95,r_281_98_20,r_73_167_120,seq4,r_281_98_20,0.95,0,20,20,43
104,r_245_293_21,r_120_215_100,seq34,r_245_293_21,1.0,0,21,21,43
84,r_189_84_110,r_300_329_27,r_174_169_53,r_189_84_110,1.0,0,110,110,43
59,r_275_284_188,r_83_141_105,r_243_331_66,r_275_284_188,0.47,0,188,188,43
91,r_65_74_29,r_330_116_172,seq34,r_65_74_29,0.65,0,29,29,43
132,seq16,r_351_216_193,r_92_367_132,r_92_367_132,1.0,6,138,132,43
57,r_168_237_96,seq38,seq314,r_168_237_96,1.0,0,96,96,43
23,r_62_64_48,seq125,seq173,r_62_64_48,1.0,0,48,48,43
71,r_165_115_92,r_92_367_132,seq129,r_165_115_92,1.0,1,93,92,43
32,r_17_137_112,r_45_52_191,r_317_44_105,r_17_137_112,1.0,0,112,112,43
147,seq70,r_337_122_103,r_304_262_33,r_337_122_103,0.97,0,103,103,43
41,r_247_294_32,r_83_141_105,seq78,r_247_294_32,1.0,0,32,32,43
241,seq344,r_330_116_172,r_207_271_8,r_330_116_172,0.98,-152,20,172,43
87,r_205_0_30,r_250_95_85,r_242_148_36,r_205_0_30,1.0,2,32,30,43
18,r_107_158_89,seq124,r_150_269_69,r_107_158_89,1.0,-1,88,89,43
45,r_195_37_44,r_320_319_155,r_93_133_4,r_195_37_44,1.0,0,44,44,43
59,r_164_278_100,seq57,r_255_105_45,r_255_105_45,0.84,76,121,45,44
109,r_39_101_118,r_116_246_142,r_183_163_112,r_116_246_142,1.0,-24,118,142,44
2,r_243_331_65,seq158,seq83,r_243_331_65,1.0,6,71,65,44
95,r_60_82_62,r_157_84_177,r_316_239_164,r_60_82_62,0.76,100,162,62,44
86,r_288_342_106,seq142,r_255_105_45,r_255_105_45,0.6,73,118,45,44
124,r_273_9_160,seq303,seq360,r_273_9_160,1.0,0,160,160,44
36,r_236_177_137,r_261_192_198,seq98,r_236_177_137,1.0,0,137,137,44
82,r_346_134_13,r_35_218_72,seq66,r_346_134_13,1.0,0,13,13,44
104,r_254_230_94,r_44_224_2,r_346_134_13,r_254_230_94,1.0,0,94,94,44
6,r_282_294_25,r_322_215_178,r_351_34_130,r_282_294_25,1.0,152,177,25,44
90,r_76_200_48,r_297_257_181,r_168_92_49,r_168_92_49,1.0,1,50,49,44
236,seq338,r_238_336_113,r_68_37_104,r_68_37_104,0.97,3,107,104,44
20,r_357_38_131,r_223_5_81,seq125,r_357_38_131,0.97,3,134,131,44
49,r_235_30_97,seq158,r_370_122_15,r_235_30_97,1.0,3,100,97,44
42,r_238_336_113,seq338,seq291,r_238_336_113,0.86,-2,111,113,44
80,r_50_314_155,seq291,r_173_112_39,r_50_314_155,0.93,1,156,155,44
69,r_25_337_19,r_184_46_194,seq89,r_25_337_19,0.58,80,99,19,44
114,r_144_198_124,r_265_325_165,seq61,r_144_198_124,1.0,0,124,124,44
24,r_297_257_181,seq171,r_335_203_97,r_297_257_181,0.99,0,181,181,44
60,r_19_260_20,r_96_361_139,r_334_120_49,r_19_260_20,0.89,1,21,20,44
75,r_259_130_43,r_54_4_162,r_119_258_24,r_259_130_43,0.86,0,43,43,44
73,r_161_15_58,seq7,r_184_46_194,r_161_15_58,0.69,1,59,58,44
108,r_116_246_142,r_297_257_181,r_286_106_58,r_116_246_142,0.99,4,146,142,44
111,r_58_315_52,seq3,seq114,r_58_315_52,1.0,0,52,52,44
21,r_21_279_163,seq301,r_176_141_94,r_176_141_94,0.51,69,163,94,44
62,r_136_14_66,r_322_215_178,seq47,r_136_14_66,1.0,0,66,66,44
141,seq57,r_164_278_100,r_286_106_58,r_286_106_58,1.0,63,121,58,44
14,r_335_203_97,r_117_253_117,seq149,r_335_203_97,0.85,0,97,97,44
176,seq152,seq142,r_326_227_50,r_326_227_50,1.0,9,59,50,44
31,r_157_84_177,r_352_11_196,r_326_227_50,r_157_84_177,0.44,-31,146,177,44
71,r_103_270_117,seq51,seq59,r_103_270_117,1.0,0,117,117,44
8,r_26_321_21,r_108_319_151,seq194,r_26_321_21,1.0,0,21,21,44
122,r_168_92_49,r_229_232_181,r_76_200_48,r_168_92_49,1.0,0,49,49,44
169,seq140,r_100_276_187,seq313,r_100_276_187,0.94,0,187,187,44
68,r_132_41_183,r_221_309_194,r_60_82_62,r_132_41_183,0.92,0,183,183,44
30,r_118_340_81,seq188,seq358,r_118_340_81,1.0,0,81,81,44
107,r_348_63_158,seq330,r_103_270_117,r_348_63_158,0.76,0,158,158,44
123,r_299_371_160,r_297_257_181,seq110,r_297_257_181,0.93,-21,160,181,44
230,seq308,seq91,r_255_105_45,r_255_105_45,1.0,34,79,45,44
234,seq330,r_348_63_158,seq211,r_348_63_158,1.0,0,158,158,44
102,r_316_239_164,seq53,r_44_224_2,r_316_239_164,0.7,12,176,164,44
51,r_27_109_45,r_327_355_151,r_77_148_102,r_27_109_45,1.0,0,45,45,44
97,r_196_187_165,seq149,r_99_150_22,r_196_187_165,0.76,1,166,165,44
178,seq158,r_243_331_65,r_35_218_72,r_243_331_65,0.79,6,71,65,44
44,r_10_283_23,seq341,seq70,r_10_283_23,0.99,1,24,23,44
79,r_102_28_19,r_176_141_94,seq301,r_102_28_19,0.99,1,20,19,44
78,r_202_372_177,seq13,r_12_267_145,r_202_372_177,0.99,0,177,177,44
120,r_274_263_146,r_135_126_195,seq269,r_135_126_195,0.7,-37,158,195,44
48,r_256_339_53,seq233,seq249,r_256_339_53,0.93,2,55,53,44
232,seq313,r_202_372_177,seq140,r_202_372_177,1.0,-17,160,177,44
76,r_333_180_33,r_68_37_104,seq155,r_68_37_104,0.98,-66,38,104,44
28,r_99_150_22,r_272_264_89,seq179,r_272_264_89,0.88,-64,25,89,44
12,r_326_227_50,r_217_153_189,seq152,r_326_227_50,1.0,0,50,50,44
85,r_156_86_184,seq364,r_255_105_45,r_156_86_184,0.97,0,184,184,44
52,r_184_46_194,r_318_22_26,r_161_15_58,r_318_22_26,0.99,0,26,26,44
91,r_42_191_40,r_272_264_89,seq147,r_42_191_40,1.0,0,40,40,44
105,r_183_163_112,r_266_189_174,r_245_71_65,r_183_163_112,1.0,0,112,112,44
34,r_167_356_67,r_334_120_49,seq194,r_167_356_67,1.0,1,68,67,44
117,r_225_365_60,r_268_271_113,seq93,r_225_365_60,0.65,0,60,60,44
9,r_190_324_143,seq98,r_119_258_24,r_190_324_143,1.0,1,144,143,44
37,r_33_237_89,seq213,seq0,r_33_237_89,1.0,1,90,89,44
19,r_221_309_194,r_132_41_183,r_282_294_25,r_132_41_183,0.77,-27,156,183,44
16,r_68_37_104,r_204_48_195,seq338,r_68_37_104,1.0,0,104,104,44
7,r_119_258_24,seq142,r_274_263_146,r_119_258_24,0.84,1,25,24,44
163,seq114,seq194,r_58_315_52,r_58_315_52,1.0,0,52,52,44
195,seq211,r_79_90_171,seq330,r_79_90_171,1.0,0,171,171,44
5,r_216_201_109,r_2_277_141,seq146,r_216_201_109,1.0,0,109,109,44
96,r_275_197_38,r_236_177_137,seq83,r_275_197_38,1.0,0,38,38,44
103,r_223_5_81,r_265_325_165,r_99_150_22,r_223_5_81,0.82,48,129,81,44
50,r_272_264_89,r_196_187_165,seq269,r_272_264_89,1.0,1,90,89,44
1,r_44_224_2,r_254_230_94,r_157_84_177,r_254_230_94,1.0,0,94,94,44
46,r_322_215_178,r_282_294_25,r_58_315_52,r_322_215_178,0.92,0,178,178,44
55,r_129_345_119,r_132_41_183,r_117_253_117,r_129_345_119,0.82,0,119,119,44
45,r_219_17_151,seq166,r_193_195_6,r_219_17_151,1.0,0,151,151,44
121,r_45_159_48,r_273_9_160,seq146,r_45_159_48,1.0,0,48,48,44
69,r_25_337_19,seq140,r_184_46_194,r_25_337_19,1.0,1,20,19,44
27,r_169_143_99,seq94,r_102_28_19,r_169_143_99,1.0,0,99,99,44
74,r_2_277_141,seq59,seq205,r_2_277_141,1.0,1,142,141,44
6,r_282_294_25,r_190_324_143,r_322_215_178,r_282_294_25,0.93,0,25,25,44
242,seq358,seq160,r_118_340_81,r_118_340_81,1.0,16,97,81,44
118,r_100_276_187,seq140,r_327_355_151,r_100_276_187,0.7,0,187,187,44
32,r_127_220_133,seq280,r_245_71_65,r_127_220_133,1.0,1,134,133,44
23,r_16_362_61,r_113_311_195,r_27_109_45,r_16_362_61,1.0,0,61,61,44
15,r_245_71_65,r_135_126_195,r_370_122_15,r_245_71_65,1.0,0,65,65,44
13,r_117_253_117,seq207,r_129_345_119,r_117_253_117,0.85,6,123,117,44
87,r_286_106_58,seq128,seq57,r_286_106_58,1.0,0,58,58,44
3,r_186_65_47,r_265_325_165,seq57,r_186_65_47,1.0,0,47,47,44
84,r_35_218_72,seq165,seq158,r_35_218_72,0.87,-4,68,72,44
0,r_173_112_39,r_242_214_126,seq70,r_173_112_39,0.95,0,39,39,44
112,r_139_8_79,r_60_82_62,r_99_150_22,r_139_8_79,1.0,0,79,79,44
83,r_115_349_27,seq179,seq40,r_115_349_27,0.92,0,27,27,44
119,r_229_232_181,seq0,r_327_355_151,r_229_232_181,0.89,3,184,181,44
1,r_44_224_2,r_157_84_177,r_316_239_164,r_44_224_2,0.67,160,162,2,44
47,r_255_105_45,r_298_199_191,seq308,r_255_105_45,1.0,0,45,45,44
64,r_64_320_20,r_297_257_181,seq251,r_64_320_20,0.9,1,21,20,44
4,r_327_355_151,seq233,seq52,r_327_355_151,0.84,4,155,151,44
35,r_80_1_108,seq56,r_343_154_105,r_80_1_108,1.0,0,108,108,44
72,r_206_62_181,r_326_227_50,r_77_148_102,r_206_62_181,0.97,0,181,181,44
95,r_60_82_62,r_167_356_67,r_157_84_177,r_167_356_67,0.91,-3,64,67,44
94,r_343_154_105,r_164_278_100,r_80_1_108,r_80_1_108,0.58,32,140,108,44
106,r_87_373_145,seq165,r_2_277_141,r_87_373_145,1.0,0,145,145,44
46,r_322_215_178,r_136_14_66,r_282_294_25,r_136_14_66,0.99,0,66,66,44
100,r_43_374_115,seq293,r_118_340_81,r_43_374_115,1.0,0,115,115,44
72,r_206_62_181,r_12_267_145,r_326_227_50,r_206_62_181,0.97,-42,139,181,44
70,r_12_267_145,r_206_62_181,r_35_218_72,r_12_267_145,1.0,-2,143,145,44
18,r_96_361_139,r_75_310_151,seq213,r_96_361_139,1.0,3,142,139,44
99,r_285_133_165,seq360,r_286_106_58,r_285_133_165,1.0,0,165,165,44
67,r_137_175_95,r_117_253_117,r_31_36_4,r_137_175_95,1.0,0,95,95,44
39,r_69_32_121,seq251,r_242_214_126,r_69_32_121,1.0,0,121,121,44
33,r_318_22_26,r_184_46_194,seq59,r_318_22_26,1.0,0,26,26,44
92,r_178_228_106,seq369,r_242_214_126,r_178_228_106,1.0,0,106,106,44
246,seq364,r_156_86_184,r_327_355_151,r_156_86_184,1.0,0,184,184,44
38,r_296_23_54,r_161_15_58,seq280,r_296_23_54,1.0,4,58,54,44
22,r_54_4_162,seq51,r_136_14_66,r_54_4_162,0.99,2,164,162,44
190,seq194,seq20,r_26_321_21,r_26_321_21,0.99,43,64,21,44
26,r_351_34_130,seq57,r_282_294_25,r_351_34_130,1.0,0,130,130,44
89,r_138_49_34,r_216_201_109,r_334_120_49,r_138_49_34,1.0,0,34,34,44
11,r_176_141_94,r_164_278_100,seq70,r_176_141_94,1.0,0,94,94,44
113,r_268_271_113,seq18,r_346_134_13,r_268_271_113,1.0,0,113,113,44
59,r_210_274_30,seq34,seq290,r_210_274_30,1.0,0,30,30,45
55,r_55_66_16,r_120_143_180,seq145,r_55_66_16,1.0,0,16,16,45
94,r_85_285_18,r_259_146_119,r_51_163_179,r_85_285_18,0.98,0,18,18,45
40,r_100_272_155,r_293_336_157,r_283_194_61,r_293_336_157,1.0,0,157,157,45
86,r_299_343_163,r_310_19_8,r_168_78_8,r_299_343_163,1.0,0,163,163,45
21,r_8_356_17,r_113_226_50,seq245,r_8_356_17,0.76,0,17,17,45
108,r_326_286_164,seq180,r_86_289_121,r_326_286_164,0.98,0,164,164,45
114,r_297_98_160,r_133_40_189,seq110,r_133_40_189,0.58,-27,162,189,45
123,r_99_63_158,seq54,seq142,r_99_63_158,0.8,8,166,158,45
34,r_271_127_24,r_231_131_184,r_151_288_188,r_271_127_24,0.97,0,24,24,45
0,r_340_150_171,seq234,r_89_123_69,r_340_150_171,1.0,0,171,171,45
72,r_16_149_153,seq96,r_13_49_27,r_16_149_153,1.0,0,153,153,45
30,r_83_215_151,seq243,r_126_305_109,r_83_215_151,1.0,0,151,151,45
208,seq267,r_366_223_80,seq348,r_366_223_80,1.0,0,80,80,45
32,r_176_56_180,seq264,r_195_260_25,r_176_56_180,0.99,2,182,180,45
46,r_334_331_137,r_179_112_165,seq73,r_334_331_137,1.0,0,137,137,45
82,r_141_5_63,r_10_117_95,r_164_190_21,r_141_5_63,1.0,0,63,63,45
66,r_317_11_39,r_212_329_96,seq216,r_317_11_39,0.71,1,40,39,45
64,r_126_305_109,r_148_87_198,r_212_329_96,r_148_87_198,1.0,-89,109,198,45
14,r_86_289_121,seq45,r_341_268_128,r_86_289_121,1.0,2,123,121,45
61,r_206_355_96,r_293_336_157,seq95,r_206_355_96,1.0,0,96,96,45
110,r_82_134_164,seq156,seq6,r_82_134_164,0.82,1,165,164,45
53,r_37_244_136,r_75_121_20,r_74_364_58,r_37_244_136,0.92,4,140,136,45
102,r_107_130_108,seq311,r_22_320_39,r_107_130_108,1.0,1,109,108,45
197,seq243,r_144_192_189,r_140_300_52,r_144_192_189,0.92,0,189,189,45
124,r_27_228_153,r_148_87_198,r_319_30_118,r_27_228_153,1.0,0,153,153,45
8,r_17_241_18,r_144_192_189,r_259_146_119,r_17_241_18,1.0,0,18,18,45
36,r_77_312_104,r_26_362_91,seq284,r_77_312_104,0.76,-13,91,104,45
100,r_135_52_84,r_126_305_109,seq229,r_126_305_109,1.0,-13,96,109,45
122,r_341_268_128,seq230,r_86_289_121,r_341_268_128,1.0,1,129,128,45
117,r_350_199_189,seq262,r_17_241_18,r_350_199_189,0.96,0,189,189,45
42,r_122_103_98,seq6,r_55_66_16,r_122_103_98,1.0,0,98,98,45
115,r_200_217_99,r_307_94_19,r_28_207_5,r_307_94_19,0.73,1,20,19,45
115,r_200_217_99,r_28_207_5,seq79,r_200_217_99,1.0,0,99,99,45
86,r_299_343_163,r_231_131_184,r_310_19_8,r_310_19_8,1.0,10,18,8,45
214,seq290,seq315,r_210_274_30,r_210_274_30,1.0,24,54,30,45
31,r_224_101_107,r_179_112_165,seq91,r_224_101_107,1.0,0,107,107,45
1,r_140_300_52,seq153,r_302_237_137,r_140_300_52,1.0,0,52,52,45
58,r_239_323_46,seq233,r_281_3_36,r_239_323_46,0.99,0,46,46,45
93,r_250_352_63,seq92,seq153,r_250_352_63,1.0,0,63,63,45
56,r_166_197_149,seq115,r_140_300_52,r_166_197_149,1.0,0,149,149,45
183,seq204,seq25,r_168_78_8,r_168_78_8,0.97,20,28,8,45
9,r_184_24_33,seq275,seq90,r_184_24_33,1.0,-1,32,33,45
95,r_26_362_91,r_77_312_104,seq104,r_26_362_91,0.86,0,91,91,45
51,r_22_320_39,r_256_238_193,seq124,r_22_320_39,0.86,4,43,39,45
26,r_4_111_134,seq348,seq54,r_4_111_134,0.66,7,141,134,45
84,r_368_247_92,r_326_286_164,seq36,r_368_247_92,1.0,0,92,92,45
81,r_256_238_193,seq208,r_8_356_17,r_256_238_193,0.66,-3,190,193,45
69,r_195_260_25,r_51_163_179,r_259_146_119,r_195_260_25,1.0,-1,24,25,45
19,r_231_131_184,seq90,seq235,r_231_131_184,0.68,1,185,184,45
88,r_75_121_20,r_37_244_136,r_109_213_71,r_75_121_20,0.93,147,167,20,45
12,r_367_187_94,r_86_289_121,r_210_274_30,r_367_187_94,1.0,0,94,94,45
33,r_293_336_157,r_100_272_155,r_8_356_17,r_293_336_157,1.0,0,157,157,45
10,r_160_171_159,r_67_2_78,seq70,r_160_171_159,0.57,-80,79,159,45
78,r_151_288_188,r_100_272_155,r_271_127_24,r_271_127_24,1.0,48,72,24,45
74,r_51_163_179,r_85_285_18,r_179_112_165,r_51_163_179,1.0,1,180,179,45
35,r_109_213_71,r_309_62_192,seq70,r_109_213_71,1.0,0,71,71,45
39,r_270_276_133,seq290,seq348,r_270_276_133,1.0,0,133,133,45
29,r_330_252_178,seq321,r_126_305_109,r_330_252_178,1.0,0,178,178,45
118,r_105_258_32,r_326_286_164,seq36,r_105_258_32,1.0,0,32,32,45
85,r_310_19_8,r_327_172_175,r_299_343_163,r_310_19_8,0.99,2,10,8,45
77,r_303_129_119,seq142,r_164_190_21,r_303_129_119,1.0,0,119,119,45
67,r_155_20_18,r_345_84_130,seq294,r_155_20_18,0.93,0,18,18,45
237,seq348,r_4_111_134,r_270_276_133,r_270_276_133,1.0,8,141,133,45
13,r_366_223_80,seq267,r_17_241_18,r_366_223_80,1.0,0,80,80,45
88,r_75_121_20,r_327_172_175,r_37_244_136,r_75_121_20,1.0,0,20,20,45
75,r_89_123_69,r_47_346_80,r_148_87_198,r_89_123_69,1.0,0,69,69,45
142,seq65,r_335_57_128,r_302_237_137,r_335_57_128,1.0,2,130,128,45
105,r_283_194_61,r_0_7_112,seq249,r_0_7_112,0.71,-52,60,112,45
38,r_338_242_158,seq196,seq332,r_338_242_158,0.8,1,159,158,45
234,seq337,r_31_339_187,r_327_172_175,r_31_339_187,1.0,0,187,187,45
92,r_116_198_23,r_133_40_189,seq29,r_116_198_23,1.0,0,23,23,45
169,seq145,r_23_220_126,r_55_66_16,r_55_66_16,0.98,30,46,16,45
74,r_51_163_179,r_195_260_25,r_85_285_18,r_51_163_179,0.94,-155,24,179,45
28,r_345_84_130,seq132,r_239_323_46,r_345_84_130,0.95,0,130,130,45
53,r_37_244_136,r_160_171_159,r_75_121_20,r_75_121_20,1.0,7,27,20,45
191,seq229,r_51_163_179,r_76_354_31,r_76_354_31,1.0,2,33,31,45
111,r_41_97_168,seq216,r_50_81_52,r_41_97_168,0.91,1,169,168,45
47,r_108_61_107,r_144_192_189,seq262,r_108_61_107,1.0,0,107,107,45
79,r_281_3_36,r_160_171_159,r_239_323_46,r_281_3_36,0.66,2,38,36,45
63,r_302_237_137,r_140_300_52,seq65,r_302_237_137,0.92,2,139,137,45
129,seq25,seq204,r_178_1_22,r_178_1_22,1.0,27,49,22,45
107,r_178_1_22,r_160_171_159,seq25,r_178_1_22,1.0,0,22,22,45
121,r_261_157_108,seq70,seq209,r_261_157_108,1.0,0,108,108,45
57,r_186_201_132,seq29,r_106_273_129,r_186_201_132,1.0,0,132,132,45
85,r_310_19_8,r_299_343_163,r_184_24_33,r_310_19_8,0.8,106,114,8,45
15,r_152_162_156,r_88_269_160,r_259_146_119,r_152_162_156,1.0,0,156,156,45
8,r_17_241_18,r_259_146_119,r_366_223_80,r_17_241_18,0.98,86,104,18,45
6,r_179_112_165,r_334_331_137,r_113_226_50,r_334_331_137,0.83,0,137,137,45
94,r_85_285_18,r_51_163_179,r_160_171_159,r_51_163_179,0.95,1,180,179,45
83,r_67_2_78,r_160_171_159,seq233,r_67_2_78,0.8,1,79,78,45
25,r_164_190_21,seq114,seq132,r_164_190_21,0.99,1,22,21,45
198,seq245,r_176_56_180,r_8_356_17,r_8_356_17,0.69,7,24,17,45
63,r_302_237_137,r_144_192_189,r_140_300_52,r_140_300_52,1.0,0,52,52,45
76,r_39_359_15,r_77_312_104,seq91,r_39_359_15,0.98,1,16,15,45
50,r_43_58_45,seq6,seq69,r_43_58_45,0.88,-1,44,45,45
90,r_47_346_80,seq138,seq358,r_47_346_80,1.0,0,80,80,45
52,r_259_146_119,seq154,seq95,r_259_146_119,1.0,0,119,119,45
65,r_314_203_21,r_340_150_171,seq304,r_314_203_21,1.0,0,21,21,45
112,r_159_318_186,r_133_40_189,r_307_94_19,r_159_318_186,0.99,0,186,186,45
17,r_222_59_44,r_133_40_189,seq21,r_222_59_44,0.55,16,60,44,45
18,r_158_185_130,seq70,r_222_59_44,r_158_185_130,1.0,0,130,130,45
104,r_189_266_154,r_349_15_5,seq296,r_189_266_154,1.0,0,154,154,45
45,r_282_211_84,r_76_354_31,seq45,r_76_354_31,1.0,2,33,31,45
154,seq95,r_363_221_71,seq332,r_363_221_71,1.0,-3,68,71,45
6,r_179_112_165,r_113_226_50,r_28_207_5,r_179_112_165,0.65,0,165,165,45
16,r_319_30_118,r_166_197_149,r_155_20_18,r_319_30_118,1.0,0,118,118,45
91,r_74_364_58,seq118,r_76_354_31,r_74_364_58,1.0,0,58,58,45
212,seq284,seq48,r_77_312_104,r_77_312_104,0.96,5,109,104,45
3,r_133_40_189,seq370,r_116_198_23,r_133_40_189,0.99,0,189,189,45
24,r_0_7_112,seq262,r_140_300_52,r_0_7_112,1.0,1,113,112,45
41,r_120_143_180,seq311,r_168_78_8,r_120_143_180,0.97,-1,179,180,45
103,r_174_251_94,r_4_111_134,r_222_59_44,r_222_59_44,0.76,52,96,44,45
168,seq142,r_303_129_119,r_99_63_158,r_303_129_119,1.0,0,119,119,45
206,seq264,r_176_56_180,r_8_356_17,r_176_56_180,1.0,2,182,180,45
54,r_50_81_52,seq154,seq214,r_50_81_52,1.0,0,52,52,45
96,r_76_354_31,r_282_211_84,seq229,r_76_354_31,0.99,0,31,31,45
60,r_119_136_142,seq104,r_319_30_118,r_319_30_118,0.96,32,150,118,45
1,r_140_300_52,r_302_237_137,r_0_7_112,r_0_7_112,0.79,27,139,112,45
87,r_181_205_88,seq110,seq321,r_181_205_88,1.0,1,89,88,45
49,r_137_193_68,r_293_336_157,seq79,r_137_193_68,0.65,7,75,68,45
180,seq188,r_16_149_153,r_10_117_95,r_16_149_153,1.0,0,153,153,45
73,r_363_221_71,seq95,r_43_58_45,r_363_221_71,1.0,0,71,71,45
135,seq36,r_293_336_157,r_368_247_92,r_368_247_92,0.85,4,96,92,45
62,r_106_273_129,r_330_252_178,r_335_57_128,r_330_252_178,1.0,-48,130,178,45
106,r_28_207_5,r_200_217_99,r_169_14_127,r_200_217_99,1.0,0,99,99,45
116,r_46_328_156,seq93,r_76_354_31,r_46_328_156,1.0,0,156,156,45
22,r_307_94_19,r_200_217_99,seq70,r_307_94_19,1.0,1,20,19,45
10,r_160_171_159,seq70,r_76_354_31,r_160_171_159,0.69,8,167,159,45
69,r_195_260_25,r_259_146_119,seq154,r_259_146_119,1.0,0,119,119,45
11,r_212_329_96,r_126_305_109,r_50_81_52,r_50_81_52,1.0,44,96,52,45
27,r_219_12_82,r_119_136_142,seq180,r_219_12_82,1.0,0,82,82,45
26,r_202_369_27,r_204_213_117,seq67,r_202_369_27,0.92,0,27,27,46
95,r_3_201_118,seq93,r_176_183_198,r_3_201_118,1.0,0,118,118,46
113,r_103_216_17,r_76_71_21,r_275_295_1,r_103_216_17,0.98,0,17,17,46
45,r_190_152_42,seq269,seq22,r_190_152_42,0.99,1,43,42,46
92,r_327_307_167,r_68_288_189,seq374,r_327_307_167,1.0,0,167,167,46
107,r_200_189_102,seq270,seq258,r_200_189_102,1.0,0,102,102,46
88,r_296_206_37,seq8,seq117,r_296_206_37,1.0,0,37,37,46
23,r_5_21_23,r_203_1_68,seq171,r_5_21_23,1.0,0,23,23,46
66,r_219_158_77,r_16_246_84,seq27,r_219_158_77,0.81,0,77,77,46
110,r_300_141_42,r_232_339_53,r_163_279_31,r_300_141_42,0.91,0,42,42,46
82,r_114_259_162,seq298,r_124_312_24,r_114_259_162,1.0,0,162,162,46
78,r_155_225_64,seq83,r_252_305_58,r_155_225_64,0.94,0,64,64,46
25,r_262_180_109,seq86,r_244_90_145,r_262_180_109,1.0,0,109,109,46
112,r_314_6_44,r_231_82_124,r_212_229_107,r_314_6_44,0.99,2,46,44,46
41,r_332_57_21,r_352_266_161,r_127_40_1,r_332_57_21,0.99,0,21,21,46
94,r_363_142_146,seq316,r_60_172_48,r_363_142_146,1.0,0,146,146,46
56,r_242_362_140,r_210_2_156,r_223_184_65,r_210_2_156,0.9,-13,143,156,46
80,r_4_324_46,r_214_17_146,r_140_194_121,r_214_17_146,1.0,-23,123,146,46
67,r_257_53_185,r_116_94_6,r_311_302_69,r_257_53_185,0.89,0,185,185,46
30,r_74_272_21,seq238,seq209,r_74_272_21,1.0,0,21,21,46
35,r_187_9_160,r_44_323_164,r_371_221_41,r_187_9_160,0.89,3,163,160,46
8,r_76_71_21,r_68_288_189,seq67,r_76_71_21,1.0,0,21,21,46
34,r_10_58_85,seq245,seq67,r_10_58_85,0.99,0,85,85,46
91,r_23_14_37,r_68_288_189,seq240,r_23_14_37,1.0,0,37,37,46
51,r_244_90_145,r_262_180_109,r_177_168_100,r_244_90_145,0.98,0,145,145,46
31,r_68_288_189,r_79_360_199,r_242_362_140,r_68_288_189,1.0,0,189,189,46
76,r_365_235_146,r_143_267_178,r_237_36_50,r_237_36_50,1.0,10,60,50,46
105,r_96_322_168,seq148,r_145_170_156,r_96_322_168,0.98,0,168,168,46
68,r_352_266_161,seq283,seq78,r_352_266_161,1.0,0,161,161,46
112,r_314_6_44,r_212_229_107,r_196_356_63,r_196_356_63,0.81,5,68,63,46
13,r_286_299_172,seq128,seq247,r_286_299_172,1.0,0,172,172,46
121,r_284_291_162,seq51,seq93,r_284_291_162,1.0,1,163,162,46
116,r_73_25_89,seq129,r_311_302_69,r_73_25_89,1.0,0,89,89,46
9,r_130_319_160,seq83,seq138,r_130_319_160,1.0,0,160,160,46
83,r_350_254_115,seq120,seq52,r_350_254_115,1.0,0,115,115,46
62,r_179_301_17,r_143_267_178,seq69,r_179_301_17,1.0,0,17,17,46
61,r_237_36_50,r_315_166_118,seq22,r_237_36_50,0.99,0,50,50,46
53,r_157_338_80,r_44_323_164,r_163_279_31,r_157_338_80,1.0,0,80,80,46
47,r_173_81_18,r_202_369_27,seq367,r_173_81_18,0.99,0,18,18,46
124,r_321_370_65,r_101_118_20,r_4_324_46,r_4_324_46,0.79,19,65,46,46
114,r_223_184_65,r_124_312_24,r_241_159_122,r_241_159_122,1.0,0,122,122,46
80,r_4_324_46,r_116_94_6,r_214_17_146,r_4_324_46,1.0,0,46,46,46
96,r_212_229_107,r_314_6_44,seq234,r_212_229_107,0.89,1,108,107,46
65,r_255_264_185,seq138,r_311_302_69,r_255_264_185,0.94,0,185,185,46
85,r_343_95_167,seq51,r_187_9_160,r_343_95_167,1.0,0,167,167,46
11,r_311_302_69,seq67,r_5_21_23,r_311_302_69,1.0,1,70,69,46
106,r_351_42_144,seq292,seq345,r_351_42_144,0.59,6,150,144,46
108,r_149_182_70,r_286_299_172,r_196_356_63,r_149_182_70,1.0,0,70,70,46
101,r_176_183_198,r_280_55_55,seq293,r_280_55_55,0.92,0,55,55,46
96,r_212_229_107,r_44_323_164,r_314_6_44,r_314_6_44,1.0,0,44,44,46
44,r_248_19_128,seq276,seq175,r_248_19_128,0.99,0,128,128,46
20,r_54_48_91,r_41_215_71,seq270,r_54_48_91,1.0,0,91,91,46
7,r_196_356_63,r_311_302_69,r_314_6_44,r_196_356_63,0.97,0,63,63,46
15,r_214_17_146,seq354,seq98,r_214_17_146,1.0,0,146,146,46
89,r_64_50_180,seq38,r_358_205_39,r_64_50_180,1.0,1,181,180,46
28,r_100_115_158,seq283,seq83,r_100_115_158,1.0,0,158,158,46
16,r_32_188_71,r_3_201_118,r_65_341_9,r_32_188_71,1.0,0,71,71,46
114,r_223_184_65,seq107,r_124_312_24,r_223_184_65,0.96,6,71,65,46
110,r_300_141_42,r_163_279_31,r_31_256_151,r_31_256_151,1.0,0,151,151,46
118,r_241_159_122,r_140_194_121,r_223_184_65,r_241_159_122,1.0,0,122,122,46
52,r_232_339_53,r_219_158_77,r_373_13_38,r_232_339_53,0.65,0,53,53,46
3,r_44_323_164,r_187_9_160,seq308,r_44_323_164,0.91,-1,163,164,46
58,r_61_250_145,seq367,seq224,r_61_250_145,1.0,1,146,145,46
0,r_349_39_18,r_111_178_81,r_179_301_17,r_349_39_18,1.0,0,18,18,46
1,r_231_82_124,r_361_330_199,seq198,r_231_82_124,1.0,0,124,124,46
19,r_177_168_100,seq243,seq108,r_177_168_100,1.0,0,100,100,46
57,r_7_337_63,r_294_99_160,seq84,r_7_337_63,0.99,0,63,63,46
72,r_236_122_180,seq22,seq167,r_236_122_180,0.95,0,180,180,46
81,r_31_256_151,r_282_85_94,r_60_172_48,r_31_256_151,0.84,-51,100,151,46
6,r_105_251_13,r_140_194_121,seq56,r_105_251_13,0.91,0,13,13,46
81,r_31_256_151,r_60_172_48,r_300_141_42,r_31_256_151,1.0,0,151,151,46
77,r_210_2_156,seq153,r_87_119_8,r_210_2_156,0.99,2,158,156,46
120,r_125_18_23,r_244_90_145,seq77,r_125_18_23,0.97,0,23,23,46
63,r_373_13_38,r_253_11_134,seq239,r_373_13_38,0.97,0,38,38,46
71,r_16_246_84,seq15,r_113_165_38,r_16_246_84,1.0,0,84,84,46
74,r_143_267_178,seq22,r_124_312_24,r_143_267_178,0.99,0,178,178,46
48,r_252_305_58,seq239,seq209,r_252_305_58,1.0,0,58,58,46
46,r_109_303_175,seq77,r_186_43_101,r_109_303_175,0.98,0,175,175,46
12,r_358_205_39,r_109_303_175,seq97,r_358_205_39,0.99,1,40,39,46
33,r_282_85_94,r_31_256_151,r_23_14_37,r_282_85_94,0.97,0,94,94,46
73,r_203_1_68,seq181,seq8,r_203_1_68,0.99,0,68,68,46
103,r_366_290_13,r_130_319_160,seq78,r_366_290_13,0.89,-2,11,13,46
76,r_365_235_146,r_237_36_50,r_16_246_84,r_365_235_146,1.0,0,146,146,46
69,r_315_166_118,seq306,seq258,r_315_166_118,1.0,1,119,118,46
17,r_91_271_72,r_54_48_91,seq35,r_91_271_72,1.0,0,72,72,46
109,r_137_151_121,seq195,r_311_302_69,r_137_151_121,1.0,0,121,121,46
84,r_274_263_127,seq355,seq228,r_274_263_127,1.0,0,127,127,46
122,r_26_285_170,r_255_264_185,r_282_85_94,r_26_285_170,0.84,0,170,170,46
179,seq148,r_96_322_168,r_358_205_39,r_96_322_168,0.99,-3,165,168,46
99,r_268_368_65,seq247,r_349_39_18,r_268_368_65,0.88,2,67,65,46
60,r_80_106_146,seq167,r_349_39_18,r_80_106_146,0.87,0,146,146,46
14,r_253_11_134,r_96_322_168,seq226,r_253_11_134,1.0,0,134,134,46
32,r_186_43_101,r_61_250_145,seq334,r_186_43_101,1.0,0,101,101,46
50,r_348_121_18,r_101_118_20,seq357,r_348_121_18,1.0,0,18,18,46
22,r_265_318_148,seq209,r_208_70_2,r_265_318_148,1.0,2,150,148,46
36,r_110_146_30,r_351_42_144,seq47,r_110_146_30,0.96,0,30,30,46
86,r_113_165_38,r_68_288_189,seq238,r_113_165_38,1.0,0,38,38,46
55,r_325_28_55,seq328,seq22,r_325_28_55,1.0,0,55,55,46
75,r_204_213_117,r_207_33_186,seq12,r_204_213_117,1.0,0,117,117,46
199,seq226,r_44_323_164,r_294_99_160,r_294_99_160,0.51,20,180,160,46
27,r_294_99_160,seq316,seq226,r_294_99_160,1.0,0,160,160,46
64,r_145_170_156,r_101_118_20,r_248_19_128,r_145_170_156,1.0,0,156,156,46
49,r_185_160_64,r_68_288_189,seq83,r_185_160_64,1.0,0,64,64,46
70,r_340_34_67,r_242_362_140,r_60_172_48,r_340_34_67,1.0,0,67,67,46
25,r_262_180_109,r_244_90_145,r_41_215_71,r_244_90_145,1.0,0,145,145,46
51,r_244_90_145,r_284_291_162,r_262_180_109,r_262_180_109,0.97,9,118,109,46
243,seq354,r_214_17_146,r_0_336_60,r_214_17_146,1.0,0,146,146,46
43,r_222_161_100,seq228,seq167,r_222_161_100,1.0,0,100,100,46
111,r_261_359_103,seq78,r_373_13_38,r_261_359_103,1.0,0,103,103,46
115,r_280_55_55,r_176_183_198,r_349_39_18,r_280_55_55,0.73,0,55,55,46
10,r_124_312_24,r_262_180_109,seq316,r_124_312_24,1.0,0,24,24,46
79,r_371_221_41,r_289_353_160,seq354,r_371_221_41,0.51,1,42,41,46
38,r_218_162_18,r_358_205_39,seq270,r_218_162_18,1.0,0,18,18,46
97,r_135_169_85,r_3_201_118,r_196_356_63,r_135_169_85,1.0,0,85,85,46
184,seq167,r_80_106_146,r_222_161_100,r_222_161_100,0.97,13,113,100,46
18,r_140_194_121,seq46,r_4_324_46,r_4_324_46,0.98,76,122,46,46
29,r_111_178_81,seq49,seq278,r_111_178_81,1.0,0,81,81,46
37,r_310_133_150,r_361_330_199,seq230,r_310_133_150,1.0,2,152,150,46
79,r_237_211_113,seq28,r_5_79_197,r_237_211_113,1.0,0,113,113,47
73,r_21_61_157,r_89_335_172,r_147_332_13,r_21_61_157,0.96,0,157,157,47
47,r_91_12_106,seq284,r_228_11_3,r_91_12_106,1.0,0,106,106,47
117,r_18_248_54,r_42_112_150,seq361,r_18_248_54,0.76,-3,51,54,47
99,r_72_221_153,seq318,r_214_104_47,r_72_221_153,1.0,-1,152,153,47
246,seq361,r_319_35_152,r_18_248_54,r_319_35_152,0.73,-101,51,152,47
0,r_369_77_27,r_269_102_155,r_210_38_9,r_369_77_27,1.0,0,27,27,47
88,r_295_204_16,r_5_79_197,seq52,r_295_204_16,0.72,0,16,16,47
123,r_53_359_25,r_89_335_172,r_179_157_40,r_179_157_40,0.72,1,41,40,47
87,r_197_312_75,r_145_353_192,r_1_58_74,r_197_312_75,1.0,0,75,75,47
138,seq59,r_269_102_155,r_163_239_32,r_163_239_32,0.98,1,33,32,47
90,r_238_315_123,r_45_306_163,r_278_287_94,r_238_315_123,1.0,3,126,123,47
115,r_220_136_8,r_144_171_144,seq357,r_220_136_8,0.95,3,11,8,47
77,r_255_342_138,r_176_88_139,seq172,r_176_88_139,1.0,-1,138,139,47
153,seq92,r_374_152_149,r_201_37_51,r_201_37_51,0.98,0,51,51,47
131,seq31,r_366_331_96,r_175_155_102,r_175_155_102,1.0,12,114,102,47
42,r_101_22_109,r_14_320_183,r_363_371_93,r_101_22_109,0.91,12,121,109,47
221,seq293,r_234_262_141,r_187_252_148,r_234_262_141,1.0,1,142,141,47
72,r_33_48_89,r_307_32_117,r_219_162_44,r_33_48_89,0.96,0,89,89,47
71,r_212_143_102,r_64_222_105,r_220_136_8,r_64_222_105,1.0,-1,104,105,47
67,r_110_299_185,seq60,r_83_203_30,r_110_299_185,1.0,0,185,185,47
102,r_317_304_49,r_188_13_156,r_45_306_163,r_317_304_49,1.0,1,50,49,47
195,seq223,seq244,r_42_112_150,r_42_112_150,0.92,4,154,150,47
35,r_10_6_49,r_219_162_44,seq193,r_219_162_44,0.96,-6,38,44,47
119,r_30_180_46,r_5_79_197,seq60,r_30_180_46,1.0,0,46,46,47
25,r_176_88_139,r_255_342_138,r_362_191_22,r_176_88_139,1.0,-1,138,139,47
51,r_103_202_63,seq141,seq93,r_103_202_63,1.0,0,63,63,47
13,r_316_50_94,r_366_331_96,r_179_157_40,r_179_157_40,0.59,49,89,40,47
5,r_125_292_118,seq70,seq186,r_125_292_118,1.0,2,120,118,47
23,r_319_35_152,seq361,r_10_6_49,r_319_35_152,1.0,0,152,152,47
102,r_317_304_49,r_45_306_163,r_94_142_121,r_45_306_163,1.0,0,163,163,47
139,seq60,r_110_299_185,r_30_180_46,r_110_299_185,1.0,0,185,185,47
92,r_199_27_137,r_14_320_183,r_224_209_123,r_199_27_137,1.0,0,137,137,47
105,r_127_80_130,seq326,seq52,r_127_80_130,1.0,0,130,130,47
7,r_224_209_123,seq100,r_256_16_120,r_224_209_123,1.0,0,123,123,47
101,r_235_350_75,seq99,seq59,r_235_350_75,0.61,4,79,75,47
81,r_4_200_61,seq284,r_121_165_56,r_4_200_61,1.0,-3,58,61,47
11,r_362_191_22,r_184_173_90,r_288_182_112,r_362_191_22,1.0,1,23,22,47
43,r_225_3_139,r_9_120_140,r_224_209_123,r_9_120_140,1.0,-1,139,140,47
3,r_121_165_56,r_349_264_126,r_4_200_61,r_121_165_56,1.0,2,58,56,47
10,r_366_331_96,seq31,seq68,r_366_331_96,0.48,-6,90,96,47
11,r_362_191_22,r_288_182_112,r_197_312_75,r_362_191_22,0.98,91,113,22,47
57,r_358_340_90,r_125_292_118,seq164,r_358_340_90,1.0,0,90,90,47
39,r_372_170_161,seq245,r_64_222_105,r_372_170_161,0.96,0,161,161,47
16,r_49_114_145,seq15,r_207_54_34,r_49_114_145,1.0,1,146,145,47
120,r_267_57_101,seq261,r_358_340_90,r_267_57_101,0.97,0,101,101,47
177,seq166,r_151_69_140,r_362_191_22,r_151_69_140,1.0,0,140,140,47
91,r_201_37_51,r_249_272_72,seq92,r_201_37_51,1.0,0,51,51,47
45,r_305_323_130,r_145_353_192,seq68,r_305_323_130,1.0,0,130,130,47
83,r_47_229_134,seq68,r_283_122_23,r_47_229_134,0.99,0,134,134,47
93,r_290_183_88,r_366_331_96,seq23,r_290_183_88,1.0,0,88,88,47
103,r_360_129_32,r_140_227_74,seq160,r_360_129_32,0.99,0,32,32,47
14,r_349_264_126,seq303,seq65,r_349_264_126,0.88,3,129,126,47
107,r_1_58_74,seq338,r_362_191_22,r_1_58_74,1.0,5,79,74,47
1,r_119_0_28,r_45_306_163,seq44,r_119_0_28,0.95,-1,27,28,47
123,r_53_359_25,r_145_353_192,r_89_335_172,r_53_359_25,0.94,0,25,25,47
37,r_207_54_34,r_366_331_96,r_247_301_189,r_207_54_34,0.96,0,34,34,47
89,r_195_130_112,seq313,seq96,r_195_130_112,1.0,2,114,112,47
106,r_307_32_117,r_295_204_16,r_175_155_102,r_307_32_117,0.94,1,118,117,47
8,r_128_291_156,seq217,seq186,r_128_291_156,1.0,0,156,156,47
116,r_175_155_102,seq270,seq31,r_175_155_102,1.0,0,102,102,47
52,r_278_287_94,r_305_323_130,r_328_236_79,r_278_287_94,0.99,0,94,94,47
69,r_45_306_163,r_238_315_123,r_317_304_49,r_317_304_49,1.0,1,50,49,47
96,r_298_123_74,r_307_32_117,seq232,r_307_32_117,0.83,-51,66,117,47
97,r_276_133_50,r_89_335_172,seq28,r_276_133_50,1.0,0,50,50,47
174,seq160,r_34_149_26,r_360_129_32,r_360_129_32,1.0,-2,30,32,47
32,r_148_2_102,r_269_102_155,r_294_29_108,r_294_29_108,0.55,1,109,108,47
104,r_144_171_144,r_266_198_145,r_34_149_26,r_144_171_144,0.8,1,145,144,47
40,r_247_301_189,r_230_309_33,r_207_54_34,r_230_309_33,0.88,0,33,33,47
113,r_365_111_147,seq231,seq313,r_365_111_147,1.0,0,147,147,47
68,r_334_322_13,r_64_222_105,seq73,r_334_322_13,1.0,0,13,13,47
76,r_285_336_54,r_288_182_112,r_119_0_28,r_285_336_54,1.0,0,54,54,47
82,r_268_241_90,r_343_233_190,seq81,r_268_241_90,1.0,0,90,90,47
146,seq73,r_89_335_172,r_362_191_22,r_89_335_172,0.99,-8,164,172,47
108,r_343_233_190,r_228_11_3,seq164,r_343_233_190,0.98,0,190,190,47
29,r_240_215_175,r_5_79_197,r_356_87_141,r_240_215_175,0.85,3,178,175,47
37,r_207_54_34,r_247_301_189,r_49_114_145,r_49_114_145,1.0,5,150,145,47
21,r_7_370_62,r_64_222_105,seq223,r_64_222_105,1.0,-43,62,105,47
34,r_230_309_33,r_247_301_189,r_282_174_25,r_230_309_33,1.0,0,33,33,47
75,r_266_198_145,r_144_171_144,r_64_222_105,r_266_198_145,1.0,0,145,145,47
110,r_46_55_72,r_268_241_90,seq99,r_46_55_72,0.99,0,72,72,47
30,r_116_19_11,r_220_136_8,r_121_165_56,r_121_165_56,0.98,2,58,56,47
95,r_42_112_150,seq265,seq223,r_42_112_150,0.98,0,150,150,47
114,r_135_337_97,seq40,r_219_162_44,r_135_337_97,0.95,0,97,97,47
109,r_288_182_112,r_21_61_157,r_256_16_120,r_288_182_112,1.0,1,113,112,47
2,r_219_162_44,r_10_6_49,seq253,r_219_162_44,1.0,0,44,44,47
53,r_294_29_108,r_311_107_162,r_148_2_102,r_294_29_108,1.0,2,110,108,47
33,r_41_167_175,seq274,r_140_227_74,r_41_167_175,1.0,0,175,175,47
84,r_314_36_184,seq164,r_219_162_44,r_314_36_184,0.93,0,184,184,47
136,seq52,r_328_236_79,r_295_204_16,r_295_204_16,0.68,3,19,16,47
94,r_251_153_158,seq303,r_214_104_47,r_251_153_158,0.54,0,158,158,47
18,r_147_332_13,r_21_61_157,seq56,r_147_332_13,0.93,1,14,13,47
58,r_63_348_94,seq100,seq68,r_63_348_94,0.99,-4,90,94,47
122,r_356_87_141,seq232,seq216,r_356_87_141,1.0,0,141,141,47
55,r_249_272_72,seq333,r_369_77_27,r_369_77_27,0.71,39,66,27,47
118,r_9_120_140,r_89_335_172,seq169,r_9_120_140,0.89,0,140,140,47
198,seq232,r_85_113_106,r_298_123_74,r_85_113_106,0.96,-28,78,106,47
20,r_269_102_155,seq253,r_151_69_140,r_269_102_155,0.91,1,156,155,47
65,r_117_325_175,r_145_353_192,r_125_292_118,r_117_325_175,1.0,0,175,175,47
49,r_188_13_156,seq95,r_128_291_156,r_188_13_156,0.7,0,156,156,47
41,r_14_320_183,seq263,seq66,r_14_320_183,0.8,1,184,183,47
64,r_289_354_119,r_41_167_175,seq131,r_41_167_175,0.55,-51,124,175,47
69,r_45_306_163,r_317_304_49,r_224_209_123,r_45_306_163,0.99,0,163,163,47
80,r_85_113_106,seq232,seq341,r_85_113_106,1.0,0,106,106,47
106,r_307_32_117,r_298_123_74,r_295_204_16,r_307_32_117,0.59,-58,59,117,47
27,r_179_157_40,r_42_112_150,r_53_359_25,r_179_157_40,1.0,0,40,40,47
70,r_328_236_79,seq52,r_219_162_44,r_328_236_79,0.94,0,79,79,47
60,r_90_154_74,r_225_3_139,seq126,r_90_154_74,1.0,0,74,74,47
124,r_187_252_148,seq181,seq293,r_187_252_148,0.82,10,158,148,47
125,seq15,r_49_114_145,r_10_6_49,r_49_114_145,0.95,-55,90,145,47
28,r_151_69_140,seq166,r_212_143_102,r_151_69_140,1.0,0,140,140,47
74,r_184_173_90,seq223,r_30_180_46,r_184_173_90,1.0,0,90,90,47
54,r_94_142_121,r_72_221_153,r_317_304_49,r_94_142_121,0.98,5,126,121,47
227,seq308,r_189_355_137,r_283_122_23,r_283_122_23,1.0,0,23,23,47
98,r_132_26_49,r_42_112_150,r_369_77_27,r_132_26_49,1.0,1,50,49,47
48,r_189_355_137,seq308,r_101_22_109,r_189_355_137,0.97,1,138,137,47
24,r_214_104_47,r_125_292_118,seq361,r_214_104_47,1.0,0,47,47,47
203,seq253,r_269_102_155,r_219_162_44,r_219_162_44,1.0,2,46,44,47
6,r_89_335_172,r_134_192_99,r_269_102_155,r_89_335_172,0.99,0,172,172,47
111,r_86_109_189,seq164,r_83_203_30,r_86_109_189,1.0,0,189,189,47
15,r_64_222_105,r_212_143_102,seq131,r_64_222_105,1.0,-1,104,105,47
56,r_163_239_32,r_42_112_150,seq59,r_163_239_32,0.96,-2,30,32,47
100,r_43_138_117,seq218,r_83_203_30,r_43_138_117,1.0,0,117,117,47
46,r_140_227_74,r_134_192_99,seq326,r_140_227_74,1.0,0,74,74,47
26,r_363_371_93,seq96,seq223,r_363_371_93,0.98,-3,90,93,47
38,r_243_259_57,r_64_222_105,seq313,r_243_259_57,1.0,0,57,57,47
84,r_285_68_178,seq278,r_186_255_124,r_285_68_178,0.53,1,179,178,48
110,r_104_93_55,r_370_45_194,seq200,r_104_93_55,1.0,0,55,55,48
3,r_193_290_158,seq269,r_79_258_88,r_193_290_158,1.0,0,158,158,48
33,r_47_127_130,seq86,seq32,r_47_127_130,1.0,1,131,130,48
16,r_327_303_125,seq244,r_352_219_1,r_327_303_125,0.99,0,125,125,48
58,r_241_117_166,r_288_215_190,r_206_159_62,r_241_117_166,1.0,0,166,166,48
80,r_205_125_77,r_230_42_180,r_77_342_4,r_205_125_77,1.0,0,77,77,48
92,r_267_18_76,seq164,seq76,r_267_18_76,1.0,0,76,76,48
96,r_103_373_89,r_60_279_111,seq102,r_103_373_89,0.98,0,89,89,48
70,r_175_135_95,seq55,seq276,r_175_135_95,0.88,-3,92,95,48
57,r_360_321_83,seq332,r_322_136_73,r_360_321_83,1.0,0,83,83,48
88,r_3_299_162,r_216_315_13,r_280_85_16,r_3_299_162,1.0,3,165,162,48
209,seq257,seq28,r_183_192_100,r_183_192_100,1.0,3,103,100,48
118,r_98_226_72,seq273,r_180_247_7,r_98_226_72,1.0,1,73,72,48
18,r_307_113_93,r_70_58_1,r_130_145_69,r_307_113_93,0.98,0,93,93,48
131,seq21,r_39_214_114,seq363,r_39_214_114,1.0,0,114,114,48
79,r_230_42_180,seq137,r_47_127_130,r_230_42_180,0.95,0,180,180,48
1,r_186_255_124,r_12_260_92,r_77_342_4,r_12_260_92,0.54,0,92,92,48
95,r_185_50_156,r_81_335_165,seq53,r_185_50_156,1.0,1,157,156,48
98,r_322_136_73,seq86,r_360_321_83,r_360_321_83,1.0,1,84,83,48
4,r_292_364_25,r_356_121_37,seq137,r_356_121_37,0.78,-12,25,37,48
107,r_331_5_184,seq8,r_253_237_47,r_331_5_184,0.98,0,184,184,48
6,r_165_83_84,r_48_354_199,r_267_18_76,r_165_83_84,0.81,1,85,84,48
68,r_38_22_83,r_201_302_175,seq132,r_38_22_83,1.0,0,83,83,48
87,r_339_344_24,r_209_341_146,seq361,r_209_341_146,0.64,0,146,146,48
75,r_196_316_21,r_25_163_83,r_149_330_55,r_196_316_21,0.92,-3,18,21,48
85,r_51_41_189,seq53,r_62_11_114,r_51_41_189,0.84,0,189,189,48
21,r_291_317_121,seq147,r_292_364_25,r_291_317_121,1.0,1,122,121,48
97,r_268_143_88,r_62_11_114,r_26_57_42,r_268_143_88,0.96,0,88,88,48
63,r_124_61_140,r_160_197_64,r_322_136_73,r_160_197_64,0.99,0,64,64,48
101,r_176_353_117,r_201_302_175,r_365_220_96,r_176_353_117,0.91,1,118,117,48
53,r_229_274_128,r_111_282_4,seq13,r_229_274_128,1.0,2,130,128,48
105,r_294_75_124,r_371_96_162,r_165_83_84,r_165_83_84,0.62,41,125,84,48
89,r_368_242_106,r_66_343_62,r_349_256_81,r_349_256_81,1.0,44,125,81,48
121,r_120_249_34,r_211_228_192,seq314,r_120_249_34,1.0,0,34,34,48
122,r_108_275_158,r_349_256_81,seq87,r_108_275_158,1.0,0,158,158,48
109,r_333_118_91,r_322_136_73,r_111_282_4,r_333_118_91,1.0,0,91,91,48
28,r_177_277_98,r_39_214_114,r_268_143_88,r_177_277_98,1.0,0,98,98,48
103,r_37_208_37,r_79_258_88,seq287,r_37_208_37,0.82,-2,35,37,48
64,r_74_0_93,r_246_116_165,seq325,r_74_0_93,1.0,0,93,93,48
94,r_99_179_104,seq23,seq346,r_99_179_104,1.0,0,104,104,48
123,r_347_289_86,r_211_228_192,seq217,r_347_289_86,1.0,0,86,86,48
182,seq167,r_313_91_185,seq21,r_313_91_185,0.97,-1,184,185,48
111,r_43_283_145,r_235_63_170,seq64,r_43_283_145,1.0,2,147,145,48
181,seq166,r_189_14_151,r_70_58_1,r_189_14_151,1.0,0,151,151,48
11,r_221_204_115,seq15,r_352_219_1,r_221_204_115,0.91,6,121,115,48
12,r_216_315_13,r_368_242_106,r_40_131_52,r_40_131_52,1.0,-1,51,52,48
2,r_280_85_16,r_47_127_130,seq223,r_280_85_16,1.0,0,16,16,48
221,seq287,r_293_232_158,r_37_208_37,r_37_208_37,0.89,-2,35,37,48
141,seq55,r_175_135_95,r_111_282_4,r_175_135_95,0.73,-5,90,95,48
160,seq112,seq155,r_367_148_44,r_367_148_44,0.54,41,85,44,48
52,r_264_67_96,seq126,seq13,r_264_67_96,1.0,-2,94,96,48
90,r_97_372_155,r_297_243_199,seq49,r_97_372_155,0.99,1,156,155,48
56,r_12_260_92,r_186_255_124,r_130_145_69,r_12_260_92,1.0,0,92,92,48
76,r_90_369_197,seq52,r_33_139_45,r_33_139_45,1.0,1,46,45,48
55,r_207_27_160,seq89,r_99_179_104,r_207_27_160,1.0,0,160,160,48
65,r_313_91_185,seq167,r_20_16_81,r_313_91_185,0.89,-1,184,185,48
81,r_35_100_70,r_209_341_146,seq123,r_35_100_70,0.96,0,70,70,48
24,r_312_2_164,r_180_247_7,r_43_283_145,r_312_2_164,0.59,1,165,164,48
9,r_293_232_158,seq287,r_193_290_158,r_293_232_158,0.98,0,158,158,48
36,r_81_335_165,seq278,r_47_127_130,r_47_127_130,0.58,39,169,130,48
10,r_251_266_33,seq69,seq150,r_251_266_33,0.99,0,33,33,48
48,r_154_54_58,seq239,r_238_6_38,r_238_6_38,0.59,21,59,38,48
78,r_189_14_151,seq166,seq134,r_189_14_151,1.0,0,151,151,48
13,r_367_148_44,r_90_369_197,seq112,r_367_148_44,0.91,-5,39,44,48
75,r_196_316_21,r_149_330_55,seq269,r_149_330_55,1.0,0,55,55,48
27,r_180_247_7,seq28,r_98_226_72,r_98_226_72,1.0,2,74,72,48
116,r_26_57_42,seq52,r_362_82_199,r_26_57_42,1.0,0,42,42,48
24,r_312_2_164,seq271,r_180_247_7,r_180_247_7,0.74,102,109,7,48
122,r_108_275_158,r_66_343_62,r_349_256_81,r_349_256_81,1.0,3,84,81,48
102,r_371_96_162,r_313_91_185,seq52,r_371_96_162,1.0,-1,161,162,48
60,r_161_152_26,seq112,r_130_145_69,r_161_152_26,1.0,0,26,26,48
120,r_106_107_96,r_81_335_165,seq363,r_106_107_96,1.0,1,97,96,48
218,seq278,r_81_335_165,r_238_6_38,r_238_6_38,1.0,0,38,38,48
148,seq76,r_305_168_185,r_233_44_45,r_305_168_185,0.38,3,188,185,48
178,seq155,r_66_343_62,r_202_95_31,r_202_95_31,1.0,2,33,31,48
23,r_7_188_173,r_130_145_69,r_20_16_81,r_7_188_173,1.0,3,176,173,48
20,r_169_109_147,seq358,r_37_208_37,r_169_109_147,1.0,0,147,147,48
39,r_295_334_57,r_198_157_176,seq129,r_295_334_57,1.0,0,57,57,48
32,r_149_330_55,r_196_316_21,seq36,r_149_330_55,1.0,0,55,55,48
74,r_305_168_185,seq76,r_47_127_130,r_305_168_185,0.62,3,188,185,48
238,seq332,r_360_321_83,r_111_282_4,r_360_321_83,1.0,0,83,83,48
115,r_174_304_137,seq105,r_322_136_73,r_174_304_137,1.0,3,140,137,48
113,r_24_158_168,r_230_42_180,r_349_256_81,r_24_158_168,0.99,2,170,168,48
71,r_206_159_62,seq142,seq182,r_206_159_62,1.0,0,62,62,48
45,r_203_31_31,r_138_248_63,r_216_315_13,r_203_31_31,0.76,0,31,31,48
5,r_79_258_88,r_297_243_199,seq105,r_79_258_88,1.0,0,88,88,48
8,r_209_341_146,r_288_215_190,r_339_344_24,r_339_344_24,1.0,2,26,24,48
69,r_350_284_48,r_312_2_164,seq114,r_350_284_48,1.0,1,49,48,48
93,r_359_119_19,r_81_335_165,r_130_145_69,r_359_119_19,1.0,1,20,19,48
14,r_349_256_81,seq178,r_368_242_106,r_349_256_81,1.0,-1,80,81,48
149,seq80,seq126,r_272_170_106,r_272_170_106,0.99,7,113,106,48
61,r_198_157_176,seq128,r_222_153_32,r_198_157_176,1.0,0,176,176,48
15,r_92_310_52,r_272_170_106,seq105,r_92_310_52,1.0,0,52,52,48
42,r_34_323_62,seq273,seq217,r_34_323_62,1.0,0,62,62,48
22,r_1_56_140,r_7_188_173,r_327_303_125,r_1_56_140,0.92,0,140,140,48
83,r_39_214_114,seq21,r_206_159_62,r_39_214_114,1.0,0,114,114,48
44,r_272_170_106,r_305_168_185,seq80,r_272_170_106,1.0,1,107,106,48
51,r_201_302_175,seq301,seq147,r_201_302_175,1.0,1,176,175,48
99,r_138_248_63,r_370_45_194,seq151,r_138_248_63,1.0,1,64,63,48
63,r_124_61_140,r_322_136_73,r_251_266_33,r_124_61_140,0.98,-1,139,140,48
87,r_339_344_24,r_81_335_165,r_209_341_146,r_339_344_24,1.0,1,25,24,48
31,r_235_63_170,seq269,seq122,r_235_63_170,0.96,1,171,170,48
32,r_149_330_55,r_193_290_158,r_196_316_21,r_149_330_55,0.52,-35,20,55,48
7,r_40_131_52,r_20_16_81,r_216_315_13,r_40_131_52,0.99,-2,50,52,48
124,r_238_6_38,r_183_192_100,seq278,r_238_6_38,1.0,0,38,38,48
25,r_62_11_114,seq217,seq269,r_62_11_114,1.0,0,114,114,48
62,r_60_279_111,r_352_219_1,r_292_364_25,r_60_279_111,1.0,0,111,111,48
67,r_33_139_45,r_74_0_93,r_90_369_197,r_33_139_45,0.99,0,45,45,48
117,r_183_192_100,seq94,seq257,r_183_192_100,1.0,0,100,100,48
49,r_366_181_59,seq129,seq257,r_366_181_59,1.0,0,59,59,48
204,seq239,r_154_54_58,r_25_163_83,r_25_163_83,0.54,0,83,83,48
112,r_356_121_37,seq9,seq128,r_356_121_37,0.93,0,37,37,48
91,r_233_44_45,r_62_11_114,seq262,r_233_44_45,1.0,0,45,45,48
1,r_186_255_124,r_77_342_4,r_111_282_4,r_186_255_124,1.0,-1,123,124,48
72,r_365_220_96,r_99_179_104,seq123,r_365_220_96,0.94,1,97,96,48
40,r_25_163_83,r_51_41_189,seq239,r_25_163_83,1.0,0,83,83,48
0,r_20_16_81,r_362_82_199,r_120_249_34,r_20_16_81,1.0,-1,80,81,48
19,r_253_237_47,r_360_321_83,seq329,r_253_237_47,0.94,0,47,47,48
41,r_160_197_64,r_124_61_140,seq13,r_160_197_64,1.0,0,64,64,48
106,r_337_144_85,r_74_0_93,r_202_95_31,r_337_144_85,0.98,0,85,85,48
35,r_202_95_31,r_333_118_91,seq155,r_202_95_31,0.84,0,31,31,48
73,r_246_116_165,seq346,r_47_127_130,r_246_116_165,1.0,0,165,165,48
85,r_163_234_141,r_331_137_182,r_150_372_85,r_163_234_141,0.99,19,160,141,49
45,r_123_27_113,seq117,seq167,r_123_27_113,1.0,0,113,113,49
27,r_294_140_44,r_122_200_96,r_163_234_141,r_294_140_44,1.0,0,44,44,49
143,seq61,r_237_314_77,r_356_355_149,r_237_314_77,1.0,0,77,77,49
99,r_105_142_138,seq48,seq109,r_105_142_138,1.0,0,138,138,49
118,r_139_246_18,r_297_354_139,seq232,r_139_246_18,1.0,0,18,18,49
156,seq87,r_33_120_177,r_237_314_77,r_237_314_77,0.97,37,114,77,49
139,seq48,r_105_142_138,r_278_220_41,r_105_142_138,1.0,0,138,138,49
82,r_21_39_154,seq1,r_296_37_94,r_21_39_154,1.0,0,154,154,49
62,r_236_86_121,seq25,seq47,r_236_86_121,1.0,0,121,121,49
36,r_252_202_141,seq151,r_229_148_64,r_229_148_64,0.85,77,141,64,49
25,r_5_24_24,r_73_136_155,seq25,r_5_24_24,0.99,0,24,24,49
46,r_271_373_155,seq88,seq47,r_271_373_155,1.0,0,155,155,49
103,r_122_200_96,seq164,seq190,r_122_200_96,0.99,1,97,96,49
6,r_153_254_44,seq68,seq332,r_153_254_44,1.0,0,44,44,49
61,r_331_137_182,r_241_313_186,seq82,r_331_137_182,0.97,1,183,182,49
129,seq11,r_361_49_59,seq267,r_361_49_59,1.0,3,62,59,49
100,r_347_365_144,seq289,r_218_160_16,r_347_365_144,1.0,2,146,144,49
5,r_132_243_148,seq8,r_288_106_123,r_132_243_148,0.98,0,148,148,49
59,r_348_131_51,seq289,r_54_336_17,r_348_131_51,1.0,2,53,51,49
106,r_361_49_59,seq11,r_15_101_27,r_361_49_59,0.95,3,62,59,49
34,r_166_369_167,seq289,r_153_254_44,r_166_369_167,0.84,0,167,167,49
101,r_319_3_136,r_123_27_113,r_9_97_74,r_319_3_136,0.81,-53,83,136,49
75,r_133_205_135,seq253,r_294_140_44,r_133_205_135,1.0,2,137,135,49
123,r_208_198_33,r_73_136_155,seq309,r_208_198_33,1.0,0,33,33,49
48,r_128_197_131,seq109,r_237_314_77,r_128_197_131,0.98,1,132,131,49
115,r_149_36_124,r_159_290_196,r_237_314_77,r_149_36_124,1.0,0,124,124,49
92,r_255_76_138,seq152,r_144_335_48,r_255_76_138,0.99,0,138,138,49
52,r_89_22_39,r_259_32_112,r_161_23_13,r_89_22_39,1.0,0,39,39,49
94,r_156_169_114,r_213_102_160,r_123_27_113,r_213_102_160,1.0,-46,114,160,49
26,r_170_358_72,seq326,seq157,r_170_358_72,1.0,3,75,72,49
79,r_247_19_128,r_206_323_164,r_162_269_28,r_247_19_128,1.0,0,128,128,49
22,r_249_299_173,seq310,r_298_207_113,r_249_299_173,0.58,0,173,173,49
50,r_278_220_41,r_349_103_101,r_10_192_19,r_278_220_41,1.0,0,41,41,49
54,r_144_335_48,seq152,seq68,r_144_335_48,1.0,1,49,48,49
11,r_111_188_89,seq262,r_226_38_31,r_111_188_89,1.0,1,90,89,49
47,r_161_23_13,r_166_369_167,seq176,r_161_23_13,0.74,-1,12,13,49
66,r_216_138_70,seq217,r_178_31_54,r_178_31_54,0.99,29,83,54,49
121,r_9_97_74,r_66_201_71,r_319_3_136,r_9_97_74,1.0,0,74,74,49
13,r_182_64_88,seq225,seq176,r_182_64_88,1.0,0,88,88,49
8,r_150_372_85,seq338,r_163_234_141,r_150_372_85,1.0,1,86,85,49
58,r_130_35_14,seq267,seq90,r_130_35_14,0.89,2,16,14,49
80,r_275_374_153,seq78,seq260,r_275_374_153,1.0,1,154,153,49
46,r_271_373_155,r_359_58_91,seq88,r_359_58_91,1.0,0,91,91,49
15,r_189_257_158,r_331_137_182,seq7,r_189_257_158,1.0,0,158,158,49
18,r_329_285_27,r_33_120_177,seq152,r_329_285_27,1.0,0,27,27,49
56,r_297_354_139,seq157,r_4_126_7,r_297_354_139,1.0,1,140,139,49
14,r_129_20_178,seq210,r_321_204_129,r_129_20_178,0.56,1,179,178,49
68,r_54_336_17,r_21_39_154,seq75,r_54_336_17,0.81,4,21,17,49
84,r_308_228_158,seq256,r_356_355_149,r_308_228_158,0.99,0,158,158,49
35,r_184_124_186,seq90,r_278_220_41,r_184_124_186,0.92,1,187,186,49
1,r_213_102_160,r_230_215_195,r_98_56_35,r_213_102_160,1.0,0,160,160,49
16,r_343_183_11,r_132_243_148,seq1,r_343_183_11,0.85,1,12,11,49
69,r_50_320_24,seq176,seq121,r_50_320_24,1.0,0,24,24,49
19,r_241_313_186,r_170_358_72,r_129_20_178,r_241_313_186,0.7,1,187,186,49
72,r_178_31_54,r_166_369_167,r_216_138_70,r_178_31_54,1.0,0,54,54,49
55,r_321_204_129,r_252_202_141,seq289,r_321_204_129,0.97,6,135,129,49
7,r_33_120_177,seq125,r_123_27_113,r_33_120_177,0.91,0,177,177,49
9,r_333_219_73,r_364_224_79,r_28_238_68,r_333_219_73,0.98,6,79,73,49
158,seq90,r_91_59_177,r_130_35_14,r_91_59_177,0.45,5,182,177,49
246,seq360,r_33_120_177,r_60_17_33,r_60_17_33,0.62,36,69,33,49
4,r_15_101_27,r_123_27_113,seq65,r_15_101_27,1.0,1,28,27,49
65,r_349_103_101,seq251,seq289,r_349_103_101,0.99,0,101,101,49
23,r_14_268_94,seq232,r_339_67_15,r_339_67_15,1.0,-3,12,15,49
193,seq231,r_123_27_113,r_213_102_160,r_123_27_113,1.0,-43,70,113,49
114,r_95_195_179,seq65,r_170_358_72,r_95_195_179,1.0,0,179,179,49
70,r_187_108_77,r_132_243_148,r_329_285_27,r_187_108_77,0.87,0,77,77,49
32,r_237_314_77,seq61,seq87,r_237_314_77,1.0,0,77,77,49
90,r_364_224_79,r_333_219_73,seq1,r_364_224_79,1.0,0,79,79,49
17,r_296_37_94,seq96,r_52_51_159,r_296_37_94,1.0,0,94,94,49
113,r_116_318_45,r_297_354_139,seq256,r_116_318_45,0.73,0,45,45,49
111,r_367_283_18,r_294_140_44,seq34,r_367_283_18,1.0,0,18,18,49
67,r_44_134_140,r_180_279_164,r_179_199_121,r_180_279_164,0.71,-29,135,164,49
121,r_9_97_74,r_319_3_136,seq117,r_319_3_136,1.0,1,137,136,49
110,r_73_136_155,seq34,seq242,r_73_136_155,1.0,0,155,155,49
81,r_301_141_71,r_193_70_197,seq11,r_301_141_71,1.0,0,71,71,49
119,r_342_235_132,r_308_228_158,r_333_219_73,r_342_235_132,1.0,0,132,132,49
177,seq167,seq107,r_123_27_113,r_123_27_113,1.0,3,116,113,49
124,r_26_345_103,r_0_113_118,r_94_322_43,r_26_345_103,1.0,3,106,103,49
19,r_241_313_186,r_331_137_182,r_170_358_72,r_170_358_72,0.61,79,151,72,49
20,r_74_13_99,seq61,r_296_37_94,r_74_13_99,1.0,0,99,99,49
91,r_0_113_118,seq286,r_170_358_72,r_0_113_118,0.84,0,118,118,49
133,seq25,r_236_86_121,r_5_24_24,r_236_86_121,1.0,0,121,121,49
95,r_93_85_189,seq280,r_213_102_160,r_93_85_189,0.58,0,189,189,49
40,r_28_238_68,r_44_134_140,seq286,r_28_238_68,1.0,0,68,68,49
108,r_118_83_144,seq332,seq100,r_118_83_144,1.0,1,145,144,49
225,seq302,r_175_316_93,r_305_287_87,r_305_287_87,1.0,6,93,87,49
33,r_266_173_122,r_168_41_197,r_54_336_17,r_266_173_122,1.0,0,122,122,49
173,seq152,r_144_335_48,r_329_285_27,r_144_335_48,0.68,0,48,48,49
96,r_229_148_64,seq7,r_259_32_112,r_229_148_64,1.0,0,64,64,49
47,r_161_23_13,seq176,r_89_22_39,r_89_22_39,0.96,8,47,39,49
74,r_181_114_71,r_351_154_114,r_356_355_149,r_181_114_71,1.0,0,71,71,49
105,r_60_17_33,r_288_106_123,seq360,r_60_17_33,1.0,1,34,33,49
88,r_180_279_164,r_209_353_186,r_252_202_141,r_180_279_164,0.99,0,164,164,49
41,r_98_56_35,r_166_369_167,seq340,r_98_56_35,0.98,0,35,35,49
21,r_288_106_123,r_252_202_141,seq84,r_288_106_123,1.0,0,123,123,49
38,r_158_300_77,r_145_186_172,seq302,r_158_300_77,0.54,0,77,77,49
49,r_91_59_177,seq90,r_333_219_73,r_91_59_177,0.69,5,182,177,49
31,r_366_155_167,seq75,r_153_254_44,r_366_155_167,0.9,1,168,167,49
29,r_46_295_89,seq121,r_54_336_17,r_46_295_89,1.0,0,89,89,49
63,r_352_282_128,seq214,r_123_27_113,r_352_282_128,0.87,1,129,128,49
39,r_135_211_63,seq332,seq233,r_135_211_63,1.0,0,63,63,49
30,r_94_322_43,r_129_20_178,seq326,r_94_322_43,1.0,0,43,43,49
149,seq75,r_366_155_167,r_54_336_17,r_54_336_17,0.98,4,21,17,49
44,r_168_41_197,r_266_173_122,r_178_31_54,r_266_173_122,0.96,0,122,122,49
122,r_298_207_113,seq210,seq55,r_298_207_113,1.0,0,113,113,49
43,r_30_62_153,seq100,seq7,r_30_62_153,1.0,0,153,153,49
42,r_351_154_114,r_277_110_2,seq261,r_351_154_114,1.0,1,115,114,49
3,r_175_316_93,seq302,r_226_38_31,r_226_38_31,0.55,62,93,31,49
101,r_319_3_136,r_9_97_74,r_356_355_149,r_319_3_136,1.0,1,137,136,49
0,r_203_177_30,r_111_188_89,seq72,r_203_177_30,1.0,2,32,30,49
51,r_306_45_27,r_361_49_59,seq338,r_361_49_59,0.98,-24,35,59,49
112,r_92_99_63,r_301_141_71,seq291,r_92_99_63,0.87,4,67,63,49
2,r_305_287_87,r_266_173_122,seq302,r_305_287_87,1.0,0,87,87,49
28,r_226_38_31,r_352_282_128,r_175_316_93,r_226_38_31,0.96,0,31,31,49
60,r_339_67_15,seq112,r_14_268_94,r_339_67_15,0.87,-3,12,15,49
89,r_52_51_159,r_213_102_160,r_296_37_94,r_52_51_159,0.93,-42,117,159,49
86,r_162_269_28,r_294_140_44,r_277_110_2,r_294_140_44,0.76,-23,21,44,49
64,r_303_370_177,seq225,r_218_160_16,r_303_370_177,0.99,2,179,177,49
98,r_159_290_196,r_149_36_124,r_5_24_24,r_149_36_124,1.0,0,124,124,49
193,seq231,r_213_102_160,seq117,r_213_102_160,0.95,-17,143,160,49
76,r_337_29_182,seq289,r_184_124_186,r_337_29_182,0.96,1,183,182,49
120,r_221_227_38,r_193_70_197,r_15_101_27,r_221_227_38,1.0,2,40,38,49
207,seq261,seq47,r_351_154_114,r_351_154_114,1.0,12,126,114,49
73,r_359_58_91,r_271_373_155,r_209_353_186,r_359_58_91,1.0,0,91,91,49
24,r_206_323_164,seq292,r_216_138_70,r_206_323_164,1.0,0,164,164,49
14,r_129_20_178,r_271_373_155,seq210,r_271_373_155,0.64,-117,38,155,49
77,r_362_307_179,seq326,r_130_35_14,r_362_307_179,0.99,3,182,179,49
53,r_263_119_147,r_249_299_173,r_278_220_41,r_263_119_147,0.66,0,147,147,49
10,r_6_115_68,seq267,seq69,r_6_115_68,1.0,0,68,68,49
104,r_179_199_121,seq225,r_162_269_28,r_179_199_121,0.67,8,129,121,49
226,seq294,r_307_76_103,seq158,r_307_76_103,1.0,0,103,103,50
19,r_344_347_33,seq121,seq79,r_344_347_33,0.96,10,43,33,50
80,r_21_301_76,r_371_123_93,seq250,r_21_301_76,1.0,0,76,76,50
101,r_334_105_15,r_34_290_104,r_190_317_187,r_334_105_15,0.92,4,19,15,50
114,r_261_116_124,seq194,r_373_324_13,r_261_116_124,1.0,6,130,124,50
195,seq225,r_167_282_107,r_38_322_54,r_38_322_54,0.93,75,129,54,50
136,seq41,r_185_293_149,r_374_119_8,r_185_293_149,1.0,1,150,149,50
55,r_187_339_140,r_269_135_182,r_173_58_6,r_187_339_140,1.0,0,140,140,50
9,r_96_366_170,seq77,r_34_290_104,r_96_366_170,1.0,0,170,170,50
178,seq178,r_333_75_170,r_302_133_6,r_333_75_170,1.0,-1,169,170,50
82,r_139_180_141,seq66,r_286_325_66,r_139_180_141,0.86,4,145,141,50
8,r_144_78_172,seq104,r_302_133_6,r_144_78_172,1.0,0,172,172,50
44,r_273_321_132,r_161_10_151,seq137,r_273_321_132,1.0,0,132,132,50
123,r_111_142_165,seq200,r_302_133_6,r_111_142_165,0.99,1,166,165,50
56,r_243_140_178,r_6_251_61,r_70_342_134,r_243_140_178,1.0,0,178,178,50
32,r_72_183_96,r_338_115_191,r_13_146_75,r_72_183_96,1.0,0,96,96,50
93,r_308_247_164,r_362_117_163,r_266_311_73,r_308_247_164,1.0,0,164,164,50
105,r_35_218_58,seq280,r_5_127_55,r_35_218_58,0.88,13,71,58,50
202,seq239,r_367_141_131,r_67_357_93,r_367_141_131,0.88,-8,123,131,50
200,seq237,r_360_216_186,r_288_207_96,r_288_207_96,1.0,4,100,96,50
101,r_334_105_15,r_190_317_187,r_126_94_123,r_334_105_15,0.7,115,130,15,50
97,r_179_47_92,r_273_321_132,seq265,r_179_47_92,0.88,0,92,92,50
27,r_213_1_23,r_14_359_184,seq306,r_213_1_23,0.98,1,24,23,50
39,r_148_355_70,seq260,seq121,r_148_355_70,0.98,-2,68,70,50
100,r_341_74_144,r_190_317_187,r_5_127_55,r_341_74_144,0.68,0,144,144,50
226,seq294,seq158,r_96_366_170,r_96_366_170,0.95,3,173,170,50
78,r_327_92_150,seq252,r_5_127_55,r_327_92_150,1.0,0,150,150,50
56,r_243_140_178,seq186,r_6_251_61,r_6_251_61,1.0,5,66,61,50
175,seq166,seq304,r_314_195_79,r_314_195_79,1.0,0,79,79,50
15,r_113_219_48,seq101,seq98,r_113_219_48,1.0,0,48,48,50
13,r_93_350_108,r_151_196_105,r_175_315_52,r_93_350_108,0.99,0,108,108,50
37,r_276_82_175,seq39,r_68_12_3,r_276_82_175,0.87,3,178,175,50
22,r_5_127_55,r_198_69_166,seq364,r_5_127_55,1.0,1,56,55,50
83,r_150_22_174,seq292,seq193,r_150_22_174,0.87,0,174,174,50
112,r_208_256_41,r_14_359_184,r_156_130_1,r_208_256_41,0.99,0,41,41,50
109,r_343_8_79,seq200,r_230_162_70,r_343_8_79,1.0,1,80,79,50
91,r_34_290_104,seq9,seq263,r_34_290_104,1.0,0,104,104,50
88,r_286_325_66,r_0_257_144,seq165,r_286_325_66,1.0,0,66,66,50
94,r_91_50_143,r_0_257_144,r_345_157_98,r_91_50_143,0.99,0,143,143,50
24,r_313_234_42,r_45_188_190,seq285,r_313_234_42,1.0,0,42,42,50
11,r_32_212_66,r_230_162_70,r_204_236_5,r_32_212_66,1.0,0,66,66,50
90,r_307_76_103,seq294,r_371_123_93,r_307_76_103,1.0,0,103,103,50
75,r_175_315_52,r_170_87_76,seq189,r_175_315_52,1.0,0,52,52,50
43,r_221_31_13,r_150_22_174,seq272,r_221_31_13,0.85,-1,12,13,50
77,r_235_258_113,r_185_293_149,seq351,r_235_258_113,0.96,0,113,113,50
52,r_369_53_11,r_288_207_96,seq121,r_369_53_11,0.87,0,11,11,50
4,r_14_359_184,r_204_236_5,r_333_75_170,r_14_359_184,0.81,0,184,184,50
23,r_51_310_69,seq101,seq191,r_51_310_69,1.0,0,69,69,50
38,r_3_7_120,seq228,r_230_162_70,r_3_7_120,1.0,0,120,120,50
69,r_83_84_133,r_177_214_156,r_143_275_53,r_83_84_133,1.0,0,133,133,50
4,r_14_359_184,r_208_256_41,r_204_236_5,r_208_256_41,1.0,0,41,41,50
31,r_155_71_63,r_343_8_79,seq211,r_155_71_63,1.0,0,63,63,50
185,seq193,seq272,r_131_337_101,r_131_337_101,1.0,27,128,101,50
46,r_124_241_52,r_34_290_104,seq99,r_124_241_52,0.96,0,52,52,50
17,r_371_123_93,r_229_163_156,r_148_355_70,r_371_123_93,1.0,4,97,93,50
7,r_255_297_72,r_323_168_196,seq36,r_255_297_72,1.0,0,72,72,50
158,seq104,r_144_78_172,r_227_28_20,r_144_78_172,1.0,-1,171,172,50
116,r_246_244_61,seq211,seq101,r_246_244_61,1.0,0,61,61,50
51,r_190_317_187,r_164_233_119,r_333_75_170,r_190_317_187,1.0,0,187,187,50
106,r_6_251_61,r_243_140_178,seq79,r_243_140_178,1.0,-4,174,178,50
48,r_227_28_20,r_95_108_60,seq104,r_227_28_20,0.76,1,21,20,50
99,r_147_18_168,seq121,r_273_321_132,r_147_18_168,0.88,0,168,168,50
59,r_52_43_108,r_345_157_98,r_37_210_142,r_37_210_142,1.0,0,142,142,50
73,r_348_128_111,r_145_336_6,r_68_12_3,r_348_128_111,1.0,0,111,111,50
76,r_173_58_6,r_139_180_141,r_187_339_140,r_187_339_140,0.92,0,140,140,50
62,r_328_40_71,seq361,r_5_127_55,r_328_40_71,0.97,0,71,71,50
57,r_0_257_144,seq46,r_88_203_107,r_0_257_144,0.75,0,144,144,50
0,r_170_87_76,seq363,seq306,r_170_87_76,0.99,0,76,76,50
59,r_52_43_108,r_164_233_119,r_345_157_98,r_52_43_108,0.77,4,112,108,50
108,r_303_274_102,seq171,r_345_157_98,r_303_274_102,1.0,1,103,102,50
12,r_153_152_76,seq39,seq252,r_153_152_76,0.95,0,76,76,50
91,r_34_290_104,seq263,r_367_141_131,r_367_141_131,0.81,32,163,131,50
110,r_24_217_67,r_139_180_141,r_102_19_197,r_24_217_67,1.0,0,67,67,50
111,r_61_319_172,seq224,r_177_214_156,r_61_319_172,1.0,0,172,172,50
148,seq77,r_96_366_170,r_266_311_73,r_96_366_170,1.0,-1,169,170,50
106,r_6_251_61,r_34_290_104,r_243_140_178,r_6_251_61,1.0,2,63,61,50
118,r_356_15_121,seq99,r_38_322_54,r_356_15_121,0.88,0,121,121,50
104,r_59_129_68,r_177_214_156,seq268,r_59_129_68,0.99,0,68,68,50
95,r_185_293_149,seq41,r_313_234_42,r_185_293_149,1.0,1,150,149,50
85,r_202_295_125,seq158,r_88_203_107,r_202_295_125,1.0,1,126,125,50
3,r_333_75_170,seq178,r_187_339_140,r_333_75_170,1.0,0,170,170,50
63,r_326_169_87,seq165,seq181,r_326_169_87,1.0,0,87,87,50
117,r_67_357_93,r_88_203_107,seq239,r_67_357_93,0.68,0,93,93,50
72,r_277_289_77,seq109,r_124_241_52,r_277_289_77,1.0,2,79,77,50
103,r_138_305_58,seq260,seq46,r_138_305_58,1.0,0,58,58,50
71,r_151_196_105,seq99,r_143_275_53,r_151_196_105,0.79,10,115,105,50
66,r_199_329_57,seq335,seq200,r_199_329_57,1.0,0,57,57,50
135,seq39,r_153_152_76,seq194,r_153_152_76,1.0,0,76,76,50
74,r_229_163_156,seq2,r_32_212_66,r_229_163_156,0.96,2,158,156,50
25,r_95_108_60,r_151_196_105,r_230_162_70,r_95_108_60,1.0,0,60,60,50
47,r_13_146_75,r_174_209_49,r_72_183_96,r_72_183_96,1.0,-2,94,96,50
21,r_88_203_107,seq159,seq9,r_88_203_107,0.98,0,107,107,50
6,r_230_162_70,seq304,r_95_108_60,r_95_108_60,1.0,11,71,60,50
115,r_85_370_175,seq242,r_288_207_96,r_85_370_175,1.0,0,175,175,50
86,r_56_81_154,r_229_163_156,r_37_210_142,r_56_81_154,0.65,0,154,154,50
28,r_11_118_19,r_243_140_178,seq349,r_11_118_19,0.98,0,19,19,50
18,r_70_342_134,seq159,r_221_31_13,r_70_342_134,1.0,4,138,134,50
53,r_320_122_44,r_245_23_193,seq226,r_320_122_44,1.0,0,44,44,50
16,r_45_188_190,seq77,r_155_71_63,r_45_188_190,1.0,0,190,190,50
34,r_131_337_101,r_230_162_70,seq193,r_131_337_101,1.0,0,101,101,50
33,r_204_236_5,r_14_359_184,r_32_212_66,r_32_212_66,1.0,14,80,66,50
2,r_288_207_96,seq272,seq237,r_288_207_96,1.0,2,98,96,50
194,seq224,r_61_319_172,r_345_157_98,r_61_319_172,1.0,-12,160,172,50
65,r_318_223_99,seq79,r_32_212_66,r_318_223_99,0.86,1,100,99,50
113,r_17_352_49,r_276_82_175,seq104,r_17_352_49,0.85,4,53,49,50
64,r_249_262_48,r_0_257_144,r_230_162_70,r_249_262_48,1.0,0,48,48,50
49,r_177_214_156,seq154,r_59_129_68,r_177_214_156,0.86,0,156,156,50
119,r_134_20_93,r_367_141_131,r_102_19_197,r_367_141_131,1.0,-18,113,131,50
41,r_37_210_142,seq263,r_52_43_108,r_37_210_142,1.0,1,143,142,50
102,r_367_141_131,r_134_20_93,r_34_290_104,r_134_20_93,0.89,38,131,93,50
58,r_368_254_155,r_245_23_193,seq260,r_368_254_155,1.0,0,155,155,50
186,seq194,r_261_116_124,seq39,r_261_116_124,1.0,-49,75,124,50
196,seq226,seq270,r_320_122_44,r_320_122_44,1.0,13,57,44,50
60,r_25_63_187,seq98,r_255_297_72,r_25_63_187,0.55,0,187,187,50
122,r_125_176_21,r_44_197_193,seq103,r_125_176_21,1.0,0,21,21,50
147,seq73,r_198_69_166,seq365,r_198_69_166,1.0,-14,152,166,50
40,r_38_322_54,r_273_321_132,seq225,r_38_322_54,0.8,0,54,54,50
79,r_161_10_151,r_283_331_164,r_124_241_52,r_283_331_164,0.92,-6,158,164,50
107,r_80_248_40,r_139_180_141,r_373_324_13,r_80_248_40,1.0,1,41,40,50
98,r_143_275_53,r_51_310_69,r_125_176_21,r_125_176_21,1.0,32,53,21,50
84,r_126_94_123,seq259,r_334_105_15,r_126_94_123,0.94,5,128,123,50
149,seq79,r_318_223_99,seq215,r_318_223_99,1.0,1,100,99,50
70,r_360_216_186,seq237,r_70_342_134,r_360_216_186,0.59,-1,185,186,50
92,r_279_184_149,r_269_135_182,r_345_157_98,r_345_157_98,0.52,52,150,98,50
5,r_174_209_49,r_341_74_144,seq9,r_174_209_49,0.94,0,49,49,50
121,r_283_331_164,seq206,r_167_282_107,r_283_331_164,0.96,0,164,164,50
81,r_362_117_163,seq29,seq149,r_362_117_163,0.91,4,167,163,50
54,r_314_195_79,r_356_15_121,seq166,r_314_195_79,1.0,0,79,79,50
1,r_64_222_163,seq292,r_35_218_58,r_64_222_163,1.0,2,165,163,50
47,r_13_146_75,r_85_370_175,r_174_209_49,r_13_146_75,0.82,0,75,75,50
78,r_268_215_126,r_138_131_131,r_192_251_58,r_268_215_126,0.83,3,129,126,51
39,r_291_342_148,seq198,seq256,r_291_342_148,1.0,0,148,148,51
37,r_178_323_105,r_105_79_5,r_330_154_14,r_178_323_105,1.0,0,105,105,51
147,seq94,seq205,r_47_283_97,r_47_283_97,1.0,0,97,97,51
98,r_222_39_117,r_1_113_85,seq87,r_222_39_117,0.91,-1,116,117,51
123,r_227_259_177,r_362_196_191,r_76_310_114,r_227_259_177,0.99,0,177,177,51
97,r_47_283_97,seq144,seq94,r_47_283_97,1.0,0,97,97,51
124,r_335_324_34,seq103,seq117,r_335_324_34,1.0,2,36,34,51
45,r_242_73_132,r_125_28_107,r_148_244_76,r_242_73_132,0.65,-37,95,132,51
120,r_99_150_135,r_209_115_184,seq206,r_99_150_135,1.0,0,135,135,51
160,seq121,r_17_162_50,r_255_70_142,r_255_70_142,0.98,0,142,142,51
26,r_4_212_62,r_291_342_148,seq352,r_4_212_62,0.96,1,63,62,51
5,r_214_266_139,seq337,r_189_12_21,r_214_266_139,1.0,0,139,139,51
119,r_76_310_114,r_359_98_4,seq338,r_76_310_114,1.0,0,114,114,51
27,r_204_159_121,seq239,seq182,r_204_159_121,1.0,0,121,121,51
80,r_233_202_60,seq30,seq337,r_233_202_60,1.0,0,60,60,51
110,r_371_62_22,r_14_321_38,seq66,r_371_62_22,1.0,-1,21,22,51
70,r_177_136_164,r_269_347_10,r_316_245_136,r_177_136_164,0.9,3,167,164,51
28,r_179_92_146,seq344,r_80_78_123,r_179_92_146,1.0,0,146,146,51
64,r_297_258_71,seq205,seq85,r_297_258_71,1.0,0,71,71,51
18,r_209_115_184,seq50,r_308_104_58,r_209_115_184,0.82,1,185,184,51
9,r_288_128_169,r_315_360_85,r_243_373_52,r_288_128_169,1.0,-117,52,169,51
189,seq203,r_191_305_96,seq331,r_191_305_96,1.0,0,96,96,51
122,r_41_304_46,r_151_334_187,r_105_79_5,r_41_304_46,1.0,-1,45,46,51
6,r_63_358_122,seq303,seq109,r_63_358_122,1.0,0,122,122,51
53,r_299_170_34,r_343_123_198,r_80_78_123,r_299_170_34,1.0,0,34,34,51
53,r_299_170_34,r_80_78_123,r_242_73_132,r_80_78_123,0.76,0,123,123,51
9,r_288_128_169,r_243_373_52,r_63_358_122,r_288_128_169,0.98,2,171,169,51
181,seq186,r_332_184_118,r_348_325_10,r_332_184_118,1.0,0,118,118,51
75,r_286_236_144,seq206,r_214_266_139,r_286_236_144,1.0,0,144,144,51
0,r_160_366_69,r_2_307_194,r_42_361_20,r_160_366_69,1.0,0,69,69,51
13,r_348_325_10,r_332_184_118,r_16_279_15,r_332_184_118,1.0,0,118,118,51
176,seq172,r_288_128_169,r_314_270_37,r_314_270_37,1.0,-2,35,37,51
106,r_8_158_141,seq260,r_4_212_62,r_8_158_141,0.92,1,142,141,51
85,r_69_165_77,r_191_305_96,seq19,r_69_165_77,1.0,0,77,77,51
31,r_58_56_12,seq260,r_7_296_171,r_7_296_171,0.9,0,171,171,51
115,r_80_78_123,seq51,r_299_170_34,r_299_170_34,0.95,0,34,34,51
91,r_370_253_112,r_372_139_188,r_47_283_97,r_370_253_112,1.0,0,112,112,51
51,r_189_12_21,r_48_37_144,seq239,r_189_12_21,1.0,0,21,21,51
86,r_294_319_182,seq157,r_155_10_23,r_294_319_182,1.0,0,182,182,51
10,r_372_139_188,r_40_174_65,r_48_37_144,r_372_139_188,0.67,0,188,188,51
52,r_125_28_107,r_242_73_132,seq182,r_125_28_107,0.91,1,108,107,51
93,r_341_11_102,r_362_196_191,r_108_293_79,r_362_196_191,1.0,-89,102,191,51
54,r_180_49_120,seq295,r_163_32_122,r_180_49_120,1.0,1,121,120,51
116,r_40_174_65,seq83,r_372_139_188,r_40_174_65,1.0,-1,64,65,51
65,r_255_70_142,r_93_119_147,seq121,r_255_70_142,0.79,-1,141,142,51
7,r_332_184_118,seq186,r_210_351_32,r_332_184_118,1.0,0,118,118,51
13,r_348_325_10,r_372_139_188,r_332_184_118,r_348_325_10,0.89,1,11,10,51
88,r_7_296_171,seq130,r_58_56_12,r_7_296_171,0.9,0,171,171,51
45,r_242_73_132,r_148_244_76,r_348_325_10,r_242_73_132,0.67,2,134,132,51
82,r_35_317_161,r_133_23_92,r_40_174_65,r_35_317_161,1.0,0,161,161,51
34,r_17_162_50,r_372_139_188,seq235,r_17_162_50,0.94,-2,48,50,51
107,r_169_153_148,seq257,r_4_212_62,r_169_153_148,0.88,0,148,148,51
100,r_42_361_20,seq95,seq144,r_42_361_20,0.76,0,20,20,51
40,r_14_321_38,r_1_113_85,seq77,r_14_321_38,0.88,-1,37,38,51
81,r_133_23_92,r_35_317_161,r_163_32_122,r_133_23_92,0.96,32,124,92,51
10,r_372_139_188,r_370_253_112,r_40_174_65,r_372_139_188,0.9,-123,65,188,51
207,seq248,r_168_106_169,r_155_10_23,r_168_106_169,1.0,2,171,169,51
61,r_194_199_121,r_374_5_122,r_353_175_17,r_194_199_121,1.0,0,121,121,51
76,r_213_272_146,seq137,r_204_159_121,r_204_159_121,0.66,25,146,121,51
22,r_148_244_76,seq100,seq130,r_148_244_76,1.0,0,76,76,51
114,r_357_122_44,r_231_90_120,seq51,r_357_122_44,0.96,0,44,44,51
19,r_105_79_5,r_178_323_105,r_41_304_46,r_105_79_5,0.99,63,68,5,51
111,r_289_250_51,r_291_342_148,seq256,r_289_250_51,0.6,-2,49,51,51
31,r_58_56_12,r_48_37_144,seq260,r_58_56_12,0.47,1,13,12,51
115,r_80_78_123,r_299_170_34,seq282,r_80_78_123,1.0,0,123,123,51
116,r_40_174_65,r_372_139_188,r_35_317_161,r_35_317_161,0.96,11,172,161,51
79,r_271_59_14,r_332_184_118,seq185,r_332_184_118,0.52,-104,14,118,51
197,seq225,r_288_128_169,r_84_146_29,r_84_146_29,1.0,0,29,29,51
118,r_31_340_176,seq292,seq110,r_31_340_176,0.91,7,183,176,51
25,r_88_232_76,seq94,seq363,r_88_232_76,1.0,0,76,76,51
68,r_315_360_85,r_288_128_169,r_263_72_17,r_315_360_85,1.0,0,85,85,51
36,r_3_226_135,r_209_115_184,r_263_72_17,r_3_226_135,1.0,0,135,135,51
134,seq45,r_166_356_165,r_192_251_58,r_192_251_58,0.97,2,60,58,51
47,r_267_350_171,seq97,r_14_321_38,r_267_350_171,1.0,0,171,171,51
72,r_207_101_42,seq149,r_262_55_53,r_262_55_53,0.99,11,64,53,51
12,r_273_44_18,r_213_272_146,seq367,r_273_44_18,0.91,2,20,18,51
1,r_243_373_52,seq117,r_288_128_169,r_243_373_52,1.0,1,53,52,51
41,r_155_10_23,r_299_170_34,seq97,r_155_10_23,1.0,0,23,23,51
99,r_254_274_71,r_88_232_76,seq30,r_254_274_71,0.79,0,71,71,51
67,r_224_318_31,r_151_334_187,seq260,r_224_318_31,0.96,0,31,31,51
112,r_1_113_85,seq240,r_222_39_117,r_1_113_85,1.0,0,85,85,51
187,seq198,r_291_342_148,seq134,r_291_342_148,1.0,-1,147,148,51
170,seq144,r_288_128_169,r_42_361_20,r_42_361_20,0.83,0,20,20,51
92,r_24_145_34,seq87,seq295,r_24_145_34,0.99,-2,32,34,51
23,r_353_175_17,r_288_128_169,r_216_33_99,r_353_175_17,0.94,0,17,17,51
74,r_0_67_26,r_89_201_159,seq205,r_0_67_26,1.0,-2,24,26,51
63,r_220_25_151,seq367,r_84_146_29,r_220_25_151,1.0,0,151,151,51
59,r_316_245_136,r_365_193_197,seq344,r_316_245_136,1.0,1,137,136,51
66,r_183_173_17,r_166_356_165,r_152_290_5,r_183_173_17,0.98,0,17,17,51
101,r_102_54_186,seq234,r_204_159_121,r_102_54_186,1.0,0,186,186,51
114,r_357_122_44,r_84_146_29,r_231_90_120,r_357_122_44,0.61,-15,29,44,51
11,r_166_356_165,seq45,seq107,r_166_356_165,1.0,0,165,165,51
102,r_191_305_96,seq203,r_353_175_17,r_191_305_96,1.0,0,96,96,51
82,r_35_317_161,r_138_131_131,r_133_23_92,r_133_23_92,0.59,2,94,92,51
87,r_192_251_58,r_35_317_161,seq45,r_192_251_58,1.0,0,58,58,51
35,r_84_146_29,r_357_122_44,seq225,r_84_146_29,1.0,0,29,29,51
1,r_243_373_52,r_288_128_169,r_237_135_65,r_288_128_169,1.0,5,174,169,51
190,seq205,r_297_258_71,r_0_67_26,r_297_258_71,0.6,-9,62,71,51
82,r_35_317_161,r_192_251_58,r_138_131_131,r_192_251_58,0.96,-1,57,58,51
32,r_36_116_152,seq83,r_178_323_105,r_178_323_105,1.0,36,141,105,51
62,r_57_275_114,r_267_350_171,r_345_252_112,r_57_275_114,1.0,0,114,114,51
160,seq121,seq246,r_17_162_50,r_17_162_50,0.56,12,62,50,51
17,r_237_135_65,r_48_37_144,r_243_373_52,r_237_135_65,1.0,0,65,65,51
29,r_22_320_185,r_102_54_186,r_88_232_76,r_88_232_76,0.88,109,185,76,51
98,r_222_39_117,r_17_162_50,r_1_113_85,r_1_113_85,1.0,1,86,85,51
44,r_168_106_169,seq248,r_237_135_65,r_168_106_169,1.0,0,169,169,51
200,seq234,r_102_54_186,r_155_10_23,r_102_54_186,1.0,0,186,186,51
23,r_353_175_17,r_216_33_99,r_191_305_96,r_353_175_17,1.0,82,99,17,51
21,r_89_201_159,seq188,r_14_321_38,r_89_201_159,0.6,6,165,159,51
58,r_161_82_19,r_314_270_37,seq87,r_314_270_37,0.81,-17,20,37,51
60,r_64_61_14,r_216_33_99,seq96,r_64_61_14,0.78,0,14,14,51
104,r_210_351_32,r_148_244_76,seq234,r_210_351_32,1.0,0,32,32,51
30,r_27_52_163,r_209_115_184,seq303,r_27_52_163,1.0,0,163,163,51
81,r_133_23_92,seq197,r_35_317_161,r_133_23_92,0.89,1,93,92,51
71,r_374_5_122,seq66,r_210_351_32,r_374_5_122,1.0,0,122,122,51
55,r_38_60_43,r_179_92_146,r_261_333_7,r_38_60_43,1.0,1,44,43,51
211,seq260,r_322_276_49,r_224_318_31,r_322_276_49,0.7,-17,32,49,51
112,r_1_113_85,r_222_39_117,r_40_174_65,r_222_39_117,0.53,5,122,117,51
89,r_262_55_53,seq281,r_207_101_42,r_262_55_53,1.0,0,53,53,51
3,r_263_72_17,r_35_317_161,r_359_98_4,r_263_72_17,0.98,0,17,17,51
90,r_81_118_174,seq29,r_160_366_69,r_81_118_174,0.9,2,176,174,51
105,r_208_164_144,seq6,seq301,r_208_164_144,1.0,0,144,144,51
38,r_16_279_15,r_288_128_169,r_269_347_10,r_16_279_15,0.83,0,15,15,51
46,r_231_90_120,seq120,r_237_135_65,r_231_90_120,1.0,0,120,120,51
73,r_163_32_122,seq367,r_133_23_92,r_163_32_122,1.0,1,123,122,51
108,r_68_126_90,r_89_201_159,r_263_72_17,r_68_126_90,1.0,1,91,90,51
2,r_345_252_112,seq176,r_207_101_42,r_345_252_112,1.0,1,113,112,51
77,r_314_270_37,seq142,seq172,r_314_270_37,0.98,-1,36,37,51
150,seq97,r_267_350_171,r_155_10_23,r_267_350_171,1.0,0,171,171,51
14,r_74_368_90,r_286_236_144,seq112,r_74_368_90,1.0,0,90,90,51
121,r_309_34_73,r_7_296_171,seq120,r_309_34_73,1.0,0,73,73,51
24,r_308_104_58,seq256,seq124,r_308_104_58,1.0,0,58,58,51
96,r_108_293_79,r_227_259_177,seq130,r_108_293_79,1.0,1,80,79,51
42,r_93_119_147,r_151_334_187,r_263_72_17,r_93_119_147,1.0,0,147,147,51
33,r_322_276_49,seq260,seq240,r_322_276_49,1.0,0,49,49,51
113,r_46_132_112,seq225,r_160_366_69,r_160_366_69,0.97,53,122,69,51
147,seq94,r_88_232_76,seq205,r_88_232_76,0.93,-8,68,76,51
182,seq187,r_332_184_118,r_348_325_10,r_332_184_118,1.0,0,118,118,51
109,r_26_141_83,r_343_123_198,seq195,r_26_141_83,1.0,0,83,83,51
84,r_216_33_99,seq149,r_160_366_69,r_216_33_99,1.0,0,99,99,51
95,r_330_154_14,r_35_317_161,seq172,r_330_154_14,1.0,0,14,14,51
56,r_219_111_115,seq264,seq6,r_219_111_115,1.0,0,115,115,51
15,r_48_37_144,seq295,seq205,r_48_37_144,1.0,0,144,144,51
4,r_138_131_131,r_102_54_186,r_40_174_65,r_138_131_131,1.0,0,131,131,51
48,r_360_167_148,seq194,r_316_192_87,r_316_192_87,0.68,75,162,87,52
20,r_57_1_39,r_282_149_15,r_239_125_129,r_239_125_129,1.0,17,146,129,52
78,r_356_40_158,r_218_271_129,seq59,r_218_271_129,1.0,0,129,129,52
117,r_206_33_40,seq84,seq194,r_206_33_40,0.96,0,40,40,52
4,r_286_102_152,r_94_371_163,r_211_142_40,r_211_142_40,1.0,112,152,40,52
99,r_220_216_104,r_98_212_183,seq311,r_220_216_104,1.0,0,104,104,52
113,r_287_110_142,seq155,seq30,r_287_110_142,1.0,0,142,142,52
47,r_191_227_106,seq164,r_189_20_168,r_191_227_106,1.0,0,106,106,52
20,r_57_1_39,seq36,r_282_149_15,r_57_1_39,0.75,2,41,39,52
39,r_260_200_90,r_144_343_157,seq324,r_260_200_90,1.0,0,90,90,52
28,r_153_50_164,seq184,r_360_167_148,r_153_50_164,1.0,0,164,164,52
23,r_26_138_110,r_137_261_151,r_202_331_7,r_26_138_110,1.0,0,110,110,52
6,r_23_176_162,seq265,r_187_225_47,r_23_176_162,1.0,0,162,162,52
74,r_370_268_166,r_285_31_125,r_201_342_71,r_370_268_166,1.0,3,169,166,52
58,r_281_250_139,seq58,r_77_21_78,r_281_250_139,1.0,6,145,139,52
49,r_238_18_129,seq104,r_260_200_90,r_260_200_90,1.0,61,151,90,52
40,r_210_181_15,seq69,seq324,r_210_181_15,1.0,0,15,15,52
103,r_316_192_87,seq103,r_77_21_78,r_316_192_87,1.0,0,87,87,52
120,r_354_326_120,r_272_62_123,seq155,r_354_326_120,1.0,0,120,120,52
114,r_201_342_71,r_144_343_157,r_370_268_166,r_370_268_166,1.0,7,173,166,52
82,r_154_352_95,seq237,r_47_113_64,r_154_352_95,1.0,0,95,95,52
97,r_319_329_162,seq169,r_68_334_1,r_319_329_162,0.67,-1,161,162,52
62,r_49_124_129,r_285_31_125,seq237,r_49_124_129,1.0,0,129,129,52
123,r_170_256_186,r_349_136_5,r_68_334_1,r_68_334_1,0.49,185,186,1,52
3,r_134_279_65,seq267,r_27_292_9,r_134_279_65,1.0,-1,64,65,52
22,r_285_31_125,r_370_268_166,r_37_228_117,r_285_31_125,1.0,44,169,125,52
109,r_242_17_41,r_65_89_122,seq305,r_65_89_122,0.6,-77,45,122,52
37,r_16_230_29,r_296_128_146,r_114_188_29,r_16_230_29,0.99,0,29,29,52
121,r_137_261_151,seq25,r_340_85_95,r_137_261_151,0.96,0,151,151,52
90,r_275_2_111,seq258,seq162,r_275_2_111,1.0,0,111,111,52
108,r_67_3_133,r_365_259_174,r_374_350_55,r_67_3_133,0.85,0,133,133,52
81,r_241_341_147,r_365_259_174,seq253,r_241_341_147,1.0,1,148,147,52
11,r_244_301_102,seq190,seq101,r_244_301_102,1.0,1,103,102,52
10,r_144_343_157,r_260_200_90,seq35,r_260_200_90,1.0,0,90,90,52
66,r_100_45_180,seq132,r_134_279_65,r_100_45_180,1.0,0,180,180,52
71,r_207_88_82,seq175,seq60,r_207_88_82,1.0,0,82,82,52
15,r_282_149_15,seq101,r_197_290_26,r_197_290_26,0.92,27,53,26,52
15,r_282_149_15,r_94_371_163,seq101,r_282_149_15,0.84,0,15,15,52
1,r_362_131_105,seq169,r_317_315_112,r_362_131_105,1.0,0,105,105,52
50,r_75_185_86,r_356_40_158,r_223_166_59,r_75_185_86,0.85,0,86,86,52
54,r_157_63_15,r_75_185_86,seq169,r_157_63_15,0.76,1,16,15,52
21,r_249_302_178,seq291,r_66_4_177,r_249_302_178,1.0,0,178,178,52
83,r_43_116_92,seq297,seq84,r_43_116_92,1.0,0,92,92,52
80,r_39_53_62,r_349_136_5,seq25,r_39_53_62,1.0,2,64,62,52
89,r_272_62_123,seq311,r_204_280_103,r_272_62_123,1.0,0,123,123,52
5,r_187_225_47,r_272_62_123,seq169,r_187_225_47,1.0,0,47,47,52
101,r_365_259_174,seq35,r_49_124_129,r_365_259_174,1.0,0,174,174,52
35,r_10_56_136,r_245_325_168,r_362_131_105,r_10_56_136,0.67,0,136,136,52
167,seq140,r_319_329_162,r_114_188_29,r_114_188_29,0.97,3,32,29,52
107,r_294_289_116,r_52_87_173,r_79_174_29,r_294_289_116,0.91,2,118,116,52
31,r_318_165_86,seq209,seq219,r_318_165_86,1.0,2,88,86,52
32,r_77_21_78,r_362_131_105,r_316_192_87,r_77_21_78,1.0,10,88,78,52
125,seq0,r_356_40_158,r_224_11_71,r_224_11_71,0.92,87,158,71,52
114,r_201_342_71,seq44,r_144_343_157,r_201_342_71,1.0,0,71,71,52
94,r_299_332_163,seq262,r_68_334_1,r_299_332_163,0.96,5,168,163,52
115,r_320_333_108,seq83,seq58,r_320_333_108,0.99,1,109,108,52
18,r_135_269_107,r_189_20_168,r_120_373_59,r_135_269_107,1.0,0,107,107,52
118,r_204_280_103,r_220_216_104,r_189_20_168,r_204_280_103,1.0,0,103,103,52
60,r_247_173_135,r_296_128_146,r_129_151_1,r_129_151_1,0.64,134,135,1,52
9,r_345_266_131,r_238_18_129,r_134_279_65,r_345_266_131,1.0,2,133,131,52
30,r_79_174_29,r_47_113_64,seq35,r_79_174_29,0.97,0,29,29,52
0,r_274_368_16,r_275_2_111,seq111,r_275_2_111,1.0,-1,110,111,52
59,r_277_359_105,seq59,seq327,r_277_359_105,1.0,0,105,105,52
38,r_37_228_117,r_360_167_148,seq34,r_37_228_117,1.0,0,117,117,52
68,r_122_64_103,seq54,r_150_145_31,r_122_64_103,0.51,23,126,103,52
176,seq169,r_362_131_105,r_187_225_47,r_362_131_105,0.72,0,105,105,52
76,r_314_366_99,seq146,seq190,r_314_366_99,1.0,1,100,99,52
42,r_73_193_44,r_296_128_146,seq251,r_73_193_44,1.0,1,45,44,52
43,r_254_163_116,seq60,seq36,r_254_163_116,0.97,0,116,116,52
19,r_189_20_168,r_281_250_139,seq28,r_281_250_139,0.97,-51,88,139,52
105,r_197_290_26,r_23_176_162,r_282_149_15,r_197_290_26,0.99,0,26,26,52
75,r_114_188_29,r_23_176_162,r_16_230_29,r_114_188_29,0.98,1,30,29,52
55,r_9_283_65,r_244_301_102,seq164,r_9_283_65,1.0,0,65,65,52
53,r_46_105_47,r_133_152_190,seq297,r_46_105_47,0.99,0,47,47,52
95,r_358_217_147,seq222,r_374_350_55,r_358_217_147,1.0,1,148,147,52
68,r_122_64_103,seq335,seq54,r_122_64_103,0.92,0,103,103,52
102,r_95_121_86,seq164,seq109,r_95_121_86,1.0,0,86,86,52
88,r_123_231_111,r_317_315_112,r_264_48_64,r_123_231_111,1.0,0,111,111,52
14,r_296_128_146,seq336,seq28,r_296_128_146,1.0,0,146,146,52
63,r_120_373_59,r_287_110_142,r_32_24_53,r_120_373_59,1.0,0,59,59,52
79,r_29_139_115,seq60,r_260_200_90,r_260_200_90,0.46,25,115,90,52
25,r_27_292_9,r_46_105_47,seq265,r_27_292_9,0.96,1,10,9,52
124,r_340_85_95,r_68_334_1,seq143,r_340_85_95,1.0,1,96,95,52
29,r_224_11_71,seq273,seq307,r_224_11_71,1.0,0,71,71,52
98,r_211_142_40,r_345_266_131,r_285_31_125,r_211_142_40,0.54,0,40,40,52
70,r_150_145_31,r_46_105_47,seq169,r_150_145_31,0.96,0,31,31,52
85,r_351_126_73,r_29_139_115,r_7_312_6,r_351_126_73,1.0,1,74,73,52
7,r_186_159_120,seq58,seq348,r_186_159_120,1.0,0,120,120,52
36,r_22_364_136,r_249_302_178,r_134_279_65,r_22_364_136,1.0,0,136,136,52
46,r_82_96_119,r_298_112_190,r_374_350_55,r_82_96_119,0.87,4,123,119,52
111,r_19_234_12,r_65_89_122,seq194,r_19_234_12,0.64,4,16,12,52
84,r_218_271_129,r_356_40_158,r_154_352_95,r_356_40_158,0.9,-29,129,158,52
27,r_66_4_177,r_372_288_196,r_249_302_178,r_66_4_177,1.0,3,180,177,52
56,r_133_152_190,r_98_212_183,r_296_128_146,r_98_212_183,1.0,7,190,183,52
67,r_161_99_57,seq307,seq97,r_161_99_57,0.89,0,57,57,52
138,seq44,r_201_342_71,seq101,r_201_342_71,1.0,0,71,71,52
12,r_65_89_122,r_100_45_180,r_46_105_47,r_65_89_122,1.0,0,122,122,52
112,r_15_257_57,r_249_302_178,r_157_63_15,r_15_257_57,1.0,0,57,57,52
235,seq335,r_122_64_103,r_374_350_55,r_122_64_103,0.85,0,103,103,52
64,r_52_87_173,seq97,r_362_131_105,r_52_87_173,0.98,1,174,173,52
92,r_118_106_122,r_365_259_174,r_37_228_117,r_118_106_122,0.95,1,123,122,52
52,r_317_315_112,r_365_259_174,r_362_131_105,r_362_131_105,0.64,17,122,105,52
96,r_221_74_77,r_345_266_131,r_47_113_64,r_221_74_77,1.0,3,80,77,52
93,r_303_108_51,r_223_166_59,seq184,r_303_108_51,0.99,0,51,51,52
104,r_86_13_41,r_362_131_105,seq330,r_86_13_41,0.6,0,41,41,52
0,r_274_368_16,r_362_131_105,r_275_2_111,r_274_368_16,1.0,0,16,16,52
13,r_178_147_164,seq58,r_47_113_64,r_178_147_164,0.97,0,164,164,52
41,r_47_113_64,seq214,r_141_367_2,r_47_113_64,1.0,0,64,64,52
2,r_182_172_183,seq34,r_187_225_47,r_182_172_183,1.0,0,183,183,52
100,r_156_293_181,seq109,seq180,r_156_293_181,1.0,0,181,181,52
44,r_374_350_55,seq101,seq61,r_374_350_55,0.96,-2,53,55,52
73,r_93_115_150,seq237,seq103,r_93_115_150,1.0,0,150,150,52
119,r_223_166_59,seq324,r_372_288_196,r_223_166_59,1.0,0,59,59,52
26,r_239_125_129,seq80,seq25,r_239_125_129,1.0,0,129,129,52
44,r_205_362_133,r_278_83_55,r_277_148_125,r_205_362_133,1.0,-3,130,133,53
92,r_354_317_131,seq219,seq197,r_354_317_131,0.98,2,133,131,53
12,r_162_233_33,r_115_303_183,seq7,r_162_233_33,1.0,0,33,33,53
79,r_330_300_67,seq164,seq329,r_330_300_67,0.94,2,69,67,53
99,r_13_204_131,seq356,r_330_300_67,r_13_204_131,0.86,-1,130,131,53
84,r_297_307_107,r_76_95_114,r_262_5_48,r_297_307_107,0.93,0,107,107,53
95,r_304_188_127,r_167_323_120,r_282_11_35,r_304_188_127,1.0,-6,121,127,53
157,seq100,r_309_22_25,r_39_74_25,r_39_74_25,1.0,1,26,25,53
5,r_248_105_25,r_162_233_33,seq52,r_162_233_33,0.49,-7,26,33,53
38,r_97_252_97,r_304_188_127,seq52,r_97_252_97,1.0,1,98,97,53
159,seq104,r_184_156_56,r_61_25_28,r_184_156_56,0.7,0,56,56,53
110,r_140_350_13,r_222_347_81,seq48,r_140_350_13,0.72,0,13,13,53
82,r_201_21_46,r_94_143_174,seq259,r_201_21_46,0.98,0,46,46,53
91,r_238_92_84,r_15_318_166,seq151,r_238_92_84,1.0,0,84,84,53
29,r_332_147_161,seq150,seq355,r_332_147_161,1.0,0,161,161,53
75,r_15_318_166,seq284,r_30_292_87,r_15_318_166,1.0,0,166,166,53
1,r_179_289_50,r_112_372_69,r_320_294_55,r_179_289_50,1.0,10,60,50,53
112,r_224_267_138,seq64,r_61_25_28,r_224_267_138,1.0,0,138,138,53
13,r_81_373_56,seq60,seq259,r_81_373_56,1.0,0,56,56,53
2,r_112_372_69,r_31_58_100,seq138,r_112_372_69,1.0,1,70,69,53
89,r_78_160_157,r_244_133_158,r_222_347_81,r_78_160_157,1.0,0,157,157,53
108,r_37_88_144,r_128_106_197,r_202_28_138,r_37_88_144,1.0,0,144,144,53
71,r_320_294_55,seq203,r_179_289_50,r_320_294_55,1.0,0,55,55,53
25,r_87_9_136,r_181_281_145,r_282_11_35,r_87_9_136,1.0,2,138,136,53
104,r_244_133_158,r_78_160_157,r_337_242_101,r_244_133_158,1.0,0,158,158,53
30,r_271_209_57,r_24_243_89,r_361_144_53,r_271_209_57,1.0,2,59,57,53
65,r_235_269_59,seq20,r_170_29_3,r_235_269_59,1.0,0,59,59,53
42,r_192_45_105,seq139,r_161_93_60,r_192_45_105,1.0,5,110,105,53
23,r_127_265_70,r_119_321_129,seq132,r_127_265_70,1.0,0,70,70,53
100,r_72_89_159,r_152_357_131,r_287_273_57,r_72_89_159,0.79,-63,96,159,53
114,r_0_306_132,seq139,seq228,r_0_306_132,1.0,0,132,132,53
94,r_229_42_142,r_308_253_132,r_142_126_105,r_229_42_142,1.0,1,143,142,53
15,r_353_120_129,r_198_44_174,r_117_113_89,r_353_120_129,1.0,0,129,129,53
115,r_80_343_27,r_179_289_50,seq64,r_80_343_27,1.0,0,27,27,53
20,r_119_321_129,r_59_302_148,r_31_58_100,r_119_321_129,0.91,21,150,129,53
22,r_283_211_191,seq219,r_76_95_114,r_76_95_114,1.0,20,134,114,53
46,r_191_169_161,seq139,seq38,r_191_169_161,0.94,0,161,161,53
93,r_308_253_132,r_229_42_142,r_222_347_81,r_308_253_132,0.91,11,143,132,53
48,r_189_290_155,seq125,r_353_120_129,r_189_290_155,1.0,1,156,155,53
37,r_299_99_126,r_277_148_125,r_6_86_87,r_277_148_125,0.97,1,126,125,53
107,r_225_55_180,r_179_289_50,seq351,r_225_55_180,1.0,0,180,180,53
106,r_315_98_176,r_62_280_144,r_222_347_81,r_315_98_176,0.94,-60,116,176,53
67,r_117_113_89,r_308_253_132,seq145,r_117_113_89,1.0,1,90,89,53
11,r_167_323_120,r_304_188_127,seq183,r_167_323_120,1.0,1,121,120,53
96,r_340_239_141,seq348,seq356,r_340_239_141,0.99,1,142,141,53
66,r_124_336_193,seq67,r_6_86_87,r_6_86_87,1.0,10,97,87,53
193,seq197,r_153_77_86,r_314_220_7,r_153_77_86,1.0,0,86,86,53
62,r_268_256_29,r_192_45_105,r_167_323_120,r_268_256_29,1.0,0,29,29,53
61,r_277_148_125,r_299_99_126,seq79,r_299_99_126,1.0,0,126,126,53
60,r_134_207_61,r_76_95_114,r_80_343_27,r_134_207_61,1.0,0,61,61,53
74,r_202_28_138,r_115_303_183,r_71_109_35,r_202_28_138,1.0,0,138,138,53
155,seq91,r_205_362_133,r_114_36_190,r_205_362_133,1.0,-46,87,133,53
43,r_102_291_67,r_353_120_129,seq228,r_102_291_67,1.0,1,68,67,53
77,r_71_109_35,r_94_143_174,seq223,r_71_109_35,0.86,0,35,35,53
72,r_198_44_174,seq286,r_127_265_70,r_198_44_174,0.94,0,174,174,53
90,r_230_43_171,r_315_98_176,r_146_137_167,r_230_43_171,1.0,0,171,171,53
0,r_222_347_81,r_181_281_145,r_315_98_176,r_222_347_81,1.0,1,82,81,53
80,r_278_83_55,r_320_294_55,r_301_65_3,r_301_65_3,1.0,58,61,3,53
200,seq219,r_27_33_109,r_195_166_30,r_27_33_109,0.49,-13,96,109,53
36,r_153_77_86,seq197,seq285,r_153_77_86,1.0,0,86,86,53
45,r_346_327_65,r_205_362_133,r_361_144_53,r_346_327_65,0.98,0,65,65,53
205,seq241,r_334_121_122,r_119_321_129,r_334_121_122,1.0,0,122,122,53
0,r_222_347_81,r_315_98_176,r_238_92_84,r_315_98_176,0.95,0,176,176,53
106,r_315_98_176,r_222_347_81,r_167_323_120,r_315_98_176,0.8,0,176,176,53
32,r_31_58_100,r_149_217_97,seq241,r_31_58_100,1.0,0,100,100,53
34,r_227_358_158,seq190,r_268_256_29,r_227_358_158,1.0,0,158,158,53
116,r_325_213_160,r_128_106_197,r_81_373_56,r_325_213_160,1.0,0,160,160,53
118,r_328_359_77,seq355,seq60,r_328_359_77,1.0,4,81,77,53
49,r_85_322_54,seq68,r_262_5_48,r_85_322_54,0.96,0,54,54,53
111,r_339_237_45,seq228,r_268_256_29,r_339_237_45,1.0,0,45,45,53
81,r_41_364_93,r_225_55_180,r_282_11_35,r_282_11_35,0.99,1,36,35,53
121,r_27_33_109,seq219,r_127_265_70,r_27_33_109,1.0,0,109,109,53
57,r_24_243_89,seq366,seq200,r_24_243_89,0.92,0,89,89,53
68,r_287_273_57,r_222_347_81,r_72_89_159,r_287_273_57,1.0,0,57,57,53
64,r_182_232_60,seq223,seq145,r_182_232_60,1.0,0,60,60,53
178,seq164,r_330_300_67,seq155,r_330_300_67,0.98,2,69,67,53
105,r_12_231_107,r_181_281_145,r_328_359_77,r_12_231_107,1.0,0,107,107,53
123,r_172_199_97,seq54,seq187,r_172_199_97,0.82,-1,96,97,53
63,r_146_137_167,seq132,seq174,r_146_137_167,1.0,0,167,167,53
73,r_159_295_35,seq79,seq56,r_159_295_35,1.0,0,35,35,53
31,r_30_292_87,r_31_58_100,seq129,r_31_58_100,1.0,-21,79,100,53
117,r_6_86_87,r_299_99_126,r_206_251_91,r_6_86_87,0.87,1,88,87,53
101,r_282_11_35,r_41_364_93,r_205_362_133,r_282_11_35,0.83,58,93,35,53
7,r_279_221_113,seq14,r_301_65_3,r_279_221_113,1.0,0,113,113,53
115,r_80_343_27,seq64,r_134_207_61,r_134_207_61,1.0,25,86,61,53
19,r_161_93_60,r_180_111_168,seq366,r_161_93_60,1.0,1,61,60,53
53,r_94_143_174,r_135_369_177,r_162_233_33,r_94_143_174,1.0,2,176,174,53
9,r_110_10_50,r_368_310_89,r_170_29_3,r_110_10_50,1.0,0,50,50,53
50,r_368_310_89,r_296_173_157,seq130,r_368_310_89,1.0,0,89,89,53
124,r_206_251_91,r_181_281_145,r_6_86_87,r_181_281_145,1.0,-54,91,145,53
68,r_287_273_57,r_72_89_159,r_334_121_122,r_287_273_57,0.55,101,158,57,53
119,r_149_217_97,r_31_58_100,r_328_359_77,r_149_217_97,0.75,3,100,97,53
40,r_35_154_121,seq356,r_338_264_5,r_35_154_121,1.0,0,121,121,53
4,r_184_156_56,r_353_120_129,r_39_74_25,r_184_156_56,1.0,1,57,56,53
58,r_39_74_25,r_124_336_193,seq100,r_39_74_25,0.99,0,25,25,53
83,r_218_84_22,r_69_249_126,r_2_103_2,r_218_84_22,1.0,0,22,22,53
76,r_152_357_131,r_72_89_159,seq203,r_152_357_131,1.0,0,131,131,53
6,r_69_249_126,r_32_123_192,seq158,r_69_249_126,1.0,0,126,126,53
26,r_76_95_114,seq129,r_195_166_30,r_76_95_114,1.0,0,114,114,53
8,r_1_73_84,r_13_204_131,seq212,r_1_73_84,1.0,0,84,84,53
170,seq139,r_192_45_105,r_142_126_105,r_192_45_105,0.48,5,110,105,53
101,r_282_11_35,r_205_362_133,r_304_188_127,r_205_362_133,0.77,-5,128,133,53
10,r_262_5_48,r_114_36_190,seq90,r_262_5_48,1.0,2,50,48,53
87,r_135_369_177,seq52,r_246_66_126,r_135_369_177,1.0,0,177,177,53
27,r_61_25_28,r_299_99_126,seq104,r_61_25_28,1.0,0,28,28,53
78,r_334_121_122,seq241,r_287_273_57,r_334_121_122,1.0,0,122,122,53
54,r_246_66_126,seq175,seq176,r_246_66_126,0.95,1,127,126,53
62,r_268_256_29,r_167_323_120,r_41_364_93,r_167_323_120,0.81,1,121,120,53
101,r_282_11_35,r_78_160_157,r_41_364_93,r_282_11_35,1.0,0,35,35,53
109,r_62_280_144,seq151,r_6_86_87,r_62_280_144,1.0,0,144,144,53
14,r_178_53_89,seq197,seq208,r_178_53_89,1.0,1,90,89,53
35,r_374_263_159,seq8,r_262_5_48,r_374_263_159,1.0,0,159,159,53
127,seq8,r_296_173_157,r_246_66_126,r_296_173_157,1.0,0,157,157,53
44,r_205_362_133,seq344,r_278_83_55,r_278_83_55,1.0,5,60,55,53
81,r_41_364_93,r_282_11_35,r_268_256_29,r_41_364_93,0.84,0,93,93,53
41,r_361_144_53,r_152_357_131,seq194,r_361_144_53,1.0,0,53,53,53
97,r_142_126_105,r_119_321_129,seq18,r_142_126_105,0.99,2,107,105,53
70,r_59_302_148,r_119_321_129,r_81_373_56,r_59_302_148,0.96,2,150,148,53
59,r_326_163_107,seq155,seq228,r_326_163_107,1.0,0,107,107,53
57,r_24_243_89,r_271_209_57,seq366,r_271_209_57,1.0,2,59,57,53
103,r_365_165_157,r_337_242_101,r_195_166_30,r_365_165_157,0.94,9,166,157,53
236,seq344,r_205_362_133,r_301_65_3,r_205_362_133,1.0,-39,94,133,53
100,r_72_89_159,r_287_273_57,r_246_66_126,r_72_89_159,1.0,-1,158,159,53
243,seq356,r_13_204_131,r_340_239_141,r_340_239_141,0.75,-3,138,141,53
86,r_296_173_157,seq8,r_279_221_113,r_296_173_157,1.0,0,157,157,53
133,seq25,r_88_338_179,r_51_227_71,r_51_227_71,0.99,28,99,71,54
8,r_347_144_58,r_51_227_71,seq61,r_51_227_71,0.97,-23,48,71,54
15,r_135_106_92,r_223_161_127,r_329_97_44,r_135_106_92,0.79,0,92,92,54
116,r_46_193_66,seq139,r_329_97_44,r_46_193_66,1.0,0,66,66,54
62,r_104_199_127,seq98,seq74,r_104_199_127,1.0,0,127,127,54
40,r_289_270_90,seq49,r_108_20_55,r_289_270_90,1.0,0,90,90,54
17,r_335_125_70,r_300_136_68,seq352,r_300_136_68,0.43,0,68,68,54
19,r_349_56_117,seq356,r_102_94_97,r_102_94_97,0.99,29,126,97,54
23,r_88_338_179,r_305_32_123,r_70_176_91,r_88_338_179,0.99,-55,124,179,54
97,r_191_327_97,r_90_141_184,r_60_84_64,r_191_327_97,1.0,0,97,97,54
63,r_103_69_112,r_66_183_153,seq341,r_103_69_112,1.0,0,112,112,54
81,r_290_18_29,r_145_224_159,seq337,r_290_18_29,1.0,0,29,29,54
22,r_244_331_79,r_214_148_184,r_371_286_21,r_244_331_79,1.0,1,80,79,54
36,r_309_204_166,seq299,r_135_106_92,r_309_204_166,1.0,0,166,166,54
111,r_253_265_120,r_150_361_175,seq258,r_253_265_120,1.0,0,120,120,54
87,r_150_361_175,seq346,seq39,r_150_361_175,0.99,0,175,175,54
46,r_33_344_137,seq41,r_70_176_91,r_33_344_137,1.0,0,137,137,54
104,r_305_32_123,r_88_338_179,r_288_167_89,r_305_32_123,0.69,1,124,123,54
102,r_128_192_23,r_242_30_107,seq48,r_128_192_23,0.99,-2,21,23,54
71,r_34_207_104,r_66_183_153,seq162,r_34_207_104,1.0,1,105,104,54
16,r_243_133_179,seq279,r_315_151_24,r_243_133_179,0.96,5,184,179,54
25,r_245_363_66,r_311_157_104,r_117_159_21,r_245_363_66,1.0,0,66,66,54
78,r_51_227_71,seq221,seq254,r_51_227_71,1.0,0,71,71,54
76,r_189_6_80,r_326_336_177,r_371_286_21,r_189_6_80,0.99,-4,76,80,54
100,r_62_4_18,r_65_334_134,seq260,r_62_4_18,1.0,0,18,18,54
118,r_8_130_161,r_358_195_12,r_301_367_136,r_8_130_161,0.96,0,161,161,54
14,r_66_183_153,seq275,r_350_340_144,r_66_183_153,1.0,0,153,153,54
9,r_285_282_40,r_45_163_173,seq341,r_285_282_40,1.0,0,40,40,54
96,r_121_240_128,r_243_133_179,r_117_159_21,r_121_240_128,0.76,2,130,128,54
93,r_100_239_13,seq152,seq49,r_100_239_13,0.97,0,13,13,54
241,seq341,r_179_9_131,r_285_282_40,r_285_282_40,1.0,2,42,40,54
123,r_288_167_89,r_121_240_128,seq131,r_288_167_89,1.0,0,89,89,54
114,r_351_370_34,r_33_344_137,r_100_239_13,r_351_370_34,0.96,-2,32,34,54
73,r_47_31_49,r_66_183_153,r_190_129_43,r_47_31_49,0.98,0,49,49,54
67,r_250_44_94,seq116,r_303_93_188,r_250_44_94,1.0,0,94,94,54
208,seq241,r_181_298_132,r_329_97_44,r_329_97_44,0.51,0,44,44,54
56,r_54_63_28,r_45_163_173,r_88_338_179,r_54_63_28,0.99,0,28,28,54
35,r_73_280_91,r_225_200_93,seq7,r_73_280_91,0.94,-3,88,91,54
131,seq22,seq216,r_228_359_30,r_228_359_30,1.0,6,36,30,54
29,r_2_262_124,r_317_109_159,r_209_353_176,r_2_262_124,1.0,1,125,124,54
122,r_108_20_55,r_182_343_127,r_289_270_90,r_108_20_55,0.97,74,129,55,54
108,r_228_359_30,r_309_204_166,seq22,r_228_359_30,1.0,0,30,30,54
125,seq3,r_261_266_69,r_119_35_78,r_119_35_78,1.0,0,78,78,54
244,seq352,r_191_327_97,r_335_125_70,r_191_327_97,0.73,-13,84,97,54
66,r_107_205_25,r_347_144_58,seq341,r_107_205_25,0.98,0,25,25,54
50,r_78_158_29,r_111_312_32,seq221,r_78_158_29,1.0,0,29,29,54
91,r_238_99_50,r_189_6_80,seq127,r_238_99_50,1.0,1,51,50,54
38,r_179_9_131,seq341,r_274_251_8,r_179_9_131,1.0,1,132,131,54
55,r_323_231_167,seq202,r_347_144_58,r_323_231_167,0.82,1,168,167,54
4,r_45_163_173,seq137,r_60_84_64,r_45_163_173,0.91,2,175,173,54
83,r_328_233_91,r_45_163_173,r_290_18_29,r_328_233_91,1.0,1,92,91,54
122,r_108_20_55,r_259_313_185,r_182_343_127,r_108_20_55,1.0,0,55,55,54
72,r_273_52_119,seq173,seq246,r_273_52_119,1.0,0,119,119,54
64,r_307_96_166,seq61,seq72,r_307_96_166,1.0,0,166,166,54
1,r_301_367_136,r_145_224_159,r_189_6_80,r_301_367_136,0.99,3,139,136,54
230,seq299,r_309_204_166,r_182_343_127,r_309_204_166,0.97,0,166,166,54
52,r_357_308_24,seq232,r_358_195_12,r_357_308_24,1.0,0,24,24,54
85,r_42_185_15,r_38_319_194,seq169,r_42_185_15,0.7,0,15,15,54
212,seq254,r_332_218_97,r_51_227_71,r_51_227_71,0.99,26,97,71,54
204,seq221,r_209_353_176,r_12_83_95,r_12_83_95,1.0,10,105,95,54
13,r_230_155_103,r_317_109_159,r_335_125_70,r_230_155_103,0.96,0,103,103,54
79,r_278_213_92,seq184,seq75,r_278_213_92,1.0,0,92,92,54
6,r_225_200_93,r_73_280_91,r_333_249_36,r_225_200_93,1.0,-1,92,93,54
39,r_259_313_185,seq113,r_89_322_8,r_259_313_185,1.0,0,185,185,54
196,seq202,r_323_231_167,seq320,r_323_231_167,1.0,1,168,167,54
49,r_111_312_32,r_78_158_29,r_301_367_136,r_111_312_32,0.65,-4,28,32,54
42,r_303_93_188,r_259_313_185,r_250_44_94,r_250_44_94,1.0,0,94,94,54
99,r_114_68_123,seq36,r_278_213_92,r_114_68_123,1.0,1,124,123,54
80,r_242_30_107,r_45_163_173,seq98,r_242_30_107,1.0,0,107,107,54
75,r_160_1_169,seq208,r_289_270_90,r_160_1_169,0.97,2,171,169,54
2,r_118_373_45,seq19,seq356,r_118_373_45,1.0,-1,44,45,54
77,r_76_40_168,seq86,r_2_262_124,r_76_40_168,0.86,3,171,168,54
121,r_291_57_134,seq49,seq152,r_291_57_134,1.0,0,134,134,54
105,r_70_176_91,r_301_367_136,r_88_338_179,r_70_176_91,1.0,1,92,91,54
112,r_90_141_184,r_191_327_97,r_335_125_70,r_191_327_97,0.53,-12,85,97,54
23,r_88_338_179,r_70_176_91,r_67_188_156,r_88_338_179,0.94,1,180,179,54
101,r_276_234_46,r_187_314_86,r_194_229_110,r_194_229_110,0.89,-64,46,110,54
119,r_181_298_132,seq241,seq173,r_181_298_132,1.0,0,132,132,54
7,r_306_237_28,r_45_163_173,seq139,r_306_237_28,0.83,0,28,28,54
45,r_182_343_127,r_45_163_173,seq299,r_182_343_127,0.97,2,129,127,54
105,r_70_176_91,r_88_338_179,r_33_344_137,r_70_176_91,0.6,90,181,91,54
27,r_271_281_130,r_45_163_173,seq113,r_271_281_130,1.0,1,131,130,54
109,r_296_24_102,seq86,seq48,r_296_24_102,0.84,9,111,102,54
107,r_236_134_169,seq337,r_301_367_136,r_236_134_169,0.99,3,172,169,54
34,r_369_366_125,seq206,r_225_200_93,r_369_366_125,1.0,0,125,125,54
106,r_190_129_43,seq355,r_111_312_32,r_190_129_43,1.0,0,43,43,54
69,r_67_188_156,r_150_361_175,r_290_18_29,r_67_188_156,1.0,0,156,156,54
89,r_143_325_156,seq146,r_187_314_86,r_143_325_156,0.95,0,156,156,54
41,r_12_83_95,r_268_374_94,seq221,r_12_83_95,1.0,0,95,95,54
17,r_335_125_70,seq352,r_230_155_103,r_335_125_70,0.5,85,155,70,54
49,r_111_312_32,r_301_367_136,r_190_129_43,r_190_129_43,0.82,5,48,43,54
179,seq162,r_259_313_185,r_34_207_104,r_34_207_104,1.0,2,106,104,54
11,r_71_87_38,r_329_97_44,seq80,r_71_87_38,1.0,0,38,38,54
3,r_371_286_21,r_104_199_127,r_311_157_104,r_311_157_104,0.53,-83,21,104,54
31,r_145_224_159,r_301_367_136,seq152,r_301_367_136,0.95,3,139,136,54
92,r_350_340_144,seq36,r_100_239_13,r_350_340_144,1.0,0,144,144,54
18,r_268_374_94,seq246,r_269_149_7,r_268_374_94,0.75,32,126,94,54
68,r_310_79_134,r_371_286_21,r_198_248_57,r_310_79_134,1.0,0,134,134,54
84,r_187_314_86,seq352,seq142,r_187_314_86,1.0,1,87,86,54
56,r_54_63_28,r_88_338_179,r_51_227_71,r_51_227_71,0.68,28,99,71,54
68,r_310_79_134,r_245_363_66,r_371_286_21,r_245_363_66,0.67,-43,23,66,54
90,r_60_84_64,r_119_35_78,seq17,r_60_84_64,0.85,0,64,64,54
12,r_217_354_70,r_323_231_167,seq137,r_217_354_70,1.0,-1,69,70,54
124,r_212_10_103,seq131,seq105,r_212_10_103,1.0,0,103,103,54
28,r_300_136_68,r_335_125_70,seq137,r_300_136_68,1.0,0,68,68,54
112,r_90_141_184,r_335_125_70,r_182_343_127,r_90_141_184,0.88,0,184,184,54
88,r_198_248_57,seq72,r_310_79_134,r_310_79_134,1.0,0,134,134,54
51,r_329_97_44,r_350_340_144,seq241,r_329_97_44,0.86,0,44,44,54
120,r_0_5_181,seq142,r_66_183_153,r_0_5_181,0.78,0,181,181,54
5,r_332_218_97,seq254,r_288_167_89,r_288_167_89,1.0,26,115,89,54
133,seq25,r_51_227_71,r_145_224_159,r_145_224_159,0.54,4,163,159,54
113,r_140_255_121,r_259_313_185,r_153_138_9,r_140_255_121,1.0,0,121,121,54
24,r_65_334_134,seq221,r_245_363_66,r_65_334_134,0.98,0,134,134,54
26,r_317_109_159,r_236_134_169,r_315_151_24,r_317_109_159,1.0,0,159,159,54
117,r_311_157_104,r_245_363_66,r_371_286_21,r_311_157_104,0.55,-81,23,104,54
103,r_59_95_182,seq17,r_289_270_90,r_59_95_182,0.98,1,183,182,54
39,r_259_313_185,r_140_255_121,seq113,r_140_255_121,1.0,0,121,121,54
10,r_89_322_8,r_315_151_24,seq279,r_89_322_8,0.77,3,11,8,54
117,r_311_157_104,r_371_286_21,r_288_167_89,r_311_157_104,0.85,1,105,104,54
82,r_333_249_36,r_335_125_70,seq175,r_333_249_36,0.88,0,36,36,54
3,r_371_286_21,r_311_157_104,r_189_6_80,r_371_286_21,0.58,84,105,21,54
74,r_117_159_21,r_46_193_66,seq146,r_46_193_66,0.82,-46,20,66,54
60,r_214_148_184,seq210,r_118_373_45,r_214_148_184,0.97,0,184,184,54
88,r_198_248_57,r_66_183_153,seq72,r_198_248_57,1.0,1,58,57,54
86,r_223_161_127,r_135_106_92,r_103_69_112,r_223_161_127,1.0,2,129,127,54
31,r_145_224_159,seq152,seq25,r_145_224_159,0.83,3,162,159,54
13,r_9_322_18,r_83_208_109,seq225,r_9_322_18,0.86,0,18,18,55
235,seq337,r_58_134_142,r_370_244_92,r_58_134_142,0.96,3,145,142,55
30,r_319_99_94,seq331,seq57,r_319_99_94,1.0,0,94,94,55
112,r_140_229_91,r_224_281_115,seq205,r_224_281_115,1.0,-21,94,115,55
71,r_104_335_120,r_22_127_168,r_23_96_8,r_104_335_120,1.0,1,121,120,55
17,r_137_100_56,r_282_146_94,seq0,r_137_100_56,1.0,1,57,56,55
70,r_120_257_147,seq297,seq266,r_120_257_147,0.99,0,147,147,55
229,seq327,r_215_323_125,r_68_122_68,r_215_323_125,1.0,0,125,125,55
92,r_235_228_60,r_71_285_161,seq249,r_235_228_60,1.0,0,60,60,55
169,seq135,r_215_323_125,r_68_122_68,r_215_323_125,1.0,-30,95,125,55
177,seq161,seq243,r_76_37_85,r_76_37_85,1.0,0,85,85,55
102,r_277_75_122,seq158,r_307_197_97,r_277_75_122,0.77,-7,115,122,55
68,r_114_203_119,seq311,r_235_228_60,r_114_203_119,0.58,-7,112,119,55
22,r_103_350_17,r_260_67_78,seq210,r_103_350_17,1.0,0,17,17,55
31,r_168_8_15,seq202,seq63,r_168_8_15,0.97,0,15,15,55
139,seq49,r_44_95_126,r_216_31_11,r_44_95_126,1.0,0,126,126,55
5,r_355_33_4,r_107_45_94,r_213_172_34,r_213_172_34,1.0,25,59,34,55
90,r_3_174_85,r_181_358_183,r_86_38_70,r_86_38_70,0.52,19,89,70,55
35,r_237_357_190,seq182,r_355_33_4,r_237_357_190,0.97,0,190,190,55
69,r_239_119_87,seq82,seq147,r_239_119_87,0.98,2,89,87,55
6,r_326_362_73,r_215_323_125,seq251,r_326_362_73,0.95,0,73,73,55
12,r_213_172_34,r_20_255_84,r_355_33_4,r_213_172_34,0.81,0,34,34,55
53,r_284_26_106,seq234,seq90,r_284_26_106,1.0,0,106,106,55
178,seq166,r_98_24_125,seq311,r_98_24_125,1.0,0,125,125,55
99,r_196_312_185,seq57,r_286_247_85,r_196_312_185,0.8,0,185,185,55
15,r_286_247_85,r_120_257_147,seq366,r_286_247_85,0.53,0,85,85,55
111,r_280_116_112,seq63,seq30,r_280_116_112,1.0,1,113,112,55
8,r_48_184_103,seq0,r_87_268_1,r_48_184_103,0.7,7,110,103,55
49,r_224_281_115,r_343_354_138,r_233_221_26,r_233_221_26,0.98,89,115,26,55
115,r_136_214_79,r_20_255_84,r_324_314_13,r_136_214_79,1.0,1,80,79,55
199,seq234,r_260_67_78,r_79_142_67,r_79_142_67,1.0,0,67,67,55
108,r_262_200_58,seq309,r_290_179_47,r_290_179_47,1.0,15,62,47,55
11,r_36_126_88,seq50,seq318,r_36_126_88,1.0,1,89,88,55
94,r_254_232_138,seq351,r_306_287_47,r_254_232_138,1.0,5,143,138,55
4,r_91_153_11,r_34_204_145,seq301,r_91_153_11,1.0,1,12,11,55
32,r_68_122_68,seq193,seq135,r_68_122_68,0.69,14,82,68,55
120,r_361_101_90,r_83_208_109,seq297,r_361_101_90,1.0,0,90,90,55
58,r_148_66_23,r_107_45_94,seq158,r_148_66_23,0.58,1,24,23,55
86,r_263_61_75,seq110,r_87_268_1,r_263_61_75,1.0,0,75,75,55
48,r_176_93_74,r_343_354_138,r_216_31_11,r_176_93_74,0.8,0,74,74,55
113,r_315_74_138,seq249,r_16_207_42,r_315_74_138,0.61,12,150,138,55
156,seq108,r_345_236_166,r_9_322_18,r_345_236_166,0.99,-41,125,166,55
33,r_306_287_47,r_98_24_125,seq349,r_306_287_47,0.49,1,48,47,55
79,r_333_256_78,r_181_358_183,r_171_340_21,r_333_256_78,0.97,-5,73,78,55
2,r_98_24_125,seq166,seq367,r_98_24_125,0.99,0,125,125,55
0,r_345_236_166,seq108,r_137_100_56,r_345_236_166,1.0,0,166,166,55
73,r_188_59_110,seq7,r_295_190_35,r_295_190_35,0.99,9,44,35,55
47,r_35_47_29,r_360_359_55,seq351,r_35_47_29,0.93,0,29,29,55
208,seq272,r_162_320_118,seq194,r_162_320_118,1.0,0,118,118,55
73,r_188_59_110,r_295_190_35,seq121,r_188_59_110,1.0,0,110,110,55
31,r_168_8_15,seq63,r_28_13_57,r_28_13_57,0.76,89,146,57,55
52,r_69_269_130,seq304,seq88,r_69_269_130,1.0,0,130,130,55
144,seq57,r_196_312_185,r_253_43_22,r_253_43_22,0.98,3,25,22,55
190,seq205,seq94,r_140_229_91,r_140_229_91,0.61,26,117,91,55
34,r_180_54_59,r_240_374_189,seq349,r_180_54_59,1.0,0,59,59,55
83,r_58_134_142,seq337,seq249,r_58_134_142,0.85,3,145,142,55
118,r_192_143_182,seq97,r_68_122_68,r_192_143_182,0.89,1,183,182,55
51,r_288_52_42,r_98_24_125,seq2,r_288_52_42,1.0,0,42,42,55
25,r_175_165_179,seq198,r_222_40_121,r_175_165_179,0.95,-6,173,179,55
84,r_160_84_161,r_240_374_189,r_9_322_18,r_160_84_161,1.0,0,161,161,55
124,r_163_41_79,seq12,seq158,r_163_41_79,1.0,0,79,79,55
56,r_139_1_149,seq366,r_68_122_68,r_139_1_149,1.0,1,150,149,55
27,r_44_95_126,seq49,r_299_27_109,r_44_95_126,0.75,0,126,126,55
130,seq7,seq55,r_39_353_30,r_39_353_30,1.0,16,46,30,55
77,r_293_17_83,seq205,seq57,r_293_17_83,1.0,0,83,83,55
96,r_324_314_13,r_9_322_18,seq325,r_324_314_13,0.89,1,14,13,55
42,r_86_38_70,seq289,seq113,r_86_38_70,1.0,0,70,70,55
59,r_181_358_183,r_3_174_85,seq50,r_3_174_85,0.84,8,93,85,55
106,r_233_221_26,seq109,r_46_271_109,r_233_221_26,1.0,0,26,26,55
241,seq351,r_254_232_138,r_35_47_29,r_254_232_138,0.99,5,143,138,55
82,r_250_313_186,seq88,r_68_122_68,r_250_313_186,0.98,1,187,186,55
16,r_299_27_109,r_259_300_172,seq123,r_299_27_109,1.0,0,109,109,55
1,r_177_248_94,seq198,r_46_271_109,r_177_248_94,1.0,0,94,94,55
64,r_39_353_30,r_159_72_147,seq7,r_39_353_30,1.0,0,30,30,55
185,seq193,r_68_122_68,r_20_255_84,r_20_255_84,1.0,11,95,84,55
59,r_181_358_183,seq50,r_319_99_94,r_181_358_183,1.0,0,183,183,55
87,r_339_275_90,seq94,seq82,r_339_275_90,1.0,3,93,90,55
81,r_22_127_168,seq341,r_76_37_85,r_22_127_168,1.0,0,168,168,55
74,r_321_238_109,r_345_236_166,seq63,r_321_238_109,1.0,1,110,109,55
93,r_173_60_123,r_107_45_94,r_162_320_118,r_162_320_118,1.0,7,125,118,55
100,r_28_13_57,seq272,r_168_8_15,r_28_13_57,1.0,0,57,57,55
3,r_20_255_84,r_129_270_195,seq193,r_20_255_84,1.0,0,84,84,55
121,r_71_285_161,seq121,seq50,r_71_285_161,1.0,0,161,161,55
127,seq4,r_178_252_180,r_86_38_70,r_178_252_180,0.77,1,181,180,55
67,r_162_320_118,seq272,r_173_60_123,r_162_320_118,1.0,0,118,118,55
176,seq158,r_277_75_122,r_163_41_79,r_163_41_79,0.68,36,115,79,55
98,r_155_308_101,r_211_227_143,r_333_256_78,r_211_227_143,0.79,-30,113,143,55
105,r_295_190_35,r_188_59_110,r_324_314_13,r_188_59_110,1.0,0,110,110,55
109,r_222_40_121,seq113,r_360_359_55,r_222_40_121,1.0,0,121,121,55
104,r_259_300_172,seq110,r_163_41_79,r_163_41_79,0.97,93,172,79,55
210,seq274,r_282_146_94,r_164_242_32,r_282_146_94,0.87,-17,77,94,55
80,r_215_323_125,seq327,r_282_146_94,r_215_323_125,1.0,0,125,125,55
150,seq88,r_250_313_186,r_64_169_26,r_250_313_186,0.72,1,187,186,55
61,r_34_204_145,r_19_265_166,r_76_37_85,r_34_204_145,0.99,0,145,145,55
26,r_260_67_78,seq5,seq94,r_260_67_78,0.91,16,94,78,55
89,r_171_340_21,r_20_255_84,r_107_45_94,r_171_340_21,0.54,0,21,21,55
107,r_370_244_92,r_280_116_112,seq337,r_280_116_112,1.0,-16,96,112,55
65,r_19_265_166,seq186,r_140_229_91,r_19_265_166,1.0,0,166,166,55
103,r_157_199_67,r_163_41_79,r_91_153_11,r_91_153_11,1.0,56,67,11,55
7,r_307_197_97,seq329,seq346,r_307_197_97,0.55,2,99,97,55
76,r_178_252_180,seq4,r_103_350_17,r_178_252_180,0.98,0,180,180,55
60,r_338_187_110,seq12,r_107_45_94,r_338_187_110,1.0,0,110,110,55
75,r_92_150_154,seq205,r_364_316_2,r_92_150_154,1.0,1,155,154,55
14,r_64_169_26,r_178_252_180,seq102,r_64_169_26,0.66,2,28,26,55
123,r_77_111_139,seq241,r_177_248_94,r_77_111_139,0.9,1,140,139,55
38,r_76_37_85,seq325,seq161,r_76_37_85,1.0,0,85,85,55
78,r_343_354_138,seq63,r_361_101_90,r_343_354_138,0.87,0,138,138,55
20,r_79_142_67,seq202,seq234,r_79_142_67,1.0,0,67,67,55
9,r_216_31_11,r_137_100_56,seq183,r_216_31_11,0.8,-1,10,11,55
55,r_363_145_110,r_164_242_32,r_29_81_2,r_363_145_110,0.94,1,111,110,55
189,seq202,r_79_142_67,seq297,r_79_142_67,0.99,0,67,67,55
66,r_189_21_28,r_86_38_70,seq241,r_189_21_28,0.59,0,28,28,55
36,r_106_191_71,r_159_72_147,r_39_353_30,r_106_191_71,0.65,0,71,71,55
43,r_253_43_22,r_326_362_73,seq57,r_253_43_22,0.94,0,22,22,55
105,r_295_190_35,r_360_359_55,r_188_59_110,r_295_190_35,1.0,1,36,35,55
63,r_330_294_148,r_250_313_186,seq110,r_330_294_148,0.94,0,148,148,55
50,r_62_264_169,seq220,r_120_257_147,r_120_257_147,0.99,26,173,147,55
218,seq301,r_216_31_11,r_91_153_11,r_91_153_11,0.6,1,12,11,55
57,r_124_365_108,r_254_232_138,r_260_67_78,r_124_365_108,0.9,0,108,108,55
29,r_159_72_147,seq225,r_286_247_85,r_159_72_147,0.96,6,153,147,55
10,r_360_359_55,r_211_227_143,seq331,r_211_227_143,0.97,-75,68,143,55
39,r_83_208_109,seq201,r_35_47_29,r_83_208_109,0.96,0,109,109,55
111,r_286_292_154,r_107_176_174,r_200_207_22,r_286_292_154,1.0,0,154,154,56
135,seq33,r_59_36_44,r_134_146_48,r_134_146_48,1.0,16,64,48,56
49,r_115_266_129,r_373_188_170,r_315_113_23,r_115_266_129,1.0,2,131,129,56
83,r_79_40_177,r_279_297_147,seq12,r_279_297_147,1.0,2,149,147,56
84,r_25_192_38,seq366,seq140,r_25_192_38,0.96,1,39,38,56
30,r_321_133_82,seq35,r_359_149_5,r_321_133_82,0.57,14,96,82,56
90,r_248_94_132,r_121_126_155,r_324_361_8,r_248_94_132,1.0,0,132,132,56
6,r_123_255_151,r_72_235_182,r_219_256_55,r_123_255_151,0.99,1,152,151,56
100,r_57_268_190,seq201,r_107_176_174,r_107_176_174,0.62,15,189,174,56
55,r_373_188_170,r_115_266_129,r_13_294_79,r_373_188_170,0.57,-39,131,170,56
116,r_43_223_55,r_145_30_121,r_275_14_65,r_43_223_55,1.0,11,66,55,56
8,r_139_369_140,seq364,r_135_325_68,r_139_369_140,1.0,3,143,140,56
103,r_72_235_182,r_327_74_194,r_279_297_147,r_72_235_182,0.94,-8,174,182,56
106,r_97_64_73,r_8_5_197,seq301,r_97_64_73,1.0,0,73,73,56
93,r_134_146_48,r_356_284_189,seq33,r_134_146_48,1.0,0,48,48,56
80,r_55_93_34,seq366,seq226,r_55_93_34,1.0,0,34,34,56
82,r_51_153_61,r_6_236_175,seq172,r_51_153_61,0.7,0,61,61,56
78,r_32_10_64,seq62,r_228_322_8,r_32_10_64,1.0,0,64,64,56
7,r_147_334_62,r_155_150_126,seq15,r_147_334_62,0.95,4,66,62,56
110,r_160_281_47,seq23,seq62,r_160_281_47,1.0,0,47,47,56
26,r_155_150_126,seq226,seq221,r_155_150_126,1.0,0,126,126,56
92,r_317_245_60,r_125_143_78,seq213,r_317_245_60,1.0,1,61,60,56
86,r_242_312_182,seq263,r_304_350_55,r_242_312_182,0.91,1,183,182,56
149,seq101,r_50_259_97,r_2_365_25,r_50_259_97,0.99,-13,84,97,56
51,r_198_7_148,seq77,r_324_361_8,r_324_361_8,0.69,128,136,8,56
70,r_249_118_106,seq82,r_39_112_79,r_249_118_106,1.0,0,106,106,56
214,seq280,r_219_256_55,seq33,r_219_256_55,1.0,0,55,55,56
108,r_243_314_16,r_352_244_131,r_183_47_36,r_352_244_131,1.0,-5,126,131,56
57,r_122_137_118,r_332_86_141,seq316,r_122_137_118,1.0,0,118,118,56
53,r_208_164_146,seq211,r_139_369_140,r_208_164_146,0.7,0,146,146,56
1,r_67_206_84,r_145_30_121,seq15,r_67_206_84,1.0,0,84,84,56
34,r_240_234_6,r_327_74_194,r_324_361_8,r_240_234_6,0.68,58,64,6,56
9,r_135_325_68,seq140,r_128_250_38,r_135_325_68,0.96,2,70,68,56
64,r_156_299_101,seq130,seq12,r_156_299_101,1.0,2,103,101,56
97,r_0_87_19,r_37_341_90,r_127_252_187,r_0_87_19,1.0,0,19,19,56
33,r_2_365_25,r_22_232_131,seq101,r_2_365_25,0.81,8,33,25,56
25,r_145_30_121,seq239,r_330_320_42,r_145_30_121,0.65,2,123,121,56
200,seq221,r_107_176_174,r_315_113_23,r_107_176_174,0.77,-46,128,174,56
112,r_42_48_159,r_8_5_197,r_321_133_82,r_42_48_159,1.0,0,159,159,56
238,seq349,r_59_36_44,r_92_306_29,r_92_306_29,0.98,35,64,29,56
121,r_121_126_155,seq171,r_67_206_84,r_121_126_155,0.82,4,159,155,56
5,r_34_319_17,seq204,seq152,r_34_319_17,1.0,0,17,17,56
182,seq187,r_156_299_101,r_17_95_126,r_156_299_101,0.55,-73,28,101,56
89,r_179_273_43,r_147_334_62,r_227_29_16,r_147_334_62,0.8,-16,46,62,56
44,r_49_237_55,seq193,r_308_271_11,r_49_237_55,1.0,1,56,55,56
36,r_71_189_186,r_51_153_61,r_139_369_140,r_71_189_186,0.9,0,186,186,56
94,r_289_53_115,r_8_5_197,seq148,r_289_53_115,1.0,0,115,115,56
72,r_174_60_118,seq105,seq193,r_174_60_118,1.0,1,119,118,56
20,r_203_109_11,r_37_341_90,seq202,r_203_109_11,0.99,0,11,11,56
77,r_50_259_97,seq120,r_337_282_199,r_50_259_97,1.0,0,97,97,56
99,r_127_252_187,r_323_272_96,r_0_87_19,r_0_87_19,0.64,36,55,19,56
12,r_107_176_174,seq66,r_122_137_118,r_107_176_174,0.6,0,174,174,56
66,r_138_154_187,seq63,r_13_294_79,r_138_154_187,0.97,0,187,187,56
19,r_310_58_75,r_17_95_126,seq152,r_310_58_75,1.0,0,75,75,56
18,r_200_207_22,seq178,seq283,r_200_207_22,1.0,1,23,22,56
113,r_56_169_72,r_208_164_146,r_160_281_47,r_56_169_72,0.73,8,80,72,56
88,r_274_84_133,r_121_126_155,seq63,r_274_84_133,1.0,0,133,133,56
108,r_243_314_16,r_200_207_22,r_352_244_131,r_243_314_16,1.0,0,16,16,56
46,r_293_157_40,seq328,seq205,r_293_157_40,1.0,0,40,40,56
75,r_295_158_167,seq104,r_274_84_133,r_295_158_167,1.0,0,167,167,56
244,seq358,r_117_78_167,r_20_31_76,r_117_78_167,1.0,0,167,167,56
32,r_13_294_79,r_308_271_11,seq211,r_13_294_79,1.0,0,79,79,56
10,r_89_162_92,seq101,seq167,r_89_162_92,1.0,1,93,92,56
0,r_260_85_107,seq136,r_183_47_36,r_260_85_107,1.0,0,107,107,56
202,seq224,r_110_196_157,r_203_109_11,r_110_196_157,0.6,0,157,157,56
35,r_75_238_49,seq366,seq205,r_75_238_49,0.99,0,49,49,56
3,r_279_297_147,r_79_40_177,r_203_109_11,r_279_297_147,1.0,2,149,147,56
85,r_91_99_168,seq120,r_75_238_49,r_75_238_49,0.62,77,126,49,56
76,r_90_258_50,r_39_112_79,r_254_313_10,r_90_258_50,0.69,0,50,50,56
120,r_302_339_141,r_295_158_167,seq201,r_302_339_141,1.0,0,141,141,56
74,r_318_225_172,r_166_253_187,r_22_232_131,r_318_225_172,1.0,0,172,172,56
27,r_128_250_38,r_362_185_47,r_38_1_32,r_38_1_32,0.81,6,38,32,56
81,r_336_161_31,r_37_341_90,seq105,r_336_161_31,1.0,0,31,31,56
17,r_304_350_55,r_327_74_194,seq201,r_304_350_55,0.95,0,55,55,56
22,r_37_341_90,seq15,seq360,r_37_341_90,1.0,0,90,90,56
122,r_332_86_141,seq199,r_260_85_107,r_332_86_141,1.0,1,142,141,56
13,r_254_313_10,r_8_5_197,seq41,r_254_313_10,1.0,0,10,10,56
23,r_88_370_14,r_139_369_140,seq116,r_88_370_14,0.95,0,14,14,56
123,r_195_233_54,r_197_27_178,seq23,r_195_233_54,1.0,0,54,54,56
38,r_6_236_175,seq77,r_20_31_76,r_6_236_175,0.9,0,175,175,56
21,r_362_185_47,r_115_266_129,seq151,r_362_185_47,0.85,0,47,47,56
45,r_323_272_96,r_127_252_187,r_4_345_37,r_323_272_96,0.84,-5,91,96,56
29,r_39_112_79,r_51_153_61,r_220_100_52,r_51_153_61,0.73,18,79,61,56
28,r_265_141_33,r_135_325_68,r_92_306_29,r_265_141_33,0.65,1,34,33,56
54,r_315_113_23,r_145_30_121,seq221,r_315_113_23,0.96,0,23,23,56
109,r_165_278_96,r_166_253_187,seq105,r_165_278_96,1.0,1,97,96,56
11,r_363_217_144,seq316,seq136,r_363_217_144,1.0,0,144,144,56
124,r_80_70_177,seq73,r_240_234_6,r_80_70_177,0.97,0,177,177,56
87,r_352_244_131,r_54_269_195,r_20_31_76,r_352_244_131,1.0,0,131,131,56
96,r_338_102_187,seq116,r_321_133_82,r_338_102_187,0.88,0,187,187,56
63,r_220_100_52,r_304_350_55,seq328,r_220_100_52,1.0,0,52,52,56
99,r_127_252_187,r_0_87_19,r_83_285_2,r_127_252_187,0.91,0,187,187,56
29,r_39_112_79,r_220_100_52,r_249_118_106,r_249_118_106,0.68,2,108,106,56
36,r_71_189_186,r_229_344_120,r_51_153_61,r_229_344_120,1.0,0,120,120,56
62,r_4_345_37,seq178,seq108,r_4_345_37,0.69,1,38,37,56
104,r_38_1_32,r_8_5_197,seq184,r_38_1_32,1.0,0,32,32,56
101,r_92_306_29,r_156_299_101,r_265_141_33,r_156_299_101,0.43,-68,33,101,56
105,r_197_27_178,seq190,r_279_297_147,r_197_27_178,0.94,-1,177,178,56
2,r_20_31_76,seq316,r_4_345_37,r_20_31_76,0.98,0,76,76,56
56,r_22_232_131,seq267,seq280,r_22_232_131,1.0,0,131,131,56
73,r_333_247_120,r_8_5_197,seq9,r_333_247_120,1.0,1,121,120,56
107,r_367_287_29,r_242_312_182,r_324_361_8,r_242_312_182,0.89,-145,37,182,56
14,r_275_14_65,seq283,r_43_223_55,r_275_14_65,1.0,0,65,65,56
184,seq191,r_337_282_199,r_17_95_126,r_17_95_126,1.0,2,128,126,56
67,r_246_76_18,r_135_325_68,seq21,r_246_76_18,0.61,3,21,18,56
52,r_227_29_16,r_337_282_199,seq140,r_227_29_16,0.87,0,16,16,56
97,r_0_87_19,r_127_252_187,r_304_350_55,r_127_252_187,0.91,-1,186,187,56
48,r_125_143_78,r_332_86_141,seq33,r_125_143_78,1.0,1,79,78,56
37,r_110_196_157,seq224,r_330_320_42,r_110_196_157,0.84,0,157,157,56
39,r_106_163_163,seq204,r_145_30_121,r_106_163_163,1.0,2,165,163,56
61,r_17_95_126,r_106_163_163,seq191,r_17_95_126,1.0,0,126,126,56
47,r_330_320_42,r_50_259_97,r_55_93_34,r_330_320_42,0.97,2,44,42,56
137,seq41,r_156_299_101,r_254_313_10,r_156_299_101,0.74,-33,68,101,56
187,seq199,r_332_86_141,seq3,r_332_86_141,1.0,1,142,141,56
119,r_144_168_93,r_107_176_174,seq44,r_144_168_93,1.0,0,93,93,56
60,r_131_16_16,r_49_237_55,seq190,r_131_16_16,0.58,-1,15,16,56
102,r_46_291_138,r_8_5_197,r_43_223_55,r_46_291_138,1.0,0,138,138,56
55,r_373_188_170,r_13_294_79,r_220_100_52,r_373_188_170,1.0,0,170,170,56
118,r_229_344_120,r_71_189_186,seq15,r_229_344_120,1.0,0,120,120,56
43,r_219_256_55,seq280,r_228_322_8,r_219_256_55,1.0,0,55,55,56
83,r_79_40_177,seq12,r_39_112_79,r_79_40_177,0.97,0,177,177,56
16,r_181_69_80,r_138_154_187,seq15,r_181_69_80,1.0,0,80,80,56
15,r_371_209_171,seq201,r_254_313_10,r_371_209_171,0.99,4,175,171,56
31,r_183_47_36,r_372_262_186,r_243_314_16,r_183_47_36,0.98,0,36,36,56
211,seq267,r_22_232_131,seq177,r_22_232_131,1.0,0,131,131,56
61,r_17_95_126,r_310_58_75,r_106_163_163,r_310_58_75,1.0,0,75,75,56
182,seq187,r_254_313_10,r_43_223_55,r_43_223_55,0.39,44,99,55,56
91,r_308_271_11,r_13_294_79,r_49_237_55,r_308_271_11,0.98,68,79,11,56
4,r_117_78_167,seq358,seq104,r_117_78_167,1.0,0,167,167,56
76,r_48_11_137,seq312,r_220_6_86,r_48_11_137,1.0,0,137,137,57
60,r_22_33_172,r_180_119_12,r_113_14_126,r_22_33_172,1.0,0,172,172,57
26,r_309_265_44,seq12,seq254,r_309_265_44,1.0,0,44,44,57
95,r_184_277_41,r_263_89_189,seq288,r_184_277_41,1.0,0,41,41,57
41,r_266_311_17,r_113_14_126,seq157,r_266_311_17,0.95,0,17,17,57
112,r_84_69_124,seq276,seq241,r_84_69_124,1.0,0,124,124,57
29,r_64_227_45,r_187_299_190,seq295,r_64_227_45,1.0,0,45,45,57
224,seq301,seq30,r_308_271_116,r_308_271_116,1.0,2,118,116,57
231,seq328,r_38_214_177,r_91_196_27,r_38_214_177,0.47,0,177,177,57
104,r_171_233_13,r_31_159_25,seq212,r_171_233_13,0.75,0,13,13,57
38,r_31_159_25,seq81,seq264,r_31_159_25,0.9,0,25,25,57
14,r_191_320_165,seq188,r_309_265_44,r_191_320_165,0.99,0,165,165,57
17,r_372_267_104,seq17,r_185_65_47,r_372_267_104,1.0,0,104,104,57
151,seq75,r_256_281_165,r_34_128_86,r_34_128_86,1.0,11,97,86,57
49,r_10_270_146,seq20,r_34_128_86,r_10_270_146,0.98,0,146,146,57
83,r_327_43_112,r_133_243_172,seq54,r_327_43_112,1.0,0,112,112,57
158,seq93,r_152_186_172,r_5_294_43,r_152_186_172,1.0,1,173,172,57
63,r_293_176_102,seq56,seq25,r_293_176_102,0.99,0,102,102,57
94,r_199_125_109,r_55_215_158,seq280,r_199_125_109,1.0,0,109,109,57
32,r_150_326_86,r_232_238_100,seq226,r_150_326_86,0.62,0,86,86,57
13,r_60_345_48,r_8_359_3,seq130,r_60_345_48,1.0,3,51,48,57
44,r_46_158_88,seq86,seq295,r_46_158_88,1.0,0,88,88,57
31,r_67_300_74,r_38_214_177,seq28,r_67_300_74,1.0,0,74,74,57
12,r_121_284_160,seq349,seq90,r_121_284_160,0.99,0,160,160,57
113,r_331_165_73,r_333_373_175,seq141,r_331_165_73,1.0,0,73,73,57
67,r_230_24_22,r_98_251_173,r_237_219_130,r_230_24_22,0.95,129,151,22,57
249,seq371,r_252_114_152,r_309_265_44,r_252_114_152,0.97,1,153,152,57
222,seq295,r_166_292_125,r_64_227_45,r_166_292_125,0.96,0,125,125,57
123,r_348_306_178,seq286,r_58_140_111,r_348_306_178,0.99,0,178,178,57
61,r_298_317_111,r_83_290_123,r_32_364_35,r_298_317_111,1.0,0,111,111,57
27,r_32_364_35,r_79_222_75,r_180_119_12,r_32_364_35,1.0,0,35,35,57
72,r_339_272_190,seq295,r_367_347_46,r_339_272_190,0.75,0,190,190,57
122,r_223_204_27,r_252_114_152,seq96,r_223_204_27,1.0,0,27,27,57
5,r_139_365_87,r_166_292_125,r_287_330_9,r_139_365_87,1.0,0,87,87,57
81,r_307_80_49,r_121_284_160,r_63_192_199,r_307_80_49,0.76,3,52,49,57
89,r_160_374_132,r_211_100_186,r_367_347_46,r_160_374_132,1.0,0,132,132,57
50,r_83_290_123,seq40,r_171_233_13,r_83_290_123,1.0,2,125,123,57
170,seq130,r_113_14_126,r_60_345_48,r_113_14_126,1.0,1,127,126,57
37,r_169_36_115,seq23,seq201,r_169_36_115,1.0,0,115,115,57
88,r_41_138_85,r_327_43_112,r_340_245_69,r_340_245_69,0.73,16,85,69,57
116,r_152_186_172,seq93,r_83_290_123,r_152_186_172,1.0,1,173,172,57
137,seq26,r_163_129_191,r_91_196_27,r_91_196_27,0.87,52,79,27,57
54,r_4_99_114,r_45_318_150,r_78_110_182,r_45_318_150,0.85,-89,61,150,57
64,r_314_13_137,r_121_284_160,r_308_271_116,r_314_13_137,1.0,0,137,137,57
101,r_310_370_172,r_273_210_185,r_169_36_115,r_310_370_172,1.0,0,172,172,57
52,r_237_219_130,seq369,r_230_24_22,r_237_219_130,1.0,0,130,130,57
10,r_260_178_124,r_133_243_172,seq358,r_260_178_124,1.0,0,124,124,57
53,r_45_318_150,seq257,r_367_347_46,r_45_318_150,1.0,1,151,150,57
92,r_262_49_157,seq189,r_287_330_9,r_262_49_157,0.99,5,162,157,57
99,r_37_35_128,r_263_89_189,r_60_345_48,r_37_35_128,0.97,0,128,128,57
23,r_98_251_173,r_230_24_22,seq188,r_98_251_173,1.0,0,173,173,57
91,r_261_346_152,seq157,r_113_14_126,r_261_346_152,0.59,0,152,152,57
80,r_209_195_101,r_48_11_137,seq257,r_209_195_101,1.0,-1,100,101,57
7,r_38_214_177,seq328,r_153_161_122,r_38_214_177,0.52,0,177,177,57
103,r_172_68_138,seq286,r_316_208_49,r_172_68_138,1.0,0,138,138,57
108,r_173_334_99,r_367_347_46,seq156,r_173_334_99,0.99,1,100,99,57
4,r_82_85_177,seq132,r_316_208_49,r_82_85_177,0.99,0,177,177,57
100,r_112_61_54,r_79_222_75,seq276,r_79_222_75,0.73,-17,58,75,57
18,r_51_134_188,seq47,seq87,r_51_134_188,0.86,0,188,188,57
56,r_5_294_43,r_322_57_84,seq21,r_5_294_43,1.0,0,43,43,57
105,r_66_136_51,r_84_69_124,r_319_313_13,r_66_136_51,1.0,0,51,51,57
19,r_256_281_165,r_42_147_153,seq323,r_256_281_165,0.95,1,166,165,57
1,r_206_291_93,r_325_2_191,seq193,r_206_291_93,1.0,1,94,93,57
42,r_58_140_111,r_170_104_71,seq72,r_58_140_111,0.54,-40,71,111,57
96,r_316_208_49,r_322_57_84,seq312,r_316_208_49,1.0,0,49,49,57
62,r_135_304_142,seq295,r_187_299_190,r_135_304_142,1.0,0,142,142,57
51,r_42_147_153,r_256_281_165,r_368_122_72,r_42_147_153,0.87,1,154,153,57
117,r_55_215_158,seq201,r_287_330_9,r_55_215_158,1.0,0,158,158,57
40,r_319_313_13,r_154_177_72,seq151,r_319_313_13,0.99,0,13,13,57
21,r_343_282_112,seq25,seq241,r_343_282_112,1.0,0,112,112,57
90,r_333_373_175,seq28,r_98_251_173,r_333_373_175,0.92,0,175,175,57
43,r_217_275_31,r_78_110_182,seq28,r_217_275_31,0.98,0,31,31,57
75,r_29_44_133,seq77,seq201,r_29_44_133,1.0,0,133,133,57
98,r_175_283_105,seq341,r_139_365_87,r_175_283_105,0.71,0,105,105,57
66,r_105_228_67,r_121_284_160,seq254,r_105_228_67,1.0,0,67,67,57
118,r_109_16_187,seq74,r_343_282_112,r_109_16_187,0.86,0,187,187,57
74,r_225_39_174,seq249,r_67_300_74,r_225_39_174,1.0,0,174,174,57
2,r_185_65_47,seq28,seq248,r_185_65_47,1.0,1,48,47,57
120,r_354_146_169,seq358,r_29_44_133,r_354_146_169,1.0,0,169,169,57
70,r_95_247_31,r_32_364_35,seq86,r_32_364_35,0.82,-20,15,35,57
25,r_170_104_71,r_58_140_111,seq323,r_58_140_111,0.9,-40,71,111,57
55,r_34_128_86,seq221,seq71,r_34_128_86,1.0,1,87,86,57
115,r_127_336_111,r_332_1_61,seq17,r_127_336_111,1.0,0,111,111,57
111,r_88_197_80,r_62_183_81,r_67_300_74,r_62_183_81,0.81,-1,80,81,57
71,r_207_366_161,r_117_116_188,r_332_1_61,r_207_366_161,1.0,0,161,161,57
9,r_133_243_172,r_211_100_186,r_332_1_61,r_133_243_172,0.67,0,172,172,57
45,r_224_278_38,seq54,seq23,r_224_278_38,1.0,0,38,38,57
65,r_368_122_72,seq9,seq59,r_368_122_72,1.0,0,72,72,57
78,r_211_100_186,seq312,r_206_291_93,r_211_100_186,0.92,0,186,186,57
0,r_113_14_126,seq130,seq156,r_113_14_126,1.0,1,127,126,57
36,r_62_183_81,seq72,seq145,r_62_183_81,0.6,22,103,81,57
33,r_79_222_75,r_367_347_46,seq369,r_79_222_75,1.0,1,76,75,57
58,r_273_210_185,seq212,r_82_85_177,r_273_210_185,0.93,0,185,185,57
77,r_322_57_84,seq54,seq108,r_322_57_84,1.0,0,84,84,57
106,r_340_245_69,r_113_14_126,seq250,r_340_245_69,0.93,0,69,69,57
30,r_101_115_47,r_46_158_88,r_64_227_45,r_64_227_45,1.0,3,48,45,57
187,seq189,r_262_49_157,seq188,r_262_49_157,1.0,5,162,157,57
205,seq248,seq324,r_185_65_47,r_185_65_47,1.0,21,68,47,57
20,r_153_161_122,r_121_284_160,seq344,r_153_161_122,1.0,0,122,122,57
73,r_232_238_100,seq73,seq81,r_232_238_100,1.0,0,100,100,57
48,r_356_246_158,seq72,r_224_278_38,r_356_246_158,1.0,0,158,158,57
68,r_353_181_87,seq141,r_95_247_31,r_353_181_87,1.0,0,87,87,57
59,r_164_205_187,seq19,r_169_36_115,r_164_205_187,0.94,2,189,187,57
67,r_230_24_22,r_38_214_177,r_98_251_173,r_230_24_22,0.94,-1,21,22,57
131,seq18,seq242,r_70_131_37,r_70_131_37,1.0,25,62,37,57
16,r_154_177_72,seq253,seq72,r_154_177_72,1.0,4,76,72,57
229,seq323,r_38_214_177,r_170_104_71,r_170_104_71,0.72,-3,68,71,57
15,r_166_292_125,seq295,seq56,r_166_292_125,1.0,0,125,125,57
110,r_162_236_84,seq92,seq40,r_162_236_84,0.99,1,85,84,57
109,r_235_302_160,seq25,r_58_140_111,r_235_302_160,1.0,0,160,160,57
124,r_52_269_146,seq71,r_343_282_112,r_52_269_146,0.92,0,146,146,57
69,r_308_271_116,seq20,seq301,r_308_271_116,1.0,1,117,116,57
24,r_252_114_152,seq371,r_198_203_103,r_252_114_152,1.0,1,153,152,57
22,r_198_203_103,r_22_33_172,seq174,r_198_203_103,1.0,0,103,103,57
107,r_289_297_90,r_117_116_188,r_170_104_71,r_289_297_90,1.0,0,90,90,57
102,r_240_0_136,seq54,seq132,r_240_0_136,1.0,2,138,136,57
6,r_106_194_64,seq47,r_5_294_43,r_106_194_64,0.98,0,64,64,57
86,r_220_6_86,r_293_176_102,seq221,r_220_6_86,1.0,1,87,86,57
46,r_117_116_188,seq355,r_367_347_46,r_117_116_188,1.0,0,188,188,57
42,r_58_140_111,seq72,seq107,r_58_140_111,1.0,0,111,111,57
35,r_149_120_31,seq312,seq268,r_149_120_31,1.0,0,31,31,57
93,r_76_182_174,seq21,seq54,r_76_182_174,1.0,0,174,174,57
57,r_70_131_37,seq124,seq18,r_70_131_37,1.0,0,37,37,57
57,r_29_90_141,r_374_350_197,r_319_79_10,r_29_90_141,1.0,0,141,141,58
55,r_337_143_17,r_226_93_42,r_288_284_123,r_337_143_17,0.97,-1,16,17,58
28,r_249_235_188,seq167,r_212_162_25,r_249_235_188,0.93,0,188,188,58
53,r_74_14_179,seq40,seq155,r_74_14_179,0.94,0,179,179,58
98,r_294_300_44,r_69_16_196,seq257,r_294_300_44,0.96,1,45,44,58
11,r_292_245_159,seq361,r_362_242_103,r_292_245_159,1.0,2,161,159,58
33,r_362_242_103,seq204,seq244,r_362_242_103,1.0,0,103,103,58
98,r_294_300_44,seq257,r_324_72_149,r_324_72_149,0.88,15,164,149,58
16,r_38_297_180,seq100,r_329_195_96,r_38_297_180,1.0,0,180,180,58
109,r_369_344_35,r_234_287_46,r_26_258_191,r_369_344_35,0.99,0,35,35,58
77,r_251_267_106,r_36_275_146,seq144,r_251_267_106,1.0,0,106,106,58
131,seq24,seq355,r_178_233_157,r_178_233_157,0.98,3,160,157,58
111,r_172_248_186,r_44_148_32,r_150_88_142,r_172_248_186,0.59,0,186,186,58
52,r_196_371_132,seq257,seq346,r_196_371_132,1.0,0,132,132,58
160,seq103,r_57_363_174,r_333_289_21,r_57_363_174,1.0,2,176,174,58
15,r_116_109_35,r_1_213_157,r_110_309_28,r_116_109_35,1.0,0,35,35,58
51,r_95_299_6,r_292_245_159,r_193_197_13,r_95_299_6,0.62,5,11,6,58
1,r_234_287_46,r_217_137_177,seq35,r_234_287_46,1.0,0,46,46,58
209,seq243,seq167,r_44_148_32,r_44_148_32,1.0,30,62,32,58
74,r_145_222_32,r_184_136_125,seq48,r_145_222_32,0.99,0,32,32,58
101,r_110_309_28,r_292_245_159,seq65,r_110_309_28,1.0,0,28,28,58
97,r_28_106_164,seq364,r_44_148_32,r_28_106_164,0.99,0,164,164,58
152,seq73,r_316_7_38,r_22_343_20,r_22_343_20,1.0,0,20,20,58
82,r_359_307_72,r_342_176_63,r_328_351_52,r_359_307_72,0.81,-9,63,72,58
17,r_26_258_191,r_339_11_75,r_369_344_35,r_339_11_75,0.97,0,75,75,58
48,r_134_91_150,r_193_197_13,r_152_108_130,r_134_91_150,1.0,0,150,150,58
107,r_75_219_144,r_57_363_174,r_209_321_103,r_75_219_144,1.0,1,145,144,58
194,seq204,r_362_242_103,r_22_343_20,r_362_242_103,0.92,-5,98,103,58
21,r_365_85_31,seq34,seq70,r_365_85_31,0.74,1,32,31,58
60,r_131_250_169,r_259_8_165,r_290_5_149,r_131_250_169,1.0,-1,168,169,58
89,r_1_213_157,seq155,r_238_252_133,r_1_213_157,0.99,0,157,157,58
32,r_211_4_173,seq302,r_152_108_130,r_211_4_173,1.0,2,175,173,58
62,r_330_317_78,r_28_106_164,r_122_25_77,r_330_317_78,0.95,0,78,78,58
119,r_202_9_46,r_20_260_92,seq46,r_202_9_46,1.0,0,46,46,58
79,r_57_363_174,seq103,r_226_93_42,r_57_363_174,0.97,2,176,174,58
66,r_42_304_92,r_374_350_197,r_326_285_20,r_42_304_92,1.0,0,92,92,58
37,r_61_64_121,r_324_72_149,seq144,r_324_72_149,0.66,-53,96,149,58
92,r_192_262_130,r_246_27_7,seq155,r_192_262_130,1.0,0,130,130,58
45,r_274_332_25,r_3_151_86,seq207,r_3_151_86,0.55,-58,28,86,58
105,r_208_189_86,r_76_59_192,seq302,r_208_189_86,1.0,0,86,86,58
102,r_296_101_174,seq58,r_217_137_177,r_296_101_174,0.98,2,176,174,58
72,r_200_214_188,seq12,seq302,r_200_214_188,0.86,2,190,188,58
95,r_288_284_123,r_337_143_17,r_281_356_110,r_288_284_123,1.0,1,124,123,58
108,r_52_367_62,r_205_19_116,r_116_109_35,r_116_109_35,0.69,28,63,35,58
54,r_36_275_146,r_251_267_106,r_185_156_196,r_251_267_106,1.0,1,107,106,58
36,r_127_253_113,seq301,seq111,r_127_253_113,1.0,0,113,113,58
43,r_318_236_140,r_21_23_177,seq84,r_318_236_140,0.94,5,145,140,58
113,r_117_168_148,seq241,r_251_267_106,r_117_168_148,0.74,3,151,148,58
61,r_220_94_18,r_89_322_151,r_188_368_16,r_220_94_18,0.97,0,18,18,58
20,r_180_357_79,seq35,seq241,r_180_357_79,1.0,0,79,79,58
95,r_288_284_123,r_265_173_44,r_337_143_17,r_288_284_123,0.76,-107,16,123,58
12,r_128_336_156,seq118,r_209_321_103,r_128_336_156,1.0,7,163,156,58
184,seq174,r_114_310_162,r_150_88_142,r_114_310_162,1.0,0,162,162,58
81,r_358_183_158,r_217_137_177,r_362_242_103,r_358_183_158,0.99,0,158,158,58
141,seq55,seq126,r_102_269_14,r_102_269_14,0.97,21,35,14,58
120,r_31_306_158,seq84,r_234_287_46,r_31_306_158,1.0,1,159,158,58
93,r_295_53_71,seq237,r_188_368_16,r_295_53_71,1.0,4,75,71,58
124,r_314_206_74,r_211_4_173,seq360,r_314_206_74,1.0,1,75,74,58
41,r_22_343_20,r_365_85_31,seq73,r_22_343_20,1.0,0,20,20,58
82,r_359_307_72,r_328_351_52,r_212_162_25,r_359_307_72,0.92,2,74,72,58
162,seq111,r_223_159_179,r_152_108_130,r_223_159_179,1.0,0,179,179,58
30,r_3_151_86,r_51_13_128,seq147,r_3_151_86,1.0,0,86,86,58
112,r_223_159_179,seq111,r_246_27_7,r_223_159_179,1.0,0,179,179,58
91,r_342_176_63,r_359_307_72,seq360,r_342_176_63,1.0,0,63,63,58
110,r_316_7_38,seq73,seq273,r_316_7_38,0.71,5,43,38,58
84,r_229_60_134,r_324_72_149,seq232,r_229_60_134,1.0,0,134,134,58
121,r_226_93_42,seq161,seq360,r_226_93_42,1.0,0,42,42,58
88,r_326_285_20,r_128_336_156,seq139,r_326_285_20,0.99,0,20,20,58
134,seq35,r_138_92_138,r_234_287_46,r_234_287_46,0.55,20,66,46,58
8,r_246_27_7,r_192_262_130,r_330_317_78,r_246_27_7,0.68,123,130,7,58
118,r_333_289_21,seq129,seq278,r_333_289_21,0.93,0,21,21,58
24,r_135_45_86,r_114_310_162,seq207,r_135_45_86,1.0,0,86,86,58
114,r_121_2_61,r_217_137_177,r_157_15_58,r_121_2_61,1.0,0,61,61,58
35,r_312_256_82,seq144,seq207,r_312_256_82,1.0,0,82,82,58
10,r_327_270_186,seq283,r_281_356_110,r_327_270_186,0.62,0,186,186,58
55,r_337_143_17,r_288_284_123,seq129,r_288_284_123,0.99,1,124,123,58
70,r_281_356_110,r_131_250_169,r_369_344_35,r_281_356_110,1.0,0,110,110,58
49,r_86_130_133,seq18,seq361,r_86_130_133,1.0,1,134,133,58
171,seq139,r_158_277_100,r_326_285_20,r_326_285_20,0.64,0,20,20,58
47,r_87_268_106,r_47_153_196,r_314_206_74,r_87_268_106,1.0,1,107,106,58
117,r_265_173_44,r_288_284_123,seq174,r_265_173_44,1.0,0,44,44,58
176,seq155,r_1_213_157,seq118,r_1_213_157,1.0,0,157,157,58
73,r_20_260_92,seq346,seq215,r_20_260_92,1.0,0,92,92,58
138,seq46,r_41_154_38,r_202_9_46,r_202_9_46,1.0,17,63,46,58
94,r_328_351_52,r_247_187_82,seq241,r_328_351_52,1.0,0,52,52,58
42,r_77_164_169,seq215,r_212_162_25,r_77_164_169,0.99,0,169,169,58
19,r_212_162_25,r_150_88_142,seq203,r_212_162_25,0.99,0,25,25,58
83,r_324_72_149,seq65,r_294_300_44,r_324_72_149,0.99,4,153,149,58
80,r_261_225_30,r_150_88_142,r_44_148_32,r_44_148_32,0.58,0,32,32,58
67,r_140_254_158,r_28_106_164,r_86_130_133,r_140_254_158,0.99,1,159,158,58
25,r_21_23_177,seq118,r_150_88_142,r_21_23_177,0.96,1,178,177,58
85,r_224_165_178,seq96,r_196_371_132,r_224_165_178,0.99,0,178,178,58
0,r_166_341_38,r_41_154_38,seq43,r_166_341_38,0.99,1,39,38,58
86,r_32_83_109,r_281_356_110,seq66,r_32_83_109,1.0,0,109,109,58
50,r_142_112_122,seq305,seq161,r_142_112_122,1.0,0,122,122,58
6,r_205_19_116,r_193_197_13,r_295_53_71,r_205_19_116,0.99,3,119,116,58
244,seq355,seq24,r_369_344_35,r_369_344_35,1.0,2,37,35,58
25,r_21_23_177,r_318_236_140,seq118,r_318_236_140,0.99,5,145,140,58
225,seq301,r_185_156_196,r_196_371_132,r_196_371_132,0.99,29,161,132,58
210,seq244,r_152_108_130,r_362_242_103,r_362_242_103,0.55,28,131,103,58
22,r_51_13_128,seq361,r_142_112_122,r_51_13_128,1.0,0,128,128,58
54,r_36_275_146,r_185_156_196,r_238_252_133,r_36_275_146,0.98,0,146,146,58
3,r_152_108_130,seq244,seq181,r_152_108_130,0.99,1,131,130,58
122,r_54_123_158,seq227,seq279,r_54_123_158,1.0,-6,152,158,58
75,r_199_230_32,r_259_8_165,seq169,r_259_8_165,0.7,-133,32,165,58
123,r_146_271_102,r_374_350_197,seq66,r_146_271_102,1.0,0,102,102,58
9,r_133_308_84,r_224_165_178,seq43,r_133_308_84,0.99,0,84,84,58
87,r_122_25_77,r_327_270_186,seq34,r_122_25_77,1.0,0,77,77,58
204,seq232,r_193_197_13,r_229_60_134,r_229_60_134,1.0,-1,133,134,58
65,r_102_269_14,r_128_336_156,seq55,r_102_269_14,0.79,1,15,14,58
26,r_44_148_32,seq10,r_81_104_34,r_44_148_32,1.0,1,33,32,58
78,r_319_79_10,r_292_245_159,r_323_120_59,r_319_79_10,0.99,0,10,10,58
23,r_259_8_165,r_131_250_169,r_326_285_20,r_259_8_165,1.0,0,165,165,58
239,seq346,r_20_260_92,seq301,r_20_260_92,1.0,0,92,92,58
63,r_97_320_137,r_249_235_188,r_87_268_106,r_87_268_106,0.54,33,139,106,58
56,r_114_310_162,seq174,r_32_83_109,r_114_310_162,0.99,0,162,162,58
104,r_39_266_86,seq325,r_212_162_25,r_39_266_86,1.0,0,86,86,58
96,r_217_137_177,seq132,r_296_101_174,r_217_137_177,1.0,0,177,177,58
100,r_30_366_80,r_49_370_193,seq107,r_30_366_80,1.0,1,81,80,58
208,seq241,r_117_168_148,r_180_357_79,r_180_357_79,0.65,37,116,79,58
59,r_158_277_100,seq139,seq340,r_158_277_100,1.0,1,101,100,58
34,r_264_348_153,r_374_350_197,r_212_162_25,r_264_348_153,1.0,2,155,153,58
71,r_290_5_149,seq169,r_86_130_133,r_290_5_149,1.0,0,149,149,58
111,r_172_248_186,r_374_350_197,r_44_148_32,r_172_248_186,0.76,-27,159,186,58
31,r_188_368_16,r_365_85_31,seq50,r_188_368_16,0.99,0,16,16,58
13,r_157_15_58,r_117_168_148,r_121_2_61,r_157_15_58,0.99,5,63,58,58
46,r_323_120_59,r_158_277_100,r_319_79_10,r_158_277_100,0.8,-44,56,100,58
76,r_81_104_34,seq298,r_44_148_32,r_81_104_34,1.0,1,35,34,58
58,r_339_11_75,r_26_258_191,seq132,r_339_11_75,1.0,2,77,75,58
68,r_124_276_97,r_47_153_196,r_212_162_25,r_124_276_97,1.0,0,97,97,58
38,r_78_190_65,r_205_19_116,r_333_289_21,r_78_190_65,0.91,1,66,65,58
235,seq335,r_259_8_165,r_157_15_58,r_157_15_58,0.67,10,68,58,58
165,seq118,r_128_336_156,seq155,r_128_336_156,1.0,7,163,156,58
69,r_138_92_138,seq35,seq100,r_138_92_138,1.0,0,138,138,58
27,r_247_187_82,r_290_5_149,seq340,r_247_187_82,0.83,0,82,82,58
9,r_69_50_183,seq32,r_146_57_25,r_69_50_183,0.98,0,183,183,59
114,r_218_1_139,r_220_36_199,r_320_170_87,r_218_1_139,1.0,0,139,139,59
128,seq10,r_316_160_101,seq25,r_316_160_101,0.79,-6,95,101,59
54,r_319_262_45,r_350_51_138,seq186,r_319_262_45,1.0,0,45,45,59
35,r_26_187_100,seq118,r_108_270_91,r_26_187_100,1.0,0,100,100,59
73,r_222_325_47,seq206,seq61,r_222_325_47,1.0,0,47,47,59
17,r_193_150_45,r_320_170_87,r_324_215_56,r_193_150_45,0.67,45,90,45,59
67,r_21_317_4,r_147_62_115,r_104_225_21,r_147_62_115,0.99,0,115,115,59
59,r_179_47_156,r_331_359_81,r_349_185_143,r_179_47_156,1.0,0,156,156,59
112,r_106_80_28,r_244_224_23,r_235_123_126,r_235_123_126,1.0,9,135,126,59
62,r_253_261_166,seq163,r_161_0_105,r_253_261_166,0.98,3,169,166,59
193,seq192,r_119_42_184,r_289_167_155,r_119_42_184,0.78,0,184,184,59
228,seq311,r_188_300_52,r_104_225_21,r_188_300_52,0.83,2,54,52,59
64,r_217_208_66,r_108_270_91,r_265_65_171,r_217_208_66,1.0,1,67,66,59
136,seq32,seq237,r_274_340_123,r_274_340_123,1.0,10,133,123,59
57,r_171_131_61,r_350_51_138,seq148,r_171_131_61,1.0,0,61,61,59
75,r_271_288_157,seq367,seq354,r_271_288_157,1.0,0,157,157,59
72,r_373_295_63,seq307,seq168,r_373_295_63,0.87,26,89,63,59
118,r_265_65_171,r_101_114_150,r_217_208_66,r_265_65_171,0.8,-76,95,171,59
28,r_9_122_145,seq141,r_267_241_91,r_9_122_145,1.0,1,146,145,59
10,r_105_372_43,r_203_129_105,seq168,r_105_372_43,0.96,0,43,43,59
115,r_101_114_150,r_265_65_171,r_46_351_35,r_101_114_150,1.0,0,150,150,59
4,r_350_51_138,seq3,r_213_230_61,r_350_51_138,1.0,0,138,138,59
0,r_266_249_112,r_200_358_128,r_251_56_63,r_266_249_112,1.0,0,112,112,59
25,r_320_170_87,r_193_150_45,seq178,r_320_170_87,0.89,-2,85,87,59
108,r_130_336_128,seq141,seq162,r_130_336_128,1.0,0,128,128,59
69,r_97_322_74,r_203_129_105,seq180,r_97_322_74,0.64,1,75,74,59
38,r_259_234_17,r_20_30_174,r_214_43_1,r_259_234_17,0.91,0,17,17,59
49,r_96_175_55,r_310_269_186,r_107_327_11,r_96_175_55,0.83,14,69,55,59
182,seq163,r_253_261_166,seq63,r_253_261_166,1.0,3,169,166,59
25,r_320_170_87,r_135_281_30,r_193_150_45,r_193_150_45,0.87,2,47,45,59
60,r_247_60_121,seq297,r_105_372_43,r_247_60_121,1.0,0,121,121,59
80,r_244_224_23,r_101_114_150,r_144_362_9,r_244_224_23,0.97,0,23,23,59
21,r_341_128_64,r_253_261_166,seq192,r_341_128_64,0.93,0,64,64,59
44,r_132_197_137,seq148,r_320_170_87,r_132_197_137,1.0,0,137,137,59
29,r_188_300_52,seq311,seq79,r_188_300_52,1.0,2,54,52,59
22,r_194_172_134,r_291_277_170,r_193_150_45,r_194_172_134,1.0,0,134,134,59
83,r_18_95_155,seq127,r_134_250_19,r_18_95_155,1.0,0,155,155,59
37,r_251_56_63,r_260_191_138,r_331_359_81,r_251_56_63,1.0,0,63,63,59
94,r_154_49_48,seq23,r_135_281_30,r_154_49_48,1.0,1,49,48,59
179,seq158,r_291_277_170,r_97_322_74,r_291_277_170,0.98,0,170,170,59
17,r_193_150_45,r_316_160_101,r_320_170_87,r_193_150_45,1.0,1,46,45,59
89,r_280_330_158,seq178,r_179_47_156,r_280_330_158,1.0,0,158,158,59
31,r_272_126_131,seq201,seq93,r_272_126_131,1.0,1,132,131,59
111,r_324_215_56,r_320_170_87,r_193_150_45,r_320_170_87,0.62,4,91,87,59
107,r_299_333_79,r_152_13_181,r_220_36_199,r_299_333_79,0.99,0,79,79,59
33,r_72_283_49,r_312_166_49,r_331_359_81,r_312_166_49,0.84,-1,48,49,59
221,seq297,r_247_60_121,r_184_98_35,r_247_60_121,0.99,0,121,121,59
26,r_184_98_35,r_239_228_77,seq297,r_184_98_35,1.0,0,35,35,59
113,r_151_164_151,seq354,r_103_189_58,r_151_164_151,1.0,0,151,151,59
109,r_312_166_49,r_72_283_49,seq297,r_312_166_49,1.0,0,49,49,59
15,r_291_277_170,seq158,r_11_243_164,r_291_277_170,0.96,0,170,170,59
7,r_289_167_155,seq348,r_41_361_107,r_289_167_155,0.88,-1,154,155,59
6,r_107_327_11,seq110,r_96_175_55,r_107_327_11,0.71,68,79,11,59
76,r_238_12_122,r_138_59_157,seq34,r_238_12_122,0.89,0,122,122,59
24,r_138_59_157,seq345,seq137,r_138_59_157,1.0,0,157,157,59
2,r_146_57_25,r_26_187_100,r_318_89_26,r_146_57_25,0.68,1,26,25,59
88,r_46_351_35,r_20_30_174,seq100,r_46_351_35,0.97,0,35,35,59
4,r_350_51_138,r_171_131_61,seq3,r_171_131_61,0.98,0,61,61,59
87,r_104_225_21,r_282_4_183,seq311,r_104_225_21,0.91,-2,19,21,59
12,r_117_226_183,seq5,r_214_43_1,r_117_226_183,1.0,0,183,183,59
8,r_284_304_22,r_266_249_112,seq118,r_284_304_22,1.0,0,22,22,59
55,r_161_0_105,seq273,seq10,r_161_0_105,0.99,0,105,105,59
120,r_267_241_91,r_82_73_8,seq237,r_267_241_91,1.0,5,96,91,59
5,r_11_243_164,seq162,r_171_131_61,r_11_243_164,1.0,0,164,164,59
101,r_301_29_131,r_20_30_174,r_171_131_61,r_301_29_131,1.0,0,131,131,59
124,r_202_286_164,seq308,seq71,r_202_286_164,0.95,0,164,164,59
96,r_52_6_99,seq79,seq157,r_52_6_99,0.99,0,99,99,59
172,seq139,seq303,r_108_270_91,r_108_270_91,0.87,-3,88,91,59
78,r_296_254_90,r_147_62_115,r_108_270_91,r_296_254_90,0.99,4,94,90,59
97,r_53_102_86,r_285_199_14,seq33,r_53_102_86,1.0,0,86,86,59
90,r_147_62_115,r_21_317_4,seq84,r_147_62_115,1.0,0,115,115,59
111,r_324_215_56,seq2,r_320_170_87,r_324_215_56,0.97,0,56,56,59
47,r_203_129_105,seq35,seq229,r_203_129_105,1.0,0,105,105,59
23,r_292_204_169,seq25,r_374_365_41,r_292_204_169,1.0,0,169,169,59
1,r_20_30_174,seq5,r_161_0_105,r_20_30_174,0.98,0,174,174,59
85,r_200_358_128,r_335_290_83,seq206,r_200_358_128,1.0,0,128,128,59
223,seq303,seq201,r_296_254_90,r_296_254_90,0.49,74,164,90,59
84,r_153_75_120,seq363,seq192,r_153_75_120,1.0,3,123,120,59
85,r_200_358_128,r_266_249_112,r_335_290_83,r_335_290_83,0.55,12,95,83,59
3,r_214_43_1,r_253_261_166,r_259_234_17,r_214_43_1,0.61,58,59,1,59
116,r_156_360_160,seq229,r_289_167_155,r_156_360_160,0.95,2,162,160,59
20,r_41_361_107,seq109,r_244_224_23,r_41_361_107,0.98,0,107,107,59
42,r_213_230_61,r_153_75_120,seq35,r_213_230_61,1.0,0,61,61,59
102,r_207_58_124,seq168,seq219,r_207_58_124,0.97,0,124,124,59
66,r_355_342_51,seq275,seq125,r_355_342_51,1.0,0,51,51,59
99,r_173_356_125,r_152_13_181,seq198,r_173_356_125,1.0,0,125,125,59
51,r_276_92_49,r_41_361_107,seq23,r_276_92_49,1.0,1,50,49,59
64,r_217_208_66,r_265_65_171,seq3,r_265_65_171,1.0,-1,170,171,59
56,r_183_278_117,r_289_167_155,r_7_232_53,r_183_278_117,1.0,0,117,117,59
119,r_338_315_187,seq137,r_236_211_25,r_338_315_187,0.59,0,187,187,59
126,seq3,r_101_114_150,r_217_208_66,r_101_114_150,0.94,0,150,150,59
65,r_133_309_120,r_119_42_184,seq110,r_133_309_120,1.0,4,124,120,59
93,r_255_113_131,r_82_73_8,r_68_252_37,r_255_113_131,0.95,3,134,131,59
98,r_316_160_101,seq10,seq198,r_316_160_101,0.87,-6,95,101,59
74,r_293_14_64,seq268,seq323,r_293_14_64,1.0,0,64,64,59
112,r_106_80_28,r_31_37_54,r_244_224_23,r_106_80_28,1.0,0,28,28,59
53,r_347_196_22,r_31_37_54,r_78_142_4,r_347_196_22,1.0,0,22,22,59
70,r_335_290_83,r_19_88_154,seq174,r_335_290_83,1.0,0,83,83,59
106,r_235_123_126,seq71,r_106_80_28,r_235_123_126,1.0,0,126,126,59
30,r_236_211_25,r_38_352_108,seq77,r_236_211_25,1.0,0,25,25,59
58,r_374_365_41,seq120,seq125,r_374_365_41,1.0,0,41,41,59
19,r_68_252_37,r_53_102_86,seq307,r_68_252_37,0.94,2,39,37,59
118,r_265_65_171,r_217_208_66,r_292_204_169,r_265_65_171,1.0,0,171,171,59
217,seq275,r_355_342_51,r_318_89_26,r_355_342_51,0.68,0,51,51,59
16,r_31_37_54,r_152_13_181,seq177,r_31_37_54,1.0,-1,53,54,59
27,r_260_191_138,seq307,r_41_361_107,r_260_191_138,0.99,0,138,138,59
36,r_19_88_154,seq140,r_64_45_3,r_19_88_154,1.0,0,154,154,59
95,r_7_232_53,r_203_129_105,seq109,r_7_232_53,1.0,2,55,53,59
18,r_152_13_181,seq125,r_217_208_66,r_152_13_181,0.98,0,181,181,59
105,r_364_81_31,r_324_215_56,seq357,r_364_81_31,0.48,0,31,31,59
34,r_108_270_91,r_349_185_143,seq139,r_108_270_91,1.0,0,91,91,59
39,r_318_89_26,r_292_204_169,seq275,r_318_89_26,1.0,0,26,26,59
6,r_107_327_11,r_314_353_194,seq110,r_107_327_11,0.62,0,11,11,59
100,r_119_42_184,seq192,r_236_211_25,r_119_42_184,0.97,0,184,184,59
117,r_134_250_19,r_272_126_131,seq67,r_134_250_19,1.0,0,19,19,59
71,r_103_189_58,seq169,r_48_145_16,r_103_189_58,1.0,0,58,58,59
230,seq321,seq257,r_74_337_130,r_74_337_130,1.0,4,134,130,59
45,r_282_4_183,seq83,r_289_167_155,r_282_4_183,0.78,0,183,183,59
43,r_38_352_108,seq221,seq149,r_38_352_108,1.0,0,108,108,59
173,seq140,r_344_155_135,seq339,r_344_155_135,1.0,0,135,135,59
122,r_274_340_123,seq357,seq32,r_274_340_123,1.0,0,123,123,59
79,r_242_70_61,seq370,r_373_295_63,r_242_70_61,0.99,-1,60,61,59
41,r_344_155_135,seq140,r_31_37_54,r_344_155_135,1.0,0,135,135,59
48,r_74_337_130,seq157,seq321,r_74_337_130,1.0,1,131,130,59
177,seq149,r_310_269_186,r_38_352_108,r_38_352_108,1.0,8,116,108,59
82,r_349_185_143,seq111,seq162,r_349_185_143,0.79,0,143,143,59
121,r_220_36_199,r_218_1_139,r_299_333_79,r_220_36_199,0.98,-104,95,199,59
52,r_181_209_163,r_331_359_81,r_64_45_3,r_181_209_163,1.0,0,163,163,59
147,seq71,r_235_123_126,seq339,r_235_123_126,1.0,0,126,126,59
90,r_56_370_46,r_292_54_57,r_137_109_180,r_292_54_57,0.68,-11,46,57,60
245,seq362,r_9_212_161,seq122,r_9_212_161,1.0,-1,160,161,60
37,r_271_288_162,r_206_182_18,r_372_100_187,r_271_288_162,0.79,2,164,162,60
62,r_175_262_44,r_170_240_185,seq200,r_175_262_44,1.0,1,45,44,60
71,r_257_283_95,seq45,r_293_155_4,r_257_283_95,1.0,-1,94,95,60
30,r_241_22_38,r_176_191_41,seq70,r_241_22_38,1.0,0,38,38,60
22,r_102_339_129,seq25,r_99_58_102,r_99_58_102,0.6,27,129,102,60
210,seq252,r_260_62_162,r_326_24_44,r_260_62_162,1.0,9,171,162,60
27,r_43_224_181,r_217_113_24,r_9_212_161,r_217_113_24,0.95,157,181,24,60
67,r_345_93_82,seq144,seq320,r_345_93_82,1.0,0,82,82,60
72,r_60_268_153,seq373,seq226,r_60_268_153,1.0,0,153,153,60
65,r_159_228_44,seq31,r_365_179_32,r_159_228_44,0.99,0,44,44,60
3,r_222_147_175,seq83,r_206_182_18,r_222_147_175,0.74,0,175,175,60
115,r_213_167_97,r_294_360_111,seq77,r_213_167_97,0.94,3,100,97,60
9,r_194_71_78,seq64,seq52,r_194_71_78,1.0,3,81,78,60
77,r_307_366_73,r_219_317_73,r_195_183_43,r_307_366_73,0.99,0,73,73,60
25,r_65_324_37,r_156_37_106,seq31,r_65_324_37,1.0,0,37,37,60
87,r_355_92_187,r_314_173_194,r_279_149_37,r_355_92_187,0.55,0,187,187,60
100,r_344_211_21,r_215_318_88,seq110,r_344_211_21,1.0,1,22,21,60
59,r_238_251_175,seq38,r_293_155_4,r_238_251_175,0.98,1,176,175,60
51,r_300_158_169,seq50,r_141_174_76,r_300_158_169,1.0,0,169,169,60
41,r_274_10_78,r_304_164_178,r_48_119_67,r_274_10_78,1.0,1,79,78,60
14,r_197_6_122,seq319,r_136_227_80,r_136_227_80,0.6,44,124,80,60
43,r_367_325_77,seq226,r_359_350_63,r_367_325_77,1.0,0,77,77,60
70,r_117_153_120,seq75,r_365_179_32,r_365_179_32,0.87,100,132,32,60
44,r_61_91_42,r_299_244_51,r_177_33_37,r_61_91_42,0.95,4,46,42,60
19,r_260_62_162,seq252,seq1,r_260_62_162,0.88,2,164,162,60
160,seq86,r_176_191_41,r_351_87_12,r_351_87_12,0.95,49,61,12,60
121,r_337_298_144,r_248_347_124,r_280_19_175,r_248_347_124,1.0,0,124,124,60
91,r_327_315_104,seq45,r_177_33_37,r_327_315_104,1.0,0,104,104,60
101,r_137_109_180,r_56_370_46,r_356_57_18,r_137_109_180,1.0,0,180,180,60
97,r_351_87_12,r_156_37_106,seq86,r_351_87_12,1.0,0,12,12,60
132,seq13,r_272_82_158,r_293_155_4,r_272_82_158,1.0,0,158,158,60
103,r_131_128_113,r_168_235_154,r_141_174_76,r_141_174_76,0.73,37,113,76,60
4,r_96_363_184,r_372_100_187,r_217_113_24,r_96_363_184,0.9,0,184,184,60
52,r_343_107_140,seq70,r_76_134_107,r_343_107_140,1.0,1,141,140,60
102,r_374_277_120,seq313,seq151,r_374_277_120,1.0,0,120,120,60
26,r_48_119_67,seq34,seq47,r_48_119_67,1.0,1,68,67,60
107,r_255_236_93,r_131_128_113,r_95_32_6,r_255_236_93,1.0,0,93,93,60
10,r_259_26_88,r_96_363_184,seq306,r_259_26_88,1.0,0,88,88,60
236,seq334,r_178_29_164,r_176_191_41,r_178_29_164,1.0,0,164,164,60
64,r_27_97_120,seq126,seq185,r_27_97_120,0.8,6,126,120,60
95,r_353_286_29,seq321,seq38,r_353_286_29,1.0,1,30,29,60
108,r_301_223_99,r_99_58_102,r_215_318_88,r_215_318_88,1.0,11,99,88,60
132,seq13,r_294_360_111,r_272_82_158,r_294_360_111,1.0,1,112,111,60
119,r_154_282_70,seq122,r_95_32_6,r_154_282_70,1.0,0,70,70,60
7,r_341_352_114,seq89,seq264,r_341_352_114,0.99,0,114,114,60
122,r_171_225_133,seq242,r_341_352_114,r_171_225_133,0.85,5,138,133,60
224,seq306,r_219_317_73,r_81_53_194,r_219_317_73,0.99,1,74,73,60
92,r_76_134_107,r_27_97_120,seq120,r_76_134_107,1.0,0,107,107,60
28,r_15_348_135,r_40_111_43,r_351_87_12,r_15_348_135,1.0,0,135,135,60
57,r_192_130_149,seq20,r_248_347_124,r_248_347_124,0.65,24,148,124,60
80,r_299_244_51,r_171_225_133,seq322,r_299_244_51,1.0,1,52,51,60
16,r_190_142_44,r_136_227_80,r_241_22_38,r_136_227_80,0.99,0,80,80,60
75,r_106_150_132,seq289,seq51,r_106_150_132,1.0,0,132,132,60
90,r_56_370_46,r_137_109_180,r_272_82_158,r_56_370_46,0.99,134,180,46,60
23,r_170_240_185,seq357,r_217_113_24,r_170_240_185,0.66,0,185,185,60
86,r_232_66_186,seq77,r_276_162_176,r_232_66_186,0.82,1,187,186,60
105,r_231_90_89,r_81_53_194,seq110,r_231_90_89,1.0,0,89,89,60
35,r_276_162_176,seq151,seq41,r_276_162_176,1.0,0,176,176,60
112,r_361_201_32,seq51,seq52,r_361_201_32,0.79,4,36,32,60
46,r_101_138_45,r_232_66_186,seq319,r_101_138_45,0.94,0,45,45,60
15,r_99_58_102,r_301_223_99,r_102_339_129,r_102_339_129,0.98,17,146,129,60
82,r_304_164_178,r_353_286_29,seq50,r_304_164_178,0.99,1,179,178,60
229,seq313,r_374_277_120,r_177_33_37,r_374_277_120,0.88,-20,100,120,60
50,r_364_209_154,seq242,r_294_360_111,r_364_209_154,0.96,-3,151,154,60
98,r_198_316_148,seq120,r_241_22_38,r_198_316_148,1.0,0,148,148,60
16,r_190_142_44,r_292_54_57,r_136_227_80,r_190_142_44,0.96,2,46,44,60
142,seq38,r_238_251_175,r_353_286_29,r_238_251_175,0.97,1,176,175,60
88,r_44_35_46,r_341_352_114,r_284_270_20,r_44_35_46,0.99,4,50,46,60
42,r_294_360_111,seq13,r_177_33_37,r_294_360_111,1.0,1,112,111,60
17,r_136_227_80,r_108_261_58,r_190_142_44,r_136_227_80,0.76,-36,44,80,60
2,r_215_318_88,seq139,seq63,r_215_318_88,1.0,0,88,88,60
36,r_74_342_169,r_170_240_185,r_341_352_114,r_341_352_114,0.82,57,171,114,60
38,r_125_69_157,r_148_275_196,seq202,r_125_69_157,1.0,0,157,157,60
12,r_356_57_18,r_260_62_162,seq25,r_356_57_18,0.82,4,22,18,60
235,seq329,r_15_348_135,r_95_32_6,r_15_348_135,1.0,0,135,135,60
68,r_331_253_1,r_36_16_185,r_279_149_37,r_36_16_185,1.0,2,187,185,60
0,r_7_112_84,seq146,seq55,r_7_112_84,0.97,10,94,84,60
99,r_168_235_154,seq5,r_374_277_120,r_168_235_154,0.84,0,154,154,60
48,r_314_173_194,r_355_92_187,r_217_113_24,r_355_92_187,0.73,0,187,187,60
6,r_9_212_161,seq362,r_95_32_6,r_9_212_161,0.98,0,161,161,60
47,r_36_16_185,r_331_253_1,r_260_62_162,r_36_16_185,1.0,2,187,185,60
224,seq306,r_81_53_194,r_259_26_88,r_259_26_88,0.57,20,108,88,60
21,r_118_132_121,r_290_49_169,seq8,r_118_132_121,1.0,0,121,121,60
53,r_219_317_73,seq306,seq242,r_219_317_73,0.99,1,74,73,60
79,r_95_32_6,r_15_348_135,r_255_236_93,r_15_348_135,0.81,0,135,135,60
83,r_152_11_154,seq246,r_189_193_77,r_152_11_154,0.9,0,154,154,60
123,r_229_145_115,r_248_347_124,r_195_183_43,r_229_145_115,0.99,-1,114,115,60
34,r_195_183_43,r_94_239_122,seq181,r_195_183_43,1.0,0,43,43,60
101,r_137_109_180,r_15_348_135,r_56_370_46,r_137_109_180,0.86,-105,75,180,60
63,r_292_54_57,r_257_283_95,r_203_84_57,r_292_54_57,0.87,1,58,57,60
114,r_124_278_26,r_194_71_78,seq144,r_124_278_26,1.0,0,26,26,60
17,r_136_227_80,r_190_142_44,r_44_35_46,r_136_227_80,0.99,0,80,80,60
84,r_359_350_63,seq146,seq373,r_359_350_63,1.0,1,64,63,60
120,r_78_129_21,seq322,seq264,r_78_129_21,0.99,0,21,21,60
117,r_88_0_130,seq2,r_175_262_44,r_88_0_130,1.0,2,132,130,60
113,r_196_220_120,r_304_164_178,seq140,r_196_220_120,1.0,0,120,120,60
214,seq264,seq233,r_78_129_21,r_78_129_21,1.0,2,23,21,60
27,r_43_224_181,r_314_173_194,r_217_113_24,r_217_113_24,1.0,34,58,24,60
5,r_217_113_24,r_43_224_181,r_293_155_4,r_43_224_181,1.0,-1,180,181,60
88,r_44_35_46,r_284_270_20,r_136_227_80,r_136_227_80,1.0,0,80,80,60
116,r_108_261_58,r_136_227_80,r_293_155_4,r_293_155_4,0.51,54,58,4,60
121,r_337_298_144,r_280_19_175,r_293_155_4,r_337_298_144,1.0,0,144,144,60
94,r_333_39_105,seq110,r_56_370_46,r_333_39_105,1.0,1,106,105,60
109,r_121_263_13,r_273_309_119,seq256,r_121_263_13,0.98,0,13,13,60
73,r_336_332_116,seq31,seq120,r_336_332_116,0.99,0,116,116,60
24,r_148_275_196,r_125_69_157,seq18,r_125_69_157,1.0,-1,156,157,60
8,r_123_17_176,seq172,r_215_318_88,r_123_17_176,0.6,4,180,176,60
13,r_365_179_32,r_88_0_130,seq349,r_365_179_32,0.71,0,32,32,60
40,r_94_239_122,seq47,seq311,r_94_239_122,1.0,0,122,122,60
54,r_273_309_119,seq140,r_195_183_43,r_273_309_119,0.94,-1,118,119,60
33,r_290_49_169,r_141_174_76,r_279_149_37,r_290_49_169,1.0,0,169,169,60
69,r_40_111_43,seq116,seq295,r_40_111_43,0.48,47,90,43,60
89,r_177_33_37,r_81_53_194,seq313,r_177_33_37,1.0,0,37,37,60
81,r_248_347_124,r_337_298_144,r_65_324_37,r_248_347_124,1.0,0,124,124,60
212,seq256,r_203_84_57,r_121_263_13,r_203_84_57,1.0,1,58,57,60
18,r_156_37_106,seq116,seq139,r_156_37_106,1.0,0,106,106,60
49,r_189_193_77,seq28,r_195_183_43,r_189_193_77,0.93,0,77,77,60
124,r_328_291_127,r_143_210_157,seq346,r_328_291_127,0.54,-1,126,127,60
78,r_178_29_164,seq334,r_293_155_4,r_178_29_164,0.95,0,164,164,60
133,seq14,r_257_283_95,seq41,r_257_283_95,1.0,0,95,95,60
55,r_143_210_157,seq246,r_333_39_105,r_143_210_157,1.0,1,158,157,60
174,seq139,r_186_188_63,r_156_37_106,r_156_37_106,0.91,8,114,106,60
110,r_165_21_120,r_222_147_175,r_336_332_116,r_222_147_175,0.97,-54,121,175,60
74,r_267_285_126,seq52,r_292_54_57,r_267_285_126,0.72,6,132,126,60
233,seq322,r_117_153_120,r_299_244_51,r_299_244_51,1.0,19,70,51,60
82,r_304_164_178,r_196_220_120,r_353_286_29,r_196_220_120,0.79,0,120,120,60
20,r_46_85_140,seq127,r_353_286_29,r_46_85_140,1.0,0,140,140,60
58,r_203_84_57,seq256,r_292_54_57,r_203_84_57,1.0,1,58,57,60
32,r_279_149_37,r_99_58_102,r_331_253_1,r_279_149_37,1.0,0,37,37,60
45,r_186_188_63,r_294_360_111,seq114,r_186_188_63,1.0,0,63,63,60
5,r_217_113_24,r_292_54_57,r_43_224_181,r_217_113_24,0.88,0,24,24,60
60,r_284_270_20,r_203_84_57,seq51,r_284_270_20,0.8,0,20,20,60
66,r_280_19_175,seq45,seq116,r_280_19_175,0.98,1,176,175,60
111,r_296_67_132,seq311,r_215_318_88,r_296_67_132,0.73,0,132,132,60
72,r_307_194_69,r_104_129_73,r_139_183_59,r_307_194_69,1.0,0,69,69,61
66,r_168_274_162,seq204,r_234_368_42,r_168_274_162,0.75,1,163,162,61
115,r_207_305_159,seq279,r_218_304_6,r_207_305_159,1.0,0,159,159,61
86,r_181_333_23,r_229_272_150,r_250_244_153,r_181_333_23,0.88,130,153,23,61
52,r_251_103_59,r_318_96_156,seq165,r_251_103_59,1.0,2,61,59,61
49,r_9_325_124,seq187,seq81,r_9_325_124,1.0,0,124,124,61
108,r_172_148_19,r_36_358_116,seq11,r_172_148_19,0.99,1,20,19,61
240,seq348,seq166,r_196_253_96,r_196_253_96,0.83,55,151,96,61
95,r_153_80_11,r_356_186_81,seq197,r_153_80_11,0.97,0,11,11,61
84,r_230_8_111,r_213_220_179,seq138,r_213_220_179,0.77,-67,112,179,61
24,r_179_267_77,r_298_370_95,r_337_115_1,r_298_370_95,0.95,-15,80,95,61
116,r_374_64_43,seq24,r_109_82_14,r_374_64_43,1.0,0,43,43,61
32,r_266_321_141,r_45_2_169,seq133,r_45_2_169,0.97,-15,154,169,61
8,r_147_260_52,r_224_124_70,seq101,r_147_260_52,0.99,2,54,52,61
13,r_234_368_42,r_114_17_141,seq369,r_234_368_42,1.0,0,42,42,61
17,r_365_215_88,seq363,seq66,r_365_215_88,1.0,0,88,88,61
103,r_142_210_20,r_239_216_137,r_334_94_137,r_142_210_20,1.0,117,137,20,61
58,r_310_257_43,r_0_294_158,r_271_328_107,r_310_257_43,0.93,116,159,43,61
43,r_288_254_58,r_356_186_81,seq187,r_288_254_58,1.0,0,58,58,61
62,r_155_284_14,r_226_252_112,r_151_52_171,r_155_284_14,0.94,0,14,14,61
124,r_263_364_72,seq348,r_34_245_1,r_263_364_72,0.93,0,72,72,61
15,r_346_258_169,r_34_245_1,r_116_319_147,r_346_258_169,0.94,0,169,169,61
113,r_104_129_73,seq190,seq362,r_104_129_73,1.0,0,73,73,61
23,r_344_373_125,seq38,r_347_46_74,r_344_373_125,1.0,0,125,125,61
111,r_139_183_59,seq302,r_307_194_69,r_307_194_69,1.0,1,70,69,61
81,r_203_85_159,seq19,r_263_364_72,r_203_85_159,0.96,6,165,159,61
138,seq38,r_344_373_125,r_139_183_59,r_344_373_125,1.0,1,126,125,61
101,r_111_50_162,seq86,seq278,r_111_50_162,1.0,0,162,162,61
87,r_34_245_1,seq277,r_292_122_47,r_292_122_47,0.98,15,62,47,61
74,r_228_130_97,seq128,seq363,r_228_130_97,1.0,1,98,97,61
178,seq146,r_70_326_197,r_342_367_51,r_342_367_51,0.99,27,78,51,61
6,r_293_98_96,r_168_274_162,seq355,r_293_98_96,1.0,0,96,96,61
26,r_235_255_97,seq43,seq222,r_235_255_97,0.9,3,100,97,61
100,r_334_94_137,r_360_4_158,r_142_210_20,r_334_94_137,1.0,0,137,137,61
86,r_181_333_23,seq159,r_229_272_150,r_181_333_23,0.97,4,27,23,61
114,r_250_244_153,seq199,r_181_333_23,r_250_244_153,1.0,1,154,153,61
142,seq43,r_235_255_97,r_247_42_184,r_235_255_97,0.96,3,100,97,61
3,r_226_252_112,r_84_202_126,r_290_185_22,r_226_252_112,0.99,0,112,112,61
64,r_311_95_89,r_164_349_196,seq100,r_311_95_89,1.0,0,89,89,61
58,r_310_257_43,r_70_326_197,r_0_294_158,r_310_257_43,1.0,0,43,43,61
63,r_239_216_137,r_93_281_106,r_142_210_20,r_239_216_137,0.7,-54,83,137,61
67,r_79_58_102,seq48,seq291,r_79_58_102,1.0,0,102,102,61
14,r_51_317_125,r_247_42_184,seq72,r_51_317_125,1.0,2,127,125,61
76,r_371_23_24,r_340_285_82,r_109_82_14,r_371_23_24,0.77,1,25,24,61
104,r_109_82_14,r_293_98_96,seq201,r_109_82_14,0.73,0,14,14,61
31,r_196_253_96,seq119,seq363,r_196_253_96,1.0,1,97,96,61
173,seq136,r_15_69_183,r_231_268_24,r_15_69_183,0.93,0,183,183,61
12,r_30_248_174,seq90,r_179_267_77,r_30_248_174,0.78,0,174,174,61
166,seq119,r_79_58_102,r_290_185_22,r_79_58_102,0.82,-38,64,102,61
7,r_89_212_132,seq278,seq286,r_89_212_132,1.0,0,132,132,61
42,r_68_301_62,seq19,seq361,r_68_301_62,1.0,2,64,62,61
45,r_352_162_181,seq100,seq278,r_352_162_181,0.99,0,181,181,61
5,r_36_358_116,seq201,seq121,r_36_358_116,0.99,1,117,116,61
70,r_144_13_140,seq137,seq14,r_144_13_140,1.0,2,142,140,61
39,r_180_174_150,seq135,r_273_71_46,r_180_174_150,0.99,0,150,150,61
21,r_356_186_81,seq338,seq354,r_356_186_81,0.96,0,81,81,61
54,r_318_96_156,r_44_145_174,r_151_52_171,r_318_96_156,1.0,1,157,156,61
121,r_45_2_169,seq372,r_149_31_23,r_45_2_169,0.98,3,172,169,61
35,r_65_315_139,r_61_25_195,r_211_287_4,r_65_315_139,0.67,0,139,139,61
41,r_295_102_71,seq136,r_123_167_20,r_295_102_71,1.0,1,72,71,61
98,r_322_227_127,seq262,seq3,r_322_227_127,0.84,0,127,127,61
1,r_208_366_146,seq3,r_36_358_116,r_208_366_146,0.63,0,146,146,61
105,r_150_18_7,r_9_325_124,r_142_210_20,r_9_325_124,1.0,-25,99,124,61
0,r_345_312_80,seq133,seq32,r_345_312_80,0.93,6,86,80,61
106,r_298_370_95,seq355,r_234_368_42,r_298_370_95,1.0,0,95,95,61
240,seq348,r_263_364_72,seq166,r_263_364_72,0.96,0,72,72,61
50,r_340_285_82,seq354,seq137,r_340_285_82,0.77,1,83,82,61
46,r_173_359_42,r_293_98_96,seq233,r_173_359_42,0.57,2,44,42,61
77,r_290_185_22,r_74_7_91,seq119,r_290_185_22,1.0,0,22,22,61
102,r_229_272_150,r_0_294_158,r_139_183_59,r_229_272_150,0.85,3,153,150,61
123,r_88_209_70,seq11,r_337_115_1,r_88_209_70,1.0,0,70,70,61
103,r_142_210_20,r_352_162_181,r_239_216_137,r_142_210_20,0.94,-2,18,20,61
142,seq43,r_247_42_184,r_214_232_54,r_247_42_184,1.0,1,185,184,61
16,r_74_7_91,r_33_280_118,r_34_245_1,r_33_280_118,0.73,-22,96,118,61
99,r_28_108_80,r_134_78_99,seq341,r_134_78_99,0.46,-18,81,99,61
69,r_171_22_19,r_15_69_183,r_110_49_4,r_171_22_19,1.0,0,19,19,61
44,r_283_154_10,r_36_358_116,seq19,r_283_154_10,0.75,0,10,10,61
78,r_332_131_28,seq86,seq278,r_332_131_28,1.0,1,29,28,61
9,r_134_78_99,seq336,r_172_148_19,r_134_78_99,1.0,0,99,99,61
118,r_35_118_135,seq53,r_311_95_89,r_311_95_89,1.0,51,140,89,61
197,seq197,seq190,r_153_80_11,r_153_80_11,0.83,48,59,11,61
73,r_29_331_103,seq37,r_345_312_80,r_29_331_103,1.0,0,103,103,61
92,r_343_327_44,r_214_232_54,r_337_115_1,r_343_327_44,0.99,0,44,44,61
112,r_189_175_171,r_151_52_171,seq166,r_189_175_171,0.82,5,176,171,61
218,seq278,r_89_212_132,r_332_131_28,r_89_212_132,0.96,-38,94,132,61
75,r_33_280_118,seq156,r_234_368_42,r_33_280_118,1.0,0,118,118,61
19,r_360_4_158,seq279,r_314_188_81,r_360_4_158,0.99,0,158,158,61
48,r_149_31_23,r_189_175_171,seq100,r_149_31_23,0.99,0,23,23,61
110,r_123_167_20,r_134_78_99,seq330,r_134_78_99,0.73,-76,23,99,61
56,r_0_294_158,r_310_257_43,r_196_253_96,r_0_294_158,0.61,0,158,158,61
51,r_6_60_31,r_237_264_121,seq140,r_6_60_31,1.0,0,31,31,61
89,r_271_328_107,r_111_50_162,r_310_257_43,r_271_328_107,1.0,0,107,107,61
109,r_105_91_75,r_26_73_145,r_295_102_71,r_26_73_145,0.53,-68,77,145,61
20,r_313_92_121,seq156,r_79_58_102,r_313_92_121,1.0,0,121,121,61
60,r_116_319_147,r_16_243_144,r_239_216_137,r_116_319_147,1.0,0,147,147,61
88,r_84_202_126,r_89_212_132,r_293_98_96,r_84_202_126,0.9,0,126,126,61
22,r_54_57_66,r_344_373_125,seq163,r_54_57_66,1.0,-1,65,66,61
63,r_239_216_137,r_142_210_20,r_313_92_121,r_239_216_137,0.95,0,137,137,61
225,seq299,r_35_118_135,r_307_194_69,r_307_194_69,1.0,11,80,69,61
117,r_126_353_160,seq233,r_74_7_91,r_126_353_160,1.0,2,162,160,61
245,seq361,r_214_232_54,seq38,r_214_232_54,1.0,1,55,54,61
91,r_219_67_53,r_266_321_141,seq86,r_219_67_53,0.97,5,58,53,61
10,r_93_281_106,r_239_216_137,r_293_98_96,r_93_281_106,0.99,0,106,106,61
55,r_247_42_184,seq43,r_234_368_42,r_247_42_184,0.98,0,184,184,61
27,r_342_367_51,r_226_252_112,seq146,r_342_367_51,0.96,2,53,51,61
33,r_26_73_145,seq198,r_235_255_97,r_26_73_145,0.77,1,146,145,61
18,r_231_268_24,r_266_321_141,r_109_82_14,r_231_268_24,0.69,1,25,24,61
65,r_213_220_179,seq279,r_196_253_96,r_213_220_179,0.98,4,183,179,61
68,r_249_270_110,r_0_294_158,r_68_301_62,r_249_270_110,1.0,1,111,110,61
47,r_15_69_183,seq136,r_334_94_137,r_15_69_183,0.81,0,183,183,61
247,seq363,r_365_215_88,r_125_206_17,r_365_215_88,1.0,0,88,88,61
37,r_157_303_86,seq222,seq302,r_157_303_86,1.0,0,86,86,61
128,seq11,r_88_209_70,r_172_148_19,r_88_209_70,1.0,-2,68,70,61
2,r_214_232_54,seq361,seq222,r_214_232_54,1.0,1,55,54,61
40,r_114_17_141,r_79_58_102,r_89_212_132,r_114_17_141,1.0,1,142,141,61
34,r_205_47_35,r_179_267_77,r_16_243_144,r_205_47_35,1.0,0,35,35,61
96,r_44_145_174,seq136,r_365_215_88,r_44_145_174,0.66,0,174,174,61
56,r_0_294_158,r_26_73_145,r_310_257_43,r_310_257_43,1.0,17,60,43,61
120,r_127_225_14,r_36_358_116,seq204,r_127_225_14,0.94,2,16,14,61
79,r_276_161_114,r_114_17_141,r_127_225_14,r_276_161_114,1.0,0,114,114,61
204,seq222,r_157_303_86,r_214_232_54,r_157_303_86,0.64,0,86,86,61
107,r_292_122_47,r_10_169_198,r_34_245_1,r_292_122_47,0.88,8,55,47,61
40,r_114_17_141,r_276_161_114,r_79_58_102,r_114_17_141,1.0,-27,114,141,61
83,r_240_99_57,r_180_174_150,seq279,r_240_99_57,1.0,1,58,57,61
94,r_347_46_74,r_356_186_81,seq158,r_347_46_74,0.99,0,74,74,61
122,r_316_217_84,seq300,r_54_57_66,r_316_217_84,0.9,1,85,84,61
59,r_56_306_183,seq106,r_313_92_121,r_56_306_183,0.99,0,183,183,61
85,r_143_117_114,r_168_274_162,r_28_108_80,r_143_117_114,1.0,0,114,114,61
79,r_224_166_11,seq281,seq129,r_224_166_11,0.88,0,11,11,62
30,r_273_114_66,r_36_156_46,seq13,r_273_114_66,0.98,0,66,66,62
16,r_77_112_40,r_160_194_78,seq278,r_77_112_40,0.71,-13,27,40,62
122,r_212_198_132,r_265_56_173,r_115_226_7,r_212_198_132,0.65,2,134,132,62
52,r_352_167_26,r_344_370_96,r_234_328_37,r_234_328_37,0.66,0,37,37,62
44,r_333_346_67,r_125_180_183,r_225_247_18,r_333_346_67,0.85,1,68,67,62
142,seq57,r_146_313_155,r_360_342_56,r_360_342_56,1.0,30,86,56,62
102,r_231_118_88,r_32_363_127,r_107_320_68,r_32_363_127,0.54,-39,88,127,62
19,r_344_370_96,seq29,r_91_238_84,r_344_370_96,0.9,0,96,96,62
39,r_55_16_101,seq165,seq134,r_55_16_101,0.98,11,112,101,62
0,r_0_23_160,seq116,r_192_72_58,r_0_23_160,0.93,4,164,160,62
98,r_351_7_155,r_334_217_190,seq11,r_351_7_155,0.94,7,162,155,62
249,seq369,r_22_95_89,seq10,r_22_95_89,1.0,-25,64,89,62
67,r_303_339_40,r_232_264_52,seq119,r_303_339_40,0.97,2,42,40,62
31,r_318_290_188,r_284_50_110,seq117,r_318_290_188,0.69,0,188,188,62
68,r_366_141_156,r_249_345_184,r_99_183_112,r_99_183_112,0.99,0,112,112,62
21,r_253_359_82,r_55_16_101,seq10,r_253_359_82,1.0,0,82,82,62
99,r_92_361_87,r_285_307_173,r_88_163_6,r_92_361_87,1.0,0,87,87,62
26,r_17_270_21,r_25_73_106,r_315_355_97,r_17_270_21,0.54,0,21,21,62
212,seq274,r_83_19_10,r_249_345_184,r_83_19_10,0.55,127,137,10,62
14,r_125_180_183,seq338,r_187_172_132,r_125_180_183,0.99,0,183,183,62
224,seq294,seq34,r_189_147_27,r_189_147_27,1.0,0,27,27,62
56,r_1_364_140,seq357,r_127_306_191,r_1_364_140,0.93,3,143,140,62
107,r_40_213_145,seq81,r_143_373_117,r_40_213_145,1.0,0,145,145,62
83,r_208_39_86,r_304_177_91,r_250_371_8,r_208_39_86,0.92,0,86,86,62
77,r_250_371_8,r_344_370_96,seq109,r_250_371_8,0.9,4,12,8,62
4,r_179_18_74,seq4,seq300,r_179_18_74,1.0,0,74,74,62
57,r_334_217_190,seq291,r_123_326_113,r_123_326_113,0.79,77,190,113,62
2,r_251_244_146,seq144,seq119,r_251_244_146,1.0,0,146,146,62
5,r_285_307_173,r_138_257_185,r_55_16_101,r_138_257_185,0.95,-11,174,185,62
10,r_176_27_66,r_0_23_160,seq186,r_176_27_66,0.89,-2,64,66,62
13,r_199_196_40,r_173_101_27,r_127_306_191,r_199_196_40,0.73,-6,34,40,62
23,r_74_149_188,seq10,r_0_23_160,r_74_149_188,0.99,0,188,188,62
48,r_30_2_133,seq80,seq286,r_30_2_133,0.99,0,133,133,62
92,r_42_26_105,r_321_113_190,r_173_101_27,r_42_26_105,0.79,6,111,105,62
31,r_318_290_188,seq324,r_284_50_110,r_284_50_110,0.93,-1,109,110,62
6,r_103_175_149,seq341,r_344_370_96,r_103_175_149,0.98,2,151,149,62
9,r_138_257_185,r_308_24_180,seq298,r_138_257_185,1.0,1,186,185,62
20,r_322_215_22,r_251_244_146,seq66,r_322_215_22,0.97,0,22,22,62
22,r_107_320_68,r_99_183_112,seq281,r_107_320_68,0.86,0,68,68,62
101,r_232_264_52,seq186,r_199_196_40,r_232_264_52,0.71,0,52,52,62
37,r_15_21_116,r_259_133_121,r_250_371_8,r_250_371_8,1.0,108,116,8,62
123,r_53_374_49,r_253_359_82,seq45,r_253_359_82,0.47,-39,43,82,62
17,r_210_343_117,seq206,r_261_62_42,r_210_343_117,0.97,12,129,117,62
242,seq338,r_125_180_183,r_171_327_120,r_125_180_183,1.0,0,183,183,62
93,r_174_90_88,r_135_159_51,seq336,r_174_90_88,1.0,0,88,88,62
66,r_248_51_21,r_36_156_46,seq278,r_248_51_21,0.99,0,21,21,62
55,r_256_68_45,r_303_339_40,seq65,r_256_68_45,0.94,-5,40,45,62
8,r_187_172_132,r_285_307_173,r_100_170_70,r_100_170_70,0.63,64,134,70,62
86,r_329_86_44,seq267,seq338,r_329_86_44,0.98,-1,43,44,62
210,seq263,r_305_230_52,r_142_169_21,r_142_169_21,0.97,21,42,21,62
74,r_189_147_27,r_253_359_82,seq294,r_189_147_27,0.94,0,27,27,62
68,r_366_141_156,r_99_183_112,r_224_166_11,r_366_141_156,0.93,0,156,156,62
89,r_132_190_91,seq14,r_88_163_6,r_132_190_91,1.0,0,91,91,62
113,r_58_61_138,seq298,seq301,r_58_61_138,1.0,0,138,138,62
40,r_321_113_190,seq60,seq71,r_321_113_190,0.58,0,190,190,62
35,r_234_328_37,seq281,r_352_167_26,r_234_328_37,1.0,0,37,37,62
30,r_273_114_66,seq188,r_36_156_46,r_273_114_66,0.84,-14,52,66,62
47,r_37_237_50,r_59_246_119,seq116,r_37_237_50,0.9,0,50,50,62
95,r_297_258_164,seq335,r_176_27_66,r_297_258_164,0.42,0,164,164,62
60,r_160_194_78,r_254_63_158,seq267,r_160_194_78,1.0,0,78,78,62
109,r_225_247_18,r_253_359_82,seq222,r_225_247_18,0.83,0,18,18,62
27,r_193_310_147,seq79,r_143_373_117,r_193_310_147,1.0,0,147,147,62
90,r_178_325_144,seq13,r_32_363_127,r_178_325_144,0.97,0,144,144,62
120,r_331_268_147,seq280,r_354_5_46,r_354_5_46,0.88,100,146,46,62
78,r_201_266_133,r_251_244_146,r_284_50_110,r_201_266_133,1.0,0,133,133,62
118,r_220_216_80,r_1_364_140,r_295_41_8,r_220_216_80,1.0,-1,79,80,62
38,r_261_62_42,r_236_128_111,seq165,r_261_62_42,0.58,0,42,42,62
91,r_304_177_91,r_208_39_86,seq206,r_304_177_91,0.69,0,91,91,62
73,r_36_156_46,r_123_326_113,r_273_114_66,r_36_156_46,0.82,-1,45,46,62
103,r_182_275_128,seq367,r_171_327_120,r_182_275_128,1.0,1,129,128,62
50,r_91_238_84,r_178_325_144,r_292_3_24,r_91_238_84,1.0,0,84,84,62
65,r_99_183_112,r_30_2_133,r_366_141_156,r_99_183_112,0.65,0,112,112,62
76,r_209_348_51,r_47_136_62,r_256_68_45,r_47_136_62,0.87,-12,50,62,62
41,r_181_271_100,r_125_180_183,r_135_159_51,r_181_271_100,0.77,0,100,100,62
61,r_22_95_89,seq369,seq368,r_22_95_89,1.0,0,89,89,62
64,r_347_46_162,seq202,r_127_306_191,r_347_46_162,0.82,3,165,162,62
124,r_236_128_111,seq276,seq69,r_236_128_111,0.82,0,111,111,62
237,seq324,r_318_290_188,r_140_314_65,r_140_314_65,0.71,-14,51,65,62
51,r_241_158_170,seq368,r_193_310_147,r_193_310_147,0.92,26,173,147,62
84,r_315_355_97,r_241_158_170,seq28,r_315_355_97,0.87,-7,90,97,62
29,r_47_136_62,r_231_118_88,seq219,r_231_118_88,0.5,-26,62,88,62
15,r_123_326_113,r_262_87_139,r_229_130_71,r_123_326_113,1.0,1,114,113,62
58,r_64_358_124,r_6_340_121,seq57,r_64_358_124,0.95,-1,123,124,62
85,r_282_38_150,seq276,seq233,r_282_38_150,1.0,1,151,150,62
34,r_59_246_119,r_265_56_173,r_189_147_27,r_59_246_119,1.0,0,119,119,62
108,r_292_3_24,r_0_23_160,seq144,r_292_3_24,1.0,0,24,24,62
70,r_97_96_157,r_249_345_184,seq81,r_97_96_157,0.97,0,157,157,62
111,r_284_50_110,r_315_355_97,r_201_266_133,r_201_266_133,0.99,1,134,133,62
12,r_127_306_191,r_334_217_190,r_372_111_23,r_372_111_23,0.99,-4,19,23,62
18,r_354_5_46,seq10,seq66,r_354_5_46,1.0,0,46,46,62
63,r_254_63_158,seq13,seq89,r_254_63_158,1.0,0,158,158,62
65,r_99_183_112,r_366_141_156,r_77_112_40,r_366_141_156,1.0,0,156,156,62
162,seq116,r_0_23_160,r_37_237_50,r_0_23_160,0.74,4,164,160,62
7,r_360_342_56,r_15_21_116,seq57,r_360_342_56,0.73,0,56,56,62
22,r_107_320_68,seq281,r_231_118_88,r_231_118_88,0.99,2,90,88,62
45,r_100_170_70,r_151_299_191,r_102_353_10,r_100_170_70,1.0,0,70,70,62
97,r_262_87_139,seq227,r_52_239_8,r_262_87_139,1.0,0,139,139,62
112,r_43_139_176,seq89,r_161_85_121,r_43_139_176,0.77,1,177,176,62
42,r_146_313_155,seq76,r_176_27_66,r_146_313_155,0.77,1,156,155,62
169,seq129,seq117,r_224_166_11,r_224_166_11,0.93,-1,10,11,62
59,r_6_340_121,r_64_358_124,r_100_170_70,r_100_170_70,0.85,53,123,70,62
82,r_259_133_121,r_251_244_146,r_25_73_106,r_259_133_121,1.0,0,121,121,62
198,seq222,seq211,r_225_247_18,r_225_247_18,1.0,1,19,18,62
36,r_229_130_71,r_344_370_96,seq188,r_229_130_71,0.98,0,71,71,62
88,r_350_49_17,r_171_327_120,seq144,r_350_49_17,0.76,0,17,17,62
119,r_32_363_127,r_331_268_147,seq54,r_32_363_127,0.93,9,136,127,62
96,r_287_252_118,r_249_345_184,r_305_230_52,r_287_252_118,0.79,36,154,118,62
110,r_161_85_121,r_178_325_144,seq79,r_161_85_121,1.0,0,121,121,62
11,r_192_72_58,r_366_141_156,seq14,r_192_72_58,0.53,-6,52,58,62
75,r_171_327_120,r_58_61_138,seq338,r_58_61_138,0.99,-18,120,138,62
80,r_140_314_65,r_59_246_119,seq324,r_140_314_65,0.94,-3,62,65,62
81,r_25_73_106,r_40_213_145,seq277,r_25_73_106,0.75,0,106,106,62
53,r_143_373_117,r_265_56_173,seq289,r_143_373_117,0.88,-1,116,117,62
71,r_372_111_23,r_253_359_82,r_127_306_191,r_372_111_23,0.99,-4,19,23,62
41,r_181_271_100,seq71,r_125_180_183,r_181_271_100,0.49,-60,40,100,62
105,r_305_230_52,seq263,seq276,r_305_230_52,0.75,1,53,52,62
117,r_272_78_84,r_171_327_120,seq79,r_272_78_84,1.0,-1,83,84,62
62,r_154_150_70,seq205,r_224_166_11,r_154_150_70,1.0,0,70,70,62
73,r_36_156_46,r_273_114_66,seq10,r_273_114_66,0.66,0,66,66,62
32,r_197_122_42,seq228,seq153,r_197_122_42,1.0,0,42,42,62
100,r_293_162_37,seq274,seq14,r_293_162_37,0.75,-2,35,37,62
184,seq186,seq336,r_176_27_66,r_176_27_66,1.0,-4,62,66,62
59,r_28_221_94,r_122_103_10,r_215_99_11,r_28_221_94,1.0,0,94,94,63
113,r_77_239_20,seq35,seq26,r_77_239_20,0.73,0,20,20,63
21,r_79_340_103,seq163,seq76,r_79_340_103,1.0,2,105,103,63
64,r_350_137_81,r_250_114_157,r_273_289_35,r_350_137_81,0.6,1,82,81,63
173,seq150,r_13_112_199,r_18_309_20,r_18_309_20,0.9,4,24,20,63
166,seq119,r_250_114_157,r_279_69_103,r_250_114_157,1.0,2,159,157,63
48,r_323_171_80,seq50,r_267_217_16,r_323_171_80,0.71,11,91,80,63
120,r_18_309_20,seq314,seq150,r_18_309_20,0.68,0,20,20,63
246,seq367,r_186_15_185,r_276_364_64,r_186_15_185,0.99,2,187,185,63
80,r_89_64_139,seq68,r_280_146_88,r_89_64_139,1.0,0,139,139,63
37,r_280_146_88,r_158_358_155,seq196,r_280_146_88,1.0,-1,87,88,63
58,r_337_317_111,seq293,seq27,r_337_317_111,1.0,0,111,111,63
54,r_106_211_50,seq148,seq131,r_106_211_50,0.84,-3,47,50,63
102,r_305_297_115,seq229,r_140_165_1,r_305_297_115,1.0,0,115,115,63
155,seq81,seq39,r_45_198_51,r_45_198_51,1.0,-1,50,51,63
12,r_263_180_85,seq49,seq48,r_263_180_85,1.0,-4,81,85,63
11,r_304_226_128,r_224_269_194,seq60,r_304_226_128,0.98,1,129,128,63
40,r_130_96_54,r_296_287_183,r_126_90_139,r_130_96_54,0.81,129,183,54,63
84,r_267_217_16,r_29_197_54,seq1,r_267_217_16,0.64,0,16,16,63
117,r_277_312_15,r_365_230_108,r_13_112_199,r_277_312_15,0.6,1,16,15,63
57,r_316_311_32,r_186_15_185,seq195,r_316_311_32,0.73,1,33,32,63
148,seq55,r_74_243_183,r_212_6_27,r_212_6_27,0.99,-2,25,27,63
91,r_117_257_142,seq373,r_242_43_95,r_117_257_142,0.87,6,148,142,63
45,r_242_43_95,seq38,r_205_313_112,r_242_43_95,1.0,3,98,95,63
35,r_270_254_50,r_113_327_158,seq16,r_270_254_50,1.0,0,50,50,63
72,r_356_320_90,seq87,r_292_362_3,r_356_320_90,0.99,-1,89,90,63
50,r_74_243_183,seq55,r_42_59_130,r_74_243_183,0.96,0,183,183,63
56,r_248_100_147,r_189_133_196,r_365_230_108,r_248_100_147,1.0,0,147,147,63
30,r_105_210_165,seq14,seq272,r_105_210_165,1.0,1,166,165,63
107,r_94_192_129,r_172_33_183,seq38,r_94_192_129,0.99,0,129,129,63
119,r_152_209_19,seq153,seq4,r_152_209_19,0.96,0,19,19,63
55,r_326_30_109,r_328_80_143,seq44,r_326_30_109,1.0,0,109,109,63
36,r_42_59_130,seq1,r_276_364_64,r_276_364_64,0.67,74,138,64,63
79,r_335_21_173,seq190,r_0_19_87,r_335_21_173,1.0,3,176,173,63
70,r_353_23_60,r_115_125_192,r_107_338_106,r_107_338_106,0.98,15,121,106,63
123,r_8_57_144,seq307,r_365_230_108,r_365_230_108,0.54,41,149,108,63
20,r_158_358_155,r_279_69_103,r_242_43_95,r_158_358_155,0.97,5,160,155,63
99,r_328_80_143,seq241,seq295,r_328_80_143,0.76,6,149,143,63
244,seq352,r_86_234_117,r_185_213_63,r_86_234_117,1.0,0,117,117,63
7,r_126_90_139,seq252,seq84,r_126_90_139,1.0,0,139,139,63
94,r_164_182_181,r_120_101_112,seq295,r_120_101_112,0.88,-26,86,112,63
140,seq38,r_242_43_95,seq60,r_242_43_95,1.0,-27,68,95,63
71,r_215_99_11,r_264_266_55,r_205_313_112,r_215_99_11,0.57,0,11,11,63
43,r_37_330_39,r_156_162_120,seq346,r_37_330_39,0.98,-1,38,39,63
81,r_354_200_102,seq34,r_205_313_112,r_354_200_102,1.0,0,102,102,63
114,r_359_374_25,r_31_294_136,r_17_178_44,r_31_294_136,1.0,1,137,136,63
6,r_264_266_55,r_172_33_183,seq307,r_264_266_55,1.0,0,55,55,63
75,r_185_213_63,r_224_269_194,seq352,r_185_213_63,0.96,-1,62,63,63
4,r_0_19_87,r_186_15_185,seq228,r_0_19_87,1.0,0,87,87,63
44,r_156_162_120,seq102,seq343,r_156_162_120,1.0,0,120,120,63
69,r_344_61_174,seq161,r_0_19_87,r_344_61_174,0.96,2,176,174,63
226,seq299,r_107_338_106,r_106_211_50,r_107_338_106,1.0,0,106,106,63
124,r_276_364_64,r_79_340_103,seq367,r_276_364_64,0.64,1,65,64,63
147,seq50,r_186_15_185,r_290_372_132,r_290_372_132,0.67,5,137,132,63
104,r_107_338_106,seq299,r_353_23_60,r_107_338_106,1.0,0,106,106,63
2,r_147_70_19,r_189_133_196,seq44,r_147_70_19,1.0,0,19,19,63
88,r_191_265_85,r_122_103_10,seq154,r_191_265_85,1.0,0,85,85,63
89,r_172_33_183,r_129_160_7,r_250_114_157,r_172_33_183,1.0,0,183,183,63
8,r_250_114_157,seq119,r_255_104_77,r_250_114_157,0.99,2,159,157,63
154,seq76,r_371_355_172,r_79_340_103,r_79_340_103,0.61,70,173,103,63
61,r_279_69_103,r_280_146_88,seq345,r_280_146_88,1.0,0,88,88,63
217,seq272,r_53_24_177,r_105_210_165,r_105_210_165,0.66,-1,164,165,63
94,r_164_182_181,seq295,r_0_19_87,r_164_182_181,0.93,1,182,181,63
105,r_86_234_117,seq352,seq345,r_86_234_117,1.0,0,117,117,63
110,r_47_342_173,r_78_177_195,r_323_171_80,r_47_342_173,1.0,1,174,173,63
9,r_95_237_37,r_122_103_10,seq44,r_95_237_37,1.0,0,37,37,63
78,r_149_134_188,seq170,r_42_59_130,r_149_134_188,1.0,1,189,188,63
217,seq272,r_339_85_55,r_53_24_177,r_339_85_55,1.0,1,56,55,63
13,r_13_112_199,seq150,r_277_312_15,r_277_312_15,0.89,1,16,15,63
152,seq68,r_89_64_139,r_318_63_28,r_318_63_28,0.88,0,28,28,63
68,r_20_56_71,r_172_33_183,r_167_110_48,r_20_56_71,1.0,0,71,71,63
60,r_123_54_136,r_122_103_10,r_0_19_87,r_123_54_136,1.0,-1,135,136,63
66,r_58_325_103,r_371_355_172,r_106_211_50,r_58_325_103,1.0,0,103,103,63
83,r_52_155_67,seq12,seq278,r_52_155_67,1.0,-2,65,67,63
5,r_246_108_182,seq41,r_0_19_87,r_246_108_182,1.0,0,182,182,63
52,r_255_104_77,r_122_103_10,seq190,r_255_104_77,1.0,0,77,77,63
24,r_139_136_45,r_369_151_59,seq314,r_139_136_45,0.93,1,46,45,63
10,r_253_22_142,r_250_114_157,r_152_209_19,r_253_22_142,1.0,0,142,142,63
109,r_231_138_153,seq348,r_0_19_87,r_231_138_153,1.0,0,153,153,63
118,r_212_6_27,seq32,seq55,r_212_6_27,0.84,-2,25,27,63
95,r_290_372_132,seq87,seq50,r_290_372_132,1.0,0,132,132,63
103,r_347_174_24,r_369_151_59,seq153,r_347_174_24,0.98,1,25,24,63
213,seq256,r_113_327_158,r_120_101_112,r_113_327_158,0.63,11,169,158,63
92,r_45_198_51,seq343,seq81,r_45_198_51,1.0,-2,49,51,63
96,r_308_357_62,r_263_180_85,seq41,r_308_357_62,1.0,0,62,62,63
101,r_17_178_44,r_361_3_120,r_359_374_25,r_17_178_44,1.0,0,44,44,63
121,r_167_110_48,r_93_5_87,r_97_360_191,r_97_360_191,1.0,-143,48,191,63
87,r_336_116_73,r_140_165_1,r_292_362_3,r_336_116_73,1.0,0,73,73,63
63,r_113_327_158,seq256,r_0_19_87,r_113_327_158,0.97,11,169,158,63
41,r_296_287_183,r_130_96_54,r_94_192_129,r_296_287_183,1.0,0,183,183,63
62,r_183_319_147,seq98,seq300,r_183_319_147,1.0,1,148,147,63
70,r_353_23_60,r_52_155_67,r_115_125_192,r_353_23_60,0.97,0,60,60,63
49,r_235_73_162,r_157_92_130,r_106_211_50,r_157_92_130,1.0,-1,129,130,63
49,r_235_73_162,r_106_211_50,r_122_103_10,r_235_73_162,0.98,0,162,162,63
225,seq295,seq203,r_328_80_143,r_328_80_143,0.62,5,148,143,63
14,r_361_3_120,seq310,seq170,r_361_3_120,1.0,0,120,120,63
53,r_315_284_181,seq220,r_304_226_128,r_315_284_181,1.0,0,181,181,63
185,seq176,r_145_2_92,seq67,r_145_2_92,1.0,0,92,92,63
19,r_186_15_185,seq367,r_185_213_63,r_186_15_185,0.93,2,187,185,63
85,r_145_2_92,seq176,seq256,r_145_2_92,1.0,0,92,92,63
67,r_339_85_55,seq272,seq141,r_339_85_55,1.0,0,55,55,63
241,seq346,seq195,r_37_330_39,r_37_330_39,0.91,83,122,39,63
51,r_122_103_10,r_275_240_195,r_235_73_162,r_235_73_162,0.99,8,170,162,63
40,r_130_96_54,r_140_165_1,r_296_287_183,r_130_96_54,1.0,0,54,54,63
17,r_72_333_13,r_354_200_102,seq173,r_72_333_13,1.0,0,13,13,63
18,r_318_63_28,r_371_355_172,seq68,r_318_63_28,1.0,0,28,28,63
46,r_25_193_59,r_296_287_183,seq288,r_25_193_59,1.0,0,59,59,63
15,r_120_101_112,r_164_182_181,r_145_2_92,r_145_2_92,0.91,21,113,92,63
42,r_273_289_35,r_250_114_157,seq370,r_273_289_35,1.0,0,35,35,63
97,r_222_303_41,r_122_103_10,r_277_312_15,r_222_303_41,1.0,0,41,41,63
0,r_369_151_59,r_315_284_181,seq119,r_369_151_59,0.99,0,59,59,63
73,r_51_201_54,r_86_234_117,seq124,r_51_201_54,0.71,-12,42,54,63
114,r_359_374_25,r_246_108_182,r_31_294_136,r_359_374_25,1.0,0,25,25,63
34,r_371_355_172,seq76,seq49,r_371_355_172,0.72,1,173,172,63
108,r_157_92_130,r_235_73_162,seq81,r_157_92_130,0.81,-1,129,130,63
115,r_65_260_27,r_264_266_55,r_267_217_16,r_65_260_27,0.6,2,29,27,63
41,r_296_287_183,r_25_193_59,r_130_96_54,r_296_287_183,1.0,-128,55,183,63
1,r_93_5_87,seq283,r_20_56_71,r_93_5_87,1.0,0,87,87,63
76,r_187_66_124,seq131,seq154,r_187_66_124,1.0,1,125,124,63
146,seq49,r_263_180_85,r_212_6_27,r_263_180_85,0.51,4,89,85,63
106,r_249_111_25,r_95_237_37,r_140_165_1,r_249_111_25,0.95,0,25,25,63
74,r_298_247_46,r_250_114_157,r_18_309_20,r_298_247_46,1.0,0,46,46,63
119,r_4_107_173,seq362,r_126_317_56,r_4_107_173,0.66,1,174,173,64
3,r_300_197_92,r_358_236_127,seq285,r_300_197_92,1.0,0,92,92,64
93,r_275_23_163,r_309_153_186,r_300_197_92,r_275_23_163,0.99,7,170,163,64
50,r_360_145_45,seq242,seq203,r_360_145_45,1.0,1,46,45,64
47,r_368_343_106,seq295,r_27_282_81,r_27_282_81,0.96,25,106,81,64
91,r_196_215_19,r_27_282_81,seq86,r_196_215_19,0.99,1,20,19,64
99,r_87_314_188,seq44,r_356_322_168,r_87_314_188,0.95,0,188,188,64
25,r_287_265_103,r_315_118_105,r_21_22_35,r_287_265_103,0.76,0,103,103,64
15,r_148_132_34,r_18_272_62,r_172_280_112,r_148_132_34,0.99,0,34,34,64
246,seq362,r_4_107_173,r_72_267_20,r_4_107_173,0.55,1,174,173,64
193,seq206,r_358_236_127,r_361_277_50,r_358_236_127,0.77,0,127,127,64
76,r_181_261_109,r_51_228_174,r_268_351_151,r_181_261_109,1.0,0,109,109,64
11,r_356_322_168,r_42_13_181,r_319_212_144,r_356_322_168,1.0,1,169,168,64
98,r_8_227_81,seq239,seq10,r_8_227_81,0.99,0,81,81,64
39,r_327_0_172,seq175,r_149_374_8,r_327_0_172,1.0,0,172,172,64
220,seq286,r_232_256_157,r_363_201_37,r_232_256_157,1.0,0,157,157,64
71,r_303_159_77,seq316,seq3,r_303_159_77,0.99,0,77,77,64
61,r_24_177_32,seq262,seq14,r_24_177_32,0.96,0,32,32,64
56,r_147_60_126,seq295,seq73,r_147_60_126,0.98,3,129,126,64
100,r_288_200_105,seq302,r_318_260_71,r_288_200_105,1.0,0,105,105,64
6,r_126_317_56,r_50_312_108,seq154,r_126_317_56,1.0,0,56,56,64
90,r_26_105_70,seq245,seq316,r_26_105_70,1.0,0,70,70,64
78,r_166_120_149,r_111_127_199,r_319_212_144,r_166_120_149,0.99,1,150,149,64
12,r_121_116_181,seq158,seq89,r_121_116_181,0.97,1,182,181,64
64,r_51_228_174,r_47_331_73,r_327_0_172,r_51_228_174,1.0,0,174,174,64
0,r_102_29_22,r_38_257_106,seq193,r_102_29_22,0.96,0,22,22,64
30,r_340_81_21,r_72_267_20,seq28,r_340_81_21,0.93,0,21,21,64
62,r_365_348_171,r_185_199_3,r_104_53_143,r_185_199_3,0.97,169,172,3,64
53,r_369_165_187,seq364,r_300_197_92,r_369_165_187,0.72,0,187,187,64
43,r_324_74_43,r_327_0_172,r_148_132_34,r_327_0_172,0.85,-129,43,172,64
59,r_111_127_199,r_166_120_149,r_297_57_34,r_166_120_149,0.93,1,150,149,64
2,r_97_310_29,r_20_373_73,r_174_11_13,r_97_310_29,0.95,3,32,29,64
82,r_191_298_124,r_134_155_148,r_263_273_35,r_191_298_124,1.0,0,124,124,64
42,r_30_32_158,r_123_113_190,r_147_60_126,r_123_113_190,0.9,-25,165,190,64
45,r_50_312_108,seq341,seq210,r_50_312_108,1.0,0,108,108,64
108,r_169_61_107,seq170,seq252,r_169_61_107,1.0,0,107,107,64
37,r_9_130_48,r_51_228_174,r_353_138_32,r_9_130_48,1.0,0,48,48,64
121,r_47_331_73,r_327_0_172,seq176,r_47_331_73,1.0,1,74,73,64
176,seq157,r_91_140_163,r_184_186_39,r_91_140_163,1.0,1,164,163,64
124,r_342_37_68,seq129,seq52,r_342_37_68,1.0,1,69,68,64
73,r_21_22_35,r_104_53_143,r_287_265_103,r_104_53_143,1.0,0,143,143,64
23,r_271_192_199,r_289_82_94,r_353_138_32,r_353_138_32,0.98,2,34,32,64
1,r_42_13_181,seq225,r_72_267_20,r_42_13_181,0.99,1,182,181,64
96,r_135_1_72,seq39,r_308_77_65,r_135_1_72,0.99,0,72,72,64
70,r_216_182_137,seq93,r_360_145_45,r_216_182_137,1.0,0,137,137,64
36,r_15_88_109,seq70,seq109,r_15_88_109,1.0,0,109,109,64
44,r_90_305_143,r_115_106_163,seq230,r_90_305_143,1.0,0,143,143,64
114,r_25_207_150,seq341,r_211_67_138,r_25_207_150,1.0,3,153,150,64
49,r_297_57_34,r_160_244_3,r_111_127_199,r_297_57_34,0.99,0,34,34,64
66,r_65_49_79,seq48,seq170,r_65_49_79,1.0,2,81,79,64
40,r_141_2_190,seq73,r_38_257_106,r_141_2_190,0.83,0,190,190,64
9,r_20_373_73,r_337_41_161,r_18_272_62,r_20_373_73,1.0,0,73,73,64
110,r_218_307_110,seq52,seq5,r_218_307_110,1.0,1,111,110,64
95,r_333_320_126,r_111_127_199,r_149_374_8,r_333_320_126,0.77,1,127,126,64
16,r_79_332_36,r_136_117_160,seq291,r_136_117_160,0.89,-113,47,160,64
69,r_198_220_18,r_27_282_81,r_293_352_9,r_198_220_18,0.99,0,18,18,64
112,r_115_106_163,r_90_305_143,r_97_310_29,r_90_305_143,0.98,0,143,143,64
189,seq202,r_15_88_109,r_209_173_16,r_15_88_109,0.49,-65,44,109,64
97,r_309_153_186,seq286,r_356_322_168,r_309_153_186,0.74,0,186,186,64
18,r_328_76_150,seq187,r_15_88_109,r_328_76_150,1.0,0,150,150,64
106,r_68_17_12,r_131_16_16,seq316,r_68_17_12,1.0,0,12,12,64
58,r_224_233_53,r_238_270_105,seq245,r_224_233_53,1.0,0,53,53,64
31,r_27_282_81,seq48,seq175,r_27_282_81,1.0,2,83,81,64
67,r_318_260_71,r_87_314_188,seq295,r_318_260_71,1.0,0,71,71,64
19,r_183_255_179,seq78,seq55,r_183_255_179,1.0,0,179,179,64
247,seq364,r_369_165_187,r_180_290_104,r_369_165_187,1.0,0,187,187,64
221,seq291,r_51_228_174,r_79_332_36,r_51_228_174,1.0,-59,115,174,64
112,r_115_106_163,r_97_310_29,seq34,r_115_106_163,0.91,0,163,163,64
28,r_66_62_39,r_18_272_62,r_131_16_16,r_66_62_39,0.46,1,40,39,64
83,r_296_269_48,r_254_161_130,r_160_244_3,r_254_161_130,1.0,-81,49,130,64
85,r_289_82_94,r_271_192_199,seq133,r_289_82_94,0.51,7,101,94,64
14,r_91_140_163,seq157,r_251_64_42,r_91_140_163,0.87,1,164,163,64
7,r_219_142_71,seq112,seq349,r_219_142_71,1.0,0,71,71,64
81,r_308_77_65,r_218_307_110,seq93,r_308_77_65,1.0,0,65,65,64
213,seq252,seq239,r_169_61_107,r_169_61_107,1.0,2,109,107,64
87,r_125_162_95,r_121_116_181,seq345,r_125_162_95,1.0,0,95,95,64
13,r_284_248_107,r_121_116_181,seq122,r_284_248_107,0.95,0,107,107,64
111,r_163_258_160,r_337_41_161,r_30_32_158,r_163_258_160,1.0,0,160,160,64
4,r_38_257_106,r_321_156_188,r_43_119_25,r_38_257_106,1.0,-1,105,106,64
103,r_137_336_48,seq46,seq350,r_137_336_48,1.0,0,48,48,64
92,r_143_59_25,r_297_57_34,seq58,r_143_59_25,0.83,1,26,25,64
107,r_36_323_66,seq316,seq330,r_36_323_66,1.0,0,66,66,64
21,r_363_201_37,r_328_76_150,seq286,r_363_201_37,1.0,0,37,37,64
104,r_253_276_9,r_216_182_137,r_268_351_151,r_216_182_137,1.0,0,137,137,64
123,r_251_64_42,seq109,seq98,r_251_64_42,1.0,0,42,42,64
118,r_263_273_35,r_371_306_183,seq242,r_263_273_35,0.87,1,36,35,64
105,r_358_236_127,seq206,seq133,r_358_236_127,1.0,0,127,127,64
33,r_254_161_130,seq95,seq239,r_254_161_130,1.0,0,130,130,64
24,r_43_119_25,r_27_282_81,r_293_352_9,r_43_119_25,1.0,0,25,25,64
77,r_45_355_127,seq89,seq304,r_45_355_127,1.0,0,127,127,64
159,seq95,r_254_161_130,r_18_272_62,r_254_161_130,0.92,1,131,130,64
51,r_235_152_94,r_147_60_126,r_360_145_45,r_235_152_94,1.0,0,94,94,64
74,r_6_85_179,seq158,r_184_186_39,r_6_85_179,1.0,0,179,179,64
5,r_18_272_62,r_241_367_178,r_296_269_48,r_18_272_62,1.0,0,62,62,64
68,r_104_53_143,r_21_22_35,r_174_11_13,r_104_53_143,1.0,0,143,143,64
73,r_21_22_35,r_99_259_122,r_104_53_143,r_21_22_35,0.95,4,39,35,64
75,r_123_113_190,seq108,r_196_215_19,r_123_113_190,0.98,0,190,190,64
144,seq58,seq237,r_143_59_25,r_143_59_25,0.82,53,78,25,64
46,r_232_256_157,seq286,r_340_81_21,r_232_256_157,1.0,0,157,157,64
63,r_238_270_105,seq194,seq292,r_238_270_105,0.95,1,106,105,64
27,r_283_69_22,r_167_124_193,seq364,r_283_69_22,1.0,0,22,22,64
68,r_104_53_143,seq14,r_21_22_35,r_21_22_35,0.98,19,54,35,64
22,r_315_118_105,seq154,seq52,r_315_118_105,0.9,16,121,105,64
164,seq109,r_30_32_158,r_15_88_109,r_15_88_109,1.0,0,109,109,64
17,r_131_16_16,r_43_119_25,r_66_62_39,r_131_16_16,0.9,0,16,16,64
109,r_136_117_160,seq230,r_169_61_107,r_136_117_160,1.0,0,160,160,64
131,seq19,seq349,r_144_266_9,r_144_266_9,0.97,26,35,9,64
88,r_174_11_13,r_79_332_36,seq204,r_174_11_13,0.98,0,13,13,64
135,seq34,seq86,r_115_106_163,r_115_106_163,1.0,-2,161,163,64
101,r_299_164_35,r_371_306_183,r_353_138_32,r_299_164_35,0.97,0,35,35,64
225,seq302,r_288_200_105,r_149_374_8,r_288_200_105,1.0,0,105,105,64
115,r_211_67_138,r_91_140_163,seq44,r_211_67_138,1.0,0,138,138,64
72,r_361_277_50,r_65_49_79,seq206,r_361_277_50,1.0,0,50,50,64
84,r_99_259_122,seq329,seq311,r_99_259_122,1.0,0,122,122,64
117,r_357_101_125,seq325,r_209_173_16,r_357_101_125,1.0,1,126,125,64
89,r_234_56_55,r_65_49_79,seq112,r_234_56_55,1.0,1,56,55,64
41,r_209_173_16,r_18_272_62,seq202,r_209_173_16,0.99,0,16,16,64
35,r_353_138_32,r_42_13_181,r_271_192_199,r_353_138_32,1.0,0,32,32,64
154,seq86,r_134_155_148,r_196_215_19,r_196_215_19,0.85,17,36,19,64
64,r_51_228_174,seq291,r_47_331_73,r_47_331_73,0.98,42,115,73,64
54,r_103_114_185,seq133,r_131_16_16,r_103_114_185,1.0,0,185,185,64
65,r_231_168_13,r_300_197_92,seq112,r_231_168_13,1.0,0,13,13,64
10,r_72_267_20,r_15_88_109,seq230,r_15_88_109,0.86,-82,27,109,64
55,r_172_280_112,r_319_212_144,r_148_132_34,r_148_132_34,0.92,0,34,34,64
20,r_180_290_104,seq295,seq364,r_180_290_104,0.98,0,104,104,64
15,r_148_132_34,r_172_280_112,r_324_74_43,r_324_74_43,0.62,71,114,43,64
120,r_190_35_152,seq48,r_72_267_20,r_190_35_152,1.0,1,153,152,64
4,r_12_199_98,seq172,seq106,r_12_199_98,1.0,0,98,98,65
91,r_233_263_125,r_339_141_135,r_108_87_17,r_233_263_125,1.0,2,127,125,65
20,r_81_353_194,r_309_57_127,r_22_274_186,r_309_57_127,1.0,2,129,127,65
64,r_41_343_28,seq154,seq132,r_41_343_28,0.79,1,29,28,65
45,r_231_138_84,seq172,r_147_40_17,r_231_138_84,0.99,0,84,84,65
29,r_113_110_87,r_48_145_141,seq52,r_113_110_87,1.0,1,88,87,65
224,seq286,r_366_122_177,r_297_237_154,r_297_237_154,1.0,4,158,154,65
57,r_202_264_165,seq187,r_50_236_161,r_202_264_165,1.0,0,165,165,65
40,r_167_247_161,seq55,r_210_38_87,r_167_247_161,0.97,13,174,161,65
61,r_224_158_125,r_285_194_131,r_104_287_121,r_104_287_121,0.56,4,125,121,65
66,r_195_303_109,seq80,r_322_53_109,r_195_303_109,1.0,0,109,109,65
118,r_117_6_14,r_200_133_187,seq80,r_117_6_14,0.81,-2,12,14,65
69,r_103_278_132,r_299_326_138,r_100_363_105,r_103_278_132,1.0,0,132,132,65
99,r_85_165_163,r_299_326_138,seq172,r_85_165_163,1.0,0,163,163,65
218,seq261,seq358,r_190_135_84,r_190_135_84,1.0,6,90,84,65
76,r_334_269_21,r_12_199_98,r_277_3_12,r_334_269_21,0.46,0,21,21,65
6,r_186_91_141,seq348,r_317_232_70,r_186_91_141,1.0,0,141,141,65
31,r_238_248_25,r_107_228_174,seq8,r_107_228_174,0.62,-132,42,174,65
12,r_210_38_87,r_293_88_103,seq291,r_210_38_87,1.0,-1,86,87,65
53,r_116_163_63,seq36,seq10,r_116_163_63,1.0,0,63,63,65
74,r_150_372_91,seq105,seq127,r_150_372_91,1.0,2,93,91,65
89,r_255_205_39,r_365_166_82,seq250,r_255_205_39,1.0,0,39,39,65
23,r_175_254_36,seq213,seq275,r_175_254_36,0.93,13,49,36,65
189,seq197,r_169_306_70,seq291,r_169_306_70,0.9,17,87,70,65
5,r_107_228_174,r_299_326_138,r_104_287_121,r_107_228_174,1.0,0,174,174,65
105,r_280_188_114,seq106,r_321_350_198,r_280_188_114,1.0,0,114,114,65
77,r_146_279_58,r_317_232_70,seq36,r_317_232_70,0.88,-6,64,70,65
19,r_179_4_182,r_119_142_56,r_200_133_187,r_119_142_56,0.8,18,74,56,65
157,seq80,r_195_303_109,r_117_6_14,r_195_303_109,1.0,0,109,109,65
7,r_42_30_51,r_107_228_174,seq275,r_42_30_51,1.0,0,51,51,65
14,r_97_99_166,seq348,r_86_361_114,r_97_99_166,1.0,0,166,166,65
109,r_183_65_38,r_169_306_70,r_108_87_17,r_183_65_38,1.0,1,39,38,65
17,r_304_258_60,r_12_199_98,r_118_340_30,r_304_258_60,0.79,3,63,60,65
68,r_240_74_41,seq8,r_301_196_20,r_301_196_20,0.61,22,42,20,65
27,r_212_160_35,seq16,seq77,r_212_160_35,1.0,0,35,35,65
75,r_335_11_174,r_200_133_187,r_174_344_167,r_335_11_174,1.0,1,175,174,65
30,r_147_40_17,r_341_152_76,seq0,r_147_40_17,0.97,2,19,17,65
47,r_86_361_114,r_101_72_183,r_322_53_109,r_86_361_114,1.0,2,116,114,65
101,r_207_284_107,r_292_289_42,r_41_343_28,r_207_284_107,1.0,1,108,107,65
85,r_174_344_167,r_51_76_10,r_134_129_194,r_174_344_167,1.0,0,167,167,65
8,r_104_287_121,seq275,r_67_23_116,r_104_287_121,1.0,0,121,121,65
94,r_98_9_165,seq25,seq229,r_98_9_165,1.0,0,165,165,65
55,r_140_316_89,seq208,seq26,r_140_316_89,1.0,2,91,89,65
49,r_50_236_161,seq36,seq239,r_50_236_161,1.0,1,162,161,65
103,r_48_145_141,r_327_32_181,r_352_219_26,r_48_145_141,1.0,0,141,141,65
121,r_355_143_23,r_276_181_42,r_346_305_6,r_355_143_23,1.0,1,24,23,65
22,r_371_337_180,r_327_32_181,r_192_2_165,r_371_337_180,1.0,0,180,180,65
116,r_352_219_26,r_78_320_122,seq14,r_352_219_26,1.0,0,26,26,65
96,r_176_68_114,seq55,seq154,r_176_68_114,1.0,0,114,114,65
110,r_123_185_111,seq164,seq56,r_123_185_111,1.0,0,111,111,65
19,r_179_4_182,r_200_133_187,r_352_219_26,r_179_4_182,0.97,0,182,182,65
117,r_211_323_121,seq148,seq226,r_211_323_121,1.0,0,121,121,65
16,r_155_35_111,seq16,seq92,r_155_35_111,0.78,3,114,111,65
33,r_342_234_128,r_159_360_195,seq90,r_342_234_128,0.58,22,150,128,65
220,seq266,seq128,r_41_343_28,r_41_343_28,0.67,72,100,28,65
65,r_108_87_17,seq286,seq191,r_108_87_17,0.98,0,17,17,65
184,seq172,seq120,r_85_165_163,r_85_165_163,0.99,3,166,163,65
119,r_223_125_134,r_174_344_167,seq64,r_223_125_134,0.99,0,134,134,65
80,r_47_201_43,r_336_249_53,r_332_230_23,r_47_201_43,1.0,0,43,43,65
122,r_298_330_150,seq273,r_62_182_69,r_298_330_150,1.0,3,153,150,65
97,r_192_2_165,r_174_344_167,r_108_87_17,r_192_2_165,1.0,0,165,165,65
92,r_310_153_33,seq14,seq80,r_310_153_33,1.0,1,34,33,65
78,r_44_19_46,seq112,seq214,r_44_19_46,1.0,0,46,46,65
159,seq92,r_238_248_25,r_155_35_111,r_155_35_111,0.56,-2,109,111,65
224,seq286,r_108_87_17,r_366_122_177,r_108_87_17,1.0,0,17,17,65
113,r_312_282_28,r_277_3_12,r_108_87_17,r_312_282_28,1.0,1,29,28,65
72,r_276_181_42,r_93_302_153,r_332_230_23,r_276_181_42,0.64,0,42,42,65
81,r_309_57_127,r_81_353_194,r_62_182_69,r_309_57_127,1.0,2,129,127,65
83,r_285_194_131,r_93_302_153,r_13_272_59,r_285_194_131,1.0,0,131,131,65
1,r_365_166_82,r_202_264_165,r_336_249_53,r_365_166_82,1.0,1,83,82,65
38,r_82_246_29,r_310_153_33,seq273,r_82_246_29,1.0,1,30,29,65
62,r_58_29_115,r_211_323_121,seq33,r_58_29_115,1.0,1,116,115,65
88,r_328_177_52,seq137,seq10,r_328_177_52,0.78,2,54,52,65
54,r_293_88_103,seq79,seq1,r_293_88_103,1.0,0,103,103,65
102,r_251_357_140,seq73,r_104_287_121,r_251_357_140,1.0,0,140,140,65
46,r_329_313_129,seq8,seq239,r_329_313_129,1.0,0,129,129,65
114,r_39_290_74,r_231_138_84,r_299_326_138,r_39_290_74,1.0,0,74,74,65
227,seq294,seq8,r_78_320_122,r_78_320_122,1.0,34,156,122,65
124,r_7_364_133,r_193_308_121,r_240_74_41,r_7_364_133,1.0,0,133,133,65
70,r_222_144_81,r_60_262_144,r_94_271_69,r_222_144_81,0.72,0,81,81,65
58,r_67_23_116,seq126,r_51_76_10,r_67_23_116,1.0,0,116,116,65
28,r_118_340_30,seq10,r_82_246_29,r_118_340_30,1.0,0,30,30,65
44,r_301_196_20,r_12_199_98,r_299_326_138,r_301_196_20,0.49,0,20,20,65
98,r_339_141_135,seq127,r_100_363_105,r_339_141_135,1.0,2,137,135,65
39,r_13_272_59,r_193_308_121,seq314,r_13_272_59,1.0,0,59,59,65
228,seq295,r_155_35_111,r_332_230_23,r_332_230_23,1.0,8,31,23,65
15,r_31_267_114,r_97_99_166,r_259_307_31,r_31_267_114,1.0,0,114,114,65
56,r_22_274_186,r_81_353_194,r_31_267_114,r_31_267_114,0.57,72,186,114,65
11,r_94_271_69,r_277_3_12,seq347,r_94_271_69,1.0,0,69,69,65
36,r_60_262_144,r_222_144_81,r_355_143_23,r_222_144_81,0.85,0,81,81,65
108,r_259_307_31,seq18,seq154,r_259_307_31,0.74,7,38,31,65
25,r_115_89_125,seq172,seq164,r_115_89_125,1.0,0,125,125,65
26,r_178_71_120,r_104_287_121,seq164,r_178_71_120,0.73,0,120,120,65
42,r_319_157_120,r_315_162_103,r_62_182_69,r_319_157_120,1.0,0,120,120,65
95,r_346_305_6,r_180_59_7,r_355_143_23,r_355_143_23,1.0,43,66,23,65
35,r_100_363_105,seq215,r_354_374_5,r_100_363_105,1.0,0,105,105,65
67,r_190_135_84,r_109_17_102,seq261,r_190_135_84,1.0,0,84,84,65
106,r_336_249_53,seq18,seq173,r_336_249_53,0.93,-2,51,53,65
3,r_227_359_111,r_251_357_140,r_328_177_52,r_251_357_140,1.0,-29,111,140,65
50,r_325_43_47,r_113_110_87,seq311,r_325_43_47,0.86,1,48,47,65
179,seq154,seq362,r_176_68_114,r_176_68_114,1.0,42,156,114,65
222,seq275,r_104_287_121,r_42_30_51,r_104_287_121,0.85,0,121,121,65
60,r_119_142_56,r_179_4_182,seq362,r_119_142_56,0.73,18,74,56,65
34,r_169_306_70,seq197,r_315_162_103,r_169_306_70,0.93,5,75,70,65
87,r_204_84_105,r_101_72_183,r_255_205_39,r_204_84_105,1.0,0,105,105,65
71,r_78_320_122,seq220,seq294,r_78_320_122,1.0,1,123,122,65
0,r_62_182_69,seq90,r_114_136_4,r_62_182_69,1.0,1,70,69,65
112,r_83_161_146,r_292_289_42,r_332_230_23,r_83_161_146,1.0,0,146,146,65
24,r_366_122_177,seq69,r_292_289_42,r_366_122_177,0.81,1,178,177,65
73,r_93_302_153,seq221,r_277_3_12,r_93_302_153,1.0,0,153,153,65
18,r_341_152_76,seq132,seq252,r_341_152_76,0.71,8,84,76,65
115,r_28_156_138,r_97_99_166,r_100_363_105,r_28_156_138,1.0,0,138,138,65
184,seq172,r_115_89_125,seq120,r_115_89_125,1.0,0,125,125,65
111,r_315_162_103,r_319_157_120,r_169_306_70,r_319_157_120,1.0,-12,108,120,65
107,r_297_237_154,r_327_32_181,seq286,r_297_237_154,1.0,1,155,154,65
36,r_60_262_144,r_355_143_23,seq52,r_60_262_144,1.0,0,144,144,65
104,r_322_53_109,r_299_326_138,seq213,r_322_53_109,1.0,0,109,109,65
43,r_317_232_70,seq173,seq266,r_317_232_70,1.0,0,70,70,65
139,seq33,seq252,r_58_29_115,r_58_29_115,1.0,19,134,115,65
48,r_243_49_171,seq21,r_118_340_30,r_243_49_171,1.0,1,172,171,65
106,r_336_249_53,seq173,r_365_166_82,r_365_166_82,0.65,21,103,82,65
59,r_101_72_183,seq56,r_147_40_17,r_101_72_183,1.0,0,183,183,65
64,r_186_69_31,seq109,r_322_137_30,r_186_69_31,1.0,1,32,31,66
21,r_304_191_180,r_144_65_102,r_112_135_15,r_304_191_180,0.6,-76,104,180,66
58,r_357_286_112,seq132,r_354_362_82,r_357_286_112,1.0,0,112,112,66
70,r_106_32_154,seq36,r_194_341_139,r_106_32_154,0.99,1,155,154,66
4,r_169_311_51,seq42,seq71,r_169_311_51,1.0,2,53,51,66
77,r_260_108_159,r_192_75_40,r_340_296_148,r_260_108_159,1.0,0,159,159,66
86,r_197_255_160,seq86,seq58,r_197_255_160,1.0,0,160,160,66
211,seq271,r_181_346_110,r_80_270_40,r_80_270_40,0.84,39,79,40,66
90,r_110_56_114,r_262_34_149,seq8,r_110_56_114,0.93,1,115,114,66
123,r_204_280_46,seq259,seq175,r_204_280_46,0.95,1,47,46,66
44,r_319_298_17,r_90_145_74,seq273,r_319_298_17,0.99,1,18,17,66
203,seq256,r_306_163_171,r_91_224_4,r_306_163_171,0.9,1,172,171,66
5,r_74_1_39,r_11_173_97,seq8,r_11_173_97,1.0,0,97,97,66
80,r_84_151_169,r_13_52_75,r_251_219_63,r_84_151_169,0.69,2,171,169,66
106,r_159_27_159,seq258,r_128_16_105,r_128_16_105,0.95,-1,104,105,66
114,r_13_52_75,r_84_151_169,r_99_324_102,r_84_151_169,0.5,3,172,169,66
68,r_234_141_74,r_354_362_82,seq215,r_234_141_74,1.0,0,74,74,66
106,r_159_27_159,r_128_16_105,r_340_296_148,r_159_27_159,1.0,0,159,159,66
83,r_11_173_97,r_74_1_39,r_155_77_40,r_11_173_97,1.0,0,97,97,66
31,r_205_216_125,r_197_255_160,r_263_275_108,r_205_216_125,0.88,-1,124,125,66
2,r_320_148_62,r_330_121_79,seq54,r_330_121_79,1.0,-15,64,79,66
17,r_55_310_55,r_262_34_149,seq103,r_55_310_55,0.66,14,69,55,66
1,r_239_315_87,r_254_339_118,r_179_67_86,r_239_315_87,0.99,1,88,87,66
48,r_37_302_60,r_262_34_149,seq150,r_37_302_60,0.7,4,64,60,66
66,r_154_337_89,r_159_27_159,r_30_44_70,r_154_337_89,1.0,0,89,89,66
120,r_257_166_106,seq48,r_200_230_4,r_257_166_106,0.97,0,106,106,66
205,seq259,seq221,r_343_366_55,r_343_366_55,1.0,19,74,55,66
69,r_144_65_102,r_304_191_180,seq314,r_144_65_102,0.75,2,104,102,66
7,r_254_339_118,r_225_299_126,r_78_46_98,r_254_339_118,1.0,0,118,118,66
105,r_199_118_93,r_192_75_40,seq2,r_199_118_93,1.0,0,93,93,66
74,r_128_16_105,r_159_27_159,r_262_34_149,r_128_16_105,0.88,54,159,105,66
46,r_28_51_98,seq326,seq18,r_28_51_98,1.0,0,98,98,66
80,r_84_151_169,seq18,r_13_52_75,r_13_52_75,0.99,0,75,75,66
110,r_6_72_145,seq26,r_161_120_129,r_6_72_145,0.92,2,147,145,66
104,r_161_120_129,seq172,seq214,r_161_120_129,1.0,-1,128,129,66
0,r_340_296_148,seq171,r_370_57_30,r_370_57_30,1.0,0,30,30,66
33,r_185_331_128,seq308,seq356,r_185_331_128,1.0,0,128,128,66
28,r_40_61_151,seq374,r_155_77_40,r_40_61_151,0.78,-38,113,151,66
101,r_123_352_145,r_24_344_189,seq369,r_123_352_145,1.0,1,146,145,66
117,r_370_57_30,r_161_120_129,r_340_296_148,r_370_57_30,0.99,0,30,30,66
31,r_205_216_125,r_368_295_92,r_197_255_160,r_368_295_92,0.6,2,94,92,66
35,r_45_126_53,r_343_366_55,r_327_107_32,r_45_126_53,0.9,0,53,53,66
32,r_155_77_40,r_28_51_98,seq201,r_155_77_40,0.85,1,41,40,66
8,r_322_137_30,r_169_311_51,r_186_69_31,r_186_69_31,0.6,-1,30,31,66
118,r_29_184_54,seq323,seq300,r_29_184_54,0.92,0,54,54,66
13,r_354_362_82,r_192_75_40,r_370_57_30,r_354_362_82,1.0,0,82,82,66
180,seq183,r_316_209_166,seq213,r_316_209_166,0.74,-74,92,166,66
112,r_325_101_131,r_139_178_187,seq48,r_325_101_131,0.86,3,134,131,66
97,r_3_170_158,seq58,r_225_299_126,r_3_170_158,0.96,1,159,158,66
89,r_269_33_61,r_354_362_82,seq363,r_354_362_82,1.0,-13,69,82,66
114,r_13_52_75,seq70,r_84_151_169,r_13_52_75,1.0,0,75,75,66
73,r_181_346_110,seq271,seq64,r_181_346_110,0.48,12,122,110,66
17,r_55_310_55,seq103,r_358_278_106,r_358_278_106,1.0,-3,103,106,66
45,r_78_46_98,r_307_246_196,r_254_339_118,r_254_339_118,0.79,21,139,118,66
15,r_225_299_126,seq2,r_179_67_86,r_225_299_126,1.0,1,127,126,66
138,seq48,r_146_127_30,r_325_101_131,r_325_101_131,0.51,-14,117,131,66
55,r_22_7_18,seq374,r_12_88_79,r_12_88_79,0.92,37,116,79,66
55,r_22_7_18,r_320_148_62,seq374,r_22_7_18,0.83,-6,12,18,66
22,r_368_295_92,r_205_216_125,r_155_77_40,r_368_295_92,0.75,2,94,92,66
79,r_152_153_92,r_200_230_4,r_250_47_135,r_152_153_92,1.0,0,92,92,66
80,r_84_151_169,r_149_220_38,seq18,r_149_220_38,0.85,5,43,38,66
45,r_78_46_98,r_128_16_105,r_307_246_196,r_128_16_105,1.0,-1,104,105,66
24,r_358_278_106,r_192_75_40,r_55_310_55,r_358_278_106,0.7,3,109,106,66
16,r_179_67_86,seq150,seq249,r_179_67_86,0.99,2,88,86,66
23,r_196_232_155,r_327_107_32,r_35_198_33,r_196_232_155,0.6,4,159,155,66
21,r_304_191_180,r_112_135_15,r_208_68_119,r_304_191_180,0.99,2,182,180,66
39,r_39_143_179,seq308,seq122,r_39_143_179,1.0,0,179,179,66
72,r_330_121_79,seq365,seq248,r_330_121_79,1.0,0,79,79,66
37,r_223_20_149,seq150,r_269_33_61,r_223_20_149,0.97,6,155,149,66
54,r_281_63_155,r_39_143_179,seq180,r_281_63_155,1.0,0,155,155,66
49,r_231_160_94,seq54,seq109,r_231_160_94,1.0,0,94,94,66
92,r_285_105_102,seq329,r_239_315_87,r_285_105_102,1.0,0,102,102,66
18,r_371_367_108,seq363,r_335_297_40,r_371_367_108,0.93,-7,101,108,66
138,seq48,r_257_166_106,r_146_127_30,r_257_166_106,0.73,-14,92,106,66
47,r_23_189_186,seq4,r_225_299_126,r_23_189_186,0.98,1,187,186,66
14,r_208_68_119,r_250_47_135,r_119_131_70,r_208_68_119,1.0,0,119,119,66
77,r_260_108_159,r_263_275_108,r_192_75_40,r_263_275_108,1.0,0,108,108,66
56,r_288_100_185,seq256,r_22_7_18,r_288_100_185,0.41,0,185,185,66
117,r_370_57_30,r_340_296_148,r_354_362_82,r_370_57_30,0.9,118,148,30,66
124,r_94_168_82,r_28_51_98,seq287,r_94_168_82,1.0,0,82,82,66
75,r_202_210_63,r_358_278_106,r_17_117_4,r_202_210_63,1.0,5,68,63,66
63,r_24_344_189,seq213,r_319_298_17,r_24_344_189,1.0,1,190,189,66
38,r_90_145_74,r_78_46_98,seq103,r_90_145_74,1.0,0,74,74,66
106,r_159_27_159,r_154_337_89,seq258,r_154_337_89,0.95,0,89,89,66
94,r_119_131_70,r_154_337_89,r_345_241_7,r_119_131_70,1.0,1,71,70,66
71,r_268_115_190,seq364,r_294_342_5,r_268_115_190,1.0,0,190,190,66
52,r_306_163_171,seq256,r_169_311_51,r_306_163_171,0.97,1,172,171,66
137,seq42,seq215,r_59_303_38,r_59_303_38,1.0,23,61,38,66
116,r_89_227_138,r_276_53_161,seq318,r_89_227_138,1.0,0,138,138,66
158,seq103,r_197_255_160,r_245_10_104,r_245_10_104,0.79,-5,99,104,66
119,r_59_303_38,seq336,seq42,r_59_303_38,1.0,0,38,38,66
10,r_335_297_40,r_199_118_93,seq355,r_199_118_93,0.59,-51,42,93,66
95,r_138_76_36,seq19,r_22_7_18,r_138_76_36,0.85,17,53,36,66
12,r_99_324_102,seq8,seq203,r_99_324_102,1.0,2,104,102,66
51,r_251_219_63,r_90_145_74,r_133_238_15,r_251_219_63,1.0,5,68,63,66
40,r_243_38_161,seq50,r_96_274_6,r_243_38_161,1.0,3,164,161,66
111,r_129_333_148,seq150,r_161_120_129,r_129_333_148,0.96,7,155,148,66
59,r_102_134_58,r_106_32_154,r_60_321_27,r_102_134_58,0.74,-1,57,58,66
93,r_289_147_42,r_45_126_53,r_113_21_28,r_289_147_42,1.0,1,43,42,66
11,r_218_284_50,seq0,seq180,r_218_284_50,1.0,3,53,50,66
158,seq103,r_343_366_55,r_197_255_160,r_343_366_55,0.87,3,58,55,66
87,r_12_88_79,r_78_46_98,r_22_7_18,r_12_88_79,1.0,0,79,79,66
99,r_15_162_120,r_222_313_140,seq329,r_15_162_120,1.0,0,120,120,66
1,r_239_315_87,r_179_67_86,r_285_105_102,r_285_105_102,0.86,4,106,102,66
178,seq175,r_146_127_30,r_204_280_46,r_204_280_46,0.86,-6,40,46,66
19,r_35_198_33,r_316_209_166,seq252,r_35_198_33,0.75,0,33,33,66
107,r_343_366_55,seq103,seq259,r_343_366_55,0.99,3,58,55,66
42,r_338_188_156,r_316_209_166,r_146_127_30,r_316_209_166,0.74,-7,159,166,66
65,r_149_220_38,r_13_52_75,r_345_241_7,r_13_52_75,0.98,0,75,75,66
88,r_156_25_47,seq124,seq252,r_156_25_47,0.97,0,47,47,66
187,seq213,r_24_344_189,r_225_299_126,r_24_344_189,0.74,1,190,189,66
83,r_11_173_97,r_99_324_102,r_74_1_39,r_74_1_39,1.0,0,39,39,66
9,r_262_34_149,seq356,r_128_16_105,r_262_34_149,0.99,3,152,149,66
26,r_194_341_139,seq2,r_15_162_120,r_194_341_139,1.0,1,140,139,66
85,r_245_10_104,seq157,seq103,r_245_10_104,1.0,1,105,104,66
115,r_113_21_28,r_92_236_67,seq4,r_92_236_67,0.97,-38,29,67,66
230,seq326,r_28_51_98,seq109,r_28_51_98,1.0,0,98,98,66
216,seq287,seq5,r_94_168_82,r_94_168_82,1.0,15,97,82,66
81,r_222_313_140,r_15_162_120,r_155_77_40,r_15_162_120,0.97,0,120,120,66
60,r_92_236_67,seq73,seq2,r_92_236_67,1.0,1,68,67,66
74,r_128_16_105,r_78_46_98,r_159_27_159,r_128_16_105,1.0,0,105,105,66
29,r_80_270_40,r_245_10_104,seq271,r_80_270_40,1.0,0,40,40,66
103,r_263_275_108,r_260_108_159,seq93,r_263_275_108,0.78,0,108,108,66
132,seq18,seq124,r_28_51_98,r_28_51_98,0.99,0,98,98,66
43,r_30_44_70,r_99_324_102,seq14,r_30_44_70,1.0,0,70,70,66
65,r_149_220_38,r_84_151_169,r_13_52_75,r_149_220_38,0.98,-3,35,38,66
34,r_200_230_4,r_316_209_166,r_257_166_106,r_200_230_4,0.99,116,120,4,66
0,r_340_296_148,r_370_57_30,r_205_216_125,r_340_296_148,0.82,0,148,148,66
108,r_276_53_161,r_328_182_196,r_345_241_7,r_276_53_161,1.0,2,163,161,66
5,r_74_1_39,r_80_270_40,r_11_173_97,r_74_1_39,0.82,0,39,39,66
57,r_30_79_141,r_193_93_153,seq53,r_30_79_141,1.0,0,141,141,67
33,r_162_152_184,r_50_10_73,r_145_219_117,r_162_152_184,0.99,0,184,184,67
41,r_246_39_181,seq317,r_329_156_53,r_246_39_181,0.98,0,181,181,67
192,seq201,r_145_219_117,seq313,r_145_219_117,1.0,0,117,117,67
54,r_230_151_50,r_134_71_145,seq60,r_230_151_50,0.95,0,50,50,67
68,r_321_67_129,seq43,r_7_304_103,r_7_304_103,0.89,33,136,103,67
117,r_2_259_172,seq129,seq261,r_2_259_172,1.0,0,172,172,67
11,r_114_0_177,r_75_227_75,seq233,r_75_227_75,1.0,1,76,75,67
52,r_237_212_153,r_280_308_155,r_168_239_49,r_168_239_49,1.0,104,153,49,67
33,r_162_152_184,r_157_3_100,r_50_10_73,r_162_152_184,0.68,-55,129,184,67
77,r_358_366_106,r_221_180_148,r_262_55_48,r_221_180_148,1.0,-42,106,148,67
30,r_258_341_65,r_236_28_93,seq42,r_258_341_65,1.0,0,65,65,67
60,r_335_343_49,r_283_170_184,seq95,r_335_343_49,1.0,0,49,49,67
90,r_367_306_164,seq293,r_45_73_42,r_367_306_164,1.0,0,164,164,67
65,r_134_71_145,r_316_278_186,seq187,r_134_71_145,0.78,0,145,145,67
98,r_186_190_88,r_333_209_159,r_72_54_62,r_186_190_88,1.0,0,88,88,67
5,r_88_205_119,r_176_191_152,r_253_143_11,r_88_205_119,1.0,0,119,119,67
106,r_96_35_186,r_160_250_186,r_23_301_109,r_96_35_186,1.0,0,186,186,67
26,r_351_97_184,r_24_16_11,r_101_315_125,r_351_97_184,0.99,0,184,184,67
55,r_229_218_169,seq169,r_56_167_172,r_229_218_169,1.0,0,169,169,67
21,r_286_49_31,r_256_305_123,seq368,r_286_49_31,1.0,0,31,31,67
17,r_326_65_186,seq200,seq17,r_326_65_186,1.0,-1,185,186,67
120,r_72_54_62,seq92,seq169,r_72_54_62,1.0,0,62,62,67
28,r_344_217_146,seq20,seq46,r_344_217_146,1.0,0,146,146,67
93,r_370_265_26,r_355_320_52,seq198,r_370_265_26,0.69,0,26,26,67
113,r_252_29_58,seq121,seq241,r_252_29_58,0.98,8,66,58,67
122,r_160_250_186,seq158,r_127_365_187,r_160_250_186,1.0,1,187,186,67
12,r_48_348_120,seq11,r_255_336_198,r_48_348_120,1.0,0,120,120,67
123,r_253_143_11,seq144,r_88_205_119,r_88_205_119,1.0,19,138,119,67
70,r_232_269_53,r_257_139_126,seq231,r_232_269_53,1.0,0,53,53,67
161,seq118,r_161_307_185,r_125_330_50,r_161_307_185,1.0,0,185,185,67
95,r_234_296_64,r_333_209_159,r_230_151_50,r_234_296_64,0.98,1,65,64,67
31,r_130_41_44,seq270,seq215,r_130_41_44,1.0,0,44,44,67
64,r_238_287_152,seq4,seq116,r_238_287_152,0.9,0,152,152,67
99,r_117_266_40,r_327_328_43,r_303_274_25,r_117_266_40,0.89,0,40,40,67
37,r_288_364_108,seq211,seq215,r_288_364_108,0.89,10,118,108,67
75,r_64_279_97,r_33_226_174,r_159_150_112,r_33_226_174,0.95,-4,170,174,67
101,r_23_301_109,r_267_309_168,seq43,r_267_309_168,0.98,-50,118,168,67
14,r_213_243_150,r_290_271_15,r_255_336_198,r_213_243_150,1.0,0,150,150,67
137,seq31,r_314_203_156,r_164_179_86,r_314_203_156,0.8,-52,104,156,67
118,r_314_203_156,seq90,r_355_320_52,r_314_203_156,1.0,0,156,156,67
73,r_147_324_141,r_221_180_148,r_125_330_50,r_147_324_141,0.96,0,141,141,67
232,seq311,r_291_202_134,r_75_227_75,r_75_227_75,0.57,30,105,75,67
87,r_329_156_53,r_174_25_126,seq158,r_329_156_53,1.0,0,53,53,67
4,r_161_307_185,seq118,seq201,r_161_307_185,0.99,0,185,185,67
184,seq184,seq149,r_319_89_70,r_319_89_70,0.73,27,97,70,67
25,r_300_332_43,r_327_328_43,seq119,r_327_328_43,0.99,2,45,43,67
74,r_24_16_11,seq196,r_351_97_184,r_24_16_11,0.94,-1,10,11,67
81,r_7_304_103,seq95,r_370_265_26,r_7_304_103,1.0,0,103,103,67
96,r_319_89_70,r_213_243_150,seq184,r_213_243_150,0.78,-74,76,150,67
80,r_267_309_168,r_162_152_184,r_59_57_96,r_267_309_168,0.96,0,168,168,67
246,seq368,r_56_167_172,r_286_49_31,r_286_49_31,1.0,24,55,31,67
29,r_174_25_126,seq264,seq184,r_174_25_126,0.98,2,128,126,67
69,r_155_273_88,seq173,r_302_331_59,r_155_273_88,1.0,0,88,88,67
34,r_108_63_30,seq132,r_162_152_184,r_108_63_30,1.0,0,30,30,67
45,r_194_112_114,r_344_217_146,r_288_364_108,r_194_112_114,0.99,0,114,114,67
75,r_64_279_97,r_157_3_100,r_33_226_174,r_64_279_97,0.64,35,132,97,67
86,r_100_189_95,r_160_250_186,seq84,r_160_250_186,0.95,-78,108,186,67
103,r_52_37_40,r_134_71_145,seq53,r_52_37_40,0.93,6,46,40,67
51,r_127_365_187,seq20,r_318_356_72,r_127_365_187,0.95,0,187,187,67
225,seq293,r_367_306_164,r_236_28_93,r_367_306_164,1.0,0,164,164,67
6,r_350_62_56,r_321_67_129,r_302_331_59,r_302_331_59,1.0,7,66,59,67
104,r_83_372_51,r_325_34_165,seq322,r_83_372_51,1.0,0,51,51,67
74,r_24_16_11,r_351_97_184,r_78_99_34,r_351_97_184,1.0,0,184,184,67
9,r_302_331_59,r_326_65_186,r_350_62_56,r_302_331_59,1.0,0,59,59,67
123,r_253_143_11,r_145_219_117,seq144,r_253_143_11,0.87,1,12,11,67
124,r_120_363_79,r_344_217_146,seq235,r_120_363_79,1.0,0,79,79,67
78,r_6_109_111,r_325_34_165,seq69,r_6_109_111,1.0,0,111,111,67
42,r_236_28_93,seq188,seq293,r_236_28_93,0.83,1,94,93,67
119,r_282_349_145,seq81,seq214,r_282_349_145,1.0,0,145,145,67
115,r_192_136_76,seq14,r_140_105_70,r_192_136_76,1.0,0,76,76,67
94,r_333_209_159,seq233,r_318_356_72,r_333_209_159,1.0,1,160,159,67
85,r_240_359_126,r_160_250_186,seq225,r_240_359_126,1.0,0,126,126,67
92,r_164_179_86,r_221_180_148,seq31,r_221_180_148,0.88,-47,101,148,67
107,r_107_98_105,r_255_336_198,r_262_55_48,r_107_98_105,1.0,0,105,105,67
13,r_195_86_135,seq313,r_72_54_62,r_195_86_135,1.0,0,135,135,67
0,r_101_315_125,r_221_180_148,r_208_85_53,r_101_315_125,1.0,0,125,125,67
84,r_371_40_16,r_325_34_165,r_221_180_148,r_371_40_16,0.96,5,21,16,67
84,r_371_40_16,r_221_180_148,r_303_274_25,r_221_180_148,1.0,-1,147,148,67
40,r_137_183_26,seq141,r_74_133_15,r_137_183_26,1.0,0,26,26,67
50,r_357_111_25,r_360_185_116,seq69,r_357_111_25,1.0,1,26,25,67
114,r_208_85_53,r_174_25_126,r_283_170_184,r_208_85_53,0.91,8,61,53,67
36,r_262_55_48,r_232_269_53,seq225,r_232_269_53,1.0,-1,52,53,67
110,r_291_202_134,seq292,r_258_341_65,r_291_202_134,0.66,3,137,134,67
46,r_59_57_96,seq163,r_335_343_49,r_59_57_96,1.0,0,96,96,67
196,seq211,r_288_364_108,r_302_331_59,r_302_331_59,0.85,59,118,59,67
27,r_168_239_49,r_176_191_152,seq163,r_168_239_49,1.0,0,49,49,67
121,r_12_51_53,r_134_71_145,seq95,r_12_51_53,1.0,0,53,53,67
24,r_303_274_25,r_221_180_148,r_371_40_16,r_221_180_148,1.0,-1,147,148,67
22,r_33_226_174,seq53,r_230_151_50,r_33_226_174,1.0,0,174,174,67
224,seq292,r_291_202_134,seq242,r_291_202_134,0.93,3,137,134,67
8,r_159_150_112,seq342,r_288_364_108,r_159_150_112,1.0,0,112,112,67
89,r_216_76_21,r_176_191_152,r_193_93_153,r_216_76_21,1.0,0,21,21,67
72,r_312_138_82,r_91_68_72,seq8,r_312_138_82,1.0,3,85,82,67
71,r_355_320_52,seq46,r_175_361_9,r_355_320_52,0.93,1,53,52,67
108,r_327_328_43,seq184,r_24_16_11,r_327_328_43,0.91,0,43,43,67
89,r_216_76_21,r_193_93_153,r_59_57_96,r_216_76_21,0.83,126,147,21,67
24,r_303_274_25,r_78_99_34,r_221_180_148,r_303_274_25,1.0,0,25,25,67
62,r_166_115_73,r_56_167_172,seq132,r_166_115_73,1.0,0,73,73,67
49,r_280_308_155,seq200,seq268,r_280_308_155,0.99,0,155,155,67
179,seq169,r_229_218_169,seq106,r_229_218_169,1.0,-72,97,169,67
83,r_257_139_126,seq106,r_80_47_132,r_257_139_126,1.0,0,126,126,67
23,r_82_26_82,r_255_336_198,seq322,r_82_26_82,1.0,0,82,82,67
44,r_75_227_75,r_114_0_177,seq311,r_75_227_75,1.0,1,76,75,67
26,r_351_97_184,r_78_99_34,r_24_16_11,r_24_16_11,1.0,-1,10,11,67
34,r_108_63_30,r_162_152_184,r_56_167_172,r_162_152_184,1.0,0,184,184,67
43,r_193_93_153,seq182,seq81,r_193_93_153,0.99,0,153,153,67
56,r_338_5_129,r_283_170_184,r_45_73_42,r_338_5_129,0.84,2,131,129,67
7,r_272_245_100,seq223,r_74_133_15,r_272_245_100,1.0,0,100,100,67
109,r_91_68_72,r_312_138_82,seq60,r_312_138_82,0.93,-8,74,82,67
67,r_145_219_117,seq201,seq106,r_145_219_117,1.0,0,117,117,67
88,r_19_13_90,seq235,seq129,r_19_13_90,1.0,0,90,90,67
66,r_318_356_72,r_123_102_163,seq87,r_318_356_72,1.0,0,72,72,67
59,r_256_305_123,seq148,r_52_37_40,r_256_305_123,1.0,0,123,123,67
79,r_177_44_99,seq225,seq149,r_177_44_99,1.0,0,99,99,67
82,r_125_330_50,seq116,seq118,r_125_330_50,1.0,0,50,50,67
32,r_352_172_155,seq215,seq17,r_352_172_155,1.0,0,155,155,67
48,r_204_38_122,seq116,seq317,r_204_38_122,0.93,4,126,122,67
102,r_224_340_130,seq70,r_360_185_116,r_224_340_130,1.0,0,130,130,67
214,seq261,r_114_0_177,r_2_259_172,r_2_259_172,0.99,6,178,172,67
61,r_104_142_161,r_351_97_184,seq200,r_104_142_161,1.0,0,161,161,67
111,r_50_10_73,seq295,seq4,r_50_10_73,0.82,0,73,73,67
229,seq298,r_350_62_56,r_175_361_9,r_175_361_9,1.0,1,10,9,67
18,r_360_185_116,seq53,seq275,r_360_185_116,0.99,1,117,116,67
116,r_123_102_163,seq322,seq313,r_123_102_163,1.0,1,164,163,67
236,seq341,r_3_99_166,r_129_325_71,r_129_325_71,0.83,13,84,71,68
15,r_349_53_125,seq89,r_327_153_37,r_349_53_125,0.99,1,126,125,68
26,r_228_150_65,r_81_372_65,r_367_60_19,r_228_150_65,1.0,1,66,65,68
38,r_193_159_49,r_129_325_71,r_318_221_13,r_193_159_49,0.98,-11,38,49,68
6,r_321_184_184,seq304,seq166,r_321_184_184,0.94,0,184,184,68
51,r_67_361_159,seq54,r_73_72_65,r_67_361_159,1.0,0,159,159,68
78,r_293_141_124,seq220,seq42,r_293_141_124,1.0,1,125,124,68
121,r_298_187_141,seq89,r_48_226_35,r_298_187_141,1.0,0,141,141,68
29,r_61_224_179,r_364_332_89,r_45_135_45,r_61_224_179,1.0,0,179,179,68
30,r_6_4_38,r_88_156_57,r_68_371_6,r_6_4_38,1.0,0,38,38,68
107,r_218_66_31,r_95_76_185,r_8_363_38,r_218_66_31,0.68,34,65,31,68
110,r_33_246_42,r_342_172_81,seq207,r_33_246_42,1.0,5,47,42,68
9,r_49_186_183,r_227_41_81,r_291_236_164,r_227_41_81,0.55,103,184,81,68
29,r_61_224_179,seq169,r_364_332_89,r_364_332_89,0.91,41,130,89,68
178,seq169,seq160,r_142_346_13,r_142_346_13,0.95,36,49,13,68
107,r_218_66_31,r_61_224_179,r_95_76_185,r_218_66_31,0.96,1,32,31,68
93,r_155_2_35,r_227_41_81,seq320,r_155_2_35,0.87,1,36,35,68
108,r_109_16_106,seq148,seq374,r_109_16_106,1.0,0,106,106,68
9,r_49_186_183,r_337_281_173,r_227_41_81,r_337_281_173,1.0,1,174,173,68
64,r_73_72_65,r_164_287_183,seq92,r_73_72_65,1.0,0,65,65,68
62,r_116_197_21,r_23_264_129,seq250,r_116_197_21,0.94,0,21,21,68
94,r_295_247_3,r_198_289_109,seq92,r_198_289_109,1.0,0,109,109,68
96,r_306_323_103,seq285,r_368_107_161,r_306_323_103,0.98,4,107,103,68
2,r_132_11_135,r_190_308_142,seq359,r_190_308_142,0.98,2,144,142,68
39,r_317_105_103,seq158,r_348_21_96,r_317_105_103,1.0,0,103,103,68
31,r_278_63_74,seq188,r_208_97_5,r_278_63_74,0.93,0,74,74,68
40,r_8_363_38,r_19_131_129,r_218_66_31,r_8_363_38,0.88,0,38,38,68
100,r_219_34_12,r_228_150_65,seq249,r_219_34_12,0.99,0,12,12,68
109,r_261_373_21,r_180_111_94,seq96,r_261_373_21,0.82,0,21,21,68
103,r_340_268_123,r_291_236_164,r_283_77_66,r_340_268_123,0.93,3,126,123,68
79,r_369_350_15,seq32,seq70,r_369_350_15,0.97,1,16,15,68
123,r_119_152_156,seq260,seq83,r_119_152_156,1.0,4,160,156,68
85,r_103_171_120,r_327_153_37,seq58,r_103_171_120,0.93,2,122,120,68
80,r_7_288_113,seq166,r_369_350_15,r_7_288_113,0.92,1,114,113,68
3,r_108_112_29,r_164_287_183,seq161,r_108_112_29,0.98,1,30,29,68
47,r_95_76_185,seq265,r_73_72_65,r_73_72_65,1.0,51,116,65,68
34,r_190_308_142,r_132_11_135,r_180_111_94,r_190_308_142,0.92,2,144,142,68
61,r_69_178_149,seq70,r_317_105_103,r_317_105_103,0.59,46,149,103,68
96,r_306_323_103,r_368_107_161,r_155_2_35,r_368_107_161,1.0,-8,153,161,68
98,r_310_216_97,seq352,seq251,r_310_216_97,1.0,-1,96,97,68
55,r_154_14_106,seq58,seq143,r_154_14_106,1.0,0,106,106,68
46,r_212_231_51,seq315,seq134,r_212_231_51,0.96,1,52,51,68
85,r_103_171_120,r_10_253_60,r_327_153_37,r_327_153_37,0.52,7,44,37,68
68,r_202_213_47,r_132_11_135,r_272_242_29,r_132_11_135,0.54,-88,47,135,68
70,r_331_328_137,r_252_270_195,r_81_372_65,r_331_328_137,1.0,0,137,137,68
120,r_110_234_170,r_164_287_183,r_227_41_81,r_164_287_183,0.57,-5,178,183,68
25,r_147_222_95,r_64_114_190,seq36,r_147_222_95,1.0,2,97,95,68
222,seq304,r_321_184_184,r_193_159_49,r_321_184_184,0.96,1,185,184,68
14,r_337_281_173,r_49_186_183,seq12,r_337_281_173,0.97,1,174,173,68
33,r_0_257_124,seq305,seq335,r_0_257_124,1.0,1,125,124,68
132,seq28,r_274_39_101,r_318_221_13,r_318_221_13,0.68,-1,12,13,68
105,r_13_254_72,seq12,r_142_346_13,r_13_254_72,1.0,2,74,72,68
16,r_68_371_6,r_200_50_1,r_6_4_38,r_6_4_38,0.79,33,71,38,68
65,r_326_56_22,r_154_14_106,seq299,r_326_56_22,0.99,0,22,22,68
27,r_230_255_55,seq96,seq106,r_230_255_55,1.0,1,56,55,68
4,r_291_236_164,seq192,r_0_257_124,r_291_236_164,1.0,0,164,164,68
87,r_98_125_43,r_13_254_72,r_142_346_13,r_142_346_13,1.0,30,43,13,68
113,r_256_65_139,r_44_209_195,r_329_229_76,r_256_65_139,0.99,-2,137,139,68
76,r_327_153_37,r_317_105_103,r_103_171_120,r_327_153_37,0.96,0,37,37,68
97,r_26_263_110,seq161,seq15,r_26_263_110,0.99,2,112,110,68
10,r_64_114_190,r_147_222_95,r_86_238_37,r_147_222_95,0.87,2,97,95,68
36,r_122_87_24,r_317_105_103,seq250,r_122_87_24,0.9,1,25,24,68
12,r_138_146_83,r_293_141_124,seq322,r_138_146_83,1.0,2,85,83,68
246,seq359,r_1_144_104,r_108_112_29,r_1_144_104,0.88,2,106,104,68
101,r_129_325_71,r_208_97_5,r_258_165_7,r_129_325_71,1.0,0,71,71,68
92,r_195_37_41,r_138_146_83,seq130,r_195_37_41,0.96,0,41,41,68
177,seq166,r_7_288_113,seq352,r_7_288_113,1.0,1,114,113,68
111,r_3_99_166,seq104,seq314,r_3_99_166,1.0,0,166,166,68
83,r_185_84_32,seq57,r_133_174_47,r_133_174_47,0.99,2,49,47,68
20,r_274_39_101,seq28,r_212_231_51,r_274_39_101,1.0,1,102,101,68
122,r_203_51_133,seq75,seq121,r_203_51_133,0.54,-24,109,133,68
112,r_300_139_71,r_348_21_96,r_193_159_49,r_300_139_71,0.95,4,75,71,68
67,r_283_77_66,seq46,r_342_172_81,r_342_172_81,1.0,6,87,81,68
160,seq106,r_40_292_166,r_230_255_55,r_40_292_166,1.0,0,166,166,68
66,r_136_82_147,seq307,r_180_111_94,r_136_82_147,0.99,1,148,147,68
119,r_286_334_129,seq314,r_243_118_94,r_286_334_129,0.69,3,132,129,68
138,seq46,r_283_77_66,r_195_37_41,r_195_37_41,1.0,46,87,41,68
88,r_368_107_161,seq352,r_306_323_103,r_306_323_103,0.94,8,111,103,68
21,r_181_196_26,r_321_184_184,seq249,r_181_196_26,0.97,0,26,26,68
58,r_19_131_129,seq22,r_329_229_76,r_19_131_129,1.0,0,129,129,68
76,r_327_153_37,r_103_171_120,r_243_118_94,r_103_171_120,0.6,3,123,120,68
118,r_176_339_165,seq43,r_230_255_55,r_176_339_165,1.0,0,165,165,68
0,r_127_370_179,r_38_343_103,r_227_41_81,r_127_370_179,0.91,0,179,179,68
115,r_294_137_114,seq22,seq47,r_294_137_114,0.95,6,120,114,68
35,r_81_372_65,r_228_150_65,seq175,r_81_372_65,0.93,1,66,65,68
24,r_180_111_94,r_282_354_197,r_369_350_15,r_180_111_94,1.0,0,94,94,68
117,r_364_332_89,seq161,r_142_346_13,r_364_332_89,0.99,-1,88,89,68
81,r_167_344_50,r_349_53_125,r_252_270_195,r_167_344_50,1.0,0,50,50,68
11,r_214_233_169,seq309,r_154_14_106,r_214_233_169,0.99,1,170,169,68
95,r_366_115_140,seq163,seq31,r_366_115_140,1.0,0,140,140,68
91,r_319_191_161,seq299,r_88_156_57,r_319_191_161,0.85,4,165,161,68
32,r_10_253_60,r_294_137_114,seq96,r_10_253_60,1.0,0,60,60,68
7,r_329_229_76,seq36,r_326_56_22,r_329_229_76,1.0,2,78,76,68
22,r_133_174_47,r_19_131_129,r_185_84_32,r_133_174_47,1.0,1,48,47,68
41,r_86_238_37,r_133_174_47,seq78,r_86_238_37,0.95,2,39,37,68
1,r_164_287_183,seq249,r_180_111_94,r_164_287_183,0.99,0,183,183,68
176,seq163,r_366_115_140,seq12,r_366_115_140,1.0,0,140,140,68
88,r_368_107_161,r_306_323_103,r_230_255_55,r_368_107_161,1.0,0,161,161,68
104,r_189_266_157,seq269,seq20,r_189_266_157,1.0,0,157,157,68
106,r_248_9_188,seq161,r_291_236_164,r_248_9_188,0.93,1,189,188,68
45,r_318_221_13,r_291_236_164,seq28,r_318_221_13,0.93,-1,12,13,68
5,r_237_71_131,seq75,r_324_90_51,r_237_71_131,1.0,0,131,131,68
133,seq31,seq204,r_366_115_140,r_366_115_140,1.0,0,140,140,68
102,r_243_118_94,seq285,r_327_153_37,r_243_118_94,1.0,3,97,94,68
54,r_74_333_84,seq299,seq46,r_74_333_84,1.0,1,85,84,68
28,r_142_346_13,r_49_186_183,seq169,r_142_346_13,0.8,-1,12,13,68
77,r_101_30_48,r_88_156_57,r_326_56_22,r_101_30_48,1.0,0,48,48,68
52,r_168_59_150,seq143,r_283_77_66,r_168_59_150,1.0,1,151,150,68
48,r_44_209_195,r_256_65_139,seq160,r_256_65_139,0.52,-17,122,139,68
19,r_88_156_57,r_306_323_103,seq347,r_306_323_103,0.56,-36,67,103,68
23,r_117_157_48,r_3_99_166,seq356,r_117_157_48,1.0,0,48,48,68
43,r_23_264_129,seq170,r_208_97_5,r_23_264_129,1.0,0,129,129,68
69,r_342_172_81,seq303,r_283_77_66,r_342_172_81,1.0,0,81,81,68
90,r_324_90_51,r_278_63_74,seq330,r_324_90_51,0.7,2,53,51,68
89,r_198_289_109,r_295_247_3,r_155_2_35,r_198_289_109,1.0,1,110,109,68
229,seq314,r_286_334_129,r_279_215_141,r_279_215_141,0.88,1,142,141,68
17,r_252_270_195,r_331_328_137,r_167_344_50,r_252_270_195,0.47,-133,62,195,68
99,r_38_343_103,r_127_370_179,r_1_144_104,r_38_343_103,0.9,76,179,103,68
8,r_279_215_141,r_214_233_169,seq322,r_279_215_141,0.93,0,141,141,68
71,r_275_241_172,r_182_35_193,seq305,r_275_241_172,0.98,2,174,172,68
75,r_1_144_104,seq359,r_38_343_103,r_1_144_104,0.95,2,106,104,68
59,r_40_292_166,seq106,r_280_17_30,r_40_292_166,1.0,0,166,166,68
10,r_64_114_190,r_86_238_37,r_127_370_179,r_64_114_190,0.83,0,190,190,68
37,r_151_183_133,r_67_361_159,r_181_196_26,r_151_183_133,1.0,0,133,133,68
232,seq322,seq126,r_138_146_83,r_138_146_83,1.0,6,89,83,68
44,r_208_97_5,r_129_325_71,r_278_63_74,r_208_97_5,0.93,68,73,5,68
72,r_45_135_45,r_136_82_147,seq345,r_45_135_45,0.74,1,46,45,68
56,r_272_242_29,r_26_263_110,seq249,r_272_242_29,0.98,1,30,29,68
47,r_95_76_185,r_73_72_65,r_366_115_140,r_95_76_185,0.98,0,185,185,68
13,r_280_17_30,seq250,seq192,r_280_17_30,0.99,0,30,30,68
86,r_348_21_96,seq47,seq188,r_348_21_96,1.0,3,99,96,68
32,r_170_210_187,r_297_106_139,r_136_7_122,r_170_210_187,1.0,-47,140,187,69
53,r_83_47_30,r_170_210_187,r_102_124_3,r_83_47_30,0.98,-1,29,30,69
41,r_363_56_180,seq57,r_356_81_9,r_363_56_180,0.98,1,181,180,69
81,r_351_26_31,r_140_21_164,r_312_98_47,r_140_21_164,0.99,2,166,164,69
88,r_117_15_150,seq298,r_208_201_142,r_117_15_150,1.0,2,152,150,69
19,r_217_347_95,seq85,r_67_282_34,r_217_347_95,1.0,1,96,95,69
31,r_165_277_78,seq39,r_80_218_65,r_165_277_78,1.0,0,78,78,69
43,r_271_179_1,seq214,r_234_146_71,r_234_146_71,1.0,5,76,71,69
123,r_144_360_24,seq250,seq97,r_144_360_24,0.82,0,24,24,69
73,r_225_34_133,seq73,seq108,r_225_34_133,1.0,0,133,133,69
93,r_116_219_49,r_17_358_189,seq341,r_116_219_49,0.9,-1,48,49,69
100,r_159_70_70,r_88_55_175,r_103_200_7,r_159_70_70,1.0,0,70,70,69
105,r_314_301_170,seq73,r_215_114_148,r_314_301_170,0.99,5,175,170,69
4,r_4_196_10,r_354_125_156,seq280,r_4_196_10,0.64,0,10,10,69
230,seq324,r_66_197_91,seq343,r_66_197_91,1.0,-25,66,91,69
5,r_266_28_119,seq43,seq99,r_266_28_119,1.0,0,119,119,69
35,r_354_125_156,seq291,seq212,r_354_125_156,0.98,1,157,156,69
142,seq61,r_16_303_148,r_80_218_65,r_80_218_65,0.99,-1,64,65,69
121,r_234_146_71,r_247_152_190,r_271_179_1,r_234_146_71,1.0,0,71,71,69
9,r_17_358_189,seq101,r_330_46_121,r_17_358_189,0.54,0,189,189,69
54,r_185_203_133,r_154_69_184,seq153,r_185_203_133,1.0,1,134,133,69
101,r_63_235_8,r_208_201_142,r_37_281_158,r_63_235_8,0.63,148,156,8,69
2,r_130_126_162,r_168_253_198,r_354_125_156,r_130_126_162,0.97,0,162,162,69
48,r_342_104_70,seq176,r_32_224_14,r_342_104_70,0.91,-2,68,70,69
24,r_330_46_121,r_120_107_165,r_22_340_21,r_330_46_121,0.92,2,123,121,69
78,r_136_7_122,r_205_147_125,r_312_98_47,r_136_7_122,1.0,1,123,122,69
94,r_285_19_99,seq115,seq6,r_285_19_99,0.97,1,100,99,69
83,r_267_178_25,r_336_121_182,seq48,r_267_178_25,1.0,0,25,25,69
15,r_66_197_91,r_287_270_197,seq187,r_66_197_91,1.0,-2,89,91,69
10,r_312_98_47,r_165_277_78,r_229_302_27,r_312_98_47,0.99,1,48,47,69
87,r_257_110_101,r_247_152_190,seq108,r_257_110_101,1.0,0,101,101,69
12,r_120_107_165,r_330_46_121,r_287_270_197,r_330_46_121,1.0,2,123,121,69
85,r_67_282_34,r_82_18_156,seq187,r_67_282_34,1.0,0,34,34,69
114,r_50_164_34,r_198_60_151,r_300_100_89,r_50_164_34,1.0,0,34,34,69
36,r_163_299_106,r_12_112_165,seq53,r_163_299_106,1.0,0,106,106,69
98,r_90_134_82,seq151,r_356_81_9,r_90_134_82,0.87,0,82,82,69
52,r_294_148_153,seq71,r_261_174_33,r_294_148_153,0.75,1,154,153,69
14,r_5_251_187,r_279_317_74,r_170_210_187,r_5_251_187,0.43,-1,186,187,69
32,r_170_210_187,r_136_7_122,r_158_42_155,r_170_210_187,0.94,0,187,187,69
14,r_5_251_187,r_369_252_169,r_279_317_74,r_279_317_74,1.0,14,88,74,69
40,r_180_295_133,seq128,seq242,r_180_295_133,1.0,0,133,133,69
63,r_80_218_65,seq331,seq61,r_80_218_65,1.0,-1,64,65,69
17,r_353_355_20,r_306_260_109,seq264,r_353_355_20,0.92,0,20,20,69
245,seq350,r_95_249_176,seq76,r_95_249_176,1.0,1,177,176,69
165,seq123,r_292_372_112,seq256,r_292_372_112,1.0,1,113,112,69
86,r_289_87_143,seq9,seq6,r_289_87_143,0.96,2,145,143,69
72,r_229_302_27,seq48,seq331,r_229_302_27,1.0,0,27,27,69
60,r_369_252_169,seq242,r_16_303_148,r_369_252_169,1.0,0,169,169,69
50,r_140_21_164,r_314_301_170,r_328_86_73,r_328_86_73,0.77,93,166,73,69
97,r_64_195_87,r_52_27_14,r_328_86_73,r_64_195_87,1.0,0,87,87,69
46,r_336_121_182,seq141,r_356_81_9,r_336_121_182,0.7,0,182,182,69
13,r_158_42_155,seq85,r_292_372_112,r_158_42_155,0.93,0,155,155,69
66,r_132_308_68,seq236,r_320_155_14,r_132_308_68,1.0,0,68,68,69
96,r_84_209_74,seq137,r_353_355_20,r_84_209_74,1.0,0,74,74,69
55,r_345_75_167,seq10,r_208_201_142,r_345_75_167,0.69,1,168,167,69
70,r_364_172_103,seq39,r_67_282_34,r_364_172_103,1.0,0,103,103,69
242,seq343,r_322_374_186,r_144_360_24,r_322_374_186,0.84,-33,153,186,69
113,r_248_237_148,seq280,r_306_260_109,r_248_237_148,1.0,3,151,148,69
6,r_30_223_68,r_117_15_150,r_273_177_7,r_30_223_68,0.92,-1,67,68,69
45,r_228_278_6,r_38_259_168,seq176,r_38_259_168,0.99,0,168,168,69
51,r_297_106_139,r_170_210_187,seq62,r_297_106_139,1.0,1,140,139,69
34,r_157_105_56,r_119_59_100,seq214,r_157_105_56,0.75,0,56,56,69
119,r_318_160_180,seq316,r_267_178_25,r_318_160_180,0.79,0,180,180,69
115,r_22_340_21,r_229_302_27,seq85,r_22_340_21,0.99,1,22,21,69
1,r_54_183_102,seq331,r_50_164_34,r_54_183_102,1.0,0,102,102,69
28,r_315_133_96,seq333,seq2,r_315_133_96,1.0,1,97,96,69
71,r_74_258_79,seq254,seq149,r_74_258_79,1.0,0,79,79,69
16,r_207_241_159,seq115,r_231_305_198,r_207_241_159,0.85,1,160,159,69
37,r_88_55_175,seq62,r_30_223_68,r_88_55_175,1.0,0,175,175,69
118,r_255_122_79,seq212,seq182,r_255_122_79,1.0,0,79,79,69
114,r_50_164_34,r_204_240_188,r_54_183_102,r_54_183_102,0.6,4,106,102,69
108,r_52_27_14,r_312_98_47,r_64_195_87,r_52_27_14,0.91,0,14,14,69
38,r_169_227_164,r_319_265_39,r_273_177_7,r_319_265_39,0.96,-19,20,39,69
82,r_91_238_141,seq111,r_323_25_47,r_91_238_141,0.99,0,141,141,69
64,r_154_69_184,r_231_305_198,r_228_278_6,r_154_69_184,0.68,0,184,184,69
39,r_338_346_20,r_170_210_187,seq175,r_338_346_20,0.99,0,20,20,69
84,r_127_29_110,seq6,seq343,r_127_29_110,0.78,1,111,110,69
26,r_322_374_186,seq343,r_169_227_164,r_322_374_186,0.98,0,186,186,69
18,r_119_59_100,seq189,r_312_98_47,r_119_59_100,1.0,1,101,100,69
95,r_16_303_148,seq334,seq33,r_16_303_148,1.0,0,148,148,69
81,r_351_26_31,r_306_260_109,r_140_21_164,r_351_26_31,1.0,0,31,31,69
99,r_366_337_174,seq65,r_4_196_10,r_366_337_174,1.0,1,175,174,69
103,r_344_162_17,r_247_152_190,seq370,r_344_162_17,0.94,1,18,17,69
49,r_365_113_136,r_247_152_190,r_185_203_133,r_247_152_190,1.0,-53,137,190,69
27,r_269_145_67,r_363_56_180,seq274,r_269_145_67,1.0,0,67,67,69
69,r_131_193_121,seq97,r_306_260_109,r_131_193_121,0.93,5,126,121,69
61,r_290_304_38,r_13_188_195,seq313,r_290_304_38,0.99,1,39,38,69
102,r_135_51_29,r_365_113_136,seq373,r_135_51_29,1.0,-1,28,29,69
109,r_12_112_165,r_44_309_176,r_285_19_99,r_285_19_99,0.77,66,165,99,69
107,r_198_60_151,seq313,r_267_178_25,r_198_60_151,0.95,1,152,151,69
111,r_129_368_104,r_37_281_158,seq65,r_129_368_104,0.95,1,105,104,69
30,r_215_114_148,r_130_126_162,r_208_201_142,r_208_201_142,0.95,6,148,142,69
122,r_166_357_188,seq187,r_312_98_47,r_166_357_188,1.0,1,189,188,69
20,r_38_259_168,r_228_278_6,r_198_60_151,r_38_259_168,0.96,0,168,168,69
12,r_120_107_165,r_287_270_197,seq280,r_120_107_165,1.0,0,165,165,69
186,seq187,r_166_357_188,r_66_197_91,r_166_357_188,0.95,1,189,188,69
77,r_362_40_84,seq194,seq333,r_362_40_84,1.0,0,84,84,69
67,r_367_359_89,r_363_56_180,seq41,r_367_359_89,1.0,-1,88,89,69
114,r_50_164_34,r_300_100_89,r_204_240_188,r_300_100_89,0.61,0,89,89,69
38,r_169_227_164,r_273_177_7,r_365_113_136,r_365_113_136,0.7,29,165,136,69
91,r_95_249_176,seq350,r_30_223_68,r_95_249_176,1.0,1,177,176,69
80,r_208_201_142,r_63_235_8,seq65,r_208_201_142,0.8,3,145,142,69
108,r_52_27_14,r_64_195_87,seq78,r_64_195_87,1.0,1,88,87,69
68,r_319_265_39,r_169_227_164,seq274,r_319_265_39,0.96,1,40,39,69
106,r_49_3_32,seq245,r_205_147_125,r_49_3_32,0.95,0,32,32,69
80,r_208_201_142,r_8_36_127,r_63_235_8,r_8_36_127,1.0,-39,88,127,69
97,r_64_195_87,r_261_174_33,r_52_27_14,r_64_195_87,0.84,-67,20,87,69
7,r_300_100_89,r_204_240_188,r_50_164_34,r_300_100_89,0.61,-54,35,89,69
110,r_44_309_176,seq41,r_215_114_148,r_44_309_176,0.98,1,177,176,69
90,r_32_224_14,r_64_195_87,seq61,r_32_224_14,0.99,0,14,14,69
74,r_371_199_17,r_130_126_162,seq151,r_371_199_17,0.98,1,18,17,69
56,r_292_372_112,seq123,seq41,r_292_372_112,1.0,1,113,112,69
44,r_8_36_127,r_208_201_142,seq11,r_8_36_127,1.0,0,127,127,69
116,r_323_25_47,r_37_281_158,r_103_200_7,r_37_281_158,0.72,-110,48,158,69
172,seq149,r_369_252_169,r_74_258_79,r_74_258_79,1.0,2,81,79,69
7,r_300_100_89,r_50_164_34,seq283,r_300_100_89,1.0,0,89,89,69
11,r_31_202_40,r_17_358_189,seq286,r_31_202_40,0.72,-8,32,40,69
151,seq85,r_217_347_95,r_22_340_21,r_217_347_95,0.73,-23,72,95,69
124,r_320_155_14,r_170_210_187,seq313,r_320_155_14,0.89,1,15,14,69
59,r_192_156_107,seq331,r_315_133_96,r_192_156_107,1.0,0,107,107,69
47,r_273_177_7,r_169_227_164,r_30_223_68,r_273_177_7,0.79,121,128,7,69
194,seq214,r_271_179_1,r_157_105_56,r_157_105_56,1.0,-1,55,56,69
33,r_204_240_188,seq41,seq370,r_204_240_188,0.88,0,188,188,69
62,r_103_200_7,r_306_260_109,r_159_70_70,r_159_70_70,1.0,2,72,70,69
23,r_279_317_74,seq331,r_5_251_187,r_279_317_74,1.0,1,75,74,69
65,r_222_68_39,r_294_148_153,r_290_304_38,r_222_68_39,0.96,0,39,39,69
45,r_119_146_113,seq231,r_40_240_2,r_119_146_113,1.0,0,113,113,70
106,r_298_194_126,seq346,r_339_189_41,r_298_194_126,1.0,2,128,126,70
63,r_53_75_147,seq242,seq176,r_53_75_147,1.0,0,147,147,70
9,r_325_230_148,seq2,r_100_177_49,r_325_230_148,0.91,0,148,148,70
50,r_207_152_49,r_374_212_194,seq67,r_207_152_49,1.0,0,49,49,70
21,r_19_27_92,r_128_52_97,r_316_197_73,r_19_27_92,0.85,12,104,92,70
93,r_54_103_142,r_244_341_156,seq62,r_54_103_142,0.92,2,144,142,70
12,r_166_219_49,seq90,seq329,r_166_219_49,1.0,0,49,49,70
108,r_205_297_165,seq308,r_42_104_62,r_205_297_165,1.0,0,165,165,70
13,r_373_206_2,seq242,r_96_79_16,r_96_79_16,1.0,-1,15,16,70
42,r_133_319_60,seq266,r_357_252_44,r_133_319_60,1.0,0,60,60,70
43,r_225_184_191,r_138_105_119,r_356_372_31,r_356_372_31,1.0,1,32,31,70
92,r_142_185_129,r_26_367_151,seq74,r_142_185_129,1.0,0,129,129,70
89,r_80_229_122,r_68_8_193,r_17_139_49,r_80_229_122,0.78,2,124,122,70
14,r_294_200_120,seq43,r_86_50_87,r_294_200_120,1.0,3,123,120,70
72,r_234_273_88,seq134,seq131,r_234_273_88,1.0,0,88,88,70
78,r_16_291_121,r_68_8_193,seq305,r_16_291_121,1.0,2,123,121,70
114,r_65_360_164,seq271,r_210_45_18,r_65_360_164,1.0,0,164,164,70
65,r_57_160_121,seq64,seq262,r_57_160_121,0.98,0,121,121,70
60,r_22_112_115,seq305,seq21,r_22_112_115,1.0,0,115,115,70
218,seq271,r_171_25_138,r_339_189_41,r_339_189_41,1.0,0,41,41,70
98,r_110_93_26,r_12_326_135,r_356_372_31,r_110_93_26,1.0,4,30,26,70
51,r_175_284_149,r_236_258_195,r_97_164_112,r_97_164_112,0.89,41,153,112,70
28,r_102_327_77,r_320_301_196,r_195_276_107,r_102_327_77,0.72,74,151,77,70
177,seq155,r_156_20_187,r_294_200_120,r_156_20_187,0.63,0,187,187,70
27,r_304_186_51,seq315,seq162,r_304_186_51,1.0,0,51,51,70
240,seq347,seq193,r_332_46_33,r_332_46_33,0.83,-1,32,33,70
54,r_47_222_180,seq246,r_57_160_121,r_47_222_180,0.99,0,180,180,70
88,r_345_196_85,seq61,r_357_252_44,r_345_196_85,0.96,-1,84,85,70
249,seq370,seq74,r_260_6_100,r_260_6_100,1.0,24,124,100,70
35,r_316_197_73,r_261_282_107,seq123,r_261_282_107,0.99,-34,73,107,70
5,r_280_343_157,seq109,seq94,r_280_343_157,1.0,0,157,157,70
73,r_17_139_49,r_209_188_162,r_57_160_121,r_209_188_162,1.0,0,162,162,70
120,r_267_362_10,r_304_186_51,r_320_301_196,r_320_301_196,0.72,-186,10,196,70
58,r_153_71_49,seq145,seq274,r_153_71_49,1.0,0,49,49,70
36,r_42_104_62,seq101,seq90,r_42_104_62,1.0,0,62,62,70
48,r_330_32_136,seq204,r_22_112_115,r_330_32_136,1.0,0,136,136,70
90,r_302_63_113,seq232,seq253,r_302_63_113,1.0,1,114,113,70
75,r_286_249_126,seq257,seq308,r_286_249_126,1.0,0,126,126,70
170,seq134,r_234_273_88,r_135_277_185,r_234_273_88,1.0,-11,77,88,70
2,r_97_164_112,seq274,seq285,r_97_164_112,1.0,0,112,112,70
84,r_82_10_134,r_225_184_191,seq30,r_82_10_134,1.0,1,135,134,70
54,r_47_222_180,r_348_216_131,seq246,r_348_216_131,1.0,0,131,131,70
31,r_36_83_117,r_37_296_160,r_238_218_63,r_36_83_117,1.0,0,117,117,70
179,seq162,seq193,r_304_186_51,r_304_186_51,1.0,0,51,51,70
7,r_151_227_114,seq107,seq231,r_151_227_114,1.0,0,114,114,70
124,r_149_158_123,seq355,r_42_104_62,r_149_158_123,0.98,0,123,123,70
221,seq279,r_244_341_156,r_15_7_23,r_15_7_23,0.94,0,23,23,70
107,r_38_269_150,seq141,r_53_75_147,r_38_269_150,0.93,0,150,150,70
102,r_156_20_187,seq155,r_37_296_160,r_156_20_187,1.0,0,187,187,70
18,r_100_177_49,r_150_99_146,seq232,r_100_177_49,0.73,-13,36,49,70
68,r_13_95_139,r_316_197_73,r_171_25_138,r_13_95_139,1.0,1,140,139,70
81,r_168_243_70,r_5_226_116,seq30,r_5_226_116,0.95,-46,70,116,70
164,seq118,r_92_56_164,r_321_311_67,r_321_311_67,0.91,6,73,67,70
220,seq274,seq130,r_153_71_49,r_153_71_49,1.0,37,86,49,70
6,r_179_129_121,seq155,r_358_334_74,r_179_129_121,0.74,0,121,121,70
122,r_331_202_144,seq335,r_366_213_26,r_331_202_144,1.0,0,144,144,70
44,r_356_372_31,r_289_125_109,r_110_93_26,r_356_372_31,0.79,0,31,31,70
53,r_223_161_105,r_132_170_125,r_172_263_82,r_132_170_125,0.99,-17,108,125,70
33,r_358_334_74,r_179_129_121,r_247_124_11,r_247_124_11,1.0,63,74,11,70
59,r_187_1_160,seq215,r_280_343_157,r_187_1_160,0.59,0,160,160,70
20,r_348_216_131,r_47_222_180,seq271,r_348_216_131,1.0,0,131,131,70
38,r_122_318_19,r_357_252_44,seq87,r_122_318_19,1.0,0,19,19,70
118,r_332_46_33,r_172_263_82,seq347,r_172_263_82,0.6,-50,32,82,70
73,r_17_139_49,seq72,r_209_188_162,r_17_139_49,1.0,-4,45,49,70
29,r_48_136_108,r_306_55_199,seq364,r_306_55_199,0.53,-87,112,199,70
61,r_77_265_105,r_270_239_191,seq349,r_77_265_105,1.0,0,105,105,70
16,r_289_125_109,r_330_32_136,r_147_190_64,r_289_125_109,1.0,0,109,109,70
101,r_328_317_142,r_68_8_193,r_294_200_120,r_328_317_142,1.0,2,144,142,70
97,r_310_120_16,r_179_129_121,seq349,r_310_120_16,0.93,0,16,16,70
70,r_250_299_129,seq134,seq94,r_250_299_129,1.0,0,129,129,70
83,r_89_307_49,r_82_10_134,seq259,r_89_307_49,0.62,0,49,49,70
111,r_84_220_56,r_138_105_119,seq107,r_84_220_56,1.0,0,56,56,70
22,r_171_25_138,seq163,r_13_95_139,r_13_95_139,0.69,-1,138,139,70
56,r_287_159_68,r_374_212_194,r_42_104_62,r_287_159_68,1.0,-1,67,68,70
8,r_138_105_119,r_225_184_191,r_289_125_109,r_289_125_109,0.94,14,123,109,70
117,r_26_367_151,r_12_326_135,seq274,r_26_367_151,1.0,0,151,151,70
74,r_144_28_65,r_374_212_194,r_373_206_2,r_144_28_65,0.99,0,65,65,70
64,r_33_0_100,r_294_200_120,r_304_186_51,r_33_0_100,1.0,0,100,100,70
206,seq242,r_373_206_2,r_182_127_77,r_182_127_77,1.0,0,77,77,70
25,r_238_218_63,r_19_27_92,seq61,r_238_218_63,1.0,-3,60,63,70
17,r_264_3_108,r_82_10_134,r_316_197_73,r_316_197_73,0.94,35,108,73,70
19,r_339_189_41,r_119_146_113,seq271,r_339_189_41,1.0,0,41,41,70
55,r_91_29_174,seq108,r_42_104_62,r_91_29_174,0.99,1,175,174,70
79,r_244_341_156,seq192,seq49,r_244_341_156,1.0,1,157,156,70
71,r_288_368_157,r_68_8_193,r_260_6_100,r_288_368_157,1.0,0,157,157,70
116,r_278_322_162,seq178,r_151_227_114,r_278_322_162,0.99,0,162,162,70
144,seq66,r_357_252_44,r_209_188_162,r_209_188_162,1.0,3,165,162,70
86,r_182_127_77,r_172_263_82,seq242,r_182_127_77,1.0,0,77,77,70
30,r_336_18_99,seq178,seq253,r_336_18_99,1.0,0,99,99,70
123,r_92_56_164,seq118,seq271,r_92_56_164,1.0,0,164,164,70
23,r_117_23_36,r_5_226_116,r_356_372_31,r_117_23_36,1.0,0,36,36,70
234,seq329,seq193,r_166_219_49,r_166_219_49,1.0,0,49,49,70
91,r_34_359_143,seq271,seq246,r_34_359_143,1.0,0,143,143,70
46,r_69_290_49,seq329,seq155,r_69_290_49,1.0,0,49,49,70
104,r_342_365_143,r_14_115_151,r_57_160_121,r_342_365_143,1.0,0,143,143,70
119,r_260_6_100,seq114,seq370,r_260_6_100,1.0,0,100,100,70
121,r_15_7_23,r_100_177_49,seq279,r_15_7_23,0.97,0,23,23,70
57,r_174_353_22,seq137,seq101,r_174_353_22,0.93,0,22,22,70
40,r_366_213_26,r_325_230_148,seq148,r_366_213_26,0.99,-1,25,26,70
103,r_351_211_152,seq191,seq364,r_351_211_152,1.0,1,153,152,70
235,seq335,r_331_202_144,r_102_327_77,r_331_202_144,0.67,0,144,144,70
37,r_73_35_142,r_270_239_191,r_100_177_49,r_73_35_142,0.98,0,142,142,70
52,r_321_311_67,r_86_50_87,seq118,r_321_311_67,1.0,-3,64,67,70
95,r_209_188_162,r_17_139_49,seq66,r_209_188_162,1.0,0,162,162,70
109,r_228_344_32,r_320_301_196,seq303,r_228_344_32,0.91,6,38,32,70
99,r_210_45_18,seq9,seq329,r_210_45_18,0.63,0,18,18,70
87,r_154_167_132,seq232,seq59,r_154_167_132,1.0,1,133,132,70
80,r_86_50_87,r_119_146_113,seq9,r_119_146_113,0.98,-24,89,113,70
32,r_147_190_64,r_306_55_199,seq109,r_147_190_64,1.0,1,65,64,70
24,r_150_99_146,seq169,r_128_52_97,r_150_99_146,0.92,3,149,146,70
120,r_267_362_10,r_320_301_196,r_89_307_49,r_267_362_10,0.78,138,148,10,70
34,r_261_282_107,seq245,seq204,r_261_282_107,1.0,0,107,107,70
85,r_293_314_42,r_179_129_121,seq140,r_293_314_42,1.0,0,42,42,70
3,r_268_363_25,seq90,seq183,r_268_363_25,0.86,0,25,25,70
62,r_96_79_16,r_320_301_196,r_373_206_2,r_96_79_16,0.95,-1,15,16,70
28,r_102_327_77,r_34_359_143,r_320_301_196,r_102_327_77,1.0,0,77,77,70
110,r_128_52_97,r_19_27_92,seq337,r_128_52_97,0.89,7,104,97,70
76,r_132_170_125,seq183,seq58,r_132_170_125,1.0,0,125,125,70
82,r_11_81_43,r_321_311_67,seq9,r_321_311_67,0.66,-27,40,67,70
95,r_209_188_162,r_19_27_92,r_17_139_49,r_17_139_49,1.0,-1,48,49,70
188,seq183,seq337,r_268_363_25,r_268_363_25,1.0,0,25,25,70
66,r_14_115_151,r_65_360_164,r_179_129_121,r_14_115_151,1.0,0,151,151,70
115,r_198_333_132,seq315,r_97_164_112,r_198_333_132,1.0,1,133,132,70
24,r_70_151_82,r_364_125_134,seq118,r_364_125_134,0.99,-50,84,134,71
2,r_337_266_105,seq249,seq150,r_337_266_105,1.0,1,106,105,71
118,r_241_14_117,seq20,r_92_332_59,r_241_14_117,1.0,0,117,117,71
46,r_364_125_134,seq297,r_19_288_11,r_364_125_134,1.0,0,134,134,71
54,r_353_141_136,seq71,r_200_264_11,r_353_141_136,1.0,0,136,136,71
111,r_90_178_186,seq274,r_223_24_80,r_90_178_186,1.0,0,186,186,71
112,r_214_363_145,seq60,r_44_86_197,r_214_363_145,0.98,0,145,145,71
29,r_352_323_141,r_237_373_131,r_31_46_141,r_352_323_141,0.74,-2,139,141,71
21,r_302_173_104,seq109,r_70_151_82,r_302_173_104,1.0,0,104,104,71
56,r_47_146_27,r_262_218_199,r_365_136_195,r_47_146_27,1.0,0,27,27,71
34,r_36_35_171,seq166,r_157_220_102,r_36_35_171,1.0,0,171,171,71
68,r_34_160_134,seq27,r_0_169_97,r_34_160_134,1.0,0,134,134,71
52,r_267_329_111,r_316_121_173,r_28_298_46,r_28_298_46,0.97,0,46,46,71
39,r_365_136_195,r_31_46_141,r_47_146_27,r_31_46_141,1.0,0,141,141,71
113,r_58_279_178,seq150,r_295_8_25,r_58_279_178,0.99,0,178,178,71
190,seq208,r_226_11_126,r_19_288_11,r_226_11_126,1.0,0,126,126,71
123,r_213_349_43,r_205_336_141,r_92_332_59,r_92_332_59,0.78,2,61,59,71
174,seq150,r_157_220_102,r_337_266_105,r_337_266_105,1.0,1,106,105,71
11,r_19_288_11,seq12,seq208,r_19_288_11,1.0,0,11,11,71
78,r_306_344_39,seq187,r_132_360_10,r_132_360_10,0.96,30,40,10,71
100,r_38_30_16,r_321_251_102,seq261,r_38_30_16,1.0,2,18,16,71
80,r_100_52_103,r_289_158_91,r_10_269_115,r_289_158_91,0.88,0,91,91,71
95,r_226_11_126,seq208,r_80_235_28,r_226_11_126,1.0,0,126,126,71
42,r_25_155_113,r_196_97_140,seq79,r_25_155_113,0.52,0,113,113,71
232,seq325,r_283_225_119,r_87_339_32,r_87_339_32,1.0,8,40,32,71
115,r_177_74_37,r_145_161_43,seq260,r_177_74_37,1.0,0,37,37,71
117,r_72_1_102,r_78_88_94,r_317_156_23,r_72_1_102,1.0,0,102,102,71
119,r_196_97_140,seq282,r_127_108_120,r_196_97_140,1.0,0,140,140,71
30,r_49_45_146,r_280_244_169,r_10_269_115,r_10_269_115,0.83,32,147,115,71
9,r_231_149_92,seq261,r_94_179_10,r_231_149_92,1.0,0,92,92,71
107,r_113_198_169,r_183_122_196,r_330_105_4,r_113_198_169,1.0,0,169,169,71
99,r_284_50_110,r_134_265_133,seq322,r_284_50_110,1.0,0,110,110,71
13,r_190_314_129,seq103,r_295_8_25,r_190_314_129,0.92,0,129,129,71
85,r_300_99_120,r_134_265_133,r_127_108_120,r_300_99_120,1.0,1,121,120,71
17,r_205_336_141,seq206,r_0_169_97,r_205_336_141,1.0,1,142,141,71
71,r_157_220_102,seq150,r_247_42_93,r_247_42_93,1.0,13,106,93,71
66,r_211_110_188,seq221,r_19_288_11,r_211_110_188,0.83,0,188,188,71
29,r_352_323_141,r_63_165_81,r_237_373_131,r_63_165_81,1.0,1,82,81,71
103,r_270_9_128,seq57,r_13_367_126,r_270_9_128,1.0,0,128,128,71
124,r_207_176_34,r_214_363_145,seq75,r_207_176_34,1.0,0,34,34,71
15,r_268_135_90,seq185,r_119_315_29,r_268_135_90,1.0,0,90,90,71
50,r_250_227_28,r_49_45_146,seq129,r_250_227_28,1.0,0,28,28,71
74,r_85_140_49,r_374_345_124,r_168_194_80,r_85_140_49,0.72,73,122,49,71
44,r_326_296_128,r_131_117_156,r_0_169_97,r_326_296_128,0.64,0,128,128,71
94,r_195_114_108,r_316_121_173,r_256_175_10,r_195_114_108,1.0,2,110,108,71
82,r_368_245_125,r_18_172_121,r_168_194_80,r_368_245_125,1.0,0,125,125,71
67,r_92_332_59,seq39,r_213_349_43,r_92_332_59,1.0,0,59,59,71
87,r_56_301_81,r_190_314_129,r_362_62_29,r_56_301_81,0.92,1,82,81,71
96,r_43_278_41,seq201,r_306_344_39,r_43_278_41,1.0,0,41,41,71
110,r_54_33_126,r_18_172_121,r_63_165_81,r_54_33_126,0.98,0,126,126,71
58,r_237_373_131,r_352_323_141,r_19_288_11,r_237_373_131,0.69,5,136,131,71
81,r_191_222_92,seq206,seq277,r_191_222_92,0.55,2,94,92,71
91,r_138_271_158,r_115_148_178,r_337_266_105,r_138_271_158,1.0,0,158,158,71
37,r_372_199_111,seq249,r_18_172_121,r_372_199_111,1.0,0,111,111,71
49,r_87_339_32,seq142,seq325,r_87_339_32,1.0,0,32,32,71
14,r_321_251_102,seq124,r_61_96_43,r_321_251_102,1.0,0,102,102,71
41,r_316_121_173,r_267_329_111,r_154_163_164,r_316_121_173,1.0,1,174,173,71
104,r_145_161_43,seq219,r_37_202_37,r_145_161_43,1.0,0,43,43,71
203,seq239,seq359,r_19_288_11,r_19_288_11,0.78,86,97,11,71
128,seq12,r_19_288_11,seq229,r_19_288_11,0.74,2,13,11,71
55,r_115_148_178,r_80_235_28,r_190_314_129,r_115_148_178,0.81,0,178,178,71
59,r_28_298_46,r_49_45_146,r_267_329_111,r_28_298_46,1.0,1,47,46,71
12,r_61_96_43,r_190_314_129,r_306_344_39,r_61_96_43,1.0,0,43,43,71
73,r_258_128_88,r_316_121_173,r_200_264_11,r_258_128_88,1.0,0,88,88,71
38,r_0_169_97,seq303,r_177_74_37,r_0_169_97,1.0,0,97,97,71
63,r_223_24_80,r_70_151_82,seq124,r_223_24_80,1.0,0,80,80,71
120,r_31_46_141,r_365_136_195,r_80_235_28,r_31_46_141,1.0,0,141,141,71
10,r_40_234_170,r_333_67_162,r_330_105_4,r_40_234_170,1.0,0,170,170,71
93,r_119_315_29,r_40_234_170,seq348,r_119_315_29,1.0,0,29,29,71
88,r_347_334_59,r_70_151_82,seq188,r_347_334_59,1.0,0,59,59,71
84,r_283_225_119,seq39,r_153_197_51,r_283_225_119,0.67,12,131,119,71
51,r_69_159_154,r_224_276_199,seq359,r_69_159_154,0.96,0,154,154,71
65,r_78_88_94,r_72_1_102,r_133_291_18,r_72_1_102,1.0,0,102,102,71
114,r_184_286_55,seq359,r_85_140_49,r_184_286_55,0.99,0,55,55,71
28,r_131_117_156,seq22,r_372_199_111,r_131_117_156,1.0,0,156,156,71
33,r_333_67_162,seq309,seq60,r_333_67_162,0.74,15,177,162,71
208,seq249,r_337_266_105,r_70_151_82,r_337_266_105,1.0,1,106,105,71
27,r_304_3_158,seq331,r_268_135_90,r_304_3_158,0.97,0,158,158,71
45,r_289_158_91,r_100_52_103,r_18_172_121,r_100_52_103,0.58,-12,91,103,71
8,r_168_194_80,seq188,r_85_140_49,r_168_194_80,1.0,0,80,80,71
92,r_144_2_38,seq249,seq6,r_144_2_38,1.0,0,38,38,71
75,r_21_116_47,seq123,seq23,r_21_116_47,0.98,0,47,47,71
38,r_0_169_97,r_177_74_37,r_326_296_128,r_326_296_128,0.95,9,137,128,71
6,r_153_197_51,r_281_294_171,r_224_276_199,r_153_197_51,1.0,0,51,51,71
40,r_350_240_77,r_321_251_102,seq103,r_350_240_77,1.0,0,77,77,71
16,r_63_165_81,r_352_323_141,seq185,r_63_165_81,1.0,1,82,81,71
64,r_134_265_133,seq357,seq23,r_134_265_133,0.74,3,136,133,71
116,r_247_42_93,r_66_212_60,r_157_220_102,r_247_42_93,1.0,0,93,93,71
148,seq71,r_213_349_43,r_317_156_23,r_317_156_23,0.75,26,49,23,71
61,r_171_292_159,seq29,seq26,r_171_292_159,0.94,10,169,159,71
31,r_111_55_180,seq331,r_153_197_51,r_111_55_180,1.0,0,180,180,71
60,r_374_345_124,seq16,seq59,r_374_345_124,1.0,0,124,124,71
48,r_335_102_54,seq327,r_61_96_43,r_335_102_54,1.0,0,54,54,71
43,r_295_8_25,r_40_234_170,seq22,r_295_8_25,1.0,0,25,25,71
32,r_5_76_176,seq311,seq84,r_5_76_176,1.0,0,176,176,71
105,r_13_367_126,seq164,r_270_9_128,r_13_367_126,1.0,2,128,126,71
122,r_137_143_92,r_69_159_154,r_87_339_32,r_137_143_92,0.87,4,96,92,71
4,r_10_269_115,seq260,seq357,r_10_269_115,0.99,0,115,115,71
101,r_189_101_40,r_131_117_156,r_250_227_28,r_189_101_40,0.95,3,43,40,71
26,r_362_62_29,r_58_279_178,seq29,r_362_62_29,1.0,0,29,29,71
72,r_37_202_37,r_262_218_199,r_38_30_16,r_37_202_37,0.99,0,37,37,71
55,r_115_148_178,r_138_271_158,r_80_235_28,r_138_271_158,0.96,0,158,158,71
74,r_85_140_49,r_49_45_146,r_374_345_124,r_85_140_49,1.0,0,49,49,71
97,r_324_370_71,r_205_336_141,seq232,r_324_370_71,1.0,0,71,71,71
3,r_281_294_171,r_181_346_2,r_40_234_170,r_40_234_170,0.78,2,172,170,71
77,r_44_86_197,r_310_253_33,r_133_291_18,r_44_86_197,0.92,-164,33,197,71
57,r_15_106_136,r_273_233_190,r_177_74_37,r_15_106_136,1.0,0,136,136,71
5,r_154_163_164,r_171_292_159,r_268_135_90,r_154_163_164,0.94,1,165,164,71
70,r_310_253_33,r_44_86_197,r_330_105_4,r_310_253_33,1.0,0,33,33,71
113,r_58_279_178,r_78_88_94,seq150,r_58_279_178,0.64,-115,63,178,71
80,r_100_52_103,r_10_269_115,r_347_334_59,r_100_52_103,0.92,0,103,103,71
135,seq39,r_187_326_100,r_93_371_41,r_93_371_41,0.49,120,161,41,72
126,seq5,r_339_221_177,r_188_125_76,r_339_221_177,0.98,0,177,177,72
58,r_129_75_166,seq80,r_37_11_40,r_129_75_166,1.0,0,166,166,72
104,r_264_343_36,r_268_297_110,r_25_358_62,r_268_297_110,0.94,0,110,110,72
52,r_337_247_104,seq161,seq280,r_337_247_104,1.0,0,104,104,72
10,r_144_167_182,seq255,r_34_103_168,r_144_167_182,1.0,0,182,182,72
80,r_45_147_135,seq137,seq73,r_45_147_135,0.74,4,139,135,72
109,r_303_55_152,seq374,r_366_181_148,r_366_181_148,0.72,10,158,148,72
18,r_331_16_63,seq352,r_93_371_41,r_331_16_63,1.0,0,63,63,72
28,r_319_259_160,seq3,r_169_338_8,r_319_259_160,1.0,0,160,160,72
50,r_119_330_136,seq90,seq23,r_119_330_136,1.0,0,136,136,72
87,r_37_11_40,seq72,r_12_101_128,r_37_11_40,1.0,0,40,40,72
15,r_278_226_165,seq275,r_171_325_87,r_278_226_165,1.0,0,165,165,72
2,r_85_0_59,r_188_125_76,seq120,r_85_0_59,1.0,0,59,59,72
51,r_228_77_90,r_7_195_117,r_312_369_70,r_228_77_90,1.0,6,96,90,72
149,seq80,r_129_75_166,r_215_310_166,r_129_75_166,1.0,0,166,166,72
77,r_7_195_117,seq110,r_51_346_108,r_7_195_117,1.0,0,117,117,72
87,r_37_11_40,r_12_101_128,r_135_243_108,r_37_11_40,1.0,74,114,40,72
82,r_295_191_63,seq82,seq373,r_295_191_63,1.0,0,63,63,72
158,seq102,r_302_220_149,r_50_43_15,r_50_43_15,1.0,0,15,15,72
113,r_109_309_80,r_185_139_100,seq117,r_109_309_80,1.0,1,81,80,72
89,r_34_103_168,seq208,seq22,r_34_103_168,1.0,0,168,168,72
100,r_160_52_144,seq14,r_321_279_62,r_160_52_144,0.99,0,144,144,72
9,r_83_9_102,seq92,seq255,r_83_9_102,0.94,0,102,102,72
12,r_372_229_186,r_233_126_135,r_171_325_87,r_233_126_135,1.0,0,135,135,72
13,r_268_297_110,r_166_219_172,r_264_343_36,r_264_343_36,1.0,6,42,36,72
95,r_31_218_56,r_237_350_69,seq216,r_31_218_56,1.0,1,57,56,72
118,r_151_186_101,r_29_178_149,seq210,r_151_186_101,1.0,1,102,101,72
62,r_138_254_157,seq223,r_146_342_1,r_138_254_157,1.0,0,157,157,72
35,r_187_326_100,r_61_261_158,seq59,r_61_261_158,0.63,-57,101,158,72
63,r_10_294_95,r_29_178_149,seq133,r_10_294_95,1.0,0,95,95,72
23,r_27_4_126,r_13_162_130,r_318_18_19,r_27_4_126,1.0,0,126,126,72
121,r_127_26_124,seq214,seq79,r_127_26_124,1.0,0,124,124,72
215,seq262,r_146_342_1,r_49_94_72,r_49_94_72,1.0,8,80,72,72
190,seq196,r_131_238_128,r_105_19_47,r_131_238_128,1.0,0,128,128,72
40,r_107_222_130,r_119_330_136,r_66_140_127,r_107_222_130,0.63,1,131,130,72
83,r_33_24_123,r_98_231_111,r_177_174_163,r_98_231_111,0.99,0,111,111,72
102,r_227_71_119,seq345,seq133,r_227_71_119,1.0,0,119,119,72
65,r_213_108_180,r_41_307_188,r_246_202_96,r_213_108_180,1.0,0,180,180,72
88,r_340_62_18,r_228_77_90,r_166_219_172,r_340_62_18,1.0,0,18,18,72
97,r_173_1_94,r_146_342_1,seq216,r_173_1_94,1.0,0,94,94,72
114,r_132_206_53,seq121,seq352,r_132_206_53,1.0,0,53,53,72
85,r_49_94_72,r_160_52_144,seq262,r_49_94_72,1.0,0,72,72,72
86,r_35_314_93,seq161,r_308_274_23,r_35_314_93,0.96,0,93,93,72
101,r_13_162_130,seq241,r_336_170_105,r_13_162_130,1.0,0,130,130,72
88,r_340_62_18,r_166_219_172,r_98_231_111,r_166_219_172,0.78,0,172,172,72
39,r_315_296_49,r_66_140_127,seq245,r_315_296_49,0.54,0,49,49,72
248,seq373,r_83_9_102,r_295_191_63,r_295_191_63,1.0,0,63,63,72
94,r_115_42_44,r_10_294_95,seq298,r_115_42_44,0.99,0,44,44,72
37,r_317_351_180,seq14,r_105_19_47,r_317_351_180,1.0,0,180,180,72
21,r_263_207_75,seq117,seq250,r_263_207_75,1.0,0,75,75,72
124,r_290_123_150,r_177_174_163,r_366_181_148,r_366_181_148,0.53,2,150,148,72
38,r_32_100_140,r_177_174_163,r_185_139_100,r_32_100_140,0.79,0,140,140,72
47,r_113_48_96,r_64_193_98,seq313,r_64_193_98,1.0,0,98,98,72
76,r_135_243_108,seq203,r_37_11_40,r_135_243_108,0.87,0,108,108,72
107,r_224_200_108,seq142,r_270_164_28,r_224_200_108,0.99,1,109,108,72
27,r_63_209_152,seq328,r_321_279_62,r_63_209_152,1.0,0,152,152,72
29,r_143_89_50,seq73,seq241,r_143_89_50,1.0,0,50,50,72
56,r_188_125_76,seq67,seq5,r_188_125_76,1.0,0,76,76,72
19,r_212_47_154,r_357_69_152,r_152_341_141,r_212_47_154,0.99,0,154,154,72
57,r_335_301_150,seq241,r_300_175_124,r_335_301_150,0.75,0,150,150,72
72,r_323_128_70,r_129_75_166,r_31_218_56,r_323_128_70,1.0,0,70,70,72
69,r_344_240_153,r_278_226_165,seq197,r_344_240_153,0.97,0,153,153,72
108,r_265_248_94,seq6,seq328,r_265_248_94,1.0,2,96,94,72
93,r_78_293_165,seq90,r_265_248_94,r_78_293_165,1.0,0,165,165,72
92,r_12_101_128,r_105_19_47,r_37_11_40,r_12_101_128,0.81,-98,30,128,72
64,r_105_19_47,r_303_55_152,r_115_42_44,r_105_19_47,1.0,0,47,47,72
8,r_25_358_62,r_302_220_149,seq345,r_25_358_62,1.0,0,62,62,72
236,seq345,r_227_71_119,r_25_358_62,r_227_71_119,0.92,0,119,119,72
48,r_98_231_111,r_33_24_123,r_340_62_18,r_98_231_111,1.0,0,111,111,72
105,r_81_156_149,seq56,r_83_9_102,r_81_156_149,1.0,0,149,149,72
5,r_302_220_149,seq36,r_321_279_62,r_302_220_149,1.0,0,149,149,72
75,r_29_178_149,seq194,r_270_164_28,r_29_178_149,0.93,5,154,149,72
46,r_51_346_108,r_41_307_188,seq59,r_51_346_108,0.97,0,108,108,72
103,r_312_369_70,r_131_238_128,seq194,r_312_369_70,1.0,0,70,70,72
67,r_166_219_172,r_227_71_119,r_340_62_18,r_166_219_172,0.72,-143,29,172,72
117,r_300_175_124,seq155,r_151_186_101,r_300_175_124,1.0,0,124,124,72
79,r_152_341_141,seq116,seq90,r_152_341_141,1.0,-1,140,141,72
24,r_61_261_158,r_205_136_70,seq235,r_61_261_158,0.85,0,158,158,72
43,r_60_251_44,seq298,seq161,r_60_251_44,0.95,0,44,44,72
34,r_321_279_62,r_66_140_127,seq266,r_321_279_62,1.0,0,62,62,72
78,r_185_139_100,seq210,seq95,r_185_139_100,1.0,2,102,100,72
135,seq39,r_367_150_128,r_187_326_100,r_367_150_128,1.0,0,128,128,72
90,r_93_371_41,r_233_126_135,seq176,r_93_371_41,0.99,1,42,41,72
98,r_86_353_78,r_27_4_126,r_340_62_18,r_86_353_78,1.0,0,78,78,72
60,r_154_363_141,seq197,seq6,r_154_363_141,1.0,0,141,141,72
70,r_355_272_43,r_17_239_99,seq316,r_17_239_99,0.64,-54,45,99,72
24,r_61_261_158,r_187_326_100,r_205_136_70,r_205_136_70,0.72,31,101,70,72
7,r_336_170_105,seq316,seq203,r_336_170_105,1.0,1,106,105,72
74,r_257_362_59,r_41_307_188,r_57_21_76,r_257_362_59,0.8,77,136,59,72
55,r_260_230_127,r_45_147_135,r_33_24_123,r_260_230_127,0.69,1,128,127,72
0,r_66_140_127,seq364,r_199_287_35,r_66_140_127,1.0,0,127,127,72
17,r_366_181_148,seq130,r_51_346_108,r_366_181_148,1.0,0,148,148,72
155,seq92,r_83_9_102,r_105_19_47,r_105_19_47,0.93,55,102,47,72
81,r_318_18_19,r_237_350_69,seq142,r_318_18_19,1.0,1,20,19,72
122,r_357_69_152,r_212_47_154,r_367_150_128,r_357_69_152,0.8,0,152,152,72
119,r_112_104_104,seq210,seq114,r_112_104_104,1.0,3,107,104,72
92,r_12_101_128,r_37_11_40,r_205_136_70,r_12_101_128,1.0,1,129,128,72
67,r_166_219_172,r_340_62_18,r_366_181_148,r_166_219_172,1.0,0,172,172,72
42,r_367_150_128,seq39,seq161,r_367_150_128,1.0,0,128,128,72
68,r_97_141_80,r_107_222_130,seq204,r_97_141_80,0.61,0,80,80,72
44,r_149_134_107,r_177_174_163,r_64_193_98,r_149_134_107,0.69,0,107,107,72
83,r_33_24_123,r_177_174_163,seq74,r_33_24_123,0.92,0,123,123,72
33,r_106_148_47,r_113_48_96,seq352,r_106_148_47,1.0,0,47,47,72
112,r_131_238_128,seq196,seq223,r_131_238_128,1.0,0,128,128,72
239,seq352,r_278_226_165,r_106_148_47,r_106_148_47,1.0,0,47,47,72
20,r_271_324_117,seq176,r_171_325_87,r_271_324_117,1.0,0,117,117,72
92,r_12_101_128,r_50_43_15,r_105_19_47,r_105_19_47,0.5,-37,10,47,72
3,r_233_126_135,r_372_229_186,seq328,r_233_126_135,1.0,0,135,135,72
4,r_199_287_35,r_225_354_193,r_285_2_25,r_199_287_35,1.0,0,35,35,72
221,seq280,seq76,r_337_247_104,r_337_247_104,1.0,6,110,104,72
74,r_257_362_59,r_185_139_100,r_41_307_188,r_257_362_59,1.0,0,59,59,72
30,r_57_21_76,seq72,r_257_362_59,r_57_21_76,1.0,0,76,76,72
84,r_284_299_51,r_271_324_117,seq172,r_284_299_51,0.36,0,51,51,72
99,r_304_88_179,seq110,r_61_261_158,r_304_88_179,1.0,0,179,179,72
12,r_372_229_186,r_171_325_87,seq190,r_372_229_186,0.91,-1,185,186,72
1,r_177_174_163,seq234,r_112_104_104,r_177_174_163,1.0,0,163,163,72
96,r_70_311_125,seq54,seq282,r_70_311_125,1.0,0,125,125,72
41,r_205_136_70,r_152_341_141,seq223,r_205_136_70,1.0,0,70,70,72
153,seq90,r_119_330_136,r_322_145_8,r_119_330_136,1.0,0,136,136,72
16,r_289_211_170,r_44_269_192,r_187_326_100,r_289_211_170,0.68,0,170,170,72
104,r_264_343_36,r_138_254_157,r_268_297_110,r_264_343_36,1.0,0,36,36,72
6,r_308_274_23,r_302_220_149,seq54,r_308_274_23,1.0,0,23,23,72
111,r_28_96_81,r_160_52_144,r_295_191_63,r_28_96_81,0.99,0,81,81,72
31,r_246_202_96,seq280,seq8,r_246_202_96,1.0,0,96,96,72
26,r_118_320_125,r_319_259_160,r_10_294_95,r_118_320_125,1.0,5,130,125,72
66,r_281_291_181,seq36,r_64_193_98,r_281_291_181,0.65,0,181,181,72
13,r_268_297_110,r_264_343_36,seq374,r_268_297_110,1.0,-1,109,110,72
22,r_64_193_98,r_113_48_96,seq122,r_64_193_98,1.0,0,98,98,72
137,seq47,r_325_63_30,seq125,r_325_63_30,1.0,0,30,30,73
93,r_186_328_55,r_156_258_58,r_173_7_20,r_186_328_55,1.0,0,55,55,73
112,r_354_185_94,r_240_172_199,seq58,r_354_185_94,1.0,0,94,94,73
66,r_69_135_154,r_32_282_163,r_15_103_42,r_15_103_42,1.0,112,154,42,73
53,r_156_258_58,seq46,r_70_180_77,r_156_258_58,0.99,2,60,58,73
44,r_76_230_159,seq5,seq51,r_76_230_159,1.0,1,160,159,73
63,r_61_6_112,seq9,r_123_286_27,r_61_6_112,1.0,0,112,112,73
98,r_222_218_106,r_372_224_125,r_198_331_32,r_372_224_125,1.0,-3,122,125,73
77,r_190_203_102,seq309,seq142,r_190_203_102,0.81,4,106,102,73
22,r_221_299_69,seq334,seq157,r_221_299_69,1.0,0,69,69,73
78,r_277_197_17,seq78,seq255,r_277_197_17,1.0,-2,15,17,73
79,r_245_202_181,seq211,r_15_103_42,r_245_202_181,1.0,1,182,181,73
59,r_23_155_68,r_36_65_140,seq312,r_23_155_68,1.0,1,69,68,73
21,r_169_322_145,r_144_115_84,r_8_260_84,r_169_322_145,0.99,1,146,145,73
46,r_342_199_12,seq71,r_261_166_60,r_261_166_60,1.0,19,79,60,73
57,r_345_356_27,r_144_115_84,seq158,r_345_356_27,0.89,1,28,27,73
119,r_264_113_20,r_373_19_129,r_91_274_72,r_264_113_20,0.93,60,80,20,73
107,r_173_7_20,r_347_364_198,seq302,r_173_7_20,0.98,6,26,20,73
108,r_244_353_181,seq98,r_101_29_141,r_244_353_181,0.99,0,181,181,73
105,r_106_27_11,r_162_127_116,seq85,r_106_27_11,0.98,0,11,11,73
104,r_360_280_59,seq302,seq83,r_360_280_59,1.0,1,60,59,73
116,r_62_148_152,seq66,seq139,r_62_148_152,1.0,0,152,152,73
48,r_300_60_177,r_68_219_7,r_288_285_78,r_300_60_177,1.0,1,178,177,73
82,r_31_196_156,r_319_28_159,seq118,r_31_196_156,0.96,1,157,156,73
28,r_18_12_105,r_272_45_166,r_288_285_78,r_272_45_166,0.99,-60,106,166,73
141,seq55,r_238_126_63,r_117_281_31,r_238_126_63,1.0,0,63,63,73
72,r_232_326_109,r_95_208_125,r_8_260_84,r_95_208_125,0.99,-14,111,125,73
149,seq82,seq213,r_2_371_20,r_2_371_20,1.0,25,45,20,73
102,r_317_279_180,r_77_174_180,r_68_219_7,r_317_279_180,0.99,0,180,180,73
32,r_67_129_34,r_170_184_94,r_141_237_28,r_67_129_34,0.69,0,34,34,73
58,r_8_260_84,seq4,r_232_326_109,r_8_260_84,0.76,10,94,84,73
226,seq305,r_168_24_135,r_204_200_28,r_168_24_135,0.67,-49,86,135,73
7,r_162_127_116,r_49_75_125,r_123_286_27,r_162_127_116,1.0,1,117,116,73
13,r_3_50_34,r_8_260_84,seq211,r_3_50_34,0.86,0,34,34,73
60,r_319_28_159,seq266,r_277_197_17,r_319_28_159,1.0,0,159,159,73
188,seq181,r_287_332_9,r_207_72_34,r_207_72_34,1.0,-1,33,34,73
213,seq266,r_319_28_159,r_99_37_13,r_319_28_159,1.0,0,159,159,73
71,r_141_237_28,seq116,r_169_322_145,r_141_237_28,1.0,0,28,28,73
0,r_261_166_60,r_349_350_1,r_342_199_12,r_261_166_60,0.63,1,61,60,73
97,r_320_17_181,seq160,seq249,r_320_17_181,0.94,0,181,181,73
19,r_122_149_141,seq158,r_41_344_2,r_122_149_141,1.0,0,141,141,73
4,r_42_26_91,seq85,r_13_252_10,r_42_26_91,1.0,0,91,91,73
124,r_86_209_86,seq188,r_204_200_28,r_86_209_86,1.0,1,87,86,73
69,r_88_241_152,seq158,seq370,r_88_241_152,0.98,9,161,152,73
83,r_153_206_134,seq34,r_239_263_189,r_153_206_134,1.0,0,134,134,73
43,r_246_89_36,r_288_285_78,seq109,r_246_89_36,1.0,0,36,36,73
5,r_329_298_81,seq40,seq80,r_329_298_81,1.0,0,81,81,73
76,r_35_338_138,r_320_17_181,r_373_19_129,r_35_338_138,0.98,0,138,138,73
33,r_183_102_47,r_54_138_199,seq363,r_183_102_47,0.86,1,48,47,73
86,r_297_143_119,r_152_105_176,r_227_278_34,r_297_143_119,1.0,0,119,119,73
55,r_301_43_187,seq33,seq292,r_301_43_187,0.97,3,190,187,73
106,r_250_128_60,seq255,seq4,r_250_128_60,1.0,1,61,60,73
161,seq108,r_373_19_129,r_269_316_60,r_373_19_129,0.75,1,130,129,73
74,r_227_278_34,r_259_333_150,seq34,r_227_278_34,1.0,0,34,34,73
87,r_330_147_138,seq83,r_315_310_57,r_330_147_138,1.0,0,138,138,73
54,r_53_57_168,seq25,r_259_333_150,r_53_57_168,1.0,0,168,168,73
31,r_303_275_182,r_262_248_171,seq116,r_303_275_182,0.9,1,183,182,73
1,r_259_333_150,seq296,r_329_298_81,r_259_333_150,1.0,0,150,150,73
91,r_361_291_178,seq139,seq159,r_361_291_178,0.99,0,178,178,73
9,r_30_306_79,r_64_136_183,r_95_208_125,r_30_306_79,0.84,67,146,79,73
70,r_0_39_46,r_54_138_199,seq25,r_0_39_46,0.69,6,52,46,73
100,r_289_150_183,seq98,r_261_166_60,r_289_150_183,0.83,0,183,183,73
103,r_325_63_30,seq47,r_225_268_7,r_325_63_30,0.96,0,30,30,73
65,r_168_24_135,seq25,r_15_103_42,r_168_24_135,0.93,3,138,135,73
101,r_91_274_72,seq188,r_264_113_20,r_91_274_72,1.0,1,73,72,73
52,r_341_216_52,r_324_212_58,r_41_344_2,r_41_344_2,1.0,50,52,2,73
38,r_41_344_2,r_144_115_84,r_341_216_52,r_144_115_84,0.58,0,84,84,73
150,seq83,r_330_147_138,r_360_280_59,r_360_280_59,0.74,7,66,59,73
128,seq21,seq158,r_79_16_33,r_79_16_33,1.0,36,69,33,73
42,r_170_184_94,r_319_28_159,seq255,r_170_184_94,1.0,0,94,94,73
71,r_141_237_28,r_169_322_145,r_67_129_34,r_169_322_145,1.0,-23,122,145,73
227,seq307,r_144_115_84,r_41_344_2,r_144_115_84,1.0,0,84,84,73
24,r_68_219_7,r_300_60_177,r_317_279_180,r_68_219_7,0.97,173,180,7,73
45,r_36_65_140,seq107,r_10_151_98,r_36_65_140,0.96,1,141,140,73
129,seq22,r_64_136_183,seq163,r_64_136_183,0.66,0,183,183,73
96,r_194_134_16,r_91_274_72,r_13_252_10,r_194_134_16,0.92,-1,15,16,73
20,r_288_285_78,r_18_12_105,r_41_344_2,r_41_344_2,1.0,76,78,2,73
222,seq294,seq121,r_198_331_32,r_198_331_32,1.0,25,57,32,73
84,r_131_265_123,r_152_105_176,r_1_140_31,r_131_265_123,0.92,1,124,123,73
123,r_366_14_86,r_240_172_199,r_20_114_4,r_366_14_86,1.0,1,87,86,73
34,r_269_316_60,r_361_291_178,seq108,r_269_316_60,1.0,2,62,60,73
47,r_189_104_81,r_61_6_112,r_2_371_20,r_61_6_112,0.98,-30,82,112,73
88,r_324_212_58,seq21,seq181,r_324_212_58,1.0,2,60,58,73
11,r_10_151_98,seq312,seq318,r_10_151_98,1.0,0,98,98,73
177,seq142,seq4,r_190_203_102,r_190_203_102,0.74,4,106,102,73
75,r_247_73_112,seq292,r_277_197_17,r_247_73_112,1.0,0,112,112,73
25,r_315_310_57,r_95_208_125,seq171,r_315_310_57,0.94,1,58,57,73
10,r_351_192_109,seq195,r_358_256_115,r_358_256_115,0.99,5,120,115,73
15,r_352_179_154,r_76_230_159,r_8_260_84,r_8_260_84,0.99,71,155,84,73
89,r_2_371_20,r_183_102_47,seq82,r_2_371_20,0.75,1,21,20,73
37,r_64_136_183,seq22,r_76_230_159,r_76_230_159,0.62,24,183,159,73
67,r_74_335_89,r_169_322_145,seq58,r_74_335_89,0.96,2,91,89,73
35,r_177_217_5,seq55,r_117_281_31,r_117_281_31,0.91,14,45,31,73
3,r_1_140_31,r_261_166_60,seq4,r_1_140_31,0.9,1,32,31,73
50,r_15_103_42,r_228_167_153,seq158,r_228_167_153,0.94,-109,44,153,73
196,seq211,r_245_202_181,seq359,r_245_202_181,1.0,1,182,181,73
113,r_348_323_162,seq363,r_324_212_58,r_348_323_162,0.94,0,162,162,73
68,r_117_281_31,seq83,r_177_217_5,r_117_281_31,0.75,1,32,31,73
134,seq40,r_329_298_81,r_13_252_10,r_329_298_81,1.0,0,81,81,73
146,seq78,r_277_197_17,seq71,r_277_197_17,0.7,-3,14,17,73
78,r_277_197_17,seq255,r_247_73_112,r_247_73_112,1.0,5,117,112,73
9,r_30_306_79,seq292,r_64_136_183,r_30_306_79,0.98,4,83,79,73
14,r_373_19_129,seq108,r_100_11_38,r_373_19_129,1.0,1,130,129,73
8,r_144_115_84,seq307,seq195,r_144_115_84,1.0,0,84,84,73
61,r_132_59_81,r_77_174_180,seq119,r_132_59_81,1.0,0,81,81,73
36,r_77_174_180,r_317_279_180,seq66,r_317_279_180,0.91,-1,179,180,73
115,r_272_45_166,seq236,r_76_230_159,r_76_230_159,0.95,8,167,159,73
119,r_264_113_20,r_347_364_198,r_373_19_129,r_264_113_20,0.98,1,21,20,73
12,r_101_29_141,r_300_60_177,r_183_102_47,r_101_29_141,1.0,1,142,141,73
92,r_358_256_115,r_352_179_154,r_351_192_109,r_358_256_115,1.0,0,115,115,73
85,r_154_210_103,r_169_322_145,seq243,r_154_210_103,1.0,1,104,103,73
111,r_327_343_108,r_54_138_199,r_70_180_77,r_327_343_108,1.0,0,108,108,73
39,r_79_16_33,r_3_50_34,seq21,r_79_16_33,1.0,0,33,33,73
26,r_198_331_32,r_365_257_191,seq294,r_198_331_32,0.99,0,32,32,73
120,r_100_11_38,r_183_102_47,r_287_332_9,r_100_11_38,0.99,2,40,38,73
17,r_349_350_1,r_261_166_60,seq118,r_261_166_60,0.56,1,61,60,73
30,r_228_167_153,seq195,seq87,r_228_167_153,1.0,0,153,153,73
21,r_169_322_145,r_74_335_89,r_144_115_84,r_169_322_145,1.0,-54,91,145,73
118,r_321_367_46,r_373_19_129,seq255,r_373_19_129,1.0,-83,46,129,73
120,r_219_323_83,seq292,seq368,r_219_323_83,0.99,0,83,83,74
107,r_187_372_188,seq203,r_105_99_106,r_187_372_188,0.96,-6,182,188,74
101,r_356_59_175,r_184_189_104,r_105_99_106,r_356_59_175,0.99,0,175,175,74
184,seq181,r_184_189_104,r_164_127_64,r_164_127_64,0.8,6,70,64,74
83,r_93_139_101,seq295,r_7_229_55,r_93_139_101,1.0,0,101,101,74
54,r_214_68_72,r_3_335_145,seq180,r_214_68_72,1.0,3,75,72,74
40,r_362_209_95,r_23_17_193,seq149,r_362_209_95,1.0,0,95,95,74
17,r_75_167_170,seq108,r_360_4_31,r_75_167_170,0.99,-1,169,170,74
59,r_191_131_168,r_150_22_67,seq173,r_150_22_67,1.0,0,67,67,74
161,seq104,r_45_211_116,r_213_62_42,r_45_211_116,1.0,1,117,116,74
99,r_155_363_133,seq247,r_160_237_4,r_155_363_133,1.0,0,133,133,74
48,r_324_208_181,r_364_114_153,r_284_10_142,r_324_208_181,0.82,-1,180,181,74
27,r_188_326_25,r_89_355_159,r_354_276_158,r_188_326_25,1.0,136,161,25,74
45,r_26_28_19,r_49_263_161,r_370_101_113,r_26_28_19,0.99,0,19,19,74
4,r_235_115_160,seq130,r_81_272_60,r_235_115_160,1.0,1,161,160,74
24,r_129_218_16,r_188_326_25,seq246,r_188_326_25,0.84,-9,16,25,74
39,r_81_272_60,r_33_137_60,seq149,r_33_137_60,1.0,0,60,60,74
12,r_266_250_169,seq210,r_134_199_106,r_266_250_169,0.74,4,173,169,74
85,r_370_101_113,r_266_250_169,r_26_28_19,r_26_28_19,0.83,8,27,19,74
71,r_333_366_100,r_23_17_193,seq46,r_333_366_100,1.0,0,100,100,74
50,r_2_183_176,r_75_167_170,r_49_263_161,r_2_183_176,1.0,0,176,176,74
18,r_63_357_192,r_13_82_89,r_87_107_17,r_13_82_89,1.0,1,90,89,74
127,seq11,r_304_207_159,seq236,r_304_207_159,1.0,2,161,159,74
123,r_193_336_121,seq180,r_231_278_58,r_193_336_121,1.0,0,121,121,74
42,r_156_38_120,seq130,r_253_313_114,r_156_38_120,1.0,1,121,120,74
88,r_97_53_183,seq12,r_164_127_64,r_97_53_183,0.82,0,183,183,74
9,r_176_225_102,seq161,seq353,r_176_225_102,1.0,0,102,102,74
27,r_188_326_25,seq173,r_89_355_159,r_188_326_25,0.97,0,25,25,74
32,r_222_275_81,seq58,seq66,r_222_275_81,1.0,0,81,81,74
84,r_213_62_42,seq246,seq104,r_213_62_42,1.0,5,47,42,74
117,r_231_278_58,seq236,seq35,r_231_278_58,1.0,0,58,58,74
34,r_3_335_145,seq274,seq173,r_3_335_145,1.0,0,145,145,74
16,r_89_355_159,seq32,r_188_326_25,r_188_326_25,1.0,5,30,25,74
77,r_202_327_160,seq35,r_160_237_4,r_202_327_160,1.0,0,160,160,74
122,r_329_269_148,seq340,seq295,r_329_269_148,0.97,0,148,148,74
30,r_168_40_30,seq248,seq84,r_168_40_30,1.0,0,30,30,74
20,r_16_143_152,seq186,seq367,r_16_143_152,1.0,0,152,152,74
45,r_26_28_19,r_370_101_113,seq243,r_370_101_113,1.0,6,119,113,74
115,r_230_116_125,r_75_167_170,seq232,r_230_116_125,1.0,1,126,125,74
95,r_13_82_89,r_63_357_192,r_231_278_58,r_63_357_192,0.64,-102,90,192,74
91,r_91_320_109,r_159_267_138,seq37,r_91_320_109,1.0,0,109,109,74
111,r_159_267_138,seq203,r_27_80_57,r_159_267_138,1.0,0,138,138,74
109,r_33_137_60,r_81_272_60,seq77,r_33_137_60,1.0,0,60,60,74
121,r_239_21_185,seq8,seq180,r_239_21_185,0.99,0,185,185,74
103,r_7_229_55,r_291_374_174,seq162,r_7_229_55,1.0,0,55,55,74
38,r_205_347_86,r_57_287_97,r_141_318_4,r_57_287_97,0.69,-11,86,97,74
61,r_321_5_69,r_332_270_119,r_112_163_87,r_332_270_119,0.97,-14,105,119,74
6,r_87_107_17,r_196_95_188,seq246,r_87_107_17,0.99,0,17,17,74
96,r_119_142_44,r_239_21_185,seq210,r_119_142_44,1.0,0,44,44,74
35,r_346_258_72,seq243,seq108,r_346_258_72,1.0,0,72,72,74
90,r_364_114_153,seq212,r_157_69_71,r_364_114_153,0.61,-25,128,153,74
113,r_332_270_119,r_145_305_198,r_198_47_91,r_332_270_119,1.0,0,119,119,74
101,r_356_59_175,seq37,r_184_189_104,r_184_189_104,0.64,11,115,104,74
56,r_200_217_176,r_23_17_193,r_334_78_122,r_200_217_176,1.0,0,176,176,74
33,r_57_287_97,r_262_179_107,seq20,r_57_287_97,1.0,0,97,97,74
15,r_198_47_91,seq98,seq206,r_198_47_91,1.0,0,91,91,74
11,r_45_211_116,seq104,r_93_139_101,r_45_211_116,1.0,1,117,116,74
25,r_145_305_198,r_332_270_119,r_112_163_87,r_145_305_198,0.99,-93,105,198,74
76,r_253_313_114,r_145_305_198,r_156_38_120,r_253_313_114,1.0,7,121,114,74
82,r_54_273_68,seq277,seq210,r_54_273_68,0.82,0,68,68,74
81,r_344_309_179,seq181,r_49_263_161,r_344_309_179,0.75,0,179,179,74
100,r_90_365_121,r_141_318_4,r_70_177_112,r_90_365_121,1.0,0,121,121,74
61,r_321_5_69,r_105_99_106,r_332_270_119,r_321_5_69,0.86,1,70,69,74
59,r_191_131_168,seq173,seq42,r_191_131_168,0.93,0,168,168,74
112,r_360_4_31,r_222_275_81,seq76,r_360_4_31,1.0,0,31,31,74
87,r_223_345_115,seq76,seq111,r_223_345_115,1.0,0,115,115,74
5,r_260_153_50,r_23_17_193,seq368,r_260_153_50,1.0,0,50,50,74
31,r_196_95_188,seq20,r_266_250_169,r_196_95_188,0.87,0,188,188,74
118,r_170_74_82,r_45_211_116,r_360_4_31,r_170_74_82,1.0,0,82,82,74
94,r_56_73_18,r_222_275_81,seq85,r_56_73_18,1.0,-1,17,18,74
119,r_328_259_145,r_316_14_185,seq106,r_328_259_145,1.0,0,145,145,74
89,r_291_374_174,seq130,r_170_74_82,r_291_374_174,0.99,2,176,174,74
37,r_141_318_4,r_90_365_121,r_205_347_86,r_90_365_121,1.0,0,121,121,74
21,r_268_302_69,r_219_323_83,seq30,r_268_302_69,1.0,1,70,69,74
98,r_6_312_20,r_49_263_161,seq216,r_6_312_20,0.98,1,21,20,74
116,r_27_80_57,r_90_365_121,seq247,r_27_80_57,0.83,0,57,57,74
73,r_134_199_106,r_3_335_145,r_319_24_51,r_134_199_106,1.0,0,106,106,74
80,r_55_39_106,seq212,r_6_312_20,r_55_39_106,1.0,1,107,106,74
97,r_150_22_67,r_191_131_168,seq201,r_150_22_67,1.0,0,67,67,74
0,r_369_154_157,seq249,r_371_113_86,r_369_154_157,1.0,1,158,157,74
8,r_244_288_162,seq48,r_346_258_72,r_244_288_162,1.0,1,163,162,74
135,seq32,seq243,r_188_326_25,r_188_326_25,0.96,51,76,25,74
67,r_304_207_159,seq11,r_346_258_72,r_304_207_159,1.0,2,161,159,74
50,r_2_183_176,r_51_294_150,r_75_167_170,r_51_294_150,1.0,0,150,150,74
62,r_171_204_154,seq130,r_56_73_18,r_171_204_154,1.0,0,154,154,74
110,r_112_163_87,seq173,r_321_5_69,r_112_163_87,1.0,0,87,87,74
2,r_122_310_68,r_257_296_191,seq94,r_122_310_68,1.0,0,68,68,74
79,r_284_10_142,r_283_34_181,seq84,r_284_10_142,1.0,0,142,142,74
14,r_182_41_13,r_90_365_121,seq292,r_182_41_13,0.83,-1,12,13,74
7,r_227_172_99,seq88,r_7_229_55,r_227_172_99,1.0,0,99,99,74
177,seq161,seq264,r_185_301_52,r_185_301_52,1.0,6,58,52,74
41,r_331_174_142,seq147,seq194,r_331_174_142,1.0,1,143,142,74
124,r_164_127_64,r_135_144_169,seq181,r_164_127_64,1.0,0,64,64,74
85,r_370_101_113,r_26_28_19,r_150_22_67,r_370_101_113,1.0,1,114,113,74
58,r_50_286_105,r_358_307_185,seq232,r_50_286_105,1.0,0,105,105,74
108,r_238_110_49,seq71,seq169,r_238_110_49,1.0,0,49,49,74
16,r_89_355_159,r_188_326_25,seq249,r_89_355_159,1.0,2,161,159,74
93,r_70_177_112,r_2_183_176,seq166,r_70_177_112,1.0,0,112,112,74
72,r_184_189_104,r_356_59_175,r_91_320_109,r_356_59_175,1.0,-8,167,175,74
75,r_185_301_52,seq368,seq161,r_185_301_52,0.99,1,53,52,74
51,r_9_15_68,seq300,seq203,r_9_15_68,1.0,2,70,68,74
28,r_252_100_23,seq201,seq241,r_252_100_23,1.0,0,23,23,74
46,r_105_99_106,seq85,r_333_366_100,r_105_99_106,1.0,0,106,106,74
78,r_371_113_86,seq29,seq194,r_371_113_86,1.0,1,87,86,74
22,r_118_120_55,seq67,r_213_62_42,r_118_120_55,1.0,0,55,55,74
3,r_281_299_106,r_316_14_185,r_141_318_4,r_281_299_106,1.0,0,106,106,74
65,r_283_34_181,seq111,r_61_265_7,r_283_34_181,0.98,0,181,181,74
105,r_52_228_24,r_119_142_44,seq289,r_52_228_24,1.0,0,24,24,74
205,seq241,r_146_44_197,r_252_100_23,r_252_100_23,0.67,54,77,23,74
102,r_319_24_51,r_253_313_114,seq203,r_319_24_51,1.0,0,51,51,74
44,r_60_256_29,r_171_204_154,r_322_86_59,r_60_256_29,0.99,31,60,29,74
70,r_51_294_150,r_2_183_176,r_93_139_101,r_51_294_150,1.0,0,150,150,74
68,r_334_78_122,r_316_14_185,r_185_301_52,r_334_78_122,1.0,0,122,122,74
53,r_316_14_185,seq232,r_324_208_181,r_316_14_185,0.96,1,186,185,74
106,r_224_271_102,r_23_17_193,seq29,r_224_271_102,1.0,0,102,102,74
178,seq162,r_23_17_193,r_242_19_68,r_242_19_68,0.87,70,138,68,74
74,r_242_19_68,r_281_299_106,seq162,r_242_19_68,1.0,0,68,68,74
36,r_322_86_59,r_234_330_197,r_60_256_29,r_322_86_59,0.99,0,59,59,74
13,r_135_144_169,seq35,r_176_225_102,r_135_144_169,0.98,0,169,169,74
66,r_354_276_158,seq77,r_188_326_25,r_354_276_158,1.0,0,158,158,74
195,seq212,r_364_114_153,r_70_177_112,r_70_177_112,0.99,56,168,112,74
49,r_262_179_107,r_358_307_185,seq221,r_262_179_107,1.0,0,107,107,74
191,seq201,r_283_34_181,r_150_22_67,r_150_22_67,0.96,40,107,67,74
1,r_165_128_154,seq339,seq243,r_165_128_154,1.0,0,154,154,74
57,r_315_36_34,seq64,seq31,r_315_36_34,0.94,0,34,34,74
69,r_109_348_175,seq140,r_227_172_99,r_109_348_175,1.0,0,175,175,74
43,r_49_263_161,seq194,seq125,r_49_263_161,1.0,0,161,161,74
72,r_184_189_104,seq181,r_356_59_175,r_184_189_104,0.94,0,104,104,74
86,r_0_117_161,seq94,r_45_211_116,r_0_117_161,1.0,0,161,161,74
4,r_309_106_23,r_339_27_164,seq227,r_309_106_23,0.96,-1,22,23,75
54,r_226_345_96,seq100,r_101_62_27,r_226_345_96,1.0,0,96,96,75
21,r_91_256_103,r_167_99_193,r_7_243_58,r_91_256_103,1.0,1,104,103,75
18,r_28_72_102,r_115_214_155,seq61,r_28_72_102,1.0,0,102,102,75
123,r_293_83_166,seq327,r_215_39_4,r_293_83_166,0.99,0,166,166,75
128,seq12,r_26_225_126,r_125_20_58,r_26_225_126,0.51,-3,123,126,75
73,r_286_231_159,seq60,r_318_308_62,r_286_231_159,1.0,0,159,159,75
91,r_44_132_111,r_129_372_195,seq55,r_44_132_111,1.0,4,115,111,75
100,r_326_134_100,seq46,seq203,r_326_134_100,1.0,1,101,100,75
232,seq319,r_135_59_183,r_360_181_142,r_360_181_142,0.9,6,148,142,75
98,r_358_33_165,seq150,r_158_185_124,r_358_33_165,1.0,3,168,165,75
35,r_2_362_178,r_309_106_23,r_317_153_17,r_2_362_178,0.94,-160,18,178,75
78,r_157_209_40,r_50_298_40,seq162,r_157_209_40,1.0,0,40,40,75
122,r_348_103_23,r_255_35_46,seq357,r_348_103_23,0.99,-1,22,23,75
167,seq128,r_71_198_68,seq203,r_71_198_68,0.98,5,73,68,75
93,r_48_280_58,seq186,r_50_298_40,r_48_280_58,1.0,-1,57,58,75
28,r_339_27_164,r_54_169_197,r_91_256_103,r_339_27_164,0.93,6,170,164,75
13,r_228_299_190,seq41,r_202_120_104,r_228_299_190,0.98,0,190,190,75
96,r_206_142_101,r_9_232_187,r_331_205_71,r_206_142_101,1.0,0,101,101,75
6,r_122_37_183,seq295,r_312_131_131,r_122_37_183,0.99,-2,181,183,75
90,r_340_159_44,seq274,seq86,r_340_159_44,1.0,0,44,44,75
53,r_115_214_155,r_170_192_161,r_15_290_7,r_115_214_155,1.0,0,155,155,75
120,r_29_344_51,r_129_372_195,r_38_354_12,r_29_344_51,1.0,0,51,51,75
85,r_165_343_169,seq337,r_367_57_41,r_165_343_169,1.0,1,170,169,75
39,r_187_249_140,seq126,r_13_247_121,r_187_249_140,0.8,0,140,140,75
69,r_242_262_139,seq107,r_318_308_62,r_242_262_139,1.0,0,139,139,75
16,r_143_208_66,r_336_366_193,seq139,r_143_208_66,0.99,-1,65,66,75
77,r_267_189_121,r_339_27_164,r_14_119_78,r_267_189_121,0.74,0,121,121,75
74,r_264_10_39,r_175_291_173,seq250,r_264_10_39,1.0,0,39,39,75
116,r_349_109_38,seq126,seq90,r_349_109_38,1.0,-1,37,38,75
83,r_263_40_57,r_7_243_58,seq148,r_263_40_57,0.98,0,57,57,75
64,r_254_67_69,r_167_99_193,r_312_131_131,r_312_131_131,0.67,8,139,131,75
151,seq87,r_233_17_181,r_145_152_145,r_233_17_181,1.0,1,182,181,75
105,r_65_369_174,seq281,r_317_153_17,r_65_369_174,1.0,0,174,174,75
84,r_170_192_161,r_115_214_155,r_285_361_65,r_170_192_161,0.97,-4,157,161,75
71,r_38_354_12,r_251_97_36,r_195_171_190,r_38_354_12,1.0,0,12,12,75
10,r_80_31_13,r_233_17_181,r_144_105_4,r_80_31_13,0.84,0,13,13,75
46,r_317_153_17,r_155_234_186,r_2_362_178,r_317_153_17,0.93,0,17,17,75
55,r_255_35_46,r_76_266_170,seq224,r_255_35_46,1.0,0,46,46,75
9,r_294_172_145,seq250,r_318_308_62,r_294_172_145,1.0,0,145,145,75
29,r_233_17_181,seq87,r_158_185_124,r_233_17_181,1.0,1,182,181,75
51,r_325_184_152,r_129_372_195,r_91_256_103,r_325_184_152,1.0,4,156,152,75
1,r_4_30_104,seq183,r_80_31_13,r_4_30_104,1.0,1,105,104,75
31,r_135_59_183,r_363_78_189,r_353_18_119,r_135_59_183,0.56,2,185,183,75
15,r_312_131_131,r_173_221_18,r_44_132_111,r_312_131_131,1.0,0,131,131,75
2,r_50_298_40,r_353_18_119,seq75,r_50_298_40,1.0,-2,38,40,75
86,r_14_119_78,seq36,seq223,r_14_119_78,1.0,1,79,78,75
46,r_317_153_17,r_2_362_178,r_65_369_174,r_317_153_17,0.59,161,178,17,75
3,r_251_97_36,r_358_33_165,r_102_350_8,r_251_97_36,1.0,0,36,36,75
145,seq68,r_322_149_143,seq327,r_322_149_143,1.0,0,143,143,75
43,r_158_185_124,seq229,r_4_30_104,r_158_185_124,0.61,1,125,124,75
117,r_133_235_131,seq357,seq5,r_133_235_131,1.0,0,131,131,75
26,r_202_120_104,r_0_85_126,r_226_345_96,r_202_120_104,1.0,3,107,104,75
50,r_92_246_123,r_351_177_182,seq100,r_92_246_123,1.0,0,123,123,75
52,r_270_282_130,seq148,r_101_62_27,r_270_282_130,1.0,0,130,130,75
108,r_302_47_124,seq79,r_54_169_197,r_302_47_124,1.0,0,124,124,75
124,r_195_171_190,r_242_262_139,r_38_354_12,r_38_354_12,0.7,6,18,12,75
70,r_1_124_24,r_155_234_186,seq310,r_1_124_24,0.81,-2,22,24,75
63,r_252_136_123,seq319,r_202_120_104,r_252_136_123,0.96,0,123,123,75
104,r_82_210_111,r_195_171_190,r_50_298_40,r_82_210_111,1.0,0,111,111,75
66,r_125_20_58,r_133_235_131,r_43_161_53,r_125_20_58,0.99,0,58,58,75
81,r_173_221_18,r_122_37_183,r_312_131_131,r_173_221_18,0.95,0,18,18,75
5,r_51_22_91,seq224,seq250,r_51_22_91,1.0,0,91,91,75
36,r_70_164_150,r_129_372_195,seq98,r_70_164_150,1.0,1,151,150,75
109,r_113_77_138,r_336_366_193,r_13_247_121,r_113_77_138,0.93,0,138,138,75
232,seq319,r_252_136_123,r_135_59_183,r_252_136_123,1.0,0,123,123,75
71,r_38_354_12,r_195_171_190,r_145_152_145,r_195_171_190,0.89,0,190,190,75
35,r_2_362_178,r_317_153_17,r_353_18_119,r_2_362_178,0.97,0,178,178,75
62,r_360_181_142,seq166,seq319,r_360_181_142,0.99,1,143,142,75
23,r_145_152_145,r_175_291_173,r_38_354_12,r_145_152_145,0.55,0,145,145,75
15,r_312_131_131,r_321_216_199,r_173_221_18,r_173_221_18,1.0,0,18,18,75
22,r_367_57_41,r_322_149_143,r_167_99_193,r_367_57_41,0.81,0,41,41,75
89,r_76_266_170,seq313,r_51_22_91,r_76_266_170,0.99,0,170,170,75
111,r_175_291_173,seq34,r_54_169_197,r_175_291_173,1.0,0,173,173,75
45,r_154_245_175,seq275,r_157_209_40,r_154_245_175,0.95,1,176,175,75
24,r_259_146_121,seq148,seq46,r_259_146_121,1.0,0,121,121,75
99,r_278_3_154,r_339_27_164,r_353_18_119,r_278_3_154,0.74,4,158,154,75
33,r_353_18_119,r_6_305_165,r_331_205_71,r_353_18_119,0.99,1,120,119,75
119,r_43_161_53,seq162,seq12,r_43_161_53,1.0,0,53,53,75
59,r_331_205_71,r_104_315_67,seq347,r_104_315_67,1.0,-8,59,67,75
38,r_322_149_143,seq68,seq239,r_322_149_143,1.0,-1,142,143,75
225,seq297,seq162,r_157_209_40,r_157_209_40,1.0,0,40,40,75
87,r_0_85_126,r_336_366_193,seq337,r_0_85_126,1.0,0,126,126,75
68,r_204_93_108,r_135_59_183,r_28_72_102,r_135_59_183,0.93,-75,108,183,75
81,r_173_221_18,r_312_131_131,r_91_256_103,r_173_221_18,0.94,113,131,18,75
124,r_195_171_190,r_38_354_12,r_326_134_100,r_195_171_190,0.79,0,190,190,75
30,r_335_23_128,seq196,r_348_103_23,r_335_23_128,1.0,0,128,128,75
112,r_6_305_165,seq194,r_309_106_23,r_6_305_165,0.98,1,166,165,75
17,r_287_24_10,r_51_22_91,seq253,r_287_24_10,1.0,1,11,10,75
102,r_351_177_182,seq140,r_287_24_10,r_351_177_182,0.97,1,183,182,75
65,r_7_243_58,r_263_40_57,seq90,r_7_243_58,0.94,0,58,58,75
25,r_248_116_70,seq49,seq19,r_248_116_70,1.0,0,70,70,75
14,r_285_361_65,r_252_136_123,seq46,r_285_361_65,1.0,0,65,65,75
67,r_104_315_67,r_92_246_123,r_7_243_58,r_104_315_67,1.0,-1,66,67,75
95,r_330_138_64,seq147,seq123,r_330_138_64,1.0,0,64,64,75
113,r_338_359_162,seq327,r_335_23_128,r_335_23_128,0.66,38,166,128,75
11,r_151_371_114,r_261_332_28,seq179,r_151_371_114,1.0,0,114,114,75
103,r_307_323_145,seq141,seq230,r_307_323_145,1.0,0,145,145,75
178,seq162,seq297,r_157_209_40,r_157_209_40,1.0,0,40,40,75
32,r_74_81_108,seq61,r_91_256_103,r_74_81_108,1.0,0,108,108,75
110,r_174_271_142,seq203,r_263_40_57,r_174_271_142,1.0,0,142,142,75
42,r_182_108_136,seq347,r_13_247_121,r_13_247_121,0.93,25,146,121,75
94,r_9_232_187,seq203,r_94_110_1,r_9_232_187,0.81,0,187,187,75
76,r_328_288_44,r_7_243_58,seq241,r_328_288_44,1.0,0,44,44,75
82,r_283_265_48,r_65_369_174,r_331_205_71,r_283_265_48,1.0,2,50,48,75
58,r_71_198_68,seq128,seq327,r_71_198_68,1.0,-3,65,68,75
114,r_311_53_162,seq123,r_191_21_195,r_311_53_162,1.0,3,165,162,75
80,r_218_238_89,seq46,r_340_159_44,r_218_238_89,1.0,0,89,89,75
56,r_26_225_126,seq179,r_285_361_65,r_26_225_126,1.0,0,126,126,75
97,r_114_306_109,seq32,r_215_39_4,r_114_306_109,1.0,0,109,109,75
88,r_13_247_121,seq107,seq112,r_13_247_121,1.0,0,121,121,75
101,r_188_168_102,r_165_343_169,r_367_57_41,r_188_168_102,0.92,0,102,102,75
148,seq79,r_302_47_124,seq150,r_302_47_124,1.0,0,124,124,75
41,r_336_366_193,r_143_208_66,r_50_298_40,r_336_366_193,0.98,-136,57,193,75
12,r_333_25_158,seq274,r_28_72_102,r_333_25_158,1.0,1,159,158,75
8,r_318_308_62,r_51_22_91,seq11,r_318_308_62,0.99,-1,61,62,75
75,r_102_350_8,seq66,seq111,r_102_350_8,0.86,4,12,8,75
72,r_167_99_193,r_91_256_103,r_188_168_102,r_167_99_193,1.0,-89,104,193,75
93,r_158_121_59,r_371_199_168,seq184,r_158_121_59,1.0,1,60,59,76
44,r_264_276_130,r_116_0_181,r_74_332_87,r_264_276_130,1.0,0,130,130,76
73,r_298_1_12,r_65_240_51,seq10,r_298_1_12,1.0,0,12,12,76
7,r_263_363_69,r_230_6_170,r_273_350_133,r_263_363_69,0.93,103,172,69,76
34,r_267_304_32,r_17_145_113,r_131_274_48,r_17_145_113,1.0,2,115,113,76
199,seq223,r_74_332_87,seq210,r_74_332_87,0.99,1,88,87,76
69,r_280_259_45,r_263_363_69,r_166_39_58,r_263_363_69,0.84,0,69,69,76
23,r_106_25_84,r_337_160_178,seq236,r_106_25_84,0.98,1,85,84,76
49,r_357_233_154,seq120,r_32_129_74,r_357_233_154,0.79,3,157,154,76
57,r_134_349_164,r_291_102_1,r_4_331_86,r_134_349_164,1.0,1,165,164,76
13,r_96_128_146,seq219,r_67_271_53,r_96_128_146,1.0,0,146,146,76
88,r_329_87_19,r_247_209_110,seq133,r_329_87_19,0.95,0,19,19,76
120,r_191_282_12,r_220_232_117,r_211_308_99,r_191_282_12,1.0,90,102,12,76
10,r_185_281_47,r_134_349_164,r_309_341_32,r_134_349_164,1.0,-2,162,164,76
27,r_364_125_107,r_291_102_1,r_11_316_14,r_364_125_107,1.0,2,109,107,76
98,r_361_167_88,r_3_188_180,r_52_343_36,r_361_167_88,1.0,0,88,88,76
81,r_230_6_170,r_263_363_69,r_74_332_87,r_230_6_170,0.82,2,172,170,76
18,r_273_350_133,seq101,r_263_363_69,r_273_350_133,1.0,0,133,133,76
71,r_220_232_117,seq69,r_191_282_12,r_191_282_12,1.0,5,17,12,76
52,r_22_330_146,r_190_13_162,r_211_308_99,r_22_330_146,0.97,1,147,146,76
234,seq324,r_181_113_154,seq26,r_181_113_154,1.0,0,154,154,76
106,r_118_85_176,seq56,seq55,r_118_85_176,0.91,0,176,176,76
25,r_53_254_150,r_344_178_199,seq161,r_53_254_150,0.89,3,153,150,76
161,seq109,r_263_363_69,r_166_39_58,r_263_363_69,0.98,-26,43,69,76
24,r_116_0_181,seq189,r_291_102_1,r_116_0_181,0.85,0,181,181,76
120,r_191_282_12,r_150_58_125,r_220_232_117,r_191_282_12,1.0,0,12,12,76
114,r_234_305_122,r_65_240_51,r_147_110_54,r_234_305_122,1.0,1,123,122,76
111,r_166_39_58,r_172_253_172,r_280_259_45,r_166_39_58,0.86,2,60,58,76
94,r_29_175_131,seq292,r_267_304_32,r_29_175_131,1.0,1,132,131,76
9,r_217_136_150,r_213_173_46,seq38,r_217_136_150,1.0,0,150,150,76
11,r_99_107_77,seq325,seq260,r_99_107_77,0.97,3,80,77,76
82,r_32_129_74,r_172_253_172,seq7,r_32_129_74,1.0,0,74,74,76
99,r_148_66_70,r_169_30_107,r_95_261_96,r_148_66_70,1.0,0,70,70,76
244,seq360,r_31_19_187,r_99_107_77,r_31_19_187,1.0,-3,184,187,76
68,r_269_321_74,r_187_296_165,r_355_33_13,r_269_321_74,1.0,0,74,74,76
154,seq89,r_112_195_86,r_198_108_38,r_112_195_86,0.92,1,87,86,76
79,r_358_367_178,seq320,seq20,r_358_367_178,1.0,-2,176,178,76
55,r_213_173_46,r_217_136_150,r_32_129_74,r_217_136_150,1.0,0,150,150,76
8,r_62_72_18,seq86,r_298_1_12,r_62_72_18,0.99,0,18,18,76
110,r_119_362_37,seq260,seq14,r_119_362_37,1.0,0,37,37,76
42,r_247_209_110,seq184,r_141_23_26,r_247_209_110,1.0,0,110,110,76
35,r_65_240_51,r_234_305_122,seq184,r_234_305_122,1.0,-4,118,122,76
108,r_75_297_119,seq237,seq257,r_75_297_119,1.0,2,121,119,76
97,r_42_80_131,seq164,seq137,r_42_80_131,1.0,1,132,131,76
85,r_88_12_45,r_67_271_53,seq272,r_88_12_45,1.0,0,45,45,76
46,r_351_103_32,r_187_296_165,seq164,r_351_103_32,1.0,2,34,32,76
123,r_79_114_104,r_60_345_139,r_124_252_135,r_79_114_104,1.0,0,104,104,76
38,r_355_33_13,r_211_308_99,r_95_261_96,r_355_33_13,0.98,1,14,13,76
56,r_328_356_73,r_357_233_154,seq57,r_328_356_73,0.8,2,75,73,76
41,r_67_271_53,r_3_188_180,r_104_27_110,r_67_271_53,0.9,65,118,53,76
20,r_187_296_165,seq161,seq310,r_187_296_165,0.72,5,170,165,76
156,seq97,r_81_265_170,r_169_30_107,r_81_265_170,1.0,0,170,170,76
40,r_211_308_99,r_212_244_37,r_191_282_12,r_211_308_99,1.0,0,99,99,76
122,r_174_63_160,seq36,seq239,r_174_63_160,1.0,1,161,160,76
63,r_212_244_37,r_211_308_99,r_263_363_69,r_211_308_99,0.85,0,99,99,76
194,seq210,r_270_226_159,r_302_256_126,r_270_226_159,0.62,6,165,159,76
104,r_37_306_132,seq144,seq100,r_37_306_132,1.0,0,132,132,76
102,r_3_188_180,r_67_271_53,r_245_284_170,r_3_188_180,1.0,1,181,180,76
59,r_165_93_138,r_275_206_47,seq154,r_165_93_138,1.0,0,138,138,76
9,r_217_136_150,seq227,r_213_173_46,r_213_173_46,1.0,27,73,46,76
50,r_242_82_82,r_336_186_93,seq202,r_242_82_82,1.0,0,82,82,76
83,r_104_27_110,r_165_93_138,r_67_271_53,r_165_93_138,0.92,-19,119,138,76
96,r_159_179_41,r_187_296_165,seq155,r_159_179_41,1.0,0,41,41,76
31,r_74_332_87,seq223,seq268,r_74_332_87,1.0,1,88,87,76
204,seq239,seq325,r_174_63_160,r_174_63_160,1.0,10,170,160,76
21,r_163_258_135,r_323_216_182,r_181_113_154,r_163_258_135,0.83,20,155,135,76
195,seq218,r_291_102_1,r_294_34_117,r_294_34_117,1.0,0,117,117,76
138,seq38,seq71,r_11_316_14,r_11_316_14,1.0,2,16,14,76
107,r_11_316_14,r_318_279_98,seq38,r_11_316_14,1.0,0,14,14,76
64,r_172_253_172,seq10,r_247_209_110,r_172_253_172,0.98,0,172,172,76
35,r_65_240_51,r_357_233_154,r_234_305_122,r_65_240_51,0.97,3,54,51,76
60,r_190_13_162,seq7,r_314_77_112,r_190_13_162,0.99,1,163,162,76
45,r_131_274_48,seq325,r_267_304_32,r_131_274_48,0.99,0,48,48,76
170,seq144,r_37_306_132,r_204_342_59,r_37_306_132,0.99,0,132,132,76
119,r_162_146_78,r_165_93_138,seq219,r_162_146_78,1.0,0,78,78,76
71,r_220_232_117,r_191_282_12,seq285,r_220_232_117,1.0,0,117,117,76
103,r_180_369_27,r_187_296_165,seq197,r_180_369_27,1.0,1,28,27,76
34,r_267_304_32,r_198_108_38,r_17_145_113,r_267_304_32,1.0,1,33,32,76
16,r_115_76_161,seq51,r_174_63_160,r_115_76_161,0.62,2,163,161,76
59,r_165_93_138,r_104_27_110,r_275_206_47,r_275_206_47,1.0,11,58,47,76
65,r_135_214_91,r_337_160_178,seq71,r_135_214_91,1.0,1,92,91,76
63,r_212_244_37,r_275_206_47,r_211_308_99,r_275_206_47,0.74,-9,38,47,76
48,r_31_19_187,seq360,r_337_160_178,r_31_19_187,1.0,0,187,187,76
74,r_215_208_157,r_194_59_69,r_307_303_143,r_215_208_157,1.0,0,157,157,76
129,seq10,r_172_253_172,r_298_1_12,r_298_1_12,1.0,0,12,12,76
114,r_234_305_122,r_247_209_110,r_65_240_51,r_65_240_51,0.9,4,55,51,76
91,r_336_186_93,seq5,r_355_33_13,r_336_186_93,1.0,0,93,93,76
30,r_245_284_170,seq154,r_42_80_131,r_245_284_170,1.0,0,170,170,76
115,r_225_339_78,r_95_261_96,r_191_282_12,r_225_339_78,1.0,1,79,78,76
81,r_230_6_170,r_212_244_37,r_263_363_69,r_263_363_69,1.0,0,69,69,76
10,r_185_281_47,r_371_199_168,r_134_349_164,r_185_281_47,1.0,2,49,47,76
157,seq98,r_134_349_164,r_291_102_1,r_134_349_164,1.0,1,165,164,76
29,r_48_9_148,seq285,r_45_231_107,r_48_9_148,1.0,0,148,148,76
124,r_169_30_107,seq100,seq97,r_169_30_107,0.74,26,133,107,76
105,r_44_28_178,seq161,r_74_332_87,r_44_28_178,0.65,0,178,178,76
43,r_156_249_102,seq315,r_49_83_22,r_156_249_102,1.0,3,105,102,76
58,r_352_196_169,r_127_94_195,r_138_61_109,r_352_196_169,0.99,0,169,169,76
121,r_334_200_74,r_142_326_73,r_67_271_53,r_67_271_53,0.87,33,86,53,76
7,r_263_363_69,r_4_331_86,r_230_6_170,r_263_363_69,0.75,0,69,69,76
118,r_112_195_86,seq89,seq184,r_112_195_86,1.0,1,87,86,76
84,r_140_123_190,r_95_261_96,r_187_296_165,r_140_123_190,0.67,0,190,190,76
32,r_235_359_146,r_270_226_159,r_318_279_98,r_270_226_159,0.97,-13,146,159,76
55,r_213_173_46,r_263_363_69,r_217_136_150,r_213_173_46,0.64,5,51,46,76
5,r_337_160_178,seq157,r_169_30_107,r_169_30_107,0.55,73,180,107,76
0,r_275_206_47,r_165_93_138,r_138_61_109,r_165_93_138,1.0,0,138,138,76
86,r_277_143_109,r_53_254_150,r_177_372_71,r_177_372_71,1.0,38,109,71,76
28,r_49_83_22,r_234_305_122,r_329_87_19,r_234_305_122,0.96,-100,22,122,76
90,r_177_372_71,r_48_9_148,seq370,r_177_372_71,0.97,0,71,71,76
2,r_318_279_98,seq370,r_62_72_18,r_318_279_98,1.0,0,98,98,76
40,r_211_308_99,r_355_33_13,r_212_244_37,r_355_33_13,0.66,1,14,13,76
22,r_81_265_170,seq97,r_309_341_32,r_81_265_170,0.99,0,170,170,76
92,r_204_342_59,r_215_208_157,seq144,r_204_342_59,1.0,0,59,59,76
0,r_275_206_47,r_183_295_67,r_165_93_138,r_275_206_47,1.0,0,47,47,76
148,seq68,r_138_61_109,r_314_77_112,r_138_61_109,0.83,0,109,109,76
116,r_238_346_136,seq56,r_289_50_8,r_238_346_136,0.55,1,137,136,76
69,r_280_259_45,r_165_93_138,r_263_363_69,r_280_259_45,0.96,0,45,45,76
87,r_344_178_199,r_53_254_150,r_163_258_135,r_53_254_150,0.95,3,153,150,76
77,r_45_231_107,r_187_296_165,seq56,r_45_231_107,0.99,2,109,107,76
51,r_309_341_32,r_371_199_168,seq36,r_309_341_32,1.0,0,32,32,76
47,r_307_303_143,seq55,r_204_342_59,r_307_303_143,1.0,0,143,143,76
190,seq202,r_371_199_168,r_242_82_82,r_242_82_82,0.99,25,107,82,76
222,seq292,r_29_175_131,r_106_25_84,r_29_175_131,0.88,1,132,131,76
112,r_302_256_126,r_187_296_165,seq210,r_302_256_126,0.88,-4,122,126,76
109,r_4_331_86,seq137,seq236,r_4_331_86,1.0,0,86,86,76
113,r_17_145_113,seq260,r_67_271_53,r_17_145_113,0.99,2,115,113,76
53,r_262_317_185,seq14,seq26,r_262_317_185,1.0,0,185,185,76
66,r_147_110_54,r_270_226_159,seq360,r_147_110_54,1.0,0,54,54,76
41,r_67_271_53,r_37_306_132,r_3_188_180,r_67_271_53,0.99,0,53,53,76
6,r_150_58_125,r_42_80_131,seq184,r_150_58_125,1.0,-2,123,125,76
61,r_15_287_181,seq236,r_150_58_125,r_15_287_181,0.98,1,182,181,76
36,r_183_295_67,seq290,seq130,r_183_295_67,1.0,0,67,67,76
19,r_198_108_38,r_242_82_82,seq89,r_198_108_38,0.75,2,40,38,76
62,r_224_24_138,r_44_28_178,r_242_82_82,r_224_24_138,0.78,0,138,138,76
238,seq338,r_150_58_125,r_138_61_109,r_150_58_125,1.0,-2,123,125,76
1,r_270_226_159,seq210,r_45_231_107,r_270_226_159,0.85,6,165,159,76
80,r_294_34_117,seq56,seq218,r_294_34_117,1.0,0,117,117,76
102,r_3_188_180,r_361_167_88,r_67_271_53,r_3_188_180,0.53,-113,67,180,76
72,r_46_313_183,seq8,r_126_170_40,r_46_313_183,1.0,0,183,183,76
67,r_181_113_154,seq324,r_163_258_135,r_181_113_154,1.0,0,154,154,76
100,r_250_84_43,r_116_0_181,r_95_261_96,r_250_84_43,1.0,0,43,43,76
111,r_81_257_15,r_2_318_199,seq173,r_81_257_15,1.0,0,15,15,77
49,r_35_90_143,seq236,r_54_71_70,r_35_90_143,1.0,0,143,143,77
66,r_353_274_100,seq14,r_202_10_112,r_202_10_112,0.99,12,124,112,77
90,r_363_116_30,r_120_163_181,seq31,r_363_116_30,1.0,0,30,30,77
21,r_68_191_108,seq174,r_75_203_71,r_68_191_108,1.0,0,108,108,77
114,r_334_93_175,seq89,seq19,r_334_93_175,0.98,0,175,175,77
11,r_153_62_102,r_340_351_119,seq77,r_153_62_102,1.0,0,102,102,77
50,r_172_231_49,r_314_317_107,seq254,r_172_231_49,1.0,0,49,49,77
63,r_340_351_119,seq109,r_133_86_67,r_133_86_67,0.89,54,121,67,77
65,r_168_246_188,seq146,r_16_73_165,r_168_246_188,0.84,0,188,188,77
85,r_243_255_106,seq48,r_301_331_61,r_243_255_106,1.0,0,106,106,77
73,r_115_372_159,seq108,r_96_82_23,r_115_372_159,1.0,0,159,159,77
56,r_162_374_115,r_256_98_145,r_222_267_82,r_162_374_115,0.91,1,116,115,77
59,r_301_331_61,seq307,seq7,r_301_331_61,1.0,0,61,61,77
102,r_13_111_139,seq285,seq14,r_13_111_139,1.0,0,139,139,77
121,r_176_171_90,r_2_318_199,seq205,r_176_171_90,1.0,2,92,90,77
84,r_276_252_75,r_243_255_106,seq113,r_243_255_106,1.0,-25,81,106,77
156,seq89,r_334_93_175,r_265_190_37,r_334_93_175,0.88,0,175,175,77
216,seq279,seq8,r_53_298_131,r_53_298_131,1.0,5,136,131,77
100,r_72_159_143,seq99,r_256_98_145,r_256_98_145,1.0,1,146,145,77
101,r_189_349_103,r_25_208_116,seq150,r_189_349_103,1.0,0,103,103,77
122,r_145_61_44,r_72_159_143,seq128,r_145_61_44,1.0,0,44,44,77
0,r_352_51_120,seq244,seq350,r_352_51_120,1.0,0,120,120,77
16,r_282_261_74,r_308_12_123,r_172_231_49,r_172_231_49,1.0,35,84,49,77
95,r_117_121_171,seq329,r_102_365_14,r_117_121_171,1.0,2,173,171,77
1,r_314_317_107,seq77,r_81_257_15,r_314_317_107,1.0,0,107,107,77
36,r_265_190_37,r_300_123_187,seq158,r_265_190_37,1.0,1,38,37,77
97,r_78_272_87,r_308_12_123,r_96_82_23,r_78_272_87,1.0,1,88,87,77
105,r_250_305_137,r_300_123_187,r_100_360_137,r_250_305_137,1.0,0,137,137,77
68,r_206_50_165,r_24_6_171,r_297_200_113,r_24_6_171,1.0,-6,165,171,77
9,r_40_52_120,r_335_91_3,seq20,r_40_52_120,1.0,2,122,120,77
35,r_278_259_58,r_202_10_112,r_67_373_57,r_278_259_58,1.0,0,58,58,77
103,r_369_185_61,r_162_374_115,seq288,r_369_185_61,1.0,-1,60,61,77
78,r_67_373_57,r_13_111_139,seq167,r_67_373_57,1.0,0,57,57,77
80,r_132_248_114,seq22,r_30_253_82,r_132_248_114,1.0,0,114,114,77
166,seq126,r_297_200_113,seq17,r_297_200_113,1.0,1,114,113,77
181,seq158,r_233_209_177,r_265_190_37,r_265_190_37,0.87,8,45,37,77
120,r_134_280_119,seq150,seq258,r_134_280_119,1.0,0,119,119,77
116,r_57_275_29,seq170,seq89,r_57_275_29,1.0,0,29,29,77
27,r_277_338_53,r_207_283_161,seq324,r_277_338_53,0.92,-1,52,53,77
109,r_43_181_42,r_223_195_175,seq254,r_43_181_42,1.0,2,44,42,77
40,r_289_266_119,r_0_240_143,seq70,r_289_266_119,1.0,0,119,119,77
108,r_54_71_70,r_177_269_88,seq371,r_54_71_70,1.0,0,70,70,77
31,r_297_200_113,seq126,seq70,r_297_200_113,1.0,1,114,113,77
124,r_234_345_57,r_23_341_122,r_335_91_3,r_234_345_57,1.0,0,57,57,77
28,r_25_208_116,r_189_349_103,r_0_240_143,r_189_349_103,0.84,-7,96,103,77
54,r_188_83_61,r_202_10_112,seq285,r_188_83_61,1.0,0,61,61,77
115,r_339_142_94,r_206_50_165,seq218,r_339_142_94,1.0,1,95,94,77
72,r_313_136_33,seq327,seq32,r_313_136_33,1.0,0,33,33,77
52,r_229_107_103,seq33,seq7,r_229_107_103,1.0,0,103,103,77
38,r_148_210_23,r_59_193_24,seq108,r_148_210_23,0.98,5,28,23,77
14,r_220_49_66,r_11_147_159,r_41_69_41,r_220_49_66,0.92,0,66,66,77
37,r_186_355_113,r_308_12_123,seq17,r_186_355_113,1.0,1,114,113,77
112,r_271_187_179,seq7,r_179_4_52,r_271_187_179,1.0,0,179,179,77
208,seq242,seq258,r_233_209_177,r_233_209_177,0.59,5,182,177,77
26,r_11_147_159,seq151,seq316,r_11_147_159,1.0,1,160,159,77
93,r_133_86_67,r_166_239_182,seq201,r_133_86_67,1.0,0,67,67,77
123,r_300_123_187,seq273,r_344_319_58,r_300_123_187,0.87,1,188,187,77
10,r_202_10_112,r_104_92_114,r_270_110_35,r_202_10_112,1.0,0,112,112,77
41,r_179_4_52,seq70,r_361_342_193,r_179_4_52,1.0,0,52,52,77
53,r_222_267_82,seq9,r_65_359_198,r_222_267_82,1.0,1,83,82,77
110,r_36_3_28,r_233_209_177,seq14,r_36_3_28,1.0,0,28,28,77
76,r_215_26_98,r_132_248_114,seq144,r_215_26_98,1.0,2,100,98,77
83,r_103_310_147,seq323,seq70,r_103_310_147,1.0,0,147,147,77
60,r_270_110_35,r_344_319_58,r_308_12_123,r_308_12_123,1.0,-88,35,123,77
33,r_344_319_58,r_184_211_154,seq174,r_344_319_58,1.0,0,58,58,77
15,r_34_197_187,seq14,r_23_341_122,r_34_197_187,0.72,1,188,187,77
8,r_23_341_122,r_120_163_181,r_367_165_62,r_23_341_122,0.94,1,123,122,77
117,r_232_28_158,seq201,r_102_365_14,r_232_28_158,1.0,0,158,158,77
77,r_245_228_186,seq125,r_27_106_174,r_245_228_186,0.97,1,187,186,77
199,seq218,r_207_283_161,r_339_142_94,r_339_142_94,0.99,2,96,94,77
119,r_347_281_115,r_25_208_116,r_68_191_108,r_68_191_108,1.0,7,115,108,77
92,r_63_346_182,r_216_129_195,r_102_365_14,r_63_346_182,1.0,0,182,182,77
67,r_155_315_58,r_46_263_72,r_270_110_35,r_270_110_35,0.98,23,58,35,77
98,r_24_6_171,seq17,r_215_26_98,r_24_6_171,1.0,2,173,171,77
107,r_303_114_48,r_352_51_120,seq180,r_303_114_48,1.0,0,48,48,77
86,r_184_211_154,r_334_93_175,r_188_83_61,r_184_211_154,1.0,1,155,154,77
71,r_247_21_159,r_27_106_174,r_297_200_113,r_247_21_159,1.0,0,159,159,77
69,r_41_69_41,r_245_228_186,seq311,r_41_69_41,1.0,1,42,41,77
223,seq292,seq170,r_141_251_35,r_141_251_35,1.0,9,44,35,77
145,seq48,r_243_255_106,seq258,r_243_255_106,1.0,0,106,106,77
30,r_166_239_182,seq225,r_2_318_199,r_166_239_182,1.0,0,182,182,77
29,r_223_195_175,seq1,r_335_91_3,r_223_195_175,1.0,0,175,175,77
42,r_207_283_161,seq218,r_134_280_119,r_207_283_161,0.87,3,164,161,77
32,r_152_241_59,seq9,r_303_114_48,r_152_241_59,0.94,0,59,59,77
74,r_366_182_130,seq254,r_308_12_123,r_366_182_130,0.92,0,130,130,77
44,r_354_169_170,seq254,r_222_267_82,r_354_169_170,0.98,0,170,170,77
94,r_124_87_39,seq262,seq151,r_124_87_39,0.97,1,40,39,77
211,seq258,seq196,r_134_280_119,r_134_280_119,1.0,21,140,119,77
4,r_217_330_100,r_361_342_193,r_222_267_82,r_217_330_100,1.0,0,100,100,77
7,r_102_365_14,r_202_10_112,seq285,r_102_365_14,0.96,0,14,14,77
79,r_293_358_31,r_297_200_113,r_302_76_12,r_293_358_31,0.99,1,32,31,77
47,r_233_209_177,seq316,seq242,r_233_209_177,1.0,0,177,177,77
57,r_75_203_71,seq77,r_68_191_108,r_68_191_108,1.0,16,124,108,77
106,r_59_193_24,r_148_210_23,seq196,r_59_193_24,0.99,4,28,24,77
70,r_177_269_88,seq70,seq64,r_177_269_88,1.0,0,88,88,77
113,r_30_253_82,seq178,seq9,r_30_253_82,1.0,1,83,82,77
34,r_53_298_131,seq143,seq279,r_53_298_131,1.0,0,131,131,77
43,r_16_73_165,seq226,r_369_185_61,r_16_73_165,1.0,0,165,165,77
51,r_141_251_35,r_179_4_52,seq292,r_141_251_35,0.94,0,35,35,77
57,r_75_203_71,r_256_98_145,seq77,r_75_203_71,1.0,0,71,71,77
99,r_361_342_193,r_217_330_100,r_179_4_52,r_361_342_193,1.0,-125,68,193,77
28,r_25_208_116,r_0_240_143,r_153_62_102,r_25_208_116,0.99,0,116,116,77
104,r_65_359_198,r_233_209_177,r_222_267_82,r_222_267_82,0.74,6,88,82,77
82,r_58_66_168,r_0_240_143,r_297_200_113,r_58_66_168,1.0,0,168,168,77
58,r_0_240_143,r_289_266_119,r_363_116_30,r_289_266_119,1.0,-12,107,119,77
2,r_120_163_181,seq180,r_220_49_66,r_120_163_181,0.79,0,181,181,77
3,r_5_230_171,r_198_224_193,r_270_110_35,r_5_230_171,1.0,1,172,171,77
62,r_256_98_145,seq60,r_313_136_33,r_256_98_145,1.0,0,145,145,77
6,r_204_101_64,r_25_208_116,r_96_82_23,r_204_101_64,0.98,0,64,64,77
55,r_96_82_23,r_58_66_168,seq327,r_96_82_23,0.97,1,24,23,77
22,r_367_165_62,r_177_269_88,seq273,r_367_165_62,1.0,0,62,62,77
45,r_322_56_131,seq329,seq33,r_322_56_131,0.97,0,131,131,77
87,r_27_106_174,seq130,r_118_299_6,r_27_106_174,1.0,2,176,174,77
163,seq113,r_223_195_175,r_276_252_75,r_223_195_175,0.84,-90,85,175,77
36,r_188_38_185,r_46_261_95,r_65_262_144,r_188_38_185,0.73,0,185,185,78
50,r_223_21_86,seq229,r_327_143_69,r_223_21_86,1.0,5,91,86,78
124,r_8_251_107,r_309_168_162,seq283,r_8_251_107,1.0,0,107,107,78
106,r_22_114_139,seq130,seq27,r_22_114_139,1.0,0,139,139,78
196,seq182,r_17_147_96,r_92_374_17,r_17_147_96,1.0,0,96,96,78
45,r_301_157_80,r_364_205_171,seq257,r_301_157_80,1.0,0,80,80,78
22,r_252_361_85,seq165,seq28,r_252_361_85,1.0,-2,83,85,78
35,r_342_141_173,r_225_210_124,r_267_67_41,r_225_210_124,0.99,2,126,124,78
57,r_302_282_22,r_296_215_198,r_350_245_41,r_350_245_41,0.97,30,71,41,78
120,r_204_75_89,r_298_218_152,seq206,r_204_75_89,1.0,0,89,89,78
103,r_62_90_69,r_298_218_152,seq244,r_62_90_69,1.0,0,69,69,78
6,r_326_278_160,r_49_190_175,r_216_43_141,r_326_278_160,1.0,2,162,160,78
122,r_149_115_162,seq201,r_40_123_139,r_149_115_162,1.0,0,162,162,78
35,r_342_141_173,r_267_67_41,r_51_369_59,r_342_141_173,0.88,1,174,173,78
96,r_324_228_145,r_61_72_146,r_277_243_103,r_61_72_146,0.84,1,147,146,78
54,r_3_281_160,r_23_100_196,r_371_263_154,r_23_100_196,0.69,-36,160,196,78
20,r_113_286_56,r_159_291_14,seq41,r_113_286_56,0.93,0,56,56,78
65,r_276_289_63,r_155_81_189,seq359,r_276_289_63,1.0,0,63,63,78
198,seq195,r_209_221_92,seq125,r_209_221_92,1.0,0,92,92,78
49,r_54_268_56,seq130,r_311_99_16,r_54_268_56,0.99,0,56,56,78
110,r_373_116_21,seq13,r_285_335_25,r_373_116_21,0.97,0,21,21,78
248,seq359,r_311_99_16,r_276_289_63,r_276_289_63,1.0,0,63,63,78
61,r_71_230_150,r_232_183_176,r_317_235_85,r_71_230_150,0.97,9,159,150,78
111,r_277_243_103,r_367_307_10,r_87_117_55,r_277_243_103,0.82,1,104,103,78
64,r_36_194_81,r_252_361_85,seq175,r_36_194_81,0.87,0,81,81,78
15,r_138_180_97,r_97_174_172,r_144_250_93,r_97_174_172,1.0,-75,97,172,78
46,r_156_89_65,r_310_119_178,seq370,r_156_89_65,1.0,0,65,65,78
2,r_173_185_49,seq151,seq13,r_173_185_49,1.0,0,49,49,78
82,r_166_231_84,seq44,r_264_184_6,r_166_231_84,1.0,0,84,84,78
43,r_179_265_38,r_364_205_171,seq108,r_179_265_38,1.0,0,38,38,78
95,r_109_77_73,seq178,r_193_259_40,r_109_77_73,0.98,0,73,73,78
37,r_352_303_126,r_216_43_141,seq106,r_352_303_126,1.0,0,126,126,78
3,r_39_20_112,r_242_360_196,seq175,r_39_20_112,0.99,0,112,112,78
14,r_309_168_162,r_8_251_107,seq182,r_8_251_107,1.0,0,107,107,78
86,r_93_271_93,r_17_147_96,r_366_365_41,r_93_271_93,0.99,0,93,93,78
242,seq346,seq130,r_65_262_144,r_65_262_144,1.0,9,153,144,78
205,seq208,r_317_235_85,r_372_82_70,r_317_235_85,1.0,1,86,85,78
56,r_313_318_148,r_232_183_176,seq133,r_313_318_148,0.95,1,149,148,78
4,r_5_34_139,seq28,seq9,r_5_34_139,1.0,0,139,139,78
32,r_330_102_35,seq73,seq293,r_330_102_35,0.95,4,39,35,78
121,r_193_259_40,r_211_197_192,seq12,r_193_259_40,1.0,0,40,40,78
105,r_298_218_152,r_204_75_89,r_260_280_90,r_298_218_152,0.99,-63,89,152,78
1,r_94_68_137,r_3_281_160,seq201,r_94_68_137,1.0,0,137,137,78
17,r_7_124_132,seq269,r_173_185_49,r_7_124_132,1.0,0,132,132,78
109,r_92_374_17,r_211_197_192,seq88,r_92_374_17,0.87,1,18,17,78
8,r_333_32_70,r_317_235_85,seq137,r_333_32_70,1.0,0,70,70,78
40,r_163_258_181,seq55,r_363_85_113,r_163_258_181,0.92,3,184,181,78
77,r_272_256_169,seq295,r_86_248_3,r_272_256_169,1.0,0,169,169,78
73,r_95_339_184,seq12,r_342_141_173,r_95_339_184,0.92,0,184,184,78
44,r_56_79_180,r_301_157_80,seq240,r_56_79_180,0.85,0,180,180,78
42,r_40_123_139,seq175,seq288,r_40_123_139,1.0,0,139,139,78
105,r_298_218_152,r_260_280_90,r_92_374_17,r_298_218_152,0.81,14,166,152,78
89,r_312_316_197,r_246_172_130,seq42,r_246_172_130,1.0,0,130,130,78
118,r_246_172_130,r_312_316_197,r_292_110_52,r_246_172_130,1.0,0,130,130,78
185,seq154,seq140,r_332_319_81,r_332_319_81,1.0,6,87,81,78
20,r_113_286_56,r_39_20_112,r_159_291_14,r_159_291_14,0.78,0,14,14,78
76,r_225_210_124,r_342_141_173,seq140,r_225_210_124,1.0,2,126,124,78
66,r_296_215_198,seq269,r_350_245_41,r_350_245_41,0.9,62,103,41,78
47,r_371_263_154,r_364_205_171,seq299,r_371_263_154,0.72,0,154,154,78
94,r_362_266_139,seq145,seq104,r_362_266_139,1.0,0,139,139,78
78,r_61_72_146,r_324_228_145,r_357_181_36,r_61_72_146,1.0,1,147,146,78
92,r_270_161_175,seq358,r_285_335_25,r_270_161_175,1.0,0,175,175,78
29,r_356_16_144,r_56_79_180,r_138_180_97,r_356_16_144,0.69,3,147,144,78
116,r_87_117_55,r_65_262_144,seq214,r_87_117_55,1.0,2,57,55,78
18,r_274_345_140,seq299,r_51_369_59,r_274_345_140,1.0,1,141,140,78
72,r_285_335_25,seq140,r_373_116_21,r_285_335_25,0.52,0,25,25,78
38,r_4_64_43,r_347_189_193,seq198,r_4_64_43,1.0,0,43,43,78
79,r_51_369_59,r_48_57_193,seq244,r_51_369_59,1.0,2,61,59,78
70,r_310_119_178,seq42,r_241_14_175,r_310_119_178,0.98,0,178,178,78
107,r_216_43_141,seq198,seq295,r_216_43_141,1.0,2,143,141,78
30,r_232_183_176,r_71_230_150,r_331_323_135,r_232_183_176,0.71,0,176,176,78
5,r_317_235_85,seq208,seq229,r_317_235_85,1.0,1,86,85,78
90,r_241_14_175,r_290_368_197,r_302_282_22,r_241_14_175,0.99,0,175,175,78
67,r_153_1_61,r_209_221_92,seq130,r_153_1_61,0.82,0,61,61,78
99,r_144_250_93,r_274_345_140,seq170,r_144_250_93,1.0,0,93,93,78
9,r_366_365_41,r_196_58_55,seq294,r_366_365_41,0.99,0,41,41,78
83,r_254_306_179,seq257,r_366_365_41,r_254_306_179,1.0,0,179,179,78
39,r_97_174_172,r_91_322_187,r_213_239_72,r_97_174_172,0.94,4,176,172,78
55,r_49_190_175,r_128_35_190,r_298_218_152,r_49_190_175,0.99,0,175,175,78
53,r_267_67_41,r_342_141_173,r_138_180_97,r_267_67_41,0.86,133,174,41,78
233,seq299,r_274_345_140,seq358,r_274_345_140,1.0,1,141,140,78
131,seq13,r_364_205_171,r_173_185_49,r_173_185_49,0.97,8,57,49,78
119,r_0_199_61,seq74,seq19,r_0_199_61,1.0,0,61,61,78
100,r_334_255_87,r_188_38_185,r_107_220_11,r_334_255_87,0.82,4,91,87,78
27,r_260_280_90,seq202,seq80,r_260_280_90,1.0,0,90,90,78
0,r_158_50_49,r_309_168_162,seq219,r_158_50_49,0.57,5,54,49,78
98,r_344_234_16,seq240,r_264_184_6,r_344_234_16,0.9,2,18,16,78
176,seq133,r_46_261_95,r_313_318_148,r_313_318_148,0.98,9,157,148,78
52,r_328_63_135,seq9,seq219,r_328_63_135,0.66,5,140,135,78
11,r_177_187_98,seq338,seq164,r_177_187_98,1.0,0,98,98,78
80,r_59_127_32,r_364_205_171,seq343,r_59_127_32,1.0,0,32,32,78
113,r_350_245_41,seq164,r_302_282_22,r_350_245_41,1.0,0,41,41,78
220,seq257,r_254_306_179,r_301_157_80,r_254_306_179,0.98,0,179,179,78
12,r_292_110_52,seq359,seq69,r_292_110_52,1.0,1,53,52,78
13,r_209_221_92,seq195,seq249,r_209_221_92,1.0,0,92,92,78
57,r_302_282_22,r_356_16_144,r_296_215_198,r_302_282_22,1.0,0,22,22,78
104,r_155_81_189,seq249,r_179_265_38,r_155_81_189,0.87,0,189,189,78
187,seq162,r_317_235_85,r_107_220_11,r_107_220_11,0.96,-1,10,11,78
91,r_91_322_187,r_97_174_172,r_326_278_160,r_91_322_187,0.8,0,187,187,78
44,r_56_79_180,r_356_16_144,r_301_157_80,r_56_79_180,0.73,-33,147,180,78
102,r_196_58_55,seq88,seq69,r_196_58_55,1.0,1,56,55,78
71,r_111_148_166,r_364_205_171,r_371_263_154,r_364_205_171,1.0,-5,166,171,78
172,seq126,r_315_118_121,r_317_235_85,r_315_118_121,0.63,0,121,121,78
81,r_213_239_72,seq226,r_367_307_10,r_213_239_72,1.0,0,72,72,78
204,seq206,r_270_161_175,r_204_75_89,r_204_75_89,0.98,3,92,89,78
24,r_159_291_14,r_292_110_52,r_113_286_56,r_159_291_14,0.72,1,15,14,78
26,r_364_205_171,r_24_314_188,seq121,r_364_205_171,1.0,1,172,171,78
34,r_24_314_188,seq6,r_113_286_56,r_24_314_188,0.58,0,188,188,78
68,r_233_238_146,seq129,r_173_185_49,r_233_238_146,0.98,1,147,146,78
88,r_311_99_16,r_156_89_65,seq10,r_311_99_16,0.67,1,17,16,78
53,r_267_67_41,r_173_185_49,r_342_141_173,r_267_67_41,0.95,0,41,41,78
123,r_107_220_11,r_62_90_69,seq162,r_107_220_11,0.73,-1,10,11,78
115,r_300_305_59,r_332_319_81,seq178,r_300_305_59,0.92,2,61,59,78
31,r_192_222_12,r_366_365_41,seq351,r_192_222_12,0.99,0,12,12,78
114,r_29_320_188,seq346,r_331_323_135,r_29_320_188,0.77,0,188,188,78
10,r_332_319_81,seq284,seq154,r_332_319_81,1.0,0,81,81,78
49,r_54_268_56,r_311_99_16,r_276_289_63,r_54_268_56,0.53,38,94,56,78
21,r_327_143_69,seq206,seq152,r_327_143_69,1.0,-2,67,69,78
60,r_15_325_149,seq336,r_156_89_65,r_15_325_149,1.0,0,149,149,78
16,r_65_262_144,r_136_191_175,seq346,r_65_262_144,1.0,0,144,144,78
25,r_304_31_165,seq219,r_4_64_43,r_304_31_165,1.0,1,166,165,78
62,r_207_76_80,r_94_68_137,seq348,r_207_76_80,0.91,0,80,80,78
93,r_315_118_121,seq126,seq142,r_315_118_121,1.0,0,121,121,78
14,r_309_168_162,seq182,r_311_99_16,r_309_168_162,1.0,-1,161,162,78
108,r_363_85_113,seq240,seq83,r_363_85_113,1.0,0,113,113,78
97,r_17_147_96,seq182,r_209_221_92,r_17_147_96,1.0,0,96,96,78
87,r_185_83_31,r_98_132_196,r_370_150_20,r_185_83_31,0.97,0,31,31,79
16,r_194_56_71,r_143_95_93,r_326_2_27,r_194_56_71,0.99,1,72,71,79
37,r_27_117_83,seq209,r_316_344_14,r_27_117_83,0.97,4,87,83,79
23,r_114_347_93,seq169,r_189_258_9,r_114_347_93,0.97,1,94,93,79
78,r_326_2_27,r_317_18_70,seq97,r_326_2_27,0.97,0,27,27,79
27,r_336_256_164,seq138,seq216,r_336_256_164,1.0,0,164,164,79
83,r_192_71_57,r_139_149_87,r_89_263_9,r_89_263_9,1.0,10,19,9,79
88,r_116_180_102,seq146,r_369_303_77,r_116_180_102,0.62,4,106,102,79
244,seq356,seq337,r_228_40_54,r_228_40_54,1.0,45,99,54,79
104,r_315_170_115,seq268,r_259_93_56,r_315_170_115,1.0,0,115,115,79
48,r_82_105_11,r_55_197_71,r_19_299_94,r_82_105_11,0.81,0,11,11,79
46,r_289_328_135,r_368_31_186,r_304_215_93,r_289_328_135,1.0,0,135,135,79
55,r_317_18_70,r_308_101_166,seq12,r_317_18_70,1.0,0,70,70,79
89,r_191_241_177,seq5,r_219_46_4,r_191_241_177,0.85,2,179,177,79
90,r_157_206_23,seq237,seq179,r_157_206_23,0.99,0,23,23,79
111,r_295_338_128,r_342_230_111,r_19_299_94,r_295_338_128,0.85,-24,104,128,79
10,r_87_293_163,seq127,r_166_298_15,r_87_293_163,0.99,1,164,163,79
74,r_106_165_44,r_28_254_167,seq145,r_106_165_44,1.0,0,44,44,79
71,r_44_283_177,r_68_204_187,r_313_125_80,r_44_283_177,1.0,0,177,177,79
113,r_111_345_146,r_39_366_165,seq268,r_111_345_146,1.0,0,146,146,79
49,r_214_269_72,r_28_254_167,seq286,r_214_269_72,1.0,0,72,72,79
105,r_368_31_186,r_289_328_135,seq332,r_289_328_135,1.0,0,135,135,79
9,r_217_30_70,seq337,r_52_159_32,r_217_30_70,0.99,0,70,70,79
107,r_339_38_130,seq198,r_316_344_14,r_339_38_130,1.0,0,130,130,79
14,r_370_150_20,r_36_42_121,seq32,r_370_150_20,1.0,0,20,20,79
56,r_68_204_187,seq10,r_194_56_71,r_68_204_187,0.6,2,189,187,79
34,r_369_303_77,seq51,seq245,r_369_303_77,1.0,0,77,77,79
73,r_264_148_67,seq3,seq107,r_264_148_67,0.99,2,69,67,79
102,r_260_297_171,r_362_13_176,r_96_161_89,r_260_297_171,1.0,0,171,171,79
15,r_36_42_121,seq92,r_322_94_125,r_36_42_121,1.0,0,121,121,79
111,r_295_338_128,r_19_299_94,r_189_258_9,r_295_338_128,0.99,0,128,128,79
59,r_322_94_125,seq66,r_36_42_121,r_36_42_121,0.56,4,125,121,79
35,r_28_254_167,seq141,seq218,r_28_254_167,1.0,0,167,167,79
84,r_235_164_86,r_247_90_159,r_219_46_4,r_235_164_86,1.0,0,86,86,79
4,r_55_197_71,r_362_13_176,r_233_119_116,r_55_197_71,0.94,50,121,71,79
42,r_65_374_122,seq216,r_313_125_80,r_65_374_122,1.0,0,122,122,79
18,r_54_277_49,r_36_42_121,seq207,r_54_277_49,0.98,0,49,49,79
217,seq268,r_315_170_115,r_174_151_48,r_315_170_115,1.0,0,115,115,79
83,r_192_71_57,r_336_256_164,r_233_119_116,r_192_71_57,0.87,62,119,57,79
32,r_96_161_89,seq222,r_228_40_54,r_228_40_54,0.91,59,113,54,79
51,r_342_230_111,r_295_338_128,seq33,r_342_230_111,1.0,0,111,111,79
115,r_199_60_105,seq302,seq79,r_199_60_105,1.0,0,105,105,79
17,r_252_307_126,seq255,seq141,r_252_307_126,1.0,0,126,126,79
91,r_373_211_173,seq209,r_252_307_126,r_373_211_173,0.5,0,173,173,79
65,r_353_321_110,r_285_294_179,r_372_85_63,r_353_321_110,0.67,0,110,110,79
81,r_224_21_155,r_191_241_177,r_316_344_14,r_224_21_155,0.84,-1,154,155,79
92,r_91_163_187,seq305,r_76_318_141,r_91_163_187,0.79,1,188,187,79
103,r_14_49_83,r_87_293_163,r_147_34_5,r_14_49_83,0.63,2,85,83,79
12,r_19_299_94,r_81_162_183,r_370_150_20,r_19_299_94,1.0,0,94,94,79
47,r_24_67_137,r_135_17_38,r_214_269_72,r_24_67_137,1.0,0,137,137,79
118,r_131_250_183,seq137,r_96_161_89,r_131_250_183,1.0,0,183,183,79
2,r_63_253_17,r_114_347_93,seq302,r_63_253_17,0.99,0,17,17,79
20,r_316_344_14,r_370_150_20,seq11,r_316_344_14,1.0,0,14,14,79
60,r_139_149_87,seq268,seq129,r_139_149_87,1.0,0,87,87,79
63,r_190_203_143,r_135_17_38,seq75,r_190_203_143,0.99,2,145,143,79
24,r_76_318_141,seq66,r_244_202_7,r_76_318_141,1.0,0,141,141,79
123,r_52_159_32,r_121_175_114,r_55_197_71,r_52_159_32,0.99,0,32,32,79
21,r_313_125_80,r_247_90_159,r_65_374_122,r_65_374_122,0.84,-1,121,122,79
13,r_309_104_55,r_270_142_125,seq78,r_309_104_55,1.0,0,55,55,79
5,r_154_273_142,seq0,seq124,r_154_273_142,0.61,10,152,142,79
31,r_323_100_90,r_287_236_43,r_139_149_87,r_323_100_90,0.97,0,90,90,79
70,r_308_101_166,seq123,r_19_299_94,r_19_299_94,0.74,81,175,94,79
77,r_270_142_125,seq79,r_369_303_77,r_270_142_125,1.0,0,125,125,79
48,r_82_105_11,r_19_299_94,r_371_110_45,r_82_105_11,0.74,33,44,11,79
8,r_174_151_48,r_369_303_77,seq268,r_369_303_77,0.98,-28,49,77,79
57,r_81_162_183,seq97,r_39_366_165,r_81_162_183,0.98,0,183,183,79
175,seq137,r_76_318_141,r_354_58_8,r_76_318_141,0.99,-53,88,141,79
179,seq145,r_287_236_43,r_106_165_44,r_106_165_44,1.0,21,65,44,79
117,r_304_215_93,r_59_72_155,seq66,r_304_215_93,1.0,0,93,93,79
122,r_314_324_135,seq332,seq255,r_314_324_135,1.0,0,135,135,79
123,r_52_159_32,r_55_197_71,r_217_30_70,r_217_30_70,1.0,0,70,70,79
64,r_228_40_54,r_28_254_167,seq356,r_228_40_54,0.99,1,55,54,79
36,r_113_274_188,seq33,r_336_256_164,r_113_274_188,0.99,0,188,188,79
21,r_313_125_80,r_59_72_155,r_247_90_159,r_313_125_80,1.0,0,80,80,79
200,seq218,r_55_197_71,r_372_85_63,r_372_85_63,0.99,2,65,63,79
45,r_9_57_17,r_28_254_167,seq11,r_9_57_17,1.0,0,17,17,79
66,r_280_173_31,r_220_77_184,seq359,r_280_173_31,0.89,0,31,31,79
33,r_156_182_95,seq208,seq168,r_156_182_95,1.0,0,95,95,79
50,r_166_298_15,r_252_307_126,seq123,r_166_298_15,1.0,0,15,15,79
53,r_7_351_25,r_224_21_155,seq363,r_7_351_25,0.97,0,25,25,79
25,r_115_348_134,seq64,seq141,r_115_348_134,0.94,0,134,134,79
101,r_247_90_159,r_313_125_80,r_55_197_71,r_247_90_159,0.98,-1,158,159,79
121,r_103_249_10,r_63_253_17,seq359,r_103_249_10,0.97,0,10,10,79
40,r_372_85_63,r_116_180_102,seq218,r_372_85_63,1.0,0,63,63,79
94,r_84_70_78,r_259_93_56,seq171,r_259_93_56,1.0,0,56,56,79
83,r_192_71_57,r_89_263_9,r_336_256_164,r_192_71_57,1.0,0,57,57,79
29,r_362_13_176,r_260_297_171,r_285_294_179,r_362_13_176,1.0,-1,175,176,79
38,r_59_72_155,seq11,r_229_69_26,r_59_72_155,1.0,0,155,155,79
68,r_74_301_166,seq138,r_316_344_14,r_74_301_166,1.0,0,166,166,79
110,r_361_122_85,seq15,seq209,r_361_122_85,0.98,2,87,85,79
169,seq123,r_308_101_166,r_87_293_163,r_87_293_163,0.97,12,175,163,79
26,r_143_95_93,r_24_67_137,r_280_173_31,r_143_95_93,1.0,0,93,93,79
44,r_333_187_72,r_55_197_71,r_316_344_14,r_333_187_72,1.0,0,72,72,79
7,r_259_93_56,r_188_152_190,r_315_170_115,r_315_170_115,1.0,2,117,115,79
75,r_300_350_95,r_28_254_167,r_143_95_93,r_300_350_95,0.99,0,95,95,79
236,seq332,r_314_324_135,seq352,r_314_324_135,1.0,0,135,135,79
101,r_247_90_159,r_235_164_86,r_313_125_80,r_247_90_159,1.0,-73,86,159,79
79,r_229_69_26,r_36_42_121,seq22,r_229_69_26,1.0,0,26,26,79
69,r_371_110_45,r_369_303_77,r_82_105_11,r_371_110_45,0.82,0,45,45,79
7,r_259_93_56,r_84_70_78,r_188_152_190,r_259_93_56,1.0,0,56,56,79
97,r_231_239_138,r_285_294_179,r_309_104_55,r_231_239_138,1.0,0,138,138,79
3,r_223_367_155,r_210_346_192,r_275_234_27,r_223_367_155,0.94,2,157,155,79
11,r_62_176_152,seq79,r_63_253_17,r_62_176_152,1.0,0,152,152,79
114,r_275_234_27,r_114_347_93,seq325,r_275_234_27,0.79,0,27,27,79
0,r_121_175_114,r_154_273_142,r_316_344_14,r_121_175_114,1.0,0,114,114,79
109,r_153_6_160,seq11,r_106_165_44,r_153_6_160,1.0,0,160,160,79
156,seq80,r_28_254_167,seq332,r_28_254_167,0.96,-61,106,167,79
112,r_172_134_136,r_59_72_155,r_36_42_121,r_172_134_136,1.0,0,136,136,79
41,r_285_294_179,seq168,r_63_253_17,r_285_294_179,0.96,0,179,179,79
95,r_246_155_167,r_210_346_192,seq0,r_246_155_167,1.0,0,167,167,79
100,r_233_119_116,r_308_101_166,r_55_197_71,r_233_119_116,0.98,0,116,116,79
124,r_89_263_9,r_192_71_57,r_174_151_48,r_192_71_57,0.97,0,57,57,79
185,seq179,r_191_241_177,r_157_206_23,r_157_206_23,1.0,30,53,23,79
99,r_50_26_137,seq359,seq208,r_50_26_137,0.92,4,141,137,79
106,r_292_158_174,seq0,r_219_46_4,r_292_158_174,1.0,0,174,174,79
4,r_55_197_71,r_336_256_164,r_362_13_176,r_55_197_71,0.68,15,86,71,79
39,r_262_311_146,r_87_293_163,r_289_328_135,r_262_311_146,1.0,0,146,146,79
30,r_220_77_184,seq140,r_336_256_164,r_220_77_184,1.0,0,184,184,79
120,r_240_178_166,seq92,r_55_197_71,r_240_178_166,1.0,0,166,166,79
61,r_343_364_180,seq169,r_55_197_71,r_343_364_180,0.95,1,181,180,79
118,r_143_127_84,r_192_200_194,seq273,r_143_127_84,1.0,0,84,84,80
17,r_131_123_143,seq120,seq70,r_131_123_143,0.94,7,150,143,80
35,r_148_39_100,r_230_51_133,seq126,r_148_39_100,1.0,0,100,100,80
22,r_343_258_94,r_262_4_102,r_85_235_38,r_343_258_94,1.0,1,95,94,80
231,seq313,r_207_320_83,seq60,r_207_320_83,1.0,0,83,83,80
108,r_266_182_164,seq288,r_41_54_145,r_266_182_164,1.0,0,164,164,80
97,r_364_352_74,seq33,r_219_119_9,r_364_352_74,1.0,-2,72,74,80
51,r_276_301_182,seq121,r_248_7_75,r_276_301_182,1.0,2,184,182,80
100,r_305_172_70,seq240,r_46_245_16,r_305_172_70,1.0,0,70,70,80
95,r_96_67_11,r_339_361_152,r_291_191_42,r_96_67_11,0.61,57,68,11,80
55,r_370_348_183,seq32,r_155_354_144,r_155_354_144,0.89,39,183,144,80
37,r_251_94_5,seq205,r_62_118_19,r_62_118_19,1.0,9,28,19,80
94,r_162_71_127,seq36,seq50,r_162_71_127,1.0,0,127,127,80
110,r_81_30_138,seq237,r_322_227_116,r_81_30_138,0.96,0,138,138,80
76,r_230_51_133,r_169_73_109,r_1_244_78,r_169_73_109,0.99,0,109,109,80
187,seq165,r_345_100_93,seq98,r_345_100_93,0.93,1,94,93,80
60,r_18_247_97,r_19_17_118,r_186_183_77,r_18_247_97,1.0,0,97,97,80
48,r_290_187_130,seq279,r_190_110_111,r_190_110_111,1.0,39,150,111,80
98,r_219_119_9,r_230_51_133,r_364_352_74,r_230_51_133,0.54,0,133,133,80
103,r_38_146_100,r_230_51_133,r_303_134_1,r_303_134_1,0.56,99,100,1,80
153,seq70,r_316_277_148,r_131_123_143,r_316_277_148,1.0,0,148,148,80
90,r_56_333_159,seq115,seq5,r_56_333_159,0.99,2,161,159,80
28,r_28_228_132,seq125,seq66,r_28_228_132,1.0,0,132,132,80
57,r_346_117_171,seq22,r_108_367_11,r_346_117_171,1.0,0,171,171,80
12,r_331_77_23,r_232_42_142,r_62_118_19,r_232_42_142,0.41,-119,23,142,80
49,r_357_74_125,seq12,r_344_173_110,r_357_74_125,1.0,0,125,125,80
105,r_209_231_133,seq50,seq362,r_209_231_133,1.0,0,133,133,80
34,r_218_372_64,seq340,seq32,r_218_372_64,1.0,0,64,64,80
80,r_90_282_10,r_106_318_72,seq58,r_90_282_10,0.69,0,10,10,80
36,r_95_267_146,seq20,seq152,r_95_267_146,0.94,12,158,146,80
16,r_269_210_98,r_158_233_191,seq33,r_269_210_98,1.0,0,98,98,80
9,r_161_196_22,r_291_191_42,seq236,r_161_196_22,0.85,1,23,22,80
3,r_116_329_54,seq221,seq365,r_116_329_54,1.0,1,55,54,80
81,r_297_26_102,seq319,r_14_89_30,r_297_26_102,1.0,0,102,102,80
23,r_97_78_55,r_99_195_178,r_41_54_145,r_97_78_55,0.98,124,179,55,80
14,r_302_225_21,r_297_26_102,seq22,r_302_225_21,0.43,1,22,21,80
8,r_264_139_130,seq58,seq112,r_264_139_130,1.0,2,132,130,80
41,r_330_229_74,r_199_163_71,seq22,r_330_229_74,0.99,6,80,74,80
107,r_289_341_182,seq242,r_24_280_146,r_289_341_182,0.49,1,183,182,80
74,r_99_195_178,r_97_78_55,r_234_321_26,r_99_195_178,0.87,1,179,178,80
91,r_166_29_13,r_189_59_192,seq222,r_166_29_13,0.62,0,13,13,80
213,seq252,r_87_307_193,r_179_265_109,r_179_265_109,0.74,3,112,109,80
70,r_254_304_140,seq275,r_291_191_42,r_254_304_140,1.0,0,140,140,80
5,r_1_244_78,seq362,r_364_352_74,r_364_352_74,0.99,5,79,74,80
93,r_278_238_135,seq35,r_218_372_64,r_278_238_135,1.0,3,138,135,80
27,r_248_7_75,r_285_176_120,r_107_114_152,r_248_7_75,1.0,-1,74,75,80
218,seq261,r_9_159_177,r_177_136_37,r_9_159_177,1.0,0,177,177,80
43,r_335_358_154,r_303_134_1,seq309,r_335_358_154,1.0,0,154,154,80
44,r_19_17_118,seq242,r_199_163_71,r_19_17_118,1.0,1,119,118,80
120,r_62_118_19,r_87_307_193,r_251_94_5,r_62_118_19,0.96,0,19,19,80
121,r_160_69_135,seq326,r_217_351_68,r_160_69_135,1.0,0,135,135,80
123,r_169_73_109,r_230_51_133,r_207_320_83,r_169_73_109,1.0,0,109,109,80
96,r_234_321_26,seq3,r_219_119_9,r_234_321_26,0.99,1,27,26,80
50,r_356_350_82,r_290_187_130,seq121,r_356_350_82,1.0,0,82,82,80
88,r_281_327_21,r_325_202_25,r_63_180_26,r_281_327_21,0.88,0,21,21,80
38,r_41_54_145,r_169_73_109,r_1_244_78,r_169_73_109,1.0,3,112,109,80
52,r_342_8_106,r_158_233_191,r_1_244_78,r_158_233_191,0.93,-82,109,191,80
69,r_239_135_24,r_269_210_98,seq260,r_239_135_24,1.0,0,24,24,80
152,seq66,seq334,r_28_228_132,r_28_228_132,1.0,23,155,132,80
119,r_179_265_109,seq193,seq252,r_179_265_109,0.99,1,110,109,80
92,r_107_114_152,r_248_7_75,r_90_282_10,r_107_114_152,1.0,1,153,152,80
32,r_102_198_51,r_263_147_113,r_90_282_10,r_102_198_51,0.91,0,51,51,80
78,r_48_141_131,seq181,seq80,r_48_141_131,0.97,0,131,131,80
116,r_108_367_11,r_177_136_37,seq240,r_108_367_11,0.88,0,11,11,80
45,r_44_104_170,seq337,r_177_136_37,r_44_104_170,1.0,1,171,170,80
76,r_230_51_133,r_1_244_78,seq152,r_230_51_133,1.0,0,133,133,80
62,r_55_311_104,seq133,r_249_294_77,r_55_311_104,1.0,1,105,104,80
68,r_325_202_25,seq221,seq120,r_325_202_25,1.0,3,28,25,80
1,r_177_136_37,r_217_351_68,seq3,r_217_351_68,0.98,-15,53,68,80
10,r_232_42_142,seq337,r_162_71_127,r_232_42_142,1.0,0,142,142,80
84,r_185_64_72,r_190_110_111,seq144,r_185_64_72,1.0,1,73,72,80
39,r_46_245_16,r_129_212_193,seq340,r_46_245_16,0.86,0,16,16,80
240,seq340,r_218_372_64,r_46_245_16,r_218_372_64,1.0,0,64,64,80
40,r_285_176_120,seq47,seq157,r_285_176_120,1.0,0,120,120,80
18,r_72_323_170,seq61,r_356_350_82,r_72_323_170,1.0,2,172,170,80
83,r_373_86_50,seq124,r_272_284_52,r_373_86_50,1.0,-1,49,50,80
142,seq35,r_278_238_135,r_14_89_30,r_278_238_135,0.98,3,138,135,80
29,r_138_43_46,seq124,seq126,r_138_43_46,1.0,1,47,46,80
4,r_262_4_102,r_328_226_194,r_179_265_109,r_262_4_102,1.0,0,102,102,80
75,r_106_318_72,seq75,seq32,r_106_318_72,1.0,1,73,72,80
58,r_272_284_52,r_162_71_127,r_373_86_50,r_272_284_52,1.0,0,52,52,80
92,r_107_114_152,seq25,r_248_7_75,r_248_7_75,1.0,0,75,75,80
82,r_241_149_37,r_6_132_49,seq13,r_241_149_37,0.95,0,37,37,80
27,r_248_7_75,r_107_114_152,r_357_74_125,r_248_7_75,1.0,64,139,75,80
115,r_174_128_129,seq360,seq16,r_174_128_129,1.0,0,129,129,80
148,seq58,r_264_139_130,r_90_282_10,r_264_139_130,1.0,-66,64,130,80
42,r_292_201_105,seq255,r_116_329_54,r_292_201_105,1.0,1,106,105,80
33,r_223_76_167,seq21,r_263_147_113,r_223_76_167,1.0,0,167,167,80
74,r_99_195_178,r_357_74_125,r_97_78_55,r_99_195_178,0.82,-115,63,178,80
0,r_111_270_143,seq340,r_344_173_110,r_111_270_143,1.0,0,143,143,80
25,r_291_191_42,r_99_195_178,r_96_67_11,r_291_191_42,1.0,0,42,42,80
30,r_316_277_148,seq70,seq337,r_316_277_148,1.0,0,148,148,80
77,r_214_2_30,r_269_210_98,seq21,r_214_2_30,1.0,0,30,30,80
101,r_190_110_111,r_9_159_177,seq336,r_190_110_111,1.0,0,111,111,80
85,r_85_235_38,r_148_39_100,seq309,r_85_235_38,1.0,0,38,38,80
65,r_339_361_152,r_96_67_11,seq124,r_339_361_152,1.0,0,152,152,80
6,r_268_0_108,r_346_117_171,seq242,r_268_0_108,1.0,1,109,108,80
234,seq319,r_297_26_102,r_179_265_109,r_297_26_102,1.0,0,102,102,80
67,r_344_173_110,seq126,r_248_7_75,r_344_173_110,0.83,0,110,110,80
63,r_9_159_177,seq261,r_46_245_16,r_9_159_177,1.0,0,177,177,80
56,r_368_216_169,seq309,r_24_280_146,r_368_216_169,1.0,0,169,169,80
87,r_186_183_77,seq340,seq105,r_186_183_77,1.0,2,79,77,80
139,seq32,r_370_348_183,r_218_372_64,r_218_372_64,1.0,57,121,64,80
111,r_324_57_124,r_316_277_148,r_161_196_22,r_324_57_124,0.65,1,125,124,80
47,r_6_132_49,r_272_284_52,seq31,r_6_132_49,1.0,0,49,49,80
86,r_79_27_22,r_148_39_100,seq32,r_79_27_22,0.94,0,22,22,80
99,r_345_100_93,seq165,r_214_2_30,r_345_100_93,0.63,1,94,93,80
46,r_217_351_68,seq126,seq296,r_217_351_68,1.0,0,68,68,80
124,r_359_68_127,r_276_301_182,seq3,r_359_68_127,1.0,0,127,127,80
2,r_263_147_113,seq121,seq126,r_263_147_113,1.0,0,113,113,80
66,r_154_257_94,seq105,r_177_136_37,r_154_257_94,1.0,1,95,94,80
23,r_97_78_55,r_322_227_116,r_99_195_178,r_97_78_55,0.98,1,56,55,80
38,r_41_54_145,r_1_244_78,r_97_78_55,r_41_54_145,1.0,0,145,145,80
24,r_155_354_144,seq349,seq273,r_155_354_144,1.0,1,145,144,80
26,r_295_287_36,r_330_229_74,seq255,r_295_287_36,0.99,0,36,36,80
53,r_322_227_116,r_174_128_129,r_328_226_194,r_322_227_116,1.0,0,116,116,80
113,r_153_243_24,seq88,seq237,r_153_243_24,1.0,0,24,24,80
102,r_49_283_146,seq36,r_190_110_111,r_49_283_146,1.0,0,146,146,80
129,seq12,r_357_74_125,r_325_202_25,r_357_74_125,1.0,0,125,125,80
19,r_300_293_33,seq274,r_214_2_30,r_214_2_30,1.0,7,37,30,80
73,r_207_320_83,seq313,seq33,r_207_320_83,1.0,0,83,83,80
89,r_286_353_53,r_56_333_159,r_325_202_25,r_286_353_53,1.0,1,54,53,80
101,r_225_5_83,r_240_179_192,seq319,r_225_5_83,0.95,9,92,83,81
118,r_95_271_20,r_323_56_60,r_64_121_194,r_64_121_194,0.49,-171,23,194,81
61,r_292_212_69,r_55_88_178,seq138,r_292_212_69,1.0,3,72,69,81
98,r_167_343_19,r_331_54_165,seq71,r_167_343_19,1.0,0,19,19,81
22,r_170_149_135,seq370,r_1_305_60,r_170_149_135,0.96,8,143,135,81
82,r_302_361_145,r_360_241_145,r_350_53_53,r_350_53_53,0.99,101,154,53,81
119,r_177_163_137,seq194,r_251_165_199,r_177_163_137,0.94,4,141,137,81
24,r_223_217_91,r_335_186_158,r_202_104_11,r_202_104_11,0.41,80,91,11,81
5,r_191_254_191,r_365_348_174,r_140_9_147,r_365_348_174,1.0,1,175,174,81
6,r_24_294_173,seq205,seq252,r_24_294_173,0.9,0,173,173,81
96,r_189_106_61,seq111,r_141_249_144,r_189_106_61,1.0,0,61,61,81
55,r_346_123_173,seq215,r_232_278_151,r_346_123_173,1.0,0,173,173,81
71,r_255_180_100,seq20,r_223_217_91,r_255_180_100,1.0,0,100,100,81
59,r_12_184_51,r_79_109_166,seq20,r_12_184_51,1.0,2,53,51,81
47,r_368_50_64,r_55_88_178,r_116_344_23,r_368_50_64,0.99,3,67,64,81
84,r_234_112_117,r_347_282_179,r_24_294_173,r_234_112_117,0.59,-65,52,117,81
28,r_274_27_90,seq133,seq147,r_274_27_90,0.72,-1,89,90,81
13,r_372_373_93,seq233,seq126,r_372_373_93,0.74,4,97,93,81
19,r_134_221_84,r_24_294_173,r_141_249_144,r_134_221_84,1.0,1,85,84,81
77,r_327_113_133,seq20,r_317_70_57,r_327_113_133,1.0,1,134,133,81
99,r_247_296_69,r_289_17_96,seq91,r_247_296_69,1.0,1,70,69,81
39,r_169_29_43,r_323_56_60,seq338,r_169_29_43,0.99,0,43,43,81
191,seq208,r_79_109_166,r_190_155_19,r_190_155_19,0.54,23,42,19,81
3,r_224_334_186,seq78,r_211_97_22,r_224_334_186,0.85,-1,185,186,81
54,r_342_207_4,r_266_363_140,r_42_284_33,r_266_363_140,1.0,0,140,140,81
114,r_356_369_136,r_170_149_135,r_350_53_53,r_356_369_136,0.94,5,141,136,81
9,r_258_192_70,r_24_294_173,seq275,r_258_192_70,1.0,0,70,70,81
53,r_94_349_12,r_191_254_191,seq270,r_94_349_12,0.93,0,12,12,81
69,r_79_109_166,seq154,r_211_97_22,r_79_109_166,1.0,0,166,166,81
110,r_42_284_33,r_316_239_195,r_342_207_4,r_42_284_33,0.99,0,33,33,81
106,r_152_52_56,seq194,seq154,r_152_52_56,1.0,0,56,56,81
41,r_173_44_58,r_45_62_107,r_202_104_11,r_173_44_58,1.0,2,60,58,81
23,r_216_32_121,seq319,r_350_53_53,r_216_32_121,0.86,2,123,121,81
62,r_203_345_103,r_24_294_173,r_16_81_103,r_203_345_103,1.0,0,103,103,81
64,r_105_136_105,seq147,r_95_271_20,r_105_136_105,0.98,1,106,105,81
8,r_55_88_178,seq196,r_40_300_23,r_55_88_178,0.93,0,178,178,81
76,r_195_326_75,r_157_90_97,seq359,r_195_326_75,1.0,0,75,75,81
50,r_243_0_55,r_346_123_173,seq135,r_243_0_55,1.0,1,56,55,81
27,r_347_282_179,seq158,r_211_97_22,r_347_282_179,0.77,0,179,179,81
236,seq338,r_146_23_164,r_169_29_43,r_146_23_164,1.0,0,164,164,81
72,r_1_305_60,seq103,seq313,r_1_305_60,0.96,0,60,60,81
11,r_350_53_53,r_366_159_140,seq196,r_350_53_53,0.89,1,54,53,81
75,r_260_150_86,seq103,r_36_33_82,r_260_150_86,1.0,0,86,86,81
31,r_181_231_150,seq6,r_58_14_6,r_181_231_150,1.0,0,150,150,81
86,r_101_82_43,r_47_8_182,seq194,r_101_82_43,0.7,0,43,43,81
0,r_323_56_60,seq242,r_64_121_194,r_323_56_60,1.0,0,60,60,81
63,r_182_265_55,r_143_31_125,r_185_236_58,r_143_31_125,0.79,-65,60,125,81
67,r_141_249_144,r_134_221_84,r_316_239_195,r_141_249_144,1.0,0,144,144,81
178,seq162,seq57,r_37_222_88,r_37_222_88,1.0,11,99,88,81
18,r_48_197_145,r_28_114_142,seq57,r_48_197_145,1.0,-1,144,145,81
68,r_206_118_47,seq67,seq7,r_206_118_47,1.0,0,47,47,81
142,seq71,r_320_137_30,r_167_343_19,r_167_343_19,0.99,18,37,19,81
229,seq315,r_240_179_192,r_317_70_57,r_317_70_57,0.72,84,141,57,81
42,r_360_241_145,r_302_361_145,r_19_175_150,r_19_175_150,1.0,4,154,150,81
30,r_127_318_141,r_191_254_191,r_350_53_53,r_127_318_141,0.89,0,141,141,81
10,r_337_272_121,r_28_114_142,r_211_97_22,r_337_272_121,0.73,3,124,121,81
107,r_295_306_122,seq359,r_134_221_84,r_134_221_84,1.0,43,127,84,81
58,r_309_279_58,seq135,seq196,r_309_279_58,1.0,1,59,58,81
70,r_18_193_136,seq297,seq158,r_18_193_136,1.0,0,136,136,81
84,r_234_112_117,r_24_294_173,seq154,r_24_294_173,0.75,-54,119,173,81
48,r_332_237_188,seq310,seq226,r_332_237_188,0.97,0,188,188,81
108,r_301_66_94,r_181_231_150,seq60,r_301_66_94,0.73,9,103,94,81
43,r_145_51_97,r_374_235_124,r_251_165_199,r_145_51_97,1.0,0,97,97,81
90,r_185_236_58,seq138,r_182_265_55,r_185_236_58,0.7,1,59,58,81
160,seq119,r_1_305_60,r_224_334_186,r_224_334_186,0.55,-42,144,186,81
115,r_250_172_137,seq60,r_63_283_152,r_63_283_152,1.0,5,157,152,81
105,r_146_23_164,seq338,seq164,r_146_23_164,1.0,0,164,164,81
57,r_335_186_158,r_223_217_91,seq26,r_223_217_91,1.0,3,94,91,81
92,r_336_291_32,r_250_172_137,seq20,r_336_291_32,0.99,2,34,32,81
2,r_366_159_140,seq126,r_28_114_142,r_366_159_140,0.91,3,143,140,81
248,seq364,r_157_90_97,r_40_300_23,r_157_90_97,1.0,0,97,97,81
103,r_251_165_199,r_238_59_128,seq370,r_238_59_128,1.0,1,129,128,81
29,r_116_344_23,r_157_90_97,seq96,r_116_344_23,1.0,0,23,23,81
170,seq138,r_156_219_194,r_292_212_69,r_292_212_69,0.77,66,135,69,81
78,r_41_65_70,r_220_38_123,seq226,r_41_65_70,1.0,0,70,70,81
4,r_211_97_22,r_55_88_178,r_89_198_130,r_211_97_22,0.8,1,23,22,81
246,seq359,r_295_306_122,r_195_326_75,r_195_326_75,1.0,52,127,75,81
12,r_84_204_117,r_295_306_122,r_336_291_32,r_336_291_32,0.7,85,117,32,81
80,r_220_38_123,r_183_199_71,r_223_217_91,r_223_217_91,1.0,33,124,91,81
46,r_190_155_19,r_170_149_135,seq208,r_190_155_19,0.99,0,19,19,81
223,seq298,r_347_282_179,r_40_300_23,r_40_300_23,0.87,13,36,23,81
104,r_36_33_82,seq20,seq248,r_36_33_82,1.0,1,83,82,81
17,r_143_31_125,r_108_13_192,r_328_285_9,r_143_31_125,1.0,0,125,125,81
52,r_238_59_128,r_251_165_199,r_152_52_56,r_238_59_128,0.99,1,129,128,81
118,r_95_271_20,r_64_121_194,r_105_136_105,r_105_136_105,1.0,-1,104,105,81
15,r_317_70_57,seq351,seq117,r_317_70_57,1.0,0,57,57,81
16,r_140_9_147,seq96,seq233,r_140_9_147,0.89,1,148,147,81
66,r_371_61_172,seq194,seq166,r_371_61_172,1.0,0,172,172,81
73,r_157_90_97,seq364,r_274_27_90,r_157_90_97,1.0,0,97,97,81
36,r_289_17_96,r_64_121_194,seq297,r_289_17_96,1.0,0,96,96,81
26,r_331_54_165,seq256,r_211_97_22,r_331_54_165,0.98,1,166,165,81
45,r_85_229_30,r_22_98_123,seq214,r_85_229_30,0.76,4,34,30,81
34,r_120_281_180,seq370,r_195_326_75,r_120_281_180,0.96,2,182,180,81
57,r_335_186_158,seq26,r_19_175_150,r_335_186_158,0.97,-4,154,158,81
96,r_189_106_61,r_141_249_144,r_84_204_117,r_141_249_144,0.77,-35,109,144,81
87,r_232_278_151,seq313,seq124,r_232_278_151,0.96,0,151,151,81
81,r_312_151_81,seq7,r_1_305_60,r_312_151_81,1.0,4,85,81,81
95,r_299_367_103,seq67,seq315,r_299_367_103,1.0,0,103,103,81
44,r_266_363_140,r_342_207_4,r_258_192_70,r_266_363_140,1.0,0,140,140,81
38,r_40_300_23,r_146_23_164,seq298,r_40_300_23,1.0,0,23,23,81
85,r_28_114_142,seq68,r_63_283_152,r_63_283_152,1.0,5,157,152,81
20,r_47_8_182,seq319,r_143_31_125,r_47_8_182,1.0,0,182,182,81
116,r_365_348_174,r_191_254_191,r_346_123_173,r_365_348_174,1.0,1,175,174,81
49,r_308_218_65,r_141_249_144,seq83,r_308_218_65,1.0,0,65,65,81
88,r_276_358_62,seq261,seq171,r_276_358_62,1.0,1,63,62,81
113,r_16_81_103,r_108_13_192,r_203_345_103,r_203_345_103,0.53,1,104,103,81
83,r_37_222_88,seq25,seq162,r_37_222_88,1.0,0,88,88,81
123,r_99_246_119,seq20,seq257,r_99_246_119,1.0,1,120,119,81
79,r_168_86_49,r_55_88_178,seq7,r_168_86_49,1.0,0,49,49,81
65,r_273_107_134,r_191_254_191,r_323_56_60,r_273_107_134,1.0,0,134,134,81
109,r_15_314_84,r_141_249_144,seq269,r_15_314_84,1.0,2,86,84,81
102,r_128_110_83,seq122,r_58_14_6,r_128_110_83,1.0,0,83,83,81
51,r_64_121_194,r_289_17_96,r_323_56_60,r_64_121_194,1.0,-117,77,194,81
100,r_45_62_107,seq20,seq25,r_45_62_107,1.0,1,108,107,81
67,r_141_249_144,r_15_314_84,r_134_221_84,r_141_249_144,0.76,-58,86,144,81
19,r_134_221_84,r_141_249_144,r_295_306_122,r_141_249_144,1.0,0,144,144,81
25,r_63_283_152,seq111,r_28_114_142,r_63_283_152,1.0,0,152,152,81
120,r_125_142_166,seq267,seq364,r_125_142_166,0.95,0,166,166,81
112,r_22_98_123,r_125_142_166,r_258_192_70,r_22_98_123,1.0,0,123,123,81
5,r_70_286_20,r_284_283_193,r_62_311_137,r_62_311_137,1.0,10,147,137,82
66,r_369_266_163,seq129,r_347_73_61,r_369_266_163,1.0,0,163,163,82
67,r_62_311_137,r_253_324_141,r_70_286_20,r_62_311_137,1.0,0,137,137,82
117,r_103_308_48,r_150_169_101,r_5_138_13,r_5_138_13,0.85,35,48,13,82
39,r_12_271_74,seq71,seq173,r_12_271_74,1.0,2,76,74,82
61,r_278_337_71,r_253_324_141,r_277_179_9,r_278_337_71,0.99,1,72,71,82
106,r_371_364_128,r_159_325_67,r_187_366_171,r_159_325_67,0.53,-19,48,67,82
104,r_159_325_67,r_371_364_128,seq242,r_159_325_67,0.9,-2,65,67,82
106,r_371_364_128,r_177_196_95,seq345,r_371_364_128,0.95,0,128,128,82
249,seq370,r_76_105_22,r_181_258_126,r_181_258_126,0.88,0,126,126,82
237,seq334,r_141_99_175,r_262_15_43,r_262_15_43,0.9,1,44,43,82
13,r_339_16_43,r_317_133_58,r_106_256_10,r_317_133_58,0.91,-15,43,58,82
15,r_358_195_113,seq25,r_61_287_98,r_358_195_113,0.56,3,116,113,82
59,r_357_158_98,seq360,seq29,r_357_158_98,1.0,0,98,98,82
56,r_317_133_58,r_357_158_98,seq273,r_317_133_58,0.81,0,58,58,82
12,r_142_321_141,r_315_298_92,r_358_195_113,r_142_321_141,0.76,-25,116,141,82
16,r_328_98_105,seq109,seq80,r_328_98_105,1.0,0,105,105,82
57,r_163_92_82,seq20,r_30_13_35,r_163_92_82,1.0,0,82,82,82
31,r_225_164_86,r_369_266_163,r_208_341_21,r_225_164_86,1.0,0,86,86,82
63,r_330_252_15,r_347_73_61,seq79,r_347_73_61,0.61,-46,15,61,82
120,r_209_312_113,seq29,r_30_13_35,r_209_312_113,1.0,2,115,113,82
78,r_356_47_123,r_369_266_163,r_159_325_67,r_356_47_123,1.0,0,123,123,82
162,seq111,seq182,r_75_145_91,r_75_145_91,1.0,32,123,91,82
2,r_243_117_133,r_214_279_65,seq128,r_243_117_133,1.0,0,133,133,82
12,r_142_321_141,r_358_195_113,seq66,r_142_321_141,0.85,3,144,141,82
118,r_8_354_139,r_342_299_165,r_157_340_33,r_8_354_139,1.0,0,139,139,82
123,r_157_340_33,r_232_18_156,seq293,r_157_340_33,1.0,0,33,33,82
70,r_81_6_122,r_85_14_144,seq60,r_81_6_122,1.0,1,123,122,82
62,r_348_110_52,r_176_272_55,r_139_215_51,r_348_110_52,1.0,0,52,52,82
34,r_180_351_114,seq156,r_278_337_71,r_180_351_114,1.0,0,114,114,82
94,r_175_304_110,seq207,seq151,r_175_304_110,1.0,1,111,110,82
115,r_148_269_119,r_230_201_161,r_35_41_24,r_148_269_119,0.99,0,119,119,82
19,r_84_213_74,r_297_72_44,seq197,r_84_213_74,1.0,0,74,74,82
14,r_122_188_173,seq90,r_288_121_19,r_288_121_19,1.0,1,20,19,82
30,r_320_45_189,seq58,r_176_272_55,r_320_45_189,0.98,0,189,189,82
49,r_9_10_104,r_232_18_156,seq217,r_232_18_156,0.93,-64,92,156,82
44,r_368_233_137,seq79,r_94_332_4,r_368_233_137,1.0,0,137,137,82
53,r_85_14_144,r_284_283_193,seq51,r_85_14_144,1.0,0,144,144,82
90,r_288_121_19,r_122_188_173,r_5_138_13,r_122_188_173,1.0,-1,172,173,82
178,seq156,r_353_146_175,r_122_188_173,r_353_146_175,0.68,0,175,175,82
24,r_204_24_81,r_2_69_158,seq270,r_204_24_81,1.0,0,81,81,82
74,r_28_326_110,seq90,seq197,r_28_326_110,1.0,4,114,110,82
119,r_267_307_129,r_342_299_165,seq136,r_342_299_165,0.98,-23,142,165,82
105,r_315_298_92,r_142_321_141,r_70_286_20,r_315_298_92,0.96,24,116,92,82
88,r_198_140_145,seq194,r_97_123_138,r_198_140_145,1.0,0,145,145,82
86,r_184_222_75,seq310,r_297_72_44,r_184_222_75,1.0,0,75,75,82
20,r_75_145_91,r_2_69_158,seq111,r_75_145_91,1.0,1,92,91,82
180,seq162,r_113_55_113,r_231_352_105,r_113_55_113,1.0,2,115,113,82
108,r_355_216_63,seq27,seq25,r_355_216_63,1.0,0,63,63,82
35,r_37_67_71,r_264_86_197,r_335_108_35,r_335_108_35,0.69,41,76,35,82
99,r_177_196_95,r_75_145_91,r_245_116_154,r_245_116_154,1.0,0,154,154,82
98,r_282_365_169,r_143_323_32,r_176_272_55,r_282_365_169,1.0,0,169,169,82
29,r_292_306_171,seq74,r_39_160_57,r_292_306_171,0.79,5,176,171,82
106,r_371_364_128,r_187_366_171,r_177_196_95,r_177_196_95,0.94,1,96,95,82
124,r_150_169_101,seq362,r_347_73_61,r_150_169_101,1.0,0,101,101,82
0,r_347_73_61,r_141_99_175,r_106_256_10,r_347_73_61,1.0,-1,60,61,82
38,r_176_272_55,seq136,seq350,r_176_272_55,1.0,0,55,55,82
17,r_5_138_13,seq289,r_103_308_48,r_103_308_48,0.95,23,71,48,82
72,r_181_258_126,seq197,r_61_287_98,r_181_258_126,0.93,2,128,126,82
89,r_107_78_35,r_97_123_138,seq4,r_107_78_35,0.9,0,35,35,82
100,r_231_352_105,r_346_101_138,seq162,r_231_352_105,0.85,9,114,105,82
8,r_246_52_52,seq211,seq251,r_246_52_52,1.0,1,53,52,82
75,r_186_261_19,r_328_98_105,r_193_259_126,r_186_261_19,1.0,0,19,19,82
1,r_232_18_156,seq190,r_373_290_197,r_232_18_156,1.0,0,156,156,82
96,r_302_135_116,seq109,seq134,r_302_135_116,1.0,0,116,116,82
128,seq11,r_56_131_151,seq234,r_56_131_151,1.0,0,151,151,82
77,r_21_296_83,r_232_18_156,r_291_199_10,r_232_18_156,1.0,-80,76,156,82
79,r_262_15_43,r_120_100_122,seq334,r_262_15_43,1.0,1,44,43,82
51,r_61_287_98,r_346_101_138,r_358_195_113,r_61_287_98,1.0,4,102,98,82
37,r_120_100_122,r_48_244_129,r_335_108_35,r_48_244_129,1.0,-8,121,129,82
112,r_238_322_169,seq360,r_226_152_7,r_238_322_169,0.99,1,170,169,82
41,r_342_299_165,seq240,r_347_73_61,r_342_299_165,0.88,0,165,165,82
9,r_97_123_138,seq205,r_317_133_58,r_97_123_138,0.86,0,138,138,82
109,r_53_313_111,seq156,r_5_138_13,r_53_313_111,1.0,3,114,111,82
102,r_119_229_92,r_97_123_138,r_76_105_22,r_119_229_92,0.81,0,92,92,82
101,r_31_1_144,seq80,r_19_144_80,r_31_1_144,1.0,0,144,144,82
48,r_30_13_35,r_96_114_109,seq58,r_30_13_35,1.0,0,35,35,82
36,r_33_228_44,r_181_258_126,seq338,r_33_228_44,1.0,1,45,44,82
103,r_274_166_120,seq248,r_19_144_80,r_274_166_120,1.0,0,120,120,82
122,r_39_160_57,r_369_266_163,seq17,r_39_160_57,0.85,1,58,57,82
95,r_301_54_16,r_76_105_22,r_297_72_44,r_301_54_16,1.0,8,24,16,82
11,r_104_189_83,r_43_224_8,r_297_72_44,r_104_189_83,1.0,1,84,83,82
130,seq20,r_163_92_82,seq350,r_163_92_82,1.0,-25,57,82,82
3,r_253_324_141,seq3,r_143_323_32,r_253_324_141,1.0,0,141,141,82
97,r_95_23_111,r_257_174_179,seq129,r_95_23_111,1.0,0,111,111,82
181,seq165,r_230_201_161,r_5_138_13,r_230_201_161,1.0,1,162,161,82
33,r_353_146_175,r_372_202_181,r_367_59_148,r_353_146_175,0.88,-1,174,175,82
10,r_143_323_32,seq149,seq362,r_143_323_32,1.0,0,32,32,82
25,r_318_91_159,r_122_188_173,r_97_123_138,r_122_188_173,0.77,-12,161,173,82
90,r_288_121_19,r_142_321_141,r_122_188_173,r_288_121_19,0.99,0,19,19,82
21,r_297_72_44,r_82_260_85,r_301_54_16,r_297_72_44,0.86,-20,24,44,82
84,r_96_114_109,seq221,r_317_133_58,r_96_114_109,1.0,0,109,109,82
23,r_335_108_35,r_147_223_118,r_37_67_71,r_335_108_35,1.0,1,36,35,82
69,r_57_102_180,seq221,r_5_138_13,r_57_102_180,1.0,-1,179,180,82
65,r_263_130_176,seq350,seq212,r_263_130_176,1.0,0,176,176,82
52,r_147_223_118,seq194,seq338,r_147_223_118,1.0,2,120,118,82
14,r_122_188_173,r_288_121_19,seq345,r_122_188_173,0.99,0,173,173,82
27,r_112_316_36,seq234,seq251,r_112_316_36,1.0,0,36,36,82
91,r_276_137_119,r_282_365_169,seq178,r_276_137_119,1.0,1,120,119,82
83,r_2_69_158,seq128,seq44,r_2_69_158,0.76,0,158,158,82
5,r_70_286_20,r_302_135_116,r_284_283_193,r_70_286_20,1.0,0,20,20,82
46,r_35_41_24,r_97_123_138,seq74,r_35_41_24,1.0,0,24,24,82
42,r_49_247_38,r_75_145_91,seq237,r_49_247_38,1.0,1,39,38,82
7,r_367_59_148,seq89,seq87,r_367_59_148,1.0,0,148,148,82
17,r_5_138_13,r_75_145_91,seq289,r_5_138_13,1.0,0,13,13,82
110,r_48_244_129,r_120_100_122,r_81_6_122,r_48_244_129,0.82,0,129,129,82
64,r_19_144_80,r_349_294_192,r_31_1_144,r_31_1_144,0.98,3,147,144,82
76,r_56_131_151,seq11,r_107_78_35,r_56_131_151,1.0,0,151,151,82
54,r_82_260_85,r_263_130_176,seq79,r_82_260_85,1.0,0,85,85,82
32,r_208_341_21,r_12_271_74,seq251,r_208_341_21,1.0,-1,20,21,82
99,r_177_196_95,r_264_86_197,r_371_364_128,r_177_196_95,0.99,0,95,95,82
209,seq237,r_85_14_144,r_49_247_38,r_49_247_38,0.78,2,40,38,82
98,r_282_365_169,r_276_137_119,r_143_323_32,r_276_137_119,0.5,5,124,119,82
99,r_177_196_95,r_371_364_128,r_75_145_91,r_371_364_128,0.98,0,128,128,82
168,seq128,r_75_145_91,r_297_72_44,r_75_145_91,0.72,-67,24,91,82
87,r_257_174_179,r_118_34_192,r_30_13_35,r_118_34_192,0.63,-4,188,192,82
111,r_331_309_169,seq125,r_175_304_110,r_331_309_169,1.0,1,170,169,82
43,r_187_366_171,seq88,r_347_73_61,r_187_366_171,1.0,0,171,171,82
55,r_346_101_138,seq319,r_50_220_8,r_346_101_138,0.92,1,139,138,82
73,r_285_185_165,seq132,r_157_340_33,r_285_185_165,1.0,0,165,165,82
7,r_85_349_18,r_5_306_193,seq271,r_85_349_18,1.0,0,18,18,83
112,r_272_133_62,seq339,seq65,r_272_133_62,1.0,1,63,62,83
17,r_350_357_101,seq339,seq170,r_350_357_101,0.88,0,101,101,83
93,r_211_226_154,r_88_94_63,r_236_38_114,r_211_226_154,1.0,0,154,154,83
135,seq37,r_31_76_171,seq149,r_31_76_171,1.0,0,171,171,83
103,r_243_310_173,r_86_47_187,seq37,r_243_310_173,0.62,1,174,173,83
49,r_63_341_57,r_338_212_37,seq53,r_63_341_57,1.0,1,58,57,83
118,r_186_321_18,r_366_351_147,seq289,r_186_321_18,0.66,2,20,18,83
52,r_206_213_146,r_75_58_88,r_363_113_36,r_206_213_146,0.91,-50,96,146,83
57,r_143_312_165,seq53,seq79,r_143_312_165,0.99,0,165,165,83
81,r_264_135_136,r_338_212_37,r_128_232_126,r_264_135_136,1.0,0,136,136,83
83,r_131_101_59,r_39_44_59,r_229_267_32,r_131_101_59,0.99,1,60,59,83
32,r_174_197_95,seq271,r_335_119_11,r_174_197_95,1.0,1,96,95,83
87,r_198_141_177,r_338_212_37,r_35_342_72,r_198_141_177,0.66,2,179,177,83
24,r_309_92_166,seq87,r_207_177_58,r_309_92_166,1.0,1,167,166,83
88,r_356_62_152,seq30,r_123_303_54,r_356_62_152,0.97,5,157,152,83
70,r_223_154_90,r_240_330_163,seq87,r_240_330_163,0.72,-71,92,163,83
43,r_253_368_27,seq11,seq106,r_253_368_27,1.0,0,27,27,83
246,seq352,r_52_26_180,r_250_0_144,r_250_0_144,0.6,15,159,144,83
242,seq339,r_350_357_101,seq114,r_350_357_101,1.0,0,101,101,83
30,r_220_159_135,seq82,seq140,r_220_159_135,1.0,0,135,135,83
38,r_187_40_63,r_21_67_77,seq4,r_187_40_63,0.83,7,70,63,83
98,r_52_26_180,seq352,r_338_212_37,r_52_26_180,0.94,2,182,180,83
14,r_27_359_169,seq126,seq218,r_27_359_169,1.0,0,169,169,83
72,r_373_7_51,seq287,seq30,r_373_7_51,1.0,0,51,51,83
74,r_86_47_187,seq96,r_203_285_96,r_86_47_187,0.82,0,187,187,83
96,r_128_232_126,seq326,seq64,r_128_232_126,1.0,0,126,126,83
16,r_88_94_63,r_211_226_154,r_229_267_32,r_211_226_154,1.0,0,154,154,83
0,r_153_156_145,r_268_362_121,r_370_317_7,r_268_362_121,0.93,-25,96,121,83
54,r_98_105_181,seq2,r_187_40_63,r_98_105_181,1.0,0,181,181,83
25,r_229_267_32,r_211_226_154,r_273_328_67,r_229_267_32,0.92,79,111,32,83
105,r_107_23_82,r_174_197_95,seq230,r_107_23_82,1.0,0,82,82,83
61,r_111_127_21,seq315,seq125,r_111_127_21,0.99,0,21,21,83
66,r_308_297_167,r_331_361_199,r_88_94_63,r_308_297_167,0.99,1,168,167,83
109,r_224_353_106,r_104_19_102,seq147,r_224_353_106,0.53,-4,102,106,83
191,seq178,r_338_212_37,r_108_150_18,r_108_150_18,1.0,34,52,18,83
197,seq193,seq18,r_160_163_21,r_160_163_21,1.0,22,43,21,83
85,r_325_181_167,r_148_284_193,seq192,r_325_181_167,0.81,4,171,167,83
123,r_166_6_176,r_172_344_157,r_293_244_143,r_293_244_143,0.82,15,158,143,83
3,r_108_150_18,seq188,seq178,r_108_150_18,1.0,0,18,18,83
114,r_28_205_90,r_265_61_178,seq289,r_28_205_90,1.0,0,90,90,83
124,r_169_59_89,seq2,seq138,r_169_59_89,0.98,0,89,89,83
10,r_338_212_37,seq218,r_234_231_9,r_234_231_9,0.73,87,96,9,83
180,seq149,r_274_246_154,seq37,r_274_246_154,0.97,6,160,154,83
79,r_104_19_102,r_224_353_106,r_252_12_31,r_104_19_102,1.0,0,102,102,83
46,r_250_0_144,seq126,seq352,r_250_0_144,1.0,0,144,144,83
104,r_366_351_147,seq74,r_95_228_81,r_366_351_147,0.96,1,148,147,83
8,r_208_157_60,r_366_351_147,r_153_156_145,r_208_157_60,0.98,88,148,60,83
40,r_191_358_143,r_102_32_7,r_28_205_90,r_191_358_143,1.0,0,143,143,83
89,r_20_266_118,r_98_105_181,seq339,r_20_266_118,1.0,0,118,118,83
60,r_84_72_98,seq65,seq18,r_84_72_98,0.99,1,99,98,83
137,seq43,r_371_237_181,r_295_204_149,r_371_237_181,0.49,4,185,181,83
37,r_158_340_178,seq29,r_143_312_165,r_158_340_178,0.81,2,180,178,83
93,r_211_226_154,r_216_374_75,r_88_94_63,r_211_226_154,1.0,-79,75,154,83
48,r_49_278_20,r_148_284_193,r_186_321_18,r_49_278_20,1.0,1,21,20,83
94,r_294_316_24,r_338_212_37,seq245,r_294_316_24,1.0,0,24,24,83
41,r_295_204_149,r_5_306_193,seq43,r_295_204_149,1.0,3,152,149,83
11,r_172_344_157,r_166_6_176,r_48_24_69,r_172_344_157,0.82,1,158,157,83
29,r_136_329_166,r_257_305_195,r_174_197_95,r_136_329_166,0.85,0,166,166,83
2,r_203_285_96,r_274_246_154,seq168,r_203_285_96,1.0,0,96,96,83
76,r_335_119_11,r_136_329_166,seq53,r_136_329_166,0.61,-155,11,166,83
27,r_160_163_21,seq192,seq193,r_160_163_21,0.97,0,21,21,83
66,r_308_297_167,r_151_360_154,r_331_361_199,r_151_360_154,0.55,-51,103,154,83
110,r_214_225_160,seq185,seq96,r_214_225_160,1.0,0,160,160,83
39,r_182_235_53,r_95_228_81,seq147,r_182_235_53,0.52,0,53,53,83
47,r_34_201_190,r_151_360_154,r_42_139_71,r_42_139_71,1.0,16,87,71,83
33,r_222_124_132,seq146,r_100_210_6,r_222_124_132,1.0,0,132,132,83
92,r_9_14_120,seq194,r_56_196_8,r_9_14_120,1.0,0,120,120,83
1,r_42_139_71,seq292,r_34_201_190,r_42_139_71,1.0,2,73,71,83
25,r_229_267_32,r_373_7_51,r_211_226_154,r_229_267_32,0.85,2,34,32,83
15,r_95_228_81,r_240_330_163,seq93,r_95_228_81,0.99,0,81,81,83
115,r_268_362_121,r_153_156_145,seq304,r_268_362_121,1.0,0,121,121,83
107,r_236_38_114,r_286_13_192,r_211_226_154,r_236_38_114,0.57,34,148,114,83
117,r_77_118_84,r_265_61_178,seq132,r_77_118_84,1.0,0,84,84,83
9,r_31_76_171,seq37,r_115_195_114,r_31_76_171,0.93,0,171,171,83
8,r_208_157_60,seq262,r_366_351_147,r_208_157_60,0.99,4,64,60,83
194,seq185,r_214_225_160,seq64,r_214_225_160,1.0,-42,118,160,83
0,r_153_156_145,r_370_317_7,r_208_157_60,r_153_156_145,0.9,3,148,145,83
53,r_102_32_7,r_191_358_143,r_189_334_7,r_191_358_143,1.0,-1,142,143,83
106,r_8_336_79,r_343_129_89,seq74,r_8_336_79,1.0,0,79,79,83
28,r_367_217_10,r_33_145_98,seq87,r_367_217_10,1.0,0,10,10,83
214,seq262,r_208_157_60,seq93,r_208_157_60,0.97,4,64,60,83
22,r_333_116_136,r_309_92_166,r_189_334_7,r_333_116_136,1.0,0,136,136,83
77,r_346_221_20,r_338_212_37,r_335_119_11,r_346_221_20,1.0,0,20,20,83
6,r_274_246_154,seq149,r_49_278_20,r_274_246_154,0.81,4,158,154,83
40,r_191_358_143,r_42_139_71,r_102_32_7,r_42_139_71,0.96,-30,41,71,83
84,r_68_332_152,seq254,r_115_195_114,r_68_332_152,1.0,0,152,152,83
183,seq161,r_301_355_165,r_242_238_138,r_242_238_138,1.0,16,154,138,83
86,r_277_16_104,r_166_6_176,r_33_145_98,r_33_145_98,1.0,11,109,98,83
50,r_371_237_181,seq43,r_95_228_81,r_371_237_181,1.0,4,185,181,83
5,r_33_145_98,seq64,r_200_142_9,r_33_145_98,1.0,0,98,98,83
31,r_89_10_70,r_136_329_166,seq170,r_89_10_70,1.0,0,70,70,83
99,r_75_58_88,r_206_213_146,r_108_150_18,r_75_58_88,0.96,4,92,88,83
101,r_171_281_172,seq51,r_248_15_27,r_171_281_172,0.95,1,173,172,83
175,seq138,r_136_329_166,r_169_59_89,r_169_59_89,0.66,7,96,89,83
113,r_322_256_172,seq114,r_242_238_138,r_242_238_138,1.0,31,169,138,83
4,r_35_342_72,r_81_190_2,seq120,r_35_342_72,1.0,0,72,72,83
51,r_48_24_69,r_371_237_181,seq247,r_48_24_69,0.99,1,70,69,83
54,r_98_105_181,r_20_266_118,seq2,r_20_266_118,1.0,0,118,118,83
18,r_258_199_28,r_220_159_135,seq241,r_258_199_28,0.99,0,28,28,83
80,r_273_328_67,r_242_238_138,r_229_267_32,r_273_328_67,1.0,0,67,67,83
121,r_175_209_52,r_88_94_63,seq54,r_175_209_52,1.0,0,52,52,83
69,r_248_15_27,r_148_284_193,seq155,r_248_15_27,1.0,0,27,27,83
65,r_293_244_143,r_240_330_163,r_166_6_176,r_166_6_176,0.46,-33,143,176,83
19,r_301_355_165,seq161,r_253_368_27,r_253_368_27,0.78,138,165,27,83
119,r_176_25_142,r_52_26_180,r_175_209_52,r_176_25_142,0.65,1,143,142,83
34,r_363_113_36,r_153_156_145,seq287,r_363_113_36,1.0,0,36,36,83
78,r_252_12_31,r_115_195_114,seq22,r_252_12_31,0.98,0,31,31,83
155,seq90,r_343_129_89,r_56_196_8,r_343_129_89,0.98,2,91,89,83
62,r_183_1_129,r_242_238_138,r_46_60_177,r_46_60_177,1.0,-47,130,177,83
107,r_236_38_114,r_220_159_135,r_286_13_192,r_236_38_114,1.0,0,114,114,83
52,r_206_213_146,r_363_113_36,r_95_228_81,r_206_213_146,0.97,0,146,146,83
64,r_123_303_54,r_222_124_132,r_294_316_24,r_123_303_54,0.79,0,54,54,83
95,r_207_177_58,r_265_61_178,seq185,r_207_177_58,1.0,0,58,58,83
71,r_216_374_75,r_211_226_154,r_189_334_7,r_216_374_75,1.0,0,75,75,83
68,r_343_129_89,seq90,seq41,r_343_129_89,1.0,2,91,89,83
16,r_88_94_63,r_356_62_152,r_211_226_154,r_88_94_63,1.0,0,63,63,83
17,r_315_290_112,seq38,r_167_286_109,r_315_290_112,0.78,0,112,112,84
54,r_103_127_113,r_200_309_134,r_208_151_15,r_103_127_113,1.0,0,113,113,84
51,r_37_124_111,r_211_85_173,r_99_266_162,r_37_124_111,0.82,62,173,111,84
75,r_324_110_82,seq249,seq353,r_324_110_82,1.0,-1,81,82,84
50,r_87_163_172,r_285_305_76,r_150_238_170,r_87_163_172,0.99,0,172,172,84
105,r_25_92_159,r_306_181_54,r_13_115_62,r_25_92_159,1.0,0,159,159,84
45,r_285_305_76,seq137,seq58,r_285_305_76,0.96,4,80,76,84
99,r_200_309_134,r_36_62_180,r_352_322_130,r_200_309_134,1.0,0,134,134,84
144,seq55,seq210,r_104_0_23,r_104_0_23,1.0,0,23,23,84
101,r_328_125_41,r_257_133_60,seq277,r_328_125_41,0.99,0,41,41,84
9,r_263_128_72,seq86,seq249,r_263_128_72,0.91,-4,68,72,84
37,r_84_191_32,r_363_72_116,r_101_361_10,r_84_191_32,0.99,-4,28,32,84
100,r_52_39_161,seq106,seq185,r_52_39_161,0.78,2,163,161,84
89,r_214_178_146,r_25_92_159,r_208_151_15,r_214_178_146,0.97,0,146,146,84
184,seq184,r_268_116_176,r_234_372_48,r_268_116_176,0.99,0,176,176,84
74,r_278_187_26,seq210,seq369,r_278_187_26,0.92,0,26,26,84
19,r_165_117_81,seq53,r_328_125_41,r_165_117_81,1.0,1,82,81,84
113,r_17_228_112,seq108,r_310_193_48,r_17_228_112,0.79,0,112,112,84
192,seq202,r_225_256_151,r_79_345_22,r_79_345_22,0.94,0,22,22,84
130,seq16,r_79_345_22,seq78,r_79_345_22,0.85,0,22,22,84
88,r_160_343_64,r_123_272_113,r_307_239_63,r_123_272_113,0.98,0,113,113,84
0,r_327_140_51,r_274_21_132,r_328_125_41,r_274_21_132,1.0,0,132,132,84
236,seq348,seq136,r_363_72_116,r_363_72_116,1.0,11,127,116,84
67,r_157_240_156,seq311,r_34_47_141,r_157_240_156,0.86,0,156,156,84
4,r_107_358_132,seq111,seq45,r_107_358_132,0.88,1,133,132,84
6,r_296_33_11,r_327_140_51,r_340_156_177,r_296_33_11,0.93,-1,10,11,84
142,seq51,r_99_266_162,r_90_342_82,r_90_342_82,0.75,2,84,82,84
91,r_336_26_146,seq351,r_255_303_35,r_336_26_146,1.0,1,147,146,84
109,r_188_59_125,seq80,r_109_186_33,r_109_186_33,0.97,99,132,33,84
32,r_349_195_144,r_157_240_156,r_101_361_10,r_101_361_10,0.53,134,144,10,84
104,r_96_126_169,seq43,r_330_325_162,r_330_325_162,0.98,7,169,162,84
63,r_105_244_37,r_352_322_130,seq18,r_105_244_37,0.99,0,37,37,84
107,r_288_64_170,seq192,r_203_97_68,r_288_64_170,0.98,0,170,170,84
86,r_164_332_125,seq189,r_362_14_96,r_164_332_125,0.69,7,132,125,84
108,r_199_264_58,r_66_280_149,r_339_162_199,r_199_264_58,0.96,-1,57,58,84
117,r_66_280_149,seq70,r_31_359_19,r_66_280_149,0.99,1,150,149,84
78,r_362_14_96,r_138_356_161,r_337_30_92,r_362_14_96,1.0,0,96,96,84
53,r_352_322_130,seq202,seq53,r_352_322_130,1.0,0,130,130,84
186,seq189,r_164_332_125,seq364,r_164_332_125,0.9,-48,77,125,84
30,r_208_151_15,r_296_33_11,r_103_127_113,r_103_127_113,1.0,25,138,113,84
24,r_270_218_43,seq348,seq295,r_270_218_43,0.99,0,43,43,84
49,r_211_85_173,seq205,r_135_231_124,r_211_85_173,0.86,0,173,173,84
61,r_147_175_28,r_268_116_176,seq35,r_147_175_28,0.98,0,28,28,84
93,r_113_354_35,r_107_358_132,seq365,r_113_354_35,1.0,0,35,35,84
38,r_135_231_124,r_107_358_132,r_257_133_60,r_135_231_124,0.95,2,126,124,84
71,r_167_286_109,r_95_235_199,r_69_366_27,r_167_286_109,1.0,0,109,109,84
42,r_245_269_48,r_291_41_70,seq56,r_245_269_48,1.0,0,48,48,84
36,r_54_283_94,r_107_358_132,r_324_110_82,r_324_110_82,0.64,11,93,82,84
106,r_68_75_115,seq57,r_77_246_3,r_68_75_115,0.99,1,116,115,84
118,r_129_259_41,seq179,seq80,r_129_259_41,1.0,-2,39,41,84
28,r_93_145_113,r_71_312_121,seq298,r_93_145_113,0.94,0,113,113,84
114,r_292_216_100,seq57,r_328_125_41,r_292_216_100,1.0,0,100,100,84
35,r_183_182_83,seq60,r_147_175_28,r_183_182_83,1.0,-2,81,83,84
11,r_150_238_170,seq233,r_87_163_172,r_87_163_172,0.75,1,173,172,84
98,r_130_299_94,r_289_46_51,seq65,r_130_299_94,1.0,2,96,94,84
123,r_319_209_27,r_226_63_102,seq261,r_319_209_27,0.91,-2,25,27,84
62,r_101_361_10,r_54_283_94,r_84_191_32,r_54_283_94,1.0,0,94,94,84
48,r_226_63_102,seq173,seq298,r_226_63_102,0.99,0,102,102,84
97,r_176_122_187,seq57,seq12,r_176_122_187,1.0,2,189,187,84
55,r_1_317_77,seq295,seq40,r_1_317_77,1.0,0,77,77,84
79,r_69_366_27,r_339_162_199,seq360,r_69_366_27,1.0,0,27,27,84
73,r_257_133_60,r_146_81_190,seq338,r_257_133_60,1.0,0,60,60,84
31,r_225_256_151,r_352_322_130,r_94_83_29,r_94_83_29,1.0,-1,28,29,84
115,r_331_88_71,seq2,seq298,r_331_88_71,1.0,-2,69,71,84
110,r_138_356_161,seq185,r_129_259_41,r_138_356_161,0.75,0,161,161,84
179,seq169,r_268_116_176,r_234_372_48,r_234_372_48,0.68,0,48,48,84
23,r_281_76_85,seq365,seq320,r_281_76_85,1.0,-1,84,85,84
51,r_37_124_111,r_200_309_134,r_211_85_173,r_37_124_111,1.0,0,111,111,84
5,r_170_132_94,seq254,r_281_76_85,r_170_132_94,1.0,0,94,94,84
85,r_13_115_62,r_201_144_111,seq155,r_13_115_62,1.0,2,64,62,84
8,r_215_19_86,r_222_29_140,seq166,r_215_19_86,1.0,1,87,86,84
132,seq24,r_25_92_159,r_306_181_54,r_25_92_159,0.87,-7,152,159,84
88,r_160_343_64,seq161,r_123_272_113,r_160_343_64,0.97,0,64,64,84
16,r_203_97_68,seq318,seq233,r_203_97_68,1.0,0,68,68,84
1,r_234_372_48,seq168,seq169,r_234_372_48,0.99,0,48,48,84
80,r_61_219_181,seq100,r_71_312_121,r_61_219_181,0.99,0,181,181,84
182,seq179,r_129_259_41,seq198,r_129_259_41,1.0,-3,38,41,84
87,r_121_149_32,r_84_191_32,r_204_321_86,r_204_321_86,1.0,8,94,86,84
96,r_71_312_121,seq134,seq131,r_71_312_121,1.0,0,121,121,84
57,r_307_239_63,seq277,r_147_175_28,r_307_239_63,1.0,0,63,63,84
31,r_225_256_151,r_94_83_29,seq190,r_225_256_151,0.98,0,151,151,84
41,r_73_276_126,r_99_266_162,seq78,r_73_276_126,1.0,0,126,126,84
149,seq65,seq335,r_300_273_114,r_300_273_114,1.0,15,129,114,84
83,r_146_81_190,seq360,r_222_29_140,r_146_81_190,0.92,0,190,190,84
58,r_274_21_132,r_170_132_94,r_327_140_51,r_274_21_132,0.87,-80,52,132,84
27,r_268_116_176,seq184,r_242_253_58,r_268_116_176,1.0,0,176,176,84
111,r_204_321_86,r_90_342_82,r_121_149_32,r_204_321_86,1.0,1,87,86,84
77,r_79_345_22,seq16,seq202,r_79_345_22,0.93,0,22,22,84
92,r_300_273_114,seq365,seq65,r_300_273_114,1.0,0,114,114,84
22,r_252_6_101,seq224,seq134,r_252_6_101,1.0,3,104,101,84
14,r_222_29_140,r_139_118_187,r_252_6_101,r_222_29_140,1.0,0,140,140,84
76,r_104_0_23,r_160_343_64,seq55,r_104_0_23,0.99,0,23,23,84
234,seq344,r_330_325_162,seq67,r_330_325_162,1.0,1,163,162,84
94,r_302_197_97,seq344,seq137,r_302_197_97,1.0,0,97,97,84
97,r_176_122_187,r_201_144_111,seq57,r_201_144_111,1.0,0,111,111,84
238,seq351,r_336_26_146,r_95_235_199,r_336_26_146,1.0,1,147,146,84
43,r_172_267_142,seq368,r_363_72_116,r_172_267_142,0.99,0,142,142,84
121,r_310_193_48,r_226_63_102,seq131,r_310_193_48,0.98,-4,44,48,84
170,seq137,seq190,r_302_197_97,r_302_197_97,1.0,9,106,97,84
50,r_87_163_172,r_201_144_111,r_285_305_76,r_201_144_111,0.57,0,111,111,84
222,seq304,r_54_283_94,r_84_191_32,r_54_283_94,1.0,3,97,94,84
124,r_217_153_167,seq43,r_289_46_51,r_217_153_167,0.89,0,167,167,84
72,r_260_152_149,seq82,r_349_195_144,r_260_152_149,0.8,0,149,149,84
44,r_94_83_29,r_225_256_151,seq275,r_225_256_151,1.0,0,151,151,84
82,r_15_248_175,seq35,r_352_322_130,r_15_248_175,1.0,0,175,175,84
59,r_109_186_33,r_337_30_92,r_204_321_86,r_109_186_33,1.0,0,33,33,84
47,r_5_9_16,r_349_195_144,seq82,r_5_9_16,0.57,-2,14,16,84
84,r_287_174_103,r_222_29_140,r_167_286_109,r_287_174_103,1.0,6,109,103,84
81,r_337_30_92,seq18,r_362_14_96,r_362_14_96,1.0,1,97,96,84
58,r_274_21_132,r_327_140_51,r_77_246_3,r_274_21_132,1.0,0,132,132,84
59,r_109_186_33,r_204_321_86,r_188_59_125,r_204_321_86,1.0,1,87,86,84
78,r_362_14_96,r_337_30_92,r_164_332_125,r_164_332_125,0.99,0,125,125,84
116,r_242_253_58,seq185,seq2,r_242_253_58,1.0,0,58,58,84
44,r_94_83_29,r_68_75_115,r_225_256_151,r_94_83_29,1.0,0,29,29,84
46,r_306_181_54,r_25_92_159,seq24,r_25_92_159,1.0,0,159,159,84
102,r_363_72_116,seq45,seq348,r_363_72_116,1.0,0,116,116,84
143,seq53,r_31_359_19,r_352_322_130,r_352_322_130,1.0,0,130,130,84
20,r_171_49_118,seq44,r_221_7_70,r_221_7_70,0.99,52,122,70,84
33,r_99_266_162,seq51,r_37_124_111,r_99_266_162,1.0,2,164,162,84
90,r_8_374_109,r_61_219_181,seq86,r_8_374_109,0.97,1,110,109,84
103,r_212_220_100,r_167_286_109,seq58,r_212_220_100,0.99,1,101,100,84
69,r_90_342_82,r_204_321_86,seq51,r_90_342_82,0.95,2,84,82,84
112,r_154_213_65,r_52_39_161,seq42,r_154_213_65,0.79,0,65,65,84
56,r_330_325_162,seq344,r_109_186_33,r_330_325_162,1.0,0,162,162,84
66,r_279_326_190,seq241,r_234_372_48,r_279_326_190,0.68,0,190,190,84
46,r_306_181_54,r_176_122_187,r_25_92_159,r_306_181_54,1.0,0,54,54,84
119,r_11_251_158,seq91,r_109_186_33,r_11_251_158,1.0,1,159,158,84
18,r_22_50_43,r_242_253_58,seq58,r_22_50_43,0.74,-1,42,43,84
120,r_36_62_180,seq350,r_113_354_35,r_36_62_180,0.99,0,180,180,84
232,seq338,seq198,r_257_133_60,r_257_133_60,1.0,0,60,60,84
64,r_102_20_167,seq194,r_339_162_199,r_102_20_167,1.0,1,168,167,84
0,r_327_140_51,seq137,r_274_21_132,r_327_140_51,1.0,0,51,51,84
13,r_123_272_113,seq258,r_215_19_86,r_123_272_113,1.0,0,113,113,84
105,r_25_92_159,seq24,r_306_181_54,r_306_181_54,1.0,5,59,54,84
161,seq106,r_52_39_161,r_215_19_86,r_215_19_86,0.83,80,166,86,84
26,r_34_47_141,seq82,r_32_265_65,r_34_47_141,1.0,1,142,141,84
34,r_31_359_19,r_349_195_144,seq60,r_31_359_19,0.97,-1,18,19,84
2,r_255_303_35,r_260_152_149,seq254,r_255_303_35,1.0,1,36,35,84
95,r_271_236_142,r_139_118_187,r_270_218_43,r_271_236_142,1.0,0,142,142,84
30,r_208_151_15,r_289_46_51,r_296_33_11,r_208_151_15,1.0,-1,14,15,84
122,r_201_144_111,r_176_122_187,r_328_125_41,r_201_144_111,1.0,0,111,111,84
10,r_164_312_149,seq291,r_89_15_29,r_164_312_149,1.0,0,149,149,85
115,r_138_48_145,r_240_113_3,r_322_170_40,r_138_48_145,1.0,1,146,145,85
228,seq291,r_164_312_149,r_175_262_13,r_164_312_149,1.0,0,149,149,85
114,r_258_187_195,r_160_122_175,r_366_251_140,r_366_251_140,1.0,0,140,140,85
90,r_39_307_101,r_275_343_153,seq263,r_39_307_101,0.89,0,101,101,85
91,r_83_4_36,r_368_346_149,r_154_174_8,r_368_346_149,0.74,-96,53,149,85
48,r_222_373_133,r_135_372_6,r_190_281_2,r_222_373_133,1.0,0,133,133,85
121,r_252_242_144,r_138_48_145,r_12_60_72,r_12_60_72,1.0,69,141,72,85
118,r_126_332_59,r_8_224_65,seq107,r_126_332_59,1.0,0,59,59,85
83,r_186_32_136,seq79,r_10_198_62,r_186_32_136,1.0,0,136,136,85
81,r_94_237_77,r_70_289_86,r_322_170_40,r_94_237_77,0.71,2,79,77,85
1,r_313_145_172,seq134,r_106_114_84,r_313_145_172,0.64,0,172,172,85
92,r_304_208_109,r_92_84_96,r_169_321_102,r_92_84_96,0.43,0,96,96,85
76,r_86_301_41,r_50_364_71,r_190_281_2,r_86_301_41,1.0,0,41,41,85
29,r_106_114_84,seq136,seq280,r_106_114_84,1.0,1,85,84,85
8,r_50_364_71,seq144,seq370,r_50_364_71,1.0,0,71,71,85
49,r_194_278_50,r_282_206_122,seq109,r_194_278_50,1.0,5,55,50,85
62,r_369_199_42,r_50_364_71,seq68,r_369_199_42,1.0,0,42,42,85
110,r_65_155_187,seq120,r_34_295_35,r_65_155_187,0.99,2,189,187,85
95,r_333_112_168,r_296_33_25,r_8_224_65,r_333_112_168,0.91,-1,167,168,85
107,r_73_253_67,r_335_245_123,seq285,r_335_245_123,0.97,-56,67,123,85
65,r_12_60_72,r_217_77_151,r_256_336_56,r_12_60_72,1.0,1,73,72,85
32,r_34_295_35,r_306_93_128,seq142,r_34_295_35,1.0,-1,34,35,85
119,r_104_327_16,r_323_310_116,r_258_187_195,r_104_327_16,0.93,8,24,16,85
6,r_282_206_122,seq91,r_45_157_47,r_282_206_122,0.81,0,122,122,85
30,r_175_262_13,r_158_25_37,seq291,r_175_262_13,0.97,0,13,13,85
85,r_203_344_181,seq216,r_322_170_40,r_203_344_181,0.99,0,181,181,85
64,r_247_340_140,seq370,r_104_327_16,r_247_340_140,1.0,0,140,140,85
63,r_37_300_93,r_36_329_122,r_161_146_43,r_37_300_93,1.0,2,95,93,85
15,r_284_9_165,seq47,r_374_355_163,r_284_9_165,0.9,2,167,165,85
73,r_115_127_75,r_149_59_187,seq76,r_115_127_75,1.0,0,75,75,85
227,seq288,r_231_46_163,r_50_364_71,r_231_46_163,0.67,3,166,163,85
165,seq121,r_69_350_84,r_161_146_43,r_161_146_43,1.0,21,64,43,85
61,r_325_0_167,seq14,r_175_262_13,r_325_0_167,1.0,0,167,167,85
214,seq261,r_49_235_126,r_83_4_36,r_49_235_126,0.73,-52,74,126,85
60,r_1_74_76,seq358,r_267_349_184,r_1_74_76,0.69,15,91,76,85
117,r_182_171_149,seq68,r_322_170_40,r_182_171_149,1.0,1,150,149,85
108,r_123_178_36,r_61_318_196,seq55,r_123_178_36,0.97,-1,35,36,85
50,r_228_181_40,r_161_146_43,seq195,r_228_181_40,1.0,1,41,40,85
94,r_207_165_149,seq303,r_266_189_66,r_207_165_149,0.89,0,149,149,85
25,r_92_84_96,r_304_208_109,seq233,r_92_84_96,1.0,0,96,96,85
31,r_244_30_105,seq315,r_8_224_65,r_244_30_105,1.0,1,106,105,85
111,r_140_264_138,r_240_113_3,seq67,r_140_264_138,1.0,0,138,138,85
120,r_296_33_25,r_306_93_128,r_333_112_168,r_296_33_25,1.0,1,26,25,85
104,r_154_174_8,r_222_373_133,r_83_4_36,r_222_373_133,1.0,-81,52,133,85
39,r_80_38_41,seq177,r_371_352_199,r_80_38_41,0.72,8,49,41,85
184,seq172,r_101_238_164,r_36_329_122,r_101_238_164,0.97,0,164,164,85
120,r_296_33_25,r_333_112_168,r_275_343_153,r_275_343_153,0.84,14,167,153,85
80,r_63_223_154,seq150,r_132_166_78,r_63_223_154,1.0,1,155,154,85
45,r_219_239_168,r_43_183_178,r_35_137_101,r_219_239_168,0.98,0,168,168,85
105,r_268_143_55,seq156,seq351,r_268_143_55,1.0,0,55,55,85
74,r_308_311_109,r_149_59_187,seq303,r_308_311_109,0.98,2,111,109,85
66,r_341_179_10,r_337_6_111,seq351,r_341_179_10,1.0,0,10,10,85
106,r_320_95_59,r_333_112_168,r_232_196_6,r_320_95_59,1.0,1,60,59,85
89,r_70_289_86,seq316,r_207_165_149,r_70_289_86,1.0,-1,85,86,85
58,r_366_251_140,seq142,r_10_198_62,r_366_251_140,1.0,3,143,140,85
56,r_275_343_153,seq272,r_12_60_72,r_275_343_153,1.0,0,153,153,85
89,r_70_289_86,r_207_165_149,seq148,r_207_165_149,0.66,-17,132,149,85
46,r_36_329_122,seq40,seq172,r_36_329_122,1.0,2,124,122,85
52,r_132_166_78,seq55,seq209,r_132_166_78,0.99,-1,77,78,85
77,r_163_302_82,r_342_347_175,r_1_74_76,r_163_302_82,0.9,1,83,82,85
28,r_374_355_163,seq315,seq156,r_374_355_163,0.94,0,163,163,85
70,r_257_271_80,r_306_93_128,r_330_269_190,r_330_269_190,0.73,-110,80,190,85
26,r_8_224_65,seq214,seq47,r_8_224_65,1.0,2,67,65,85
116,r_249_294_57,r_43_183_178,r_89_15_29,r_249_294_57,0.94,0,57,57,85
161,seq109,r_169_321_102,r_194_278_50,r_194_278_50,0.59,24,74,50,85
72,r_371_352_199,r_161_146_43,r_80_38_41,r_161_146_43,1.0,-1,42,43,85
93,r_241_105_24,r_330_269_190,seq365,r_330_269_190,0.65,-166,24,190,85
5,r_335_245_123,seq233,r_287_234_43,r_335_245_123,1.0,0,123,123,85
0,r_326_108_123,r_160_122_175,r_66_71_106,r_326_108_123,0.51,2,125,123,85
53,r_45_157_47,seq110,r_342_347_175,r_45_157_47,1.0,0,47,47,85
17,r_360_82_72,r_186_32_136,seq167,r_186_32_136,0.99,-31,105,136,85
38,r_240_113_3,r_140_264_138,r_81_184_25,r_140_264_138,1.0,0,138,138,85
27,r_356_152_176,seq363,r_282_206_122,r_356_152_176,0.99,0,176,176,85
69,r_368_346_149,r_333_112_168,seq362,r_368_346_149,0.93,1,150,149,85
54,r_169_321_102,r_43_183_178,r_241_105_24,r_169_321_102,0.88,2,104,102,85
95,r_333_112_168,r_320_95_59,r_296_33_25,r_333_112_168,1.0,-125,43,168,85
16,r_158_25_37,r_342_347_175,seq91,r_158_25_37,0.53,0,37,37,85
174,seq142,r_366_251_140,r_34_295_35,r_366_251_140,0.98,1,141,140,85
119,r_104_327_16,r_258_187_195,r_10_198_62,r_10_198_62,0.78,73,135,62,85
24,r_135_372_6,r_222_373_133,r_96_248_50,r_222_373_133,1.0,-19,114,133,85
18,r_348_334_47,r_169_321_102,r_330_269_190,r_348_334_47,0.62,0,47,47,85
33,r_255_72_85,seq88,seq259,r_255_72_85,1.0,0,85,85,85
144,seq67,seq109,r_140_264_138,r_140_264_138,1.0,6,144,138,85
37,r_225_23_45,r_360_82_72,seq280,r_225_23_45,1.0,0,45,45,85
96,r_220_227_77,r_49_235_126,r_89_15_29,r_220_227_77,0.94,0,77,77,85
100,r_52_57_135,seq41,r_24_317_61,r_52_57_135,1.0,0,135,135,85
88,r_101_238_164,seq172,r_326_108_123,r_101_238_164,0.72,0,164,164,85
57,r_66_71_106,r_304_208_109,r_341_179_10,r_66_71_106,1.0,0,106,106,85
59,r_342_347_175,r_163_302_82,r_45_157_47,r_342_347_175,0.6,-112,63,175,85
162,seq110,r_45_157_47,r_73_253_67,r_45_157_47,1.0,3,50,47,85
42,r_217_77_151,r_65_155_187,seq17,r_217_77_151,0.99,2,153,151,85
112,r_160_122_175,r_10_198_62,r_255_72_85,r_160_122_175,0.65,3,178,175,85
217,seq272,r_275_343_153,r_115_127_75,r_275_343_153,0.61,0,153,153,85
78,r_35_137_101,seq293,seq177,r_35_137_101,1.0,0,101,101,85
47,r_354_26_57,r_306_93_128,seq88,r_354_26_57,1.0,0,57,57,85
171,seq136,r_106_114_84,seq107,r_106_114_84,1.0,1,85,84,85
115,r_138_48_145,r_252_242_144,r_240_113_3,r_138_48_145,0.66,-115,30,145,85
162,seq110,r_73_253_67,r_162_21_172,r_162_21_172,0.82,0,172,172,85
82,r_266_189_66,r_35_137_101,seq29,r_35_137_101,0.99,-31,70,101,85
53,r_45_157_47,r_342_347_175,r_282_206_122,r_342_347_175,0.64,0,175,175,85
71,r_231_46_163,seq288,r_190_281_2,r_231_46_163,1.0,3,166,163,85
84,r_256_336_56,r_169_321_102,r_296_33_25,r_256_336_56,1.0,1,57,56,85
97,r_367_270_50,seq124,seq191,r_367_270_50,1.0,1,51,50,85
36,r_161_146_43,r_228_181_40,seq121,r_161_146_43,1.0,-2,41,43,85
124,r_49_235_126,seq261,r_132_166_78,r_49_235_126,0.99,0,126,126,85
44,r_62_2_131,r_231_46_163,seq18,r_62_2_131,1.0,0,131,131,85
4,r_43_183_178,r_162_21_172,r_342_347_175,r_162_21_172,0.87,0,172,172,85
51,r_89_15_29,r_326_108_123,seq211,r_326_108_123,0.6,-94,29,123,85
40,r_162_21_172,r_43_183_178,seq110,r_162_21_172,1.0,0,172,172,85
59,r_342_347_175,r_45_157_47,r_43_183_178,r_342_347_175,0.88,0,175,175,85
22,r_81_184_25,r_161_146_43,r_240_113_3,r_240_113_3,0.84,22,25,3,85
20,r_306_93_128,seq204,r_1_74_76,r_306_93_128,1.0,0,128,128,85
7,r_7_226_34,r_8_224_65,seq280,r_7_226_34,0.89,-1,33,34,85
122,r_323_310_116,seq168,r_1_74_76,r_1_74_76,0.54,47,123,76,85
41,r_24_317_61,seq273,seq76,r_24_317_61,1.0,0,61,61,85
11,r_149_59_187,seq362,r_164_312_149,r_149_59_187,0.52,1,188,187,85
13,r_10_198_62,seq76,seq195,r_10_198_62,1.0,1,63,62,85
132,seq20,r_65_155_187,r_180_13_118,r_180_13_118,1.0,-1,117,118,85
123,r_19_176_118,r_247_340_140,r_81_184_25,r_19_176_118,1.0,1,119,118,85
19,r_96_248_50,r_94_237_77,r_135_372_6,r_96_248_50,1.0,7,57,50,85
14,r_322_170_40,r_96_248_50,seq293,r_322_170_40,0.87,-1,39,40,85
112,r_160_122_175,r_326_108_123,r_10_198_62,r_160_122_175,0.86,-52,123,175,85
68,r_287_234_43,seq41,seq107,r_287_234_43,1.0,0,43,43,85
86,r_342_249_179,r_188_55_191,r_156_207_54,r_342_249_179,1.0,0,179,179,86
114,r_197_222_19,r_175_47_22,r_269_157_123,r_269_157_123,1.0,11,134,123,86
60,r_353_291_56,r_191_52_103,seq5,r_353_291_56,1.0,-1,55,56,86
26,r_335_68_83,r_192_176_117,seq124,r_335_68_83,1.0,1,84,83,86
23,r_159_233_142,seq158,seq16,r_159_233_142,1.0,2,144,142,86
102,r_12_246_164,seq22,r_227_85_144,r_12_246_164,1.0,1,165,164,86
168,seq127,seq240,r_100_373_71,r_100_373_71,1.0,9,80,71,86
80,r_209_72_40,seq5,seq317,r_209_72_40,0.92,0,40,40,86
100,r_171_28_164,r_191_52_103,r_141_318_93,r_171_28_164,0.95,-70,94,164,86
4,r_228_374_68,r_326_129_58,r_75_40_13,r_228_374_68,1.0,0,68,68,86
71,r_87_118_16,r_140_199_59,seq137,r_87_118_16,1.0,1,17,16,86
45,r_231_310_27,r_337_181_159,seq158,r_231_310_27,1.0,0,27,27,86
38,r_36_112_167,seq205,r_231_310_27,r_36_112_167,1.0,0,167,167,86
39,r_130_253_18,r_285_368_180,seq54,r_130_253_18,1.0,0,18,18,86
61,r_323_350_17,r_135_230_112,r_25_308_5,r_323_350_17,1.0,0,17,17,86
99,r_244_264_178,seq27,r_256_255_118,r_244_264_178,1.0,0,178,178,86
49,r_190_163_48,r_251_70_120,seq49,r_190_163_48,1.0,0,48,48,86
93,r_293_278_49,seq5,r_190_163_48,r_293_278_49,1.0,0,49,49,86
84,r_223_67_62,r_279_286_183,r_210_216_20,r_279_286_183,0.99,1,184,183,86
107,r_14_144_145,seq39,r_126_273_62,r_14_144_145,1.0,0,145,145,86
70,r_75_40_13,r_269_157_123,seq329,r_75_40_13,1.0,1,14,13,86
27,r_280_348_24,r_191_52_103,r_25_308_5,r_280_348_24,1.0,1,25,24,86
28,r_11_234_170,seq66,seq299,r_11_234_170,1.0,0,170,170,86
170,seq132,r_279_286_183,r_41_123_87,r_41_123_87,0.97,-3,84,87,86
100,r_171_28_164,r_141_318_93,r_77_42_3,r_171_28_164,0.99,0,164,164,86
123,r_288_103_22,r_226_282_151,r_324_63_117,r_324_63_117,1.0,13,130,117,86
35,r_83_372_159,seq237,seq107,r_83_372_159,0.99,2,161,159,86
94,r_265_153_53,r_6_257_166,r_289_339_94,r_265_153_53,0.97,72,125,53,86
63,r_337_181_159,r_79_355_185,seq205,r_337_181_159,0.99,0,159,159,86
8,r_303_369_52,r_294_102_194,r_113_170_78,r_303_369_52,0.53,-9,43,52,86
31,r_46_26_75,seq60,seq32,r_46_26_75,1.0,1,76,75,86
47,r_279_286_183,seq239,r_223_67_62,r_223_67_62,1.0,9,71,62,86
85,r_217_349_123,r_6_257_166,seq143,r_217_349_123,1.0,0,123,123,86
15,r_126_273_62,r_64_43_180,seq38,r_126_273_62,1.0,-1,61,62,86
17,r_370_298_142,seq136,seq189,r_370_298_142,0.86,0,142,142,86
53,r_57_3_84,r_64_43_180,seq248,r_57_3_84,1.0,1,85,84,86
50,r_210_216_20,r_192_176_117,seq239,r_210_216_20,1.0,0,20,20,86
116,r_177_295_89,r_214_114_191,r_167_320_11,r_177_295_89,1.0,0,89,89,86
83,r_289_339_94,r_324_63_117,r_265_153_53,r_289_339_94,1.0,0,94,94,86
109,r_245_220_169,seq165,r_69_301_68,r_245_220_169,1.0,0,169,169,86
51,r_208_354_116,r_345_312_196,r_335_68_83,r_208_354_116,1.0,0,116,116,86
114,r_197_222_19,r_251_70_120,r_175_47_22,r_197_222_19,1.0,0,19,19,86
20,r_110_9_46,seq331,r_128_262_56,r_128_262_56,1.0,3,59,56,86
52,r_135_230_112,seq201,r_148_173_141,r_135_230_112,1.0,0,112,112,86
42,r_191_52_103,r_171_28_164,seq66,r_191_52_103,1.0,0,103,103,86
3,r_122_266_76,r_259_104_117,r_277_34_105,r_122_266_76,1.0,0,76,76,86
25,r_358_139_45,r_324_63_117,seq359,r_358_139_45,1.0,0,45,45,86
55,r_227_85_144,r_93_327_160,r_100_373_71,r_100_373_71,1.0,73,144,71,86
94,r_265_153_53,r_148_173_141,r_6_257_166,r_265_153_53,1.0,0,53,53,86
77,r_154_195_172,seq311,r_229_145_8,r_154_195_172,0.99,0,172,172,86
64,r_0_19_76,r_122_266_76,r_44_258_82,r_0_19_76,1.0,-3,73,76,86
59,r_256_255_118,seq366,seq143,r_256_255_118,0.75,-22,96,118,86
119,r_169_91_157,r_141_318_93,seq205,r_141_318_93,1.0,1,94,93,86
2,r_251_70_120,r_244_264_178,seq120,r_251_70_120,0.9,1,121,120,86
209,seq239,r_279_286_183,r_210_216_20,r_210_216_20,1.0,2,22,20,86
118,r_6_257_166,seq18,r_315_367_47,r_6_257_166,1.0,1,167,166,86
113,r_164_86_132,r_93_327_160,r_57_3_84,r_164_86_132,1.0,4,136,132,86
185,seq162,r_110_9_46,r_108_51_39,r_108_51_39,1.0,0,39,39,86
22,r_362_330_176,r_188_55_191,r_279_286_183,r_362_330_176,0.69,8,184,176,86
103,r_269_157_123,seq252,r_197_222_19,r_269_157_123,1.0,0,123,123,86
121,r_84_218_155,seq147,r_203_325_7,r_84_218_155,1.0,0,155,155,86
115,r_166_343_32,r_192_176_117,seq300,r_166_343_32,1.0,0,32,32,86
90,r_175_47_22,r_285_368_180,r_197_222_19,r_175_47_22,1.0,0,22,22,86
68,r_281_321_28,r_126_273_62,seq275,r_281_321_28,0.94,0,28,28,86
101,r_328_88_134,r_36_112_167,r_192_176_117,r_328_88_134,1.0,0,134,134,86
212,seq248,seq124,r_57_3_84,r_57_3_84,1.0,21,105,84,86
11,r_363_341_112,r_256_255_118,r_191_52_103,r_363_341_112,1.0,0,112,112,86
74,r_29_17_109,seq134,seq10,r_29_17_109,1.0,0,109,109,86
92,r_100_373_71,r_6_257_166,seq127,r_100_373_71,1.0,1,72,71,86
16,r_259_104_117,seq22,r_25_308_5,r_259_104_117,1.0,2,119,117,86
182,seq158,seq10,r_231_310_27,r_231_310_27,1.0,30,57,27,86
228,seq300,r_202_111_183,r_166_343_32,r_202_111_183,1.0,0,183,183,86
96,r_305_4_55,r_345_312_196,seq18,r_305_4_55,1.0,-1,54,55,86
19,r_21_193_137,r_154_195_172,r_156_207_54,r_21_193_137,1.0,1,138,137,86
43,r_125_109_34,r_228_374_68,seq152,r_125_109_34,1.0,0,34,34,86
95,r_150_313_119,seq20,seq105,r_150_313_119,1.0,0,119,119,86
40,r_200_347_151,seq38,seq65,r_200_347_151,1.0,3,154,151,86
29,r_225_306_142,seq299,r_315_367_47,r_225_306_142,1.0,0,142,142,86
111,r_93_327_160,seq179,r_41_123_87,r_93_327_160,1.0,0,160,160,86
110,r_133_243_85,seq124,seq165,r_133_243_85,1.0,1,86,85,86
32,r_345_312_196,r_208_354_116,r_128_262_56,r_345_312_196,0.62,-139,57,196,86
0,r_156_207_54,r_224_8_148,seq27,r_156_207_54,1.0,0,54,54,86
57,r_247_62_27,r_57_3_84,seq186,r_247_62_27,1.0,0,27,27,86
56,r_336_319_59,r_57_3_84,r_358_139_45,r_336_319_59,1.0,0,59,59,86
37,r_226_282_151,seq54,r_69_301_68,r_69_301_68,0.95,6,74,68,86
47,r_279_286_183,r_223_67_62,r_362_330_176,r_279_286_183,0.62,1,184,183,86
62,r_324_63_117,r_61_287_183,r_288_103_22,r_324_63_117,1.0,1,118,117,86
108,r_89_371_24,r_214_114_191,seq136,r_89_371_24,1.0,0,24,24,86
73,r_79_355_185,seq168,r_210_216_20,r_79_355_185,0.83,0,185,185,86
78,r_61_287_183,seq147,r_156_207_54,r_61_287_183,1.0,0,183,183,86
34,r_309_297_98,r_337_181_159,r_315_367_47,r_309_297_98,1.0,2,100,98,86
75,r_141_318_93,r_169_91_157,seq212,r_141_318_93,1.0,1,94,93,86
117,r_254_316_98,seq178,seq252,r_254_316_98,1.0,0,98,98,86
106,r_277_34_105,r_69_301_68,r_122_266_76,r_122_266_76,0.91,1,77,76,86
122,r_357_333_74,seq5,seq184,r_357_333_74,1.0,0,74,74,86
104,r_271_196_143,seq158,seq204,r_271_196_143,1.0,0,143,143,86
87,r_64_43_180,r_126_273_62,r_175_47_22,r_64_43_180,0.99,-139,41,180,86
18,r_315_367_47,r_226_282_151,seq186,r_315_367_47,1.0,1,48,47,86
69,r_101_81_22,r_148_173_141,seq23,r_101_81_22,0.99,0,22,22,86
5,r_128_262_56,seq183,r_345_312_196,r_128_262_56,1.0,1,57,56,86
142,seq38,r_200_347_151,r_126_273_62,r_200_347_151,0.66,3,154,151,86
33,r_242_90_56,seq38,r_190_163_48,r_242_90_56,1.0,-4,52,56,86
130,seq15,r_44_258_82,r_30_261_80,r_30_261_80,1.0,1,81,80,86
162,seq107,r_277_34_105,r_83_372_159,r_83_372_159,0.88,10,169,159,86
46,r_138_96_68,r_192_176_117,seq95,r_138_96_68,1.0,0,68,68,86
84,r_223_67_62,r_224_8_148,r_279_286_183,r_223_67_62,0.89,-5,57,62,86
144,seq49,r_44_258_82,r_190_163_48,r_190_163_48,1.0,1,49,48,86
123,r_288_103_22,r_245_220_169,r_226_282_151,r_288_103_22,0.99,0,22,22,86
112,r_56_290_64,r_271_196_143,r_281_321_28,r_56_290_64,0.99,0,64,64,86
91,r_113_170_78,r_83_372_159,r_303_369_52,r_113_170_78,0.97,-10,68,78,86
1,r_192_176_117,seq78,seq66,r_192_176_117,1.0,0,117,117,86
12,r_224_8_148,r_188_55_191,seq161,r_224_8_148,1.0,0,148,148,86
14,r_41_123_87,seq182,seq132,r_41_123_87,0.83,2,89,87,86
67,r_206_80_165,seq275,r_46_26_75,r_206_80_165,0.99,1,166,165,86
41,r_326_129_58,r_228_374_68,seq338,r_326_129_58,0.6,-5,53,58,86
36,r_140_199_59,r_36_112_167,r_75_40_13,r_140_199_59,1.0,0,59,59,86
146,seq54,r_224_8_148,r_130_253_18,r_130_253_18,0.98,0,18,18,86
7,r_58_115_152,r_277_34_105,seq94,r_58_115_152,0.96,3,155,152,86
98,r_69_301_68,r_277_34_105,r_226_282_151,r_69_301_68,0.99,-3,65,68,86
87,r_64_43_180,r_175_47_22,r_363_341_112,r_64_43_180,0.99,-1,179,180,86
30,r_346_99_88,seq59,seq267,r_346_99_88,0.9,-1,87,88,86
221,seq275,r_285_368_180,r_281_321_28,r_281_321_28,1.0,1,29,28,86
76,r_236_48_173,seq276,r_269_157_123,r_236_48_173,1.0,0,173,173,86
48,r_202_111_183,seq300,seq183,r_202_111_183,1.0,0,183,183,86
105,r_108_51_39,r_192_176_117,seq162,r_108_51_39,1.0,0,39,39,86
99,r_356_177_147,seq205,r_176_206_55,r_356_177_147,1.0,1,148,147,87
97,r_48_313_52,seq236,seq15,r_48_313_52,1.0,0,52,52,87
26,r_117_171_24,r_366_317_24,r_162_300_22,r_162_300_22,1.0,5,27,22,87
117,r_232_219_47,r_36_277_76,seq111,r_232_219_47,1.0,1,48,47,87
52,r_184_157_34,r_197_275_132,seq139,r_184_157_34,0.94,3,37,34,87
201,seq216,r_339_369_59,r_24_231_4,r_339_369_59,0.79,2,61,59,87
64,r_278_372_29,r_264_143_101,seq72,r_278_372_29,0.81,0,29,29,87
14,r_47_218_60,r_222_122_157,seq82,r_47_218_60,1.0,0,60,60,87
18,r_130_213_39,r_333_325_73,seq68,r_130_213_39,0.93,0,39,39,87
147,seq63,r_280_31_168,r_316_151_62,r_280_31_168,0.99,0,168,168,87
23,r_185_5_110,seq95,r_257_198_187,r_185_5_110,1.0,0,110,110,87
88,r_108_248_160,r_39_13_194,r_164_17_157,r_108_248_160,0.98,1,161,160,87
17,r_1_230_86,r_254_0_121,r_342_298_30,r_1_230_86,0.99,0,86,86,87
43,r_194_255_72,seq83,r_176_206_55,r_194_255_72,1.0,0,72,72,87
3,r_162_300_22,r_96_113_92,seq20,r_162_300_22,0.86,0,22,22,87
86,r_100_25_60,r_194_255_72,r_195_259_40,r_100_25_60,1.0,0,60,60,87
110,r_243_183_109,r_336_214_169,r_144_9_31,r_243_183_109,1.0,0,109,109,87
57,r_355_110_127,seq253,r_278_372_29,r_355_110_127,0.55,2,129,127,87
60,r_189_16_69,seq86,r_176_206_55,r_189_16_69,1.0,0,69,69,87
6,r_190_127_86,r_145_237_199,seq186,r_190_127_86,0.92,1,87,86,87
121,r_222_122_157,seq261,r_269_332_6,r_222_122_157,1.0,0,157,157,87
39,r_134_363_132,seq124,seq236,r_134_363_132,1.0,0,132,132,87
73,r_145_237_199,r_190_127_86,seq327,r_190_127_86,0.96,1,87,86,87
108,r_79_245_144,seq140,r_51_88_2,r_79_245_144,1.0,0,144,144,87
44,r_333_325_73,r_130_213_39,r_158_341_18,r_333_325_73,0.65,-34,39,73,87
27,r_158_341_18,r_333_325_73,seq103,r_333_325_73,1.0,2,75,73,87
102,r_266_299_110,seq155,seq73,r_266_299_110,1.0,0,110,110,87
67,r_291_286_179,seq285,r_134_363_132,r_291_286_179,0.93,3,182,179,87
7,r_263_84_58,r_39_13_194,seq44,r_263_84_58,0.89,0,58,58,87
54,r_348_200_102,r_178_78_182,r_51_88_2,r_348_200_102,1.0,0,102,102,87
249,seq371,r_197_275_132,r_87_260_176,r_197_275_132,1.0,4,136,132,87
15,r_368_6_121,seq139,r_315_229_49,r_315_229_49,0.88,72,121,49,87
76,r_357_276_39,seq8,seq28,r_357_276_39,0.99,0,39,39,87
157,seq82,seq83,r_47_218_60,r_47_218_60,1.0,26,86,60,87
93,r_273_12_158,seq103,r_51_88_2,r_273_12_158,0.92,1,159,158,87
66,r_279_85_68,seq71,seq285,r_279_85_68,1.0,0,68,68,87
236,seq327,r_283_106_61,r_26_303_37,r_283_106_61,0.54,0,61,61,87
149,seq68,r_291_286_179,r_130_213_39,r_130_213_39,0.58,23,62,39,87
61,r_192_125_108,seq120,r_96_113_92,r_192_125_108,0.61,7,115,108,87
68,r_264_143_101,r_334_58_178,seq83,r_264_143_101,1.0,0,101,101,87
106,r_75_57_119,seq175,seq155,r_75_57_119,1.0,0,119,119,87
62,r_234_30_168,seq233,r_199_74_59,r_234_30_168,0.93,0,168,168,87
22,r_118_247_180,seq73,seq56,r_118_247_180,0.96,0,180,180,87
114,r_292_373_91,seq324,r_176_206_55,r_292_373_91,1.0,0,91,91,87
13,r_354_322_32,r_266_299_110,seq29,r_266_299_110,0.74,-73,37,110,87
100,r_146_240_154,r_144_9_31,seq68,r_146_240_154,1.0,2,156,154,87
19,r_302_99_58,r_75_57_119,seq42,r_75_57_119,0.54,-60,59,119,87
24,r_283_106_61,seq327,seq119,r_283_106_61,1.0,0,61,61,87
118,r_358_208_67,seq161,r_24_231_4,r_358_208_67,1.0,0,67,67,87
9,r_181_137_112,r_150_132_147,seq111,r_181_137_112,1.0,0,112,112,87
58,r_199_74_59,r_374_353_171,seq285,r_199_74_59,1.0,0,59,59,87
120,r_335_347_72,seq327,seq261,r_335_347_72,1.0,0,72,72,87
94,r_297_148_122,seq104,seq77,r_297_148_122,0.97,0,122,122,87
31,r_318_349_188,r_67_249_36,r_107_217_188,r_318_349_188,0.97,0,188,188,87
75,r_280_31_168,seq63,r_190_127_86,r_280_31_168,0.97,0,168,168,87
33,r_374_353_171,r_154_344_16,r_333_325_73,r_374_353_171,0.82,0,171,171,87
47,r_59_346_154,seq2,seq370,r_59_346_154,0.99,0,154,154,87
74,r_241_215_153,r_154_344_16,seq2,r_241_215_153,1.0,0,153,153,87
0,r_142_65_190,seq370,r_138_258_16,r_142_65_190,0.82,0,190,190,87
77,r_3_76_123,seq175,seq32,r_3_76_123,0.98,2,125,123,87
113,r_271_43_29,r_130_213_39,seq44,r_271_43_29,1.0,0,29,29,87
72,r_152_14_73,seq111,r_195_259_40,r_152_14_73,1.0,0,73,73,87
40,r_176_206_55,r_273_12_158,seq328,r_176_206_55,0.96,2,57,55,87
101,r_203_33_62,r_194_255_72,r_269_332_6,r_194_255_72,0.79,-9,63,72,87
105,r_178_78_182,r_39_13_194,r_263_84_58,r_178_78_182,0.94,1,183,182,87
176,seq139,r_368_6_121,r_345_250_48,r_345_250_48,1.0,8,56,48,87
96,r_316_151_62,r_273_12_158,seq63,r_316_151_62,1.0,0,62,62,87
45,r_221_238_154,seq253,r_357_276_39,r_221_238_154,1.0,0,154,154,87
69,r_26_303_37,r_254_0_121,seq327,r_254_0_121,0.68,-84,37,121,87
80,r_91_153_53,r_283_106_61,seq46,r_91_153_53,1.0,1,54,53,87
85,r_53_296_138,seq2,r_239_330_62,r_53_296_138,1.0,0,138,138,87
48,r_96_113_92,seq46,seq62,r_96_113_92,1.0,0,92,92,87
233,seq320,r_273_12_158,seq261,r_273_12_158,0.9,-97,61,158,87
70,r_306_141_109,r_266_299_110,r_345_250_48,r_306_141_109,0.96,1,110,109,87
122,r_7_136_158,r_142_65_190,seq212,r_7_136_158,1.0,0,158,158,87
124,r_61_210_167,seq233,seq15,r_61_210_167,0.64,0,167,167,87
20,r_209_18_98,r_319_19_156,r_251_252_57,r_209_18_98,1.0,0,98,98,87
84,r_126_262_148,seq124,r_147_94_41,r_126_262_148,1.0,-1,147,148,87
123,r_109_156_30,seq80,seq72,r_109_156_30,1.0,0,30,30,87
82,r_311_129_53,r_87_260_176,r_51_88_2,r_311_129_53,1.0,1,54,53,87
78,r_326_362_169,r_51_88_2,r_355_110_127,r_326_362_169,1.0,2,171,169,87
71,r_254_0_121,seq77,seq81,r_254_0_121,1.0,1,122,121,87
95,r_98_167_112,r_319_19_156,seq253,r_319_19_156,0.98,-43,113,156,87
87,r_150_132_147,seq228,r_316_151_62,r_316_151_62,0.76,91,153,62,87
83,r_38_270_177,seq93,r_130_213_39,r_38_270_177,0.97,5,182,177,87
50,r_323_293_64,r_280_31_168,r_138_258_16,r_323_293_64,1.0,1,65,64,87
29,r_70_50_155,seq133,r_279_85_68,r_70_50_155,1.0,1,156,155,87
27,r_158_341_18,r_41_90_90,r_333_325_73,r_158_341_18,0.78,-2,16,18,87
44,r_333_325_73,r_158_341_18,seq115,r_333_325_73,0.85,2,75,73,87
90,r_52_289_121,r_355_110_127,r_96_113_92,r_52_289_121,0.6,4,125,121,87
42,r_27_165_156,seq272,seq233,r_27_165_156,0.67,0,156,156,87
36,r_342_298_30,r_107_217_188,seq187,r_342_298_30,1.0,0,30,30,87
162,seq93,r_38_270_177,r_352_224_15,r_38_270_177,0.99,5,182,177,87
32,r_49_170_72,r_70_50_155,seq261,r_49_170_72,1.0,1,73,72,87
107,r_116_244_58,r_374_353_171,r_357_276_39,r_116_244_58,1.0,0,58,58,87
63,r_123_159_69,r_59_346_154,seq44,r_123_159_69,1.0,0,69,69,87
65,r_36_277_76,seq22,seq228,r_36_277_76,1.0,0,76,76,87
37,r_164_17_157,seq115,seq35,r_164_17_157,1.0,0,157,157,87
137,seq35,seq204,r_199_74_59,r_199_74_59,1.0,32,91,59,87
41,r_345_250_48,seq66,seq139,r_345_250_48,1.0,0,48,48,87
179,seq160,r_336_214_169,r_354_322_32,r_336_214_169,1.0,0,169,169,87
92,r_352_224_15,r_164_17_157,seq93,r_352_224_15,0.99,-1,14,15,87
11,r_319_19_156,r_21_226_190,seq133,r_319_19_156,1.0,0,156,156,87
4,r_138_258_16,r_1_230_86,seq139,r_138_258_16,0.54,0,16,16,87
28,r_41_90_90,seq56,seq161,r_41_90_90,1.0,0,90,90,87
111,r_251_252_57,seq370,r_209_18_98,r_209_18_98,1.0,10,108,98,87
98,r_315_229_49,r_41_90_90,seq128,r_315_229_49,1.0,0,49,49,87
109,r_337_121_53,seq32,seq324,r_337_121_53,1.0,1,54,53,87
79,r_195_259_40,seq35,seq201,r_195_259_40,0.94,0,40,40,87
115,r_336_214_169,seq160,r_352_224_15,r_336_214_169,0.93,0,169,169,87
5,r_239_330_62,seq220,seq45,r_239_330_62,0.51,10,72,62,87
154,seq77,r_254_0_121,r_297_148_122,r_254_0_121,0.99,1,122,121,87
112,r_339_369_59,seq216,r_112_256_4,r_339_369_59,0.87,2,61,59,87
103,r_334_58_178,seq201,r_145_237_199,r_334_58_178,0.97,0,178,178,87
91,r_64_343_67,r_251_252_57,r_269_332_6,r_64_343_67,1.0,0,67,67,87
172,seq128,r_374_353_171,r_315_229_49,r_315_229_49,0.99,10,59,49,87
53,r_257_198_187,seq155,r_185_5_110,r_185_5_110,0.95,26,136,110,87
8,r_368_348_38,r_40_342_182,seq267,r_368_348_38,1.0,1,39,38,88
74,r_241_292_181,r_156_162_38,r_5_314_133,r_241_292_181,1.0,0,181,181,88
73,r_37_193_11,r_288_179_142,seq2,r_37_193_11,0.95,1,12,11,88
71,r_129_281_72,r_99_329_108,r_89_306_51,r_99_329_108,0.59,-36,72,108,88
117,r_332_231_48,r_308_90_178,seq72,r_332_231_48,1.0,0,48,48,88
21,r_9_137_18,seq72,r_114_299_109,r_114_299_109,0.95,56,165,109,88
6,r_353_213_187,seq96,r_24_80_47,r_353_213_187,0.89,1,188,187,88
60,r_121_23_103,seq131,seq68,r_121_23_103,1.0,0,103,103,88
99,r_151_360_127,r_275_234_141,r_128_333_100,r_151_360_127,0.94,11,138,127,88
107,r_67_138_21,r_16_124_190,r_221_236_21,r_67_138_21,0.95,0,21,21,88
69,r_149_78_36,r_106_51_62,seq240,r_149_78_36,1.0,0,36,36,88
110,r_107_113_143,r_40_342_182,r_5_314_133,r_40_342_182,1.0,-39,143,182,88
35,r_39_366_126,seq267,r_226_210_69,r_39_366_126,1.0,0,126,126,88
219,seq267,r_39_366_126,r_368_348_38,r_39_366_126,0.99,0,126,126,88
49,r_222_351_62,r_345_305_105,r_294_339_104,r_222_351_62,1.0,43,105,62,88
63,r_147_370_197,r_24_80_47,r_106_51_62,r_147_370_197,0.98,-131,66,197,88
80,r_200_355_10,r_75_328_27,seq301,r_200_355_10,0.94,2,12,10,88
27,r_365_91_107,seq167,r_297_125_69,r_297_125_69,0.6,40,109,69,88
98,r_114_299_109,r_278_46_178,r_9_137_18,r_114_299_109,1.0,0,109,109,88
67,r_6_192_141,seq256,r_226_210_69,r_6_192_141,0.67,1,142,141,88
79,r_272_315_162,seq185,r_221_236_21,r_272_315_162,0.93,5,167,162,88
24,r_278_46_178,seq238,r_350_86_15,r_278_46_178,0.99,1,179,178,88
39,r_316_268_171,seq144,r_226_210_69,r_316_268_171,1.0,1,172,171,88
65,r_69_47_41,seq58,seq201,r_69_47_41,0.99,3,44,41,88
33,r_76_252_183,r_194_62_187,r_5_314_133,r_194_62_187,0.67,-3,184,187,88
227,seq289,r_6_192_141,r_164_286_6,r_6_192_141,1.0,7,148,141,88
116,r_159_173_125,seq45,seq202,r_159_173_125,1.0,0,125,125,88
4,r_152_198_161,r_170_218_133,r_74_304_119,r_152_198_161,0.96,-36,125,161,88
28,r_26_64_95,r_152_198_161,seq92,r_26_64_95,1.0,0,95,95,88
114,r_250_43_24,r_157_255_159,seq60,r_250_43_24,0.79,-1,23,24,88
83,r_327_248_24,r_24_80_47,seq180,r_327_248_24,1.0,1,25,24,88
7,r_24_80_47,r_147_370_197,r_191_93_6,r_24_80_47,0.63,2,49,47,88
100,r_54_55_68,seq81,seq14,r_54_55_68,1.0,0,68,68,88
42,r_235_22_82,r_39_366_126,seq354,r_235_22_82,0.94,1,83,82,88
78,r_77_118_16,r_341_73_4,r_302_36_1,r_77_118_16,0.6,1,17,16,88
17,r_97_230_54,r_243_284_142,r_331_57_76,r_97_230_54,0.99,23,77,54,88
70,r_321_71_44,seq254,r_302_36_1,r_321_71_44,0.98,9,53,44,88
14,r_209_143_108,seq265,r_82_372_21,r_209_143_108,1.0,0,108,108,88
108,r_59_119_61,r_4_117_135,seq322,r_59_119_61,0.99,0,61,61,88
87,r_53_7_111,r_295_44_149,seq300,r_53_7_111,0.99,0,111,111,88
58,r_264_296_103,r_221_236_21,r_368_348_38,r_264_296_103,1.0,0,103,103,88
105,r_331_57_76,seq242,r_97_230_54,r_331_57_76,0.94,0,76,76,88
90,r_31_38_73,r_277_283_140,seq2,r_31_38_73,1.0,0,73,73,88
4,r_152_198_161,r_74_304_119,r_149_78_36,r_152_198_161,0.98,0,161,161,88
109,r_194_62_187,seq190,r_353_213_187,r_194_62_187,0.97,1,188,187,88
41,r_208_174_177,seq240,r_336_195_10,r_208_174_177,1.0,0,177,177,88
176,seq167,r_16_124_190,r_82_372_21,r_82_372_21,1.0,0,21,21,88
86,r_298_309_144,seq263,seq2,r_298_309_144,1.0,1,145,144,88
1,r_16_124_190,seq322,r_228_274_62,r_16_124_190,0.97,0,190,190,88
29,r_295_44_149,r_53_7_111,r_346_199_139,r_295_44_149,0.96,-38,111,149,88
3,r_288_179_142,seq35,r_34_94_10,r_288_179_142,0.96,2,144,142,88
57,r_4_117_135,r_120_27_39,r_128_333_100,r_4_117_135,1.0,0,135,135,88
0,r_18_8_175,seq249,r_365_91_107,r_18_8_175,0.99,0,175,175,88
56,r_275_234_141,seq142,seq1,r_275_234_141,1.0,1,142,141,88
34,r_115_20_92,r_99_329_108,seq49,r_115_20_92,1.0,0,92,92,88
50,r_158_116_53,seq349,r_191_93_6,r_158_116_53,0.81,0,53,53,88
120,r_259_359_139,seq12,seq21,r_259_359_139,1.0,1,140,139,88
53,r_99_329_108,seq15,r_3_17_21,r_99_329_108,0.99,-1,107,108,88
25,r_104_215_160,seq150,r_75_328_27,r_104_215_160,1.0,0,160,160,88
143,seq58,seq349,r_280_217_100,r_280_217_100,1.0,11,111,100,88
23,r_308_90_178,seq0,r_24_80_47,r_24_80_47,0.65,56,103,47,88
64,r_330_79_69,r_243_284_142,seq322,r_330_79_69,0.73,1,70,69,88
45,r_155_175_181,r_168_112_187,r_368_348_38,r_155_175_181,0.91,0,181,181,88
91,r_134_260_44,r_16_124_190,seq271,r_134_260_44,1.0,0,44,44,88
122,r_106_51_62,seq254,r_147_370_197,r_106_51_62,0.9,2,64,62,88
61,r_123_251_67,r_365_91_107,seq185,r_123_251_67,1.0,0,67,67,88
49,r_222_351_62,seq49,r_345_305_105,r_222_351_62,0.84,0,62,62,88
15,r_157_255_159,seq227,r_279_85_148,r_157_255_159,0.92,0,159,159,88
38,r_74_304_119,r_63_103_151,r_152_198_161,r_74_304_119,1.0,2,121,119,88
51,r_170_218_133,r_171_344_136,r_209_143_108,r_170_218_133,0.97,0,133,133,88
12,r_253_247_58,r_298_309_144,r_82_372_21,r_253_247_58,1.0,3,61,58,88
225,seq282,r_41_357_101,seq45,r_41_357_101,1.0,0,101,101,88
43,r_197_312_95,r_302_36_1,seq205,r_197_312_95,1.0,2,97,95,88
46,r_324_334_123,seq14,r_50_237_123,r_324_334_123,0.95,1,124,123,88
92,r_287_358_69,r_298_309_144,r_106_51_62,r_298_309_144,0.74,-75,69,144,88
32,r_350_86_15,r_229_160_149,seq65,r_350_86_15,1.0,0,15,15,88
77,r_307_364_20,r_331_57_76,seq211,r_307_364_20,0.99,1,21,20,88
111,r_50_237_123,r_16_124_190,r_324_334_123,r_50_237_123,1.0,0,123,123,88
9,r_128_333_100,r_16_124_190,r_115_20_92,r_16_124_190,1.0,-90,100,190,88
40,r_229_160_149,r_100_356_181,r_74_304_119,r_229_160_149,1.0,0,149,149,88
36,r_345_305_105,r_206_30_151,r_222_351_62,r_222_351_62,0.91,14,76,62,88
106,r_63_103_151,seq65,r_259_359_139,r_63_103_151,0.83,3,154,151,88
20,r_317_108_14,r_76_252_183,seq319,r_317_108_14,0.94,-1,13,14,88
21,r_9_137_18,r_16_124_190,seq72,r_9_137_18,1.0,0,18,18,88
119,r_100_356_181,seq88,seq140,r_100_356_181,1.0,1,182,181,88
47,r_156_162_38,r_241_292_181,r_288_179_142,r_241_292_181,1.0,0,181,181,88
81,r_84_154_27,r_262_311_120,seq273,r_84_154_27,0.98,4,31,27,88
95,r_297_125_69,r_229_160_149,seq189,r_297_125_69,1.0,0,69,69,88
102,r_66_214_80,r_40_342_182,r_24_80_47,r_66_214_80,1.0,0,80,80,88
19,r_89_306_51,r_294_339_104,seq265,r_89_306_51,0.98,0,51,51,88
121,r_346_199_139,seq246,r_295_44_149,r_346_199_139,0.99,0,139,139,88
115,r_341_73_4,r_157_255_159,r_275_234_141,r_341_73_4,0.43,45,49,4,88
112,r_325_101_35,r_52_178_190,seq21,r_325_101_35,1.0,0,35,35,88
74,r_241_292_181,r_52_178_190,r_156_162_38,r_156_162_38,1.0,3,41,38,88
22,r_221_236_21,r_262_311_120,r_67_138_21,r_221_236_21,0.57,0,21,21,88
30,r_40_342_182,seq153,r_288_179_142,r_40_342_182,1.0,0,182,182,88
4,r_152_198_161,r_26_64_95,r_170_218_133,r_26_64_95,1.0,0,95,95,88
23,r_308_90_178,r_24_80_47,r_156_162_38,r_308_90_178,0.97,0,178,178,88
11,r_226_210_69,r_279_85_148,r_330_79_69,r_226_210_69,1.0,0,69,69,88
16,r_52_178_190,r_34_94_10,r_89_306_51,r_52_178_190,0.86,0,190,190,88
54,r_228_274_62,seq233,seq371,r_228_274_62,0.84,0,62,62,88
118,r_225_313_110,r_157_255_159,r_209_143_108,r_157_255_159,1.0,-49,110,159,88
38,r_74_304_119,r_152_198_161,r_229_160_149,r_74_304_119,0.68,42,161,119,88
55,r_232_340_123,seq131,seq282,r_232_340_123,0.97,5,128,123,88
213,seq254,r_321_71_44,r_164_286_6,r_321_71_44,0.92,3,47,44,88
36,r_345_305_105,r_222_351_62,r_350_86_15,r_345_305_105,1.0,0,105,105,88
47,r_156_162_38,seq242,r_241_292_181,r_156_162_38,1.0,1,39,38,88
26,r_135_56_75,r_280_217_100,seq11,r_135_56_75,1.0,1,76,75,88
17,r_97_230_54,seq362,r_243_284_142,r_97_230_54,1.0,0,54,54,88
52,r_302_36_1,r_197_312_95,r_77_118_16,r_197_312_95,1.0,2,97,95,88
103,r_369_109_62,r_135_56_75,seq227,r_369_109_62,1.0,0,62,62,88
29,r_295_44_149,r_346_199_139,r_197_312_95,r_295_44_149,0.81,0,149,149,88
89,r_42_361_141,seq203,r_134_260_44,r_42_361_141,1.0,1,142,141,88
124,r_258_87_90,seq15,r_24_80_47,r_258_87_90,1.0,0,90,90,88
140,seq45,r_159_173_125,seq33,r_159_173_125,1.0,0,125,125,88
113,r_294_339_104,seq127,r_222_351_62,r_294_339_104,0.99,0,104,104,88
44,r_41_357_101,seq282,r_128_333_100,r_41_357_101,1.0,0,101,101,88
139,seq35,r_288_179_142,r_219_326_9,r_288_179_142,0.9,2,144,142,88
2,r_165_141_113,seq183,r_135_56_75,r_165_141_113,1.0,0,113,113,88
50,r_158_116_53,r_191_93_6,r_157_255_159,r_157_255_159,0.43,13,172,159,88
82,r_373_10_151,r_353_213_187,r_226_210_69,r_373_10_151,0.58,1,152,151,88
31,r_5_314_133,seq220,r_99_329_108,r_5_314_133,1.0,0,133,133,88
115,r_341_73_4,r_275_234_141,r_262_311_120,r_275_234_141,0.6,7,148,141,88
115,r_341_73_4,r_77_118_16,r_157_255_159,r_157_255_159,0.57,-138,21,159,88
7,r_24_80_47,r_191_93_6,r_258_87_90,r_258_87_90,0.98,13,103,90,88
97,r_277_283_140,seq72,r_350_86_15,r_277_283_140,1.0,2,142,140,88
85,r_3_17_21,r_232_340_123,seq319,r_3_17_21,0.98,0,21,21,88
37,r_262_311_120,r_272_315_162,seq263,r_262_311_120,0.99,4,124,120,88
66,r_182_320_145,seq180,seq371,r_182_320_145,1.0,0,145,145,88
68,r_243_284_142,seq92,seq335,r_243_284_142,1.0,1,143,142,88
142,seq49,seq349,r_128_333_100,r_128_333_100,1.0,6,106,100,88
62,r_171_344_136,r_170_218_133,r_5_314_133,r_171_344_136,0.95,-1,135,136,88
104,r_206_30_151,seq188,r_24_80_47,r_206_30_151,1.0,1,152,151,88
76,r_280_217_100,seq65,seq58,r_280_217_100,1.0,2,102,100,88
88,r_257_244_158,seq68,r_226_210_69,r_257_244_158,0.98,1,159,158,88
123,r_191_93_6,r_308_90_178,r_66_214_80,r_66_214_80,1.0,17,97,80,88
176,seq177,r_82_350_60,r_281_123_37,r_82_350_60,1.0,0,60,60,89
66,r_204_340_95,seq56,seq269,r_204_340_95,0.97,1,96,95,89
90,r_203_92_138,seq75,r_226_94_47,r_203_92_138,1.0,0,138,138,89
36,r_7_67_137,r_331_121_166,r_156_128_39,r_7_67_137,0.95,0,137,137,89
0,r_118_60_174,seq172,seq297,r_118_60_174,0.97,0,174,174,89
41,r_80_84_199,r_244_238_100,r_34_369_65,r_80_84_199,0.7,-99,100,199,89
102,r_113_171_165,r_174_217_183,r_204_340_95,r_113_171_165,1.0,0,165,165,89
69,r_45_115_25,r_250_256_191,r_174_217_183,r_45_115_25,1.0,0,25,25,89
116,r_226_94_47,r_1_148_174,r_82_350_60,r_226_94_47,1.0,13,60,47,89
107,r_373_11_11,r_201_225_71,seq158,r_201_225_71,0.78,-60,11,71,89
204,seq259,r_91_197_100,r_195_260_199,r_91_197_100,1.0,-1,99,100,89
115,r_134_81_176,seq51,r_258_119_17,r_134_81_176,1.0,0,176,176,89
7,r_34_369_65,seq19,r_80_84_199,r_34_369_65,1.0,1,66,65,89
35,r_258_119_17,r_118_60_174,seq255,r_258_119_17,0.99,1,18,17,89
222,seq297,r_211_192_99,seq332,r_211_192_99,1.0,0,99,99,89
85,r_135_231_55,r_159_221_142,r_265_3_19,r_135_231_55,0.98,0,55,55,89
94,r_112_160_98,seq139,r_195_260_199,r_112_160_98,1.0,0,98,98,89
80,r_74_308_122,r_228_143_128,r_242_9_83,r_242_9_83,0.91,39,122,83,89
217,seq291,r_370_153_105,r_279_305_8,r_370_153_105,1.0,0,105,105,89
43,r_63_275_41,seq270,seq68,r_63_275_41,1.0,0,41,41,89
34,r_29_313_26,r_12_240_148,seq236,r_29_313_26,1.0,0,26,26,89
9,r_312_337_149,seq287,r_102_39_96,r_312_337_149,1.0,0,149,149,89
57,r_40_210_123,seq178,seq130,r_40_210_123,1.0,0,123,123,89
101,r_49_124_149,r_195_260_199,r_100_215_14,r_49_124_149,1.0,2,151,149,89
4,r_44_229_122,seq291,r_129_372_69,r_44_229_122,1.0,0,122,122,89
86,r_241_150_39,seq126,r_63_275_41,r_241_150_39,0.6,5,44,39,89
123,r_69_181_127,r_140_103_185,seq355,r_69_181_127,0.99,0,127,127,89
100,r_242_9_83,r_132_202_147,seq5,r_242_9_83,1.0,0,83,83,89
95,r_281_123_37,r_118_60_174,seq177,r_118_60_174,0.53,-137,37,174,89
56,r_97_54_104,seq117,seq157,r_97_54_104,1.0,0,104,104,89
24,r_65_26_174,seq319,r_201_225_71,r_65_26_174,1.0,0,174,174,89
99,r_250_256_191,seq247,r_343_284_199,r_250_256_191,0.77,-1,190,191,89
104,r_370_153_105,seq291,r_63_275_41,r_370_153_105,1.0,0,105,105,89
29,r_125_368_111,seq66,seq104,r_125_368_111,1.0,0,111,111,89
144,seq75,r_203_92_138,r_83_264_38,r_203_92_138,1.0,0,138,138,89
55,r_156_128_39,r_20_274_66,seq318,r_156_128_39,0.99,1,40,39,89
165,seq154,r_61_227_71,r_83_264_38,r_61_227_71,1.0,-3,68,71,89
32,r_228_143_128,seq355,r_194_188_4,r_228_143_128,1.0,0,128,128,89
16,r_361_324_56,r_189_334_158,seq25,r_361_324_56,1.0,1,57,56,89
25,r_70_71_30,r_281_123_37,seq78,r_70_71_30,1.0,0,30,30,89
27,r_32_162_61,r_176_205_61,seq10,r_32_162_61,1.0,0,61,61,89
98,r_100_215_14,r_189_334_158,seq72,r_100_215_14,0.99,0,14,14,89
1,r_201_225_71,r_199_329_106,seq259,r_201_225_71,1.0,0,71,71,89
106,r_17_131_191,r_99_88_128,r_364_6_8,r_17_131_191,0.44,-144,47,191,89
19,r_211_192_99,seq297,seq303,r_211_192_99,1.0,0,99,99,89
120,r_109_356_46,r_228_143_128,seq66,r_109_356_46,1.0,0,46,46,89
124,r_99_88_128,seq164,r_258_119_17,r_99_88_128,1.0,0,128,128,89
121,r_183_323_132,r_203_92_138,r_261_0_99,r_183_323_132,1.0,1,133,132,89
61,r_141_335_29,seq269,seq47,r_141_335_29,1.0,0,29,29,89
208,seq268,r_343_284_199,r_339_359_152,r_339_359_152,0.77,8,160,152,89
78,r_151_43_151,seq180,r_201_225_71,r_151_43_151,0.99,0,151,151,89
208,seq268,r_272_28_140,r_343_284_199,r_272_28_140,1.0,0,140,140,89
147,seq78,r_261_0_99,r_70_71_30,r_261_0_99,0.82,2,101,99,89
76,r_107_167_53,seq77,seq352,r_107_167_53,1.0,1,54,53,89
89,r_87_351_79,seq352,seq355,r_87_351_79,0.82,3,82,79,89
79,r_95_206_43,r_203_92_138,seq252,r_95_206_43,1.0,1,44,43,89
45,r_298_214_104,r_370_153_105,seq186,r_298_214_104,1.0,0,104,104,89
67,r_73_277_145,seq292,r_347_161_185,r_73_277_145,1.0,8,153,145,89
21,r_354_212_182,seq255,r_102_39_96,r_354_212_182,0.99,0,182,182,89
119,r_8_365_145,seq169,r_100_215_14,r_8_365_145,1.0,0,145,145,89
51,r_190_96_141,seq306,r_279_305_8,r_190_96_141,1.0,0,141,141,89
227,seq309,seq72,r_226_94_47,r_226_94_47,1.0,1,48,47,89
118,r_299_145_81,r_159_221_142,r_258_119_17,r_299_145_81,1.0,0,81,81,89
20,r_133_235_108,seq236,r_107_167_53,r_133_235_108,1.0,0,108,108,89
109,r_257_2_114,seq318,r_149_336_73,r_257_2_114,1.0,0,114,114,89
23,r_89_341_100,seq327,r_31_234_45,r_89_341_100,1.0,0,100,100,89
50,r_12_240_148,seq108,r_62_321_41,r_12_240_148,1.0,0,148,148,89
54,r_62_321_41,r_65_26_174,r_48_16_49,r_62_321_41,1.0,0,41,41,89
108,r_50_64_23,r_125_368_111,seq213,r_50_64_23,0.84,2,25,23,89
112,r_273_30_169,seq233,r_343_284_199,r_273_30_169,1.0,0,169,169,89
28,r_20_274_66,r_7_67_137,seq56,r_20_274_66,1.0,0,66,66,89
40,r_132_202_147,r_138_267_27,r_89_341_100,r_89_341_100,0.94,47,147,100,89
38,r_159_221_142,seq56,r_271_222_76,r_159_221_142,1.0,-1,141,142,89
33,r_173_254_95,r_86_35_156,seq5,r_173_254_95,0.61,0,95,95,89
218,seq292,r_73_277_145,r_50_64_23,r_73_277_145,0.94,9,154,145,89
86,r_241_150_39,r_63_275_41,seq19,r_63_275_41,0.49,32,73,41,89
14,r_272_28_140,seq268,r_185_223_187,r_272_28_140,1.0,0,140,140,89
47,r_220_38_51,r_250_256_191,r_41_46_2,r_220_38_51,1.0,0,51,51,89
68,r_138_267_27,r_343_284_199,seq170,r_138_267_27,1.0,0,27,27,89
74,r_193_328_171,r_354_212_182,r_339_359_152,r_193_328_171,0.58,-5,166,171,89
83,r_185_223_187,r_86_35_156,r_272_28_140,r_185_223_187,1.0,-31,156,187,89
11,r_349_345_147,r_1_148_174,seq287,r_349_345_147,1.0,0,147,147,89
70,r_82_350_60,seq177,r_226_94_47,r_82_350_60,1.0,0,60,60,89
12,r_1_148_174,seq303,r_173_254_95,r_1_148_174,0.94,1,175,174,89
31,r_283_24_79,r_80_84_199,r_107_167_53,r_283_24_79,0.77,0,79,79,89
88,r_116_219_44,r_228_143_128,seq296,r_116_219_44,1.0,0,44,44,89
243,seq352,r_90_196_49,r_107_167_53,r_107_167_53,0.97,8,61,53,89
76,r_107_167_53,seq352,r_133_235_108,r_133_235_108,0.56,63,171,108,89
159,seq136,seq322,r_111_106_58,r_111_106_58,1.0,6,64,58,89
42,r_176_205_61,r_32_162_61,seq184,r_176_205_61,1.0,0,61,61,89
60,r_244_238_100,r_80_84_199,seq158,r_244_238_100,1.0,0,100,100,89
48,r_61_227_71,r_204_340_95,seq130,r_61_227_71,1.0,0,71,71,89
26,r_83_264_38,r_32_162_61,seq154,r_32_162_61,0.86,-23,38,61,89
245,seq355,seq163,r_69_181_127,r_69_181_127,1.0,0,127,127,89
72,r_31_234_45,r_118_60_174,seq155,r_31_234_45,1.0,0,45,45,89
87,r_129_372_69,seq130,seq175,r_129_372_69,1.0,1,70,69,89
64,r_271_222_76,r_80_84_199,seq19,r_271_222_76,1.0,0,76,76,89
114,r_86_35_156,r_185_223_187,seq114,r_86_35_156,1.0,0,156,156,89
58,r_149_336_73,r_283_24_79,r_82_350_60,r_149_336_73,1.0,0,73,73,89
17,r_304_58_35,r_40_210_123,seq200,r_304_58_35,1.0,0,35,35,89
93,r_288_166_43,r_189_334_158,seq27,r_288_166_43,1.0,0,43,43,89
175,seq175,seq269,r_129_372_69,r_129_372_69,1.0,0,69,69,89
71,r_339_359_152,r_174_217_183,seq268,r_339_359_152,1.0,1,153,152,89
75,r_90_196_49,seq352,seq306,r_90_196_49,1.0,2,51,49,89
37,r_21_371_162,r_354_212_182,r_97_54_104,r_21_371_162,0.99,0,162,162,89
97,r_325_358_134,seq178,r_201_225_71,r_325_358_134,0.57,5,139,134,89
5,r_102_39_96,seq332,r_141_335_29,r_102_39_96,1.0,0,96,96,89
106,r_17_131_191,r_364_6_8,r_80_84_199,r_17_131_191,0.44,-1,190,191,89
81,r_199_329_106,seq157,r_63_275_41,r_199_329_106,1.0,1,107,106,89
49,r_301_182_149,r_354_212_182,r_198_42_66,r_301_182_149,0.95,0,149,149,89
6,r_152_348_16,r_304_58_35,seq56,r_152_348_16,0.94,0,16,16,89
225,seq306,r_190_96_141,r_90_196_49,r_190_96_141,1.0,0,141,141,89
18,r_93_362_105,seq293,r_220_38_51,r_220_38_51,0.58,55,106,51,89
10,r_91_197_100,seq259,seq51,r_91_197_100,1.0,0,100,100,89
59,r_265_3_19,seq53,seq178,r_265_3_19,0.99,3,22,19,89
96,r_278_52_22,r_118_60_174,seq353,r_278_52_22,1.0,0,22,22,89
13,r_189_334_158,seq10,r_125_368_111,r_189_334_158,0.66,0,158,158,89
63,r_261_0_99,seq78,seq184,r_261_0_99,1.0,2,101,99,89
193,seq237,r_17_131_191,r_62_321_41,r_62_321_41,1.0,82,123,41,89
110,r_57_330_91,r_204_340_95,r_195_260_199,r_57_330_91,1.0,0,91,91,89
40,r_132_202_147,r_242_9_83,r_138_267_27,r_242_9_83,0.93,0,83,83,89
46,r_98_276_128,seq19,seq302,r_98_276_128,1.0,-1,127,128,89
173,seq170,seq209,r_138_267_27,r_138_267_27,0.87,17,44,27,89
185,seq213,r_189_334_158,r_50_64_23,r_189_334_158,0.67,-95,63,158,89
113,r_142_22_152,seq209,seq110,r_142_22_152,1.0,0,152,152,89
62,r_346_300_140,r_1_148_174,seq126,r_346_300_140,1.0,0,140,140,89
92,r_317_208_80,r_261_0_99,seq230,r_317_208_80,1.0,0,80,80,89
6,r_234_30_22,seq116,seq119,r_234_30_22,1.0,0,22,22,90
4,r_332_302_116,seq170,r_354_227_41,r_354_227_41,0.81,75,116,41,90
54,r_92_331_96,seq171,r_251_193_41,r_92_331_96,0.72,0,96,96,90
9,r_241_63_169,seq188,seq191,r_241_63_169,1.0,1,170,169,90
41,r_161_25_96,r_70_81_149,r_364_102_26,r_161_25_96,1.0,1,97,96,90
162,seq118,r_218_280_176,r_6_262_90,r_218_280_176,1.0,0,176,176,90
0,r_307_176_172,seq268,r_190_65_122,r_307_176_172,0.99,2,174,172,90
45,r_32_254_10,r_0_136_197,seq66,r_32_254_10,0.96,0,10,10,90
94,r_56_368_25,r_208_337_110,r_340_22_183,r_56_368_25,0.92,0,25,25,90
55,r_94_353_76,r_41_100_127,seq142,r_94_353_76,1.0,2,78,76,90
24,r_80_120_160,r_183_77_171,r_138_33_8,r_80_120_160,1.0,1,161,160,90
186,seq177,r_330_163_197,r_374_137_132,r_374_137_132,1.0,2,134,132,90
236,seq317,r_71_38_115,r_143_148_7,r_71_38_115,0.9,-19,96,115,90
84,r_213_103_78,r_350_247_165,seq200,r_213_103_78,1.0,0,78,78,90
110,r_354_227_41,r_287_215_85,r_73_243_189,r_354_227_41,1.0,0,41,41,90
102,r_286_125_118,r_51_352_101,seq140,r_286_125_118,0.83,0,118,118,90
93,r_316_299_59,r_131_1_60,r_56_368_25,r_56_368_25,0.95,34,59,25,90
63,r_270_166_99,r_198_335_162,r_67_122_135,r_270_166_99,1.0,1,100,99,90
187,seq178,r_183_77_171,r_235_266_24,r_183_77_171,0.7,4,175,171,90
174,seq142,seq301,r_94_353_76,r_94_353_76,0.91,75,151,76,90
171,seq139,seq229,r_329_13_58,r_329_13_58,1.0,16,74,58,90
48,r_172_168_155,seq216,r_55_130_58,r_172_168_155,1.0,0,155,155,90
85,r_44_152_27,r_6_262_90,r_340_22_183,r_44_152_27,1.0,0,27,27,90
32,r_82_315_152,seq284,seq23,r_82_315_152,1.0,0,152,152,90
1,r_39_339_36,seq191,r_234_30_22,r_39_339_36,1.0,0,36,36,90
22,r_244_349_75,seq358,seq205,r_244_349_75,0.99,0,75,75,90
116,r_8_181_54,seq210,seq7,r_8_181_54,1.0,0,54,54,90
79,r_251_193_41,r_237_204_143,r_92_331_96,r_251_193_41,0.53,57,98,41,90
109,r_218_280_176,seq118,r_51_352_101,r_218_280_176,0.95,0,176,176,90
39,r_324_345_79,r_183_77_171,r_267_147_46,r_267_147_46,0.81,41,87,46,90
217,seq269,r_237_204_143,r_92_331_96,r_92_331_96,0.41,-1,95,96,90
15,r_42_106_77,r_73_243_189,r_78_212_20,r_42_106_77,1.0,1,78,77,90
13,r_237_204_143,r_370_86_74,r_251_193_41,r_251_193_41,0.89,21,62,41,90
205,seq224,r_154_93_111,seq88,r_154_93_111,0.68,30,141,111,90
52,r_64_272_92,r_307_176_172,seq271,r_64_272_92,1.0,0,92,92,90
75,r_328_319_10,r_11_297_191,seq117,r_328_319_10,1.0,0,10,10,90
46,r_126_91_62,r_183_77_171,seq52,r_126_91_62,1.0,0,62,62,90
23,r_190_65_122,seq239,seq43,r_190_65_122,0.78,3,125,122,90
51,r_127_255_122,seq96,r_126_91_62,r_127_255_122,1.0,0,122,122,90
107,r_341_49_161,seq189,seq72,r_341_49_161,1.0,0,161,161,90
47,r_261_327_163,seq119,seq27,r_261_327_163,0.93,0,163,163,90
67,r_4_230_190,seq229,r_261_327_163,r_4_230_190,0.85,0,190,190,90
31,r_372_10_49,r_55_130_58,r_364_102_26,r_55_130_58,0.99,-8,50,58,90
105,r_26_34_118,r_11_297_191,r_67_122_135,r_26_34_118,1.0,7,125,118,90
3,r_11_297_191,seq209,r_149_104_84,r_11_297_191,0.91,-1,190,191,90
49,r_51_352_101,seq23,seq196,r_51_352_101,1.0,0,101,101,90
151,seq88,r_225_194_131,seq224,r_225_194_131,1.0,-8,123,131,90
106,r_276_228_141,seq123,r_154_93_111,r_276_228_141,1.0,-1,140,141,90
80,r_144_342_110,r_70_81_149,r_48_59_92,r_144_342_110,1.0,2,112,110,90
66,r_360_58_69,r_42_106_77,r_55_130_58,r_42_106_77,0.9,-9,68,77,90
76,r_318_223_119,r_198_335_162,r_143_148_7,r_318_223_119,0.96,11,130,119,90
249,seq369,r_70_81_149,r_373_288_72,r_373_288_72,0.64,4,76,72,90
111,r_282_274_128,r_172_168_155,r_203_37_102,r_282_274_128,0.59,0,128,128,90
34,r_330_163_197,seq177,r_48_59_92,r_48_59_92,1.0,2,94,92,90
119,r_370_86_74,seq134,seq291,r_370_86_74,0.81,11,85,74,90
11,r_70_81_149,seq132,seq314,r_70_81_149,1.0,1,150,149,90
120,r_79_249_140,seq283,r_312_300_28,r_79_249_140,1.0,0,140,140,90
101,r_346_109_69,seq7,r_251_193_41,r_346_109_69,1.0,-1,68,69,90
57,r_131_1_60,r_346_109_69,r_145_248_3,r_131_1_60,1.0,0,60,60,90
42,r_374_137_132,seq72,seq177,r_374_137_132,1.0,0,132,132,90
60,r_157_111_164,r_35_20_30,r_333_294_122,r_35_20_30,0.99,134,164,30,90
82,r_290_197_68,r_278_107_81,seq7,r_290_197_68,0.95,0,68,68,90
12,r_71_38_115,seq317,r_105_17_12,r_71_38_115,0.93,0,115,115,90
112,r_371_256_83,r_79_249_140,seq363,r_371_256_83,0.98,3,86,83,90
59,r_206_362_161,r_185_265_177,seq88,r_206_362_161,1.0,0,161,161,90
53,r_336_74_75,seq196,seq47,r_336_74_75,1.0,2,77,75,90
7,r_235_266_24,seq220,r_328_319_10,r_235_266_24,1.0,0,24,24,90
95,r_155_179_116,seq5,r_235_266_24,r_155_179_116,1.0,0,116,116,90
33,r_18_275_40,seq239,r_187_246_38,r_18_275_40,0.86,0,40,40,90
74,r_169_217_47,seq205,seq239,r_169_217_47,1.0,0,47,47,90
122,r_356_232_53,r_156_355_180,r_138_33_8,r_356_232_53,0.98,0,53,53,90
8,r_48_59_92,seq27,r_330_163_197,r_48_59_92,0.9,0,92,92,90
26,r_198_335_162,r_35_20_30,seq158,r_198_335_162,0.98,1,163,162,90
79,r_251_193_41,r_332_302_116,r_237_204_143,r_251_193_41,1.0,0,41,41,90
222,seq284,r_82_315_152,r_39_339_36,r_82_315_152,0.98,0,152,152,90
206,seq226,r_370_86_74,r_187_246_38,r_187_246_38,1.0,14,52,38,90
58,r_333_294_122,seq219,r_187_246_38,r_333_294_122,1.0,0,122,122,90
70,r_359_2_179,seq27,r_6_262_90,r_359_2_179,0.77,-1,178,179,90
71,r_78_212_20,r_332_302_116,seq146,r_78_212_20,1.0,0,20,20,90
139,seq52,r_208_337_110,r_126_91_62,r_126_91_62,0.97,6,68,62,90
65,r_208_337_110,seq291,r_67_122_135,r_208_337_110,1.0,4,114,110,90
99,r_245_321_118,r_341_49_161,r_336_74_75,r_245_321_118,1.0,0,118,118,90
25,r_225_194_131,seq88,r_149_104_84,r_225_194_131,1.0,0,131,131,90
97,r_187_246_38,seq142,seq226,r_187_246_38,1.0,0,38,38,90
168,seq132,r_70_81_149,r_9_357_49,r_70_81_149,0.99,-75,74,149,90
69,r_154_93_111,seq224,seq171,r_154_93_111,0.89,4,115,111,90
50,r_329_13_58,r_172_168_155,seq139,r_329_13_58,1.0,2,60,58,90
102,r_286_125_118,seq196,r_51_352_101,r_51_352_101,0.89,-1,100,101,90
78,r_264_351_68,r_172_168_155,seq189,r_264_351_68,1.0,1,69,68,90
89,r_211_277_21,r_374_137_132,seq358,r_211_277_21,0.99,0,21,21,90
44,r_350_247_165,seq47,r_208_337_110,r_350_247_165,1.0,5,170,165,90
38,r_287_215_85,r_286_125_118,seq135,r_287_215_85,1.0,2,87,85,90
92,r_150_343_16,r_373_288_72,r_340_22_183,r_373_288_72,0.82,-54,18,72,90
18,r_267_147_46,r_257_252_199,r_105_17_12,r_267_147_46,1.0,0,46,46,90
90,r_347_289_56,r_92_331_96,seq96,r_347_289_56,1.0,1,57,56,90
81,r_121_83_19,r_108_69_21,seq119,r_121_83_19,0.58,1,20,19,90
37,r_323_180_138,seq175,r_336_74_75,r_323_180_138,0.98,-1,137,138,90
68,r_108_69_21,seq205,seq7,r_108_69_21,0.53,2,23,21,90
123,r_19_334_116,seq135,r_340_22_183,r_19_334_116,1.0,0,116,116,90
21,r_183_77_171,seq117,r_165_253_28,r_183_77_171,0.83,-5,166,171,90
43,r_75_296_155,seq229,seq291,r_75_296_155,1.0,0,155,155,90
13,r_237_204_143,r_251_193_41,seq5,r_237_204_143,1.0,0,143,143,90
17,r_41_100_127,r_298_207_192,r_154_93_111,r_41_100_127,0.96,0,127,127,90
104,r_242_114_18,r_237_204_143,r_18_275_40,r_242_114_18,0.87,52,70,18,90
104,r_242_114_18,r_14_313_190,r_237_204_143,r_14_313_190,0.58,-170,20,190,90
14,r_373_288_72,seq326,seq369,r_373_288_72,1.0,0,72,72,90
40,r_9_357_49,r_185_265_177,seq132,r_9_357_49,0.76,3,52,49,90
61,r_278_107_81,r_46_273_164,r_251_193_41,r_278_107_81,0.64,1,82,81,90
19,r_6_262_90,r_127_255_122,seq283,r_127_255_122,1.0,-32,90,122,90
2,r_149_104_84,seq47,seq40,r_149_104_84,1.0,0,84,84,90
175,seq146,seq5,r_78_212_20,r_78_212_20,1.0,30,50,20,90
20,r_55_130_58,seq239,r_9_357_49,r_55_130_58,1.0,0,58,58,90
38,r_287_215_85,r_354_227_41,r_286_125_118,r_354_227_41,1.0,0,41,41,90
103,r_303_199_19,r_237_204_143,r_105_17_12,r_303_199_19,1.0,1,20,19,90
94,r_56_368_25,r_340_22_183,r_316_299_59,r_316_299_59,1.0,29,88,59,90
117,r_115_95_19,r_41_100_127,seq236,r_115_95_19,0.7,1,20,19,90
27,r_310_12_126,seq301,r_143_148_7,r_310_12_126,0.99,1,127,126,90
86,r_31_99_161,seq3,r_51_352_101,r_31_99_161,0.99,0,161,161,90
16,r_24_153_111,seq200,seq66,r_24_153_111,1.0,1,112,111,90
117,r_309_26_152,r_369_266_165,r_96_268_38,r_96_268_38,1.0,4,42,38,91
48,r_346_229_42,r_80_84_60,r_0_12_55,r_0_12_55,0.63,7,62,55,91
81,r_176_66_91,seq240,r_83_301_4,r_176_66_91,0.99,4,95,91,91
119,r_330_223_80,r_204_29_176,r_162_183_50,r_330_223_80,1.0,0,80,80,91
31,r_356_253_35,r_194_196_47,seq340,r_356_253_35,1.0,0,35,35,91
59,r_80_84_60,seq318,r_246_67_5,r_246_67_5,0.59,56,61,5,91
44,r_275_242_192,seq104,r_368_259_126,r_275_242_192,0.74,-11,181,192,91
46,r_0_12_55,seq35,r_346_229_42,r_346_229_42,0.9,19,61,42,91
65,r_23_85_27,seq164,r_24_163_198,r_23_85_27,0.9,0,27,27,91
40,r_342_21_110,seq360,seq300,r_342_21_110,1.0,-1,109,110,91
183,seq191,seq19,r_217_161_97,r_217_161_97,1.0,2,99,97,91
45,r_251_118_63,r_311_100_134,seq254,r_251_118_63,0.92,8,71,63,91
43,r_341_172_74,r_370_65_147,seq360,r_341_172_74,1.0,0,74,74,91
7,r_155_293_105,r_87_174_196,r_281_147_53,r_155_293_105,1.0,4,109,105,91
71,r_112_339_60,r_275_242_192,r_27_291_91,r_27_291_91,0.73,9,100,91,91
99,r_358_260_48,r_11_257_74,seq116,r_358_260_48,1.0,-1,47,48,91
92,r_312_299_20,r_214_348_168,r_47_248_41,r_312_299_20,0.95,0,20,20,91
212,seq274,r_219_114_73,seq247,r_219_114_73,1.0,6,79,73,91
121,r_136_308_155,seq97,r_271_62_97,r_136_308_155,1.0,2,157,155,91
3,r_186_159_5,r_175_143_160,r_115_319_89,r_115_319_89,0.95,32,121,89,91
205,seq254,seq55,r_251_118_63,r_251_118_63,0.63,16,79,63,91
21,r_48_76_111,r_135_9_187,r_272_294_76,r_48_76_111,0.98,2,113,111,91
49,r_43_170_176,seq4,r_169_210_161,r_169_210_161,0.88,3,164,161,91
19,r_1_125_59,r_27_291_91,seq345,r_1_125_59,1.0,1,60,59,91
116,r_121_324_77,seq352,seq329,r_121_324_77,0.91,0,77,77,91
52,r_220_106_40,seq108,seq126,r_220_106_40,1.0,0,40,40,91
38,r_204_29_176,seq98,r_14_154_46,r_204_29_176,0.8,4,180,176,91
36,r_239_237_148,seq97,seq192,r_239_237_148,0.98,0,148,148,91
198,seq240,r_176_66_91,r_101_166_23,r_101_166_23,0.92,-9,14,23,91
30,r_72_146_147,seq54,seq36,r_72_146_147,1.0,0,147,147,91
83,r_165_354_162,seq19,r_273_328_106,r_165_354_162,0.98,3,165,162,91
67,r_280_198_139,seq323,r_139_71_46,r_139_71_46,0.64,99,145,46,91
111,r_187_22_94,seq225,seq35,r_187_22_94,0.91,1,95,94,91
223,seq304,r_86_199_179,r_145_81_24,r_86_199_179,1.0,-3,176,179,91
97,r_365_69_156,seq128,r_1_125_59,r_365_69_156,1.0,1,157,156,91
128,seq5,r_368_259_126,r_194_196_47,r_368_259_126,0.71,-49,77,126,91
9,r_175_143_160,r_186_159_5,r_190_120_110,r_175_143_160,0.98,0,160,160,91
99,r_358_260_48,seq116,r_140_39_126,r_140_39_126,1.0,1,127,126,91
98,r_295_124_14,r_204_29_176,seq353,r_295_124_14,0.71,-4,10,14,91
35,r_201_258_76,r_155_293_105,seq13,r_201_258_76,0.97,0,76,76,91
57,r_151_42_79,r_365_69_156,seq58,r_151_42_79,1.0,0,79,79,91
227,seq318,r_173_197_146,r_14_154_46,r_173_197_146,1.0,0,146,146,91
62,r_96_268_38,r_10_363_107,r_309_26_152,r_96_268_38,1.0,-1,37,38,91
76,r_311_100_134,r_322_182_180,r_14_154_46,r_311_100_134,0.59,4,138,134,91
85,r_179_33_37,r_271_62_97,seq58,r_271_62_97,0.99,-48,49,97,91
50,r_314_51_113,r_175_143_160,seq54,r_314_51_113,1.0,0,113,113,91
211,seq270,r_271_62_97,r_194_196_47,r_271_62_97,0.99,-27,70,97,91
0,r_86_199_179,seq304,r_273_328_106,r_86_199_179,0.99,1,180,179,91
77,r_317_7_42,r_252_70_49,r_94_110_7,r_94_110_7,0.99,40,47,7,91
60,r_123_45_153,r_169_210_161,r_121_324_77,r_123_45_153,0.87,0,153,153,91
18,r_219_114_73,seq274,seq235,r_219_114_73,0.97,6,79,73,91
1,r_169_210_161,r_43_170_176,r_181_303_39,r_43_170_176,0.36,2,178,176,91
117,r_309_26_152,r_96_268_38,r_176_66_91,r_309_26_152,0.91,7,159,152,91
29,r_271_62_97,r_368_259_126,seq126,r_271_62_97,1.0,2,99,97,91
107,r_368_259_126,seq205,r_356_253_35,r_368_259_126,1.0,1,127,126,91
95,r_289_337_25,r_233_373_180,seq137,r_289_337_25,0.98,-2,23,25,91
34,r_315_41_179,seq360,r_175_143_160,r_315_41_179,0.99,0,179,179,91
120,r_190_120_110,seq93,seq91,r_190_120_110,0.96,3,113,110,91
56,r_211_133_38,r_86_199_179,seq132,r_211_133_38,1.0,-1,37,38,91
49,r_43_170_176,r_169_210_161,seq131,r_43_170_176,0.81,2,178,176,91
28,r_217_161_97,r_314_51_113,seq191,r_217_161_97,0.99,0,97,97,91
39,r_325_25_67,r_368_259_126,seq276,r_325_25_67,0.69,0,67,67,91
87,r_57_335_115,seq323,r_342_21_110,r_57_335_115,1.0,0,115,115,91
123,r_361_195_155,seq213,r_251_118_63,r_361_195_155,0.99,0,155,155,91
12,r_89_148_140,seq235,r_155_293_105,r_89_148_140,1.0,0,140,140,91
32,r_214_348_168,seq189,r_219_114_73,r_214_348_168,0.87,0,168,168,91
62,r_96_268_38,r_309_26_152,r_211_133_38,r_309_26_152,1.0,7,159,152,91
58,r_193_265_53,r_359_44_134,r_249_230_38,r_193_265_53,0.63,0,53,53,91
91,r_27_291_91,seq63,r_112_339_60,r_27_291_91,0.99,0,91,91,91
84,r_64_178_54,seq92,r_14_154_46,r_64_178_54,0.98,1,55,54,91
61,r_302_269_110,r_169_210_161,seq336,r_302_269_110,1.0,0,110,110,91
94,r_38_218_135,r_136_308_155,r_285_207_5,r_38_218_135,0.89,0,135,135,91
182,seq189,r_214_348_168,r_74_184_174,r_74_184_174,0.72,0,174,174,91
68,r_49_79_73,r_53_6_172,seq288,r_49_79_73,1.0,0,73,73,91
48,r_346_229_42,r_281_147_53,r_80_84_60,r_346_229_42,0.89,3,45,42,91
55,r_272_294_76,r_239_237_148,seq19,r_272_294_76,0.99,-1,75,76,91
102,r_212_168_89,seq32,seq90,r_212_168_89,0.95,2,91,89,91
13,r_162_183_50,r_369_266_165,seq8,r_162_183_50,1.0,0,50,50,91
115,r_306_34_63,seq113,seq137,r_306_34_63,1.0,1,64,63,91
110,r_366_287_134,r_315_41_179,r_285_207_5,r_366_287_134,1.0,-1,133,134,91
54,r_359_44_134,seq141,r_179_33_37,r_359_44_134,0.8,-2,132,134,91
33,r_305_338_92,seq372,seq238,r_305_338_92,1.0,-1,91,92,91
101,r_18_107_197,r_138_119_10,r_14_154_46,r_18_107_197,0.45,-59,138,197,91
82,r_74_184_174,seq4,seq189,r_74_184_174,1.0,0,174,174,91
109,r_153_267_24,seq191,seq32,r_153_267_24,0.89,5,29,24,91
100,r_115_319_89,seq300,r_186_159_5,r_115_319_89,1.0,1,90,89,91
54,r_359_44_134,r_193_265_53,seq141,r_359_44_134,0.74,-80,54,134,91
71,r_112_339_60,r_325_25_67,r_275_242_192,r_112_339_60,0.99,3,63,60,91
26,r_134_282_167,seq97,seq98,r_134_282_167,1.0,2,169,167,91
14,r_322_182_180,seq192,r_233_373_180,r_322_182_180,0.77,0,180,180,91
47,r_350_68_142,r_167_52_192,seq205,r_350_68_142,0.83,16,158,142,91
69,r_281_147_53,r_40_224_140,seq63,r_281_147_53,1.0,0,53,53,91
51,r_273_328_106,seq32,seq73,r_273_328_106,1.0,0,106,106,91
88,r_10_363_107,seq235,r_298_327_33,r_10_363_107,1.0,5,112,107,91
17,r_140_39_126,seq91,r_358_260_48,r_140_39_126,0.98,2,128,126,91
104,r_135_9_187,seq313,r_271_62_97,r_135_9_187,0.87,0,187,187,91
4,r_369_266_165,seq132,r_239_237_148,r_369_266_165,0.8,0,165,165,91
23,r_233_373_180,seq208,r_285_207_5,r_233_373_180,1.0,0,180,180,91
130,seq13,seq28,r_201_258_76,r_201_258_76,0.85,5,81,76,91
240,seq345,r_1_125_59,r_75_177_103,r_75_177_103,1.0,35,138,103,91
15,r_14_154_46,seq28,r_64_178_54,r_64_178_54,0.79,0,54,54,91
8,r_173_197_146,seq318,r_314_51_113,r_173_197_146,0.85,0,146,146,91
37,r_347_17_158,r_167_52_192,r_94_110_7,r_347_17_158,0.76,-1,157,158,91
238,seq343,seq300,r_145_81_24,r_145_81_24,0.66,127,151,24,91
237,seq340,r_48_76_111,r_356_253_35,r_356_253_35,0.82,19,54,35,91
66,r_194_196_47,r_47_248_41,seq270,r_194_196_47,0.89,25,72,47,91
49,r_43_170_176,seq90,seq4,r_43_170_176,0.43,-99,77,176,91
78,r_171_160_81,seq234,seq90,r_171_160_81,1.0,0,81,81,91
53,r_180_61_73,seq300,seq290,r_180_61_73,1.0,0,73,73,91
63,r_15_37_50,r_140_39_126,seq113,r_15_37_50,1.0,0,50,50,91
82,r_74_184_174,seq92,seq4,r_74_184_174,0.55,-74,100,174,91
166,seq128,r_365_69_156,seq189,r_365_69_156,1.0,-14,142,156,91
90,r_297_206_46,seq28,seq104,r_297_206_46,0.97,5,51,46,91
170,seq132,r_369_266_165,r_211_133_38,r_369_266_165,0.84,0,165,165,91
27,r_181_303_39,r_219_114_73,r_47_248_41,r_181_303_39,1.0,0,39,39,91
93,r_370_65_147,r_316_374_198,r_176_66_91,r_370_65_147,1.0,0,147,147,91
74,r_40_224_140,seq234,r_181_303_39,r_40_224_140,0.9,0,140,140,91
5,r_262_99_164,seq73,seq244,r_262_99_164,1.0,3,167,164,91
20,r_75_177_103,seq238,seq345,r_75_177_103,1.0,1,104,103,91
1,r_169_210_161,seq126,r_43_170_176,r_169_210_161,0.99,4,165,161,91
89,r_145_81_24,seq270,seq343,r_145_81_24,1.0,0,24,24,91
16,r_77_226_69,seq36,r_346_229_42,r_346_229_42,0.96,53,95,42,91
2,r_139_71_46,r_86_199_179,seq254,r_139_71_46,1.0,-1,45,46,91
8,r_232_358_79,seq42,r_72_343_27,r_232_358_79,1.0,0,79,79,92
202,seq243,r_176_101_105,r_304_314_53,r_304_314_53,1.0,52,105,53,92
208,seq263,r_355_183_175,r_211_80_29,r_355_183_175,0.98,2,177,175,92
30,r_230_20_1,r_123_151_59,r_207_221_68,r_123_151_59,0.98,1,60,59,92
50,r_156_154_36,seq5,seq152,r_156_154_36,1.0,0,36,36,92
49,r_13_33_18,r_121_70_179,seq131,r_13_33_18,1.0,0,18,18,92
98,r_144_247_61,seq212,seq9,r_144_247_61,1.0,1,62,61,92
25,r_368_279_177,seq295,seq157,r_368_279_177,0.94,0,177,177,92
36,r_235_277_58,seq58,seq88,r_235_277_58,0.99,2,60,58,92
9,r_281_124_150,seq294,seq169,r_281_124_150,0.97,1,151,150,92
46,r_180_205_132,seq268,seq1,r_180_205_132,1.0,0,132,132,92
94,r_53_259_151,seq21,r_13_33_18,r_53_259_151,1.0,0,151,151,92
115,r_59_137_15,r_281_124_150,seq353,r_59_137_15,1.0,0,15,15,92
42,r_251_316_157,seq88,r_144_247_61,r_251_316_157,0.97,0,157,157,92
51,r_195_162_163,seq96,r_13_33_18,r_195_162_163,1.0,0,163,163,92
15,r_299_242_93,seq99,r_372_126_34,r_299_242_93,1.0,0,93,93,92
176,seq169,r_95_108_46,r_281_124_150,r_281_124_150,1.0,1,151,150,92
104,r_270_66_89,r_281_124_150,r_32_362_81,r_281_124_150,0.66,-59,91,150,92
21,r_129_164_79,r_363_330_195,seq142,r_129_164_79,1.0,3,82,79,92
29,r_51_87_157,seq41,seq42,r_51_87_157,0.77,4,161,157,92
116,r_256_12_139,seq14,r_303_214_79,r_256_12_139,0.99,1,140,139,92
4,r_54_215_130,seq367,r_133_297_54,r_54_215_130,1.0,2,132,130,92
172,seq157,r_127_331_40,seq243,r_127_331_40,1.0,1,41,40,92
55,r_130_17_60,r_54_215_130,seq191,r_130_17_60,1.0,0,60,60,92
120,r_278_193_120,r_274_117_173,seq132,r_278_193_120,0.94,0,120,120,92
57,r_192_107_180,seq340,seq200,r_192_107_180,0.99,0,180,180,92
39,r_71_49_98,r_89_45_191,seq266,r_71_49_98,1.0,3,101,98,92
154,seq96,r_195_162_163,r_234_244_61,r_195_162_163,1.0,0,163,163,92
89,r_272_309_115,seq42,r_304_314_53,r_272_309_115,0.98,0,115,115,92
17,r_339_322_138,seq79,seq16,r_339_322_138,1.0,2,140,138,92
113,r_352_182_61,r_222_31_87,seq57,r_352_182_61,1.0,0,61,61,92
2,r_174_255_171,r_113_284_47,r_250_24_50,r_174_255_171,1.0,-121,50,171,92
35,r_347_27_104,r_274_117_173,seq321,r_347_27_104,1.0,0,104,104,92
117,r_23_346_45,r_122_282_111,seq92,r_23_346_45,0.42,0,45,45,92
65,r_3_354_68,r_274_117_173,seq269,r_3_354_68,1.0,0,68,68,92
47,r_64_236_113,r_363_330_195,r_166_118_171,r_64_236_113,1.0,0,113,113,92
0,r_305_76_176,seq201,r_141_0_162,r_305_76_176,0.65,1,177,176,92
81,r_265_264_102,r_252_128_4,r_303_214_79,r_265_264_102,1.0,0,102,102,92
2,r_174_255_171,r_250_24_50,r_292_44_101,r_174_255_171,0.92,1,172,171,92
90,r_133_297_54,r_112_37_41,seq340,r_133_297_54,0.97,0,54,54,92
95,r_210_185_110,r_256_12_139,seq136,r_210_185_110,0.95,5,115,110,92
227,seq321,r_194_120_47,seq269,r_194_120_47,1.0,0,47,47,92
92,r_348_260_52,seq55,seq50,r_348_260_52,1.0,2,54,52,92
103,r_229_175_47,r_222_31_87,seq373,r_229_175_47,1.0,0,47,47,92
11,r_81_351_86,seq1,r_225_140_39,r_225_140_39,0.98,16,55,39,92
12,r_335_110_51,seq293,seq261,r_335_110_51,0.99,0,51,51,92
91,r_228_300_107,seq170,seq58,r_228_300_107,1.0,0,107,107,92
108,r_111_172_93,r_347_27_104,r_59_137_15,r_111_172_93,0.91,0,93,93,92
143,seq56,r_195_162_163,r_329_30_52,r_329_30_52,0.8,2,54,52,92
131,seq9,r_122_282_111,r_144_247_61,r_122_282_111,0.64,0,111,111,92
52,r_250_24_50,r_174_255_171,r_71_49_98,r_174_255_171,0.94,1,172,171,92
194,seq226,r_35_94_113,seq340,r_35_94_113,1.0,0,113,113,92
139,seq41,r_51_87_157,seq55,r_51_87_157,0.49,4,161,157,92
1,r_166_118_171,r_64_236_113,seq226,r_166_118_171,0.94,2,173,171,92
33,r_63_85_51,r_216_319_131,seq269,r_63_85_51,1.0,3,54,51,92
97,r_10_275_59,seq169,seq243,r_10_275_59,1.0,0,59,59,92
38,r_122_282_111,seq9,seq364,r_122_282_111,1.0,0,111,111,92
76,r_207_221_68,seq345,r_230_20_1,r_207_221_68,0.9,3,71,68,92
9,r_281_124_150,r_270_66_89,seq294,r_270_66_89,0.99,2,91,89,92
53,r_258_116_129,seq7,seq16,r_258_116_129,0.87,4,133,129,92
58,r_310_22_59,r_153_254_117,seq324,r_310_22_59,0.75,0,59,59,92
19,r_329_30_52,r_186_26_178,r_68_288_33,r_329_30_52,0.88,2,54,52,92
229,seq324,seq100,r_310_22_59,r_310_22_59,0.96,47,106,59,92
52,r_250_24_50,r_83_46_180,r_174_255_171,r_250_24_50,0.99,2,52,50,92
72,r_355_183_175,seq263,r_235_277_58,r_355_183_175,0.73,2,177,175,92
5,r_28_197_150,seq61,seq42,r_28_197_150,1.0,0,150,150,92
62,r_176_101_105,seq243,r_123_151_59,r_123_151_59,1.0,46,105,59,92
34,r_68_288_33,r_220_291_139,seq56,r_68_288_33,0.64,0,33,33,92
10,r_220_291_139,seq16,r_73_109_24,r_220_291_139,0.95,2,141,139,92
56,r_304_314_53,r_222_31_87,seq312,r_304_314_53,1.0,0,53,53,92
79,r_127_331_40,seq157,seq245,r_127_331_40,1.0,1,41,40,92
119,r_181_36_90,seq241,seq239,r_181_36_90,1.0,1,91,90,92
7,r_121_70_179,seq209,r_160_276_123,r_121_70_179,1.0,1,180,179,92
96,r_113_284_47,r_174_255_171,seq5,r_113_284_47,1.0,0,47,47,92
186,seq201,r_305_76_176,r_84_125_37,r_305_76_176,0.93,1,177,176,92
31,r_199_253_117,seq5,seq367,r_199_253_117,1.0,3,120,117,92
22,r_222_31_87,r_256_12_139,r_230_20_1,r_222_31_87,1.0,0,87,87,92
67,r_342_52_117,seq333,seq209,r_342_52_117,0.84,1,118,117,92
47,r_64_236_113,r_166_118_171,seq21,r_166_118_171,1.0,2,173,171,92
23,r_234_244_61,r_222_31_87,seq96,r_234_244_61,0.75,0,61,61,92
114,r_72_343_27,seq257,seq367,r_72_343_27,0.96,2,29,27,92
112,r_106_38_144,seq50,r_93_296_145,r_106_38_144,1.0,0,144,144,92
83,r_103_307_171,r_95_108_46,r_329_30_52,r_103_307_171,1.0,0,171,171,92
188,seq203,r_19_161_185,r_93_296_145,r_93_296_145,1.0,4,149,145,92
48,r_292_44_101,seq261,seq114,r_292_44_101,1.0,0,101,101,92
20,r_77_78_98,r_301_145_191,r_40_86_64,r_77_78_98,1.0,0,98,98,92
14,r_211_80_29,r_347_27_104,seq263,r_211_80_29,1.0,1,30,29,92
1,r_166_118_171,r_290_74_118,r_64_236_113,r_64_236_113,0.93,6,119,113,92
155,seq99,r_299_242_93,r_370_283_30,r_299_242_93,0.98,0,93,93,92
13,r_206_361_84,r_64_236_113,r_112_37_41,r_206_361_84,1.0,2,86,84,92
209,seq266,r_43_11_170,r_71_49_98,r_71_49_98,0.74,14,112,98,92
84,r_141_0_162,r_83_46_180,seq302,r_141_0_162,1.0,0,162,162,92
88,r_313_48_156,r_195_162_163,r_13_33_18,r_13_33_18,1.0,138,156,18,92
26,r_225_140_39,r_232_358_79,seq246,r_225_140_39,1.0,0,39,39,92
110,r_6_287_167,r_360_159_182,r_206_361_84,r_6_287_167,1.0,0,167,167,92
41,r_290_74_118,r_216_319_131,seq326,r_290_74_118,1.0,1,119,118,92
106,r_366_286_90,seq14,r_165_240_7,r_366_286_90,0.82,31,121,90,92
123,r_248_344_93,seq321,r_329_30_52,r_248_344_93,1.0,0,93,93,92
124,r_271_98_181,seq29,r_28_197_150,r_271_98_181,1.0,0,181,181,92
27,r_177_67_9,seq142,r_194_120_47,r_194_120_47,1.0,9,56,47,92
85,r_84_125_37,r_198_82_74,seq201,r_84_125_37,0.96,0,37,37,92
59,r_95_108_46,r_103_307_171,r_281_124_150,r_95_108_46,0.98,125,171,46,92
60,r_371_178_34,r_54_215_130,seq200,r_371_178_34,1.0,2,36,34,92
44,r_318_135_62,seq263,seq333,r_318_135_62,0.64,9,71,62,92
63,r_83_46_180,seq61,seq308,r_83_46_180,0.98,1,181,180,92
205,seq249,r_40_86_64,seq1,r_40_86_64,1.0,3,67,64,92
109,r_93_296_145,seq57,seq203,r_93_296_145,1.0,0,145,145,92
66,r_19_161_185,seq203,r_84_125_37,r_19_161_185,0.91,0,185,185,92
87,r_75_163_69,seq285,r_372_126_34,r_75_163_69,1.0,0,69,69,92
37,r_32_362_81,seq359,r_270_66_89,r_32_362_81,0.92,4,85,81,92
43,r_43_11_170,seq62,r_206_361_84,r_43_11_170,0.95,0,170,170,92
73,r_223_187_108,seq374,seq261,r_223_187_108,0.83,7,115,108,92
64,r_186_26_178,seq8,r_93_296_145,r_186_26_178,0.75,1,179,178,92
59,r_95_108_46,r_292_44_101,r_103_307_171,r_95_108_46,1.0,0,46,46,92
128,seq5,r_199_253_117,r_113_284_47,r_199_253_117,0.95,3,120,117,92
86,r_273_104_98,seq179,seq167,r_273_104_98,0.59,23,121,98,92
28,r_40_86_64,seq249,seq61,r_40_86_64,1.0,1,65,64,92
111,r_216_319_131,r_166_118_171,r_113_284_47,r_216_319_131,0.94,2,133,131,92
93,r_198_82_74,seq138,seq317,r_198_82_74,1.0,3,77,74,92
16,r_303_214_79,r_258_116_129,seq341,r_303_214_79,0.96,1,80,79,92
24,r_194_120_47,seq321,r_177_67_9,r_194_120_47,1.0,0,47,47,92
101,r_218_105_57,seq209,r_329_30_52,r_218_105_57,0.96,3,60,57,92
71,r_123_151_59,r_230_20_1,r_156_154_36,r_123_151_59,0.49,0,59,59,92
246,seq367,r_54_215_130,r_232_358_79,r_54_215_130,0.67,2,132,130,92
77,r_360_159_182,seq200,r_153_254_117,r_360_159_182,1.0,0,182,182,92
27,r_177_67_9,r_15_155_143,seq142,r_177_67_9,0.93,2,11,9,92
83,r_103_307_171,r_10_275_59,r_95_108_46,r_103_307_171,0.99,-118,53,171,92
118,r_224_334_48,seq18,r_337_69_4,r_224_334_48,1.0,0,48,48,92
18,r_153_254_117,r_342_52_117,r_304_314_53,r_153_254_117,0.86,0,117,117,92
124,r_180_183_147,r_161_140_163,r_28_210_69,r_180_183_147,1.0,0,147,147,93
112,r_235_268_26,r_316_352_155,seq232,r_235_268_26,1.0,0,26,26,93
7,r_58_182_79,r_251_366_185,r_362_87_31,r_362_87_31,0.89,49,80,31,93
22,r_223_292_37,r_230_69_137,r_235_268_26,r_223_292_37,0.96,2,39,37,93
58,r_49_17_162,seq108,seq225,r_49_17_162,1.0,0,162,162,93
97,r_213_145_90,seq9,seq35,r_213_145_90,1.0,0,90,90,93
42,r_18_12_86,r_202_65_19,seq262,r_18_12_86,1.0,0,86,86,93
98,r_285_241_162,seq302,r_208_326_110,r_285_241_162,0.97,0,162,162,93
33,r_189_19_88,seq175,seq288,r_189_19_88,1.0,0,88,88,93
57,r_203_289_121,r_325_349_143,r_223_292_37,r_203_289_121,1.0,0,121,121,93
37,r_297_239_164,r_213_145_90,seq188,r_297_239_164,1.0,1,165,164,93
106,r_8_372_96,r_336_97_139,seq101,r_8_372_96,1.0,0,96,96,93
90,r_34_331_95,r_251_366_185,seq29,r_34_331_95,1.0,0,95,95,93
104,r_209_78_115,seq269,r_301_0_34,r_209_78_115,1.0,0,115,115,93
122,r_360_121_16,r_166_222_23,seq270,r_360_121_16,0.98,0,16,16,93
149,seq77,r_197_186_102,r_279_371_17,r_197_186_102,1.0,0,102,102,93
43,r_205_163_27,seq160,seq368,r_205_163_27,1.0,0,27,27,93
46,r_55_190_165,seq219,r_272_353_86,r_55_190_165,1.0,0,165,165,93
89,r_328_85_56,seq148,seq171,r_328_85_56,1.0,1,57,56,93
63,r_337_298_3,r_119_167_85,r_25_229_49,r_119_167_85,0.99,0,85,85,93
115,r_341_363_125,seq37,r_130_170_8,r_341_363_125,0.98,0,125,125,93
20,r_119_167_85,r_337_298_3,r_345_66_6,r_119_167_85,1.0,0,85,85,93
24,r_263_192_128,r_309_158_136,r_214_217_36,r_263_192_128,0.78,4,132,128,93
131,seq29,r_4_80_140,r_34_331_95,r_4_80_140,0.96,-38,102,140,93
102,r_25_229_49,r_281_221_71,r_337_298_3,r_25_229_49,0.95,1,50,49,93
205,seq234,r_230_69_137,r_329_115_22,r_230_69_137,0.93,4,141,137,93
41,r_230_69_137,r_223_292_37,r_329_115_22,r_223_292_37,0.58,-15,22,37,93
15,r_168_322_166,seq11,r_28_210_69,r_168_322_166,0.62,3,169,166,93
107,r_2_247_161,seq240,r_28_210_69,r_2_247_161,1.0,0,161,161,93
228,seq300,r_159_76_190,r_213_145_90,r_213_145_90,1.0,11,101,90,93
67,r_193_141_22,r_28_210_69,seq42,r_193_141_22,0.94,0,22,22,93
48,r_254_369_63,seq135,seq270,r_254_369_63,0.99,1,64,63,93
79,r_165_142_62,r_119_167_85,r_223_292_37,r_165_142_62,0.98,0,62,62,93
5,r_278_172_150,seq302,seq303,r_278_172_150,1.0,1,151,150,93
69,r_329_115_22,r_230_69_137,seq234,r_230_69_137,0.95,4,141,137,93
78,r_325_349_143,seq95,r_361_314_91,r_361_314_91,0.53,52,143,91,93
110,r_197_186_102,seq77,r_272_353_86,r_197_186_102,1.0,0,102,102,93
55,r_237_265_45,r_316_352_155,r_233_53_157,r_237_265_45,1.0,0,45,45,93
76,r_279_371_17,r_165_142_62,seq77,r_279_371_17,0.7,0,17,17,93
239,seq338,r_15_79_150,seq73,r_15_79_150,1.0,1,151,150,93
96,r_248_16_135,r_195_149_189,r_130_170_8,r_248_16_135,1.0,0,135,135,93
23,r_231_304_77,r_278_172_150,seq136,r_231_304_77,1.0,0,77,77,93
25,r_107_185_96,seq127,r_43_124_83,r_107_185_96,1.0,0,96,96,93
9,r_75_70_95,seq135,r_130_170_8,r_75_70_95,1.0,0,95,95,93
11,r_82_109_41,r_311_94_118,r_90_320_54,r_82_109_41,0.99,0,41,41,93
116,r_272_353_86,seq73,seq1,r_272_353_86,0.97,4,90,86,93
204,seq232,r_296_60_177,r_235_268_26,r_235_268_26,1.0,0,26,26,93
10,r_147_114_163,seq32,r_283_91_68,r_147_114_163,0.99,0,163,163,93
37,r_297_239_164,r_33_21_138,r_213_145_90,r_33_21_138,0.82,0,138,138,93
82,r_6_191_149,seq277,r_286_155_60,r_6_191_149,1.0,2,151,149,93
99,r_27_103_49,r_107_185_96,seq133,r_27_103_49,1.0,1,50,49,93
62,r_347_356_168,r_212_246_177,r_223_292_37,r_212_246_177,0.6,-9,168,177,93
113,r_199_236_180,seq146,r_325_349_143,r_199_236_180,0.63,1,181,180,93
60,r_138_177_34,r_168_322_166,r_214_217_36,r_214_217_36,0.86,8,44,36,93
12,r_336_97_139,r_8_372_96,r_286_155_60,r_336_97_139,0.94,-43,96,139,93
6,r_283_91_68,r_256_274_103,seq146,r_283_91_68,1.0,2,70,68,93
8,r_43_124_83,r_195_149_189,seq84,r_43_124_83,1.0,4,87,83,93
131,seq29,r_361_314_91,r_4_80_140,r_361_314_91,0.9,0,91,91,93
56,r_214_217_36,seq89,seq108,r_214_217_36,1.0,1,37,36,93
52,r_256_274_103,r_203_289_121,r_231_304_77,r_203_289_121,0.77,-18,103,121,93
0,r_309_158_136,r_56_67_144,seq295,r_56_67_144,1.0,-7,137,144,93
138,seq42,seq255,r_193_141_22,r_193_141_22,1.0,0,22,22,93
154,seq93,r_348_5_141,r_28_210_69,r_348_5_141,1.0,0,141,141,93
103,r_258_350_124,r_54_310_138,r_82_109_41,r_258_350_124,0.96,14,138,124,93
65,r_33_21_138,r_297_239_164,seq148,r_33_21_138,1.0,0,138,138,93
35,r_361_314_91,seq29,r_337_298_3,r_361_314_91,1.0,0,91,91,93
55,r_237_265_45,r_233_53_157,r_348_5_141,r_237_265_45,1.0,112,157,45,93
16,r_296_60_177,seq291,seq342,r_296_60_177,0.6,0,177,177,93
1,r_316_352_155,seq308,r_286_155_60,r_316_352_155,0.99,2,157,155,93
39,r_10_364_82,r_278_172_150,seq44,r_10_364_82,1.0,0,82,82,93
2,r_3_275_160,seq106,r_130_170_8,r_3_275_160,1.0,0,160,160,93
64,r_184_143_13,r_195_149_189,seq105,r_184_143_13,1.0,-3,10,13,93
66,r_293_243_91,seq122,r_334_273_181,r_293_243_91,0.99,0,91,91,93
92,r_181_63_49,r_208_326_110,seq68,r_181_63_49,1.0,0,49,49,93
118,r_54_310_138,seq262,r_34_331_95,r_54_310_138,0.68,0,138,138,93
45,r_318_23_158,r_346_250_194,seq11,r_318_23_158,1.0,0,158,158,93
32,r_28_210_69,r_49_17_162,r_88_179_19,r_49_17_162,0.98,-86,76,162,93
123,r_245_13_70,r_283_91_68,seq133,r_245_13_70,1.0,0,70,70,93
240,seq342,r_332_40_89,r_214_217_36,r_332_40_89,0.64,0,89,89,93
247,seq368,seq118,r_205_163_27,r_205_163_27,1.0,0,27,27,93
95,r_56_67_144,seq51,r_129_38_137,r_56_67_144,0.82,0,144,144,93
84,r_152_211_145,seq188,r_166_222_23,r_152_211_145,0.76,4,149,145,93
114,r_129_38_137,seq374,seq37,r_129_38_137,1.0,0,137,137,93
88,r_233_53_157,r_237_265_45,seq207,r_233_53_157,1.0,0,157,157,93
94,r_281_221_71,seq77,r_193_141_22,r_281_221_71,1.0,0,71,71,93
59,r_4_80_140,seq68,seq162,r_4_80_140,1.0,0,140,140,93
29,r_319_30_185,seq206,r_208_326_110,r_319_30_185,1.0,0,185,185,93
120,r_305_224_88,seq218,seq61,r_305_224_88,0.77,4,92,88,93
173,seq136,seq187,r_231_304_77,r_231_304_77,1.0,14,91,77,93
51,r_7_307_168,seq105,r_263_192_128,r_263_192_128,0.64,40,168,128,93
146,seq68,r_4_80_140,r_181_63_49,r_4_80_140,1.0,0,140,140,93
47,r_212_246_177,seq225,r_8_372_96,r_212_246_177,0.98,0,177,177,93
77,r_280_339_84,r_256_274_103,seq253,r_280_339_84,1.0,0,84,84,93
74,r_45_64_148,seq261,r_208_326_110,r_45_64_148,1.0,0,148,148,93
69,r_329_115_22,r_301_0_34,r_230_69_137,r_329_115_22,0.75,0,22,22,93
109,r_104_264_125,r_83_284_38,r_18_12_86,r_83_284_38,0.55,87,125,38,93
184,seq171,r_144_123_96,r_328_85_56,r_328_85_56,0.73,42,98,56,93
73,r_14_324_102,seq41,seq22,r_14_324_102,1.0,0,102,102,93
27,r_166_222_23,r_293_243_91,seq37,r_166_222_23,0.99,-1,22,23,93
85,r_244_57_124,r_278_172_150,r_223_292_37,r_244_57_124,0.96,0,124,124,93
81,r_348_5_141,seq93,r_237_265_45,r_348_5_141,1.0,0,141,141,93
14,r_36_59_50,r_327_26_195,seq9,r_36_59_50,1.0,3,53,50,93
160,seq106,r_3_275_160,r_132_157_163,r_3_275_160,1.0,0,160,160,93
26,r_156_287_109,seq44,seq77,r_156_287_109,1.0,0,109,109,93
12,r_336_97_139,r_286_155_60,r_254_369_63,r_336_97_139,0.87,1,140,139,93
54,r_132_157_163,r_147_114_163,seq73,r_147_114_163,0.99,-5,158,163,93
127,seq11,r_168_322_166,r_318_23_158,r_318_23_158,1.0,11,169,158,93
18,r_340_333_36,r_346_250_194,seq306,r_340_333_36,0.92,4,40,36,93
30,r_343_112_41,r_195_149_189,r_166_222_23,r_343_112_41,1.0,0,41,41,93
71,r_15_79_150,seq338,r_231_304_77,r_15_79_150,1.0,-1,149,150,93
53,r_311_94_118,seq315,r_231_304_77,r_311_94_118,0.92,3,121,118,93
175,seq148,seq374,r_33_21_138,r_33_21_138,1.0,6,144,138,93
68,r_266_102_144,seq188,r_75_70_95,r_266_102_144,0.68,-2,142,144,93
111,r_202_65_19,r_18_12_86,seq62,r_18_12_86,1.0,-12,74,86,93
88,r_233_53_157,r_180_183_147,r_237_265_45,r_237_265_45,1.0,7,52,45,93
41,r_230_69_137,r_329_115_22,r_189_19_88,r_189_19_88,0.88,53,141,88,93
101,r_362_87_31,r_296_60_177,seq146,r_362_87_31,1.0,0,31,31,93
207,seq240,r_2_247_161,r_286_155_60,r_2_247_161,0.83,0,161,161,93
107,r_298_172_71,r_10_91_138,seq288,r_298_172_71,0.83,2,73,71,94
101,r_264_81_116,seq26,seq138,r_264_81_116,0.92,1,117,116,94
87,r_204_340_37,seq75,seq326,r_204_340_37,1.0,0,37,37,94
56,r_110_101_97,r_67_215_169,r_233_329_41,r_110_101_97,0.99,0,97,97,94
17,r_33_271_133,seq28,r_219_330_30,r_33_271_133,1.0,0,133,133,94
112,r_242_42_138,r_245_68_9,r_211_295_104,r_242_42_138,0.73,2,140,138,94
6,r_229_165_123,r_245_68_9,r_304_7_21,r_304_7_21,0.98,-1,20,21,94
5,r_27_39_56,r_366_108_121,seq193,r_27_39_56,1.0,0,56,56,94
104,r_201_115_99,seq282,r_32_107_44,r_201_115_99,1.0,0,99,99,94
89,r_20_352_26,r_219_330_30,r_341_5_186,r_20_352_26,0.95,-1,25,26,94
48,r_362_301_143,seq307,r_206_189_61,r_362_301_143,0.99,0,143,143,94
76,r_370_281_117,seq21,r_38_324_43,r_370_281_117,1.0,1,118,117,94
118,r_265_310_154,r_102_212_114,r_264_81_116,r_265_310_154,1.0,0,154,154,94
240,seq350,r_219_330_30,r_188_345_59,r_188_345_59,1.0,4,63,59,94
9,r_148_59_134,r_58_72_134,seq358,r_148_59_134,1.0,0,134,134,94
108,r_116_136_27,r_119_279_192,r_67_215_169,r_116_136_27,0.79,1,28,27,94
59,r_262_348_175,seq224,r_137_267_4,r_262_348_175,1.0,0,175,175,94
92,r_228_62_180,seq37,r_335_44_20,r_228_62_180,0.92,1,181,180,94
28,r_139_328_139,r_232_74_141,r_339_195_115,r_232_74_141,1.0,-2,139,141,94
85,r_360_163_43,r_370_281_117,seq11,r_360_163_43,1.0,0,43,43,94
53,r_364_70_71,r_102_212_114,seq26,r_364_70_71,1.0,0,71,71,94
64,r_339_195_115,seq355,seq11,r_339_195_115,0.99,2,117,115,94
95,r_153_156_153,seq75,r_191_47_46,r_153_156_153,1.0,0,153,153,94
31,r_32_107_44,seq76,seq83,r_32_107_44,1.0,0,44,44,94
89,r_20_352_26,r_341_5_186,r_191_47_46,r_191_47_46,0.7,18,64,46,94
124,r_45_6_127,seq26,seq277,r_45_6_127,0.96,7,134,127,94
100,r_57_24_74,r_54_114_175,r_41_122_178,r_57_24_74,1.0,100,174,74,94
68,r_166_160_53,r_315_16_116,r_229_165_123,r_166_160_53,1.0,75,128,53,94
109,r_222_154_159,seq175,r_211_295_104,r_222_154_159,1.0,0,159,159,94
6,r_229_165_123,r_304_7_21,r_166_160_53,r_229_165_123,1.0,1,124,123,94
38,r_270_306_50,r_237_257_119,r_333_151_42,r_270_306_50,0.97,-5,45,50,94
115,r_73_88_144,r_208_349_157,r_63_227_105,r_73_88_144,0.85,3,147,144,94
25,r_297_287_174,seq253,r_27_39_56,r_297_287_174,0.99,0,174,174,94
98,r_102_212_114,r_265_310_154,r_240_205_73,r_265_310_154,1.0,-31,123,154,94
82,r_303_275_174,seq316,r_353_179_105,r_303_275_174,0.8,0,174,174,94
100,r_57_24_74,r_196_291_83,r_54_114_175,r_57_24_74,1.0,1,75,74,94
225,seq305,r_266_359_177,r_191_47_46,r_266_359_177,0.88,1,178,177,94
10,r_197_112_101,r_242_42_138,r_188_345_59,r_197_112_101,0.75,0,101,101,94
86,r_333_151_42,r_208_349_157,r_270_306_50,r_333_151_42,0.99,1,43,42,94
69,r_332_357_150,seq142,r_164_373_62,r_332_357_150,1.0,4,154,150,94
106,r_141_249_144,r_104_86_82,seq327,r_141_249_144,0.98,0,144,144,94
61,r_314_173_127,r_118_128_181,seq283,r_314_173_127,0.94,-1,126,127,94
7,r_53_247_154,r_54_114_175,seq76,r_53_247_154,1.0,0,154,154,94
67,r_313_19_101,seq293,r_245_68_9,r_313_19_101,1.0,3,104,101,94
37,r_94_308_130,seq343,r_250_346_62,r_94_308_130,1.0,1,131,130,94
41,r_2_178_116,seq93,seq351,r_2_178_116,0.95,1,117,116,94
52,r_120_299_186,r_341_5_186,r_262_348_175,r_120_299_186,0.99,0,186,186,94
15,r_129_184_127,seq56,seq90,r_129_184_127,1.0,0,127,127,94
74,r_17_371_85,r_141_249_144,r_364_70_71,r_17_371_85,0.84,0,85,85,94
72,r_48_177_147,seq187,r_129_184_127,r_48_177_147,0.92,0,147,147,94
14,r_211_295_104,r_321_22_5,seq162,r_211_295_104,1.0,-2,102,104,94
108,r_116_136_27,r_67_215_169,seq132,r_67_215_169,1.0,-41,128,169,94
171,seq149,r_41_122_178,r_207_251_93,r_41_122_178,0.99,1,179,178,94
131,seq21,r_370_281_117,r_219_330_30,r_370_281_117,0.99,-48,69,117,94
49,r_320_40_96,r_157_289_144,seq253,r_320_40_96,1.0,0,96,96,94
80,r_4_323_104,seq235,seq282,r_4_323_104,1.0,0,104,104,94
97,r_117_64_155,r_54_114_175,seq35,r_117_64_155,1.0,1,156,155,94
110,r_266_359_177,seq305,seq236,r_266_359_177,0.96,1,178,177,94
55,r_269_180_153,seq150,r_216_276_48,r_269_180_153,1.0,0,153,153,94
91,r_36_243_99,seq37,seq130,r_36_243_99,1.0,1,100,99,94
102,r_41_122_178,seq149,r_27_39_56,r_41_122_178,0.97,1,179,178,94
113,r_124_30_133,seq69,r_131_336_6,r_124_30_133,0.99,8,141,133,94
65,r_159_284_164,seq130,r_223_84_90,r_159_284_164,0.95,5,169,164,94
13,r_315_16_116,seq76,r_166_160_53,r_166_160_53,1.0,2,55,53,94
172,seq150,r_269_180_153,r_185_338_89,r_269_180_153,0.6,0,153,153,94
83,r_185_338_89,seq171,seq150,r_185_338_89,1.0,0,89,89,94
3,r_255_217_21,r_191_47_46,r_63_227_105,r_255_217_21,0.75,-1,20,21,94
73,r_196_291_83,r_100_186_103,r_191_47_46,r_196_291_83,0.67,2,85,83,94
215,seq280,r_208_349_157,r_157_289_144,r_208_349_157,0.99,2,159,157,94
162,seq130,r_159_284_164,r_36_243_99,r_36_243_99,0.84,51,150,99,94
70,r_368_155_171,seq367,r_50_192_132,r_368_155_171,0.8,0,171,171,94
63,r_100_186_103,seq283,r_207_251_93,r_100_186_103,0.97,4,107,103,94
81,r_239_123_83,seq35,r_245_68_9,r_239_123_83,0.68,1,84,83,94
0,r_237_257_119,seq356,r_17_371_85,r_237_257_119,1.0,2,121,119,94
94,r_82_302_156,r_0_133_195,seq93,r_82_302_156,0.84,2,158,156,94
111,r_374_202_20,r_313_19_101,r_304_7_21,r_304_7_21,0.8,-1,20,21,94
35,r_104_86_82,r_118_128_181,r_219_330_30,r_104_86_82,1.0,0,82,82,94
8,r_361_344_153,seq138,seq146,r_361_344_153,0.86,1,154,153,94
27,r_170_85_78,r_222_154_159,r_27_39_56,r_170_85_78,0.99,-2,76,78,94
84,r_60_15_149,seq138,seq37,r_60_15_149,1.0,0,149,149,94
44,r_325_134_40,r_250_346_62,r_106_52_19,r_325_134_40,0.96,-4,36,40,94
51,r_188_345_59,seq130,seq350,r_188_345_59,1.0,0,59,59,94
187,seq214,r_148_59_134,r_87_199_31,r_148_59_134,0.96,-2,132,134,94
54,r_135_109_104,seq34,seq354,r_135_109_104,1.0,1,105,104,94
120,r_29_95_41,r_266_359_177,r_46_213_22,r_29_95_41,1.0,0,41,41,94
39,r_210_273_57,r_118_128_181,seq3,r_210_273_57,0.9,0,57,57,94
24,r_106_52_19,r_240_205_73,r_325_134_40,r_106_52_19,1.0,0,19,19,94
20,r_353_179_105,r_63_227_105,seq105,r_353_179_105,0.98,2,107,105,94
40,r_233_329_41,seq252,seq34,r_233_329_41,1.0,0,41,41,94
117,r_1_12_55,r_153_156_153,r_116_136_27,r_1_12_55,1.0,0,55,55,94
29,r_79_337_44,r_314_173_127,seq125,r_79_337_44,1.0,0,44,44,94
93,r_304_7_21,r_219_330_30,r_229_165_123,r_304_7_21,0.7,-1,20,21,94
75,r_206_189_61,r_174_182_68,r_55_168_30,r_206_189_61,0.93,-1,60,61,94
58,r_46_213_22,r_229_165_123,seq309,r_46_213_22,0.79,-2,20,22,94
90,r_341_5_186,r_120_299_186,r_27_39_56,r_341_5_186,0.97,0,186,186,94
96,r_268_144_101,seq235,r_364_70_71,r_268_144_101,0.93,1,102,101,94
4,r_207_251_93,r_78_61_196,seq149,r_207_251_93,0.98,0,93,93,94
23,r_58_72_134,r_87_199_31,r_174_182_68,r_58_72_134,0.92,2,136,134,94
135,seq28,r_33_271_133,r_191_47_46,r_33_271_133,0.99,0,133,133,94
119,r_87_199_31,r_50_192_132,r_58_72_134,r_87_199_31,0.98,0,31,31,94
123,r_174_182_68,seq326,seq278,r_174_182_68,1.0,1,69,68,94
93,r_304_7_21,r_229_165_123,r_164_373_62,r_229_165_123,1.0,0,123,123,94
47,r_208_349_157,seq280,r_245_68_9,r_208_349_157,0.88,2,159,157,94
13,r_315_16_116,r_166_160_53,r_204_340_37,r_315_16_116,1.0,0,116,116,94
30,r_219_330_30,r_20_352_26,seq34,r_20_352_26,0.99,-1,25,26,94
78,r_55_168_30,r_98_259_163,seq252,r_55_168_30,0.75,0,30,30,94
99,r_318_158_144,seq34,seq37,r_318_158_144,1.0,0,144,144,94
68,r_166_160_53,r_98_259_163,r_315_16_116,r_166_160_53,1.0,1,54,53,94
204,seq253,r_297_287_174,r_320_40_96,r_297_287_174,0.99,0,174,174,94
88,r_54_114_175,r_57_24_74,r_191_47_46,r_54_114_175,0.99,0,175,175,94
62,r_203_334_163,seq83,r_50_192_132,r_203_334_163,1.0,2,165,163,94
66,r_164_373_62,r_320_40_96,r_304_7_21,r_164_373_62,0.97,0,62,62,94
105,r_10_91_138,r_298_172_71,r_219_330_30,r_10_91_138,0.46,-61,77,138,94
23,r_58_72_134,r_148_59_134,r_87_199_31,r_87_199_31,1.0,-1,30,31,94
45,r_366_108_121,seq272,r_245_68_9,r_366_108_121,0.99,0,121,121,94
77,r_232_74_141,r_139_328_139,r_197_112_101,r_139_328_139,0.92,2,141,139,94
151,seq83,r_203_334_163,r_32_107_44,r_203_334_163,1.0,2,165,163,94
116,r_216_276_48,seq25,r_335_44_20,r_216_276_48,1.0,0,48,48,94
88,r_54_114_175,r_53_247_154,r_57_24_74,r_53_247_154,0.94,0,154,154,94
105,r_10_91_138,r_219_330_30,r_137_267_4,r_10_91_138,1.0,1,139,138,94
26,r_167_372_32,r_185_338_89,seq175,r_167_372_32,0.97,0,32,32,94
18,r_250_346_62,r_157_289_144,seq75,r_250_346_62,1.0,0,62,62,94
1,r_50_192_132,r_126_89_12,seq286,r_50_192_132,1.0,2,134,132,94
106,r_141_249_144,r_17_371_85,r_104_86_82,r_141_249_144,1.0,-59,85,144,94
22,r_118_128_181,seq282,seq248,r_118_128_181,1.0,5,186,181,94
103,r_67_215_169,seq294,r_27_39_56,r_67_215_169,1.0,1,170,169,94
119,r_87_199_31,r_58_72_134,seq214,r_58_72_134,0.88,2,136,134,94
2,r_191_47_46,seq69,r_20_352_26,r_191_47_46,0.98,-1,45,46,94
114,r_38_324_43,r_353_179_105,seq241,r_38_324_43,1.0,0,43,43,94
124,r_275_279_107,seq366,seq24,r_275_279_107,0.99,0,107,107,95
122,r_19_177_120,seq7,seq92,r_19_177_120,1.0,1,121,120,95
26,r_105_43_46,r_110_126_183,seq182,r_105_43_46,1.0,0,46,46,95
29,r_288_282_26,r_110_126_183,r_245_170_2,r_288_282_26,0.91,1,27,26,95
134,seq37,r_294_25_160,r_124_373_95,r_294_25_160,0.99,0,160,160,95
6,r_312_300_38,r_124_373_95,seq316,r_312_300_38,0.97,8,46,38,95
25,r_362_102_26,r_60_310_42,seq273,r_362_102_26,0.9,2,28,26,95
178,seq178,r_233_108_149,r_70_8_50,r_233_108_149,1.0,0,149,149,95
76,r_113_213_83,r_209_23_181,r_190_304_28,r_209_23_181,1.0,0,181,181,95
81,r_337_94_32,r_171_333_124,r_160_351_31,r_337_94_32,1.0,0,32,32,95
46,r_208_2_90,r_57_291_183,seq322,r_208_2_90,1.0,0,90,90,95
98,r_186_238_88,r_110_126_183,r_174_264_48,r_186_238_88,0.98,0,88,88,95
40,r_54_324_47,r_258_205_95,r_70_8_50,r_54_324_47,1.0,0,47,47,95
9,r_253_165_93,seq211,r_70_8_50,r_253_165_93,1.0,1,94,93,95
63,r_207_100_179,seq201,seq342,r_207_100_179,0.99,0,179,179,95
97,r_287_117_110,seq192,seq80,r_287_117_110,1.0,0,110,110,95
16,r_224_34_176,seq335,seq156,r_224_34_176,0.63,-15,161,176,95
93,r_231_276_179,seq73,r_288_282_26,r_231_276_179,1.0,0,179,179,95
181,seq182,r_66_11_109,r_105_43_46,r_105_43_46,0.97,32,78,46,95
68,r_152_236_104,r_210_161_185,r_67_278_77,r_152_236_104,1.0,1,105,104,95
104,r_3_357_25,seq335,seq139,r_3_357_25,1.0,0,25,25,95
158,seq127,r_350_344_114,r_3_357_25,r_350_344_114,0.69,-39,75,114,95
112,r_329_112_110,r_20_29_155,r_190_304_28,r_329_112_110,1.0,0,110,110,95
24,r_30_311_11,r_293_91_27,seq211,r_30_311_11,0.98,0,11,11,95
84,r_67_278_77,r_6_303_155,seq172,r_67_278_77,1.0,0,77,77,95
114,r_26_285_36,r_173_234_104,r_115_206_193,r_26_285_36,1.0,0,36,36,95
3,r_86_42_159,r_371_40_3,seq168,r_86_42_159,1.0,0,159,159,95
18,r_198_111_189,seq172,r_217_134_9,r_198_111_189,1.0,0,189,189,95
28,r_124_373_95,r_41_277_174,seq176,r_124_373_95,1.0,0,95,95,95
87,r_359_107_45,r_332_52_63,r_26_285_36,r_332_52_63,0.96,0,63,63,95
38,r_87_313_78,r_76_214_155,r_355_308_58,r_87_313_78,1.0,0,78,78,95
65,r_332_52_63,r_359_107_45,r_245_170_2,r_332_52_63,0.96,0,63,63,95
59,r_150_244_90,seq162,r_362_102_26,r_150_244_90,1.0,0,90,90,95
109,r_74_114_46,r_54_324_47,r_362_102_26,r_54_324_47,0.99,-1,46,47,95
51,r_262_89_126,r_57_291_183,seq22,r_262_89_126,1.0,1,127,126,95
113,r_155_199_56,r_184_365_172,seq211,r_155_199_56,0.99,2,58,56,95
99,r_209_23_181,r_186_238_88,r_113_213_83,r_209_23_181,0.67,-93,88,181,95
8,r_327_120_69,r_151_121_45,r_115_206_193,r_327_120_69,1.0,-1,68,69,95
58,r_239_17_180,seq334,r_26_285_36,r_239_17_180,1.0,0,180,180,95
19,r_268_128_124,r_209_23_181,seq180,r_268_128_124,1.0,0,124,124,95
105,r_62_309_130,seq16,seq95,r_62_309_130,0.98,0,130,130,95
41,r_60_310_42,r_184_365_172,seq307,r_60_310_42,1.0,0,42,42,95
92,r_93_354_98,r_314_96_152,r_190_304_28,r_93_354_98,1.0,0,98,98,95
56,r_190_304_28,r_188_374_96,r_55_216_151,r_190_304_28,1.0,0,28,28,95
121,r_367_106_115,seq80,r_12_27_82,r_367_106_115,1.0,1,116,115,95
226,seq307,seq335,r_60_310_42,r_60_310_42,0.97,4,46,42,95
189,seq200,seq24,r_350_344_114,r_350_344_114,1.0,30,144,114,95
14,r_350_344_114,seq127,seq200,r_350_344_114,1.0,0,114,114,95
30,r_294_25_160,seq37,seq290,r_294_25_160,1.0,0,160,160,95
167,seq154,r_45_353_76,seq281,r_45_353_76,1.0,0,76,76,95
12,r_70_8_50,r_327_120_69,seq292,r_327_120_69,0.88,-18,51,69,95
77,r_159_256_166,seq358,seq149,r_159_256_166,1.0,0,166,166,95
67,r_233_108_149,seq178,r_349_36_136,r_233_108_149,1.0,0,149,149,95
76,r_113_213_83,seq228,r_209_23_181,r_113_213_83,1.0,0,83,83,95
21,r_110_126_183,seq297,r_217_134_9,r_110_126_183,0.79,0,183,183,95
37,r_171_333_124,seq175,seq80,r_171_333_124,0.9,1,125,124,95
107,r_336_361_124,r_184_365_172,r_350_344_114,r_184_365_172,1.0,-47,125,172,95
87,r_359_107_45,r_88_267_185,r_332_52_63,r_359_107_45,0.76,0,45,45,95
120,r_6_303_155,seq226,r_254_372_117,r_6_303_155,1.0,0,155,155,95
236,seq331,r_136_368_138,r_280_118_4,r_136_368_138,0.93,-59,79,138,95
203,seq248,r_173_234_104,r_148_97_47,r_173_234_104,0.57,0,104,104,95
73,r_181_212_27,r_327_120_69,seq119,r_181_212_27,1.0,0,27,27,95
44,r_130_75_182,r_12_27_82,r_155_199_56,r_12_27_82,0.61,-8,74,82,95
111,r_76_214_155,r_174_264_48,r_163_263_26,r_76_214_155,0.98,0,155,155,95
80,r_191_219_56,r_198_111_189,r_79_235_58,r_191_219_56,1.0,0,56,56,95
56,r_190_304_28,r_55_216_151,r_187_51_41,r_55_216_151,0.65,-87,64,151,95
49,r_370_50_126,seq168,r_103_185_25,r_370_50_126,1.0,1,127,126,95
44,r_130_75_182,r_155_199_56,r_254_372_117,r_130_75_182,0.95,-1,181,182,95
79,r_187_51_41,r_12_27_82,r_190_304_28,r_187_51_41,1.0,0,41,41,95
4,r_174_264_48,seq24,r_321_109_54,r_174_264_48,1.0,1,49,48,95
71,r_20_29_155,seq77,r_103_185_25,r_20_29_155,1.0,0,155,155,95
50,r_254_372_117,r_19_177_120,seq82,r_19_177_120,1.0,0,120,120,95
22,r_88_267_185,seq273,r_293_91_27,r_88_267_185,0.99,2,187,185,95
115,r_220_65_63,r_12_27_82,r_321_109_54,r_220_65_63,0.99,1,64,63,95
118,r_257_33_161,seq226,r_60_310_42,r_257_33_161,0.99,4,165,161,95
33,r_12_27_82,r_130_75_182,r_364_59_34,r_12_27_82,1.0,1,83,82,95
7,r_314_96_152,r_231_276_179,r_362_102_26,r_314_96_152,0.92,0,152,152,95
219,seq292,seq286,r_70_8_50,r_70_8_50,1.0,3,53,50,95
101,r_136_368_138,seq342,r_56_289_15,r_136_368_138,1.0,0,138,138,95
83,r_321_109_54,r_355_308_58,r_174_264_48,r_321_109_54,1.0,0,54,54,95
39,r_251_44_12,r_312_300_38,seq162,r_251_44_12,1.0,0,12,12,95
159,seq129,r_124_373_95,seq318,r_124_373_95,0.8,-31,64,95,95
74,r_45_353_76,seq154,seq298,r_45_353_76,1.0,0,76,76,95
116,r_81_164_128,r_260_58_195,r_60_310_42,r_81_164_128,1.0,1,129,128,95
10,r_56_289_15,r_268_128_124,seq123,r_56_289_15,0.66,-1,14,15,95
85,r_369_53_41,r_287_117_110,seq180,r_369_53_41,1.0,0,41,41,95
123,r_352_48_42,r_253_165_93,seq92,r_352_48_42,0.95,0,42,42,95
66,r_153_133_48,seq302,seq340,r_153_133_48,0.98,3,51,48,95
78,r_255_299_103,seq326,r_12_27_82,r_255_299_103,1.0,2,105,103,95
2,r_148_97_47,r_210_161_185,seq248,r_148_97_47,1.0,0,47,47,95
171,seq162,r_150_244_90,r_251_44_12,r_150_244_90,1.0,0,90,90,95
102,r_319_202_150,r_314_96_152,r_19_177_120,r_319_202_150,1.0,0,150,150,95
91,r_47_269_108,r_260_58_195,seq119,r_47_269_108,1.0,0,108,108,95
99,r_209_23_181,r_113_213_83,r_55_216_151,r_113_213_83,0.57,98,181,83,95
62,r_41_277_174,seq21,r_105_43_46,r_41_277_174,1.0,1,175,174,95
55,r_184_365_172,seq166,r_173_234_104,r_184_365_172,0.87,2,174,172,95
47,r_115_206_193,r_1_140_194,r_327_120_69,r_327_120_69,1.0,8,77,69,95
54,r_196_242_84,r_81_164_128,r_12_27_82,r_196_242_84,0.91,0,84,84,95
75,r_84_167_129,seq322,seq339,r_84_167_129,1.0,0,129,129,95
65,r_332_52_63,r_1_140_194,r_359_107_45,r_359_107_45,0.72,5,50,45,95
11,r_55_216_151,seq119,seq271,r_55_216_151,1.0,1,152,151,95
86,r_103_185_25,r_209_23_181,seq292,r_103_185_25,1.0,0,25,25,95
94,r_18_10_20,r_268_128_124,seq226,r_18_10_20,1.0,0,20,20,95
45,r_122_104_99,seq28,r_79_235_58,r_122_104_99,0.98,2,101,99,95
5,r_355_308_58,r_349_36_136,r_369_53_41,r_355_308_58,1.0,0,58,58,95
100,r_348_230_168,seq240,r_253_165_93,r_348_230_168,1.0,0,168,168,95
43,r_210_161_185,seq149,seq301,r_210_161_185,0.84,0,185,185,95
27,r_363_146_40,r_370_50_126,seq21,r_363_146_40,1.0,2,42,40,95
72,r_160_351_31,r_188_374_96,r_337_94_32,r_160_351_31,0.99,6,37,31,95
48,r_9_13_61,r_210_161_185,r_251_44_12,r_9_13_61,1.0,1,62,61,95
61,r_330_4_74,r_84_167_129,seq315,r_84_167_129,0.49,-53,76,129,95
82,r_132_215_185,seq265,r_253_165_93,r_132_215_185,1.0,0,185,185,95
108,r_203_145_129,r_349_36_136,r_160_351_31,r_203_145_129,1.0,0,129,129,95
15,r_57_291_183,r_88_267_185,seq37,r_88_267_185,0.6,-2,183,185,95
60,r_0_347_67,r_327_120_69,r_288_282_26,r_0_347_67,1.0,0,67,67,95
57,r_258_205_95,seq176,seq197,r_258_205_95,0.99,0,95,95,95
117,r_222_241_127,seq340,seq21,r_222_241_127,1.0,0,127,127,95
90,r_143_252_47,seq5,r_362_102_26,r_143_252_47,0.69,4,51,47,95
53,r_78_283_120,r_81_164_128,r_67_278_77,r_78_283_120,1.0,1,121,120,95
13,r_138_137_109,seq158,seq125,r_138_137_109,1.0,4,113,109,95
32,r_116_325_187,seq119,r_173_234_104,r_173_234_104,0.59,83,187,104,95
17,r_218_296_94,seq119,seq193,r_218_296_94,0.58,2,96,94,95
95,r_163_263_26,r_367_106_115,seq35,r_163_263_26,1.0,0,26,26,95
111,r_76_214_155,r_87_313_78,r_174_264_48,r_76_214_155,0.99,-104,51,155,95
103,r_49_306_169,seq366,r_12_27_82,r_49_306_169,1.0,1,170,169,95
70,r_188_374_96,seq162,r_153_133_48,r_188_374_96,1.0,2,98,96,95
23,r_349_36_136,r_159_256_166,r_371_40_3,r_349_36_136,1.0,0,136,136,95
89,r_364_59_34,r_60_310_42,seq77,r_364_59_34,1.0,0,34,34,95
31,r_173_234_104,seq248,seq211,r_173_234_104,1.0,0,104,104,95
111,r_10_348_10,r_298_280_181,seq322,r_10_348_10,0.88,0,10,10,96
26,r_199_326_147,seq219,r_4_259_130,r_199_326_147,1.0,0,147,147,96
121,r_64_103_46,r_195_241_182,r_110_324_153,r_64_103_46,1.0,0,46,46,96
25,r_372_228_43,r_214_281_170,r_153_289_129,r_372_228_43,1.0,0,43,43,96
57,r_153_289_129,r_159_149_61,r_372_228_43,r_153_289_129,1.0,-86,43,129,96
113,r_186_36_4,seq342,r_319_252_39,r_319_252_39,1.0,11,50,39,96
25,r_372_228_43,r_242_133_198,r_48_16_164,r_48_16_164,0.97,5,169,164,96
121,r_64_103_46,r_110_324_153,r_309_254_54,r_110_324_153,1.0,0,153,153,96
109,r_91_19_32,r_340_251_166,r_261_85_16,r_91_19_32,0.82,3,35,32,96
69,r_256_66_157,r_96_239_45,r_203_243_59,r_256_66_157,1.0,0,157,157,96
53,r_214_281_170,r_106_331_197,r_360_197_13,r_214_281_170,0.99,0,170,170,96
32,r_313_234_164,seq57,r_95_75_35,r_313_234_164,0.9,3,167,164,96
213,seq253,r_356_301_131,r_258_205_178,r_356_301_131,0.96,6,137,131,96
71,r_319_252_39,r_34_211_197,r_186_36_4,r_319_252_39,1.0,1,40,39,96
79,r_49_343_36,r_162_24_98,seq304,r_49_343_36,0.98,1,37,36,96
49,r_159_149_61,r_287_212_78,seq359,r_159_149_61,1.0,0,61,61,96
23,r_46_367_55,r_86_87_123,r_288_207_119,r_46_367_55,0.96,68,123,55,96
124,r_51_215_142,r_273_290_124,seq93,r_273_290_124,0.99,0,124,124,96
90,r_62_97_117,seq345,r_339_148_114,r_62_97_117,1.0,0,117,117,96
103,r_15_135_97,r_373_210_148,seq39,r_15_135_97,0.69,2,99,97,96
72,r_110_324_153,r_298_280_181,seq117,r_110_324_153,0.94,0,153,153,96
142,seq65,r_373_210_148,r_50_355_24,r_373_210_148,1.0,0,148,148,96
58,r_287_212_78,r_242_133_198,seq160,r_287_212_78,0.99,0,78,78,96
74,r_96_239_45,r_256_66_157,seq357,r_256_66_157,1.0,0,157,157,96
206,seq227,r_300_138_167,r_83_175_62,r_300_138_167,0.74,0,167,167,96
36,r_265_278_123,seq107,r_159_149_61,r_265_278_123,0.99,0,123,123,96
78,r_12_341_123,seq194,r_247_69_60,r_12_341_123,1.0,0,123,123,96
11,r_184_308_178,r_45_358_7,seq286,r_184_308_178,0.97,0,178,178,96
1,r_346_363_149,seq187,seq219,r_346_363_149,0.78,4,153,149,96
44,r_1_88_87,r_293_332_167,r_262_136_36,r_1_88_87,0.98,1,88,87,96
55,r_291_306_28,r_15_135_97,r_10_348_10,r_291_306_28,1.0,7,35,28,96
25,r_372_228_43,r_153_289_129,r_242_133_198,r_153_289_129,0.97,0,129,129,96
83,r_13_22_52,r_174_17_134,r_262_136_36,r_13_22_52,0.88,0,52,52,96
40,r_271_113_29,r_249_142_63,seq116,r_271_113_29,0.59,0,29,29,96
98,r_190_132_119,seq117,r_15_135_97,r_190_132_119,1.0,1,120,119,96
239,seq329,seq39,r_4_259_130,r_4_259_130,1.0,3,133,130,96
52,r_20_237_56,r_340_251_166,r_312_189_59,r_20_237_56,1.0,1,57,56,96
89,r_203_243_59,seq101,r_47_220_41,r_47_220_41,0.73,21,62,41,96
27,r_143_90_175,seq304,r_41_279_63,r_143_90_175,0.94,0,175,175,96
107,r_122_245_59,r_51_215_142,r_260_327_55,r_51_215_142,0.84,-4,138,142,96
31,r_312_189_59,seq137,r_20_237_56,r_312_189_59,1.0,2,61,59,96
76,r_188_54_65,seq14,r_95_75_35,r_188_54_65,0.69,5,70,65,96
242,seq342,r_51_215_142,r_260_327_55,r_260_327_55,1.0,18,73,55,96
108,r_41_279_63,r_30_196_94,r_221_282_5,r_41_279_63,1.0,0,63,63,96
61,r_263_344_44,seq304,r_0_108_37,r_263_344_44,1.0,0,44,44,96
65,r_309_254_54,r_260_327_55,r_64_103_46,r_309_254_54,1.0,2,56,54,96
115,r_209_172_164,seq92,r_255_347_36,r_209_172_164,1.0,0,164,164,96
106,r_299_225_168,seq191,r_83_175_62,r_299_225_168,1.0,0,168,168,96
91,r_48_16_164,seq43,r_372_228_43,r_48_16_164,1.0,0,164,164,96
48,r_232_23_174,seq76,r_110_324_153,r_110_324_153,0.97,24,177,153,96
5,r_30_196_94,seq117,seq275,r_30_196_94,0.97,0,94,94,96
34,r_373_210_148,seq65,seq187,r_373_210_148,1.0,0,148,148,96
6,r_50_355_24,r_339_148_114,seq222,r_50_355_24,1.0,0,24,24,96
69,r_256_66_157,r_312_189_59,r_96_239_45,r_256_66_157,0.96,-107,50,157,96
35,r_261_85_16,r_373_210_148,seq102,r_261_85_16,0.99,0,16,16,96
9,r_95_75_35,r_96_239_45,r_80_140_30,r_95_75_35,1.0,2,37,35,96
12,r_195_241_182,seq28,r_199_326_147,r_195_241_182,0.96,1,183,182,96
38,r_317_79_112,seq77,r_374_362_29,r_317_79_112,1.0,0,112,112,96
24,r_89_337_107,seq32,r_312_189_59,r_89_337_107,1.0,0,107,107,96
99,r_21_59_178,r_374_362_29,r_70_63_147,r_21_59_178,1.0,0,178,178,96
86,r_193_38_63,seq177,seq8,r_193_38_63,1.0,0,63,63,96
145,seq76,r_232_23_174,seq185,r_232_23_174,0.99,3,177,174,96
120,r_311_115_155,seq116,r_41_279_63,r_311_115_155,1.0,0,155,155,96
112,r_124_351_123,r_293_332_167,seq74,r_124_351_123,1.0,3,126,123,96
54,r_37_7_122,r_313_234_164,r_144_179_52,r_37_7_122,0.69,1,123,122,96
95,r_321_353_185,seq150,r_50_355_24,r_321_353_185,0.96,3,188,185,96
56,r_233_338_150,r_173_120_199,seq176,r_233_338_150,1.0,0,150,150,96
94,r_249_142_63,r_31_257_157,r_52_217_59,r_52_217_59,0.65,4,63,59,96
17,r_361_231_187,seq2,r_52_217_59,r_361_231_187,0.83,1,188,187,96
21,r_164_292_94,seq165,r_221_282_5,r_164_292_94,1.0,0,94,94,96
15,r_274_58_154,seq77,r_50_355_24,r_274_58_154,1.0,0,154,154,96
85,r_318_192_163,seq131,r_309_254_54,r_318_192_163,0.74,0,163,163,96
59,r_174_17_134,seq116,r_127_371_5,r_174_17_134,1.0,0,134,134,96
93,r_53_26_165,seq27,r_317_79_112,r_53_26_165,1.0,0,165,165,96
42,r_128_238_70,r_86_87_123,seq43,r_128_238_70,1.0,0,70,70,96
75,r_374_362_29,r_21_59_178,r_317_79_112,r_374_362_29,0.86,149,178,29,96
58,r_287_212_78,r_159_149_61,r_242_133_198,r_159_149_61,0.98,0,61,61,96
39,r_298_280_181,seq183,r_82_60_156,r_298_280_181,0.97,0,181,181,96
185,seq165,r_164_292_94,seq304,r_164_292_94,1.0,0,94,94,96
82,r_368_320_27,r_95_75_35,seq250,r_368_320_27,1.0,0,27,27,96
80,r_273_290_124,r_51_215_142,r_50_355_24,r_273_290_124,1.0,0,124,124,96
23,r_46_367_55,r_295_302_191,r_86_87_123,r_46_367_55,1.0,0,55,55,96
28,r_82_60_156,seq117,r_193_38_63,r_82_60_156,0.98,0,156,156,96
96,r_0_108_37,r_118_35_157,seq27,r_0_108_37,1.0,0,37,37,96
14,r_288_207_119,seq126,r_46_367_55,r_288_207_119,1.0,0,119,119,96
30,r_4_259_130,seq352,r_356_301_131,r_4_259_130,1.0,0,130,130,96
10,r_255_347_36,r_164_292_94,seq171,r_255_347_36,1.0,0,36,36,96
119,r_247_69_60,r_195_241_182,seq150,r_247_69_60,1.0,1,61,60,96
3,r_52_217_59,seq119,seq323,r_52_217_59,1.0,0,59,59,96
62,r_86_87_123,r_46_367_55,r_265_278_123,r_86_87_123,1.0,0,123,123,96
162,seq117,r_56_330_94,r_110_324_153,r_110_324_153,1.0,3,156,153,96
84,r_68_224_59,seq323,seq107,r_68_224_59,1.0,2,61,59,96
66,r_144_179_52,r_233_338_150,seq61,r_144_179_52,1.0,1,53,52,96
68,r_293_332_167,seq216,r_30_196_94,r_293_332_167,0.99,0,167,167,96
18,r_202_167_185,seq107,r_255_347_36,r_202_167_185,1.0,1,186,185,96
118,r_29_5_141,r_214_281_170,r_153_289_129,r_29_5_141,0.99,0,141,141,96
100,r_67_181_112,r_313_234_164,r_95_75_35,r_67_181_112,0.76,0,112,112,96
7,r_163_111_96,seq198,r_261_85_16,r_163_111_96,1.0,0,96,96,96
123,r_47_220_41,r_96_239_45,r_203_243_59,r_47_220_41,1.0,1,42,41,96
108,r_41_279_63,r_221_282_5,r_311_115_155,r_311_115_155,1.0,3,158,155,96
201,seq216,r_293_332_167,r_339_148_114,r_339_148_114,0.79,2,116,114,96
13,r_73_206_120,seq8,seq43,r_73_206_120,1.0,0,120,120,96
192,seq183,r_298_280_181,r_309_254_54,r_298_280_181,1.0,0,181,181,96
107,r_122_245_59,r_29_5_141,r_51_215_142,r_122_245_59,1.0,2,61,59,96
70,r_180_335_146,r_233_338_150,r_263_344_44,r_180_335_146,1.0,0,146,146,96
64,r_340_251_166,seq99,seq303,r_340_251_166,1.0,1,167,166,96
161,seq116,r_311_115_155,r_271_113_29,r_311_115_155,0.99,-49,106,155,96
202,seq219,r_199_326_147,r_346_363_149,r_199_326_147,1.0,0,147,147,96
87,r_45_358_7,r_184_308_178,r_340_251_166,r_45_358_7,0.99,171,178,7,96
248,seq359,r_162_24_98,r_159_149_61,r_162_24_98,0.68,0,98,98,96
77,r_360_197_13,r_321_353_185,seq352,r_360_197_13,0.99,0,13,13,96
81,r_81_369_145,seq27,r_317_79_112,r_81_369_145,1.0,1,146,145,96
50,r_356_301_131,seq253,r_4_259_130,r_4_259_130,1.0,1,131,130,96
46,r_262_136_36,r_96_239_45,seq77,r_262_136_36,1.0,2,38,36,96
41,r_218_297_128,r_4_259_130,r_56_330_94,r_218_297_128,1.0,0,128,128,96
102,r_300_138_167,seq227,seq357,r_300_138_167,1.0,0,167,167,96
245,seq352,r_4_259_130,r_360_197_13,r_4_259_130,1.0,0,130,130,96
104,r_366_170_85,r_233_338_150,r_186_36_4,r_366_170_85,1.0,2,87,85,96
57,r_153_289_129,r_372_228_43,r_230_283_3,r_153_289_129,0.99,0,129,129,96
92,r_44_229_187,seq28,r_153_289_129,r_44_229_187,0.99,2,189,187,96
99,r_21_59_178,r_52_217_59,r_374_362_29,r_21_59_178,0.95,-149,29,178,96
19,r_118_35_157,seq219,seq272,r_118_35_157,0.88,0,157,157,96
75,r_374_362_29,r_34_211_197,r_21_59_178,r_374_362_29,1.0,0,29,29,96
51,r_336_71_115,seq102,seq112,r_336_71_115,1.0,0,115,115,96
97,r_201_370_148,r_248_104_184,r_50_355_24,r_50_355_24,0.58,124,148,24,96
105,r_80_140_30,seq93,seq177,r_80_140_30,0.98,1,31,30,96
4,r_70_63_147,seq107,seq114,r_70_63_147,1.0,0,147,147,96
20,r_339_148_114,seq208,seq216,r_339_148_114,1.0,0,114,114,96
8,r_260_327_55,r_31_257_157,seq342,r_260_327_55,1.0,1,56,55,96
116,r_168_294_47,seq342,seq131,r_168_294_47,1.0,1,48,47,96
88,r_310_204_171,seq102,r_124_351_123,r_310_204_171,0.86,2,173,171,96
74,r_96_239_45,seq240,r_256_66_157,r_96_239_45,0.89,4,49,45,96
212,seq250,seq246,r_368_320_27,r_368_320_27,0.99,23,50,27,96
2,r_56_330_94,r_346_363_149,seq117,r_56_330_94,1.0,0,94,94,96
43,r_83_175_62,r_356_301_131,seq314,r_83_175_62,1.0,0,62,62,96
62,r_86_87_123,r_128_238_70,r_46_367_55,r_86_87_123,1.0,-53,70,123,96
0,r_248_104_184,seq194,r_271_113_29,r_248_104_184,0.93,2,186,184,96
235,seq322,seq187,r_10_348_10,r_10_348_10,0.83,36,46,10,96
22,r_162_24_98,seq359,r_46_367_55,r_162_24_98,1.0,0,98,98,96
93,r_230_178_57,r_110_212_74,seq50,r_110_212_74,0.61,-14,60,74,97
23,r_65_8_51,r_39_2_135,seq240,r_65_8_51,0.89,1,52,51,97
203,seq237,r_105_81_157,r_208_134_49,r_105_81_157,1.0,0,157,157,97
11,r_263_262_97,seq153,seq40,r_263_262_97,1.0,0,97,97,97
39,r_342_233_90,r_244_325_188,r_24_354_4,r_342_233_90,1.0,0,90,90,97
196,seq220,r_209_269_165,r_225_294_22,r_209_269_165,1.0,0,165,165,97
91,r_119_311_56,r_158_92_87,seq42,r_119_311_56,1.0,1,57,56,97
96,r_176_87_157,seq240,seq16,r_176_87_157,1.0,0,157,157,97
105,r_362_265_175,seq277,r_110_212_74,r_362_265_175,0.99,0,175,175,97
101,r_61_219_180,seq332,r_139_256_57,r_61_219_180,0.89,0,180,180,97
73,r_371_181_175,seq26,r_24_354_4,r_371_181_175,1.0,1,176,175,97
74,r_255_19_30,seq196,seq245,r_255_19_30,1.0,2,32,30,97
75,r_274_232_165,r_270_217_187,r_322_131_55,r_274_232_165,0.74,1,166,165,97
66,r_21_85_99,r_363_315_151,r_104_102_68,r_21_85_99,1.0,0,99,99,97
15,r_31_7_29,r_84_201_35,seq118,r_31_7_29,0.97,0,29,29,97
68,r_137_356_94,r_374_238_96,seq45,r_137_356_94,1.0,1,95,94,97
48,r_211_251_36,r_363_315_151,seq42,r_211_251_36,0.84,0,36,36,97
35,r_66_74_26,r_126_135_51,r_0_305_30,r_66_74_26,0.8,4,30,26,97
158,seq80,r_179_241_110,r_122_78_47,r_122_78_47,0.99,28,75,47,97
16,r_270_217_187,seq49,r_17_352_19,r_270_217_187,0.58,0,187,187,97
92,r_122_78_47,seq48,seq80,r_122_78_47,1.0,0,47,47,97
114,r_197_132_110,seq245,r_65_8_51,r_197_132_110,1.0,0,110,110,97
0,r_208_134_49,r_4_27_108,seq237,r_208_134_49,1.0,0,49,49,97
213,seq275,r_231_299_118,seq38,r_231_299_118,1.0,1,119,118,97
13,r_37_296_95,r_373_261_175,r_110_212_74,r_373_261_175,1.0,-80,95,175,97
52,r_244_325_188,seq271,r_54_172_165,r_244_325_188,0.95,0,188,188,97
40,r_69_344_66,r_137_356_94,r_31_7_29,r_69_344_66,1.0,0,66,66,97
33,r_84_201_35,r_350_128_56,seq227,r_84_201_35,0.96,1,36,35,97
109,r_133_222_21,r_234_113_93,seq115,r_133_222_21,1.0,0,21,21,97
51,r_225_294_22,r_105_81_157,seq282,r_225_294_22,0.79,-1,21,22,97
41,r_355_247_129,r_66_74_26,r_84_201_35,r_355_247_129,1.0,0,129,129,97
41,r_355_247_129,r_263_262_97,r_66_74_26,r_355_247_129,0.44,-95,34,129,97
123,r_124_151_74,r_363_315_151,r_188_90_70,r_124_151_74,1.0,2,76,74,97
6,r_194_180_93,r_154_370_141,seq136,r_194_180_93,1.0,1,94,93,97
18,r_54_172_165,seq146,r_57_75_145,r_54_172_165,0.68,0,165,165,97
221,seq297,r_215_142_174,r_24_354_4,r_215_142_174,1.0,0,174,174,97
46,r_5_155_17,r_215_142_174,seq228,r_5_155_17,1.0,0,17,17,97
58,r_272_199_95,r_223_290_149,seq358,r_272_199_95,1.0,0,95,95,97
45,r_205_318_144,seq38,seq68,r_205_318_144,1.0,0,144,144,97
65,r_4_27_108,seq50,r_17_352_19,r_4_27_108,1.0,0,108,108,97
84,r_39_2_135,seq47,seq10,r_39_2_135,1.0,0,135,135,97
14,r_43_213_170,seq42,r_259_97_168,r_259_97_168,0.97,5,173,168,97
54,r_41_22_131,seq166,r_108_99_76,r_41_22_131,1.0,0,131,131,97
2,r_363_315_151,seq349,seq202,r_363_315_151,1.0,0,151,151,97
98,r_242_257_156,seq165,r_84_201_35,r_242_257_156,0.99,1,157,156,97
107,r_223_290_149,seq303,r_125_52_4,r_223_290_149,1.0,1,150,149,97
20,r_179_241_110,seq80,seq258,r_179_241_110,0.81,-19,91,110,97
64,r_285_103_137,r_57_75_145,r_84_201_35,r_285_103_137,1.0,0,137,137,97
30,r_71_300_167,r_259_97_168,r_120_287_26,r_71_300_167,0.69,1,168,167,97
90,r_192_130_24,r_149_317_190,seq297,r_192_130_24,1.0,0,24,24,97
49,r_9_286_47,r_342_233_90,seq72,r_9_286_47,1.0,0,47,47,97
100,r_372_138_85,r_214_162_125,seq343,r_372_138_85,0.99,0,85,85,97
82,r_306_29_78,r_279_147_125,r_188_90_70,r_306_29_78,1.0,1,79,78,97
167,seq136,r_268_93_161,r_194_180_93,r_194_180_93,0.76,3,96,93,97
112,r_279_147_125,seq360,r_110_212_74,r_279_147_125,1.0,1,126,125,97
32,r_23_336_44,r_182_88_162,seq16,r_182_88_162,1.0,1,163,162,97
21,r_105_81_157,seq237,seq303,r_105_81_157,1.0,0,157,157,97
113,r_158_92_87,seq266,seq337,r_158_92_87,1.0,0,87,87,97
56,r_17_352_19,seq72,seq289,r_17_352_19,1.0,0,19,19,97
72,r_323_76_171,r_246_307_188,seq258,r_323_76_171,1.0,0,171,171,97
63,r_57_75_145,seq245,r_231_299_118,r_57_75_145,0.9,0,145,145,97
70,r_182_88_162,r_39_2_135,r_23_336_44,r_182_88_162,0.93,-85,77,162,97
80,r_322_131_55,r_234_113_93,r_30_191_63,r_322_131_55,0.96,4,59,55,97
12,r_143_183_189,seq156,r_167_321_83,r_143_183_189,0.82,0,189,189,97
10,r_186_123_39,r_185_107_121,seq277,r_186_123_39,1.0,2,41,39,97
85,r_13_200_97,seq245,seq33,r_13_200_97,1.0,0,97,97,97
212,seq271,r_244_325_188,r_179_241_110,r_244_325_188,0.99,0,188,188,97
69,r_59_144_113,seq203,seq14,r_59_144_113,0.83,1,114,113,97
120,r_327_328_35,r_57_75_145,r_264_226_8,r_327_328_35,0.99,0,35,35,97
79,r_154_370_141,r_59_144_113,r_338_326_96,r_154_370_141,1.0,-1,140,141,97
57,r_120_287_26,r_65_8_51,r_133_222_21,r_120_287_26,0.99,0,26,26,97
115,r_170_82_178,seq337,r_133_222_21,r_170_82_178,0.98,0,178,178,97
88,r_117_67_78,seq18,seq258,r_117_67_78,1.0,1,79,78,97
104,r_167_321_83,r_105_81_157,r_24_354_4,r_167_321_83,1.0,0,83,83,97
97,r_309_249_162,r_112_169_55,r_116_359_122,r_309_249_162,1.0,0,162,162,97
199,seq228,r_179_241_110,r_5_155_17,r_5_155_17,1.0,4,21,17,97
50,r_250_51_69,r_143_183_189,seq207,r_250_51_69,1.0,0,69,69,97
34,r_100_25_139,seq198,r_158_92_87,r_100_25_139,0.95,3,142,139,97
108,r_231_299_118,seq275,r_65_8_51,r_231_299_118,1.0,1,119,118,97
8,r_268_93_161,seq68,r_186_123_39,r_268_93_161,0.59,0,161,161,97
81,r_365_278_36,r_126_135_51,r_255_19_30,r_126_135_51,1.0,-12,39,51,97
22,r_259_97_168,seq324,seq136,r_259_97_168,1.0,0,168,168,97
29,r_77_353_73,r_125_52_4,seq36,r_77_353_73,0.96,0,73,73,97
67,r_281_340_32,r_170_82_178,seq196,r_281_340_32,1.0,0,32,32,97
83,r_374_238_96,r_209_269_165,seq369,r_209_269_165,0.87,-67,98,165,97
160,seq95,seq334,r_161_145_69,r_161_145_69,1.0,2,71,69,97
118,r_60_157_155,r_170_82_178,r_77_353_73,r_60_157_155,1.0,0,155,155,97
4,r_335_341_44,seq171,seq26,r_335_341_44,1.0,0,44,44,97
3,r_104_102_68,seq1,seq146,r_104_102_68,0.61,-1,67,68,97
59,r_108_99_76,r_323_76_171,r_77_353_73,r_108_99_76,1.0,0,76,76,97
86,r_350_128_56,r_214_162_125,seq236,r_350_128_56,1.0,0,56,56,97
47,r_346_64_172,r_94_15_194,r_23_336_44,r_346_64_172,1.0,0,172,172,97
37,r_161_145_69,r_125_52_4,seq95,r_161_145_69,0.92,1,70,69,97
32,r_23_336_44,r_351_53_150,r_182_88_162,r_23_336_44,1.0,0,44,44,97
55,r_20_34_127,r_371_181_175,seq38,r_20_34_127,1.0,0,127,127,97
70,r_182_88_162,r_23_336_44,r_351_53_150,r_182_88_162,1.0,0,162,162,97
117,r_291_129_109,r_355_247_129,seq258,r_291_129_109,1.0,1,110,109,97
89,r_280_301_30,r_215_142_174,seq235,r_280_301_30,1.0,1,31,30,97
27,r_329_152_57,seq3,r_66_74_26,r_329_152_57,0.92,0,57,57,97
116,r_86_330_171,seq33,seq79,r_86_330_171,1.0,1,172,171,97
28,r_351_53_150,r_176_87_157,r_100_25_139,r_351_53_150,0.7,0,150,150,97
106,r_338_326_96,r_125_52_4,seq58,r_338_326_96,1.0,1,97,96,97
17,r_260_292_16,r_121_273_182,seq1,r_260_292_16,1.0,0,16,16,97
71,r_0_305_30,r_170_82_178,r_66_74_26,r_0_305_30,0.96,0,30,30,97
19,r_121_273_182,seq360,r_234_113_93,r_121_273_182,0.89,1,183,182,97
110,r_150_91_107,r_105_81_157,seq136,r_150_91_107,1.0,1,108,107,97
177,seq166,r_41_22_131,seq68,r_41_22_131,1.0,0,131,131,97
31,r_116_359_122,seq258,seq368,r_116_359_122,1.0,0,122,122,97
99,r_209_269_165,seq220,seq118,r_209_269_165,1.0,0,165,165,97
121,r_126_135_51,seq95,seq266,r_126_135_51,1.0,1,52,51,97
202,seq236,seq6,r_350_128_56,r_350_128_56,1.0,12,68,56,97
7,r_234_113_93,r_270_217_187,seq165,r_234_113_93,1.0,0,93,93,97
95,r_188_90_70,seq58,r_124_151_74,r_188_90_70,1.0,1,71,70,97
25,r_361_56_104,seq289,r_255_19_30,r_361_56_104,1.0,0,104,104,97
124,r_252_284_80,seq343,r_77_353_73,r_252_284_80,0.99,1,81,80,97
53,r_185_107_121,seq153,seq324,r_185_107_121,1.0,0,121,121,97
87,r_246_307_188,seq115,r_263_262_97,r_246_307_188,0.97,0,188,188,97
24,r_312_254_148,seq349,r_59_144_113,r_312_254_148,0.55,16,164,148,97
94,r_214_162_125,r_30_191_63,r_37_296_95,r_214_162_125,1.0,0,125,125,97
44,r_215_142_174,seq297,r_185_107_121,r_215_142_174,0.52,0,174,174,97
36,r_283_190_74,seq314,r_126_135_51,r_283_190_74,1.0,-1,73,74,97
60,r_163_298_82,r_234_113_93,seq141,r_163_298_82,0.99,0,82,82,97
59,r_145_224_146,seq51,seq241,r_145_224_146,0.72,3,149,146,98
51,r_326_120_158,seq252,seq127,r_326_120_158,0.99,1,159,158,98
28,r_6_343_140,seq79,r_22_192_137,r_6_343_140,1.0,3,143,140,98
31,r_281_103_135,seq333,seq274,r_281_103_135,0.91,2,137,135,98
96,r_26_167_89,seq124,seq119,r_26_167_89,1.0,0,89,89,98
26,r_76_29_184,seq89,r_223_278_17,r_223_278_17,1.0,46,63,17,98
113,r_20_259_48,r_326_120_158,seq331,r_20_259_48,1.0,0,48,48,98
65,r_185_220_141,r_360_138_159,r_262_46_108,r_185_220_141,0.99,1,142,141,98
70,r_218_147_20,r_363_149_72,seq201,r_363_149_72,0.83,-51,21,72,98
221,seq303,r_360_138_159,r_183_357_123,r_360_138_159,0.67,0,159,159,98
37,r_78_130_122,r_230_299_151,seq333,r_78_130_122,1.0,1,123,122,98
16,r_268_325_30,r_58_337_106,r_329_289_110,r_268_325_30,0.97,76,106,30,98
107,r_275_54_144,seq315,seq115,r_275_54_144,1.0,1,145,144,98
220,seq301,seq89,r_121_23_60,r_121_23_60,1.0,37,97,60,98
97,r_40_310_85,r_329_289_110,seq83,r_40_310_85,0.77,3,88,85,98
119,r_320_286_37,r_148_304_174,seq209,r_320_286_37,0.94,9,46,37,98
23,r_101_324_126,seq113,r_74_47_51,r_101_324_126,1.0,0,126,126,98
108,r_114_36_132,seq241,seq112,r_114_36_132,1.0,2,134,132,98
80,r_75_245_11,r_92_294_172,r_139_168_2,r_75_245_11,0.93,-1,10,11,98
95,r_4_318_108,r_150_15_193,r_215_211_56,r_4_318_108,0.94,0,108,108,98
16,r_268_325_30,seq197,r_58_337_106,r_268_325_30,1.0,0,30,30,98
35,r_198_370_180,seq231,r_111_37_50,r_198_370_180,0.96,0,180,180,98
6,r_122_96_80,seq82,seq368,r_122_96_80,1.0,-2,78,80,98
123,r_25_266_178,seq342,r_145_224_146,r_25_266_178,0.87,1,179,178,98
92,r_360_138_159,seq303,r_111_37_50,r_360_138_159,1.0,0,159,159,98
191,seq209,r_68_70_157,r_223_278_17,r_68_70_157,1.0,0,157,157,98
54,r_313_1_76,r_4_318_108,seq169,r_313_1_76,1.0,1,77,76,98
27,r_223_278_17,r_27_336_189,r_76_29_184,r_223_278_17,1.0,0,17,17,98
30,r_17_346_29,r_153_50_116,seq132,r_17_346_29,1.0,1,30,29,98
121,r_58_337_106,seq306,seq164,r_58_337_106,1.0,0,106,106,98
18,r_334_151_125,r_43_123_137,r_344_317_197,r_334_151_125,1.0,0,125,125,98
57,r_253_373_89,seq142,seq187,r_253_373_89,1.0,1,90,89,98
63,r_199_57_181,seq339,r_35_174_125,r_199_57_181,1.0,1,182,181,98
160,seq124,r_26_167_89,r_93_338_199,r_26_167_89,1.0,0,89,89,98
48,r_160_69_17,seq216,seq239,r_160_69_17,1.0,0,17,17,98
42,r_153_50_116,r_97_99_178,seq107,r_153_50_116,0.99,0,116,116,98
29,r_55_217_128,seq254,r_111_37_50,r_55_217_128,0.99,0,128,128,98
103,r_280_265_130,seq79,seq71,r_280_265_130,1.0,0,130,130,98
7,r_111_37_50,r_183_357_123,seq187,r_111_37_50,1.0,2,52,50,98
32,r_66_49_170,seq330,seq115,r_66_49_170,1.0,0,170,170,98
44,r_43_123_137,r_334_151_125,seq339,r_43_123_137,0.96,-9,128,137,98
74,r_92_294_172,seq169,r_363_149_72,r_92_294_172,0.92,1,173,172,98
120,r_97_99_178,seq128,r_166_8_71,r_97_99_178,0.98,0,178,178,98
163,seq128,r_97_99_178,r_90_233_53,r_97_99_178,0.61,0,178,178,98
98,r_285_251_23,r_126_367_151,r_122_96_80,r_285_251_23,0.55,0,23,23,98
104,r_9_13_116,seq340,r_248_38_110,r_9_13_116,0.87,4,120,116,98
3,r_354_247_38,r_276_5_189,r_21_232_4,r_354_247_38,0.97,1,39,38,98
81,r_95_195_190,r_93_338_199,r_111_37_50,r_95_195_190,1.0,0,190,190,98
114,r_108_307_144,seq239,r_253_373_89,r_108_307_144,1.0,1,145,144,98
25,r_53_7_190,seq113,seq84,r_53_7_190,0.9,0,190,190,98
232,seq331,seq48,r_20_259_48,r_20_259_48,1.0,40,88,48,98
8,r_39_246_74,seq113,r_177_364_9,r_39_246_74,0.93,0,74,74,98
4,r_74_47_51,r_104_240_41,seq44,r_74_47_51,1.0,1,52,51,98
105,r_374_309_196,r_106_302_90,r_67_18_54,r_106_302_90,0.95,0,90,90,98
215,seq279,seq306,r_300_152_41,r_300_152_41,1.0,64,105,41,98
56,r_183_357_123,seq231,seq303,r_183_357_123,1.0,4,127,123,98
110,r_188_210_171,r_63_200_169,r_156_308_70,r_188_210_171,1.0,7,178,171,98
62,r_225_234_138,r_215_211_56,r_78_130_122,r_225_234_138,1.0,0,138,138,98
83,r_176_161_40,seq279,seq269,r_176_161_40,1.0,0,40,40,98
60,r_166_8_71,seq214,seq12,r_166_8_71,1.0,0,71,71,98
117,r_284_358_25,seq311,seq283,r_284_358_25,1.0,0,25,25,98
77,r_208_290_154,seq119,r_90_233_53,r_208_290_154,1.0,1,155,154,98
88,r_215_211_56,r_225_234_138,r_4_318_108,r_215_211_56,0.98,59,115,56,98
1,r_238_341_157,r_28_155_169,r_68_70_157,r_28_155_169,0.76,-12,157,169,98
84,r_33_366_150,seq347,r_17_346_29,r_33_366_150,0.98,0,150,150,98
112,r_28_155_169,r_238_341_157,seq335,r_238_341_157,1.0,0,157,157,98
43,r_90_233_53,r_313_1_76,seq128,r_90_233_53,1.0,0,53,53,98
33,r_179_178_114,seq34,r_40_310_85,r_179_178_114,0.89,0,114,114,98
38,r_67_18_54,seq62,seq83,r_67_18_54,0.99,2,56,54,98
122,r_297_295_135,seq51,r_88_42_114,r_297_295_135,0.98,0,135,135,98
15,r_156_308_70,r_139_168_2,r_41_355_55,r_156_308_70,1.0,0,70,70,98
78,r_213_264_44,r_148_304_174,seq197,r_213_264_44,0.68,7,51,44,98
20,r_230_299_151,seq44,seq71,r_230_299_151,1.0,0,151,151,98
45,r_312_11_151,seq291,r_165_146_11,r_312_11_151,1.0,0,151,151,98
9,r_126_367_151,seq306,r_212_59_100,r_126_367_151,1.0,0,151,151,98
61,r_45_0_147,r_257_140_184,seq339,r_45_0_147,0.9,1,148,147,98
21,r_296_184_133,seq119,seq84,r_296_184_133,1.0,0,133,133,98
90,r_186_332_123,r_351_105_197,r_148_304_174,r_186_332_123,0.59,23,146,123,98
201,seq239,r_108_307_144,r_160_69_17,r_108_307_144,1.0,1,145,144,98
75,r_2_171_139,seq193,r_114_36_132,r_2_171_139,1.0,0,139,139,98
68,r_87_163_85,r_183_357_123,r_190_135_34,r_87_163_85,1.0,3,88,85,98
99,r_212_59_100,r_78_130_122,seq102,r_212_59_100,1.0,0,100,100,98
131,seq34,r_257_140_184,r_356_229_30,r_257_140_184,0.99,1,185,184,98
67,r_14_60_61,seq323,r_137_369_39,r_14_60_61,1.0,2,63,61,98
124,r_257_140_184,seq34,r_74_47_51,r_257_140_184,0.97,1,185,184,98
79,r_189_305_72,r_242_282_139,r_205_19_93,r_205_19_93,0.98,8,101,93,98
58,r_100_30_95,r_55_217_128,seq128,r_100_30_95,0.75,1,96,95,98
62,r_225_234_138,r_329_289_110,r_215_211_56,r_215_211_56,0.91,5,61,56,98
202,seq241,r_114_36_132,r_145_224_146,r_114_36_132,1.0,2,134,132,98
40,r_300_152_41,seq143,seq279,r_300_152_41,1.0,0,41,41,98
85,r_190_135_34,r_298_72_1,seq132,r_190_135_34,0.7,7,41,34,98
34,r_64_204_94,r_58_337_106,r_74_47_51,r_64_204_94,0.99,1,95,94,98
27,r_223_278_17,r_76_29_184,r_242_282_139,r_76_29_184,0.93,1,185,184,98
47,r_205_19_93,seq77,r_189_305_72,r_205_19_93,1.0,0,93,93,98
169,seq142,seq82,r_133_3_56,r_133_3_56,1.0,49,105,56,98
36,r_262_46_108,seq115,r_285_251_23,r_262_46_108,1.0,0,108,108,98
0,r_363_149_72,r_68_70_157,seq237,r_363_149_72,0.95,0,72,72,98
73,r_276_5_189,seq12,r_73_196_185,r_276_5_189,0.81,1,190,189,98
109,r_133_3_56,seq84,seq51,r_133_3_56,1.0,0,56,56,98
141,seq79,r_280_265_130,r_35_174_125,r_280_265_130,1.0,0,130,130,98
53,r_88_42_114,seq260,seq119,r_88_42_114,1.0,0,114,114,98
46,r_41_355_55,r_219_65_163,seq260,r_41_355_55,1.0,0,55,55,98
86,r_352_94_164,seq102,r_111_37_50,r_352_94_164,0.94,0,164,164,98
64,r_242_282_139,r_327_91_184,r_320_286_37,r_242_282_139,0.99,4,143,139,98
2,r_137_369_39,r_230_299_151,r_104_240_41,r_137_369_39,1.0,0,39,39,98
12,r_350_261_179,seq187,r_363_149_72,r_350_261_179,0.97,0,179,179,98
118,r_22_192_137,r_97_99_178,r_363_149_72,r_22_192_137,0.78,-1,136,137,98
5,r_73_196_185,seq83,r_334_151_125,r_73_196_185,0.98,1,186,185,98
98,r_285_251_23,r_122_96_80,r_354_247_38,r_122_96_80,1.0,1,81,80,98
111,r_35_174_125,r_154_272_166,seq216,r_35_174_125,0.96,0,125,125,98
164,seq129,seq12,r_222_158_136,r_222_158_136,1.0,14,150,136,98
49,r_356_229_30,r_41_355_55,seq231,r_356_229_30,0.86,0,30,30,98
91,r_165_146_11,r_354_247_38,seq201,r_165_146_11,0.94,0,11,11,98
11,r_63_200_169,r_188_210_171,r_255_288_23,r_188_210_171,0.96,4,175,171,98
106,r_116_131_164,r_327_91_184,r_356_229_30,r_116_131_164,1.0,1,165,164,98
93,r_93_338_199,r_95_195_190,r_74_47_51,r_95_195_190,1.0,0,190,190,98
19,r_106_302_90,r_374_309_196,seq315,r_106_302_90,1.0,0,90,90,98
66,r_248_38_110,r_350_261_179,seq127,r_248_38_110,0.99,0,110,110,98
72,r_222_158_136,r_154_272_166,seq129,r_222_158_136,1.0,0,136,136,98
26,r_76_29_184,r_223_278_17,r_14_60_61,r_76_29_184,0.99,1,185,184,98
204,seq244,r_122_96_80,r_104_240_41,r_122_96_80,1.0,-13,67,80,98
50,r_267_321_81,seq371,seq315,r_267_321_81,0.92,0,81,81,98
100,r_121_23_60,r_27_336_189,seq301,r_121_23_60,1.0,3,63,60,98
52,r_219_65_163,seq250,r_111_37_50,r_219_65_163,0.97,0,163,163,98
88,r_215_211_56,seq274,r_225_234_138,r_215_211_56,1.0,2,58,56,98
132,seq44,r_230_299_151,r_74_47_51,r_230_299_151,1.0,0,151,151,98
208,seq254,r_55_217_128,seq56,r_55_217_128,1.0,0,128,128,98
55,r_329_289_110,r_114_36_132,r_268_325_30,r_329_289_110,1.0,0,110,110,98
233,seq333,r_281_103_135,r_78_130_122,r_78_130_122,1.0,15,137,122,98
14,r_84_196_29,r_209_197_100,seq27,r_84_196_29,1.0,0,29,29,99
80,r_216_185_143,r_135_88_183,r_250_60_96,r_216_185_143,1.0,0,143,143,99
16,r_19_221_92,r_2_176_3,seq1,r_19_221_92,1.0,0,92,92,99
72,r_313_17_149,r_182_360_149,r_195_233_74,r_195_233_74,0.83,76,150,74,99
119,r_42_344_31,r_253_354_117,r_346_145_70,r_253_354_117,0.66,0,117,117,99
31,r_72_277_190,seq214,r_2_176_3,r_72_277_190,1.0,0,190,190,99
59,r_178_22_164,seq289,seq57,r_178_22_164,0.99,0,164,164,99
20,r_0_98_38,r_346_145_70,r_54_359_19,r_346_145_70,0.97,0,70,70,99
112,r_268_373_124,seq1,r_13_143_91,r_268_373_124,1.0,0,124,124,99
24,r_108_226_157,r_77_52_179,r_116_235_50,r_108_226_157,0.62,4,161,157,99
81,r_262_41_55,seq89,r_339_158_43,r_262_41_55,0.99,0,55,55,99
42,r_278_208_188,seq1,r_133_180_88,r_278_208_188,0.86,0,188,188,99
144,seq67,r_339_158_43,r_9_147_4,r_339_158_43,0.99,-6,37,43,99
77,r_243_293_161,r_99_318_48,r_13_143_91,r_13_143_91,0.65,73,164,91,99
15,r_283_309_44,r_250_60_96,seq260,r_283_309_44,0.99,0,44,44,99
121,r_151_149_90,seq192,seq36,r_151_149_90,1.0,1,91,90,99
207,seq259,r_45_165_111,r_154_200_108,r_45_165_111,1.0,0,111,111,99
69,r_148_118_171,seq224,seq85,r_148_118_171,0.81,0,171,171,99
58,r_264_157_81,seq91,r_195_233_74,r_264_157_81,1.0,0,81,81,99
4,r_167_330_132,r_168_144_157,r_23_179_92,r_167_330_132,0.93,0,132,132,99
30,r_254_28_12,r_253_354_117,seq246,r_254_28_12,0.67,0,12,12,99
21,r_3_96_23,r_271_171_75,seq192,r_3_96_23,0.95,0,23,23,99
22,r_177_347_63,r_263_231_178,seq369,r_177_347_63,0.49,-7,56,63,99
94,r_25_166_87,seq289,seq324,r_25_166_87,0.92,-3,84,87,99
48,r_135_88_183,seq299,r_13_143_91,r_135_88_183,0.91,1,184,183,99
97,r_100_353_67,seq356,seq66,r_100_353_67,1.0,-2,65,67,99
49,r_55_86_76,r_295_343_153,seq131,r_55_86_76,0.87,-4,72,76,99
128,seq10,r_117_275_178,r_164_11_122,r_164_11_122,0.86,0,122,122,99
33,r_82_338_187,seq95,r_9_147_4,r_82_338_187,1.0,0,187,187,99
19,r_227_113_180,seq246,r_9_147_4,r_227_113_180,0.9,1,181,180,99
132,seq32,r_250_60_96,r_319_156_126,r_319_156_126,0.66,-25,101,126,99
67,r_64_74_64,seq110,seq67,r_64_74_64,0.78,-4,60,64,99
71,r_43_120_156,r_350_130_156,r_19_221_92,r_19_221_92,0.69,70,162,92,99
76,r_121_190_138,seq90,seq335,r_121_190_138,1.0,1,139,138,99
37,r_294_62_15,r_317_368_21,seq202,r_294_62_15,0.94,0,15,15,99
27,r_339_158_43,seq67,r_53_305_6,r_339_158_43,1.0,0,43,43,99
62,r_70_365_195,r_290_111_89,r_154_200_108,r_290_111_89,1.0,3,92,89,99
95,r_247_272_5,r_43_120_156,r_51_304_69,r_43_120_156,0.99,9,165,156,99
78,r_38_213_127,seq101,seq215,r_38_213_127,1.0,0,127,127,99
2,r_162_281_13,r_104_186_111,seq115,r_162_281_13,0.69,0,13,13,99
0,r_195_233_74,r_14_142_115,r_364_361_58,r_195_233_74,0.8,0,74,74,99
73,r_316_245_134,r_108_226_157,r_254_28_12,r_316_245_134,1.0,0,134,134,99
75,r_193_59_125,seq80,r_269_223_49,r_193_59_125,0.93,1,126,125,99
17,r_295_343_153,seq246,r_63_127_18,r_295_343_153,0.86,0,153,153,99
79,r_317_368_21,seq76,seq201,r_317_368_21,1.0,0,21,21,99
92,r_284_249_178,seq348,r_254_28_12,r_254_28_12,0.51,166,178,12,99
90,r_230_342_128,seq205,seq114,r_230_342_128,1.0,0,128,128,99
106,r_51_304_69,r_43_120_156,r_247_272_5,r_43_120_156,0.85,0,156,156,99
215,seq289,r_23_179_92,r_63_127_18,r_63_127_18,0.99,0,18,18,99
65,r_188_30_13,r_295_343_153,r_93_291_22,r_93_291_22,0.95,8,30,22,99
108,r_265_355_17,r_117_275_178,seq311,r_265_355_17,0.95,0,17,17,99
74,r_244_248_30,r_280_332_58,seq7,r_244_248_30,1.0,0,30,30,99
51,r_77_52_179,seq172,r_313_17_149,r_313_17_149,0.56,38,187,149,99
105,r_63_127_18,r_167_330_132,seq289,r_63_127_18,0.94,0,18,18,99
185,seq202,r_150_139_162,r_294_62_15,r_294_62_15,0.94,1,16,15,99
226,seq312,r_239_194_19,r_54_359_19,r_54_359_19,1.0,0,19,19,99
65,r_188_30_13,r_84_196_29,r_295_343_153,r_188_30_13,0.89,-1,12,13,99
115,r_168_144_157,r_47_94_7,r_188_30_13,r_168_144_157,1.0,0,157,157,99
29,r_292_220_14,r_294_62_15,seq169,r_292_220_14,0.93,0,14,14,99
6,r_296_257_163,r_99_318_48,seq106,r_296_257_163,1.0,0,163,163,99
47,r_119_16_95,r_296_257_163,r_13_143_91,r_119_16_95,0.84,-1,94,95,99
85,r_189_50_116,seq34,seq198,r_189_50_116,0.88,0,116,116,99
5,r_13_143_91,r_135_88_183,r_339_158_43,r_13_143_91,1.0,0,91,91,99
218,seq299,r_135_88_183,r_236_161_123,r_135_88_183,0.74,1,184,183,99
70,r_261_107_100,seq24,seq112,r_261_107_100,1.0,0,100,100,99
91,r_152_225_98,seq131,r_174_333_54,r_152_225_98,1.0,0,98,98,99
116,r_183_49_11,r_150_139_162,seq301,r_183_49_11,0.96,0,11,11,99
52,r_271_171_75,r_152_225_98,seq314,r_152_225_98,0.99,-24,74,98,99
18,r_154_200_108,seq206,seq85,r_154_200_108,0.86,-12,96,108,99
111,r_29_367_187,seq299,r_263_231_178,r_29_367_187,0.84,0,187,187,99
41,r_319_156_126,seq40,r_261_107_100,r_261_107_100,0.89,26,126,100,99
102,r_174_333_54,r_364_361_58,r_47_94_7,r_174_333_54,1.0,0,54,54,99
114,r_341_288_177,r_99_318_48,r_164_11_122,r_164_11_122,0.51,55,177,122,99
110,r_47_94_7,r_168_144_157,r_280_332_58,r_47_94_7,1.0,93,100,7,99
83,r_69_325_83,r_284_249_178,r_339_158_43,r_69_325_83,0.9,0,83,83,99
25,r_253_354_117,r_236_161_123,r_4_287_57,r_253_354_117,1.0,0,117,117,99
38,r_116_235_50,r_286_126_106,seq141,r_116_235_50,1.0,0,50,50,99
45,r_104_186_111,r_236_161_123,seq203,r_104_186_111,1.0,0,111,111,99
187,seq205,r_286_126_106,r_99_318_48,r_286_126_106,1.0,0,106,106,99
93,r_137_163_74,r_38_213_127,r_339_158_43,r_137_163_74,1.0,0,74,74,99
98,r_18_132_114,seq112,r_26_92_7,r_18_132_114,0.94,4,118,114,99
34,r_364_361_58,r_56_87_193,seq322,r_364_361_58,1.0,0,58,58,99
82,r_54_359_19,r_154_200_108,seq312,r_54_359_19,1.0,0,19,19,99
12,r_117_275_178,r_82_338_187,r_31_5_172,r_117_275_178,0.98,0,178,178,99
32,r_280_332_58,seq66,r_47_94_7,r_280_332_58,1.0,0,58,58,99
181,seq192,r_150_139_162,r_3_96_23,r_3_96_23,0.96,1,24,23,99
56,r_187_219_108,r_2_176_3,r_357_336_78,r_357_336_78,1.0,34,112,78,99
88,r_209_197_100,seq61,seq255,r_209_197_100,0.68,7,107,100,99
53,r_48_274_115,seq97,r_103_181_99,r_48_274_115,1.0,0,115,115,99
118,r_93_291_22,r_84_196_29,r_188_30_13,r_93_291_22,0.78,0,22,22,99
239,seq348,r_284_249_178,r_150_139_162,r_150_139_162,0.97,16,178,162,99
84,r_21_340_64,r_296_257_163,seq169,r_21_340_64,1.0,0,64,64,99
9,r_103_181_99,r_320_122_141,r_133_180_88,r_103_181_99,1.0,0,99,99,99
44,r_79_20_42,r_364_361_58,seq202,r_79_20_42,1.0,0,42,42,99
101,r_31_5_172,seq75,r_78_237_93,r_78_237_93,1.0,13,106,93,99
23,r_182_360_149,r_82_338_187,r_26_92_7,r_182_360_149,1.0,1,150,149,99
103,r_14_142_115,seq184,seq101,r_14_142_115,1.0,0,115,115,99
63,r_150_139_162,seq202,r_193_59_125,r_150_139_162,1.0,0,162,162,99
8,r_133_180_88,seq36,r_294_62_15,r_133_180_88,1.0,0,88,88,99
100,r_164_11_122,seq80,seq10,r_164_11_122,1.0,0,122,122,99
123,r_78_237_93,r_38_213_127,r_239_194_19,r_78_237_93,1.0,0,93,93,99
50,r_68_256_165,seq321,r_133_180_88,r_68_256_165,1.0,0,165,165,99
35,r_303_138_172,seq201,r_263_231_178,r_303_138_172,0.77,10,182,172,99
99,r_269_223_49,r_164_11_122,seq124,r_269_223_49,0.88,0,49,49,99
119,r_42_344_31,r_263_231_178,r_253_354_117,r_42_344_31,0.99,0,31,31,99
57,r_350_130_156,r_43_120_156,r_263_231_178,r_350_130_156,0.91,6,162,156,99
68,r_37_134_41,r_19_221_92,seq172,r_37_134_41,0.5,-1,40,41,99
60,r_236_161_123,seq24,seq299,r_236_161_123,1.0,1,124,123,99
96,r_286_126_106,r_230_342_128,r_244_248_30,r_286_126_106,1.0,0,106,106,99
11,r_4_287_57,r_103_181_99,seq39,r_4_287_57,0.86,-1,56,57,99
120,r_290_111_89,r_19_221_92,seq90,r_290_111_89,1.0,-3,86,89,99
107,r_83_331_144,seq202,r_292_220_14,r_83_331_144,0.99,0,144,144,99
13,r_211_362_119,seq101,r_64_74_64,r_211_362_119,1.0,0,119,119,99
229,seq322,r_276_326_182,r_364_361_58,r_364_361_58,1.0,12,70,58,99
66,r_250_60_96,r_43_120_156,r_216_185_143,r_250_60_96,0.68,60,156,96,99
55,r_315_15_36,seq234,seq184,r_315_15_36,0.84,-4,32,36,99
43,r_229_128_9,r_296_257_163,seq7,r_229_128_9,0.99,1,10,9,99
124,r_204_8_183,seq314,r_4_287_57,r_204_8_183,0.92,1,184,183,99
89,r_191_140_27,r_103_181_99,seq206,r_191_140_27,1.0,0,27,27,99
40,r_173_366_114,r_56_87_193,r_13_143_91,r_173_366_114,1.0,0,114,114,99
61,r_276_326_182,seq322,r_0_98_38,r_276_326_182,0.98,0,182,182,99
109,r_320_122_141,seq141,seq334,r_320_122_141,1.0,0,141,141,99
113,r_346_145_70,r_0_98_38,r_42_344_31,r_346_145_70,1.0,0,70,70,99
26,r_23_179_92,seq155,seq34,r_23_179_92,0.99,-2,90,92,99
122,r_45_165_111,seq259,r_133_180_88,r_45_165_111,1.0,0,111,111,99
