93,r_35_274_106,seq110,r_154_53_32,r_35_274_106,0.97,0,106,106,0
51,r_235_144_195,r_64_176_178,r_80_62_33,r_80_62_33,0.97,145,178,33,0
36,r_265_67_148,seq129,r_23_54_38,r_265_67_148,0.75,0,148,148,0
100,seq2,r_75_22_88,r_46_260_38,r_46_260_38,1.0,0,38,38,0
124,seq83,r_216_254_174,r_189_267_27,r_189_267_27,1.0,1,28,27,0
53,r_219_104_137,seq109,r_90_76_138,r_219_104_137,0.99,0,137,137,0
18,r_138_10_34,r_5_194_57,seq202,r_138_10_34,1.0,0,34,34,0
54,r_55_48_96,r_227_181_112,r_296_277_156,r_55_48_96,1.0,1,97,96,0
83,r_184_241_74,r_252_58_176,seq112,r_184_241_74,1.0,-2,72,74,0
55,r_264_12_141,seq220,seq129,r_264_12_141,0.85,1,142,141,0
71,r_131_175_156,seq2,seq109,r_131_175_156,0.56,0,156,156,0
86,r_102_283_61,r_187_134_96,r_41_177_52,r_102_283_61,1.0,0,61,61,0
1,r_118_127_152,r_209_99_169,r_73_245_131,r_118_127_152,0.78,0,152,152,0
5,r_297_231_140,seq255,seq237,r_297_231_140,0.99,0,140,140,0
42,r_135_139_60,seq143,seq91,r_135_139_60,0.97,0,60,60,0
9,r_290_214_56,seq29,seq63,r_290_214_56,1.0,0,56,56,0
69,r_187_134_96,seq112,r_11_87_68,r_187_134_96,0.53,-2,94,96,0
45,r_282_44_147,seq256,r_80_62_33,r_282_44_147,0.92,0,147,147,0
19,r_203_168_90,r_31_146_161,r_135_139_60,r_203_168_90,1.0,0,90,90,0
75,r_46_260_38,seq20,seq2,r_46_260_38,1.0,0,38,38,0
175,seq226,r_35_274_106,r_7_201_192,r_35_274_106,0.81,-80,26,106,0
95,r_40_52_190,seq6,r_151_133_89,r_151_133_89,0.71,101,190,89,0
66,r_11_87_68,r_151_133_89,seq140,r_11_87_68,0.99,0,68,68,0
44,r_77_270_34,r_244_213_176,seq16,r_77_270_34,1.0,0,34,34,0
60,r_199_141_25,r_243_218_82,r_145_130_79,r_199_141_25,1.0,54,79,25,0
103,seq9,r_246_126_128,seq156,r_246_126_128,0.99,0,128,128,0
110,seq33,r_74_198_165,r_116_124_82,r_116_124_82,0.96,3,85,82,0
89,r_296_277_156,r_252_58_176,r_74_198_165,r_74_198_165,0.97,14,179,165,0
3,r_123_190_96,seq36,r_7_201_192,r_123_190_96,0.62,0,96,96,0
10,r_70_122_84,r_4_25_96,r_151_133_89,r_4_25_96,0.98,-10,86,96,0
90,r_236_193_74,seq295,seq14,r_236_193_74,0.84,-2,72,74,0
26,r_252_58_176,r_296_277_156,r_115_225_137,r_115_225_137,0.81,42,179,137,0
8,r_37_60_7,r_74_198_165,r_246_126_128,r_246_126_128,0.94,37,165,128,0
78,r_113_161_172,r_93_137_58,r_80_62_33,r_93_137_58,0.53,114,172,58,0
0,r_115_225_137,seq212,r_73_245_131,r_115_225_137,0.54,1,138,137,0
63,r_185_230_83,r_291_92_183,r_4_25_96,r_185_230_83,1.0,0,83,83,0
11,r_145_130_79,r_259_100_84,r_199_141_25,r_145_130_79,1.0,1,80,79,0
68,r_45_200_47,r_128_111_141,seq63,r_45_200_47,0.83,0,47,47,0
13,r_7_201_192,seq13,r_123_190_96,r_123_190_96,1.0,4,100,96,0
76,r_243_218_82,r_79_271_34,r_199_141_25,r_243_218_82,0.95,-57,25,82,0
98,r_228_57_174,seq195,r_252_58_176,r_228_57_174,0.65,0,174,174,0
91,r_59_43_44,r_207_257_138,seq299,r_59_43_44,1.0,0,44,44,0
62,r_291_92_183,r_185_230_83,r_235_144_195,r_185_230_83,1.0,1,84,83,0
38,r_0_15_28,r_154_53_32,seq29,r_0_15_28,1.0,0,28,28,0
81,r_8_215_28,r_151_133_89,r_7_201_192,r_8_215_28,0.92,0,28,28,0
85,r_229_1_183,seq14,r_37_60_7,r_229_1_183,0.5,0,183,183,0
99,r_157_28_85,seq63,r_196_164_4,r_157_28_85,0.99,0,85,85,0
134,seq109,r_227_181_112,r_160_153_49,r_160_153_49,0.98,26,75,49,0
136,seq112,r_187_134_96,r_184_241_74,r_184_241_74,0.74,13,87,74,0
172,seq220,r_264_12_141,r_18_167_133,r_18_167_133,0.89,9,142,133,0
87,r_293_49_108,r_229_1_183,seq163,r_293_49_108,1.0,0,108,108,0
97,r_276_84_16,r_80_62_33,seq147,r_276_84_16,1.0,0,16,16,0
2,r_216_254_174,seq83,r_56_159_8,r_216_254_174,0.51,0,174,174,0
41,r_74_198_165,r_37_60_7,r_296_277_156,r_74_198_165,0.62,0,165,165,0
47,r_278_281_68,r_217_178_148,seq120,r_278_281_68,1.0,0,68,68,0
20,r_154_53_32,r_115_225_137,r_5_194_57,r_154_53_32,0.96,38,70,32,0
40,r_206_298_129,seq212,seq240,r_206_298_129,0.5,0,129,129,0
105,seq14,r_229_1_183,r_80_62_33,r_80_62_33,0.84,150,183,33,0
178,seq238,r_151_133_89,r_196_164_4,r_151_133_89,0.9,-55,34,89,0
74,r_98_32_87,seq39,r_236_193_74,r_98_32_87,1.0,0,87,87,0
29,r_224_94_71,seq299,seq212,r_224_94_71,0.98,0,71,71,0
24,r_227_181_112,r_219_104_137,seq106,r_219_104_137,0.59,-24,113,137,0
25,r_17_287_157,seq179,seq286,r_17_287_157,0.52,0,157,157,0
88,r_50_82_54,seq107,r_160_153_49,r_50_82_54,1.0,-1,53,54,0
33,r_90_76_138,r_128_111_141,r_219_104_137,r_90_76_138,0.98,0,138,138,0
127,seq91,r_278_281_68,r_135_139_60,r_278_281_68,0.82,-8,60,68,0
30,r_30_173_49,r_216_254_174,seq273,r_30_173_49,1.0,0,49,49,0
64,r_247_85_164,seq205,seq119,r_247_85_164,0.64,0,164,164,0
191,seq272,seq39,r_188_72_111,r_188_72_111,1.0,8,119,111,0
50,r_64_176_178,r_235_144_195,r_115_225_137,r_235_144_195,0.46,-17,178,195,0
58,r_217_178_148,seq91,seq273,r_217_178_148,0.94,0,148,148,0
20,r_154_53_32,r_114_125_193,r_115_225_137,r_154_53_32,0.99,0,32,32,0
57,r_189_267_27,seq36,seq83,r_189_267_27,1.0,0,27,27,0
59,r_160_153_49,seq6,seq109,r_160_153_49,1.0,1,50,49,0
61,r_18_167_133,seq47,seq220,r_18_167_133,1.0,0,133,133,0
82,r_5_194_57,seq255,r_154_53_32,r_5_194_57,0.86,0,57,57,0
52,r_75_22_88,seq2,seq197,r_75_22_88,0.72,-9,79,88,0
34,r_24_262_13,r_115_225_137,seq166,r_115_225_137,0.59,-124,13,137,0
60,r_199_141_25,r_297_231_140,r_243_218_82,r_199_141_25,0.95,0,25,25,0
76,r_243_218_82,r_199_141_25,r_135_139_60,r_243_218_82,1.0,0,82,82,0
6,r_80_62_33,r_265_67_148,seq171,r_80_62_33,0.99,0,33,33,0
168,seq205,r_247_85_164,seq208,r_247_85_164,0.89,-85,79,164,0
17,r_244_213_176,seq249,r_252_58_176,r_244_213_176,0.6,0,176,176,0
94,r_269_253_131,r_115_225_137,r_154_53_32,r_154_53_32,1.0,38,70,32,0
32,r_21_174_25,r_75_22_88,seq14,r_21_174_25,0.98,1,26,25,0
96,r_188_72_111,seq120,seq272,r_188_72_111,1.0,0,111,111,0
21,r_79_271_34,seq117,seq14,r_79_271_34,1.0,0,34,34,0
16,r_41_177_52,r_188_72_111,r_59_43_44,r_188_72_111,1.0,-58,53,111,0
22,r_250_26_158,seq192,r_80_62_33,r_80_62_33,0.84,125,158,33,0
62,r_291_92_183,r_235_144_195,r_115_225_137,r_291_92_183,0.7,0,183,183,0
49,r_242_95_121,r_118_127_152,seq51,r_242_95_121,0.79,1,122,121,0
72,r_165_288_179,r_61_170_7,r_115_225_137,r_165_288_179,0.67,0,179,179,0
140,seq121,r_27_105_70,seq51,r_27_105_70,1.0,-4,66,70,0
7,r_31_146_161,seq19,r_90_76_138,r_31_146_161,0.7,0,161,161,0
131,seq103,r_209_99_169,r_203_168_90,r_203_168_90,0.99,79,169,90,0
23,r_284_183_148,r_113_161_172,r_80_62_33,r_284_183_148,0.67,0,148,148,0
94,r_269_253_131,r_154_53_32,r_24_262_13,r_269_253_131,1.0,0,131,131,0
79,r_207_257_138,seq65,r_23_54_38,r_207_257_138,0.92,0,138,138,0
35,r_259_100_84,seq3,r_23_54_38,r_259_100_84,0.99,0,84,84,0
12,r_108_142_94,r_227_181_112,r_46_260_38,r_108_142_94,0.66,1,95,94,0
48,r_204_285_51,r_74_198_165,r_138_10_34,r_204_285_51,1.0,0,51,51,0
72,r_165_288_179,r_108_142_94,r_61_170_7,r_165_288_179,0.79,-155,24,179,0
84,r_27_105_70,seq121,seq258,r_27_105_70,0.99,-2,68,70,0
93,r_85_34_94,r_266_0_133,r_186_54_13,r_85_34_94,1.0,0,94,94,1
30,r_141_285_81,r_40_156_197,r_87_241_68,r_141_285_81,1.0,0,81,81,1
51,r_290_246_65,r_165_172_127,seq99,r_290_246_65,1.0,0,65,65,1
75,r_135_233_56,r_7_158_95,seq252,r_135_233_56,1.0,-1,55,56,1
53,r_133_2_142,seq220,seq294,r_133_2_142,0.98,0,142,142,1
43,r_296_279_181,seq134,seq218,r_296_279_181,0.49,0,181,181,1
197,seq294,seq74,r_133_2_142,r_133_2_142,1.0,45,187,142,1
3,r_105_153_26,r_31_32_26,seq15,r_105_153_26,1.0,0,26,26,1
54,r_159_281_130,r_192_239_122,r_257_185_67,r_192_239_122,0.67,18,140,122,1
37,r_7_158_95,seq18,r_105_153_26,r_7_158_95,1.0,0,95,95,1
157,seq150,r_73_154_32,seq295,r_73_154_32,1.0,3,35,32,1
71,r_64_24_148,r_92_25_47,r_238_113_3,r_64_24_148,0.52,0,148,148,1
5,r_163_126_22,r_165_172_127,seq208,r_163_126_22,0.79,0,22,22,1
16,r_257_185_67,r_118_103_161,r_80_258_67,r_80_258_67,0.79,0,67,67,1
21,r_49_242_118,r_165_172_127,seq188,r_49_242_118,0.93,4,122,118,1
165,seq173,r_142_240_55,r_192_239_122,r_142_240_55,0.59,14,69,55,1
1,r_165_172_127,seq287,r_174_274_199,r_165_172_127,1.0,1,128,127,1
97,r_3_262_188,seq145,r_249_89_40,r_249_89_40,0.55,148,188,40,1
46,r_250_270_132,seq14,r_251_229_96,r_250_270_132,0.95,0,132,132,1
42,r_190_33_78,r_230_112_165,seq196,r_190_33_78,1.0,1,79,78,1
64,r_92_25_47,seq122,r_142_240_55,r_92_25_47,0.83,2,49,47,1
80,r_87_241_68,r_293_211_197,seq226,r_87_241_68,1.0,0,68,68,1
45,r_100_61_128,r_171_88_142,r_49_242_118,r_100_61_128,1.0,0,128,128,1
19,r_259_205_129,seq15,r_163_126_22,r_259_205_129,0.59,0,129,129,1
9,r_213_222_52,seq81,r_166_255_44,r_166_255_44,0.68,4,48,44,1
39,r_235_119_19,r_256_203_97,seq129,r_235_119_19,0.89,0,19,19,1
95,r_263_184_85,r_3_262_188,r_21_101_75,r_263_184_85,0.73,-4,81,85,1
76,r_157_65_190,seq237,r_21_101_75,r_21_101_75,1.0,5,80,75,1
38,r_66_152_15,r_244_231_106,seq218,r_244_231_106,1.0,0,106,106,1
14,r_147_216_49,r_179_60_41,seq55,r_147_216_49,1.0,0,49,49,1
67,r_106_214_137,r_111_29_137,seq14,r_106_214_137,0.95,0,137,137,1
47,r_31_32_26,r_105_153_26,seq17,r_105_153_26,0.88,-3,23,26,1
86,r_206_284_44,r_166_255_44,seq295,r_206_284_44,1.0,0,44,44,1
89,r_228_254_161,r_175_78_179,r_250_270_132,r_175_78_179,0.78,-18,161,179,1
23,r_249_89_40,r_142_240_55,seq226,r_249_89_40,0.6,0,40,40,1
10,r_248_176_141,r_238_113_3,r_8_181_19,r_238_113_3,0.7,138,141,3,1
90,r_180_58_113,r_100_61_128,r_105_153_26,r_180_58_113,1.0,3,116,113,1
26,r_225_59_76,seq232,r_253_114_164,r_225_59_76,1.0,0,76,76,1
38,r_66_152_15,seq218,r_26_164_131,r_26_164_131,1.0,5,136,131,1
143,seq122,r_225_59_76,r_124_199_38,r_225_59_76,1.0,-43,33,76,1
4,r_256_203_97,seq137,seq107,r_256_203_97,1.0,0,97,97,1
0,r_148_288_102,r_296_279_181,r_105_153_26,r_148_288_102,0.99,0,102,102,1
63,r_298_201_65,seq260,r_163_126_22,r_298_201_65,1.0,0,65,65,1
73,r_131_50_159,seq139,seq67,r_131_50_159,0.89,0,159,159,1
11,r_202_177_148,seq129,seq5,r_202_177_148,0.9,0,148,148,1
20,r_138_243_173,r_171_88_142,r_148_288_102,r_148_288_102,0.98,72,174,102,1
98,r_268_195_89,r_47_53_114,seq41,r_268_195_89,1.0,0,89,89,1
15,r_175_78_179,r_228_254_161,seq150,r_228_254_161,0.71,0,161,161,1
49,r_253_114_164,r_225_59_76,r_49_242_118,r_225_59_76,0.51,88,164,76,1
57,r_244_231_106,seq218,r_13_221_186,r_244_231_106,1.0,0,106,106,1
181,seq232,r_225_59_76,r_170_27_66,r_225_59_76,0.99,0,76,76,1
74,r_21_101_75,r_157_65_190,r_108_90_114,r_108_90_114,0.91,29,143,114,1
99,r_111_29_137,r_106_214_137,r_238_113_3,r_111_29_137,1.0,0,137,137,1
8,r_183_68_36,r_190_33_78,seq132,r_183_68_36,0.99,0,36,36,1
136,seq99,r_230_112_165,r_290_246_65,r_290_246_65,1.0,28,93,65,1
87,r_251_229_96,seq18,r_250_270_132,r_250_270_132,0.97,18,150,132,1
2,r_118_103_161,r_13_221_186,seq81,r_118_103_161,0.89,0,161,161,1
74,r_21_101_75,r_106_214_137,r_157_65_190,r_21_101_75,1.0,0,75,75,1
18,r_170_27_66,seq140,seq232,r_170_27_66,0.92,1,67,66,1
24,r_35_276_172,r_182_269_181,r_170_27_66,r_35_276_172,0.6,0,172,172,1
127,seq83,r_277_189_68,seq4,r_277_189_68,1.0,-3,65,68,1
31,r_142_240_55,seq173,r_92_25_47,r_142_240_55,0.91,-6,49,55,1
13,r_8_181_19,r_266_0_133,seq291,r_8_181_19,0.97,0,19,19,1
68,r_215_36_27,seq191,r_235_119_19,r_215_36_27,1.0,0,27,27,1
88,r_28_209_96,seq278,r_87_241_68,r_28_209_96,1.0,1,97,96,1
156,seq145,r_3_262_188,r_104_117_163,r_104_117_163,0.91,25,188,163,1
58,r_104_117_163,seq110,seq245,r_104_117_163,0.78,0,163,163,1
65,r_136_12_125,r_47_53_114,r_46_198_36,r_136_12_125,0.93,0,125,125,1
155,seq143,r_131_50_159,r_80_258_67,r_80_258_67,1.0,79,146,67,1
61,r_273_6_162,seq129,r_163_126_22,r_163_126_22,0.53,140,162,22,1
32,r_266_0_133,seq252,r_163_126_22,r_266_0_133,0.91,1,134,133,1
77,r_297_62_88,seq17,seq39,r_297_62_88,0.99,0,88,88,1
76,r_157_65_190,r_21_101_75,r_213_222_52,r_213_222_52,0.58,138,190,52,1
169,seq196,seq294,r_190_33_78,r_190_33_78,1.0,15,93,78,1
36,r_73_154_32,seq150,seq123,r_73_154_32,1.0,1,33,32,1
34,r_186_54_13,r_170_27_66,r_1_57_9,r_186_54_13,0.91,0,13,13,1
66,r_38_20_51,r_197_11_179,r_183_68_36,r_38_20_51,0.87,0,51,51,1
154,seq140,r_170_27_66,seq143,r_170_27_66,0.86,-3,63,66,1
62,r_166_255_44,r_64_24_148,seq110,r_166_255_44,1.0,0,44,44,1
60,r_182_269_181,seq107,r_66_152_15,r_66_152_15,0.74,170,185,15,1
185,seq252,r_266_0_133,r_135_233_56,r_135_233_56,0.96,-1,55,56,1
17,r_204_149_73,seq86,seq94,r_204_149_73,1.0,0,73,73,1
94,r_238_113_3,r_248_176_141,r_111_29_137,r_238_113_3,0.97,138,141,3,1
59,r_46_198_36,seq132,seq160,r_46_198_36,1.0,-1,35,36,1
26,r_225_59_76,r_253_114_164,r_204_149_73,r_253_114_164,0.74,0,164,164,1
91,r_51_194_25,r_40_156_197,seq208,r_51_194_25,1.0,0,25,25,1
96,r_108_90_114,r_289_75_188,r_21_101_75,r_289_75_188,1.0,-74,114,188,1
38,r_66_152_15,r_133_2_142,r_244_231_106,r_66_152_15,0.83,0,15,15,1
198,seq295,r_175_78_179,r_206_284_44,r_206_284_44,1.0,1,45,44,1
49,r_253_114_164,seq237,r_225_59_76,r_225_59_76,1.0,2,78,76,1
41,r_272_261_29,seq295,seq130,r_272_261_29,1.0,0,29,29,1
56,r_26_164_131,r_106_214_137,r_66_152_15,r_26_164_131,0.88,0,131,131,1
7,r_80_258_67,r_165_172_127,seq143,r_80_258_67,0.93,0,67,67,1
175,seq218,r_244_231_106,seq41,r_244_231_106,1.0,-35,71,106,1
40,r_162_265_27,r_259_205_129,seq264,r_162_265_27,0.64,0,27,27,1
27,r_72_227_39,seq42,r_144_210_25,r_72_227_39,1.0,0,39,39,1
15,r_175_78_179,seq150,seq44,r_175_78_179,0.89,0,179,179,1
101,seq5,r_247_45_52,r_202_177_148,r_202_177_148,0.99,11,159,148,1
35,r_79_271_117,r_230_112_165,r_31_32_26,r_79_271_117,0.8,0,117,117,1
12,r_192_239_122,r_159_281_130,seq173,r_159_281_130,0.63,10,140,130,1
84,r_277_189_68,seq83,seq16,r_277_189_68,1.0,1,69,68,1
93,r_155_266_176,seq231,r_17_74_1,r_155_266_176,0.67,0,176,176,2
51,r_50_56_70,r_75_172_117,r_59_206_27,r_50_56_70,0.83,0,70,70,2
36,r_265_183_163,r_158_287_187,seq29,r_265_183_163,0.37,3,166,163,2
63,r_53_260_46,seq60,seq264,r_53_260_46,0.82,2,48,46,2
95,r_188_187_40,r_285_119_164,seq149,r_188_187_40,0.86,7,47,40,2
14,r_97_238_104,r_280_298_152,r_156_291_43,r_280_298_152,0.63,-48,104,152,2
53,r_186_102_78,r_42_246_115,seq276,r_186_102_78,0.95,0,78,78,2
37,r_297_284_23,r_106_57_118,seq52,r_297_284_23,0.83,1,24,23,2
60,r_196_40_42,r_286_136_134,seq7,r_196_40_42,1.0,7,49,42,2
15,r_229_208_35,r_282_4_174,seq184,r_229_208_35,0.67,0,35,35,2
59,r_233_132_98,seq23,seq70,r_233_132_98,0.96,0,98,98,2
81,r_15_100_16,seq113,seq166,r_15_100_16,0.84,1,17,16,2
73,r_282_4_174,r_229_208_35,seq159,r_282_4_174,0.52,-123,51,174,2
71,r_27_14_76,seq81,r_89_84_74,r_27_14_76,0.64,15,91,76,2
86,r_107_162_3,r_30_115_115,r_235_174_5,r_107_162_3,0.6,117,120,3,2
16,r_13_62_112,r_30_115_115,seq9,r_13_62_112,0.85,0,112,112,2
21,r_220_64_114,seq237,seq68,r_220_64_114,0.68,3,117,114,2
39,r_33_213_118,seq159,seq232,r_33_213_118,0.53,2,120,118,2
5,r_173_71_44,seq154,r_196_40_42,r_173_71_44,0.96,18,62,44,2
80,r_286_136_134,seq228,r_0_283_15,r_286_136_134,0.81,7,141,134,2
45,r_218_209_170,seq80,r_147_192_18,r_147_192_18,0.87,153,171,18,2
92,r_110_19_86,r_138_224_47,r_156_291_43,r_110_19_86,1.0,-39,47,86,2
89,r_259_24_177,r_261_69_94,r_42_246_115,r_259_24_177,0.81,1,178,177,2
70,r_156_291_43,r_173_71_44,seq85,r_156_291_43,1.0,0,43,43,2
153,seq159,r_33_213_118,r_30_115_115,r_30_115_115,0.75,5,120,115,2
66,r_45_41_122,r_211_216_130,seq154,r_45_41_122,0.52,1,123,122,2
33,r_54_169_33,r_259_24_177,seq11,r_54_169_33,0.85,0,33,33,2
31,r_32_171_72,r_211_216_130,seq281,r_32_171_72,1.0,0,72,72,2
3,r_92_214_54,r_36_258_68,seq85,r_92_214_54,1.0,1,55,54,2
89,r_259_24_177,seq7,r_261_69_94,r_261_69_94,0.98,23,117,94,2
10,r_227_38_135,seq11,seq83,r_227_38_135,0.87,1,136,135,2
90,r_245_67_190,seq105,r_13_62_112,r_245_67_190,0.17,0,190,190,2
4,r_226_253_107,r_191_167_169,seq168,r_226_253_107,0.89,1,108,107,2
78,r_211_216_130,r_155_266_176,r_111_194_24,r_155_266_176,0.69,-45,131,176,2
0,r_43_3_71,seq85,seq52,r_43_3_71,1.0,0,71,71,2
56,r_191_167_169,r_138_224_47,r_111_194_24,r_111_194_24,0.57,148,172,24,2
48,r_1_179_175,seq175,r_13_62_112,r_1_179_175,0.29,7,182,175,2
106,seq23,r_233_132_98,seq230,r_233_132_98,0.93,0,98,98,2
12,r_59_206_27,r_280_298_152,r_30_115_115,r_30_115_115,0.61,40,155,115,2
117,seq70,r_112_288_141,r_233_132_98,r_233_132_98,0.57,7,105,98,2
6,r_261_69_94,seq149,r_79_35_37,r_261_69_94,0.94,4,98,94,2
62,r_55_58_108,r_48_170_91,r_44_66_104,r_55_58_108,0.95,-13,95,108,2
85,r_90_91_125,r_218_209_170,seq153,r_90_91_125,0.76,2,127,125,2
51,r_50_56_70,r_59_206_27,r_104_109_98,r_104_109_98,0.54,16,114,98,2
99,r_123_289_86,seq296,r_223_256_36,r_123_289_86,0.85,1,87,86,2
68,r_223_256_36,seq130,seq108,r_223_256_36,0.99,0,36,36,2
27,r_44_66_104,r_18_47_174,r_55_58_108,r_44_66_104,0.96,1,105,104,2
12,r_59_206_27,r_261_69_94,r_280_298_152,r_59_206_27,0.84,1,28,27,2
25,r_79_35_37,r_33_213_118,r_173_71_44,r_79_35_37,0.97,1,38,37,2
87,r_75_172_117,seq7,seq29,r_75_172_117,0.78,12,129,117,2
178,seq230,r_207_243_116,seq23,r_207_243_116,1.0,-18,98,116,2
76,r_271_61_27,r_129_151_194,seq232,r_271_61_27,0.88,0,27,27,2
2,r_262_121_153,seq135,r_128_295_127,r_262_121_153,0.93,0,153,153,2
47,r_48_170_91,r_55_58_108,r_201_268_27,r_48_170_91,0.63,4,95,91,2
40,r_18_47_174,seq68,r_233_132_98,r_233_132_98,0.7,79,177,98,2
29,r_138_224_47,r_110_19_86,r_191_167_169,r_138_224_47,1.0,0,47,47,2
74,r_165_72_121,r_73_163_147,r_98_93_128,r_165_72_121,0.87,8,129,121,2
18,r_98_93_128,r_18_47_174,r_165_72_121,r_98_93_128,0.85,1,129,128,2
24,r_137_185_166,seq221,r_21_197_166,r_137_185_166,0.36,0,166,166,2
64,r_274_49_166,seq63,r_30_115_115,r_274_49_166,0.44,1,167,166,2
88,r_280_298_152,r_73_163_147,r_220_64_114,r_280_298_152,0.65,-1,151,152,2
11,r_147_192_18,r_1_179_175,seq94,r_147_192_18,0.97,-1,17,18,2
50,r_267_133_162,seq37,seq77,r_267_133_162,0.94,0,162,162,2
79,r_247_140_38,r_43_3_71,r_0_283_15,r_0_283_15,0.91,23,38,15,2
77,r_157_139_58,r_55_58_108,r_39_242_55,r_157_139_58,0.92,1,59,58,2
65,r_106_57_118,r_65_198_182,r_111_194_24,r_65_198_182,0.74,-60,122,182,2
61,r_148_141_113,seq166,r_53_260_46,r_148_141_113,0.75,7,120,113,2
32,r_145_252_130,seq221,r_223_256_36,r_145_252_130,0.78,1,131,130,2
38,r_10_16_74,r_227_38_135,r_297_284_23,r_10_16_74,0.6,1,75,74,2
52,r_36_258_68,seq248,seq52,r_36_258_68,0.96,2,70,68,2
34,r_195_299_74,r_112_288_141,r_53_260_46,r_195_299_74,0.96,0,74,74,2
13,r_201_268_27,seq178,seq130,r_201_268_27,0.89,0,27,27,2
75,r_73_163_147,r_280_298_152,seq228,r_73_163_147,0.66,4,151,147,2
30,r_277_78_30,r_21_197_166,seq281,r_277_78_30,0.88,2,32,30,2
25,r_79_35_37,r_173_71_44,r_261_69_94,r_261_69_94,0.93,16,110,94,2
94,r_204_144_110,seq200,seq202,r_204_144_110,0.75,0,110,110,2
1,r_111_194_24,r_285_119_164,seq149,r_111_194_24,0.92,-3,21,24,2
9,r_65_198_182,seq101,r_145_252_130,r_145_252_130,0.77,53,183,130,2
96,r_46_270_98,r_182_125_134,r_225_8_8,r_46_270_98,0.89,0,98,98,2
58,r_181_2_32,r_27_14_76,r_65_198_182,r_181_2_32,0.95,3,35,32,2
56,r_191_167_169,r_226_253_107,r_138_224_47,r_138_224_47,1.0,1,48,47,2
29,r_138_224_47,r_191_167_169,r_137_185_166,r_137_185_166,0.79,6,172,166,2
22,r_182_125_134,seq273,seq105,r_182_125_134,0.6,9,143,134,2
73,r_282_4_174,seq159,r_44_66_104,r_44_66_104,0.54,70,174,104,2
91,r_217_275_91,seq234,seq51,r_217_275_91,1.0,0,91,91,2
7,r_30_115_115,r_13_62_112,seq189,r_30_115_115,0.84,-3,112,115,2
44,r_269_239_73,seq77,r_173_71_44,r_269_239_73,1.0,0,73,73,2
41,r_99_254_53,seq108,seq113,r_99_254_53,0.98,0,53,53,2
23,r_112_288_141,seq202,seq237,r_112_288_141,0.6,0,141,141,2
138,seq122,r_39_242_55,r_235_174_5,r_39_242_55,0.62,5,60,55,2
82,r_126_203_69,r_21_197_166,seq178,r_126_203_69,0.96,0,69,69,2
35,r_128_295_127,seq153,r_262_121_153,r_262_121_153,0.48,1,154,153,2
84,r_39_242_55,seq122,r_157_139_58,r_39_242_55,0.96,5,60,55,2
93,r_90_189_81,r_70_8_109,r_101_241_52,r_90_189_81,0.97,0,81,81,3
139,seq120,r_39_240_49,r_190_124_46,r_190_124_46,1.0,-1,45,46,3
51,r_68_23_157,seq148,seq54,r_68_23_157,0.51,0,157,157,3
36,r_70_8_109,seq150,seq63,r_70_8_109,0.59,0,109,109,3
92,r_100_71_151,r_94_285_194,r_30_293_33,r_94_285_194,0.69,-43,151,194,3
14,r_284_58_110,r_55_44_174,r_236_147_28,r_55_44_174,0.81,-64,110,174,3
8,r_237_113_149,seq37,r_46_184_71,r_46_184_71,1.0,78,149,71,3
53,r_138_84_72,r_242_203_79,seq163,r_138_84_72,1.0,-1,71,72,3
7,r_132_158_32,r_101_241_52,r_60_213_32,r_101_241_52,0.57,-21,31,52,3
125,seq73,r_2_232_162,seq210,r_2_232_162,1.0,-1,161,162,3
83,r_265_233_185,seq264,r_111_116_134,r_111_116_134,0.64,51,185,134,3
50,r_254_297_8,seq177,r_282_172_45,r_282_172_45,1.0,1,46,45,3
55,r_55_44_174,r_170_24_88,r_152_176_76,r_152_176_76,1.0,0,76,76,3
71,r_15_226_93,seq248,seq195,r_15_226_93,0.93,-5,88,93,3
21,r_0_106_178,seq187,r_205_56_125,r_0_106_178,0.51,0,178,178,3
39,r_107_174_86,r_94_285_194,seq187,r_107_174_86,1.0,-1,85,86,3
1,r_292_98_133,r_257_155_188,r_99_281_32,r_292_98_133,1.0,0,133,133,3
97,r_20_256_86,r_36_185_172,seq150,r_20_256_86,0.9,5,91,86,3
46,r_252_139_179,seq260,r_193_180_49,r_193_180_49,0.97,130,179,49,3
42,r_272_262_105,r_55_44_174,r_149_112_119,r_272_262_105,0.84,5,110,105,3
80,r_280_197_126,seq144,r_101_241_52,r_280_197_126,0.71,0,126,126,3
32,r_201_32_22,r_225_79_183,seq82,r_225_79_183,0.59,-23,160,183,3
38,r_267_299_130,r_225_79_183,r_201_32_22,r_225_79_183,1.0,0,183,183,3
69,r_19_75_77,seq3,r_154_227_54,r_19_75_77,1.0,0,77,77,3
130,seq89,seq41,r_60_213_32,r_60_213_32,1.0,1,33,32,3
13,r_101_241_52,seq43,r_91_48_23,r_101_241_52,1.0,-1,51,52,3
19,r_133_125_98,r_53_5_139,seq146,r_133_125_98,0.96,0,98,98,3
16,r_225_79_183,r_267_299_130,seq6,r_225_79_183,0.85,0,183,183,3
2,r_200_207_57,r_34_105_103,r_249_287_54,r_200_207_57,1.0,0,57,57,3
66,r_119_110_150,seq195,r_170_24_88,r_119_110_150,0.37,2,152,150,3
76,r_65_164_101,seq121,seq83,r_65_164_101,0.92,0,101,101,3
64,r_196_13_17,r_102_239_77,r_267_299_130,r_196_13_17,0.95,0,17,17,3
38,r_267_299_130,r_196_13_17,r_225_79_183,r_267_299_130,0.99,0,130,130,3
99,r_91_48_23,r_242_203_79,seq211,r_91_48_23,0.99,0,23,23,3
41,r_53_5_139,seq66,seq96,r_53_5_139,0.55,0,139,139,3
67,r_122_268_166,seq21,seq208,r_122_268_166,0.71,0,166,166,3
38,r_267_299_130,r_19_75_77,r_196_13_17,r_267_299_130,0.6,-85,45,130,3
89,r_159_286_139,r_2_232_162,r_34_105_103,r_159_286_139,0.97,0,139,139,3
3,r_34_105_103,seq25,r_154_227_54,r_34_105_103,0.94,0,103,103,3
16,r_225_79_183,r_201_32_22,r_267_299_130,r_267_299_130,1.0,4,134,130,3
25,r_154_227_54,r_244_169_130,seq49,r_154_227_54,1.0,0,54,54,3
78,r_17_182_101,seq57,r_196_13_17,r_17_182_101,0.98,0,101,101,3
16,r_225_79_183,r_249_287_54,r_201_32_22,r_201_32_22,0.76,29,51,22,3
114,seq41,r_244_169_130,r_221_141_109,r_244_169_130,0.55,0,130,130,3
73,r_168_222_109,seq25,r_65_164_101,r_168_222_109,1.0,0,109,109,3
20,r_221_141_109,seq25,seq41,r_221_141_109,0.95,0,109,109,3
15,r_170_24_88,r_272_262_105,r_288_33_55,r_288_33_55,1.0,33,88,55,3
48,r_224_228_108,r_2_232_162,r_193_180_49,r_224_228_108,1.0,0,108,108,3
57,r_157_10_169,seq11,seq134,r_157_10_169,0.65,0,169,169,3
199,seq298,r_193_180_49,seq177,r_193_180_49,1.0,-2,47,49,3
62,r_291_250_172,r_170_24_88,r_267_299_130,r_267_299_130,0.93,33,163,130,3
11,r_193_180_49,seq298,seq166,r_193_180_49,1.0,0,49,49,3
87,r_282_172_45,seq6,r_254_297_8,r_282_172_45,1.0,0,45,45,3
10,r_179_183_34,r_205_56_125,seq16,r_205_56_125,0.81,-92,33,125,3
31,r_47_220_48,seq219,seq37,r_47_220_48,0.99,0,48,48,3
45,r_153_261_46,r_191_289_158,seq264,r_153_261_46,1.0,-1,45,46,3
63,r_60_213_32,r_107_174_86,r_132_158_32,r_107_174_86,0.62,-55,31,86,3
27,r_76_186_98,seq274,seq145,r_76_186_98,1.0,-1,97,98,3
72,r_236_147_28,r_292_98_133,r_151_88_112,r_236_147_28,0.85,1,29,28,3
79,r_269_117_24,r_200_207_57,seq219,r_269_117_24,1.0,1,25,24,3
40,r_39_240_49,seq145,r_72_140_63,r_72_140_63,1.0,0,63,63,3
18,r_259_38_158,r_149_112_119,r_30_293_33,r_259_38_158,0.38,1,159,158,3
29,r_270_278_94,seq294,seq175,r_270_278_94,1.0,0,94,94,3
24,r_242_203_79,r_149_112_119,seq290,r_242_203_79,1.0,0,79,79,3
33,r_7_74_163,seq136,seq11,r_7_74_163,0.84,0,163,163,3
191,seq264,r_265_233_185,r_153_261_46,r_153_261_46,1.0,139,185,46,3
88,r_151_88_112,r_149_112_119,r_30_293_33,r_151_88_112,0.53,-2,110,112,3
85,r_188_135_26,seq248,r_109_85_60,r_109_85_60,1.0,92,152,60,3
58,r_52_198_148,seq16,r_190_124_46,r_52_198_148,0.94,0,148,148,3
70,r_2_232_162,seq73,r_196_13_17,r_2_232_162,0.68,0,162,162,3
56,r_18_95_12,r_0_106_178,seq144,r_18_95_12,1.0,0,12,12,3
68,r_86_199_132,r_2_232_162,seq25,r_86_199_132,0.97,0,132,132,3
85,r_188_135_26,r_47_220_48,seq248,r_188_135_26,0.83,-1,25,26,3
52,r_191_289_158,seq82,r_68_23_157,r_191_289_158,0.55,12,170,158,3
77,r_28_114_116,seq96,r_99_281_32,r_28_114_116,1.0,0,116,116,3
64,r_196_13_17,r_267_299_130,r_17_182_101,r_196_13_17,0.97,84,101,17,3
4,r_249_287_54,r_225_79_183,r_200_207_57,r_200_207_57,0.59,0,57,57,3
60,r_143_51_109,seq258,r_101_241_52,r_143_51_109,0.98,0,109,109,3
81,r_276_77_91,r_17_182_101,r_254_297_8,r_17_182_101,0.9,-17,84,101,3
17,r_152_176_76,r_2_232_162,r_102_239_77,r_152_176_76,0.99,1,77,76,3
119,seq54,r_128_69_154,seq92,r_128_69_154,0.99,1,155,154,3
26,r_244_169_130,r_154_227_54,r_60_213_32,r_244_169_130,0.97,-97,33,130,3
94,r_46_184_71,r_292_98_133,seq177,r_292_98_133,0.87,-64,69,133,3
9,r_102_239_77,seq6,r_152_176_76,r_102_239_77,1.0,0,77,77,3
26,r_244_169_130,r_60_213_32,r_170_24_88,r_244_169_130,0.92,0,130,130,3
96,r_273_35_123,seq271,r_270_278_94,r_273_35_123,0.86,0,123,123,3
22,r_109_85_60,r_244_169_130,r_18_95_12,r_109_85_60,0.82,0,60,60,3
95,r_288_33_55,r_133_125_98,r_149_112_119,r_288_33_55,0.96,0,55,55,3
75,r_30_293_33,r_137_206_179,seq64,r_30_293_33,0.82,-4,29,33,3
91,r_283_263_190,seq144,r_47_220_48,r_47_220_48,1.0,142,190,48,3
72,r_236_147_28,r_151_88_112,r_284_58_110,r_236_147_28,0.86,88,116,28,3
140,seq121,r_65_164_101,seq218,r_65_164_101,1.0,-29,72,101,3
185,seq248,r_15_226_93,r_109_85_60,r_109_85_60,0.89,16,76,60,3
44,r_59_40_125,r_257_155_188,seq219,r_59_40_125,0.91,0,125,125,3
32,r_201_32_22,r_111_116_134,r_225_79_183,r_201_32_22,0.99,1,23,22,3
23,r_111_116_134,r_157_10_169,seq82,r_111_116_134,0.96,1,135,134,3
84,r_190_124_46,r_224_228_108,seq120,r_190_124_46,0.97,-1,45,46,3
82,r_296_126_190,seq4,r_111_116_134,r_111_116_134,0.9,56,190,134,3
35,r_72_140_63,r_2_232_162,r_39_240_49,r_72_140_63,0.98,0,63,63,3
158,seq171,r_70_8_109,r_276_77_91,r_70_8_109,0.46,-54,55,109,3
12,r_205_56_125,r_119_110_150,seq66,r_205_56_125,0.95,0,125,125,3
194,seq274,r_76_186_98,seq215,r_76_186_98,1.0,-43,55,98,3
182,seq245,r_280_197_126,seq167,r_280_197_126,1.0,-18,108,126,3
128,seq82,r_191_289_158,seq215,r_191_289_158,0.72,12,170,158,3
55,r_55_44_174,r_152_176_76,r_137_206_179,r_55_44_174,0.33,6,180,174,3
93,r_239_278_110,seq226,r_191_56_62,r_239_278_110,1.0,0,110,110,4
51,r_233_109_114,r_202_250_159,r_143_18_21,r_233_109_114,0.87,3,117,114,4
36,r_131_245_158,seq210,r_262_110_5,r_131_245_158,0.53,3,161,158,4
101,seq1,r_4_25_168,r_237_224_108,r_237_224_108,0.86,1,109,108,4
95,r_121_76_41,r_27_107_76,r_203_41_187,r_121_76_41,0.63,0,41,41,4
14,r_78_103_100,seq67,r_191_56_62,r_78_103_100,0.98,1,101,100,4
8,r_294_90_147,seq0,r_182_197_101,r_294_90_147,0.88,3,150,147,4
53,r_246_297_62,seq157,r_203_41_187,r_203_41_187,0.47,-123,64,187,4
54,r_66_139_155,r_203_41_187,r_28_207_1,r_66_139_155,0.81,0,155,155,4
83,r_32_204_126,seq81,r_273_295_115,r_32_204_126,0.99,0,126,126,4
22,r_42_91_52,r_271_62_61,r_21_38_14,r_42_91_52,0.77,0,52,52,4
116,seq61,r_4_25_168,r_237_224_108,r_237_224_108,0.87,31,139,108,4
163,seq189,seq57,r_259_253_41,r_259_253_41,0.84,7,48,41,4
55,r_267_51_102,seq174,r_129_272_22,r_267_51_102,0.98,1,103,102,4
86,r_198_214_113,seq30,seq252,r_198_214_113,0.69,0,113,113,4
16,r_60_97_165,seq94,r_27_107_76,r_27_107_76,0.95,89,165,76,4
21,r_268_260_102,seq0,r_269_200_108,r_269_200_108,1.0,2,110,108,4
39,r_82_152_66,r_15_29_69,seq210,r_82_152_66,1.0,0,66,66,4
46,r_185_173_139,seq48,r_42_91_52,r_185_173_139,0.97,0,139,139,4
80,r_77_249_143,seq116,r_26_140_79,r_77_249_143,0.92,0,143,143,4
35,r_88_22_27,r_125_187_189,seq184,r_88_22_27,0.99,0,27,27,4
69,r_285_118_144,seq222,r_191_56_62,r_285_118_144,0.69,0,144,144,4
95,r_121_76_41,r_203_41_187,r_55_14_69,r_55_14_69,0.98,9,78,69,4
76,r_144_234_75,r_195_244_97,r_5_156_30,r_144_234_75,1.0,0,75,75,4
31,r_27_107_76,seq130,r_77_249_143,r_27_107_76,1.0,0,76,76,4
67,r_183_135_185,r_28_207_1,r_251_120_129,r_28_207_1,0.46,184,185,1,4
89,r_217_70_65,r_199_293_158,r_72_215_28,r_217_70_65,1.0,0,65,65,4
72,r_19_83_27,r_85_247_57,r_286_150_12,r_19_83_27,0.95,0,27,27,4
1,r_31_50_33,seq115,seq282,r_31_50_33,0.98,0,33,33,4
10,r_199_293_158,seq270,r_55_14_69,r_55_14_69,0.83,92,161,69,4
179,seq248,r_125_187_189,r_191_56_62,r_191_56_62,1.0,127,189,62,4
78,r_71_229_60,seq45,r_21_38_14,r_71_229_60,0.99,1,61,60,4
0,r_256_123_103,r_72_215_28,seq115,r_256_123_103,1.0,0,103,103,4
11,r_114_127_117,seq112,r_205_86_55,r_114_127_117,0.93,0,117,117,4
12,r_143_18_21,r_294_90_147,r_7_73_79,r_143_18_21,0.99,0,21,21,4
88,r_286_150_12,r_294_90_147,r_72_215_28,r_286_150_12,0.96,0,12,12,4
13,r_93_141_158,r_3_80_195,seq13,r_93_141_158,0.6,0,158,158,4
98,r_129_272_22,r_233_109_114,seq44,r_129_272_22,0.99,1,23,22,4
48,r_9_179_177,seq276,r_256_123_103,r_256_123_103,1.0,75,178,103,4
101,seq1,r_133_24_39,r_4_25_168,r_133_24_39,1.0,0,39,39,4
57,r_203_41_187,r_66_139_155,r_246_297_62,r_203_41_187,0.71,-110,77,187,4
106,seq37,r_205_86_55,r_12_287_97,r_12_287_97,1.0,12,109,97,4
20,r_196_212_24,r_114_127_117,seq0,r_196_212_24,1.0,0,24,24,4
181,seq254,seq157,r_55_14_69,r_55_14_69,1.0,2,71,69,4
167,seq210,r_131_245_158,r_82_152_66,r_82_152_66,1.0,69,135,66,4
30,r_5_156_30,r_126_10_189,seq117,r_5_156_30,1.0,1,31,30,4
6,r_191_56_62,seq30,seq248,r_191_56_62,0.97,0,62,62,4
62,r_269_200_108,r_32_204_126,r_268_260_102,r_268_260_102,0.99,6,108,102,4
85,r_230_36_92,seq119,r_160_227_1,r_230_36_92,0.65,3,95,92,4
99,r_275_69_159,r_4_25_168,r_230_36_92,r_275_69_159,0.39,0,159,159,4
27,r_59_193_46,r_268_260_102,seq30,r_59_193_46,1.0,1,47,46,4
53,r_246_297_62,r_203_41_187,r_199_293_158,r_246_297_62,0.55,126,188,62,4
19,r_176_292_38,r_268_260_102,seq40,r_176_292_38,1.0,0,38,38,4
47,r_146_49_85,r_202_250_159,seq164,r_146_49_85,1.0,0,85,85,4
74,r_106_134_154,seq283,r_143_18_21,r_106_134_154,0.82,0,154,154,4
18,r_4_25_168,seq61,r_237_224_108,r_237_224_108,1.0,3,111,108,4
24,r_153_34_62,r_60_97_165,r_160_227_1,r_153_34_62,0.97,2,64,62,4
177,seq242,r_7_73_79,r_195_244_97,r_7_73_79,0.95,-3,76,79,4
25,r_181_11_3,r_114_127_117,r_96_8_55,r_96_8_55,0.89,20,75,55,4
33,r_194_165_126,r_199_293_158,r_256_123_103,r_194_165_126,0.69,0,126,126,4
64,r_15_29_69,seq184,seq45,r_15_29_69,1.0,1,70,69,4
191,seq277,r_126_10_189,r_68_124_41,r_68_124_41,0.97,148,189,41,4
190,seq276,r_9_179_177,r_101_216_16,r_101_216_16,0.79,162,178,16,4
50,r_166_33_147,seq119,r_27_107_76,r_166_33_147,0.69,2,149,147,4
65,r_35_92_111,seq281,seq232,r_35_92_111,0.93,0,111,111,4
29,r_96_8_55,seq157,r_181_11_3,r_96_8_55,1.0,1,56,55,4
12,r_143_18_21,r_7_73_79,r_195_244_97,r_7_73_79,1.0,0,79,79,4
61,r_211_291_182,seq43,r_42_91_52,r_42_91_52,0.53,130,182,52,4
32,r_98_236_78,r_78_103_100,seq213,r_98_236_78,1.0,0,78,78,4
63,r_21_38_14,seq57,r_126_10_189,r_21_38_14,0.94,0,14,14,4
38,r_192_104_73,seq65,seq148,r_192_104_73,0.98,0,73,73,4
77,r_126_10_189,seq277,r_101_216_16,r_101_216_16,0.9,173,189,16,4
57,r_203_41_187,r_246_297_62,r_88_22_27,r_246_297_62,0.58,125,187,62,4
73,r_85_247_57,seq188,r_105_228_193,r_85_247_57,0.67,1,58,57,4
34,r_68_124_41,r_199_293_158,seq108,r_68_124_41,1.0,0,41,41,4
75,r_7_73_79,r_58_206_57,r_143_18_21,r_7_73_79,0.76,-15,64,79,4
60,r_169_17_89,r_183_135_185,r_31_50_33,r_169_17_89,0.9,0,89,89,4
41,r_298_54_43,seq115,seq281,r_298_54_43,1.0,0,43,43,4
81,r_237_224_108,seq0,seq1,r_237_224_108,0.97,0,108,108,4
12,r_143_18_21,r_195_244_97,r_233_109_114,r_233_109_114,1.0,8,122,114,4
18,r_4_25_168,r_237_224_108,seq178,r_4_25_168,0.99,0,168,168,4
17,r_195_244_97,r_144_234_75,seq242,r_144_234_75,0.82,0,75,75,4
73,r_85_247_57,r_105_228_193,r_7_73_79,r_7_73_79,0.98,10,89,79,4
94,r_55_14_69,seq282,r_121_76_41,r_55_14_69,1.0,0,69,69,4
63,r_21_38_14,r_126_10_189,r_71_229_60,r_71_229_60,1.0,16,76,60,4
40,r_75_296_54,r_221_220_154,seq266,r_75_296_54,0.98,0,54,54,4
31,r_27_107_76,r_77_249_143,r_166_33_147,r_27_107_76,1.0,72,148,76,4
28,r_273_295_115,seq48,seq0,r_273_295_115,0.53,4,119,115,4
91,r_12_287_97,seq117,seq37,r_12_287_97,1.0,1,98,97,4
135,seq119,r_230_36_92,r_269_200_108,r_269_200_108,1.0,9,117,108,4
152,seq164,r_180_280_189,r_146_49_85,r_146_49_85,1.0,24,109,85,4
194,seq282,r_55_14_69,r_31_50_33,r_55_14_69,0.87,0,69,69,4
56,r_182_197_101,seq57,seq112,r_182_197_101,0.93,-26,75,101,4
7,r_28_207_1,r_183_135_185,r_66_139_155,r_66_139_155,0.8,30,185,155,4
44,r_100_20_87,r_269_200_108,seq37,r_100_20_87,1.0,0,87,87,4
23,r_58_206_57,r_7_73_79,r_271_62_61,r_58_206_57,1.0,7,64,57,4
82,r_271_62_61,r_42_91_52,seq189,r_271_62_61,1.0,0,61,61,4
96,r_225_265_21,r_31_50_33,seq162,r_225_265_21,0.68,3,24,21,4
79,r_251_120_129,seq178,seq226,r_251_120_129,0.99,0,129,129,4
75,r_7_73_79,r_143_18_21,r_85_247_57,r_7_73_79,0.89,0,79,79,4
42,r_132_238_51,r_114_127_117,seq67,r_132_238_51,1.0,0,51,51,4
84,r_202_250_159,seq117,r_261_151_32,r_202_250_159,0.9,1,160,159,4
30,r_121_242_68,r_269_149_117,seq78,r_121_242_68,1.0,1,69,68,5
36,r_145_125_72,seq191,seq72,r_145_125_72,0.73,3,75,72,5
83,r_199_205_124,seq22,r_21_246_183,r_199_205_124,0.49,-61,63,124,5
51,r_103_282_12,r_252_27_124,seq157,r_103_282_12,0.99,0,12,12,5
59,r_17_57_104,seq177,seq153,r_17_57_104,1.0,0,104,104,5
53,r_70_96_35,seq157,seq287,r_70_96_35,1.0,1,36,35,5
71,r_216_208_189,seq72,r_7_210_130,r_7_210_130,0.66,59,189,130,5
86,r_249_187_192,r_214_238_108,r_188_4_96,r_249_187_192,0.98,-84,108,192,5
39,r_228_104_154,seq248,r_62_209_144,r_228_104_154,0.86,0,154,154,5
95,r_120_154_12,r_280_271_184,seq219,r_120_154_12,0.95,0,12,12,5
143,seq148,r_229_114_107,r_40_32_2,r_229_114_107,0.99,0,107,107,5
5,r_172_87_143,r_195_150_158,r_70_96_35,r_172_87_143,0.9,0,143,143,5
46,r_80_13_74,r_294_264_197,seq295,r_80_13_74,1.0,0,74,74,5
42,r_136_45_122,seq198,seq141,r_136_45_122,0.99,0,122,122,5
69,r_214_238_108,r_249_187_192,r_130_179_78,r_249_187_192,1.0,-84,108,192,5
45,r_260_128_107,seq15,seq78,r_260_128_107,0.95,1,108,107,5
24,r_284_170_146,r_140_174_38,r_145_125_72,r_284_170_146,0.99,0,146,146,5
72,r_18_263_31,r_288_23_133,seq189,r_18_263_31,1.0,0,31,31,5
94,r_197_227_37,r_166_278_84,seq290,r_197_227_37,1.0,0,37,37,5
103,seq6,r_127_293_119,r_299_37_69,r_299_37_69,1.0,53,122,69,5
31,r_127_293_119,seq6,r_31_200_96,r_31_200_96,1.0,26,122,96,5
129,seq110,r_247_186_133,r_269_149_117,r_247_186_133,0.59,0,133,133,5
67,r_178_52_65,seq226,seq224,r_178_52_65,1.0,4,69,65,5
3,r_167_124_112,seq177,seq35,r_167_124_112,1.0,0,112,112,5
10,r_292_244_151,seq42,r_137_69_52,r_137_69_52,1.0,100,152,52,5
90,r_132_58_130,r_28_85_166,seq202,r_132_58_130,0.94,0,130,130,5
26,r_159_176_140,seq266,r_137_69_52,r_159_176_140,0.65,0,140,140,5
180,seq248,r_228_104_154,seq75,r_228_104_154,0.97,0,154,154,5
1,r_137_69_52,seq287,r_135_232_197,r_137_69_52,1.0,0,52,52,5
4,r_144_258_175,seq212,seq206,r_144_258_175,0.63,0,175,175,5
61,r_192_279_38,r_241_19_78,r_222_134_49,r_222_134_49,0.75,-7,42,49,5
0,r_223_239_167,seq12,r_18_263_31,r_223_239_167,0.45,1,168,167,5
63,r_241_19_78,seq8,seq226,r_241_19_78,1.0,0,78,78,5
73,r_162_109_77,r_21_246_183,seq77,r_162_109_77,1.0,0,77,77,5
107,seq15,r_260_128_107,seq141,r_260_128_107,1.0,1,108,107,5
20,r_247_186_133,seq110,seq259,r_247_186_133,0.87,0,133,133,5
13,r_299_37_69,seq76,seq6,r_299_37_69,1.0,0,69,69,5
98,r_229_114_107,seq148,seq53,r_229_114_107,0.96,0,107,107,5
83,r_199_205_124,r_21_246_183,seq5,r_199_205_124,1.0,-2,122,124,5
48,r_66_68_93,r_183_194_110,seq211,r_66_68_93,0.92,0,93,93,5
97,r_230_91_32,r_127_293_119,seq177,r_230_91_32,0.97,1,33,32,5
57,r_98_217_190,r_7_210_130,r_88_105_138,r_7_210_130,0.89,0,130,130,5
117,seq72,r_216_208_189,r_284_170_146,r_284_170_146,1.0,43,189,146,5
167,seq212,r_144_258_175,r_270_171_58,r_270_171_58,1.0,117,175,58,5
6,r_288_23_133,r_184_235_161,r_137_69_52,r_137_69_52,0.95,85,137,52,5
62,r_256_51_139,seq77,seq295,r_256_51_139,0.63,7,146,139,5
99,r_221_71_174,r_240_250_167,r_118_84_102,r_240_250_167,0.6,7,174,167,5
34,r_270_171_58,r_122_10_193,seq211,r_270_171_58,1.0,1,59,58,5
27,r_74_131_168,r_216_208_189,r_2_126_35,r_74_131_168,0.7,5,173,168,5
24,r_284_170_146,r_269_149_117,r_140_174_38,r_284_170_146,0.74,-90,56,146,5
87,r_151_36_98,r_216_208_189,seq281,r_151_36_98,1.0,0,98,98,5
47,r_21_246_183,seq177,r_223_239_167,r_21_246_183,0.43,0,183,183,5
54,r_196_86_41,r_214_238_108,seq11,r_196_86_41,1.0,0,41,41,5
40,r_29_180_113,seq281,r_143_99_8,r_143_99_8,0.62,140,148,8,5
126,seq102,r_184_235_161,r_65_16_59,r_184_235_161,0.63,0,161,161,5
68,r_222_134_49,r_88_105_138,r_192_279_38,r_192_279_38,1.0,14,52,38,5
74,r_269_149_117,r_284_170_146,seq110,r_269_149_117,0.65,0,117,117,5
25,r_62_209_144,seq191,seq110,r_62_209_144,0.61,1,145,144,5
43,r_169_254_34,r_167_124_112,seq141,r_169_254_34,1.0,0,34,34,5
127,seq106,r_60_94_158,r_118_84_102,r_60_94_158,0.83,0,158,158,5
64,r_31_200_96,seq25,r_127_293_119,r_31_200_96,1.0,0,96,96,5
88,r_28_85_166,r_132_58_130,r_140_174_38,r_28_85_166,0.7,-36,130,166,5
58,r_44_142_160,seq220,r_140_174_38,r_140_174_38,0.6,122,160,38,5
70,r_83_90_105,seq78,r_18_263_31,r_83_90_105,0.99,0,105,105,5
85,r_298_291_41,r_167_124_112,r_261_161_19,r_261_161_19,0.56,22,41,19,5
129,seq110,r_269_149_117,r_62_209_144,r_62_209_144,0.99,8,152,144,5
75,r_184_235_161,seq102,r_162_109_77,r_184_235_161,0.81,0,161,161,5
32,r_63_41_53,seq133,seq181,r_63_41_53,1.0,0,53,53,5
60,r_130_179_78,r_66_68_93,r_121_242_68,r_130_179_78,0.49,0,78,78,5
77,r_2_126_35,r_292_244_151,seq101,r_2_126_35,0.91,4,39,35,5
81,r_67_26_145,r_216_208_189,r_18_263_31,r_67_26_145,0.74,0,145,145,5
17,r_65_16_59,r_294_264_197,seq42,r_65_16_59,0.83,14,73,59,5
21,r_283_59_46,seq225,seq54,r_283_59_46,1.0,0,46,46,5
9,r_252_27_124,seq220,seq236,r_252_27_124,0.99,1,125,124,5
96,r_47_93_187,seq182,r_118_84_102,r_118_84_102,0.6,85,187,102,5
66,r_261_161_19,r_252_27_124,seq257,r_261_161_19,0.95,0,19,19,5
29,r_140_174_38,seq175,r_103_282_12,r_140_174_38,0.98,1,39,38,5
133,seq115,seq101,r_268_55_45,r_268_55_45,1.0,49,94,45,5
2,r_146_81_34,r_172_87_143,seq243,r_146_81_34,1.0,0,34,34,5
28,r_7_210_130,r_98_217_190,r_240_250_167,r_7_210_130,0.79,0,130,130,5
91,r_49_56_97,r_292_244_151,seq182,r_49_56_97,0.95,0,97,97,5
88,r_28_85_166,r_140_174_38,r_270_171_58,r_28_85_166,1.0,0,166,166,5
135,seq119,r_231_61_185,r_73_46_22,r_231_61_185,0.85,0,185,185,5
49,r_95_296_143,r_215_272_150,seq251,r_95_296_143,0.92,0,143,143,5
164,seq206,r_215_272_150,r_163_160_110,r_215_272_150,0.81,0,150,150,5
56,r_188_4_96,r_240_250_167,r_249_187_192,r_188_4_96,0.99,0,96,96,5
44,r_166_278_84,seq139,r_64_117_129,r_64_117_129,0.53,37,166,129,5
118,seq75,r_195_150_158,seq148,r_195_150_158,0.7,1,159,158,5
23,r_163_160_110,r_183_194_110,seq206,r_183_194_110,0.99,0,110,110,5
82,r_183_194_110,r_228_104_154,seq198,r_183_194_110,1.0,0,110,110,5
60,r_130_179_78,r_121_242_68,r_214_238_108,r_214_238_108,0.99,8,116,108,5
79,r_34_38_63,seq153,seq204,r_34_38_63,1.0,1,64,63,5
35,r_48_165_145,r_60_94_158,seq25,r_48_165_145,0.81,1,146,145,5
12,r_9_262_137,seq22,seq53,r_9_262_137,0.87,3,140,137,5
7,r_268_55_45,seq5,seq115,r_268_55_45,1.0,0,45,45,5
162,seq202,r_73_46_22,r_132_58_130,r_132_58_130,0.82,0,130,130,5
84,r_215_272_150,seq206,r_169_254_34,r_215_272_150,0.78,0,150,150,5
93,r_229_43_108,seq69,seq57,r_229_43_108,0.87,1,109,108,6
30,r_72_59_189,seq213,r_161_37_103,r_161_37_103,1.0,86,189,103,6
44,r_276_291_74,r_186_123_145,r_161_37_103,r_186_123_145,0.55,-3,142,145,6
36,r_110_73_106,r_119_151_157,seq207,r_110_73_106,0.92,1,107,106,6
8,r_131_118_129,r_275_168_133,r_87_193_91,r_275_168_133,0.96,-3,130,133,6
53,r_175_82_115,r_33_190_190,r_218_125_3,r_175_82_115,0.85,-1,114,115,6
146,seq147,seq109,r_34_295_42,r_34_295_42,1.0,47,89,42,6
37,r_58_153_61,r_254_143_185,seq20,r_58_153_61,0.9,0,61,61,6
10,r_192_38_30,seq54,seq90,r_192_38_30,1.0,0,30,30,6
71,r_256_133_76,r_158_50_87,r_12_97_46,r_256_133_76,0.57,0,76,76,6
16,r_202_42_174,seq206,r_12_97_46,r_12_97_46,1.0,129,175,46,6
1,r_275_168_133,r_131_118_129,seq26,r_275_168_133,0.68,0,133,133,6
97,r_119_151_157,seq41,r_282_244_65,r_119_151_157,0.86,2,159,157,6
80,r_205_46_45,r_86_146_155,r_217_11_172,r_205_46_45,0.46,119,164,45,6
5,r_117_47_127,seq274,r_49_3_122,r_117_47_127,0.99,0,127,127,6
46,r_204_140_93,r_16_176_2,seq51,r_204_140_93,1.0,1,94,93,6
116,seq54,r_192_38_30,r_269_134_2,r_192_38_30,0.93,0,30,30,6
69,r_268_138_125,seq57,seq284,r_268_138_125,0.87,0,125,125,6
45,r_87_193_91,r_286_1_119,r_269_134_2,r_87_193_91,0.98,2,93,91,6
76,r_186_123_145,seq32,r_276_291_74,r_276_291_74,1.0,4,78,74,6
74,r_263_22_38,seq14,seq25,r_263_22_38,1.0,1,39,38,6
103,seq14,seq200,r_186_123_145,r_186_123_145,1.0,4,149,145,6
31,r_280_297_102,seq39,seq177,r_280_297_102,0.99,0,102,102,6
129,seq90,r_7_142_159,r_49_3_122,r_49_3_122,0.84,15,137,122,6
41,r_89_270_75,seq211,seq239,r_89_270_75,1.0,0,75,75,6
110,seq32,r_208_260_176,r_23_74_77,r_23_74_77,1.0,25,102,77,6
89,r_240_77_106,seq25,seq60,r_240_77_106,1.0,0,106,106,6
3,r_100_28_71,seq150,r_232_144_49,r_100_28_71,1.0,0,71,71,6
42,r_187_174_23,seq198,seq220,r_187_174_23,1.0,2,25,23,6
90,r_234_44_116,seq96,seq150,r_234_44_116,0.99,0,116,116,6
14,r_21_67_24,seq65,seq173,r_21_67_24,1.0,0,24,24,6
170,seq211,r_89_270_75,r_63_225_57,r_89_270_75,0.68,0,75,75,6
4,r_56_68_89,seq32,r_19_141_82,r_56_68_89,1.0,0,89,89,6
0,r_49_3_122,r_250_227_170,r_192_38_30,r_49_3_122,0.98,0,122,122,6
63,r_217_11_172,r_7_142_159,r_205_46_45,r_205_46_45,0.76,116,161,45,6
73,r_102_2_28,seq219,seq274,r_102_2_28,1.0,0,28,28,6
86,r_127_163_30,r_252_31_38,seq278,r_252_31_38,1.0,-4,34,38,6
182,seq242,seq61,r_179_258_15,r_179_258_15,0.87,16,31,15,6
20,r_279_172_86,seq245,r_18_78_19,r_279_172_86,0.94,7,93,86,6
98,r_13_288_121,r_191_92_196,r_223_40_82,r_191_92_196,0.78,-75,121,196,6
21,r_232_144_49,r_72_59_189,seq271,r_232_144_49,1.0,1,50,49,6
187,seq264,seq247,r_223_40_82,r_223_40_82,1.0,15,97,82,6
51,r_259_277_46,r_234_44_116,seq70,r_234_44_116,0.81,-70,46,116,6
6,r_29_80_90,seq169,seq26,r_29_80_90,0.99,0,90,90,6
27,r_62_293_100,r_149_238_120,seq257,r_62_293_100,1.0,1,101,100,6
59,r_252_31_38,r_218_125_3,seq262,r_252_31_38,1.0,0,38,38,6
58,r_154_10_52,r_254_143_185,seq198,r_154_10_52,1.0,1,53,52,6
87,r_243_160_112,seq274,seq278,r_243_160_112,1.0,0,112,112,6
2,r_249_52_157,seq267,r_6_196_9,r_249_52_157,0.91,0,157,157,6
47,r_236_178_104,r_86_146_155,seq164,r_236_178_104,1.0,0,104,104,6
40,r_201_66_134,r_36_130_134,r_79_209_61,r_79_209_61,0.99,76,137,61,6
105,seq20,seq85,r_58_153_61,r_58_153_61,1.0,77,138,61,6
29,r_7_142_159,r_217_11_172,r_131_118_129,r_7_142_159,0.82,2,161,159,6
25,r_210_107_69,r_16_176_2,seq169,r_210_107_69,1.0,0,69,69,6
191,seq272,r_201_66_134,r_253_15_126,r_253_15_126,1.0,17,143,126,6
190,seq271,seq65,r_232_144_49,r_232_144_49,1.0,20,69,49,6
70,r_116_224_73,r_167_287_137,r_21_67_24,r_116_224_73,1.0,0,73,73,6
65,r_185_53_123,seq164,r_58_153_61,r_58_153_61,0.75,62,123,61,6
68,r_23_74_77,r_268_138_125,seq32,r_23_74_77,1.0,0,77,77,6
61,r_101_136_74,r_167_287_137,r_252_31_38,r_101_136_74,0.48,0,74,74,6
32,r_98_298_101,seq114,seq83,r_98_298_101,1.0,0,101,101,6
38,r_208_260_176,seq32,seq281,r_208_260_176,0.67,1,177,176,6
52,r_79_209_61,r_86_146_155,r_201_66_134,r_79_209_61,1.0,1,62,61,6
77,r_282_244_65,seq228,seq112,r_282_244_65,0.84,10,75,65,6
76,r_186_123_145,r_276_291_74,seq14,r_186_123_145,1.0,-1,144,145,6
94,r_294_129_46,r_240_77_106,seq51,r_294_129_46,0.99,0,46,46,6
169,seq207,seq32,r_110_73_106,r_110_73_106,1.0,-1,105,106,6
18,r_104_35_32,r_185_53_123,seq39,r_104_35_32,0.97,6,38,32,6
75,r_286_1_119,seq60,r_98_298_101,r_98_298_101,1.0,26,127,101,6
132,seq96,r_234_44_116,seq26,r_234_44_116,1.0,0,116,116,6
60,r_86_146_155,r_99_221_143,r_280_297_102,r_280_297_102,0.56,41,143,102,6
81,r_19_141_82,seq132,seq170,r_19_141_82,0.73,1,83,82,6
17,r_36_130_134,r_201_66_134,seq122,r_36_130_134,0.62,3,137,134,6
112,seq41,r_119_151_157,r_283_9_146,r_119_151_157,0.91,2,159,157,6
171,seq213,r_72_59_189,r_49_3_122,r_49_3_122,1.0,67,189,122,6
9,r_226_212_153,seq95,r_186_123_145,r_186_123_145,0.58,10,155,145,6
96,r_115_81_98,r_226_212_153,r_87_193_91,r_115_81_98,0.87,0,98,98,6
22,r_223_40_82,r_269_134_2,seq264,r_223_40_82,1.0,0,82,82,6
28,r_261_128_166,seq88,seq239,r_261_128_166,0.94,0,166,166,6
57,r_12_97_46,r_98_298_101,seq103,r_12_97_46,0.91,0,46,46,6
91,r_105_76_11,r_49_3_122,seq222,r_105_76_11,0.98,0,11,11,6
13,r_179_258_15,r_167_287_137,seq242,r_179_258_15,0.84,2,17,15,6
80,r_205_46_45,r_279_172_86,r_86_146_155,r_205_46_45,1.0,0,45,45,6
7,r_214_194_100,seq85,seq198,r_214_194_100,1.0,0,100,100,6
185,seq257,seq109,r_62_293_100,r_62_293_100,1.0,10,110,100,6
54,r_197_248_13,r_275_168_133,seq109,r_197_248_13,0.99,-1,12,13,6
44,r_276_291_74,seq148,r_186_123_145,r_276_291_74,1.0,0,74,74,6
118,seq60,r_286_1_119,r_240_77_106,r_240_77_106,1.0,21,127,106,6
85,r_34_295_42,r_259_277_46,seq147,r_34_295_42,1.0,0,42,42,6
82,r_99_221_143,r_86_146_155,seq245,r_99_221_143,0.91,0,143,143,6
79,r_167_287_137,seq284,r_236_178_104,r_236_178_104,0.69,34,138,104,6
35,r_253_15_126,seq173,r_243_160_112,r_253_15_126,0.94,1,127,126,6
95,r_63_225_57,r_36_130_134,seq211,r_63_225_57,0.99,1,58,57,6
12,r_161_37_103,seq198,r_276_291_74,r_161_37_103,1.0,1,104,103,6
39,r_135_265_36,r_202_42_174,seq264,r_135_265_36,1.0,0,36,36,6
93,r_76_179_102,r_25_253_139,seq104,r_76_179_102,0.98,0,102,102,7
30,r_287_269_118,seq185,r_242_125_41,r_242_125_41,1.0,82,123,41,7
51,r_294_205_134,seq67,seq296,r_294_205_134,0.92,3,137,134,7
92,r_224_140_138,r_8_18_190,r_133_154_123,r_224_140_138,0.55,5,143,138,7
8,r_91_196_177,seq198,r_298_32_169,r_298_32_169,0.98,8,177,169,7
70,r_188_79_89,r_139_178_119,seq296,r_139_178_119,1.0,0,119,119,7
38,r_139_178_119,r_188_79_89,seq71,r_139_178_119,0.96,0,119,119,7
58,r_43_290_68,r_9_223_170,r_292_60_76,r_9_223_170,0.98,-1,169,170,7
33,r_99_173_17,r_235_289_26,seq48,r_99_173_17,0.76,-1,16,17,7
83,r_21_23_126,r_159_225_145,r_54_72_1,r_21_23_126,0.87,0,126,126,7
37,r_25_253_139,seq208,r_255_42_62,r_25_253_139,0.74,0,139,139,7
3,r_9_223_170,r_43_290_68,r_61_157_115,r_9_223_170,0.96,0,170,170,7
86,r_239_272_163,seq33,r_78_10_12,r_239_272_163,0.72,0,163,163,7
16,r_129_12_117,seq143,seq174,r_129_12_117,0.78,2,119,117,7
21,r_175_244_151,r_115_151_139,r_283_171_112,r_175_244_151,0.86,-3,148,151,7
61,r_164_297_94,r_228_231_57,r_126_141_8,r_228_231_57,1.0,-16,41,57,7
42,r_233_176_187,seq105,r_54_72_1,r_233_176_187,0.33,0,187,187,7
80,r_68_89_115,seq48,r_34_216_14,r_68_89_115,1.0,0,115,115,7
7,r_82_2_17,r_239_272_163,r_58_254_60,r_58_254_60,0.45,61,121,60,7
69,r_230_220_97,seq161,r_207_36_65,r_207_36_65,0.63,29,94,65,7
45,r_86_215_105,r_217_263_142,r_58_254_60,r_86_215_105,0.99,0,105,105,7
15,r_217_263_142,r_55_5_56,r_286_214_38,r_55_5_56,0.63,86,142,56,7
95,r_88_85_151,seq84,r_268_49_1,r_88_85_151,0.48,0,151,151,7
76,r_92_19_177,seq293,r_54_72_1,r_92_19_177,0.45,1,178,177,7
31,r_62_65_185,seq182,r_148_29_93,r_148_29_93,0.6,92,185,93,7
67,r_80_160_91,seq142,seq219,r_80_160_91,1.0,0,91,91,7
59,r_34_216_14,r_44_158_153,seq84,r_34_216_14,0.51,-1,13,14,7
44,r_191_213_113,r_218_94_141,r_44_158_153,r_191_213_113,0.78,41,154,113,7
89,r_152_26_142,seq177,r_69_150_28,r_152_26_142,0.9,0,142,142,7
3,r_9_223_170,r_188_79_89,r_43_290_68,r_9_223_170,0.94,-81,89,170,7
10,r_260_246_128,r_78_10_12,seq105,r_260_246_128,0.92,0,128,128,7
60,r_202_194_39,seq52,seq177,r_202_194_39,1.0,0,39,39,7
36,r_102_250_17,r_233_176_187,seq211,r_102_250_17,0.71,-1,16,17,7
196,seq285,seq47,r_11_51_38,r_11_51_38,0.96,11,49,38,7
109,seq37,r_7_123_87,r_97_234_81,r_97_234_81,0.81,11,92,81,7
26,r_35_295_74,seq259,seq161,r_35_295_74,0.88,3,77,74,7
14,r_69_150_28,r_136_275_170,r_152_26_142,r_152_26_142,0.84,27,169,142,7
170,seq210,r_227_20_88,seq77,r_227_20_88,1.0,0,88,88,7
198,seq293,r_92_19_177,seq52,r_92_19_177,0.83,-35,142,177,7
4,r_148_29_93,r_1_81_174,r_66_13_37,r_66_13_37,1.0,59,96,37,7
0,r_255_42_62,r_152_26_142,seq4,r_255_42_62,0.95,0,62,62,7
63,r_128_203_99,seq71,seq31,r_128_203_99,1.0,0,99,99,7
73,r_298_32_169,r_190_120_112,r_153_144_39,r_298_32_169,0.93,-54,115,169,7
20,r_227_20_88,seq210,seq142,r_227_20_88,1.0,0,88,88,7
13,r_115_151_139,r_175_244_151,r_148_29_93,r_175_244_151,0.65,-11,140,151,7
15,r_217_263_142,r_86_215_105,r_55_5_56,r_217_263_142,0.96,-81,61,142,7
48,r_14_155_105,seq279,r_35_295_74,r_14_155_105,0.87,3,108,105,7
98,r_55_5_56,r_115_151_139,r_217_263_142,r_55_5_56,0.94,2,58,56,7
57,r_241_96_61,r_192_281_128,seq77,r_241_96_61,1.0,1,62,61,7
117,seq71,r_92_19_177,r_139_178_119,r_139_178_119,1.0,12,131,119,7
187,seq266,r_257_222_136,r_164_297_94,r_257_222_136,0.73,-43,93,136,7
141,seq134,r_106_45_166,r_153_144_39,r_153_144_39,0.97,127,166,39,7
85,r_292_60_76,r_93_282_164,seq114,r_292_60_76,0.92,0,76,76,7
12,r_118_135_26,seq30,seq98,r_118_135_26,0.74,0,26,26,7
99,r_100_291_108,seq84,seq16,r_100_291_108,0.93,1,109,108,7
53,r_232_63_33,r_170_201_2,r_61_157_115,r_61_157_115,1.0,0,115,115,7
172,seq219,seq113,r_80_160_91,r_80_160_91,1.0,11,102,91,7
87,r_190_120_112,seq138,seq284,r_190_120_112,1.0,2,114,112,7
32,r_101_165_20,seq98,seq284,r_101_165_20,1.0,2,22,20,7
22,r_39_6_42,r_152_26_142,seq130,r_39_6_42,1.0,1,43,42,7
2,r_207_36_65,seq31,seq184,r_207_36_65,1.0,0,65,65,7
47,r_7_123_87,seq37,r_66_13_37,r_66_13_37,0.78,55,92,37,7
142,seq138,r_73_122_100,r_298_32_169,r_73_122_100,1.0,0,100,100,7
23,r_136_275_170,r_100_291_108,r_69_150_28,r_136_275_170,0.91,-115,55,170,7
195,seq284,r_136_275_170,r_101_165_20,r_101_165_20,0.64,12,32,20,7
6,r_242_125_41,r_145_107_183,seq293,r_242_125_41,1.0,2,43,41,7
64,r_93_282_164,r_170_201_2,r_54_72_1,r_93_282_164,0.62,0,164,164,7
73,r_298_32_169,r_153_144_39,r_100_291_108,r_298_32_169,0.92,0,169,169,7
50,r_73_122_100,seq138,r_230_220_97,r_73_122_100,0.95,0,100,100,7
58,r_43_290_68,r_260_246_128,r_9_223_170,r_43_290_68,1.0,0,68,68,7
70,r_188_79_89,r_9_223_170,r_139_178_119,r_188_79_89,0.66,0,89,89,7
7,r_82_2_17,seq64,r_239_272_163,r_82_2_17,1.0,0,17,17,7
155,seq181,r_133_154_123,seq87,r_133_154_123,1.0,0,123,123,7
68,r_17_57_56,r_129_12_117,r_99_173_17,r_17_57_56,0.99,4,60,56,7
38,r_139_178_119,seq240,r_188_79_89,r_188_79_89,1.0,3,92,89,7
52,r_236_41_126,r_175_244_151,r_235_289_26,r_235_289_26,0.88,101,127,26,7
34,r_145_107_183,seq197,r_175_244_151,r_175_244_151,0.6,33,184,151,7
41,r_153_144_39,r_25_253_139,seq134,r_153_144_39,1.0,0,39,39,7
182,seq252,r_129_12_117,r_270_112_45,r_270_112_45,1.0,1,46,45,7
75,r_283_171_112,r_68_89_115,r_166_108_104,r_283_171_112,0.87,2,114,112,7
19,r_235_289_26,r_25_253_139,seq273,r_235_289_26,1.0,0,26,26,7
14,r_69_150_28,seq280,r_136_275_170,r_69_150_28,0.99,0,28,28,7
81,r_97_234_81,r_62_65_185,seq37,r_97_234_81,1.0,0,81,81,7
97,r_27_83_44,seq161,seq198,r_27_83_44,0.87,3,47,44,7
168,seq208,r_25_253_139,seq52,r_25_253_139,0.98,0,139,139,7
119,seq75,r_3_172_189,r_69_150_28,r_69_150_28,0.93,145,173,28,7
94,r_195_256_77,r_92_19_177,r_99_173_17,r_195_256_77,0.91,7,84,77,7
121,seq84,r_100_291_108,r_34_216_14,r_100_291_108,1.0,1,109,108,7
96,r_237_53_74,r_14_155_105,seq67,r_237_53_74,1.0,7,81,74,7
53,r_232_63_33,r_241_96_61,r_170_201_2,r_232_63_33,1.0,2,35,33,7
98,r_55_5_56,r_217_263_142,r_164_297_94,r_217_263_142,0.94,0,142,142,7
123,seq90,r_40_204_147,r_283_171_112,r_283_171_112,0.84,42,154,112,7
28,r_61_157_115,r_129_12_117,r_170_201_2,r_61_157_115,0.99,1,116,115,7
1,r_228_231_57,r_164_297_94,seq127,r_228_231_57,1.0,0,57,57,7
91,r_192_281_128,seq0,r_34_216_14,r_192_281_128,0.81,1,129,128,7
11,r_270_112_45,seq221,seq124,r_270_112_45,1.0,0,45,45,7
49,r_44_158_153,seq119,r_191_213_113,r_44_158_153,0.78,1,154,153,7
56,r_170_201_2,r_93_282_164,r_61_157_115,r_61_157_115,0.92,41,156,115,7
44,r_191_213_113,seq206,r_218_94_141,r_191_213_113,0.7,2,115,113,7
108,seq33,r_239_272_163,r_58_254_60,r_58_254_60,1.0,32,92,60,7
173,seq221,r_270_112_45,seq206,r_270_112_45,1.0,0,45,45,7
159,seq185,r_287_269_118,seq147,r_287_269_118,0.95,5,123,118,7
79,r_166_108_104,r_260_246_128,seq67,r_166_108_104,0.73,1,105,104,7
35,r_58_254_60,seq114,seq33,r_58_254_60,1.0,6,66,60,7
142,seq138,r_298_32_169,r_292_60_76,r_298_32_169,1.0,4,173,169,7
84,r_40_204_147,seq90,seq265,r_40_204_147,0.73,7,154,147,7
74,r_11_51_38,r_129_12_117,seq285,r_11_51_38,0.97,5,43,38,7
128,seq105,r_233_176_187,r_133_154_123,r_133_154_123,0.99,50,173,123,7
93,r_231_237_146,r_42_49_161,r_182_117_196,r_231_237_146,0.77,0,146,146,8
36,r_61_2_96,r_55_87_114,r_42_49_161,r_61_2_96,0.98,0,96,96,8
92,r_196_299_111,seq62,seq0,r_196_299_111,0.86,0,111,111,8
53,r_285_201_111,seq203,r_213_60_3,r_285_201_111,0.83,0,111,111,8
43,r_141_159_184,seq66,seq226,r_141_159_184,0.23,0,184,184,8
37,r_188_134_81,r_99_292_119,r_244_45_176,r_188_134_81,1.0,0,81,81,8
59,r_205_95_127,seq122,seq187,r_205_95_127,0.88,0,127,127,8
55,r_47_142_135,r_214_151_182,r_69_76_87,r_214_151_182,0.98,-42,140,182,8
16,r_78_5_63,seq175,seq44,r_78_5_63,1.0,0,63,63,8
21,r_127_25_95,seq202,seq57,r_127_25_95,0.89,2,97,95,8
97,r_174_56_127,r_248_67_139,r_208_164_197,r_174_56_127,0.9,6,133,127,8
4,r_263_224_140,r_165_186_151,r_111_93_49,r_111_93_49,1.0,-1,48,49,8
5,r_11_31_164,r_74_147_139,r_15_124_50,r_11_31_164,0.63,-25,139,164,8
46,r_86_48_170,seq35,r_278_100_3,r_86_48_170,0.38,3,173,170,8
61,r_246_120_17,r_162_283_124,r_133_129_173,r_246_120_17,0.99,0,17,17,8
80,r_197_114_158,seq287,r_92_91_111,r_197_114_158,0.62,1,159,158,8
7,r_15_124_50,r_74_147_139,r_289_254_47,r_74_147_139,1.0,0,139,139,8
69,r_155_136_129,r_38_77_192,r_216_118_78,r_155_136_129,0.64,0,129,129,8
45,r_161_135_127,seq27,seq202,r_161_135_127,0.88,0,127,127,8
34,r_111_93_49,r_290_110_66,r_263_224_140,r_111_93_49,1.0,0,49,49,8
65,r_32_204_46,r_18_121_105,seq73,r_32_204_46,0.98,1,47,46,8
19,r_16_59_156,seq160,r_157_150_115,r_16_59_156,0.64,1,157,156,8
153,seq187,seq81,r_205_95_127,r_205_95_127,0.97,7,134,127,8
39,r_148_232_47,r_68_54_159,seq183,r_148_232_47,0.99,0,47,47,8
95,r_262_251_93,seq226,seq294,r_262_251_93,0.94,0,93,93,8
66,r_163_257_122,seq264,r_104_24_36,r_163_257_122,0.96,1,123,122,8
76,r_55_87_114,seq228,r_179_167_19,r_55_87_114,0.91,2,116,114,8
31,r_92_91_111,seq112,seq84,r_92_91_111,0.9,4,115,111,8
41,r_168_192_106,r_231_237_146,seq62,r_168_192_106,0.94,0,106,106,8
98,r_104_24_36,r_289_254_47,seq66,r_104_24_36,1.0,1,37,36,8
89,r_273_3_104,seq17,seq84,r_273_3_104,0.56,10,114,104,8
3,r_162_283_124,seq84,r_282_274_66,r_162_283_124,0.77,3,127,124,8
10,r_244_45_176,r_157_150_115,r_140_131_196,r_244_45_176,0.78,-60,116,176,8
26,r_36_19_188,r_144_30_196,r_205_95_127,r_36_19_188,0.24,0,188,188,8
72,r_107_145_116,seq94,seq281,r_107_145_116,0.91,0,116,116,8
198,seq295,r_216_118_78,seq207,r_216_118_78,0.88,0,78,78,8
63,r_103_10_88,seq53,seq44,r_103_10_88,0.97,0,88,88,8
83,r_289_254_47,r_140_131_196,r_116_156_177,r_289_254_47,0.98,0,47,47,8
73,r_33_258_128,r_162_283_124,r_223_85_9,r_33_258_128,0.68,2,130,128,8
11,r_157_150_115,r_244_45_176,seq230,r_157_150_115,0.96,1,116,115,8
10,r_244_45_176,r_140_131_196,r_43_80_126,r_244_45_176,0.56,-12,164,176,8
33,r_83_298_41,r_236_177_191,seq17,r_83_298_41,1.0,0,41,41,8
15,r_39_7_187,seq154,r_182_117_196,r_182_117_196,0.68,-9,187,196,8
49,r_42_49_161,r_61_2_96,r_90_26_156,r_42_49_161,0.75,3,164,161,8
4,r_263_224_140,r_111_93_49,r_78_5_63,r_263_224_140,0.94,1,141,140,8
57,r_213_60_3,r_64_70_178,r_285_201_111,r_285_201_111,0.65,21,132,111,8
44,r_179_167_19,r_182_117_196,r_185_288_84,r_179_167_19,0.46,-8,11,19,8
141,seq149,seq202,r_101_219_67,r_101_219_67,1.0,8,75,67,8
99,r_220_297_132,r_214_151_182,seq102,r_220_297_132,0.77,0,132,132,8
44,r_179_167_19,r_185_288_84,r_55_87_114,r_179_167_19,0.53,49,68,19,8
36,r_61_2_96,r_42_49_161,r_282_274_66,r_42_49_161,0.67,1,162,161,8
51,r_74_147_139,r_15_124_50,seq122,r_74_147_139,0.99,0,139,139,8
87,r_284_132_79,seq265,r_182_117_196,r_284_132_79,0.97,0,79,79,8
2,r_69_76_87,seq113,seq50,r_69_76_87,0.8,1,88,87,8
47,r_218_215_145,r_90_26_156,r_246_120_17,r_218_215_145,0.91,5,150,145,8
17,r_286_280_120,r_133_129_173,r_8_51_27,r_8_51_27,0.99,0,27,27,8
74,r_99_292_119,seq210,seq160,r_99_292_119,0.91,0,119,119,8
18,r_88_233_169,r_90_26_156,seq46,r_90_26_156,0.99,-6,150,156,8
29,r_290_110_66,r_161_135_127,r_289_254_47,r_290_110_66,1.0,6,72,66,8
195,seq291,r_64_70_178,r_256_249_19,r_64_70_178,0.61,0,178,178,8
56,r_116_156_177,r_146_181_64,r_289_254_47,r_116_156_177,0.99,-120,57,177,8
61,r_246_120_17,r_133_129_173,r_218_215_145,r_246_120_17,0.85,157,174,17,8
24,r_101_219_67,r_188_134_81,seq149,r_101_219_67,0.98,4,71,67,8
34,r_111_93_49,r_263_224_140,seq269,r_263_224_140,0.92,1,141,140,8
25,r_225_75_110,r_236_177_191,seq106,r_225_75_110,0.93,0,110,110,8
48,r_8_51_27,r_286_280_120,r_246_120_17,r_286_280_120,0.99,1,121,120,8
64,r_282_274_66,r_92_91_111,seq279,r_282_274_66,0.97,2,68,66,8
20,r_133_129_173,r_38_77_192,r_246_120_17,r_246_120_17,0.95,2,19,17,8
50,r_18_121_105,r_64_70_178,seq0,r_18_121_105,0.72,0,105,105,8
58,r_270_115_143,seq172,seq119,r_270_115_143,0.8,0,143,143,8
70,r_259_267_79,r_88_233_169,seq84,r_259_267_79,0.92,1,80,79,8
20,r_133_129_173,r_246_120_17,r_32_204_46,r_246_120_17,0.72,157,174,17,8
32,r_165_186_151,seq126,r_148_232_47,r_165_186_151,0.68,0,151,151,8
38,r_23_158_109,seq294,r_38_77_192,r_23_158_109,0.84,1,110,109,8
48,r_8_51_27,r_162_283_124,r_286_280_120,r_8_51_27,0.99,0,27,27,8
51,r_74_147_139,r_11_31_164,r_15_124_50,r_15_124_50,0.86,0,50,50,8
75,r_185_288_84,seq202,r_271_180_198,r_185_288_84,1.0,1,85,84,8
81,r_63_247_115,r_193_153_191,seq154,r_63_247_115,0.82,0,115,115,8
94,r_89_29_70,seq12,seq269,r_89_29_70,0.96,2,72,70,8
9,r_40_261_37,seq154,r_146_181_64,r_146_181_64,1.0,3,67,64,8
198,seq295,seq207,r_90_26_156,r_90_26_156,0.94,-1,155,156,8
22,r_146_181_64,r_96_217_175,r_40_261_37,r_146_181_64,1.0,1,65,64,8
7,r_15_124_50,r_225_75_110,r_74_147_139,r_225_75_110,0.38,-60,50,110,8
91,r_234_268_75,seq154,r_241_52_9,r_234_268_75,0.65,0,75,75,8
135,seq122,r_205_95_127,r_127_25_95,r_205_95_127,0.67,0,127,127,8
49,r_42_49_161,r_168_192_106,r_61_2_96,r_42_49_161,0.97,-65,96,161,8
194,seq287,r_197_114_158,seq27,r_197_114_158,0.69,1,159,158,8
23,r_90_26_156,r_88_233_169,r_42_49_161,r_88_233_169,0.59,-5,164,169,8
68,r_253_123_12,r_16_59_156,seq119,r_253_123_12,0.85,-1,11,12,8
17,r_286_280_120,r_8_51_27,seq294,r_286_280_120,1.0,1,121,120,8
82,r_216_118_78,seq295,seq34,r_216_118_78,0.97,1,79,78,8
8,r_178_79_33,r_163_257_122,r_128_190_109,r_178_79_33,0.98,0,33,33,8
79,r_139_13_146,r_90_26_156,r_223_85_9,r_139_13_146,0.78,0,146,146,8
35,r_109_105_149,seq166,seq14,r_109_105_149,0.53,7,156,149,8
5,r_11_31_164,r_15_124_50,r_163_257_122,r_11_31_164,0.91,0,164,164,8
51,r_172_133_69,r_206_19_144,r_223_196_38,r_172_133_69,1.0,7,76,69,9
92,r_97_287_177,seq47,seq144,r_97_287_177,0.6,1,178,177,9
63,r_115_24_40,seq91,r_195_150_11,r_115_24_40,0.97,3,43,40,9
14,r_178_15_177,r_103_29_178,r_153_256_159,r_103_29_178,0.48,-1,177,178,9
8,r_153_256_159,seq16,r_28_292_47,r_28_292_47,1.0,115,162,47,9
53,r_159_11_72,seq205,seq286,r_159_11_72,0.96,3,75,72,9
125,seq67,r_174_143_179,r_206_19_144,r_206_19_144,0.6,37,181,144,9
148,seq123,r_84_33_125,r_139_170_17,r_139_170_17,0.67,7,24,17,9
54,r_31_213_125,r_206_19_144,seq56,r_31_213_125,0.44,3,128,125,9
83,r_233_81_165,seq3,r_225_117_170,r_225_117_170,0.6,1,171,170,9
37,r_298_110_149,seq120,r_223_196_38,r_298_110_149,0.85,0,149,149,9
71,r_242_55_61,seq289,seq116,r_242_55_61,0.88,6,67,61,9
1,r_132_157_116,seq131,seq205,r_132_157_116,1.0,0,116,116,9
97,r_257_291_106,r_137_27_59,r_149_272_61,r_257_291_106,1.0,-45,61,106,9
5,r_89_262_65,seq277,r_106_217_69,r_89_262_65,0.95,2,67,65,9
46,r_240_58_91,seq56,seq152,r_240_58_91,1.0,0,91,91,9
6,r_75_260_44,seq121,seq294,r_75_260_44,1.0,0,44,44,9
48,r_122_1_34,r_178_15_177,seq275,r_122_1_34,0.99,0,34,34,9
69,r_155_284_101,r_206_19_144,seq297,r_206_19_144,0.71,-36,108,144,9
45,r_225_117_170,seq116,r_12_82_87,r_12_82_87,0.98,5,92,87,9
66,r_57_43_80,r_106_217_69,seq247,r_57_43_80,1.0,0,80,80,9
27,r_264_96_48,r_288_181_69,seq165,r_264_96_48,0.97,3,51,48,9
76,r_21_50_109,seq232,seq25,r_21_50_109,0.96,0,109,109,9
100,seq0,seq199,r_222_142_79,r_222_142_79,0.9,30,109,79,9
31,r_59_83_125,seq130,seq3,r_59_83_125,0.85,0,125,125,9
41,r_276_198_132,seq32,r_281_49_12,r_276_198_132,0.86,0,132,132,9
97,r_257_291_106,r_149_272_61,r_42_208_79,r_257_291_106,1.0,0,106,106,9
89,r_137_27_59,r_257_291_106,r_122_1_34,r_137_27_59,1.0,2,61,59,9
86,r_23_214_33,r_288_181_69,r_111_8_10,r_111_8_10,0.48,23,33,10,9
3,r_113_203_23,r_84_33_125,r_223_196_38,r_113_203_23,0.97,102,125,23,9
10,r_227_13_85,r_234_202_109,seq65,r_227_13_85,0.85,0,85,85,9
38,r_243_204_117,r_7_60_53,seq44,r_7_60_53,0.99,6,59,53,9
113,seq32,r_276_198_132,seq124,r_276_198_132,1.0,-2,130,132,9
26,r_221_197_164,r_103_29_178,r_259_250_77,r_221_197_164,0.49,1,165,164,9
72,r_164_126_136,r_135_271_190,r_86_175_85,r_164_126_136,1.0,0,136,136,9
4,r_46_235_111,seq40,r_282_147_90,r_46_235_111,1.0,0,111,111,9
78,r_266_228_78,r_276_198_132,r_113_203_23,r_266_228_78,1.0,0,78,78,9
0,r_296_278_166,r_66_63_169,seq121,r_296_278_166,0.63,0,166,166,9
11,r_288_181_69,seq286,seq232,r_288_181_69,0.87,0,69,69,9
20,r_299_136_92,r_153_256_159,seq68,r_299_136_92,0.88,1,93,92,9
13,r_36_184_74,r_153_256_159,seq165,r_36_184_74,0.96,4,78,74,9
98,r_73_229_70,seq124,seq78,r_73_229_70,1.0,0,70,70,9
15,r_234_202_109,r_201_112_199,r_243_204_117,r_234_202_109,0.52,5,114,109,9
166,seq171,r_206_19_144,r_146_18_59,r_146_18_59,1.0,92,151,59,9
181,seq232,r_21_50_109,r_288_181_69,r_21_50_109,0.81,-42,67,109,9
58,r_146_18_59,r_225_117_170,seq171,r_146_18_59,1.0,0,59,59,9
36,r_249_258_41,r_215_293_152,seq124,r_249_258_41,0.58,110,151,41,9
42,r_139_170_17,r_28_292_47,seq123,r_139_170_17,0.86,0,17,17,9
56,r_244_88_50,r_93_54_4,r_85_224_42,r_93_54_4,0.83,46,50,4,9
85,r_111_8_10,r_178_15_177,seq30,r_111_8_10,0.99,0,10,10,9
87,r_145_94_72,seq70,r_42_208_79,r_145_94_72,1.0,0,72,72,9
39,r_154_148_19,r_115_24_40,seq286,r_154_148_19,0.73,-3,16,19,9
47,r_194_189_185,r_236_162_56,r_36_184_74,r_36_184_74,0.96,111,185,74,9
142,seq107,r_66_63_169,r_28_292_47,r_28_292_47,1.0,100,147,47,9
40,r_259_250_77,r_233_81_165,r_73_229_70,r_259_250_77,1.0,0,77,77,9
18,r_149_272_61,r_233_81_165,seq72,r_149_272_61,1.0,0,61,61,9
29,r_71_216_63,seq25,seq124,r_71_216_63,0.99,0,63,63,9
157,seq152,r_125_268_164,r_240_58_91,r_240_58_91,1.0,14,105,91,9
43,r_238_269_44,r_288_181_69,seq76,r_238_269_44,0.86,0,44,44,9
9,r_45_295_57,r_276_198_132,seq99,r_45_295_57,1.0,0,57,57,9
88,r_134_270_153,r_153_256_159,r_259_250_77,r_153_256_159,0.54,-6,153,159,9
50,r_282_147_90,r_132_157_116,r_111_8_10,r_282_147_90,0.56,0,90,90,9
70,r_209_90_94,seq6,r_288_181_69,r_209_90_94,0.9,1,95,94,9
65,r_253_64_135,seq173,seq207,r_253_64_135,0.85,1,136,135,9
68,r_106_217_69,r_57_43_80,r_111_8_10,r_57_43_80,0.7,-15,65,80,9
196,seq286,r_288_181_69,r_154_148_19,r_288_181_69,0.42,0,69,69,9
57,r_215_293_152,r_249_258_41,seq279,r_215_293_152,0.44,10,162,152,9
34,r_125_268_164,seq152,r_21_50_109,r_21_50_109,1.0,55,164,109,9
77,r_85_224_42,r_146_18_59,seq169,r_85_224_42,1.0,0,42,42,9
64,r_191_39_48,seq78,seq87,r_191_39_48,1.0,0,48,48,9
75,r_66_63_169,seq107,r_288_181_69,r_288_181_69,0.94,100,169,69,9
38,r_243_204_117,seq44,r_234_202_109,r_243_204_117,0.96,-3,114,117,9
93,r_274_210_42,seq123,seq2,r_274_210_42,1.0,1,43,42,9
60,r_129_69_86,r_125_268_164,r_98_186_9,r_129_69_86,1.0,0,86,86,9
45,r_225_117_170,r_12_82_87,seq130,r_225_117_170,0.91,0,170,170,9
7,r_281_49_12,r_298_110_149,r_52_48_5,r_281_49_12,0.94,0,12,12,9
81,r_226_182_154,seq20,r_45_295_57,r_226_182_154,0.77,0,154,154,9
2,r_223_196_38,seq20,r_139_170_17,r_223_196_38,1.0,1,39,38,9
17,r_222_142_79,seq5,seq0,r_222_142_79,0.78,4,83,79,9
94,r_174_143_179,seq67,r_46_235_111,r_46_235_111,1.0,70,181,111,9
32,r_218_167_24,r_215_293_152,r_195_150_11,r_218_167_24,0.55,2,26,24,9
67,r_7_60_53,r_243_204_117,seq6,r_7_60_53,1.0,4,57,53,9
112,seq30,r_209_90_94,r_111_8_10,r_111_8_10,0.99,0,10,10,9
96,r_119_241_124,seq267,r_89_262_65,r_119_241_124,0.93,0,124,124,9
22,r_84_33_125,r_113_203_23,seq131,r_84_33_125,0.91,0,125,125,9
28,r_105_261_126,seq188,r_242_55_61,r_105_261_126,0.56,0,126,126,9
91,r_10_17_142,seq176,seq263,r_10_17_142,0.67,0,142,142,9
36,r_249_258_41,r_28_292_47,r_215_293_152,r_215_293_152,0.79,-111,41,152,9
57,r_215_293_152,r_45_295_57,r_249_258_41,r_215_293_152,0.88,-106,46,152,9
44,r_118_185_98,seq183,r_236_162_56,r_118_185_98,0.81,0,98,98,9
21,r_114_51_42,r_244_88_50,seq78,r_114_51_42,1.0,0,42,42,9
145,seq116,r_146_18_59,r_242_55_61,r_146_18_59,0.96,0,59,59,9
23,r_12_82_87,seq177,seq165,r_12_82_87,0.9,-1,86,87,9
24,r_28_292_47,r_125_268_164,seq107,r_28_292_47,1.0,0,47,47,9
82,r_211_79_34,seq121,seq161,r_211_79_34,1.0,0,34,34,9
12,r_236_162_56,r_194_189_185,r_153_256_159,r_194_189_185,0.43,0,185,185,9
135,seq91,r_115_24_40,seq207,r_115_24_40,0.99,3,43,40,9
93,r_221_239_108,seq169,r_166_13_107,r_221_239_108,0.66,3,111,108,10
30,r_285_206_123,seq28,seq80,r_285_206_123,1.0,0,123,123,10
51,r_16_90_84,seq37,seq216,r_16_90_84,1.0,-1,83,84,10
50,r_172_44_59,r_70_156_8,seq209,r_172_44_59,1.0,0,59,59,10
36,r_98_162_107,seq132,r_248_116_36,r_248_116_36,1.0,77,113,36,10
86,r_56_200_16,r_153_60_121,seq10,r_56_200_16,0.97,-1,15,16,10
17,r_298_61_47,seq79,seq168,r_298_61_47,1.0,0,47,47,10
92,r_41_250_166,seq104,r_285_206_123,r_285_206_123,1.0,44,167,123,10
14,r_124_158_186,r_97_272_110,r_127_57_57,r_124_158_186,1.0,-76,110,186,10
8,r_66_86_92,seq244,seq123,r_66_86_92,1.0,0,92,92,10
53,r_259_51_107,r_241_207_152,r_164_75_115,r_259_51_107,0.93,0,107,107,10
58,r_112_77_12,r_258_292_132,r_118_284_15,r_258_292_132,1.0,0,132,132,10
54,r_155_278_68,r_122_175_61,seq180,r_155_278_68,1.0,0,68,68,10
83,r_89_195_68,r_49_87_186,r_32_254_65,r_89_195_68,0.82,4,72,68,10
12,r_62_217_54,seq210,r_18_151_43,r_62_217_54,1.0,0,54,54,10
37,r_143_227_89,r_166_13_107,r_23_114_37,r_143_227_89,1.0,0,89,89,10
3,r_258_292_132,r_112_77_12,r_295_201_74,r_258_292_132,0.93,0,132,132,10
72,r_157_134_35,r_124_158_186,seq31,r_157_134_35,1.0,0,35,35,10
59,r_231_25_93,r_286_197_143,r_233_218_40,r_231_25_93,1.0,-1,92,93,10
99,r_70_156_8,r_172_44_59,r_203_167_14,r_172_44_59,0.62,-29,30,59,10
67,r_53_59_4,seq144,r_166_13_107,r_166_13_107,0.57,-46,61,107,10
134,seq108,r_124_158_186,r_256_245_12,r_256_245_12,1.0,1,13,12,10
55,r_241_207_152,seq264,r_122_175_61,r_122_175_61,1.0,95,156,61,10
71,r_97_272_110,r_124_158_186,r_15_243_99,r_124_158_186,0.99,-76,110,186,10
16,r_291_273_74,r_1_92_112,r_155_278_68,r_291_273_74,0.99,0,74,74,10
21,r_276_211_168,r_163_299_80,r_164_75_115,r_276_211_168,0.92,0,168,168,10
39,r_153_60_121,seq210,seq28,r_153_60_121,1.0,0,121,121,10
1,r_171_146_145,seq63,seq247,r_171_146_145,0.74,2,147,145,10
97,r_287_228_194,r_72_202_131,r_233_218_40,r_287_228_194,0.84,-64,130,194,10
143,seq132,r_98_162_107,seq80,r_98_162_107,0.91,6,113,107,10
5,r_52_257_141,r_117_29_191,seq226,r_52_257_141,0.83,0,141,141,10
46,r_173_268_178,seq274,r_62_217_54,r_62_217_54,0.99,125,179,54,10
80,r_45_215_158,seq12,r_258_292_132,r_45_215_158,0.6,-1,157,158,10
69,r_234_88_89,r_229_185_138,r_99_186_189,r_234_88_89,0.99,0,89,89,10
45,r_166_13_107,seq180,seq144,r_166_13_107,0.63,9,116,107,10
64,r_23_114_37,seq142,seq128,r_23_114_37,0.83,3,40,37,10
76,r_110_174_52,seq141,seq274,r_110_174_52,1.0,1,53,52,10
193,seq274,r_173_268_178,r_188_95_12,r_188_95_12,0.95,167,179,12,10
95,r_49_87_186,seq179,r_89_195_68,r_89_195_68,1.0,118,186,68,10
66,r_138_54_22,r_143_227_89,r_27_35_66,r_138_54_22,0.93,69,91,22,10
89,r_40_83_94,r_99_186_189,r_78_230_146,r_40_83_94,1.0,1,95,94,10
10,r_205_5_133,seq289,r_188_95_12,r_205_5_133,0.8,0,133,133,10
90,r_295_201_74,r_1_92_112,r_203_167_14,r_295_201_74,1.0,0,74,74,10
197,seq282,r_33_22_59,seq43,r_33_22_59,1.0,-1,58,59,10
26,r_67_107_137,seq103,seq165,r_67_107_137,0.82,0,137,137,10
139,seq123,seq168,r_66_86_92,r_66_86_92,1.0,30,122,92,10
0,r_242_196_88,r_236_240_2,r_82_68_31,r_82_68_31,1.0,64,95,31,10
38,r_105_113_54,r_1_92_112,r_56_200_16,r_105_113_54,1.0,1,55,54,10
63,r_30_184_113,seq106,seq179,r_30_184_113,0.83,1,114,113,10
73,r_15_243_99,r_225_9_120,seq21,r_15_243_99,0.97,0,99,99,10
58,r_112_77_12,r_122_175_61,r_258_292_132,r_112_77_12,0.97,0,12,12,10
75,r_82_68_31,r_33_22_59,seq63,r_82_68_31,1.0,0,31,31,10
20,r_194_293_184,seq2,seq226,r_194_293_184,0.53,1,185,184,10
57,r_1_92_112,seq222,r_78_230_146,r_1_92_112,0.92,0,112,112,10
117,seq48,seq43,r_225_9_120,r_225_9_120,0.99,1,121,120,10
6,r_224_19_109,r_49_87_186,r_74_69_54,r_49_87_186,0.97,-78,108,186,10
85,r_27_35_66,r_286_197_143,r_138_54_22,r_27_35_66,1.0,0,66,66,10
9,r_74_69_54,r_91_34_102,r_4_192_43,r_74_69_54,0.97,5,59,54,10
160,seq180,r_166_13_107,r_155_278_68,r_155_278_68,1.0,48,116,68,10
27,r_18_151_43,r_20_17_170,r_62_217_54,r_62_217_54,0.7,11,65,54,10
136,seq111,seq212,r_11_296_27,r_11_296_27,1.0,36,63,27,10
87,r_135_46_80,r_16_90_84,r_269_81_198,r_135_46_80,0.97,-1,79,80,10
47,r_136_64_131,r_52_257_141,seq148,r_52_257_141,1.0,-9,132,141,10
3,r_258_292_132,r_143_227_89,r_112_77_12,r_258_292_132,0.93,-104,28,132,10
40,r_160_190_110,r_269_81_198,r_112_77_12,r_160_190_110,0.81,0,110,110,10
81,r_290_246_31,r_233_218_40,r_236_240_2,r_290_246_31,1.0,0,31,31,10
18,r_275_119_162,seq85,r_286_197_143,r_275_119_162,0.46,1,163,162,10
29,r_163_299_80,r_276_211_168,r_258_292_132,r_258_292_132,0.66,36,168,132,10
24,r_93_255_73,seq121,seq120,r_93_255_73,0.99,1,74,73,10
25,r_286_197_143,seq120,seq103,r_286_197_143,0.81,0,143,143,10
88,r_91_34_102,seq96,r_125_294_10,r_91_34_102,1.0,1,103,102,10
11,r_33_22_59,seq282,seq214,r_33_22_59,0.99,0,59,59,10
190,seq266,r_276_211_168,seq132,r_276_211_168,1.0,-15,153,168,10
70,r_269_81_198,r_160_190_110,r_135_46_80,r_269_81_198,0.99,-95,103,198,10
65,r_249_161_86,seq267,seq109,r_249_161_86,0.99,-1,85,86,10
98,r_203_167_14,r_205_5_133,r_70_156_8,r_203_167_14,0.88,1,15,14,10
33,r_118_284_15,r_224_19_109,r_112_77_12,r_118_284_15,1.0,0,15,15,10
137,seq120,r_286_197_143,r_93_255_73,r_93_255_73,1.0,70,143,73,10
130,seq96,r_91_34_102,seq103,r_91_34_102,1.0,2,104,102,10
61,r_72_202_131,r_287_228_194,seq103,r_72_202_131,0.96,0,131,131,10
32,r_14_283_133,seq10,r_15_243_99,r_14_283_133,0.87,1,134,133,10
52,r_220_213_152,seq191,r_93_255_73,r_220_213_152,0.78,0,152,152,10
77,r_32_254_65,r_166_13_107,seq251,r_32_254_65,1.0,0,65,65,10
34,r_236_240_2,r_242_196_88,r_290_246_31,r_290_246_31,1.0,64,95,31,10
13,r_11_296_27,r_276_211_168,seq111,r_11_296_27,1.0,0,27,27,10
43,r_127_57_57,seq43,r_124_158_186,r_127_57_57,1.0,2,59,57,10
31,r_4_192_43,r_124_158_186,seq274,r_4_192_43,0.93,4,47,43,10
60,r_182_170_148,seq267,r_208_235_8,r_208_235_8,0.67,144,152,8,10
94,r_280_265_146,seq216,r_285_206_123,r_280_265_146,0.93,3,149,146,10
78,r_101_130_30,r_242_196_88,r_203_167_14,r_101_130_30,1.0,0,30,30,10
96,r_252_133_76,r_1_92_112,r_208_235_8,r_252_133_76,0.99,0,76,76,10
22,r_164_75_115,seq10,r_259_51_107,r_259_51_107,1.0,10,117,107,10
35,r_233_218_40,r_1_92_112,r_287_228_194,r_233_218_40,1.0,0,40,40,10
7,r_122_175_61,r_155_278_68,seq106,r_155_278_68,0.8,0,68,68,10
44,r_20_17_170,seq165,r_143_227_89,r_143_227_89,1.0,92,181,89,10
82,r_225_9_120,r_173_268_178,seq48,r_225_9_120,0.94,0,120,120,10
62,r_125_294_10,r_233_218_40,seq58,r_125_294_10,0.64,0,10,10,10
183,seq247,r_117_29_191,r_171_146_145,r_171_146_145,0.88,26,171,145,10
93,r_4_272_178,seq6,r_155_199_29,r_155_199_29,0.96,153,182,29,11
30,r_261_273_169,seq154,seq103,r_261_273_169,0.49,-105,64,169,11
76,r_212_278_46,r_40_82_36,seq269,r_212_278_46,0.99,-1,45,46,11
9,r_165_187_40,r_87_298_150,r_123_241_84,r_165_187_40,1.0,65,105,40,11
17,r_274_183_57,seq35,r_234_201_54,r_234_201_54,0.88,3,57,54,11
53,r_286_16_88,r_266_11_139,r_20_180_132,r_286_16_88,0.99,52,140,88,11
14,r_224_110_181,seq71,r_69_93_97,r_69_93_97,0.94,85,182,97,11
8,r_126_188_64,r_220_97_122,seq88,r_126_188_64,1.0,0,64,64,11
12,r_266_11_139,r_286_16_88,r_216_60_14,r_266_11_139,0.98,1,140,139,11
53,r_286_16_88,r_0_190_151,r_266_11_139,r_286_16_88,0.93,0,88,88,11
54,r_141_137_48,seq248,seq231,r_141_137_48,0.86,-1,47,48,11
83,r_73_296_167,seq210,r_33_245_66,r_33_245_66,0.8,101,167,66,11
71,r_211_17_94,r_173_172_145,seq163,r_211_17_94,1.0,0,94,94,11
86,r_293_10_113,seq185,r_40_82_36,r_293_10_113,0.7,5,118,113,11
16,r_228_12_74,seq217,seq58,r_228_12_74,0.65,64,138,74,11
21,r_255_292_125,seq239,r_282_83_120,r_255_292_125,1.0,1,126,125,11
39,r_123_241_84,seq9,r_215_46_65,r_123_241_84,0.98,-2,82,84,11
97,r_161_152_140,r_213_81_143,seq258,r_161_152_140,0.5,1,141,140,11
5,r_33_245_66,seq51,r_77_184_12,r_33_245_66,1.0,0,66,66,11
46,r_80_205_126,seq35,seq210,r_80_205_126,0.7,1,127,126,11
42,r_146_287_96,seq239,seq222,r_146_287_96,1.0,1,97,96,11
55,r_18_129_56,r_282_83_120,r_200_105_47,r_200_105_47,0.99,9,56,47,11
80,r_252_91_114,seq192,r_130_202_54,r_252_91_114,0.92,0,114,114,11
24,r_87_298_150,r_181_208_31,r_295_124_37,r_87_298_150,0.97,0,150,150,11
69,r_213_81_143,r_22_223_112,r_161_152_140,r_22_223_112,0.9,0,112,112,11
45,r_66_145_184,seq13,r_104_221_14,r_104_221_14,0.7,170,184,14,11
20,r_277_249_53,r_294_138_123,seq247,r_277_249_53,0.99,0,53,53,11
19,r_50_30_85,seq233,seq84,r_50_30_85,1.0,1,86,85,11
9,r_165_187_40,r_242_207_191,r_87_298_150,r_165_187_40,1.0,0,40,40,11
77,r_26_275_100,r_45_257_21,seq134,r_26_275_100,0.55,2,102,100,11
95,r_206_214_103,seq134,seq29,r_206_214_103,0.79,5,108,103,11
103,seq15,r_3_100_76,r_18_129_56,r_18_129_56,0.59,60,116,56,11
50,r_166_150_35,r_3_100_76,r_67_48_26,r_166_150_35,0.62,-8,27,35,11
31,r_45_257_21,r_155_199_29,r_26_275_100,r_26_275_100,0.96,-79,21,100,11
3,r_215_46_65,r_159_178_188,r_165_187_40,r_159_178_188,0.94,-123,65,188,11
10,r_291_38_166,seq231,r_147_151_89,r_147_151_89,0.59,77,166,89,11
87,r_234_201_54,r_20_180_132,seq191,r_234_201_54,0.93,-1,53,54,11
181,seq244,r_236_227_171,r_67_48_26,r_67_48_26,0.55,-1,25,26,11
62,r_270_99_57,r_282_83_120,seq109,r_270_99_57,0.99,0,57,57,11
26,r_230_39_99,r_79_264_99,seq163,r_230_39_99,1.0,0,99,99,11
179,seq239,r_23_251_160,seq51,r_23_251_160,1.0,0,160,160,11
4,r_85_182_180,seq243,r_266_11_139,r_266_11_139,0.88,42,181,139,11
73,r_220_97_122,seq36,r_57_259_90,r_220_97_122,0.44,14,136,122,11
11,r_236_227_171,seq134,r_157_240_10,r_157_240_10,1.0,168,178,10,11
99,r_115_61_152,r_130_202_54,r_266_11_139,r_266_11_139,0.97,7,146,139,11
163,seq185,r_293_10_113,r_270_99_57,r_270_99_57,0.65,79,136,57,11
182,seq247,r_282_83_120,r_277_249_53,r_277_249_53,1.0,0,53,53,11
48,r_98_64_112,seq90,r_146_287_96,r_146_287_96,1.0,16,112,96,11
187,seq258,r_20_180_132,seq113,r_20_180_132,1.0,0,132,132,11
99,r_115_61_152,seq88,r_130_202_54,r_130_202_54,0.96,16,70,54,11
36,r_181_208_31,r_87_298_150,r_165_187_40,r_87_298_150,0.6,0,150,150,11
91,r_200_105_47,r_3_100_76,r_18_129_56,r_3_100_76,0.7,17,93,76,11
77,r_26_275_100,r_3_100_76,r_45_257_21,r_45_257_21,0.99,0,21,21,11
59,r_2_132_38,seq76,seq189,r_2_132_38,0.98,-1,37,38,11
197,seq288,r_0_190_151,seq149,r_0_190_151,0.64,-96,55,151,11
90,r_218_106_55,r_206_214_103,seq36,r_218_106_55,1.0,0,55,55,11
94,r_157_240_10,r_266_11_139,seq42,r_157_240_10,0.9,0,10,10,11
2,r_177_229_84,seq127,r_170_107_30,r_177_229_84,0.57,0,84,84,11
47,r_7_148_89,seq35,r_77_184_12,r_7_148_89,1.0,0,89,89,11
40,r_69_93_97,seq217,seq163,r_69_93_97,0.94,1,98,97,11
74,r_260_232_183,seq29,r_212_278_46,r_260_232_183,0.32,4,187,183,11
24,r_87_298_150,seq154,r_181_208_31,r_181_208_31,1.0,77,108,31,11
36,r_181_208_31,r_136_226_108,r_87_298_150,r_181_208_31,1.0,0,31,31,11
33,r_79_264_99,r_230_39_99,seq111,r_79_264_99,0.56,-5,94,99,11
127,seq84,r_282_83_120,r_50_30_85,r_50_30_85,1.0,5,90,85,11
64,r_173_172_145,seq96,r_57_259_90,r_173_172_145,0.92,0,145,145,11
25,r_130_202_54,r_66_145_184,r_2_132_38,r_130_202_54,1.0,-1,53,54,11
58,r_22_223_112,r_213_81_143,r_117_186_25,r_22_223_112,0.92,0,112,112,11
57,r_170_107_30,r_252_91_114,seq217,r_170_107_30,0.94,-3,27,30,11
61,r_136_226_108,seq32,r_216_60_14,r_136_226_108,0.94,0,108,108,11
32,r_125_92_124,r_225_120_194,r_206_214_103,r_125_92_124,0.58,6,130,124,11
75,r_52_68_75,r_220_97_122,seq88,r_52_68_75,0.99,-1,74,75,11
124,seq72,r_147_151_89,seq109,r_147_151_89,0.96,-7,82,89,11
183,seq248,r_141_137_48,r_2_132_38,r_2_132_38,0.71,5,43,38,11
51,r_77_184_12,r_283_279_170,seq127,r_77_184_12,0.97,1,13,12,11
81,r_294_138_123,seq86,r_7_148_89,r_294_138_123,0.97,0,123,123,11
0,r_295_124_37,r_94_74_195,r_59_196_21,r_295_124_37,0.95,0,37,37,11
96,r_235_108_125,seq9,r_282_83_120,r_235_108_125,0.96,1,126,125,11
63,r_156_140_47,seq210,seq75,r_156_140_47,0.98,-2,45,47,11
31,r_45_257_21,r_26_275_100,r_18_129_56,r_45_257_21,0.69,81,102,21,11
22,r_104_221_14,r_266_11_139,seq149,r_104_221_14,0.98,-1,13,14,11
49,r_3_100_76,seq88,r_274_183_57,r_3_100_76,0.72,17,93,76,11
78,r_47_24_60,r_266_11_139,r_212_278_46,r_47_24_60,0.97,-1,59,60,11
85,r_78_290_26,r_215_46_65,seq13,r_215_46_65,0.56,-44,21,65,11
151,seq154,r_266_11_139,r_87_298_150,r_87_298_150,0.94,-113,37,150,11
91,r_200_105_47,seq113,r_3_100_76,r_200_105_47,0.89,-2,45,47,11
69,r_213_81_143,r_161_152_140,seq6,r_213_81_143,0.97,-2,141,143,11
12,r_266_11_139,seq154,r_286_16_88,r_286_16_88,1.0,12,100,88,11
35,r_59_196_21,seq193,seq95,r_59_196_21,1.0,0,21,21,11
84,r_147_151_89,seq185,seq168,r_147_151_89,0.99,0,89,89,11
93,r_61_270_146,seq136,seq225,r_61_270_146,0.8,0,146,146,12
40,r_158_12_8,r_120_98_133,r_221_274_117,r_158_12_8,1.0,125,133,8,12
30,r_151_243_187,r_180_28_170,r_272_145_183,r_272_145_183,0.66,5,188,183,12
190,seq276,r_82_245_157,r_107_104_18,r_107_104_18,0.84,0,18,18,12
92,r_216_94_162,seq25,r_116_258_65,r_216_94_162,0.76,0,162,162,12
5,r_261_285_55,seq93,seq22,r_261_285_55,0.89,1,56,55,12
8,r_121_56_142,seq218,r_160_108_47,r_121_56_142,0.56,0,142,142,12
14,r_76_65_45,seq296,seq246,r_76_65_45,1.0,0,45,45,12
83,r_70_127_73,seq36,seq242,r_70_127_73,0.89,0,73,73,12
37,r_279_30_195,r_154_293_149,r_116_258_65,r_116_258_65,1.0,17,82,65,12
54,r_163_280_34,r_126_148_125,r_15_11_60,r_163_280_34,0.69,91,125,34,12
17,r_60_27_23,seq22,r_80_146_188,r_60_27_23,1.0,0,23,23,12
71,r_133_229_141,r_259_181_169,r_277_87_23,r_133_229_141,0.89,0,141,141,12
86,r_53_299_131,r_157_31_190,r_277_87_23,r_53_299_131,0.73,6,137,131,12
16,r_91_262_100,seq140,seq200,r_91_262_100,0.8,-3,97,100,12
21,r_195_198_107,r_235_226_114,r_1_223_8,r_195_198_107,0.61,2,109,107,12
39,r_284_118_149,seq174,seq39,r_284_118_149,0.56,2,151,149,12
1,r_59_117_195,r_227_112_143,r_212_5_143,r_227_112_143,0.9,0,143,143,12
97,r_234_141_89,seq63,r_277_87_23,r_234_141_89,0.58,0,89,89,12
42,r_16_203_136,seq52,r_143_213_199,r_16_203_136,0.81,0,136,136,12
56,r_211_248_54,r_7_255_125,seq249,r_211_248_54,1.0,0,54,54,12
111,seq36,r_70_127_73,r_217_40_125,r_70_127_73,0.97,0,73,73,12
80,r_24_194_188,seq46,r_120_98_133,r_120_98_133,0.69,55,188,133,12
32,r_154_293_149,r_185_291_82,seq115,r_154_293_149,0.89,2,151,149,12
69,r_183_72_72,seq32,r_76_65_45,r_183_72_72,0.98,0,72,72,12
45,r_233_73_61,r_180_28_170,seq8,r_233_73_61,1.0,1,62,61,12
89,r_212_5_143,r_150_264_51,seq166,r_212_5_143,0.63,4,147,143,12
73,r_160_108_47,r_284_118_149,seq267,r_160_108_47,0.77,-7,40,47,12
19,r_120_98_133,seq115,seq52,r_120_98_133,1.0,0,133,133,12
95,r_58_47_110,seq153,seq37,r_58_47_110,0.87,0,110,110,12
66,r_232_228_126,seq246,seq63,r_232_228_126,1.0,0,126,126,12
76,r_86_132_111,r_54_294_119,r_105_214_78,r_105_214_78,0.83,33,111,78,12
2,r_26_193_32,r_216_94_162,seq250,r_26_193_32,0.94,0,32,32,12
129,seq99,seq63,r_162_190_57,r_162_190_57,1.0,3,60,57,12
67,r_79_123_186,seq192,r_233_73_61,r_233_73_61,1.0,125,186,61,12
3,r_221_274_117,r_79_123_186,r_158_12_8,r_221_274_117,1.0,0,117,117,12
26,r_259_181_169,r_133_229_141,r_135_230_183,r_133_229_141,0.74,0,141,141,12
72,r_256_0_76,r_260_209_145,r_4_175_56,r_4_175_56,0.91,21,77,56,12
4,r_266_251_75,r_131_269_101,seq136,r_266_251_75,1.0,0,75,75,12
78,r_147_134_137,seq220,r_266_251_75,r_147_134_137,1.0,0,137,137,12
0,r_15_11_60,r_183_72_72,r_163_280_34,r_15_11_60,1.0,0,60,60,12
11,r_29_106_77,seq9,r_162_190_57,r_29_106_77,1.0,0,77,77,12
46,r_295_18_52,r_235_226_114,seq114,r_295_18_52,1.0,0,52,52,12
105,seq22,seq242,r_261_285_55,r_261_285_55,0.91,0,55,55,12
15,r_10_75_167,seq153,r_76_65_45,r_10_75_167,0.64,-2,165,167,12
48,r_102_149_144,seq210,r_277_87_23,r_102_149_144,0.9,0,144,144,12
57,r_208_62_99,r_284_118_149,seq140,r_284_118_149,0.91,-55,94,149,12
117,seq46,r_24_194_188,r_161_77_162,r_161_77_162,0.83,26,188,162,12
167,seq210,r_102_149_144,seq114,r_102_149_144,1.0,0,144,144,12
85,r_157_31_190,r_266_251_75,r_232_228_126,r_157_31_190,1.0,0,190,190,12
6,r_235_226_114,seq74,seq283,r_235_226_114,0.99,0,114,114,12
54,r_163_280_34,r_61_270_146,r_126_148_125,r_163_280_34,1.0,0,34,34,12
85,r_157_31_190,r_53_299_131,r_266_251_75,r_266_251_75,0.95,62,137,75,12
99,r_159_119_183,seq225,r_188_206_1,r_188_206_1,0.51,182,183,1,12
88,r_54_294_119,r_261_285_55,r_38_241_197,r_54_294_119,0.66,2,121,119,12
134,seq115,r_120_98_133,r_154_293_149,r_120_98_133,0.92,-2,131,133,12
27,r_131_269_101,seq8,seq83,r_131_269_101,1.0,0,101,101,12
24,r_201_89_55,seq196,seq172,r_201_89_55,0.98,1,56,55,12
59,r_21_33_26,r_154_293_149,seq109,r_21_33_26,0.58,0,26,26,12
41,r_277_87_23,r_41_139_2,seq153,r_277_87_23,1.0,0,23,23,12
87,r_101_138_86,seq68,seq278,r_101_138_86,1.0,0,86,86,12
47,r_224_168_154,seq44,r_21_33_26,r_224_168_154,0.66,1,155,154,12
74,r_124_100_85,r_10_75_167,seq167,r_124_100_85,1.0,0,85,85,12
29,r_19_57_68,seq246,seq218,r_19_57_68,1.0,1,69,68,12
20,r_162_190_57,r_91_262_100,seq99,r_162_190_57,1.0,0,57,57,12
63,r_13_298_26,r_26_193_32,r_53_299_131,r_13_298_26,1.0,0,26,26,12
177,seq242,seq275,r_70_127_73,r_70_127_73,0.98,25,98,73,12
33,r_185_291_82,r_284_118_149,seq254,r_185_291_82,1.0,4,86,82,12
127,seq93,r_261_285_55,seq215,r_261_285_55,0.71,16,71,55,12
64,r_227_112_143,r_59_117_195,r_76_65_45,r_227_112_143,0.85,0,143,143,12
88,r_54_294_119,r_38_241_197,r_297_92_137,r_297_92_137,0.95,0,137,137,12
88,r_54_294_119,r_86_132_111,r_261_285_55,r_86_132_111,0.58,0,111,111,12
50,r_82_245_157,r_50_66_163,r_61_270_146,r_50_66_163,0.82,-6,157,163,12
70,r_197_164_116,r_79_123_186,seq109,r_197_164_116,0.97,1,117,116,12
65,r_161_77_162,seq275,r_50_66_163,r_161_77_162,0.65,0,162,162,12
68,r_252_49_75,r_290_128_18,r_295_18_52,r_252_49_75,0.51,0,75,75,12
32,r_154_293_149,r_279_30_195,r_185_291_82,r_185_291_82,1.0,0,82,82,12
98,r_265_231_40,r_157_31_190,seq22,r_265_231_40,1.0,0,40,40,12
52,r_7_255_125,r_147_134_137,r_195_198_107,r_7_255_125,1.0,0,125,125,12
77,r_182_95_76,r_260_209_145,seq218,r_182_95_76,0.98,-1,75,76,12
77,r_182_95_76,seq218,r_205_55_96,r_205_55_96,0.45,38,134,96,12
34,r_260_209_145,seq83,r_217_40_125,r_260_209_145,0.87,1,146,145,12
75,r_130_67_131,seq287,r_26_193_32,r_130_67_131,0.96,0,131,131,12
26,r_259_181_169,r_135_230_183,r_266_251_75,r_259_181_169,0.98,1,170,169,12
43,r_4_175_56,r_284_118_149,r_256_0_76,r_4_175_56,1.0,-2,54,56,12
124,seq83,r_260_209_145,r_131_269_101,r_131_269_101,0.73,45,146,101,12
81,r_41_139_2,seq278,r_26_193_32,r_26_193_32,1.0,84,116,32,12
94,r_84_48_91,r_180_28_170,seq64,r_84_48_91,1.0,0,91,91,12
63,r_13_298_26,r_53_299_131,r_266_251_75,r_266_251_75,0.56,62,137,75,12
96,r_50_66_163,seq39,r_161_77_162,r_161_77_162,0.56,6,168,162,12
89,r_212_5_143,seq166,r_150_264_51,r_150_264_51,1.0,0,51,51,12
31,r_150_264_51,r_212_5_143,r_29_106_77,r_29_106_77,0.91,70,147,77,12
31,r_150_264_51,r_58_47_110,r_212_5_143,r_150_264_51,1.0,0,51,51,12
22,r_116_258_65,r_188_206_1,seq254,r_116_258_65,1.0,0,65,65,12
62,r_126_148_125,r_163_280_34,r_105_214_78,r_126_148_125,1.0,0,125,125,12
60,r_80_146_188,seq46,r_60_27_23,r_60_27_23,1.0,1,24,23,12
49,r_3_103_81,seq153,r_76_65_45,r_3_103_81,1.0,0,81,81,12
152,seq174,r_284_118_149,seq225,r_284_118_149,1.0,2,151,149,12
44,r_247_97_88,seq2,seq220,r_247_97_88,0.58,-11,77,88,12
9,r_107_104_18,seq144,seq276,r_107_104_18,0.97,0,18,18,12
138,seq140,r_239_71_188,r_78_122_127,r_78_122_127,0.98,10,137,127,12
17,r_60_27_23,r_80_146_188,r_161_77_162,r_60_27_23,0.44,165,188,23,12
186,seq268,r_126_148_125,r_15_11_60,r_15_11_60,0.68,65,125,60,12
62,r_126_148_125,seq268,r_163_280_34,r_163_280_34,1.0,0,34,34,12
79,r_78_122_127,seq8,seq140,r_78_122_127,0.98,3,130,127,12
183,seq254,r_279_30_195,r_185_291_82,r_185_291_82,1.0,13,95,82,12
60,r_80_146_188,r_60_27_23,r_105_214_78,r_80_146_188,0.58,0,188,188,12
35,r_191_85_150,seq37,seq69,r_191_85_150,0.88,1,151,150,12
28,r_171_81_14,seq237,seq114,r_171_81_14,0.75,0,14,14,12
84,r_205_55_96,r_235_226_114,r_182_95_76,r_205_55_96,0.99,2,98,96,12
199,seq296,r_86_132_111,seq96,r_86_132_111,1.0,0,111,111,12
93,r_179_239_154,seq135,seq189,r_179_239_154,0.88,0,154,154,13
51,r_158_38_190,seq105,r_182_226_78,r_182_226_78,1.0,112,190,78,13
92,r_84_18_161,seq227,r_3_32_2,r_84_18_161,0.62,0,161,161,13
14,r_219_42_80,seq34,r_88_90_2,r_219_42_80,1.0,0,80,80,13
81,r_49_297_32,r_84_18_161,seq34,r_49_297_32,1.0,0,32,32,13
54,r_26_110_117,r_3_32_2,seq142,r_26_110_117,0.92,2,119,117,13
71,r_131_104_135,r_211_249_170,seq86,r_131_104_135,0.91,0,135,135,13
86,r_111_152_105,seq265,r_16_8_112,r_111_152_105,0.87,4,109,105,13
16,r_112_230_109,r_175_21_154,r_44_6_174,r_112_230_109,0.98,0,109,109,13
1,r_103_124_133,r_44_6_174,r_16_8_112,r_103_124_133,0.7,2,135,133,13
97,r_19_9_96,seq20,seq82,r_19_9_96,1.0,1,97,96,13
98,r_289_241_141,r_52_196_52,r_137_92_7,r_52_196_52,1.0,0,52,52,13
5,r_88_90_2,r_16_8_112,r_219_42_80,r_219_42_80,1.0,11,91,80,13
42,r_292_233_95,seq171,seq189,r_292_233_95,0.99,1,96,95,13
111,seq57,r_206_245_138,r_29_149_105,r_29_149_105,0.81,33,138,105,13
55,r_50_121_36,r_99_190_196,seq60,r_50_121_36,0.99,0,36,36,13
59,r_242_250_27,r_264_91_166,seq198,r_242_250_27,0.51,4,31,27,13
19,r_87_89_146,r_246_274_194,r_112_230_109,r_246_274_194,0.56,-46,148,194,13
9,r_133_71_47,seq81,seq59,r_133_71_47,1.0,1,48,47,13
95,r_264_91_166,seq45,r_281_97_60,r_281_97_60,0.53,106,166,60,13
66,r_181_33_87,r_73_46_139,r_101_100_20,r_181_33_87,0.98,1,88,87,13
76,r_41_114_129,seq183,seq154,r_41_114_129,0.84,0,129,129,13
0,r_47_37_32,r_173_263_79,r_175_21_154,r_47_37_32,0.95,1,33,32,13
69,r_27_223_9,r_87_89_146,r_109_287_104,r_27_223_9,0.83,3,12,9,13
43,r_194_85_12,r_181_33_87,seq95,r_194_85_12,1.0,0,12,12,13
89,r_276_277_99,seq198,seq115,r_276_277_99,0.7,5,104,99,13
30,r_101_100_20,r_224_107_44,seq166,r_101_100_20,0.97,0,20,20,13
10,r_43_163_73,r_119_291_93,seq228,r_43_163_73,1.0,1,74,73,13
90,r_211_249_170,r_131_104_135,r_292_233_95,r_211_249_170,0.69,-50,120,170,13
56,r_204_186_19,r_242_250_27,seq171,r_204_186_19,0.95,2,21,19,13
26,r_182_226_78,r_96_256_197,seq86,r_182_226_78,1.0,0,78,78,13
72,r_7_235_172,seq127,r_103_124_133,r_103_124_133,0.6,42,175,133,13
16,r_112_230_109,r_44_6_174,r_87_89_146,r_112_230_109,0.86,65,174,109,13
4,r_2_78_96,seq290,r_242_250_27,r_2_78_96,0.97,2,98,96,13
78,r_28_56_184,seq57,r_24_210_180,r_24_210_180,0.65,5,185,180,13
63,r_177_30_155,r_225_94_19,r_133_71_47,r_225_94_19,0.6,136,155,19,13
73,r_122_125_98,seq171,r_77_257_196,r_122_125_98,1.0,1,99,98,13
20,r_39_284_145,seq166,r_5_136_113,r_39_284_145,0.58,0,145,145,13
13,r_221_35_92,seq162,seq161,r_221_35_92,1.0,0,92,92,13
163,seq197,r_15_4_132,r_109_287_104,r_109_287_104,0.83,29,133,104,13
15,r_65_148_61,r_109_287_104,seq171,r_65_148_61,0.79,2,63,61,13
166,seq202,r_62_298_166,r_43_163_73,r_43_163_73,1.0,93,166,73,13
48,r_238_66_50,seq222,seq296,r_238_66_50,0.96,3,53,50,13
85,r_175_21_154,r_112_230_109,r_47_37_32,r_175_21_154,0.88,-77,77,154,13
46,r_164_254_51,r_0_139_177,seq12,r_164_254_51,1.0,0,51,51,13
0,r_47_37_32,r_175_21_154,seq20,r_175_21_154,1.0,-33,121,154,13
134,seq127,r_7_235_172,r_73_46_139,r_73_46_139,0.64,36,175,139,13
88,r_44_6_174,r_112_230_109,r_101_100_20,r_44_6_174,0.81,0,174,174,13
27,r_108_295_151,seq255,r_2_78_96,r_108_295_151,0.48,4,155,151,13
29,r_113_195_16,r_101_100_20,seq64,r_113_195_16,0.8,2,18,16,13
40,r_288_13_136,seq170,r_109_287_104,r_288_13_136,0.72,0,136,136,13
126,seq86,r_17_240_181,r_131_104_135,r_131_104_135,0.73,16,151,135,13
18,r_119_291_93,seq138,r_69_232_64,r_119_291_93,0.54,0,93,93,13
24,r_173_263_79,seq222,seq134,r_173_263_79,1.0,1,80,79,13
123,seq81,r_133_71_47,seq229,r_133_71_47,1.0,-8,39,47,13
64,r_172_156_30,seq59,r_132_208_153,r_172_156_30,0.99,1,31,30,13
25,r_132_208_153,r_29_149_105,seq68,r_29_149_105,1.0,3,108,105,13
33,r_16_8_112,r_77_257_196,r_111_152_105,r_16_8_112,0.84,0,112,112,13
88,r_44_6_174,r_129_117_147,r_112_230_109,r_112_230_109,0.93,8,117,109,13
85,r_175_21_154,r_47_37_32,r_14_150_102,r_175_21_154,0.78,0,154,154,13
50,r_279_252_63,seq74,r_27_223_9,r_279_252_63,0.99,0,63,63,13
70,r_5_136_113,seq229,seq155,r_5_136_113,0.91,1,114,113,13
6,r_137_92_7,r_289_241_141,r_50_121_36,r_137_92_7,0.87,112,119,7,13
65,r_258_267_127,seq183,r_199_167_4,r_199_167_4,0.76,123,127,4,13
36,r_140_261_47,seq82,seq118,r_140_261_47,0.92,3,50,47,13
68,r_275_205_77,seq169,seq57,r_275_205_77,1.0,4,81,77,13
61,r_129_117_147,r_44_6_174,r_2_78_96,r_44_6_174,0.62,-21,153,174,13
32,r_151_176_98,r_44_6_174,seq183,r_151_176_98,0.97,0,98,98,13
39,r_52_196_52,r_289_241_141,r_55_272_25,r_52_196_52,1.0,0,52,52,13
52,r_62_298_166,seq202,r_27_223_9,r_62_298_166,0.55,0,166,166,13
34,r_15_4_132,seq197,r_201_244_138,r_201_244_138,0.5,-5,133,138,13
75,r_23_1_169,seq183,r_61_187_164,r_23_1_169,0.68,0,169,169,13
124,seq82,r_129_117_147,r_19_9_96,r_19_9_96,1.0,21,117,96,13
60,r_0_139_177,seq10,r_132_208_153,r_0_139_177,0.74,1,178,177,13
17,r_281_97_60,r_231_234_167,seq227,r_281_97_60,1.0,0,60,60,13
173,seq227,r_84_18_161,r_281_97_60,r_281_97_60,1.0,38,98,60,13
145,seq155,r_73_46_139,r_39_284_145,r_73_46_139,0.71,8,147,139,13
98,r_289_241_141,r_137_92_7,r_109_287_104,r_289_241_141,0.99,0,141,141,13
22,r_109_287_104,seq135,r_153_58_9,r_109_287_104,0.85,0,104,104,13
28,r_17_240_181,seq98,r_179_239_154,r_179_239_154,0.62,28,182,154,13
49,r_206_245_138,seq57,r_201_244_138,r_206_245_138,0.9,0,138,138,13
164,seq198,r_276_277_99,r_2_78_96,r_2_78_96,0.93,2,98,96,13
149,seq161,r_264_91_166,r_221_35_92,r_221_35_92,0.81,11,103,92,13
7,r_29_149_105,r_132_208_153,seq57,r_29_149_105,0.99,3,108,105,13
44,r_212_216_62,r_24_210_180,r_70_102_24,r_212_216_62,1.0,0,62,62,13
175,seq229,r_5_136_113,seq81,r_5_136_113,0.93,1,114,113,13
82,r_73_46_139,r_24_210_180,seq127,r_73_46_139,0.49,8,147,139,13
79,r_218_215_136,r_206_245_138,r_113_195_16,r_218_215_136,0.77,0,136,136,13
74,r_55_272_25,r_192_53_57,seq127,r_55_272_25,0.89,0,25,25,13
35,r_61_187_164,r_28_56_184,r_14_150_102,r_28_56_184,0.86,-20,164,184,13
69,r_27_223_9,r_109_287_104,r_279_252_63,r_27_223_9,0.94,59,68,9,13
12,r_144_40_127,r_103_124_133,r_41_114_129,r_144_40_127,0.67,0,127,127,13
90,r_211_249_170,r_292_233_95,r_19_9_96,r_211_249_170,0.97,0,170,170,13
87,r_70_102_24,r_2_78_96,seq105,r_70_102_24,0.98,2,26,24,13
58,r_203_285_42,seq174,seq36,r_203_285_42,0.99,3,45,42,13
93,r_297_48_120,r_286_94_188,r_24_148_8,r_297_48_120,0.85,0,120,120,14
36,r_47_238_65,seq6,seq140,r_47_238_65,0.7,0,65,65,14
6,r_137_212_32,r_239_213_179,seq163,r_137_212_32,1.0,0,32,32,14
23,r_36_230_27,seq197,seq8,r_36_230_27,0.54,1,28,27,14
92,r_192_46_87,seq165,r_205_13_88,r_192_46_87,1.0,0,87,87,14
147,seq140,r_114_41_145,r_47_238_65,r_47_238_65,0.95,80,145,65,14
53,r_112_89_102,seq26,seq25,r_112_89_102,0.97,0,102,102,14
26,r_223_161_43,r_157_83_56,seq63,r_223_161_43,1.0,0,43,43,14
125,seq80,r_20_110_136,r_205_13_88,r_205_13_88,1.0,18,106,88,14
83,r_201_269_130,r_210_78_149,r_298_281_75,r_201_269_130,0.9,0,130,130,14
80,r_178_232_37,r_211_40_100,r_133_67_37,r_178_232_37,1.0,3,40,37,14
19,r_210_78_149,r_211_40_100,r_178_232_37,r_210_78_149,1.0,0,149,149,14
188,seq275,seq52,r_31_107_16,r_31_107_16,0.99,57,73,16,14
55,r_240_177_190,seq260,r_137_212_32,r_137_212_32,0.54,158,190,32,14
71,r_139_15_91,r_97_166_146,r_137_212_32,r_139_15_91,0.93,0,91,91,14
86,r_56_33_78,r_71_181_30,seq63,r_56_33_78,0.87,4,82,78,14
16,r_187_128_87,seq18,seq260,r_187_128_87,1.0,0,87,87,14
39,r_44_74_142,seq8,r_254_1_96,r_44_74_142,0.96,0,142,142,14
1,r_174_77_114,seq117,r_133_67_37,r_174_77_114,1.0,1,115,114,14
42,r_50_0_111,seq142,seq236,r_50_0_111,0.98,0,111,111,14
45,r_76_61_95,seq150,seq4,r_76_61_95,1.0,0,95,95,14
19,r_210_78_149,r_201_269_130,r_211_40_100,r_210_78_149,0.87,-60,89,149,14
28,r_16_221_58,seq124,seq80,r_16_221_58,1.0,0,58,58,14
66,r_286_94_188,seq182,r_277_154_133,r_277_154_133,1.0,55,188,133,14
76,r_99_296_98,r_170_19_177,seq208,r_99_296_98,0.97,0,98,98,14
151,seq153,r_58_282_88,r_65_224_16,r_58_282_88,0.66,-52,36,88,14
31,r_90_272_108,r_97_166_146,seq132,r_90_272_108,1.0,0,108,108,14
41,r_277_154_133,seq153,r_24_148_8,r_277_154_133,1.0,0,133,133,14
54,r_211_40_100,r_210_78_149,r_254_1_96,r_210_78_149,1.0,0,149,149,14
72,r_164_185_171,seq45,r_187_128_87,r_187_128_87,0.99,84,171,87,14
198,seq293,r_91_68_69,seq158,r_91_68_69,1.0,0,69,69,14
0,r_91_68_69,seq293,r_157_83_56,r_91_68_69,1.0,0,69,69,14
63,r_285_93_131,seq134,r_223_161_43,r_223_161_43,1.0,88,131,43,14
65,r_31_107_16,r_100_219_106,seq275,r_31_107_16,0.83,0,16,16,14
114,seq45,r_164_185_171,seq248,r_164_185_171,0.91,0,171,171,14
73,r_205_13_88,seq63,r_192_46_87,r_205_13_88,0.99,0,88,88,14
69,r_131_245_41,r_69_176_100,seq29,r_131_245_41,1.0,0,41,41,14
68,r_65_224_16,r_143_62_57,seq153,r_65_224_16,0.78,0,16,16,14
13,r_39_237_123,seq142,r_231_27_4,r_39_237_123,1.0,0,123,123,14
98,r_276_151_115,seq203,seq117,r_276_151_115,0.9,1,116,115,14
15,r_97_166_146,seq84,r_88_267_65,r_97_166_146,0.92,0,146,146,14
40,r_287_17_176,r_58_282_88,r_119_209_34,r_287_17_176,0.98,-140,36,176,14
181,seq260,r_240_177_190,r_187_128_87,r_187_128_87,1.0,75,162,87,14
62,r_183_242_159,seq158,seq111,r_183_242_159,0.53,0,159,159,14
22,r_59_190_21,r_146_292_110,seq123,r_59_190_21,0.91,1,22,21,14
4,r_119_209_34,seq275,r_287_17_176,r_119_209_34,0.99,0,34,34,14
97,r_85_274_57,seq104,seq294,r_85_274_57,1.0,0,57,57,14
27,r_254_1_96,r_287_17_176,seq124,r_254_1_96,1.0,0,96,96,14
59,r_32_235_46,r_91_68_69,seq278,r_32_235_46,1.0,1,47,46,14
8,r_149_266_28,r_76_61_95,seq220,r_149_266_28,1.0,0,28,28,14
87,r_217_198_163,seq261,r_186_295_26,r_217_198_163,0.64,1,164,163,14
47,r_145_265_103,r_217_198_163,r_47_238_65,r_145_265_103,0.87,0,103,103,14
57,r_75_191_46,r_196_251_115,r_24_148_8,r_75_191_46,0.97,1,47,46,14
51,r_172_147_11,r_240_177_190,seq142,r_172_147_11,1.0,-1,10,11,14
126,seq81,seq132,r_109_207_128,r_109_207_128,1.0,9,137,128,14
74,r_38_96_77,r_201_269_130,r_211_40_100,r_38_96_77,0.68,4,81,77,14
29,r_21_87_62,seq111,seq289,r_21_87_62,1.0,0,62,62,14
24,r_100_219_106,seq195,r_21_87_62,r_100_219_106,1.0,2,108,106,14
25,r_159_11_157,seq194,r_65_224_16,r_159_11_157,0.9,0,157,157,14
88,r_298_281_75,r_187_128_87,seq54,r_298_281_75,0.99,0,75,75,14
54,r_211_40_100,r_178_232_37,r_214_2_190,r_178_232_37,1.0,1,38,37,14
74,r_38_96_77,r_211_40_100,r_146_292_110,r_146_292_110,0.68,1,111,110,14
50,r_69_176_100,r_144_252_102,r_249_103_43,r_69_176_100,0.99,0,100,100,14
58,r_114_41_145,seq140,r_99_296_98,r_99_296_98,1.0,47,145,98,14
70,r_256_120_61,r_170_19_177,r_193_14_54,r_170_19_177,0.97,-116,61,177,14
10,r_42_53_32,r_66_108_65,seq194,r_42_53_32,0.99,0,32,32,14
38,r_58_282_88,r_227_244_157,seq132,r_58_282_88,1.0,0,88,88,14
52,r_162_216_167,seq102,r_253_95_103,r_253_95_103,0.72,64,167,103,14
77,r_168_229_150,r_133_67_37,r_114_41_145,r_168_229_150,0.78,0,150,150,14
2,r_193_14_54,seq117,seq102,r_193_14_54,1.0,0,54,54,14
169,seq208,seq6,r_99_296_98,r_99_296_98,1.0,16,114,98,14
33,r_249_103_43,r_196_251_115,seq26,r_249_103_43,1.0,1,44,43,14
34,r_109_207_128,r_162_216_167,seq81,r_109_207_128,1.0,1,129,128,14
84,r_186_295_26,r_119_209_34,seq6,r_186_295_26,0.98,0,26,26,14
75,r_55_263_133,seq63,seq9,r_55_263_133,1.0,0,133,133,14
85,r_173_169_19,r_137_212_32,seq79,r_173_169_19,0.74,0,19,19,14
35,r_30_202_173,r_253_95_103,r_88_267_65,r_30_202_173,1.0,0,173,173,14
60,r_136_138_168,seq6,r_193_14_54,r_193_14_54,0.63,115,169,54,14
17,r_189_92_107,seq111,seq165,r_189_92_107,0.99,0,107,107,14
94,r_126_247_95,seq105,r_193_14_54,r_126_247_95,1.0,1,96,95,14
61,r_171_199_20,r_189_92_107,seq182,r_171_199_20,0.59,0,20,20,14
9,r_239_213_179,seq73,r_187_128_87,r_187_128_87,0.99,92,179,87,14
96,r_144_252_102,seq54,r_231_27_4,r_144_252_102,1.0,0,102,102,14
54,r_211_40_100,r_214_2_190,r_210_78_149,r_211_40_100,0.66,-6,94,100,14
91,r_146_292_110,seq220,r_38_96_77,r_146_292_110,1.0,-2,108,110,14
7,r_196_251_115,r_285_93_131,seq86,r_196_251_115,1.0,0,115,115,14
44,r_43_259_153,seq195,r_172_147_11,r_43_259_153,0.73,0,153,153,14
189,seq278,r_214_2_190,r_32_235_46,r_32_235_46,1.0,24,70,46,14
82,r_227_244_157,seq294,r_223_161_43,r_227_244_157,1.0,0,157,157,14
35,r_30_202_173,r_116_70_159,r_253_95_103,r_253_95_103,1.0,15,118,103,14
12,r_160_12_103,r_276_151_115,seq82,r_160_12_103,0.97,0,103,103,14
182,seq261,r_217_198_163,r_16_221_58,r_16_221_58,0.97,106,164,58,14
16,r_22_28_15,r_21_185_98,seq188,r_22_28_15,1.0,0,15,15,15
23,r_250_115_28,r_21_185_98,seq207,r_250_115_28,0.95,0,28,28,15
92,r_24_33_116,seq164,seq119,r_24_33_116,0.74,3,119,116,15
14,r_219_260_145,seq220,r_160_280_130,r_219_260_145,0.98,1,146,145,15
17,r_59_118_50,seq201,seq81,r_59_118_50,1.0,0,50,50,15
53,r_90_49_97,seq214,seq207,r_90_49_97,1.0,0,97,97,15
43,r_106_77_144,seq289,seq162,r_106_77_144,0.9,1,145,144,15
55,r_16_253_23,r_153_257_149,seq74,r_16_253_23,1.0,0,23,23,15
54,r_202_129_144,seq6,r_190_87_76,r_202_129_144,0.72,4,148,144,15
41,r_54_229_32,r_255_72_30,r_22_28_15,r_54_229_32,0.64,56,88,32,15
37,r_160_280_130,seq67,seq132,r_160_280_130,0.9,0,130,130,15
59,r_156_294_82,r_24_33_116,seq195,r_156_294_82,0.89,6,88,82,15
98,r_184_295_174,r_273_53_89,r_54_229_32,r_184_295_174,0.91,0,174,174,15
86,r_61_259_82,r_283_58_142,seq152,r_61_259_82,0.6,5,87,82,15
39,r_124_46_111,seq137,r_250_115_28,r_124_46_111,0.96,0,111,111,15
1,r_298_104_74,seq109,seq35,r_298_104_74,1.0,0,74,74,15
97,r_200_261_108,seq189,r_291_96_81,r_200_261_108,0.98,1,109,108,15
5,r_21_185_98,r_278_254_171,r_266_91_199,r_21_185_98,1.0,0,98,98,15
104,seq6,r_202_129_144,seq105,r_202_129_144,0.99,4,148,144,15
46,r_127_274_163,r_93_282_4,r_145_206_88,r_127_274_163,0.68,2,165,163,15
42,r_27_99_123,seq52,seq11,r_27_99_123,1.0,0,123,123,15
80,r_122_224_186,seq95,r_273_53_89,r_273_53_89,1.0,97,186,89,15
32,r_198_36_48,r_26_231_185,r_64_246_42,r_26_231_185,0.72,-5,180,185,15
34,r_203_288_48,r_61_259_82,seq67,r_203_288_48,1.0,1,49,48,15
193,seq269,r_291_96_81,r_145_206_88,r_291_96_81,0.74,10,91,81,15
19,r_245_237_175,seq102,r_120_14_120,r_245_237_175,0.68,1,176,175,15
95,r_273_53_89,r_122_224_186,r_184_295_174,r_273_53_89,1.0,0,89,89,15
66,r_158_97_140,seq74,seq95,r_158_97_140,0.98,0,140,140,15
31,r_286_196_170,seq192,seq213,r_286_196_170,0.66,0,170,170,15
129,seq81,seq56,r_59_118_50,r_59_118_50,1.0,74,124,50,15
89,r_182_285_173,seq6,r_243_236_106,r_243_236_106,0.63,67,173,106,15
3,r_120_14_120,r_283_58_142,r_93_282_4,r_283_58_142,0.61,-22,120,142,15
10,r_63_186_89,seq105,r_290_40_59,r_63_186_89,0.98,0,89,89,15
174,seq213,r_293_108_72,r_61_259_82,r_293_108_72,0.93,0,72,72,15
4,r_55_3_140,seq148,r_1_7_22,r_55_3_140,0.76,4,144,140,15
78,r_121_292_173,seq269,r_21_185_98,r_21_185_98,1.0,75,173,98,15
0,r_153_257_149,r_79_111_195,r_209_147_107,r_209_147_107,0.98,38,145,107,15
73,r_278_254_171,seq210,r_130_141_1,r_278_254_171,0.49,0,171,171,15
11,r_8_194_195,seq176,r_264_139_146,r_264_139_146,1.0,8,154,146,15
98,r_184_295_174,r_287_174_134,r_273_53_89,r_273_53_89,0.68,45,134,89,15
71,r_178_60_49,r_149_138_88,r_283_58_142,r_178_60_49,0.99,0,49,49,15
15,r_223_179_134,seq25,seq34,r_223_179_134,1.0,0,134,134,15
48,r_131_17_107,seq146,seq51,r_131_17_107,1.0,0,107,107,15
70,r_283_58_142,r_266_91_199,r_63_186_89,r_283_58_142,1.0,0,142,142,15
57,r_293_108_72,seq213,seq5,r_293_108_72,1.0,0,72,72,15
85,r_73_84_25,r_127_274_163,seq102,r_73_84_25,1.0,1,26,25,15
99,r_251_172_70,r_122_224_186,seq171,r_251_172_70,0.99,0,70,70,15
52,r_26_231_185,r_198_36_48,seq112,r_198_36_48,0.79,137,185,48,15
51,r_177_263_41,r_21_185_98,seq68,r_177_263_41,1.0,1,42,41,15
134,seq95,r_122_224_186,r_276_20_42,r_276_20_42,0.99,144,186,42,15
9,r_276_20_42,seq13,r_248_128_18,r_276_20_42,1.0,0,42,42,15
136,seq102,r_245_237_175,r_85_142_89,r_85_142_89,0.98,79,168,89,15
38,r_64_246_42,seq119,seq48,r_64_246_42,1.0,0,42,42,15
172,seq207,seq100,r_90_49_97,r_90_49_97,1.0,23,120,97,15
106,seq12,seq116,r_242_225_23,r_242_225_23,1.0,3,26,23,15
52,r_26_231_185,r_163_222_197,r_198_36_48,r_26_231_185,0.55,-129,56,185,15
84,r_242_225_23,r_156_294_82,seq12,r_242_225_23,1.0,0,23,23,15
68,r_83_193_1,r_31_204_52,r_1_7_22,r_31_204_52,1.0,0,52,52,15
74,r_256_123_86,r_187_226_113,r_154_43_7,r_154_43_7,0.43,79,86,7,15
18,r_117_212_68,r_19_76_165,seq89,r_117_212_68,0.97,0,68,68,15
195,seq272,r_277_113_122,r_255_72_30,r_255_72_30,1.0,107,137,30,15
157,seq164,r_24_33_116,r_298_104_74,r_298_104_74,1.0,45,119,74,15
79,r_107_29_17,r_277_113_122,seq183,r_107_29_17,0.91,0,17,17,15
24,r_264_139_146,seq44,r_8_194_195,r_264_139_146,0.92,0,146,146,15
25,r_190_87_76,seq180,seq5,r_190_87_76,0.5,0,76,76,15
33,r_19_76_165,seq171,r_63_186_89,r_63_186_89,1.0,83,172,89,15
29,r_135_271_55,seq214,seq94,r_135_271_55,1.0,0,55,55,15
64,r_287_174_134,r_184_295_174,r_1_7_22,r_287_174_134,0.88,0,134,134,15
41,r_54_229_32,r_31_204_52,r_184_295_174,r_184_295_174,1.0,2,176,174,15
88,r_42_143_141,seq192,r_223_179_134,r_42_143_141,0.55,0,141,141,15
50,r_75_101_68,r_160_280_130,seq230,r_75_101_68,0.76,0,68,68,15
58,r_205_181_103,r_122_224_186,seq144,r_205_181_103,1.0,0,103,103,15
70,r_283_58_142,r_61_259_82,r_266_91_199,r_61_259_82,0.52,2,84,82,15
65,r_166_170_151,r_184_295_174,r_177_263_41,r_166_170_151,0.66,0,151,151,15
41,r_54_229_32,r_22_28_15,r_31_204_52,r_54_229_32,0.6,114,146,32,15
77,r_151_281_153,seq68,r_63_186_89,r_63_186_89,0.81,64,153,89,15
67,r_50_38_52,r_243_236_106,seq183,r_50_38_52,1.0,0,52,52,15
45,r_255_72_30,seq116,seq272,r_255_72_30,1.0,0,30,30,15
71,r_178_60_49,r_283_58_142,r_279_211_89,r_178_60_49,1.0,52,101,49,15
75,r_15_66_72,r_57_70_67,r_93_282_4,r_15_66_72,1.0,0,72,72,15
32,r_198_36_48,r_283_58_142,r_26_231_185,r_198_36_48,0.65,0,48,48,15
60,r_238_168_183,seq137,r_85_142_89,r_85_142_89,1.0,94,183,89,15
81,r_9_244_111,seq144,r_85_142_89,r_85_142_89,1.0,35,124,89,15
61,r_1_7_22,r_248_128_18,r_83_193_1,r_83_193_1,0.64,15,16,1,15
93,r_31_204_52,r_83_193_1,seq191,r_31_204_52,1.0,0,52,52,15
96,r_149_138_88,seq173,r_73_84_25,r_149_138_88,0.78,0,88,88,15
133,seq94,r_145_206_88,r_135_271_55,r_135_271_55,1.0,49,104,55,15
21,r_69_252_49,r_26_231_185,seq221,r_69_252_49,1.0,0,49,49,15
22,r_86_133_111,seq144,r_15_66_72,r_86_133_111,0.96,0,111,111,15
28,r_262_110_90,r_86_133_111,seq5,r_262_110_90,1.0,0,90,90,15
91,r_209_147_107,r_55_3_140,seq67,r_209_147_107,1.0,0,107,107,15
49,r_85_142_89,r_92_103_192,seq109,r_85_142_89,0.99,0,89,89,15
152,seq148,r_55_3_140,r_178_60_49,r_178_60_49,1.0,95,144,49,15
7,r_187_226_113,seq176,r_284_234_35,r_187_226_113,0.98,1,114,113,15
44,r_277_113_122,seq272,r_177_263_41,r_177_263_41,1.0,90,131,41,15
131,seq88,seq213,r_61_259_82,r_61_259_82,0.99,12,94,82,15
41,r_54_229_32,r_86_133_111,r_255_72_30,r_86_133_111,1.0,-79,32,111,15
36,r_41_215_59,r_106_77_144,seq47,r_41_215_59,1.0,0,59,59,15
12,r_30_10_189,seq71,r_21_185_98,r_21_185_98,0.6,91,189,98,15
95,r_273_53_89,r_184_295_174,r_122_224_186,r_273_53_89,0.79,98,187,89,15
6,r_157_165_48,r_30_10_189,seq89,r_157_165_48,1.0,0,48,48,15
23,r_250_115_28,seq207,r_124_46_111,r_124_46_111,1.0,13,124,111,15
51,r_87_91_102,seq78,r_271_230_89,r_87_91_102,0.96,1,103,102,16
36,r_48_126_156,seq41,r_224_36_18,r_48_126_156,0.94,0,156,156,16
119,seq59,r_28_7_34,r_281_11_193,r_28_7_34,0.63,-1,33,34,16
17,r_284_88_58,r_271_230_89,seq138,r_284_88_58,1.0,-1,57,58,16
92,r_287_23_123,seq69,seq248,r_287_23_123,0.85,0,123,123,16
8,r_155_169_138,r_247_244_156,r_197_42_60,r_155_169_138,0.86,0,138,138,16
52,r_195_299_25,r_155_169_138,seq111,r_195_299_25,1.0,0,25,25,16
37,r_224_36_18,r_228_104_79,seq27,r_224_36_18,1.0,-1,17,18,16
76,r_183_3_107,r_281_11_193,r_28_7_34,r_183_3_107,0.76,-30,77,107,16
83,r_249_245_83,r_20_158_110,seq293,r_249_245_83,0.97,1,84,83,16
76,r_183_3_107,r_28_7_34,r_202_65_59,r_183_3_107,0.99,2,109,107,16
55,r_222_223_89,seq26,seq256,r_222_223_89,0.99,0,89,89,16
71,r_273_179_142,r_237_68_159,seq132,r_273_179_142,0.98,1,143,142,16
39,r_260_125_103,seq90,r_224_36_18,r_260_125_103,0.98,0,103,103,16
143,seq138,seq34,r_284_88_58,r_284_88_58,1.0,55,113,58,16
5,r_0_105_132,r_39_187_146,seq52,r_0_105_132,0.92,0,132,132,16
46,r_129_272_80,r_175_99_164,r_159_168_53,r_129_272_80,0.88,1,81,80,16
42,r_45_211_110,seq113,seq84,r_45_211_110,1.0,0,110,110,16
57,r_124_192_40,seq52,r_28_7_34,r_124_192_40,1.0,1,41,40,16
69,r_180_89_103,r_79_118_124,r_106_233_3,r_106_233_3,0.62,100,103,3,16
87,r_148_60_22,r_83_194_104,r_14_100_155,r_148_60_22,1.0,0,22,22,16
19,r_189_73_187,seq116,r_35_285_150,r_35_285_150,0.64,37,187,150,16
77,r_251_199_186,r_268_5_116,r_182_53_66,r_251_199_186,0.79,0,186,186,16
199,seq298,r_50_121_50,r_191_141_190,r_50_121_50,0.98,0,50,50,16
95,r_184_58_103,r_115_226_117,r_197_42_60,r_197_42_60,1.0,12,72,60,16
66,r_198_254_102,r_234_10_138,r_224_36_18,r_198_254_102,0.91,9,111,102,16
76,r_183_3_107,seq80,r_281_11_193,r_183_3_107,0.59,-46,61,107,16
100,seq4,r_146_282_116,seq15,r_146_282_116,0.7,0,116,116,16
97,r_14_100_155,r_148_60_22,r_190_31_146,r_14_100_155,0.99,0,155,155,16
59,r_67_262_13,r_37_108_198,seq34,r_67_262_13,1.0,0,13,13,16
89,r_247_244_156,seq12,r_37_108_198,r_247_244_156,0.95,0,156,156,16
20,r_246_81_17,r_79_118_124,seq218,r_246_81_17,1.0,0,17,17,16
3,r_66_142_63,r_234_10_138,seq161,r_66_142_63,1.0,0,63,63,16
10,r_297_149_111,r_57_295_174,r_136_24_89,r_297_149_111,0.84,0,111,111,16
173,seq218,r_191_141_190,r_8_250_37,r_8_250_37,1.0,0,37,37,16
26,r_136_24_89,seq29,r_167_289_75,r_136_24_89,0.89,2,91,89,16
72,r_167_289_75,r_20_158_110,seq210,r_167_289_75,1.0,-1,74,75,16
174,seq221,r_137_120_187,r_222_223_89,r_222_223_89,1.0,61,150,89,16
4,r_283_238_111,r_259_257_121,seq294,r_283_238_111,0.97,0,111,111,16
78,r_119_130_152,r_122_215_160,r_77_40_92,r_77_40_92,0.96,61,153,92,16
0,r_63_217_177,seq32,r_271_230_89,r_271_230_89,1.0,88,177,89,16
11,r_173_201_117,r_251_199_186,seq205,r_173_201_117,1.0,0,117,117,16
13,r_190_31_146,seq132,r_75_17_13,r_190_31_146,0.62,3,149,146,16
25,r_202_65_59,seq248,seq264,r_202_65_59,1.0,0,59,59,16
98,r_235_140_167,seq177,r_146_282_116,r_235_140_167,0.48,1,168,167,16
15,r_134_101_118,seq263,seq205,r_134_101_118,0.79,5,123,118,16
48,r_252_43_119,seq294,r_240_242_83,r_252_43_119,0.98,1,120,119,16
14,r_181_229_48,r_117_204_55,seq138,r_181_229_48,1.0,0,48,48,16
62,r_228_104_79,r_273_179_142,seq298,r_228_104_79,0.97,2,81,79,16
119,seq59,r_281_11_193,seq210,r_281_11_193,0.33,-103,90,193,16
141,seq132,r_190_31_146,seq170,r_190_31_146,0.49,-81,65,146,16
2,r_159_168_53,r_0_105_132,r_129_272_80,r_0_105_132,0.89,-9,123,132,16
43,r_117_204_55,r_181_229_48,seq133,r_181_229_48,1.0,-1,47,48,16
67,r_186_1_47,seq64,r_156_13_5,r_186_1_47,0.99,0,47,47,16
99,r_110_95_67,r_191_141_190,seq78,r_110_95_67,1.0,0,67,67,16
87,r_148_60_22,r_14_100_155,r_139_154_132,r_148_60_22,0.79,134,156,22,16
91,r_115_226_117,r_143_266_182,r_28_7_34,r_115_226_117,0.97,3,120,117,16
27,r_271_230_89,r_137_120_187,seq62,r_271_230_89,1.0,0,89,89,16
199,seq298,r_191_141_190,r_228_104_79,r_228_104_79,0.96,3,82,79,16
21,r_239_109_31,r_159_168_53,seq18,r_239_109_31,0.92,-2,29,31,16
18,r_197_42_60,r_72_46_8,r_155_169_138,r_155_169_138,0.93,6,144,138,16
60,r_163_292_18,r_134_101_118,seq29,r_163_292_18,0.79,-1,17,18,16
47,r_291_30_83,r_77_40_92,seq116,r_291_30_83,1.0,0,83,83,16
93,r_22_213_21,r_131_102_187,r_273_179_142,r_273_179_142,0.87,45,187,142,16
74,r_160_232_149,r_281_11_193,r_151_243_110,r_281_11_193,1.0,-44,149,193,16
18,r_197_42_60,r_20_158_110,r_184_58_103,r_197_42_60,0.68,1,61,60,16
29,r_182_53_66,seq18,seq288,r_182_53_66,1.0,0,66,66,16
195,seq288,r_139_154_132,r_182_53_66,r_182_53_66,1.0,67,133,66,16
24,r_156_13_5,r_251_199_186,r_186_1_47,r_186_1_47,1.0,100,147,47,16
96,r_8_250_37,r_284_88_58,seq218,r_8_250_37,0.94,0,37,37,16
64,r_20_158_110,seq27,seq171,r_20_158_110,1.0,0,110,110,16
90,r_131_102_187,r_190_31_146,r_22_213_21,r_22_213_21,1.0,0,21,21,16
50,r_234_10_138,seq111,r_134_101_118,r_234_10_138,0.99,0,138,138,16
58,r_77_40_92,seq170,r_246_81_17,r_77_40_92,0.99,-1,91,92,16
70,r_16_220_108,r_57_295_174,r_239_109_31,r_16_220_108,1.0,1,109,108,16
65,r_139_154_132,seq288,r_174_97_7,r_139_154_132,0.74,1,133,132,16
95,r_184_58_103,r_197_42_60,r_182_53_66,r_184_58_103,1.0,1,104,103,16
68,r_143_266_182,r_178_2_191,r_66_142_63,r_66_142_63,0.85,118,181,63,16
93,r_22_213_21,r_281_11_193,r_131_102_187,r_22_213_21,1.0,0,21,21,16
61,r_70_61_173,seq26,r_182_53_66,r_70_61_173,0.79,0,173,173,16
32,r_103_96_119,seq19,seq207,r_103_96_119,1.0,0,119,119,16
40,r_275_38_43,r_93_265_117,seq41,r_275_38_43,0.93,-2,41,43,16
38,r_146_282_116,seq4,seq33,r_146_282_116,0.96,0,116,116,16
77,r_251_199_186,r_173_201_117,r_268_5_116,r_251_199_186,1.0,-70,116,186,16
18,r_197_42_60,r_184_58_103,r_72_46_8,r_184_58_103,0.73,1,104,103,16
34,r_6_107_172,seq15,r_45_211_110,r_6_107_172,0.7,0,172,172,16
97,r_14_100_155,r_174_97_7,r_148_60_22,r_148_60_22,1.0,1,23,22,16
75,r_47_56_152,seq113,seq64,r_47_56_152,0.95,1,153,152,16
81,r_268_5_116,r_143_266_182,r_222_223_89,r_268_5_116,0.95,3,119,116,16
2,r_159_168_53,r_66_142_63,r_0_105_132,r_0_105_132,1.0,-79,53,132,16
179,seq248,r_202_65_59,r_79_118_124,r_202_65_59,0.77,-4,55,59,16
94,r_93_265_117,seq205,r_246_81_17,r_246_81_17,0.48,106,123,17,16
9,r_151_243_110,r_251_199_186,seq98,r_151_243_110,0.94,0,110,110,16
86,r_92_280_16,r_20_158_110,seq170,r_92_280_16,0.99,1,17,16,16
90,r_131_102_187,r_22_213_21,seq90,r_22_213_21,0.47,166,187,21,16
28,r_79_118_124,seq15,seq85,r_79_118_124,0.99,1,125,124,16
7,r_50_121_50,seq298,seq196,r_50_121_50,1.0,0,50,50,16
91,r_115_226_117,r_184_58_103,r_143_266_182,r_184_58_103,0.85,-31,72,103,16
164,seq205,r_93_265_117,r_173_201_117,r_173_201_117,0.65,6,123,117,16
49,r_28_7_34,seq59,seq114,r_28_7_34,0.99,1,35,34,16
56,r_39_187_146,seq210,seq278,r_39_187_146,0.89,0,146,146,16
44,r_259_257_121,seq127,r_103_96_119,r_259_257_121,0.95,0,121,121,16
23,r_240_242_83,seq18,seq177,r_240_242_83,1.0,0,83,83,16
138,seq116,seq111,r_291_30_83,r_291_30_83,1.0,4,87,83,16
82,r_237_68_159,seq161,r_28_7_34,r_237_68_159,0.53,8,167,159,16
35,r_83_194_104,r_45_211_110,seq15,r_83_194_104,1.0,-1,103,104,16
12,r_71_274_115,seq200,seq69,r_71_274_115,0.94,0,115,115,16
84,r_122_215_160,seq85,r_146_282_116,r_122_215_160,0.72,1,161,160,16
30,r_165_256_177,seq229,r_56_52_6,r_165_256_177,0.78,0,177,177,17
51,r_275_183_131,seq191,r_36_198_65,r_275_183_131,0.98,0,131,131,17
36,r_84_18_71,seq121,r_144_118_14,r_84_18_71,0.68,-8,63,71,17
92,r_237_0_119,seq55,r_188_38_43,r_188_38_43,1.0,31,74,43,17
53,r_215_19_106,seq3,r_204_14_62,r_215_19_106,1.0,0,106,106,17
43,r_44_133_76,r_108_245_127,r_217_93_188,r_44_133_76,1.0,0,76,76,17
197,seq289,r_184_74_178,r_206_39_68,r_206_39_68,1.0,29,97,68,17
18,r_154_279_30,r_87_107_75,seq178,r_154_279_30,0.86,4,34,30,17
37,r_236_27_35,r_269_112_159,seq231,r_236_27_35,0.97,0,35,35,17
3,r_71_90_188,r_135_51_63,r_56_52_6,r_71_90_188,1.0,0,188,188,17
59,r_258_64_113,seq98,seq151,r_258_64_113,0.99,0,113,113,17
55,r_197_294_60,seq78,seq46,r_197_294_60,0.69,29,89,60,17
71,r_254_149_132,r_130_175_6,r_219_211_126,r_254_149_132,1.0,0,132,132,17
16,r_293_172_159,seq229,r_109_233_15,r_293_172_159,0.79,0,159,159,17
21,r_89_117_69,r_293_172_159,r_48_252_10,r_89_117_69,1.0,0,69,69,17
1,r_150_148_98,seq156,seq173,r_150_148_98,1.0,0,98,98,17
97,r_195_17_165,seq213,r_44_133_76,r_44_133_76,0.67,89,165,76,17
143,seq128,seq121,r_87_107_75,r_87_107_75,0.85,9,84,75,17
85,r_147_207_28,r_58_115_180,seq271,r_147_207_28,0.99,0,28,28,17
46,r_155_11_78,r_58_115_180,r_24_221_20,r_155_11_78,0.98,1,79,78,17
42,r_66_125_77,r_31_160_191,r_109_233_15,r_66_125_77,0.5,4,81,77,17
80,r_212_250_139,r_184_74_178,r_242_272_35,r_184_74_178,0.92,-39,139,178,17
88,r_135_51_63,r_71_90_188,r_258_64_113,r_258_64_113,0.93,75,188,113,17
69,r_132_94_143,seq8,seq33,r_132_94_143,0.84,0,143,143,17
45,r_36_198_65,r_174_287_184,r_197_294_60,r_36_198_65,0.77,1,66,65,17
10,r_188_38_43,r_214_276_74,seq45,r_188_38_43,1.0,0,43,43,17
19,r_114_265_125,r_123_73_150,r_170_102_126,r_114_265_125,1.0,1,126,125,17
75,r_262_120_38,r_86_142_112,seq98,r_262_120_38,0.98,0,38,38,17
158,seq178,r_220_122_63,r_154_279_30,r_220_122_63,0.76,0,63,63,17
11,r_220_122_63,seq3,r_9_12_106,r_9_12_106,1.0,22,128,106,17
27,r_255_26_16,r_215_19_106,r_218_29_89,r_255_26_16,0.77,80,96,16,17
76,r_158_95_95,r_104_230_162,seq13,r_158_95_95,1.0,0,95,95,17
31,r_200_77_86,r_131_103_178,seq260,r_200_77_86,0.98,0,86,86,17
41,r_65_171_176,r_10_283_190,r_248_111_65,r_10_283_190,0.65,-14,176,190,17
67,r_1_157_148,seq22,seq119,r_1_157_148,0.97,0,148,148,17
89,r_87_107_75,seq164,seq128,r_87_107_75,0.93,3,78,75,17
3,r_71_90_188,seq151,r_135_51_63,r_135_51_63,1.0,61,124,63,17
24,r_82_126_21,r_104_230_162,seq41,r_82_126_21,1.0,0,21,21,17
26,r_85_227_80,r_296_6_174,seq32,r_85_227_80,1.0,0,80,80,17
72,r_206_39_68,seq106,seq169,r_206_39_68,1.0,0,68,68,17
4,r_104_230_162,seq59,r_228_222_75,r_104_230_162,0.78,0,162,162,17
0,r_58_115_180,r_155_11_78,r_214_276_74,r_58_115_180,0.78,-101,79,180,17
11,r_220_122_63,seq178,seq3,r_220_122_63,1.0,0,63,63,17
104,seq15,seq199,r_91_76_20,r_91_76_20,1.0,8,28,20,17
107,seq25,seq173,r_86_142_112,r_86_142_112,0.78,-50,62,112,17
57,r_285_21_155,seq46,r_219_211_126,r_219_211_126,0.78,0,126,126,17
13,r_251_266_89,r_270_264_195,seq55,r_251_266_89,1.0,0,89,89,17
73,r_281_63_44,seq53,seq88,r_281_63_44,0.99,0,44,44,17
48,r_184_74_178,r_212_250_139,r_206_39_68,r_206_39_68,0.85,71,139,68,17
57,r_285_21_155,r_291_286_88,seq46,r_291_286_88,0.87,1,89,88,17
181,seq240,r_228_222_75,r_168_47_29,r_168_47_29,0.81,48,77,29,17
6,r_10_283_190,seq263,r_56_52_6,r_10_283_190,0.42,0,190,190,17
65,r_180_35_22,seq128,seq229,r_180_35_22,0.97,0,22,22,17
62,r_194_2_180,seq231,r_155_11_78,r_155_11_78,0.89,103,181,78,17
99,r_225_72_93,r_1_157_148,r_182_62_48,r_225_72_93,1.0,0,93,93,17
0,r_58_115_180,r_214_276_74,r_147_207_28,r_58_115_180,0.88,0,180,180,17
87,r_48_252_10,r_141_298_69,r_89_117_69,r_89_117_69,1.0,4,73,69,17
57,r_285_21_155,r_219_211_126,seq34,r_285_21_155,0.95,0,155,155,17
77,r_168_47_29,r_159_134_88,seq240,r_168_47_29,0.95,0,29,29,17
172,seq213,r_195_17_165,r_281_63_44,r_281_63_44,0.7,121,165,44,17
54,r_242_272_35,r_131_103_178,seq106,r_242_272_35,0.98,0,35,35,17
47,r_123_73_150,r_105_124_173,r_239_5_109,r_239_5_109,0.85,46,155,109,17
105,seq16,r_7_246_153,r_123_73_150,r_7_246_153,0.85,0,153,153,17
29,r_140_247_122,r_194_2_180,seq243,r_140_247_122,0.58,7,129,122,17
93,r_143_70_36,r_188_38_43,r_144_118_14,r_143_70_36,1.0,1,37,36,17
33,r_204_14_62,r_114_265_125,seq253,r_204_14_62,1.0,0,62,62,17
64,r_9_12_106,r_114_265_125,r_220_122_63,r_9_12_106,1.0,0,106,106,17
54,r_242_272_35,seq106,r_159_134_88,r_159_134_88,1.0,4,92,88,17
98,r_182_62_48,r_131_103_178,seq208,r_182_62_48,1.0,0,48,48,17
88,r_135_51_63,r_202_167_88,r_71_90_188,r_202_167_88,0.53,-20,68,88,17
50,r_299_137_66,seq4,seq280,r_299_137_66,0.99,0,66,66,17
58,r_269_112_159,seq69,r_277_152_28,r_277_152_28,0.49,132,160,28,17
70,r_219_211_126,seq50,r_285_21_155,r_219_211_126,0.74,0,126,126,17
91,r_282_49_39,r_66_125_77,r_91_76_20,r_282_49_39,0.96,2,41,39,17
155,seq169,r_184_74_178,r_291_286_88,r_291_286_88,1.0,1,89,88,17
68,r_170_102_126,r_237_0_119,seq199,r_170_102_126,0.93,2,128,126,17
81,r_109_233_15,r_168_47_29,seq121,r_109_233_15,0.99,0,15,15,17
61,r_105_124_173,seq113,r_56_52_6,r_105_124_173,0.75,1,174,173,17
84,r_163_297_28,r_174_287_184,seq81,r_163_297_28,0.95,6,34,28,17
32,r_226_288_162,seq41,r_123_73_150,r_226_288_162,0.77,0,162,162,17
63,r_144_118_14,r_206_39_68,seq59,r_144_118_14,1.0,0,14,14,17
38,r_108_245_127,r_1_157_148,r_218_29_89,r_1_157_148,0.6,-21,127,148,17
52,r_291_286_88,r_285_21_155,seq169,r_291_286_88,0.77,1,89,88,17
87,r_48_252_10,r_140_247_122,r_141_298_69,r_48_252_10,0.87,0,10,10,17
196,seq280,r_141_298_69,r_299_137_66,r_299_137_66,1.0,11,77,66,17
34,r_101_209_181,seq295,r_204_14_62,r_204_14_62,0.99,119,181,62,17
15,r_146_177_28,r_158_95_95,seq57,r_146_177_28,1.0,0,28,28,17
60,r_7_246_153,seq16,r_109_233_15,r_7_246_153,0.85,0,153,153,17
48,r_184_74_178,r_206_39_68,r_56_52_6,r_184_74_178,1.0,0,178,178,17
192,seq271,seq33,r_147_207_28,r_147_207_28,0.99,5,33,28,17
17,r_214_276_74,seq145,r_58_115_180,r_214_276_74,0.95,0,74,74,17
27,r_255_26_16,r_147_207_28,r_215_19_106,r_255_26_16,0.91,0,16,16,17
94,r_159_134_88,seq203,r_242_272_35,r_159_134_88,0.98,0,88,88,17
9,r_131_103_178,seq13,r_89_117_69,r_89_117_69,1.0,110,179,69,17
120,seq55,r_237_0_119,r_251_266_89,r_251_266_89,1.0,46,135,89,17
70,r_219_211_126,r_285_21_155,r_254_149_132,r_285_21_155,0.96,0,155,155,17
95,r_277_152_28,r_196_284_187,seq274,r_277_152_28,0.98,3,31,28,17
49,r_42_238_185,seq231,seq190,r_42_238_185,0.58,0,185,185,17
149,seq151,r_71_90_188,r_258_64_113,r_258_64_113,1.0,11,124,113,17
56,r_290_161_170,seq162,r_140_247_122,r_290_161_170,0.83,0,170,170,17
7,r_181_244_90,seq67,seq22,r_181_244_90,1.0,0,90,90,17
23,r_218_29_89,r_10_283_190,seq235,r_218_29_89,1.0,2,91,89,17
189,seq263,r_10_283_190,r_42_238_185,r_42_238_185,0.89,5,190,185,17
17,r_214_276_74,r_58_115_180,r_130_175_6,r_58_115_180,0.92,0,180,180,17
82,r_196_284_187,seq69,r_214_276_74,r_196_284_187,0.42,1,188,187,17
79,r_248_111_65,r_30_23_181,seq259,r_248_111_65,0.91,1,66,65,17
35,r_228_222_75,seq240,seq113,r_228_222_75,0.83,0,75,75,17
5,r_61_79_25,r_30_23_181,seq3,r_61_79_25,0.99,9,34,25,17
66,r_24_221_20,r_61_79_25,seq223,r_24_221_20,0.69,0,20,20,17
74,r_91_76_20,r_146_177_28,seq15,r_91_76_20,0.99,0,20,20,17
199,seq295,r_101_209_181,r_44_133_76,r_44_133_76,1.0,93,169,76,17
30,r_139_242_127,r_36_172_177,r_274_251_71,r_139_242_127,1.0,4,131,127,18
92,r_8_230_65,r_184_218_196,r_248_170_19,r_8_230_65,1.0,0,65,65,18
66,r_22_292_54,r_139_242_127,seq231,r_22_292_54,1.0,1,55,54,18
8,r_41_247_132,seq199,seq0,r_41_247_132,0.96,1,133,132,18
60,r_299_68_14,r_73_155_191,seq133,r_299_68_14,0.91,-1,13,14,18
43,r_32_95_78,seq238,r_154_152_57,r_32_95_78,1.0,2,80,78,18
83,r_255_183_120,seq136,seq168,r_255_183_120,0.62,0,120,120,18
116,seq44,r_224_23_96,seq90,r_224_23_96,1.0,0,96,96,18
37,r_81_94_146,r_210_198_199,r_157_179_159,r_81_94_146,0.61,0,146,146,18
51,r_47_103_51,r_102_164_112,r_126_45_62,r_102_164_112,0.56,0,112,112,18
54,r_107_146_40,r_241_124_177,seq62,r_107_146_40,0.57,0,40,40,18
141,seq133,r_299_68_14,r_169_283_83,r_169_283_83,1.0,15,98,83,18
55,r_200_122_62,seq133,seq54,r_200_122_62,1.0,1,63,62,18
16,r_178_99_91,seq46,r_22_292_54,r_178_99_91,1.0,0,91,91,18
39,r_201_137_164,seq63,seq271,r_201_137_164,0.57,0,164,164,18
97,r_206_35_128,seq264,r_105_28_98,r_206_35_128,0.98,2,130,128,18
5,r_241_124_177,r_150_108_165,r_188_76_108,r_188_76_108,0.46,22,130,108,18
69,r_16_89_123,seq264,seq275,r_16_89_123,1.0,0,123,123,18
45,r_282_240_99,seq83,seq163,r_282_240_99,0.88,1,100,99,18
31,r_166_182_49,r_171_295_181,seq253,r_166_182_49,0.95,3,52,49,18
193,seq286,r_114_82_47,r_196_197_53,r_196_197_53,1.0,11,64,53,18
22,r_88_162_31,seq275,seq31,r_88_162_31,0.99,0,31,31,18
4,r_145_208_12,r_270_185_188,r_158_175_196,r_145_208_12,0.74,0,12,12,18
59,r_70_250_15,r_3_277_15,seq265,r_70_250_15,0.7,-2,13,15,18
64,r_154_152_57,r_262_223_197,r_148_280_8,r_154_152_57,1.0,0,57,57,18
89,r_106_239_164,r_4_9_5,seq12,r_106_239_164,0.65,0,164,164,18
10,r_207_174_126,seq291,r_102_164_112,r_207_174_126,0.92,0,126,126,18
90,r_141_14_167,seq118,r_25_93_62,r_25_93_62,0.99,105,167,62,18
63,r_126_45_62,r_210_198_199,r_47_103_51,r_126_45_62,1.0,0,62,62,18
11,r_49_177_180,seq265,r_139_242_127,r_49_177_180,0.76,0,180,180,18
13,r_105_28_98,r_106_239_164,r_71_125_4,r_105_28_98,0.98,0,98,98,18
5,r_241_124_177,r_188_76_108,r_42_33_177,r_241_124_177,0.54,2,179,177,18
15,r_25_93_62,r_282_240_99,seq246,r_25_93_62,1.0,0,62,62,18
48,r_92_26_154,r_100_215_6,seq46,r_92_26_154,0.87,0,154,154,18
57,r_102_164_112,seq189,seq61,r_102_164_112,0.57,0,112,112,18
0,r_3_277_15,r_105_28_98,seq254,r_3_277_15,0.73,-2,13,15,18
6,r_224_23_96,seq44,seq98,r_224_23_96,0.99,0,96,96,18
62,r_249_96_57,seq78,r_100_215_6,r_249_96_57,0.8,3,60,57,18
141,seq133,r_200_122_62,r_299_68_14,r_200_122_62,1.0,1,63,62,18
85,r_148_280_8,r_71_125_4,r_154_152_57,r_154_152_57,1.0,10,67,57,18
99,r_43_138_171,r_156_290_199,seq17,r_43_138_171,0.4,0,171,171,18
21,r_261_144_14,r_156_290_199,seq199,r_261_144_14,0.99,0,14,14,18
28,r_65_120_170,r_234_149_110,r_79_109_35,r_65_120_170,1.0,0,170,170,18
33,r_77_128_167,r_79_109_35,r_129_72_38,r_77_128_167,0.86,1,168,167,18
26,r_129_72_38,r_16_89_123,r_58_167_40,r_129_72_38,1.0,3,41,38,18
87,r_150_108_165,seq10,r_100_215_6,r_150_108_165,0.82,0,165,165,18
79,r_158_175_196,seq17,r_145_208_12,r_158_175_196,0.64,-171,25,196,18
47,r_127_24_123,seq27,seq1,r_127_24_123,0.87,0,123,123,18
40,r_186_75_92,r_157_179_159,r_52_18_21,r_186_75_92,0.98,2,94,92,18
126,seq66,r_234_149_110,r_188_76_108,r_234_149_110,1.0,-6,104,110,18
74,r_132_53_140,r_100_215_6,r_245_134_75,r_100_215_6,0.98,137,143,6,18
18,r_171_295_181,seq291,seq191,r_171_295_181,0.57,0,181,181,18
29,r_169_283_83,seq263,seq133,r_169_283_83,1.0,0,83,83,18
190,seq275,r_88_162_31,r_139_242_127,r_88_162_31,0.99,0,31,31,18
33,r_77_128_167,r_285_195_153,r_79_109_35,r_79_109_35,0.82,118,153,35,18
88,r_36_172_177,seq222,r_88_162_31,r_88_162_31,1.0,147,178,31,18
50,r_234_149_110,seq66,r_169_283_83,r_234_149_110,0.81,1,111,110,18
58,r_245_134_75,r_274_251_71,seq27,r_245_134_75,1.0,1,76,75,18
70,r_274_251_71,seq264,r_284_115_198,r_274_251_71,0.68,1,72,71,18
61,r_57_229_160,r_171_295_181,r_100_215_6,r_57_229_160,0.57,0,160,160,18
32,r_67_101_190,r_156_290_199,r_105_28_98,r_67_101_190,0.38,0,190,190,18
158,seq199,r_270_185_188,r_261_144_14,r_261_144_14,1.0,3,17,14,18
78,r_52_18_21,r_69_117_195,seq264,r_52_18_21,0.96,0,21,21,18
38,r_285_195_153,r_77_128_167,seq237,r_285_195_153,0.81,0,153,153,18
52,r_181_153_65,r_260_55_166,seq233,r_260_55_166,0.89,-97,69,166,18
93,r_196_197_53,r_171_295_181,seq286,r_196_197_53,1.0,1,54,53,18
77,r_142_243_84,r_147_30_190,r_58_167_40,r_142_243_84,1.0,0,84,84,18
71,r_87_202_53,r_184_218_196,seq238,r_87_202_53,1.0,0,53,53,18
72,r_244_293_43,r_169_283_83,seq238,r_244_293_43,1.0,2,45,43,18
19,r_79_109_35,seq289,r_156_290_199,r_79_109_35,1.0,0,35,35,18
41,r_193_217_15,r_49_177_180,seq10,r_193_217_15,0.85,0,15,15,18
150,seq163,seq286,r_276_38_122,r_276_38_122,0.96,10,132,122,18
17,r_284_115_198,seq21,r_274_251_71,r_274_251_71,0.77,38,109,71,18
119,seq54,r_257_258_58,r_200_122_62,r_200_122_62,0.97,3,65,62,18
173,seq237,r_42_33_177,r_2_298_87,r_2_298_87,1.0,91,178,87,18
34,r_58_167_40,seq84,seq12,r_58_167_40,1.0,0,40,40,18
95,r_50_64_17,r_49_177_180,seq205,r_50_64_17,0.86,0,17,17,18
94,r_123_111_38,r_47_103_51,seq97,r_123_111_38,0.98,1,39,38,18
51,r_47_103_51,seq238,r_102_164_112,r_47_103_51,0.9,3,54,51,18
9,r_257_258_58,seq54,seq39,r_257_258_58,0.95,2,60,58,18
96,r_276_38_122,r_270_185_188,seq163,r_276_38_122,0.96,0,122,122,18
53,r_236_116_53,r_206_35_128,seq265,r_236_116_53,0.7,1,54,53,18
28,r_65_120_170,r_139_242_127,r_234_149_110,r_65_120_170,0.94,-50,120,170,18
3,r_248_170_19,r_207_174_126,seq118,r_248_170_19,0.86,0,19,19,18
56,r_74_173_188,r_184_218_196,r_73_155_191,r_184_218_196,0.38,-8,188,196,18
23,r_157_179_159,r_186_75_92,r_87_202_53,r_157_179_159,0.99,-65,94,159,18
106,seq12,r_158_175_196,r_58_167_40,r_58_167_40,1.0,1,41,40,18
82,r_7_15_168,seq265,seq180,r_7_15_168,0.69,1,169,168,18
46,r_80_13_15,r_69_117_195,seq6,r_69_117_195,0.61,-139,56,195,18
35,r_228_48_109,r_42_33_177,r_105_28_98,r_228_48_109,1.0,0,109,109,18
12,r_2_298_87,seq61,r_261_144_14,r_2_298_87,1.0,1,88,87,18
84,r_226_232_85,r_139_242_127,seq12,r_226_232_85,1.0,0,85,85,18
30,r_193_199_114,seq282,r_256_152_67,r_256_152_67,1.0,48,115,67,19
36,r_250_29_120,seq185,r_182_137_133,r_250_29_120,0.63,10,130,120,19
52,r_62_276_58,seq106,seq2,r_62_276_58,0.85,1,59,58,19
92,r_103_173_153,r_259_8_66,seq226,r_259_8_66,1.0,0,66,66,19
43,r_66_82_156,seq255,r_81_114_10,r_66_82_156,0.85,2,158,156,19
37,r_135_42_179,seq159,seq234,r_135_42_179,0.69,0,179,179,19
122,seq73,r_56_224_37,r_5_145_129,r_56_224_37,1.0,2,39,37,19
83,r_31_227_11,r_278_245_167,r_229_188_4,r_31_227_11,1.0,0,11,11,19
188,seq274,r_182_137_133,r_184_54_64,r_184_54_64,1.0,72,136,64,19
16,r_182_137_133,seq274,r_250_29_120,r_182_137_133,0.69,3,136,133,19
21,r_184_54_64,seq211,r_259_8_66,r_184_54_64,1.0,0,64,64,19
39,r_57_27_98,r_209_84_115,r_256_152_67,r_209_84_115,1.0,-16,99,115,19
1,r_28_19_61,r_21_23_122,r_230_277_28,r_230_277_28,0.55,47,75,28,19
97,r_203_275_68,r_9_13_3,seq144,r_203_275_68,1.0,0,68,68,19
42,r_126_205_120,r_162_265_152,seq233,r_126_205_120,0.9,2,122,120,19
122,seq73,r_5_145_129,r_132_136_56,r_5_145_129,0.91,-49,80,129,19
69,r_239_175_98,seq111,seq180,r_239_175_98,0.99,0,98,98,19
45,r_46_41_197,seq7,r_89_213_113,r_89_213_113,1.0,26,139,113,19
24,r_292_45_44,r_261_280_157,r_218_198_61,r_261_280_157,0.72,-16,141,157,19
19,r_134_289_127,seq15,seq243,r_134_289_127,1.0,0,127,127,19
95,r_44_249_70,seq24,seq129,r_44_249_70,1.0,0,70,70,19
66,r_37_116_146,seq159,r_115_210_129,r_37_116_146,0.92,0,146,146,19
44,r_6_22_34,r_5_145_129,seq30,r_6_22_34,0.79,0,34,34,19
31,r_278_245_167,r_240_47_134,r_21_23_122,r_278_245_167,0.37,-27,140,167,19
41,r_183_122_130,r_80_273_116,seq100,r_80_273_116,0.94,0,116,116,19
67,r_223_216_136,r_231_166_85,r_256_152_67,r_223_216_136,0.98,0,136,136,19
64,r_33_219_57,seq290,seq34,r_33_219_57,0.98,0,57,57,19
89,r_21_23_122,seq204,seq38,r_21_23_122,0.45,1,123,122,19
24,r_292_45_44,seq179,r_261_280_157,r_292_45_44,0.88,4,48,44,19
3,r_202_220_153,seq168,seq274,r_202_220_153,0.88,0,153,153,19
10,r_112_125_186,seq156,r_256_152_67,r_256_152_67,0.74,119,186,67,19
72,r_59_17_109,r_155_288_176,r_33_219_57,r_155_288_176,0.95,-64,112,176,19
139,seq118,r_252_232_111,r_279_176_119,r_252_232_111,1.0,0,111,111,19
78,r_197_169_94,seq153,r_124_299_17,r_197_169_94,1.0,0,94,94,19
0,r_256_152_67,r_182_137_133,r_281_52_45,r_256_152_67,1.0,0,67,67,19
63,r_186_123_136,r_160_4_194,r_218_198_61,r_186_123_136,0.98,0,136,136,19
73,r_89_213_113,seq228,r_269_238_47,r_89_213_113,0.94,0,113,113,19
23,r_172_170_41,r_252_232_111,seq290,r_172_170_41,0.61,0,41,41,19
13,r_18_131_96,seq107,seq117,r_18_131_96,0.5,10,106,96,19
33,r_56_224_37,seq73,seq153,r_56_224_37,1.0,2,39,37,19
15,r_115_210_129,r_10_248_179,r_177_48_23,r_10_248_179,0.55,-49,130,179,19
79,r_138_69_21,r_126_205_120,seq121,r_138_69_21,0.98,-3,18,21,19
48,r_252_232_111,seq118,r_28_19_61,r_252_232_111,0.94,0,111,111,19
86,r_97_257_37,r_5_145_129,seq7,r_97_257_37,1.0,0,37,37,19
57,r_254_78_136,r_3_208_112,r_66_82_156,r_3_208_112,0.99,0,112,112,19
181,seq255,r_66_82_156,seq234,r_66_82_156,1.0,2,158,156,19
167,seq211,r_184_54_64,r_33_219_57,r_184_54_64,0.68,0,64,64,19
6,r_187_140_110,r_87_200_198,seq67,r_187_140_110,0.74,-4,106,110,19
62,r_83_149_64,seq225,seq194,r_83_149_64,1.0,0,64,64,19
38,r_230_277_28,r_237_139_91,seq159,r_230_277_28,0.84,0,28,28,19
99,r_195_191_149,r_278_245_167,seq73,r_195_191_149,0.99,0,149,149,19
27,r_133_94_173,r_10_248_179,r_103_173_153,r_103_173_153,0.64,25,178,153,19
87,r_10_248_179,seq67,r_256_152_67,r_256_152_67,0.98,112,179,67,19
162,seq185,r_250_29_120,r_110_75_44,r_110_75_44,1.0,77,121,44,19
47,r_284_174_108,seq190,seq128,r_284_174_108,0.99,0,108,108,19
40,r_259_8_66,r_103_173_153,r_184_54_64,r_259_8_66,1.0,0,66,66,19
14,r_281_52_45,r_18_131_96,seq141,r_281_52_45,0.89,2,47,45,19
34,r_177_48_23,seq73,r_115_210_129,r_115_210_129,1.0,17,146,129,19
20,r_261_280_157,r_162_265_152,r_292_45_44,r_292_45_44,0.97,6,50,44,19
167,seq211,r_33_219_57,r_103_173_153,r_103_173_153,0.98,9,162,153,19
71,r_110_75_44,seq30,seq185,r_110_75_44,1.0,0,44,44,19
92,r_103_173_153,seq226,seq211,r_103_173_153,0.99,0,153,153,19
18,r_5_145_129,r_97_257_37,seq73,r_97_257_37,1.0,0,37,37,19
190,seq283,r_155_288_176,r_80_273_116,r_80_273_116,0.95,60,176,116,19
58,r_298_158_144,seq38,r_258_40_3,r_298_158_144,0.97,0,144,144,19
70,r_155_288_176,seq283,r_260_247_3,r_155_288_176,0.5,0,176,176,19
31,r_278_245_167,r_21_23_122,r_88_151_63,r_278_245_167,0.73,0,167,167,19
20,r_261_280_157,r_292_45_44,r_167_50_147,r_261_280_157,0.73,1,158,157,19
68,r_207_266_74,seq104,seq107,r_207_266_74,0.58,5,79,74,19
137,seq111,r_239_175_98,r_88_151_63,r_239_175_98,1.0,0,98,98,19
29,r_132_136_56,seq95,seq73,r_132_136_56,0.99,0,56,56,19
61,r_25_192_84,seq104,r_28_19_61,r_25_192_84,1.0,0,84,84,19
32,r_209_84_115,r_250_29_120,seq272,r_209_84_115,0.94,0,115,115,19
46,r_74_241_48,r_46_41_197,seq127,r_74_241_48,1.0,1,49,48,19
124,seq79,r_162_265_152,r_143_98_105,r_143_98_105,0.85,60,165,105,19
60,r_218_198_61,r_167_50_147,r_56_224_37,r_218_198_61,0.99,0,61,61,19
81,r_167_50_147,seq7,seq242,r_167_50_147,0.97,-2,145,147,19
4,r_124_299_17,r_132_136_56,seq104,r_124_299_17,0.97,0,17,17,19
94,r_148_93_125,seq270,r_187_140_110,r_148_93_125,0.98,0,125,125,19
54,r_246_236_55,seq287,r_269_238_47,r_246_236_55,0.54,4,59,55,19
9,r_26_163_71,seq102,r_146_235_12,r_26_163_71,1.0,0,71,71,19
96,r_70_113_122,r_112_125_186,r_218_198_61,r_70_113_122,0.91,0,122,122,19
90,r_269_238_47,r_46_41_197,r_89_213_113,r_89_213_113,1.0,6,119,113,19
22,r_11_77_174,seq274,r_261_280_157,r_261_280_157,0.83,19,176,157,19
28,r_80_273_116,r_183_122_130,r_83_149_64,r_80_273_116,0.85,0,116,116,19
91,r_63_85_72,r_134_289_127,seq1,r_63_85_72,1.0,0,72,72,19
57,r_254_78_136,r_66_82_156,r_9_13_3,r_254_78_136,0.94,3,139,136,19
41,r_183_122_130,seq100,r_142_91_7,r_183_122_130,0.95,0,130,130,19
49,r_240_47_134,r_278_245_167,r_6_22_34,r_240_47_134,0.76,6,140,134,19
152,seq157,r_231_166_85,r_92_90_103,r_92_90_103,1.0,0,103,103,19
34,r_177_48_23,r_18_131_96,seq73,r_177_48_23,0.99,0,23,23,19
56,r_92_90_103,seq105,seq157,r_92_90_103,1.0,0,103,103,19
7,r_119_262_155,seq109,r_6_22_34,r_119_262_155,0.71,0,155,155,19
18,r_5_145_129,seq73,r_239_175_98,r_5_145_129,1.0,0,129,129,19
175,seq233,r_60_165_198,r_126_205_120,r_126_205_120,1.0,25,145,120,19
138,seq117,seq111,r_18_131_96,r_18_131_96,0.5,10,106,96,19
90,r_269_238_47,r_162_265_152,r_46_41_197,r_269_238_47,0.98,0,47,47,19
183,seq267,r_202_220_153,seq180,r_202_220_153,0.99,-80,73,153,19
60,r_218_198_61,r_56_224_37,r_70_113_122,r_70_113_122,1.0,2,124,122,19
84,r_237_139_91,r_143_98_105,seq270,r_237_139_91,1.0,0,91,91,19
12,r_229_188_4,r_162_265_152,r_31_227_11,r_31_227_11,0.53,41,52,11,19
51,r_42_192_169,r_224_168_153,r_145_21_198,r_224_168_153,0.65,0,153,153,20
92,r_40_174_72,seq90,seq178,r_40_174_72,1.0,0,72,72,20
9,r_267_59_89,seq53,r_7_202_134,r_7_202_134,0.98,27,161,134,20
8,r_256_149_64,r_80_119_81,r_109_143_4,r_256_149_64,0.99,0,64,64,20
60,r_63_57_13,r_51_22_35,seq33,r_63_57_13,0.67,0,13,13,20
43,r_95_233_66,r_198_13_151,seq24,r_95_233_66,0.99,0,66,66,20
54,r_162_161_123,seq16,seq37,r_162_161_123,0.98,0,123,123,20
83,r_52_184_70,seq88,r_220_50_199,r_52_184_70,1.0,1,71,70,20
46,r_35_73_10,r_183_93_66,seq140,r_35_73_10,0.95,1,11,10,20
3,r_3_227_141,r_31_9_22,seq121,r_3_227_141,0.76,3,144,141,20
59,r_68_265_78,seq16,seq217,r_68_265_78,1.0,0,78,78,20
53,r_273_295_24,r_250_141_40,seq249,r_273_295_24,0.95,0,24,24,20
55,r_133_157_147,r_203_146_152,r_293_195_129,r_133_157_147,0.79,0,147,147,20
21,r_61_150_158,r_41_123_138,r_97_272_128,r_61_150_158,0.56,-24,134,158,20
39,r_220_50_199,r_144_287_186,r_52_184_70,r_52_184_70,0.98,3,73,70,20
1,r_284_294_108,seq16,r_288_23_4,r_284_294_108,0.95,2,110,108,20
42,r_296_99_86,seq188,r_34_29_61,r_296_99_86,0.81,0,86,86,20
21,r_61_150_158,r_97_272_128,r_176_65_48,r_61_150_158,0.78,2,160,158,20
3,r_3_227_141,r_45_182_58,r_31_9_22,r_31_9_22,0.8,2,24,22,20
95,r_115_177_77,seq262,r_244_102_35,r_115_177_77,0.95,0,77,77,20
66,r_293_195_129,seq163,seq243,r_293_195_129,0.98,0,129,129,20
76,r_111_282_85,seq14,seq121,r_111_282_85,1.0,0,85,85,20
184,seq249,seq19,r_273_295_24,r_273_295_24,0.97,108,132,24,20
77,r_190_71_148,seq170,r_290_15_173,r_190_71_148,0.68,28,176,148,20
41,r_268_105_156,r_28_156_177,r_41_123_138,r_28_156_177,0.68,-21,156,177,20
80,r_137_25_49,r_258_206_145,r_144_287_186,r_137_25_49,1.0,0,49,49,20
67,r_216_26_93,seq32,seq160,r_216_26_93,0.88,0,93,93,20
89,r_251_66_83,r_201_91_135,r_259_297_5,r_251_66_83,1.0,0,83,83,20
90,r_96_252_69,seq94,seq211,r_96_252_69,1.0,0,69,69,20
25,r_77_1_33,r_45_182_58,seq134,r_77_1_33,0.98,6,39,33,20
16,r_4_210_11,seq62,r_85_54_99,r_85_54_99,1.0,-1,98,99,20
179,seq235,r_55_229_80,seq289,r_55_229_80,1.0,-10,70,80,20
174,seq211,seq140,r_96_252_69,r_96_252_69,1.0,36,105,69,20
78,r_230_78_83,r_267_59_89,r_248_151_6,r_230_78_83,1.0,0,83,83,20
63,r_236_172_103,r_199_231_66,r_245_154_13,r_236_172_103,1.0,0,103,103,20
73,r_257_113_81,r_145_21_198,seq12,r_257_113_81,0.77,0,81,81,20
11,r_183_93_66,seq173,seq67,r_183_93_66,1.0,0,66,66,20
31,r_221_218_27,r_45_182_58,r_86_228_125,r_221_218_27,0.9,0,27,27,20
99,r_224_168_153,r_42_192_169,r_36_107_85,r_224_168_153,1.0,0,153,153,20
20,r_130_108_173,seq140,r_98_175_64,r_98_175_64,1.0,41,105,64,20
98,r_269_238_96,r_133_157_147,r_35_73_10,r_269_238_96,0.98,1,97,96,20
6,r_241_181_24,r_36_107_85,seq70,r_241_181_24,1.0,0,24,24,20
15,r_41_123_138,r_61_150_158,r_245_154_13,r_41_123_138,0.75,0,138,138,20
48,r_213_79_133,r_28_156_177,seq62,r_213_79_133,0.89,2,135,133,20
57,r_85_54_99,r_86_228_125,r_4_210_11,r_85_54_99,1.0,0,99,99,20
62,r_203_146_152,r_133_157_147,seq139,r_203_146_152,0.98,1,153,152,20
85,r_298_18_172,r_142_30_196,r_198_13_151,r_198_13_151,0.8,22,173,151,20
99,r_224_168_153,r_98_175_64,r_42_192_169,r_98_175_64,1.0,0,64,64,20
10,r_45_182_58,r_290_15_173,r_234_205_20,r_45_182_58,0.95,0,58,58,20
4,r_189_209_55,r_246_6_195,seq12,r_189_209_55,0.96,0,55,55,20
27,r_86_228_125,r_85_54_99,r_221_218_27,r_85_54_99,0.54,0,99,99,20
87,r_11_135_84,r_292_237_194,seq110,r_11_135_84,1.0,0,84,84,20
29,r_31_9_22,r_41_123_138,r_3_227_141,r_31_9_22,0.99,1,23,22,20
47,r_80_119_81,r_111_282_85,seq126,r_80_119_81,1.0,0,81,81,20
40,r_144_287_186,seq289,r_263_266_12,r_144_287_186,0.55,0,186,186,20
74,r_28_156_177,seq289,r_84_10_84,r_84_10_84,0.61,93,177,84,20
115,seq62,r_4_210_11,r_213_79_133,r_213_79_133,0.72,10,143,133,20
27,r_86_228_125,r_221_218_27,seq158,r_86_228_125,0.68,13,138,125,20
35,r_36_107_85,r_61_150_158,r_224_168_153,r_36_107_85,0.76,75,160,85,20
19,r_194_299_12,r_183_93_66,r_109_143_4,r_194_299_12,0.96,-1,11,12,20
33,r_97_272_128,r_198_13_151,r_36_107_85,r_97_272_128,0.63,0,128,128,20
64,r_58_49_124,seq70,r_248_151_6,r_58_49_124,0.97,0,124,124,20
22,r_250_141_40,r_52_184_70,r_220_50_199,r_220_50_199,0.98,-159,40,199,20
50,r_185_215_67,r_246_6_195,r_35_73_10,r_185_215_67,1.0,1,68,67,20
115,seq62,seq106,r_4_210_11,r_4_210_11,0.78,12,23,11,20
58,r_43_17_178,seq159,r_130_108_173,r_43_17_178,0.75,0,178,178,20
65,r_118_131_154,r_298_18_172,seq62,r_118_131_154,0.94,1,155,154,20
20,r_130_108_173,r_98_175_64,seq289,r_130_108_173,0.97,-1,172,173,20
129,seq106,seq62,r_51_22_35,r_51_22_35,0.78,0,35,35,20
38,r_258_206_145,seq129,r_271_276_55,r_258_206_145,0.88,0,145,145,20
52,r_125_38_103,seq104,r_288_23_4,r_125_38_103,0.98,0,103,103,20
77,r_190_71_148,r_212_103_188,seq170,r_190_71_148,0.68,0,148,148,20
68,r_234_205_20,r_225_48_118,seq129,r_234_205_20,1.0,0,20,20,20
169,seq196,r_190_71_148,r_221_218_27,r_221_218_27,0.43,123,150,27,20
2,r_263_266_12,seq87,seq121,r_263_266_12,1.0,0,12,12,20
69,r_176_65_48,r_43_17_178,seq188,r_176_65_48,1.0,0,48,48,20
34,r_225_48_118,seq139,r_11_135_84,r_11_135_84,1.0,39,123,84,20
51,r_42_192_169,r_145_21_198,r_271_276_55,r_145_21_198,0.94,-29,169,198,20
32,r_281_46_28,seq235,r_39_132_5,r_281_46_28,0.75,0,28,28,20
17,r_51_22_35,r_98_175_64,seq106,r_51_22_35,0.91,0,35,35,20
81,r_219_264_76,r_145_21_198,seq16,r_219_264_76,1.0,0,76,76,20
94,r_20_214_165,seq140,seq153,r_20_214_165,0.9,1,166,165,20
18,r_245_154_13,r_296_99_86,r_72_179_3,r_245_154_13,0.96,0,13,13,20
31,r_221_218_27,r_86_228_125,seq14,r_86_228_125,0.56,49,174,125,20
16,r_4_210_11,r_189_209_55,seq62,r_4_210_11,0.55,0,11,11,20
29,r_31_9_22,r_3_227_141,r_216_26_93,r_31_9_22,0.62,118,140,22,20
49,r_34_29_61,seq211,seq27,r_34_29_61,1.0,0,61,61,20
56,r_55_229_80,seq235,seq277,r_55_229_80,1.0,0,80,80,20
44,r_64_8_100,seq153,r_34_29_61,r_34_29_61,1.0,42,103,61,20
79,r_244_102_35,r_183_93_66,seq5,r_244_102_35,0.98,0,35,35,20
23,r_98_175_64,r_224_168_153,r_259_297_5,r_98_175_64,1.0,0,64,64,20
175,seq217,r_212_103_188,seq14,r_212_103_188,0.45,0,188,188,20
80,r_137_25_49,r_144_287_186,seq289,r_144_287_186,0.63,-89,97,186,20
35,r_36_107_85,seq140,r_61_150_158,r_36_107_85,0.93,0,85,85,20
12,r_198_13_151,seq275,seq208,r_198_13_151,0.91,0,151,151,20
84,r_74_100_161,seq90,r_189_209_55,r_189_209_55,0.85,106,161,55,20
199,seq289,r_28_156_177,r_130_108_173,r_28_156_177,0.24,0,177,177,20
172,seq216,r_296_169_34,r_105_181_29,r_105_181_29,0.94,5,34,29,21
64,r_2_224_25,r_229_19_197,r_94_184_13,r_2_224_25,0.63,0,25,25,21
42,r_299_133_34,r_0_267_69,seq210,r_299_133_34,0.99,0,34,34,21
36,r_85_205_72,r_221_273_158,r_281_17_38,r_221_273_158,0.71,-85,73,158,21
92,r_31_128_60,r_125_136_81,seq253,r_31_128_60,1.0,1,61,60,21
8,r_109_18_159,seq61,r_294_191_74,r_294_191_74,0.99,91,165,74,21
89,r_141_155_148,r_16_183_23,seq187,r_16_183_23,0.55,-6,17,23,21
54,r_193_220_69,seq62,r_281_17_38,r_281_17_38,0.74,33,71,38,21
83,r_125_136_81,r_31_128_60,seq236,r_31_128_60,0.99,1,61,60,21
37,r_252_176_122,r_160_9_137,r_296_169_34,r_252_176_122,0.97,1,123,122,21
59,r_113_170_128,seq99,seq68,r_113_170_128,1.0,0,128,128,21
55,r_6_65_95,seq217,r_296_169_34,r_6_65_95,1.0,2,97,95,21
71,r_194_83_66,r_276_53_161,seq217,r_194_83_66,1.0,0,66,66,21
86,r_74_167_47,r_69_201_194,r_103_280_36,r_103_280_36,0.8,38,74,36,21
16,r_151_72_69,seq263,seq187,r_151_72_69,1.0,0,69,69,21
21,r_283_147_158,seq91,r_238_7_94,r_238_7_94,0.98,52,146,94,21
97,r_285_288_104,seq57,seq8,r_285_288_104,1.0,0,104,104,21
75,r_36_45_16,r_35_144_116,seq130,r_36_45_16,0.98,1,17,16,21
5,r_266_92_131,seq293,r_152_235_19,r_266_92_131,0.94,0,131,131,21
80,r_258_80_75,seq218,r_194_83_66,r_258_80_75,1.0,1,76,75,21
32,r_221_273_158,r_215_174_33,r_6_65_95,r_221_273_158,0.69,3,161,158,21
69,r_96_76_58,r_6_65_95,seq145,r_96_76_58,1.0,5,63,58,21
45,r_230_14_98,seq236,r_102_207_17,r_230_14_98,0.82,1,99,98,21
43,r_88_282_62,r_109_18_159,r_199_172_68,r_109_18_159,0.94,-118,41,159,21
158,seq164,r_109_18_159,r_295_268_83,r_295_268_83,1.0,23,106,83,21
95,r_179_292_95,seq163,seq5,r_179_292_95,0.99,0,95,95,21
66,r_192_95_121,r_178_247_159,r_198_44_13,r_192_95_121,0.81,0,121,121,21
143,seq130,r_274_73_190,r_36_45_16,r_36_45_16,1.0,1,17,16,21
41,r_0_267_69,seq34,r_194_83_66,r_0_267_69,0.99,1,70,69,21
67,r_296_169_34,r_74_167_47,r_252_176_122,r_252_176_122,0.89,-1,121,122,21
47,r_241_196_22,r_295_268_83,r_226_269_13,r_241_196_22,0.99,1,23,22,21
39,r_189_46_22,r_129_265_26,seq140,r_189_46_22,0.79,-5,17,22,21
31,r_152_235_19,seq228,seq163,r_152_235_19,0.75,2,21,19,21
10,r_289_48_138,seq293,seq257,r_289_48_138,0.69,6,144,138,21
40,r_94_184_13,r_137_246_163,seq260,r_94_184_13,0.8,4,17,13,21
170,seq212,seq119,r_202_127_84,r_202_127_84,1.0,4,88,84,21
44,r_139_277_42,r_221_273_158,r_294_191_74,r_294_191_74,0.39,0,74,74,21
78,r_43_71_105,seq81,seq3,r_43_71_105,0.9,1,106,105,21
0,r_294_191_74,r_124_182_135,r_139_277_42,r_294_191_74,0.88,0,74,74,21
11,r_178_247_159,r_22_245_6,r_199_172_68,r_178_247_159,0.82,1,160,159,21
63,r_13_39_32,r_124_182_135,seq293,r_13_39_32,1.0,0,32,32,21
20,r_126_121_104,seq56,seq81,r_126_121_104,1.0,0,104,104,21
98,r_123_158_94,seq104,r_149_157_32,r_123_158_94,0.99,0,94,94,21
74,r_82_162_110,r_276_53_161,r_137_246_163,r_82_162_110,0.97,53,163,110,21
72,r_198_44_13,r_109_18_159,seq255,r_198_44_13,0.92,0,13,13,21
6,r_137_246_163,seq210,r_31_128_60,r_137_246_163,0.62,0,163,163,21
62,r_244_87_15,seq8,r_297_264_57,r_297_264_57,1.0,3,60,57,21
19,r_105_181_29,r_79_243_179,seq216,r_105_181_29,1.0,0,29,29,21
99,r_276_53_161,r_82_162_110,r_112_42_178,r_82_162_110,0.51,64,174,110,21
28,r_64_231_16,r_29_118_52,r_142_204_197,r_64_231_16,0.92,1,17,16,21
53,r_215_174_33,r_221_273_158,seq23,r_221_273_158,0.99,3,161,158,21
25,r_103_280_36,r_29_118_52,r_299_133_34,r_29_118_52,0.66,-14,38,52,21
51,r_112_42_178,r_12_132_7,r_276_53_161,r_112_42_178,0.38,0,178,178,21
87,r_251_67_90,seq77,r_96_76_58,r_251_67_90,0.92,2,92,90,21
79,r_222_291_25,r_294_191_74,seq218,r_222_291_25,0.96,0,25,25,21
49,r_226_269_13,r_215_174_33,r_97_106_126,r_226_269_13,0.98,0,13,13,21
79,r_222_291_25,seq218,r_168_200_89,r_168_200_89,1.0,8,97,89,21
18,r_286_30_14,r_238_7_94,seq104,r_286_30_14,1.0,3,17,14,21
24,r_29_118_52,r_258_80_75,seq145,r_29_118_52,0.98,0,52,52,21
2,r_124_182_135,r_112_42_178,r_29_118_52,r_112_42_178,0.69,-42,136,178,21
93,r_12_132_7,r_112_42_178,r_230_14_98,r_12_132_7,0.53,171,178,7,21
27,r_281_17_38,r_290_180_167,seq213,r_281_17_38,0.98,0,38,38,21
140,seq116,r_229_19_197,r_186_209_13,r_186_209_13,1.0,0,13,13,21
33,r_168_200_89,seq213,r_222_291_25,r_168_200_89,1.0,0,89,89,21
88,r_142_204_197,r_41_225_152,r_103_280_36,r_103_280_36,0.85,116,152,36,21
85,r_129_265_26,r_219_165_196,r_190_254_154,r_190_254_154,0.63,6,160,154,21
58,r_249_75_181,seq23,r_35_144_116,r_35_144_116,0.91,57,173,116,21
70,r_55_195_78,seq52,seq188,r_55_195_78,0.55,4,82,78,21
65,r_190_254_154,seq263,r_129_265_26,r_190_254_154,0.69,0,154,154,21
49,r_226_269_13,r_97_106_126,r_241_196_22,r_226_269_13,0.59,22,35,13,21
61,r_20_47_113,seq111,seq218,r_20_47_113,0.66,0,113,113,21
32,r_221_273_158,r_85_205_72,r_215_174_33,r_221_273_158,0.78,-85,73,158,21
38,r_279_60_99,seq166,seq81,r_279_60_99,1.0,0,99,99,21
44,r_139_277_42,r_137_246_163,r_221_273_158,r_139_277_42,0.97,0,42,42,21
77,r_86_10_112,seq262,seq62,r_86_10_112,0.65,3,115,112,21
34,r_295_268_83,seq140,seq164,r_295_268_83,1.0,0,83,83,21
85,r_129_265_26,seq115,r_219_165_196,r_129_265_26,0.96,4,30,26,21
46,r_171_21_35,r_221_273_158,r_22_245_6,r_171_21_35,0.99,3,38,35,21
168,seq210,r_137_246_163,r_299_133_34,r_299_133_34,0.95,41,75,34,21
17,r_101_150_81,r_233_59_116,r_194_83_66,r_101_150_81,1.0,1,82,81,21
14,r_297_264_57,r_199_172_68,r_244_87_15,r_297_264_57,0.59,1,58,57,21
94,r_32_90_75,seq3,seq98,r_32_90_75,1.0,0,75,75,21
121,seq58,seq8,r_25_284_144,r_25_284_144,0.9,8,152,144,21
9,r_238_7_94,seq131,seq120,r_238_7_94,0.99,0,94,94,21
96,r_271_122_124,r_109_18_159,seq93,r_271_122_124,0.87,0,124,124,21
48,r_78_175_43,r_168_200_89,seq91,r_78_175_43,1.0,0,43,43,21
53,r_215_174_33,r_123_158_94,r_221_273_158,r_215_174_33,0.99,2,35,33,21
22,r_41_225_152,r_142_204_197,r_295_268_83,r_142_204_197,0.86,-45,152,197,21
102,seq5,seq27,r_179_292_95,r_179_292_95,1.0,12,107,95,21
91,r_160_9_137,seq120,seq63,r_160_9_137,0.56,0,137,137,21
23,r_233_59_116,seq1,seq263,r_233_59_116,0.51,10,126,116,21
73,r_16_183_23,r_141_155_148,r_198_44_13,r_16_183_23,0.94,-2,21,23,21
26,r_149_157_32,r_290_180_167,seq89,r_149_157_32,0.97,0,32,32,21
108,seq26,r_125_136_81,seq11,r_125_136_81,0.79,5,86,81,21
82,r_4_107_102,r_137_246_163,r_13_39_32,r_13_39_32,0.68,83,115,32,21
90,r_186_209_13,r_124_182_135,seq116,r_186_209_13,0.98,0,13,13,21
186,seq255,r_25_284_144,r_198_44_13,r_198_44_13,0.65,0,13,13,21
56,r_102_207_17,r_105_181_29,seq77,r_102_207_17,0.98,0,17,17,21
12,r_35_144_116,seq91,r_94_184_13,r_35_144_116,0.97,4,120,116,21
84,r_206_110_171,seq40,r_168_200_89,r_206_110_171,0.49,1,172,171,21
36,r_114_153_150,seq30,seq4,r_114_153_150,0.87,0,150,150,22
5,r_264_60_40,r_210_204_10,seq290,r_264_60_40,0.51,5,45,40,22
92,r_117_248_117,r_129_17_148,r_170_195_102,r_129_17_148,0.59,-31,117,148,22
53,r_105_90_127,r_282_292_129,seq137,r_105_90_127,0.99,0,127,127,22
146,seq154,r_54_134_176,r_274_271_8,r_54_134_176,0.77,0,176,176,22
37,r_175_180_178,seq137,r_84_126_44,r_175_180_178,0.6,0,178,178,22
42,r_10_213_48,r_42_64_199,seq256,r_10_213_48,0.56,4,52,48,22
55,r_196_200_99,r_54_134_176,r_273_103_47,r_196_200_99,0.77,0,99,99,22
71,r_83_107_82,seq12,seq154,r_83_107_82,1.0,1,83,82,22
9,r_261_246_12,r_249_184_47,seq106,r_261_246_12,0.82,2,14,12,22
16,r_138_177_153,seq171,r_104_76_109,r_104_76_109,0.71,45,154,109,22
21,r_148_128_123,seq256,r_155_143_85,r_148_128_123,1.0,0,123,123,22
39,r_63_14_154,seq30,r_244_55_98,r_63_14_154,0.9,0,154,154,22
97,r_243_24_71,seq18,r_264_60_40,r_243_24_71,0.99,3,74,71,22
46,r_258_36_168,seq172,r_155_143_85,r_155_143_85,0.98,83,168,85,22
80,r_34_225_79,seq106,seq171,r_34_225_79,0.9,4,83,79,22
83,r_47_72_25,r_155_143_85,seq127,r_47_72_25,0.92,0,25,25,22
24,r_5_206_4,seq50,r_252_116_120,r_252_116_120,1.0,2,122,120,22
86,r_277_259_35,r_80_26_116,seq66,r_277_259_35,0.61,0,35,35,22
184,seq263,r_179_284_158,r_170_195_102,r_170_195_102,0.89,22,124,102,22
31,r_282_292_129,seq66,r_74_99_126,r_282_292_129,1.0,1,130,129,22
67,r_92_86_66,r_129_17_148,seq232,r_92_86_66,1.0,0,66,66,22
89,r_119_32_97,seq263,seq283,r_119_32_97,0.59,9,106,97,22
10,r_122_214_65,seq151,seq192,r_122_214_65,0.96,1,66,65,22
0,r_44_115_30,seq15,seq95,r_44_115_30,1.0,0,30,30,22
113,seq45,r_221_270_87,r_6_11_32,r_6_11_32,0.92,35,67,32,22
26,r_244_55_98,seq56,seq251,r_244_55_98,1.0,0,98,98,22
139,seq137,r_175_180_178,r_44_115_30,r_44_115_30,0.86,148,178,30,22
76,r_298_208_37,r_297_174_149,r_20_57_193,r_298_208_37,0.64,1,38,37,22
78,r_74_99_126,seq173,r_282_292_129,r_74_99_126,0.58,5,131,126,22
63,r_253_295_94,seq120,seq262,r_253_295_94,1.0,0,94,94,22
114,seq50,r_109_49_105,r_178_27_99,r_178_27_99,1.0,8,107,99,22
73,r_167_40_132,seq198,r_287_146_157,r_167_40_132,0.99,1,133,132,22
20,r_155_143_85,seq30,r_70_79_63,r_155_143_85,1.0,1,86,85,22
13,r_71_194_73,seq50,seq121,r_71_194_73,1.0,0,73,73,22
98,r_288_35_122,seq12,seq137,r_288_35_122,1.0,0,122,122,22
15,r_8_87_76,seq91,seq78,r_8_87_76,1.0,4,80,76,22
6,r_226_0_179,seq191,seq56,r_226_0_179,0.34,0,179,179,22
164,seq193,r_273_103_47,r_75_108_7,r_273_103_47,0.57,-28,19,47,22
96,r_21_276_28,r_34_225_79,seq23,r_21_276_28,0.88,0,28,28,22
61,r_96_223_58,r_169_233_45,seq50,r_96_223_58,1.0,0,58,58,22
45,r_84_126_44,r_221_270_87,r_167_40_132,r_221_270_87,0.6,-42,45,87,22
90,r_211_289_16,r_249_184_47,seq216,r_211_289_16,0.85,2,18,16,22
87,r_182_94_162,seq89,r_274_271_8,r_182_94_162,0.91,2,164,162,22
2,r_274_271_8,r_53_185_140,seq22,r_53_185_140,1.0,0,140,140,22
47,r_297_174_149,r_70_79_63,r_9_101_146,r_70_79_63,0.95,3,66,63,22
3,r_220_2_24,r_167_40_132,seq189,r_220_2_24,0.95,3,27,24,22
45,r_84_126_44,r_167_40_132,r_249_184_47,r_167_40_132,0.8,-60,72,132,22
1,r_112_150_57,r_199_140_63,r_118_260_4,r_112_150_57,1.0,1,58,57,22
29,r_202_110_132,r_160_1_138,r_34_225_79,r_160_1_138,1.0,-3,135,138,22
40,r_250_237_40,r_148_128_123,seq227,r_250_237_40,1.0,0,40,40,22
95,r_188_190_24,r_282_292_129,r_80_26_116,r_188_190_24,1.0,0,24,24,22
25,r_109_49_105,seq50,r_209_164_61,r_209_164_61,1.0,46,107,61,22
43,r_52_231_163,r_67_37_8,r_100_19_7,r_52_231_163,0.5,0,163,163,22
33,r_80_26_116,r_287_146_157,r_117_248_117,r_80_26_116,1.0,0,116,116,22
48,r_67_37_8,r_52_231_163,r_282_292_129,r_67_37_8,0.83,155,163,8,22
64,r_70_79_63,r_297_174_149,seq222,r_70_79_63,1.0,3,66,63,22
47,r_297_174_149,r_9_101_146,r_229_266_159,r_9_101_146,0.93,-16,130,146,22
88,r_247_147_160,seq4,r_281_77_32,r_247_147_160,0.45,0,160,160,22
11,r_16_234_17,r_196_200_99,seq23,r_16_234_17,0.82,0,17,17,22
156,seq172,r_258_36_168,seq62,r_258_36_168,0.95,0,168,168,22
50,r_145_228_111,r_282_292_129,r_209_164_61,r_145_228_111,1.0,1,112,111,22
70,r_170_195_102,r_258_36_168,seq263,r_170_195_102,1.0,-1,101,102,22
65,r_255_265_90,r_138_177_153,r_188_190_24,r_255_265_90,1.0,1,91,90,22
68,r_218_7_141,seq127,r_238_88_51,r_238_88_51,0.96,92,143,51,22
91,r_203_197_11,r_229_266_159,seq30,r_203_197_11,0.98,1,12,11,22
32,r_252_116_120,seq278,r_5_206_4,r_252_116_120,0.99,0,120,120,22
52,r_53_185_140,r_274_271_8,r_145_228_111,r_53_185_140,0.95,0,140,140,22
77,r_3_207_79,seq262,seq299,r_3_207_79,1.0,0,79,79,22
34,r_221_270_87,r_20_57_193,r_264_60_40,r_221_270_87,0.57,1,88,87,22
85,r_280_97_36,r_273_103_47,r_169_233_45,r_280_97_36,0.74,2,38,36,22
60,r_209_164_61,r_243_24_71,seq30,r_209_164_61,1.0,0,61,61,22
17,r_229_266_159,seq45,seq161,r_229_266_159,0.66,1,160,159,22
18,r_249_184_47,r_209_164_61,r_31_41_179,r_249_184_47,0.7,1,48,47,22
133,seq121,r_221_270_87,r_71_194_73,r_71_194_73,1.0,8,81,73,22
28,r_68_124_137,r_51_257_159,r_170_195_102,r_68_124_137,0.94,1,138,137,22
49,r_201_93_113,seq81,r_244_55_98,r_201_93_113,1.0,0,113,113,22
51,r_113_241_52,seq89,r_16_234_17,r_113_241_52,1.0,0,52,52,22
54,r_240_136_52,r_182_94_162,seq278,r_240_136_52,1.0,0,52,52,22
56,r_160_1_138,r_202_110_132,seq152,r_160_1_138,0.96,0,138,138,22
41,r_281_77_32,seq189,seq299,r_281_77_32,1.0,0,32,32,22
27,r_219_85_37,seq186,r_187_69_15,r_219_85_37,0.92,0,37,37,22
82,r_20_57_193,r_221_270_87,r_298_208_37,r_20_57_193,0.49,-105,88,193,22
74,r_187_69_15,r_288_35_122,seq242,r_187_69_15,0.98,0,15,15,22
79,r_179_284_158,seq263,seq149,r_179_284_158,0.89,0,158,158,22
183,seq262,r_3_207_79,r_112_150_57,r_112_150_57,1.0,18,75,57,22
35,r_9_101_146,seq106,r_157_133_5,r_9_101_146,0.91,0,146,146,22
22,r_273_103_47,r_252_116_120,seq95,r_273_103_47,0.67,0,47,47,22
12,r_178_27_99,seq232,seq50,r_178_27_99,1.0,0,99,99,22
183,seq262,r_112_150_57,r_253_295_94,r_253_295_94,0.99,0,94,94,22
95,r_188_190_24,r_80_26_116,r_287_146_157,r_80_26_116,1.0,0,116,116,22
182,seq256,r_148_128_123,r_10_213_48,r_148_128_123,0.99,-57,66,123,22
84,r_31_41_179,r_167_40_132,r_249_184_47,r_31_41_179,0.96,-118,61,179,22
199,seq299,seq59,r_3_207_79,r_3_207_79,1.0,23,102,79,22
93,r_169_162_104,seq85,r_149_234_93,r_169_162_104,0.91,0,104,104,23
51,r_155_281_79,r_196_143_137,seq245,r_155_281_79,1.0,0,79,79,23
18,r_295_275_178,r_121_88_18,r_256_283_16,r_295_275_178,0.96,-163,15,178,23
36,r_211_278_82,seq168,r_16_190_12,r_211_278_82,0.9,0,82,82,23
122,seq54,r_135_270_192,r_196_143_137,r_196_143_137,1.0,35,172,137,23
92,r_74_262_137,seq64,seq172,r_74_262_137,0.61,0,137,137,23
14,r_67_277_110,seq21,seq68,r_67_277_110,1.0,1,111,110,23
8,r_259_189_131,seq125,r_193_213_96,r_259_189_131,0.99,0,131,131,23
53,r_129_106_2,r_123_229_171,r_104_284_64,r_104_284_64,1.0,108,172,64,23
43,r_72_35_111,seq29,r_235_138_168,r_72_35_111,0.99,2,113,111,23
54,r_266_5_133,seq157,seq219,r_266_5_133,0.68,0,133,133,23
83,r_145_111_171,r_158_39_198,r_266_5_133,r_145_111_171,0.45,5,176,171,23
34,r_228_98_45,r_292_108_189,seq29,r_228_98_45,1.0,0,45,45,23
37,r_207_55_75,seq64,r_83_217_8,r_207_55_75,0.99,0,75,75,23
52,r_40_37_46,r_78_101_195,seq85,r_40_37_46,1.0,0,46,46,23
59,r_66_212_63,r_298_161_172,seq94,r_66_212_63,1.0,1,64,63,23
55,r_154_147_66,seq28,seq156,r_154_147_66,1.0,1,67,66,23
86,r_244_25_134,r_204_142_161,seq238,r_244_25_134,0.99,0,134,134,23
16,r_58_159_85,r_87_45_88,seq17,r_58_159_85,1.0,0,85,85,23
21,r_258_273_168,r_19_124_178,seq82,r_258_273_168,0.83,0,168,168,23
77,r_33_75_43,seq9,seq291,r_33_75_43,0.99,1,44,43,23
91,r_110_253_55,seq153,r_117_151_36,r_110_253_55,0.96,1,56,55,23
1,r_235_138_168,r_292_108_189,r_72_35_111,r_72_35_111,0.81,10,121,111,23
73,r_121_88_18,r_227_279_145,r_180_271_33,r_180_271_33,1.0,11,44,33,23
46,r_87_45_88,r_244_25_134,seq157,r_87_45_88,1.0,0,88,88,23
80,r_19_124_178,r_258_273_168,r_16_190_12,r_16_190_12,0.68,156,168,12,23
69,r_2_15_76,seq50,seq28,r_2_15_76,1.0,-1,75,76,23
11,r_23_13_20,seq178,seq107,r_23_13_20,0.89,-1,19,20,23
45,r_73_224_121,seq20,seq237,r_73_224_121,0.99,0,121,121,23
25,r_184_241_47,r_258_273_168,seq172,r_184_241_47,0.55,0,47,47,23
95,r_206_236_176,r_255_249_174,r_3_182_73,r_3_182_73,0.98,105,178,73,23
66,r_240_36_142,seq127,r_92_272_67,r_92_272_67,0.69,75,142,67,23
76,r_251_200_120,seq62,r_140_113_1,r_251_200_120,0.98,2,122,120,23
31,r_218_18_94,seq153,r_164_96_78,r_218_18_94,0.99,0,94,94,23
67,r_83_217_8,r_196_143_137,r_207_55_75,r_83_217_8,0.99,72,80,8,23
3,r_263_100_158,seq56,seq157,r_263_100_158,0.55,0,158,158,23
80,r_19_124_178,r_16_190_12,r_70_246_164,r_19_124_178,0.8,0,178,178,23
90,r_298_161_172,seq68,r_164_96_78,r_164_96_78,0.8,96,174,78,23
72,r_242_287_132,r_292_108_189,seq44,r_242_287_132,0.67,4,136,132,23
0,r_31_148_117,seq219,r_187_166_67,r_31_148_117,0.99,0,117,117,23
63,r_149_234_93,r_123_229_171,seq26,r_149_234_93,1.0,0,93,93,23
20,r_296_269_136,seq205,seq62,r_296_269_136,0.94,0,136,136,23
13,r_146_53_106,seq82,seq183,r_146_53_106,0.87,2,108,106,23
15,r_3_182_73,r_67_277_110,seq29,r_3_182_73,1.0,0,73,73,23
40,r_198_170_36,r_296_269_136,r_23_13_20,r_198_170_36,1.0,0,36,36,23
48,r_167_115_74,r_58_159_85,seq69,r_167_115_74,1.0,-3,71,74,23
79,r_160_102_56,r_91_192_170,seq176,r_160_102_56,1.0,0,56,56,23
73,r_121_88_18,r_295_275_178,r_227_279_145,r_121_88_18,0.57,-2,16,18,23
57,r_186_84_121,seq56,r_177_254_105,r_186_84_121,0.95,1,122,121,23
6,r_92_272_67,r_77_171_196,r_66_212_63,r_92_272_67,1.0,0,67,67,23
148,seq125,r_259_189_131,seq30,r_259_189_131,1.0,1,132,131,23
39,r_128_134_36,r_41_195_143,seq54,r_128_134_36,1.0,-1,35,36,23
87,r_204_142_161,seq85,r_164_96_78,r_204_142_161,0.65,0,161,161,23
49,r_230_139_25,r_123_229_171,seq21,r_230_139_25,0.88,0,25,25,23
61,r_41_195_143,r_128_134_36,r_10_89_4,r_128_134_36,1.0,-1,35,36,23
35,r_16_190_12,r_123_229_171,r_19_124_178,r_16_190_12,0.88,0,12,12,23
4,r_164_96_78,r_135_270_192,seq188,r_164_96_78,0.69,-29,49,78,23
2,r_227_279_145,seq56,r_33_75_43,r_33_75_43,1.0,108,151,43,23
47,r_297_203_97,seq219,seq6,r_297_203_97,1.0,-2,95,97,23
29,r_104_284_64,seq43,r_214_63_37,r_104_284_64,1.0,0,64,64,23
61,r_41_195_143,r_10_89_4,r_117_151_36,r_41_195_143,0.39,3,146,143,23
35,r_16_190_12,r_19_124_178,r_211_278_82,r_211_278_82,0.94,103,185,82,23
169,seq188,seq116,r_164_96_78,r_164_96_78,0.77,-28,50,78,23
99,r_180_271_33,r_266_5_133,r_121_88_18,r_180_271_33,0.9,1,34,33,23
33,r_76_243_175,seq59,r_260_51_59,r_260_51_59,1.0,116,175,59,23
190,seq264,r_137_131_164,r_73_224_121,r_73_224_121,0.99,51,172,121,23
50,r_137_131_164,seq264,r_23_13_20,r_23_13_20,0.73,152,172,20,23
70,r_274_290_15,r_58_159_85,seq237,r_274_290_15,0.97,0,15,15,23
68,r_91_192_170,seq14,r_154_147_66,r_154_147_66,1.0,104,170,66,23
24,r_133_201_13,r_215_60_72,seq141,r_133_201_13,0.79,6,19,13,23
137,seq94,r_202_105_174,r_66_212_63,r_66_212_63,1.0,24,87,63,23
38,r_123_229_171,r_129_106_2,r_92_272_67,r_92_272_67,0.91,105,172,67,23
27,r_208_11_57,seq222,seq122,r_208_11_57,1.0,1,58,57,23
64,r_286_103_47,r_58_159_85,seq56,r_286_103_47,0.94,1,48,47,23
97,r_71_181_23,r_104_284_64,seq94,r_71_181_23,0.98,0,23,23,23
75,r_187_166_67,seq248,r_31_148_117,r_31_148_117,1.0,1,118,117,23
132,seq82,r_146_53_106,seq118,r_146_53_106,1.0,3,109,106,23
17,r_52_221_148,r_135_270_192,r_244_25_134,r_135_270_192,0.66,-44,148,192,23
94,r_163_185_163,seq59,r_299_231_13,r_163_185_163,0.63,0,163,163,23
9,r_158_39_198,r_145_111_171,r_260_51_59,r_260_51_59,1.0,117,176,59,23
26,r_196_143_137,r_83_217_8,r_128_134_36,r_196_143_137,0.89,1,138,137,23
96,r_252_34_172,seq291,r_255_249_174,r_252_34_172,0.84,0,172,172,23
10,r_47_267_51,r_92_272_67,seq197,r_47_267_51,0.94,-1,50,51,23
159,seq165,r_27_216_193,r_299_231_13,r_299_231_13,0.93,2,15,13,23
22,r_194_38_108,r_187_166_67,r_83_217_8,r_194_38_108,1.0,2,110,108,23
28,r_112_239_63,r_263_100_158,seq26,r_112_239_63,1.0,1,64,63,23
74,r_260_51_59,seq125,seq9,r_260_51_59,1.0,0,59,59,23
7,r_202_105_174,seq94,r_255_249_174,r_202_105_174,0.78,0,174,174,23
18,r_295_275_178,r_256_283_16,seq1,r_256_283_16,0.52,163,179,16,23
118,seq44,r_70_246_164,r_242_287_132,r_242_287_132,0.93,35,167,132,23
60,r_256_283_16,r_137_131_164,r_295_275_178,r_256_283_16,0.95,-1,15,16,23
23,r_292_108_189,seq26,r_73_224_121,r_73_224_121,0.92,68,189,121,23
82,r_81_276_146,r_298_161_172,seq127,r_81_276_146,0.95,2,148,146,23
42,r_214_63_37,r_58_159_85,seq153,r_214_63_37,0.98,0,37,37,23
84,r_193_213_96,seq50,seq46,r_193_213_96,0.97,0,96,96,23
93,r_292_208_139,r_154_281_142,r_259_188_20,r_292_208_139,0.91,2,141,139,24
30,r_125_189_158,seq33,r_154_281_142,r_154_281_142,0.64,18,160,142,24
21,r_19_51_54,seq17,seq283,r_19_51_54,1.0,0,54,54,24
51,r_57_82_169,seq191,r_218_120_73,r_218_120_73,0.89,96,169,73,24
36,r_47_134_149,r_288_234_103,r_224_229_112,r_288_234_103,0.65,1,104,103,24
92,r_257_79_72,r_223_6_145,seq61,r_257_79_72,1.0,0,72,72,24
14,r_37_199_135,r_271_93_175,r_186_144_88,r_37_199_135,0.65,1,136,135,24
13,r_236_230_43,seq77,seq97,r_236_230_43,0.98,0,43,43,24
59,r_209_81_131,r_96_254_168,r_146_67_91,r_209_81_131,0.66,4,135,131,24
55,r_146_67_91,r_298_179_192,seq203,r_146_67_91,1.0,0,91,91,24
16,r_54_36_172,r_141_206_149,seq80,r_141_206_149,0.78,-50,99,149,24
39,r_2_249_164,seq22,r_232_5_163,r_2_249_164,0.7,0,164,164,24
165,seq198,r_96_254_168,seq290,r_96_254_168,0.95,0,168,168,24
1,r_117_260_114,seq204,r_295_235_87,r_117_260_114,0.95,1,115,114,24
97,r_218_120_73,r_287_87_93,seq94,r_218_120_73,1.0,1,74,73,24
46,r_96_254_168,r_209_81_131,r_119_258_37,r_119_258_37,1.0,60,97,37,24
112,seq34,r_267_92_170,r_165_160_11,r_165_160_11,0.97,2,13,11,24
80,r_58_16_132,seq84,r_295_235_87,r_58_16_132,0.72,0,132,132,24
4,r_53_136_25,r_32_73_55,seq145,r_53_136_25,0.99,0,25,25,24
69,r_48_221_83,r_247_291_157,seq129,r_48_221_83,1.0,0,83,83,24
45,r_186_144_88,seq66,r_165_160_11,r_186_144_88,0.97,0,88,88,24
42,r_28_190_27,r_267_92_170,seq128,r_28_190_27,1.0,1,28,27,24
41,r_147_296_24,r_271_93_175,seq151,r_147_296_24,1.0,1,25,24,24
8,r_75_132_27,r_272_29_141,seq202,r_75_132_27,0.97,0,27,27,24
158,seq173,r_170_159_65,seq129,r_170_159_65,1.0,0,65,65,24
95,r_7_250_164,seq128,seq38,r_7_250_164,0.55,1,165,164,24
76,r_102_11_141,r_183_111_164,r_117_260_114,r_183_111_164,0.75,-23,141,164,24
103,seq12,r_271_93_175,r_193_52_119,r_193_52_119,0.97,56,175,119,24
67,r_154_281_142,r_292_208_139,seq1,r_292_208_139,0.68,5,144,139,24
15,r_248_220_19,r_267_92_170,seq195,r_248_220_19,0.99,1,20,19,24
3,r_90_142_110,r_102_11_141,r_256_278_30,r_102_11_141,0.74,-31,110,141,24
10,r_287_87_93,seq266,seq155,r_287_87_93,0.99,0,93,93,24
90,r_183_111_164,r_267_92_170,r_53_136_25,r_183_111_164,0.8,1,165,164,24
16,r_54_36_172,seq80,r_125_189_158,r_54_36_172,0.94,2,174,172,24
99,r_165_160_11,r_162_43_115,seq34,r_165_160_11,0.98,0,11,11,24
65,r_31_8_55,r_262_18_197,r_119_258_37,r_31_8_55,1.0,1,56,55,24
174,seq227,r_124_23_147,seq80,r_124_23_147,0.58,-80,67,147,24
78,r_170_159_65,seq173,seq22,r_170_159_65,1.0,0,65,65,24
0,r_267_92_170,r_280_44_176,r_117_260_114,r_280_44_176,0.65,-6,170,176,24
11,r_162_43_115,r_222_131_72,r_219_153_31,r_162_43_115,0.68,-38,77,115,24
20,r_205_56_147,seq226,r_236_230_43,r_205_56_147,0.53,2,149,147,24
49,r_276_255_34,r_197_178_187,seq226,r_276_255_34,1.0,0,34,34,24
98,r_224_229_112,r_279_289_4,r_47_134_149,r_279_289_4,0.73,109,113,4,24
46,r_96_254_168,r_119_258_37,r_7_250_164,r_96_254_168,0.99,0,168,168,24
48,r_143_294_125,r_273_214_137,r_295_235_87,r_143_294_125,0.9,0,125,125,24
62,r_39_212_156,seq177,seq14,r_39_212_156,0.7,0,156,156,24
75,r_228_161_42,r_194_130_192,r_165_160_11,r_228_161_42,0.69,14,56,42,24
2,r_119_258_37,r_96_254_168,r_222_131_72,r_119_258_37,0.7,131,168,37,24
72,r_239_0_17,r_287_87_93,seq283,r_239_0_17,0.99,0,17,17,24
19,r_32_73_55,r_295_235_87,seq112,r_32_73_55,1.0,0,55,55,24
117,seq45,r_143_294_125,seq202,r_143_294_125,0.98,1,126,125,24
87,r_101_15_76,r_7_250_164,r_27_182_52,r_7_250_164,0.82,-87,77,164,24
73,r_259_188_20,seq45,seq157,r_259_188_20,1.0,0,20,20,24
47,r_49_225_161,seq283,r_295_235_87,r_49_225_161,0.71,0,161,161,24
106,seq17,r_19_51_54,seq66,r_19_51_54,1.0,0,54,54,24
105,seq14,seq1,r_39_212_156,r_39_212_156,0.85,0,156,156,24
18,r_138_252_133,seq184,r_106_270_65,r_138_252_133,0.7,0,133,133,24
38,r_256_278_30,r_39_212_156,seq282,r_256_278_30,1.0,0,30,30,24
25,r_193_52_119,seq121,seq12,r_193_52_119,1.0,0,119,119,24
64,r_166_59_154,seq210,r_272_29_141,r_166_59_154,0.73,0,154,154,24
88,r_273_214_137,seq202,r_186_144_88,r_186_144_88,0.52,49,137,88,24
50,r_106_270_65,r_141_206_149,seq121,r_106_270_65,1.0,0,65,65,24
70,r_115_175_166,seq282,r_287_87_93,r_115_175_166,0.86,0,166,166,24
192,seq282,r_279_289_4,r_256_278_30,r_256_278_30,1.0,32,62,30,24
66,r_24_200_52,r_162_43_115,r_259_188_20,r_24_200_52,0.95,1,53,52,24
61,r_172_74_83,r_2_249_164,seq13,r_172_74_83,1.0,0,83,83,24
32,r_265_187_73,seq1,r_196_207_49,r_265_187_73,0.88,0,73,73,24
52,r_141_206_149,seq105,seq245,r_141_206_149,0.89,0,149,149,24
77,r_197_178_187,seq91,r_117_260_114,r_197_178_187,0.56,0,187,187,24
27,r_103_215_57,r_279_289_4,seq171,r_103_215_57,1.0,1,58,57,24
168,seq204,r_117_260_114,seq88,r_117_260_114,1.0,1,115,114,24
2,r_119_258_37,r_125_189_158,r_96_254_168,r_119_258_37,0.98,2,39,37,24
85,r_27_182_52,seq98,r_219_153_31,r_27_182_52,0.53,1,53,52,24
53,r_104_110_36,seq286,r_239_0_17,r_104_110_36,0.96,1,37,36,24
9,r_181_100_100,r_183_111_164,seq129,r_181_100_100,0.99,0,100,100,24
63,r_196_207_49,r_279_289_4,r_265_187_73,r_265_187_73,1.0,77,150,73,24
145,seq129,r_124_23_147,r_181_100_100,r_181_100_100,1.0,47,147,100,24
37,r_219_153_31,r_162_43_115,r_27_182_52,r_162_43_115,0.99,0,115,115,24
22,r_3_192_121,r_223_6_145,r_47_134_149,r_3_192_121,0.98,0,121,121,24
28,r_295_235_87,r_154_281_142,seq171,r_154_281_142,1.0,-45,97,142,24
91,r_118_216_104,seq129,r_256_278_30,r_256_278_30,0.86,75,105,30,24
37,r_219_153_31,r_70_251_194,r_162_43_115,r_219_153_31,1.0,0,31,31,24
135,seq97,r_70_251_194,r_236_230_43,r_236_230_43,1.0,54,97,43,24
164,seq195,r_146_67_91,r_248_220_19,r_146_67_91,0.6,0,91,91,24
56,r_222_131_72,r_162_43_115,r_31_8_55,r_222_131_72,1.0,5,77,72,24
44,r_55_65_83,r_193_52_119,seq46,r_55_65_83,1.0,0,83,83,24
23,r_232_5_163,seq155,r_219_153_31,r_232_5_163,0.74,0,163,163,24
57,r_63_109_51,seq299,seq50,r_63_109_51,1.0,0,51,51,24
63,r_196_207_49,r_24_200_52,r_279_289_4,r_196_207_49,1.0,0,49,49,24
79,r_223_6_145,seq237,seq157,r_223_6_145,0.68,0,145,145,24
35,r_64_261_99,r_96_254_168,seq145,r_64_261_99,1.0,0,99,99,24
117,seq45,r_259_188_20,r_143_294_125,r_259_188_20,0.89,0,20,20,24
12,r_124_23_147,seq129,r_137_107_52,r_124_23_147,0.18,0,147,147,24
11,r_162_43_115,r_219_153_31,seq286,r_162_43_115,0.99,1,116,115,24
84,r_288_234_103,r_47_134_149,r_137_107_52,r_47_134_149,1.0,-45,104,149,24
93,r_79_20_190,r_146_156_194,r_63_50_52,r_146_156_194,0.55,-4,190,194,25
51,r_232_211_178,seq206,r_223_45_129,r_232_211_178,0.37,0,178,178,25
36,r_186_256_75,r_128_148_141,seq172,r_186_256_75,1.0,1,76,75,25
57,r_3_2_93,r_29_181_71,seq192,r_3_2_93,0.96,0,93,93,25
14,r_5_136_138,r_288_17_175,r_213_41_73,r_213_41_73,1.0,65,138,73,25
8,r_38_105_158,r_11_205_3,seq98,r_38_105_158,0.74,0,158,158,25
53,r_261_228_73,r_128_148_141,r_176_42_141,r_261_228_73,1.0,1,74,73,25
1,r_198_133_32,r_118_32_193,r_207_49_1,r_198_133_32,1.0,0,32,32,25
82,r_252_75_17,seq182,seq28,r_252_75_17,0.63,-2,15,17,25
92,r_214_59_56,r_3_2_93,seq289,r_214_59_56,1.0,0,56,56,25
59,r_68_83_130,r_213_41_73,seq255,r_213_41_73,1.0,0,73,73,25
71,r_263_111_147,r_37_73_196,r_187_277_74,r_187_277_74,0.91,80,154,74,25
21,r_290_101_109,r_179_262_173,r_76_1_154,r_290_101_109,0.96,0,109,109,25
5,r_244_241_151,r_138_102_98,seq92,r_244_241_151,0.75,0,151,151,25
104,seq13,r_163_215_168,seq255,r_163_215_168,0.41,-23,145,168,25
46,r_217_237_112,seq26,r_127_284_14,r_217_237_112,1.0,0,112,112,25
42,r_57_141_163,seq108,r_127_284_14,r_57_141_163,0.91,0,163,163,25
80,r_178_270_84,seq85,r_99_48_32,r_178_270_84,0.68,1,85,84,25
32,r_213_41_73,r_198_133_32,r_5_136_138,r_5_136_138,0.87,10,148,138,25
73,r_76_1_154,r_290_101_109,r_275_299_11,r_76_1_154,0.99,0,154,154,25
19,r_106_60_116,r_146_156_194,r_275_299_11,r_106_60_116,0.98,0,116,116,25
37,r_189_194_41,r_63_50_52,seq10,r_189_194_41,1.0,0,41,41,25
153,seq164,r_163_215_168,r_89_266_47,r_89_266_47,0.67,124,171,47,25
11,r_71_281_34,r_116_212_125,seq24,r_71_281_34,1.0,1,35,34,25
49,r_89_266_47,seq54,seq255,r_89_266_47,0.98,6,53,47,25
66,r_4_94_101,seq257,seq6,r_4_94_101,1.0,0,101,101,25
78,r_238_34_21,r_175_245_126,r_142_8_96,r_175_245_126,0.75,2,128,126,25
76,r_93_224_85,r_158_131_86,seq257,r_93_224_85,1.0,0,85,85,25
67,r_293_23_146,r_282_204_93,r_144_82_28,r_282_204_93,0.73,-1,92,93,25
89,r_175_245_126,r_146_156_194,r_68_83_130,r_175_245_126,0.87,2,128,126,25
10,r_81_166_171,seq64,seq77,r_81_166_171,0.83,0,171,171,25
90,r_36_278_63,seq268,seq28,r_36_278_63,1.0,0,63,63,25
4,r_9_145_187,r_176_42_141,seq283,r_9_145_187,0.54,1,188,187,25
72,r_193_171_166,seq108,r_198_133_32,r_193_171_166,0.76,0,166,166,25
170,seq220,seq139,r_149_227_118,r_149_227_118,1.0,3,121,118,25
4,r_9_145_187,seq92,r_176_42_141,r_176_42_141,0.81,7,148,141,25
0,r_29_181_71,r_81_166_171,r_3_2_93,r_29_181_71,0.85,1,72,71,25
63,r_87_78_93,r_81_166_171,seq26,r_87_78_93,1.0,0,93,93,25
73,r_76_1_154,r_229_165_158,r_290_101_109,r_290_101_109,0.88,11,120,109,25
55,r_33_40_19,r_76_1_154,r_69_124_2,r_33_40_19,1.0,0,19,19,25
20,r_125_143_129,seq53,seq159,r_125_143_129,0.99,2,131,129,25
13,r_146_156_194,r_106_60_116,r_142_8_96,r_106_60_116,1.0,0,116,116,25
163,seq192,r_263_111_147,r_3_2_93,r_3_2_93,1.0,0,93,93,25
98,r_202_234_143,seq61,r_168_113_47,r_202_234_143,0.99,0,143,143,25
0,r_29_181_71,r_3_2_93,r_163_215_168,r_3_2_93,0.81,0,93,93,25
15,r_187_277_74,r_287_296_86,seq230,r_187_277_74,1.0,1,75,74,25
48,r_210_121_105,seq100,seq97,r_210_121_105,0.95,0,105,105,25
54,r_168_113_47,r_128_148_141,seq0,r_168_113_47,1.0,1,48,47,25
17,r_144_82_28,seq58,r_293_23_146,r_144_82_28,0.82,9,37,28,25
57,r_3_2_93,r_123_267_80,r_29_181_71,r_3_2_93,0.85,-14,79,93,25
12,r_128_148_141,r_250_253_14,seq80,r_128_148_141,0.67,0,141,141,25
167,seq206,r_30_209_173,r_116_212_125,r_116_212_125,0.99,48,173,125,25
6,r_123_267_80,r_3_2_93,r_126_117_16,r_126_117_16,1.0,64,80,16,25
99,r_116_212_125,seq16,seq206,r_116_212_125,0.9,0,125,125,25
52,r_176_42_141,r_261_228_73,r_258_15_140,r_261_228_73,0.91,69,142,73,25
45,r_140_297_46,r_84_74_42,r_275_299_11,r_140_297_46,1.0,2,48,46,25
69,r_99_48_32,r_81_166_171,seq254,r_99_48_32,0.96,0,32,32,25
27,r_11_205_3,r_38_105_158,r_161_109_129,r_11_205_3,0.87,155,158,3,25
53,r_261_228_73,r_176_42_141,r_125_143_129,r_261_228_73,0.99,69,142,73,25
70,r_67_235_37,r_65_134_140,seq182,r_67_235_37,1.0,0,37,37,25
87,r_207_49_1,seq220,r_198_133_32,r_198_133_32,1.0,18,50,32,25
22,r_127_284_14,r_288_17_175,r_5_136_138,r_288_17_175,0.73,2,177,175,25
88,r_173_221_39,seq283,seq268,r_173_221_39,1.0,0,39,39,25
39,r_177_110_56,seq269,r_275_299_11,r_177_110_56,1.0,0,56,56,25
2,r_287_296_86,seq100,seq247,r_287_296_86,1.0,0,86,86,25
28,r_275_299_11,r_287_296_86,seq218,r_275_299_11,1.0,0,11,11,25
40,r_30_209_173,seq206,r_198_133_32,r_30_209_173,0.81,0,173,173,25
105,seq16,r_116_212_125,r_129_120_95,r_116_212_125,1.0,0,125,125,25
12,r_128_148_141,r_186_256_75,r_250_253_14,r_250_253_14,0.72,-1,13,14,25
193,seq283,r_173_221_39,r_275_299_11,r_173_221_39,0.79,0,39,39,25
18,r_229_165_158,seq77,r_282_204_93,r_282_204_93,1.0,76,169,93,25
29,r_129_120_95,r_118_32_193,r_99_48_32,r_99_48_32,0.85,66,98,32,25
67,r_293_23_146,r_144_82_28,r_282_204_93,r_293_23_146,1.0,0,146,146,25
24,r_52_203_161,seq257,r_158_131_86,r_52_203_161,0.92,1,162,161,25
35,r_250_253_14,r_128_148_141,r_188_265_141,r_250_253_14,1.0,127,141,14,25
25,r_223_45_129,seq43,seq86,r_223_45_129,0.91,0,129,129,25
108,seq24,seq273,r_71_281_34,r_71_281_34,1.0,17,51,34,25
50,r_272_70_105,r_161_109_129,r_123_267_80,r_161_109_129,0.54,-24,105,129,25
58,r_258_15_140,r_72_197_149,r_176_42_141,r_72_197_149,0.86,-7,142,149,25
65,r_72_197_149,seq28,r_223_45_129,r_72_197_149,0.78,0,149,149,25
68,r_291_191_156,seq39,seq96,r_291_191_156,0.55,0,156,156,25
61,r_65_134_140,seq80,seq100,r_65_134_140,0.94,0,140,140,25
32,r_213_41_73,r_68_83_130,r_198_133_32,r_213_41_73,1.0,0,73,73,25
78,r_238_34_21,seq7,r_175_245_126,r_238_34_21,1.0,0,21,21,25
38,r_12_260_143,seq185,r_282_204_93,r_282_204_93,0.99,50,143,93,25
52,r_176_42_141,seq154,r_261_228_73,r_261_228_73,1.0,7,80,73,25
196,seq289,r_179_262_173,r_201_248_22,r_201_248_22,0.51,152,174,22,25
35,r_250_253_14,r_213_41_73,r_128_148_141,r_250_253_14,0.99,-1,13,14,25
22,r_127_284_14,seq218,r_288_17_175,r_127_284_14,1.0,0,14,14,25
75,r_142_8_96,r_22_151_178,r_238_34_21,r_142_8_96,0.94,2,98,96,25
83,r_276_62_23,seq24,seq219,r_276_62_23,1.0,0,23,23,25
60,r_138_102_98,r_244_241_151,r_282_204_93,r_282_204_93,0.5,31,124,93,25
150,seq159,r_249_103_130,r_125_143_129,r_125_143_129,1.0,2,131,129,25
81,r_22_151_178,seq239,r_63_50_52,r_22_151_178,0.62,0,178,178,25
94,r_163_215_168,seq115,r_168_113_47,r_168_113_47,1.0,124,171,47,25
96,r_56_19_137,r_14_264_174,seq27,r_56_19_137,0.73,0,137,137,25
193,seq283,r_275_299_11,r_9_145_187,r_9_145_187,0.56,2,189,187,25
62,r_288_17_175,r_127_284_14,r_104_190_23,r_288_17_175,0.4,2,177,175,25
91,r_31_132_74,r_261_228_73,r_119_295_48,r_119_295_48,0.92,29,77,48,25
3,r_63_50_52,seq27,seq222,r_63_50_52,0.91,4,56,52,25
56,r_161_109_129,seq122,r_11_205_3,r_161_109_129,0.53,1,130,129,25
7,r_179_262_173,seq289,seq122,r_179_262_173,0.55,1,174,173,25
44,r_169_147_88,seq26,r_93_224_85,r_169_147_88,0.94,0,88,88,25
23,r_282_204_93,r_293_23_146,r_138_102_98,r_282_204_93,0.42,0,93,93,25
17,r_144_82_28,r_293_23_146,seq269,r_293_23_146,0.94,0,146,146,25
62,r_288_17_175,r_5_136_138,r_127_284_14,r_127_284_14,1.0,1,15,14,25
21,r_290_101_109,r_76_1_154,r_223_45_129,r_76_1_154,0.96,0,154,154,25
186,seq255,seq180,r_89_266_47,r_89_266_47,0.98,24,71,47,25
79,r_158_131_86,r_93_224_85,seq155,r_93_224_85,0.96,-1,84,85,25
95,r_119_295_48,r_81_166_171,seq26,r_119_295_48,1.0,0,48,48,25
85,r_208_216_32,r_93_224_85,seq289,r_208_216_32,1.0,0,32,32,25
33,r_201_248_22,r_287_296_86,seq289,r_201_248_22,1.0,0,22,22,25
84,r_149_227_118,r_57_141_163,seq220,r_149_227_118,0.71,0,118,118,25
59,r_68_83_130,seq255,r_175_245_126,r_68_83_130,1.0,0,130,130,25
14,r_19_246_75,seq46,seq54,r_19_246_75,1.0,1,76,75,26
53,r_187_68_173,r_202_226_120,seq61,r_202_226_120,1.0,0,120,120,26
43,r_29_149_149,r_164_274_149,seq51,r_29_149_149,0.88,4,153,149,26
84,r_146_130_34,r_85_275_149,seq196,r_146_130_34,0.59,1,35,34,26
3,r_144_230_26,r_164_274_149,r_10_125_141,r_144_230_26,1.0,0,26,26,26
59,r_202_226_120,r_187_68_173,r_248_45_24,r_202_226_120,0.99,0,120,120,26
71,r_123_122_111,r_296_75_155,r_33_139_45,r_123_122_111,1.0,0,111,111,26
16,r_205_6_75,r_162_23_159,seq4,r_205_6_75,1.0,1,76,75,26
21,r_289_137_87,r_278_234_98,r_18_188_72,r_289_137_87,0.99,1,88,87,26
1,r_18_188_72,r_79_81_121,seq154,r_18_188_72,1.0,0,72,72,26
80,r_2_247_174,r_116_83_5,r_60_268_49,r_60_268_49,0.91,125,174,49,26
5,r_164_274_149,r_29_149_149,seq191,r_29_149_149,0.85,4,153,149,26
46,r_103_38_147,seq61,r_97_294_65,r_103_38_147,0.47,0,147,147,26
42,r_203_207_100,seq200,seq54,r_203_207_100,0.61,-4,96,100,26
63,r_225_216_56,r_199_208_112,r_33_139_45,r_199_208_112,0.94,-56,56,112,26
196,seq283,r_108_91_39,r_72_128_66,r_72_128_66,0.74,51,117,66,26
69,r_13_37_90,r_103_38_147,r_99_107_15,r_13_37_90,0.89,0,90,90,26
90,r_279_93_12,r_20_243_146,r_291_101_8,r_279_93_12,0.78,0,12,12,26
86,r_56_213_29,r_286_143_27,r_21_121_3,r_286_143_27,0.99,-4,23,27,26
53,r_187_68_173,seq61,r_240_215_75,r_187_68_173,1.0,1,174,173,26
72,r_60_268_49,r_254_5_126,seq44,r_60_268_49,1.0,2,51,49,26
38,r_167_193_54,seq271,seq168,r_167_193_54,1.0,0,54,54,26
95,r_79_81_121,r_285_94_185,seq111,r_79_81_121,0.93,0,121,121,26
98,r_155_189_26,seq25,r_295_136_112,r_155_189_26,0.91,0,26,26,26
66,r_199_208_112,seq223,r_58_288_9,r_199_208_112,0.73,0,112,112,26
103,seq14,r_62_147_154,r_253_133_146,r_62_147_154,0.82,-4,150,154,26
97,r_116_83_5,r_2_247_174,r_71_292_164,r_2_247_174,0.93,0,174,174,26
31,r_278_234_98,r_186_293_96,seq102,r_186_293_96,1.0,0,96,96,26
30,r_42_259_30,r_165_64_147,r_141_262_45,r_42_259_30,1.0,0,30,30,26
89,r_9_52_85,seq44,seq50,r_9_52_85,1.0,0,85,85,26
152,seq168,r_160_78_117,r_167_193_54,r_167_193_54,0.95,1,55,54,26
10,r_240_215_75,r_48_89_171,seq50,r_240_215_75,1.0,1,76,75,26
44,r_74_112_21,r_34_249_113,seq28,r_74_112_21,0.97,0,21,21,26
54,r_298_59_54,seq28,r_21_121_3,r_298_59_54,0.99,2,56,54,26
28,r_252_156_33,seq177,seq96,r_252_156_33,1.0,0,33,33,26
26,r_97_294_65,seq228,seq63,r_97_294_65,1.0,0,65,65,26
198,seq297,r_8_180_104,seq235,r_8_180_104,1.0,-8,96,104,26
4,r_238_204_131,seq80,r_197_244_1,r_238_204_131,0.8,1,132,131,26
0,r_8_180_104,seq297,r_210_7_18,r_8_180_104,0.98,0,104,104,26
73,r_113_263_115,r_119_53_43,seq168,r_113_263_115,0.99,0,115,115,26
11,r_260_182_167,seq219,r_62_147_154,r_260_182_167,0.74,1,168,167,26
107,seq25,r_18_188_72,r_171_151_63,r_18_188_72,0.82,-2,70,72,26
20,r_145_195_188,seq174,r_65_173_55,r_65_173_55,1.0,133,188,55,26
13,r_181_124_170,seq105,r_254_5_126,r_254_5_126,1.0,45,171,126,26
57,r_71_292_164,seq277,r_13_37_90,r_13_37_90,1.0,81,171,90,26
62,r_186_293_96,r_278_234_98,r_286_143_27,r_278_234_98,0.72,-2,96,98,26
85,r_266_206_148,seq273,r_240_215_75,r_240_215_75,1.0,74,149,75,26
8,r_172_265_57,r_103_38_147,seq22,r_172_265_57,1.0,0,57,57,26
19,r_284_270_52,r_240_215_75,r_167_193_54,r_284_270_52,1.0,3,55,52,26
99,r_242_67_142,seq102,seq61,r_242_67_142,0.97,0,142,142,26
52,r_295_136_112,r_155_189_26,seq132,r_295_136_112,1.0,0,112,112,26
45,r_33_139_45,r_34_249_113,r_3_100_34,r_34_249_113,0.96,-68,45,113,26
87,r_237_157_91,r_158_30_191,seq245,r_237_157_91,1.0,0,91,91,26
79,r_57_185_12,r_20_243_146,seq82,r_57_185_12,0.77,1,13,12,26
52,r_295_136_112,r_227_1_43,r_155_189_26,r_295_136_112,0.99,-89,23,112,26
2,r_254_5_126,r_41_27_157,r_57_185_12,r_254_5_126,0.93,0,126,126,26
47,r_85_275_149,seq258,seq219,r_85_275_149,0.99,0,149,149,26
96,r_99_107_15,r_98_84_53,seq236,r_99_107_15,0.81,0,15,15,26
93,r_160_78_117,r_155_189_26,seq142,r_160_78_117,0.97,0,117,117,26
40,r_165_64_147,seq261,r_33_139_45,r_165_64_147,0.65,0,147,147,26
18,r_48_89_171,seq273,r_20_243_146,r_48_89_171,0.55,0,171,171,26
29,r_62_147_154,seq14,seq169,r_62_147_154,0.87,0,154,154,26
27,r_141_262_45,r_10_125_141,r_42_259_30,r_42_259_30,0.81,20,50,30,26
33,r_34_249_113,seq104,r_21_121_3,r_34_249_113,0.87,3,116,113,26
50,r_12_148_195,r_70_233_180,r_197_244_1,r_70_233_180,0.67,-70,110,180,26
70,r_209_129_80,seq0,r_140_127_17,r_209_129_80,0.99,0,80,80,26
77,r_179_35_45,r_254_5_126,seq134,r_179_35_45,1.0,0,45,45,26
6,r_286_143_27,r_113_263_115,r_218_26_47,r_286_143_27,0.73,88,115,27,26
65,r_41_27_157,r_47_212_194,r_238_204_131,r_41_27_157,0.51,14,171,157,26
130,seq102,r_242_67_142,r_278_234_98,r_242_67_142,0.99,0,142,142,26
61,r_72_128_66,r_164_274_149,seq283,r_72_128_66,0.76,0,66,66,26
32,r_70_233_180,seq106,r_34_249_113,r_34_249_113,0.81,67,180,113,26
64,r_108_91_39,seq277,seq283,r_108_91_39,0.87,13,52,39,26
154,seq174,r_145_195_188,r_48_89_171,r_48_89_171,0.56,17,188,171,26
124,seq80,r_238_204_131,seq174,r_238_204_131,0.76,1,132,131,26
132,seq105,r_181_124_170,r_290_251_50,r_290_251_50,1.0,121,171,50,26
34,r_16_220_12,r_85_275_149,seq273,r_16_220_12,0.74,-1,11,12,26
93,r_160_78_117,r_227_1_43,r_155_189_26,r_227_1_43,0.61,0,43,43,26
17,r_15_176_65,seq276,seq134,r_15_176_65,0.81,0,65,65,26
75,r_211_267_52,seq43,seq126,r_211_267_52,0.97,1,53,52,26
94,r_171_151_63,seq192,seq25,r_171_151_63,0.96,0,63,63,26
145,seq142,seq17,r_160_78_117,r_160_78_117,1.0,19,136,117,26
48,r_227_1_43,r_295_136_112,seq54,r_227_1_43,1.0,0,43,43,26
51,r_3_100_34,r_225_216_56,r_10_125_141,r_10_125_141,1.0,-106,35,141,26
6,r_286_143_27,r_205_6_75,r_113_263_115,r_286_143_27,1.0,0,27,27,26
98,r_155_189_26,r_295_136_112,r_167_193_54,r_155_189_26,0.71,89,115,26,26
22,r_20_243_146,seq31,r_58_288_9,r_20_243_146,0.97,-1,145,146,26
102,seq11,r_285_94_185,r_171_151_63,r_171_151_63,0.91,122,185,63,26
49,r_170_138_71,r_165_64_147,seq177,r_170_138_71,0.94,0,71,71,26
140,seq126,seq163,r_211_267_52,r_211_267_52,0.99,13,65,52,26
58,r_140_127_17,r_42_259_30,r_21_121_3,r_140_127_17,1.0,0,17,17,26
39,r_32_198_44,r_253_133_146,seq22,r_32_198_44,0.96,0,44,44,26
56,r_66_92_184,seq280,r_253_133_146,r_66_92_184,0.63,0,184,184,26
7,r_217_86_85,r_158_30_191,r_119_53_43,r_217_86_85,0.93,0,85,85,26
131,seq104,r_34_249_113,r_227_1_43,r_227_1_43,0.95,68,111,43,26
23,r_218_26_47,seq28,seq95,r_218_26_47,1.0,0,47,47,26
68,r_190_39_11,seq177,seq54,r_190_39_11,0.96,0,11,11,26
176,seq236,r_70_233_180,r_99_107_15,r_99_107_15,0.96,-1,14,15,26
25,r_210_7_18,r_18_188_72,seq163,r_210_7_18,1.0,1,19,18,26
83,r_98_84_53,seq194,seq43,r_98_84_53,1.0,0,53,53,26
51,r_170_44_65,r_135_121_111,seq267,r_170_44_65,0.8,0,65,65,27
36,r_107_48_185,r_298_182_182,r_30_257_55,r_30_257_55,0.57,130,185,55,27
9,r_294_18_178,seq275,r_36_92_169,r_36_92_169,0.99,8,177,169,27
118,seq62,r_220_260_171,r_183_16_5,r_183_16_5,0.55,13,18,5,27
92,r_39_230_180,seq207,r_14_22_62,r_14_22_62,1.0,118,180,62,27
8,r_14_22_62,r_125_248_168,seq29,r_14_22_62,1.0,0,62,62,27
116,seq52,seq89,r_34_250_27,r_34_250_27,1.0,7,34,27,27
83,r_93_224_133,seq275,r_11_91_60,r_11_91_60,1.0,80,140,60,27
37,r_59_203_96,r_288_120_128,r_145_210_70,r_59_203_96,0.97,0,96,96,27
59,r_49_223_184,seq58,r_56_112_28,r_49_223_184,0.34,1,185,184,27
19,r_213_162_113,r_289_79_32,seq113,r_213_162_113,0.8,2,115,113,27
55,r_109_243_143,r_56_112_28,seq43,r_109_243_143,0.79,4,147,143,27
71,r_37_297_79,seq199,r_220_260_171,r_37_297_79,1.0,0,79,79,27
86,r_36_92_169,seq29,seq165,r_36_92_169,0.74,0,169,169,27
21,r_135_121_111,seq189,seq105,r_135_121_111,0.79,7,118,111,27
39,r_55_296_176,seq43,r_133_146_42,r_133_146_42,0.98,134,176,42,27
1,r_23_287_74,r_235_45_90,r_19_61_1,r_23_287_74,1.0,0,74,74,27
97,r_110_17_172,r_152_166_175,r_19_61_1,r_19_61_1,0.81,171,172,1,27
5,r_295_40_78,seq119,seq126,r_295_40_78,0.99,0,78,78,27
29,r_0_168_33,r_23_287_74,seq104,r_0_168_33,0.69,0,33,33,27
31,r_284_282_56,r_5_244_60,r_140_151_152,r_284_282_56,1.0,0,56,56,27
45,r_240_94_145,r_290_264_11,r_288_120_128,r_240_94_145,0.88,0,145,145,27
56,r_68_118_52,r_294_18_178,seq89,r_68_118_52,0.77,0,52,52,27
89,r_289_79_32,r_213_162_113,seq77,r_213_162_113,0.62,2,115,113,27
15,r_133_146_42,seq103,seq111,r_133_146_42,0.99,0,42,42,27
76,r_220_260_171,seq62,r_37_297_79,r_37_297_79,1.0,3,82,79,27
184,seq254,r_290_264_11,r_255_217_68,r_255_217_68,1.0,79,147,68,27
41,r_90_252_134,seq1,seq119,r_90_252_134,0.89,-1,133,134,27
67,r_155_144_155,seq258,r_255_217_68,r_255_217_68,0.99,87,155,68,27
62,r_140_151_152,r_213_162_113,r_284_282_56,r_284_282_56,0.97,0,56,56,27
50,r_171_167_41,r_216_4_151,seq111,r_171_167_41,1.0,0,41,41,27
10,r_66_245_100,seq275,r_271_215_45,r_66_245_100,0.97,1,101,100,27
44,r_200_268_43,r_59_203_96,r_242_172_43,r_59_203_96,0.76,-53,43,96,27
90,r_97_299_90,r_184_291_1,r_3_274_63,r_97_299_90,0.43,5,95,90,27
89,r_289_79_32,r_59_203_96,r_213_162_113,r_289_79_32,1.0,0,32,32,27
115,seq50,r_185_241_118,r_176_206_68,r_176_206_68,0.82,62,130,68,27
26,r_187_286_78,r_196_153_77,r_2_95_80,r_2_95_80,0.96,0,80,80,27
160,seq191,r_242_172_43,r_288_120_128,r_242_172_43,0.99,0,43,43,27
72,r_209_247_152,seq219,seq38,r_209_247_152,0.83,0,152,152,27
4,r_32_86_157,r_107_48_185,seq74,r_32_86_157,0.65,0,157,157,27
78,r_60_24_168,seq89,r_242_172_43,r_242_172_43,0.51,125,168,43,27
63,r_2_95_80,seq77,r_187_286_78,r_2_95_80,1.0,0,80,80,27
73,r_281_158_168,seq38,r_133_146_42,r_281_158_168,0.76,0,168,168,27
11,r_255_217_68,r_184_291_1,r_272_180_55,r_184_291_1,1.0,69,70,1,27
20,r_186_31_156,r_136_218_161,r_19_61_1,r_186_31_156,0.66,1,157,156,27
46,r_183_16_5,seq62,r_37_297_79,r_37_297_79,1.0,3,82,79,27
54,r_34_250_27,r_271_215_45,seq52,r_34_250_27,1.0,0,27,27,27
48,r_195_63_109,seq102,seq212,r_195_63_109,0.94,0,109,109,27
57,r_3_274_63,seq43,r_97_299_90,r_3_274_63,0.57,18,81,63,27
170,seq212,seq169,r_195_63_109,r_195_63_109,0.67,-3,106,109,27
0,r_242_172_43,seq191,seq141,r_242_172_43,1.0,-3,40,43,27
85,r_64_65_169,seq254,r_236_160_167,r_64_65_169,0.67,3,172,169,27
99,r_85_143_84,r_261_221_178,seq12,r_85_143_84,0.82,3,87,84,27
27,r_11_91_60,r_195_63_109,seq258,r_11_91_60,1.0,0,60,60,27
172,seq219,r_209_247_152,r_225_73_54,r_225_73_54,0.99,98,152,54,27
162,seq194,r_249_33_111,seq89,r_249_33_111,0.85,-3,108,111,27
42,r_216_4_151,r_171_167_41,r_261_221_178,r_171_167_41,1.0,0,41,41,27
2,r_137_13_190,seq12,r_159_6_170,r_159_6_170,0.6,20,190,170,27
47,r_154_70_61,r_195_63_109,seq25,r_154_70_61,1.0,0,61,61,27
142,seq126,seq266,r_295_40_78,r_295_40_78,1.0,25,103,78,27
17,r_272_180_55,seq9,seq29,r_272_180_55,1.0,0,55,55,27
74,r_261_221_178,r_19_61_1,r_242_172_43,r_261_221_178,0.48,0,178,178,27
18,r_185_241_118,seq50,r_34_250_27,r_34_250_27,1.0,103,130,27,27
24,r_276_174_72,r_155_144_155,seq169,r_276_174_72,1.0,0,72,72,27
170,seq212,r_271_215_45,seq169,r_271_215_45,0.99,0,45,45,27
33,r_8_190_154,r_36_92_169,seq67,r_8_190_154,0.65,0,154,154,27
88,r_5_244_60,seq119,seq149,r_5_244_60,1.0,0,60,60,27
70,r_125_248_168,seq74,r_259_128_3,r_125_248_168,0.82,1,169,168,27
65,r_138_21_161,r_56_112_28,r_145_210_70,r_56_112_28,0.84,133,161,28,27
42,r_216_4_151,r_261_221_178,seq102,r_216_4_151,0.82,0,151,151,27
61,r_249_33_111,seq194,seq25,r_249_33_111,0.55,10,121,111,27
32,r_152_166_175,seq111,r_147_57_126,r_152_166_175,0.66,0,175,175,27
38,r_231_78_61,r_195_63_109,r_35_42_1,r_231_78_61,1.0,0,61,61,27
52,r_236_160_167,seq15,seq123,r_236_160_167,0.72,0,167,167,27
76,r_220_260_171,r_37_297_79,r_216_4_151,r_220_260_171,0.97,0,171,171,27
71,r_37_297_79,r_220_260_171,r_183_16_5,r_220_260_171,1.0,-11,160,171,27
154,seq169,seq212,r_276_174_72,r_276_174_72,1.0,0,72,72,27
43,r_124_131_13,seq181,r_273_192_10,r_124_131_13,0.9,0,13,13,27
75,r_211_173_84,r_83_99_193,seq29,r_211_173_84,1.0,0,84,84,27
60,r_288_120_128,seq41,seq191,r_288_120_128,0.76,5,133,128,27
168,seq207,r_39_230_180,r_53_270_183,r_39_230_180,0.54,0,180,180,27
94,r_69_134_127,seq149,seq181,r_69_134_127,0.8,1,128,127,27
9,r_294_18_178,r_68_118_52,seq275,r_68_118_52,0.61,12,64,52,27
145,seq141,seq20,r_242_172_43,r_242_172_43,1.0,18,61,43,27
96,r_115_239_169,r_177_205_192,r_216_4_151,r_177_205_192,0.73,-23,169,192,27
19,r_213_162_113,r_2_95_80,r_289_79_32,r_213_162_113,0.45,-74,39,113,27
31,r_284_282_56,r_140_151_152,r_145_210_70,r_140_151_152,0.71,0,152,152,27
62,r_140_151_152,r_284_282_56,seq142,r_140_151_152,0.89,0,152,152,27
53,r_225_73_54,r_59_203_96,seq219,r_225_73_54,1.0,0,54,54,27
22,r_30_257_55,r_49_223_184,seq25,r_30_257_55,1.0,0,55,55,27
28,r_75_72_147,seq117,r_242_172_43,r_75_72_147,0.71,0,147,147,27
69,r_156_114_18,r_56_112_28,seq293,r_156_114_18,0.79,5,23,18,27
138,seq117,r_75_72_147,seq207,r_75_72_147,0.94,-7,140,147,27
82,r_10_51_134,r_55_296_176,r_211_173_84,r_55_296_176,0.99,-42,134,176,27
79,r_76_175_80,r_184_291_1,r_198_54_40,r_76_175_80,1.0,0,80,80,27
35,r_100_101_124,seq178,seq149,r_100_101_124,0.74,-1,123,124,27
95,r_271_215_45,seq212,seq41,r_271_215_45,1.0,0,45,45,27
84,r_176_206_68,r_56_112_28,seq50,r_176_206_68,0.94,4,72,68,27
58,r_71_116_45,r_159_6_170,seq89,r_71_116_45,0.83,0,45,45,27
93,r_171_15_103,seq173,seq101,r_171_15_103,0.71,1,104,103,28
53,r_152_143_27,r_219_104_135,seq119,r_152_143_27,0.94,2,29,27,28
99,r_187_236_32,r_256_2_165,r_33_46_195,r_187_236_32,0.99,0,32,32,28
64,r_134_54_42,r_290_247_158,seq148,r_134_54_42,0.75,1,43,42,28
14,r_292_123_133,r_210_30_160,r_192_115_35,r_210_30_160,0.78,-26,134,160,28
43,r_17_76_124,seq289,r_197_99_41,r_17_76_124,0.72,2,126,124,28
54,r_192_115_35,r_114_68_174,r_292_123_133,r_292_123_133,0.75,41,174,133,28
59,r_1_227_187,r_60_263_185,r_26_266_25,r_26_266_25,0.81,162,187,25,28
55,r_120_212_100,seq283,seq173,r_120_212_100,1.0,0,100,100,28
71,r_254_128_90,seq215,seq91,r_254_128_90,0.99,0,90,90,28
86,r_200_65_68,r_213_169_150,seq25,r_200_65_68,1.0,4,72,68,28
16,r_195_297_105,seq286,r_122_225_105,r_195_297_105,0.72,-1,104,105,28
21,r_243_61_62,seq119,seq101,r_243_61_62,1.0,2,64,62,28
39,r_291_190_188,seq73,r_161_156_170,r_161_156_170,0.7,19,189,170,28
97,r_180_274_158,seq25,r_70_272_51,r_70_272_51,0.78,108,159,51,28
46,r_137_124_70,seq118,r_111_220_165,r_111_220_165,0.62,-101,64,165,28
80,r_178_94_174,r_170_52_162,r_167_267_34,r_167_267_34,0.67,134,168,34,28
73,r_296_154_17,r_213_169_150,seq284,r_296_154_17,1.0,0,17,17,28
45,r_264_179_167,r_45_27_2,r_7_40_132,r_264_179_167,0.47,0,167,167,28
9,r_70_272_51,r_219_104_135,seq162,r_70_272_51,1.0,1,52,51,28
31,r_97_138_38,r_259_130_189,seq28,r_97_138_38,0.95,4,42,38,28
19,r_47_6_71,seq79,r_278_191_16,r_47_6_71,1.0,0,71,71,28
47,r_197_99_41,r_171_15_103,r_149_4_164,r_197_99_41,1.0,0,41,41,28
0,r_167_267_34,r_217_244_129,seq73,r_167_267_34,0.99,1,35,34,28
89,r_182_157_135,seq91,seq19,r_182_157_135,0.8,0,135,135,28
3,r_18_262_123,seq19,r_53_223_59,r_18_262_123,0.59,0,123,123,28
10,r_62_265_127,seq216,r_167_267_34,r_167_267_34,0.97,95,129,34,28
90,r_132_20_159,seq101,seq29,r_132_20_159,0.81,0,159,159,28
5,r_121_285_57,r_31_269_7,r_258_158_70,r_258_158_70,0.98,1,71,70,28
26,r_14_139_150,r_60_263_185,r_81_23_106,r_81_23_106,0.36,44,150,106,28
72,r_10_241_140,seq218,seq64,r_10_241_140,0.83,-1,139,140,28
198,seq295,r_273_133_186,r_14_139_150,r_14_139_150,0.89,36,186,150,28
4,r_219_104_135,seq214,seq90,r_219_104_135,0.88,0,135,135,28
78,r_232_32_106,r_256_2_165,r_120_212_100,r_256_2_165,1.0,-59,106,165,28
29,r_103_75_59,r_114_68_174,r_14_139_150,r_103_75_59,1.0,0,59,59,28
11,r_136_127_93,seq106,seq41,r_136_127_93,1.0,1,94,93,28
107,seq28,r_233_67_96,r_97_138_38,r_97_138_38,0.98,117,155,38,28
20,r_53_223_59,seq29,seq142,r_53_223_59,0.93,10,69,59,28
13,r_235_205_131,seq44,r_232_32_106,r_235_205_131,0.89,0,131,131,28
46,r_137_124_70,r_111_220_165,r_170_52_162,r_137_124_70,0.85,95,165,70,28
15,r_217_244_129,seq59,seq287,r_217_244_129,0.73,1,130,129,28
48,r_290_247_158,seq162,seq37,r_290_247_158,0.64,0,158,158,28
35,r_209_55_33,r_137_124_70,seq119,r_209_55_33,0.92,4,37,33,28
76,r_271_172_15,seq85,seq206,r_271_172_15,0.89,0,15,15,28
57,r_34_201_152,r_222_226_164,r_213_169_150,r_222_226_164,0.68,-7,157,164,28
106,seq25,r_180_274_158,r_12_246_90,r_12_246_90,0.98,68,158,90,28
6,r_0_78_60,seq63,r_234_66_35,r_0_78_60,1.0,1,61,60,28
85,r_48_277_126,seq160,seq242,r_48_277_126,0.82,0,126,126,28
193,seq284,r_126_299_153,r_296_154_17,r_296_154_17,0.85,6,23,17,28
70,r_255_87_16,r_60_263_185,seq214,r_255_87_16,0.99,0,16,16,28
61,r_114_68_174,r_103_75_59,r_192_115_35,r_103_75_59,0.62,0,59,59,28
2,r_7_40_132,seq211,seq135,r_7_40_132,0.63,1,133,132,28
40,r_288_276_187,seq110,r_93_36_68,r_93_36_68,1.0,119,187,68,28
126,seq90,seq237,r_219_104_135,r_219_104_135,0.97,5,140,135,28
74,r_86_50_99,seq101,r_207_238_1,r_86_50_99,0.96,-1,98,99,28
18,r_174_146_102,r_207_238_1,r_233_67_96,r_174_146_102,0.75,0,102,102,28
61,r_114_68_174,r_192_115_35,seq196,r_114_68_174,0.68,0,174,174,28
24,r_202_251_71,r_170_52_162,r_207_238_1,r_202_251_71,0.79,5,76,71,28
47,r_197_99_41,r_149_4_164,r_17_76_124,r_17_76_124,0.71,4,128,124,28
88,r_204_252_139,seq283,seq5,r_204_252_139,0.61,1,140,139,28
156,seq162,r_290_247_158,r_70_272_51,r_70_272_51,1.0,105,156,51,28
50,r_258_158_70,seq216,r_121_285_57,r_258_158_70,0.84,14,84,70,28
58,r_12_246_90,r_270_80_144,r_200_65_68,r_270_80_144,0.98,-53,91,144,28
192,seq283,r_204_252_139,seq275,r_204_252_139,0.74,1,140,139,28
92,r_56_84_26,r_93_36_68,seq109,r_56_84_26,0.97,0,26,26,28
38,r_168_82_60,r_273_133_186,seq237,r_168_82_60,0.67,25,85,60,28
54,r_192_115_35,r_39_177_159,r_114_68_174,r_192_115_35,1.0,2,37,35,28
75,r_39_177_159,seq142,r_93_36_68,r_93_36_68,0.88,91,159,68,28
60,r_278_191_16,r_103_75_59,seq151,r_278_191_16,1.0,0,16,16,28
81,r_261_98_134,seq295,r_209_55_33,r_261_98_134,0.98,1,135,134,28
168,seq206,r_17_76_124,r_271_172_15,r_17_76_124,0.69,-50,74,124,28
17,r_93_36_68,r_168_82_60,seq181,r_93_36_68,1.0,0,68,68,28
173,seq216,r_62_265_127,r_81_23_106,r_81_23_106,0.92,23,129,106,28
94,r_273_133_186,seq295,seq85,r_273_133_186,0.41,0,186,186,28
96,r_38_102_91,seq218,seq5,r_38_102_91,0.8,11,102,91,28
29,r_103_75_59,r_14_139_150,r_93_36_68,r_14_139_150,0.8,0,150,150,28
28,r_33_46_195,seq164,r_187_236_32,r_187_236_32,0.98,35,67,32,28
91,r_149_4_164,seq287,r_136_127_93,r_149_4_164,0.7,3,167,164,28
5,r_121_285_57,r_288_276_187,r_31_269_7,r_121_285_57,0.65,1,58,57,28
49,r_126_299_153,seq184,r_93_36_68,r_126_299_153,0.48,0,153,153,28
56,r_122_225_105,seq165,r_195_297_105,r_122_225_105,0.7,-1,104,105,28
7,r_213_169_150,r_200_65_68,r_34_201_152,r_200_65_68,0.97,9,77,68,28
44,r_221_159_62,r_180_274_158,seq282,r_221_159_62,1.0,2,64,62,28
79,r_234_66_35,r_207_238_1,seq88,r_234_66_35,1.0,0,35,35,28
22,r_26_266_25,r_111_220_165,seq79,r_26_266_25,1.0,0,25,25,28
23,r_60_263_185,r_1_227_187,r_70_272_51,r_70_272_51,0.54,136,187,51,28
159,seq173,r_171_15_103,r_120_212_100,r_120_212_100,0.9,4,104,100,28
101,seq5,r_240_228_173,r_136_127_93,r_136_127_93,0.93,80,173,93,28
182,seq250,r_114_68_174,r_292_123_133,r_292_123_133,1.0,41,174,133,28
93,r_247_171_136,seq188,r_1_270_2,r_247_171_136,0.96,2,138,136,29
30,r_77_160_83,seq204,r_145_115_18,r_77_160_83,1.0,1,84,83,29
176,seq216,r_105_52_185,r_208_88_109,r_208_88_109,1.0,80,189,109,29
64,r_145_115_18,r_229_116_132,r_41_261_124,r_145_115_18,0.85,7,25,18,29
65,r_272_36_50,seq104,seq63,r_272_36_50,0.94,2,52,50,29
36,r_103_157_171,seq98,r_210_228_147,r_103_157_171,0.65,0,171,171,29
14,r_105_52_185,seq216,r_207_232_188,r_207_232_188,0.65,1,189,188,29
8,r_290_48_89,r_124_150_187,r_23_24_12,r_290_48_89,1.0,0,89,89,29
80,r_23_24_12,seq138,seq282,r_23_24_12,0.99,0,12,12,29
54,r_208_88_109,seq83,seq216,r_208_88_109,1.0,0,109,109,29
83,r_183_269_93,r_126_253_104,seq181,r_183_269_93,1.0,0,93,93,29
37,r_82_211_99,seq293,seq97,r_82_211_99,1.0,0,99,99,29
59,r_84_223_160,r_103_157_171,r_229_116_132,r_84_223_160,0.87,0,160,160,29
96,r_35_69_117,seq5,seq109,r_35_69_117,0.99,0,117,117,29
188,seq264,r_252_200_178,r_17_296_116,r_17_296_116,0.98,63,179,116,29
55,r_187_133_131,seq248,r_82_211_99,r_82_211_99,1.0,49,148,99,29
71,r_112_258_82,r_187_133_131,r_15_62_9,r_112_258_82,0.57,4,86,82,29
86,r_166_53_107,r_252_200_178,r_220_289_80,r_252_200_178,1.0,-71,107,178,29
16,r_51_154_70,r_41_261_124,r_90_108_11,r_51_154_70,0.95,4,74,70,29
39,r_40_173_92,r_207_232_188,r_90_108_11,r_40_173_92,1.0,0,92,92,29
165,seq180,r_182_158_134,r_123_285_104,r_182_158_134,0.91,0,134,134,29
97,r_235_117_138,r_28_16_136,r_207_232_188,r_235_117_138,0.99,0,138,138,29
80,r_23_24_12,seq282,r_298_292_66,r_298_292_66,0.67,7,73,66,29
75,r_54_49_17,r_55_278_96,seq128,r_54_49_17,0.99,0,17,17,29
5,r_298_292_66,r_247_171_136,r_23_24_12,r_247_171_136,0.61,-63,73,136,29
46,r_124_150_187,seq176,r_103_157_171,r_103_157_171,0.9,16,187,171,29
58,r_65_118_55,r_39_64_127,r_105_52_185,r_65_118_55,1.0,0,55,55,29
196,seq282,r_23_24_12,r_50_165_89,r_50_165_89,1.0,7,96,89,29
22,r_222_45_56,r_96_238_62,seq27,r_222_45_56,1.0,0,56,56,29
66,r_255_262_72,r_29_190_142,seq25,r_29_190_142,0.6,-68,74,142,29
76,r_146_299_91,seq180,seq61,r_146_299_91,1.0,0,91,91,29
63,r_263_206_37,r_272_36_50,seq167,r_263_206_37,0.99,0,37,37,29
58,r_65_118_55,r_105_52_185,r_294_241_78,r_294_241_78,0.97,14,92,78,29
103,seq7,r_170_196_189,r_81_226_100,r_81_226_100,1.0,61,161,100,29
41,r_55_278_96,r_35_69_117,r_197_37_70,r_35_69_117,0.89,-20,97,117,29
67,r_91_205_113,r_252_200_178,seq120,r_91_205_113,1.0,0,113,113,29
89,r_287_281_138,r_124_150_187,r_183_269_93,r_124_150_187,0.81,-49,138,187,29
3,r_174_67_104,seq43,seq204,r_174_67_104,1.0,1,105,104,29
90,r_182_158_134,seq180,r_244_243_28,r_182_158_134,0.98,0,134,134,29
26,r_142_111_93,seq72,seq63,r_142_111_93,0.65,1,94,93,29
72,r_210_228_147,seq132,seq38,r_210_228_147,0.72,0,147,147,29
179,seq224,seq131,r_162_13_138,r_162_13_138,0.98,5,143,138,29
98,r_156_246_56,r_298_292_66,r_90_108_11,r_156_246_56,1.0,0,56,56,29
174,seq204,r_77_160_83,r_119_242_198,r_77_160_83,1.0,1,84,83,29
29,r_265_215_53,seq288,seq30,r_265_215_53,1.0,0,53,53,29
78,r_110_135_160,seq99,seq149,r_110_135_160,0.97,0,160,160,29
0,r_126_253_104,r_252_200_178,seq176,r_126_253_104,0.65,0,104,104,29
11,r_39_64_127,seq201,r_207_232_188,r_39_64_127,0.93,0,127,127,29
13,r_17_296_116,seq131,seq264,r_17_296_116,1.0,0,116,116,29
48,r_218_203_71,r_174_67_104,r_272_36_50,r_218_203_71,0.99,1,72,71,29
57,r_95_3_109,seq236,r_15_62_9,r_95_3_109,1.0,0,109,109,29
31,r_87_12_13,r_207_232_188,seq163,r_87_12_13,0.94,0,13,13,29
6,r_29_190_142,seq178,seq73,r_29_190_142,0.91,1,143,142,29
62,r_294_241_78,r_50_165_89,r_65_118_55,r_50_165_89,0.98,-11,78,89,29
61,r_244_243_28,seq38,seq66,r_244_243_28,0.95,1,29,28,29
85,r_197_37_70,r_51_154_70,r_207_232_188,r_197_37_70,0.92,0,70,70,29
99,r_81_226_100,seq11,seq7,r_81_226_100,0.99,0,100,100,29
27,r_267_85_88,r_290_48_89,r_245_26_1,r_267_85_88,1.0,0,88,88,29
162,seq176,r_124_150_187,r_126_253_104,r_126_253_104,0.94,83,187,104,29
2,r_162_13_138,r_245_26_1,seq224,r_162_13_138,0.98,0,138,138,29
40,r_195_137_82,r_257_186_135,r_298_292_66,r_195_137_82,0.99,0,82,82,29
181,seq236,seq66,r_44_239_8,r_44_239_8,0.96,28,36,8,29
18,r_96_238_62,r_208_88_109,r_198_213_197,r_96_238_62,0.61,0,62,62,29
24,r_50_165_89,seq161,seq282,r_50_165_89,1.0,0,89,89,29
25,r_59_56_181,seq181,r_207_232_188,r_59_56_181,0.49,0,181,181,29
43,r_240_21_33,seq161,r_254_279_77,r_254_279_77,1.0,38,115,77,29
33,r_276_227_103,seq86,seq8,r_276_227_103,0.39,-4,99,103,29
191,seq271,r_124_150_187,r_19_74_180,r_124_150_187,0.33,-7,180,187,29
82,r_46_250_188,r_10_234_27,r_240_21_33,r_240_21_33,0.59,155,188,33,29
69,r_42_147_41,r_210_228_147,r_90_108_11,r_42_147_41,1.0,1,42,41,29
50,r_284_9_129,seq27,seq288,r_284_9_129,0.99,0,129,129,29
70,r_92_140_132,seq293,seq248,r_92_140_132,0.95,2,134,132,29
92,r_177_209_11,r_231_33_168,seq99,r_177_209_11,0.92,0,11,11,29
44,r_10_234_27,seq282,r_46_250_188,r_10_234_27,0.98,0,27,27,29
173,seq202,r_251_68_38,r_212_169_134,r_212_169_134,0.7,6,140,134,29
32,r_41_261_124,seq63,r_76_275_105,r_76_275_105,0.73,20,125,105,29
38,r_76_275_105,seq163,seq5,r_76_275_105,1.0,0,105,105,29
85,r_197_37_70,r_207_232_188,r_55_278_96,r_55_278_96,0.82,1,97,96,29
45,r_185_184_34,r_283_78_160,seq248,r_185_184_34,0.8,4,38,34,29
34,r_257_186_135,seq5,seq6,r_257_186_135,0.76,-1,134,135,29
64,r_145_115_18,r_41_261_124,r_77_160_83,r_77_160_83,0.93,24,107,83,29
198,seq288,r_265_215_53,seq61,r_265_215_53,1.0,0,53,53,29
60,r_252_200_178,seq264,r_70_106_171,r_252_200_178,0.67,1,179,178,29
17,r_123_285_104,seq102,seq180,r_123_285_104,0.74,1,105,104,29
94,r_18_291_165,seq98,r_174_67_104,r_174_67_104,0.91,63,167,104,29
9,r_70_106_171,seq58,r_51_154_70,r_70_106_171,0.75,0,171,171,29
96,r_35_69_117,r_55_278_96,seq5,r_55_278_96,0.89,1,97,96,29
49,r_20_130_43,r_212_169_134,seq199,r_20_130_43,1.0,0,43,43,29
120,seq63,r_41_261_124,r_218_203_71,r_218_203_71,0.99,54,125,71,29
198,seq288,seq61,r_212_169_134,r_212_169_134,1.0,12,146,134,29
28,r_198_213_197,r_126_253_104,r_96_238_62,r_198_213_197,0.78,-137,60,197,29
91,r_297_134_101,r_76_275_105,r_44_239_8,r_76_275_105,0.98,-4,101,105,29
43,r_240_21_33,seq60,seq161,r_240_21_33,1.0,0,33,33,29
56,r_170_196_189,seq7,r_295_121_72,r_295_121_72,0.99,117,189,72,29
174,seq204,r_119_242_198,r_174_67_104,r_174_67_104,0.88,6,110,104,29
196,seq282,r_17_296_116,r_23_24_12,r_23_24_12,0.98,0,12,12,29
82,r_46_250_188,seq249,r_10_234_27,r_10_234_27,1.0,47,74,27,29
12,r_220_289_80,r_28_16_136,seq60,r_220_289_80,1.0,0,80,80,29
51,r_251_68_38,seq30,seq132,r_251_68_38,1.0,0,38,38,29
74,r_125_172_41,r_257_186_135,seq43,r_125_172_41,1.0,2,43,41,29
93,r_277_202_65,seq37,r_234_17_20,r_277_202_65,0.95,0,65,65,30
51,r_10_154_144,seq2,r_260_29_109,r_10_154_144,0.92,0,144,144,30
92,r_175_265_52,r_36_74_111,seq147,r_36_74_111,1.0,-46,65,111,30
14,r_46_126_66,r_189_249_83,r_14_264_169,r_46_126_66,1.0,0,66,66,30
8,r_235_117_69,r_54_115_163,r_19_53_15,r_235_117_69,1.0,0,69,69,30
151,seq143,r_160_111_173,r_260_29_109,r_260_29_109,1.0,76,185,109,30
58,r_120_70_5,r_100_275_165,r_174_123_122,r_120_70_5,0.62,116,121,5,30
43,r_22_239_126,seq144,seq78,r_22_239_126,0.99,0,126,126,30
54,r_251_95_70,r_41_109_154,r_71_65_19,r_251_95_70,1.0,0,70,70,30
83,r_197_185_116,r_238_221_167,seq268,r_238_221_167,0.5,-46,121,167,30
3,r_158_164_183,seq91,r_100_275_165,r_100_275_165,0.54,18,183,165,30
10,r_27_229_31,r_160_111_173,seq157,r_27_229_31,0.81,0,31,31,30
55,r_227_34_112,seq192,seq1,r_227_34_112,0.99,1,113,112,30
16,r_101_169_113,seq200,r_110_156_97,r_101_169_113,0.99,0,113,113,30
21,r_212_232_70,seq92,seq73,r_212_232_70,0.96,0,70,70,30
1,r_198_136_172,seq204,r_125_245_154,r_125_245_154,0.77,18,172,154,30
5,r_79_261_48,r_172_9_148,seq35,r_172_9_148,0.78,-100,48,148,30
35,r_286_211_118,r_260_29_109,r_188_99_58,r_286_211_118,1.0,-59,59,118,30
88,r_56_105_140,r_240_152_11,r_233_76_6,r_56_105_140,1.0,1,141,140,30
69,r_210_66_118,r_54_115_163,seq2,r_210_66_118,1.0,0,118,118,30
19,r_172_9_148,seq244,r_85_263_60,r_85_263_60,0.98,88,148,60,30
53,r_228_299_34,r_132_129_64,seq42,r_228_299_34,1.0,0,34,34,30
33,r_188_99_58,r_286_211_118,r_231_184_148,r_231_184_148,1.0,11,159,148,30
62,r_97_270_16,r_79_261_48,seq256,r_97_270_16,1.0,0,16,16,30
184,seq244,r_172_9_148,r_79_261_48,r_79_261_48,0.59,100,148,48,30
64,r_71_65_19,r_212_232_70,seq11,r_71_65_19,0.99,1,20,19,30
41,r_127_148_96,seq217,seq92,r_127_148_96,1.0,1,97,96,30
67,r_122_52_72,r_93_279_177,seq225,r_122_52_72,0.78,0,72,72,30
89,r_231_184_148,seq291,r_188_99_58,r_188_99_58,0.74,91,149,58,30
47,r_19_53_15,r_234_17_20,seq50,r_19_53_15,0.99,0,15,15,30
14,r_46_126_66,r_14_264_169,r_100_275_165,r_46_126_66,0.74,100,166,66,30
170,seq205,seq262,r_5_151_115,r_5_151_115,1.0,0,115,115,30
198,seq291,r_5_151_115,seq3,r_5_151_115,1.0,-19,96,115,30
4,r_163_107_122,seq192,r_54_115_163,r_163_107_122,1.0,1,123,122,30
78,r_222_131_166,seq106,r_84_280_157,r_222_131_166,0.55,1,167,166,30
114,seq39,r_100_275_165,r_79_261_48,r_100_275_165,0.71,0,165,165,30
37,r_20_114_46,r_260_29_109,seq3,r_20_114_46,1.0,0,46,46,30
26,r_139_215_51,seq92,seq15,r_139_215_51,1.0,0,51,51,30
20,r_58_25_117,seq55,seq207,r_58_25_117,1.0,0,117,117,30
13,r_110_156_97,seq50,r_220_237_47,r_110_156_97,0.99,-1,96,97,30
98,r_272_281_157,r_93_279_177,r_120_70_5,r_272_281_157,0.52,0,157,157,30
62,r_97_270_16,seq256,r_242_80_38,r_242_80_38,0.98,34,72,38,30
187,seq262,seq205,r_255_246_27,r_255_246_27,1.0,19,46,27,30
48,r_125_245_154,r_286_211_118,seq37,r_286_211_118,0.69,-50,68,118,30
57,r_84_280_157,r_203_168_195,seq244,r_84_280_157,0.83,0,157,157,30
34,r_150_199_47,r_241_72_117,seq0,r_150_199_47,0.79,9,56,47,30
136,seq91,r_158_164_183,r_4_247_100,r_158_164_183,0.95,0,183,183,30
6,r_100_275_165,seq39,r_46_126_66,r_100_275_165,0.95,0,165,165,30
152,seq144,r_22_239_126,r_86_32_44,r_86_32_44,0.5,7,51,44,30
27,r_7_116_101,r_5_151_115,r_122_52_72,r_5_151_115,0.67,-14,101,115,30
136,seq91,r_68_206_140,r_158_164_183,r_68_206_140,0.66,0,140,140,30
87,r_174_123_122,seq256,r_120_70_5,r_174_123_122,1.0,1,123,122,30
79,r_124_162_23,r_41_109_154,r_295_60_101,r_124_162_23,0.98,2,25,23,30
79,r_124_162_23,r_295_60_101,r_150_199_47,r_295_60_101,1.0,0,101,101,30
2,r_260_29_109,seq88,r_132_129_64,r_260_29_109,1.0,0,109,109,30
33,r_188_99_58,seq250,r_286_211_118,r_188_99_58,1.0,0,58,58,30
40,r_180_140_134,seq49,seq135,r_180_140_134,0.51,0,134,134,30
74,r_155_259_79,r_203_168_195,r_234_17_20,r_155_259_79,1.0,1,80,79,30
29,r_6_103_140,seq108,r_7_116_101,r_6_103_140,0.82,0,140,140,30
24,r_5_151_115,seq291,seq205,r_5_151_115,1.0,0,115,115,30
25,r_14_264_169,r_277_202_65,r_46_126_66,r_14_264_169,1.0,-103,66,169,30
48,r_125_245_154,seq37,r_57_67_15,r_125_245_154,0.63,0,154,154,30
88,r_56_105_140,r_212_232_70,r_240_152_11,r_212_232_70,0.92,0,70,70,30
11,r_252_173_16,r_23_293_178,seq77,r_252_173_16,1.0,0,16,16,30
50,r_189_249_83,seq171,seq204,r_189_249_83,0.98,1,84,83,30
70,r_128_38_86,seq201,seq96,r_128_38_86,0.98,0,86,86,30
155,seq157,r_161_118_77,r_27_229_31,r_27_229_31,1.0,65,96,31,30
130,seq77,r_100_275_165,r_252_173_16,r_252_173_16,0.62,96,112,16,30
61,r_61_290_90,r_4_247_100,seq51,r_61_290_90,0.53,1,91,90,30
38,r_186_208_59,r_212_232_70,seq2,r_212_232_70,0.98,-10,60,70,30
52,r_274_90_171,r_158_164_183,r_7_116_101,r_7_116_101,0.52,70,171,101,30
86,r_89_21_56,r_145_257_173,r_240_152_11,r_89_21_56,1.0,0,56,56,30
0,r_226_59_52,r_110_156_97,seq15,r_226_59_52,1.0,0,52,52,30
75,r_24_276_121,r_172_9_148,seq30,r_24_276_121,1.0,2,123,121,30
60,r_195_254_103,seq43,r_260_29_109,r_260_29_109,1.0,1,110,109,30
77,r_242_80_38,r_180_140_134,r_97_270_16,r_242_80_38,1.0,1,39,38,30
25,r_14_264_169,r_46_126_66,seq102,r_14_264_169,0.83,2,171,169,30
94,r_85_263_60,r_172_9_148,seq192,r_85_263_60,0.96,2,62,60,30
137,seq92,r_139_215_51,r_240_152_11,r_139_215_51,0.99,0,51,51,30
96,r_132_129_64,r_198_136_172,seq171,r_132_129_64,1.0,0,64,64,30
97,r_258_26_50,r_58_25_117,seq1,r_258_26_50,1.0,1,51,50,30
22,r_4_247_100,seq15,r_97_270_16,r_4_247_100,0.99,0,100,100,30
91,r_240_152_11,r_255_246_27,seq92,r_240_152_11,1.0,0,11,11,30
135,seq88,r_286_211_118,r_188_99_58,r_188_99_58,1.0,11,69,58,30
49,r_177_297_68,r_241_72_117,seq43,r_177_297_68,0.55,0,68,68,30
140,seq102,seq88,r_14_264_169,r_14_264_169,0.53,2,171,169,30
194,seq284,r_145_257_173,r_98_191_112,r_98_191_112,0.83,-4,108,112,30
39,r_86_32_44,r_241_72_117,seq144,r_86_32_44,1.0,0,44,44,30
7,r_13_267_65,seq18,seq3,r_13_267_65,1.0,0,65,65,30
185,seq250,r_153_141_186,r_7_116_101,r_7_116_101,0.46,86,187,101,30
189,seq268,seq209,r_197_185_116,r_197_185_116,0.44,-11,105,116,30
82,r_93_279_177,seq170,seq204,r_93_279_177,0.64,0,177,177,30
95,r_295_60_101,r_36_74_111,r_124_162_23,r_124_162_23,0.96,3,26,23,30
12,r_283_243_140,seq273,r_241_72_117,r_283_243_140,0.94,0,140,140,30
42,r_142_248_51,seq108,seq48,r_142_248_51,1.0,0,51,51,30
95,r_295_60_101,r_124_162_23,seq170,r_295_60_101,1.0,0,101,101,30
46,r_255_246_27,r_183_196_61,seq262,r_255_246_27,1.0,0,27,27,30
65,r_187_16_58,r_122_52_72,seq15,r_187_16_58,1.0,-1,57,58,30
84,r_112_294_131,seq192,r_4_247_100,r_4_247_100,0.97,33,133,100,30
30,r_113_107_76,r_299_189_97,seq154,r_113_107_76,1.0,0,76,76,31
64,r_77_261_26,r_298_124_175,r_257_12_26,r_77_261_26,0.97,-1,25,26,31
71,r_203_97_23,r_88_168_175,seq226,r_203_97_23,0.92,0,23,23,31
14,r_4_224_130,r_54_35_190,seq128,r_4_224_130,1.0,0,130,130,31
81,r_41_217_58,seq268,seq170,r_41_217_58,0.98,-4,54,58,31
37,r_122_179_175,r_234_240_175,r_103_157_119,r_122_179_175,0.34,0,175,175,31
59,r_248_20_107,seq26,r_98_93_9,r_248_20_107,0.99,2,109,107,31
26,r_88_168_175,r_130_190_73,r_255_108_17,r_88_168_175,0.81,-154,21,175,31
55,r_269_166_118,seq138,r_125_119_114,r_269_166_118,0.97,0,118,118,31
16,r_229_228_124,r_127_160_196,seq91,r_229_228_124,0.88,0,124,124,31
1,r_283_102_123,seq276,r_129_242_100,r_283_102_123,0.97,0,123,123,31
97,r_146_51_79,r_4_224_130,seq43,r_146_51_79,1.0,0,79,79,31
5,r_191_60_62,r_62_164_105,seq53,r_191_60_62,1.0,1,63,62,31
42,r_196_198_109,r_298_124_175,seq187,r_196_198_109,0.98,0,109,109,31
80,r_210_126_113,r_165_243_117,r_255_108_17,r_210_126_113,0.59,0,113,113,31
69,r_267_250_175,r_194_34_189,r_156_87_101,r_194_34_189,0.52,-14,175,189,31
18,r_253_297_45,r_47_100_163,seq238,r_253_297_45,1.0,0,45,45,31
45,r_129_242_100,seq274,seq152,r_129_242_100,1.0,2,102,100,31
19,r_29_295_60,seq17,seq5,r_29_295_60,1.0,0,60,60,31
66,r_54_35_190,seq10,r_156_87_101,r_156_87_101,0.95,89,190,101,31
76,r_161_171_149,r_47_100_163,seq202,r_47_100_163,0.78,-12,151,163,31
103,seq10,r_4_224_130,r_98_93_9,r_4_224_130,0.92,-54,76,130,31
178,seq233,r_45_139_40,r_192_143_111,r_192_143_111,0.63,1,112,111,31
41,r_216_80_62,seq16,r_296_2_7,r_216_80_62,1.0,0,62,62,31
21,r_78_236_20,r_192_143_111,seq136,r_78_236_20,0.98,0,20,20,31
67,r_76_19_150,seq159,seq70,r_76_19_150,0.84,1,151,150,31
89,r_135_220_94,r_4_224_130,seq96,r_135_220_94,0.99,2,96,94,31
84,r_15_262_49,seq178,seq159,r_15_262_49,1.0,0,49,49,31
3,r_192_143_111,r_267_250_175,seq233,r_192_143_111,0.96,0,111,111,31
10,r_71_200_80,r_192_143_111,seq226,r_71_200_80,1.0,0,80,80,31
90,r_183_104_159,seq226,r_271_64_17,r_183_104_159,0.82,0,159,159,31
20,r_105_137_25,r_103_157_119,r_188_69_28,r_105_137_25,1.0,0,25,25,31
63,r_130_190_73,r_88_168_175,seq226,r_130_190_73,0.88,0,73,73,31
83,r_31_275_47,r_201_163_97,seq26,r_31_275_47,0.99,0,47,47,31
11,r_156_87_101,r_76_19_150,r_113_107_76,r_156_87_101,1.0,0,101,101,31
13,r_273_1_96,r_123_8_134,seq66,r_273_1_96,1.0,0,96,96,31
98,r_92_140_160,r_267_250_175,r_76_19_150,r_92_140_160,0.68,0,160,160,31
15,r_234_240_175,r_122_179_175,r_273_1_96,r_273_1_96,0.71,79,175,96,31
48,r_14_115_166,seq5,r_216_80_62,r_14_115_166,0.7,-9,157,166,31
75,r_56_231_56,r_298_124_175,seq232,r_56_231_56,1.0,1,57,56,31
57,r_158_40_104,seq90,r_296_2_7,r_158_40_104,0.99,0,104,104,31
31,r_182_33_12,r_244_223_182,seq222,r_182_33_12,0.78,1,13,12,31
6,r_195_86_103,seq153,r_255_108_17,r_195_86_103,1.0,1,104,103,31
62,r_181_49_82,seq148,r_71_200_80,r_181_49_82,0.93,0,82,82,31
52,r_235_11_55,r_103_157_119,seq280,r_103_157_119,0.85,-65,54,119,31
85,r_284_75_96,r_4_224_130,r_255_108_17,r_284_75_96,1.0,0,96,96,31
2,r_255_108_17,r_88_168_175,r_195_86_103,r_195_86_103,1.0,76,179,103,31
9,r_165_243_117,r_144_199_77,r_41_217_58,r_165_243_117,1.0,0,117,117,31
2,r_255_108_17,r_106_270_90,r_88_168_175,r_255_108_17,0.72,0,17,17,31
65,r_257_12_26,r_218_6_183,r_77_261_26,r_257_12_26,1.0,-1,25,26,31
93,r_32_30_38,seq222,r_127_160_196,r_32_30_38,1.0,0,38,38,31
27,r_251_286_80,seq84,seq145,r_251_286_80,0.72,-6,74,80,31
87,r_7_173_134,r_267_250_175,r_192_143_111,r_267_250_175,1.0,-41,134,175,31
70,r_72_221_24,r_293_61_36,seq28,r_72_221_24,1.0,-1,23,24,31
47,r_63_246_94,seq37,seq279,r_63_246_94,0.52,2,96,94,31
17,r_109_95_28,r_191_60_62,seq70,r_109_95_28,0.97,-1,27,28,31
40,r_42_59_109,seq238,seq197,r_42_59_109,0.92,0,109,109,31
24,r_123_8_134,seq205,r_135_220_94,r_123_8_134,0.89,0,134,134,31
177,seq232,r_167_212_177,r_56_231_56,r_56_231_56,1.0,123,179,56,31
25,r_134_209_62,seq263,seq142,r_134_209_62,0.76,0,62,62,31
33,r_62_164_105,seq5,r_273_1_96,r_62_164_105,0.85,0,105,105,31
88,r_206_237_122,seq43,seq222,r_206_237_122,0.93,0,122,122,31
50,r_175_259_113,r_165_243_117,r_156_87_101,r_175_259_113,1.0,0,113,113,31
192,seq279,r_0_147_116,r_63_246_94,r_0_147_116,0.93,0,116,116,31
68,r_201_163_97,r_45_139_40,seq17,r_201_163_97,1.0,1,98,97,31
32,r_103_157_119,seq214,r_32_30_38,r_103_157_119,0.98,0,119,119,31
38,r_144_199_77,r_201_163_97,r_165_243_117,r_144_199_77,0.93,0,77,77,31
77,r_0_147_116,seq279,r_156_87_101,r_0_147_116,0.84,0,116,116,31
38,r_144_199_77,r_165_243_117,r_299_189_97,r_144_199_77,0.53,40,117,77,31
34,r_83_174_83,seq148,seq222,r_83_174_83,1.0,0,83,83,31
4,r_293_61_36,seq233,seq101,r_293_61_36,0.99,0,36,36,31
60,r_252_23_152,seq17,seq5,r_252_23_152,0.89,0,152,152,31
168,seq205,r_123_8_134,seq9,r_123_8_134,1.0,0,134,134,31
173,seq222,seq3,r_83_174_83,r_83_174_83,1.0,1,84,83,31
94,r_112_193_110,seq207,r_296_2_7,r_112_193_110,0.97,0,110,110,31
144,seq128,r_215_73_163,r_4_224_130,r_4_224_130,0.94,36,166,130,31
9,r_165_243_117,r_175_259_113,r_144_199_77,r_144_199_77,0.96,0,77,77,31
86,r_271_64_17,r_144_199_77,seq159,r_271_64_17,0.75,0,17,17,31
26,r_88_168_175,r_255_108_17,r_71_200_80,r_71_200_80,0.95,99,179,80,31
31,r_182_33_12,seq222,r_188_69_28,r_188_69_28,0.79,80,108,28,31
22,r_277_172_67,r_245_265_187,seq153,r_277_172_67,1.0,0,67,67,31
28,r_47_100_163,seq70,r_185_48_4,r_47_100_163,0.68,0,163,163,31
91,r_162_141_95,r_4_224_130,seq28,r_162_141_95,0.99,0,95,95,31
164,seq187,r_88_168_175,r_196_198_109,r_196_198_109,0.97,52,161,109,31
99,r_133_239_42,seq138,seq238,r_133_239_42,0.99,1,43,42,31
56,r_18_256_63,seq152,seq24,r_18_256_63,1.0,0,63,63,31
44,r_244_223_182,seq154,r_277_172_67,r_244_223_182,0.41,0,182,182,31
79,r_110_290_46,seq43,seq28,r_110_290_46,1.0,-1,45,46,31
7,r_188_69_28,r_161_171_149,r_105_137_25,r_188_69_28,1.0,-1,27,28,31
23,r_127_160_196,seq170,r_32_30_38,r_32_30_38,1.0,35,73,38,31
82,r_125_119_114,r_244_223_182,seq85,r_125_119_114,0.98,0,114,114,31
101,seq5,seq22,r_252_23_152,r_252_23_152,0.96,0,152,152,31
35,r_299_189_97,seq151,r_144_199_77,r_299_189_97,0.89,0,97,97,31
12,r_106_270_90,seq28,r_18_256_63,r_106_270_90,0.99,0,90,90,31
78,r_176_74_12,r_298_124_175,r_296_2_7,r_176_74_12,0.83,1,13,12,31
36,r_260_172_176,seq9,r_266_130_30,r_266_130_30,0.77,149,179,30,32
77,r_118_162_131,seq51,seq15,r_118_162_131,0.78,0,131,131,32
92,r_94_55_184,seq278,r_288_104_40,r_288_104_40,0.64,145,185,40,32
14,r_110_289_141,r_127_161_173,r_275_165_112,r_110_289_141,0.81,1,142,141,32
151,seq163,r_263_196_192,r_66_202_153,r_66_202_153,0.93,27,180,153,32
43,r_217_216_94,r_118_162_131,r_175_180_77,r_175_180_77,1.0,18,95,77,32
16,r_142_124_7,r_262_158_43,r_116_273_23,r_142_124_7,0.87,37,44,7,32
54,r_137_192_152,seq296,r_40_81_135,r_137_192_152,0.74,0,152,152,32
59,r_226_208_123,seq65,seq278,r_226_208_123,0.94,0,123,123,32
71,r_228_198_153,r_293_255_159,seq254,r_228_198_153,0.89,1,154,153,32
21,r_241_152_172,r_34_218_5,seq135,r_241_152_172,0.66,0,172,172,32
39,r_74_277_104,r_271_187_83,seq108,r_271_187_83,1.0,0,83,83,32
1,r_144_243_190,seq46,r_40_81_135,r_144_243_190,0.45,0,190,190,32
65,r_262_158_43,seq280,seq51,r_262_158_43,0.98,1,44,43,32
5,r_103_28_149,r_54_204_135,r_34_218_5,r_103_28_149,0.41,-77,72,149,32
46,r_175_180_77,seq155,seq163,r_175_180_77,1.0,1,78,77,32
42,r_115_195_86,seq171,seq100,r_115_195_86,1.0,0,86,86,32
87,r_97_215_17,r_144_243_190,seq131,r_97_215_17,0.88,-2,15,17,32
80,r_267_182_92,r_25_176_195,r_60_246_65,r_267_182_92,1.0,0,92,92,32
53,r_93_240_119,r_252_88_185,r_245_139_28,r_245_139_28,1.0,12,40,28,32
10,r_101_17_56,seq199,r_107_268_55,r_101_17_56,1.0,1,57,56,32
93,r_209_57_26,r_260_172_176,seq80,r_209_57_26,0.99,0,26,26,32
193,seq284,r_183_84_44,seq15,r_183_84_44,1.0,0,44,44,32
95,r_106_78_64,r_62_203_183,seq259,r_106_78_64,1.0,1,65,64,32
66,r_107_268_55,r_144_243_190,r_101_17_56,r_101_17_56,1.0,6,62,56,32
76,r_159_126_61,seq135,r_276_19_41,r_159_126_61,1.0,0,61,61,32
38,r_127_161_173,r_276_19_41,r_92_79_69,r_127_161_173,0.83,0,173,173,32
103,seq9,r_260_172_176,seq232,r_260_172_176,0.85,3,179,176,32
41,r_30_99_63,r_140_29_196,seq6,r_30_99_63,1.0,1,64,63,32
67,r_293_255_159,seq12,r_107_268_55,r_293_255_159,0.86,0,159,159,32
89,r_179_257_92,seq21,seq49,r_179_257_92,1.0,0,92,92,32
3,r_119_184_125,r_25_176_195,r_167_214_25,r_119_184_125,0.91,1,126,125,32
90,r_122_229_62,r_186_166_81,seq49,r_122_229_62,0.93,0,62,62,32
115,seq36,seq14,r_186_166_81,r_186_166_81,1.0,44,125,81,32
26,r_66_202_153,seq113,seq163,r_66_202_153,0.86,1,154,153,32
72,r_186_166_81,seq169,seq171,r_186_166_81,1.0,2,83,81,32
4,r_82_0_86,r_133_188_188,r_86_4_24,r_82_0_86,1.0,1,87,86,32
0,r_279_238_135,r_2_129_196,seq14,r_279_238_135,0.99,0,135,135,32
11,r_275_165_112,seq108,seq296,r_275_165_112,1.0,0,112,112,32
107,seq15,seq284,r_118_162_131,r_118_162_131,0.98,5,136,131,32
20,r_64_26_144,seq287,r_245_139_28,r_64_26_144,0.8,0,144,144,32
98,r_59_72_155,seq6,r_183_84_44,r_59_72_155,0.72,0,155,155,32
15,r_71_170_92,r_123_91_196,r_27_253_85,r_27_253_85,0.53,8,93,85,32
166,seq210,r_60_246_65,r_34_218_5,r_60_246_65,0.46,8,73,65,32
48,r_58_233_86,r_85_256_102,seq189,r_58_233_86,1.0,1,87,86,32
57,r_164_143_141,seq232,r_16_111_4,r_164_143_141,0.96,1,142,141,32
2,r_86_4_24,r_264_112_121,r_61_206_52,r_86_4_24,1.0,46,70,24,32
62,r_27_253_85,r_66_202_153,seq131,r_27_253_85,1.0,1,86,85,32
45,r_288_104_40,seq52,r_142_124_7,r_288_104_40,0.97,0,40,40,32
141,seq131,r_92_79_69,r_27_253_85,r_27_253_85,1.0,8,93,85,32
81,r_34_218_5,r_241_152_172,r_83_96_45,r_241_152_172,0.92,-13,159,172,32
5,r_103_28_149,r_34_218_5,r_279_238_135,r_103_28_149,0.9,0,149,149,32
2,r_86_4_24,r_40_81_135,r_264_112_121,r_86_4_24,1.0,-1,23,24,32
83,r_183_84_44,seq284,seq9,r_183_84_44,1.0,0,44,44,32
44,r_149_35_165,r_142_124_7,r_175_180_77,r_149_35_165,0.86,-4,161,165,32
6,r_266_130_30,seq3,seq52,r_266_130_30,1.0,0,30,30,32
27,r_37_117_120,seq100,seq46,r_37_117_120,0.99,1,121,120,32
53,r_93_240_119,r_245_139_28,r_128_56_30,r_93_240_119,1.0,0,119,119,32
136,seq108,r_275_165_112,r_74_277_104,r_275_165_112,1.0,0,112,112,32
38,r_127_161_173,r_98_194_151,r_276_19_41,r_276_19_41,1.0,1,42,41,32
47,r_98_194_151,r_114_67_199,r_250_247_102,r_98_194_151,0.63,1,152,151,32
74,r_276_19_41,r_110_289_141,r_159_126_61,r_276_19_41,0.76,51,92,41,32
40,r_191_132_2,r_62_203_183,r_250_247_102,r_250_247_102,0.84,44,146,102,32
18,r_41_234_170,seq5,r_151_77_77,r_151_77_77,0.65,93,170,77,32
29,r_40_81_135,seq95,r_179_257_92,r_40_81_135,0.96,0,135,135,32
64,r_154_298_92,seq18,seq201,r_154_298_92,1.0,0,92,92,32
78,r_205_141_33,r_288_104_40,r_245_139_28,r_288_104_40,1.0,-7,33,40,32
88,r_60_246_65,seq210,r_267_182_92,r_267_182_92,1.0,10,102,92,32
74,r_276_19_41,seq258,r_110_289_141,r_276_19_41,1.0,0,41,41,32
50,r_105_222_173,r_94_55_184,seq280,r_105_222_173,0.37,0,173,173,32
58,r_264_112_121,seq6,r_71_170_92,r_264_112_121,0.94,1,122,121,32
70,r_271_187_83,r_263_196_192,seq31,r_271_187_83,1.0,0,83,83,32
37,r_83_96_45,r_260_172_176,seq169,r_83_96_45,1.0,0,45,45,32
44,r_149_35_165,r_288_104_40,r_142_124_7,r_142_124_7,0.53,118,125,7,32
61,r_150_138_119,seq31,seq18,r_150_138_119,0.98,1,120,119,32
32,r_8_47_103,r_62_203_183,r_16_111_4,r_8_47_103,1.0,0,103,103,32
22,r_128_56_30,r_41_234_170,seq12,r_128_56_30,1.0,0,30,30,32
52,r_44_42_76,seq213,seq49,r_44_42_76,1.0,0,76,76,32
77,r_118_162_131,r_217_216_94,seq51,r_217_216_94,0.98,1,95,94,32
34,r_250_247_102,seq200,r_38_63_18,r_250_247_102,0.94,-4,98,102,32
63,r_61_206_52,seq53,r_86_4_24,r_61_206_52,1.0,0,52,52,32
75,r_168_286_107,r_103_28_149,seq21,r_168_286_107,0.99,0,107,107,32
25,r_146_160_21,r_92_79_69,r_142_124_7,r_146_160_21,0.75,2,23,21,32
81,r_34_218_5,r_168_286_107,r_241_152_172,r_168_286_107,0.97,0,107,107,32
56,r_33_227_31,r_154_298_92,seq100,r_33_227_31,1.0,1,32,31,32
94,r_281_11_99,seq174,r_142_124_7,r_281_11_99,0.97,0,99,99,32
68,r_167_214_25,seq254,seq53,r_167_214_25,0.97,0,25,25,32
9,r_151_77_77,r_190_76_123,seq109,r_151_77_77,0.97,1,78,77,32
85,r_116_273_23,r_82_0_86,r_142_124_7,r_116_273_23,1.0,0,23,23,32
96,r_231_68_5,r_121_244_137,seq120,r_121_244_137,1.0,0,137,137,32
163,seq199,r_101_17_56,seq95,r_101_17_56,1.0,1,57,56,32
12,r_220_285_25,r_144_243_190,seq125,r_220_285_25,0.95,0,25,25,32
91,r_121_244_137,r_231_68_5,r_106_78_64,r_121_244_137,0.82,0,137,137,32
124,seq53,seq135,r_167_214_25,r_167_214_25,1.0,13,38,25,32
49,r_62_203_183,r_191_132_2,r_86_4_24,r_86_4_24,0.69,159,183,24,32
194,seq287,r_64_26_144,seq254,r_64_26_144,1.0,0,144,144,32
7,r_54_204_135,r_103_28_149,seq199,r_54_204_135,0.95,0,135,135,32
185,seq259,r_41_234_170,r_106_78_64,r_106_78_64,1.0,7,71,64,32
44,r_149_35_165,r_151_77_77,r_288_104_40,r_149_35_165,0.58,-80,85,165,32
189,seq278,r_105_222_173,r_92_79_69,r_105_222_173,0.9,-27,146,173,32
82,r_20_236_70,r_8_47_103,seq52,r_20_236_70,0.54,1,71,70,32
101,seq5,r_41_234_170,r_106_78_64,r_106_78_64,1.0,82,146,64,32
79,r_145_292_82,r_25_176_195,seq242,r_145_292_82,1.0,0,82,82,32
35,r_297_7_64,r_37_117_120,seq89,r_297_7_64,0.99,1,65,64,32
84,r_190_76_123,seq75,r_133_188_188,r_190_76_123,1.0,0,123,123,32
30,r_260_155_110,r_216_142_147,r_88_282_90,r_216_142_147,0.98,-37,110,147,33
27,r_137_159_43,r_22_43_87,r_222_247_188,r_137_159_43,1.0,1,44,43,33
8,r_29_85_2,seq5,r_206_240_105,r_206_240_105,1.0,17,122,105,33
53,r_180_191_176,r_203_50_159,r_151_212_131,r_151_212_131,0.83,3,134,131,33
54,r_252_229_110,r_10_7_198,r_121_228_66,r_252_229_110,1.0,2,112,110,33
83,r_115_77_68,r_52_242_161,seq101,r_115_77_68,0.55,5,73,68,33
81,r_222_247_188,r_137_159_43,r_22_43_87,r_137_159_43,0.41,145,188,43,33
59,r_93_133_160,seq169,r_165_99_164,r_165_99_164,0.66,-1,163,164,33
16,r_134_148_187,seq69,r_181_158_97,r_181_158_97,0.57,90,187,97,33
39,r_254_157_87,r_295_17_129,r_255_103_69,r_295_17_129,1.0,-42,87,129,33
1,r_266_9_182,seq285,r_26_117_39,r_26_117_39,0.99,143,182,39,33
46,r_201_256_90,r_184_82_41,r_270_34_162,r_201_256_90,0.97,0,90,90,33
42,r_30_274_115,r_12_183_114,r_13_268_28,r_13_268_28,0.72,88,116,28,33
80,r_293_61_139,r_264_107_160,seq267,r_293_61_139,0.75,0,139,139,33
69,r_10_7_198,r_252_229_110,seq173,r_252_229_110,1.0,-1,109,110,33
13,r_31_296_56,r_70_258_133,seq53,r_31_296_56,1.0,0,56,56,33
45,r_193_281_69,seq5,seq231,r_193_281_69,1.0,0,69,69,33
61,r_128_257_114,r_213_130_26,r_254_157_87,r_128_257_114,0.84,0,114,114,33
61,r_128_257_114,r_203_50_159,r_213_130_26,r_213_130_26,0.93,29,55,26,33
15,r_217_218_24,r_90_202_187,r_11_211_5,r_90_202_187,0.55,0,187,187,33
27,r_137_159_43,r_222_247_188,seq283,r_222_247_188,0.93,0,188,188,33
95,r_32_248_165,seq241,r_115_77_68,r_115_77_68,0.74,103,171,68,33
21,r_89_215_21,r_13_268_28,seq277,r_89_215_21,1.0,-2,19,21,33
63,r_116_46_114,r_164_163_186,seq35,r_116_46_114,0.72,31,145,114,33
44,r_255_103_69,seq5,r_254_157_87,r_254_157_87,0.98,35,122,87,33
76,r_276_239_99,seq233,seq241,r_276_239_99,1.0,1,100,99,33
97,r_213_130_26,r_128_257_114,seq16,r_128_257_114,1.0,0,114,114,33
31,r_151_212_131,seq251,r_213_130_26,r_151_212_131,1.0,0,131,131,33
41,r_140_28_65,r_136_64_106,seq111,r_140_28_65,1.0,0,65,65,33
67,r_198_172_68,r_270_34_162,seq37,r_198_172_68,1.0,0,68,68,33
89,r_126_110_130,seq37,r_136_64_106,r_136_64_106,0.96,27,133,106,33
48,r_192_150_15,r_52_242_161,seq16,r_192_150_15,1.0,0,15,15,33
90,r_206_240_105,r_270_34_162,r_254_157_87,r_206_240_105,0.9,0,105,105,33
25,r_26_117_39,r_125_80_41,r_294_39_25,r_26_117_39,0.96,0,39,39,33
9,r_265_124_49,r_14_262_179,seq74,r_265_124_49,1.0,0,49,49,33
26,r_60_287_96,seq4,r_92_224_56,r_60_287_96,1.0,0,96,96,33
72,r_174_275_152,seq267,r_236_132_78,r_174_275_152,0.68,0,152,152,33
198,seq291,seq83,r_45_127_21,r_45_127_21,0.99,44,65,21,33
4,r_88_282_90,seq16,seq0,r_88_282_90,1.0,0,90,90,33
52,r_168_194_55,seq71,seq27,r_168_194_55,1.0,0,55,55,33
78,r_24_123_61,r_81_199_136,seq53,r_24_123_61,1.0,0,61,61,33
0,r_22_43_87,seq94,seq188,r_22_43_87,1.0,0,87,87,33
63,r_116_46_114,r_245_36_98,r_164_163_186,r_116_46_114,0.8,1,115,114,33
11,r_52_242_161,seq185,seq5,r_52_242_161,0.92,0,161,161,33
20,r_182_67_148,seq237,seq35,r_182_67_148,0.77,1,149,148,33
98,r_203_50_159,r_180_191_176,r_276_239_99,r_180_191_176,0.92,-16,160,176,33
15,r_217_218_24,seq200,r_90_202_187,r_217_218_24,1.0,0,24,24,33
53,r_180_191_176,r_151_212_131,r_246_220_20,r_180_191_176,0.99,0,176,176,33
57,r_279_214_91,seq178,seq284,r_279_214_91,0.74,1,92,91,33
181,seq241,r_32_248_165,r_276_239_99,r_276_239_99,1.0,52,151,99,33
6,r_181_158_97,r_260_155_110,r_131_208_61,r_181_158_97,0.88,3,100,97,33
99,r_118_273_136,seq141,r_151_212_131,r_118_273_136,0.95,1,137,136,33
51,r_90_202_187,r_118_273_136,r_217_218_24,r_90_202_187,0.86,-145,42,187,33
51,r_90_202_187,r_217_218_24,r_29_85_2,r_217_218_24,0.67,163,187,24,33
87,r_209_1_111,r_125_80_41,seq69,r_209_1_111,0.57,2,113,111,33
2,r_102_139_100,seq54,seq41,r_102_139_100,1.0,1,101,100,33
47,r_131_208_61,r_125_80_41,seq105,r_131_208_61,0.95,3,64,61,33
142,seq129,r_86_98_169,seq233,r_86_98_169,0.99,3,172,169,33
40,r_187_40_126,seq27,r_265_124_49,r_265_124_49,1.0,78,127,49,33
71,r_246_220_20,r_134_148_187,seq4,r_246_220_20,0.99,0,20,20,33
74,r_14_262_179,seq153,r_26_117_39,r_26_117_39,0.58,140,179,39,33
18,r_245_36_98,r_116_46_114,r_25_63_40,r_245_36_98,0.87,4,102,98,33
29,r_78_100_62,r_245_36_98,seq285,r_78_100_62,1.0,0,62,62,33
157,seq171,r_165_99_164,r_184_82_41,r_165_99_164,0.53,-17,147,164,33
24,r_264_107_160,seq210,seq185,r_264_107_160,0.92,0,160,160,33
19,r_144_73_41,r_203_50_159,seq79,r_144_73_41,0.72,10,51,41,33
7,r_13_268_28,r_216_142_147,seq284,r_13_268_28,0.99,0,28,28,33
82,r_143_238_20,r_125_80_41,r_294_39_25,r_143_238_20,1.0,-1,19,20,33
94,r_95_280_26,seq35,r_125_80_41,r_95_280_26,0.9,1,27,26,33
33,r_3_190_148,seq231,r_252_229_110,r_3_190_148,0.99,0,148,148,33
127,seq76,seq71,r_217_218_24,r_217_218_24,1.0,51,75,24,33
64,r_243_161_78,seq5,seq44,r_243_161_78,1.0,0,78,78,33
191,seq283,r_18_72_69,r_137_159_43,r_137_159_43,0.87,30,73,43,33
68,r_294_39_25,seq156,r_143_238_20,r_143_238_20,0.82,7,27,20,33
97,r_213_130_26,r_243_161_78,r_128_257_114,r_213_130_26,0.76,0,26,26,33
5,r_226_84_23,seq167,seq33,r_226_84_23,1.0,0,23,23,33
156,seq169,r_93_133_160,r_25_63_40,r_25_63_40,0.73,31,71,40,33
50,r_48_75_99,r_125_80_41,seq74,r_48_75_99,1.0,0,99,99,33
58,r_165_99_164,seq171,r_93_133_160,r_165_99_164,0.89,0,164,164,33
70,r_270_34_162,r_206_240_105,r_201_256_90,r_270_34_162,0.96,-57,105,162,33
65,r_18_72_69,r_222_247_188,r_68_87_8,r_18_72_69,0.98,4,73,69,33
111,seq35,seq267,r_182_67_148,r_182_67_148,0.97,2,150,148,33
32,r_136_64_106,seq267,r_193_281_69,r_136_64_106,1.0,0,106,106,33
38,r_11_211_5,r_118_273_136,r_217_218_24,r_11_211_5,0.98,117,122,5,33
196,seq289,r_164_163_186,r_182_67_148,r_182_67_148,0.79,39,187,148,33
28,r_19_177_22,r_164_163_186,r_294_39_25,r_19_177_22,1.0,0,22,22,33
34,r_236_132_78,r_264_107_160,seq230,r_236_132_78,0.95,0,78,78,33
75,r_51_38_87,seq233,r_121_228_66,r_51_38_87,0.85,0,87,87,33
60,r_223_65_85,r_264_107_160,r_31_296_56,r_223_65_85,1.0,0,85,85,33
150,seq153,r_14_262_179,r_102_139_100,r_102_139_100,1.0,79,179,100,33
81,r_222_247_188,r_18_72_69,r_137_159_43,r_137_159_43,0.69,30,73,43,33
111,seq35,r_95_280_26,seq267,r_95_280_26,0.89,1,27,26,33
17,r_92_224_56,r_187_40_126,seq167,r_92_224_56,0.74,42,98,56,33
96,r_121_228_66,r_102_139_100,seq221,r_121_228_66,0.99,0,66,66,33
70,r_270_34_162,r_201_256_90,r_81_199_136,r_81_199_136,0.66,28,164,136,33
133,seq101,r_112_269_190,r_115_77_68,r_115_77_68,0.55,122,190,68,33
22,r_81_199_136,r_263_23_182,r_297_145_94,r_81_199_136,0.96,2,138,136,33
91,r_114_66_183,seq146,r_236_132_78,r_114_66_183,0.46,1,184,183,33
49,r_154_299_61,r_264_107_160,r_13_268_28,r_154_299_61,1.0,0,61,61,33
3,r_219_91_21,r_60_287_96,seq111,r_219_91_21,0.75,-2,19,21,33
56,r_109_176_128,seq41,seq138,r_109_176_128,0.99,0,128,128,33
44,r_255_103_69,seq230,seq5,r_255_103_69,1.0,-1,68,69,33
119,seq56,r_201_256_90,r_68_87_8,r_201_256_90,0.99,-54,36,90,33
23,r_263_23_182,seq251,r_136_64_106,r_136_64_106,1.0,76,182,106,33
189,seq277,r_245_36_98,r_89_215_21,r_89_215_21,0.77,62,83,21,33
93,r_25_63_40,seq251,seq169,r_25_63_40,0.99,0,40,40,33
186,seq267,r_136_64_106,r_174_275_152,r_136_64_106,1.0,0,106,106,33
192,seq284,r_88_282_90,r_13_268_28,r_88_282_90,0.99,-34,56,90,33
35,r_42_170_162,seq251,seq147,r_42_170_162,0.84,0,162,162,33
66,r_45_127_21,r_226_84_23,seq291,r_45_127_21,0.95,-1,20,21,33
12,r_70_258_133,r_3_190_148,seq15,r_70_258_133,0.92,0,133,133,33
84,r_297_145_94,r_295_17_129,seq195,r_297_145_94,1.0,0,94,94,33
93,r_276_126_149,seq286,seq14,r_276_126_149,0.99,0,149,149,34
30,r_115_120_106,seq208,r_224_104_102,r_115_120_106,0.97,0,106,106,34
44,r_188_236_64,r_75_127_170,r_83_221_113,r_188_236_64,0.98,101,165,64,34
36,r_2_92_176,seq226,r_138_189_41,r_138_189_41,0.75,135,176,41,34
6,r_229_179_32,r_5_58_68,seq117,r_229_179_32,1.0,0,32,32,34
92,r_258_262_149,seq165,r_144_19_59,r_258_262_149,0.85,0,149,149,34
78,r_89_210_23,r_183_68_100,seq119,r_89_210_23,1.0,0,23,23,34
14,r_209_47_120,seq55,seq32,r_209_47_120,0.9,1,121,120,34
8,r_191_107_82,seq80,r_123_174_68,r_191_107_82,0.98,0,82,82,34
53,r_251_147_191,r_277_194_104,r_64_118_47,r_251_147_191,1.0,-94,97,191,34
197,seq289,r_241_73_145,r_263_135_6,r_241_73_145,0.77,-14,131,145,34
27,r_36_227_12,r_70_204_42,seq101,r_36_227_12,1.0,0,12,12,34
54,r_249_16_155,seq55,seq76,r_249_16_155,0.65,0,155,155,34
83,r_155_100_104,r_290_38_105,r_270_202_75,r_270_202_75,0.89,29,104,75,34
3,r_238_43_30,r_56_137_168,r_184_150_53,r_238_43_30,0.89,137,167,30,34
59,r_114_284_186,seq253,r_249_16_155,r_114_284_186,0.27,0,186,186,34
7,r_70_204_42,r_209_47_120,seq103,r_70_204_42,1.0,0,42,42,34
55,r_171_274_83,seq71,r_275_90_183,r_171_274_83,1.0,0,83,83,34
104,seq14,r_42_298_33,r_276_126_149,r_276_126_149,0.97,29,178,149,34
71,r_85_124_143,seq79,r_129_250_89,r_85_124_143,0.58,2,145,143,34
86,r_125_86_170,seq286,r_171_274_83,r_171_274_83,0.99,87,170,83,34
21,r_129_250_89,seq32,seq41,r_129_250_89,1.0,2,91,89,34
39,r_112_173_157,seq55,r_205_130_87,r_112_173_157,0.93,0,157,157,34
16,r_48_280_26,seq18,seq165,r_48_280_26,1.0,0,26,26,34
97,r_141_206_158,r_291_163_63,r_112_173_157,r_141_206_158,0.77,0,158,158,34
5,r_231_3_105,seq158,r_239_225_42,r_231_3_105,0.92,0,105,105,34
46,r_181_154_168,r_281_213_131,r_105_219_96,r_105_219_96,0.49,19,115,96,34
69,r_61_26_61,r_241_73_145,seq152,r_61_26_61,1.0,0,61,61,34
95,r_33_157_37,r_129_250_89,r_144_19_59,r_33_157_37,1.0,1,38,37,34
77,r_224_104_102,r_195_271_46,r_167_228_164,r_167_228_164,1.0,6,170,164,34
158,seq177,r_240_111_164,r_46_0_107,r_46_0_107,0.97,58,165,107,34
66,r_142_97_129,seq260,r_263_135_6,r_142_97_129,0.77,0,129,129,34
184,seq255,r_56_137_168,r_136_161_79,r_136_161_79,1.0,3,82,79,34
41,r_105_219_96,r_115_120_106,seq80,r_105_219_96,1.0,0,96,96,34
134,seq103,r_275_90_183,r_70_204_42,r_70_204_42,1.0,9,51,42,34
67,r_178_72_107,seq264,seq133,r_178_72_107,0.97,2,109,107,34
89,r_57_8_157,seq201,r_261_40_30,r_57_8_157,0.72,1,158,157,34
72,r_106_45_54,r_60_11_154,seq76,r_106_45_54,0.97,3,57,54,34
42,r_184_150_53,seq99,r_238_43_30,r_184_150_53,1.0,1,54,53,34
26,r_87_197_76,r_270_202_75,r_288_143_47,r_87_197_76,0.74,0,76,76,34
4,r_46_0_107,r_20_164_187,seq177,r_46_0_107,1.0,0,107,107,34
61,r_232_81_41,seq14,seq260,r_232_81_41,0.99,1,42,41,34
46,r_181_154_168,r_105_219_96,r_46_0_107,r_181_154_168,1.0,0,168,168,34
0,r_183_68_100,r_181_154_168,seq10,r_183_68_100,1.0,0,100,100,34
63,r_136_161_79,seq101,seq255,r_136_161_79,1.0,0,79,79,34
73,r_60_11_154,seq23,r_209_47_120,r_60_11_154,0.78,0,154,154,34
11,r_281_213_131,r_291_163_63,r_182_34_50,r_291_163_63,0.93,68,131,63,34
68,r_252_7_47,seq76,r_195_271_46,r_252_7_47,0.9,0,47,47,34
20,r_277_194_104,r_251_147_191,r_229_179_32,r_277_194_104,1.0,0,104,104,34
25,r_42_298_33,seq257,seq14,r_42_298_33,1.0,0,33,33,34
48,r_108_242_95,r_178_72_107,seq146,r_108_242_95,1.0,1,96,95,34
2,r_166_149_40,r_87_197_76,seq187,r_166_149_40,0.89,0,40,40,34
49,r_56_137_168,r_238_43_30,r_188_236_64,r_56_137_168,0.85,0,168,168,34
70,r_182_34_50,r_290_38_105,r_195_271_46,r_290_38_105,0.73,-53,52,105,34
62,r_122_193_158,seq110,r_263_135_6,r_122_193_158,0.7,0,158,158,34
74,r_20_164_187,seq253,r_105_219_96,r_20_164_187,0.85,0,187,187,34
85,r_291_163_63,r_141_206_158,r_299_30_70,r_141_206_158,1.0,0,158,158,34
99,r_123_174_68,r_56_137_168,seq84,r_123_174_68,1.0,0,68,68,34
52,r_275_90_183,r_171_274_83,r_183_68_100,r_275_90_183,0.65,-1,182,183,34
51,r_167_228_164,r_138_189_41,seq295,r_138_189_41,0.7,1,42,41,34
136,seq110,r_122_193_158,r_261_40_30,r_122_193_158,0.93,0,158,158,34
51,r_167_228_164,seq295,r_224_104_102,r_167_228_164,0.81,1,165,164,34
64,r_288_143_47,r_183_68_100,seq156,r_288_143_47,0.94,0,47,47,34
87,r_35_245_143,seq18,r_13_9_30,r_35_245_143,0.93,0,143,143,34
80,r_144_19_59,r_176_266_97,r_33_157_37,r_144_19_59,0.54,0,59,59,34
47,r_212_235_67,r_122_193_158,r_36_227_12,r_212_235_67,1.0,2,69,67,34
126,seq88,r_278_37_70,seq91,r_278_37_70,0.73,-8,62,70,34
74,r_20_164_187,r_46_0_107,seq253,r_46_0_107,1.0,-10,97,107,34
18,r_75_127_170,r_240_111_164,r_188_236_64,r_188_236_64,1.0,43,107,64,34
29,r_259_25_66,r_115_120_106,seq279,r_259_25_66,1.0,3,69,66,34
195,seq286,r_125_86_170,r_195_271_46,r_195_271_46,1.0,20,66,46,34
24,r_278_37_70,seq88,seq18,r_278_37_70,0.7,4,74,70,34
70,r_182_34_50,r_195_271_46,r_281_213_131,r_281_213_131,1.0,14,145,131,34
88,r_59_169_83,seq145,r_48_280_26,r_59_169_83,0.98,0,83,83,34
50,r_17_254_72,r_136_161_79,r_48_280_26,r_17_254_72,1.0,0,72,72,34
58,r_22_220_120,r_112_173_157,r_61_26_61,r_112_173_157,1.0,-36,121,157,34
65,r_5_58_68,r_85_124_143,seq18,r_5_58_68,0.98,1,69,68,34
82,r_176_266_97,r_144_19_59,r_42_298_33,r_42_298_33,0.92,26,59,33,34
37,r_239_225_42,r_275_90_183,r_251_147_191,r_239_225_42,1.0,0,42,42,34
32,r_151_94_110,seq102,seq172,r_151_94_110,0.92,7,117,110,34
38,r_82_67_176,seq32,r_191_107_82,r_191_107_82,1.0,96,178,82,34
52,r_275_90_183,r_35_245_143,r_171_274_83,r_171_274_83,0.99,2,85,83,34
77,r_224_104_102,seq24,r_195_271_46,r_195_271_46,0.61,56,102,46,34
75,r_64_118_47,r_272_168_176,r_251_147_191,r_64_118_47,1.0,0,47,47,34
3,r_238_43_30,seq113,r_56_137_168,r_238_43_30,0.99,2,32,30,34
31,r_160_21_58,seq74,seq139,r_160_21_58,1.0,0,58,58,34
25,r_42_298_33,seq14,r_296_297_112,r_296_297_112,1.0,8,120,112,34
144,seq134,r_6_216_179,r_290_38_105,r_290_38_105,0.97,74,179,105,34
82,r_176_266_97,r_42_298_33,seq128,r_176_266_97,0.98,1,98,97,34
10,r_195_271_46,seq14,r_252_7_47,r_195_271_46,0.9,1,47,46,34
9,r_290_38_105,seq93,seq233,r_290_38_105,1.0,0,105,105,34
96,r_294_218_107,r_60_11_154,seq247,r_294_218_107,0.94,9,116,107,34
37,r_239_225_42,r_251_147_191,r_231_3_105,r_231_3_105,1.0,8,113,105,34
22,r_241_73_145,seq289,r_191_107_82,r_191_107_82,0.72,63,145,82,34
90,r_31_39_14,r_183_68_100,seq99,r_31_39_14,0.79,0,14,14,34
28,r_140_230_183,seq84,r_70_204_42,r_70_204_42,0.9,141,183,42,34
91,r_205_130_87,r_85_124_143,r_238_43_30,r_205_130_87,0.49,0,87,87,34
81,r_51_273_43,seq146,seq289,r_51_273_43,1.0,0,43,43,34
49,r_56_137_168,r_123_174_68,r_238_43_30,r_56_137_168,0.61,-100,68,168,34
149,seq152,r_44_62_191,r_22_220_120,r_22_220_120,0.86,1,121,120,34
56,r_69_185_92,r_240_111_164,seq226,r_69_185_92,1.0,0,92,92,34
18,r_75_127_170,r_188_236_64,r_108_242_95,r_75_127_170,1.0,0,170,170,34
44,r_188_236_64,r_122_193_158,r_75_127_170,r_188_236_64,1.0,0,64,64,34
131,seq99,seq162,r_31_39_14,r_31_39_14,0.77,131,145,14,34
1,r_214_121_15,r_224_104_102,seq95,r_214_121_15,0.65,2,17,15,34
175,seq226,r_2_92_176,r_63_292_74,r_63_292_74,0.95,102,176,74,34
108,seq24,r_224_104_102,seq257,r_224_104_102,0.94,-28,74,102,34
101,seq4,r_251_147_191,r_290_38_105,r_290_38_105,1.0,34,139,105,34
79,r_237_192_91,r_60_11_154,seq54,r_237_192_91,0.83,0,91,91,34
35,r_270_202_75,r_87_197_76,seq134,r_270_202_75,1.0,0,75,75,34
12,r_63_292_74,seq131,seq128,r_63_292_74,0.93,0,74,74,34
17,r_138_189_41,r_167_228_164,r_98_53_9,r_138_189_41,0.98,1,42,41,34
23,r_98_53_9,r_166_149_40,seq162,r_98_53_9,0.77,2,11,9,34
84,r_49_27_115,seq257,r_63_292_74,r_49_27_115,0.98,0,115,115,34
128,seq93,r_290_38_105,seq18,r_290_38_105,1.0,-8,97,105,34
55,r_171_274_83,r_275_90_183,r_70_204_42,r_275_90_183,0.97,-1,182,183,34
93,r_226_187_156,seq137,r_97_49_115,r_226_187_156,0.78,1,157,156,35
30,r_243_159_199,seq89,r_295_99_66,r_295_99_66,1.0,15,81,66,35
184,seq246,r_37_38_125,r_203_1_9,r_203_1_9,0.97,2,11,9,35
51,r_247_10_163,seq50,r_174_198_50,r_174_198_50,0.74,113,163,50,35
47,r_12_194_165,seq11,r_203_1_9,r_12_194_165,1.0,0,165,165,35
14,r_23_62_69,r_221_261_184,seq262,r_23_62_69,1.0,0,69,69,35
87,r_266_60_27,r_0_158_182,seq176,r_266_60_27,0.81,1,28,27,35
53,r_229_292_163,seq136,r_43_29_3,r_229_292_163,0.64,3,166,163,35
60,r_28_172_33,seq6,seq207,r_28_172_33,0.91,0,33,33,35
54,r_27_86_149,seq244,r_94_100_147,r_27_86_149,0.74,0,149,149,35
59,r_152_58_140,seq186,seq67,r_152_58_140,0.39,5,145,140,35
55,r_249_21_135,seq84,r_37_38_125,r_249_21_135,0.83,1,136,135,35
86,r_277_46_94,seq5,r_45_113_36,r_45_113_36,0.98,68,104,36,35
16,r_122_271_148,r_97_49_115,r_164_130_147,r_97_49_115,0.71,33,148,115,35
21,r_157_283_75,seq178,seq42,r_157_283_75,1.0,0,75,75,35
1,r_287_167_79,r_282_281_193,r_227_156_35,r_282_281_193,0.97,-113,80,193,35
5,r_120_107_122,seq262,r_254_7_8,r_120_107_122,0.79,0,122,122,35
42,r_33_220_183,seq136,r_285_39_177,r_33_220_183,0.38,0,183,183,35
69,r_75_115_181,seq25,r_183_68_18,r_183_68_18,1.0,165,183,18,35
31,r_34_296_48,r_118_234_135,seq109,r_118_234_135,0.81,-83,52,135,35
76,r_190_143_33,r_243_159_199,seq137,r_190_143_33,1.0,0,33,33,35
39,r_123_40_32,r_51_36_100,r_199_8_8,r_123_40_32,1.0,0,32,32,35
153,seq162,r_117_236_148,r_97_49_115,r_117_236_148,1.0,0,148,148,35
71,r_110_294_15,r_72_96_198,seq4,r_110_294_15,1.0,0,15,15,35
24,r_209_135_42,r_144_286_115,seq245,r_209_135_42,0.94,0,42,42,35
41,r_83_274_93,r_215_76_193,seq242,r_83_274_93,1.0,0,93,93,35
50,r_291_54_20,seq31,seq57,r_291_54_20,0.99,0,20,20,35
67,r_200_269_178,r_132_98_195,r_118_234_135,r_132_98_195,0.57,-17,178,195,35
89,r_105_201_180,seq111,r_256_267_162,r_105_201_180,0.62,0,180,180,35
146,seq137,r_226_187_156,r_190_143_33,r_190_143_33,0.97,15,48,33,35
10,r_154_225_187,r_70_230_168,r_92_272_6,r_70_230_168,0.83,0,168,168,35
144,seq134,seq13,r_279_103_29,r_279_103_29,1.0,3,32,29,35
103,seq6,r_199_8_8,r_174_198_50,r_174_198_50,0.88,7,57,50,35
115,seq50,r_247_10_163,r_214_268_13,r_247_10_163,0.8,0,163,163,35
72,r_168_138_184,seq109,r_254_7_8,r_254_7_8,0.54,176,184,8,35
4,r_278_47_102,r_285_39_177,seq35,r_278_47_102,0.98,1,103,102,35
0,r_256_267_162,r_75_115_181,seq173,r_256_267_162,0.81,1,163,162,35
11,r_237_224_181,seq262,r_27_86_149,r_27_86_149,0.53,32,181,149,35
99,r_221_261_184,r_24_250_37,r_23_62_69,r_221_261_184,0.89,0,184,184,35
13,r_118_234_135,seq42,seq111,r_118_234_135,0.95,0,135,135,35
15,r_141_222_119,seq235,r_24_250_37,r_141_222_119,0.99,0,119,119,35
66,r_174_198_50,r_257_73_71,seq6,r_174_198_50,1.0,0,50,50,35
62,r_238_241_161,seq251,r_164_130_147,r_164_130_147,0.76,15,162,147,35
99,r_221_261_184,r_197_129_145,r_24_250_37,r_24_250_37,0.67,30,67,37,35
160,seq178,r_157_283_75,r_214_268_13,r_157_283_75,1.0,0,75,75,35
8,r_80_2_41,r_237_224_181,r_72_96_198,r_80_2_41,1.0,0,41,41,35
27,r_165_217_189,seq137,r_295_99_66,r_295_99_66,1.0,123,189,66,35
26,r_179_196_41,r_256_267_162,seq245,r_179_196_41,1.0,0,41,41,35
79,r_144_286_115,r_45_113_36,seq79,r_144_286_115,1.0,0,115,115,35
36,r_206_124_24,r_51_36_100,seq15,r_206_124_24,0.92,-9,15,24,35
47,r_12_194_165,r_22_204_114,seq11,r_22_204_114,1.0,0,114,114,35
40,r_37_38_125,seq246,r_28_172_33,r_37_38_125,0.97,0,125,125,35
45,r_45_113_36,seq207,r_144_286_115,r_45_113_36,1.0,0,36,36,35
10,r_154_225_187,r_92_272_6,r_278_47_102,r_154_225_187,0.75,0,187,187,35
74,r_94_100_147,r_70_230_168,r_197_129_145,r_70_230_168,0.57,-21,147,168,35
29,r_22_204_114,r_12_194_165,r_170_232_61,r_22_204_114,0.84,0,114,114,35
52,r_279_103_29,r_72_96_198,seq134,r_279_103_29,1.0,0,29,29,35
191,seq263,r_197_129_145,r_24_250_37,r_24_250_37,0.85,109,146,37,35
6,r_24_250_37,seq116,r_221_261_184,r_24_250_37,0.82,2,39,37,35
98,r_160_128_29,seq61,r_70_230_168,r_160_128_29,0.99,0,29,29,35
88,r_85_17_148,r_75_115_181,r_174_198_50,r_75_115_181,0.78,-33,148,181,35
190,seq262,r_237_224_181,r_23_62_69,r_23_62_69,1.0,112,181,69,35
58,r_88_16_81,seq106,r_28_172_33,r_88_16_81,0.96,0,81,81,35
6,r_24_250_37,r_221_261_184,r_141_222_119,r_141_222_119,1.0,65,184,119,35
65,r_257_73_71,r_117_236_148,seq147,r_257_73_71,1.0,0,71,71,35
68,r_151_155_75,seq121,r_203_1_9,r_151_155_75,0.99,0,75,75,35
57,r_264_78_23,r_12_194_165,r_183_68_18,r_264_78_23,1.0,0,23,23,35
32,r_0_158_182,seq202,r_23_62_69,r_23_62_69,1.0,115,184,69,35
77,r_71_293_159,seq35,r_23_62_69,r_23_62_69,0.98,90,159,69,35
34,r_253_82_154,seq14,r_37_38_125,r_37_38_125,0.98,30,155,125,35
75,r_295_99_66,seq13,r_243_159_199,r_295_99_66,1.0,0,66,66,35
22,r_183_68_18,r_210_273_116,seq77,r_183_68_18,1.0,0,18,18,35
25,r_248_18_21,r_219_30_90,seq19,r_248_18_21,0.73,2,23,21,35
45,r_45_113_36,r_144_286_115,r_277_46_94,r_45_113_36,0.98,79,115,36,35
81,r_148_81_69,r_210_273_116,seq147,r_148_81_69,1.0,2,71,69,35
168,seq192,seq218,r_164_130_147,r_164_130_147,1.0,3,150,147,35
17,r_219_30_90,r_71_293_159,r_51_36_100,r_219_30_90,0.98,2,92,90,35
18,r_72_96_198,r_70_230_168,r_80_2_41,r_80_2_41,0.93,7,48,41,35
94,r_131_66_157,seq177,r_34_296_48,r_131_66_157,0.85,0,157,157,35
121,seq65,r_26_56_85,seq116,r_26_56_85,1.0,0,85,85,35
9,r_70_230_168,r_154_225_187,seq4,r_70_230_168,0.47,0,168,168,35
96,r_97_49_115,seq15,seq162,r_97_49_115,0.44,34,149,115,35
98,r_160_128_29,r_70_230_168,r_125_213_115,r_160_128_29,0.83,139,168,29,35
102,seq5,r_277_46_94,seq35,r_277_46_94,0.95,10,104,94,35
91,r_197_129_145,seq263,seq136,r_197_129_145,0.39,1,146,145,35
135,seq108,r_197_129_145,r_203_1_9,r_203_1_9,0.64,76,85,9,35
49,r_210_273_116,seq244,seq11,r_210_273_116,0.98,0,116,116,35
140,seq121,r_151_155_75,seq231,r_151_155_75,1.0,0,75,75,35
56,r_164_130_147,r_197_129_145,r_144_286_115,r_164_130_147,0.54,0,147,147,35
7,r_51_36_100,seq19,r_219_30_90,r_219_30_90,1.0,12,102,90,35
185,seq251,r_87_48_178,r_209_135_42,r_209_135_42,1.0,136,178,42,35
44,r_125_213_115,r_75_115_181,r_160_128_29,r_160_128_29,0.65,97,126,29,35
23,r_59_114_92,r_122_271_148,r_23_62_69,r_122_271_148,1.0,-56,92,148,35
20,r_166_52_10,r_0_158_182,seq255,r_166_52_10,0.99,0,10,10,35
82,r_117_236_148,seq162,seq4,r_117_236_148,0.87,0,148,148,35
159,seq177,r_131_66_157,r_170_232_61,r_170_232_61,1.0,96,157,61,35
79,r_144_286_115,r_209_135_42,r_45_113_36,r_144_286_115,1.0,-73,42,115,35
12,r_74_298_108,r_97_49_115,r_278_47_102,r_278_47_102,0.98,9,111,102,35
172,seq207,seq280,r_28_172_33,r_28_172_33,1.0,26,59,33,35
51,r_85_196_147,seq155,r_106_13_141,r_85_196_147,0.78,0,147,147,36
36,r_112_64_116,seq119,seq259,r_112_64_116,0.98,0,116,116,36
69,r_218_204_51,r_6_71_129,seq178,r_218_204_51,1.0,0,51,51,36
86,r_51_232_19,r_180_184_160,seq72,r_51_232_19,0.81,-4,15,19,36
65,r_102_133_46,r_168_111_126,seq75,r_102_133_46,1.0,0,46,46,36
14,r_103_208_182,seq79,seq161,r_103_208_182,0.59,0,182,182,36
8,r_36_92_108,seq97,seq19,r_36_92_108,0.42,1,109,108,36
58,r_180_184_160,r_148_239_56,seq209,r_180_184_160,0.81,4,164,160,36
43,r_108_76_122,seq113,r_137_267_101,r_108_76_122,0.94,0,122,122,36
54,r_24_285_75,r_6_71_129,r_286_86_67,r_6_71_129,0.92,-54,75,129,36
59,r_170_18_113,r_48_157_180,seq63,r_170_18_113,0.97,0,113,113,36
74,r_33_230_136,r_180_184_160,r_275_38_26,r_275_38_26,1.0,0,26,26,36
39,r_221_126_80,r_279_61_122,r_273_234_16,r_221_126_80,0.89,8,88,80,36
7,r_110_17_76,seq83,r_166_25_128,r_166_25_128,1.0,4,132,128,36
5,r_140_59_74,seq58,r_294_150_47,r_294_150_47,0.99,29,76,47,36
46,r_39_288_129,seq0,r_292_7_38,r_292_7_38,0.86,93,131,38,36
80,r_254_40_156,seq291,r_176_220_9,r_254_40_156,0.59,0,156,156,36
11,r_281_56_22,r_170_18_113,seq97,r_281_56_22,0.78,-3,19,22,36
45,r_94_116_76,r_87_141_47,seq260,r_94_116_76,0.54,-2,74,76,36
193,seq287,r_84_31_154,r_69_8_75,r_69_8_75,0.89,19,94,75,36
19,r_251_205_91,r_84_31_154,seq173,r_251_205_91,0.83,0,91,91,36
71,r_247_1_13,r_219_210_169,seq80,r_247_1_13,0.63,0,13,13,36
158,seq162,r_249_280_190,r_286_86_67,r_286_86_67,1.0,123,190,67,36
95,r_74_233_143,seq289,r_46_290_5,r_74_233_143,0.72,1,144,143,36
76,r_192_128_128,r_180_184_160,r_140_59_74,r_192_128_128,0.98,0,128,128,36
31,r_6_71_129,seq80,r_94_116_76,r_6_71_129,0.74,7,136,129,36
129,seq83,seq162,r_11_258_43,r_11_258_43,1.0,57,100,43,36
67,r_242_187_173,r_47_257_87,seq58,r_47_257_87,0.38,92,179,87,36
89,r_129_44_100,seq189,r_275_38_26,r_129_44_100,0.98,1,101,100,36
0,r_250_225_58,r_103_208_182,r_101_42_94,r_250_225_58,1.0,0,58,58,36
90,r_47_257_87,r_242_187_173,seq178,r_47_257_87,0.5,12,99,87,36
42,r_148_239_56,r_109_195_190,r_180_184_160,r_148_239_56,1.0,0,56,56,36
26,r_88_264_144,seq248,r_244_32_55,r_88_264_144,0.94,1,145,144,36
180,seq229,r_219_210_169,seq10,r_219_210_169,1.0,0,169,169,36
170,seq198,r_279_61_122,r_156_214_70,r_156_214_70,1.0,57,127,70,36
128,seq81,r_77_14_51,r_101_42_94,r_77_14_51,1.0,0,51,51,36
4,r_212_121_176,seq30,r_194_29_34,r_194_29_34,0.57,143,177,34,36
78,r_269_216_105,r_45_165_129,r_156_214_70,r_156_214_70,0.81,43,113,70,36
73,r_277_224_126,r_6_71_129,r_271_66_43,r_6_71_129,0.74,-2,127,129,36
13,r_200_123_82,r_222_143_195,seq260,r_200_123_82,0.59,4,86,82,36
15,r_219_210_169,seq229,seq155,r_219_210_169,0.8,0,169,169,36
2,r_275_38_26,seq181,r_33_230_136,r_275_38_26,1.0,0,26,26,36
18,r_125_149_31,r_74_233_143,seq26,r_125_149_31,0.78,0,31,31,36
6,r_235_223_86,r_84_31_154,seq139,r_235_223_86,1.0,0,86,86,36
53,r_175_237_99,seq63,r_294_150_47,r_294_150_47,1.0,5,52,47,36
74,r_33_230_136,r_275_38_26,seq207,r_33_230_136,1.0,1,137,136,36
85,r_69_8_75,r_110_17_76,seq287,r_69_8_75,1.0,4,79,75,36
2,r_275_38_26,r_33_230_136,r_129_44_100,r_275_38_26,0.89,111,137,26,36
30,r_55_238_39,r_168_111_126,r_278_297_29,r_55_238_39,0.87,1,40,39,36
160,seq172,r_84_31_154,r_271_66_43,r_271_66_43,0.66,50,93,43,36
161,seq173,seq10,r_251_205_91,r_251_205_91,0.95,14,105,91,36
27,r_48_157_180,r_273_234_16,r_279_61_122,r_279_61_122,0.65,62,184,122,36
1,r_77_14_51,seq81,r_171_185_3,r_77_14_51,1.0,0,51,51,36
87,r_120_272_103,r_144_23_75,r_137_267_101,r_120_272_103,0.98,0,103,103,36
47,r_286_86_67,r_279_61_122,seq259,r_286_86_67,1.0,0,67,67,36
40,r_159_193_63,r_268_177_192,seq291,r_159_193_63,0.99,0,63,63,36
126,seq79,r_103_208_182,r_292_7_38,r_292_7_38,0.79,144,182,38,36
97,r_244_32_55,seq15,r_247_1_13,r_244_32_55,0.96,0,55,55,36
195,seq291,r_254_40_156,r_159_193_63,r_159_193_63,0.98,93,156,63,36
25,r_130_12_73,seq161,seq21,r_130_12_73,1.0,0,73,73,36
33,r_273_234_16,r_48_157_180,r_221_126_80,r_221_126_80,1.0,104,184,80,36
48,r_163_206_160,r_46_290_5,seq63,r_163_206_160,0.96,0,160,160,36
92,r_191_160_53,r_219_210_169,r_247_1_13,r_191_160_53,0.97,0,53,53,36
64,r_62_256_115,r_6_71_129,r_35_203_54,r_62_256_115,0.86,1,116,115,36
191,seq265,r_169_226_91,r_104_167_7,r_169_226_91,1.0,0,91,91,36
53,r_175_237_99,r_294_150_47,r_101_42_94,r_175_237_99,1.0,0,99,99,36
58,r_180_184_160,r_192_128_128,r_148_239_56,r_148_239_56,0.69,7,63,56,36
192,seq276,r_192_128_128,r_148_239_56,r_148_239_56,0.84,72,128,56,36
68,r_118_293_91,seq299,r_125_149_31,r_118_293_91,1.0,2,93,91,36
42,r_148_239_56,r_180_184_160,seq276,r_180_184_160,0.82,4,164,160,36
38,r_169_226_91,seq265,seq95,r_169_226_91,1.0,0,91,91,36
52,r_142_114_94,seq96,seq80,r_142_114_94,0.96,0,94,94,36
34,r_174_146_100,r_254_40_156,r_292_7_38,r_174_146_100,1.0,0,100,100,36
10,r_292_7_38,seq75,seq73,r_292_7_38,0.96,0,38,38,36
61,r_183_20_53,r_100_182_118,r_281_56_22,r_183_20_53,1.0,0,53,53,36
60,r_84_31_154,seq172,r_110_17_76,r_84_31_154,0.71,0,154,154,36
41,r_194_29_34,r_110_17_76,seq3,r_110_17_76,1.0,-33,43,76,36
81,r_156_214_70,r_166_25_128,seq72,r_156_214_70,0.99,0,70,70,36
17,r_22_52_118,r_261_283_62,r_77_14_51,r_261_283_62,0.95,56,118,62,36
144,seq127,r_137_267_101,seq248,r_137_267_101,0.97,0,101,101,36
9,r_106_13_141,seq49,seq60,r_106_13_141,0.86,2,143,141,36
96,r_93_98_151,seq231,r_221_126_80,r_93_98_151,0.58,0,151,151,36
57,r_100_182_118,r_183_20_53,r_292_7_38,r_100_182_118,1.0,-65,53,118,36
99,r_271_66_43,r_286_86_67,seq172,r_271_66_43,1.0,1,44,43,36
91,r_166_25_128,seq209,r_110_17_76,r_166_25_128,0.89,0,128,128,36
77,r_11_258_43,r_6_71_129,seq83,r_11_258_43,1.0,0,43,43,36
49,r_266_134_138,seq26,r_129_44_100,r_129_44_100,0.9,40,140,100,36
56,r_137_267_101,seq127,r_120_272_103,r_137_267_101,0.93,2,103,101,36
7,r_110_17_76,r_69_8_75,seq83,r_110_17_76,1.0,4,80,76,36
44,r_68_153_65,seq162,seq295,r_68_153_65,1.0,0,65,65,36
63,r_278_297_29,r_118_293_91,r_55_238_39,r_278_297_29,1.0,21,50,29,36
82,r_249_280_190,seq162,seq107,r_249_280_190,0.39,0,190,190,36
24,r_294_150_47,r_235_223_86,r_140_59_74,r_294_150_47,1.0,0,47,47,36
79,r_240_91_148,seq259,r_275_38_26,r_240_91_148,0.95,0,148,148,36
22,r_270_5_29,r_88_264_144,seq57,r_270_5_29,0.93,0,29,29,36
12,r_168_111_126,r_253_67_19,r_277_224_126,r_168_111_126,0.53,1,127,126,36
23,r_46_290_5,r_163_206_160,r_74_233_143,r_163_206_160,0.57,-16,144,160,36
40,r_183_213_197,r_274_69_65,r_268_96_156,r_268_96_156,0.95,14,170,156,37
44,r_56_215_77,r_189_217_148,r_234_143_135,r_56_215_77,1.0,71,148,77,37
51,r_208_104_119,seq242,seq43,r_208_104_119,0.97,1,120,119,37
36,r_146_59_133,r_4_238_187,r_174_198_21,r_146_59_133,0.6,0,133,133,37
14,r_118_237_89,seq165,seq38,r_118_237_89,1.0,0,89,89,37
37,r_94_138_180,r_87_17_161,r_254_230_141,r_94_138_180,0.8,-19,161,180,37
168,seq225,r_126_163_51,r_80_115_43,r_126_163_51,1.0,1,52,51,37
59,r_119_9_162,r_229_120_70,r_214_103_162,r_119_9_162,0.85,1,163,162,37
55,r_296_130_137,r_195_26_155,seq242,r_195_26_155,0.46,-16,139,155,37
86,r_75_272_169,seq11,seq136,r_75_272_169,0.89,0,169,169,37
30,r_71_62_21,r_22_102_129,r_243_157_14,r_71_62_21,0.96,2,23,21,37
1,r_214_103_162,r_253_151_15,r_71_62_21,r_214_103_162,0.83,0,162,162,37
97,r_57_186_116,r_188_251_103,seq281,r_57_186_116,1.0,0,116,116,37
42,r_170_95_168,r_52_3_167,seq68,r_52_3_167,0.44,1,168,167,37
85,r_153_187_123,r_75_272_169,r_282_262_75,r_153_187_123,1.0,1,124,123,37
69,r_282_262_75,seq68,seq78,r_282_262_75,1.0,0,75,75,37
45,r_184_202_75,r_118_237_89,seq35,r_184_202_75,0.87,0,75,75,37
24,r_128_223_34,seq68,r_6_16_106,r_6_16_106,1.0,5,111,106,37
19,r_87_17_161,r_94_138_180,r_126_163_51,r_126_163_51,0.9,110,161,51,37
95,r_294_145_111,seq53,seq264,r_294_145_111,0.85,9,120,111,37
66,r_51_220_64,r_23_116_163,seq250,r_51_220_64,1.0,0,64,64,37
31,r_37_236_152,r_214_103_162,seq267,r_37_236_152,0.93,2,154,152,37
67,r_19_88_137,seq297,r_146_59_133,r_19_88_137,0.99,0,137,137,37
80,r_77_112_39,seq125,seq97,r_77_112_39,0.99,0,39,39,37
3,r_39_28_80,seq18,r_152_179_12,r_39_28_80,1.0,2,82,80,37
10,r_195_26_155,r_90_224_172,seq11,r_195_26_155,0.9,1,156,155,37
96,r_84_178_19,r_71_62_21,seq30,r_84_178_19,0.99,0,19,19,37
26,r_254_230_141,r_32_233_186,r_99_283_186,r_254_230_141,0.98,2,143,141,37
179,seq264,r_255_58_179,r_294_145_111,r_294_145_111,0.58,68,179,111,37
198,seq297,r_19_88_137,seq267,r_19_88_137,1.0,0,137,137,37
4,r_158_207_114,r_254_230_141,r_57_186_116,r_158_207_114,0.91,1,115,114,37
0,r_107_271_82,r_153_187_123,seq266,r_107_271_82,0.94,0,82,82,37
63,r_66_211_140,r_135_141_188,seq203,r_66_211_140,0.66,1,141,140,37
73,r_67_261_161,seq55,r_189_217_148,r_67_261_161,0.69,0,161,161,37
11,r_240_231_165,seq232,r_118_237_89,r_118_237_89,0.9,76,165,89,37
32,r_192_227_31,r_106_110_89,r_253_151_15,r_253_151_15,0.55,17,32,15,37
20,r_80_115_43,r_76_177_78,r_122_277_167,r_76_177_78,1.0,-18,60,78,37
98,r_204_259_123,seq53,seq216,r_204_259_123,0.84,2,125,123,37
15,r_292_131_177,seq74,seq20,r_292_131_177,0.34,0,177,177,37
48,r_83_191_98,seq246,r_229_120_70,r_83_191_98,1.0,2,100,98,37
22,r_221_65_10,r_218_171_162,seq133,r_221_65_10,1.0,0,10,10,37
106,seq13,r_155_260_138,seq165,r_155_260_138,1.0,1,139,138,37
65,r_173_29_37,r_22_102_129,r_14_235_115,r_173_29_37,0.99,0,37,37,37
6,r_160_129_68,seq101,r_192_227_31,r_160_129_68,1.0,2,70,68,37
62,r_64_98_143,r_124_15_192,r_270_123_99,r_124_15_192,0.48,-49,143,192,37
24,r_128_223_34,r_292_131_177,seq68,r_128_223_34,0.93,1,35,34,37
85,r_153_187_123,r_107_271_82,r_75_272_169,r_107_271_82,1.0,0,82,82,37
162,seq203,r_173_29_37,r_66_211_140,r_66_211_140,0.7,-2,138,140,37
43,r_14_235_115,r_77_112_39,r_173_29_37,r_173_29_37,0.98,5,42,37,37
136,seq111,r_146_59_133,r_106_110_89,r_106_110_89,0.89,3,92,89,37
87,r_144_258_195,r_122_277_167,r_80_115_43,r_144_258_195,0.84,-28,167,195,37
2,r_106_110_89,seq0,seq53,r_106_110_89,0.95,7,96,89,37
40,r_183_213_197,r_6_16_106,r_274_69_65,r_183_213_197,0.98,-91,106,197,37
78,r_197_181_51,r_8_166_96,seq1,r_197_181_51,1.0,0,51,51,37
18,r_24_285_84,seq43,seq101,r_24_285_84,1.0,1,85,84,37
29,r_274_69_65,seq111,r_124_15_192,r_274_69_65,1.0,0,65,65,37
71,r_126_163_51,seq225,r_77_112_39,r_126_163_51,1.0,1,52,51,37
53,r_243_157_14,seq250,seq113,r_243_157_14,1.0,0,14,14,37
35,r_189_217_148,r_56_215_77,r_270_123_99,r_189_217_148,1.0,1,149,148,37
25,r_255_58_179,seq264,r_254_230_141,r_255_58_179,0.45,0,179,179,37
43,r_14_235_115,r_173_29_37,r_152_179_12,r_14_235_115,0.96,0,115,115,37
33,r_4_238_187,seq53,r_299_25_1,r_4_238_187,0.48,0,187,187,37
64,r_234_143_135,r_214_103_162,seq101,r_234_143_135,0.77,0,135,135,37
65,r_173_29_37,r_14_235_115,seq43,r_14_235_115,1.0,0,115,115,37
5,r_41_180_43,r_282_262_75,seq298,r_41_180_43,0.83,1,44,43,37
88,r_247_10_183,seq12,r_214_103_162,r_247_10_183,0.49,0,183,183,37
50,r_124_15_192,r_195_26_155,r_274_69_65,r_274_69_65,0.99,1,66,65,37
58,r_245_201_152,seq68,seq297,r_245_201_152,0.97,2,154,152,37
177,seq250,r_221_65_10,r_51_220_64,r_51_220_64,1.0,0,64,64,37
20,r_80_115_43,r_122_277_167,seq18,r_122_277_167,0.99,0,167,167,37
140,seq125,r_77_112_39,r_174_198_21,r_77_112_39,0.94,0,39,39,37
61,r_52_3_167,r_170_95_168,r_173_29_37,r_173_29_37,0.97,131,168,37,37
23,r_54_73_52,r_140_287_79,seq45,r_54_73_52,1.0,1,53,52,37
38,r_268_96_156,seq293,r_183_213_197,r_183_213_197,0.5,-41,156,197,37
52,r_270_123_99,r_188_251_103,seq53,r_270_123_99,1.0,0,99,99,37
77,r_34_164_166,r_122_277_167,r_299_25_1,r_34_164_166,0.69,3,169,166,37
34,r_176_79_135,seq167,seq50,r_176_79_135,0.75,1,136,135,37
13,r_174_198_21,seq82,seq125,r_174_198_21,0.86,6,27,21,37
60,r_22_102_129,r_247_10_183,r_54_73_52,r_247_10_183,0.95,-54,129,183,37
81,r_196_89_149,r_214_103_162,seq45,r_196_89_149,0.72,5,154,149,37
94,r_6_16_106,r_183_213_197,r_128_223_34,r_6_16_106,1.0,0,106,106,37
9,r_76_177_78,r_80_115_43,seq242,r_76_177_78,1.0,0,78,78,37
123,seq53,r_294_145_111,r_270_123_99,r_270_123_99,1.0,21,120,99,37
91,r_140_287_79,r_31_108_191,seq49,r_140_287_79,0.99,0,79,79,37
49,r_185_241_69,seq225,seq45,r_185_241_69,1.0,1,70,69,37
44,r_56_215_77,r_122_277_167,r_189_217_148,r_56_215_77,0.86,5,82,77,37
138,seq114,r_218_171_162,r_195_26_155,r_195_26_155,0.97,9,164,155,37
82,r_199_222_122,seq101,seq267,r_199_222_122,0.98,0,122,122,37
90,r_149_81_26,seq50,seq55,r_149_81_26,1.0,1,27,26,37
35,r_189_217_148,seq101,r_56_215_77,r_56_215_77,0.99,7,84,77,37
12,r_8_166_96,seq284,r_2_92_7,r_8_166_96,1.0,0,96,96,37
72,r_152_179_12,r_76_177_78,seq265,r_152_179_12,0.73,0,12,12,37
84,r_122_277_167,r_144_258_195,seq42,r_122_277_167,0.74,0,167,167,37
93,r_273_268_141,seq14,r_216_133_110,r_273_268_141,0.96,0,141,141,38
51,r_227_162_172,seq149,seq185,r_227_162_172,0.53,3,175,172,38
87,r_272_235_16,r_4_67_134,seq209,r_272_235_16,0.79,0,16,16,38
50,r_228_299_50,r_150_66_148,seq212,r_228_299_50,1.0,-1,49,50,38
14,r_295_6_106,r_95_207_172,r_190_88_24,r_295_6_106,1.0,0,106,106,38
8,r_161_165_157,r_200_0_189,seq124,r_161_165_157,0.71,0,157,157,38
53,r_166_186_143,seq212,r_75_29_25,r_166_186_143,0.96,0,143,143,38
54,r_290_77_3,r_10_155_102,r_219_80_84,r_290_77_3,1.0,99,102,3,38
83,r_293_99_111,r_199_197_188,r_43_46_100,r_293_99_111,1.0,1,112,111,38
81,r_241_233_16,r_39_172_65,r_148_203_122,r_148_203_122,0.9,1,123,122,38
59,r_252_132_144,seq109,seq180,r_252_132_144,0.94,0,144,144,38
41,r_123_181_70,r_290_77_3,r_219_80_84,r_219_80_84,0.83,23,107,84,38
81,r_241_233_16,r_166_186_143,r_39_172_65,r_241_233_16,0.52,1,17,16,38
71,r_127_50_166,seq224,seq229,r_127_50_166,0.75,0,166,166,38
86,r_44_57_92,r_213_59_135,seq124,r_44_57_92,1.0,2,94,92,38
16,r_117_243_93,seq209,seq251,r_117_243_93,1.0,0,93,93,38
21,r_84_294_185,seq222,seq63,r_84_294_185,0.66,0,185,185,38
1,r_219_80_84,r_60_270_65,seq58,r_60_270_65,0.87,0,65,65,38
97,r_71_129_87,r_170_35_100,seq222,r_71_129_87,1.0,0,87,87,38
80,r_200_0_189,r_208_12_82,r_148_203_122,r_200_0_189,0.56,1,190,189,38
187,seq263,seq78,r_33_220_175,r_33_220_175,0.89,1,176,175,38
46,r_43_46_100,r_112_154_159,r_71_129_87,r_43_46_100,1.0,1,101,100,38
42,r_112_154_159,seq65,seq145,r_112_154_159,0.48,0,159,159,38
80,r_200_0_189,r_161_165_157,r_208_12_82,r_208_12_82,1.0,-1,81,82,38
69,r_52_11_68,seq85,r_131_279_51,r_52_11_68,1.0,0,68,68,38
45,r_31_177_85,r_216_133_110,seq78,r_31_177_85,1.0,2,87,85,38
1,r_219_80_84,seq58,r_123_181_70,r_219_80_84,0.98,0,84,84,38
158,seq180,r_75_29_25,r_252_132_144,r_252_132_144,1.0,8,152,144,38
38,r_8_94_40,r_4_67_134,seq174,r_8_94_40,1.0,0,40,40,38
95,r_156_217_145,seq205,r_262_202_60,r_156_217_145,0.73,0,145,145,38
76,r_281_118_101,seq97,seq114,r_281_118_101,0.98,1,102,101,38
39,r_7_221_29,r_98_258_118,seq257,r_7_221_29,1.0,0,29,29,38
31,r_182_237_100,seq184,seq257,r_182_237_100,0.82,1,101,100,38
41,r_123_181_70,seq124,r_290_77_3,r_123_181_70,1.0,1,71,70,38
3,r_291_250_147,seq255,r_64_9_146,r_291_250_147,0.94,0,147,147,38
10,r_267_214_75,r_89_256_83,r_216_133_110,r_267_214_75,1.0,0,75,75,38
90,r_120_179_186,seq171,r_4_67_134,r_120_179_186,0.5,0,186,186,38
32,r_45_74_48,r_193_298_47,seq196,r_45_74_48,1.0,1,49,48,38
72,r_139_13_125,seq22,r_297_282_173,r_139_13_125,0.99,0,125,125,38
78,r_198_54_77,seq102,seq62,r_198_54_77,1.0,0,77,77,38
73,r_213_59_135,seq96,r_93_18_101,r_213_59_135,0.99,0,135,135,38
55,r_3_195_17,r_75_29_25,seq289,r_3_195_17,0.99,0,17,17,38
198,seq289,r_53_286_157,r_3_195_17,r_3_195_17,1.0,0,17,17,38
20,r_32_153_177,seq185,r_43_46_100,r_32_153_177,0.7,1,178,177,38
77,r_249_275_51,r_164_28_166,seq15,r_249_275_51,1.0,0,51,51,38
163,seq191,seq62,r_25_147_142,r_25_147_142,0.92,0,142,142,38
98,r_238_126_67,r_227_162_172,seq269,r_238_126_67,1.0,-1,66,67,38
15,r_173_37_167,seq143,r_27_189_4,r_173_37_167,0.86,0,167,167,38
48,r_10_155_102,r_290_77_3,r_47_106_39,r_290_77_3,0.99,99,102,3,38
62,r_150_66_148,r_274_218_156,seq255,r_150_66_148,0.85,6,154,148,38
74,r_208_12_82,r_200_0_189,r_53_286_157,r_53_286_157,0.63,33,190,157,38
99,r_72_61_87,r_84_294_185,seq96,r_72_61_87,0.98,5,92,87,38
122,seq85,r_41_70_153,r_248_90_82,r_248_90_82,1.0,76,158,82,38
27,r_53_286_157,r_136_68_8,r_45_74_48,r_53_286_157,0.82,2,159,157,38
172,seq222,r_33_220_175,r_137_188_177,r_33_220_175,0.89,-14,161,175,38
146,seq144,r_178_34_122,r_83_2_53,r_83_2_53,0.62,0,53,53,38
47,r_148_203_122,seq16,r_241_233_16,r_148_203_122,0.75,1,123,122,38
105,seq22,r_139_13_125,seq101,r_139_13_125,1.0,0,125,125,38
74,r_208_12_82,seq69,r_200_0_189,r_208_12_82,1.0,-1,81,82,38
18,r_93_18_101,seq145,seq289,r_93_18_101,1.0,0,101,101,38
17,r_41_70_153,r_130_128_54,seq85,r_130_128_54,1.0,-11,43,54,38
25,r_164_28_166,r_32_153_177,seq109,r_164_28_166,0.78,1,167,166,38
33,r_5_167_63,seq168,seq91,r_5_167_63,1.0,0,63,63,38
64,r_274_218_156,r_150_66_148,r_81_142_31,r_150_66_148,0.9,6,154,148,38
61,r_47_106_39,seq20,r_272_235_16,r_47_106_39,1.0,0,39,39,38
58,r_138_277_173,seq63,r_157_254_122,r_138_277_173,0.7,0,173,173,38
70,r_201_236_70,seq140,r_130_128_54,r_130_128_54,0.77,15,69,54,38
65,r_79_232_144,r_33_220_175,seq158,r_79_232_144,0.8,1,145,144,38
37,r_130_128_54,r_41_70_153,seq76,r_130_128_54,1.0,0,54,54,38
68,r_288_204_77,seq266,r_137_188_177,r_288_204_77,1.0,0,77,77,38
63,r_105_122_35,r_117_243_93,seq168,r_105_122_35,1.0,0,35,35,38
52,r_116_210_156,seq78,r_238_126_67,r_238_126_67,1.0,90,157,67,38
34,r_178_34_122,seq144,r_290_77_3,r_178_34_122,1.0,0,122,122,38
79,r_83_2_53,r_213_59_135,seq144,r_83_2_53,1.0,0,53,53,38
60,r_262_202_60,r_33_220_175,seq14,r_262_202_60,1.0,0,60,60,38
75,r_131_279_51,r_98_258_118,r_95_207_172,r_131_279_51,1.0,0,51,51,38
94,r_21_1_39,r_297_282_173,seq63,r_21_1_39,1.0,0,39,39,38
121,seq78,r_116_210_156,r_98_258_118,r_98_258_118,0.88,39,157,118,38
9,r_25_147_142,seq40,seq191,r_25_147_142,0.97,0,142,142,38
145,seq143,r_173_37_167,seq42,r_173_37_167,0.93,0,167,167,38
85,r_271_49_22,r_123_181_70,seq212,r_271_49_22,1.0,1,23,22,38
96,r_39_172_65,r_241_233_16,r_262_202_60,r_262_202_60,1.0,6,66,60,38
23,r_211_246_144,r_31_177_85,r_8_94_40,r_211_246_144,1.0,1,145,144,38
28,r_81_142_31,seq124,r_274_218_156,r_274_218_156,0.56,-1,155,156,38
102,seq16,r_148_203_122,r_160_36_88,r_148_203_122,0.79,1,123,122,38
169,seq209,r_81_142_31,r_272_235_16,r_272_235_16,0.72,21,37,16,38
84,r_19_296_41,r_121_82_196,r_297_282_173,r_19_296_41,1.0,0,41,41,38
153,seq168,r_5_167_63,r_193_298_47,r_5_167_63,0.86,-18,45,63,38
7,r_4_67_134,r_137_188_177,seq97,r_4_67_134,0.73,1,135,134,38
44,r_60_270_65,r_219_80_84,seq65,r_60_270_65,0.98,0,65,65,38
23,r_211_246_144,r_81_142_31,r_31_177_85,r_31_177_85,1.0,6,91,85,38
82,r_24_242_62,r_98_258_118,seq255,r_24_242_62,1.0,1,63,62,38
22,r_190_88_24,r_41_70_153,r_261_23_199,r_190_88_24,0.83,-1,23,24,38
159,seq183,r_150_66_148,r_98_258_118,r_98_258_118,0.61,27,145,118,38
101,seq15,seq240,r_249_275_51,r_249_275_51,1.0,61,112,51,38
183,seq255,r_291_250_147,r_24_242_62,r_24_242_62,0.99,54,116,62,38
122,seq85,r_52_11_68,r_41_70_153,r_52_11_68,1.0,-25,43,68,38
35,r_141_253_173,seq17,r_152_245_143,r_141_253_173,0.7,0,173,173,38
12,r_157_254_122,r_127_50_166,r_281_118_101,r_157_254_122,0.99,0,122,122,38
24,r_193_298_47,r_45_74_48,seq168,r_193_298_47,0.73,-2,45,47,38
40,r_224_162_92,r_172_16_183,r_24_226_35,r_172_16_183,0.97,-2,181,183,39
30,r_251_18_97,r_205_76_194,seq113,r_251_18_97,0.95,0,97,97,39
36,r_37_286_70,seq201,r_189_199_2,r_37_286_70,1.0,0,70,70,39
92,r_231_61_183,seq298,seq66,r_231_61_183,0.44,0,183,183,39
66,r_172_16_183,r_224_162_92,r_213_260_125,r_224_162_92,0.85,91,183,92,39
14,r_90_85_112,seq273,r_93_209_199,r_90_85_112,1.0,0,112,112,39
83,r_239_59_137,r_2_36_158,r_5_263_43,r_239_59_137,0.69,0,137,137,39
90,r_92_289_50,r_164_252_145,seq298,r_92_289_50,1.0,0,50,50,39
37,r_242_217_71,r_157_134_79,r_95_40_18,r_242_217_71,1.0,-1,70,71,39
55,r_50_228_126,r_83_63_127,r_294_22_119,r_50_228_126,0.51,0,126,126,39
71,r_38_115_4,r_1_196_81,r_279_34_53,r_38_115_4,0.98,61,65,4,39
16,r_95_40_18,r_207_19_148,seq78,r_95_40_18,0.99,1,19,18,39
86,r_81_4_107,r_215_148_177,r_45_270_49,r_81_4_107,1.0,0,107,107,39
21,r_42_248_157,seq91,seq97,r_42_248_157,0.89,0,157,157,39
39,r_69_71_135,seq203,seq193,r_69_71_135,0.99,0,135,135,39
97,r_163_131_82,seq113,seq124,r_163_131_82,0.99,2,84,82,39
5,r_189_199_2,r_104_282_63,r_186_121_75,r_186_121_75,1.0,7,82,75,39
104,seq11,r_83_63_127,seq275,r_83_63_127,1.0,13,140,127,39
46,r_55_181_67,r_188_159_12,r_5_263_43,r_55_181_67,1.0,1,68,67,39
42,r_266_153_126,r_185_135_170,seq100,r_266_153_126,0.57,11,137,126,39
88,r_45_270_49,seq201,r_57_54_113,r_57_54_113,1.0,23,136,113,39
32,r_104_282_63,r_185_135_170,r_102_86_123,r_102_86_123,1.0,50,173,123,39
69,r_74_296_166,seq100,r_107_21_101,r_107_21_101,0.85,67,168,101,39
8,r_88_17_164,r_272_41_150,seq290,r_272_41_150,0.68,-96,54,150,39
95,r_272_41_150,r_88_17_164,r_144_122_5,r_272_41_150,0.86,3,153,150,39
66,r_172_16_183,seq201,r_224_162_92,r_224_162_92,1.0,-2,90,92,39
77,r_58_221_55,r_29_241_119,seq233,r_58_221_55,0.98,-5,50,55,39
190,seq275,r_284_235_62,seq11,r_284_235_62,1.0,-16,46,62,39
103,seq9,seq295,r_165_274_89,r_165_274_89,1.0,7,96,89,39
60,r_96_84_23,r_157_134_79,seq97,r_96_84_23,1.0,0,23,23,39
67,r_194_180_72,seq146,r_189_199_2,r_194_180_72,0.98,0,72,72,39
10,r_72_212_70,r_170_225_123,r_167_253_6,r_72_212_70,1.0,0,70,70,39
80,r_79_197_50,seq89,seq298,r_79_197_50,0.73,-4,46,50,39
8,r_88_17_164,seq290,r_29_241_119,r_88_17_164,0.38,5,169,164,39
72,r_283_220_129,r_211_133_179,seq171,r_283_220_129,0.99,0,129,129,39
88,r_45_270_49,r_231_61_183,seq201,r_45_270_49,1.0,0,49,49,39
78,r_299_222_170,r_145_125_158,r_105_67_151,r_299_222_170,0.49,-18,152,170,39
0,r_80_278_121,seq179,seq32,r_80_278_121,1.0,0,121,121,39
63,r_229_246_185,r_52_13_186,r_144_122_5,r_144_122_5,0.72,181,186,5,39
73,r_128_234_74,seq146,seq127,r_128_234_74,0.99,0,74,74,39
11,r_205_76_194,r_251_18_97,seq139,r_251_18_97,1.0,0,97,97,39
20,r_280_68_85,r_99_150_176,seq32,r_280_68_85,1.0,0,85,85,39
13,r_53_285_157,seq32,seq295,r_53_285_157,0.91,0,157,157,39
98,r_1_196_81,seq15,seq204,r_1_196_81,1.0,0,81,81,39
56,r_164_252_145,r_106_174_194,seq250,r_164_252_145,0.99,-1,144,145,39
78,r_299_222_170,r_105_67_151,r_51_293_88,r_105_67_151,0.5,29,180,151,39
48,r_93_209_199,seq89,r_90_85_112,r_90_85_112,1.0,43,155,112,39
57,r_143_268_149,seq78,r_207_19_148,r_143_268_149,0.57,1,150,149,39
106,seq14,r_88_17_164,seq193,r_88_17_164,0.63,-100,64,164,39
148,seq160,r_106_174_194,r_210_33_52,r_210_33_52,0.96,5,57,52,39
6,r_207_19_148,seq127,r_143_268_149,r_143_268_149,0.55,1,150,149,39
62,r_107_21_101,seq127,seq7,r_107_21_101,1.0,0,101,101,39
85,r_165_274_89,r_188_159_12,seq9,r_165_274_89,1.0,0,89,89,39
99,r_145_125_158,seq208,seq218,r_145_125_158,0.68,0,158,158,39
56,r_164_252_145,r_92_289_50,r_106_174_194,r_92_289_50,1.0,-14,36,50,39
53,r_185_135_170,r_104_282_63,r_79_197_50,r_104_282_63,0.58,110,173,63,39
26,r_279_34_53,seq35,r_38_115_4,r_279_34_53,1.0,1,54,53,39
100,seq3,r_232_236_18,r_65_60_53,r_65_60_53,1.0,1,54,53,39
47,r_102_86_123,r_213_260_125,seq48,r_102_86_123,0.99,0,123,123,39
121,seq78,r_161_114_192,r_95_40_18,r_95_40_18,1.0,0,18,18,39
40,r_224_162_92,seq146,r_172_16_183,r_224_162_92,0.95,0,92,92,39
126,seq100,r_294_22_119,r_186_121_75,r_186_121_75,1.0,45,120,75,39
74,r_2_36_158,seq77,r_83_63_127,r_2_36_158,0.89,0,158,158,39
18,r_157_134_79,r_242_217_71,seq91,r_242_217_71,0.83,-3,68,71,39
29,r_176_132_63,r_165_274_89,seq146,r_176_132_63,1.0,0,63,63,39
195,seq290,r_272_41_150,r_187_82_62,r_187_82_62,0.68,91,153,62,39
24,r_105_67_151,seq120,r_299_222_170,r_105_67_151,0.82,1,152,151,39
45,r_112_192_46,r_294_22_119,seq77,r_112_192_46,1.0,0,46,46,39
33,r_249_94_158,seq142,seq62,r_249_94_158,0.59,0,158,158,39
64,r_154_56_184,r_137_0_93,seq218,r_137_0_93,1.0,-6,87,93,39
50,r_57_54_113,seq298,r_81_4_107,r_57_54_113,1.0,0,113,113,39
58,r_110_247_80,seq267,seq169,r_110_247_80,1.0,0,80,80,39
70,r_147_259_84,r_165_274_89,seq111,r_147_259_84,0.99,0,84,84,39
65,r_215_148_177,seq227,r_104_282_63,r_215_148_177,0.38,0,177,177,39
68,r_170_225_123,seq298,r_28_264_15,r_170_225_123,0.96,0,123,123,39
3,r_28_264_15,r_213_260_125,seq238,r_28_264_15,0.49,0,15,15,39
32,r_104_282_63,r_74_296_166,r_185_135_170,r_104_282_63,0.75,-4,59,63,39
130,seq117,seq138,r_29_241_119,r_29_241_119,0.58,9,128,119,39
38,r_284_235_62,seq275,seq77,r_284_235_62,1.0,0,62,62,39
52,r_83_63_127,seq11,r_137_0_93,r_137_0_93,1.0,38,131,93,39
53,r_185_135_170,r_42_248_157,r_104_282_63,r_185_135_170,0.58,-111,59,170,39
34,r_70_47_177,seq39,r_58_221_55,r_70_47_177,0.52,2,179,177,39
64,r_154_56_184,seq218,r_189_199_2,r_154_56_184,0.95,0,184,184,39
75,r_109_43_89,r_83_63_127,seq201,r_109_43_89,0.95,0,89,89,39
89,r_65_60_53,r_165_274_89,seq3,r_65_60_53,1.0,0,53,53,39
15,r_210_33_52,r_175_255_82,seq160,r_210_33_52,1.0,0,52,52,39
112,seq32,r_53_285_157,r_280_68_85,r_280_68_85,1.0,72,157,85,39
94,r_23_195_151,seq6,seq275,r_23_195_151,0.99,0,151,151,39
25,r_24_226_35,r_79_197_50,seq218,r_24_226_35,1.0,0,35,35,39
9,r_211_133_179,seq179,r_103_129_2,r_103_129_2,0.84,176,178,2,39
96,r_51_293_88,r_42_248_157,r_232_236_18,r_51_293_88,0.99,0,88,88,39
133,seq120,r_105_67_151,seq97,r_105_67_151,0.98,1,152,151,39
28,r_213_260_125,r_102_86_123,seq277,r_102_86_123,1.0,0,123,123,39
91,r_141_214_144,seq171,r_213_260_125,r_141_214_144,0.97,2,146,144,39
49,r_29_241_119,r_229_246_185,seq117,r_29_241_119,0.64,16,135,119,39
152,seq171,r_141_214_144,r_79_197_50,r_141_214_144,0.62,2,146,144,39
163,seq201,r_45_270_49,r_109_43_89,r_109_43_89,1.0,3,92,89,39
7,r_46_291_122,seq233,r_28_264_15,r_46_291_122,1.0,0,122,122,39
168,seq218,r_154_56_184,r_24_226_35,r_24_226_35,1.0,0,35,35,39
44,r_187_82_62,r_83_63_127,r_188_159_12,r_187_82_62,0.99,0,62,62,39
23,r_294_22_119,seq100,seq113,r_294_22_119,0.76,1,120,119,39
189,seq273,r_90_85_112,seq178,r_90_85_112,1.0,0,112,112,39
101,seq6,r_23_195_151,r_5_263_43,r_23_195_151,0.89,0,151,151,39
79,r_137_0_93,r_154_56_184,seq140,r_137_0_93,1.0,0,93,93,39
12,r_186_121_75,seq223,r_194_180_72,r_186_121_75,1.0,0,75,75,39
84,r_26_152_108,r_105_67_151,r_200_8_2,r_26_152_108,1.0,1,109,108,39
61,r_10_281_31,r_183_64_49,r_175_255_82,r_10_281_31,1.0,-1,30,31,39
93,r_163_183_93,seq111,seq277,r_163_183_93,0.9,1,94,93,40
36,r_70_207_115,seq277,seq55,r_70_207_115,0.93,0,115,115,40
5,r_247_80_51,r_161_204_133,seq104,r_247_80_51,0.86,0,51,51,40
19,r_101_100_16,r_247_80_51,r_36_39_120,r_101_100_16,0.89,-1,15,16,40
14,r_257_138_81,seq78,seq214,r_257_138_81,0.62,11,92,81,40
147,seq154,seq122,r_2_267_97,r_2_267_97,1.0,9,106,97,40
43,r_2_267_97,seq115,seq154,r_2_267_97,0.94,0,97,97,40
54,r_185_255_156,seq252,r_32_142_96,r_185_255_156,0.68,0,156,156,40
53,r_28_117_16,r_36_39_120,r_57_144_131,r_28_117_16,0.62,-1,15,16,40
81,r_281_76_163,seq189,r_212_196_97,r_281_76_163,0.92,0,163,163,40
59,r_275_8_197,r_145_282_155,r_285_208_43,r_145_282_155,0.94,0,155,155,40
40,r_222_127_47,r_247_80_51,seq241,r_222_127_47,1.0,0,47,47,40
29,r_49_218_51,r_79_151_175,seq239,r_49_218_51,0.83,0,51,51,40
71,r_124_30_170,r_212_196_97,seq11,r_212_196_97,0.98,0,97,97,40
86,r_98_155_140,r_250_146_152,seq244,r_98_155_140,0.97,0,140,140,40
16,r_191_52_90,seq77,seq33,r_191_52_90,1.0,0,90,90,40
21,r_192_259_132,r_6_18_33,r_177_125_106,r_192_259_132,0.97,1,133,132,40
1,r_58_21_129,seq274,r_7_106_3,r_58_21_129,0.86,0,129,129,40
97,r_93_166_142,r_79_151_175,seq132,r_79_151_175,0.76,-33,142,175,40
42,r_13_236_92,seq214,seq149,r_13_236_92,1.0,0,92,92,40
80,r_40_90_63,r_116_173_76,r_210_225_56,r_40_90_63,0.62,0,63,63,40
69,r_116_173_76,seq149,seq158,r_116_173_76,1.0,0,76,76,40
15,r_254_107_16,r_145_282_155,seq241,r_254_107_16,0.83,0,16,16,40
46,r_12_292_29,r_199_216_182,r_270_92_19,r_12_292_29,1.0,0,29,29,40
49,r_285_208_43,seq154,r_262_46_52,r_262_46_52,1.0,1,53,52,40
45,r_279_103_54,seq189,seq59,r_279_103_54,1.0,1,55,54,40
66,r_67_37_125,r_199_216_182,r_121_251_27,r_67_37_125,0.99,0,125,125,40
3,r_14_167_44,r_63_83_93,r_101_100_16,r_14_167_44,1.0,0,44,44,40
76,r_26_87_75,r_79_151_175,seq158,r_26_87_75,0.64,4,79,75,40
31,r_233_139_104,r_69_283_160,seq160,r_233_139_104,0.99,0,104,104,40
67,r_217_97_179,seq269,r_42_238_64,r_217_97_179,0.56,0,179,179,40
110,seq41,r_295_265_168,r_66_200_106,r_66_200_106,1.0,61,167,106,40
89,r_210_225_56,r_70_207_115,r_40_90_63,r_210_225_56,0.99,7,63,56,40
95,r_57_144_131,r_58_21_129,r_28_117_16,r_57_144_131,0.76,-77,54,131,40
26,r_66_200_106,seq99,seq41,r_66_200_106,1.0,0,106,106,40
72,r_109_50_91,r_2_267_97,seq114,r_2_267_97,0.71,-3,94,97,40
64,r_75_129_189,r_4_136_118,r_199_216_182,r_4_136_118,1.0,71,189,118,40
139,seq120,r_298_178_183,r_14_167_44,r_14_167_44,0.99,140,184,44,40
37,r_270_92_19,seq71,seq253,r_270_92_19,1.0,0,19,19,40
78,r_263_169_160,seq160,r_176_188_137,r_176_188_137,0.69,23,160,137,40
8,r_36_39_120,r_28_117_16,r_101_100_16,r_36_39_120,0.79,-105,15,120,40
73,r_298_178_183,seq120,r_247_80_51,r_247_80_51,0.99,133,184,51,40
11,r_94_60_106,seq5,r_36_39_120,r_94_60_106,1.0,5,111,106,40
55,r_262_46_52,r_79_151_175,r_285_208_43,r_262_46_52,1.0,1,53,52,40
107,seq24,r_56_140_116,seq165,r_56_140_116,1.0,-38,78,116,40
98,r_1_19_167,r_79_151_175,r_28_117_16,r_79_151_175,0.63,-8,167,175,40
60,r_65_133_38,r_58_21_129,seq78,r_65_133_38,1.0,0,38,38,40
57,r_32_142_96,r_56_140_116,seq246,r_56_140_116,0.5,-19,97,116,40
85,r_53_82_35,r_268_271_178,seq11,r_53_82_35,1.0,0,35,35,40
19,r_101_100_16,r_36_39_120,r_14_167_44,r_14_167_44,0.88,11,55,44,40
33,r_81_143_176,r_164_72_119,r_192_259_132,r_81_143_176,0.86,0,176,176,40
8,r_36_39_120,r_101_100_16,r_210_225_56,r_210_225_56,1.0,-1,55,56,40
161,seq189,r_281_76_163,r_81_143_176,r_281_76_163,0.92,-5,158,163,40
63,r_168_227_31,r_94_60_106,seq239,r_168_227_31,0.98,0,31,31,40
27,r_272_62_79,r_273_197_67,r_284_48_132,r_273_197_67,0.98,1,68,67,40
53,r_28_117_16,r_57_144_131,seq203,r_57_144_131,1.0,0,131,131,40
62,r_121_251_27,r_179_190_177,seq253,r_121_251_27,0.99,0,27,27,40
87,r_256_221_146,r_75_129_189,seq170,r_256_221_146,0.66,0,146,146,40
74,r_4_136_118,seq135,r_279_103_54,r_279_103_54,1.0,72,126,54,40
18,r_161_204_133,seq287,r_240_137_29,r_161_204_133,1.0,-1,132,133,40
24,r_212_196_97,r_124_30_170,seq288,r_212_196_97,1.0,0,97,97,40
25,r_268_271_178,seq74,r_194_47_94,r_268_271_178,0.7,0,178,178,40
33,r_81_143_176,r_31_150_148,r_164_72_119,r_164_72_119,1.0,33,152,119,40
64,r_75_129_189,r_256_221_146,r_4_136_118,r_256_221_146,0.82,-5,141,146,40
88,r_179_190_177,seq11,r_42_238_64,r_42_238_64,0.71,113,177,64,40
27,r_272_62_79,r_284_48_132,seq55,r_272_62_79,1.0,0,79,79,40
58,r_264_297_150,seq170,r_279_103_54,r_264_297_150,0.99,0,150,150,40
70,r_295_265_168,seq41,r_285_208_43,r_295_265_168,0.67,0,168,168,40
38,r_164_72_119,r_81_143_176,r_124_30_170,r_164_72_119,0.58,57,176,119,40
65,r_273_197_67,r_272_62_79,r_254_107_16,r_273_197_67,1.0,1,68,67,40
0,r_240_137_29,r_66_200_106,seq105,r_240_137_29,1.0,0,29,29,40
68,r_69_283_160,seq246,r_285_208_43,r_69_283_160,0.94,-1,159,160,40
61,r_34_148_118,seq170,r_247_80_51,r_34_148_118,0.94,0,118,118,40
32,r_56_140_116,seq260,r_13_236_92,r_56_140_116,0.98,1,117,116,40
28,r_294_29_54,r_250_146_152,r_293_27_5,r_294_29_54,0.88,0,54,54,40
38,r_164_72_119,seq78,r_81_143_176,r_164_72_119,0.99,0,119,119,40
52,r_145_282_155,r_275_8_197,r_42_238_64,r_145_282_155,0.73,0,155,155,40
77,r_250_146_152,seq85,r_57_144_131,r_57_144_131,0.77,24,155,131,40
92,r_123_9_38,r_162_64_184,seq102,r_123_9_38,1.0,0,38,38,40
71,r_124_30_170,seq11,r_164_72_119,r_124_30_170,0.98,1,171,170,40
8,r_36_39_120,r_210_225_56,r_94_60_106,r_36_39_120,0.57,0,120,120,40
150,seq158,seq287,r_192_259_132,r_192_259_132,1.0,-1,131,132,40
7,r_186_242_12,r_272_62_79,seq299,r_186_242_12,0.99,0,12,12,40
81,r_281_76_163,r_194_47_94,seq189,r_194_47_94,0.9,1,95,94,40
17,r_126_152_117,seq288,r_202_280_53,r_126_152_117,1.0,0,117,117,40
9,r_3_118_99,r_249_266_197,r_257_138_81,r_3_118_99,0.96,0,99,99,40
96,r_172_237_107,seq149,seq61,r_172_237_107,0.96,0,107,107,40
22,r_153_20_102,seq171,seq261,r_153_20_102,1.0,0,102,102,40
91,r_176_188_137,seq110,seq17,r_176_188_137,0.98,-1,136,137,40
56,r_31_150_148,seq239,r_192_259_132,r_192_259_132,0.8,19,151,132,40
44,r_177_125_106,r_184_278_199,r_195_205_37,r_177_125_106,1.0,-1,105,106,40
13,r_131_258_37,r_79_151_175,seq228,r_131_258_37,1.0,1,38,37,40
23,r_245_193_179,seq111,r_247_80_51,r_247_80_51,0.53,128,179,51,40
138,seq119,r_63_83_93,seq223,r_63_83_93,1.0,-24,69,93,40
189,seq269,r_217_97_179,seq71,r_217_97_179,0.73,0,179,179,40
82,r_180_16_85,r_194_47_94,seq147,r_180_16_85,1.0,0,85,85,40
35,r_15_45_155,seq44,r_180_16_85,r_180_16_85,1.0,70,155,85,40
12,r_194_47_94,r_281_76_163,seq115,r_194_47_94,0.77,1,95,94,40
95,r_57_144_131,r_28_117_16,r_250_146_152,r_57_144_131,1.0,0,131,131,40
83,r_202_280_53,r_56_140_116,seq299,r_202_280_53,0.46,0,53,53,40
51,r_195_205_37,r_289_130_193,seq158,r_195_205_37,1.0,1,38,37,40
84,r_63_83_93,seq181,seq22,r_63_83_93,1.0,1,94,93,40
103,seq11,r_179_190_177,r_53_82_35,r_53_82_35,1.0,3,38,35,40
93,r_74_16_174,seq194,r_263_217_40,r_74_16_174,0.61,0,174,174,41
26,r_156_291_27,r_272_40_48,r_176_104_78,r_176_104_78,1.0,-51,27,78,41
30,r_26_98_169,seq117,r_123_203_65,r_123_203_65,1.0,105,170,65,41
51,r_257_261_18,r_298_122_93,r_223_295_60,r_257_261_18,0.66,42,60,18,41
36,r_148_48_149,seq195,r_34_96_86,r_34_96_86,1.0,65,151,86,41
32,r_121_38_46,r_218_209_109,seq149,r_121_38_46,1.0,0,46,46,41
92,r_237_215_94,r_218_209_109,r_263_217_40,r_263_217_40,0.67,68,108,40,41
53,r_171_29_70,seq84,r_253_216_157,r_171_29_70,1.0,0,70,70,41
43,r_179_107_60,r_49_159_177,r_139_65_8,r_179_107_60,1.0,0,60,60,41
86,r_139_65_8,r_95_69_188,r_179_107_60,r_179_107_60,1.0,42,102,60,41
83,r_212_234_138,seq288,seq84,r_212_234_138,0.99,0,138,138,41
37,r_287_126_83,r_138_101_101,seq39,r_138_101_101,0.98,-26,75,101,41
59,r_246_147_163,r_155_164_163,r_273_183_82,r_155_164_163,0.54,1,164,163,41
55,r_129_243_169,r_230_185_182,r_273_183_82,r_129_243_169,0.46,0,169,169,41
71,r_235_77_162,seq22,r_62_289_123,r_62_289_123,0.96,10,133,123,41
21,r_223_295_60,seq152,r_257_261_18,r_223_295_60,0.91,5,65,60,41
97,r_284_28_135,r_212_234_138,r_276_227_41,r_284_28_135,0.88,0,135,135,41
46,r_123_203_65,seq1,seq241,r_123_203_65,1.0,1,66,65,41
42,r_118_83_83,r_229_222_147,seq167,r_118_83_83,1.0,0,83,83,41
80,r_34_96_86,seq162,seq23,r_34_96_86,1.0,0,86,86,41
69,r_49_159_177,seq20,seq2,r_49_159_177,0.66,1,178,177,41
45,r_228_18_126,seq271,seq22,r_228_18_126,0.95,1,127,126,41
16,r_226_17_42,r_148_48_149,seq152,r_226_17_42,0.87,0,42,42,41
88,r_272_40_48,seq22,seq195,r_272_40_48,1.0,0,48,48,41
193,seq271,r_228_18_126,r_21_19_34,r_228_18_126,0.88,2,128,126,41
95,r_25_75_38,r_263_217_40,r_298_122_93,r_298_122_93,0.85,-55,38,93,41
27,r_95_69_188,r_179_107_60,r_100_249_177,r_179_107_60,0.57,128,188,60,41
66,r_189_245_89,seq110,r_120_207_88,r_189_245_89,0.66,1,90,89,41
94,r_4_113_51,r_100_249_177,seq20,r_4_113_51,1.0,0,51,51,41
76,r_218_209_109,seq103,r_272_40_48,r_272_40_48,0.74,65,113,48,41
35,r_247_36_22,r_220_279_102,seq162,r_247_36_22,1.0,0,22,22,41
184,seq248,r_225_56_160,r_199_68_9,r_225_56_160,0.79,0,160,160,41
126,seq84,r_281_60_47,seq167,r_281_60_47,1.0,0,47,47,41
67,r_260_78_71,r_14_282_71,seq244,r_260_78_71,1.0,0,71,71,41
89,r_52_133_147,r_80_32_159,r_276_227_41,r_80_32_159,0.55,-2,157,159,41
90,r_233_181_10,r_80_32_159,seq149,r_233_181_10,1.0,0,10,10,41
3,r_3_128_102,r_253_216_157,seq30,r_3_128_102,1.0,0,102,102,41
10,r_242_58_180,seq23,r_255_11_46,r_255_11_46,0.98,134,180,46,41
72,r_184_161_87,r_108_292_164,seq144,r_184_161_87,0.99,0,87,87,41
4,r_80_32_159,r_52_133_147,seq259,r_80_32_159,0.61,2,161,159,41
78,r_57_137_45,r_118_83_83,r_199_68_9,r_118_83_83,1.0,-21,62,83,41
0,r_239_64_186,r_287_126_83,r_132_232_131,r_287_126_83,0.48,103,186,83,41
114,seq43,seq91,r_120_207_88,r_120_207_88,1.0,38,126,88,41
73,r_188_219_101,r_95_69_188,r_290_71_21,r_188_219_101,0.86,2,103,101,41
68,r_281_60_47,seq84,seq1,r_281_60_47,1.0,0,47,47,41
99,r_145_61_157,r_25_75_38,r_268_50_134,r_268_50_134,0.95,24,158,134,41
163,seq170,r_100_249_177,r_290_71_21,r_100_249_177,0.75,-22,155,177,41
98,r_12_294_131,r_88_186_166,r_276_227_41,r_12_294_131,0.98,0,131,131,41
15,r_265_202_72,r_145_61_157,seq143,r_265_202_72,1.0,0,72,72,41
6,r_47_192_69,r_3_128_102,seq285,r_47_192_69,1.0,0,69,69,41
62,r_62_289_123,r_44_130_145,seq84,r_62_289_123,1.0,0,123,123,41
85,r_250_214_69,r_138_101_101,r_123_203_65,r_123_203_65,1.0,7,72,65,41
99,r_145_61_157,r_265_202_72,r_25_75_38,r_145_61_157,0.99,-85,72,157,41
160,seq166,seq201,r_263_217_40,r_263_217_40,1.0,46,86,40,41
27,r_95_69_188,r_188_219_101,r_179_107_60,r_179_107_60,0.91,43,103,60,41
53,r_171_29_70,r_253_216_157,r_123_203_65,r_253_216_157,1.0,-13,144,157,41
39,r_99_275_21,r_81_299_8,r_88_186_166,r_99_275_21,1.0,2,23,21,41
12,r_127_174_20,seq86,seq7,r_127_174_20,1.0,0,20,20,41
87,r_225_56_160,seq248,r_47_192_69,r_47_192_69,0.51,91,160,69,41
54,r_21_19_34,r_123_203_65,seq288,r_123_203_65,0.93,-30,35,65,41
2,r_100_249_177,seq170,r_127_174_20,r_100_249_177,0.64,1,178,177,41
40,r_251_270_137,r_230_185_182,r_247_36_22,r_230_185_182,0.45,-45,137,182,41
74,r_120_207_88,r_95_69_188,seq43,r_120_207_88,0.99,5,93,88,41
195,seq283,seq7,r_280_153_78,r_280_153_78,1.0,2,80,78,41
57,r_256_277_56,r_179_107_60,r_293_178_1,r_293_178_1,0.68,55,56,1,41
25,r_280_153_78,r_95_69_188,seq283,r_280_153_78,1.0,0,78,78,41
13,r_263_217_40,seq2,seq166,r_263_217_40,0.94,0,40,40,41
64,r_220_279_102,seq143,r_189_245_89,r_220_279_102,0.83,2,104,102,41
50,r_72_41_156,r_88_186_166,r_155_164_163,r_72_41_156,0.71,0,156,156,41
58,r_10_92_76,r_155_164_163,seq0,r_10_92_76,1.0,0,76,76,41
70,r_173_63_15,r_79_59_195,seq45,r_173_63_15,1.0,0,15,15,41
170,seq195,r_148_48_149,r_272_40_48,r_272_40_48,1.0,10,58,48,41
61,r_108_292_164,seq85,seq177,r_108_292_164,0.63,0,164,164,41
77,r_221_206_172,r_49_159_177,r_21_19_34,r_221_206_172,0.6,0,172,172,41
196,seq285,seq22,r_47_192_69,r_47_192_69,1.0,19,88,69,41
31,r_276_227_41,r_158_224_194,r_298_122_93,r_276_227_41,0.74,6,47,41,41
60,r_165_191_70,seq134,seq259,r_165_191_70,1.0,0,70,70,41
150,seq144,r_21_19_34,r_184_161_87,r_184_161_87,1.0,1,88,87,41
81,r_124_278_84,seq42,r_255_11_46,r_124_278_84,0.93,0,84,84,41
17,r_273_183_82,r_298_122_93,r_10_92_76,r_298_122_93,0.82,-11,82,93,41
144,seq135,r_188_219_101,r_179_107_60,r_179_107_60,0.93,49,109,60,41
24,r_240_131_9,r_127_174_20,seq258,r_240_131_9,0.97,1,10,9,41
171,seq196,r_132_232_131,r_276_227_41,r_132_232_131,1.0,0,131,131,41
9,r_31_90_140,seq91,r_218_209_109,r_31_90_140,0.94,0,140,140,41
47,r_262_163_49,r_31_90_140,r_276_227_41,r_262_163_49,0.97,0,49,49,41
139,seq116,r_93_213_194,r_44_130_145,r_44_130_145,0.53,15,160,145,41
22,r_268_50_134,seq205,seq24,r_268_50_134,1.0,0,134,134,41
91,r_253_216_157,r_3_128_102,r_171_29_70,r_253_216_157,0.59,-55,102,157,41
49,r_8_211_73,seq45,seq43,r_8_211_73,1.0,0,73,73,41
91,r_253_216_157,r_171_29_70,r_5_51_124,r_253_216_157,0.99,0,157,157,41
149,seq143,r_220_279_102,r_265_202_72,r_265_202_72,0.59,29,101,72,41
56,r_182_175_80,seq67,r_4_113_51,r_182_175_80,1.0,0,80,80,41
7,r_138_101_101,r_287_126_83,seq85,r_138_101_101,0.88,2,103,101,41
71,r_235_77_162,r_62_289_123,r_260_78_71,r_235_77_162,1.0,2,164,162,41
44,r_132_232_131,seq196,seq2,r_132_232_131,1.0,0,131,131,41
82,r_44_130_145,r_57_137_45,seq116,r_44_130_145,0.38,1,146,145,41
11,r_255_11_46,seq283,r_290_71_21,r_255_11_46,0.98,0,46,46,41
79,r_87_286_160,r_176_104_78,r_155_164_163,r_87_286_160,0.51,1,161,160,41
65,r_168_97_39,r_228_18_126,r_156_291_27,r_168_97_39,1.0,0,39,39,41
182,seq241,r_237_215_94,r_123_203_65,r_123_203_65,1.0,3,68,65,41
84,r_229_222_147,r_225_56_160,seq9,r_225_56_160,0.91,-13,147,160,41
93,r_185_264_184,r_241_208_5,r_32_165_67,r_185_264_184,0.48,0,184,184,42
73,r_207_26_12,r_214_216_155,seq48,r_207_26_12,1.0,0,12,12,42
51,r_238_55_151,r_28_290_175,seq198,r_238_55_151,0.61,0,151,151,42
36,r_228_186_98,r_102_128_89,r_261_120_52,r_261_120_52,0.7,50,102,52,42
92,r_190_258_71,seq131,seq197,r_190_258_71,1.0,1,72,71,42
14,r_240_202_154,seq87,seq14,r_240_202_154,0.65,0,154,154,42
6,r_108_17_64,r_214_216_155,r_191_30_96,r_108_17_64,0.69,54,118,64,42
8,r_79_36_140,seq160,r_51_268_56,r_79_36_140,0.96,0,140,140,42
46,r_41_251_15,r_32_165_67,r_126_86_42,r_41_251_15,0.66,0,15,15,42
83,r_217_292_93,seq215,seq23,r_217_292_93,0.97,3,96,93,42
42,r_261_120_52,seq175,r_188_196_142,r_261_120_52,1.0,0,52,52,42
118,seq48,r_45_220_116,r_207_26_12,r_207_26_12,0.94,0,12,12,42
71,r_188_196_142,r_110_148_115,r_228_186_98,r_188_196_142,0.7,-26,116,142,42
86,r_199_155_86,r_227_73_143,r_125_204_49,r_199_155_86,1.0,0,86,86,42
39,r_134_18_184,seq115,r_118_295_32,r_118_295_32,0.97,154,186,32,42
1,r_291_76_72,seq154,r_32_165_67,r_291_76_72,0.7,0,72,72,42
97,r_262_276_86,seq14,seq100,r_262_276_86,1.0,0,86,86,42
5,r_213_233_98,r_248_98_198,seq22,r_213_233_98,1.0,0,98,98,42
111,seq37,seq42,r_139_121_49,r_139_121_49,1.0,41,90,49,42
80,r_56_127_109,seq273,r_125_204_49,r_56_127_109,1.0,1,110,109,42
69,r_25_286_189,seq6,r_0_133_22,r_0_133_22,0.98,167,189,22,42
45,r_149_138_126,seq94,r_78_247_83,r_149_138_126,0.99,0,126,126,42
7,r_125_204_49,r_108_17_64,r_41_251_15,r_125_204_49,1.0,0,49,49,42
19,r_5_71_171,r_116_222_188,r_240_202_154,r_116_222_188,0.63,-16,172,188,42
9,r_7_2_40,r_183_178_188,seq96,r_7_2_40,1.0,0,40,40,42
27,r_13_123_27,seq40,r_4_10_116,r_13_123_27,1.0,0,27,27,42
27,r_13_123_27,r_4_10_116,r_243_285_83,r_13_123_27,0.63,89,116,27,42
95,r_70_266_94,r_20_106_147,seq237,r_70_266_94,1.0,1,95,94,42
66,r_49_288_61,r_119_112_67,seq115,r_49_288_61,0.99,0,61,61,42
35,r_0_133_22,r_25_286_189,seq221,r_0_133_22,0.87,0,22,22,42
100,seq6,r_25_286_189,r_243_285_83,r_243_285_83,0.97,106,189,83,42
67,r_54_156_120,seq52,r_143_269_64,r_54_156_120,0.49,0,120,120,42
89,r_275_124_73,r_99_105_130,seq52,r_275_124_73,1.0,0,73,73,42
43,r_194_205_15,r_214_216_155,r_59_64_16,r_194_205_15,0.69,1,16,15,42
3,r_101_278_182,r_183_178_188,r_166_84_13,r_101_278_182,0.65,0,182,182,42
90,r_34_189_126,seq255,r_243_285_83,r_34_189_126,0.99,0,126,126,42
94,r_99_105_130,r_32_165_67,r_139_121_49,r_99_105_130,1.0,0,130,130,42
32,r_139_121_49,seq40,seq37,r_139_121_49,0.91,0,49,49,42
26,r_117_219_82,seq234,r_59_64_16,r_117_219_82,1.0,0,82,82,42
180,seq239,r_167_299_152,r_209_256_121,r_209_256_121,0.98,32,153,121,42
78,r_153_279_135,seq14,r_108_17_64,r_108_17_64,0.99,75,139,64,42
0,r_32_165_67,seq201,r_91_169_36,r_32_165_67,1.0,2,69,67,42
63,r_143_269_64,r_183_178_188,r_241_208_5,r_143_269_64,0.96,5,69,64,42
11,r_243_285_83,seq234,r_13_123_27,r_13_123_27,0.92,59,86,27,42
107,seq23,r_24_107_179,r_240_202_154,r_240_202_154,0.98,25,179,154,42
15,r_214_216_155,seq172,r_53_170_154,r_53_170_154,0.75,4,158,154,42
181,seq245,r_116_222_188,r_137_104_34,r_116_222_188,0.58,0,188,188,42
187,seq259,seq12,r_229_83_133,r_229_83_133,0.95,0,133,133,42
6,r_108_17_64,r_136_284_183,r_214_216_155,r_108_17_64,1.0,2,66,64,42
23,r_59_64_16,r_78_247_83,r_194_205_15,r_59_64_16,0.72,0,16,16,42
57,r_267_122_12,seq160,r_103_265_155,r_103_265_155,0.99,2,157,155,42
197,seq294,r_119_112_67,r_244_177_47,r_119_112_67,0.93,-16,51,67,42
141,seq111,seq287,r_199_155_86,r_199_155_86,1.0,42,128,86,42
10,r_3_97_33,r_191_30_96,r_114_212_28,r_3_97_33,1.0,0,33,33,42
99,r_168_162_108,seq37,seq211,r_168_162_108,1.0,0,108,108,42
4,r_137_104_34,r_108_17_64,r_3_97_33,r_137_104_34,1.0,0,34,34,42
134,seq89,r_16_31_197,r_207_26_12,r_207_26_12,0.76,165,177,12,42
21,r_166_84_13,r_282_44_47,seq29,r_282_44_47,1.0,-33,14,47,42
71,r_188_196_142,r_228_186_98,seq154,r_188_196_142,0.99,1,143,142,42
87,r_113_230_168,seq95,r_32_165_67,r_113_230_168,0.6,0,168,168,42
72,r_171_1_42,r_214_216_155,r_41_251_15,r_171_1_42,1.0,0,42,42,42
38,r_193_283_56,r_250_72_121,seq77,r_193_283_56,1.0,0,56,56,42
2,r_183_178_188,r_101_278_182,r_119_112_67,r_119_112_67,1.0,120,187,67,42
142,seq115,r_134_18_184,r_49_288_61,r_49_288_61,1.0,123,184,61,42
177,seq234,r_90_225_152,r_199_155_86,r_90_225_152,0.9,-25,127,152,42
40,r_119_112_67,seq175,seq277,r_119_112_67,1.0,0,67,67,42
18,r_78_247_83,r_238_55_151,seq6,r_78_247_83,1.0,0,83,83,42
29,r_191_30_96,r_274_157_191,r_108_17_64,r_191_30_96,1.0,0,96,96,42
24,r_272_144_164,seq239,seq175,r_272_144_164,0.92,0,164,164,42
177,seq234,r_243_285_83,r_90_225_152,r_243_285_83,0.67,3,86,83,42
16,r_270_195_37,seq77,seq50,r_270_195_37,1.0,0,37,37,42
25,r_53_170_154,seq9,r_102_128_89,r_53_170_154,0.93,0,154,154,42
33,r_250_72_121,r_19_181_163,r_168_162_108,r_250_72_121,0.79,0,121,121,42
64,r_209_256_121,seq61,seq239,r_209_256_121,1.0,0,121,121,42
91,r_180_140_55,r_217_292_93,seq80,r_180_140_55,1.0,0,55,55,42
82,r_90_225_152,seq234,r_143_269_64,r_90_225_152,0.99,0,152,152,42
50,r_20_106_147,seq15,r_193_283_56,r_193_283_56,1.0,98,154,56,42
58,r_57_21_158,r_183_178_188,r_125_204_49,r_125_204_49,0.69,109,158,49,42
70,r_28_290_175,r_238_55_151,r_188_196_142,r_28_290_175,0.66,-24,151,175,42
56,r_102_128_89,r_59_64_16,r_53_170_154,r_53_170_154,1.0,0,154,154,42
20,r_4_10_116,r_13_123_27,r_248_98_198,r_4_10_116,1.0,0,116,116,42
68,r_110_148_115,r_188_196_142,r_118_295_32,r_188_196_142,0.92,-26,116,142,42
42,r_261_120_52,r_188_196_142,r_228_186_98,r_261_120_52,0.77,91,143,52,42
137,seq94,r_149_138_126,r_232_47_140,r_149_138_126,1.0,0,126,126,42
61,r_227_73_143,r_272_144_164,r_282_44_47,r_227_73_143,0.96,0,143,143,42
77,r_58_252_55,r_108_17_64,seq197,r_58_252_55,1.0,0,55,55,42
119,seq50,r_54_156_120,r_270_195_37,r_270_195_37,1.0,1,38,37,42
70,r_28_290_175,r_188_196_142,r_240_202_154,r_28_290_175,0.97,0,175,175,42
20,r_4_10_116,r_25_286_189,r_13_123_27,r_13_123_27,1.0,0,27,27,42
85,r_244_177_47,r_108_17_64,seq294,r_108_17_64,0.98,-12,52,64,42
57,r_267_122_12,seq154,seq160,r_267_122_12,0.82,79,91,12,42
34,r_19_181_163,r_260_11_135,seq23,r_19_181_163,0.82,0,163,163,42
75,r_241_208_5,r_185_264_184,r_27_200_140,r_27_200_140,0.98,44,184,140,42
60,r_103_265_155,r_134_18_184,r_267_122_12,r_103_265_155,0.76,0,155,155,42
81,r_116_222_188,seq245,r_183_178_188,r_116_222_188,0.6,0,188,188,42
84,r_91_169_36,r_214_216_155,seq62,r_91_169_36,0.94,0,36,36,42
17,r_27_200_140,r_103_265_155,seq29,r_27_200_140,0.97,1,141,140,42
94,r_99_105_130,r_275_124_73,r_32_165_67,r_99_105_130,0.99,-57,73,130,42
62,r_75_298_48,seq43,seq42,r_75_298_48,0.95,0,48,48,42
96,r_45_220_116,seq48,r_51_268_56,r_45_220_116,1.0,0,116,116,42
120,seq52,r_54_156_120,r_270_195_37,r_270_195_37,1.0,58,95,37,42
55,r_114_212_28,r_272_144_164,r_137_104_34,r_114_212_28,1.0,0,28,28,42
133,seq87,r_240_202_154,r_75_298_48,r_75_298_48,0.72,106,154,48,42
22,r_242_249_157,r_5_71_171,seq50,r_5_71_171,0.9,-8,163,171,42
28,r_235_147_147,seq172,r_291_76_72,r_291_76_72,0.85,79,151,72,42
49,r_167_299_152,seq239,seq201,r_167_299_152,0.72,1,153,152,42
74,r_51_268_56,r_229_83_133,seq95,r_51_268_56,1.0,3,59,56,42
56,r_102_128_89,r_228_186_98,r_59_64_16,r_102_128_89,0.76,13,102,89,42
31,r_118_295_32,r_24_107_179,seq297,r_118_295_32,0.95,1,33,32,42
37,r_226_159_13,r_158_109_139,seq96,r_226_159_13,0.9,0,13,13,42
82,r_90_225_152,r_250_72_121,seq234,r_250_72_121,0.98,-46,75,121,42
57,r_267_122_12,r_282_44_47,seq154,r_267_122_12,0.81,0,12,12,42
50,r_41_25_45,seq262,seq251,r_41_25_45,1.0,0,45,45,43
36,r_213_155_147,seq122,r_85_44_40,r_213_155_147,0.66,0,147,147,43
92,r_29_78_127,r_35_242_132,seq172,r_29_78_127,0.96,0,127,127,43
14,r_235_151_183,seq261,r_167_158_181,r_235_151_183,0.69,1,184,183,43
8,r_275_19_186,seq68,r_200_15_82,r_200_15_82,1.0,104,186,82,43
49,r_99_0_57,seq249,seq4,r_99_0_57,1.0,1,58,57,43
53,r_227_202_148,seq135,r_80_181_136,r_227_202_148,0.54,0,148,148,43
43,r_293_34_182,r_298_119_146,r_207_65_101,r_293_34_182,0.88,-36,146,182,43
57,r_80_181_136,r_24_86_174,r_227_202_148,r_24_86_174,1.0,1,175,174,43
54,r_89_162_114,r_76_254_97,r_191_5_32,r_89_162_114,0.97,0,114,114,43
83,r_178_220_137,r_49_288_137,r_32_90_23,r_178_220_137,0.83,0,137,137,43
37,r_209_276_154,seq4,r_258_152_100,r_209_276_154,0.52,0,154,154,43
3,r_191_5_32,seq249,r_89_162_114,r_89_162_114,1.0,1,115,114,43
59,r_70_237_170,seq252,seq262,r_70_237_170,0.42,2,172,170,43
71,r_177_190_151,r_43_264_187,seq160,r_177_190_151,0.9,1,152,151,43
86,r_82_204_138,seq240,r_29_78_127,r_29_78_127,0.95,11,138,127,43
21,r_210_176_144,seq108,r_111_239_88,r_210_176_144,0.99,0,144,144,43
39,r_22_54_173,seq102,r_294_31_29,r_294_31_29,0.64,145,174,29,43
25,r_85_44_40,r_127_244_163,r_62_71_36,r_85_44_40,1.0,0,40,40,43
1,r_257_57_178,seq116,seq184,r_257_57_178,0.42,1,179,178,43
143,seq137,r_16_223_192,r_275_19_186,r_275_19_186,0.87,3,189,186,43
127,seq107,seq126,r_2_94_42,r_2_94_42,1.0,4,46,42,43
111,seq50,r_127_244_163,r_185_212_2,r_127_244_163,0.74,-19,144,163,43
3,r_191_5_32,r_217_144_138,seq249,r_191_5_32,0.87,2,34,32,43
20,r_42_193_53,r_187_274_183,seq248,r_42_193_53,1.0,0,53,53,43
19,r_93_182_82,r_55_8_112,seq252,r_93_182_82,1.0,0,82,82,43
32,r_218_273_35,r_217_144_138,r_168_165_196,r_218_273_35,0.84,0,35,35,43
62,r_149_18_52,r_217_144_138,seq205,r_149_18_52,1.0,0,52,52,43
38,r_192_45_171,r_59_246_180,r_83_84_12,r_192_45_171,1.0,1,172,171,43
41,r_241_161_66,r_187_274_183,seq108,r_241_161_66,0.69,0,66,66,43
67,r_37_238_164,seq183,r_131_109_70,r_37_238_164,0.68,0,164,164,43
90,r_12_66_124,seq108,r_121_247_107,r_12_66_124,1.0,0,124,124,43
49,r_99_0_57,seq4,r_103_11_93,r_103_11_93,1.0,2,95,93,43
26,r_43_264_187,seq179,r_191_5_32,r_191_5_32,0.97,155,187,32,43
72,r_112_118_79,r_49_288_137,seq21,r_112_118_79,0.99,2,81,79,43
27,r_87_14_52,r_42_193_53,seq92,r_42_193_53,1.0,-1,52,53,43
47,r_104_72_58,r_275_19_186,seq110,r_104_72_58,1.0,0,58,58,43
4,r_76_254_97,r_197_20_195,r_149_18_52,r_149_18_52,1.0,10,62,52,43
64,r_81_64_158,r_147_120_36,seq114,r_147_120_36,1.0,1,37,36,43
63,r_139_157_117,seq69,seq122,r_139_157_117,0.99,0,117,117,43
114,seq68,r_275_19_186,r_227_202_148,r_275_19_186,0.31,0,186,186,43
73,r_159_163_165,seq269,r_103_11_93,r_103_11_93,0.6,73,166,93,43
11,r_130_253_95,seq205,r_166_148_24,r_130_253_95,1.0,0,95,95,43
15,r_200_15_82,seq97,r_83_84_12,r_200_15_82,1.0,0,82,82,43
76,r_224_101_15,r_235_151_183,seq88,r_224_101_15,0.97,0,15,15,43
57,r_80_181_136,seq122,r_24_86_174,r_80_181_136,0.91,0,136,136,43
56,r_266_1_37,r_235_151_183,seq229,r_266_1_37,1.0,0,37,37,43
33,r_147_120_36,r_81_64_158,r_62_71_36,r_147_120_36,1.0,1,37,36,43
85,r_143_236_81,seq36,r_216_219_3,r_143_236_81,0.94,3,84,81,43
99,r_124_13_112,r_100_296_171,seq47,r_124_13_112,0.93,0,112,112,43
35,r_73_286_49,r_241_161_66,r_292_231_33,r_73_286_49,0.65,0,49,49,43
31,r_32_90_23,r_127_244_163,seq114,r_32_90_23,0.82,0,23,23,43
69,r_24_86_174,r_275_19_186,r_104_72_58,r_24_86_174,0.43,1,175,174,43
2,r_100_296_171,seq114,r_121_247_107,r_100_296_171,0.33,1,172,171,43
172,seq229,r_82_204_138,r_266_1_37,r_266_1_37,1.0,5,42,37,43
51,r_27_138_34,r_12_66_124,seq38,r_12_66_124,0.89,-90,34,124,43
18,r_167_158_181,seq221,r_293_34_182,r_293_34_182,0.51,-1,181,182,43
24,r_280_46_72,r_235_151_183,seq172,r_280_46_72,1.0,0,72,72,43
175,seq240,r_82_204_138,r_283_295_28,r_283_295_28,1.0,27,55,28,43
69,r_24_86_174,r_62_71_36,r_275_19_186,r_62_71_36,1.0,1,37,36,43
78,r_292_231_33,r_207_65_101,seq221,r_292_231_33,1.0,0,33,33,43
70,r_268_174_67,r_35_242_132,r_136_67_56,r_35_242_132,0.8,-62,70,132,43
91,r_60_98_38,seq92,seq28,r_60_98_38,0.91,4,42,38,43
68,r_187_274_183,seq38,r_153_23_146,r_153_23_146,0.73,37,183,146,43
61,r_55_8_112,seq28,seq39,r_55_8_112,1.0,0,112,112,43
38,r_192_45_171,r_154_198_106,r_59_246_180,r_154_198_106,0.86,0,106,106,43
52,r_234_291_140,seq215,seq91,r_234_291_140,1.0,0,140,140,43
77,r_2_94_42,r_103_11_93,seq107,r_2_94_42,1.0,0,42,42,43
154,seq183,r_37_238_164,r_128_40_156,r_37_238_164,0.56,0,164,164,43
75,r_49_288_137,seq135,r_85_44_40,r_49_288_137,0.77,0,137,137,43
124,seq97,r_200_15_82,seq39,r_200_15_82,1.0,-2,80,82,43
48,r_136_67_56,seq58,seq262,r_136_67_56,1.0,0,56,56,43
81,r_154_198_106,r_192_45_171,seq249,r_154_198_106,0.73,0,106,106,43
17,r_201_3_117,seq289,seq171,r_201_3_117,0.98,3,120,117,43
16,r_83_84_12,r_166_148_24,seq137,r_83_84_12,0.99,-1,11,12,43
97,r_170_180_20,r_191_5_32,seq135,r_170_180_20,1.0,0,20,20,43
28,r_169_61_115,seq117,seq30,r_169_61_115,0.83,1,116,115,43
55,r_203_281_29,seq88,seq69,r_203_281_29,0.91,0,29,29,43
7,r_127_244_163,seq50,seq171,r_127_244_163,0.75,0,163,163,43
23,r_153_23_146,r_257_57_178,seq122,r_153_23_146,0.95,0,146,146,43
108,seq38,r_187_274_183,r_284_63_129,r_187_274_183,0.48,0,183,183,43
82,r_298_119_146,r_293_34_182,r_121_247_107,r_298_119_146,0.96,0,146,146,43
79,r_207_65_101,seq160,seq150,r_207_65_101,0.78,0,101,101,43
89,r_26_48_97,r_168_165_196,r_217_144_138,r_217_144_138,1.0,2,140,138,43
42,r_62_71_36,r_24_86_174,seq123,r_62_71_36,1.0,1,37,36,43
84,r_105_256_173,seq96,r_217_144_138,r_105_256_173,0.5,2,175,173,43
28,r_192_132_43,r_293_54_190,seq29,r_192_132_43,0.99,0,43,43,44
4,r_79_127_10,seq8,seq81,r_79_127_10,0.96,3,13,10,44
36,r_172_19_169,seq90,r_275_205_61,r_275_205_61,1.0,113,174,61,44
83,r_13_166_103,seq122,seq114,r_13_166_103,0.56,0,103,103,44
81,r_83_269_83,r_136_142_144,r_289_74_147,r_83_269_83,1.0,64,147,83,44
37,r_230_65_171,seq100,r_11_98_47,r_11_98_47,0.93,124,171,47,44
80,r_11_98_47,r_128_4_80,seq0,r_11_98_47,1.0,1,48,47,44
55,r_124_185_118,seq171,r_180_143_33,r_124_185_118,0.98,0,118,118,44
71,r_174_234_122,r_202_141_194,seq2,r_174_234_122,0.95,0,122,122,44
86,r_254_49_171,seq233,seq246,r_254_49_171,0.69,0,171,171,44
16,r_253_76_153,seq154,seq193,r_253_76_153,0.8,0,153,153,44
21,r_7_144_112,r_125_73_134,seq193,r_7_144_112,1.0,-1,111,112,44
39,r_247_245_78,r_112_156_187,seq62,r_247_245_78,1.0,0,78,78,44
165,seq193,r_93_231_87,r_133_1_167,r_93_231_87,1.0,-1,86,87,44
97,r_6_239_183,seq0,r_67_206_147,r_6_239_183,0.31,0,183,183,44
187,seq256,r_180_143_33,r_297_117_176,r_297_117_176,0.47,5,181,176,44
5,r_289_74_147,seq209,r_83_269_83,r_289_74_147,0.87,0,147,147,44
46,r_34_77_74,r_64_21_150,r_86_118_159,r_34_77_74,0.62,4,78,74,44
42,r_86_118_159,r_17_201_118,r_34_77_74,r_86_118_159,0.37,-51,108,159,44
89,r_248_167_80,r_277_162_126,r_28_215_4,r_28_215_4,0.78,10,14,4,44
69,r_42_96_128,r_273_99_181,seq129,r_42_96_128,0.6,0,128,128,44
45,r_270_27_153,r_5_106_195,seq8,r_270_27_153,0.85,0,153,153,44
42,r_86_118_159,r_34_77_74,seq14,r_86_118_159,1.0,1,160,159,44
89,r_248_167_80,r_28_215_4,seq81,r_248_167_80,0.9,0,80,80,44
51,r_40_232_36,r_5_106_195,seq110,r_40_232_36,0.99,0,36,36,44
95,r_23_22_133,seq94,seq51,r_23_22_133,0.73,0,133,133,44
66,r_91_163_116,r_64_21_150,r_192_132_43,r_91_163_116,0.93,0,116,116,44
76,r_70_221_67,seq59,seq179,r_70_221_67,1.0,0,67,67,44
100,seq0,r_6_239_183,r_11_98_47,r_11_98_47,1.0,28,75,47,44
63,r_273_99_181,r_46_25_71,r_275_205_61,r_273_99_181,0.71,0,181,181,44
31,r_296_103_155,r_35_260_175,r_187_170_23,r_187_170_23,0.48,132,155,23,44
67,r_136_142_144,r_112_156_187,seq212,r_136_142_144,0.7,0,144,144,44
10,r_112_156_187,r_136_142_144,r_83_269_83,r_112_156_187,0.55,-43,144,187,44
90,r_152_108_165,seq295,r_247_245_78,r_152_108_165,0.7,0,165,165,44
10,r_112_156_187,r_83_269_83,r_135_31_56,r_112_156_187,0.99,0,187,187,44
8,r_187_170_23,r_67_206_147,r_181_285_111,r_187_170_23,1.0,0,23,23,44
113,seq50,seq87,r_271_75_33,r_271_75_33,1.0,42,75,33,44
72,r_259_264_84,r_20_276_167,seq220,r_259_264_84,1.0,0,84,84,44
0,r_67_206_147,seq78,seq246,r_67_206_147,0.74,0,147,147,44
63,r_273_99_181,r_42_96_128,r_46_25_71,r_46_25_71,1.0,57,128,71,44
11,r_123_61_94,seq92,seq85,r_123_61_94,1.0,0,94,94,44
148,seq140,seq246,r_68_69_51,r_68_69_51,1.0,3,54,51,44
26,r_68_69_51,r_297_117_176,seq140,r_68_69_51,1.0,0,51,51,44
20,r_195_267_81,r_235_18_198,seq171,r_195_267_81,1.0,-1,80,81,44
13,r_35_260_175,r_296_103_155,r_268_175_41,r_268_175_41,1.0,114,155,41,44
46,r_34_77_74,r_86_118_159,r_79_127_10,r_86_118_159,1.0,-7,152,159,44
15,r_277_162_126,seq298,seq107,r_277_162_126,0.96,0,126,126,44
48,r_84_113_164,r_153_188_166,r_197_102_58,r_84_113_164,0.9,0,164,164,44
57,r_93_231_87,seq193,seq107,r_93_231_87,1.0,-1,86,87,44
62,r_161_224_112,seq241,r_248_167_80,r_161_224_112,0.9,0,112,112,44
74,r_28_215_4,r_248_167_80,seq252,r_248_167_80,1.0,0,80,80,44
85,r_288_66_72,r_297_117_176,r_41_101_32,r_288_66_72,1.0,0,72,72,44
99,r_198_226_70,r_230_65_171,r_268_175_41,r_198_226_70,0.99,-1,69,70,44
27,r_36_281_152,r_297_117_176,seq173,r_36_281_152,0.72,1,153,152,44
87,r_5_106_195,r_35_260_175,r_9_238_41,r_9_238_41,0.61,34,75,41,44
82,r_45_158_23,r_253_76_153,seq298,r_45_158_23,1.0,0,23,23,44
178,seq233,r_254_49_171,r_176_55_110,r_176_55_110,0.9,61,171,110,44
41,r_191_16_52,r_287_12_153,seq94,r_191_16_52,1.0,0,52,52,44
68,r_279_299_41,r_297_117_176,seq171,r_279_299_41,1.0,0,41,41,44
22,r_271_75_33,r_277_162_126,seq50,r_271_75_33,0.99,0,33,33,44
2,r_53_119_179,r_249_116_5,r_128_4_80,r_249_116_5,0.46,175,180,5,44
54,r_223_150_7,r_219_227_111,seq208,r_223_150_7,0.54,4,11,7,44
40,r_287_12_153,seq138,seq104,r_287_12_153,0.76,0,153,153,44
58,r_261_126_28,r_297_117_176,seq97,r_261_126_28,1.0,0,28,28,44
18,r_82_88_118,seq107,seq250,r_82_88_118,0.98,0,118,118,44
29,r_46_25_71,r_235_18_198,r_273_99_181,r_46_25_71,1.0,0,71,71,44
25,r_164_134_181,r_43_60_190,r_40_232_36,r_43_60_190,0.4,-9,181,190,44
33,r_204_10_143,r_36_281_152,seq121,r_204_10_143,0.87,0,143,143,44
32,r_135_31_56,r_297_117_176,seq122,r_135_31_56,1.0,1,57,56,44
50,r_56_165_81,r_169_211_182,seq111,r_56_165_81,0.98,0,81,81,44
70,r_219_227_111,r_235_18_198,r_79_127_10,r_219_227_111,0.99,0,111,111,44
91,r_44_149_39,r_67_206_147,r_268_175_41,r_44_149_39,1.0,2,41,39,44
137,seq111,r_235_18_198,r_176_55_110,r_176_55_110,1.0,41,151,110,44
14,r_30_263_9,r_297_117_176,seq242,r_30_263_9,0.73,1,10,9,44
38,r_176_55_110,r_147_257_165,r_56_165_81,r_176_55_110,0.99,0,110,110,44
52,r_196_168_66,r_176_55_110,seq216,r_196_168_66,0.97,1,67,66,44
77,r_160_184_144,r_84_113_164,r_70_221_67,r_160_184_144,0.86,0,144,144,44
34,r_125_73_134,r_84_113_164,seq59,r_125_73_134,0.76,0,134,134,44
6,r_180_143_33,r_292_47_94,seq24,r_180_143_33,0.73,0,33,33,44
81,r_83_269_83,r_176_55_110,r_136_142_144,r_83_269_83,0.76,0,83,83,44
43,r_225_218_50,r_86_118_159,seq177,r_225_218_50,1.0,0,50,50,44
171,seq209,r_289_74_147,r_176_55_110,r_176_55_110,0.61,37,147,110,44
13,r_35_260_175,r_268_175_41,r_13_166_103,r_35_260_175,0.97,1,176,175,44
29,r_46_25_71,r_273_99_181,r_194_282_105,r_194_282_105,0.9,85,190,105,44
152,seq155,r_35_260_175,r_268_175_41,r_268_175_41,0.76,34,75,41,44
44,r_210_265_94,seq177,r_56_165_81,r_210_265_94,1.0,0,94,94,44
118,seq71,r_255_278_167,r_191_16_52,r_191_16_52,0.91,116,168,52,44
131,seq100,r_230_65_171,seq139,r_230_65_171,1.0,0,171,171,44
94,r_197_102_58,r_93_231_87,seq130,r_197_102_58,0.99,0,58,58,44
23,r_292_47_94,seq220,seq159,r_292_47_94,1.0,0,94,94,44
175,seq217,r_43_60_190,r_123_61_94,r_123_61_94,1.0,96,190,94,44
7,r_41_101_32,r_128_4_80,seq8,r_41_101_32,1.0,0,32,32,44
159,seq179,seq14,r_70_221_67,r_70_221_67,1.0,22,89,67,44
35,r_194_282_105,seq216,r_131_63_12,r_194_282_105,1.0,0,105,105,44
12,r_275_205_61,seq256,seq78,r_275_205_61,1.0,0,61,61,44
93,r_104_214_112,seq275,seq250,r_104_214_112,1.0,0,112,112,45
30,r_52_98_70,r_239_146_126,seq171,r_52_98_70,1.0,0,70,70,45
51,r_70_62_174,r_71_288_193,r_176_124_173,r_176_124_173,0.95,5,178,173,45
36,r_21_78_162,seq66,r_138_255_111,r_21_78_162,0.62,3,165,162,45
14,r_65_284_117,r_281_278_151,r_93_247_41,r_65_284_117,0.59,0,117,117,45
8,r_16_33_127,r_44_157_164,r_119_293_125,r_16_33_127,0.64,0,127,127,45
43,r_101_57_4,seq173,r_104_214_112,r_104_214_112,1.0,45,157,112,45
146,seq151,r_50_192_187,r_108_280_146,r_108_280_146,0.99,26,172,146,45
122,seq73,r_210_37_38,r_128_59_154,r_210_37_38,0.99,0,38,38,45
54,r_119_293_125,seq24,r_112_23_20,r_119_293_125,0.8,0,125,125,45
83,r_145_47_160,seq170,r_186_198_159,r_145_47_160,0.78,0,160,160,45
37,r_165_253_73,seq256,r_168_220_139,r_165_253_73,0.78,2,75,73,45
59,r_200_185_76,r_208_13_154,seq27,r_200_185_76,1.0,0,76,76,45
94,r_161_103_28,r_51_205_95,seq15,r_161_103_28,0.59,1,29,28,45
50,r_209_251_39,r_69_43_155,seq152,r_209_251_39,1.0,1,40,39,45
55,r_228_277_71,r_50_192_187,r_233_156_66,r_228_277_71,0.83,-9,62,71,45
71,r_83_72_109,seq275,r_209_251_39,r_209_251_39,0.57,70,109,39,45
86,r_102_143_73,r_178_276_112,seq212,r_102_143_73,1.0,0,73,73,45
64,r_93_247_41,seq86,r_68_287_18,r_93_247_41,0.85,1,42,41,45
16,r_69_43_155,r_282_172_132,r_11_189_98,r_11_189_98,1.0,35,133,98,45
21,r_128_59_154,seq164,r_76_97_77,r_128_59_154,0.59,1,155,154,45
39,r_279_190_76,r_11_189_98,seq173,r_279_190_76,0.98,0,76,76,45
1,r_137_107_130,seq27,seq231,r_137_107_130,0.91,5,135,130,45
97,r_46_20_100,seq86,seq17,r_46_20_100,0.99,1,101,100,45
4,r_129_10_39,r_241_153_54,seq226,r_129_10_39,1.0,1,40,39,45
46,r_76_97_77,seq115,seq6,r_76_97_77,0.96,1,78,77,45
84,r_265_215_16,r_58_41_174,seq85,r_265_215_16,1.0,2,18,16,45
80,r_295_271_88,r_208_13_154,seq286,r_295_271_88,1.0,0,88,88,45
5,r_235_111_40,r_11_189_98,seq115,r_11_189_98,0.93,-55,43,98,45
69,r_298_238_131,seq117,r_26_74_30,r_26_74_30,0.95,101,131,30,45
45,r_51_205_95,seq199,r_106_35_83,r_51_205_95,0.94,3,98,95,45
153,seq167,r_207_110_98,seq158,r_207_110_98,1.0,0,98,98,45
135,seq117,seq218,r_210_37_38,r_210_37_38,1.0,10,48,38,45
65,r_241_153_54,r_129_10_39,r_68_287_18,r_129_10_39,0.51,1,40,39,45
95,r_180_9_103,seq193,r_264_64_35,r_180_9_103,0.91,0,103,103,45
66,r_4_131_130,seq48,r_26_74_30,r_4_131_130,0.6,1,131,130,45
76,r_282_172_132,r_168_220_139,seq151,r_282_172_132,0.91,1,133,132,45
73,r_244_67_56,r_128_59_154,seq81,r_244_67_56,1.0,0,56,56,45
31,r_223_285_79,r_65_284_117,r_165_253_73,r_223_285_79,0.96,0,79,79,45
41,r_106_35_83,seq45,r_264_64_35,r_106_35_83,1.0,1,84,83,45
89,r_44_157_164,seq80,r_106_35_83,r_106_35_83,0.99,82,165,83,45
53,r_29_39_48,r_116_257_187,seq158,r_29_39_48,1.0,1,49,48,45
90,r_281_278_151,r_65_284_117,seq221,r_65_284_117,0.76,0,117,117,45
115,seq48,r_144_246_61,seq85,r_144_246_61,1.0,1,62,61,45
26,r_217_87_93,r_188_187_187,seq171,r_217_87_93,0.99,1,94,93,45
63,r_118_34_138,seq195,r_209_251_39,r_209_251_39,0.95,101,140,39,45
11,r_296_0_176,seq258,r_159_12_110,r_296_0_176,0.62,0,176,176,45
13,r_213_203_178,seq299,r_229_181_159,r_213_203_178,0.71,0,178,178,45
98,r_122_130_104,r_241_153_54,r_116_257_187,r_122_130_104,1.0,2,106,104,45
44,r_289_182_12,r_119_293_125,seq36,r_289_182_12,0.85,0,12,12,45
48,r_268_77_97,r_188_187_187,r_102_143_73,r_188_187_187,1.0,-90,97,187,45
57,r_236_84_95,r_44_157_164,seq31,r_236_84_95,0.89,0,95,95,45
10,r_175_92_21,seq231,seq275,r_175_92_21,0.46,13,34,21,45
62,r_108_280_146,r_21_78_162,seq151,r_108_280_146,0.98,1,147,146,45
85,r_272_254_153,seq242,seq88,r_272_254_153,0.78,0,153,153,45
61,r_168_220_139,r_60_294_55,r_282_172_132,r_60_294_55,0.88,3,58,55,45
160,seq193,r_96_259_129,seq80,r_96_259_129,1.0,-2,127,129,45
161,seq194,r_237_147_192,r_159_12_110,r_159_12_110,0.98,1,111,110,45
122,seq73,r_128_59_154,r_270_90_111,r_270_90_111,1.0,10,121,111,45
0,r_68_287_18,r_201_22_135,r_241_153_54,r_68_287_18,0.98,0,18,18,45
87,r_120_140_130,seq245,r_70_62_174,r_120_140_130,0.85,3,133,130,45
37,r_165_253_73,r_168_220_139,r_223_285_79,r_168_220_139,0.56,-52,87,139,45
2,r_229_181_159,seq136,r_239_146_126,r_229_181_159,0.9,1,160,159,45
40,r_58_41_174,seq36,r_161_103_28,r_161_103_28,0.93,146,174,28,45
105,seq17,seq114,r_46_20_100,r_46_20_100,0.96,4,104,100,45
74,r_38_290_81,r_239_146_126,seq164,r_38_290_81,0.77,0,81,81,45
18,r_260_191_190,seq261,r_209_251_39,r_209_251_39,1.0,151,190,39,45
96,r_177_127_54,seq109,seq15,r_177_127_54,1.0,3,57,54,45
29,r_239_146_126,seq167,seq89,r_239_146_126,0.9,0,126,126,45
195,seq275,r_83_72_109,r_175_92_21,r_83_72_109,0.95,-12,97,109,45
61,r_168_220_139,r_282_172_132,r_239_146_126,r_168_220_139,1.0,0,139,139,45
24,r_50_192_187,r_188_187_187,r_79_91_114,r_79_91_114,0.98,73,187,114,45
99,r_60_294_55,r_168_220_139,r_210_37_38,r_60_294_55,0.98,3,58,55,45
88,r_159_12_110,r_95_142_198,seq194,r_159_12_110,0.97,1,111,110,45
70,r_188_187_187,r_50_192_187,r_201_22_135,r_201_22_135,0.88,52,187,135,45
68,r_166_32_83,seq286,r_129_10_39,r_166_32_83,0.85,2,85,83,45
32,r_270_90_111,r_150_134_178,seq73,r_270_90_111,1.0,0,111,111,45
38,r_150_134_178,seq1,seq202,r_150_134_178,0.54,0,178,178,45
77,r_123_63_144,seq291,r_71_288_193,r_123_63_144,0.74,1,145,144,45
92,r_210_37_38,seq73,seq117,r_210_37_38,1.0,0,38,38,45
34,r_8_56_103,r_40_7_198,r_268_77_97,r_8_56_103,0.62,0,103,103,45
75,r_138_255_111,seq55,seq2,r_138_255_111,0.98,0,111,111,45
15,r_99_113_24,r_260_191_190,seq27,r_99_113_24,1.0,2,26,24,45
17,r_201_22_135,seq152,seq171,r_201_22_135,0.7,0,135,135,45
119,seq55,r_138_255_111,seq53,r_138_255_111,1.0,0,111,111,45
171,seq218,r_298_238_131,r_183_292_97,r_183_292_97,0.97,24,121,97,45
23,r_26_74_30,r_260_191_190,seq199,r_26_74_30,1.0,0,30,30,45
28,r_297_216_137,r_176_124_173,r_65_284_117,r_297_216_137,0.98,1,138,137,45
91,r_178_276_112,r_233_156_66,r_105_230_54,r_105_230_54,0.96,57,111,54,45
49,r_207_110_98,r_239_146_126,r_52_98_70,r_239_146_126,1.0,-28,98,126,45
56,r_208_13_154,seq36,r_26_74_30,r_26_74_30,0.99,124,154,30,45
185,seq250,seq173,r_104_214_112,r_104_214_112,1.0,44,156,112,45
72,r_141_42_44,r_270_90_111,seq80,r_141_42_44,1.0,0,44,44,45
90,r_281_278_151,seq221,r_289_182_12,r_281_278_151,1.0,0,151,151,45
82,r_79_91_114,seq202,r_60_294_55,r_79_91_114,1.0,2,116,114,45
16,r_69_43_155,r_11_189_98,r_116_257_187,r_69_43_155,0.9,0,155,155,45
35,r_144_246_61,seq48,seq136,r_144_246_61,1.0,1,62,61,45
60,r_112_23_20,r_235_111_40,seq256,r_112_23_20,1.0,0,20,20,45
78,r_222_160_34,r_128_59_154,r_26_74_30,r_222_160_34,0.95,0,34,34,45
58,r_264_64_35,r_29_39_48,seq149,r_264_64_35,1.0,5,40,35,45
30,r_78_138_74,seq158,seq43,r_78_138_74,1.0,0,74,74,46
65,r_228_74_52,seq189,r_65_281_23,r_228_74_52,0.55,0,52,52,46
26,r_28_197_161,r_213_37_45,r_39_173_28,r_28_197_161,0.96,-116,45,161,46
14,r_211_145_92,seq233,seq104,r_211_145_92,1.0,0,92,92,46
57,r_18_20_43,r_205_51_125,r_8_139_172,r_18_20_43,1.0,0,43,43,46
60,r_128_90_122,seq63,r_150_275_19,r_150_275_19,1.0,0,19,19,46
54,r_53_21_110,r_154_4_139,r_218_10_75,r_154_4_139,0.98,-29,110,139,46
83,r_9_56_102,r_28_197_161,r_254_200_84,r_28_197_161,0.81,-58,103,161,46
22,r_194_204_52,seq113,r_86_288_46,r_194_204_52,1.0,0,52,52,46
37,r_170_198_73,seq189,seq58,r_170_198_73,1.0,0,73,73,46
3,r_5_40_171,r_287_11_5,r_273_186_195,r_5_40_171,0.7,0,171,171,46
59,r_234_122_146,r_112_199_197,r_287_11_5,r_234_122_146,0.87,1,147,146,46
43,r_245_168_30,r_234_122_146,r_92_111_132,r_245_168_30,0.9,0,30,30,46
71,r_294_66_159,seq244,seq0,r_294_66_159,0.93,1,160,159,46
86,r_277_32_133,r_84_119_87,r_285_267_196,r_277_32_133,0.96,0,133,133,46
39,r_253_100_121,r_291_225_70,r_217_123_195,r_291_225_70,0.95,0,70,70,46
1,r_120_13_162,r_280_96_124,r_128_90_122,r_128_90_122,0.99,41,163,122,46
97,r_254_200_84,r_266_192_45,seq113,r_254_200_84,1.0,0,84,84,46
143,seq146,r_107_72_86,r_69_260_17,r_107_72_86,0.97,-10,76,86,46
5,r_15_29_151,r_5_40_171,seq163,r_5_40_171,0.66,-21,150,171,46
80,r_27_64_159,seq58,r_88_75_20,r_27_64_159,0.9,1,160,159,46
88,r_276_2_49,r_196_153_171,r_234_122_146,r_276_2_49,0.6,128,177,49,46
6,r_219_162_41,seq3,r_24_222_7,r_219_162_41,1.0,1,42,41,46
69,r_191_34_120,seq57,r_132_81_123,r_191_34_120,0.98,0,120,120,46
91,r_161_237_21,seq187,seq239,r_161_237_21,1.0,0,21,21,46
19,r_117_262_83,seq0,r_174_147_45,r_117_262_83,1.0,1,84,83,46
95,r_257_167_175,seq116,r_211_145_92,r_211_145_92,1.0,90,182,92,46
66,r_284_208_87,seq241,r_226_185_47,r_226_185_47,0.73,41,88,47,46
39,r_253_100_121,r_217_123_195,seq126,r_253_100_121,1.0,0,121,121,46
41,r_247_263_180,seq54,r_30_136_40,r_30_136_40,0.98,140,180,40,46
67,r_132_81_123,r_247_263_180,r_39_173_28,r_132_81_123,0.98,1,124,123,46
89,r_181_252_109,r_274_143_133,seq97,r_181_252_109,0.66,2,111,109,46
10,r_52_135_97,seq58,r_228_74_52,r_52_135_97,1.0,-1,96,97,46
179,seq241,seq141,r_93_31_81,r_93_31_81,1.0,14,95,81,46
139,seq131,r_247_263_180,r_218_10_75,r_218_10_75,1.0,20,95,75,46
88,r_276_2_49,r_79_82_178,r_196_153_171,r_276_2_49,1.0,0,49,49,46
4,r_243_50_77,seq101,seq124,r_243_50_77,1.0,0,77,77,46
15,r_285_267_196,seq177,r_277_32_133,r_277_32_133,1.0,3,136,133,46
78,r_24_222_7,seq239,r_219_162_41,r_219_162_41,1.0,69,110,41,46
63,r_289_48_140,seq270,r_205_51_125,r_289_48_140,0.61,0,140,140,46
73,r_33_98_103,r_109_232_183,r_170_198_73,r_170_198_73,0.99,45,118,73,46
11,r_142_279_86,r_285_267_196,r_171_203_1,r_142_279_86,0.97,0,86,86,46
107,seq23,seq163,r_228_74_52,r_228_74_52,1.0,24,76,52,46
20,r_298_269_146,r_290_71_145,seq3,r_298_269_146,0.94,0,146,146,46
98,r_193_62_120,r_68_102_181,seq19,r_193_62_120,0.48,3,123,120,46
38,r_174_147_45,r_125_256_163,seq295,r_174_147_45,0.99,7,52,45,46
15,r_285_267_196,r_142_279_86,seq177,r_285_267_196,0.55,-110,86,196,46
48,r_55_130_144,seq97,seq239,r_55_130_144,0.99,0,144,144,46
2,r_30_136_40,r_28_197_161,seq129,r_30_136_40,1.0,0,40,40,46
72,r_184_118_25,r_294_66_159,r_112_199_197,r_184_118_25,0.97,1,26,25,46
99,r_125_256_163,r_201_134_189,r_52_135_97,r_52_135_97,1.0,92,189,97,46
134,seq116,r_257_167_175,r_142_279_86,r_142_279_86,1.0,96,182,86,46
27,r_7_207_101,seq41,seq43,r_7_207_101,1.0,0,101,101,46
53,r_92_111_132,r_245_168_30,r_248_67_79,r_245_168_30,0.92,102,132,30,46
74,r_255_22_23,r_247_263_180,seq227,r_255_22_23,0.57,0,23,23,46
172,seq230,seq235,r_248_67_79,r_248_67_79,1.0,4,83,79,46
93,r_150_275_19,r_128_90_122,r_254_200_84,r_150_275_19,0.93,103,122,19,46
40,r_202_35_114,r_180_25_187,seq220,r_202_35_114,0.68,2,116,114,46
51,r_36_46_34,r_280_96_124,seq54,r_36_46_34,1.0,0,34,34,46
53,r_92_111_132,r_86_288_46,r_245_168_30,r_92_111_132,0.9,-85,47,132,46
18,r_218_10_75,seq241,seq131,r_218_10_75,1.0,0,75,75,46
25,r_8_139_172,r_103_169_128,r_18_20_43,r_18_20_43,0.52,85,128,43,46
43,r_245_168_30,r_92_111_132,r_133_215_128,r_245_168_30,0.89,102,132,30,46
31,r_196_153_171,seq221,r_276_2_49,r_276_2_49,1.0,0,49,49,46
64,r_274_143_133,seq278,seq158,r_274_143_133,0.98,0,133,133,46
58,r_178_12_132,seq188,seq141,r_178_12_132,0.59,0,132,132,46
70,r_103_169_128,r_8_139_172,r_271_95_163,r_103_169_128,1.0,0,128,128,46
145,seq149,seq104,r_88_75_20,r_88_75_20,1.0,0,20,20,46
81,r_69_260_17,r_294_66_159,seq41,r_69_260_17,1.0,-2,15,17,46
170,seq227,seq63,r_255_22_23,r_255_22_23,0.95,5,28,23,46
25,r_8_139_172,r_18_20_43,seq42,r_8_139_172,0.83,1,173,172,46
52,r_290_71_145,r_298_269_146,r_91_76_107,r_290_71_145,0.98,1,146,145,46
77,r_105_265_174,r_109_232_183,r_280_96_124,r_280_96_124,0.79,51,175,124,46
76,r_39_173_28,r_28_197_161,r_132_81_123,r_39_173_28,0.79,110,138,28,46
196,seq295,r_93_31_81,r_174_147_45,r_93_31_81,0.85,-1,80,81,46
57,r_18_20_43,r_8_139_172,r_28_197_161,r_28_197_161,0.96,12,173,161,46
85,r_165_238_30,r_120_13_162,seq206,r_165_238_30,1.0,0,30,30,46
46,r_106_59_10,seq146,seq23,r_106_59_10,0.88,0,10,10,46
93,r_150_275_19,r_117_262_83,r_128_90_122,r_150_275_19,1.0,1,20,19,46
75,r_283_223_101,seq80,seq70,r_283_223_101,1.0,1,102,101,46
24,r_61_166_32,r_55_130_144,seq77,r_61_166_32,1.0,1,33,32,46
17,r_91_76_107,seq190,seq80,r_91_76_107,1.0,1,108,107,46
112,seq43,r_154_4_139,r_7_207_101,r_7_207_101,0.97,14,115,101,46
9,r_127_89_128,seq242,seq47,r_127_89_128,0.69,0,128,128,46
26,r_28_197_161,r_39_173_28,r_18_20_43,r_28_197_161,0.91,0,161,161,46
31,r_196_153_171,r_276_2_49,r_253_100_121,r_196_153_171,0.62,2,173,171,46
33,r_226_185_47,seq249,r_68_102_181,r_226_185_47,1.0,0,47,47,46
32,r_88_75_20,r_8_139_172,seq149,r_88_75_20,1.0,0,20,20,46
62,r_287_11_5,r_5_40_171,r_234_122_146,r_287_11_5,0.58,166,171,5,46
102,seq3,seq23,r_298_269_146,r_298_269_146,0.96,5,151,146,46
68,r_213_37_45,r_28_197_161,r_30_136_40,r_28_197_161,1.0,-116,45,161,46
149,seq158,seq73,r_274_143_133,r_274_143_133,1.0,46,179,133,46
44,r_205_51_125,r_201_134_189,seq216,r_205_51_125,1.0,0,125,125,46
131,seq104,seq149,r_211_145_92,r_211_145_92,1.0,17,109,92,46
23,r_172_264_90,r_178_12_132,seq235,r_172_264_90,1.0,-1,89,90,46
138,seq129,seq155,r_30_136_40,r_30_136_40,1.0,58,98,40,46
96,r_86_288_46,r_92_111_132,r_194_204_52,r_86_288_46,0.73,6,52,46,46
159,seq188,r_178_12_132,seq157,r_178_12_132,1.0,0,132,132,46
79,r_248_67_79,r_93_31_81,seq230,r_248_67_79,0.8,-1,78,79,46
60,r_128_90_122,r_150_275_19,r_108_87_1,r_128_90_122,0.99,0,122,122,46
35,r_107_72_86,seq146,seq183,r_107_72_86,0.77,0,86,86,46
55,r_156_6_20,r_247_263_180,seq242,r_156_6_20,1.0,0,20,20,46
12,r_133_215_128,seq282,r_174_147_45,r_133_215_128,0.98,0,128,128,46
84,r_93_31_81,seq295,seq241,r_93_31_81,1.0,0,81,81,46
76,r_39_173_28,r_298_269_146,r_28_197_161,r_39_173_28,1.0,0,28,28,46
93,r_72_218_63,seq235,seq9,r_72_218_63,0.99,5,68,63,47
30,r_147_170_109,seq208,seq30,r_147_170_109,0.96,0,109,109,47
176,seq228,r_11_114_182,r_97_287_126,r_97_287_126,0.99,60,186,126,47
8,r_42_109_161,seq196,r_112_4_109,r_42_109_161,0.58,0,161,161,47
58,r_75_151_30,seq209,r_50_93_111,r_50_93_111,1.0,18,129,111,47
80,r_108_73_33,r_258_74_73,r_90_289_123,r_108_73_33,1.0,1,34,33,47
54,r_113_56_73,seq223,seq199,r_113_56_73,0.96,0,73,73,47
37,r_292_243_140,r_224_149_122,r_50_93_111,r_50_93_111,0.79,11,122,111,47
56,r_183_85_23,r_258_74_73,seq17,r_183_85_23,1.0,0,23,23,47
59,r_29_87_82,seq45,seq155,r_29_87_82,0.77,4,86,82,47
37,r_292_243_140,r_50_93_111,r_34_103_100,r_34_103_100,0.5,40,140,100,47
86,r_263_298_161,seq140,r_36_110_134,r_263_298_161,0.6,0,161,161,47
16,r_274_53_114,r_61_190_124,seq196,r_274_53_114,0.91,0,114,114,47
21,r_258_74_73,r_126_106_2,seq186,r_258_74_73,0.65,1,74,73,47
58,r_75_151_30,r_29_87_82,seq209,r_75_151_30,1.0,0,30,30,47
1,r_224_149_122,r_292_243_140,r_91_180_69,r_91_180_69,0.73,53,122,69,47
80,r_108_73_33,r_90_289_123,r_219_249_123,r_108_73_33,1.0,90,123,33,47
143,seq139,r_64_47_183,r_270_25_87,r_270_25_87,1.0,31,118,87,47
5,r_97_287_126,seq252,r_162_295_11,r_97_287_126,0.86,0,126,126,47
42,r_91_180_69,seq24,seq21,r_91_180_69,1.0,1,70,69,47
35,r_265_83_59,r_258_74_73,seq261,r_265_83_59,1.0,0,59,59,47
69,r_76_246_102,r_264_131_165,r_136_178_60,r_136_178_60,0.99,45,105,60,47
67,r_268_12_11,r_169_158_116,seq272,r_268_12_11,0.82,2,13,11,47
39,r_96_71_47,r_258_74_73,seq297,r_96_71_47,1.0,0,47,47,47
71,r_256_80_15,r_224_149_122,seq235,r_256_80_15,0.83,0,15,15,47
76,r_135_5_121,seq18,r_39_187_60,r_135_5_121,0.94,0,121,121,47
97,r_162_295_11,seq228,r_97_287_126,r_97_287_126,0.98,2,128,126,47
31,r_6_245_47,r_95_88_116,r_159_65_103,r_6_245_47,0.96,69,116,47,47
41,r_136_178_60,r_50_93_111,seq133,r_136_178_60,0.68,0,60,60,47
3,r_82_227_68,r_104_231_171,r_39_187_60,r_82_227_68,1.0,0,68,68,47
10,r_173_52_180,seq297,r_244_253_57,r_244_253_57,0.48,124,181,57,47
43,r_77_257_29,seq272,r_239_127_95,r_77_257_29,0.98,0,29,29,47
90,r_207_142_180,r_104_231_171,r_44_238_154,r_44_238_154,0.75,17,171,154,47
26,r_285_68_63,r_34_103_100,seq181,r_285_68_63,1.0,1,64,63,47
72,r_266_193_70,seq14,seq209,r_266_193_70,0.98,4,74,70,47
198,seq296,seq186,r_27_41_42,r_27_41_42,0.93,57,99,42,47
174,seq223,r_113_56_73,seq192,r_113_56_73,0.99,0,73,73,47
78,r_63_55_74,seq241,r_27_41_42,r_63_55_74,1.0,0,74,74,47
0,r_191_121_158,seq14,r_15_164_3,r_191_121_158,0.88,0,158,158,47
63,r_202_129_69,seq119,r_183_85_23,r_202_129_69,1.0,0,69,69,47
73,r_150_102_170,seq210,r_236_203_133,r_236_203_133,0.82,37,170,133,47
11,r_163_98_89,r_213_132_114,seq198,r_163_98_89,1.0,0,89,89,47
107,seq18,r_135_5_121,seq165,r_135_5_121,1.0,0,121,121,47
79,r_1_216_24,r_239_127_95,seq48,r_1_216_24,1.0,0,24,24,47
20,r_283_260_75,seq59,r_154_43_49,r_283_260_75,1.0,0,75,75,47
98,r_159_65_103,seq209,r_6_245_47,r_159_65_103,1.0,1,104,103,47
15,r_95_88_116,r_6_245_47,seq286,r_95_88_116,0.97,0,116,116,47
57,r_236_203_133,seq21,seq118,r_236_203_133,0.77,1,134,133,47
6,r_262_299_163,r_15_164_3,seq130,r_262_299_163,0.67,1,164,163,47
62,r_62_10_79,r_90_289_123,seq198,r_62_10_79,0.89,1,80,79,47
141,seq134,seq284,r_215_282_116,r_215_282_116,1.0,0,116,116,47
85,r_195_237_156,seq8,r_292_243_140,r_195_237_156,0.37,2,158,156,47
87,r_35_116_43,r_270_25_87,seq24,r_35_116_43,0.97,0,43,43,47
99,r_34_103_100,seq155,seq14,r_34_103_100,1.0,1,101,100,47
27,r_168_188_177,seq196,r_264_131_165,r_168_188_177,0.46,1,178,177,47
60,r_79_172_166,r_265_83_59,seq252,r_79_172_166,0.97,-1,165,166,47
34,r_27_41_42,r_274_53_114,r_28_141_26,r_274_53_114,0.98,-70,44,114,47
38,r_105_242_20,r_217_128_189,seq241,r_105_242_20,1.0,0,20,20,47
48,r_226_247_34,r_144_117_79,r_177_111_10,r_226_247_34,1.0,1,35,34,47
2,r_39_187_60,r_278_240_128,r_126_106_2,r_39_187_60,1.0,0,60,60,47
47,r_233_33_111,seq166,seq8,r_233_33_111,1.0,0,111,111,47
153,seq167,r_244_253_57,r_37_294_30,r_244_253_57,1.0,0,57,57,47
74,r_16_49_139,seq228,r_219_249_123,r_219_249_123,0.87,16,139,123,47
29,r_78_26_182,seq248,r_224_149_122,r_224_149_122,0.74,60,182,122,47
28,r_177_111_10,r_95_88_116,r_226_247_34,r_226_247_34,0.53,0,34,34,47
84,r_50_93_111,r_112_4_109,r_75_151_30,r_75_151_30,0.9,84,114,30,47
25,r_104_231_171,r_207_142_180,r_29_87_82,r_104_231_171,0.84,0,171,171,47
43,r_77_257_29,r_239_127_95,r_183_85_23,r_239_127_95,1.0,0,95,95,47
127,seq89,r_232_222_117,seq157,r_232_222_117,1.0,-7,110,117,47
64,r_44_238_154,seq30,seq174,r_44_238_154,0.82,0,154,154,47
82,r_239_127_95,r_77_257_29,r_29_87_82,r_239_127_95,1.0,1,96,95,47
192,seq284,r_217_128_189,r_57_122_30,r_57_122_30,1.0,22,52,30,47
88,r_120_171_128,seq69,r_258_74_73,r_120_171_128,0.89,1,129,128,47
156,seq179,seq296,r_232_222_117,r_232_222_117,1.0,12,129,117,47
50,r_22_204_81,r_135_5_121,r_35_116_43,r_22_204_81,1.0,0,81,81,47
44,r_37_294_30,r_258_74_73,seq167,r_37_294_30,0.78,0,30,30,47
65,r_46_19_82,seq181,r_276_250_33,r_46_19_82,1.0,0,82,82,47
66,r_206_153_51,seq100,seq94,r_206_153_51,0.96,2,53,51,47
61,r_264_131_165,seq32,r_168_188_177,r_264_131_165,0.22,14,179,165,47
32,r_36_110_134,r_160_176_164,r_77_257_29,r_36_110_134,0.58,3,137,134,47
52,r_232_222_117,seq228,seq179,r_232_222_117,1.0,0,117,117,47
75,r_90_289_123,r_108_73_33,seq152,r_90_289_123,1.0,0,123,123,47
75,r_90_289_123,r_62_10_79,r_108_73_33,r_90_289_123,1.0,-43,80,123,47
4,r_244_253_57,seq167,seq18,r_244_253_57,0.86,0,57,57,47
60,r_79_172_166,r_112_4_109,r_265_83_59,r_79_172_166,0.62,-57,109,166,47
17,r_112_4_109,r_79_172_166,r_136_178_60,r_79_172_166,0.99,-57,109,166,47
9,r_270_25_87,r_264_131_165,seq139,r_270_25_87,1.0,0,87,87,47
96,r_160_176_164,seq174,r_177_111_10,r_160_176_164,0.85,0,164,164,47
91,r_280_161_56,r_16_49_139,seq137,r_280_161_56,0.74,2,58,56,47
23,r_57_122_30,r_191_121_158,seq284,r_57_122_30,1.0,0,30,30,47
28,r_177_111_10,seq94,r_95_88_116,r_177_111_10,0.79,2,12,10,47
102,seq8,r_195_237_156,r_233_33_111,r_233_33_111,1.0,47,158,111,47
97,r_162_295_11,r_215_282_116,seq228,r_162_295_11,1.0,0,11,11,47
77,r_28_141_26,r_244_253_57,r_27_41_42,r_244_253_57,0.92,-21,36,57,47
55,r_156_20_22,r_72_218_63,seq134,r_156_20_22,0.72,0,22,22,47
68,r_200_229_29,seq99,seq208,r_200_229_29,1.0,0,29,29,47
7,r_169_158_116,r_61_190_124,seq192,r_61_190_124,0.66,-6,118,124,47
185,seq261,seq125,r_265_83_59,r_265_83_59,1.0,17,76,59,47
83,r_276_250_33,r_270_25_87,seq14,r_270_25_87,0.94,-51,36,87,47
90,r_207_142_180,r_44_238_154,r_224_149_122,r_207_142_180,0.89,1,181,180,47
159,seq186,seq296,r_61_190_124,r_61_190_124,0.69,6,130,124,47
82,r_239_127_95,seq134,r_77_257_29,r_77_257_29,0.93,7,36,29,47
12,r_64_47_183,seq139,r_168_188_177,r_64_47_183,0.64,1,184,183,47
84,r_50_93_111,r_136_178_60,r_112_4_109,r_136_178_60,1.0,0,60,60,47
199,seq297,r_173_52_180,r_96_71_47,r_96_71_47,1.0,19,66,47,47
55,r_156_20_22,seq134,r_215_282_116,r_215_282_116,1.0,8,124,116,47
93,r_217_76_165,seq36,r_97_122_153,r_217_76_165,0.61,0,165,165,48
30,r_83_235_136,seq180,r_26_182_1,r_83_235_136,0.94,0,136,136,48
36,r_290_92_150,seq263,r_273_121_26,r_290_92_150,0.61,2,152,150,48
8,r_295_260_87,r_290_92_150,r_204_211_35,r_295_260_87,0.8,0,87,87,48
53,r_61_177_1,r_242_197_166,r_137_138_77,r_137_138_77,1.0,6,83,77,48
43,r_65_1_97,seq246,seq117,r_65_1_97,1.0,2,99,97,48
52,r_159_174_27,r_222_158_35,seq206,r_159_174_27,0.66,-2,25,27,48
125,seq86,r_280_115_101,seq94,r_280_115_101,0.81,27,128,101,48
88,r_21_253_15,r_297_289_170,seq82,r_21_253_15,0.96,1,16,15,48
3,r_262_188_29,r_47_34_86,seq50,r_47_34_86,0.95,-51,35,86,48
92,r_6_3_49,r_61_177_1,seq292,r_6_3_49,1.0,2,51,49,48
59,r_175_14_120,r_150_171_90,seq67,r_150_171_90,0.7,4,94,90,48
26,r_41_79_46,r_189_133_89,seq250,r_41_79_46,0.99,1,47,46,48
55,r_47_34_86,r_4_96_167,r_261_99_86,r_47_34_86,1.0,0,86,86,48
71,r_43_5_127,seq185,r_255_91_82,r_43_5_127,0.71,1,128,127,48
86,r_255_91_82,seq13,seq219,r_255_91_82,0.96,0,82,82,48
16,r_150_171_90,r_175_14_120,seq190,r_150_171_90,0.98,4,94,90,48
39,r_242_197_166,r_31_286_169,seq229,r_31_286_169,0.87,-1,168,169,48
1,r_25_214_103,seq18,r_204_211_35,r_25_214_103,0.95,0,103,103,48
86,r_255_91_82,seq219,r_43_5_127,r_43_5_127,1.0,-1,126,127,48
5,r_287_149_130,r_196_154_169,r_135_104_75,r_287_149_130,0.76,0,130,130,48
42,r_153_224_92,r_192_245_186,r_151_128_22,r_153_224_92,0.97,2,94,92,48
80,r_4_96_167,seq126,r_25_214_103,r_25_214_103,0.48,64,167,103,48
176,seq226,seq132,r_265_272_172,r_265_272_172,0.96,3,175,172,48
45,r_189_133_89,r_134_100_57,r_11_254_1,r_189_133_89,1.0,0,89,89,48
21,r_151_128_22,r_88_127_38,seq220,r_151_128_22,1.0,0,22,22,48
25,r_88_127_38,r_95_169_133,seq87,r_88_127_38,0.93,3,41,38,48
19,r_46_285_114,r_161_212_129,r_275_45_14,r_46_285_114,1.0,1,115,114,48
59,r_175_14_120,seq67,r_203_48_107,r_175_14_120,0.99,0,120,120,48
69,r_120_215_58,r_178_101_151,r_297_289_170,r_120_215_58,1.0,1,59,58,48
72,r_273_121_26,r_58_27_150,seq208,r_58_27_150,0.66,-119,31,150,48
44,r_56_90_45,seq190,r_33_110_13,r_56_90_45,1.0,1,46,45,48
95,r_107_282_77,seq116,seq102,r_107_282_77,1.0,1,78,77,48
66,r_161_212_129,seq123,r_60_209_83,r_161_212_129,0.93,0,129,129,48
31,r_196_154_169,seq50,seq94,r_196_154_169,0.86,0,169,169,48
129,seq102,seq15,r_107_282_77,r_107_282_77,1.0,6,83,77,48
41,r_184_40_139,seq57,r_61_177_1,r_184_40_139,1.0,0,139,139,48
10,r_271_10_66,r_178_101_151,seq89,r_271_10_66,1.0,0,66,66,48
90,r_270_22_133,seq20,r_243_238_92,r_270_22_133,0.99,1,134,133,48
54,r_223_284_15,seq51,seq148,r_223_284_15,1.0,1,16,15,48
50,r_69_239_26,seq130,r_11_254_1,r_69_239_26,0.78,2,28,26,48
78,r_84_125_176,r_72_17_183,seq112,r_84_125_176,0.5,2,178,176,48
0,r_55_23_3,r_267_8_72,seq266,r_267_8_72,1.0,3,75,72,48
83,r_299_277_46,r_105_74_165,r_55_23_3,r_299_277_46,1.0,1,47,46,48
11,r_288_0_59,r_105_74_165,seq246,r_288_0_59,1.0,1,60,59,48
124,seq82,r_281_139_172,r_21_253_15,r_21_253_15,1.0,2,17,15,48
20,r_53_195_182,r_162_268_197,r_25_214_103,r_25_214_103,0.89,80,183,103,48
13,r_105_74_165,r_4_96_167,seq185,r_105_74_165,0.6,0,165,165,48
15,r_152_28_100,r_98_233_164,seq18,r_152_28_100,1.0,2,102,100,48
166,seq206,r_63_244_128,r_159_174_27,r_63_244_128,0.94,-31,97,128,48
48,r_243_238_92,r_192_245_186,r_164_276_6,r_243_238_92,0.89,2,94,92,48
4,r_297_289_170,r_120_215_58,r_203_48_107,r_120_215_58,0.77,115,173,58,48
14,r_136_231_48,r_191_298_189,r_124_35_41,r_136_231_48,1.0,0,48,48,48
57,r_178_101_151,seq140,seq62,r_178_101_151,0.54,0,151,151,48
62,r_97_122_153,seq113,r_21_253_15,r_21_253_15,0.78,139,154,15,48
85,r_170_78_128,r_217_76_165,r_199_193_35,r_170_78_128,0.99,0,128,128,48
67,r_124_35_41,seq141,r_136_231_48,r_136_231_48,0.75,-1,47,48,48
99,r_265_272_172,r_11_254_1,seq226,r_265_272_172,0.57,0,172,172,48
7,r_72_17_183,r_56_90_45,r_63_244_128,r_72_17_183,0.89,1,184,183,48
27,r_191_298_189,seq66,r_105_74_165,r_105_74_165,0.77,24,189,165,48
6,r_173_252_37,r_288_0_59,seq119,r_173_252_37,1.0,1,38,37,48
82,r_199_193_35,r_83_235_136,seq51,r_199_193_35,1.0,0,35,35,48
162,seq185,r_43_5_127,seq221,r_43_5_127,0.99,1,128,127,48
69,r_120_215_58,r_297_289_170,r_85_93_10,r_297_289_170,0.98,7,177,170,48
2,r_63_244_128,seq206,seq38,r_63_244_128,0.97,0,128,128,48
47,r_251_230_151,seq229,r_150_171_90,r_251_230_151,0.75,0,151,151,48
98,r_204_211_35,r_58_27_150,seq187,r_204_211_35,0.97,0,35,35,48
74,r_135_104_75,seq119,seq141,r_135_104_75,1.0,5,80,75,48
18,r_168_198_181,r_259_129_191,r_105_74_165,r_259_129_191,0.47,-8,183,191,48
29,r_200_237_140,seq132,r_261_99_86,r_200_237_140,0.77,0,140,140,48
24,r_33_110_13,r_84_125_176,r_56_90_45,r_56_90_45,0.97,105,150,45,48
70,r_205_183_81,seq145,seq13,r_205_183_81,1.0,0,81,81,48
32,r_261_99_86,seq140,r_47_34_86,r_261_99_86,1.0,0,86,86,48
38,r_137_138_77,r_63_244_128,r_61_177_1,r_137_138_77,0.73,2,79,77,48
77,r_42_143_120,r_281_139_172,r_159_174_27,r_42_143_120,0.98,0,120,120,48
34,r_58_27_150,seq80,r_135_104_75,r_58_27_150,0.92,1,151,150,48
46,r_85_93_10,r_56_90_45,seq66,r_85_93_10,0.96,0,10,10,48
75,r_280_115_101,seq86,r_243_238_92,r_243_238_92,0.85,9,101,92,48
4,r_297_289_170,r_191_298_189,r_120_215_58,r_120_215_58,1.0,-1,57,58,48
60,r_95_169_133,seq232,r_43_5_127,r_95_169_133,0.9,0,133,133,48
81,r_267_8_72,r_55_23_3,seq39,r_267_8_72,1.0,3,75,72,48
168,seq208,r_63_244_128,r_273_121_26,r_63_244_128,0.93,-61,67,128,48
96,r_222_158_35,r_60_209_83,seq36,r_222_158_35,0.92,8,43,35,48
94,r_203_48_107,seq80,seq236,r_203_48_107,0.62,-10,97,107,48
144,seq132,r_200_237_140,r_61_177_1,r_200_237_140,0.96,0,140,140,48
9,r_77_247_68,seq62,r_210_201_3,r_77_247_68,0.93,0,68,68,48
126,seq87,seq71,r_88_127_38,r_88_127_38,1.0,6,44,38,48
133,seq112,seq190,r_84_125_176,r_84_125_176,0.65,5,181,176,48
22,r_60_209_83,r_107_282_77,seq240,r_107_282_77,1.0,1,78,77,48
50,r_69_239_26,r_11_254_1,r_241_146_50,r_241_146_50,1.0,7,57,50,48
28,r_160_227_171,seq220,r_299_277_46,r_160_227_171,0.64,0,171,171,48
49,r_30_256_140,r_97_122_153,r_134_100_57,r_30_256_140,0.99,0,140,140,48
164,seq187,r_271_10_66,r_204_211_35,r_271_10_66,0.72,0,66,66,48
56,r_44_2_71,seq240,seq39,r_44_2_71,0.99,0,71,71,48
7,r_72_17_183,r_84_125_176,r_56_90_45,r_56_90_45,1.0,105,150,45,48
63,r_241_146_50,r_63_244_128,r_69_239_26,r_241_146_50,1.0,0,50,50,48
79,r_98_233_164,seq142,seq112,r_98_233_164,0.51,2,166,164,48
35,r_192_245_186,seq185,r_137_138_77,r_192_245_186,0.3,0,186,186,48
128,seq94,seq220,r_196_154_169,r_196_154_169,0.92,14,183,169,48
51,r_33_273_142,seq112,r_203_25_144,r_203_25_144,0.9,2,146,144,49
54,r_54_157_65,r_241_291_50,r_33_273_142,r_241_291_50,0.99,0,50,50,49
72,r_65_127_67,r_148_60_103,seq161,r_148_60_103,1.0,3,106,103,49
92,r_180_259_173,seq123,r_108_184_139,r_180_259_173,0.54,0,173,173,49
14,r_51_81_61,seq265,seq6,r_51_81_61,1.0,0,61,61,49
8,r_175_266_92,seq45,seq258,r_175_266_92,0.83,0,92,92,49
53,r_219_270_165,seq261,r_274_187_118,r_274_187_118,0.5,47,165,118,49
83,r_170_237_149,seq83,r_281_198_103,r_281_198_103,0.72,47,150,103,49
37,r_211_52_164,r_256_141_173,r_183_7_26,r_211_52_164,0.68,0,164,164,49
71,r_281_198_103,r_180_259_173,seq85,r_281_198_103,0.98,0,103,103,49
21,r_36_195_122,r_71_59_154,seq146,r_36_195_122,0.83,0,122,122,49
97,r_221_209_137,r_33_273_142,r_37_44_109,r_221_209_137,0.99,-1,136,137,49
104,seq20,r_256_141_173,seq101,r_256_141_173,0.84,-26,147,173,49
42,r_26_174_157,r_113_90_176,seq95,r_26_174_157,0.81,0,157,157,49
80,r_56_41_124,seq86,r_208_193_22,r_56_41_124,0.91,1,125,124,49
69,r_242_55_141,seq223,seq83,r_242_55_141,0.99,0,141,141,49
45,r_131_229_100,seq78,r_262_88_11,r_131_229_100,0.69,0,100,100,49
29,r_249_2_56,r_186_102_198,seq223,r_249_2_56,1.0,2,58,56,49
19,r_204_140_73,r_73_153_61,seq172,r_204_140_73,1.0,0,73,73,49
187,seq253,r_277_14_150,r_297_188_26,r_297_188_26,1.0,0,26,26,49
153,seq144,r_280_137_145,r_191_254_141,r_280_137_145,1.0,0,145,145,49
90,r_218_284_45,r_139_299_103,seq78,r_218_284_45,1.0,0,45,45,49
73,r_67_46_31,seq202,seq83,r_67_46_31,0.92,6,37,31,49
95,r_49_39_173,r_117_143_176,r_175_266_92,r_175_266_92,0.71,87,179,92,49
66,r_64_10_173,seq290,r_104_264_131,r_104_264_131,0.64,42,173,131,49
76,r_276_115_111,r_121_69_165,r_239_149_26,r_276_115_111,0.95,0,111,111,49
31,r_4_145_130,r_89_164_142,seq42,r_4_145_130,0.99,0,130,130,49
41,r_62_285_114,r_159_298_195,seq76,r_62_285_114,1.0,0,114,114,49
67,r_214_77_102,seq79,seq61,r_214_77_102,0.98,-1,101,102,49
96,r_207_8_71,r_117_143_176,r_37_44_109,r_207_8_71,0.71,110,181,71,49
3,r_277_14_150,seq94,r_242_55_141,r_277_14_150,0.46,0,150,150,49
10,r_108_184_139,seq63,seq163,r_108_184_139,0.9,1,140,139,49
109,seq31,r_121_69_165,r_220_190_101,r_220_190_101,0.89,64,165,101,49
26,r_275_129_86,r_121_69_165,r_222_3_9,r_275_129_86,1.0,0,86,86,49
72,r_65_127_67,seq120,r_148_60_103,r_65_127_67,0.71,0,67,67,49
4,r_256_141_173,seq124,r_93_68_89,r_256_141_173,0.68,0,173,173,49
78,r_80_206_109,r_293_158_178,r_12_228_52,r_12_228_52,1.0,56,108,52,49
98,r_11_160_47,seq95,seq147,r_11_160_47,0.99,0,47,47,49
13,r_23_72_147,r_167_282_162,r_183_7_26,r_167_282_162,0.67,-15,147,162,49
48,r_87_263_110,r_293_158_178,r_192_267_14,r_87_263_110,1.0,0,110,110,49
93,r_192_267_14,seq147,seq63,r_192_267_14,0.97,4,18,14,49
57,r_185_154_97,seq144,seq43,r_185_154_97,1.0,0,97,97,49
6,r_73_153_61,r_204_140_73,seq24,r_73_153_61,0.84,6,67,61,49
81,r_148_60_103,r_65_127_67,seq100,r_148_60_103,0.97,3,106,103,49
85,r_71_59_154,seq28,r_255_128_85,r_255_128_85,1.0,70,155,85,49
99,r_89_164_142,r_219_270_165,r_279_118_32,r_219_270_165,0.79,-23,142,165,49
34,r_34_66_16,seq29,seq177,r_34_66_16,1.0,0,16,16,49
160,seq163,r_248_98_15,r_108_184_139,r_108_184_139,0.97,12,151,139,49
27,r_260_189_162,r_117_143_176,r_34_66_16,r_260_189_162,0.75,1,163,162,49
55,r_239_149_26,r_211_52_164,seq86,r_239_149_26,1.0,0,26,26,49
24,r_12_228_52,r_131_229_100,seq120,r_12_228_52,1.0,0,52,52,49
2,r_210_0_103,r_135_231_110,seq162,r_210_0_103,0.93,0,103,103,49
47,r_117_143_176,r_49_39_173,r_211_52_164,r_211_52_164,0.87,15,179,164,49
93,r_192_267_14,seq63,r_87_263_110,r_87_263_110,1.0,4,114,110,49
40,r_167_282_162,seq43,r_208_193_22,r_167_282_162,0.74,0,162,162,49
74,r_74_169_134,seq292,r_241_291_50,r_74_169_134,0.79,0,134,134,49
18,r_244_243_63,r_40_16_129,r_194_21_71,r_244_243_63,1.0,5,68,63,49
25,r_191_254_141,r_232_234_6,seq144,r_232_234_6,0.83,135,141,6,49
33,r_252_109_115,seq224,seq268,r_252_109_115,0.95,0,115,115,49
127,seq91,r_48_22_176,r_255_128_85,r_255_128_85,1.0,91,176,85,49
88,r_18_225_112,seq265,seq250,r_18_225_112,0.98,0,112,112,49
156,seq151,r_289_5_151,seq226,r_289_5_151,0.64,1,152,151,49
50,r_293_158_178,seq50,r_13_283_6,r_13_283_6,0.9,173,179,6,49
70,r_278_181_71,seq99,seq53,r_278_181_71,1.0,1,72,71,49
35,r_208_193_22,r_256_141_173,seq75,r_208_193_22,1.0,1,23,22,49
65,r_113_90_176,r_293_158_178,r_37_44_109,r_113_90_176,0.48,-7,169,176,49
68,r_203_25_144,seq269,r_33_273_142,r_203_25_144,0.97,0,144,144,49
61,r_159_298_195,r_62_285_114,r_239_149_26,r_159_298_195,0.94,-80,115,195,49
15,r_297_188_26,r_183_7_26,seq253,r_297_188_26,0.57,1,27,26,49
38,r_280_137_145,seq144,r_278_181_71,r_280_137_145,0.9,0,145,145,49
52,r_121_69_165,seq31,seq171,r_121_69_165,0.75,0,165,165,49
77,r_220_190_101,r_33_273_142,seq31,r_220_190_101,1.0,0,101,101,49
16,r_116_245_52,seq163,seq261,r_116_245_52,0.55,2,54,52,49
136,seq103,r_62_285_114,seq91,r_62_285_114,0.77,-85,29,114,49
154,seq146,r_106_182_199,r_36_195_122,r_36_195_122,0.97,13,135,122,49
75,r_194_21_71,seq50,r_244_243_63,r_244_243_63,1.0,10,73,63,49
59,r_279_118_32,r_135_231_110,seq114,r_279_118_32,1.0,0,32,32,49
81,r_148_60_103,seq161,r_65_127_67,r_65_127_67,0.99,9,76,67,49
17,r_104_264_131,seq120,seq61,r_104_264_131,1.0,0,131,131,49
119,seq75,r_113_90_176,r_208_193_22,r_208_193_22,1.0,143,165,22,49
94,r_152_107_89,seq94,r_82_47_21,r_152_107_89,0.96,5,94,89,49
9,r_150_1_29,r_12_228_52,seq136,r_150_1_29,0.94,0,29,29,49
96,r_207_8_71,r_74_169_134,r_117_143_176,r_207_8_71,0.57,1,72,71,49
54,r_54_157_65,r_33_273_142,seq43,r_54_157_65,1.0,0,65,65,49
1,r_257_246_41,r_255_128_85,seq19,r_257_246_41,1.0,0,41,41,49
133,seq99,r_278_181_71,seq78,r_278_181_71,1.0,1,72,71,49
123,seq83,r_170_237_149,r_277_14_150,r_170_237_149,0.67,1,150,149,49
28,r_135_231_110,seq200,seq287,r_135_231_110,1.0,0,110,110,49
7,r_139_299_103,r_256_141_173,seq265,r_139_299_103,0.76,2,105,103,49
185,seq250,seq61,r_18_225_112,r_18_225_112,1.0,33,145,112,49
44,r_37_44_109,r_105_38_179,r_207_8_71,r_105_38_179,0.99,-71,108,179,49
79,r_179_35_169,r_105_38_179,seq99,r_179_35_169,0.44,0,169,169,49
12,r_274_187_118,r_71_59_154,r_275_129_86,r_274_187_118,0.99,0,118,118,49
63,r_262_88_11,r_23_72_147,seq142,r_262_88_11,0.92,0,11,11,49
89,r_212_205_49,r_56_41_124,seq45,r_212_205_49,0.79,5,54,49,49
84,r_255_128_85,seq130,seq91,r_255_128_85,1.0,0,85,85,49
30,r_32_262_87,r_234_156_86,r_280_257_46,r_234_156_86,1.0,2,88,86,50
55,r_89_61_16,seq190,r_158_164_13,r_89_61_16,0.83,0,16,16,50
94,r_189_58_16,r_250_210_81,seq90,r_189_58_16,0.94,2,18,16,50
53,r_146_25_68,seq295,seq294,r_146_25_68,0.98,-2,66,68,50
113,seq31,r_44_70_142,r_280_257_46,r_280_257_46,0.67,4,50,46,50
15,r_136_50_31,r_118_26_122,r_278_96_13,r_136_50_31,0.78,4,35,31,50
54,r_45_66_32,r_105_207_166,r_44_70_142,r_44_70_142,0.57,24,166,142,50
72,r_209_159_40,r_198_283_193,seq11,r_209_159_40,0.94,-2,38,40,50
59,r_278_96_13,r_260_243_47,seq57,r_278_96_13,0.94,3,16,13,50
71,r_284_53_109,r_240_46_198,seq83,r_284_53_109,0.62,8,117,109,50
16,r_20_282_60,r_261_28_101,seq79,r_20_282_60,1.0,-2,58,60,50
21,r_234_156_86,r_157_165_76,r_215_212_63,r_157_165_76,1.0,0,76,76,50
1,r_299_37_177,seq140,r_197_252_174,r_299_37_177,0.42,0,177,177,50
97,r_68_133_184,seq154,seq74,r_68_133_184,0.21,2,186,184,50
5,r_167_201_108,r_261_28_101,r_189_58_16,r_167_201_108,0.87,1,109,108,50
46,r_281_254_111,seq85,r_290_231_52,r_281_254_111,0.73,1,112,111,50
42,r_162_5_119,r_129_196_146,seq216,r_162_5_119,0.77,0,119,119,50
110,seq22,r_166_87_50,r_149_245_55,r_149_245_55,0.53,-1,54,55,50
80,r_239_200_171,seq152,r_93_101_110,r_93_101_110,0.84,62,172,110,50
3,r_77_273_27,seq117,seq125,r_77_273_27,0.99,-3,24,27,50
69,r_249_169_83,r_250_210_81,seq203,r_249_169_83,0.95,1,84,83,50
9,r_290_231_52,r_197_252_174,seq193,r_290_231_52,1.0,0,52,52,50
28,r_124_40_60,seq64,r_209_159_40,r_124_40_60,1.0,-2,58,60,50
27,r_106_97_110,r_189_58_16,seq59,r_106_97_110,0.94,0,110,110,50
95,r_7_265_64,r_222_266_92,r_260_243_47,r_222_266_92,0.61,-30,62,92,50
76,r_157_165_76,r_234_156_86,r_7_265_64,r_234_156_86,0.68,-10,76,86,50
13,r_141_220_42,r_166_87_50,r_78_104_50,r_78_104_50,0.98,4,54,50,50
41,r_118_26_122,seq125,r_291_258_87,r_118_26_122,0.92,0,122,122,50
67,r_4_227_174,seq295,r_170_298_134,r_170_298_134,0.75,38,172,134,50
65,r_149_245_55,seq22,seq219,r_149_245_55,0.49,33,88,55,50
11,r_38_95_56,r_260_243_47,r_222_266_92,r_222_266_92,0.81,7,99,92,50
6,r_114_272_59,r_234_156_86,seq138,r_114_272_59,1.0,-1,58,59,50
175,seq218,seq193,r_128_67_48,r_128_67_48,1.0,0,48,48,50
92,r_62_172_4,seq193,r_42_271_34,r_42_271_34,0.85,20,54,34,50
4,r_261_28_101,seq247,seq15,r_261_28_101,0.68,-3,98,101,50
78,r_291_258_87,seq138,seq85,r_291_258_87,0.5,3,90,87,50
0,r_240_46_198,r_284_53_109,r_93_101_110,r_93_101_110,0.75,7,117,110,50
63,r_297_120_140,seq24,r_93_101_110,r_297_120_140,0.6,4,144,140,50
85,r_215_212_63,seq91,r_56_10_36,r_56_10_36,1.0,14,50,36,50
39,r_158_164_13,r_240_46_198,seq191,r_158_164_13,0.86,1,14,13,50
65,r_149_245_55,r_214_221_183,seq22,r_149_245_55,0.97,-1,54,55,50
73,r_280_257_46,seq35,seq31,r_280_257_46,1.0,-2,44,46,50
98,r_65_202_136,seq218,r_93_101_110,r_65_202_136,0.89,0,136,136,50
48,r_139_112_165,seq140,r_288_150_102,r_139_112_165,0.45,2,167,165,50
54,r_45_66_32,r_32_262_87,r_105_207_166,r_45_66_32,0.98,0,32,32,50
51,r_260_243_47,r_32_262_87,r_280_257_46,r_260_243_47,0.6,0,47,47,50
12,r_129_196_146,r_250_210_81,r_167_201_108,r_129_196_146,0.7,3,149,146,50
47,r_128_67_48,seq16,seq218,r_128_67_48,0.75,0,48,48,50
99,r_211_82_65,r_284_53_109,r_293_39_31,r_211_82_65,0.95,-1,64,65,50
66,r_47_36_81,r_149_245_55,r_171_276_69,r_47_36_81,0.9,0,81,81,50
32,r_78_104_50,seq191,r_141_220_42,r_78_104_50,1.0,1,51,50,50
87,r_105_207_166,r_45_66_32,seq19,r_105_207_166,0.73,0,166,166,50
45,r_166_87_50,seq22,seq35,r_166_87_50,0.85,0,50,50,50
8,r_56_10_36,r_214_221_183,seq0,r_56_10_36,0.89,-4,32,36,50
121,seq59,r_293_39_31,r_106_97_110,r_106_97_110,1.0,33,143,110,50
11,r_38_95_56,r_222_266_92,r_260_243_47,r_38_95_56,0.71,1,57,56,50
2,r_109_175_104,seq148,r_60_279_7,r_109_175_104,0.99,0,104,104,50
18,r_214_221_183,seq24,r_126_248_72,r_126_248_72,0.73,111,183,72,50
96,r_235_263_57,r_9_100_84,r_293_39_31,r_293_39_31,0.56,26,57,31,50
29,r_3_180_133,seq138,r_215_212_63,r_3_180_133,0.79,4,137,133,50
24,r_126_248_72,seq59,r_158_164_13,r_126_248_72,1.0,0,72,72,50
25,r_177_168_91,r_55_228_155,seq183,r_177_168_91,0.97,0,91,91,50
121,seq59,r_126_248_72,r_293_39_31,r_126_248_72,0.92,-24,48,72,50
89,r_296_143_22,r_260_243_47,seq193,r_296_143_22,0.9,0,22,22,50
88,r_102_208_66,r_106_97_110,seq140,r_102_208_66,0.99,0,66,66,50
95,r_7_265_64,r_260_243_47,r_157_165_76,r_157_165_76,1.0,3,79,76,50
50,r_237_17_93,seq264,r_77_273_27,r_77_273_27,0.8,60,87,27,50
58,r_170_298_134,seq24,r_161_238_90,r_170_298_134,0.62,1,135,134,50
70,r_9_100_84,seq86,seq48,r_9_100_84,1.0,0,84,84,50
27,r_106_97_110,r_102_208_66,r_189_58_16,r_106_97_110,0.95,-76,34,110,50
167,seq193,seq218,r_290_231_52,r_290_231_52,1.0,0,52,52,50
68,r_161_238_90,seq274,seq115,r_161_238_90,0.83,0,90,90,50
77,r_176_131_171,seq194,r_44_70_142,r_44_70_142,0.91,32,174,142,50
64,r_153_54_57,r_240_46_198,seq13,r_153_54_57,0.97,2,59,57,50
122,seq64,r_124_40_60,r_185_255_196,r_124_40_60,0.66,-30,30,60,50
75,r_288_150_102,seq13,seq16,r_288_150_102,0.94,3,105,102,50
62,r_188_2_38,r_93_101_110,seq117,r_188_2_38,0.94,0,38,38,50
104,seq11,seq29,r_209_159_40,r_209_159_40,1.0,-2,38,40,50
60,r_108_135_166,r_122_213_185,r_44_70_142,r_44_70_142,0.9,25,167,142,50
81,r_44_70_142,seq256,r_45_66_32,r_44_70_142,0.96,0,142,142,50
84,r_42_271_34,seq116,r_62_172_4,r_42_271_34,1.0,-2,32,34,50
61,r_92_52_16,r_122_213_185,seq223,r_92_52_16,0.89,4,20,16,50
26,r_132_287_18,r_240_46_198,seq6,r_132_287_18,0.88,0,18,18,50
90,r_23_27_40,r_171_276_69,seq138,r_23_27_40,0.98,0,40,40,50
22,r_49_147_74,r_291_258_87,seq0,r_49_147_74,0.98,-2,72,74,50
91,r_267_174_151,seq187,seq34,r_267_174_151,0.56,-7,144,151,50
93,r_63_226_46,r_214_221_183,r_76_151_22,r_63_226_46,0.85,-16,30,46,50
56,r_93_101_110,seq216,seq18,r_93_101_110,0.98,0,110,110,50
7,r_99_142_99,r_129_196_146,seq24,r_99_142_99,0.89,1,100,99,50
44,r_197_252_174,seq178,r_299_37_177,r_197_252_174,0.29,1,175,174,50
131,seq90,r_55_228_155,r_189_58_16,r_189_58_16,0.84,139,155,16,50
66,r_47_36_81,r_171_276_69,r_149_245_55,r_47_36_81,0.77,-27,54,81,50
23,r_222_266_92,r_217_69_3,r_38_95_56,r_217_69_3,1.0,90,93,3,50
108,seq18,r_240_46_198,r_93_101_110,r_93_101_110,1.0,9,119,110,50
82,r_71_30_118,seq193,r_293_39_31,r_71_30_118,0.93,1,119,118,50
10,r_293_39_31,r_93_101_110,seq223,r_293_39_31,0.68,-7,24,31,50
79,r_72_232_165,r_246_14_194,r_32_262_87,r_72_232_165,0.61,1,166,165,50
12,r_129_196_146,r_99_142_99,r_250_210_81,r_99_142_99,0.93,-24,75,99,50
87,r_105_207_166,r_167_201_108,r_45_66_32,r_45_66_32,0.64,0,32,32,50
38,r_12_130_55,seq193,seq236,r_12_130_55,0.96,2,57,55,50
93,r_208_215_158,seq18,r_209_1_27,r_208_215_158,0.57,0,158,158,51
30,r_203_269_94,r_105_190_169,seq82,r_203_269_94,1.0,0,94,94,51
82,r_66_237_153,seq225,r_172_178_36,r_66_237_153,0.98,0,153,153,51
51,r_164_94_114,r_205_191_175,r_216_213_24,r_164_94_114,0.98,0,114,114,51
92,r_175_256_162,r_205_191_175,seq18,r_175_256_162,0.58,0,162,162,51
61,r_278_195_25,seq63,seq47,r_278_195_25,1.0,0,25,25,51
14,r_205_191_175,seq131,r_31_106_139,r_205_191_175,0.66,0,175,175,51
54,r_93_98_20,r_105_190_169,seq225,r_93_98_20,0.99,-1,19,20,51
147,seq148,r_277_118_148,r_207_166_65,r_277_118_148,1.0,-82,66,148,51
8,r_294_249_159,seq287,r_172_178_36,r_294_249_159,0.85,0,159,159,51
43,r_41_44_181,seq100,r_105_190_169,r_41_44_181,0.4,-2,179,181,51
146,seq147,r_205_191_175,r_209_1_27,r_205_191_175,1.0,-41,134,175,51
83,r_32_255_163,r_205_191_175,r_0_25_133,r_205_191_175,0.55,-12,163,175,51
37,r_221_15_86,r_130_67_105,r_39_43_58,r_221_15_86,0.8,4,90,86,51
59,r_185_177_147,r_85_136_1,r_232_153_145,r_85_136_1,1.0,145,146,1,51
55,r_110_162_132,seq159,r_240_179_126,r_110_162_132,0.99,1,133,132,51
69,r_22_252_53,seq30,seq281,r_22_252_53,1.0,1,54,53,51
21,r_86_280_63,seq290,seq72,r_86_280_63,0.97,7,70,63,51
39,r_31_106_139,r_79_155_186,seq290,r_31_106_139,0.7,2,141,139,51
165,seq197,r_193_157_51,r_167_223_83,r_167_223_83,0.95,82,165,83,51
1,r_277_118_148,seq281,seq225,r_277_118_148,0.65,0,148,148,51
97,r_123_298_162,seq291,r_167_223_83,r_167_223_83,1.0,79,162,83,51
5,r_145_83_124,seq295,seq231,r_145_83_124,0.83,0,124,124,51
111,seq34,r_6_107_185,r_113_272_65,r_113_272_65,1.0,29,94,65,51
45,r_154_20_51,seq28,r_244_204_52,r_154_20_51,0.99,0,51,51,51
19,r_285_26_129,seq198,r_110_162_132,r_285_26_129,0.93,2,131,129,51
153,seq158,seq222,r_250_271_35,r_250_271_35,0.99,83,118,35,51
95,r_224_76_71,seq14,r_102_70_1,r_224_76_71,1.0,0,71,71,51
66,r_257_239_122,seq14,r_53_202_73,r_257_239_122,1.0,0,122,122,51
31,r_45_89_60,r_193_157_51,seq295,r_45_89_60,1.0,0,60,60,51
41,r_276_274_169,r_85_136_1,r_23_282_94,r_276_274_169,0.76,0,169,169,51
67,r_23_282_94,r_243_188_118,seq2,r_23_282_94,0.94,1,95,94,51
89,r_170_91_103,r_230_139_117,seq30,r_230_139_117,1.0,0,117,117,51
10,r_275_196_103,r_105_190_169,seq40,r_275_196_103,0.93,2,105,103,51
139,seq131,r_0_25_133,r_48_61_52,r_48_61_52,0.91,81,133,52,51
78,r_73_266_151,seq163,r_78_181_18,r_73_266_151,0.88,0,151,151,51
0,r_243_188_118,seq17,seq144,r_243_188_118,1.0,0,118,118,51
20,r_49_125_69,seq231,seq140,r_49_125_69,0.99,0,69,69,51
13,r_167_223_83,r_277_118_148,seq13,r_167_223_83,1.0,2,85,83,51
98,r_226_248_86,seq27,seq77,r_226_248_86,1.0,1,87,86,51
15,r_113_272_65,r_243_188_118,seq34,r_113_272_65,0.76,0,65,65,51
48,r_244_204_52,r_205_191_175,r_278_195_25,r_244_204_52,0.95,10,62,52,51
167,seq200,r_69_112_177,r_0_25_133,r_0_25_133,0.95,44,177,133,51
6,r_120_133_130,seq90,seq64,r_120_133_130,0.96,0,130,130,51
62,r_101_21_100,r_31_106_139,r_78_181_18,r_101_21_100,0.61,0,100,100,51
85,r_230_139_117,r_170_91_103,r_45_89_60,r_230_139_117,0.95,0,117,117,51
99,r_9_176_107,seq171,seq126,r_9_176_107,0.88,0,107,107,51
27,r_240_179_126,r_205_191_175,seq144,r_240_179_126,0.96,0,126,126,51
136,seq126,r_201_273_190,r_9_176_107,r_9_176_107,0.99,1,108,107,51
87,r_36_121_126,r_79_155_186,r_167_223_83,r_36_121_126,0.91,0,126,126,51
2,r_6_107_185,seq34,r_102_70_1,r_6_107_185,0.23,5,190,185,51
47,r_218_3_170,seq75,r_170_91_103,r_218_3_170,0.54,0,170,170,51
142,seq140,r_41_44_181,r_49_125_69,r_49_125_69,1.0,10,79,69,51
40,r_42_293_137,seq5,seq163,r_42_293_137,0.78,0,137,137,51
29,r_251_109_153,seq40,r_145_83_124,r_251_109_153,0.81,1,154,153,51
189,seq284,r_230_139_117,r_165_116_18,r_165_116_18,0.62,5,23,18,51
157,seq168,r_170_91_103,r_103_229_78,r_103_229_78,1.0,45,123,78,51
24,r_220_169_100,seq144,seq18,r_220_169_100,0.79,8,108,100,51
36,r_24_235_52,r_68_186_132,seq261,r_24_235_52,1.0,0,52,52,51
64,r_62_297_61,seq289,seq63,r_62_297_61,1.0,0,61,61,51
42,r_216_213_24,r_73_266_151,seq184,r_216_213_24,0.74,-10,14,24,51
88,r_130_67_105,seq246,seq198,r_130_67_105,1.0,1,106,105,51
50,r_119_258_150,seq100,r_103_229_78,r_103_229_78,0.72,75,153,78,51
58,r_33_80_129,seq57,seq40,r_33_80_129,0.95,0,129,129,51
65,r_265_19_66,seq27,r_173_7_29,r_265_19_66,1.0,0,66,66,51
25,r_193_157_51,seq13,seq197,r_193_157_51,0.51,7,58,51,51
32,r_207_166_65,seq47,seq148,r_207_166_65,0.3,34,99,65,51
63,r_236_214_14,r_95_55_195,seq247,r_236_214_14,1.0,0,14,14,51
38,r_279_10_75,r_31_106_139,seq138,r_279_10_75,1.0,-1,74,75,51
52,r_92_104_131,seq111,r_50_12_87,r_50_12_87,1.0,44,131,87,51
108,seq27,r_128_54_157,seq180,r_128_54_157,1.0,-7,150,157,51
77,r_88_16_87,r_115_219_197,seq246,r_88_16_87,0.93,0,87,87,51
169,seq211,r_142_84_132,r_265_19_66,r_265_19_66,1.0,70,136,66,51
34,r_97_117_152,r_205_191_175,r_74_58_135,r_97_117_152,0.58,0,152,152,51
132,seq100,r_119_258_150,r_39_43_58,r_39_43_58,1.0,95,153,58,51
60,r_134_212_147,seq262,seq291,r_134_212_147,0.87,0,147,147,51
81,r_99_189_166,seq247,r_23_282_94,r_99_189_166,0.85,0,166,166,51
17,r_242_135_126,seq138,seq259,r_242_135_126,0.76,0,126,126,51
94,r_87_233_167,seq187,r_74_58_135,r_87_233_167,0.91,0,167,167,51
145,seq144,r_220_169_100,r_243_188_118,r_243_188_118,0.92,3,121,118,51
96,r_128_54_157,seq27,seq222,r_128_54_157,0.92,0,157,157,51
57,r_78_181_18,r_227_56_167,seq14,r_78_181_18,0.99,0,18,18,51
86,r_137_194_25,r_277_118_148,seq149,r_137_194_25,1.0,0,25,25,51
90,r_199_234_40,r_257_239_122,seq222,r_199_234_40,1.0,0,40,40,51
46,r_209_1_27,r_205_191_175,seq77,r_205_191_175,0.82,-116,59,175,51
7,r_250_271_35,r_206_253_150,seq299,r_250_271_35,1.0,0,35,35,51
22,r_227_56_167,seq108,r_33_80_129,r_227_56_167,0.63,0,167,167,51
28,r_50_12_87,r_294_249_159,seq151,r_50_12_87,0.56,0,87,87,51
91,r_192_146_104,r_6_107_185,seq200,r_192_146_104,1.0,1,105,104,51
74,r_165_116_18,r_277_118_148,seq284,r_165_116_18,1.0,0,18,18,51
68,r_173_7_29,r_243_188_118,seq211,r_173_7_29,1.0,0,29,29,51
56,r_103_229_78,seq46,seq168,r_103_229_78,1.0,0,78,78,51
75,r_172_178_36,r_53_202_73,seq247,r_172_178_36,1.0,1,37,36,51
11,r_48_61_52,r_279_10_75,seq131,r_48_61_52,1.0,0,52,52,51
108,seq27,r_226_248_86,r_128_54_157,r_226_248_86,1.0,1,87,86,51
79,r_79_155_186,seq247,r_29_254_161,r_79_155_186,0.31,0,186,186,51
12,r_53_202_73,r_208_215_158,seq82,r_53_202_73,1.0,2,75,73,51
26,r_39_43_58,seq183,seq100,r_39_43_58,1.0,0,58,58,51
84,r_8_238_82,r_206_253_150,r_78_181_18,r_8_238_82,0.96,0,82,82,51
93,r_24_271_180,r_99_65_24,r_198_195_71,r_24_271_180,0.42,6,186,180,52
30,r_222_70_88,r_191_280_128,seq252,r_191_280_128,1.0,-29,99,128,52
36,r_261_31_138,r_26_52_156,seq184,r_261_31_138,0.8,1,139,138,52
122,seq86,seq97,r_216_164_65,r_216_164_65,1.0,12,77,65,52
64,r_82_286_33,r_157_75_156,seq218,r_82_286_33,0.89,1,34,33,52
87,r_234_183_28,r_77_162_48,r_93_123_154,r_234_183_28,0.54,0,28,28,52
8,r_136_67_93,r_191_280_128,r_204_83_166,r_136_67_93,0.73,0,93,93,52
53,r_270_32_141,seq184,r_108_291_12,r_270_32_141,0.77,2,143,141,52
43,r_138_13_34,r_274_177_34,r_8_132_163,r_8_132_163,1.0,-85,78,163,52
54,r_166_103_139,r_170_79_167,r_131_227_23,r_170_79_167,0.9,-28,139,167,52
83,r_60_109_56,seq130,r_23_33_36,r_23_33_36,0.98,24,60,36,52
55,r_175_76_176,r_22_14_6,r_131_227_23,r_22_14_6,0.48,170,176,6,52
71,r_244_100_79,r_248_122_76,r_56_276_182,r_244_100_79,1.0,0,79,79,52
16,r_9_6_10,r_205_240_191,r_16_150_84,r_16_150_84,1.0,20,104,84,52
39,r_59_278_161,seq72,r_214_212_110,r_59_278_161,0.72,1,162,161,52
25,r_189_115_65,r_56_276_182,r_267_258_98,r_267_258_98,0.7,14,112,98,52
1,r_265_54_159,seq169,r_108_291_12,r_265_54_159,0.49,5,164,159,52
5,r_179_272_95,seq236,r_22_14_6,r_179_272_95,0.85,5,100,95,52
46,r_247_39_148,seq50,seq285,r_247_39_148,0.57,0,148,148,52
42,r_133_34_186,r_151_185_120,seq102,r_151_185_120,1.0,-44,76,120,52
61,r_36_220_17,r_157_75_156,r_58_238_195,r_36_220_17,0.82,0,17,17,52
80,r_170_79_167,r_248_122_76,r_196_268_8,r_170_79_167,0.66,0,167,167,52
37,r_51_128_30,r_237_94_48,seq180,r_237_94_48,0.64,-18,30,48,52
19,r_108_291_12,r_216_164_65,seq225,r_108_291_12,0.88,0,12,12,52
69,r_62_242_85,seq180,seq283,r_62_242_85,0.99,1,86,85,52
15,r_3_275_42,r_157_75_156,seq125,r_3_275_42,0.84,6,48,42,52
45,r_192_263_128,seq28,r_136_67_93,r_192_263_128,0.89,0,128,128,52
90,r_208_259_12,r_15_273_48,r_257_116_177,r_257_116_177,0.89,-165,12,177,52
158,seq180,r_62_242_85,r_105_96_22,r_62_242_85,0.98,1,86,85,52
95,r_161_202_142,seq92,r_4_264_17,r_161_202_142,0.87,5,147,142,52
31,r_243_10_130,seq180,seq92,r_243_10_130,0.88,0,130,130,52
41,r_43_287_96,r_56_276_182,seq223,r_43_287_96,0.96,0,96,96,52
49,r_85_119_33,r_38_289_93,r_35_135_186,r_85_119_33,1.0,0,33,33,52
67,r_2_68_12,r_107_153_13,r_204_83_166,r_2_68_12,0.6,0,12,12,52
22,r_274_177_34,r_80_146_121,seq169,r_274_177_34,1.0,0,34,34,52
109,seq48,r_99_65_24,r_151_185_120,r_151_185_120,1.0,7,127,120,52
26,r_61_207_175,r_99_65_24,r_4_264_17,r_99_65_24,0.56,151,175,24,52
72,r_29_217_64,r_190_42_119,seq19,r_29_217_64,0.78,2,66,64,52
179,seq236,r_179_272_95,r_245_200_60,r_245_200_60,0.92,35,95,60,52
170,seq215,r_147_178_176,r_77_162_48,r_77_162_48,1.0,26,74,48,52
4,r_250_269_62,r_204_83_166,seq124,r_250_269_62,1.0,0,62,62,52
73,r_90_158_67,seq84,seq19,r_90_158_67,0.98,0,67,67,52
138,seq125,r_126_241_93,r_3_275_42,r_126_241_93,0.67,-40,53,93,52
20,r_216_164_65,seq218,seq86,r_216_164_65,0.98,0,65,65,52
98,r_249_279_158,r_265_54_159,r_243_10_130,r_243_10_130,0.98,51,181,130,52
74,r_23_33_36,r_157_75_156,r_60_109_56,r_157_75_156,0.95,-63,93,156,52
48,r_1_127_86,seq292,r_126_241_93,r_126_241_93,0.9,4,97,93,52
49,r_85_119_33,r_35_135_186,seq102,r_85_119_33,0.47,153,186,33,52
91,r_57_233_174,r_104_296_30,r_214_212_110,r_57_233_174,0.82,1,175,174,52
74,r_23_33_36,seq181,r_157_75_156,r_23_33_36,1.0,2,38,36,52
62,r_40_253_157,seq121,r_248_122_76,r_40_253_157,0.44,2,159,157,52
29,r_93_123_154,r_4_264_17,r_234_183_28,r_234_183_28,0.94,1,29,28,52
99,r_20_143_169,seq251,r_138_13_34,r_20_143_169,0.47,5,174,169,52
52,r_35_135_186,r_85_119_33,r_104_296_30,r_85_119_33,0.47,153,186,33,52
87,r_234_183_28,r_93_123_154,r_4_264_17,r_234_183_28,0.44,150,178,28,52
192,seq290,seq21,r_47_232_21,r_47_232_21,1.0,-3,18,21,52
27,r_176_30_84,r_35_135_186,r_88_18_53,r_176_30_84,1.0,0,84,84,52
136,seq121,r_40_253_157,seq262,r_40_253_157,0.99,2,159,157,52
2,r_157_75_156,r_57_233_174,seq155,r_157_75_156,0.5,0,156,156,52
47,r_78_44_176,r_57_233_174,r_261_31_138,r_78_44_176,0.43,1,177,176,52
40,r_145_228_89,seq95,seq27,r_145_228_89,0.84,2,91,89,52
18,r_191_280_128,r_25_106_135,r_176_30_84,r_176_30_84,0.7,44,128,84,52
25,r_189_115_65,r_265_54_159,r_56_276_182,r_189_115_65,1.0,1,66,65,52
33,r_204_83_166,r_250_269_62,r_51_128_30,r_250_269_62,1.0,0,62,62,52
157,seq172,r_89_186_153,r_15_273_48,r_15_273_48,0.66,5,53,48,52
13,r_237_94_48,seq86,seq134,r_237_94_48,0.97,2,50,48,52
88,r_288_11_161,r_170_79_167,r_138_13_34,r_138_13_34,0.81,130,164,34,52
60,r_88_18_53,seq118,seq5,r_88_18_53,0.99,0,53,53,52
58,r_81_139_99,seq225,r_58_238_195,r_81_139_99,0.68,0,99,99,52
70,r_245_200_60,seq252,seq236,r_245_200_60,1.0,1,61,60,52
79,r_257_116_177,r_110_188_122,r_208_259_12,r_257_116_177,0.7,-139,38,177,52
65,r_16_150_84,r_176_30_84,r_9_6_10,r_9_6_10,1.0,99,109,10,52
21,r_38_289_93,r_85_119_33,seq27,r_85_119_33,1.0,0,33,33,52
14,r_104_296_30,r_281_256_39,r_99_65_24,r_104_296_30,0.85,0,30,30,52
130,seq102,r_255_17_164,r_85_119_33,r_85_119_33,0.83,131,164,33,52
32,r_255_17_164,seq102,r_23_33_36,r_255_17_164,0.67,0,164,164,52
38,r_151_185_120,r_133_34_186,seq48,r_151_185_120,0.99,0,120,120,52
52,r_35_135_186,r_176_30_84,r_85_119_33,r_35_135_186,0.98,-102,84,186,52
114,seq63,r_151_185_120,r_46_12_54,r_46_12_54,0.69,0,54,54,52
77,r_190_42_119,seq290,r_131_227_23,r_190_42_119,0.96,1,120,119,52
96,r_281_256_39,seq64,r_47_232_21,r_281_256_39,1.0,0,39,39,52
97,r_77_162_48,seq206,seq215,r_77_162_48,1.0,0,48,48,52
92,r_47_232_21,r_81_139_99,seq290,r_47_232_21,0.95,-3,18,21,52
34,r_80_146_121,r_56_276_182,seq114,r_80_146_121,0.4,22,143,121,52
17,r_267_258_98,seq87,r_189_115_65,r_189_115_65,1.0,37,102,65,52
94,r_168_71_108,r_157_75_156,seq102,r_168_71_108,0.99,0,108,108,52
9,r_174_182_45,r_198_195_71,seq84,r_174_182_45,0.87,26,71,45,52
51,r_173_148_39,r_209_254_143,seq283,r_173_148_39,1.0,0,39,39,52
56,r_15_273_48,seq121,seq172,r_15_273_48,0.99,0,48,48,52
29,r_93_123_154,r_234_183_28,seq260,r_234_183_28,0.53,150,178,28,52
91,r_57_233_174,r_157_75_156,r_104_296_30,r_104_296_30,0.79,126,156,30,52
7,r_198_195_71,r_174_182_45,r_15_273_48,r_15_273_48,0.99,37,85,48,52
44,r_126_241_93,seq125,seq152,r_126_241_93,0.98,0,93,93,52
118,seq72,r_59_278_161,r_107_153_13,r_59_278_161,0.66,1,162,161,52
179,seq236,r_245_200_60,r_224_197_140,r_224_197_140,1.0,23,163,140,52
23,r_214_212_110,r_147_178_176,seq283,r_214_212_110,0.78,0,110,110,52
82,r_89_186_153,r_58_238_195,r_131_227_23,r_58_238_195,0.79,-42,153,195,52
6,r_131_227_23,r_198_195_71,seq218,r_131_227_23,0.89,0,23,23,52
57,r_46_12_54,r_250_269_62,seq63,r_46_12_54,1.0,0,54,54,52
93,r_147_248_167,r_176_146_172,r_130_189_101,r_147_248_167,0.61,0,167,167,53
44,r_185_93_22,r_176_146_172,r_201_220_110,r_201_220_110,1.0,62,172,110,53
122,seq64,r_180_62_173,r_231_214_33,r_231_214_33,1.0,140,173,33,53
44,r_185_93_22,r_252_198_134,r_176_146_172,r_185_93_22,0.77,-9,13,22,53
8,r_278_98_161,seq75,seq0,r_278_98_161,0.74,0,161,161,53
53,r_261_38_160,seq104,seq253,r_261_38_160,0.89,0,160,160,53
43,r_168_256_132,seq258,r_249_229_77,r_168_256_132,0.81,1,133,132,53
197,seq295,r_284_207_181,r_137_276_171,r_137_276_171,0.99,10,181,171,53
146,seq139,r_137_276_171,r_89_45_43,r_89_45_43,1.0,108,151,43,53
37,r_196_173_72,r_40_289_108,seq69,r_196_173_72,1.0,0,72,72,53
55,r_232_218_121,r_66_172_183,r_194_263_110,r_232_218_121,1.0,0,121,121,53
71,r_127_224_157,seq85,seq217,r_127_224_157,0.86,0,157,157,53
86,r_273_210_84,r_249_229_77,r_108_153_32,r_273_210_84,0.99,0,84,84,53
16,r_281_132_66,seq283,r_72_52_12,r_281_132_66,0.99,1,67,66,53
21,r_275_35_82,r_130_189_101,seq283,r_275_35_82,1.0,0,82,82,53
165,seq217,r_22_175_98,seq246,r_22_175_98,1.0,0,98,98,53
97,r_265_118_148,r_249_229_77,seq123,r_265_118_148,0.94,0,148,148,53
5,r_103_279_187,seq99,r_240_78_36,r_240_78_36,0.64,151,187,36,53
46,r_114_18_104,r_261_38_160,r_88_86_70,r_114_18_104,1.0,-1,103,104,53
69,r_186_221_65,r_201_220_110,r_200_36_53,r_186_221_65,0.99,3,68,65,53
45,r_277_140_121,seq206,seq251,r_277_140_121,1.0,0,121,121,53
73,r_240_78_36,r_147_248_167,seq223,r_240_78_36,0.94,4,40,36,53
19,r_280_92_144,seq234,seq64,r_280_92_144,0.95,0,144,144,53
75,r_177_192_37,seq74,r_227_257_193,r_177_192_37,1.0,1,38,37,53
85,r_56_235_43,r_40_289_108,seq298,r_56_235_43,1.0,0,43,43,53
50,r_72_52_12,r_180_62_173,r_37_63_169,r_37_63_169,0.61,-159,10,169,53
11,r_50_293_65,r_106_1_169,r_294_181_10,r_106_1_169,0.59,-3,166,169,53
95,r_158_90_100,r_15_126_152,seq96,r_15_126_152,0.94,-30,122,152,53
66,r_204_191_80,r_40_289_108,seq205,r_204_191_80,1.0,0,80,80,53
14,r_176_146_172,r_8_222_31,r_185_93_22,r_8_222_31,0.87,2,33,31,53
31,r_9_115_79,r_66_172_183,seq260,r_66_172_183,0.49,-104,79,183,53
41,r_11_79_199,seq183,r_105_82_121,r_105_82_121,1.0,6,127,121,53
67,r_141_29_61,r_265_118_148,r_14_271_39,r_265_118_148,0.97,-84,64,148,53
89,r_129_255_112,r_278_98_161,r_101_54_88,r_101_54_88,0.59,24,112,88,53
39,r_264_159_17,r_105_82_121,r_287_285_169,r_264_159_17,0.5,0,17,17,53
3,r_105_82_121,r_107_225_130,r_11_79_199,r_105_82_121,0.99,0,121,121,53
90,r_101_54_88,seq0,r_113_154_95,r_113_154_95,0.82,9,104,95,53
26,r_252_198_134,seq83,r_88_86_70,r_252_198_134,0.97,0,134,134,53
180,seq251,seq245,r_277_140_121,r_277_140_121,1.0,2,123,121,53
91,r_290_60_30,r_277_140_121,seq223,r_290_60_30,1.0,0,30,30,53
14,r_176_146_172,r_185_93_22,r_128_297_171,r_176_146_172,0.86,0,172,172,53
4,r_162_190_99,seq5,seq74,r_162_190_99,1.0,0,99,99,53
78,r_124_58_142,seq5,r_177_192_37,r_124_58_142,0.96,0,142,142,53
11,r_50_293_65,r_114_18_104,r_106_1_169,r_50_293_65,1.0,0,65,65,53
20,r_17_174_178,seq64,r_272_244_144,r_17_174_178,0.76,0,178,178,53
13,r_34_10_91,r_148_24_1,r_155_23_55,r_34_10_91,1.0,0,91,91,53
98,r_136_32_23,r_66_172_183,seq57,r_136_32_23,1.0,0,23,23,53
15,r_53_80_91,seq20,seq228,r_53_80_91,1.0,0,91,91,53
57,r_84_211_80,seq223,r_163_122_45,r_84_211_80,0.7,0,80,80,53
79,r_201_220_110,seq70,seq193,r_201_220_110,0.99,0,110,110,53
167,seq223,r_84_211_80,r_240_78_36,r_84_211_80,0.97,0,80,80,53
6,r_227_257_193,r_150_3_99,r_177_192_37,r_227_257_193,0.91,-93,100,193,53
62,r_142_21_59,r_252_198_134,seq47,r_142_21_59,1.0,2,61,59,53
27,r_155_23_55,r_15_126_152,seq95,r_15_126_152,0.8,-96,56,152,53
10,r_231_214_33,seq6,r_8_222_31,r_231_214_33,1.0,0,33,33,53
48,r_37_63_169,r_199_87_151,r_72_52_12,r_72_52_12,0.85,6,18,12,53
161,seq205,r_199_87_151,r_204_191_80,r_204_191_80,0.72,2,82,80,53
134,seq94,seq243,r_294_181_10,r_294_181_10,0.4,130,140,10,53
51,r_135_270_161,r_278_98_161,seq282,r_135_270_161,0.6,0,161,161,53
87,r_121_26_74,r_12_28_74,seq64,r_121_26_74,1.0,0,74,74,53
84,r_15_126_152,r_195_116_102,r_290_60_30,r_15_126_152,0.84,-1,151,152,53
51,r_135_270_161,r_162_190_99,r_278_98_161,r_162_190_99,0.93,-46,53,99,53
2,r_40_289_108,seq25,r_9_115_79,r_40_289_108,1.0,0,108,108,53
40,r_119_43_69,r_284_207_181,seq205,r_119_43_69,0.63,1,70,69,53
29,r_137_276_171,seq139,r_148_24_1,r_137_276_171,0.51,0,171,171,53
25,r_150_3_99,r_227_257_193,r_249_229_77,r_150_3_99,0.99,1,100,99,53
48,r_37_63_169,r_72_52_12,r_194_263_110,r_194_263_110,1.0,8,118,110,53
127,seq71,r_281_132_66,r_109_144_8,r_281_132_66,1.0,-1,65,66,53
64,r_145_239_134,seq282,r_34_10_91,r_145_239_134,0.98,0,134,134,53
165,seq217,seq246,r_127_224_157,r_127_224_157,1.0,4,161,157,53
88,r_120_76_74,seq20,seq125,r_120_76_74,1.0,0,74,74,53
58,r_182_233_73,r_249_229_77,r_109_144_8,r_182_233_73,1.0,0,73,73,53
77,r_163_122_45,r_252_198_134,seq4,r_163_122_45,1.0,0,45,45,53
65,r_284_207_181,seq295,r_281_132_66,r_281_132_66,1.0,115,181,66,53
192,seq283,seq71,r_275_35_82,r_275_35_82,1.0,16,98,82,53
155,seq183,r_11_79_199,r_264_159_17,r_264_159_17,1.0,125,142,17,53
68,r_27_31_140,seq228,r_272_244_144,r_272_244_144,1.0,6,150,144,53
63,r_287_285_169,seq183,r_264_159_17,r_264_159_17,1.0,18,35,17,53
61,r_73_274_77,seq125,seq234,r_73_274_77,1.0,1,78,77,53
92,r_14_271_39,seq2,seq295,r_14_271_39,0.98,1,40,39,53
32,r_130_189_101,seq260,r_141_29_61,r_130_189_101,1.0,0,101,101,53
38,r_194_263_110,seq49,r_232_218_121,r_194_263_110,0.95,9,119,110,53
196,seq292,r_12_28_74,r_108_153_32,r_12_28_74,0.61,-7,67,74,53
36,r_8_222_31,r_176_146_172,r_231_214_33,r_8_222_31,0.74,2,33,31,53
47,r_108_153_32,seq253,seq292,r_108_153_32,0.99,0,32,32,53
80,r_161_110_58,r_230_202_148,r_264_159_17,r_161_110_58,1.0,0,58,58,53
48,r_37_63_169,r_194_263_110,r_195_116_102,r_37_63_169,0.72,0,169,169,53
132,seq85,r_127_224_157,r_130_189_101,r_130_189_101,0.96,56,157,101,53
24,r_296_156_34,seq219,seq104,r_296_156_34,1.0,0,34,34,53
60,r_272_244_144,seq47,r_27_31_140,r_272_244_144,0.97,1,145,144,53
81,r_134_81_83,seq178,r_155_23_55,r_134_81_83,1.0,0,83,83,53
17,r_199_87_151,seq205,r_22_175_98,r_199_87_151,0.77,0,151,151,53
9,r_200_36_53,r_278_98_161,r_186_221_65,r_186_221_65,0.66,21,86,65,53
50,r_72_52_12,r_37_63_169,r_281_132_66,r_281_132_66,0.96,8,74,66,53
99,r_89_45_43,seq213,seq139,r_89_45_43,0.98,1,44,43,53
28,r_230_202_148,r_137_276_171,seq268,r_137_276_171,0.55,-23,148,171,53
102,seq4,seq70,r_163_122_45,r_163_122_45,1.0,24,69,45,53
49,r_33_68_65,seq7,seq254,r_33_68_65,1.0,0,65,65,53
56,r_113_154_95,r_162_190_99,seq20,r_113_154_95,0.92,0,95,95,53
185,seq260,r_130_189_101,r_9_115_79,r_130_189_101,1.0,0,101,101,53
131,seq83,r_252_198_134,seq49,r_252_198_134,0.98,0,134,134,53
94,r_157_16_58,seq262,r_155_23_55,r_157_16_58,1.0,0,58,58,53
23,r_22_175_98,seq217,seq125,r_22_175_98,0.98,0,98,98,53
82,r_102_44_85,r_22_175_98,seq5,r_102_44_85,0.98,1,86,85,53
186,seq262,r_66_172_183,r_272_244_144,r_272_244_144,0.98,6,150,144,53
79,r_201_220_110,r_186_221_65,seq70,r_186_221_65,0.48,3,68,65,53
35,r_12_28_74,r_121_26_74,r_27_31_140,r_12_28_74,1.0,0,74,74,53
74,r_117_216_16,r_168_256_132,seq213,r_168_256_132,0.6,-116,16,132,53
22,r_179_160_47,r_15_126_152,r_177_192_37,r_179_160_47,1.0,0,47,47,53
12,r_66_172_183,seq262,r_287_285_169,r_66_172_183,0.4,-1,182,183,53
182,seq254,r_145_239_134,r_33_68_65,r_33_68_65,0.96,22,87,65,53
84,r_15_126_152,r_158_90_100,r_195_116_102,r_195_116_102,0.99,20,122,102,53
128,seq74,seq178,r_162_190_99,r_162_190_99,1.0,7,106,99,53
93,r_259_258_161,seq174,r_133_199_75,r_133_199_75,0.92,86,161,75,54
24,r_191_189_34,r_239_255_31,seq61,r_191_189_34,0.79,2,36,34,54
30,r_281_73_108,seq295,r_125_43_89,r_125_43_89,0.37,21,110,89,54
51,r_274_170_113,seq99,r_269_194_48,r_274_170_113,0.95,0,113,113,54
36,r_186_148_150,r_294_80_2,r_75_66_34,r_186_148_150,0.86,0,150,150,54
92,r_24_247_178,r_131_162_167,r_245_284_35,r_245_284_35,0.96,133,168,35,54
97,r_264_21_45,r_71_83_94,r_197_229_174,r_264_21_45,1.0,0,45,45,54
8,r_190_35_75,r_225_279_180,seq50,r_190_35_75,1.0,0,75,75,54
53,r_197_229_174,seq55,r_60_124_119,r_197_229_174,0.65,0,174,174,54
43,r_147_211_182,seq89,seq58,r_147_211_182,0.25,0,182,182,54
89,r_33_285_50,seq298,seq138,r_33_285_50,1.0,0,50,50,54
81,r_121_94_13,r_114_32_9,r_260_23_101,r_260_23_101,0.85,-1,100,101,54
37,r_29_65_132,seq69,seq10,r_29_65_132,0.95,1,133,132,54
72,r_245_284_35,r_60_124_119,seq99,r_245_284_35,1.0,0,35,35,54
86,r_119_122_173,seq88,r_149_188_4,r_119_122_173,0.61,0,173,173,54
16,r_31_160_167,seq276,r_18_48_55,r_18_48_55,0.35,112,167,55,54
66,r_187_52_37,r_54_95_183,r_4_96_28,r_187_52_37,1.0,0,37,37,54
1,r_141_291_185,seq138,r_282_234_170,r_282_234_170,0.94,16,186,170,54
5,r_202_250_184,seq58,r_153_222_119,r_202_250_184,0.65,0,184,184,54
42,r_133_199_75,r_71_83_94,r_165_221_163,r_133_199_75,1.0,0,75,75,54
80,r_203_287_138,seq70,r_71_83_94,r_203_287_138,0.74,0,138,138,54
69,r_272_181_92,r_230_267_168,seq276,r_272_181_92,0.99,2,94,92,54
94,r_293_209_16,r_157_246_99,seq224,r_293_209_16,0.84,0,16,16,54
34,r_45_92_103,r_6_77_69,r_184_127_120,r_45_92_103,0.7,17,120,103,54
19,r_132_22_168,r_197_229_174,r_2_117_163,r_132_22_168,0.53,0,168,168,54
15,r_84_175_185,r_118_15_100,seq111,r_118_15_100,1.0,0,100,100,54
158,seq174,r_259_258_161,r_156_143_146,r_259_258_161,0.91,0,161,161,54
95,r_294_80_2,r_186_148_150,r_11_128_75,r_294_80_2,0.53,127,129,2,54
82,r_101_249_51,seq9,seq201,r_101_249_51,1.0,0,51,51,54
20,r_220_130_16,r_157_246_99,seq159,r_220_130_16,0.48,5,21,16,54
103,seq10,r_153_222_119,seq129,r_153_222_119,0.98,1,120,119,54
41,r_11_128_75,r_153_222_119,r_294_80_2,r_11_128_75,1.0,0,75,75,54
81,r_121_94_13,r_141_291_185,r_114_32_9,r_121_94_13,0.84,-1,12,13,54
31,r_18_48_55,r_157_246_99,seq16,r_18_48_55,1.0,0,55,55,54
10,r_232_261_181,seq28,r_31_160_167,r_31_160_167,0.99,19,186,167,54
26,r_2_117_163,seq163,r_132_22_168,r_2_117_163,0.65,7,170,163,54
4,r_36_20_103,r_81_296_76,r_63_266_18,r_81_296_76,1.0,0,76,76,54
78,r_41_200_66,seq16,r_210_74_6,r_41_200_66,1.0,0,66,66,54
0,r_153_222_119,seq10,seq195,r_153_222_119,0.88,1,120,119,54
73,r_26_91_126,seq97,r_210_74_6,r_26_91_126,0.99,0,126,126,54
11,r_105_64_182,seq55,r_60_124_119,r_105_64_182,0.38,0,182,182,54
59,r_75_66_34,r_259_258_161,seq82,r_75_66_34,0.88,0,34,34,54
117,seq55,r_197_229_174,r_208_108_52,r_208_108_52,1.0,122,174,52,54
85,r_81_296_76,r_36_20_103,seq55,r_81_296_76,1.0,1,77,76,54
2,r_225_279_180,r_232_261_181,seq206,r_225_279_180,0.83,0,180,180,54
161,seq180,r_169_3_6,r_280_14_93,r_280_14_93,1.0,3,96,93,54
27,r_71_83_94,r_133_199_75,seq213,r_133_199_75,0.99,0,75,75,54
87,r_87_136_108,seq112,r_238_227_51,r_87_136_108,0.98,0,108,108,54
39,r_113_86_56,seq289,seq164,r_113_86_56,1.0,0,56,56,54
2,r_225_279_180,r_190_35_75,r_232_261_181,r_190_35_75,1.0,0,75,75,54
47,r_165_221_163,r_202_250_184,r_133_199_75,r_133_199_75,1.0,1,76,75,54
142,seq138,r_141_291_185,r_11_128_75,r_11_128_75,1.0,111,186,75,54
79,r_102_158_9,r_38_178_146,seq99,r_102_158_9,0.89,1,10,9,54
40,r_167_93_138,seq166,r_243_7_124,r_167_93_138,0.86,0,138,138,54
105,seq17,seq112,r_243_7_124,r_243_7_124,1.0,3,127,124,54
74,r_271_204_170,seq196,r_71_83_94,r_271_204_170,0.65,0,170,170,54
18,r_104_126_143,seq159,seq151,r_104_126_143,0.74,6,149,143,54
29,r_157_246_99,seq240,r_37_231_13,r_157_246_99,0.96,4,103,99,54
55,r_4_96_28,r_186_148_150,r_187_52_37,r_4_96_28,0.93,10,38,28,54
25,r_185_273_63,r_8_59_197,seq135,r_185_273_63,0.99,0,63,63,54
88,r_1_244_51,r_60_124_119,seq201,r_1_244_51,1.0,2,53,51,54
33,r_260_23_101,r_202_250_184,r_121_94_13,r_260_23_101,1.0,1,102,101,54
64,r_60_124_119,seq295,seq233,r_60_124_119,1.0,1,120,119,54
191,seq275,r_197_229_174,r_208_108_52,r_208_108_52,1.0,114,166,52,54
47,r_165_221_163,r_133_199_75,r_281_73_108,r_165_221_163,0.99,0,163,163,54
50,r_27_237_76,seq298,r_269_194_48,r_27_237_76,1.0,2,78,76,54
58,r_120_139_84,seq242,seq262,r_120_139_84,1.0,0,84,84,54
70,r_183_56_95,seq89,r_146_286_85,r_183_56_95,1.0,1,96,95,54
65,r_125_43_89,seq155,seq163,r_125_43_89,1.0,0,89,89,54
42,r_133_199_75,r_165_221_163,r_259_258_161,r_133_199_75,0.9,88,163,75,54
32,r_192_57_149,seq82,seq28,r_192_57_149,0.96,0,149,149,54
52,r_239_255_31,seq42,r_116_106_4,r_239_255_31,0.44,63,94,31,54
90,r_142_297_27,seq137,seq150,r_142_297_27,1.0,1,28,27,54
77,r_38_178_146,seq224,r_18_48_55,r_18_48_55,0.99,95,150,55,54
75,r_6_77_69,r_31_160_167,r_293_209_16,r_6_77_69,1.0,0,69,69,54
15,r_84_175_185,r_198_228_28,r_118_15_100,r_198_228_28,1.0,0,28,28,54
48,r_269_194_48,r_29_65_132,r_37_231_13,r_269_194_48,1.0,2,50,48,54
60,r_19_283_89,r_186_148_150,seq196,r_19_283_89,1.0,1,90,89,54
17,r_146_286_85,r_232_261_181,seq53,r_232_261_181,0.59,-119,62,181,54
63,r_72_47_17,seq214,seq135,r_72_47_17,0.87,0,17,17,54
22,r_198_228_28,r_84_175_185,seq76,r_198_228_28,1.0,0,28,28,54
4,r_36_20_103,r_63_266_18,seq50,r_36_20_103,0.92,0,103,103,54
15,r_84_175_185,seq111,seq79,r_84_175_185,0.77,0,185,185,54
28,r_107_219_101,seq30,seq28,r_107_219_101,0.97,0,101,101,54
99,r_251_44_26,r_157_246_99,r_294_80_2,r_251_44_26,0.95,0,26,26,54
91,r_118_15_100,r_84_175_185,r_113_86_56,r_84_175_185,0.69,-85,100,185,54
97,r_264_21_45,r_197_229_174,r_208_108_52,r_197_229_174,0.61,-76,98,174,54
125,seq76,r_239_255_31,r_198_228_28,r_198_228_28,1.0,12,40,28,54
164,seq195,seq253,r_252_98_51,r_252_98_51,0.89,29,80,51,54
56,r_280_14_93,seq99,seq180,r_280_14_93,1.0,1,94,93,54
44,r_131_162_167,r_24_247_178,r_208_108_52,r_208_108_52,1.0,116,168,52,54
118,seq58,r_145_134_160,r_133_199_75,r_133_199_75,0.86,87,162,75,54
131,seq90,r_282_234_170,r_156_143_146,r_282_234_170,0.93,-10,160,170,54
23,r_115_85_95,seq50,seq9,r_115_85_95,1.0,0,95,95,54
175,seq224,seq214,r_293_209_16,r_293_209_16,1.0,90,106,16,54
101,seq5,seq42,r_238_227_51,r_238_227_51,0.8,33,84,51,54
96,r_212_217_24,r_156_143_146,r_37_231_13,r_212_217_24,1.0,0,24,24,54
83,r_13_109_58,seq53,r_210_74_6,r_13_109_58,1.0,0,58,58,54
84,r_230_267_168,seq173,r_281_73_108,r_281_73_108,0.97,61,169,108,54
51,r_253_260_123,seq82,seq166,r_253_260_123,0.99,0,123,123,55
33,r_176_41_51,seq230,seq55,r_176_41_51,1.0,0,51,51,55
54,r_258_133_57,r_59_252_107,seq182,r_59_252_107,0.83,-49,58,107,55
92,r_154_235_125,r_185_297_121,seq290,r_185_297_121,0.98,0,121,121,55
43,r_59_252_107,r_25_89_188,seq64,r_59_252_107,0.56,1,108,107,55
135,seq111,r_184_53_52,seq95,r_184_53_52,1.0,0,52,52,55
71,r_167_292_107,r_143_75_50,r_246_80_67,r_143_75_50,1.0,57,107,50,55
39,r_161_88_70,seq155,seq240,r_161_88_70,0.81,1,71,70,55
165,seq191,r_207_11_186,r_259_62_191,r_259_62_191,0.95,-2,189,191,55
143,seq123,seq64,r_174_197_67,r_174_197_67,1.0,3,70,67,55
5,r_106_279_74,seq152,seq139,r_106_279_74,1.0,0,74,74,55
42,r_48_56_87,r_263_42_110,r_94_81_20,r_94_81_20,0.77,67,87,20,55
63,r_39_205_22,r_288_45_190,seq135,r_39_205_22,1.0,0,22,22,55
44,r_118_177_17,r_114_126_112,seq96,r_118_177_17,0.98,0,17,17,55
120,seq73,seq166,r_217_262_16,r_217_262_16,0.99,8,24,16,55
69,r_159_97_138,seq129,r_210_284_87,r_159_97_138,0.94,0,138,138,55
20,r_94_81_20,r_72_67_164,r_29_141_5,r_94_81_20,1.0,0,20,20,55
30,r_233_149_45,r_245_277_138,seq272,r_233_149_45,1.0,0,45,45,55
19,r_114_126_112,seq58,r_204_76_105,r_114_126_112,0.92,0,112,112,55
33,r_176_41_51,seq55,r_24_208_60,r_24_208_60,0.47,59,119,60,55
66,r_225_196_123,r_186_274_144,seq142,r_225_196_123,0.95,0,123,123,55
36,r_36_219_44,seq213,seq273,r_36_219_44,1.0,0,44,44,55
103,seq17,r_186_274_144,r_36_219_44,r_36_219_44,0.98,100,144,44,55
31,r_175_86_65,r_161_88_70,r_2_70_38,r_161_88_70,0.9,-4,66,70,55
81,r_193_228_58,r_259_62_191,seq109,r_193_228_58,1.0,0,58,58,55
41,r_68_180_165,seq194,r_263_42_110,r_68_180_165,0.87,0,165,165,55
77,r_2_70_38,r_59_252_107,seq117,r_2_70_38,1.0,0,38,38,55
96,r_217_262_16,seq64,seq73,r_217_262_16,0.98,0,16,16,55
67,r_77_211_154,seq95,r_285_293_48,r_77_211_154,0.71,0,154,154,55
58,r_179_201_44,r_59_252_107,seq55,r_179_201_44,1.0,0,44,44,55
10,r_246_80_67,r_162_132_145,r_39_205_22,r_246_80_67,1.0,0,67,67,55
113,seq55,r_174_197_67,r_257_16_69,r_174_197_67,1.0,0,67,67,55
26,r_23_13_66,seq61,r_291_35_8,r_23_13_66,1.0,0,66,66,55
72,r_165_244_116,seq273,r_192_206_4,r_165_244_116,1.0,0,116,116,55
12,r_108_209_12,r_175_86_65,seq286,r_108_209_12,0.79,-1,11,12,55
174,seq224,seq173,r_285_293_48,r_285_293_48,0.89,93,141,48,55
4,r_257_16_69,r_186_274_144,r_179_201_44,r_179_201_44,1.0,31,75,44,55
78,r_140_34_131,r_105_221_195,r_39_205_22,r_140_34_131,0.98,0,131,131,55
0,r_185_297_121,seq17,r_10_249_4,r_185_297_121,0.99,0,121,121,55
107,seq22,r_84_189_114,r_192_206_4,r_84_189_114,0.95,2,116,114,55
13,r_72_67_164,seq91,seq79,r_72_67_164,0.37,0,164,164,55
65,r_116_130_54,r_10_249_4,seq227,r_116_130_54,1.0,0,54,54,55
163,seq188,seq50,r_54_153_71,r_54_153_71,1.0,5,76,71,55
98,r_204_76_105,r_288_45_190,seq113,r_204_76_105,1.0,0,105,105,55
15,r_245_277_138,seq242,r_239_15_1,r_245_277_138,0.76,0,138,138,55
166,seq194,r_68_180_165,seq272,r_68_180_165,0.99,0,165,165,55
48,r_174_197_67,seq55,seq123,r_174_197_67,1.0,0,67,67,55
117,seq64,seq123,r_59_252_107,r_59_252_107,0.89,18,125,107,55
6,r_128_271_194,r_150_3_142,r_145_14_125,r_128_271_194,0.99,-52,142,194,55
62,r_241_270_116,seq135,r_263_42_110,r_241_270_116,0.99,0,116,116,55
85,r_150_3_142,r_128_271_194,r_161_88_70,r_150_3_142,0.96,0,142,142,55
99,r_0_281_57,r_8_92_167,seq123,r_0_281_57,1.0,0,57,57,55
16,r_24_208_60,r_107_6_11,seq19,r_24_208_60,0.9,2,62,60,55
97,r_107_6_11,r_24_208_60,r_36_219_44,r_36_219_44,1.0,18,62,44,55
3,r_247_202_57,seq111,seq18,r_247_202_57,0.97,0,57,57,55
10,r_246_80_67,r_39_205_22,r_167_292_107,r_167_292_107,1.0,39,146,107,55
87,r_183_37_103,r_114_126_112,seq100,r_183_37_103,1.0,0,103,103,55
162,seq182,r_212_282_180,r_278_266_143,r_212_282_180,0.62,0,180,180,55
47,r_60_255_75,seq152,seq261,r_60_255_75,0.99,1,76,75,55
40,r_162_132_145,seq117,seq115,r_162_132_145,0.62,0,145,145,55
74,r_275_119_112,r_10_249_4,r_29_141_5,r_275_119_112,0.99,0,112,112,55
29,r_186_274_144,seq17,seq111,r_186_274_144,0.62,0,144,144,55
157,seq166,seq73,r_253_260_123,r_253_260_123,1.0,1,124,123,55
24,r_178_218_118,seq100,r_151_87_83,r_151_87_83,1.0,39,122,83,55
25,r_299_124_182,seq101,r_161_88_70,r_299_124_182,0.41,0,182,182,55
64,r_25_89_188,seq113,r_247_202_57,r_25_89_188,0.51,0,188,188,55
89,r_157_195_22,r_185_297_121,r_78_104_21,r_185_297_121,1.0,-99,22,121,55
46,r_184_53_52,seq111,seq101,r_184_53_52,0.97,1,53,52,55
130,seq100,r_178_218_118,r_183_37_103,r_183_37_103,1.0,19,122,103,55
61,r_54_153_71,seq61,seq188,r_54_153_71,1.0,0,71,71,55
32,r_263_42_110,seq96,seq242,r_263_42_110,1.0,0,110,110,55
38,r_207_11_186,seq191,r_147_172_8,r_207_11_186,0.33,3,189,186,55
95,r_285_293_48,r_167_292_107,seq100,r_285_293_48,0.65,2,50,48,55
52,r_31_237_186,seq214,r_278_266_143,r_31_237_186,0.47,2,188,186,55
83,r_43_1_20,r_8_92_167,seq95,r_43_1_20,1.0,0,20,20,55
34,r_148_187_142,r_105_221_195,r_29_141_5,r_148_187_142,0.93,1,143,142,55
60,r_232_74_93,seq7,seq17,r_232_74_93,0.99,0,93,93,55
68,r_51_138_23,seq188,seq129,r_51_138_23,1.0,0,23,23,55
17,r_145_14_125,seq22,r_128_271_194,r_145_14_125,0.96,0,125,125,55
45,r_99_134_31,seq17,seq18,r_99_134_31,0.55,2,33,31,55
94,r_170_250_104,seq85,r_210_284_87,r_170_250_104,0.97,0,104,104,55
30,r_233_149_45,seq272,seq113,r_233_149_45,0.64,49,94,45,55
16,r_24_208_60,r_257_16_69,r_107_6_11,r_107_6_11,1.0,0,11,11,55
133,seq109,seq58,r_193_228_58,r_193_228_58,1.0,71,129,58,55
75,r_226_83_26,r_288_45_190,seq168,r_226_83_26,1.0,1,27,26,55
22,r_212_282_180,seq182,r_43_1_20,r_212_282_180,0.63,0,180,180,55
28,r_151_87_83,r_289_198_168,seq50,r_151_87_83,0.99,0,83,83,55
91,r_20_265_78,seq139,seq146,r_20_265_78,1.0,0,78,78,55
97,r_107_6_11,r_246_80_67,r_24_208_60,r_107_6_11,0.91,0,11,11,55
56,r_243_283_110,r_140_34_131,r_23_13_66,r_243_283_110,0.62,0,110,110,55
131,seq101,r_299_124_182,r_184_53_52,r_184_53_52,1.0,130,182,52,55
11,r_254_44_52,seq50,r_46_5_1,r_254_44_52,1.0,0,52,52,55
23,r_8_92_167,r_102_203_31,seq103,r_8_92_167,0.6,0,167,167,55
189,seq269,r_25_89_188,r_294_264_80,r_294_264_80,1.0,4,84,80,55
82,r_164_144_171,seq98,r_72_67_164,r_72_67_164,0.54,8,172,164,55
79,r_210_284_87,seq248,seq229,r_210_284_87,1.0,0,87,87,55
35,r_102_203_31,r_8_92_167,seq169,r_8_92_167,1.0,0,167,167,55
84,r_220_163_116,r_72_67_164,r_232_74_93,r_220_163_116,0.99,0,116,116,55
30,r_180_241_78,seq218,seq7,r_180_241_78,1.0,1,79,78,56
94,r_261_197_27,r_4_165_127,seq176,r_261_197_27,0.96,1,28,27,56
51,r_11_62_96,r_234_122_137,r_170_63_69,r_170_63_69,0.94,3,72,69,56
60,r_101_135_46,r_158_92_196,seq90,r_101_135_46,1.0,0,46,46,56
41,r_157_13_118,r_30_103_47,r_177_51_8,r_30_103_47,0.79,2,49,47,56
53,r_28_111_33,r_179_140_38,seq43,r_28_111_33,0.94,-1,32,33,56
11,r_119_227_62,r_98_276_76,r_77_251_63,r_119_227_62,0.59,0,62,62,56
135,seq94,r_47_203_165,r_290_183_33,r_290_183_33,0.96,19,52,33,56
39,r_80_60_32,r_146_81_84,r_25_249_80,r_80_60_32,1.0,52,84,32,56
116,seq43,seq83,r_282_280_93,r_282_280_93,1.0,-1,92,93,56
154,seq148,r_179_140_38,r_136_91_14,r_136_91_14,0.69,1,15,14,56
188,seq264,r_187_263_160,r_244_34_115,r_244_34_115,0.96,13,128,115,56
55,r_253_295_169,seq265,r_288_123_123,r_253_295_169,0.37,3,172,169,56
71,r_167_161_190,seq124,r_105_209_187,r_105_209_187,0.77,3,190,187,56
87,r_67_68_54,r_154_270_193,r_281_289_32,r_67_68_54,0.95,-2,52,54,56
16,r_170_63_69,r_2_156_107,r_59_128_27,r_170_63_69,0.56,0,69,69,56
21,r_98_276_76,r_178_230_87,r_99_147_15,r_98_276_76,1.0,1,77,76,56
97,r_254_44_90,r_27_220_125,r_261_197_27,r_254_44_90,0.92,0,90,90,56
5,r_47_203_165,seq69,seq70,r_47_203_165,0.77,0,165,165,56
46,r_86_16_158,seq206,r_269_19_134,r_86_16_158,0.87,0,158,158,56
22,r_234_122_137,r_166_293_68,seq20,r_234_122_137,1.0,0,137,137,56
51,r_11_62_96,r_170_63_69,seq152,r_11_62_96,0.88,0,96,96,56
33,r_281_289_32,r_239_229_192,r_38_259_178,r_281_289_32,1.0,0,32,32,56
45,r_201_193_186,r_38_259_178,seq85,r_201_193_186,0.44,0,186,186,56
86,r_160_35_22,seq83,seq104,r_160_35_22,0.93,1,23,22,56
39,r_80_60_32,seq21,r_146_81_84,r_80_60_32,1.0,0,32,32,56
19,r_96_169_89,r_24_243_105,r_170_63_69,r_96_169_89,1.0,0,89,89,56
95,r_23_204_124,seq66,seq49,r_23_204_124,0.95,2,126,124,56
76,r_166_293_68,r_24_243_105,r_170_63_69,r_166_293_68,0.99,1,69,68,56
36,r_56_52_56,r_208_223_90,seq138,r_56_52_56,1.0,0,56,56,56
31,r_269_19_134,r_201_193_186,r_86_16_158,r_86_16_158,0.58,2,160,158,56
67,r_271_149_136,seq109,r_277_266_120,r_271_149_136,0.51,0,136,136,56
58,r_1_126_46,r_234_122_137,seq66,r_1_126_46,0.96,-2,44,46,56
89,r_127_116_95,seq0,r_108_296_94,r_127_116_95,1.0,2,97,95,56
3,r_155_117_23,r_102_222_139,seq200,r_155_117_23,0.94,0,23,23,56
64,r_217_168_41,r_236_118_135,seq14,r_217_168_41,1.0,-5,36,41,56
90,r_121_141_97,r_202_18_162,r_292_151_9,r_121_141_97,1.0,0,97,97,56
167,seq190,seq42,r_146_81_84,r_146_81_84,0.71,1,85,84,56
113,seq36,r_199_6_82,r_262_12_61,r_199_6_82,1.0,5,87,82,56
174,seq207,r_163_114_165,seq139,r_163_114_165,0.8,0,165,165,56
195,seq286,seq148,r_225_88_50,r_225_88_50,0.99,5,55,50,56
78,r_159_210_63,seq190,seq43,r_159_210_63,1.0,-1,62,63,56
63,r_2_156_107,seq85,r_99_147_15,r_2_156_107,0.93,0,107,107,56
73,r_185_238_61,seq109,r_287_75_125,r_185_238_61,1.0,1,62,61,56
20,r_24_243_105,r_166_293_68,r_274_233_45,r_24_243_105,1.0,-42,63,105,56
72,r_53_232_47,seq137,seq17,r_53_232_47,1.0,1,48,47,56
57,r_87_61_71,r_65_186_187,seq137,r_87_61_71,1.0,-1,70,71,56
12,r_287_75_125,r_185_238_61,r_77_251_63,r_287_75_125,0.88,2,127,125,56
14,r_179_140_38,seq8,seq132,r_179_140_38,0.99,-2,36,38,56
6,r_199_6_82,seq36,r_170_63_69,r_199_6_82,1.0,0,82,82,56
62,r_240_245_137,seq279,r_244_34_115,r_240_245_137,0.97,0,137,137,56
47,r_225_88_50,r_142_284_100,seq286,r_225_88_50,0.99,-2,48,50,56
195,seq286,r_225_88_50,r_24_243_105,r_24_243_105,0.99,3,108,105,56
85,r_108_296_94,r_93_268_98,r_129_58_98,r_108_296_94,0.89,0,94,94,56
99,r_171_100_178,r_202_18_162,seq219,r_202_18_162,0.8,-2,160,162,56
178,seq218,r_53_232_47,seq72,r_53_232_47,1.0,-15,32,47,56
27,r_236_118_135,seq132,seq181,r_236_118_135,0.77,2,137,135,56
2,r_191_31_74,r_22_3_180,r_28_111_33,r_191_31_74,0.92,1,75,74,56
41,r_157_13_118,r_177_51_8,r_155_117_23,r_157_13_118,1.0,-2,116,118,56
40,r_202_18_162,r_113_247_9,seq172,r_202_18_162,0.81,1,163,162,56
74,r_248_45_86,seq57,seq226,r_248_45_86,1.0,0,86,86,56
18,r_208_223_90,r_173_153_140,r_185_238_61,r_208_223_90,1.0,-1,89,90,56
29,r_288_123_123,r_255_194_176,seq21,r_255_194_176,0.5,-53,123,176,56
59,r_274_233_45,r_119_227_62,seq55,r_274_233_45,0.72,0,45,45,56
0,r_99_147_15,seq133,seq213,r_99_147_15,0.83,0,15,15,56
25,r_77_251_63,r_65_186_187,seq73,r_77_251_63,1.0,-1,62,63,56
66,r_146_81_84,r_80_60_32,seq190,r_146_81_84,1.0,0,84,84,56
88,r_246_131_183,seq124,r_277_266_120,r_277_266_120,0.6,65,185,120,56
171,seq200,r_239_229_192,r_155_117_23,r_155_117_23,0.93,0,23,23,56
156,seq152,seq73,r_11_62_96,r_11_62_96,1.0,23,119,96,56
66,r_146_81_84,r_185_238_61,r_80_60_32,r_80_60_32,0.7,0,32,32,56
50,r_277_266_120,r_105_209_187,seq69,r_277_266_120,1.0,0,120,120,56
20,r_24_243_105,r_274_233_45,seq286,r_274_233_45,0.67,66,111,45,56
68,r_278_64_107,r_269_19_134,r_142_284_100,r_278_64_107,0.75,2,109,107,56
42,r_292_151_9,seq291,r_121_141_97,r_121_141_97,1.0,1,98,97,56
137,seq97,seq196,r_142_284_100,r_142_284_100,1.0,12,112,100,56
61,r_129_58_98,r_23_204_124,r_108_296_94,r_129_58_98,0.9,-4,94,98,56
32,r_142_284_100,seq71,seq97,r_142_284_100,1.0,3,103,100,56
28,r_134_235_60,seq145,r_167_161_190,r_134_235_60,0.67,-6,54,60,56
38,r_65_186_187,r_125_26_192,r_27_220_125,r_65_186_187,0.5,0,187,187,56
77,r_244_34_115,seq0,r_108_296_94,r_244_34_115,1.0,0,115,115,56
34,r_105_209_187,seq228,seq42,r_105_209_187,0.37,1,188,187,56
4,r_211_79_12,r_129_58_98,seq17,r_211_79_12,0.98,-1,11,12,56
70,r_30_103_47,r_157_13_118,seq15,r_30_103_47,1.0,2,49,47,56
48,r_5_46_49,r_96_169_89,seq257,r_5_46_49,1.0,1,50,49,56
65,r_38_259_178,r_201_193_186,r_281_289_32,r_281_289_32,1.0,0,32,32,56
24,r_136_91_14,r_27_220_125,seq148,r_136_91_14,0.97,-1,13,14,56
17,r_224_39_139,r_102_222_139,r_30_103_47,r_30_103_47,0.99,95,142,47,56
52,r_290_183_33,r_127_116_95,seq94,r_290_183_33,1.0,0,33,33,56
173,seq206,r_86_16_158,r_173_153_140,r_86_16_158,0.93,0,158,158,56
9,r_102_222_139,seq107,r_287_75_125,r_102_222_139,0.64,1,140,139,56
96,r_215_250_137,seq43,seq257,r_215_250_137,0.95,3,140,137,56
28,r_134_235_60,r_167_161_190,r_155_117_23,r_167_161_190,0.73,0,190,190,56
22,r_234_122_137,r_11_62_96,r_166_293_68,r_234_122_137,0.99,-41,96,137,56
73,r_185_238_61,r_287_75_125,r_208_223_90,r_185_238_61,0.57,66,127,61,56
91,r_273_195_107,seq213,r_262_12_61,r_273_195_107,0.89,0,107,107,56
84,r_187_263_160,r_108_296_94,r_56_52_56,r_187_263_160,0.98,0,160,160,56
11,r_119_227_62,r_274_233_45,r_98_276_76,r_119_227_62,0.65,-17,45,62,56
49,r_163_114_165,seq207,r_129_58_98,r_163_114_165,0.65,0,165,165,56
69,r_59_128_27,seq139,seq72,r_59_128_27,1.0,0,27,27,56
56,r_106_297_176,r_187_263_160,r_240_245_137,r_240_245_137,0.97,4,141,137,56
7,r_282_280_93,r_287_75_125,seq43,r_282_280_93,0.91,0,93,93,56
44,r_48_275_67,seq285,r_99_147_15,r_48_275_67,1.0,-1,66,67,56
118,seq54,r_106_297_176,r_244_34_115,r_244_34_115,0.91,19,134,115,56
23,r_178_230_87,seq72,seq109,r_178_230_87,0.99,0,87,87,56
94,r_261_197_27,seq176,r_254_44_90,r_254_44_90,1.0,27,117,90,56
189,seq265,r_253_295_169,r_47_203_165,r_47_203_165,0.82,7,172,165,56
101,seq7,seq152,r_180_241_78,r_180_241_78,1.0,8,86,78,56
56,r_106_297_176,r_240_245_137,r_224_39_139,r_106_297_176,0.99,0,176,176,56
79,r_40_256_135,r_154_270_193,seq283,r_40_256_135,0.77,2,137,135,56
35,r_37_258_92,seq200,r_53_232_47,r_53_232_47,0.61,48,95,47,56
140,seq109,r_185_238_61,r_177_51_8,r_185_238_61,0.99,-15,46,61,56
12,r_287_75_125,r_282_280_93,r_185_238_61,r_185_238_61,1.0,1,62,61,56
84,r_187_263_160,seq264,r_108_296_94,r_108_296_94,0.99,1,95,94,56
55,r_262_227_16,r_52_6_171,seq176,r_262_227_16,0.99,0,16,16,57
36,r_76_144_184,seq104,r_63_134_102,r_76_144_184,0.41,0,184,184,57
76,r_81_83_120,r_23_234_53,r_266_280_198,r_23_234_53,1.0,-4,49,53,57
92,r_139_121_80,r_76_144_184,seq129,r_139_121_80,1.0,0,80,80,57
43,r_241_40_66,seq67,r_221_240_20,r_241_40_66,1.0,3,69,66,57
54,r_13_277_87,seq66,seq68,r_13_277_87,0.99,0,87,87,57
31,r_254_193_40,r_263_202_134,seq154,r_254_193_40,1.0,0,40,40,57
46,r_15_184_25,seq173,seq176,r_15_184_25,1.0,0,25,25,57
59,r_271_150_180,seq293,r_291_196_181,r_291_196_181,0.84,-1,180,181,57
188,seq268,r_17_93_57,r_103_273_174,r_17_93_57,0.71,57,114,57,57
71,r_72_236_97,seq248,r_57_175_22,r_72_236_97,1.0,0,97,97,57
78,r_57_175_22,r_52_6_171,r_210_45_116,r_57_175_22,0.99,0,22,22,57
86,r_298_114_100,seq163,r_288_74_199,r_298_114_100,0.99,0,100,100,57
21,r_274_108_164,r_70_284_189,seq66,r_70_284_189,0.52,-25,164,189,57
39,r_103_273_174,r_34_286_172,r_63_134_102,r_63_134_102,0.57,70,172,102,57
1,r_63_134_102,seq87,seq129,r_63_134_102,1.0,1,103,102,57
42,r_55_27_69,seq168,r_17_93_57,r_55_27_69,1.0,0,69,69,57
80,r_204_259_185,seq275,r_181_124_164,r_204_259_185,0.52,0,185,185,57
45,r_228_65_140,seq115,seq178,r_228_65_140,0.65,0,140,140,57
19,r_186_289_111,r_100_37_183,r_200_88_117,r_186_289_111,1.0,2,113,111,57
30,r_38_299_13,r_278_146_17,seq155,r_38_299_13,0.86,0,13,13,57
60,r_4_281_31,r_103_273_174,r_98_156_145,r_4_281_31,1.0,0,31,31,57
95,r_223_11_85,r_81_83_120,seq137,r_223_11_85,1.0,0,85,85,57
98,r_20_194_26,r_29_32_74,r_92_145_198,r_20_194_26,1.0,0,26,26,57
66,r_97_18_83,seq96,seq256,r_97_18_83,0.99,1,84,83,57
78,r_57_175_22,r_210_45_116,r_72_236_97,r_57_175_22,0.98,94,116,22,57
184,seq256,r_52_6_171,r_294_1_97,r_294_1_97,1.0,74,171,97,57
67,r_31_73_178,r_205_35_130,r_23_234_53,r_23_234_53,0.75,78,131,53,57
110,seq53,r_39_101_91,r_57_175_22,r_39_101_91,0.42,-22,69,91,57
85,r_219_213_57,seq248,r_278_146_17,r_219_213_57,0.99,0,57,57,57
3,r_249_85_137,r_92_145_198,r_223_11_85,r_249_85_137,0.57,0,137,137,57
10,r_82_258_120,seq253,r_219_213_57,r_82_258_120,1.0,0,120,120,57
90,r_263_202_134,seq269,r_38_299_13,r_263_202_134,0.98,1,135,134,57
26,r_215_116_86,seq217,seq128,r_215_116_86,1.0,0,86,86,57
72,r_12_167_110,r_52_6_171,seq247,r_12_167_110,1.0,0,110,110,57
179,seq247,r_29_32_74,seq119,r_29_32_74,0.82,-9,65,74,57
0,r_294_1_97,seq22,r_97_18_83,r_294_1_97,0.99,1,98,97,57
63,r_28_270_92,r_291_196_181,r_4_281_31,r_28_270_92,0.8,0,92,92,57
11,r_181_124_164,r_92_145_198,seq174,r_181_124_164,0.64,3,167,164,57
20,r_291_196_181,seq84,r_295_25_155,r_295_25_155,0.86,28,183,155,57
13,r_200_88_117,seq275,r_186_289_111,r_186_289_111,1.0,19,130,111,57
22,r_39_101_91,r_244_58_119,r_21_49_120,r_21_49_120,0.52,-1,119,120,57
174,seq238,seq115,r_17_93_57,r_17_93_57,1.0,1,58,57,57
6,r_220_33_119,seq287,seq61,r_220_33_119,0.99,0,119,119,57
62,r_149_169_187,r_288_74_199,r_90_197_12,r_90_197_12,0.56,177,189,12,57
99,r_189_24_116,r_246_260_179,seq176,r_189_24_116,1.0,1,117,116,57
5,r_210_45_116,r_57_175_22,seq187,r_210_45_116,1.0,0,116,116,57
160,seq183,r_10_86_146,r_171_9_37,r_171_9_37,1.0,109,146,37,57
94,r_278_146_17,r_131_162_167,seq225,r_278_146_17,1.0,0,17,17,57
27,r_29_32_74,r_246_260_179,r_219_213_57,r_246_260_179,0.99,-101,78,179,57
32,r_244_58_119,seq153,r_39_101_91,r_39_101_91,0.61,1,92,91,57
87,r_34_286_172,r_103_273_174,seq242,r_34_286_172,0.7,0,172,172,57
2,r_80_164_84,seq68,seq287,r_80_164_84,1.0,0,84,84,57
40,r_211_122_136,seq95,r_63_134_102,r_63_134_102,1.0,35,137,102,57
56,r_19_135_24,r_244_58_119,seq61,r_19_135_24,0.98,0,24,24,57
74,r_143_62_175,seq61,r_63_134_102,r_143_62_175,0.45,1,176,175,57
29,r_148_230_174,seq153,r_249_85_137,r_249_85_137,0.85,46,183,137,57
24,r_47_94_181,seq183,r_249_85_137,r_47_94_181,0.35,1,182,181,57
8,r_118_105_27,seq51,seq192,r_118_105_27,1.0,2,29,27,57
16,r_136_206_37,r_55_27_69,seq180,r_136_206_37,1.0,0,37,37,57
33,r_190_79_70,seq61,r_262_227_16,r_190_79_70,1.0,0,70,70,57
64,r_44_46_70,r_244_58_119,seq151,r_44_46_70,1.0,0,70,70,57
191,seq275,r_200_88_117,r_130_111_114,r_130_111_114,1.0,16,130,114,57
88,r_290_110_177,r_149_169_187,r_220_33_119,r_220_33_119,1.0,59,178,119,57
50,r_288_74_199,r_149_169_187,r_80_164_84,r_80_164_84,1.0,48,132,84,57
58,r_125_165_78,r_198_107_197,r_44_46_70,r_125_165_78,1.0,2,80,78,57
70,r_126_89_95,seq96,r_19_135_24,r_126_89_95,0.99,1,96,95,57
65,r_226_208_123,seq120,r_207_2_50,r_226_208_123,0.7,10,133,123,57
155,seq174,r_246_260_179,r_181_124_164,r_181_124_164,0.81,15,179,164,57
68,r_224_235_100,seq36,r_179_160_98,r_224_235_100,1.0,0,100,100,57
130,seq104,r_76_144_184,r_179_160_98,r_179_160_98,0.96,86,184,98,57
61,r_50_195_123,seq155,r_179_160_98,r_50_195_123,0.94,0,123,123,57
32,r_244_58_119,r_44_46_70,seq153,r_44_46_70,0.97,0,70,70,57
57,r_255_261_41,r_244_58_119,seq267,r_255_261_41,0.99,3,44,41,57
32,r_244_58_119,r_39_101_91,r_223_11_85,r_244_58_119,0.74,2,121,119,57
52,r_166_185_185,seq279,r_220_33_119,r_166_185_185,0.42,0,185,185,57
77,r_130_111_114,seq172,seq264,r_130_111_114,0.99,0,114,114,57
76,r_81_83_120,r_266_280_198,r_90_197_12,r_81_83_120,0.94,0,120,120,57
75,r_98_156_145,seq142,r_4_281_31,r_4_281_31,0.89,29,60,31,57
124,seq87,seq242,r_90_197_12,r_90_197_12,0.72,101,113,12,57
81,r_10_86_146,seq183,r_80_164_84,r_80_164_84,1.0,62,146,84,57
17,r_52_6_171,seq256,seq102,r_52_6_171,0.62,0,171,171,57
69,r_182_141_21,r_118_105_27,seq172,r_182_141_21,0.99,1,22,21,57
9,r_205_35_130,r_31_73_178,seq8,r_205_35_130,0.98,1,131,130,57
145,seq153,r_148_230_174,r_222_132_1,r_222_132_1,0.57,162,163,1,57
48,r_23_234_53,r_81_83_120,seq269,r_23_234_53,1.0,1,54,53,57
28,r_207_2_50,r_263_202_134,seq248,r_207_2_50,0.82,-1,49,50,57
97,r_221_240_20,r_244_58_119,seq245,r_221_240_20,1.0,0,20,20,57
22,r_39_101_91,r_296_112_100,r_244_58_119,r_39_101_91,0.81,0,91,91,57
91,r_117_209_93,seq269,seq36,r_117_209_93,1.0,1,94,93,57
5,r_210_45_116,seq53,r_57_175_22,r_57_175_22,0.95,5,27,22,57
49,r_100_37_183,seq78,r_125_165_78,r_125_165_78,0.8,105,183,78,57
164,seq192,r_47_94_181,r_118_105_27,r_118_105_27,0.91,87,114,27,57
23,r_216_138_48,seq272,seq172,r_216_138_48,1.0,0,48,48,57
7,r_296_112_100,seq66,r_221_240_20,r_296_112_100,1.0,0,100,100,57
134,seq119,r_130_111_114,seq247,r_130_111_114,1.0,-58,56,114,57
75,r_98_156_145,r_4_281_31,r_125_165_78,r_98_156_145,0.99,0,145,145,57
79,r_5_250_97,seq276,seq69,r_5_250_97,1.0,0,97,97,57
183,seq253,r_295_25_155,r_44_46_70,r_44_46_70,0.86,86,156,70,57
60,r_4_281_31,r_98_156_145,seq142,r_98_156_145,1.0,0,145,145,57
38,r_17_93_57,seq203,seq238,r_17_93_57,1.0,1,58,57,57
44,r_92_145_198,r_181_124_164,r_19_135_24,r_92_145_198,0.57,-145,53,198,57
12,r_179_160_98,seq129,seq51,r_179_160_98,1.0,0,98,98,57
67,r_31_73_178,r_23_234_53,r_4_281_31,r_31_73_178,0.61,2,180,178,57
82,r_171_9_37,r_31_73_178,seq183,r_171_9_37,0.99,1,38,37,57
166,seq219,r_275_60_132,r_236_100_39,r_236_100_39,1.0,1,40,39,58
93,r_276_290_171,seq94,seq144,r_276_290_171,0.63,0,171,171,58
30,r_133_217_131,r_114_168_190,r_236_100_39,r_114_168_190,0.48,-59,131,190,58
51,r_262_202_136,seq281,seq263,r_262_202_136,0.77,0,136,136,58
36,r_21_108_99,r_124_14_178,seq285,r_21_108_99,0.98,-4,95,99,58
14,r_124_14_178,seq179,r_21_108_99,r_21_108_99,1.0,79,178,99,58
41,r_221_9_48,seq88,seq78,r_221_9_48,1.0,1,49,48,58
43,r_147_234_90,seq228,r_204_253_40,r_147_234_90,1.0,0,90,90,58
83,r_20_105_91,seq228,seq173,r_20_105_91,1.0,0,91,91,58
196,seq288,r_260_180_86,r_59_176_28,r_59_176_28,0.79,0,28,28,58
37,r_127_240_131,seq271,seq134,r_127_240_131,0.87,0,131,131,58
59,r_274_218_103,r_200_272_117,seq278,r_274_218_103,0.99,0,103,103,58
55,r_65_282_73,seq255,seq19,r_65_282_73,0.65,-5,68,73,58
86,r_232_23_131,seq169,seq230,r_232_23_131,0.99,0,131,131,58
16,r_200_272_117,r_138_13_139,seq34,r_200_272_117,0.99,9,126,117,58
39,r_283_205_102,seq279,r_216_227_82,r_283_205_102,1.0,0,102,102,58
5,r_146_161_101,r_266_104_137,seq72,r_146_161_101,0.89,1,102,101,58
46,r_129_256_147,seq246,r_262_202_136,r_129_256_147,0.94,0,147,147,58
49,r_238_83_56,r_145_183_64,seq285,r_238_83_56,0.8,0,56,56,58
69,r_215_57_171,seq230,r_251_32_87,r_215_57_171,0.84,0,171,171,58
70,r_258_265_15,r_65_282_73,seq280,r_258_265_15,0.96,-1,14,15,58
95,r_37_299_130,seq45,r_190_188_67,r_37_299_130,0.99,0,130,130,58
66,r_189_249_128,seq49,seq255,r_189_249_128,0.95,0,128,128,58
184,seq255,r_65_282_73,r_189_249_128,r_189_249_128,1.0,23,151,128,58
67,r_128_296_137,r_245_116_193,seq88,r_128_296_137,0.96,0,137,137,58
3,r_70_195_52,seq271,seq206,r_70_195_52,0.65,47,99,52,58
10,r_275_60_132,seq219,seq49,r_275_60_132,0.93,0,132,132,58
22,r_291_143_34,r_221_9_48,r_103_139_29,r_291_143_34,0.99,0,34,34,58
26,r_138_13_139,seq33,r_275_60_132,r_275_60_132,0.73,18,150,132,58
18,r_50_140_24,r_192_154_61,seq250,r_50_140_24,1.0,0,24,24,58
72,r_103_139_29,r_264_213_172,r_277_89_89,r_103_139_29,0.65,57,86,29,58
98,r_39_294_56,r_264_213_172,seq211,r_39_294_56,1.0,0,56,56,58
170,seq228,r_147_234_90,seq158,r_147_234_90,0.99,-2,88,90,58
78,r_171_122_101,seq295,seq246,r_171_122_101,0.95,0,101,101,58
63,r_93_85_157,r_208_164_154,seq250,r_93_85_157,0.66,4,161,157,58
73,r_59_176_28,seq53,seq288,r_59_176_28,1.0,0,28,28,58
76,r_209_172_34,r_145_183_64,seq78,r_209_172_34,1.0,0,34,34,58
13,r_156_0_78,seq45,seq88,r_156_0_78,1.0,0,78,78,58
15,r_71_56_91,seq257,seq295,r_71_56_91,1.0,-3,88,91,58
48,r_149_117_143,r_185_43_178,r_128_296_137,r_149_117_143,0.85,1,144,143,58
80,r_35_287_53,r_71_56_91,r_276_290_171,r_35_287_53,1.0,0,53,53,58
193,seq280,r_210_12_153,r_258_265_15,r_258_265_15,0.96,-1,14,15,58
6,r_64_107_90,r_251_32_87,r_145_183_64,r_64_107_90,0.88,1,91,90,58
62,r_270_273_103,r_245_116_193,seq96,r_270_273_103,1.0,1,104,103,58
7,r_145_183_64,r_200_272_117,r_64_107_90,r_200_272_117,0.97,-5,112,117,58
80,r_35_287_53,r_276_290_171,r_24_203_85,r_35_287_53,0.57,43,96,53,58
85,r_216_227_82,seq73,seq137,r_216_227_82,0.68,0,82,82,58
53,r_185_43_178,r_187_101_47,r_146_161_101,r_185_43_178,0.58,0,178,178,58
47,r_286_97_105,seq263,seq148,r_286_97_105,1.0,0,105,105,58
40,r_47_106_122,seq178,r_260_180_86,r_47_106_122,0.81,0,122,122,58
97,r_86_268_55,r_264_213_172,seq271,r_86_268_55,1.0,0,55,55,58
29,r_54_175_120,seq295,r_145_183_64,r_54_175_120,0.75,3,123,120,58
89,r_222_151_41,r_156_0_78,seq196,r_156_0_78,0.73,-60,18,78,58
27,r_191_8_50,seq72,seq75,r_191_8_50,0.98,0,50,50,58
25,r_251_32_87,r_64_107_90,r_236_100_39,r_251_32_87,0.93,4,91,87,58
127,seq94,r_276_290_171,r_286_97_105,r_286_97_105,0.86,66,171,105,58
64,r_74_51_89,seq226,r_209_172_34,r_74_51_89,0.85,1,90,89,58
191,seq278,seq15,r_274_218_103,r_274_218_103,1.0,18,121,103,58
88,r_277_89_89,seq123,r_103_139_29,r_277_89_89,0.56,-2,87,89,58
2,r_36_166_45,r_3_46_89,seq211,r_36_166_45,1.0,1,46,45,58
50,r_24_203_85,r_286_97_105,r_35_287_53,r_35_287_53,0.91,32,85,53,58
58,r_77_11_65,r_124_14_178,seq40,r_77_11_65,1.0,1,66,65,58
65,r_118_10_72,seq96,seq155,r_118_10_72,1.0,-2,70,72,58
159,seq196,r_65_282_73,r_222_151_41,r_222_151_41,0.7,-5,36,41,58
53,r_185_43_178,seq78,r_187_101_47,r_187_101_47,1.0,1,48,47,58
68,r_25_162_175,seq181,r_276_290_171,r_276_290_171,0.56,4,175,171,58
61,r_125_84_168,seq62,r_291_143_34,r_125_84_168,0.76,0,168,168,58
32,r_42_284_184,seq49,r_129_256_147,r_129_256_147,0.83,39,186,147,58
77,r_142_141_106,r_200_272_117,seq94,r_142_141_106,1.0,2,108,106,58
87,r_187_101_47,r_204_253_40,seq78,r_187_101_47,0.99,0,47,47,58
169,seq226,r_74_51_89,seq123,r_74_51_89,1.0,1,90,89,58
34,r_192_154_61,r_184_120_109,seq53,r_192_154_61,1.0,0,61,61,58
99,r_81_98_14,r_149_117_143,seq223,r_81_98_14,0.99,2,16,14,58
154,seq181,r_25_162_175,r_297_30_112,r_297_30_112,0.99,63,175,112,58
75,r_92_1_162,r_208_164_154,r_252_38_97,r_252_38_97,1.0,65,162,97,58
60,r_252_38_97,r_121_289_197,seq242,r_252_38_97,1.0,-1,96,97,58
81,r_112_7_146,seq288,r_192_154_61,r_112_7_146,0.88,0,146,146,58
17,r_260_180_86,r_127_240_131,seq201,r_260_180_86,1.0,1,87,86,58
9,r_266_104_137,seq269,r_68_17_50,r_266_104_137,0.95,0,137,137,58
96,r_237_79_128,r_200_272_117,r_283_205_102,r_237_79_128,0.93,1,129,128,58
120,seq73,r_210_12_153,seq246,r_210_12_153,0.73,0,153,153,58
195,seq285,r_192_154_61,r_238_83_56,r_192_154_61,0.84,-5,56,61,58
28,r_297_30_112,seq137,seq181,r_297_30_112,0.99,0,112,112,58
56,r_214_220_133,seq148,seq28,r_214_220_133,0.99,0,133,133,58
7,r_145_183_64,seq135,r_200_272_117,r_145_183_64,0.92,-2,62,64,58
44,r_76_225_113,seq109,seq255,r_76_225_113,0.99,0,113,113,58
71,r_131_2_49,seq242,r_258_265_15,r_131_2_49,1.0,1,50,49,58
101,seq5,seq87,r_22_52_63,r_22_52_63,1.0,62,125,63,58
183,seq250,r_65_282_73,r_93_85_157,r_93_85_157,0.82,2,159,157,58
35,r_210_12_153,seq73,r_192_154_61,r_192_154_61,0.76,92,153,61,58
91,r_68_17_50,r_64_107_90,seq33,r_68_17_50,0.46,-2,48,50,58
74,r_66_67_17,seq250,seq157,r_66_67_17,0.99,0,17,17,58
84,r_264_213_172,seq157,r_70_195_52,r_264_213_172,0.64,0,172,172,58
199,seq295,r_54_175_120,r_71_56_91,r_71_56_91,0.98,32,123,91,58
22,r_284_127_44,seq203,seq104,r_284_127_44,1.0,0,44,44,59
51,r_110_212_74,seq252,r_177_238_73,r_110_212_74,1.0,0,74,74,59
92,r_5_281_63,r_158_114_146,seq67,r_5_281_63,1.0,1,64,63,59
14,r_123_142_85,r_257_77_173,r_73_45_28,r_123_142_85,0.98,2,87,85,59
8,r_40_111_105,r_198_229_197,r_270_44_4,r_40_111_105,0.48,4,109,105,59
53,r_137_41_130,seq93,r_12_192_79,r_12_192_79,0.6,51,130,79,59
146,seq144,seq283,r_52_173_51,r_52_173_51,1.0,13,64,51,59
168,seq203,r_284_127_44,seq16,r_284_127_44,1.0,0,44,44,59
83,r_294_9_185,seq66,r_94_2_109,r_94_2_109,0.8,76,185,109,59
116,seq42,r_210_239_118,seq225,r_210_239_118,1.0,0,118,118,59
37,r_95_80_129,r_91_106_92,seq26,r_95_80_129,0.89,0,129,129,59
56,r_60_138_25,seq159,seq102,r_60_138_25,1.0,-2,23,25,59
59,r_182_234_84,seq140,r_205_292_12,r_182_234_84,1.0,1,85,84,59
55,r_53_105_83,r_231_260_129,r_54_271_152,r_53_105_83,0.84,0,83,83,59
71,r_227_217_91,r_210_239_118,seq189,r_227_217_91,0.94,1,92,91,59
86,r_133_33_100,r_184_157_109,r_91_106_92,r_184_157_109,0.78,0,109,109,59
16,r_291_207_134,r_158_114_146,r_233_172_120,r_158_114_146,0.48,-12,134,146,59
39,r_196_215_136,seq96,seq194,r_196_215_136,0.91,0,136,136,59
1,r_200_230_168,seq278,seq65,r_200_230_168,0.73,0,168,168,59
97,r_14_174_137,seq0,r_221_245_119,r_14_174_137,0.51,0,137,137,59
38,r_171_11_42,seq118,seq56,r_171_11_42,0.47,6,48,42,59
5,r_76_19_64,r_210_239_118,seq275,r_76_19_64,1.0,0,64,64,59
46,r_28_120_137,seq75,r_60_138_25,r_28_120_137,0.95,0,137,137,59
42,r_231_260_129,r_53_105_83,r_107_17_69,r_231_260_129,0.86,-46,83,129,59
80,r_258_277_6,r_224_222_154,r_113_15_41,r_113_15_41,1.0,53,94,41,59
69,r_274_272_85,seq26,r_204_55_31,r_204_55_31,1.0,110,141,31,59
45,r_257_77_173,r_123_142_85,r_160_85_60,r_160_85_60,0.79,27,87,60,59
90,r_46_187_43,r_285_115_149,r_158_114_146,r_46_187_43,1.0,1,44,43,59
77,r_264_57_50,r_40_111_105,seq151,r_264_57_50,1.0,0,50,50,59
31,r_87_282_133,r_74_298_176,seq189,r_87_282_133,0.59,5,138,133,59
41,r_49_150_83,r_133_33_100,r_263_250_54,r_49_150_83,0.87,0,83,83,59
67,r_268_148_60,r_178_18_149,seq162,r_268_148_60,1.0,1,61,60,59
110,seq29,r_247_149_188,r_253_235_154,r_253_235_154,0.79,14,168,154,59
3,r_218_83_154,seq225,r_38_213_142,r_38_213_142,0.7,29,171,142,59
113,seq32,r_40_111_105,r_273_228_52,r_273_228_52,1.0,35,87,52,59
26,r_48_4_138,seq226,seq81,r_48_4_138,0.82,2,140,138,59
72,r_253_235_154,r_88_136_7,seq29,r_253_235_154,0.83,4,158,154,59
72,r_253_235_154,r_78_108_103,r_88_136_7,r_78_108_103,0.91,0,103,103,59
179,seq237,r_107_17_69,r_270_44_4,r_107_17_69,0.69,1,70,69,59
4,r_38_213_142,r_294_9_185,r_21_109_33,r_38_213_142,0.83,1,143,142,59
73,r_177_238_73,r_274_272_85,r_110_212_74,r_110_212_74,0.99,0,74,74,59
20,r_94_2_109,seq34,seq118,r_94_2_109,1.0,2,111,109,59
13,r_184_157_109,r_133_33_100,r_99_1_96,r_184_157_109,0.96,0,109,109,59
98,r_145_101_138,r_200_230_168,r_186_103_63,r_200_230_168,0.94,-29,139,168,59
48,r_122_276_109,r_231_260_129,r_270_44_4,r_122_276_109,0.86,7,116,109,59
2,r_113_15_41,seq30,r_258_277_6,r_113_15_41,1.0,0,41,41,59
57,r_54_271_152,r_200_230_168,r_248_92_138,r_200_230_168,0.76,-4,164,168,59
42,r_231_260_129,r_107_17_69,r_273_228_52,r_231_260_129,0.89,0,129,129,59
62,r_89_241_164,seq147,r_218_83_154,r_89_241_164,0.77,0,164,164,59
74,r_107_17_69,seq16,r_68_35_84,r_107_17_69,0.52,95,164,69,59
99,r_78_108_103,r_253_235_154,seq203,r_78_108_103,1.0,0,103,103,59
23,r_24_10_31,r_279_134_195,seq0,r_24_10_31,0.99,4,35,31,59
27,r_221_245_119,seq162,r_107_17_69,r_221_245_119,1.0,0,119,119,59
87,r_176_71_61,r_240_201_167,seq140,r_176_71_61,1.0,0,61,61,59
47,r_248_92_138,seq75,seq179,r_248_92_138,0.59,0,138,138,59
93,r_296_97_30,r_257_77_173,r_160_85_60,r_296_97_30,0.8,69,99,30,59
40,r_131_23_91,seq22,r_176_71_61,r_131_23_91,1.0,0,91,91,59
74,r_107_17_69,seq237,seq16,r_107_17_69,0.97,1,70,69,59
29,r_186_103_63,r_274_272_85,seq255,r_186_103_63,1.0,1,64,63,59
89,r_52_173_51,seq30,seq144,r_52_173_51,1.0,1,52,51,59
24,r_73_45_28,seq278,seq147,r_73_45_28,0.9,1,29,28,59
35,r_236_191_77,r_178_18_149,r_286_84_138,r_286_84_138,1.0,9,147,138,59
25,r_286_84_138,r_132_164_188,r_236_191_77,r_132_164_188,0.98,-48,140,188,59
61,r_178_18_149,seq297,seq90,r_178_18_149,0.75,4,153,149,59
33,r_249_153_154,seq162,seq67,r_249_153_154,0.39,-16,138,154,59
66,r_204_55_31,seq75,seq66,r_204_55_31,0.89,1,32,31,59
50,r_141_206_102,r_248_92_138,r_204_55_31,r_141_206_102,0.62,3,105,102,59
58,r_242_7_166,seq118,r_204_55_31,r_242_7_166,0.54,0,166,166,59
76,r_154_130_42,seq135,r_60_138_25,r_154_130_42,0.96,0,42,42,59
68,r_37_288_100,r_14_174_137,r_99_1_96,r_37_288_100,0.98,0,100,100,59
61,r_178_18_149,r_243_290_125,seq297,r_178_18_149,0.51,-24,125,149,59
32,r_74_298_176,seq75,r_180_129_9,r_180_129_9,0.67,167,176,9,59
34,r_50_51_122,r_87_282_133,seq118,r_50_51_122,0.98,0,122,122,59
64,r_273_228_52,r_99_1_96,seq32,r_273_228_52,1.0,0,52,52,59
70,r_155_64_57,r_261_209_108,r_204_55_31,r_261_209_108,0.58,-51,57,108,59
75,r_233_172_120,seq20,seq128,r_233_172_120,0.99,0,120,120,59
60,r_160_85_60,r_38_213_142,r_296_97_30,r_160_85_60,0.98,0,60,60,59
45,r_257_77_173,r_160_85_60,r_248_92_138,r_257_77_173,0.86,0,173,173,59
17,r_165_269_135,r_285_115_149,r_124_72_39,r_124_72_39,0.83,97,136,39,59
43,r_21_109_33,r_291_207_134,seq20,r_21_109_33,0.99,2,35,33,59
94,r_210_239_118,seq42,r_113_15_41,r_210_239_118,0.87,0,118,118,59
9,r_99_1_96,seq102,r_73_45_28,r_99_1_96,0.63,0,96,96,59
96,r_243_290_125,r_178_18_149,seq135,r_243_290_125,0.61,0,125,125,59
90,r_46_187_43,r_158_114_146,r_91_106_92,r_158_114_146,0.78,-32,114,146,59
123,seq66,r_294_9_185,r_87_282_133,r_87_282_133,0.63,52,185,133,59
28,r_240_201_167,seq119,r_258_277_6,r_258_277_6,0.85,161,167,6,59
91,r_68_35_84,r_48_4_138,r_107_17_69,r_68_35_84,0.94,0,84,84,59
135,seq104,r_285_115_149,r_284_127_44,r_284_127_44,1.0,62,106,44,59
49,r_224_222_154,r_258_277_6,r_107_17_69,r_107_17_69,0.7,97,166,69,59
93,r_296_97_30,seq144,r_257_77_173,r_296_97_30,1.0,0,30,30,59
7,r_158_114_146,seq140,r_38_213_142,r_158_114_146,0.74,0,146,146,59
131,seq93,r_137_41_130,r_248_92_138,r_137_41_130,0.9,0,130,130,59
19,r_61_70_60,r_133_33_100,seq295,r_61_70_60,1.0,-2,58,60,59
81,r_39_139_40,r_196_215_136,r_171_11_42,r_39_139_40,1.0,0,40,40,59
138,seq118,r_242_7_166,r_94_2_109,r_94_2_109,0.95,57,166,109,59
82,r_259_82_76,r_99_1_96,seq96,r_259_82_76,1.0,0,76,76,59
79,r_261_209_108,r_137_41_130,r_76_19_64,r_137_41_130,0.69,-22,108,130,59
35,r_236_191_77,r_285_115_149,r_178_18_149,r_236_191_77,0.99,0,77,77,59
95,r_88_136_7,r_253_235_154,r_61_70_60,r_61_70_60,1.0,98,158,60,59
84,r_199_63_114,r_274_272_85,r_61_70_60,r_199_63_114,0.69,0,114,114,59
55,r_53_105_83,r_54_271_152,r_270_44_4,r_54_271_152,0.87,15,167,152,59
30,r_240_175_136,seq230,r_158_73_134,r_240_175_136,0.92,1,137,136,60
53,r_209_98_29,r_187_116_58,seq129,r_209_98_29,0.76,0,29,29,60
51,r_118_283_190,r_130_13_197,r_45_112_121,r_45_112_121,0.99,69,190,121,60
70,r_93_91_46,seq176,seq7,r_93_91_46,1.0,1,47,46,60
92,r_92_254_110,seq54,seq7,r_92_254_110,0.95,0,110,110,60
41,r_82_59_18,r_166_60_194,seq119,r_82_59_18,0.85,-1,17,18,60
53,r_209_98_29,seq129,r_187_116_58,r_187_116_58,0.99,23,81,58,60
14,r_135_174_109,seq274,seq206,r_135_174_109,0.99,0,109,109,60
8,r_299_42_178,seq120,r_170_139_114,r_170_139_114,1.0,65,179,114,60
43,r_170_139_114,r_142_168_177,r_211_169_78,r_170_139_114,0.92,0,114,114,60
83,r_127_233_69,r_259_291_79,r_188_122_166,r_127_233_69,0.78,0,69,69,60
116,seq52,r_84_104_188,r_138_87_71,r_138_87_71,0.92,117,188,71,60
54,r_149_57_6,r_142_168_177,r_61_182_73,r_61_182_73,1.0,104,177,73,60
59,r_276_44_185,seq96,r_61_182_73,r_61_182_73,0.79,112,185,73,60
39,r_247_255_126,seq36,seq245,r_247_255_126,0.99,0,126,126,60
153,seq167,seq164,r_290_50_42,r_290_50_42,1.0,13,55,42,60
1,r_107_273_189,seq7,r_262_18_185,r_107_273_189,0.38,1,190,189,60
5,r_298_249_87,r_10_184_158,seq65,r_298_249_87,0.63,-3,84,87,60
46,r_51_62_95,seq22,seq32,r_51_62_95,1.0,1,96,95,60
13,r_257_33_41,r_108_258_164,r_94_284_12,r_257_33_41,0.99,0,41,41,60
80,r_266_208_116,r_56_28_96,r_227_136_115,r_227_136_115,0.5,0,115,115,60
71,r_106_100_35,r_125_199_115,seq253,r_106_100_35,0.7,0,35,35,60
69,r_220_3_101,r_23_81_157,seq260,r_220_3_101,0.93,0,101,101,60
83,r_127_233_69,r_188_122_166,r_247_255_126,r_247_255_126,1.0,42,168,126,60
2,r_195_236_11,r_298_249_87,seq14,r_195_236_11,0.95,-1,10,11,60
19,r_259_291_79,r_127_233_69,seq271,r_259_291_79,0.76,-10,69,79,60
42,r_205_214_58,seq198,seq173,r_205_214_58,1.0,0,58,58,60
15,r_29_191_35,r_45_112_121,seq97,r_45_112_121,1.0,0,121,121,60
184,seq253,seq171,r_106_100_35,r_106_100_35,0.98,0,35,35,60
95,r_125_199_115,r_289_162_185,seq9,r_125_199_115,1.0,0,115,115,60
66,r_121_110_105,r_270_275_111,r_257_33_41,r_121_110_105,1.0,0,105,105,60
76,r_196_252_156,r_108_258_164,seq230,r_108_258_164,0.75,-8,156,164,60
103,seq7,r_107_273_189,r_92_254_110,r_92_254_110,1.0,53,163,110,60
9,r_132_128_27,r_23_81_157,r_30_267_23,r_132_128_27,0.93,-4,23,27,60
31,r_26_113_83,seq146,r_103_153_8,r_26_113_83,0.99,0,83,83,60
67,r_228_89_183,seq15,r_207_152_167,r_207_152_167,0.7,16,183,167,60
89,r_203_31_156,r_107_273_189,r_132_128_27,r_107_273_189,0.78,-32,157,189,60
3,r_138_87_71,r_240_175_136,r_47_66_30,r_138_87_71,1.0,1,72,71,60
17,r_45_112_121,seq97,r_29_191_35,r_29_191_35,0.96,-3,32,35,60
10,r_23_81_157,r_276_44_185,r_264_46_30,r_23_81_157,0.74,0,157,157,60
90,r_38_248_90,seq154,seq176,r_38_248_90,1.0,0,90,90,60
113,seq37,r_108_258_164,seq201,r_108_258_164,0.88,3,167,164,60
72,r_211_169_78,seq77,seq155,r_211_169_78,1.0,0,78,78,60
4,r_131_241_161,r_34_237_5,r_227_136_115,r_227_136_115,1.0,46,161,115,60
63,r_41_27_86,r_207_152_167,seq155,r_41_27_86,1.0,0,86,86,60
114,seq40,r_289_162_185,r_156_124_8,r_289_162_185,0.61,-39,146,185,60
11,r_34_237_5,r_131_241_161,r_170_139_114,r_170_139_114,1.0,47,161,114,60
55,r_221_180_19,r_105_210_52,seq244,r_221_180_19,0.96,-2,17,19,60
20,r_268_126_185,seq129,r_105_210_52,r_105_210_52,0.98,135,187,52,60
25,r_207_152_167,r_41_27_86,seq260,r_41_27_86,1.0,-27,59,86,60
98,r_204_115_88,seq159,seq148,r_204_115_88,1.0,0,88,88,60
44,r_187_116_58,r_151_53_145,r_209_98_29,r_151_53_145,0.57,-87,58,145,60
157,seq176,r_93_91_46,seq86,r_93_91_46,0.72,-17,29,46,60
12,r_289_162_185,r_156_124_8,r_257_33_41,r_289_162_185,0.86,2,187,185,60
181,seq245,r_188_122_166,r_247_255_126,r_247_255_126,1.0,6,132,126,60
40,r_287_21_49,r_72_140_20,r_69_58_87,r_69_58_87,0.94,9,96,87,60
6,r_178_189_80,r_266_208_116,seq165,r_178_189_80,1.0,0,80,80,60
50,r_94_284_12,r_287_21_49,seq161,r_94_284_12,0.98,1,13,12,60
141,seq146,r_26_113_83,seq230,r_26_113_83,0.89,0,83,83,60
85,r_10_184_158,seq159,r_298_249_87,r_298_249_87,0.84,71,158,87,60
99,r_158_73_134,seq70,r_41_27_86,r_41_27_86,0.94,49,135,86,60
40,r_287_21_49,seq32,r_72_140_20,r_287_21_49,0.99,0,49,49,60
36,r_103_153_8,r_217_144_104,r_26_113_83,r_103_153_8,0.68,86,94,8,60
27,r_85_17_125,seq164,r_125_199_115,r_85_17_125,0.55,0,125,125,60
47,r_216_279_184,seq119,r_269_80_98,r_269_80_98,0.77,87,185,98,60
15,r_29_191_35,r_166_60_194,r_45_112_121,r_29_191_35,0.91,-2,33,35,60
74,r_269_80_98,seq271,seq32,r_269_80_98,1.0,0,98,98,60
18,r_194_83_168,seq74,r_223_234_167,r_194_83_168,0.75,0,168,168,60
29,r_188_122_166,seq245,r_127_233_69,r_127_233_69,0.78,18,87,69,60
33,r_75_8_117,r_228_89_183,seq244,r_75_8_117,0.99,2,119,117,60
64,r_217_144_104,seq161,seq219,r_217_144_104,1.0,0,104,104,60
82,r_142_168_177,r_149_57_6,r_259_291_79,r_259_291_79,0.25,98,177,79,60
155,seq172,r_143_63_145,r_11_16_85,r_11_16_85,1.0,60,145,85,60
68,r_137_197_118,r_142_168_177,r_205_214_58,r_142_168_177,0.92,-59,118,177,60
61,r_108_258_164,seq37,r_207_152_167,r_108_258_164,0.43,3,167,164,60
82,r_142_168_177,r_170_139_114,r_149_57_6,r_170_139_114,0.95,-57,57,114,60
52,r_193_71_64,r_268_126_185,seq35,r_193_71_64,1.0,0,64,64,60
79,r_30_267_23,r_130_13_197,seq159,r_30_267_23,0.9,0,23,23,60
34,r_225_177_109,seq243,r_132_128_27,r_225_177_109,0.96,0,109,109,60
60,r_223_234_167,seq70,r_194_83_168,r_194_83_168,0.68,0,168,168,60
25,r_207_152_167,seq260,r_156_124_8,r_207_152_167,0.78,0,167,167,60
144,seq154,r_38_248_90,r_156_124_8,r_38_248_90,1.0,-2,88,90,60
21,r_105_210_52,r_247_255_126,r_296_192_177,r_105_210_52,1.0,0,52,52,60
78,r_264_46_30,r_11_16_85,seq274,r_264_46_30,1.0,0,30,30,60
96,r_151_53_145,seq201,r_82_59_18,r_151_53_145,0.83,0,145,145,60
32,r_72_140_20,r_26_113_83,seq222,r_72_140_20,1.0,0,20,20,60
56,r_202_292_29,seq97,seq5,r_202_292_29,0.93,0,29,29,60
123,seq77,r_211_169_78,seq54,r_211_169_78,1.0,0,78,78,60
29,r_188_122_166,r_127_233_69,r_135_174_109,r_135_174_109,0.93,59,168,109,60
22,r_69_58_87,seq200,r_287_21_49,r_287_21_49,1.0,46,95,49,60
28,r_11_16_85,seq200,seq172,r_11_16_85,1.0,0,85,85,60
102,seq6,r_34_237_5,r_299_42_178,r_299_42_178,0.46,-12,166,178,60
135,seq119,r_216_279_184,r_239_295_19,r_216_279_184,0.61,1,185,184,60
49,r_282_4_91,r_143_63_145,seq96,r_282_4_91,1.0,0,91,91,60
58,r_0_1_16,r_178_189_80,seq155,r_0_1_16,0.89,1,17,16,60
7,r_270_275_111,r_216_279_184,r_195_236_11,r_270_275_111,0.9,1,112,111,60
23,r_227_136_115,seq165,r_12_43_25,r_227_136_115,0.99,0,115,115,60
94,r_111_39_9,r_84_104_188,r_290_50_42,r_290_50_42,1.0,46,88,42,60
17,r_45_112_121,r_29_191_35,r_90_78_1,r_45_112_121,0.95,0,121,121,60
38,r_290_50_42,r_223_234_167,seq167,r_290_50_42,1.0,-1,41,42,60
186,seq260,r_207_152_167,r_220_3_101,r_220_3_101,1.0,64,165,101,60
35,r_61_182_73,r_268_126_185,r_149_57_6,r_61_182_73,1.0,-1,72,73,60
12,r_289_162_185,r_125_199_115,r_156_124_8,r_125_199_115,1.0,0,115,115,60
65,r_224_123_57,r_92_254_110,seq198,r_224_123_57,1.0,0,57,57,60
84,r_145_231_72,r_166_60_194,r_150_24_32,r_145_231_72,0.48,-11,61,72,60
8,r_99_24_69,seq232,seq272,r_99_24_69,1.0,0,69,69,61
151,seq140,r_28_46_115,seq44,r_28_46_115,1.0,0,115,115,61
53,r_25_257_128,r_98_79_152,seq60,r_25_257_128,0.89,0,128,128,61
43,r_58_167_135,seq103,seq107,r_58_167_135,1.0,1,136,135,61
147,seq121,r_14_156_95,r_114_135_99,r_114_135_99,0.94,7,106,99,61
99,r_75_128_37,r_225_169_81,seq60,r_225_169_81,0.76,0,81,81,61
54,r_190_13_90,seq0,seq144,r_190_13_90,0.97,11,101,90,61
83,r_174_27_128,seq20,r_160_213_32,r_174_27_128,0.61,0,128,128,61
116,seq41,r_14_156_95,r_230_110_77,r_230_110_77,1.0,56,133,77,61
37,r_164_34_98,seq6,seq50,r_164_34_98,0.97,0,98,98,61
7,r_295_102_73,r_75_128_37,r_236_166_81,r_75_128_37,0.96,5,42,37,61
55,r_114_135_99,seq158,seq121,r_114_135_99,0.99,0,99,99,61
71,r_78_258_63,seq85,seq6,r_78_258_63,1.0,0,63,63,61
86,r_30_204_84,seq162,seq291,r_30_204_84,1.0,1,85,84,61
21,r_236_166_81,r_174_27_128,r_240_104_14,r_236_166_81,1.0,0,81,81,61
39,r_230_110_77,seq243,seq41,r_230_110_77,1.0,0,77,77,61
97,r_68_3_132,seq17,seq185,r_68_3_132,0.91,1,133,132,61
14,r_285_270_43,seq41,seq39,r_285_270_43,0.9,0,43,43,61
143,seq107,r_113_97_102,seq84,r_113_97_102,0.97,1,103,102,61
5,r_184_168_189,r_281_54_75,r_222_88_25,r_281_54_75,0.99,-1,74,75,61
46,r_125_275_128,seq217,r_230_110_77,r_230_110_77,0.94,51,128,77,61
94,r_32_124_21,r_187_245_121,r_73_246_3,r_32_124_21,0.97,1,22,21,61
87,r_240_104_14,r_125_275_128,r_231_249_144,r_240_104_14,1.0,1,15,14,61
123,seq59,r_125_275_128,r_205_248_25,r_205_248_25,1.0,1,26,25,61
156,seq154,r_173_136_31,seq266,r_173_136_31,0.99,0,31,31,61
45,r_134_233_145,r_231_249_144,r_99_24_69,r_231_249_144,0.85,1,145,144,61
69,r_225_169_81,r_75_128_37,r_80_37_62,r_225_169_81,1.0,1,82,81,61
127,seq70,r_202_92_32,r_183_74_39,r_183_74_39,1.0,0,39,39,61
153,seq144,r_150_55_180,r_299_111_85,r_150_55_180,0.73,0,180,180,61
156,seq154,seq266,r_77_127_56,r_77_127_56,1.0,32,88,56,61
95,r_276_253_140,seq81,seq103,r_276_253_140,0.92,0,140,140,61
66,r_98_79_152,seq271,seq103,r_98_79_152,0.82,0,152,152,61
76,r_66_90_62,r_199_178_110,seq10,r_199_178_110,1.0,-50,60,110,61
99,r_75_128_37,r_295_102_73,r_225_169_81,r_75_128_37,1.0,1,38,37,61
32,r_123_269_54,r_244_51_85,seq21,r_123_269_54,1.0,0,54,54,61
115,seq39,seq100,r_285_270_43,r_285_270_43,1.0,9,52,43,61
31,r_215_259_168,seq288,r_11_280_166,r_215_259_168,0.61,0,168,168,61
67,r_220_157_184,seq93,r_236_166_81,r_236_166_81,0.51,103,184,81,61
89,r_227_228_177,seq50,seq93,r_227_228_177,0.52,0,177,177,61
3,r_262_195_153,seq209,r_25_257_128,r_262_195_153,0.98,1,154,153,61
90,r_129_35_116,r_276_253_140,r_105_48_83,r_129_35_116,1.0,2,118,116,61
47,r_1_267_18,r_244_51_85,r_250_63_13,r_1_267_18,0.99,0,18,18,61
57,r_108_151_56,r_105_48_83,r_112_261_29,r_108_151_56,0.99,2,58,56,61
72,r_252_238_69,seq86,seq210,r_252_238_69,1.0,0,69,69,61
4,r_299_111_85,r_216_171_103,seq31,r_216_171_103,0.98,1,104,103,61
78,r_242_120_106,r_68_3_132,seq107,r_242_120_106,0.99,0,106,106,61
0,r_143_235_90,r_134_233_145,r_2_211_5,r_143_235_90,0.77,1,91,90,61
11,r_187_245_121,seq272,r_181_172_67,r_187_245_121,0.96,0,121,121,61
107,seq17,seq223,r_295_102_73,r_295_102_73,1.0,35,108,73,61
13,r_206_94_177,seq9,r_61_118_74,r_61_118_74,0.54,104,178,74,61
98,r_260_12_118,r_150_55_180,seq292,r_260_12_118,0.64,4,122,118,61
109,seq21,r_239_196_165,r_123_269_54,r_123_269_54,1.0,1,55,54,61
15,r_137_175_117,r_214_132_18,seq191,r_137_175_117,0.93,2,119,117,61
166,seq191,seq42,r_137_175_117,r_137_175_117,1.0,22,139,117,61
106,seq16,r_165_142_129,r_146_116_125,r_165_142_129,0.63,-3,126,129,61
181,seq232,r_294_234_172,r_183_74_39,r_183_74_39,0.98,119,158,39,61
6,r_203_89_143,seq268,seq29,r_203_89_143,0.69,1,144,143,61
92,r_77_127_56,r_139_177_86,seq154,r_77_127_56,1.0,2,58,56,61
61,r_112_261_29,r_43_56_177,seq49,r_112_261_29,1.0,0,29,29,61
85,r_43_56_177,seq41,r_137_175_117,r_43_56_177,0.54,0,177,177,61
63,r_205_248_25,r_28_46_115,seq59,r_205_248_25,1.0,0,25,25,61
5,r_184_168_189,r_222_88_25,r_68_3_132,r_222_88_25,0.6,164,189,25,61
58,r_218_278_37,r_225_169_81,seq241,r_218_278_37,1.0,0,37,37,61
16,r_183_74_39,r_295_102_73,seq70,r_183_74_39,1.0,0,39,39,61
62,r_224_229_27,r_202_92_32,r_286_47_188,r_224_229_27,1.0,0,27,27,61
7,r_295_102_73,r_236_166_81,seq17,r_295_102_73,0.89,1,74,73,61
2,r_244_51_85,r_115_274_193,r_80_37_62,r_115_274_193,1.0,-109,84,193,61
105,seq10,r_65_283_100,r_66_90_62,r_65_283_100,1.0,0,100,100,61
74,r_76_15_104,r_199_178_110,r_295_102_73,r_76_15_104,1.0,0,104,104,61
29,r_133_279_162,seq17,r_160_213_32,r_160_213_32,0.67,130,162,32,61
24,r_4_182_118,seq83,r_250_63_13,r_4_182_118,0.99,0,118,118,61
25,r_65_283_100,seq10,seq194,r_65_283_100,0.99,0,100,100,61
33,r_45_22_100,seq64,seq266,r_45_22_100,0.99,1,101,100,61
69,r_225_169_81,r_218_278_37,r_75_128_37,r_225_169_81,1.0,-44,37,81,61
64,r_264_193_23,seq10,seq243,r_264_193_23,1.0,0,23,23,61
70,r_199_178_110,seq186,r_264_193_23,r_199_178_110,0.73,1,111,110,61
65,r_38_53_86,seq9,seq117,r_38_53_86,1.0,0,86,86,61
192,seq287,r_146_116_125,r_149_69_55,r_149_69_55,0.92,41,96,55,61
38,r_165_142_129,seq119,r_143_235_90,r_165_142_129,0.87,0,129,129,61
77,r_19_179_183,r_139_177_86,r_150_55_180,r_19_179_183,0.37,1,184,183,61
196,seq291,r_239_196_165,r_30_204_84,r_30_204_84,0.88,20,104,84,61
73,r_219_18_43,r_11_280_166,seq106,r_219_18_43,1.0,0,43,43,61
75,r_67_71_81,seq266,seq232,r_67_71_81,1.0,0,81,81,61
19,r_222_88_25,r_105_48_83,r_184_168_189,r_184_168_189,0.79,-163,26,189,61
60,r_216_171_103,seq210,r_139_177_86,r_216_171_103,0.99,1,104,103,61
81,r_181_172_67,r_139_177_86,r_187_245_121,r_187_245_121,0.97,3,124,121,61
118,seq44,r_61_118_74,r_214_132_18,r_61_118_74,1.0,-17,57,74,61
51,r_286_47_188,r_230_110_77,r_224_229_27,r_286_47_188,0.7,-134,54,188,61
84,r_250_63_13,r_138_40_194,seq297,r_250_63_13,0.69,0,13,13,61
171,seq200,r_155_159_182,r_262_195_153,r_262_195_153,0.81,29,182,153,61
9,r_61_118_74,seq44,r_188_251_183,r_61_118_74,1.0,0,74,74,61
96,r_28_46_115,seq140,seq271,r_28_46_115,0.99,0,115,115,61
27,r_23_263_27,r_295_102_73,r_240_104_14,r_23_263_27,1.0,1,28,27,61
22,r_294_234_172,seq232,r_113_97_102,r_113_97_102,0.85,70,172,102,61
10,r_149_69_55,r_113_97_102,seq287,r_149_69_55,1.0,0,55,55,61
91,r_126_101_102,r_174_27_128,seq8,r_126_101_102,1.0,1,103,102,61
0,r_143_235_90,r_2_211_5,r_165_142_129,r_165_142_129,0.8,2,131,129,61
164,seq186,r_199_178_110,seq42,r_199_178_110,1.0,-14,96,110,61
69,r_225_169_81,r_80_37_62,r_68_3_132,r_68_3_132,0.9,38,170,132,61
44,r_146_116_125,seq287,seq16,r_146_116_125,0.72,1,126,125,61
26,r_160_213_32,seq16,seq85,r_160_213_32,1.0,0,32,32,61
82,r_281_54_75,r_184_168_189,seq198,r_281_54_75,1.0,0,75,75,61
79,r_277_254_73,r_146_116_125,r_99_24_69,r_277_254_73,1.0,0,73,73,61
35,r_150_55_180,seq144,r_165_142_129,r_165_142_129,0.71,51,180,129,61
23,r_282_284_21,r_113_97_102,seq289,r_282_284_21,1.0,0,21,21,61
80,r_173_136_31,seq154,seq9,r_173_136_31,1.0,0,31,31,61
30,r_133_204_169,seq131,r_60_159_82,r_60_159_82,0.57,87,169,82,62
176,seq250,r_270_138_61,r_285_69_22,r_270_138_61,1.0,0,61,61,62
59,r_237_229_17,r_205_142_172,seq111,r_237_229_17,0.99,0,17,17,62
93,r_172_104_54,r_99_56_176,r_241_143_42,r_172_104_54,1.0,1,55,54,62
36,r_54_294_150,seq124,seq178,r_54_294_150,0.87,0,150,150,62
6,r_182_183_50,r_11_32_172,seq6,r_182_183_50,1.0,2,52,50,62
92,r_83_129_85,r_207_105_154,r_67_288_31,r_83_129_85,0.99,0,85,85,62
8,r_181_226_131,r_203_206_199,seq195,r_181_226_131,1.0,0,131,131,62
151,seq160,r_146_66_114,r_270_138_61,r_270_138_61,1.0,15,76,61,62
58,r_231_9_8,r_80_170_69,r_241_143_42,r_231_9_8,0.86,61,69,8,62
10,r_166_157_40,r_245_278_179,seq195,r_166_157_40,1.0,0,40,40,62
43,r_201_248_112,seq291,r_119_179_91,r_201_248_112,0.98,0,112,112,62
83,r_119_179_91,seq8,seq227,r_119_179_91,1.0,0,91,91,62
81,r_176_212_41,r_109_94_123,r_106_223_146,r_109_94_123,1.0,3,126,123,62
37,r_205_142_172,seq48,seq8,r_205_142_172,0.77,0,172,172,62
75,r_52_16_15,r_55_31_37,seq86,r_52_16_15,0.97,0,15,15,62
71,r_148_228_85,seq195,r_255_298_40,r_255_298_40,1.0,30,70,40,62
16,r_106_223_146,r_141_134_181,seq177,r_106_223_146,0.79,0,146,146,62
39,r_60_159_82,seq35,seq17,r_60_159_82,1.0,0,82,82,62
1,r_109_94_123,r_176_212_41,seq49,r_109_94_123,0.99,2,125,123,62
46,r_264_162_113,seq168,r_199_233_195,r_264_162_113,1.0,1,114,113,62
81,r_176_212_41,r_270_138_61,r_109_94_123,r_176_212_41,0.78,0,41,41,62
42,r_152_18_113,seq68,seq108,r_152_18_113,1.0,1,114,113,62
94,r_102_297_108,r_197_261_28,r_4_295_15,r_102_297_108,1.0,-93,15,108,62
80,r_80_170_69,r_245_278_179,seq111,r_80_170_69,1.0,0,69,69,62
73,r_276_81_59,seq195,seq180,r_276_81_59,1.0,0,59,59,62
77,r_255_298_40,seq177,seq96,r_255_298_40,1.0,1,41,40,62
19,r_271_215_112,r_246_265_148,r_117_268_196,r_271_215_112,1.0,0,112,112,62
189,seq279,r_113_12_48,r_40_188_37,r_113_12_48,1.0,0,48,48,62
33,r_67_288_31,seq44,seq177,r_67_288_31,0.99,3,34,31,62
95,r_132_120_186,r_217_275_116,r_207_105_154,r_132_120_186,0.45,0,186,186,62
76,r_99_56_176,seq92,seq293,r_99_56_176,0.62,0,176,176,62
41,r_73_53_83,seq259,r_38_236_85,r_73_53_83,1.0,2,85,83,62
14,r_78_185_56,seq25,seq17,r_78_185_56,1.0,0,56,56,62
89,r_230_89_68,r_70_41_197,seq291,r_230_89_68,1.0,0,68,68,62
61,r_4_295_15,r_78_185_56,r_102_297_108,r_4_295_15,0.99,0,15,15,62
3,r_150_140_146,seq266,r_246_265_148,r_150_140_146,0.94,1,147,146,62
90,r_247_116_105,seq155,r_241_143_42,r_247_116_105,1.0,0,105,105,62
2,r_197_261_28,r_102_297_108,r_217_275_116,r_217_275_116,0.77,-87,29,116,62
40,r_238_292_174,r_161_5_50,r_225_130_88,r_238_292_174,1.0,0,174,174,62
26,r_239_103_125,r_202_84_81,r_238_292_174,r_202_84_81,1.0,0,81,81,62
72,r_225_130_88,r_149_218_198,seq68,r_225_130_88,1.0,0,88,88,62
4,r_127_21_181,seq26,r_110_39_125,r_127_21_181,0.54,0,181,181,62
78,r_246_265_148,seq95,r_150_140_146,r_150_140_146,1.0,22,168,146,62
0,r_38_236_85,seq82,r_73_53_83,r_38_236_85,1.0,0,85,85,62
63,r_262_244_124,r_251_252_191,r_270_138_61,r_251_252_191,0.75,-65,126,191,62
55,r_14_286_17,seq85,seq168,r_14_286_17,1.0,0,17,17,62
107,seq22,r_245_278_179,r_241_143_42,r_241_143_42,1.0,137,179,42,62
20,r_242_164_175,seq174,r_238_292_174,r_242_164_175,0.56,1,176,175,62
98,r_76_47_170,seq291,seq193,r_76_47_170,0.68,2,172,170,62
15,r_251_252_191,r_262_244_124,seq63,r_262_244_124,1.0,3,127,124,62
48,r_199_233_195,r_242_164_175,r_264_162_113,r_264_162_113,0.8,2,115,113,62
28,r_40_188_37,r_276_81_59,seq279,r_276_81_59,0.98,-22,37,59,62
62,r_112_90_121,r_54_294_150,r_152_18_113,r_112_90_121,1.0,1,122,121,62
85,r_202_84_81,r_239_103_125,r_156_115_22,r_202_84_81,0.99,0,81,81,62
99,r_72_58_62,r_80_170_69,r_197_261_28,r_72_58_62,0.97,0,62,62,62
26,r_239_103_125,r_238_292_174,seq195,r_238_292_174,0.7,-48,126,174,62
27,r_196_19_68,seq62,seq235,r_196_19_68,1.0,0,68,68,62
87,r_269_224_123,r_29_175_178,r_4_295_15,r_269_224_123,0.9,1,124,123,62
96,r_43_189_38,r_181_226_131,r_123_122_158,r_43_189_38,1.0,0,38,38,62
47,r_28_173_176,seq293,r_181_226_131,r_28_173_176,0.74,0,176,176,62
40,r_238_292_174,r_239_103_125,r_161_5_50,r_161_5_50,0.66,76,126,50,62
68,r_161_5_50,r_112_90_121,seq266,r_161_5_50,0.7,2,52,50,62
74,r_61_100_158,seq135,r_243_3_103,r_61_100_158,0.9,0,158,158,62
5,r_128_64_10,r_240_151_159,seq250,r_128_64_10,0.95,0,10,10,62
61,r_4_295_15,r_102_297_108,r_247_116_105,r_4_295_15,1.0,94,109,15,62
102,seq8,seq259,r_205_142_172,r_205_142_172,0.85,-1,171,172,62
53,r_51_45_31,r_112_90_121,seq256,r_112_90_121,0.97,-90,31,121,62
50,r_249_284_17,r_187_190_32,seq48,r_249_284_17,0.56,-2,15,17,62
11,r_241_143_42,r_70_41_197,r_231_9_8,r_241_143_42,1.0,1,43,42,62
25,r_211_50_61,r_152_18_113,r_91_214_9,r_152_18_113,0.91,-52,61,113,62
88,r_207_105_154,seq266,r_51_45_31,r_207_105_154,0.6,2,156,154,62
190,seq280,r_70_41_197,r_210_118_70,r_210_118_70,1.0,57,127,70,62
156,seq174,r_242_164_175,r_110_39_125,r_242_164_175,0.9,1,176,175,62
70,r_210_118_70,r_264_162_113,seq280,r_210_118_70,0.98,0,70,70,62
79,r_220_171_38,r_166_157_40,seq174,r_220_171_38,1.0,0,38,38,62
65,r_137_59_81,r_152_18_113,r_14_286_17,r_137_59_81,1.0,0,81,81,62
38,r_107_23_64,r_181_226_131,seq85,r_107_23_64,1.0,0,64,64,62
34,r_57_289_144,r_91_214_9,r_7_20_3,r_57_289_144,0.99,0,144,144,62
29,r_113_12_48,seq279,seq192,r_113_12_48,1.0,0,48,48,62
60,r_245_278_179,seq22,r_133_204_169,r_245_278_179,0.65,0,179,179,62
97,r_285_69_22,r_83_129_85,seq250,r_285_69_22,0.98,0,22,22,62
13,r_2_258_44,r_182_183_50,seq192,r_2_258_44,1.0,0,44,44,62
17,r_29_175_178,seq144,r_182_183_50,r_29_175_178,0.8,0,178,178,62
56,r_187_190_32,r_145_186_129,seq144,r_187_190_32,1.0,0,32,32,62
21,r_87_163_52,seq0,r_4_295_15,r_87_163_52,0.99,0,52,52,62
67,r_77_97_57,seq86,seq42,r_77_97_57,1.0,0,57,57,62
7,r_55_31_37,seq36,seq114,r_55_31_37,0.97,1,38,37,62
1,r_109_94_123,r_141_134_181,r_176_212_41,r_176_212_41,0.89,0,41,41,62
22,r_243_3_103,r_152_18_113,seq114,r_243_3_103,0.99,0,103,103,62
102,seq8,r_119_179_91,seq259,r_119_179_91,0.87,2,93,91,62
91,r_270_138_61,seq250,seq160,r_270_138_61,1.0,0,61,61,62
135,seq111,r_11_32_172,r_80_170_69,r_80_170_69,1.0,64,133,69,62
49,r_217_275_116,r_132_120_186,seq250,r_132_120_186,0.71,-24,162,186,62
23,r_11_32_172,seq111,r_264_162_113,r_264_162_113,0.69,59,172,113,62
94,r_102_297_108,r_4_295_15,seq108,r_102_297_108,1.0,0,108,108,62
138,seq124,r_54_294_150,r_7_20_3,r_54_294_150,0.94,-24,126,150,62
64,r_156_115_22,r_148_228_85,seq95,r_156_115_22,1.0,0,22,22,62
82,r_272_88_74,seq46,r_51_45_31,r_272_88_74,0.96,-1,73,74,62
35,r_146_66_114,r_54_294_150,r_161_5_50,r_54_294_150,1.0,-36,114,150,62
12,r_141_134_181,seq257,r_238_292_174,r_141_134_181,0.73,0,181,181,62
84,r_34_27_174,seq6,r_166_157_40,r_166_157_40,0.89,134,174,40,62
93,r_61_234_139,seq40,r_152_15_26,r_61_234_139,0.98,0,139,139,63
30,r_273_96_84,seq109,seq153,r_273_96_84,1.0,0,84,84,63
176,seq229,r_240_65_171,r_239_114_85,r_239_114_85,1.0,88,173,85,63
92,r_125_139_147,seq64,r_12_87_5,r_125_139_147,0.89,0,147,147,63
8,r_202_213_112,r_225_102_173,r_130_47_66,r_225_102_173,0.51,-62,111,173,63
53,r_211_274_130,seq17,seq237,r_211_274_130,0.96,0,130,130,63
177,seq231,r_295_254_187,r_125_139_147,r_295_254_187,0.71,1,188,187,63
125,seq74,r_86_195_122,seq73,r_86_195_122,0.96,0,122,122,63
43,r_247_159_14,r_206_97_58,r_116_51_108,r_247_159_14,1.0,0,14,14,63
59,r_130_47_66,seq16,seq299,r_130_47_66,1.0,0,66,66,63
26,r_245_151_21,r_3_244_119,seq53,r_245_151_21,1.0,0,21,21,63
55,r_35_106_156,r_216_253_159,r_247_159_14,r_247_159_14,0.89,142,156,14,63
71,r_238_219_75,r_243_170_109,seq66,r_238_219_75,0.94,2,77,75,63
86,r_267_227_120,seq217,r_178_70_3,r_267_227_120,1.0,0,120,120,63
16,r_146_39_142,seq187,r_238_219_75,r_146_39_142,0.74,1,143,142,63
21,r_242_135_76,r_35_106_156,seq75,r_35_106_156,0.6,-79,77,156,63
39,r_113_233_145,seq120,seq16,r_113_233_145,1.0,0,145,145,63
1,r_86_195_122,seq74,r_32_175_96,r_86_195_122,1.0,0,122,122,63
88,r_189_7_173,r_24_248_52,r_3_244_119,r_189_7_173,0.99,0,173,173,63
42,r_239_114_85,seq184,seq229,r_239_114_85,1.0,0,85,85,63
111,seq53,seq124,r_245_151_21,r_245_151_21,1.0,104,125,21,63
66,r_165_110_160,r_9_79_55,seq199,r_9_79_55,0.56,8,63,55,63
45,r_11_132_171,seq187,seq199,r_11_132_171,0.5,0,171,171,63
35,r_107_1_50,r_10_246_70,seq72,r_107_1_50,1.0,1,51,50,63
28,r_284_98_53,seq259,r_206_97_58,r_206_97_58,1.0,0,58,58,63
27,r_24_248_52,r_189_7_173,r_226_209_86,r_24_248_52,0.93,121,173,52,63
78,r_225_102_173,seq237,seq117,r_225_102_173,0.95,0,173,173,63
41,r_91_155_122,seq199,r_165_110_160,r_91_155_122,0.55,1,123,122,63
67,r_240_65_171,seq229,r_45_149_105,r_45_149_105,1.0,68,173,105,63
3,r_80_173_58,r_202_213_112,r_28_186_199,r_80_173_58,0.95,0,58,58,63
89,r_44_163_108,seq288,r_37_198_4,r_44_163_108,0.95,0,108,108,63
96,r_20_94_179,r_276_85_16,r_86_195_122,r_86_195_122,0.69,59,181,122,63
90,r_68_147_147,r_216_253_159,r_91_155_122,r_68_147_147,0.99,1,148,147,63
36,r_152_15_26,r_207_54_160,seq204,r_152_15_26,0.99,0,26,26,63
72,r_76_214_107,seq69,seq153,r_76_214_107,0.7,3,110,107,63
27,r_24_248_52,r_243_170_109,r_189_7_173,r_24_248_52,1.0,0,52,52,63
170,seq212,seq120,r_104_174_78,r_104_174_78,1.0,42,120,78,63
78,r_225_102_173,r_202_213_112,seq237,r_202_213_112,1.0,-26,86,112,63
63,r_10_246_70,seq217,r_276_85_16,r_10_246_70,1.0,0,70,70,63
73,r_6_282_117,seq296,r_32_175_96,r_32_175_96,0.73,19,115,96,63
11,r_207_54_160,seq36,seq53,r_207_54_160,0.76,0,160,160,63
107,seq36,r_207_54_160,r_126_41_123,r_126_41_123,0.69,37,160,123,63
20,r_58_172_139,seq26,seq287,r_58_172_139,0.86,1,140,139,63
13,r_144_142_123,seq256,r_107_1_50,r_107_1_50,1.0,93,143,50,63
98,r_251_128_76,r_6_282_117,r_134_222_40,r_251_128_76,1.0,1,77,76,63
48,r_228_59_90,r_252_230_125,seq261,r_228_59_90,1.0,1,91,90,63
57,r_126_41_123,seq220,seq36,r_126_41_123,0.99,1,124,123,63
167,seq199,r_81_119_192,r_12_87_5,r_12_87_5,0.36,95,100,5,63
6,r_226_209_86,r_144_142_123,r_9_79_55,r_226_209_86,1.0,1,87,86,63
62,r_5_200_178,r_271_167_132,r_202_213_112,r_202_213_112,1.0,67,179,112,63
74,r_116_51_108,r_247_159_14,seq297,r_116_51_108,1.0,0,108,108,63
85,r_19_52_113,r_289_82_190,r_83_111_121,r_19_52_113,0.99,-1,112,113,63
99,r_28_186_199,r_145_2_129,r_232_190_92,r_28_186_199,1.0,-99,100,199,63
34,r_276_85_16,r_226_209_86,r_20_94_179,r_276_85_16,1.0,0,16,16,63
161,seq184,seq166,r_86_195_122,r_86_195_122,1.0,60,182,122,63
66,r_165_110_160,r_91_155_122,r_235_168_105,r_165_110_160,1.0,1,161,160,63
192,seq283,r_83_111_121,r_201_298_11,r_201_298_11,1.0,0,11,11,63
87,r_232_190_92,r_290_22_9,r_28_186_199,r_232_190_92,0.79,5,97,92,63
41,r_91_155_122,r_165_110_160,r_68_147_147,r_91_155_122,0.91,39,161,122,63
2,r_84_0_147,seq296,r_86_195_122,r_84_0_147,0.53,0,147,147,63
40,r_243_170_109,r_125_139_147,seq109,r_243_170_109,0.96,1,110,109,63
126,seq75,r_210_205_147,r_242_135_76,r_210_205_147,0.53,-32,115,147,63
47,r_277_33_56,seq117,r_28_186_199,r_277_33_56,1.0,0,56,56,63
18,r_104_174_78,r_285_293_106,seq212,r_104_174_78,1.0,0,78,78,63
29,r_156_99_181,seq73,r_235_168_105,r_235_168_105,0.56,76,181,105,63
157,seq179,seq53,r_100_46_94,r_100_46_94,1.0,9,103,94,63
4,r_134_222_40,r_24_248_52,seq14,r_134_222_40,0.89,3,43,40,63
177,seq231,r_252_230_125,r_295_254_187,r_252_230_125,1.0,0,125,125,63
34,r_276_85_16,r_20_94_179,r_10_246_70,r_10_246_70,1.0,111,181,70,63
80,r_23_38_20,r_207_54_160,seq95,r_23_38_20,0.86,0,20,20,63
43,r_247_159_14,r_116_51_108,seq261,r_116_51_108,1.0,0,108,108,63
64,r_93_194_166,seq25,r_24_248_52,r_93_194_166,0.83,0,166,166,63
37,r_201_298_11,r_48_161_118,seq283,r_201_298_11,0.95,0,11,11,63
88,r_189_7_173,seq123,r_24_248_52,r_24_248_52,1.0,62,114,52,63
50,r_162_221_61,r_171_272_185,seq154,r_162_221_61,1.0,0,61,61,63
58,r_83_111_121,seq124,r_19_52_113,r_19_52_113,0.86,9,122,113,63
70,r_216_253_159,seq154,r_228_59_90,r_228_59_90,0.97,70,160,90,63
65,r_285_293_106,seq118,seq26,r_285_293_106,1.0,0,106,106,63
25,r_206_97_58,seq212,r_284_98_53,r_206_97_58,1.0,0,58,58,63
137,seq118,r_285_293_106,seq73,r_285_293_106,1.0,0,106,106,63
61,r_140_34_137,seq180,seq66,r_140_34_137,0.97,0,137,137,63
32,r_171_272_185,seq157,r_12_87_5,r_12_87_5,0.72,181,186,5,63
38,r_31_158_110,seq72,r_42_249_100,r_42_249_100,1.0,13,113,100,63
75,r_30_18_165,seq166,r_91_155_122,r_30_18_165,0.81,0,165,165,63
124,seq73,r_156_99_181,r_252_230_125,r_252_230_125,1.0,56,181,125,63
60,r_45_149_105,seq184,seq180,r_45_149_105,0.99,0,105,105,63
66,r_165_110_160,r_48_161_118,r_9_79_55,r_165_110_160,0.59,-122,38,160,63
81,r_42_249_100,seq90,seq224,r_42_249_100,1.0,0,100,100,63
9,r_48_161_118,seq120,seq67,r_48_161_118,1.0,0,118,118,63
136,seq117,r_277_33_56,seq69,r_277_33_56,1.0,0,56,56,63
133,seq109,r_80_173_58,r_243_170_109,r_243_170_109,0.63,12,121,109,63
22,r_9_79_55,r_239_114_85,seq50,r_9_79_55,1.0,0,55,55,63
91,r_100_46_94,seq95,seq179,r_100_46_94,1.0,0,94,94,63
49,r_294_141_80,r_232_190_92,r_107_1_50,r_294_141_80,1.0,0,80,80,63
56,r_148_164_139,seq49,seq237,r_148_164_139,0.83,0,139,139,63
7,r_268_43_60,r_83_111_121,seq137,r_268_43_60,1.0,0,60,60,63
44,r_235_168_105,seq204,seq64,r_235_168_105,1.0,1,106,105,63
23,r_32_175_96,seq115,r_232_190_92,r_32_175_96,1.0,0,96,96,63
138,seq120,r_48_161_118,seq143,r_48_161_118,1.0,-22,96,118,63
108,seq40,r_61_234_139,seq188,r_61_234_139,1.0,-1,138,139,63
82,r_145_2_129,r_28_186_199,r_263_258_29,r_145_2_129,0.98,0,129,129,63
96,r_20_94_179,r_84_0_147,r_276_85_16,r_276_85_16,0.94,8,24,16,63
79,r_289_82_190,r_88_291_196,r_226_209_86,r_226_209_86,1.0,104,190,86,63
84,r_295_254_187,seq231,r_226_209_86,r_226_209_86,1.0,102,188,86,63
74,r_116_51_108,seq281,r_247_159_14,r_247_159_14,0.95,29,43,14,63
199,seq299,seq157,r_130_47_66,r_130_47_66,1.0,31,97,66,63
36,r_245_26_64,r_12_64_116,seq149,r_245_26_64,0.65,-1,63,64,64
92,r_93_169_177,r_120_72_153,r_58_118_93,r_58_118_93,1.0,56,149,93,64
14,r_68_176_138,seq44,r_210_10_89,r_210_10_89,1.0,55,144,89,64
43,r_57_181_148,seq20,r_253_35_117,r_57_181_148,0.89,0,148,148,64
37,r_206_282_107,seq87,seq94,r_206_282_107,0.72,0,107,107,64
80,r_14_79_24,r_178_236_62,r_183_296_124,r_14_79_24,1.0,-3,21,24,64
165,seq187,r_142_204_150,r_215_29_20,r_215_29_20,0.63,-3,17,20,64
17,r_197_91_23,r_298_267_106,seq191,r_197_91_23,0.96,0,23,23,64
71,r_250_184_70,seq32,r_215_29_20,r_250_184_70,0.74,-3,67,70,64
86,r_58_118_93,seq15,r_241_23_3,r_58_118_93,1.0,1,94,93,64
16,r_298_267_106,r_121_137_185,seq94,r_298_267_106,1.0,0,106,106,64
12,r_182_171_50,r_245_26_64,r_209_153_199,r_209_153_199,0.8,-150,49,199,64
1,r_278_59_119,seq146,seq33,r_278_59_119,0.78,9,128,119,64
97,r_277_110_189,seq87,r_8_265_60,r_8_265_60,1.0,130,190,60,64
5,r_290_189_175,r_227_49_93,r_231_216_77,r_231_216_77,1.0,37,114,77,64
46,r_56_185_63,seq106,r_163_263_19,r_56_185_63,0.88,0,63,63,64
42,r_235_272_175,seq73,r_257_229_10,r_257_229_10,0.73,170,180,10,64
45,r_258_132_160,r_36_85_4,seq214,r_258_132_160,0.49,1,161,160,64
2,r_174_161_35,seq27,seq269,r_174_161_35,1.0,0,35,35,64
53,r_180_154_43,r_298_267_106,r_114_101_35,r_298_267_106,1.0,-63,43,106,64
66,r_226_133_103,r_220_264_159,r_55_119_29,r_220_264_159,0.98,-55,104,159,64
31,r_211_51_28,seq16,seq74,r_211_51_28,0.87,-3,25,28,64
170,seq194,r_275_105_106,r_4_127_54,r_275_105_106,1.0,-51,55,106,64
161,seq168,r_213_157_168,r_145_234_8,r_213_157_168,1.0,0,168,168,64
41,r_42_92_129,r_209_153_199,seq103,r_42_92_129,0.98,0,129,129,64
96,r_253_35_117,r_213_157_168,r_57_181_148,r_253_35_117,0.88,33,150,117,64
67,r_233_202_156,r_120_72_153,r_223_134_127,r_223_134_127,0.96,27,154,127,64
89,r_275_105_106,seq194,seq152,r_275_105_106,1.0,0,106,106,64
10,r_142_204_150,seq88,r_243_90_53,r_142_204_150,0.46,2,152,150,64
72,r_121_137_185,seq240,r_56_185_63,r_56_185_63,0.56,122,185,63,64
35,r_243_90_53,seq128,seq193,r_243_90_53,1.0,0,53,53,64
4,r_172_254_94,seq192,r_99_0_6,r_172_254_94,0.97,0,94,94,64
64,r_280_1_37,r_217_25_157,seq63,r_280_1_37,0.98,0,37,37,64
52,r_40_299_57,r_227_49_93,seq297,r_40_299_57,1.0,-2,55,57,64
63,r_34_104_94,seq159,seq62,r_34_104_94,1.0,0,94,94,64
79,r_123_155_27,r_210_10_89,seq48,r_123_155_27,1.0,0,27,27,64
73,r_82_111_162,seq269,seq9,r_82_111_162,0.75,0,162,162,64
11,r_165_70_132,seq193,r_255_232_6,r_165_70_132,0.71,0,132,132,64
20,r_178_236_62,seq140,r_174_161_35,r_178_236_62,0.98,1,63,62,64
15,r_3_283_130,r_183_296_124,r_172_254_94,r_3_283_130,0.95,0,130,130,64
48,r_221_201_108,seq286,seq287,r_221_201_108,0.6,0,108,108,64
57,r_130_150_188,r_116_60_159,r_56_185_63,r_56_185_63,0.89,96,159,63,64
117,seq44,r_68_176_138,r_285_96_80,r_285_96_80,1.0,0,80,80,64
6,r_220_264_159,r_277_110_189,r_197_91_23,r_220_264_159,0.49,2,161,159,64
92,r_93_169_177,r_58_118_93,r_21_37_126,r_93_169_177,0.82,0,177,177,64
85,r_170_141_92,seq98,r_56_185_63,r_170_141_92,1.0,-2,90,92,64
5,r_290_189_175,r_231_216_77,r_174_161_35,r_290_189_175,0.92,1,176,175,64
74,r_260_242_36,r_298_267_106,r_77_177_31,r_260_242_36,0.84,0,36,36,64
161,seq168,r_71_80_108,r_213_157_168,r_71_80_108,1.0,1,109,108,64
27,r_41_173_176,seq192,r_162_7_33,r_41_173_176,0.48,0,176,176,64
57,r_130_150_188,r_56_185_63,r_197_91_23,r_130_150_188,0.76,0,188,188,64
47,r_114_101_35,r_298_267_106,seq193,r_114_101_35,1.0,0,35,35,64
18,r_125_158_177,seq5,r_257_229_10,r_257_229_10,0.88,170,180,10,64
195,seq287,seq140,r_221_201_108,r_221_201_108,0.91,9,117,108,64
24,r_217_25_157,seq62,r_21_37_126,r_217_25_157,0.8,0,157,157,64
54,r_162_7_33,r_125_158_177,seq73,r_162_7_33,0.85,-2,31,33,64
82,r_163_263_19,r_11_247_116,seq128,r_163_263_19,1.0,0,19,19,64
90,r_215_29_20,r_34_104_94,seq187,r_215_29_20,0.82,-3,17,20,64
33,r_120_72_153,r_233_202_156,r_298_267_106,r_298_267_106,0.92,47,153,106,64
88,r_116_60_159,r_130_150_188,r_197_91_23,r_116_60_159,0.74,0,159,159,64
58,r_47_147_160,seq83,seq28,r_47_147_160,0.94,0,160,160,64
19,r_289_18_14,seq31,seq159,r_289_18_14,0.93,0,14,14,64
70,r_22_200_74,seq5,r_182_171_50,r_22_200_74,0.77,0,74,74,64
65,r_136_102_100,r_68_176_138,r_210_10_89,r_210_10_89,1.0,5,94,89,64
0,r_55_119_29,r_21_37_126,seq195,r_55_119_29,1.0,0,29,29,64
155,seq152,seq164,r_275_105_106,r_275_105_106,1.0,0,106,106,64
68,r_46_273_85,r_220_264_159,seq248,r_46_273_85,1.0,0,85,85,64
61,r_122_208_69,r_231_216_77,seq98,r_122_208_69,0.43,-2,67,69,64
38,r_227_49_93,r_290_189_175,seq39,r_290_189_175,0.67,-65,110,175,64
25,r_115_198_42,seq30,r_233_202_156,r_115_198_42,1.0,0,42,42,64
169,seq193,r_165_70_132,r_114_101_35,r_114_101_35,0.68,97,132,35,64
34,r_231_216_77,r_122_208_69,r_238_268_35,r_231_216_77,0.92,0,77,77,64
39,r_219_256_34,r_290_189_175,seq140,r_219_256_34,0.93,0,34,34,64
59,r_65_45_14,r_298_267_106,seq218,r_65_45_14,0.61,0,14,14,64
60,r_71_80_108,seq168,r_238_268_35,r_71_80_108,1.0,0,108,108,64
21,r_76_239_35,r_183_296_124,r_197_91_23,r_76_239_35,0.85,0,35,35,64
81,r_293_131_137,r_4_127_54,r_46_273_85,r_4_127_54,0.69,83,137,54,64
168,seq192,r_172_254_94,seq117,r_172_254_94,1.0,-16,78,94,64
50,r_151_100_35,r_142_204_150,r_223_134_127,r_151_100_35,0.75,-10,25,35,64
173,seq199,r_12_64_116,r_11_247_116,r_12_64_116,0.97,0,116,116,64
25,r_115_198_42,r_233_202_156,r_81_97_59,r_115_198_42,0.84,114,156,42,64
69,r_126_274_46,r_47_147_160,seq287,r_126_274_46,1.0,0,46,46,64
9,r_8_265_60,r_56_185_63,seq61,r_8_265_60,1.0,0,60,60,64
96,r_253_35_117,r_183_296_124,r_213_157_168,r_253_35_117,0.67,0,117,117,64
51,r_238_268_35,seq270,r_114_101_35,r_238_268_35,0.94,0,35,35,64
22,r_210_10_89,r_71_80_108,seq103,r_210_10_89,0.49,1,90,89,64
49,r_285_96_80,seq6,seq44,r_285_96_80,1.0,0,80,80,64
56,r_95_86_71,seq74,seq248,r_95_86_71,1.0,0,71,71,64
7,r_292_69_132,r_165_70_132,r_81_97_59,r_292_69_132,1.0,0,132,132,64
44,r_12_64_116,seq199,seq84,r_12_64_116,1.0,0,116,116,64
23,r_36_85_4,r_258_132_160,r_114_101_35,r_114_101_35,0.74,119,154,35,64
13,r_81_97_59,r_210_10_89,r_115_198_42,r_115_198_42,0.9,17,59,42,64
84,r_2_212_162,r_241_23_3,r_174_161_35,r_241_23_3,0.4,159,162,3,64
40,r_241_210_184,r_151_14_60,seq212,r_241_210_184,0.69,1,185,184,65
30,r_110_245_176,seq167,r_181_120_56,r_110_245_176,0.46,0,176,176,65
44,r_58_111_186,seq113,r_158_85_65,r_58_111_186,0.98,0,186,186,65
51,r_87_160_177,seq221,r_96_33_144,r_87_160_177,0.67,0,177,177,65
36,r_246_41_114,seq129,seq116,r_246_41_114,1.0,0,114,114,65
8,r_276_223_87,seq2,seq260,r_276_223_87,1.0,0,87,87,65
37,r_84_179_166,seq108,r_134_141_26,r_84_179_166,0.81,1,167,166,65
54,r_144_32_169,r_47_56_131,r_175_106_117,r_144_32_169,0.74,-52,117,169,65
59,r_199_299_92,r_263_176_137,r_134_141_26,r_199_299_92,1.0,-3,89,92,65
55,r_132_114_153,r_38_147_169,r_250_64_47,r_132_114_153,0.99,0,153,153,65
71,r_240_17_135,seq125,r_175_106_117,r_240_17_135,0.95,0,135,135,65
97,r_177_71_181,seq81,r_166_184_17,r_177_71_181,0.52,0,181,181,65
5,r_262_164_115,r_58_111_186,r_88_218_30,r_262_164_115,1.0,0,115,115,65
42,r_27_117_83,seq2,r_99_189_198,r_27_117_83,1.0,0,83,83,65
9,r_230_6_32,seq224,seq215,r_230_6_32,1.0,-1,31,32,65
80,r_158_85_65,r_47_56_131,seq149,r_158_85_65,1.0,0,65,65,65
69,r_188_222_63,r_292_35_123,seq2,r_188_222_63,1.0,0,63,63,65
39,r_165_256_54,seq180,r_50_11_160,r_165_256_54,1.0,0,54,54,65
87,r_181_120_56,r_84_179_166,r_138_248_26,r_181_120_56,0.94,0,56,56,65
19,r_8_20_92,seq0,seq51,r_8_20_92,1.0,0,92,92,65
82,r_175_106_117,r_144_32_169,r_240_17_135,r_144_32_169,0.98,0,169,169,65
73,r_231_268_33,r_100_30_27,seq290,r_231_268_33,1.0,-2,31,33,65
31,r_131_55_97,seq279,seq216,r_131_55_97,1.0,0,97,97,65
67,r_67_273_159,seq296,seq211,r_67_273_159,0.94,0,159,159,65
35,r_257_3_55,seq237,seq37,r_257_3_55,1.0,0,55,55,65
26,r_169_186_167,seq237,r_201_235_153,r_201_235_153,0.88,23,176,153,65
170,seq208,r_232_283_186,r_5_225_21,r_5_225_21,0.95,165,186,21,65
198,seq291,seq122,r_206_238_124,r_206_238_124,1.0,20,144,124,65
4,r_258_255_145,seq221,seq118,r_258_255_145,0.58,4,149,145,65
78,r_185_183_119,r_156_275_138,r_145_57_66,r_185_183_119,1.0,0,119,119,65
0,r_298_234_118,r_174_112_100,r_82_133_78,r_298_234_118,0.96,1,119,118,65
11,r_76_294_96,seq237,r_22_105_18,r_76_294_96,0.75,0,96,96,65
54,r_144_32_169,r_175_106_117,seq2,r_144_32_169,0.99,0,169,169,65
20,r_206_238_124,r_50_11_160,seq291,r_206_238_124,0.94,2,126,124,65
70,r_155_102_39,r_265_72_12,r_45_101_30,r_155_102_39,0.96,0,39,39,65
98,r_151_14_60,r_190_287_194,r_241_210_184,r_151_14_60,0.96,1,61,60,65
15,r_201_235_153,seq249,seq129,r_201_235_153,0.91,0,153,153,65
57,r_267_15_26,r_139_59_87,seq81,r_267_15_26,1.0,-1,25,26,65
17,r_9_25_54,r_8_20_92,seq75,r_8_20_92,1.0,-41,51,92,65
117,seq51,r_190_287_194,r_8_20_92,r_8_20_92,1.0,45,137,92,65
139,seq116,r_91_90_99,seq159,r_91_90_99,0.99,-40,59,99,65
6,r_80_286_99,seq290,seq54,r_80_286_99,1.0,1,100,99,65
89,r_148_121_48,r_92_254_76,r_50_11_160,r_148_121_48,1.0,0,48,48,65
85,r_190_287_194,r_84_179_166,r_8_20_92,r_8_20_92,0.92,13,105,92,65
134,seq103,r_190_287_194,r_97_282_60,r_97_282_60,1.0,0,60,60,65
27,r_128_49_101,seq212,seq159,r_128_49_101,1.0,0,101,101,65
54,r_144_32_169,r_131_55_97,r_47_56_131,r_131_55_97,0.66,-62,35,97,65
16,r_166_184_17,r_276_223_87,seq122,r_166_184_17,1.0,0,17,17,65
2,r_139_59_87,r_232_283_186,seq13,r_232_283_186,0.76,-105,81,186,65
47,r_16_242_184,r_146_251_170,r_150_53_93,r_146_251_170,0.43,14,184,170,65
142,seq122,seq291,r_239_157_97,r_239_157_97,0.95,17,114,97,65
25,r_134_141_26,r_82_133_78,seq244,r_134_141_26,0.97,-1,25,26,65
40,r_241_210_184,r_99_189_198,r_151_14_60,r_151_14_60,0.99,36,96,60,65
74,r_97_282_60,seq126,seq103,r_97_282_60,1.0,0,60,60,65
18,r_96_33_144,seq153,r_246_41_114,r_246_41_114,0.99,32,146,114,65
29,r_145_57_66,seq237,r_146_251_170,r_145_57_66,1.0,-3,63,66,65
111,seq34,seq18,r_22_105_18,r_22_105_18,1.0,27,45,18,65
43,r_88_218_30,r_139_59_87,seq29,r_88_218_30,1.0,1,31,30,65
53,r_138_248_26,r_262_164_115,seq142,r_138_248_26,1.0,-1,25,26,65
33,r_60_261_153,r_219_217_197,r_80_286_99,r_60_261_153,0.73,0,153,153,65
64,r_146_251_170,r_16_242_184,r_80_286_99,r_80_286_99,0.98,84,183,99,65
88,r_263_176_137,seq152,r_181_120_56,r_263_176_137,0.99,0,137,137,65
21,r_274_280_57,r_292_35_123,seq98,r_274_280_57,0.72,-2,55,57,65
50,r_91_90_99,seq116,seq224,r_91_90_99,1.0,0,99,99,65
58,r_156_275_138,seq244,r_151_14_60,r_156_275_138,0.93,0,138,138,65
137,seq113,r_262_164_115,seq18,r_262_164_115,0.99,-8,107,115,65
61,r_161_192_138,seq13,seq216,r_161_192_138,0.91,0,138,138,65
38,r_292_35_123,seq13,r_80_286_99,r_80_286_99,1.0,24,123,99,65
86,r_270_79_48,r_100_30_27,seq75,r_270_79_48,0.85,-3,45,48,65
128,seq81,r_190_287_194,r_267_15_26,r_267_15_26,1.0,-1,25,26,65
34,r_78_295_102,r_62_127_159,r_99_189_198,r_78_295_102,1.0,0,102,102,65
48,r_46_194_50,r_150_53_93,seq193,r_46_194_50,1.0,0,50,50,65
90,r_293_284_39,r_195_266_59,seq173,r_293_284_39,0.74,4,43,39,65
60,r_174_112_100,r_298_234_118,seq154,r_298_234_118,0.99,-22,96,118,65
81,r_26_213_137,seq34,seq12,r_26_213_137,0.96,0,137,137,65
94,r_61_40_187,seq264,r_150_53_93,r_150_53_93,0.66,94,187,93,65
96,r_92_254_76,seq289,r_109_271_63,r_92_254_76,1.0,0,76,76,65
98,r_151_14_60,r_241_210_184,r_156_275_138,r_156_275_138,1.0,47,185,138,65
22,r_232_283_186,seq208,r_78_295_102,r_78_295_102,1.0,84,186,102,65
10,r_5_225_21,r_200_297_98,seq89,r_5_225_21,1.0,0,21,21,65
28,r_170_178_148,seq68,seq252,r_170_178_148,0.54,0,148,148,65
91,r_39_187_102,r_240_17_135,r_285_10_76,r_285_10_76,0.56,26,102,76,65
49,r_135_259_188,seq93,r_258_255_145,r_135_259_188,0.47,0,188,188,65
151,seq142,r_150_53_93,r_138_248_26,r_138_248_26,1.0,-1,25,26,65
45,r_195_266_59,r_175_106_117,seq93,r_195_266_59,1.0,0,59,59,65
93,r_250_64_47,seq113,seq108,r_250_64_47,0.63,4,51,47,65
7,r_31_86_187,seq115,r_144_32_169,r_144_32_169,0.93,18,187,169,65
185,seq249,r_201_235_153,r_285_10_76,r_285_10_76,0.81,0,76,76,65
44,r_58_111_186,r_262_164_115,seq113,r_262_164_115,1.0,0,115,115,65
138,seq115,r_31_86_187,r_1_272_53,r_1_272_53,1.0,134,187,53,65
82,r_175_106_117,seq37,r_144_32_169,r_175_106_117,0.99,0,117,117,65
84,r_214_182_81,r_16_242_184,seq205,r_214_182_81,1.0,0,81,81,65
199,seq296,r_109_271_63,r_134_141_26,r_134_141_26,0.91,41,67,26,65
0,r_218_88_33,r_52_20_170,seq211,r_218_88_33,0.82,-5,28,33,66
36,r_272_176_6,r_143_296_193,r_170_113_45,r_170_113_45,0.95,37,82,45,66
190,seq263,r_17_291_32,r_191_71_27,r_191_71_27,1.0,1,28,27,66
50,r_170_113_45,r_11_165_82,r_272_176_6,r_11_165_82,0.76,-36,46,82,66
92,r_69_298_138,r_187_270_199,r_196_283_101,r_187_270_199,0.55,-56,143,199,66
8,r_151_54_60,r_275_201_196,r_141_189_39,r_275_201_196,1.0,-136,60,196,66
43,r_293_94_92,seq3,r_258_243_156,r_293_94_92,0.59,-28,64,92,66
197,seq282,r_53_132_164,r_255_119_26,r_255_119_26,0.96,-2,24,26,66
37,r_153_252_174,seq155,r_255_119_26,r_255_119_26,0.82,149,175,26,66
71,r_229_173_105,r_49_248_177,seq89,r_229_173_105,0.57,4,109,105,66
5,r_82_56_59,r_215_219_184,r_240_133_42,r_82_56_59,1.0,0,59,59,66
86,r_53_132_164,seq282,r_272_176_6,r_53_132_164,0.32,4,168,164,66
21,r_196_283_101,r_127_40_110,seq31,r_196_283_101,0.96,1,102,101,66
46,r_49_248_177,seq211,seq73,r_49_248_177,0.26,0,177,177,66
62,r_267_103_147,r_169_64_151,r_259_268_32,r_259_268_32,1.0,10,42,32,66
80,r_277_266_73,r_106_57_187,r_240_133_42,r_277_266_73,1.0,0,73,73,66
85,r_183_299_13,r_169_64_151,seq84,r_183_299_13,0.99,0,13,13,66
45,r_110_60_47,r_152_14_152,r_118_15_57,r_110_60_47,0.58,17,64,47,66
69,r_181_142_108,seq6,r_289_297_1,r_181_142_108,1.0,0,108,108,66
35,r_163_174_35,r_49_248_177,seq144,r_163_174_35,0.77,1,36,35,66
19,r_187_270_199,r_69_298_138,seq134,r_69_298_138,0.98,-17,121,138,66
65,r_4_214_40,seq10,seq185,r_4_214_40,0.98,0,40,40,66
95,r_228_269_75,seq63,seq65,r_228_269_75,1.0,0,75,75,66
66,r_93_177_88,seq211,seq47,r_93_177_88,0.95,1,89,88,66
42,r_202_104_51,r_106_57_187,r_262_288_52,r_262_288_52,1.0,1,53,52,66
31,r_235_66_38,r_152_14_152,r_110_60_47,r_110_60_47,0.94,38,85,47,66
12,r_191_71_27,r_22_178_167,seq263,r_191_71_27,0.99,0,27,27,66
110,seq25,r_138_224_170,r_249_35_72,r_249_35_72,1.0,99,171,72,66
3,r_156_253_71,r_192_194_127,seq91,r_156_253_71,0.98,13,84,71,66
10,r_1_242_98,r_26_126_163,r_4_214_40,r_1_242_98,0.95,0,98,98,66
83,r_226_244_30,seq159,seq273,r_226_244_30,1.0,0,30,30,66
90,r_205_285_99,seq217,r_123_81_96,r_205_285_99,0.56,0,99,99,66
113,seq31,r_26_126_163,r_152_14_152,r_152_14_152,0.68,10,162,152,66
26,r_140_209_170,seq6,r_183_299_13,r_140_209_170,0.51,1,171,170,66
74,r_259_268_32,r_109_223_189,r_267_103_147,r_259_268_32,0.99,1,33,32,66
4,r_121_124_83,seq74,r_160_172_27,r_160_172_27,0.5,52,79,27,66
63,r_197_154_151,r_143_296_193,r_196_283_101,r_143_296_193,0.87,-40,153,193,66
73,r_109_223_189,seq84,r_279_171_129,r_279_171_129,0.84,60,189,129,66
75,r_257_44_23,r_169_64_151,seq3,r_257_44_23,1.0,0,23,23,66
13,r_139_294_157,seq51,seq5,r_139_294_157,0.35,1,158,157,66
11,r_149_280_41,r_129_101_125,r_106_57_187,r_149_280_41,0.92,-1,40,41,66
57,r_75_0_75,seq233,seq159,r_75_0_75,1.0,0,75,75,66
127,seq65,seq159,r_228_269_75,r_228_269_75,1.0,3,78,75,66
91,r_278_107_43,seq155,r_106_57_187,r_278_107_43,0.97,1,44,43,66
6,r_184_29_178,seq91,r_151_54_60,r_151_54_60,1.0,118,178,60,66
127,seq65,r_262_288_52,seq159,r_262_288_52,1.0,0,52,52,66
64,r_135_284_47,r_129_101_125,seq8,r_135_284_47,0.98,-1,46,47,66
74,r_259_268_32,r_267_103_147,r_17_291_32,r_267_103_147,1.0,0,147,147,66
99,r_220_225_81,seq213,r_255_119_26,r_220_225_81,0.75,0,81,81,66
105,seq10,r_4_214_40,r_160_172_27,r_160_172_27,0.9,3,30,27,66
45,r_110_60_47,r_82_56_59,r_152_14_152,r_110_60_47,0.94,0,47,47,66
97,r_118_15_57,r_220_225_81,r_110_60_47,r_118_15_57,0.81,0,57,57,66
134,seq84,r_109_223_189,r_140_209_170,r_140_209_170,0.96,19,189,170,66
136,seq89,r_234_79_38,r_229_173_105,r_229_173_105,1.0,1,106,105,66
87,r_50_164_125,seq16,r_226_244_30,r_50_164_125,0.97,0,125,125,66
47,r_186_264_116,seq148,r_272_176_6,r_186_264_116,0.57,9,125,116,66
40,r_30_112_110,seq59,seq105,r_30_112_110,1.0,0,110,110,66
18,r_48_161_105,r_127_40_110,seq8,r_48_161_105,0.87,1,106,105,66
24,r_83_290_143,seq96,r_226_244_30,r_83_290_143,0.95,0,143,143,66
33,r_245_38_94,r_109_223_189,seq77,r_245_38_94,0.98,1,95,94,66
65,r_4_214_40,seq185,r_1_242_98,r_1_242_98,1.0,16,114,98,66
191,seq265,r_152_14_152,r_110_60_47,r_110_60_47,0.87,19,66,47,66
88,r_261_232_164,seq33,r_156_253_71,r_261_232_164,0.65,0,164,164,66
58,r_179_78_93,r_129_101_125,seq125,r_179_78_93,0.77,1,94,93,66
94,r_43_203_36,r_149_280_41,seq114,r_149_280_41,0.7,-7,34,41,66
70,r_279_171_129,r_169_64_151,seq55,r_169_64_151,0.99,-12,139,151,66
68,r_249_35_72,seq273,seq25,r_249_35_72,1.0,0,72,72,66
61,r_123_81_96,r_50_164_125,seq3,r_123_81_96,0.99,0,96,96,66
32,r_36_210_181,seq175,r_106_57_187,r_36_210_181,0.47,0,181,181,66
53,r_23_236_49,r_127_40_110,r_70_9_188,r_23_236_49,0.98,-3,46,49,66
43,r_293_94_92,r_258_243_156,r_135_284_47,r_293_94_92,0.93,0,92,92,66
38,r_68_157_106,r_127_40_110,r_90_21_26,r_68_157_106,0.9,0,106,106,66
34,r_138_224_170,seq25,r_169_64_151,r_169_64_151,0.45,20,171,151,66
77,r_234_79_38,r_49_248_177,seq89,r_234_79_38,0.93,4,42,38,66
84,r_90_21_26,r_278_107_43,seq7,r_90_21_26,1.0,0,26,26,66
79,r_2_46_52,r_240_133_42,r_52_20_170,r_2_46_52,1.0,1,53,52,66
60,r_111_238_74,r_127_40_110,seq91,r_111_238_74,0.69,3,77,74,66
17,r_152_14_152,r_235_66_38,r_196_283_101,r_152_14_152,0.75,0,152,152,66
9,r_169_64_151,r_166_97_199,r_83_290_143,r_169_64_151,0.71,0,151,151,66
96,r_95_251_78,seq37,r_289_297_1,r_95_251_78,1.0,-1,77,78,66
133,seq77,r_138_224_170,r_245_38_94,r_245_38_94,0.96,3,97,94,66
62,r_267_103_147,r_259_268_32,r_121_124_83,r_267_103_147,0.87,0,147,147,66
28,r_26_126_163,seq31,seq117,r_26_126_163,0.57,-1,162,163,66
49,r_262_288_52,seq65,r_202_104_51,r_262_288_52,1.0,0,52,52,66
56,r_129_101_125,seq10,r_106_57_187,r_129_101_125,0.55,0,125,125,66
7,r_80_204_116,r_106_57_187,r_228_269_75,r_106_57_187,0.46,-71,116,187,66
44,r_258_243_156,seq115,seq45,r_258_243_156,0.58,0,156,156,66
98,r_19_130_28,r_169_64_151,seq59,r_19_130_28,1.0,0,28,28,66
82,r_34_212_152,r_258_243_156,r_151_54_60,r_34_212_152,0.91,0,152,152,66
81,r_70_9_188,r_169_64_151,r_23_236_49,r_70_9_188,0.97,-142,46,188,66
51,r_160_172_27,r_240_133_42,seq10,r_160_172_27,0.99,0,27,27,66
182,seq233,r_75_0_75,r_52_20_170,r_75_0_75,1.0,0,75,75,66
72,r_255_119_26,seq98,seq282,r_255_119_26,0.9,-2,24,26,66
93,r_243_116_80,r_159_229_159,seq207,r_243_116_80,1.0,0,80,80,67
30,r_257_54_83,r_220_213_165,seq150,r_257_54_83,0.98,-1,82,83,67
130,seq88,r_122_160_22,r_117_97_24,r_122_160_22,0.99,-3,19,22,67
92,r_220_213_165,seq166,seq113,r_220_213_165,0.54,5,170,165,67
14,r_224_198_64,r_214_240_197,seq273,r_224_198_64,1.0,3,67,64,67
99,r_236_26_24,r_130_118_107,seq298,r_236_26_24,0.76,0,24,24,67
53,r_209_259_168,seq150,r_227_133_147,r_227_133_147,0.72,23,170,147,67
83,r_167_102_135,r_83_174_3,r_192_84_72,r_167_102_135,0.74,4,139,135,67
84,r_120_136_16,r_42_106_159,seq88,r_120_136_16,1.0,-1,15,16,67
144,seq132,r_12_164_53,seq113,r_12_164_53,0.99,4,57,53,67
59,r_58_2_128,seq277,r_108_57_17,r_58_2_128,0.72,5,133,128,67
55,r_32_255_72,r_290_280_87,seq125,r_32_255_72,0.9,3,75,72,67
71,r_16_50_66,r_19_269_128,r_210_28_170,r_19_269_128,1.0,-57,71,128,67
16,r_83_174_3,r_167_102_135,r_262_266_10,r_83_174_3,0.56,72,75,3,67
39,r_165_179_177,r_214_240_197,r_243_116_80,r_214_240_197,0.32,-18,179,197,67
1,r_79_186_189,seq87,r_192_84_72,r_79_186_189,0.96,0,189,189,67
1,r_79_186_189,r_19_269_128,seq87,r_19_269_128,1.0,0,128,128,67
46,r_296_56_179,r_123_175_1,seq277,r_123_175_1,0.51,178,179,1,67
37,r_228_44_19,r_42_106_159,r_220_213_165,r_228_44_19,1.0,2,21,19,67
193,seq277,r_58_2_128,seq156,r_58_2_128,0.88,11,139,128,67
19,r_230_288_76,seq43,seq202,r_230_288_76,1.0,0,76,76,67
73,r_38_193_35,seq272,seq18,r_38_193_35,1.0,2,37,35,67
76,r_100_93_95,seq176,r_286_71_90,r_100_93_95,0.81,4,99,95,67
54,r_276_180_15,seq202,seq166,r_276_180_15,0.96,0,15,15,67
35,r_122_160_22,seq88,seq31,r_122_160_22,1.0,0,22,22,67
41,r_94_195_28,r_185_182_101,r_123_175_1,r_123_175_1,0.89,33,34,1,67
31,r_51_141_116,seq277,r_38_193_35,r_51_141_116,0.99,1,117,116,67
67,r_169_258_161,seq0,r_287_103_174,r_169_258_161,0.93,0,161,161,67
110,seq22,seq181,r_275_91_97,r_275_91_97,1.0,4,101,97,67
89,r_152_189_187,seq114,r_296_56_179,r_296_56_179,0.54,8,187,179,67
24,r_223_45_46,r_257_54_83,seq0,r_223_45_46,1.0,2,48,46,67
3,r_184_64_119,r_23_60_197,r_264_154_26,r_184_64_119,0.64,2,121,119,67
10,r_126_161_73,seq95,r_108_57_17,r_126_161_73,0.98,0,73,73,67
80,r_260_139_20,r_232_76_63,seq294,r_232_76_63,0.71,-44,19,63,67
91,r_46_151_50,r_159_229_159,seq196,r_46_151_50,1.0,1,51,50,67
72,r_130_118_107,seq181,seq21,r_130_118_107,0.97,0,107,107,67
47,r_52_111_52,r_287_103_174,r_6_170_42,r_6_170_42,0.51,16,58,42,67
139,seq114,r_152_189_187,r_210_28_170,r_210_28_170,0.72,17,187,170,67
170,seq202,r_241_30_109,r_230_288_76,r_230_288_76,0.99,2,78,76,67
4,r_210_28_170,r_37_208_107,r_16_50_66,r_37_208_107,1.0,-36,71,107,67
8,r_153_211_30,r_131_53_197,seq5,r_153_211_30,1.0,0,30,30,67
78,r_232_76_63,r_70_247_100,seq222,r_232_76_63,0.99,2,65,63,67
11,r_275_91_97,seq140,seq22,r_275_91_97,0.99,0,97,97,67
20,r_248_234_100,seq150,r_83_174_3,r_248_234_100,0.99,0,100,100,67
13,r_138_183_77,r_110_72_147,r_117_97_24,r_138_183_77,1.0,1,78,77,67
98,r_3_40_88,r_167_102_135,seq80,r_3_40_88,0.99,0,88,88,67
15,r_131_53_197,r_250_119_142,r_295_85_197,r_250_119_142,0.45,38,180,142,67
48,r_159_229_159,r_157_75_190,r_131_53_197,r_159_229_159,0.64,0,159,159,67
74,r_48_216_30,r_169_258_161,seq254,r_48_216_30,1.0,0,30,30,67
75,r_4_128_22,seq21,seq109,r_4_128_22,1.0,-3,19,22,67
4,r_210_28_170,r_16_50_66,r_3_40_88,r_210_28_170,0.97,0,170,170,67
6,r_124_62_99,r_241_30_109,r_293_14_170,r_241_30_109,0.85,-13,96,109,67
50,r_12_164_53,seq132,r_4_128_22,r_12_164_53,1.0,4,57,53,67
82,r_144_33_45,seq22,seq172,r_144_33_45,1.0,2,47,45,67
112,seq31,r_290_280_87,r_122_160_22,r_122_160_22,0.85,1,23,22,67
134,seq101,seq265,r_185_182_101,r_185_182_101,1.0,7,108,101,67
27,r_290_280_87,r_279_89_91,seq95,r_290_280_87,0.66,1,88,87,67
87,r_70_247_100,seq113,seq212,r_70_247_100,0.94,3,103,100,67
162,seq181,r_130_118_107,seq125,r_130_118_107,0.96,-32,75,107,67
18,r_171_112_72,seq104,r_52_111_52,r_171_112_72,0.99,0,72,72,67
29,r_110_72_147,r_23_60_197,r_122_160_22,r_122_160_22,0.49,126,148,22,67
157,seq166,r_220_213_165,r_19_269_128,r_19_269_128,0.98,42,170,128,67
25,r_19_269_128,r_79_186_189,seq166,r_19_269_128,1.0,0,128,128,67
33,r_29_270_84,seq13,seq20,r_29_270_84,1.0,1,85,84,67
127,seq80,seq104,r_3_40_88,r_3_40_88,1.0,15,103,88,67
64,r_185_182_101,r_235_225_129,seq101,r_185_182_101,0.88,0,101,101,67
88,r_299_205_108,seq142,r_23_60_197,r_299_205_108,0.93,0,108,108,67
43,r_291_15_26,seq142,r_6_170_42,r_6_170_42,0.95,10,52,42,67
58,r_163_47_60,seq35,r_264_154_26,r_163_47_60,1.0,1,61,60,67
69,r_117_97_24,r_19_269_128,seq88,r_19_269_128,0.57,-109,19,128,67
70,r_155_149_153,seq66,seq148,r_155_149_153,0.84,0,153,153,67
65,r_250_119_142,r_131_53_197,seq129,r_250_119_142,0.43,38,180,142,67
38,r_237_121_93,seq244,seq41,r_237_121_93,0.98,0,93,93,67
52,r_286_71_90,r_248_234_100,r_192_84_72,r_248_234_100,1.0,-6,94,100,67
77,r_281_49_130,seq254,seq226,r_281_49_130,0.86,2,132,130,67
169,seq200,r_168_199_185,r_81_204_6,r_168_199_185,0.74,-114,71,185,67
71,r_16_50_66,r_210_28_170,r_279_89_91,r_16_50_66,0.43,104,170,66,67
7,r_6_170_42,r_159_229_159,r_291_15_26,r_6_170_42,1.0,1,43,42,67
36,r_78_17_47,r_203_27_7,seq74,r_78_17_47,1.0,0,47,47,67
60,r_219_25_154,seq35,r_237_121_93,r_237_121_93,1.0,61,154,93,67
81,r_268_201_162,r_214_240_197,r_220_213_165,r_268_201_162,0.36,8,170,162,67
17,r_227_133_147,seq24,r_297_105_78,r_227_133_147,0.84,1,148,147,67
119,seq61,r_206_90_110,r_293_14_170,r_206_90_110,1.0,2,112,110,67
43,r_291_15_26,r_224_198_64,seq142,r_291_15_26,0.89,-3,23,26,67
138,seq113,r_69_239_49,r_220_213_165,r_220_213_165,1.0,9,174,165,67
94,r_157_75_190,seq41,r_16_50_66,r_16_50_66,0.57,124,190,66,67
171,seq207,seq13,r_243_116_80,r_243_116_80,1.0,16,96,80,67
9,r_145_177_66,seq95,seq140,r_145_177_66,1.0,0,66,66,67
96,r_162_233_113,seq59,r_70_247_100,r_162_233_113,0.97,0,113,113,67
37,r_228_44_19,r_220_213_165,r_276_180_15,r_220_213_165,1.0,-6,159,165,67
57,r_262_266_10,seq134,r_83_174_3,r_262_266_10,0.88,0,10,10,67
28,r_235_225_129,seq146,seq66,r_235_225_129,0.88,4,133,129,67
49,r_297_105_78,r_257_54_83,seq173,r_297_105_78,0.99,-3,75,78,67
199,seq298,r_293_14_170,r_236_26_24,r_236_26_24,1.0,27,51,24,67
44,r_206_90_110,seq61,r_29_270_84,r_206_90_110,0.67,1,111,110,67
23,r_69_239_49,seq20,seq147,r_69_239_49,0.82,24,73,49,67
138,seq113,r_70_247_100,r_69_239_49,r_70_247_100,0.97,3,103,100,67
90,r_217_11_46,r_159_229_159,seq187,r_217_11_46,1.0,1,47,46,67
79,r_37_208_107,r_169_258_161,seq278,r_37_208_107,1.0,0,107,107,67
34,r_108_57_17,r_145_177_66,seq59,r_108_57_17,0.63,1,18,17,67
12,r_42_106_159,seq285,r_69_239_49,r_42_106_159,0.66,0,159,159,67
51,r_264_154_26,r_38_193_35,seq9,r_264_154_26,0.97,1,27,26,67
93,r_176_96_120,r_0_290_136,seq60,r_176_96_120,1.0,0,120,120,68
28,r_231_77_43,r_273_177_183,seq130,r_231_77_43,1.0,0,43,43,68
30,r_36_142_76,r_88_152_142,r_281_229_17,r_36_142_76,0.99,0,76,76,68
51,r_222_153_68,r_295_41_158,seq70,r_222_153_68,1.0,0,68,68,68
68,r_257_64_31,r_27_174_75,seq17,r_257_64_31,1.0,0,31,31,68
26,r_13_214_46,seq293,r_294_270_12,r_13_214_46,1.0,0,46,46,68
36,r_251_126_68,r_258_223_89,seq163,r_251_126_68,1.0,0,68,68,68
122,seq70,r_76_180_149,r_222_153_68,r_222_153_68,0.97,82,150,68,68
92,r_154_286_182,r_170_110_186,r_158_242_45,r_158_242_45,1.0,19,64,45,68
14,r_273_177_183,r_117_172_104,r_213_84_194,r_117_172_104,1.0,1,105,104,68
43,r_148_147_103,seq74,r_92_12_105,r_148_147_103,1.0,0,103,103,68
197,seq297,r_27_174_75,r_97_123_64,r_97_123_64,1.0,19,83,64,68
83,r_253_140_110,seq111,seq112,r_253_140_110,1.0,0,110,110,68
101,seq5,r_138_204_199,r_61_164_8,r_138_204_199,1.0,-171,28,199,68
55,r_132_53_65,seq79,r_235_265_37,r_235_265_37,1.0,41,78,37,68
71,r_59_14_182,seq197,r_94_137_73,r_59_14_182,0.43,0,182,182,68
86,r_68_194_142,seq58,seq288,r_68_194_142,0.75,3,145,142,68
21,r_208_191_134,seq283,seq86,r_208_191_134,0.91,0,134,134,68
39,r_266_157_181,seq135,r_28_116_123,r_28_116_123,0.75,58,181,123,68
1,r_25_181_122,r_241_16_146,r_115_48_18,r_25_181_122,1.0,1,123,122,68
97,r_149_144_88,seq23,seq114,r_149_144_88,1.0,0,88,88,68
15,r_115_48_18,r_263_65_193,seq4,r_115_48_18,0.82,-1,17,18,68
5,r_227_9_106,r_32_24_184,seq161,r_227_9_106,1.0,0,106,106,68
46,r_165_198_189,seq262,r_28_116_123,r_28_116_123,0.92,66,189,123,68
42,r_190_51_162,seq114,r_13_214_46,r_190_51_162,0.52,0,162,162,68
34,r_247_205_15,r_208_191_134,seq135,r_247_205_15,0.52,0,15,15,68
56,r_93_69_52,r_139_45_109,r_61_164_8,r_93_69_52,1.0,0,52,52,68
98,r_189_233_42,r_273_177_183,seq280,r_189_233_42,1.0,0,42,42,68
19,r_284_15_135,r_67_254_147,r_125_129_39,r_67_254_147,0.91,-9,138,147,68
146,seq130,seq44,r_231_77_43,r_231_77_43,1.0,0,43,43,68
76,r_292_207_141,r_213_84_194,seq23,r_292_207_141,0.82,4,145,141,68
129,seq95,r_55_160_146,seq8,r_55_160_146,0.99,0,146,146,68
41,r_75_272_63,seq268,seq186,r_75_272_63,0.72,13,76,63,68
85,r_196_122_46,r_138_204_199,seq178,r_196_122_46,1.0,0,46,46,68
89,r_73_224_150,r_131_156_191,r_215_11_107,r_73_224_150,0.86,0,150,150,68
3,r_241_16_146,seq120,r_75_272_63,r_241_16_146,0.73,4,150,146,68
95,r_170_110_186,r_258_223_89,r_158_242_45,r_158_242_45,1.0,4,49,45,68
10,r_89_243_143,seq4,seq197,r_89_243_143,0.96,0,143,143,68
47,r_294_270_12,r_235_265_37,r_138_204_199,r_294_270_12,0.74,0,12,12,68
90,r_40_230_96,seq278,r_257_64_31,r_257_64_31,1.0,69,100,31,68
72,r_202_66_87,seq293,seq50,r_202_66_87,1.0,0,87,87,68
14,r_273_177_183,r_213_84_194,seq29,r_213_84_194,0.72,-11,183,194,68
4,r_27_174_75,r_107_193_67,seq268,r_27_174_75,0.78,-6,69,75,68
63,r_159_143_148,r_32_24_184,r_94_137_73,r_159_143_148,0.97,0,148,148,68
11,r_141_259_151,seq112,r_93_69_52,r_141_259_151,0.86,0,151,151,68
20,r_183_108_59,r_117_172_104,r_220_246_56,r_183_108_59,0.99,1,60,59,68
13,r_185_6_63,r_276_34_139,seq283,r_185_6_63,0.9,1,64,63,68
70,r_125_129_39,r_89_243_143,r_210_47_9,r_125_129_39,0.72,0,39,39,68
48,r_97_123_64,r_132_53_65,seq297,r_97_123_64,1.0,0,64,64,68
57,r_199_289_157,seq17,r_71_173_134,r_199_289_157,0.86,0,157,157,68
6,r_30_226_37,r_227_9_106,seq236,r_30_226_37,0.68,0,37,37,68
62,r_276_34_139,r_59_14_182,seq90,r_59_14_182,0.56,-41,141,182,68
99,r_220_246_56,seq109,seq237,r_220_246_56,1.0,1,57,56,68
75,r_121_287_48,r_131_156_191,r_281_229_17,r_121_287_48,1.0,0,48,48,68
27,r_215_11_107,r_200_134_176,r_261_145_199,r_215_11_107,0.9,-2,105,107,68
87,r_213_84_194,r_292_207_141,r_113_151_17,r_213_84_194,0.77,-71,123,194,68
69,r_113_151_17,r_117_172_104,r_148_147_103,r_113_151_17,0.99,88,105,17,68
142,seq120,r_241_16_146,r_36_142_76,r_36_142_76,1.0,74,150,76,68
40,r_139_45_109,seq86,r_115_48_18,r_139_45_109,1.0,1,110,109,68
74,r_92_12_105,seq186,r_148_147_103,r_148_147_103,0.57,2,105,103,68
18,r_88_152_142,r_261_145_199,r_107_193_67,r_88_152_142,0.97,0,142,142,68
29,r_217_136_130,r_273_177_183,seq74,r_217_136_130,0.99,1,131,130,68
67,r_281_229_17,r_208_191_134,seq120,r_281_229_17,0.97,-1,16,17,68
35,r_98_244_171,seq124,r_43_150_44,r_98_244_171,0.61,4,175,171,68
25,r_211_252_127,seq297,r_94_137_73,r_211_252_127,0.84,1,128,127,68
33,r_32_24_184,r_227_9_106,r_132_53_65,r_227_9_106,1.0,0,106,106,68
70,r_125_129_39,r_210_47_9,r_284_15_135,r_284_15_135,0.89,17,152,135,68
64,r_10_179_110,seq283,r_132_53_65,r_10_179_110,1.0,0,110,110,68
92,r_154_286_182,r_158_242_45,seq127,r_154_286_182,0.44,0,182,182,68
88,r_18_218_102,seq238,seq262,r_18_218_102,1.0,0,102,102,68
50,r_76_180_149,seq70,seq297,r_76_180_149,0.98,1,150,149,68
65,r_209_37_152,seq86,r_149_144_88,r_209_37_152,0.92,0,152,152,68
61,r_107_193_67,r_27_174_75,r_75_272_63,r_107_193_67,0.53,9,76,67,68
41,r_75_272_63,seq186,r_232_87_119,r_232_87_119,0.7,12,131,119,68
84,r_188_91_33,r_208_191_134,r_59_14_182,r_188_91_33,0.98,1,34,33,68
32,r_200_134_176,seq70,r_148_147_103,r_148_147_103,0.91,74,177,103,68
38,r_267_26_120,seq293,r_115_48_18,r_267_26_120,0.99,0,120,120,68
52,r_261_145_199,r_88_152_142,r_215_11_107,r_261_145_199,0.94,-57,142,199,68
77,r_78_225_73,seq127,r_185_6_63,r_78_225_73,1.0,0,73,73,68
81,r_72_42_20,r_141_259_151,r_3_57_9,r_72_42_20,1.0,0,20,20,68
60,r_117_172_104,r_273_177_183,r_115_48_18,r_117_172_104,1.0,1,105,104,68
17,r_282_52_172,seq245,r_141_259_151,r_282_52_172,0.73,2,174,172,68
147,seq133,seq120,r_121_287_48,r_121_287_48,1.0,1,49,48,68
94,r_234_206_93,r_98_244_171,seq58,r_234_206_93,1.0,0,93,93,68
2,r_235_265_37,r_185_6_63,r_132_53_65,r_235_265_37,1.0,0,37,37,68
69,r_113_151_17,seq277,r_117_172_104,r_113_151_17,0.99,0,17,17,68
9,r_55_160_146,seq95,r_3_57_9,r_55_160_146,0.74,1,147,146,68
96,r_7_49_131,seq146,r_25_181_122,r_25_181_122,1.0,5,127,122,68
82,r_201_195_32,r_170_110_186,r_61_164_8,r_201_195_32,1.0,1,33,32,68
123,seq74,r_148_147_103,seq216,r_148_147_103,1.0,0,103,103,68
66,r_158_242_45,r_227_9_106,seq237,r_158_242_45,1.0,0,45,45,68
91,r_295_41_158,seq102,r_185_6_63,r_185_6_63,0.72,96,159,63,68
84,r_188_91_33,r_59_14_182,r_0_290_136,r_188_91_33,0.49,127,160,33,68
49,r_248_2_133,r_141_259_151,r_202_66_87,r_248_2_133,0.99,3,136,133,68
164,seq197,r_276_34_139,r_89_243_143,r_89_243_143,0.97,1,144,143,68
125,seq81,seq39,r_210_47_9,r_210_47_9,0.45,38,47,9,68
44,r_67_254_147,r_43_150_44,r_88_152_142,r_43_150_44,0.89,103,147,44,68
23,r_43_150_44,r_67_254_147,r_98_244_171,r_67_254_147,0.99,0,147,147,68
35,r_98_244_171,r_234_206_93,seq124,r_234_206_93,1.0,0,93,93,68
12,r_80_184_166,r_32_24_184,r_222_153_68,r_222_153_68,0.98,98,166,68,68
95,r_170_110_186,r_158_242_45,r_3_57_9,r_158_242_45,0.39,142,187,45,68
93,r_275_60_107,r_165_23_132,r_58_200_100,r_165_23_132,1.0,-25,107,132,69
30,r_129_72_143,seq262,r_164_230_57,r_129_72_143,1.0,0,143,143,69
87,r_287_201_26,r_186_9_167,r_294_207_112,r_287_201_26,0.91,2,28,26,69
8,r_90_185_128,seq252,seq13,r_90_185_128,0.76,0,128,128,69
151,seq148,r_165_23_132,r_278_83_32,r_278_83_32,1.0,88,120,32,69
43,r_164_230_57,r_43_134_194,r_110_187_17,r_164_230_57,1.0,10,67,57,69
20,r_40_216_178,seq270,r_219_228_140,r_40_216_178,0.97,0,178,178,69
54,r_191_141_174,r_87_203_64,r_287_201_26,r_191_141_174,0.73,-105,69,174,69
54,r_191_141_174,r_287_201_26,seq245,r_191_141_174,0.92,0,174,174,69
59,r_194_231_151,seq80,r_251_55_114,r_251_55_114,1.0,36,150,114,69
19,r_175_243_90,r_154_235_10,r_168_53_85,r_175_243_90,1.0,0,90,90,69
55,r_140_59_188,seq28,r_0_95_54,r_140_59_188,0.37,0,188,188,69
71,r_88_162_96,r_8_104_76,r_210_144_75,r_8_104_76,0.99,0,76,76,69
16,r_120_289_111,seq147,seq204,r_120_289_111,1.0,1,112,111,69
39,r_22_152_156,r_178_65_43,seq211,r_22_152_156,0.64,0,156,156,69
91,r_276_14_56,r_294_207_112,seq255,r_276_14_56,1.0,0,56,56,69
97,r_142_11_118,r_167_146_162,r_251_55_114,r_142_11_118,0.74,1,119,118,69
5,r_288_123_155,seq46,seq296,r_288_123_155,0.92,0,155,155,69
46,r_137_174_145,seq161,seq91,r_137_174_145,0.98,0,145,145,69
24,r_33_10_26,r_120_289_111,seq69,r_33_10_26,0.54,1,27,26,69
42,r_31_57_55,r_177_170_113,r_33_10_26,r_31_57_55,1.0,0,55,55,69
80,r_16_108_119,seq195,seq4,r_16_108_119,1.0,0,119,119,69
12,r_86_106_30,seq41,r_8_104_76,r_86_106_30,0.67,4,34,30,69
32,r_294_207_112,r_287_201_26,seq46,r_294_207_112,0.8,4,116,112,69
193,seq271,seq109,r_26_38_62,r_26_38_62,1.0,70,132,62,69
95,r_50_101_69,r_102_132_156,r_35_280_8,r_102_132_156,1.0,-84,72,156,69
66,r_177_170_113,seq4,seq126,r_177_170_113,1.0,0,113,113,69
1,r_219_228_140,r_67_274_16,seq75,r_219_228_140,0.54,-93,47,140,69
37,r_264_114_31,r_100_225_137,seq97,r_264_114_31,1.0,2,33,31,69
110,seq32,r_116_61_176,r_42_229_198,r_116_61_176,0.81,1,177,176,69
89,r_299_263_131,r_178_65_43,r_294_207_112,r_299_263_131,0.87,0,131,131,69
188,seq259,r_281_267_57,r_150_242_37,r_281_267_57,1.0,0,57,57,69
61,r_99_223_15,r_112_265_172,seq261,r_99_223_15,1.0,0,15,15,69
3,r_76_127_183,seq24,r_288_123_155,r_76_127_183,0.37,2,185,183,69
10,r_295_173_63,seq49,r_86_106_30,r_295_173_63,1.0,0,63,63,69
90,r_168_53_85,seq81,seq89,r_168_53_85,1.0,0,85,85,69
109,seq30,r_189_226_188,r_219_228_140,r_219_228_140,0.94,48,188,140,69
83,r_44_128_55,r_43_134_194,r_154_235_10,r_44_128_55,1.0,0,55,55,69
4,r_8_104_76,r_86_106_30,r_159_138_8,r_8_104_76,1.0,0,76,76,69
32,r_294_207_112,r_191_141_174,r_287_201_26,r_287_201_26,0.84,15,41,26,69
86,r_63_217_10,seq261,r_35_280_8,r_63_217_10,1.0,0,10,10,69
0,r_43_134_194,r_164_230_57,r_42_229_198,r_164_230_57,1.0,10,67,57,69
63,r_189_226_188,seq30,r_150_242_37,r_189_226_188,0.5,0,188,188,69
73,r_102_132_156,seq46,r_8_104_76,r_8_104_76,0.87,80,156,76,69
75,r_77_135_23,r_150_242_37,r_159_138_8,r_159_138_8,0.83,15,23,8,69
96,r_179_266_42,seq183,seq24,r_179_266_42,1.0,2,44,42,69
77,r_18_209_40,r_150_242_37,r_35_280_8,r_18_209_40,1.0,0,40,40,69
107,seq28,r_140_59_188,r_219_228_140,r_219_228_140,0.9,45,185,140,69
98,r_241_143_78,r_268_85_146,seq30,r_241_143_78,0.95,0,78,78,69
48,r_155_253_136,r_180_292_57,seq115,r_155_253_136,0.59,-72,64,136,69
94,r_258_198_94,r_35_280_8,r_219_228_140,r_219_228_140,0.99,7,147,140,69
57,r_156_236_135,seq157,r_16_108_119,r_16_108_119,0.69,19,138,119,69
13,r_281_267_57,r_6_39_163,r_268_85_146,r_268_85_146,0.98,17,163,146,69
87,r_287_201_26,r_294_207_112,r_214_176_101,r_214_176_101,1.0,15,116,101,69
40,r_121_199_10,r_76_127_183,seq282,r_121_199_10,0.97,0,10,10,69
69,r_278_83_32,seq66,seq148,r_278_83_32,0.98,0,32,32,69
27,r_181_151_105,seq126,seq81,r_181_151_105,1.0,0,105,105,69
85,r_154_235_10,r_186_9_167,r_175_243_90,r_154_235_10,0.83,0,10,10,69
26,r_213_158_15,r_186_9_167,r_160_224_4,r_213_158_15,0.51,0,15,15,69
2,r_220_45_107,r_284_48_85,r_294_207_112,r_220_45_107,0.98,0,107,107,69
47,r_221_96_131,seq51,r_42_229_198,r_221_96_131,0.98,0,131,131,69
105,seq24,r_76_127_183,r_122_273_24,r_76_127_183,0.83,-17,166,183,69
126,seq75,r_219_228_140,seq255,r_219_228_140,0.92,0,140,140,69
74,r_58_200_100,r_189_226_188,seq245,r_58_200_100,0.99,2,102,100,69
18,r_172_298_135,seq271,r_160_224_4,r_172_298_135,0.73,3,138,135,69
29,r_82_62_101,r_186_9_167,r_113_232_79,r_82_62_101,0.99,1,102,101,69
70,r_21_56_35,r_293_73_30,r_71_297_116,r_71_297_116,0.99,41,157,116,69
64,r_192_20_112,r_6_39_163,r_150_242_37,r_192_20_112,1.0,0,112,112,69
65,r_6_39_163,r_281_267_57,r_121_199_10,r_121_199_10,0.58,153,163,10,69
191,seq269,seq74,r_100_225_137,r_100_225_137,0.96,5,142,137,69
88,r_113_232_79,seq115,seq51,r_113_232_79,0.91,5,84,79,69
190,seq262,r_258_198_94,r_160_224_4,r_258_198_94,1.0,0,94,94,69
85,r_154_235_10,r_175_243_90,r_44_128_55,r_154_235_10,0.85,80,90,10,69
52,r_130_105_49,seq34,seq84,r_130_105_49,1.0,0,49,49,69
50,r_100_225_137,seq94,seq269,r_100_225_137,0.83,1,138,137,69
72,r_79_98_41,r_90_185_128,seq94,r_79_98_41,1.0,0,41,41,69
65,r_6_39_163,r_192_20_112,r_281_267_57,r_6_39_163,0.73,-98,65,163,69
19,r_175_243_90,r_1_15_50,r_154_235_10,r_175_243_90,0.88,-80,10,90,69
68,r_87_203_64,r_191_141_174,r_164_230_57,r_87_203_64,1.0,3,67,64,69
31,r_17_291_30,seq41,seq92,r_17_291_30,1.0,0,30,30,69
38,r_167_146_162,seq255,seq54,r_167_146_162,0.79,2,164,162,69
12,r_86_106_30,r_8_104_76,r_295_173_63,r_86_106_30,0.91,46,76,30,69
11,r_293_73_30,seq74,seq34,r_293_73_30,1.0,0,30,30,69
154,seq157,r_156_236_135,seq255,r_156_236_135,0.99,3,138,135,69
14,r_1_15_50,seq119,seq202,r_1_15_50,1.0,1,51,50,69
60,r_254_19_143,seq24,r_100_225_137,r_254_19_143,0.99,0,143,143,69
17,r_227_68_121,r_22_152_156,r_71_297_116,r_22_152_156,1.0,-32,124,156,69
94,r_258_198_94,seq262,r_35_280_8,r_258_198_94,0.93,0,94,94,69
22,r_251_55_114,seq29,seq204,r_251_55_114,0.6,0,114,114,69
62,r_0_95_54,r_90_185_128,seq37,r_0_95_54,1.0,0,54,54,69
51,r_257_206_52,r_102_132_156,r_293_73_30,r_257_206_52,1.0,0,52,52,69
13,r_281_267_57,seq259,r_6_39_163,r_281_267_57,1.0,0,57,57,69
82,r_239_5_52,seq36,r_121_199_10,r_239_5_52,1.0,0,52,52,69
185,seq252,r_90_185_128,r_180_292_57,r_90_185_128,0.6,-22,106,128,69
131,seq89,r_71_297_116,r_175_243_90,r_175_243_90,0.98,6,96,90,69
23,r_186_9_167,seq282,r_156_236_135,r_186_9_167,0.45,0,167,167,69
186,seq255,r_167_146_162,r_276_14_56,r_276_14_56,1.0,94,150,56,69
21,r_160_224_4,r_76_127_183,r_213_158_15,r_213_158_15,0.93,12,27,15,69
79,r_180_292_57,r_155_253_136,seq252,r_155_253_136,0.74,-72,64,136,69
35,r_268_85_146,seq115,r_281_267_57,r_281_267_57,0.94,90,147,57,69
70,r_21_56_35,r_179_266_42,r_293_73_30,r_21_56_35,0.85,0,35,35,69
7,r_150_242_37,r_18_209_40,seq259,r_18_209_40,0.72,0,40,40,69
84,r_116_61_176,seq32,seq75,r_116_61_176,0.54,1,177,176,69
87,r_130_68_186,r_168_185_127,r_104_288_58,r_130_68_186,1.0,0,186,186,70
14,r_209_90_29,seq10,seq8,r_209_90_29,1.0,0,29,29,70
51,r_212_292_68,r_114_107_153,r_128_56_35,r_212_292_68,1.0,0,68,68,70
36,r_154_162_133,seq183,r_117_242_52,r_117_242_52,1.0,24,76,52,70
92,r_72_16_172,seq37,seq11,r_72_16_172,0.28,6,178,172,70
69,r_218_171_165,r_244_60_124,r_168_185_127,r_218_171_165,0.58,0,165,165,70
197,seq286,seq91,r_7_199_122,r_7_199_122,0.99,3,125,122,70
54,r_201_127_185,seq194,r_28_105_169,r_28_105_169,0.67,16,185,169,70
3,r_299_207_33,r_124_268_164,r_220_78_66,r_299_207_33,0.7,61,94,33,70
64,r_128_56_35,r_226_23_36,r_237_235_150,r_128_56_35,1.0,0,35,35,70
55,r_220_78_66,seq92,r_299_207_33,r_220_78_66,0.98,1,67,66,70
71,r_152_27_121,seq51,r_226_23_36,r_226_23_36,0.9,97,133,36,70
21,r_135_88_137,r_236_221_107,seq228,r_236_221_107,0.91,0,107,107,70
165,seq183,r_57_95_118,seq142,r_57_95_118,0.98,0,118,118,70
1,r_262_58_133,seq102,seq200,r_262_58_133,0.98,0,133,133,70
97,r_274_251_143,seq246,r_121_187_12,r_274_251_143,0.83,0,143,143,70
21,r_135_88_137,seq228,seq224,r_135_88_137,0.96,1,138,137,70
5,r_239_160_162,seq176,seq45,r_239_160_162,0.7,1,163,162,70
42,r_118_182_71,r_218_171_165,seq243,r_118_182_71,1.0,0,71,71,70
80,r_28_105_169,r_133_195_13,seq37,r_133_195_13,0.37,155,168,13,70
88,r_52_48_58,r_261_249_162,r_275_159_101,r_261_249_162,0.81,0,162,162,70
69,r_218_171_165,r_174_120_141,r_244_60_124,r_218_171_165,0.4,-24,141,165,70
3,r_299_207_33,r_39_234_156,r_124_268_164,r_299_207_33,1.0,1,34,33,70
45,r_3_71_190,seq99,r_230_205_56,r_230_205_56,0.49,134,190,56,70
16,r_226_23_36,r_130_68_186,seq134,r_226_23_36,0.88,6,42,36,70
19,r_29_93_66,r_191_24_69,seq34,r_29_93_66,1.0,0,66,66,70
63,r_172_79_21,r_7_199_122,seq145,r_172_79_21,0.98,0,21,21,70
158,seq164,r_175_35_193,r_229_272_142,r_229_272_142,1.0,9,151,142,70
95,r_42_140_136,seq81,r_21_250_121,r_42_140_136,0.97,0,136,136,70
66,r_87_238_90,r_229_272_142,seq69,r_87_238_90,0.55,0,90,90,70
13,r_252_64_25,seq69,seq9,r_252_64_25,1.0,1,26,25,70
76,r_6_280_128,r_43_297_197,r_21_250_121,r_6_280_128,0.97,0,128,128,70
31,r_264_190_177,seq85,r_118_182_71,r_118_182_71,1.0,106,177,71,70
129,seq85,r_264_190_177,r_204_32_16,r_264_190_177,0.71,-9,168,177,70
41,r_101_227_95,r_245_97_192,r_61_153_54,r_245_97_192,0.5,-95,97,192,70
89,r_143_290_161,r_94_122_159,r_0_22_36,r_94_122_159,0.32,0,159,159,70
10,r_254_18_91,seq92,r_169_50_10,r_254_18_91,1.0,1,92,91,70
15,r_204_32_16,r_262_58_133,seq85,r_204_32_16,1.0,-1,15,16,70
109,seq20,seq224,r_103_161_141,r_103_161_141,0.95,3,144,141,70
14,r_209_90_29,seq8,seq125,r_209_90_29,0.56,77,106,29,70
170,seq198,r_124_268_164,r_168_185_127,r_168_185_127,0.81,10,137,127,70
78,r_284_66_153,seq279,seq81,r_284_66_153,0.95,0,153,153,70
0,r_124_268_164,r_130_68_186,seq63,r_124_268_164,0.62,1,165,164,70
114,seq41,r_114_107_153,seq37,r_114_107_153,0.83,0,153,153,70
105,seq10,r_209_90_29,r_84_266_14,r_209_90_29,0.79,0,29,29,70
20,r_53_197_168,seq215,r_285_47_61,r_53_197_168,0.76,0,168,168,70
98,r_174_120_141,r_218_171_165,r_191_24_69,r_218_171_165,0.75,-24,141,165,70
96,r_258_31_36,seq113,r_277_137_10,r_258_31_36,1.0,0,36,36,70
57,r_163_82_163,seq14,seq5,r_163_82_163,0.92,0,163,163,70
44,r_121_187_12,r_154_162_133,seq113,r_121_187_12,0.82,-1,11,12,70
6,r_216_136_104,r_129_293_197,seq15,r_216_136_104,0.8,-3,101,104,70
152,seq148,r_19_219_165,r_209_90_29,r_209_90_29,1.0,11,40,29,70
79,r_84_266_14,r_1_110_160,seq10,r_84_266_14,1.0,0,14,14,70
85,r_83_139_120,r_218_171_165,r_19_219_165,r_83_139_120,1.0,0,120,120,70
8,r_0_22_36,r_287_112_197,seq263,r_0_22_36,0.94,0,36,36,70
87,r_130_68_186,r_124_268_164,r_168_185_127,r_168_185_127,0.75,5,132,127,70
178,seq223,r_19_219_165,r_98_276_27,r_98_276_27,1.0,141,168,27,70
91,r_104_288_58,r_244_60_124,r_121_187_12,r_244_60_124,1.0,0,124,124,70
52,r_230_205_56,r_21_250_121,seq157,r_230_205_56,1.0,0,56,56,70
2,r_236_221_107,r_135_88_137,r_193_158_54,r_236_221_107,0.89,0,107,107,70
47,r_57_95_118,seq183,seq253,r_57_95_118,0.87,0,118,118,70
40,r_115_89_118,seq63,seq144,r_115_89_118,0.9,3,121,118,70
29,r_126_265_124,r_72_16_172,r_128_56_35,r_126_265_124,0.99,0,124,124,70
195,seq279,r_284_66_153,r_254_18_91,r_254_18_91,0.59,62,153,91,70
24,r_168_185_127,r_244_60_124,r_299_207_33,r_299_207_33,0.98,93,126,33,70
177,seq217,r_191_24_69,r_40_36_9,r_191_24_69,1.0,0,69,69,70
25,r_191_24_69,seq217,seq192,r_191_24_69,1.0,0,69,69,70
58,r_109_38_10,r_216_136_104,seq37,r_109_38_10,0.97,0,10,10,70
50,r_150_86_81,r_218_171_165,seq200,r_150_86_81,0.94,5,86,81,70
70,r_167_240_118,r_245_97_192,r_21_250_121,r_167_240_118,0.99,0,118,118,70
68,r_7_199_122,seq4,seq286,r_7_199_122,1.0,0,122,122,70
32,r_103_161_141,seq165,seq20,r_103_161_141,0.76,0,141,141,70
77,r_188_294_154,r_206_186_1,seq148,r_188_294_154,0.57,3,157,154,70
73,r_277_137_10,r_216_136_104,seq224,r_277_137_10,0.97,0,10,10,70
86,r_74_13_10,r_111_131_177,seq37,r_74_13_10,0.99,1,11,10,70
152,seq148,r_209_90_29,r_188_294_154,r_188_294_154,0.42,-5,149,154,70
34,r_261_249_162,r_245_97_192,r_61_153_54,r_61_153_54,0.52,122,176,54,70
154,seq151,seq145,r_196_33_144,r_196_33_144,0.87,5,149,144,70
75,r_196_33_144,seq4,seq151,r_196_33_144,0.95,0,144,144,70
132,seq96,seq282,r_236_221_107,r_236_221_107,1.0,15,122,107,70
60,r_62_76_99,seq108,r_21_250_121,r_62_76_99,0.87,0,99,99,70
81,r_111_131_177,seq91,r_188_294_154,r_111_131_177,0.57,0,177,177,70
112,seq34,seq224,r_29_93_66,r_29_93_66,1.0,12,78,66,70
94,r_178_203_78,r_42_140_136,r_206_186_1,r_178_203_78,1.0,0,78,78,70
144,seq134,r_245_97_192,r_226_23_36,r_226_23_36,0.99,132,168,36,70
9,r_19_219_165,seq223,r_49_44_45,r_49_44_45,1.0,123,168,45,70
48,r_193_158_54,r_188_294_154,seq96,r_193_158_54,1.0,0,54,54,70
33,r_117_242_52,r_229_272_142,seq102,r_117_242_52,1.0,0,52,52,70
91,r_104_288_58,r_42_140_136,r_244_60_124,r_104_288_58,1.0,0,58,58,70
123,seq67,r_229_272_142,seq155,r_229_272_142,0.98,0,142,142,70
22,r_229_272_142,seq67,seq164,r_229_272_142,1.0,0,142,142,70
28,r_166_70_108,r_229_272_142,seq63,r_166_70_108,0.45,2,110,108,70
73,r_277_137_10,seq224,r_258_31_36,r_258_31_36,0.99,42,78,36,70
135,seq102,r_262_58_133,r_117_242_52,r_117_242_52,0.97,81,133,52,70
43,r_49_44_45,r_62_76_99,r_281_231_189,r_62_76_99,0.72,-53,46,99,70
49,r_39_234_156,r_21_250_121,seq14,r_39_234_156,0.58,2,158,156,70
30,r_61_153_54,r_216_136_104,seq233,r_61_153_54,0.98,0,54,54,70
56,r_298_278_166,seq232,r_40_36_9,r_40_36_9,0.64,158,167,9,70
7,r_275_159_101,seq145,seq51,r_275_159_101,0.96,0,101,101,70
185,seq243,r_26_177_131,r_118_182_71,r_118_182_71,0.65,60,131,71,70
23,r_285_47_61,r_284_66_153,seq260,r_284_66_153,1.0,-72,81,153,70
83,r_237_235_150,r_254_18_91,r_128_56_35,r_237_235_150,1.0,-115,35,150,70
90,r_270_273_27,r_111_131_177,seq85,r_270_273_27,0.98,0,27,27,70
12,r_269_248_30,seq34,seq37,r_269_248_30,0.86,31,61,30,70
88,r_52_48_58,seq183,r_261_249_162,r_52_48_58,1.0,0,58,58,70
36,r_7_165_95,seq18,seq127,r_7_165_95,1.0,1,96,95,71
58,r_242_61_47,r_83_281_67,seq75,r_83_281_67,0.86,-16,51,67,71
92,r_141_220_98,seq155,seq224,r_141_220_98,1.0,0,98,98,71
66,r_169_4_34,r_289_51_144,r_99_122_75,r_169_4_34,1.0,62,96,34,71
14,r_14_46_109,r_43_50_151,r_141_220_98,r_14_46_109,1.0,0,109,109,71
187,seq271,r_118_104_58,r_44_82_38,r_44_82_38,1.0,21,59,38,71
8,r_131_130_81,seq41,seq299,r_131_130_81,1.0,0,81,81,71
53,r_29_107_59,r_156_252_109,r_6_233_49,r_29_107_59,0.59,7,66,59,71
197,seq291,seq0,r_228_196_157,r_228_196_157,0.98,6,163,157,71
125,seq80,r_298_85_180,r_110_256_77,r_110_256_77,1.0,102,179,77,71
4,r_162_184_28,r_254_115_197,r_83_281_67,r_254_115_197,0.81,-33,164,197,71
54,r_43_50_151,seq92,seq197,r_43_50_151,0.79,0,151,151,71
59,r_289_51_144,r_228_196_157,r_3_98_69,r_289_51_144,0.71,0,144,144,71
73,r_10_88_35,r_132_272_107,seq76,r_10_88_35,1.0,1,36,35,71
16,r_264_190_182,r_285_15_94,r_147_237_8,r_285_15_94,1.0,0,94,94,71
39,r_298_85_180,seq80,r_178_227_134,r_298_85_180,0.63,-1,179,180,71
1,r_210_216_134,seq159,r_207_23_118,r_210_216_134,0.76,3,137,134,71
97,r_55_244_181,r_195_112_103,seq273,r_195_112_103,1.0,0,103,103,71
5,r_96_226_131,r_185_217_159,seq137,r_96_226_131,0.47,6,137,131,71
46,r_161_87_58,r_171_124_107,seq57,r_171_124_107,0.98,-40,67,107,71
153,seq167,r_31_49_59,r_5_179_51,r_31_49_59,1.0,0,59,59,71
98,r_31_49_59,seq167,r_181_102_91,r_31_49_59,1.0,0,59,59,71
30,r_78_294_22,r_48_175_175,seq18,r_78_294_22,1.0,0,22,22,71
19,r_56_134_118,seq127,r_287_160_69,r_56_134_118,1.0,0,118,118,71
91,r_133_296_35,seq275,seq22,r_133_296_35,1.0,0,35,35,71
95,r_47_229_158,seq103,r_113_72_37,r_47_229_158,0.8,0,158,158,71
76,r_101_38_112,seq9,seq282,r_101_38_112,0.85,1,113,112,71
97,r_55_244_181,seq273,r_148_241_140,r_148_241_140,0.95,49,189,140,71
31,r_36_153_186,seq80,r_54_58_102,r_36_153_186,0.51,0,186,186,71
41,r_173_205_152,seq22,r_219_204_108,r_173_205_152,0.97,0,152,152,71
67,r_99_122_75,seq224,r_169_4_34,r_99_122_75,1.0,0,75,75,71
89,r_243_140_129,seq251,r_113_72_37,r_113_72_37,1.0,108,145,37,71
3,r_171_124_107,r_25_166_12,r_202_28_5,r_171_124_107,0.95,0,107,107,71
10,r_156_252_109,seq1,r_3_98_69,r_3_98_69,0.6,40,109,69,71
72,r_180_231_83,seq282,seq155,r_180_231_83,1.0,1,84,83,71
16,r_264_190_182,r_147_237_8,r_247_94_7,r_147_237_8,0.48,174,182,8,71
61,r_267_250_42,seq275,r_185_217_159,r_267_250_42,1.0,0,42,42,71
78,r_287_160_69,seq30,seq16,r_287_160_69,0.75,0,69,69,71
107,seq27,r_230_19_199,r_132_272_107,r_132_272_107,1.0,2,109,107,71
83,r_221_187_38,r_289_51_144,seq164,r_221_187_38,0.76,0,38,38,71
20,r_276_68_102,seq158,r_242_61_47,r_276_68_102,0.92,6,108,102,71
163,seq201,seq270,r_260_97_86,r_260_97_86,0.81,37,123,86,71
15,r_261_284_88,seq67,r_267_250_42,r_267_250_42,0.99,46,88,42,71
48,r_266_154_136,r_69_40_193,seq63,r_266_154_136,0.7,1,137,136,71
96,r_228_196_157,r_169_4_34,seq291,r_228_196_157,0.72,3,160,157,71
6,r_255_84_162,seq30,r_147_237_8,r_255_84_162,0.71,1,163,162,71
38,r_193_297_19,seq39,seq137,r_193_297_19,0.71,9,28,19,71
141,seq139,r_54_58_102,seq9,r_54_58_102,1.0,0,102,102,71
81,r_176_20_28,seq197,seq293,r_176_20_28,0.93,0,28,28,71
85,r_110_256_77,r_276_68_102,seq170,r_110_256_77,1.0,1,78,77,71
4,r_162_184_28,r_141_220_98,r_189_119_81,r_162_184_28,0.98,0,28,28,71
40,r_6_233_49,r_171_124_107,seq66,r_6_233_49,1.0,0,49,49,71
33,r_37_33_45,r_31_49_59,seq198,r_37_33_45,0.82,1,46,45,71
27,r_54_58_102,seq139,r_25_166_12,r_54_58_102,1.0,0,102,102,71
4,r_162_184_28,r_189_119_81,r_5_179_51,r_162_184_28,0.53,53,81,28,71
172,seq224,r_99_122_75,r_132_272_107,r_99_122_75,0.95,0,75,75,71
87,r_207_23_118,seq164,r_171_124_107,r_207_23_118,0.95,0,118,118,71
162,seq198,seq238,r_83_281_67,r_83_281_67,1.0,21,88,67,71
2,r_83_281_67,seq201,seq198,r_83_281_67,0.99,0,67,67,71
172,seq224,r_132_272_107,r_141_220_98,r_141_220_98,0.77,3,101,98,71
105,seq22,r_5_179_51,r_133_296_35,r_133_296_35,0.97,25,60,35,71
18,r_5_179_51,seq22,seq167,r_5_179_51,0.96,9,60,51,71
29,r_53_150_73,r_100_163_141,seq168,r_53_150_73,0.99,0,73,73,71
157,seq177,r_125_138_72,r_21_64_79,r_125_138_72,0.89,2,74,72,71
55,r_44_82_38,seq290,r_247_94_7,r_44_82_38,1.0,0,38,38,71
24,r_174_34_63,r_183_109_145,r_211_111_30,r_174_34_63,0.95,0,63,63,71
66,r_169_4_34,r_261_284_88,r_289_51_144,r_169_4_34,1.0,0,34,34,71
74,r_11_105_24,r_99_122_75,seq116,r_11_105_24,1.0,0,24,24,71
64,r_121_225_168,seq76,r_96_226_131,r_121_225_168,0.7,0,168,168,71
133,seq108,seq188,r_44_82_38,r_44_82_38,1.0,21,59,38,71
50,r_236_194_88,seq192,seq1,r_236_194_88,1.0,0,88,88,71
71,r_62_199_13,r_148_241_140,seq76,r_148_241_140,0.56,-119,21,140,71
70,r_117_149_109,r_47_229_158,r_113_72_37,r_117_149_109,0.85,0,109,109,71
65,r_125_138_72,seq177,r_247_94_7,r_125_138_72,1.0,0,72,72,71
155,seq170,seq80,r_110_256_77,r_110_256_77,1.0,4,81,77,71
68,r_118_104_58,seq271,seq212,r_118_104_58,0.81,17,75,58,71
130,seq92,r_43_50_151,r_3_98_69,r_3_98_69,1.0,82,151,69,71
77,r_129_8_119,seq188,seq265,r_129_8_119,0.46,3,122,119,71
34,r_214_232_83,r_276_68_102,seq282,r_214_232_83,1.0,1,84,83,71
192,seq280,seq213,r_247_94_7,r_247_94_7,0.57,34,41,7,71
75,r_200_295_110,seq192,r_171_124_107,r_171_124_107,0.97,-1,106,107,71
60,r_189_119_81,r_162_184_28,r_3_98_69,r_189_119_81,1.0,0,81,81,71
17,r_268_17_115,seq67,seq57,r_268_17_115,0.34,9,124,115,71
94,r_21_64_79,r_180_231_83,seq177,r_180_231_83,0.96,-2,81,83,71
121,seq75,r_141_220_98,r_242_61_47,r_141_220_98,1.0,-23,75,98,71
96,r_228_196_157,r_289_51_144,r_169_4_34,r_169_4_34,0.94,110,144,34,71
11,r_24_52_9,r_14_46_109,seq168,r_14_46_109,0.52,-97,12,109,71
22,r_128_106_134,seq18,r_257_123_13,r_128_106_134,0.86,0,134,134,71
100,seq0,r_148_241_140,r_257_123_13,r_257_123_13,0.69,8,21,13,71
4,r_162_184_28,r_5_179_51,r_254_115_197,r_162_184_28,0.43,81,109,28,71
194,seq283,r_121_225_168,r_10_88_35,r_10_88_35,0.97,25,60,35,71
93,r_211_111_30,seq142,seq274,r_211_111_30,1.0,0,30,30,71
82,r_257_123_13,r_243_140_129,seq0,r_257_123_13,1.0,1,14,13,71
56,r_285_15_94,r_264_190_182,seq9,r_285_15_94,1.0,0,94,94,71
7,r_3_98_69,r_235_286_192,r_10_88_35,r_3_98_69,1.0,0,69,69,71
44,r_178_227_134,seq57,seq249,r_178_227_134,0.97,1,135,134,71
23,r_195_112_103,r_55_244_181,r_6_233_49,r_55_244_181,0.97,-78,103,181,71
79,r_235_286_192,r_3_98_69,r_25_166_12,r_3_98_69,1.0,0,69,69,71
35,r_132_272_107,r_47_229_158,seq27,r_132_272_107,0.91,3,110,107,71
12,r_100_163_141,seq116,r_3_98_69,r_3_98_69,0.58,72,141,69,71
84,r_260_97_86,r_235_286_192,seq201,r_260_97_86,0.8,5,91,86,71
57,r_113_72_37,r_14_46_109,r_11_105_24,r_113_72_37,1.0,0,37,37,71
51,r_28_223_131,r_233_102_133,r_58_231_77,r_28_223_131,0.99,0,131,131,72
36,r_210_15_98,r_35_117_173,seq267,r_210_15_98,0.96,0,98,98,72
122,seq74,seq202,r_107_53_95,r_107_53_95,1.0,7,102,95,72
44,r_88_187_182,r_220_166_132,r_162_83_52,r_88_187_182,0.85,0,182,182,72
92,r_100_0_69,seq24,seq282,r_100_0_69,1.0,0,69,69,72
14,r_52_69_114,seq199,r_188_56_65,r_52_69_114,0.98,0,114,114,72
86,r_177_133_162,r_10_170_84,r_152_280_156,r_152_280_156,0.79,14,170,156,72
54,r_152_280_156,seq174,seq237,r_152_280_156,0.65,0,156,156,72
83,r_107_53_95,seq73,seq74,r_107_53_95,1.0,0,95,95,72
37,r_293_63_175,seq247,r_103_157_104,r_293_63_175,0.53,0,175,175,72
81,r_130_224_173,r_177_133_162,r_210_15_98,r_130_224_173,0.89,1,174,173,72
59,r_220_166_132,seq37,r_7_46_30,r_220_166_132,0.9,1,133,132,72
71,r_207_17_185,seq164,r_68_239_195,r_207_17_185,0.32,0,185,185,72
86,r_177_133_162,r_39_95_92,r_10_170_84,r_10_170_84,0.86,8,92,84,72
39,r_78_208_158,seq20,seq73,r_78_208_158,0.84,0,158,158,72
97,r_160_278_107,r_233_102_133,r_218_112_16,r_160_278_107,1.0,0,107,107,72
46,r_211_273_119,seq43,r_61_49_35,r_211_273_119,0.71,5,124,119,72
18,r_104_196_25,seq106,r_184_60_147,r_104_196_25,0.97,1,26,25,72
80,r_139_27_180,seq146,r_40_50_46,r_139_27_180,0.46,0,180,180,72
53,r_55_19_13,r_79_31_59,seq174,r_55_19_13,0.63,0,13,13,72
19,r_194_241_68,r_78_208_158,r_299_123_32,r_194_241_68,1.0,0,68,68,72
4,r_40_50_46,r_35_117_173,seq106,r_40_50_46,1.0,0,46,46,72
78,r_281_284_54,r_201_268_148,r_61_49_35,r_281_284_54,0.98,-1,53,54,72
48,r_61_49_35,r_39_95_92,seq183,r_39_95_92,0.62,-53,39,92,72
95,r_154_93_67,r_165_179_83,r_194_241_68,r_194_241_68,0.98,-1,67,68,72
66,r_233_102_133,seq108,r_172_178_5,r_233_102_133,0.95,0,133,133,72
76,r_201_268_148,r_149_206_189,r_279_115_114,r_149_206_189,0.9,-41,148,189,72
31,r_65_142_177,seq257,r_96_259_15,r_65_142_177,0.53,1,178,177,72
41,r_14_84_82,r_32_86_180,r_104_196_25,r_14_84_82,1.0,0,82,82,72
67,r_149_206_189,r_103_157_104,seq237,r_103_157_104,0.65,0,104,104,72
110,seq37,r_220_166_132,seq106,r_220_166_132,0.99,1,133,132,72
89,r_195_216_173,seq267,r_297_232_94,r_195_216_173,0.38,1,174,173,72
10,r_16_45_73,r_11_197_148,seq124,r_16_45_73,1.0,2,75,73,72
70,r_299_123_32,seq164,seq70,r_299_123_32,0.82,0,32,32,72
28,r_162_83_52,r_32_86_180,seq257,r_162_83_52,1.0,0,52,52,72
26,r_176_200_76,seq5,seq182,r_176_200_76,0.92,0,76,76,72
72,r_191_42_72,r_130_224_173,seq272,r_191_42_72,1.0,2,74,72,72
0,r_103_157_104,r_149_206_189,r_194_241_68,r_194_241_68,1.0,37,105,68,72
11,r_134_6_156,seq33,seq214,r_134_6_156,0.93,0,156,156,72
107,seq26,r_155_148_104,seq54,r_155_148_104,0.69,-7,97,104,72
20,r_250_44_165,r_207_17_185,seq135,r_250_44_165,0.38,1,166,165,72
13,r_39_95_92,r_177_133_162,seq77,r_39_95_92,0.99,0,92,92,72
90,r_114_67_56,r_188_56_65,seq106,r_114_67_56,1.0,0,56,56,72
8,r_89_121_25,r_287_13_124,seq290,r_89_121_25,1.0,9,34,25,72
98,r_292_2_142,seq113,r_104_196_25,r_104_196_25,0.97,117,142,25,72
15,r_35_117_173,seq175,r_96_259_15,r_35_117_173,0.64,0,173,173,72
57,r_155_148_104,seq26,seq289,r_155_148_104,0.65,8,112,104,72
62,r_41_256_187,seq81,r_252_269_184,r_41_256_187,0.45,0,187,187,72
99,r_156_240_101,r_10_170_84,r_100_0_69,r_100_0_69,0.68,15,84,69,72
27,r_85_51_50,seq91,seq276,r_85_51_50,0.96,-3,47,50,72
87,r_158_98_173,seq168,seq38,r_158_98_173,0.74,0,173,173,72
47,r_11_197_148,r_32_86_180,seq125,r_11_197_148,0.85,0,148,148,72
24,r_245_198_117,seq174,seq38,r_245_198_117,0.44,1,118,117,72
96,r_136_193_25,r_3_97_195,r_55_19_13,r_136_193_25,0.72,1,26,25,72
25,r_169_4_102,r_159_266_130,seq124,r_169_4_102,0.92,-1,101,102,72
33,r_298_171_161,r_72_264_171,r_144_181_30,r_298_171_161,0.73,0,161,161,72
64,r_291_285_171,seq276,r_10_170_84,r_10_170_84,1.0,91,175,84,72
88,r_287_13_124,seq213,seq141,r_287_13_124,0.89,4,128,124,72
171,seq227,r_88_187_182,r_218_112_16,r_218_112_16,1.0,7,23,16,72
156,seq182,seq24,r_176_200_76,r_176_200_76,0.95,11,87,76,72
50,r_58_231_77,r_88_187_182,seq81,r_58_231_77,1.0,0,77,77,72
68,r_209_101_171,r_88_187_182,r_9_185_47,r_88_187_182,0.51,-10,172,182,72
52,r_184_60_147,r_130_224_173,seq146,r_184_60_147,0.41,9,156,147,72
77,r_279_115_114,seq70,seq20,r_279_115_114,1.0,0,114,114,72
43,r_79_31_59,seq276,r_162_83_52,r_79_31_59,0.82,0,59,59,72
75,r_188_56_65,seq43,seq213,r_188_56_65,0.84,3,68,65,72
30,r_116_1_39,seq70,seq213,r_116_1_39,0.9,4,43,39,72
61,r_29_57_42,r_201_268_148,seq274,r_29_57_42,1.0,1,43,42,72
81,r_130_224_173,r_184_60_147,r_177_133_162,r_130_224_173,0.25,-27,146,173,72
17,r_87_243_154,seq230,seq54,r_87_243_154,0.8,1,155,154,72
94,r_165_179_83,r_220_166_132,seq164,r_165_179_83,1.0,0,83,83,72
144,seq146,r_139_27_180,r_89_121_25,r_89_121_25,0.58,143,168,25,72
9,r_189_118_66,seq261,r_76_263_2,r_189_118_66,1.0,1,67,66,72
1,r_218_112_16,r_250_44_165,seq227,r_218_112_16,1.0,-1,15,16,72
40,r_248_186_54,seq54,seq288,r_248_186_54,0.67,0,54,54,72
32,r_144_181_30,r_191_42_72,seq175,r_144_181_30,1.0,0,30,30,72
22,r_32_86_180,seq274,r_218_112_16,r_218_112_16,0.64,165,181,16,72
99,r_156_240_101,r_100_0_69,r_39_95_92,r_156_240_101,0.92,1,102,101,72
60,r_105_36_57,r_252_269_184,seq164,r_105_36_57,1.0,2,59,57,72
91,r_296_23_98,seq90,r_297_232_94,r_296_23_98,0.98,-1,97,98,72
135,seq124,r_111_109_171,r_16_45_73,r_16_45_73,1.0,95,168,73,72
49,r_244_260_167,seq81,r_134_6_156,r_244_260_167,0.75,1,168,167,72
164,seq213,r_287_13_124,r_52_69_114,r_52_69_114,0.93,14,128,114,72
7,r_297_232_94,seq70,r_296_23_98,r_297_232_94,0.73,7,101,94,72
18,r_104_196_25,r_184_60_147,r_14_84_82,r_14_84_82,1.0,9,91,82,72
44,r_88_187_182,r_209_101_171,r_220_166_132,r_220_166_132,0.78,36,168,132,72
23,r_252_269_184,seq265,r_162_83_52,r_162_83_52,1.0,132,184,52,72
82,r_159_266_130,r_3_97_195,seq132,r_159_266_130,0.75,6,136,130,72
63,r_66_129_43,r_252_269_184,r_7_46_30,r_66_129_43,1.0,1,44,43,72
24,r_245_198_117,seq38,r_126_131_129,r_126_131_129,0.82,2,131,129,72
12,r_94_235_100,r_244_260_167,r_114_67_56,r_94_235_100,0.98,4,104,100,72
182,seq257,r_65_142_177,r_162_83_52,r_162_83_52,1.0,45,97,52,72
84,r_119_18_89,r_252_269_184,seq80,r_119_18_89,0.66,3,92,89,72
3,r_221_190_38,r_287_13_124,seq247,r_221_190_38,1.0,0,38,38,72
93,r_222_209_169,r_111_61_191,r_65_83_54,r_222_209_169,0.61,0,169,169,73
30,r_283_29_188,r_259_204_87,r_41_122_10,r_283_29_188,0.61,-95,93,188,73
36,r_11_166_141,seq37,seq104,r_11_166_141,0.89,0,141,141,73
92,r_105_256_87,r_17_189_113,seq51,r_105_256_87,1.0,0,87,87,73
8,r_137_220_171,r_71_190_198,r_89_233_153,r_137_220_171,0.35,0,171,171,73
151,seq147,r_239_23_58,seq196,r_239_23_58,0.78,14,72,58,73
53,r_32_148_161,r_152_68_170,r_45_161_65,r_45_161_65,0.6,96,161,65,73
43,r_133_175_165,seq140,r_197_155_16,r_133_175_165,0.58,0,165,165,73
83,r_276_219_151,r_283_29_188,r_207_230_127,r_276_219_151,0.76,0,151,151,73
76,r_158_1_40,r_249_262_62,seq22,r_249_262_62,0.99,-21,41,62,73
55,r_17_189_113,seq142,seq134,r_17_189_113,1.0,1,114,113,73
86,r_159_279_151,seq193,r_95_124_30,r_159_279_151,0.8,0,151,151,73
16,r_45_161_65,r_53_265_124,r_263_156_66,r_45_161_65,0.95,2,67,65,73
21,r_238_172_97,r_132_62_128,seq271,r_238_172_97,1.0,1,98,97,73
39,r_106_60_89,seq51,seq232,r_106_60_89,1.0,0,89,89,73
91,r_160_295_56,r_263_156_66,seq114,r_160_295_56,1.0,0,56,56,73
1,r_212_205_104,seq250,r_136_97_88,r_212_205_104,0.85,0,104,104,73
5,r_85_38_93,r_198_77_142,r_164_261_17,r_85_38_93,0.7,0,93,93,73
46,r_15_260_115,seq102,seq47,r_15_260_115,0.96,0,115,115,73
42,r_176_168_93,seq191,seq169,r_176_168_93,0.79,0,93,93,73
80,r_278_179_126,seq203,seq242,r_278_179_126,0.52,0,126,126,73
85,r_285_129_7,r_11_166_141,r_174_92_169,r_285_129_7,0.79,6,13,7,73
69,r_49_269_126,seq134,r_186_36_92,r_49_269_126,0.97,0,126,126,73
19,r_65_83_54,r_181_201_174,r_222_209_169,r_65_83_54,0.56,114,168,54,73
98,r_44_66_41,r_212_205_104,r_95_124_30,r_44_66_41,1.0,0,41,41,73
66,r_286_87_68,r_72_63_126,r_79_19_4,r_286_87_68,0.82,6,74,68,73
184,seq250,r_194_117_147,r_243_107_159,r_243_107_159,0.74,10,169,159,73
103,seq12,r_101_150_1,r_95_124_30,r_95_124_30,0.71,42,72,30,73
31,r_181_201_174,r_65_83_54,r_108_231_9,r_181_201_174,0.54,0,174,174,73
61,r_67_31_33,r_111_61_191,r_71_190_198,r_67_31_33,1.0,1,34,33,73
29,r_197_155_16,r_291_235_98,seq81,r_197_155_16,0.97,0,16,16,73
67,r_152_68_170,seq195,r_45_161_65,r_152_68_170,0.57,0,170,170,73
27,r_244_52_35,r_10_78_161,seq114,r_244_52_35,1.0,0,35,35,73
156,seq171,seq280,r_164_261_17,r_164_261_17,0.9,4,21,17,73
10,r_240_221_99,r_174_92_169,r_277_127_89,r_277_127_89,1.0,32,121,89,73
2,r_53_265_124,r_200_40_32,r_75_296_31,r_53_265_124,1.0,0,124,124,73
115,seq50,seq104,r_136_97_88,r_136_97_88,1.0,11,99,88,73
5,r_85_38_93,r_164_261_17,r_108_231_9,r_108_231_9,0.85,110,119,9,73
4,r_123_100_111,r_194_117_147,r_106_60_89,r_123_100_111,0.69,0,111,111,73
0,r_270_91_134,seq173,seq102,r_270_91_134,0.88,0,134,134,73
63,r_119_21_136,r_113_268_177,r_75_296_31,r_119_21_136,0.9,0,136,136,73
37,r_200_40_32,r_162_94_112,r_53_265_124,r_200_40_32,1.0,2,34,32,73
73,r_207_230_127,seq144,r_276_219_151,r_276_219_151,0.77,14,165,151,73
107,seq25,r_294_146_115,r_75_296_31,r_75_296_31,0.99,30,61,31,73
95,r_39_57_17,r_160_295_56,seq182,r_39_57_17,0.95,-1,16,17,73
56,r_298_251_102,r_194_117_147,r_243_107_159,r_298_251_102,0.82,67,169,102,73
155,seq169,r_270_91_134,r_176_168_93,r_270_91_134,0.63,-30,104,134,73
15,r_194_117_147,seq250,r_76_5_35,r_76_5_35,0.68,113,148,35,73
6,r_239_23_58,seq147,seq109,r_239_23_58,1.0,2,60,58,73
62,r_82_59_148,r_159_279_151,seq55,r_82_59_148,0.85,0,148,148,73
30,r_283_29_188,r_41_122_10,r_198_77_142,r_41_122_10,0.75,178,188,10,73
87,r_174_92_169,r_240_221_99,r_285_129_7,r_285_129_7,0.59,99,106,7,73
178,seq237,r_276_219_151,r_3_163_117,r_3_163_117,0.61,15,132,117,73
2,r_53_265_124,r_45_161_65,r_200_40_32,r_53_265_124,0.69,-59,65,124,73
47,r_14_215_188,seq211,seq70,r_14_215_188,0.46,0,188,188,73
132,seq102,r_222_209_169,r_270_91_134,r_270_91_134,0.8,3,137,134,73
40,r_294_146_115,r_133_175_165,seq196,r_133_175_165,1.0,-47,118,165,73
126,seq81,r_185_126_182,r_123_100_111,r_123_100_111,1.0,71,182,111,73
18,r_198_77_142,seq226,r_167_290_128,r_198_77_142,0.94,0,142,142,73
157,seq173,r_270_91_134,seq169,r_270_91_134,0.93,1,135,134,73
25,r_291_235_98,seq109,seq9,r_291_235_98,0.93,0,98,98,73
33,r_249_262_62,seq169,seq193,r_249_262_62,1.0,0,62,62,73
64,r_170_110_66,r_238_172_97,seq22,r_170_110_66,1.0,1,67,66,73
88,r_225_103_104,seq102,seq226,r_225_103_104,1.0,0,104,104,73
50,r_136_97_88,seq271,seq50,r_136_97_88,1.0,0,88,88,73
58,r_132_62_128,seq242,seq35,r_132_62_128,0.97,1,129,128,73
65,r_138_43_127,r_153_115_190,r_208_149_58,r_138_43_127,0.58,0,127,127,73
155,seq169,r_249_262_62,r_270_91_134,r_249_262_62,1.0,2,64,62,73
49,r_164_261_17,r_11_166_141,seq171,r_164_261_17,0.98,0,17,17,73
32,r_71_190_198,r_137_220_171,r_67_31_33,r_67_31_33,0.98,138,171,33,73
38,r_73_33_183,seq114,r_85_38_93,r_73_33_183,0.51,0,183,183,73
52,r_236_213_165,seq143,r_123_100_111,r_236_213_165,0.64,0,165,165,73
77,r_259_204_87,r_276_219_151,seq56,r_276_219_151,0.71,-58,93,151,73
34,r_162_94_112,r_14_215_188,r_286_87_68,r_162_94_112,1.0,0,112,112,73
14,r_292_16_9,r_137_220_171,seq25,r_292_16_9,0.99,3,12,9,73
82,r_90_184_50,seq203,seq180,r_90_184_50,1.0,4,54,50,73
75,r_111_61_191,r_222_209_169,r_11_166_141,r_11_166_141,0.63,28,169,141,73
132,seq102,r_225_103_104,r_222_209_169,r_225_103_104,0.97,1,105,104,73
24,r_202_234_30,seq120,seq182,r_202_234_30,0.99,4,34,30,73
60,r_192_86_175,seq55,r_105_256_87,r_105_256_87,1.0,88,175,87,73
17,r_3_163_117,seq51,r_228_24_107,r_3_163_117,0.99,0,117,117,73
71,r_274_96_54,r_294_146_115,seq193,r_274_96_54,1.0,0,54,54,73
9,r_72_63_126,seq22,r_49_269_126,r_72_63_126,0.8,0,126,126,73
96,r_263_156_66,seq18,r_45_161_65,r_263_156_66,0.95,1,67,66,73
37,r_200_40_32,r_53_265_124,r_274_96_54,r_53_265_124,0.92,0,124,124,73
28,r_187_227_81,seq180,r_299_157_19,r_187_227_81,0.97,1,82,81,73
135,seq114,r_73_33_183,r_244_52_35,r_244_52_35,0.97,148,183,35,73
97,r_6_288_41,r_4_2_112,seq93,r_6_288_41,1.0,0,41,41,73
41,r_208_149_58,r_65_83_54,seq182,r_208_149_58,1.0,0,58,58,73
164,seq195,r_152_68_170,r_67_31_33,r_67_31_33,0.65,137,170,33,73
149,seq144,r_207_230_127,r_194_117_147,r_194_117_147,0.81,18,165,147,73
56,r_298_251_102,r_133_175_165,r_194_117_147,r_298_251_102,0.98,3,105,102,73
7,r_20_183_104,r_185_126_182,r_244_52_35,r_20_183_104,1.0,0,104,104,73
118,seq55,r_192_86_175,r_82_59_148,r_82_59_148,0.59,27,175,148,73
79,r_41_122_10,r_283_29_188,r_3_163_117,r_3_163_117,1.0,71,188,117,73
35,r_113_268_177,r_79_19_4,r_202_234_30,r_79_19_4,0.5,173,177,4,73
11,r_95_124_30,r_72_63_126,r_44_66_41,r_95_124_30,0.96,12,42,30,73
12,r_253_289_112,seq9,r_277_127_89,r_277_127_89,1.0,29,118,89,73
78,r_75_296_31,r_253_289_112,seq271,r_75_296_31,0.97,3,34,31,73
84,r_4_2_112,seq47,seq191,r_4_2_112,0.65,10,122,112,73
74,r_76_5_35,r_137_220_171,seq144,r_76_5_35,0.79,11,46,35,73
93,r_196_280_179,r_169_162_171,r_118_113_46,r_118_113_46,0.81,99,145,46,74
92,r_138_153_159,r_198_167_161,r_210_256_115,r_210_256_115,0.68,45,160,115,74
14,r_186_239_67,r_81_294_72,r_129_9_196,r_186_239_67,1.0,-2,65,67,74
8,r_124_56_62,seq143,r_210_256_115,r_124_56_62,1.0,1,63,62,74
53,r_218_234_158,seq231,r_118_113_46,r_218_234_158,0.55,0,158,158,74
149,seq141,r_98_147_86,seq227,r_98_147_86,1.0,-37,49,86,74
94,r_257_267_26,seq82,seq254,r_257_267_26,1.0,-1,25,26,74
98,r_290_135_57,r_112_174_101,seq235,r_290_135_57,0.5,0,57,57,74
8,r_124_56_62,r_210_256_115,seq82,r_210_256_115,1.0,-6,109,115,74
54,r_184_173_133,r_22_80_63,r_51_281_53,r_184_173_133,0.9,-70,63,133,74
54,r_184_173_133,r_51_281_53,r_30_69_88,r_184_173_133,1.0,0,133,133,74
59,r_22_80_63,r_184_173_133,r_96_230_28,r_22_80_63,0.96,0,63,63,74
55,r_99_221_154,seq130,seq93,r_99_221_154,0.54,4,158,154,74
86,r_204_248_160,r_32_261_102,seq28,r_204_248_160,0.62,-93,67,160,74
21,r_67_270_141,seq77,r_257_267_26,r_257_267_26,0.78,115,141,26,74
39,r_98_147_86,seq141,seq117,r_98_147_86,1.0,0,86,86,74
2,r_263_185_28,r_16_103_110,r_299_289_5,r_263_185_28,0.92,0,28,28,74
65,r_146_177_37,r_225_26_128,seq38,r_146_177_37,0.72,5,42,37,74
1,r_198_167_161,seq89,r_31_203_118,r_198_167_161,0.62,0,161,161,74
97,r_171_288_124,seq215,seq66,r_171_288_124,0.98,1,125,124,74
5,r_225_26_128,r_176_139_165,seq187,r_225_26_128,0.8,2,130,128,74
80,r_41_137_158,r_216_13_191,seq215,r_41_137_158,0.78,2,160,158,74
19,r_299_289_5,seq156,r_263_185_28,r_263_185_28,0.99,11,39,28,74
69,r_291_172_67,seq240,r_5_25_62,r_291_172_67,1.0,2,69,67,74
45,r_161_183_82,r_184_173_133,r_7_68_73,r_161_183_82,0.62,0,82,82,74
90,r_105_64_27,r_225_26_128,r_257_267_26,r_257_267_26,1.0,-1,25,26,74
95,r_94_37_93,r_84_43_197,r_290_135_57,r_94_37_93,0.73,1,94,93,74
41,r_79_54_42,seq23,r_73_273_35,r_79_54_42,0.99,0,42,42,74
31,r_110_168_86,r_225_26_128,seq287,r_225_26_128,0.86,-42,86,128,74
67,r_125_224_99,r_252_244_182,r_32_261_102,r_125_224_99,0.51,13,112,99,74
89,r_220_223_84,r_31_203_118,seq229,r_220_223_84,0.94,2,86,84,74
10,r_7_68_73,r_31_203_118,seq141,r_7_68_73,0.89,2,75,73,74
26,r_150_272_109,seq50,r_11_212_25,r_150_272_109,0.99,0,109,109,74
139,seq117,seq131,r_98_147_86,r_98_147_86,1.0,15,101,86,74
81,r_73_273_35,seq199,seq89,r_73_273_35,1.0,0,35,35,74
4,r_100_275_125,seq18,r_110_168_86,r_100_275_125,1.0,0,125,125,74
15,r_81_294_72,seq60,r_292_144_118,r_292_144_118,0.87,5,123,118,74
78,r_112_174_101,r_169_162_171,seq227,r_112_174_101,0.98,0,101,101,74
42,r_118_113_46,r_7_68_73,seq109,r_118_113_46,0.88,0,46,46,74
73,r_292_144_118,r_17_259_166,r_81_294_72,r_292_144_118,0.76,1,119,118,74
83,r_214_116_22,r_42_217_169,seq247,r_214_116_22,1.0,-1,21,22,74
20,r_202_279_122,seq66,seq151,r_202_279_122,0.83,3,125,122,74
15,r_81_294_72,r_181_152_156,seq60,r_81_294_72,0.97,1,73,72,74
93,r_196_280_179,r_118_113_46,r_136_14_81,r_196_280_179,0.89,0,179,179,74
57,r_71_83_154,seq28,seq61,r_71_83_154,0.79,0,154,154,74
187,seq262,r_31_203_118,r_257_267_26,r_257_267_26,0.68,94,120,26,74
85,r_48_134_72,seq90,r_105_64_27,r_48_134_72,0.97,0,72,72,74
99,r_76_123_188,seq12,r_62_226_160,r_62_226_160,0.63,28,188,160,74
27,r_232_78_62,r_32_261_102,seq18,r_232_78_62,1.0,0,62,62,74
58,r_51_281_53,seq61,seq49,r_51_281_53,1.0,0,53,53,74
47,r_62_226_160,seq40,seq3,r_62_226_160,0.8,0,160,160,74
6,r_129_9_196,r_206_241_88,r_52_29_47,r_52_29_47,0.72,0,47,47,74
40,r_169_162_171,seq229,r_100_275_125,r_100_275_125,0.78,46,171,125,74
56,r_182_121_12,r_216_13_191,seq120,r_182_121_12,0.94,1,13,12,74
74,r_47_87_72,seq128,seq242,r_47_87_72,0.98,0,72,72,74
29,r_243_154_80,r_62_226_160,r_96_230_28,r_243_154_80,1.0,0,80,80,74
98,r_290_135_57,seq235,r_94_37_93,r_94_37_93,0.96,3,96,93,74
24,r_206_241_88,seq250,r_204_248_160,r_206_241_88,0.99,-2,86,88,74
64,r_170_277_68,r_86_268_121,r_96_230_28,r_86_268_121,0.86,-60,61,121,74
13,r_175_179_19,r_232_78_62,seq23,r_232_78_62,0.73,-43,19,62,74
72,r_194_97_45,r_48_134_72,seq151,r_48_134_72,0.89,-29,43,72,74
88,r_264_284_69,seq55,seq208,r_264_284_69,0.98,2,71,69,74
52,r_65_114_49,seq3,seq117,r_65_114_49,1.0,0,49,49,74
50,r_136_14_81,seq120,seq21,r_136_14_81,1.0,0,81,81,74
68,r_181_152_156,r_4_193_195,r_7_68_73,r_181_152_156,0.91,0,156,156,74
61,r_176_139_165,seq49,r_157_178_152,r_176_139_165,0.35,1,166,165,74
38,r_39_91_162,seq141,seq15,r_39_91_162,0.51,1,163,162,74
66,r_238_85_57,seq271,seq199,r_238_85_57,0.71,-6,51,57,74
34,r_210_256_115,seq247,r_238_85_57,r_210_256_115,1.0,0,115,115,74
70,r_207_249_15,r_34_8_178,seq82,r_207_249_15,0.98,4,19,15,74
181,seq247,r_210_256_115,r_214_116_22,r_214_116_22,0.72,-1,21,22,74
36,r_52_29_47,seq61,r_129_9_196,r_52_29_47,1.0,0,47,47,74
60,r_157_178_152,seq199,r_176_139_165,r_157_178_152,0.3,0,152,152,74
150,seq143,r_124_56_62,r_118_113_46,r_124_56_62,0.9,1,63,62,74
17,r_163_222_77,seq140,r_84_43_197,r_163_222_77,0.97,-2,75,77,74
173,seq229,r_169_162_171,r_220_223_84,r_220_223_84,0.94,2,86,84,74
9,r_86_268_121,seq21,seq274,r_86_268_121,1.0,0,121,121,74
37,r_148_278_12,r_210_256_115,seq166,r_148_278_12,1.0,0,12,12,74
96,r_104_211_120,r_218_234_158,r_51_281_53,r_218_234_158,1.0,-38,120,158,74
16,r_189_53_39,r_238_85_57,seq209,r_189_53_39,0.99,-4,35,39,74
22,r_20_192_108,r_76_123_188,r_189_53_39,r_20_192_108,0.96,1,109,108,74
62,r_101_2_4,r_112_174_101,seq111,r_112_174_101,1.0,0,101,101,74
28,r_31_203_118,seq262,seq28,r_31_203_118,0.64,2,120,118,74
18,r_11_212_25,seq33,seq40,r_11_212_25,0.98,0,25,25,74
84,r_236_201_186,seq33,r_210_256_115,r_236_201_186,0.47,1,187,186,74
49,r_30_69_88,r_20_192_108,seq231,r_30_69_88,0.95,0,88,88,74
164,seq199,r_157_178_152,r_210_256_115,r_210_256_115,0.99,9,124,115,74
7,r_42_217_169,seq166,r_48_134_72,r_42_217_169,0.66,3,172,169,74
168,seq209,r_16_103_110,r_189_53_39,r_189_53_39,1.0,-4,35,39,74
44,r_149_265_153,seq227,r_51_281_53,r_51_281_53,1.0,102,155,53,74
23,r_24_57_177,seq285,r_100_275_125,r_100_275_125,0.97,53,178,125,74
79,r_5_25_62,r_169_162_171,r_291_172_67,r_5_25_62,0.71,3,65,62,74
130,seq89,r_198_167_161,r_73_273_35,r_73_273_35,1.0,0,35,35,74
12,r_32_261_102,r_204_248_160,r_125_224_99,r_32_261_102,0.5,10,112,102,74
46,r_96_230_28,r_169_162_171,seq12,r_96_230_28,0.98,-1,27,28,74
90,r_105_64_27,r_257_267_26,r_48_134_72,r_48_134_72,1.0,3,75,72,74
84,r_236_201_186,r_104_211_120,seq33,r_104_211_120,1.0,0,120,120,74
30,r_175_294_145,r_105_269_76,r_260_212_198,r_175_294_145,0.9,2,147,145,75
0,r_60_169_28,r_209_198_197,seq48,r_60_169_28,1.0,0,28,28,75
92,r_114_129_183,seq59,r_286_253_1,r_114_129_183,0.41,0,183,183,75
147,seq136,seq61,r_86_26_108,r_86_26_108,1.0,8,116,108,75
8,r_280_120_86,seq186,r_12_33_17,r_280_120_86,0.99,2,88,86,75
43,r_86_26_108,r_145_47_166,seq136,r_86_26_108,0.97,0,108,108,75
36,r_217_164_38,r_145_47_166,r_101_64_111,r_217_164_38,0.99,1,39,38,75
54,r_90_195_76,r_0_80_125,seq94,r_90_195_76,1.0,-1,75,76,75
83,r_125_55_111,r_260_212_198,seq270,r_125_55_111,1.0,0,111,111,75
60,r_235_268_27,r_230_174_37,seq69,r_235_268_27,0.99,2,29,27,75
116,seq48,r_177_78_176,r_60_169_28,r_60_169_28,0.5,148,176,28,75
44,r_226_54_18,r_62_123_103,seq261,r_62_123_103,0.72,-89,14,103,75
48,r_172_225_17,r_135_100_138,seq236,r_172_225_17,1.0,3,20,17,75
59,r_67_146_145,seq186,r_0_80_125,r_0_80_125,0.53,20,145,125,75
53,r_247_262_24,seq25,seq221,r_247_262_24,0.92,0,24,24,75
29,r_296_142_51,r_167_176_72,r_12_33_17,r_296_142_51,1.0,0,51,51,75
40,r_38_291_35,r_260_212_198,seq223,r_38_291_35,0.99,0,35,35,75
16,r_84_29_109,r_145_47_166,r_167_176_72,r_84_29_109,1.0,0,109,109,75
39,r_214_124_152,seq144,seq234,r_214_124_152,0.89,1,153,152,75
95,r_65_201_12,r_173_1_110,seq171,r_65_201_12,0.97,0,12,12,75
1,r_216_98_119,seq36,r_278_130_193,r_216_98_119,0.93,0,119,119,75
97,r_30_77_75,seq39,r_16_266_52,r_30_77_75,1.0,1,76,75,75
42,r_14_257_128,seq297,seq147,r_14_257_128,0.97,0,128,128,75
58,r_163_279_55,r_50_242_169,r_226_54_18,r_163_279_55,0.99,0,55,55,75
41,r_149_35_44,seq221,seq245,r_149_35_44,1.0,0,44,44,75
69,r_159_267_78,r_214_124_152,r_217_164_38,r_159_267_78,1.0,0,78,78,75
2,r_200_249_192,r_145_47_166,r_160_3_10,r_160_3_10,1.0,0,10,10,75
24,r_11_10_12,r_0_80_125,r_16_266_52,r_11_10_12,0.99,113,125,12,75
174,seq232,r_167_176_72,r_132_108_17,r_132_108_17,1.0,1,18,17,75
66,r_206_56_127,seq41,r_84_29_109,r_206_56_127,0.94,0,127,127,75
184,seq261,r_162_58_65,r_226_54_18,r_162_58_65,1.0,2,67,65,75
71,r_240_259_11,r_200_249_192,seq61,r_240_259_11,0.54,0,11,11,75
31,r_152_166_161,seq227,seq41,r_152_166_161,0.75,2,163,161,75
67,r_96_75_62,seq93,r_27_243_14,r_96_75_62,1.0,4,66,62,75
3,r_119_66_154,seq89,r_143_265_47,r_119_66_154,0.72,0,154,154,75
10,r_134_117_144,r_165_18_28,r_183_70_16,r_134_117_144,0.87,0,144,144,75
26,r_287_79_147,seq178,r_8_197_26,r_287_79_147,0.91,0,147,147,75
72,r_101_64_111,seq118,r_264_181_49,r_101_64_111,0.98,0,111,111,75
5,r_12_33_17,r_256_233_187,r_49_204_7,r_12_33_17,1.0,0,17,17,75
14,r_218_23_18,r_87_88_125,r_8_197_26,r_87_88_125,0.55,0,125,125,75
78,r_215_110_125,seq236,r_264_181_49,r_215_110_125,1.0,1,126,125,75
63,r_173_1_110,r_231_138_193,seq37,r_173_1_110,1.0,0,110,110,75
74,r_161_133_33,seq20,seq297,r_161_133_33,1.0,1,34,33,75
17,r_230_174_37,r_229_251_86,seq81,r_230_174_37,1.0,4,41,37,75
13,r_256_233_187,seq45,r_38_291_35,r_256_233_187,0.23,0,187,187,75
76,r_187_122_25,seq223,seq53,r_187_122_25,1.0,0,25,25,75
98,r_112_31_126,r_67_146_145,seq45,r_112_31_126,0.99,1,127,126,75
14,r_218_23_18,seq28,r_87_88_125,r_218_23_18,0.98,0,18,18,75
27,r_42_116_152,r_247_262_24,r_260_212_198,r_42_116_152,0.91,1,153,152,75
104,seq20,r_161_133_33,seq299,r_161_133_33,0.67,1,34,33,75
35,r_27_243_14,seq61,r_145_47_166,r_27_243_14,0.82,2,16,14,75
6,r_34_237_182,seq41,r_139_19_158,r_34_237_182,0.52,0,182,182,75
85,r_277_83_183,seq91,seq7,r_277_83_183,0.58,0,183,183,75
75,r_143_265_47,seq52,r_231_138_193,r_143_265_47,1.0,1,48,47,75
36,r_217_164_38,r_101_64_111,r_159_267_78,r_217_164_38,0.68,65,103,38,75
27,r_42_116_152,r_290_298_134,r_247_262_24,r_42_116_152,0.7,-18,134,152,75
80,r_111_97_55,r_214_124_152,seq73,r_111_97_55,1.0,1,56,55,75
87,r_85_192_103,r_215_110_125,r_111_97_55,r_85_192_103,0.7,0,103,103,75
47,r_250_153_174,seq41,r_143_265_47,r_143_265_47,0.74,129,176,47,75
18,r_87_88_125,r_177_78_176,r_218_23_18,r_218_23_18,0.77,83,101,18,75
88,r_231_138_193,r_173_1_110,r_143_265_47,r_231_138_193,0.87,-139,54,193,75
35,r_27_243_14,r_145_47_166,r_96_75_62,r_96_75_62,0.64,16,78,62,75
25,r_229_251_86,seq186,r_226_54_18,r_229_251_86,1.0,0,86,86,75
94,r_8_197_26,r_200_249_192,seq82,r_8_197_26,1.0,1,27,26,75
33,r_246_185_94,seq228,r_162_58_65,r_246_185_94,1.0,1,95,94,75
11,r_183_70_16,seq227,seq248,r_183_70_16,1.0,0,16,16,75
50,r_274_252_160,r_32_180_167,r_196_92_88,r_274_252_160,0.79,0,160,160,75
70,r_241_199_174,seq104,r_106_46_148,r_241_199_174,0.81,-1,173,174,75
65,r_62_123_103,seq234,seq228,r_62_123_103,0.98,0,103,103,75
19,r_160_3_10,r_216_98_119,r_200_249_192,r_160_3_10,1.0,0,10,10,75
68,r_162_58_65,seq261,r_179_151_7,r_162_58_65,1.0,2,67,65,75
61,r_115_255_148,seq37,r_179_151_7,r_115_255_148,0.87,5,153,148,75
32,r_71_6_74,r_241_199_174,seq59,r_71_6_74,0.89,8,82,74,75
38,r_50_242_169,seq150,r_67_146_145,r_50_242_169,0.49,0,169,169,75
52,r_263_154_102,seq207,seq228,r_263_154_102,0.95,6,108,102,75
77,r_0_80_125,seq44,r_72_188_10,r_0_80_125,0.91,0,125,125,75
34,r_211_182_70,seq4,r_12_33_17,r_211_182_70,1.0,0,70,70,75
154,seq170,r_145_47_166,r_246_185_94,r_246_185_94,1.0,75,169,94,75
24,r_11_10_12,seq219,r_0_80_125,r_11_10_12,0.99,0,12,12,75
79,r_16_266_52,seq7,r_11_10_12,r_16_266_52,1.0,1,53,52,75
81,r_22_158_159,seq69,seq99,r_22_158_159,0.68,1,160,159,75
173,seq228,r_246_185_94,seq270,r_246_185_94,1.0,1,95,94,75
155,seq171,r_165_18_28,r_65_201_12,r_65_201_12,1.0,0,12,12,75
18,r_87_88_125,r_218_23_18,r_183_70_16,r_87_88_125,0.89,0,125,125,75
96,r_72_188_10,r_119_66_154,seq61,r_72_188_10,0.95,0,10,10,75
22,r_106_46_148,seq9,seq288,r_106_46_148,0.9,0,148,148,75
28,r_196_92_88,seq285,seq270,r_196_92_88,1.0,1,89,88,75
91,r_13_184_143,seq121,r_196_92_88,r_196_92_88,0.66,55,143,88,75
181,seq248,seq155,r_183_70_16,r_183_70_16,1.0,0,16,16,75
49,r_24_128_35,r_230_174_37,r_172_225_17,r_24_128_35,1.0,0,35,35,75
82,r_140_193_13,r_115_255_148,seq107,r_140_193_13,0.97,1,14,13,75
56,r_15_284_163,r_277_83_183,r_14_257_128,r_277_83_183,0.85,-19,164,183,75
7,r_145_47_166,seq170,r_140_193_13,r_145_47_166,0.54,3,169,166,75
51,r_132_108_17,seq81,seq232,r_132_108_17,1.0,0,17,17,75
138,seq104,r_241_199_174,seq7,r_241_199_174,0.89,3,177,174,75
12,r_139_19_158,seq121,r_132_108_17,r_139_19_158,0.77,2,160,158,75
86,r_17_168_19,r_200_249_192,r_132_108_17,r_17_168_19,0.7,0,19,19,75
93,r_236_292_116,seq125,r_243_157_156,r_236_292_116,0.66,0,116,116,76
176,seq232,r_195_119_126,r_5_179_8,r_195_119_126,0.76,0,126,126,76
51,r_57_30_153,r_149_183_123,r_73_192_106,r_149_183_123,0.95,30,153,123,76
92,r_36_42_72,r_109_230_186,r_145_128_199,r_36_42_72,1.0,0,72,72,76
25,r_200_2_48,seq18,r_117_299_44,r_200_2_48,1.0,0,48,48,76
8,r_277_221_130,seq225,r_217_148_142,r_277_221_130,0.45,15,145,130,76
53,r_189_296_136,seq113,r_223_123_35,r_189_296_136,0.95,0,136,136,76
43,r_249_216_185,r_48_43_120,r_36_42_72,r_48_43_120,0.45,65,185,120,76
83,r_99_231_60,seq201,seq155,r_99_231_60,1.0,0,60,60,76
37,r_13_136_140,r_38_88_176,r_200_2_48,r_13_136_140,0.86,0,140,140,76
19,r_50_235_8,r_141_194_154,r_297_120_149,r_141_194_154,0.55,-14,140,154,76
71,r_68_90_134,seq233,r_279_135_119,r_68_90_134,1.0,0,134,134,76
1,r_73_192_106,seq37,r_48_43_120,r_73_192_106,1.0,0,106,106,76
104,seq19,seq274,r_82_234_27,r_82_234_27,1.0,44,71,27,76
46,r_245_122_98,r_236_292_116,seq112,r_245_122_98,1.0,0,98,98,76
42,r_247_185_94,seq155,seq282,r_247_185_94,0.7,0,94,94,76
110,seq31,r_115_207_51,r_26_228_34,r_26_228_34,1.0,20,54,34,76
80,r_35_160_113,seq71,r_200_2_48,r_35_160_113,0.99,0,113,113,76
69,r_289_10_135,seq34,r_47_186_3,r_289_10_135,0.83,2,137,135,76
45,r_224_129_83,seq61,seq198,r_224_129_83,0.59,31,114,83,76
103,seq18,seq174,r_181_162_90,r_181_162_90,1.0,0,90,90,76
11,r_156_127_186,r_104_204_91,r_20_269_25,r_156_127_186,0.7,0,186,186,76
38,r_83_9_32,r_145_128_199,seq248,r_83_9_32,1.0,0,32,32,76
95,r_108_287_127,seq265,seq259,r_108_287_127,1.0,0,127,127,76
76,r_288_293_79,r_124_87_179,r_223_123_35,r_288_293_79,1.0,0,79,79,76
129,seq102,seq61,r_84_55_27,r_84_55_27,0.96,21,48,27,76
31,r_54_44_159,r_48_43_120,r_243_157_156,r_54_44_159,0.8,2,161,159,76
41,r_109_230_186,seq33,r_66_150_161,r_66_150_161,0.69,25,186,161,76
3,r_107_72_108,r_97_244_120,r_5_179_8,r_107_72_108,0.99,-1,107,108,76
26,r_191_242_17,r_66_150_161,r_48_43_120,r_191_242_17,1.0,0,17,17,76
90,r_101_118_171,r_209_251_195,seq248,r_101_118_171,0.42,1,172,171,76
67,r_17_278_23,seq29,seq214,r_17_278_23,0.9,0,23,23,76
72,r_146_165_111,seq218,r_115_207_51,r_146_165_111,0.88,1,112,111,76
9,r_82_234_27,r_177_268_160,seq19,r_82_234_27,0.98,0,27,27,76
4,r_279_135_119,r_141_194_154,r_93_110_39,r_141_194_154,0.93,-35,119,154,76
78,r_176_182_89,seq274,r_8_0_5,r_176_182_89,0.99,1,90,89,76
0,r_197_4_74,r_97_244_120,r_261_202_80,r_197_4_74,1.0,0,74,74,76
29,r_215_63_59,r_196_131_81,seq15,r_215_63_59,1.0,0,59,59,76
73,r_77_237_136,r_124_87_179,r_189_296_136,r_77_237_136,0.93,0,136,136,76
11,r_156_127_186,r_27_6_172,r_104_204_91,r_104_204_91,1.0,11,102,91,76
99,r_27_6_172,r_281_290_49,seq144,r_27_6_172,0.77,1,173,172,76
86,r_26_228_34,r_206_106_153,seq31,r_26_228_34,1.0,0,34,34,76
15,r_297_120_149,seq37,r_50_235_8,r_50_235_8,0.8,146,154,8,76
48,r_104_204_91,seq233,r_156_127_186,r_104_204_91,1.0,0,91,91,76
30,r_281_290_49,seq155,r_27_6_172,r_281_290_49,0.98,3,52,49,76
6,r_177_268_160,r_172_7_48,r_266_246_162,r_172_7_48,0.5,112,160,48,76
62,r_195_119_126,seq232,seq52,r_195_119_126,0.9,0,126,126,76
169,seq214,r_197_4_74,r_17_278_23,r_197_4_74,0.82,-30,44,74,76
99,r_27_6_172,r_156_127_186,r_281_290_49,r_281_290_49,1.0,11,60,49,76
134,seq116,r_92_81_147,r_200_2_48,r_200_2_48,1.0,39,87,48,76
27,r_261_202_80,seq282,seq51,r_261_202_80,0.9,13,93,80,76
30,r_281_290_49,r_27_6_172,r_177_268_160,r_27_6_172,0.7,1,173,172,76
87,r_181_162_90,seq52,seq18,r_181_162_90,0.99,0,90,90,76
2,r_38_88_176,seq240,r_84_55_27,r_38_88_176,0.72,0,176,176,76
47,r_196_131_81,r_172_7_48,r_104_204_91,r_104_204_91,0.85,2,93,91,76
74,r_169_188_187,seq193,r_156_127_186,r_169_188_187,0.38,0,187,187,76
18,r_66_150_161,r_91_46_176,seq240,r_66_150_161,0.62,0,161,161,76
24,r_105_187_84,seq140,r_211_76_34,r_105_187_84,1.0,0,84,84,76
177,seq233,r_68_90_134,r_91_46_176,r_68_90_134,0.65,0,134,134,76
63,r_295_275_186,r_211_76_34,r_124_87_179,r_211_76_34,1.0,0,34,34,76
33,r_85_241_96,r_272_175_191,seq260,r_85_241_96,1.0,0,96,96,76
48,r_104_204_91,r_156_127_186,r_177_268_160,r_156_127_186,0.86,0,186,186,76
13,r_39_111_40,seq163,seq220,r_39_111_40,1.0,0,40,40,76
152,seq164,r_245_122_98,r_5_179_8,r_245_122_98,1.0,-44,54,98,76
88,r_285_80_105,seq233,r_247_185_94,r_285_80_105,1.0,1,106,105,76
103,seq18,r_200_2_48,seq174,r_200_2_48,1.0,0,48,48,76
50,r_141_194_154,seq89,seq260,r_141_194_154,0.85,0,154,154,76
81,r_93_110_39,seq152,seq180,r_93_110_39,1.0,0,39,39,76
70,r_14_257_37,r_48_43_120,seq180,r_14_257_37,0.82,8,45,37,76
61,r_96_138_137,seq184,r_94_53_122,r_96_138_137,0.68,1,138,137,76
32,r_65_171_132,seq25,r_181_162_90,r_65_171_132,1.0,1,133,132,76
77,r_58_98_85,r_236_292_116,seq250,r_58_98_85,1.0,0,85,85,76
60,r_20_269_25,r_297_120_149,seq254,r_20_269_25,1.0,0,25,25,76
39,r_211_76_34,r_295_275_186,seq62,r_211_76_34,1.0,0,34,34,76
49,r_1_255_50,r_176_182_89,seq121,r_1_255_50,1.0,0,50,50,76
59,r_84_55_27,r_252_263_185,seq102,r_84_55_27,1.0,0,27,27,76
188,seq262,r_206_106_153,seq112,r_206_106_153,0.83,-106,47,153,76
63,r_295_275_186,r_124_87_179,r_197_4_74,r_197_4_74,0.89,113,187,74,76
98,r_91_46_176,seq24,r_137_294_114,r_91_46_176,0.91,0,176,176,76
123,seq70,seq155,r_137_294_114,r_137_294_114,0.78,-3,111,114,76
22,r_252_263_185,seq52,seq233,r_252_263_185,0.32,0,185,185,76
91,r_100_205_141,r_13_136_140,r_277_221_130,r_100_205_141,0.84,-1,140,141,76
192,seq273,seq79,r_36_42_72,r_36_42_72,0.99,102,174,72,76
20,r_133_75_31,r_83_9_32,seq240,r_133_75_31,1.0,0,31,31,76
89,r_117_299_44,r_48_43_120,seq116,r_117_299_44,1.0,0,44,44,76
7,r_97_244_120,r_217_148_142,r_8_0_5,r_97_244_120,1.0,0,120,120,76
57,r_223_123_35,r_92_81_147,seq125,r_223_123_35,0.53,4,39,35,76
94,r_8_0_5,r_36_42_72,seq33,r_36_42_72,1.0,0,72,72,76
189,seq265,r_108_287_127,r_115_207_51,r_108_287_127,0.8,0,127,127,76
186,seq259,seq184,r_108_287_127,r_108_287_127,0.98,24,151,127,76
79,r_94_53_122,seq167,r_14_257_37,r_94_53_122,0.99,0,122,122,76
35,r_159_28_66,r_91_46_176,r_84_55_27,r_159_28_66,1.0,1,67,66,76
12,r_206_106_153,seq262,r_73_192_106,r_206_106_153,0.9,0,153,153,76
30,r_124_136_159,r_261_268_162,r_201_266_52,r_124_136_159,0.7,1,160,159,77
126,seq75,r_132_32_39,r_15_253_154,r_132_32_39,0.37,115,154,39,77
51,r_243_204_99,seq294,seq19,r_243_204_99,0.99,0,99,99,77
92,r_296_26_68,r_241_229_190,r_7_213_19,r_296_26_68,0.98,0,68,68,77
14,r_71_183_162,seq217,r_114_59_153,r_71_183_162,0.54,0,162,162,77
8,r_15_253_154,seq185,seq75,r_15_253_154,0.83,1,155,154,77
91,r_288_73_20,r_241_229_190,seq33,r_288_73_20,0.97,0,20,20,77
53,r_173_220_65,seq33,r_25_41_183,r_173_220_65,1.0,1,66,65,77
187,seq256,r_230_283_190,r_93_146_21,r_93_146_21,0.89,20,41,21,77
81,r_276_267_32,r_149_219_90,seq84,r_276_267_32,1.0,0,32,32,77
35,r_29_50_20,r_242_273_17,seq251,r_29_50_20,0.99,0,20,20,77
37,r_62_287_164,seq100,r_114_59_153,r_62_287_164,0.68,0,164,164,77
59,r_144_274_173,r_196_244_183,r_77_231_7,r_77_231_7,0.89,167,174,7,77
86,r_208_151_123,seq18,r_201_266_52,r_208_151_123,0.9,1,124,123,77
16,r_278_165_137,seq13,r_85_122_7,r_278_165_137,0.92,0,137,137,77
21,r_135_110_76,seq133,seq207,r_135_110_76,1.0,1,77,76,77
97,r_103_282_164,seq105,r_37_72_10,r_37_72_10,0.38,154,164,10,77
143,seq121,seq158,r_181_263_160,r_181_263_160,0.72,18,178,160,77
9,r_148_115_31,r_181_263_160,r_6_119_2,r_148_115_31,1.0,0,31,31,77
10,r_51_195_18,r_7_213_19,seq129,r_51_195_18,0.81,0,18,18,77
80,r_172_79_82,r_71_183_162,seq36,r_172_79_82,1.0,0,82,82,77
61,r_132_32_39,r_53_153_192,seq75,r_132_32_39,0.99,1,40,39,77
69,r_236_163_128,r_22_81_163,r_199_4_89,r_236_163_128,0.98,0,128,128,77
45,r_0_255_61,seq87,seq142,r_0_255_61,1.0,0,61,61,77
39,r_201_266_52,r_114_59_153,seq21,r_201_266_52,0.96,2,54,52,77
193,seq271,seq162,r_161_225_48,r_161_225_48,1.0,31,79,48,77
19,r_55_120_159,seq60,seq13,r_55_120_159,0.84,1,160,159,77
88,r_248_111_27,r_144_274_173,seq48,r_248_111_27,1.0,0,27,27,77
95,r_211_92_145,seq84,seq11,r_211_92_145,0.58,2,147,145,77
78,r_192_280_28,r_261_268_162,r_9_238_83,r_192_280_28,0.73,113,141,28,77
83,r_53_153_192,seq179,r_155_275_34,r_155_275_34,1.0,23,57,34,77
31,r_285_166_197,r_16_141_107,r_42_245_89,r_285_166_197,1.0,-90,107,197,77
41,r_85_122_7,r_77_231_7,r_278_165_137,r_278_165_137,0.98,7,144,137,77
67,r_127_113_70,r_211_92_145,seq157,r_127_113_70,1.0,1,71,70,77
3,r_242_273_17,r_209_279_164,seq210,r_209_279_164,0.99,-68,96,164,77
90,r_235_101_146,seq160,seq14,r_235_101_146,0.88,0,146,146,77
0,r_182_10_30,seq75,seq100,r_182_10_30,0.99,0,30,30,77
93,r_63_24_26,seq45,r_52_281_22,r_52_281_22,0.67,9,31,22,77
113,seq36,r_237_193_173,r_172_79_82,r_172_79_82,1.0,91,173,82,77
26,r_37_72_10,r_42_245_89,r_123_125_80,r_37_72_10,0.67,80,90,10,77
6,r_109_65_58,seq210,seq158,r_109_65_58,0.98,0,58,58,77
1,r_93_146_21,r_152_290_48,seq256,r_93_146_21,0.52,6,27,21,77
4,r_189_175_71,r_270_254_162,r_152_290_48,r_270_254_162,1.0,-91,71,162,77
18,r_152_290_48,seq140,r_285_166_197,r_152_290_48,1.0,4,52,48,77
73,r_16_141_107,r_260_30_122,r_25_41_183,r_16_141_107,0.98,0,107,107,77
11,r_209_279_164,r_242_273_17,seq68,r_209_279_164,0.87,0,164,164,77
107,seq19,r_43_89_168,r_243_204_99,r_243_204_99,1.0,70,169,99,77
76,r_299_176_34,seq34,seq105,r_299_176_34,1.0,0,34,34,77
13,r_181_263_160,r_237_193_173,seq121,r_237_193_173,0.57,-13,160,173,77
163,seq185,r_15_253_154,seq133,r_15_253_154,0.87,1,155,154,77
98,r_80_108_176,r_199_4_89,r_201_266_52,r_199_4_89,0.85,0,89,89,77
62,r_293_35_35,r_236_163_128,seq49,r_293_35_35,1.0,0,35,35,77
15,r_261_268_162,r_124_136_159,seq97,r_261_268_162,0.65,-2,160,162,77
48,r_25_41_183,seq147,r_173_220_65,r_173_220_65,1.0,66,131,65,77
61,r_132_32_39,seq75,r_149_219_90,r_149_219_90,1.0,4,94,90,77
2,r_114_59_153,r_29_50_20,r_257_286_15,r_114_59_153,0.94,0,153,153,77
99,r_130_39_127,r_237_193_173,seq112,r_130_39_127,0.9,1,128,127,77
78,r_192_280_28,r_201_266_52,r_261_268_162,r_192_280_28,0.98,0,28,28,77
58,r_128_180_37,seq150,seq20,r_128_180_37,1.0,0,37,37,77
134,seq94,r_102_88_183,r_139_186_131,r_139_186_131,0.82,19,150,131,77
27,r_118_61_65,seq13,seq157,r_118_61_65,1.0,0,65,65,77
42,r_99_156_14,r_261_268_162,seq295,r_99_156_14,0.96,-1,13,14,77
87,r_47_91_174,r_241_229_190,seq133,r_47_91_174,0.71,2,176,174,77
162,seq179,r_53_153_192,r_155_275_34,r_155_275_34,1.0,46,80,34,77
12,r_52_281_22,seq188,r_63_24_26,r_52_281_22,0.98,0,22,22,77
47,r_270_254_162,seq126,r_114_59_153,r_270_254_162,0.49,0,162,162,77
40,r_43_89_168,seq19,r_209_279_164,r_209_279_164,0.59,5,169,164,77
29,r_246_284_73,r_242_273_17,seq147,r_246_284_73,1.0,0,73,73,77
157,seq164,r_252_2_108,seq97,r_252_2_108,1.0,0,108,108,77
24,r_260_30_122,seq142,seq13,r_260_30_122,1.0,0,122,122,77
25,r_230_283_190,seq256,r_189_175_71,r_189_175_71,1.0,119,190,71,77
20,r_161_225_48,seq70,seq162,r_161_225_48,1.0,2,50,48,77
33,r_178_38_120,r_242_273_17,seq160,r_178_38_120,0.98,2,122,120,77
64,r_28_76_88,seq190,r_77_231_7,r_28_76_88,0.98,4,92,88,77
28,r_137_104_10,seq251,seq126,r_137_104_10,0.84,0,10,10,77
50,r_237_193_173,seq36,r_278_165_137,r_237_193_173,0.54,0,173,173,77
70,r_12_145_107,seq157,r_51_195_18,r_12_145_107,0.8,1,108,107,77
65,r_42_245_89,r_37_72_10,r_152_290_48,r_42_245_89,0.86,1,90,89,77
32,r_199_4_89,r_80_108_176,seq112,r_199_4_89,1.0,0,89,89,77
38,r_240_214_97,seq20,r_189_175_71,r_240_214_97,0.98,0,97,97,77
77,r_252_2_108,seq164,seq57,r_252_2_108,1.0,0,108,108,77
2,r_114_59_153,r_201_266_52,r_29_50_20,r_114_59_153,0.95,-99,54,153,77
34,r_265_216_135,r_196_244_183,r_0_255_61,r_265_216_135,0.68,0,135,135,77
46,r_159_107_48,r_103_282_164,r_138_226_46,r_159_107_48,1.0,2,50,48,77
36,r_138_226_46,r_143_56_115,r_297_95_3,r_138_226_46,1.0,1,47,46,77
75,r_222_46_111,r_230_283_190,r_201_266_52,r_222_46_111,0.89,5,116,111,77
43,r_272_98_108,seq133,r_135_110_76,r_272_98_108,0.94,0,108,108,77
17,r_9_238_83,seq207,r_192_280_28,r_192_280_28,0.83,56,84,28,77
173,seq207,r_9_238_83,r_135_110_76,r_135_110_76,1.0,8,84,76,77
94,r_221_187_141,r_47_91_174,r_201_266_52,r_221_187_141,0.75,0,141,141,77
89,r_44_174_11,r_51_195_18,r_297_95_3,r_44_174_11,0.96,0,11,11,77
43,r_272_98_108,r_236_163_128,r_55_120_159,r_272_98_108,0.5,-68,40,108,77
96,r_196_244_183,seq83,r_242_273_17,r_196_244_183,0.39,0,183,183,77
98,r_80_108_176,r_201_266_52,r_55_120_159,r_80_108_176,0.48,1,177,176,77
133,seq90,r_270_254_162,seq94,r_270_254_162,0.42,-101,61,162,77
49,r_7_213_19,r_200_40_198,seq150,r_7_213_19,1.0,0,19,19,77
43,r_272_98_108,r_55_120_159,seq133,r_55_120_159,0.51,-83,76,159,77
7,r_102_88_183,seq94,r_189_175_71,r_189_175_71,1.0,112,183,71,77
18,r_152_290_48,r_285_166_197,r_240_214_97,r_240_214_97,1.0,47,144,97,77
23,r_143_56_115,seq233,r_257_286_15,r_143_56_115,0.99,-9,106,115,77
151,seq150,r_128_180_37,r_7_213_19,r_128_180_37,0.5,0,37,37,77
5,r_171_131_49,r_149_219_90,r_182_10_30,r_171_131_49,1.0,0,49,49,77
189,seq259,r_241_229_190,r_155_275_34,r_155_275_34,0.94,156,190,34,77
71,r_5_250_19,r_240_214_97,r_99_156_14,r_5_250_19,1.0,0,19,19,77
82,r_123_125_80,r_80_108_176,r_37_72_10,r_123_125_80,0.96,0,80,80,77
74,r_257_286_15,r_182_10_30,seq247,r_257_286_15,1.0,0,15,15,77
79,r_139_186_131,seq8,seq94,r_139_186_131,0.85,2,133,131,77
55,r_155_275_34,r_9_238_83,r_53_153_192,r_155_275_34,1.0,0,34,34,77
93,r_242_117_74,r_232_132_178,seq1,r_242_117_74,1.0,0,74,74,78
23,r_121_93_38,r_154_74_169,seq156,r_121_93_38,0.96,0,38,38,78
92,r_264_89_98,r_30_58_151,r_81_142_13,r_264_89_98,0.56,0,98,98,78
82,r_70_75_182,r_130_152_55,r_213_229_20,r_70_75_182,0.95,0,182,182,78
14,r_185_250_141,seq294,r_39_4_49,r_39_4_49,0.99,92,141,49,78
151,seq158,r_134_6_141,r_186_172_44,r_186_172_44,0.76,100,144,44,78
53,r_47_293_117,seq256,seq55,r_47_293_117,0.99,0,117,117,78
43,r_125_163_59,r_280_145_102,seq224,r_125_163_59,0.99,1,60,59,78
81,r_177_28_54,seq90,r_186_172_44,r_177_28_54,1.0,1,55,54,78
54,r_123_7_73,r_136_114_189,seq170,r_123_7_73,1.0,0,73,73,78
83,r_12_184_141,r_175_292_165,r_95_295_110,r_95_295_110,0.92,31,141,110,78
37,r_180_243_127,seq127,seq77,r_180_243_127,1.0,0,127,127,78
3,r_68_106_21,seq285,r_57_183_102,r_57_183_102,1.0,12,114,102,78
3,r_68_106_21,r_27_48_177,seq285,r_68_106_21,0.85,1,22,21,78
71,r_54_195_158,seq1,r_111_215_123,r_111_215_123,0.74,40,163,123,78
86,r_27_48_177,seq1,r_68_106_21,r_68_106_21,0.65,157,178,21,78
21,r_20_282_157,seq197,seq241,r_20_282_157,0.63,0,157,157,78
97,r_18_85_181,seq179,r_185_250_141,r_18_85_181,0.71,0,181,181,78
5,r_29_86_127,r_129_245_191,seq288,r_29_86_127,1.0,0,127,127,78
80,r_141_133_144,seq181,r_111_215_123,r_111_215_123,1.0,23,146,123,78
68,r_203_137_28,seq168,seq233,r_203_137_28,0.91,2,30,28,78
69,r_201_252_149,seq42,seq94,r_201_252_149,0.85,2,151,149,78
153,seq162,seq62,r_144_76_120,r_144_76_120,1.0,4,124,120,78
95,r_192_258_180,seq127,r_130_152_55,r_130_152_55,0.62,126,181,55,78
66,r_266_99_153,seq46,r_185_250_141,r_266_99_153,0.89,0,153,153,78
76,r_103_101_100,seq224,seq181,r_103_101_100,1.0,2,102,100,78
36,r_200_16_43,r_20_282_157,seq127,r_200_16_43,0.99,1,44,43,78
41,r_3_298_155,r_21_221_186,r_63_283_2,r_3_298_155,0.67,0,155,155,78
149,seq156,seq33,r_121_93_38,r_121_93_38,0.9,-3,35,38,78
89,r_228_176_84,r_270_249_106,r_213_229_20,r_228_176_84,0.95,0,84,84,78
28,r_160_5_39,r_130_152_55,seq25,r_160_5_39,1.0,0,39,39,78
10,r_205_164_102,seq116,r_105_61_59,r_205_164_102,1.0,0,102,102,78
16,r_110_236_35,r_261_100_190,r_96_198_58,r_110_236_35,1.0,1,36,35,78
26,r_204_65_81,seq173,r_31_265_10,r_204_65_81,1.0,1,82,81,78
72,r_95_295_110,r_196_212_140,r_32_124_193,r_32_124_193,0.73,-87,106,193,78
61,r_216_38_38,r_20_282_157,seq1,r_216_38_38,0.94,0,38,38,78
0,r_219_284_117,seq88,seq157,r_219_284_117,0.64,0,117,117,78
73,r_87_165_117,r_21_221_186,r_275_190_153,r_87_165_117,1.0,0,117,117,78
11,r_270_249_106,r_180_243_127,seq33,r_270_249_106,0.89,1,107,106,78
107,seq33,seq113,r_270_249_106,r_270_249_106,1.0,8,114,106,78
13,r_202_92_104,r_13_281_127,seq188,r_13_281_127,1.0,-22,105,127,78
84,r_186_172_44,seq233,seq158,r_186_172_44,1.0,0,44,44,78
15,r_280_145_102,r_111_215_123,seq194,r_280_145_102,0.72,0,102,102,78
48,r_97_235_84,seq253,seq11,r_97_235_84,1.0,0,84,84,78
57,r_193_131_123,r_255_199_49,r_174_67_42,r_193_131_123,0.87,0,123,123,78
62,r_107_66_116,r_21_221_186,seq168,r_107_66_116,0.81,4,120,116,78
85,r_246_59_91,r_70_75_182,r_267_238_199,r_246_59_91,1.0,0,91,91,78
99,r_196_212_140,seq224,r_63_283_2,r_196_212_140,0.52,2,142,140,78
160,seq181,r_141_133_144,r_103_101_100,r_103_101_100,1.0,17,117,100,78
52,r_130_152_55,r_57_183_102,seq42,r_130_152_55,0.84,3,58,55,78
161,seq182,seq269,r_105_61_59,r_105_61_59,1.0,3,62,59,78
136,seq116,seq44,r_275_190_153,r_275_190_153,0.66,8,161,153,78
2,r_30_58_151,seq277,r_103_101_100,r_30_58_151,0.88,0,151,151,78
47,r_210_296_103,r_18_85_181,r_161_43_22,r_210_296_103,1.0,0,103,103,78
87,r_262_51_39,r_21_221_186,seq88,r_262_51_39,1.0,0,39,39,78
126,seq80,r_270_249_106,r_191_274_60,r_191_274_60,0.98,4,64,60,78
74,r_57_183_102,seq260,r_68_106_21,r_57_183_102,1.0,2,104,102,78
29,r_111_215_123,seq233,r_81_142_13,r_111_215_123,1.0,0,123,123,78
157,seq170,r_30_58_151,r_123_7_73,r_123_7_73,0.77,1,74,73,78
25,r_19_273_145,seq1,r_63_283_2,r_63_283_2,0.76,143,145,2,78
70,r_278_64_173,r_36_211_75,r_63_283_2,r_36_211_75,0.68,98,173,75,78
82,r_70_75_182,seq62,r_130_152_55,r_70_75_182,0.49,-22,160,182,78
88,r_150_53_129,r_30_58_151,r_96_198_58,r_30_58_151,0.47,-22,129,151,78
50,r_26_84_126,seq90,r_68_106_21,r_26_84_126,0.78,0,126,126,78
58,r_191_274_60,r_232_132_178,seq80,r_191_274_60,1.0,0,60,60,78
70,r_278_64_173,r_276_189_158,r_36_211_75,r_36_211_75,1.0,22,97,75,78
44,r_187_143_29,r_160_5_39,seq224,r_187_143_29,0.95,1,30,29,78
106,seq25,r_202_92_104,r_160_5_39,r_160_5_39,1.0,4,43,39,78
32,r_105_61_59,r_276_189_158,seq182,r_105_61_59,1.0,1,60,59,78
38,r_36_211_75,seq17,seq230,r_36_211_75,1.0,0,75,75,78
34,r_232_132_178,r_96_198_58,r_271_244_184,r_232_132_178,0.57,0,178,178,78
75,r_134_6_141,seq158,r_214_209_1,r_134_6_141,0.59,3,144,141,78
31,r_10_248_44,r_196_212_140,seq50,r_10_248_44,0.93,1,45,44,78
17,r_276_189_158,r_278_64_173,r_185_250_141,r_276_189_158,0.65,0,158,158,78
18,r_161_43_22,r_97_235_84,seq167,r_161_43_22,0.97,-1,21,22,78
96,r_297_72_130,r_278_64_173,r_203_137_28,r_297_72_130,0.87,6,136,130,78
22,r_129_245_191,r_29_86_127,r_111_215_123,r_129_245_191,1.0,-64,127,191,78
91,r_175_292_165,seq34,r_82_257_128,r_82_257_128,1.0,38,166,128,78
140,seq128,r_15_112_170,seq120,r_15_112_170,0.97,4,174,170,78
56,r_290_231_78,r_21_221_186,seq291,r_290_231_78,0.94,2,80,78,78
185,seq256,r_47_293_117,seq120,r_47_293_117,1.0,0,117,117,78
82,r_70_75_182,r_246_59_91,seq62,r_246_59_91,1.0,0,91,91,78
24,r_108_119_34,seq170,seq135,r_108_119_34,0.77,13,47,34,78
55,r_39_4_49,r_130_152_55,seq41,r_39_4_49,1.0,0,49,49,78
35,r_146_2_153,seq109,seq71,r_146_2_153,0.97,0,153,153,78
30,r_113_18_100,seq133,seq6,r_113_18_100,1.0,0,100,100,79
60,r_280_223_63,r_253_254_118,r_208_299_74,r_253_254_118,0.66,-7,111,118,79
36,r_209_15_21,r_16_42_129,r_12_99_87,r_209_15_21,0.55,108,129,21,79
69,r_217_35_21,seq90,seq54,r_217_35_21,0.98,0,21,21,79
17,r_190_263_54,seq74,seq206,r_190_263_54,0.8,3,57,54,79
14,r_262_64_120,seq176,r_208_299_74,r_262_64_120,0.91,0,120,120,79
43,r_82_226_162,seq207,r_266_43_56,r_266_43_56,0.99,106,162,56,79
54,r_187_157_182,seq150,r_265_62_83,r_265_62_83,1.0,99,182,83,79
83,r_33_277_64,seq58,seq90,r_33_277_64,1.0,0,64,64,79
55,r_65_155_96,r_183_268_131,seq34,r_65_155_96,1.0,0,96,96,79
16,r_71_130_84,seq137,seq205,r_71_130_84,1.0,0,84,84,79
39,r_214_92_103,r_202_60_135,seq28,r_214_92_103,1.0,1,104,103,79
1,r_246_124_148,seq75,r_81_281_86,r_246_124_148,0.6,0,148,148,79
97,r_240_215_160,seq166,r_109_242_155,r_240_215_160,0.81,0,160,160,79
5,r_278_131_163,seq111,r_169_95_87,r_278_131_163,0.68,2,165,163,79
42,r_161_126_60,r_129_228_165,seq128,r_161_126_60,1.0,0,60,60,79
80,r_25_149_91,r_0_212_142,r_36_117_44,r_25_149_91,0.8,0,91,91,79
45,r_208_299_74,r_118_162_151,r_280_223_63,r_208_299_74,1.0,0,74,74,79
19,r_238_93_178,seq219,r_82_226_162,r_238_93_178,0.46,1,179,178,79
66,r_116_293_143,r_252_67_163,r_214_92_103,r_116_293_143,0.76,0,143,143,79
76,r_105_11_96,seq188,seq186,r_105_11_96,1.0,0,96,96,79
103,seq7,r_233_251_78,r_49_286_76,r_233_251_78,0.99,0,78,78,79
31,r_258_298_139,r_36_117_44,r_56_51_126,r_36_117_44,0.72,96,140,44,79
129,seq90,seq138,r_33_277_64,r_33_277_64,1.0,91,155,64,79
67,r_53_13_186,seq21,r_87_140_33,r_87_140_33,1.0,155,188,33,79
93,r_139_229_7,seq148,r_227_173_110,r_227_173_110,0.51,-1,109,110,79
89,r_227_173_110,seq207,r_139_229_7,r_227_173_110,0.87,3,113,110,79
3,r_279_100_67,seq269,seq38,r_279_100_67,0.99,0,67,67,79
10,r_12_99_87,r_262_64_120,seq261,r_12_99_87,0.89,3,90,87,79
90,r_70_199_150,r_187_157_182,r_164_267_48,r_187_157_182,0.82,-32,150,182,79
72,r_129_228_165,r_29_156_173,r_265_62_83,r_29_156_173,0.83,-8,165,173,79
81,r_211_23_38,r_110_163_195,seq256,r_211_23_38,1.0,0,38,38,79
4,r_183_268_131,seq138,seq21,r_183_268_131,0.95,1,132,131,79
78,r_181_248_39,seq6,seq207,r_181_248_39,1.0,0,39,39,79
73,r_56_51_126,r_109_242_155,seq138,r_56_51_126,1.0,0,126,126,79
11,r_52_37_147,seq14,r_66_27_40,r_52_37_147,0.94,0,147,147,79
20,r_284_285_108,seq34,seq204,r_284_285_108,1.0,0,108,108,79
13,r_48_78_61,seq80,seq41,r_48_78_61,1.0,0,61,61,79
98,r_282_273_148,seq138,r_190_263_54,r_282_273_148,0.47,0,148,148,79
46,r_87_140_33,r_202_60_135,r_276_79_196,r_202_60_135,1.0,-18,117,135,79
15,r_253_254_118,seq201,seq236,r_253_254_118,0.93,0,118,118,79
48,r_114_184_80,r_136_247_157,seq69,r_114_184_80,1.0,0,80,80,79
79,r_108_234_34,r_146_145_78,seq296,r_108_234_34,0.94,0,34,34,79
57,r_96_249_110,seq98,r_164_267_48,r_96_249_110,0.94,1,111,110,79
117,seq55,r_116_293_143,r_265_62_83,r_265_62_83,0.63,60,143,83,79
12,r_233_251_78,r_290_271_16,seq186,r_233_251_78,1.0,0,78,78,79
6,r_192_153_164,seq218,r_87_140_33,r_192_153_164,0.72,1,165,164,79
18,r_88_46_23,r_122_102_50,r_82_226_162,r_88_46_23,1.0,0,23,23,79
27,r_283_1_13,r_202_60_135,seq219,r_283_1_13,1.0,0,13,13,79
53,r_97_132_51,seq63,seq94,r_97_132_51,1.0,0,51,51,79
85,r_276_79_196,r_214_92_103,r_87_140_33,r_276_79_196,0.63,-125,71,196,79
12,r_233_251_78,r_44_127_81,r_290_271_16,r_290_271_16,0.81,10,26,16,79
37,r_202_60_135,r_214_92_103,r_87_140_33,r_202_60_135,0.97,-83,52,135,79
87,r_40_174_101,r_77_257_178,r_169_95_87,r_77_257_178,1.0,-77,101,178,79
2,r_151_120_141,seq213,seq188,r_151_120_141,1.0,0,141,141,79
142,seq137,r_71_130_84,seq186,r_71_130_84,1.0,0,84,84,79
93,r_139_229_7,r_202_60_135,seq148,r_139_229_7,0.33,61,68,7,79
46,r_87_140_33,r_116_293_143,r_202_60_135,r_87_140_33,0.99,0,33,33,79
50,r_290_271_16,r_167_5_30,r_233_251_78,r_290_271_16,1.0,-1,15,16,79
25,r_241_260_147,seq61,seq147,r_241_260_147,0.74,0,147,147,79
33,r_29_156_173,seq206,seq137,r_29_156_173,0.59,0,173,173,79
88,r_85_135_101,seq69,seq55,r_85_135_101,1.0,0,101,101,79
58,r_16_42_129,r_209_15_21,seq86,r_16_42_129,1.0,0,129,129,79
47,r_141_104_24,seq10,seq111,r_141_104_24,1.0,0,24,24,79
38,r_49_286_76,r_225_165_132,r_290_271_16,r_225_165_132,0.78,3,135,132,79
65,r_17_244_88,r_85_135_101,seq21,r_17_244_88,1.0,0,88,88,79
192,seq274,r_239_134_130,r_122_102_50,r_239_134_130,0.56,-11,119,130,79
68,r_252_67_163,seq55,r_91_72_80,r_252_67_163,0.95,0,163,163,79
61,r_106_57_114,r_109_242_155,r_146_145_78,r_146_145_78,0.97,77,155,78,79
32,r_225_165_132,r_44_127_81,r_49_286_76,r_44_127_81,0.71,0,81,81,79
38,r_49_286_76,seq47,r_225_165_132,r_49_286_76,0.85,2,78,76,79
52,r_169_95_87,r_258_298_139,r_121_144_19,r_169_95_87,1.0,-1,86,87,79
92,r_31_189_38,r_185_235_123,seq272,r_31_189_38,1.0,0,38,38,79
32,r_225_165_132,r_49_286_76,seq103,r_225_165_132,0.93,3,135,132,79
34,r_265_62_83,seq28,seq55,r_265_62_83,1.0,0,83,83,79
0,r_26_45_14,r_278_131_163,seq6,r_26_45_14,1.0,0,14,14,79
75,r_91_72_80,r_227_173_110,seq213,r_91_72_80,1.0,2,82,80,79
82,r_44_127_81,r_246_124_148,r_239_134_130,r_44_127_81,0.98,57,138,81,79
141,seq133,r_151_120_141,r_121_144_19,r_121_144_19,1.0,0,19,19,79
51,r_266_43_56,r_227_173_110,seq47,r_266_43_56,1.0,0,56,56,79
60,r_280_223_63,r_270_194_146,r_253_254_118,r_280_223_63,0.98,2,65,63,79
112,seq38,r_258_298_139,r_279_100_67,r_279_100_67,0.58,3,70,67,79
94,r_24_50_110,r_118_162_151,r_88_46_23,r_24_50_110,1.0,1,111,110,79
171,seq206,r_29_156_173,r_190_263_54,r_190_263_54,0.81,119,173,54,79
9,r_270_194_146,seq10,seq41,r_270_194_146,0.74,0,146,146,79
145,seq148,r_81_281_86,seq171,r_81_281_86,0.81,2,88,86,79
50,r_290_271_16,r_233_251_78,r_49_286_76,r_233_251_78,0.82,0,78,78,79
96,r_118_162_151,seq41,r_97_132_51,r_97_132_51,0.98,100,151,51,79
37,r_202_60_135,r_87_140_33,seq34,r_202_60_135,1.0,0,135,135,79
28,r_167_5_30,r_82_226_162,seq159,r_167_5_30,1.0,1,31,30,79
62,r_243_73_50,r_284_285_108,seq256,r_284_285_108,0.89,-54,54,108,79
91,r_136_247_157,seq288,r_52_37_147,r_52_37_147,0.86,11,158,147,79
35,r_66_27_40,r_208_299_74,seq101,r_66_27_40,1.0,0,40,40,79
149,seq160,r_233_251_78,r_225_165_132,r_233_251_78,0.85,0,78,78,79
7,r_230_9_188,seq86,r_29_156_173,r_29_156_173,0.58,16,189,173,79
18,r_88_46_23,r_82_226_162,r_24_50_110,r_24_50_110,0.91,30,140,110,79
44,r_77_257_178,r_230_9_188,r_113_18_100,r_113_18_100,0.47,79,179,100,79
118,seq58,r_33_277_64,seq296,r_33_277_64,1.0,0,64,64,79
131,seq98,r_96_249_110,seq41,r_96_249_110,1.0,-20,90,110,79
71,r_122_102_50,seq200,seq255,r_122_102_50,0.91,0,50,50,79
82,r_44_127_81,r_225_165_132,r_246_124_148,r_44_127_81,0.96,0,81,81,79
101,seq4,r_0_212_142,seq261,r_0_212_142,0.99,0,142,142,79
183,seq236,seq180,r_253_254_118,r_253_254_118,0.98,22,140,118,79
56,r_195_83_17,r_12_99_87,seq125,r_195_83_17,0.97,0,17,17,79
84,r_109_242_155,r_106_57_114,seq61,r_109_242_155,0.82,0,155,155,79
93,r_198_10_94,r_202_139_128,r_120_56_44,r_202_139_128,0.9,-34,94,128,80
30,r_123_61_166,r_202_139_128,r_289_224_67,r_123_61_166,0.91,-61,105,166,80
51,r_235_117_91,r_30_148_103,seq172,r_30_148_103,0.92,-12,91,103,80
36,r_25_50_138,seq284,r_280_249_59,r_280_249_59,1.0,79,138,59,80
92,r_289_224_67,r_223_268_88,seq104,r_223_268_88,0.54,-20,68,88,80
29,r_278_165_46,r_272_15_129,r_196_174_186,r_278_165_46,0.88,0,46,46,80
8,r_280_249_59,seq293,seq104,r_280_249_59,1.0,1,60,59,80
53,r_133_181_136,seq95,r_92_40_172,r_133_181_136,0.93,1,137,136,80
54,r_290_19_111,seq114,seq87,r_290_19_111,1.0,0,111,111,80
61,r_272_15_129,r_278_165_46,r_115_169_44,r_272_15_129,0.48,-83,46,129,80
37,r_185_68_70,seq128,seq73,r_185_68_70,1.0,0,70,70,80
59,r_37_137_73,r_92_40_172,seq8,r_37_137_73,0.99,0,73,73,80
31,r_31_291_15,r_235_117_91,seq95,r_31_291_15,0.89,0,15,15,80
55,r_51_42_89,r_223_268_88,seq47,r_51_42_89,1.0,1,90,89,80
16,r_86_190_58,r_57_109_63,r_161_256_44,r_161_256_44,0.99,14,58,44,80
86,r_296_252_182,r_71_105_184,r_231_197_76,r_231_197_76,1.0,106,182,76,80
39,r_212_288_72,seq79,seq17,r_212_288_72,1.0,0,72,72,80
14,r_120_56_44,r_167_219_144,seq116,r_120_56_44,1.0,0,44,44,80
165,seq193,r_60_282_175,r_202_139_128,r_202_139_128,0.9,-1,127,128,80
104,seq9,seq187,r_81_121_35,r_81_121_35,0.99,51,86,35,80
46,r_125_4_108,r_167_219_144,seq227,r_125_4_108,0.91,2,110,108,80
2,r_80_269_127,r_205_106_16,r_223_268_88,r_80_269_127,0.51,2,129,127,80
96,r_7_220_32,r_94_62_63,r_141_159_159,r_94_62_63,0.84,-31,32,63,80
87,r_233_279_48,r_133_181_136,r_103_142_26,r_233_279_48,0.74,3,51,48,80
88,r_57_109_63,r_102_112_123,r_164_72_78,r_102_112_123,1.0,0,123,123,80
69,r_94_62_63,r_184_158_108,r_54_110_59,r_94_62_63,1.0,0,63,63,80
45,r_239_298_176,seq180,r_179_52_4,r_239_298_176,0.61,1,177,176,80
21,r_163_44_32,r_43_255_46,seq236,r_163_44_32,0.99,0,32,32,80
19,r_245_166_114,seq3,seq172,r_245_166_114,0.89,1,115,114,80
83,r_205_106_16,r_43_255_46,seq191,r_205_106_16,0.89,0,16,16,80
95,r_59_5_44,r_226_49_190,seq6,r_59_5_44,1.0,0,44,44,80
78,r_102_112_123,r_57_109_63,seq87,r_102_112_123,1.0,0,123,123,80
76,r_21_285_187,r_226_49_190,r_89_276_134,r_89_276_134,0.87,53,187,134,80
100,seq2,r_22_254_108,r_210_34_6,r_22_254_108,0.99,0,108,108,80
97,r_115_169_44,r_272_15_129,r_25_50_138,r_272_15_129,0.56,6,135,129,80
41,r_266_131_64,seq75,seq206,r_266_131_64,0.98,0,64,64,80
89,r_64_171_83,seq297,r_207_175_72,r_64_171_83,0.93,1,84,83,80
96,r_7_220_32,r_141_159_159,seq79,r_141_159_159,0.62,0,159,159,80
3,r_70_221_66,r_80_269_127,seq13,r_70_221_66,1.0,0,66,66,80
115,seq47,r_74_253_172,r_51_42_89,r_51_42_89,1.0,85,174,89,80
26,r_275_14_147,seq176,r_241_35_47,r_241_35_47,0.99,105,152,47,80
4,r_108_173_127,r_214_36_77,seq213,r_214_36_77,1.0,0,77,77,80
78,r_102_112_123,r_239_298_176,r_57_109_63,r_57_109_63,1.0,0,63,63,80
1,r_242_177_16,r_92_40_172,seq12,r_242_177_16,1.0,0,16,16,80
20,r_207_175_72,r_80_269_127,r_233_279_48,r_207_175_72,0.64,3,75,72,80
13,r_24_107_197,r_208_283_150,r_149_135_36,r_24_107_197,0.86,-46,151,197,80
25,r_54_110_59,seq111,seq146,r_54_110_59,1.0,0,59,59,80
67,r_161_256_44,seq297,r_86_190_58,r_86_190_58,0.99,1,59,58,80
15,r_38_267_182,seq260,r_11_189_117,r_11_189_117,0.72,65,182,117,80
48,r_143_154_106,r_27_39_180,seq172,r_143_154_106,1.0,0,106,106,80
57,r_129_53_66,r_237_126_128,r_261_240_195,r_129_53_66,0.87,0,66,66,80
6,r_92_40_172,seq127,r_185_68_70,r_185_68_70,1.0,106,176,70,80
62,r_214_36_77,r_108_173_127,seq88,r_214_36_77,1.0,0,77,77,80
113,seq41,r_239_298_176,r_241_35_47,r_241_35_47,0.93,5,52,47,80
85,r_292_162_65,r_122_209_124,seq186,r_122_209_124,0.96,-55,69,124,80
99,r_124_248_111,seq145,r_113_246_4,r_124_248_111,1.0,0,111,111,80
94,r_103_142_26,seq116,seq270,r_103_142_26,0.99,0,26,26,80
27,r_164_72_78,r_125_4_108,r_57_109_63,r_57_109_63,0.85,27,90,63,80
4,r_108_173_127,seq213,r_37_137_73,r_108_173_127,1.0,0,127,127,80
136,seq100,r_226_49_190,r_244_144_149,r_244_144_149,0.86,41,190,149,80
74,r_241_35_47,r_38_267_182,seq41,r_241_35_47,1.0,0,47,47,80
30,r_123_61_166,r_289_224_67,r_207_175_72,r_123_61_166,0.73,1,167,166,80
172,seq213,r_108_173_127,r_92_40_172,r_108_173_127,1.0,0,127,127,80
80,r_147_1_15,r_133_181_136,seq258,r_133_181_136,0.53,-109,27,136,80
2,r_80_269_127,r_207_175_72,r_205_106_16,r_80_269_127,0.91,-52,75,127,80
59,r_37_137_73,seq8,r_108_173_127,r_108_173_127,1.0,14,141,127,80
40,r_208_283_150,r_24_107_197,r_280_249_59,r_280_249_59,0.85,92,151,59,80
97,r_115_169_44,seq47,r_272_15_129,r_115_169_44,0.99,0,44,44,80
18,r_202_139_128,seq69,r_122_209_124,r_202_139_128,1.0,1,129,128,80
61,r_272_15_129,r_115_169_44,seq180,r_272_15_129,0.89,-1,128,129,80
24,r_223_268_88,r_51_42_89,seq93,r_51_42_89,0.74,1,90,89,80
177,seq228,r_184_158_108,seq104,r_184_158_108,1.0,0,108,108,80
10,r_182_204_22,seq145,seq188,r_182_204_22,1.0,0,22,22,80
42,r_216_118_47,seq32,r_108_173_127,r_216_118_47,0.99,0,47,47,80
64,r_46_262_167,seq55,r_54_110_59,r_54_110_59,0.95,108,167,59,80
65,r_196_174_186,r_278_165_46,r_244_144_149,r_196_174_186,0.88,1,187,186,80
82,r_141_159_159,r_7_220_32,r_51_42_89,r_7_220_32,0.66,127,159,32,80
88,r_57_109_63,seq17,r_102_112_123,r_57_109_63,0.98,0,63,63,80
50,r_122_209_124,r_28_151_146,seq193,r_122_209_124,1.0,0,124,124,80
70,r_184_158_108,seq228,seq119,r_184_158_108,1.0,0,108,108,80
65,r_196_174_186,r_133_181_136,r_278_165_46,r_196_174_186,0.81,-59,127,186,80
68,r_76_225_79,r_60_282_175,r_147_1_15,r_76_225_79,1.0,0,79,79,80
42,r_216_118_47,r_108_173_127,seq213,r_108_173_127,1.0,1,128,127,80
137,seq101,seq116,r_30_148_103,r_30_148_103,1.0,4,107,103,80
130,seq90,r_30_148_103,seq264,r_30_148_103,1.0,0,103,103,80
32,r_97_66_79,r_92_40_172,seq284,r_97_66_79,0.99,0,79,79,80
38,r_58_130_71,seq191,r_59_5_44,r_58_130_71,1.0,0,71,71,80
52,r_299_20_67,r_46_262_167,seq84,r_299_20_67,1.0,0,67,67,80
77,r_28_151_146,r_122_209_124,seq145,r_122_209_124,0.74,0,124,124,80
34,r_231_197_76,r_183_238_193,r_157_83_66,r_231_197_76,1.0,0,76,76,80
75,r_60_282_175,seq6,r_67_294_167,r_60_282_175,0.72,1,176,175,80
132,seq93,r_296_252_182,r_80_269_127,r_80_269_127,0.86,54,181,127,80
81,r_250_199_107,r_296_252_182,r_242_177_16,r_250_199_107,0.9,4,111,107,80
17,r_261_240_195,r_85_232_129,r_129_53_66,r_129_53_66,0.66,3,69,66,80
43,r_81_121_35,r_231_197_76,seq9,r_81_121_35,0.99,0,35,35,80
5,r_96_274_41,r_266_131_64,seq156,r_96_274_41,1.0,0,41,41,80
77,r_28_151_146,seq145,r_164_72_78,r_28_151_146,0.98,0,146,146,80
29,r_278_165_46,r_196_174_186,r_27_39_180,r_278_165_46,0.26,140,186,46,80
22,r_27_39_180,seq48,r_278_165_46,r_27_39_180,0.58,0,180,180,80
72,r_286_33_54,r_244_144_149,r_81_121_35,r_286_33_54,0.98,5,59,54,80
35,r_157_83_66,r_226_49_190,r_231_197_76,r_231_197_76,0.97,10,86,76,80
28,r_22_254_108,r_140_295_156,seq84,r_22_254_108,1.0,0,108,108,80
102,seq6,r_60_282_175,r_58_130_71,r_58_130_71,1.0,105,176,71,80
91,r_89_276_134,seq13,seq128,r_89_276_134,0.93,1,135,134,80
49,r_71_105_184,r_296_252_182,seq47,r_71_105_184,0.34,1,185,184,80
194,seq273,r_102_112_123,seq211,r_102_112_123,1.0,-8,115,123,80
44,r_74_253_172,seq47,r_54_110_59,r_54_110_59,1.0,115,174,59,80
23,r_140_295_156,seq2,seq187,r_140_295_156,0.84,1,157,156,80
82,r_141_159_159,r_212_288_72,r_7_220_32,r_212_288_72,1.0,-29,43,72,80
108,seq17,seq87,r_212_288_72,r_212_288_72,1.0,8,80,72,80
186,seq258,r_25_50_138,r_76_225_79,r_76_225_79,1.0,59,138,79,80
47,r_149_135_36,r_123_61_166,r_24_107_197,r_149_135_36,1.0,2,38,36,80
79,r_67_294_167,seq160,seq26,r_67_294_167,0.51,2,169,167,80
35,r_157_83_66,seq156,r_226_49_190,r_157_83_66,0.8,0,66,66,80
12,r_11_189_117,r_60_282_175,seq228,r_11_189_117,0.9,1,118,117,80
84,r_30_148_103,seq90,seq101,r_30_148_103,0.98,0,103,103,80
128,seq87,seq17,r_102_112_123,r_102_112_123,1.0,0,123,123,80
33,r_181_139_40,r_0_88_72,seq115,r_181_139_40,0.81,5,45,40,81
30,r_96_250_187,seq32,r_135_67_31,r_135_67_31,0.76,156,187,31,81
44,r_260_254_172,seq4,seq214,r_260_254_172,0.92,0,172,172,81
51,r_146_285_181,seq64,r_240_178_138,r_146_285_181,0.51,0,181,181,81
14,r_201_8_60,r_258_63_129,seq16,r_201_8_60,1.0,0,60,60,81
8,r_110_40_168,seq51,r_182_156_157,r_110_40_168,0.81,0,168,168,81
37,r_177_202_119,seq97,r_82_133_82,r_177_202_119,1.0,0,119,119,81
59,r_295_166_124,r_65_167_156,r_258_63_129,r_295_166_124,0.99,2,126,124,81
7,r_197_249_42,r_31_56_74,seq195,r_197_249_42,1.0,0,42,42,81
55,r_22_234_78,r_69_163_153,r_248_200_66,r_22_234_78,0.74,1,79,78,81
86,r_248_200_66,r_188_246_81,seq128,r_248_200_66,0.54,0,66,66,81
16,r_131_284_166,seq23,r_198_257_22,r_131_284_166,0.45,0,166,166,81
21,r_293_27_165,seq272,r_121_280_196,r_293_27_165,0.85,1,166,165,81
39,r_99_81_74,seq195,seq20,r_99_81_74,0.92,4,78,74,81
165,seq189,seq142,r_55_173_106,r_55_173_106,0.87,23,129,106,81
1,r_39_101_87,seq11,r_201_8_60,r_201_8_60,1.0,37,97,60,81
97,r_183_194_68,r_55_173_106,seq14,r_183_194_68,0.89,2,70,68,81
46,r_210_282_145,seq50,seq245,r_210_282_145,0.89,0,145,145,81
42,r_84_29_128,seq265,seq37,r_84_29_128,0.84,0,128,128,81
111,seq23,r_144_292_140,seq28,r_144_292_140,1.0,-31,109,140,81
80,r_2_72_82,r_169_225_1,r_243_59_4,r_2_72_82,1.0,0,82,82,81
85,r_227_33_11,seq142,seq87,r_227_33_11,1.0,0,11,11,81
92,r_152_80_166,r_57_127_190,r_26_186_12,r_26_186_12,1.0,8,20,12,81
69,r_46_211_91,seq245,seq272,r_46_211_91,1.0,0,91,91,81
83,r_108_150_32,seq230,r_92_151_106,r_92_151_106,1.0,1,107,106,81
45,r_217_235_179,r_238_191_160,seq4,r_217_235_179,0.45,-15,164,179,81
19,r_24_232_149,seq265,seq23,r_24_232_149,0.66,0,149,149,81
29,r_3_290_30,r_131_284_166,seq64,r_3_290_30,1.0,0,30,30,81
66,r_89_93_123,r_66_278_195,r_90_137_13,r_89_93_123,0.98,0,123,123,81
17,r_275_274_37,r_197_249_42,seq15,r_197_249_42,0.84,-3,39,42,81
76,r_82_133_82,seq189,seq120,r_82_133_82,0.84,0,82,82,81
103,seq11,r_39_101_87,r_65_167_156,r_65_167_156,0.87,10,166,156,81
31,r_31_56_74,seq214,seq265,r_31_56_74,1.0,0,74,74,81
41,r_78_143_64,r_204_203_157,seq14,r_78_143_64,0.77,1,65,64,81
67,r_6_107_173,seq32,r_182_156_157,r_6_107_173,0.43,1,174,173,81
36,r_135_67_31,r_204_203_157,seq128,r_135_67_31,0.99,1,32,31,81
3,r_74_215_58,seq153,r_86_42_144,r_74_215_58,1.0,0,58,58,81
96,r_266_223_143,r_69_163_153,r_75_199_140,r_75_199_140,1.0,3,143,140,81
84,r_26_186_12,r_172_111_88,seq115,r_26_186_12,0.82,0,12,12,81
90,r_240_178_138,seq37,seq155,r_240_178_138,0.83,2,140,138,81
89,r_213_233_32,r_260_254_172,seq189,r_213_233_32,1.0,0,32,32,81
62,r_136_229_17,r_25_206_58,seq224,r_136_229_17,0.99,0,17,17,81
54,r_256_105_56,r_145_124_89,r_198_257_22,r_198_257_22,0.62,34,56,22,81
72,r_73_220_70,seq265,seq38,r_73_220_70,1.0,0,70,70,81
58,r_53_123_40,r_110_40_168,r_277_132_169,r_110_40_168,0.66,-125,43,168,81
12,r_192_175_51,seq15,r_3_290_30,r_192_175_51,0.97,0,51,51,81
4,r_55_173_106,seq129,seq189,r_55_173_106,0.78,1,107,106,81
63,r_18_100_164,seq34,r_24_232_149,r_24_232_149,0.56,15,164,149,81
73,r_288_125_150,seq14,r_177_202_119,r_177_202_119,1.0,36,155,119,81
20,r_267_7_147,seq279,r_76_104_127,r_267_7_147,0.5,0,147,147,81
5,r_90_137_13,r_99_81_74,seq14,r_90_137_13,1.0,1,14,13,81
13,r_187_159_119,r_293_27_165,seq13,r_187_159_119,0.92,0,119,119,81
98,r_212_109_131,r_57_127_190,seq35,r_212_109_131,0.99,0,131,131,81
48,r_258_63_129,seq87,r_295_166_124,r_258_63_129,0.57,0,129,129,81
49,r_69_163_153,seq21,r_46_211_91,r_46_211_91,0.63,62,153,91,81
95,r_160_244_28,r_192_175_51,seq51,r_192_175_51,1.0,-23,28,51,81
57,r_113_164_140,seq196,r_90_137_13,r_113_164_140,0.92,0,140,140,81
70,r_65_167_156,r_275_274_37,seq11,r_65_167_156,0.91,0,156,156,81
96,r_266_223_143,r_231_48_50,r_69_163_153,r_231_48_50,0.99,0,50,50,81
99,r_273_208_102,r_260_254_172,r_248_200_66,r_248_200_66,0.5,37,103,66,81
5,r_90_137_13,seq14,r_98_299_140,r_98_299_140,0.85,6,146,140,81
161,seq179,seq263,r_252_270_145,r_252_270_145,0.99,3,148,145,81
87,r_231_48_50,r_266_223_143,r_275_274_37,r_231_48_50,1.0,0,50,50,81
83,r_108_150_32,r_24_232_149,seq230,r_108_150_32,1.0,0,32,32,81
2,r_182_156_157,r_238_191_160,r_31_56_74,r_238_191_160,0.52,-2,158,160,81
47,r_188_246_81,r_146_285_181,seq148,r_188_246_81,1.0,0,81,81,81
126,seq64,r_146_285_181,r_192_175_51,r_192_175_51,1.0,67,118,51,81
74,r_144_292_140,r_131_284_166,r_248_200_66,r_144_292_140,0.96,0,140,140,81
18,r_92_151_106,r_210_282_145,r_108_150_32,r_92_151_106,0.9,0,106,106,81
24,r_204_203_157,seq214,r_114_103_9,r_204_203_157,0.59,-1,156,157,81
25,r_297_247_188,seq193,r_258_63_129,r_258_63_129,0.88,6,135,129,81
92,r_152_80_166,r_26_186_12,r_277_132_169,r_152_80_166,0.6,0,166,166,81
191,seq272,r_293_27_165,r_46_211_91,r_46_211_91,0.98,6,97,91,81
50,r_252_270_145,seq44,seq179,r_252_270_145,0.95,0,145,145,81
70,r_65_167_156,r_295_166_124,r_275_274_37,r_295_166_124,0.53,1,125,124,81
65,r_157_291_58,r_240_178_138,r_275_274_37,r_157_291_58,0.91,3,61,58,81
68,r_43_41_86,seq153,seq97,r_43_41_86,1.0,0,86,86,81
61,r_190_140_151,seq119,seq10,r_190_140_151,0.82,0,151,151,81
32,r_76_104_127,seq196,r_275_274_37,r_76_104_127,1.0,0,127,127,81
38,r_5_158_92,r_86_42_144,seq168,r_5_158_92,1.0,1,93,92,81
52,r_276_52_185,seq38,r_275_274_37,r_275_274_37,0.63,148,185,37,81
77,r_271_68_159,seq180,r_75_199_140,r_75_199_140,0.98,21,161,140,81
25,r_297_247_188,r_258_63_129,seq142,r_297_247_188,0.98,1,189,188,81
34,r_86_42_144,r_5_158_92,r_74_215_58,r_86_42_144,1.0,-55,89,144,81
75,r_218_102_184,seq162,seq214,r_218_102_184,0.61,0,184,184,81
124,seq51,r_110_40_168,r_160_244_28,r_110_40_168,0.97,0,168,168,81
60,r_165_54_78,seq13,r_201_8_60,r_165_54_78,0.7,3,81,78,81
81,r_75_199_140,r_240_178_138,r_255_9_87,r_240_178_138,0.89,2,140,138,81
171,seq214,r_204_203_157,r_172_111_88,r_172_111_88,1.0,56,144,88,81
9,r_66_278_195,r_89_93_123,r_255_9_87,r_66_278_195,0.74,-97,98,195,81
27,r_134_60_18,r_201_8_60,seq174,r_201_8_60,0.61,-32,28,60,81
22,r_145_124_89,r_190_140_151,r_108_150_32,r_190_140_151,0.79,-62,89,151,81
91,r_255_9_87,seq230,r_66_278_195,r_255_9_87,1.0,0,87,87,81
49,r_69_163_153,r_22_234_78,seq21,r_22_234_78,1.0,1,79,78,81
140,seq120,r_79_239_156,r_177_202_119,r_177_202_119,1.0,24,143,119,81
56,r_98_299_140,seq119,r_90_137_13,r_98_299_140,0.56,0,140,140,81
44,r_260_254_172,r_273_208_102,seq4,r_273_208_102,0.93,-5,97,102,81
23,r_112_58_144,seq34,r_181_139_40,r_181_139_40,0.58,109,149,40,81
189,seq265,r_24_232_149,r_31_56_74,r_31_56_74,1.0,75,149,74,81
82,r_77_264_152,seq15,r_5_158_92,r_77_264_152,0.92,0,152,152,81
79,r_85_126_125,seq118,seq122,r_85_126_125,0.44,4,129,125,81
11,r_25_206_58,r_188_246_81,seq154,r_25_206_58,1.0,0,58,58,81
35,r_49_83_87,r_146_285_181,seq115,r_49_83_87,1.0,0,87,87,81
88,r_17_261_30,r_297_247_188,seq34,r_17_261_30,1.0,0,30,30,81
30,r_59_283_136,r_168_108_1,seq43,r_59_283_136,0.93,1,137,136,82
36,r_99_199_133,seq290,r_207_11_1,r_99_199_133,0.97,0,133,133,82
159,seq190,r_227_87_34,seq98,r_227_87_34,0.98,-1,33,34,82
122,seq76,r_257_73_108,seq151,r_257_73_108,0.99,0,108,108,82
23,r_249_69_28,r_106_107_89,seq273,r_249_69_28,0.98,0,28,28,82
8,r_70_111_104,r_21_85_172,r_256_123_71,r_256_123_71,1.0,39,110,71,82
88,r_94_231_19,r_160_260_75,r_235_34_101,r_94_231_19,1.0,0,19,19,82
54,r_132_19_171,seq282,r_207_11_1,r_132_19_171,0.69,0,171,171,82
83,r_294_284_171,r_41_119_1,r_131_216_83,r_131_216_83,0.5,88,171,83,82
46,r_181_203_146,r_27_252_135,r_101_130_12,r_101_130_12,0.99,-1,11,12,82
26,r_285_36_47,seq221,seq93,r_285_36_47,0.99,0,47,47,82
73,r_138_220_49,seq118,seq72,r_138_220_49,0.97,2,51,49,82
55,r_223_287_109,seq240,seq172,r_223_287_109,0.72,1,110,109,82
16,r_182_38_137,r_114_222_170,seq42,r_182_38_137,0.77,0,137,137,82
21,r_160_260_75,r_261_113_107,seq269,r_160_260_75,1.0,0,75,75,82
39,r_235_34_101,seq273,r_257_73_108,r_257_73_108,1.0,17,125,108,82
97,r_154_39_122,r_262_268_189,r_256_123_71,r_154_39_122,1.0,0,122,122,82
42,r_193_128_163,r_264_142_184,r_295_152_98,r_193_128_163,0.62,0,163,163,82
6,r_4_286_44,r_2_127_87,seq112,r_4_286_44,1.0,0,44,44,82
80,r_77_97_115,r_124_15_138,seq218,r_77_97_115,0.53,0,115,115,82
88,r_94_231_19,r_235_34_101,r_32_121_158,r_32_121_158,0.97,-2,156,158,82
32,r_261_113_107,r_237_66_36,seq202,r_261_113_107,0.99,3,110,107,82
69,r_146_244_81,seq240,seq55,r_146_244_81,1.0,0,81,81,82
45,r_183_18_122,seq82,seq75,r_183_18_122,0.95,0,122,122,82
78,r_32_121_158,r_217_37_46,r_27_252_135,r_217_37_46,0.69,-3,43,46,82
19,r_52_296_129,seq43,seq76,r_52_296_129,0.52,37,166,129,82
32,r_261_113_107,r_160_260_75,r_237_66_36,r_237_66_36,0.99,-1,35,36,82
34,r_61_29_27,r_117_178_111,seq214,r_61_29_27,1.0,0,27,27,82
53,r_101_130_12,r_183_18_122,r_181_203_146,r_101_130_12,0.99,0,12,12,82
66,r_161_297_115,seq122,r_101_130_12,r_161_297_115,0.91,0,115,115,82
78,r_32_121_158,r_27_252_135,r_0_67_70,r_32_121_158,0.87,-30,128,158,82
76,r_0_67_70,seq40,r_32_121_158,r_0_67_70,1.0,0,70,70,82
31,r_257_73_108,seq76,r_235_34_101,r_257_73_108,1.0,0,108,108,82
87,r_191_280_51,r_23_158_6,r_105_24_121,r_191_280_51,0.82,3,54,51,82
14,r_137_255_26,r_149_275_89,seq171,r_137_255_26,1.0,0,26,26,82
89,r_5_281_139,seq279,r_295_152_98,r_295_152_98,0.55,47,145,98,82
3,r_117_178_111,r_232_169_180,r_1_278_6,r_117_178_111,0.99,0,111,111,82
10,r_106_107_89,r_182_38_137,r_160_260_75,r_182_38_137,0.75,-48,89,137,82
90,r_12_86_166,seq147,seq76,r_12_86_166,0.82,0,166,166,82
95,r_225_186_58,r_219_239_166,seq272,r_225_186_58,0.97,1,59,58,82
115,seq50,r_168_108_1,r_246_116_54,r_246_116_54,1.0,0,54,54,82
5,r_198_14_18,seq20,seq122,r_198_14_18,0.92,-1,17,18,82
154,seq175,r_21_85_172,r_3_57_62,r_3_57_62,0.76,-10,52,62,82
198,seq293,seq171,r_137_255_26,r_137_255_26,1.0,41,67,26,82
4,r_212_125_109,seq273,r_61_29_27,r_61_29_27,0.8,82,109,27,82
13,r_270_31_140,seq180,r_0_67_70,r_270_31_140,0.98,0,140,140,82
98,r_96_9_154,r_262_268_189,seq293,r_96_9_154,0.95,0,154,154,82
38,r_187_45_55,r_270_31_140,r_274_48_196,r_187_45_55,0.92,-4,51,55,82
46,r_181_203_146,r_101_130_12,r_256_123_71,r_181_203_146,0.95,0,146,146,82
15,r_21_85_172,seq175,r_78_206_92,r_78_206_92,0.98,87,179,92,82
48,r_124_15_138,seq7,seq174,r_124_15_138,0.85,0,138,138,82
57,r_120_200_128,seq25,r_56_153_54,r_120_200_128,0.62,9,137,128,82
187,seq272,r_194_159_156,r_2_127_87,r_2_127_87,1.0,1,88,87,82
50,r_13_141_57,seq112,seq134,r_13_141_57,0.77,0,57,57,82
85,r_248_30_159,r_155_247_175,seq148,r_155_247_175,0.87,2,177,175,82
99,r_109_16_174,seq218,seq76,r_109_16_174,0.53,0,174,174,82
122,seq76,seq151,r_109_16_174,r_109_16_174,1.0,-1,173,174,82
53,r_101_130_12,r_181_203_146,r_71_208_108,r_101_130_12,1.0,134,146,12,82
136,seq112,r_13_141_57,r_4_286_44,r_4_286_44,1.0,1,45,44,82
47,r_224_164_156,r_65_196_4,r_207_11_1,r_224_164_156,0.51,0,156,156,82
74,r_192_157_177,seq241,r_63_165_177,r_192_157_177,0.56,0,177,177,82
29,r_264_142_184,r_207_11_1,seq271,r_207_11_1,0.66,183,184,1,82
24,r_188_259_72,seq126,seq110,r_188_259_72,0.97,-1,71,72,82
92,r_250_10_49,r_26_84_123,r_56_153_54,r_250_10_49,1.0,0,49,49,82
25,r_295_152_98,seq229,seq140,r_295_152_98,1.0,0,98,98,82
33,r_78_206_92,seq148,seq134,r_78_206_92,1.0,0,92,92,82
127,seq91,r_27_252_135,seq103,r_27_252_135,1.0,6,141,135,82
64,r_232_169_180,seq221,r_207_11_1,r_232_169_180,0.41,0,180,180,82
58,r_262_268_189,r_96_9_154,r_183_18_122,r_262_268_189,0.94,-35,154,189,82
70,r_80_83_112,seq17,r_256_123_71,r_80_83_112,1.0,0,112,112,82
65,r_256_123_71,r_78_206_92,r_3_57_62,r_3_57_62,0.65,9,71,62,82
37,r_104_167_54,r_21_85_172,seq20,r_104_167_54,0.77,0,54,54,82
68,r_26_84_123,seq214,seq175,r_26_84_123,0.83,0,123,123,82
63,r_237_66_36,seq215,r_261_113_107,r_237_66_36,1.0,-1,35,36,82
61,r_2_127_87,seq173,seq272,r_2_127_87,1.0,0,87,87,82
52,r_155_247_175,r_248_30_159,r_63_165_177,r_155_247_175,0.54,2,177,175,82
93,r_236_197_54,seq263,seq72,r_236_197_54,0.99,0,54,54,82
77,r_131_216_83,r_51_46_199,r_145_177_78,r_131_216_83,1.0,0,83,83,82
76,r_0_67_70,r_32_121_158,r_270_31_140,r_0_67_70,0.69,88,158,70,82
18,r_217_37_46,r_32_121_158,seq40,r_217_37_46,0.97,0,46,46,82
75,r_62_266_134,r_262_268_189,seq162,r_62_266_134,0.89,0,134,134,82
60,r_71_208_108,seq273,r_101_130_12,r_71_208_108,0.97,1,109,108,82
81,r_145_177_78,r_261_113_107,seq81,r_145_177_78,0.82,1,79,78,82
9,r_179_195_124,r_109_16_174,r_156_163_8,r_179_195_124,0.77,1,125,124,82
63,r_237_66_36,r_261_113_107,r_56_153_54,r_261_113_107,0.95,3,110,107,82
79,r_201_133_46,r_26_84_123,r_114_222_170,r_201_133_46,1.0,0,46,46,82
96,r_3_57_62,r_224_164_156,r_256_123_71,r_3_57_62,0.7,8,70,62,82
28,r_170_150_70,r_65_196_4,r_26_84_123,r_26_84_123,1.0,44,167,123,82
123,seq81,seq60,r_145_177_78,r_145_177_78,1.0,1,79,78,82
62,r_246_116_54,r_63_165_177,seq50,r_246_116_54,1.0,0,54,54,82
28,r_170_150_70,seq144,r_65_196_4,r_170_150_70,1.0,0,70,70,82
49,r_274_48_196,r_136_299_182,r_285_36_47,r_285_36_47,0.93,135,182,47,82
0,r_56_153_54,seq43,r_250_10_49,r_250_10_49,1.0,4,53,49,82
43,r_227_87_34,seq190,seq55,r_227_87_34,0.97,-1,33,34,82
56,r_27_252_135,seq91,r_212_125_109,r_27_252_135,0.78,0,135,135,82
185,seq269,r_219_239_166,r_160_260_75,r_160_260_75,0.79,34,109,75,82
44,r_149_275_89,r_26_84_123,seq82,r_149_275_89,1.0,0,89,89,82
94,r_23_158_6,r_191_280_51,seq276,r_191_280_51,0.62,33,84,51,82
78,r_32_121_158,r_0_67_70,r_94_231_19,r_32_121_158,0.88,0,158,158,82
109,seq40,r_0_67_70,r_115_176_103,r_0_67_70,0.97,-16,54,70,82
84,r_135_58_107,r_63_165_177,r_207_11_1,r_135_58_107,0.9,1,108,107,82
51,r_258_210_121,r_152_26_97,r_75_289_120,r_258_210_121,1.0,0,121,121,83
36,r_252_288_87,r_225_240_127,seq11,r_252_288_87,1.0,0,87,87,83
14,r_50_109_87,r_237_25_145,r_61_73_28,r_61_73_28,1.0,129,157,28,83
151,seq183,r_277_178_76,seq132,r_277_178_76,0.75,0,76,76,83
43,r_169_259_178,r_266_0_153,r_38_19_32,r_38_19_32,0.78,146,178,32,83
65,r_181_51_124,r_215_113_128,r_208_136_188,r_181_51_124,0.41,-90,34,124,83
54,r_196_74_129,seq256,r_151_275_129,r_196_74_129,0.63,0,129,129,83
83,r_269_90_75,seq91,seq76,r_269_90_75,1.0,2,77,75,83
37,r_89_110_72,r_50_109_87,seq236,r_89_110_72,1.0,0,72,72,83
26,r_262_125_195,r_282_146_191,r_253_127_15,r_253_127_15,0.81,25,40,15,83
71,r_208_136_188,seq199,r_201_115_77,r_201_115_77,1.0,111,188,77,83
86,r_10_15_110,seq32,seq268,r_10_15_110,1.0,0,110,110,83
21,r_133_263_60,r_216_77_185,seq91,r_133_263_60,1.0,1,61,60,83
39,r_202_71_113,seq290,r_184_265_25,r_202_71_113,1.0,2,115,113,83
46,r_277_178_76,seq183,r_46_135_40,r_277_178_76,0.97,0,76,76,83
33,r_134_66_59,r_284_49_107,r_182_22_9,r_134_66_59,1.0,0,59,59,83
69,r_225_240_127,r_282_146_191,r_48_227_89,r_225_240_127,0.99,0,127,127,83
151,seq183,seq132,r_48_227_89,r_48_227_89,0.95,9,98,89,83
77,r_293_20_185,r_105_57_85,r_252_288_87,r_293_20_185,0.86,0,185,185,83
66,r_98_43_115,r_58_123_89,seq149,r_98_43_115,0.98,0,115,115,83
138,seq139,seq204,r_88_155_25,r_88_155_25,1.0,6,31,25,83
76,r_52_292_72,seq14,seq203,r_52_292_72,1.0,0,72,72,83
129,seq108,r_282_146_191,r_134_66_59,r_134_66_59,1.0,59,118,59,83
89,r_166_6_93,seq278,seq140,r_166_6_93,0.99,0,93,93,83
3,r_201_115_77,r_208_136_188,r_134_66_59,r_201_115_77,0.96,1,78,77,83
10,r_95_141_71,seq140,r_133_263_60,r_95_141_71,1.0,0,71,71,83
90,r_63_114_123,seq264,seq32,r_63_114_123,1.0,1,124,123,83
72,r_237_25_145,r_50_109_87,seq107,r_50_109_87,0.64,63,150,87,83
139,seq140,r_279_54_187,r_166_6_93,r_166_6_93,1.0,13,106,93,83
174,seq230,r_279_54_187,r_65_81_103,r_65_81_103,1.0,40,143,103,83
9,r_88_155_25,r_24_238_137,seq139,r_88_155_25,1.0,0,25,25,83
4,r_75_289_120,seq268,r_258_210_121,r_75_289_120,0.98,2,122,120,83
78,r_279_54_187,seq140,seq41,r_279_54_187,0.3,0,187,187,83
0,r_33_131_130,seq271,r_28_158_108,r_33_131_130,1.0,0,130,130,83
63,r_299_243_84,r_33_131_130,seq2,r_299_243_84,0.99,0,84,84,83
20,r_226_154_120,r_266_0_153,seq53,r_226_154_120,1.0,0,120,120,83
13,r_145_291_185,seq107,r_89_110_72,r_89_110_72,1.0,113,185,72,83
98,r_193_13_71,r_28_158_108,r_92_79_23,r_193_13_71,0.51,0,71,71,83
94,r_188_111_44,r_211_172_145,r_116_159_158,r_188_111_44,1.0,0,44,44,83
48,r_137_1_108,seq32,r_88_155_25,r_137_1_108,0.89,0,108,108,83
62,r_233_147_165,r_282_146_191,r_189_64_136,r_233_147_165,0.86,0,165,165,83
85,r_39_179_113,r_189_64_136,seq264,r_39_179_113,1.0,0,113,113,83
87,r_184_265_25,seq91,r_202_71_113,r_202_71_113,1.0,3,116,113,83
8,r_38_19_32,r_28_158_108,seq294,r_38_19_32,1.0,0,32,32,83
27,r_211_172_145,seq142,seq296,r_211_172_145,0.99,0,145,145,83
59,r_205_36_36,seq171,r_148_254_197,r_205_36_36,1.0,1,37,36,83
47,r_280_187_66,r_201_115_77,seq37,r_280_187_66,1.0,0,66,66,83
59,r_205_36_36,r_148_254_197,r_295_102_11,r_148_254_197,0.75,-68,129,197,83
40,r_58_123_89,r_116_159_158,r_69_45_120,r_69_45_120,1.0,50,170,120,83
18,r_35_3_63,seq249,r_92_79_23,r_35_3_63,0.97,0,63,63,83
29,r_80_42_81,r_58_123_89,seq198,r_80_42_81,1.0,0,81,81,83
24,r_94_21_183,seq53,r_58_123_89,r_94_21_183,0.4,0,183,183,83
25,r_18_31_82,seq29,r_261_27_107,r_18_31_82,0.98,0,82,82,83
95,r_84_156_33,r_117_167_167,seq236,r_84_156_33,1.0,1,34,33,83
64,r_47_298_78,r_137_1_108,r_134_66_59,r_47_298_78,1.0,0,78,78,83
65,r_181_51_124,r_208_136_188,seq37,r_181_51_124,1.0,0,124,124,83
191,seq278,r_166_6_93,r_245_248_14,r_166_6_93,0.94,0,93,93,83
88,r_283_220_61,r_226_154_120,seq2,r_226_154_120,0.6,-49,71,120,83
190,seq276,r_24_238_137,r_295_102_11,r_24_238_137,0.99,-8,129,137,83
58,r_144_157_80,seq191,seq44,r_144_157_80,1.0,0,80,80,83
70,r_9_267_88,r_160_260_199,r_89_110_72,r_89_110_72,0.49,16,88,72,83
68,r_207_129_113,seq221,seq185,r_207_129_113,0.98,3,116,113,83
11,r_61_73_28,r_177_218_152,r_50_109_87,r_61_73_28,1.0,0,28,28,83
91,r_176_101_12,r_226_154_120,seq204,r_176_101_12,0.71,0,12,12,83
32,r_28_158_108,r_153_257_162,seq82,r_28_158_108,1.0,0,108,108,83
38,r_189_64_136,seq17,r_175_87_102,r_189_64_136,0.97,0,136,136,83
77,r_293_20_185,r_130_239_80,r_105_57_85,r_130_239_80,0.7,35,115,80,83
53,r_241_7_59,r_282_146_191,seq82,r_241_7_59,1.0,0,59,59,83
34,r_153_257_162,seq236,r_202_71_113,r_202_71_113,0.7,49,162,113,83
75,r_69_45_120,seq251,r_58_123_89,r_69_45_120,0.99,0,120,120,83
60,r_130_239_80,r_293_20_185,r_55_246_67,r_293_20_185,1.0,-98,87,185,83
42,r_253_127_15,r_88_155_25,r_262_125_195,r_253_127_15,0.99,0,15,15,83
50,r_122_164_59,r_28_158_108,seq32,r_122_164_59,0.65,0,59,59,83
17,r_284_49_107,r_65_81_103,r_28_158_108,r_65_81_103,0.76,0,103,103,83
1,r_92_79_23,r_60_118_26,seq62,r_92_79_23,0.95,0,23,23,83
96,r_255_119_80,seq198,seq297,r_255_119_80,1.0,0,80,80,83
16,r_295_102_11,r_18_31_82,seq32,r_295_102_11,0.97,0,11,11,83
22,r_105_57_85,seq198,r_56_273_46,r_56_273_46,0.97,40,86,46,83
28,r_100_59_106,r_202_71_113,r_60_118_26,r_202_71_113,0.63,-7,106,113,83
57,r_56_273_46,seq294,seq256,r_56_273_46,1.0,0,46,46,83
49,r_24_238_137,seq82,seq290,r_24_238_137,0.69,1,138,137,83
93,r_8_174_28,r_33_131_130,r_266_0_153,r_8_174_28,0.99,2,30,28,83
44,r_242_197_81,r_24_238_137,seq191,r_242_197_81,1.0,0,81,81,83
23,r_48_227_89,seq17,seq183,r_48_227_89,1.0,0,89,89,83
41,r_46_135_40,r_80_42_81,seq290,r_46_135_40,0.99,0,40,40,83
82,r_152_26_97,r_258_210_121,seq171,r_258_210_121,1.0,0,121,121,83
35,r_216_77_185,seq34,seq244,r_216_77_185,0.63,0,185,185,83
12,r_151_275_129,r_169_259_178,r_196_74_129,r_169_259_178,0.6,-49,129,178,83
87,r_184_265_25,r_88_155_25,seq91,r_184_265_25,0.95,1,26,25,83
84,r_250_231_133,seq221,r_48_227_89,r_250_231_133,0.9,0,133,133,83
128,seq107,r_145_291_185,r_65_81_103,r_65_81_103,1.0,82,185,103,83
93,r_75_141_68,r_190_36_80,seq113,r_75_141_68,1.0,2,70,68,84
111,seq33,r_103_13_117,r_28_163_85,r_103_13_117,0.92,-12,105,117,84
99,r_54_165_51,r_56_130_130,seq231,r_54_165_51,1.0,0,51,51,84
51,r_170_199_175,seq227,r_18_196_120,r_18_196_120,0.52,55,175,120,84
36,r_55_12_146,seq149,seq230,r_55_12_146,0.56,0,146,146,84
147,seq149,r_55_12_146,r_166_85_44,r_166_85_44,1.0,101,145,44,84
8,r_88_266_151,r_67_98_167,seq231,r_88_266_151,0.9,1,152,151,84
43,r_18_196_120,seq113,seq262,r_18_196_120,0.67,0,120,120,84
67,r_61_108_42,r_102_138_191,r_222_52_186,r_61_108_42,1.0,0,42,42,84
54,r_109_220_68,seq239,seq38,r_109_220_68,1.0,0,68,68,84
83,r_283_272_182,seq224,r_244_145_2,r_283_272_182,0.64,0,182,182,84
81,r_188_158_122,r_148_179_56,seq105,r_188_158_122,1.0,0,122,122,84
37,r_67_98_167,r_88_266_151,r_290_270_199,r_88_266_151,0.89,1,152,151,84
59,r_5_136_165,seq230,seq58,r_5_136_165,0.58,1,166,165,84
19,r_15_60_61,seq2,r_194_173_102,r_194_173_102,1.0,42,144,102,84
86,r_80_83_124,seq172,r_93_132_78,r_93_132_78,1.0,5,83,78,84
16,r_103_13_117,r_232_225_153,seq299,r_103_13_117,0.99,0,117,117,84
21,r_97_8_183,seq208,r_103_13_117,r_103_13_117,0.78,66,183,117,84
165,seq204,r_154_275_193,r_235_78_14,r_235_78_14,0.96,61,75,14,84
1,r_159_128_172,seq262,r_22_242_54,r_22_242_54,0.88,118,172,54,84
97,r_255_296_137,seq91,r_238_19_112,r_255_296_137,0.97,1,138,137,84
86,r_80_83_124,r_93_132_78,r_69_3_104,r_80_83_124,1.0,3,127,124,84
5,r_277_280_92,seq113,r_232_225_153,r_277_280_92,0.99,0,92,92,84
104,seq11,r_254_87_67,r_232_225_153,r_254_87_67,1.0,1,68,67,84
42,r_100_146_181,seq149,r_159_128_172,r_100_146_181,0.4,1,182,181,84
111,seq33,r_26_41_59,r_103_13_117,r_26_41_59,1.0,2,61,59,84
80,r_69_3_104,r_154_275_193,seq35,r_69_3_104,0.99,1,105,104,84
69,r_251_285_184,seq258,r_61_108_42,r_61_108_42,0.95,142,184,42,84
56,r_222_52_186,seq42,r_61_108_42,r_61_108_42,1.0,10,52,42,84
89,r_23_79_47,seq125,r_264_193_108,r_264_193_108,1.0,8,116,108,84
153,seq171,r_286_248_128,seq66,r_286_248_128,1.0,1,129,128,84
95,r_150_215_89,r_236_121_114,seq189,r_150_215_89,0.9,0,89,89,84
66,r_217_139_115,seq123,seq107,r_217_139_115,0.99,0,115,115,84
78,r_124_187_13,r_114_117_85,r_214_68_82,r_124_187_13,1.0,72,85,13,84
46,r_126_0_20,r_286_248_128,r_154_275_193,r_126_0_20,0.99,0,20,20,84
31,r_191_168_132,r_159_128_172,r_93_132_78,r_191_168_132,0.96,0,132,132,84
81,r_188_158_122,seq269,r_148_179_56,r_148_179_56,1.0,2,58,56,84
41,r_273_144_88,seq281,r_93_132_78,r_273_144_88,1.0,0,88,88,84
67,r_61_108_42,r_222_52_186,r_251_285_184,r_61_108_42,0.54,144,186,42,84
3,r_261_211_119,r_100_146_181,r_267_243_11,r_261_211_119,0.91,0,119,119,84
10,r_81_213_145,seq204,r_186_1_12,r_81_213_145,0.96,0,145,145,84
90,r_254_87_67,seq11,seq172,r_254_87_67,1.0,1,68,67,84
45,r_186_1_12,r_244_145_2,seq192,r_186_1_12,0.9,4,16,12,84
26,r_82_73_137,r_120_195_167,seq207,r_82_73_137,0.99,0,137,137,84
72,r_236_121_114,seq105,r_93_132_78,r_236_121_114,0.74,0,114,114,84
0,r_16_206_128,seq74,r_40_70_27,r_16_206_128,0.87,0,128,128,84
63,r_276_174_68,r_273_144_88,r_235_78_14,r_276_174_68,1.0,0,68,68,84
73,r_47_27_100,r_251_285_184,seq35,r_47_27_100,0.99,1,101,100,84
11,r_271_219_182,seq282,r_238_19_112,r_271_219_182,0.14,0,182,182,84
56,r_222_52_186,r_61_108_42,r_57_14_27,r_222_52_186,0.54,0,186,186,84
7,r_119_155_25,r_277_280_92,seq153,r_119_155_25,0.92,1,26,25,84
46,r_126_0_20,r_154_275_193,seq110,r_154_275_193,0.76,-23,170,193,84
15,r_175_96_170,seq20,r_226_284_157,r_175_96_170,0.43,0,170,170,84
48,r_180_274_78,seq35,seq104,r_180_274_78,1.0,-3,75,78,84
33,r_234_287_54,r_51_62_193,seq181,r_234_287_54,1.0,0,54,54,84
19,r_15_60_61,r_16_206_128,seq2,r_15_60_61,0.64,-39,22,61,84
76,r_111_151_22,seq172,r_209_43_15,r_111_151_22,1.0,0,22,22,84
55,r_267_243_11,r_102_138_191,seq160,r_267_243_11,0.86,0,11,11,84
52,r_26_41_59,r_80_83_124,r_93_132_78,r_80_83_124,0.77,3,127,124,84
27,r_49_200_112,seq32,r_59_292_86,r_59_292_86,1.0,22,108,86,84
77,r_148_179_56,seq160,seq133,r_148_179_56,1.0,0,56,56,84
79,r_72_161_9,r_6_137_144,seq74,r_6_137_144,0.99,0,144,144,84
20,r_257_201_15,seq176,r_92_218_5,r_257_201_15,0.99,0,15,15,84
39,r_129_89_56,r_109_220_68,seq221,r_129_89_56,0.55,0,56,56,84
2,r_59_292_86,seq35,seq167,r_59_292_86,1.0,0,86,86,84
142,seq133,r_188_158_122,r_148_179_56,r_148_179_56,0.71,66,122,56,84
17,r_40_70_27,r_59_292_86,r_64_25_3,r_40_70_27,1.0,0,27,27,84
40,r_39_288_146,r_88_266_151,r_119_155_25,r_39_288_146,0.39,0,146,146,84
74,r_216_162_72,r_264_193_108,r_276_174_68,r_216_162_72,0.86,0,72,72,84
18,r_143_246_100,r_159_128_172,seq4,r_143_246_100,0.94,-1,99,100,84
29,r_93_132_78,r_264_193_108,r_26_41_59,r_93_132_78,0.88,0,78,78,84
24,r_190_36_80,r_170_199_175,seq157,r_170_199_175,0.69,-80,95,175,84
25,r_77_45_96,seq10,seq152,r_77_45_96,0.67,1,97,96,84
64,r_71_53_82,r_194_173_102,seq281,r_71_53_82,1.0,0,82,82,84
88,r_286_248_128,seq171,r_186_1_12,r_286_248_128,0.93,1,129,128,84
50,r_28_163_85,r_120_195_167,seq33,r_28_163_85,0.96,2,87,85,84
58,r_214_68_82,r_55_12_146,r_124_187_13,r_214_68_82,1.0,0,82,82,84
49,r_194_173_102,r_216_162_72,r_15_60_61,r_194_173_102,1.0,0,102,102,84
61,r_114_117_85,r_49_200_112,r_64_25_3,r_114_117_85,1.0,0,85,85,84
32,r_56_130_130,seq192,seq262,r_56_130_130,0.94,2,132,130,84
38,r_264_193_108,seq265,r_23_79_47,r_264_193_108,1.0,-1,107,108,84
52,r_26_41_59,seq33,r_80_83_124,r_26_41_59,0.97,2,61,59,84
57,r_6_137_144,r_72_161_9,r_28_163_85,r_6_137_144,0.95,0,144,144,84
154,seq172,r_80_83_124,r_254_87_67,r_254_87_67,0.56,32,99,67,84
151,seq160,r_148_179_56,r_267_243_11,r_148_179_56,1.0,0,56,56,84
168,seq208,r_97_8_183,r_180_274_78,r_180_274_78,0.96,105,183,78,84
65,r_209_43_15,r_81_213_145,r_257_201_15,r_209_43_15,0.91,0,15,15,84
94,r_279_228_87,seq157,seq294,r_279_228_87,1.0,0,87,87,84
9,r_44_134_75,seq160,seq91,r_44_134_75,0.91,4,79,75,84
85,r_156_99_42,seq147,seq7,r_156_99_42,0.95,-2,40,42,84
89,r_23_79_47,r_148_179_56,seq125,r_23_79_47,0.75,4,51,47,84
22,r_238_19_112,seq263,seq269,r_238_19_112,0.99,1,113,112,84
62,r_22_242_54,r_198_46_196,seq50,r_22_242_54,1.0,0,54,54,84
49,r_194_173_102,r_71_53_82,r_216_162_72,r_194_173_102,0.65,-20,82,102,84
47,r_166_85_44,r_277_280_92,seq149,r_166_85_44,0.86,0,44,44,84
28,r_57_14_27,r_80_83_124,seq263,r_57_14_27,1.0,1,28,27,84
60,r_260_240_30,r_6_137_144,seq37,r_260_240_30,0.97,2,32,30,84
35,r_169_127_131,r_175_96_170,r_166_85_44,r_175_96_170,0.57,-38,132,170,84
12,r_237_164_60,r_26_41_59,seq122,r_237_164_60,1.0,0,60,60,84
37,r_67_98_167,r_290_270_199,r_109_220_68,r_67_98_167,0.73,1,168,167,84
78,r_124_187_13,r_57_14_27,r_114_117_85,r_114_117_85,0.99,-72,13,85,84
93,r_278_33_181,r_76_65_190,r_230_287_129,r_278_33_181,0.48,1,182,181,85
51,r_284_165_152,r_10_160_158,r_194_220_23,r_284_165_152,0.83,1,153,152,85
92,r_162_260_105,r_272_81_155,seq39,r_162_260_105,0.71,0,105,105,85
9,r_272_81_155,r_186_236_166,seq103,r_272_81_155,0.93,2,157,155,85
14,r_129_227_63,seq60,seq232,r_129_227_63,1.0,0,63,63,85
96,r_45_108_42,r_156_78_60,r_59_98_187,r_156_78_60,0.55,-14,46,60,85
8,r_261_89_101,seq281,r_31_201_109,r_31_201_109,0.94,-2,107,109,85
53,r_289_225_84,seq39,seq25,r_289_225_84,1.0,0,84,84,85
134,seq96,seq2,r_173_184_52,r_173_184_52,1.0,0,52,52,85
30,r_57_181_38,r_252_105_145,r_82_185_34,r_57_181_38,0.99,0,38,38,85
54,r_122_54_96,seq41,seq50,r_122_54_96,0.84,1,97,96,85
37,r_140_187_181,r_171_172_1,r_82_185_34,r_82_185_34,0.67,148,182,34,85
89,r_115_211_49,r_228_192_140,seq265,r_115_211_49,1.0,0,49,49,85
5,r_298_64_16,r_261_89_101,seq92,r_298_64_16,1.0,0,16,16,85
55,r_215_188_107,seq118,seq116,r_215_188_107,1.0,1,108,107,85
16,r_252_105_145,seq36,seq222,r_252_105_145,0.83,0,145,145,85
21,r_38_157_142,seq62,r_117_133_26,r_38_157_142,0.87,0,142,142,85
39,r_76_65_190,seq146,seq101,r_76_65_190,0.39,0,190,190,85
97,r_72_42_63,seq164,seq118,r_72_42_63,1.0,0,63,63,85
46,r_43_190_151,seq118,seq1,r_43_190_151,0.9,0,151,151,85
42,r_186_236_166,seq101,r_129_227_63,r_129_227_63,1.0,103,166,63,85
1,r_82_185_34,r_74_21_121,r_124_224_32,r_82_185_34,0.99,0,34,34,85
95,r_141_143_63,seq216,r_276_136_6,r_141_143_63,1.0,0,63,63,85
66,r_18_291_124,r_76_65_190,seq280,r_18_291_124,0.98,0,124,124,85
78,r_299_151_184,r_237_250_128,r_24_293_13,r_237_250_128,1.0,-54,74,128,85
76,r_128_247_98,r_61_196_94,r_82_185_34,r_82_185_34,0.58,66,100,34,85
31,r_7_266_100,seq3,seq32,r_7_266_100,0.63,1,101,100,85
41,r_275_52_178,seq66,r_268_13_148,r_275_52_178,0.65,0,178,178,85
67,r_97_210_180,seq205,r_243_16_31,r_97_210_180,0.65,2,182,180,85
3,r_58_166_114,r_252_105_145,r_24_293_13,r_58_166_114,0.99,3,117,114,85
10,r_285_138_96,r_30_149_123,seq199,r_285_138_96,0.6,1,97,96,85
90,r_268_13_148,r_272_81_155,seq146,r_268_13_148,0.88,0,148,148,85
15,r_194_220_23,seq148,seq5,r_194_220_23,1.0,0,23,23,85
26,r_111_198_101,r_12_6_187,r_71_27_67,r_111_198_101,1.0,0,101,101,85
179,seq232,r_202_153_123,r_129_227_63,r_129_227_63,0.97,60,123,63,85
96,r_45_108_42,r_59_98_187,r_11_208_79,r_11_208_79,1.0,12,91,79,85
4,r_202_153_123,seq232,r_244_209_117,r_202_153_123,0.97,0,123,123,85
0,r_19_226_91,seq265,seq204,r_19_226_91,1.0,1,92,91,85
63,r_11_208_79,seq241,r_45_108_42,r_11_208_79,1.0,0,79,79,85
11,r_9_147_124,seq100,r_68_53_134,r_68_53_134,1.0,0,134,134,85
80,r_173_184_52,r_72_42_63,r_9_147_124,r_173_184_52,1.0,0,52,52,85
20,r_68_53_134,r_12_6_187,r_9_147_124,r_68_53_134,0.95,1,135,134,85
13,r_71_27_67,r_272_81_155,r_111_198_101,r_111_198_101,0.89,6,107,101,85
98,r_279_86_64,seq290,r_269_126_9,r_279_86_64,1.0,0,64,64,85
22,r_243_16_31,r_156_78_60,seq93,r_243_16_31,1.0,1,32,31,85
48,r_17_135_189,seq232,r_230_287_129,r_230_287_129,0.67,60,189,129,85
6,r_31_201_109,seq69,r_261_89_101,r_31_201_109,0.99,0,109,109,85
62,r_59_98_187,r_45_108_42,r_71_27_67,r_71_27_67,0.63,123,190,67,85
85,r_257_191_75,seq39,r_9_147_124,r_257_191_75,1.0,0,75,75,85
1,r_82_185_34,r_124_224_32,r_156_78_60,r_156_78_60,0.96,9,69,60,85
2,r_249_77_163,r_156_78_60,r_11_208_79,r_249_77_163,0.69,0,163,163,85
99,r_67_238_71,seq127,seq281,r_67_238_71,1.0,0,71,71,85
33,r_255_35_40,r_119_44_138,seq79,r_255_35_40,0.96,0,40,40,85
151,seq145,seq216,r_113_271_42,r_113_271_42,1.0,4,46,42,85
91,r_132_182_53,seq193,seq69,r_132_182_53,0.98,1,54,53,85
181,seq245,seq2,r_173_184_52,r_173_184_52,1.0,0,52,52,85
2,r_249_77_163,r_239_15_195,r_156_78_60,r_156_78_60,1.0,1,61,60,85
74,r_10_160_158,seq60,r_38_157_142,r_10_160_158,0.86,0,158,158,85
18,r_61_196_94,r_128_247_98,seq195,r_128_247_98,0.99,2,100,98,85
27,r_233_110_31,r_61_196_94,r_144_8_3,r_233_110_31,1.0,1,32,31,85
24,r_228_192_140,seq79,r_73_28_73,r_228_192_140,0.56,0,140,140,85
25,r_244_209_117,seq40,seq195,r_244_209_117,0.91,1,118,117,85
7,r_83_207_16,r_73_28_73,seq195,r_83_207_16,1.0,0,16,16,85
34,r_213_292_18,seq161,seq214,r_213_292_18,0.99,-1,17,18,85
88,r_262_235_114,seq290,r_26_22_90,r_262_235_114,0.97,0,114,114,85
50,r_26_22_90,r_261_89_101,r_269_126_9,r_26_22_90,0.6,12,102,90,85
58,r_169_218_111,seq79,r_298_64_16,r_169_218_111,0.94,4,115,111,85
70,r_230_287_129,seq94,seq36,r_230_287_129,1.0,1,130,129,85
192,seq277,r_170_263_97,r_24_293_13,r_170_263_97,0.57,5,102,97,85
61,r_47_248_77,r_215_188_107,seq93,r_47_248_77,1.0,0,77,77,85
32,r_131_87_160,r_76_65_190,r_43_190_151,r_43_190_151,0.57,12,163,151,85
38,r_237_250_128,seq20,r_9_147_124,r_237_250_128,1.0,0,128,128,85
77,r_106_102_180,seq79,r_252_105_145,r_106_102_180,0.56,1,181,180,85
36,r_113_271_42,r_202_153_123,seq145,r_113_271_42,1.0,0,42,42,85
59,r_203_99_26,r_261_89_101,seq51,r_203_99_26,0.96,1,27,26,85
60,r_63_155_148,seq40,r_202_153_123,r_63_155_148,0.91,0,148,148,85
81,r_297_189_152,seq127,r_176_221_58,r_297_189_152,0.91,1,153,152,85
168,seq204,seq3,r_19_226_91,r_19_226_91,1.0,10,101,91,85
17,r_55_286_88,r_38_157_142,seq100,r_55_286_88,1.0,0,88,88,85
173,seq216,r_141_143_63,seq25,r_141_143_63,1.0,0,63,63,85
9,r_272_81_155,r_268_13_148,r_186_236_166,r_268_13_148,0.69,-11,137,148,85
79,r_107_90_44,seq46,seq79,r_107_90_44,1.0,2,46,44,85
28,r_170_263_97,seq277,r_45_108_42,r_170_263_97,0.89,0,97,97,85
135,seq100,r_9_147_124,r_55_286_88,r_55_286_88,1.0,46,134,88,85
49,r_73_28_73,seq177,seq94,r_73_28_73,1.0,0,73,73,85
194,seq281,r_261_89_101,r_67_238_71,r_67_238_71,1.0,31,102,71,85
68,r_176_221_58,r_239_15_195,seq154,r_176_221_58,1.0,0,58,58,85
23,r_156_78_60,r_7_266_100,r_82_185_34,r_156_78_60,1.0,0,60,60,85
65,r_24_293_13,r_83_207_16,seq3,r_24_293_13,0.68,0,13,13,85
83,r_124_224_32,r_285_138_96,r_82_185_34,r_82_185_34,0.99,1,35,34,85
35,r_12_6_187,seq85,r_202_153_123,r_202_153_123,0.59,64,187,123,85
12,r_125_0_68,r_97_210_180,seq114,r_125_0_68,1.0,1,69,68,85
86,r_117_133_26,r_82_185_34,seq197,r_117_133_26,0.73,0,26,26,85
72,r_259_180_24,r_243_16_31,seq274,r_259_180_24,0.96,0,24,24,85
84,r_74_21_121,seq93,r_7_266_100,r_74_21_121,1.0,0,121,121,85
78,r_299_151_184,r_230_287_129,r_237_250_128,r_299_151_184,0.6,-171,13,184,85
45,r_152_283_44,seq2,r_298_64_16,r_152_283_44,1.0,0,44,44,85
42,r_133_63_31,r_157_39_148,seq36,r_133_63_31,0.99,0,31,31,86
14,r_129_70_147,seq209,r_177_276_66,r_177_276_66,0.9,16,82,66,86
8,r_200_196_97,seq54,seq77,r_200_196_97,0.99,0,97,97,86
43,r_73_212_194,r_149_273_165,r_195_48_73,r_195_48_73,1.0,99,172,73,86
83,r_1_288_126,r_124_233_159,r_75_181_24,r_124_233_159,0.81,-33,126,159,86
59,r_238_38_82,r_220_156_192,r_135_61_52,r_238_38_82,0.99,0,82,82,86
55,r_29_267_146,seq54,r_262_134_142,r_262_134_142,0.94,7,149,142,86
71,r_278_65_140,seq112,r_238_38_82,r_278_65_140,0.66,1,141,140,86
21,r_51_185_196,r_286_120_142,r_88_81_100,r_88_81_100,0.55,42,142,100,86
39,r_78_158_63,r_18_264_153,seq218,r_78_158_63,1.0,0,63,63,86
1,r_236_167_79,seq119,seq42,r_236_167_79,1.0,0,79,79,86
5,r_183_60_77,seq241,seq176,r_183_60_77,0.88,2,79,77,86
29,r_197_107_31,r_177_276_66,seq84,r_197_107_31,0.91,1,32,31,86
35,r_193_59_59,r_253_69_111,r_197_107_31,r_193_59_59,1.0,0,59,59,86
69,r_270_168_65,seq49,seq131,r_270_168_65,1.0,1,66,65,86
50,r_93_159_50,r_18_264_153,r_175_160_28,r_93_159_50,1.0,0,50,50,86
56,r_297_21_17,r_251_164_80,seq35,r_297_21_17,0.68,1,18,17,86
19,r_108_53_78,r_76_146_112,seq126,r_108_53_78,1.0,0,78,78,86
66,r_262_134_142,r_62_105_187,seq85,r_262_134_142,0.98,1,143,142,86
76,r_139_6_71,seq235,seq132,r_139_6_71,1.0,0,71,71,86
67,r_17_249_20,r_253_69_111,r_291_57_1,r_17_249_20,0.83,2,22,20,86
51,r_31_182_20,r_138_141_128,seq87,r_138_141_128,0.67,-107,21,128,86
41,r_157_39_148,seq14,r_297_21_17,r_157_39_148,0.98,0,148,148,86
6,r_188_263_29,seq243,seq109,r_188_263_29,1.0,2,31,29,86
3,r_4_299_69,r_258_296_104,r_31_182_20,r_4_299_69,0.92,0,69,69,86
90,r_222_25_85,r_253_69_111,seq127,r_222_25_85,0.97,0,85,85,86
115,seq54,r_200_196_97,r_128_162_30,r_200_196_97,1.0,-17,80,97,86
26,r_204_256_122,r_62_105_187,r_210_37_56,r_204_256_122,1.0,0,122,122,86
72,r_242_10_137,r_157_39_148,r_204_256_122,r_242_10_137,0.57,0,137,137,86
14,r_129_70_147,r_177_276_66,seq112,r_129_70_147,0.99,2,149,147,86
198,seq295,r_122_232_157,seq174,r_122_232_157,0.91,0,157,157,86
4,r_177_276_66,seq87,seq66,r_177_276_66,0.97,1,67,66,86
78,r_178_99_80,r_253_69_111,seq36,r_178_99_80,0.98,0,80,80,86
0,r_40_211_150,r_122_232_157,r_252_142_70,r_40_211_150,0.54,0,150,150,86
73,r_15_22_100,seq284,r_297_21_17,r_15_22_100,0.98,0,100,100,86
31,r_128_162_30,r_124_233_159,seq54,r_128_162_30,0.97,2,32,30,86
46,r_94_285_43,seq36,seq287,r_94_285_43,0.92,0,43,43,86
20,r_23_292_77,seq72,r_20_30_75,r_23_292_77,0.63,0,77,77,86
13,r_12_91_166,r_97_271_193,r_199_275_95,r_199_275_95,1.0,72,167,95,86
163,seq189,r_104_261_93,seq226,r_104_261_93,1.0,10,103,93,86
98,r_216_214_127,r_9_147_125,r_75_181_24,r_216_214_127,0.98,0,127,127,86
15,r_76_146_112,r_282_19_29,r_33_118_4,r_76_146_112,0.97,0,112,112,86
48,r_150_117_117,r_252_142_70,r_96_180_4,r_150_117_117,1.0,2,119,117,86
97,r_291_57_1,r_138_141_128,r_17_249_20,r_17_249_20,1.0,13,33,20,86
57,r_88_81_100,seq116,seq98,r_88_81_100,0.97,0,100,100,86
62,r_217_102_20,r_23_292_77,seq116,r_217_102_20,0.94,2,22,20,86
85,r_202_191_162,seq14,r_199_275_95,r_202_191_162,0.91,0,162,162,86
99,r_175_160_28,r_47_225_196,r_93_159_50,r_93_159_50,1.0,13,63,50,86
53,r_75_181_24,r_266_110_138,r_216_214_127,r_216_214_127,0.6,11,138,127,86
172,seq219,r_9_147_125,r_55_163_68,r_55_163_68,0.56,7,75,68,86
51,r_31_182_20,seq87,r_4_299_69,r_4_299_69,1.0,14,83,69,86
87,r_104_261_93,seq189,seq83,r_104_261_93,0.85,3,96,93,86
93,r_8_224_28,r_12_91_166,seq67,r_8_224_28,0.99,0,28,28,86
9,r_135_61_52,seq203,seq235,r_135_61_52,1.0,1,53,52,86
2,r_34_205_185,seq116,r_266_110_138,r_34_205_185,0.26,-6,179,185,86
47,r_155_192_128,seq3,r_222_25_85,r_222_25_85,0.86,43,128,85,86
181,seq243,r_188_263_29,r_9_147_125,r_188_263_29,1.0,2,31,29,86
59,r_238_38_82,r_135_61_52,r_278_65_140,r_278_65_140,1.0,11,151,140,86
40,r_266_110_138,seq67,r_18_264_153,r_266_110_138,0.72,0,138,138,86
74,r_252_142_70,r_157_39_148,seq74,r_157_39_148,1.0,-44,104,148,86
18,r_173_89_145,seq109,r_197_107_31,r_173_89_145,0.88,0,145,145,86
53,r_75_181_24,seq209,r_266_110_138,r_75_181_24,0.95,1,25,24,86
25,r_111_90_182,r_282_19_29,r_200_196_97,r_200_196_97,0.97,85,182,97,86
33,r_199_275_95,r_12_91_166,seq144,r_199_275_95,1.0,0,95,95,86
64,r_166_13_153,r_122_232_157,r_236_167_79,r_236_167_79,0.82,75,154,79,86
88,r_277_269_159,r_62_105_187,r_173_89_145,r_277_269_159,0.87,0,159,159,86
190,seq274,seq67,r_75_181_24,r_75_181_24,0.95,88,112,24,86
70,r_2_5_187,seq112,r_251_164_80,r_251_164_80,0.92,108,188,80,86
68,r_7_184_107,r_155_192_128,r_183_60_77,r_7_184_107,0.69,4,111,107,86
61,r_115_100_64,r_9_147_125,seq98,r_115_100_64,1.0,0,64,64,86
38,r_251_164_80,seq131,seq243,r_251_164_80,1.0,0,80,80,86
77,r_44_228_123,seq221,seq187,r_44_228_123,1.0,1,124,123,86
34,r_56_28_92,r_2_5_187,seq187,r_56_28_92,0.84,0,92,92,86
75,r_86_171_113,r_44_228_123,r_200_196_97,r_86_171_113,0.99,0,113,113,86
81,r_45_198_82,seq116,seq209,r_45_198_82,0.91,0,82,82,86
94,r_283_16_129,seq36,seq130,r_283_16_129,0.75,3,132,129,86
121,seq72,r_23_292_77,seq49,r_23_292_77,1.0,0,77,77,86
96,r_20_30_75,seq87,seq221,r_20_30_75,1.0,0,75,75,86
133,seq106,seq221,r_9_147_125,r_9_147_125,0.92,0,125,125,86
22,r_259_71_105,seq54,r_33_118_4,r_259_71_105,1.0,0,105,105,86
102,seq14,r_202_191_162,r_238_38_82,r_238_38_82,1.0,80,162,82,86
49,r_195_48_73,seq219,r_73_212_194,r_195_48_73,1.0,0,73,73,86
7,r_9_147_125,r_272_240_186,seq106,r_9_147_125,0.9,2,127,125,86
23,r_253_69_111,r_86_171_113,r_94_285_43,r_253_69_111,1.0,0,111,111,86
175,seq230,seq119,r_177_276_66,r_177_276_66,0.9,16,82,66,86
10,r_208_80_54,r_186_229_148,seq0,r_208_80_54,0.67,-1,53,54,86
79,r_286_120_142,r_51_185_196,seq112,r_286_120_142,0.88,0,142,142,86
12,r_55_163_68,r_2_5_187,seq219,r_55_163_68,1.0,1,69,68,86
80,r_268_201_29,r_62_105_187,seq144,r_268_201_29,0.76,2,31,29,86
84,r_149_273_165,r_73_212_194,r_139_6_71,r_139_6_71,1.0,101,172,71,86
30,r_35_141_197,r_213_143_167,r_6_273_45,r_6_273_45,0.65,122,167,45,87
36,r_225_172_146,r_126_32_157,r_164_136_14,r_164_136_14,0.89,134,148,14,87
147,seq160,r_56_1_168,r_223_13_44,r_223_13_44,1.0,124,168,44,87
51,r_169_17_37,seq122,seq14,r_169_17_37,1.0,0,37,37,87
17,r_3_186_22,r_225_172_146,r_240_96_29,r_3_186_22,1.0,0,22,22,87
83,r_264_242_145,seq43,r_276_109_14,r_264_242_145,0.89,1,146,145,87
37,r_129_5_157,seq34,r_46_221_53,r_129_5_157,0.48,4,161,157,87
59,r_11_296_81,seq45,r_3_186_22,r_11_296_81,0.98,0,81,81,87
68,r_249_118_160,r_293_259_78,r_77_131_112,r_249_118_160,1.0,0,160,160,87
71,r_75_188_81,seq85,r_115_274_80,r_75_188_81,0.99,0,81,81,87
16,r_37_94_132,seq104,r_6_273_45,r_37_94_132,0.9,0,132,132,87
1,r_64_181_111,seq271,r_76_36_198,r_64_181_111,1.0,0,111,111,87
97,r_215_222_189,seq21,r_195_202_80,r_195_202_80,1.0,109,189,80,87
5,r_115_274_80,r_180_295_116,r_75_188_81,r_115_274_80,0.98,1,81,80,87
46,r_224_277_100,seq163,seq271,r_224_277_100,0.98,0,100,100,87
42,r_229_16_167,r_244_218_177,r_258_150_73,r_229_16_167,0.29,1,168,167,87
10,r_182_239_143,r_283_262_173,seq261,r_182_239_143,0.87,1,144,143,87
73,r_240_96_29,r_159_130_151,r_3_186_22,r_240_96_29,0.88,0,29,29,87
80,r_170_114_122,r_63_194_168,seq160,r_170_114_122,0.99,0,122,122,87
25,r_46_221_53,r_65_40_197,seq106,r_65_40_197,0.61,-160,37,197,87
55,r_111_266_34,r_297_31_75,seq178,r_111_266_34,1.0,2,36,34,87
45,r_284_174_72,seq193,seq261,r_284_174_72,1.0,0,72,72,87
96,r_83_22_10,r_77_131_112,seq53,r_83_22_10,0.97,1,11,10,87
34,r_84_161_26,r_89_175_182,r_294_138_117,r_84_161_26,0.98,0,26,26,87
66,r_179_237_64,seq29,seq25,r_179_237_64,1.0,0,64,64,87
3,r_223_13_44,r_168_233_157,seq160,r_223_13_44,1.0,0,44,44,87
100,seq4,seq183,r_195_202_80,r_195_202_80,1.0,0,80,80,87
184,seq268,r_244_218_177,r_75_188_81,r_75_188_81,1.0,18,99,81,87
31,r_177_196_68,seq256,seq49,r_177_196_68,1.0,1,69,68,87
41,r_148_51_94,r_78_226_88,r_102_59_115,r_148_51_94,1.0,0,94,94,87
89,r_164_136_14,seq128,r_225_172_146,r_225_172_146,0.99,6,152,146,87
64,r_168_233_157,r_6_273_45,r_52_127_26,r_168_233_157,0.73,0,157,157,87
10,r_182_239_143,r_97_62_97,r_283_262_173,r_97_62_97,1.0,0,97,97,87
90,r_201_176_106,seq285,seq165,r_201_176_106,0.6,-9,97,106,87
2,r_52_127_26,r_0_289_197,seq104,r_52_127_26,0.96,3,29,26,87
4,r_41_247_89,r_125_198_85,r_123_7_5,r_123_7_5,0.65,92,97,5,87
61,r_105_272_42,r_168_233_157,seq183,r_105_272_42,1.0,0,42,42,87
78,r_126_32_157,seq160,r_64_181_111,r_126_32_157,0.91,0,157,157,87
0,r_78_226_88,r_148_51_94,r_6_273_45,r_78_226_88,0.67,6,94,88,87
63,r_180_295_116,seq137,seq85,r_180_295_116,0.94,0,116,116,87
11,r_44_149_96,seq25,seq101,r_44_149_96,1.0,0,96,96,87
12,r_92_200_21,r_63_194_168,seq285,r_92_200_21,0.74,0,21,21,87
20,r_2_100_95,seq53,seq190,r_2_100_95,0.93,0,95,95,87
48,r_56_1_168,seq160,r_240_96_29,r_56_1_168,0.48,0,168,168,87
57,r_117_152_88,r_236_157_143,seq243,r_117_152_88,0.99,0,88,88,87
106,seq28,r_298_153_114,seq167,r_298_153_114,1.0,0,114,114,87
62,r_113_95_81,seq72,r_199_58_25,r_113_95_81,0.99,0,81,81,87
85,r_283_262_173,r_182_239_143,r_294_138_117,r_182_239_143,1.0,-40,103,143,87
99,r_119_250_128,seq279,seq254,r_119_250_128,0.95,0,128,128,87
160,seq190,r_107_211_165,r_2_100_95,r_2_100_95,0.85,69,164,95,87
6,r_6_273_45,r_24_82_126,r_92_200_21,r_6_273_45,0.98,0,45,45,87
172,seq235,r_244_218_177,r_252_9_171,r_244_218_177,0.48,0,177,177,87
47,r_298_153_114,seq28,r_6_273_45,r_298_153_114,1.0,1,115,114,87
40,r_248_19_74,r_182_239_143,seq133,r_248_19_74,1.0,0,74,74,87
74,r_107_211_165,seq190,seq39,r_107_211_165,0.48,-1,164,165,87
72,r_276_109_14,r_129_5_157,seq235,r_276_109_14,0.55,0,14,14,87
53,r_199_58_25,seq268,seq139,r_199_58_25,0.88,0,25,25,87
33,r_20_8_108,seq54,r_123_7_5,r_20_8_108,1.0,0,108,108,87
64,r_168_233_157,r_205_288_142,r_6_273_45,r_6_273_45,0.61,97,142,45,87
88,r_294_138_117,seq70,r_223_13_44,r_223_13_44,1.0,89,133,44,87
85,r_283_262_173,r_294_138_117,r_52_127_26,r_283_262_173,0.88,0,173,173,87
50,r_125_198_85,r_41_247_89,r_15_231_3,r_15_231_3,0.71,110,113,3,87
70,r_71_245_68,r_77_131_112,seq27,r_71_245_68,0.98,1,69,68,87
87,r_212_227_24,r_112_265_191,seq261,r_212_227_24,0.94,0,24,24,87
68,r_249_118_160,r_78_226_88,r_293_259_78,r_249_118_160,0.56,-57,103,160,87
130,seq101,seq147,r_44_149_96,r_44_149_96,1.0,26,122,96,87
32,r_159_130_151,seq203,seq145,r_159_130_151,0.75,1,152,151,87
77,r_48_146_158,r_66_10_158,r_64_181_111,r_64_181_111,0.8,56,167,111,87
81,r_219_23_98,r_67_208_162,r_46_221_53,r_219_23_98,0.69,-1,97,98,87
94,r_81_251_93,seq21,r_65_40_197,r_81_251_93,1.0,0,93,93,87
9,r_293_259_78,r_264_242_145,r_297_31_75,r_264_242_145,0.97,-56,89,145,87
27,r_98_230_57,seq163,seq79,r_98_230_57,1.0,0,57,57,87
28,r_77_131_112,seq14,seq34,r_77_131_112,1.0,3,115,112,87
91,r_124_26_119,seq39,r_105_272_42,r_124_26_119,1.0,0,119,119,87
49,r_195_202_80,seq261,seq4,r_195_202_80,0.99,0,80,80,87
140,seq139,r_67_208_162,r_199_58_25,r_199_58_25,0.98,81,106,25,87
194,seq286,r_0_289_197,seq156,r_0_289_197,0.53,-30,167,197,87
149,seq163,r_224_277_100,seq190,r_224_277_100,0.75,0,100,100,87
56,r_24_82_126,r_244_218_177,r_83_22_10,r_24_82_126,0.86,1,127,126,87
7,r_236_157_143,r_102_59_115,r_248_19_74,r_248_19_74,0.77,69,143,74,87
44,r_207_282_104,seq144,seq33,r_207_282_104,1.0,1,105,104,87
118,seq54,r_20_8_108,r_52_127_26,r_20_8_108,0.91,0,108,108,87
23,r_252_9_171,seq254,r_276_109_14,r_252_9_171,0.31,0,171,171,87
138,seq133,r_66_10_158,r_248_19_74,r_248_19_74,0.99,9,83,74,87
82,r_213_143_167,r_35_141_197,seq54,r_35_141_197,0.51,-30,167,197,87
79,r_60_12_121,seq104,r_293_259_78,r_60_12_121,1.0,0,121,121,87
93,r_29_83_64,r_170_49_162,seq11,r_29_83_64,1.0,0,64,64,88
30,r_122_165_182,seq166,seq198,r_122_165_182,0.48,0,182,182,88
51,r_138_107_116,seq202,r_40_70_21,r_138_107_116,1.0,0,116,116,88
26,r_268_204_44,r_14_291_61,r_72_162_3,r_268_204_44,1.0,0,44,44,88
92,r_275_244_86,r_96_61_187,r_24_243_61,r_275_244_86,1.0,0,86,86,88
14,r_109_157_166,r_106_148_28,r_161_207_132,r_161_207_132,0.92,28,160,132,88
8,r_240_6_143,seq65,seq117,r_240_6_143,0.69,0,143,143,88
53,r_14_291_61,r_182_144_88,seq60,r_14_291_61,1.0,0,61,61,88
7,r_108_153_32,r_140_53_194,r_245_119_17,r_108_153_32,1.0,-1,31,32,88
96,r_214_213_43,r_145_212_79,seq25,r_214_213_43,0.99,-1,42,43,88
25,r_230_121_141,r_164_42_72,r_120_181_33,r_164_42_72,1.0,-15,57,72,88
38,r_126_48_27,r_236_5_62,r_106_148_28,r_126_48_27,0.83,-2,25,27,88
54,r_286_150_120,seq73,seq15,r_286_150_120,0.98,0,120,120,88
83,r_32_160_139,seq105,seq199,r_32_160_139,0.92,0,139,139,88
37,r_132_229_135,seq194,r_167_267_130,r_132_229_135,0.72,1,136,135,88
78,r_2_156_144,r_294_261_70,r_59_175_17,r_2_156_144,0.9,-109,35,144,88
55,r_203_124_73,seq116,seq85,r_203_124_73,1.0,1,74,73,88
71,r_24_243_61,r_7_141_164,seq125,r_24_243_61,1.0,0,61,61,88
86,r_249_271_174,seq201,r_186_1_110,r_186_1_110,1.0,67,177,110,88
21,r_164_42_72,r_230_121_141,r_155_178_39,r_164_42_72,0.94,0,72,72,88
1,r_246_89_9,r_127_242_176,r_228_57_74,r_228_57_74,1.0,46,120,74,88
5,r_180_173_65,r_101_262_136,seq171,r_180_173_65,1.0,0,65,65,88
104,seq15,r_127_242_176,r_286_150_120,r_286_150_120,0.89,8,128,120,88
42,r_259_284_89,seq51,r_76_179_33,r_259_284_89,1.0,0,89,89,88
69,r_237_280_87,r_45_143_117,r_96_61_187,r_45_143_117,1.0,-31,86,117,88
45,r_152_115_69,r_230_121_141,seq258,r_152_115_69,0.68,-6,63,69,88
72,r_183_238_172,r_228_57_74,r_268_204_44,r_183_238_172,1.0,-125,47,172,88
193,seq279,r_227_35_178,seq112,r_227_35_178,1.0,-49,129,178,88
85,r_241_111_35,r_206_19_53,seq196,r_241_111_35,0.98,-1,34,35,88
95,r_239_139_97,seq11,r_206_19_53,r_239_139_97,0.67,0,97,97,88
78,r_2_156_144,r_59_175_17,r_206_19_53,r_2_156_144,0.96,1,145,144,88
76,r_114_128_141,seq254,seq185,r_114_128_141,1.0,0,141,141,88
184,seq255,r_64_169_117,seq134,r_64_169_117,1.0,-50,67,117,88
41,r_13_251_187,r_131_263_122,r_145_212_79,r_145_212_79,0.5,108,187,79,88
67,r_174_197_121,r_240_6_143,r_246_89_9,r_174_197_121,1.0,0,121,121,88
46,r_274_277_21,seq81,seq18,r_274_277_21,0.99,0,21,21,88
89,r_236_5_62,r_230_121_141,r_214_213_43,r_236_5_62,0.53,0,62,62,88
10,r_50_276_115,r_286_150_120,r_268_204_44,r_50_276_115,0.97,2,117,115,88
170,seq209,r_167_267_130,r_248_289_138,r_248_289_138,0.86,17,155,138,88
66,r_0_87_21,seq171,seq202,r_0_87_21,0.98,0,21,21,88
4,r_290_226_155,seq71,r_152_115_69,r_290_226_155,0.87,0,155,155,88
57,r_245_119_17,r_50_276_115,seq65,r_245_119_17,0.99,0,17,17,88
0,r_78_151_62,r_109_157_166,seq292,r_78_151_62,1.0,0,62,62,88
63,r_127_242_176,r_13_251_187,r_168_297_90,r_127_242_176,0.38,0,176,176,88
73,r_45_143_117,r_237_280_87,seq216,r_45_143_117,1.0,-1,116,117,88
20,r_43_172_139,seq46,r_24_243_61,r_24_243_61,0.67,78,139,61,88
13,r_248_289_138,seq202,r_246_89_9,r_248_289_138,0.87,0,138,138,88
98,r_283_9_62,r_227_35_178,seq39,r_283_9_62,1.0,0,62,62,88
52,r_265_79_35,r_164_42_72,seq44,r_265_79_35,0.99,0,35,35,88
94,r_120_181_33,r_140_53_194,r_268_204_44,r_268_204_44,1.0,0,44,44,88
167,seq201,r_249_271_174,r_256_38_19,r_256_38_19,0.55,158,177,19,88
6,r_90_188_154,seq92,r_16_235_95,r_90_188_154,0.53,0,154,154,88
62,r_47_33_107,r_91_104_108,seq202,r_47_33_107,0.99,0,107,107,88
11,r_40_70_21,r_78_151_62,seq3,r_40_70_21,1.0,0,21,21,88
19,r_224_102_29,r_90_188_154,seq56,r_224_102_29,0.81,0,29,29,88
99,r_222_218_97,r_64_169_117,seq295,r_222_218_97,1.0,0,97,97,88
52,r_265_79_35,seq44,r_7_141_164,r_7_141_164,0.89,2,166,164,88
87,r_59_175_17,r_2_156_144,seq299,r_2_156_144,1.0,1,145,144,88
31,r_22_260_37,r_64_169_117,seq81,r_22_260_37,0.95,0,37,37,88
27,r_16_235_95,seq71,r_58_193_47,r_16_235_95,1.0,0,95,95,88
60,r_72_162_3,r_269_205_54,r_268_204_44,r_268_204_44,0.6,10,54,44,88
39,r_155_178_39,r_203_124_73,seq67,r_155_178_39,1.0,0,39,39,88
36,r_58_193_47,r_164_42_72,seq8,r_164_42_72,0.97,-27,45,72,88
2,r_147_123_66,seq46,r_282_63_9,r_147_123_66,1.0,1,67,66,88
47,r_176_293_113,r_158_80_135,r_245_119_17,r_176_293_113,1.0,1,114,113,88
40,r_182_144_88,seq266,seq273,r_182_144_88,1.0,-1,87,88,88
74,r_7_141_164,seq299,r_265_79_35,r_7_141_164,0.83,0,164,164,88
18,r_168_297_90,r_176_293_113,seq134,r_168_297_90,1.0,0,90,90,88
29,r_186_1_110,r_248_289_138,seq217,r_186_1_110,1.0,0,110,110,88
195,seq287,seq3,r_190_99_82,r_190_99_82,1.0,18,100,82,88
157,seq171,seq66,r_180_173_65,r_180_173_65,1.0,10,75,65,88
24,r_167_267_130,seq209,r_132_229_135,r_132_229_135,0.58,6,141,135,88
87,r_59_175_17,seq221,r_2_156_144,r_59_175_17,0.99,0,17,17,88
15,r_206_19_53,seq30,seq36,r_206_19_53,1.0,0,53,53,88
80,r_269_205_54,r_228_57_74,seq30,r_269_205_54,0.83,0,54,54,88
64,r_294_261_70,r_2_156_144,seq92,r_294_261_70,0.98,1,71,70,88
88,r_95_4_166,seq125,r_50_276_115,r_95_4_166,0.91,0,166,166,88
156,seq166,r_122_165_182,seq278,r_122_165_182,0.83,0,182,182,88
50,r_135_195_133,seq202,seq98,r_135_195_133,1.0,0,133,133,88
58,r_161_207_132,seq287,r_76_179_33,r_161_207_132,1.0,0,132,132,88
70,r_131_263_122,r_191_215_114,r_68_223_111,r_131_263_122,0.98,-8,114,122,88
65,r_187_163_139,r_130_86_192,seq44,r_187_163_139,0.93,0,139,139,88
16,r_118_21_24,r_101_262_136,seq93,r_118_21_24,1.0,-1,23,24,88
32,r_145_212_79,seq52,seq299,r_145_212_79,1.0,0,79,79,88
48,r_256_38_19,r_268_204_44,seq254,r_256_38_19,1.0,0,19,19,88
77,r_68_223_111,r_240_6_143,r_131_263_122,r_68_223_111,1.0,-1,110,111,88
196,seq292,seq93,r_78_151_62,r_78_151_62,1.0,64,126,62,88
34,r_96_61_187,r_227_35_178,r_237_280_87,r_96_61_187,0.5,-101,86,187,88
75,r_190_99_82,seq266,seq287,r_190_99_82,1.0,0,82,82,88
81,r_170_49_162,r_285_137_150,r_135_195_133,r_285_137_150,0.86,12,162,150,88
17,r_228_57_74,r_183_238_172,r_246_89_9,r_228_57_74,1.0,0,74,74,88
25,r_230_121_141,r_120_181_33,r_168_297_90,r_230_121_141,0.92,0,141,141,88
9,r_101_262_136,seq55,seq56,r_101_262_136,0.56,0,136,136,88
22,r_225_219_81,seq10,seq231,r_225_219_81,1.0,0,81,81,88
100,seq3,seq287,r_40_70_21,r_40_70_21,1.0,0,21,21,88
28,r_200_136_168,seq17,seq31,r_200_136_168,0.5,0,168,168,88
49,r_149_253_94,seq18,r_206_19_53,r_149_253_94,0.99,0,94,94,88
72,r_183_238_172,r_268_204_44,seq37,r_268_204_44,0.44,128,172,44,88
56,r_191_215_114,r_131_263_122,seq202,r_191_215_114,0.97,0,114,114,88
44,r_91_104_108,seq117,seq194,r_91_104_108,0.97,0,108,108,88
138,seq92,r_90_188_154,r_294_261_70,r_294_261_70,0.94,84,154,70,88
82,r_227_35_178,seq279,r_274_277_21,r_274_277_21,0.63,157,178,21,88
186,seq258,seq66,r_152_115_69,r_152_115_69,0.83,6,75,69,88
79,r_158_80_135,seq44,r_50_276_115,r_158_80_135,0.93,1,136,135,88
12,r_64_169_117,seq255,seq234,r_64_169_117,0.99,0,117,117,88
84,r_20_12_164,seq255,r_246_89_9,r_20_12_164,0.72,0,164,164,88
199,seq299,r_7_141_164,r_145_212_79,r_145_212_79,0.96,-1,78,79,88
30,r_146_296_73,seq41,seq20,r_146_296_73,1.0,0,73,73,89
51,r_162_187_114,seq36,r_18_202_26,r_162_187_114,0.55,0,114,114,89
36,r_153_241_76,seq200,seq260,r_153_241_76,1.0,0,76,76,89
12,r_143_225_33,r_179_229_33,r_132_224_23,r_143_225_33,0.99,0,33,33,89
139,seq121,r_163_108_46,r_18_202_26,r_18_202_26,0.82,1,27,26,89
92,r_166_64_163,seq276,r_235_177_72,r_166_64_163,0.82,0,163,163,89
14,r_220_95_132,seq29,seq140,r_220_95_132,0.95,4,136,132,89
46,r_198_242_163,r_85_281_41,r_173_257_9,r_198_242_163,0.75,-141,22,163,89
43,r_154_267_128,r_77_170_45,seq182,r_154_267_128,0.78,0,128,128,89
20,r_10_262_38,r_82_60_48,seq145,r_10_262_38,0.99,1,39,38,89
146,seq145,r_70_118_84,r_40_32_27,r_70_118_84,0.62,-5,79,84,89
0,r_83_30_27,r_231_87_114,r_44_91_40,r_83_30_27,0.98,0,27,27,89
54,r_161_19_75,seq38,seq167,r_161_19_75,0.77,-6,69,75,89
175,seq237,r_190_191_5,r_292_74_130,r_292_74_130,1.0,6,136,130,89
2,r_179_229_33,r_143_225_33,seq221,r_179_229_33,1.0,0,33,33,89
39,r_66_265_129,seq41,seq26,r_66_265_129,0.97,0,129,129,89
25,r_172_80_16,seq258,r_239_75_4,r_172_80_16,0.99,0,16,16,89
6,r_17_101_44,r_44_91_40,seq200,r_17_101_44,1.0,0,44,44,89
42,r_285_35_55,r_147_126_139,seq81,r_285_35_55,0.99,0,55,55,89
80,r_86_230_113,seq213,r_57_209_79,r_86_230_113,0.94,0,113,113,89
69,r_155_11_78,r_220_95_132,seq79,r_155_11_78,1.0,0,78,78,89
45,r_96_65_137,r_119_114_138,seq111,r_96_65_137,0.9,0,137,137,89
89,r_165_280_30,seq115,r_78_130_108,r_78_130_108,1.0,3,111,108,89
19,r_137_206_172,seq45,seq258,r_137_206_172,0.58,3,175,172,89
66,r_3_218_64,r_162_187_114,r_143_225_33,r_3_218_64,0.6,-3,61,64,89
78,r_173_257_9,r_198_242_163,r_297_271_98,r_297_271_98,0.68,65,163,98,89
131,seq99,seq93,r_172_80_16,r_172_80_16,0.56,129,145,16,89
31,r_69_164_19,r_109_134_145,r_68_37_146,r_69_164_19,0.57,131,150,19,89
21,r_44_91_40,r_17_101_44,seq15,r_17_101_44,0.87,-17,27,44,89
41,r_147_126_139,seq5,seq238,r_147_126_139,0.94,0,139,139,89
67,r_42_63_1,r_8_123_149,r_139_22_147,r_42_63_1,0.66,148,149,1,89
37,r_82_60_48,seq156,seq174,r_82_60_48,1.0,0,48,48,89
3,r_297_271_98,r_298_73_163,seq116,r_297_271_98,0.94,0,98,98,89
71,r_40_32_27,r_250_181_47,seq213,r_40_32_27,0.88,0,27,27,89
90,r_34_203_98,seq152,r_190_191_5,r_34_203_98,1.0,0,98,98,89
58,r_6_53_49,seq89,r_90_46_46,r_6_53_49,1.0,0,49,49,89
113,seq41,r_66_265_129,seq192,r_66_265_129,1.0,0,129,129,89
26,r_158_196_115,r_139_22_147,seq266,r_158_196_115,0.93,0,115,115,89
72,r_97_178_139,seq125,seq27,r_97_178_139,0.8,0,139,139,89
82,r_256_269_150,r_160_253_133,r_90_46_46,r_256_269_150,0.83,1,151,150,89
35,r_148_138_17,r_47_133_134,seq290,r_148_138_17,0.97,0,17,17,89
83,r_288_103_55,r_163_108_46,seq290,r_288_103_55,1.0,0,55,55,89
84,r_270_274_29,r_23_122_19,r_3_218_64,r_23_122_19,0.5,3,22,19,89
4,r_104_1_120,seq290,seq58,r_104_1_120,1.0,0,120,120,89
63,r_13_226_117,r_90_46_46,r_124_7_14,r_13_226_117,1.0,1,118,117,89
73,r_232_293_81,r_292_74_130,seq14,r_232_293_81,1.0,0,81,81,89
11,r_235_177_72,r_220_95_132,seq260,r_235_177_72,0.52,0,72,72,89
5,r_250_181_47,seq182,seq51,r_250_181_47,1.0,0,47,47,89
13,r_9_189_81,seq197,seq51,r_9_189_81,0.51,2,83,81,89
163,seq197,r_4_246_191,r_135_201_166,r_4_246_191,0.61,-4,187,191,89
98,r_279_94_104,r_147_126_139,r_124_7_14,r_279_94_104,0.61,-43,61,104,89
56,r_77_170_45,r_154_267_128,r_16_171_161,r_77_170_45,0.87,83,128,45,89
46,r_198_242_163,r_173_257_9,r_100_217_126,r_173_257_9,0.91,154,163,9,89
15,r_277_284_71,r_199_193_81,r_148_138_17,r_277_284_71,0.94,0,71,71,89
17,r_70_118_84,r_160_253_133,r_235_177_72,r_160_253_133,1.0,0,133,133,89
57,r_47_133_134,seq79,seq221,r_47_133_134,1.0,0,134,134,89
62,r_12_141_172,seq117,r_139_22_147,r_12_141_172,0.78,0,172,172,89
185,seq258,r_2_144_1,r_137_206_172,r_137_206_172,0.85,2,174,172,89
85,r_272_282_137,seq238,r_43_131_11,r_272_282_137,0.98,0,137,137,89
65,r_292_74_130,r_232_293_81,r_132_224_23,r_292_74_130,0.69,-105,25,130,89
27,r_139_22_147,seq180,r_42_63_1,r_139_22_147,0.82,1,148,147,89
103,seq15,seq27,r_44_91_40,r_44_91_40,0.96,-13,27,40,89
64,r_163_108_46,r_288_103_55,seq152,r_288_103_55,0.88,-8,47,55,89
87,r_150_176_91,seq258,seq28,r_150_176_91,1.0,0,91,91,89
47,r_52_151_175,seq167,seq254,r_52_151_175,0.39,0,175,175,89
40,r_16_171_161,seq276,r_77_170_45,r_77_170_45,0.89,116,161,45,89
74,r_244_149_182,seq45,r_52_151_175,r_244_149_182,0.46,0,182,182,89
29,r_100_217_126,seq99,r_57_209_79,r_100_217_126,0.92,0,126,126,89
95,r_21_233_44,r_102_234_70,seq175,r_21_233_44,0.84,-1,43,44,89
65,r_292_74_130,r_132_224_23,seq237,r_292_74_130,0.99,0,130,130,89
70,r_50_204_126,r_137_206_172,seq197,r_50_204_126,0.96,0,126,126,89
68,r_68_37_146,r_139_22_147,r_69_164_19,r_69_164_19,0.89,127,146,19,89
38,r_278_71_66,r_104_1_120,seq260,r_278_71_66,1.0,0,66,66,89
34,r_57_209_79,r_298_73_163,r_285_35_55,r_285_35_55,0.84,8,63,55,89
98,r_279_94_104,r_124_7_14,seq51,r_279_94_104,0.98,0,104,104,89
132,seq107,r_286_61_122,r_23_122_19,r_286_61_122,1.0,0,122,122,89
81,r_160_253_133,seq81,r_70_118_84,r_70_118_84,1.0,0,84,84,89
17,r_70_118_84,seq145,r_160_253_133,r_70_118_84,0.95,0,84,84,89
9,r_231_87_114,seq88,r_17_101_44,r_231_87_114,0.52,0,114,114,89
96,r_252_76_122,r_198_242_163,r_9_189_81,r_252_76_122,1.0,0,122,122,89
28,r_90_46_46,r_13_226_117,r_6_53_49,r_90_46_46,0.94,3,49,46,89
86,r_33_210_191,r_10_262_38,r_132_224_23,r_33_210_191,0.55,-166,25,191,89
1,r_85_281_41,r_157_236_162,r_261_219_8,r_85_281_41,1.0,0,41,41,89
137,seq117,seq294,r_239_75_4,r_239_75_4,0.8,18,22,4,89
22,r_106_105_71,r_153_241_76,r_62_183_22,r_106_105_71,1.0,0,71,71,89
91,r_298_73_163,seq195,r_90_46_46,r_298_73_163,0.83,1,164,163,89
59,r_62_183_22,seq25,seq29,r_62_183_22,1.0,0,22,22,89
81,r_160_253_133,r_70_118_84,r_165_280_30,r_160_253_133,1.0,0,133,133,89
77,r_216_127_43,seq55,r_3_218_64,r_216_127_43,1.0,0,43,43,89
49,r_109_134_145,r_69_164_19,seq128,r_69_164_19,0.52,131,150,19,89
56,r_77_170_45,seq115,r_154_267_128,r_77_170_45,1.0,0,45,45,89
7,r_157_236_162,seq0,seq263,r_157_236_162,0.62,0,162,162,89
185,seq258,r_150_176_91,r_2_144_1,r_150_176_91,0.98,0,91,91,89
44,r_102_234_70,seq128,seq5,r_102_234_70,1.0,1,71,70,89
75,r_124_7_14,r_161_19_75,r_279_94_104,r_124_7_14,0.94,2,16,14,89
131,seq99,r_100_217_126,seq93,r_100_217_126,0.88,0,126,126,89
23,r_119_114_138,r_96_65_137,r_85_281_41,r_119_114_138,0.75,0,138,138,89
189,seq264,r_57_209_79,r_70_118_84,r_70_118_84,1.0,66,150,84,89
82,r_256_269_150,r_96_65_137,r_160_253_133,r_256_269_150,0.45,-12,138,150,89
33,r_18_202_26,r_135_201_166,seq121,r_18_202_26,1.0,0,26,26,89
75,r_124_7_14,r_279_94_104,seq41,r_279_94_104,1.0,-15,89,104,89
55,r_132_224_23,r_83_30_27,r_3_218_64,r_132_224_23,0.95,1,24,23,89
89,r_165_280_30,r_23_122_19,seq115,r_165_280_30,1.0,0,30,30,89
93,r_138_144_151,seq194,r_241_124_104,r_241_124_104,1.0,47,151,104,90
51,r_221_158_100,seq61,r_129_278_54,r_129_278_54,1.0,13,67,54,90
122,seq70,r_90_72_165,r_33_285_59,r_33_285_59,1.0,50,109,59,90
92,r_207_10_162,r_138_144_151,r_150_260_72,r_150_260_72,1.0,17,89,72,90
58,r_130_206_19,r_38_240_199,seq217,r_130_206_19,0.99,0,19,19,90
53,r_105_28_133,seq165,r_62_125_82,r_105_28_133,0.69,8,141,133,90
43,r_13_234_62,seq159,seq17,r_13_234_62,1.0,1,63,62,90
197,seq292,r_136_233_157,seq114,r_136_233_157,0.95,-25,132,157,90
54,r_152_229_173,seq149,r_16_46_7,r_152_229_173,0.4,1,174,173,90
37,r_18_180_94,r_87_167_123,r_16_46_7,r_18_180_94,1.0,1,95,94,90
59,r_267_8_76,r_56_22_195,r_232_186_32,r_267_8_76,1.0,0,76,76,90
86,r_94_126_66,r_87_167_123,r_235_174_30,r_94_126_66,0.68,1,67,66,90
21,r_45_147_50,r_20_250_155,seq114,r_20_250_155,0.52,0,155,155,90
39,r_4_134_143,seq243,r_213_53_46,r_4_134_143,0.97,2,145,143,90
97,r_142_81_84,r_111_197_110,r_68_259_78,r_142_81_84,0.96,0,84,84,90
5,r_263_177_71,seq159,r_102_117_16,r_263_177_71,1.0,0,71,71,90
104,seq19,seq218,r_263_177_71,r_263_177_71,1.0,19,90,71,90
46,r_237_77_96,seq258,r_130_206_19,r_237_77_96,1.0,1,97,96,90
42,r_62_125_82,seq41,r_192_63_69,r_62_125_82,0.92,0,82,82,90
80,r_248_284_122,seq178,seq288,r_248_284_122,0.99,3,125,122,90
98,r_44_291_59,r_101_60_193,seq165,r_44_291_59,1.0,0,59,59,90
88,r_150_260_72,r_207_10_162,r_106_162_130,r_207_10_162,0.87,0,162,162,90
77,r_213_53_46,r_256_139_102,seq208,r_213_53_46,0.59,0,46,46,90
45,r_265_299_67,r_232_186_32,seq79,r_265_299_67,1.0,0,67,67,90
1,r_33_285_59,r_246_239_169,seq85,r_33_285_59,1.0,0,59,59,90
66,r_298_182_61,seq84,r_189_71_97,r_298_182_61,1.0,2,63,61,90
73,r_92_83_22,r_152_229_173,r_111_197_110,r_92_83_22,0.98,0,22,22,90
76,r_192_63_69,r_170_27_92,seq204,r_192_63_69,0.99,0,69,69,90
184,seq247,r_140_131_137,r_95_275_87,r_95_275_87,0.79,-14,73,87,90
26,r_111_197_110,r_142_81_84,r_287_261_32,r_111_197_110,0.75,-57,53,110,90
31,r_34_15_73,seq222,r_130_206_19,r_34_15_73,1.0,0,73,73,90
41,r_20_250_155,seq114,r_45_147_50,r_20_250_155,0.53,-88,67,155,90
67,r_82_198_88,seq288,r_176_193_7,r_82_198_88,0.99,0,88,88,90
22,r_107_128_131,r_225_226_157,r_286_97_135,r_225_226_157,1.0,0,157,157,90
15,r_296_96_51,r_148_205_61,r_230_108_127,r_296_96_51,1.0,0,51,51,90
3,r_121_283_66,seq12,r_31_289_55,r_121_283_66,1.0,1,67,66,90
10,r_87_167_123,seq208,seq200,r_87_167_123,1.0,1,124,123,90
90,r_290_187_176,r_169_164_192,r_148_205_61,r_148_205_61,0.95,116,177,61,90
72,r_0_43_70,r_82_198_88,r_31_289_55,r_0_43_70,1.0,0,70,70,90
60,r_235_174_30,r_122_2_147,r_80_9_6,r_235_174_30,0.98,0,30,30,90
7,r_282_183_57,r_82_198_88,seq178,r_282_183_57,0.97,0,57,57,90
78,r_51_40_87,seq47,r_231_274_50,r_51_40_87,1.0,1,88,87,90
63,r_225_226_157,r_29_14_196,r_87_167_123,r_225_226_157,0.56,0,157,157,90
11,r_143_273_104,seq23,r_235_174_30,r_143_273_104,0.73,1,105,104,90
55,r_102_117_16,seq89,seq19,r_102_117_16,0.91,1,17,16,90
40,r_129_278_54,r_221_158_100,seq61,r_221_158_100,1.0,0,100,100,90
20,r_66_163_154,seq141,r_145_113_5,r_66_163_154,0.75,0,154,154,90
13,r_256_139_102,seq61,seq132,r_256_139_102,1.0,0,102,102,90
57,r_264_252_154,r_29_14_196,r_104_190_119,r_264_252_154,0.79,0,154,154,90
181,seq242,r_191_161_155,r_33_285_59,r_33_285_59,1.0,96,155,59,90
26,r_111_197_110,r_287_261_32,r_249_24_78,r_111_197_110,1.0,0,110,110,90
64,r_216_262_50,r_101_60_193,r_68_259_78,r_68_259_78,1.0,1,79,78,90
85,r_244_78_70,r_248_284_122,seq155,r_244_78_70,1.0,0,70,70,90
0,r_253_137_115,seq59,seq166,r_253_137_115,1.0,1,116,115,90
161,seq194,r_138_144_151,r_106_162_130,r_106_162_130,0.94,3,133,130,90
87,r_148_205_61,seq79,r_13_234_62,r_148_205_61,1.0,6,67,61,90
83,r_287_261_32,seq132,r_92_83_22,r_287_261_32,1.0,0,32,32,90
2,r_171_6_88,r_230_108_127,seq61,r_171_6_88,1.0,0,88,88,90
41,r_20_250_155,r_45_147_50,r_296_96_51,r_20_250_155,0.94,0,155,155,90
47,r_68_259_78,r_90_72_165,r_216_262_50,r_68_259_78,1.0,1,79,78,90
17,r_31_289_55,r_87_167_123,seq271,r_31_289_55,1.0,0,55,55,90
18,r_236_99_137,seq74,seq84,r_236_99_137,0.99,1,138,137,90
29,r_122_2_147,r_105_28_133,r_111_197_110,r_122_2_147,0.96,0,147,147,90
177,seq222,r_34_15_73,r_95_275_87,r_34_15_73,0.74,1,74,73,90
65,r_90_72_165,r_135_49_77,r_241_124_104,r_241_124_104,0.68,60,164,104,90
92,r_207_10_162,r_150_260_72,r_111_197_110,r_207_10_162,1.0,-1,161,162,90
88,r_150_260_72,seq212,r_207_10_162,r_150_260_72,0.98,0,72,72,90
50,r_241_124_104,seq41,seq156,r_241_124_104,0.99,0,104,104,90
65,r_90_72_165,r_68_259_78,r_135_49_77,r_68_259_78,0.98,-4,74,78,90
68,r_249_24_78,seq118,seq141,r_249_24_78,1.0,0,78,78,90
61,r_170_27_92,seq58,seq156,r_170_27_92,1.0,2,94,92,90
32,r_104_190_119,seq155,r_213_53_46,r_104_190_119,1.0,0,119,119,90
56,r_231_274_50,r_13_234_62,seq218,r_231_274_50,1.0,1,51,50,90
52,r_67_146_181,r_56_22_195,r_253_137_115,r_67_146_181,0.44,0,181,181,90
34,r_39_266_144,r_264_252_154,r_231_274_50,r_39_266_144,0.98,0,144,144,90
148,seq159,r_13_234_62,seq84,r_13_234_62,1.0,-10,52,62,90
75,r_255_119_163,seq23,r_62_125_82,r_62_125_82,0.62,81,163,82,90
150,seq165,r_122_2_147,r_44_291_59,r_44_291_59,0.89,16,75,59,90
81,r_112_110_164,seq166,r_282_183_57,r_282_183_57,1.0,109,166,57,90
94,r_169_164_192,r_290_187_176,r_140_131_137,r_169_164_192,0.57,-15,177,192,90
9,r_56_22_195,r_67_146_181,r_42_11_50,r_42_11_50,0.99,131,181,50,90
40,r_129_278_54,seq132,r_221_158_100,r_129_278_54,1.0,0,54,54,90
96,r_76_35_85,seq215,seq200,r_76_35_85,1.0,0,85,85,90
51,r_221_158_100,r_129_278_54,r_90_72_165,r_221_158_100,0.99,0,100,100,90
22,r_107_128_131,r_66_163_154,r_225_226_157,r_107_128_131,0.85,0,131,131,90
73,r_92_83_22,r_111_197_110,r_230_108_127,r_111_197_110,1.0,0,110,110,90
135,seq114,r_20_250_155,r_45_147_50,r_20_250_155,0.56,-30,125,155,90
0,r_253_137_115,r_42_11_50,seq59,r_42_11_50,1.0,1,51,50,90
44,r_57_48_72,seq19,seq141,r_57_48_72,1.0,0,72,72,90
23,r_95_275_87,r_290_187_176,seq222,r_95_275_87,0.98,-5,82,87,90
138,seq118,seq89,r_130_206_19,r_130_206_19,0.9,110,129,19,90
70,r_196_224_32,seq172,r_246_239_169,r_196_224_32,0.81,1,33,32,90
82,r_286_97_135,seq91,r_107_128_131,r_286_97_135,0.85,0,135,135,90
79,r_230_108_127,r_296_96_51,r_92_83_22,r_92_83_22,0.68,111,133,22,90
79,r_230_108_127,r_171_6_88,r_296_96_51,r_230_108_127,0.7,-39,88,127,90
35,r_246_239_169,seq41,seq26,r_246_239_169,0.45,-42,127,169,90
6,r_30_195_47,seq209,seq165,r_30_195_47,0.97,1,48,47,90
48,r_42_11_50,r_253_137_115,seq74,r_42_11_50,0.99,1,51,50,90
64,r_216_262_50,r_33_285_59,r_101_60_193,r_216_262_50,0.98,0,50,50,90
84,r_188_7_169,seq173,r_189_71_97,r_188_7_169,0.66,2,171,169,90
93,r_255_211_125,seq25,seq79,r_255_211_125,0.88,0,125,125,91
40,r_129_43_104,r_92_184_145,r_251_223_92,r_129_43_104,0.96,0,104,104,91
36,r_100_186_154,r_264_24_167,r_272_3_16,r_264_24_167,0.52,-9,158,167,91
14,r_141_267_101,r_30_136_85,r_165_11_3,r_141_267_101,0.87,0,101,101,91
75,r_191_220_54,r_261_103_53,seq167,r_191_220_54,0.9,1,55,54,91
14,r_141_267_101,seq99,r_30_136_85,r_30_136_85,0.71,1,86,85,91
53,r_235_59_145,seq1,r_276_229_2,r_235_59_145,0.94,0,145,145,91
43,r_173_208_167,seq201,seq89,r_173_208_167,0.79,2,169,167,91
83,r_92_184_145,seq162,seq69,r_92_184_145,0.73,-1,144,145,91
37,r_91_147_151,r_75_206_133,r_87_32_155,r_91_147_151,0.97,2,153,151,91
54,r_247_109_178,r_153_198_161,r_272_3_16,r_153_198_161,0.42,17,178,161,91
45,r_274_38_198,r_111_28_129,r_250_262_20,r_250_262_20,0.99,-1,19,20,91
95,r_250_262_20,r_45_252_66,r_274_38_198,r_250_262_20,1.0,-1,19,20,91
71,r_251_223_92,seq192,r_118_139_169,r_251_223_92,0.88,6,98,92,91
86,r_265_190_98,seq2,r_148_110_34,r_265_190_98,0.98,0,98,98,91
16,r_227_269_147,seq115,r_29_137_3,r_227_269_147,1.0,0,147,147,91
21,r_244_149_123,seq99,seq159,r_244_149_123,0.98,0,123,123,91
39,r_94_70_110,r_77_40_84,seq232,r_94_70_110,0.95,0,110,110,91
165,seq193,r_98_246_124,r_15_298_91,r_15_298_91,0.75,33,124,91,91
1,r_95_270_84,r_144_214_160,seq66,r_95_270_84,1.0,0,84,84,91
97,r_31_20_198,r_264_24_167,r_161_16_72,r_161_16_72,1.0,94,166,72,91
5,r_164_233_147,r_175_113_108,r_241_243_169,r_175_113_108,1.0,0,108,108,91
46,r_146_50_78,r_21_249_186,r_117_221_68,r_146_50_78,0.74,0,78,78,91
42,r_68_271_100,seq222,r_29_137_3,r_68_271_100,1.0,0,100,100,91
80,r_160_228_85,seq268,r_53_18_65,r_160_228_85,1.0,1,86,85,91
57,r_30_136_85,r_141_267_101,r_153_198_161,r_141_267_101,0.66,5,106,101,91
19,r_153_198_161,seq39,r_156_33_37,r_156_33_37,0.99,129,166,37,91
27,r_90_182_19,r_213_126_24,seq201,r_90_182_19,0.98,0,19,19,91
92,r_148_110_34,seq89,seq277,r_148_110_34,1.0,1,35,34,91
76,r_282_116_136,seq48,r_253_46_47,r_282_116_136,0.93,1,137,136,91
100,seq1,r_235_59_145,r_9_97_62,r_235_59_145,0.58,0,145,145,91
184,seq268,r_160_228_85,r_253_46_47,r_160_228_85,1.0,1,86,85,91
79,r_212_10_167,seq277,r_148_110_34,r_148_110_34,1.0,17,51,34,91
41,r_37_189_127,seq55,seq288,r_37_189_127,0.95,0,127,127,91
67,r_21_249_186,r_146_50_78,seq55,r_146_50_78,1.0,0,78,78,91
22,r_84_145_130,seq101,r_124_35_52,r_84_145_130,0.67,0,130,130,91
67,r_21_249_186,seq55,r_76_71_17,r_76_71_17,0.64,169,186,17,91
89,r_130_26_114,seq284,r_272_3_16,r_130_26_114,0.94,0,114,114,91
96,r_187_176_182,seq17,r_30_136_85,r_187_176_182,0.92,0,182,182,91
3,r_15_298_91,seq155,seq47,r_15_298_91,0.82,1,92,91,91
90,r_151_13_154,seq25,r_53_18_65,r_53_18_65,0.5,101,166,65,91
59,r_253_46_47,r_37_189_127,seq268,r_37_189_127,0.73,-79,48,127,91
130,seq80,r_45_252_66,r_272_3_16,r_272_3_16,0.83,12,28,16,91
5,r_164_233_147,r_241_243_169,r_156_33_37,r_164_233_147,1.0,1,148,147,91
109,seq25,r_134_239_106,r_124_35_52,r_124_35_52,1.0,58,110,52,91
26,r_179_254_79,seq192,seq297,r_179_254_79,1.0,0,79,79,91
72,r_73_204_176,seq142,r_276_229_2,r_276_229_2,0.56,134,136,2,91
139,seq115,r_227_269_147,r_161_16_72,r_161_16_72,0.79,75,147,72,91
170,seq217,r_240_185_120,seq181,r_240_185_120,1.0,0,120,120,91
4,r_29_137_3,r_247_109_178,r_86_157_83,r_86_157_83,0.65,2,85,83,91
78,r_161_16_72,seq63,seq115,r_161_16_72,1.0,0,72,72,91
0,r_56_242_126,seq47,r_107_209_36,r_56_242_126,0.97,0,126,126,91
63,r_83_85_103,r_84_145_130,seq39,r_84_145_130,0.53,-26,104,130,91
31,r_36_207_51,r_291_5_133,seq82,r_291_5_133,1.0,-80,53,133,91
73,r_144_214_160,seq177,r_293_88_111,r_293_88_111,1.0,49,160,111,91
20,r_218_216_167,r_295_106_172,r_272_3_16,r_218_216_167,0.17,0,167,167,91
13,r_117_221_68,r_293_88_111,seq192,r_117_221_68,1.0,3,71,68,91
48,r_123_180_91,r_291_5_133,r_108_203_58,r_123_180_91,1.0,0,91,91,91
35,r_156_33_37,r_210_258_195,seq155,r_156_33_37,1.0,0,37,37,91
57,r_30_136_85,r_129_43_104,r_141_267_101,r_30_136_85,0.91,0,85,85,91
106,seq17,r_164_233_147,r_276_229_2,r_164_233_147,0.77,0,147,147,91
167,seq199,seq292,r_12_195_97,r_12_195_97,1.0,14,111,97,91
8,r_76_71_17,r_212_10_167,seq51,r_76_71_17,0.98,0,17,17,91
6,r_125_260_117,seq89,seq278,r_125_260_117,1.0,0,117,117,91
57,r_30_136_85,r_153_198_161,r_187_176_182,r_187_176_182,0.91,1,183,182,91
85,r_196_8_181,seq6,r_111_28_129,r_111_28_129,0.65,52,181,129,91
75,r_191_220_54,seq167,r_253_46_47,r_191_220_54,0.44,38,92,54,91
136,seq99,r_244_149_123,r_15_298_91,r_244_149_123,0.77,-6,117,123,91
82,r_42_263_16,r_244_149_123,seq150,r_42_263_16,0.92,0,16,16,91
49,r_205_287_13,seq81,seq219,r_205_287_13,1.0,0,13,13,91
79,r_212_10_167,r_148_110_34,r_95_270_84,r_212_10_167,0.93,0,167,167,91
2,r_54_58_141,seq119,r_128_163_46,r_128_163_46,1.0,96,142,46,91
47,r_240_185_120,seq217,r_293_88_111,r_240_185_120,0.56,0,120,120,91
40,r_129_43_104,r_30_136_85,r_92_184_145,r_30_136_85,1.0,-13,72,85,91
25,r_111_28_129,r_91_147_151,r_90_182_19,r_111_28_129,0.56,34,163,129,91
74,r_241_243_169,r_187_176_182,r_173_208_167,r_241_243_169,0.75,0,169,169,91
18,r_295_106_172,seq138,r_168_104_55,r_295_106_172,0.74,0,172,172,91
24,r_264_24_167,r_31_20_198,r_168_104_55,r_264_24_167,0.74,0,167,167,91
87,r_60_133_17,r_174_120_1,seq74,r_60_133_17,0.97,0,17,17,91
34,r_108_203_58,r_125_260_117,seq61,r_108_203_58,0.99,0,58,58,91
25,r_111_28_129,r_274_38_198,r_91_147_151,r_111_28_129,0.47,-1,128,129,91
33,r_291_5_133,r_153_198_161,r_130_26_114,r_153_198_161,0.94,-28,133,161,91
7,r_272_3_16,r_218_216_167,seq80,r_272_3_16,0.99,0,16,16,91
50,r_259_132_85,seq172,r_213_126_24,r_259_132_85,0.98,0,85,85,91
44,r_107_209_36,seq150,r_77_40_84,r_107_209_36,1.0,0,36,36,91
68,r_188_225_167,seq74,r_124_35_52,r_124_35_52,0.94,117,169,52,91
61,r_75_206_133,r_91_147_151,r_205_287_13,r_75_206_133,0.94,1,134,133,91
32,r_175_113_108,r_164_233_147,seq177,r_175_113_108,1.0,0,108,108,91
38,r_293_88_111,r_117_221_68,seq142,r_117_221_68,0.63,3,71,68,91
77,r_9_97_62,r_291_5_133,seq1,r_291_5_133,0.96,-64,69,133,91
38,r_293_88_111,seq142,r_83_85_103,r_293_88_111,1.0,0,111,111,91
11,r_213_126_24,seq142,r_261_103_53,r_213_126_24,0.98,6,30,24,91
81,r_45_252_66,seq288,r_168_104_55,r_45_252_66,0.81,16,82,66,91
94,r_78_294_91,seq66,r_276_229_2,r_78_294_91,1.0,-1,90,91,91
9,r_197_231_85,seq17,seq150,r_197_231_85,1.0,0,85,85,91
58,r_112_65_40,seq138,seq202,r_112_65_40,1.0,1,41,40,91
96,r_187_176_182,r_241_243_169,seq17,r_187_176_182,0.5,-13,169,182,91
4,r_29_137_3,r_86_157_83,r_68_271_100,r_68_271_100,0.97,2,102,100,91
133,seq89,r_125_260_117,seq226,r_125_260_117,1.0,-1,116,117,91
22,r_84_145_130,r_83_85_103,seq101,r_83_85_103,0.73,1,104,103,91
62,r_64_102_54,r_240_185_120,seq47,r_64_102_54,0.89,0,54,54,91
28,r_236_23_180,seq158,r_87_32_155,r_236_23_180,0.53,0,180,180,91
91,r_12_195_97,seq297,seq199,r_12_195_97,1.0,0,97,97,91
152,seq158,r_236_23_180,r_73_204_176,r_236_23_180,0.64,0,180,180,91
194,seq288,r_45_252_66,r_140_200_99,r_140_200_99,1.0,23,122,99,91
66,r_261_103_53,seq273,r_213_126_24,r_261_103_53,0.99,1,54,53,91
23,r_86_157_83,seq82,r_29_137_3,r_86_157_83,0.88,0,83,83,91
72,r_73_204_176,r_276_229_2,r_60_133_17,r_73_204_176,0.91,0,176,176,91
12,r_87_32_155,r_196_8_181,r_117_221_68,r_117_221_68,1.0,101,169,68,91
25,r_111_28_129,r_90_182_19,r_196_8_181,r_196_8_181,0.96,2,183,181,91
65,r_215_105_39,seq44,seq51,r_215_105_39,1.0,0,39,39,91
84,r_98_246_124,seq193,r_293_88_111,r_293_88_111,0.99,13,124,111,91
92,r_241_294_63,r_9_80_124,r_70_36_21,r_241_294_63,1.0,0,63,63,92
20,r_90_173_40,r_73_96_86,seq31,r_90_173_40,1.0,1,41,40,92
53,r_170_209_73,r_91_68_150,seq24,r_170_209_73,1.0,1,74,73,92
43,r_65_183_193,r_91_68_150,r_287_200_128,r_287_200_128,0.62,22,150,128,92
146,seq139,r_223_118_7,r_73_96_86,r_73_96_86,1.0,13,99,86,92
89,r_239_47_16,r_201_128_84,r_74_113_191,r_239_47_16,1.0,1,17,16,92
54,r_185_206_169,r_179_299_3,seq79,r_179_299_3,0.52,168,171,3,92
83,r_265_147_119,seq101,r_208_32_67,r_265_147_119,0.9,0,119,119,92
59,r_198_154_62,r_85_142_155,seq132,r_198_154_62,0.98,7,69,62,92
55,r_75_195_92,r_201_128_84,r_288_190_81,r_75_195_92,0.63,-9,83,92,92
71,r_122_69_109,r_12_204_153,seq138,r_122_69_109,0.98,0,109,109,92
86,r_222_272_185,seq282,seq67,r_222_272_185,0.47,1,186,185,92
16,r_53_211_141,r_59_237_104,r_223_118_7,r_53_211_141,0.97,0,141,141,92
39,r_184_286_137,seq177,r_60_64_135,r_184_286_137,0.74,0,137,137,92
97,r_146_57_161,r_14_178_103,r_91_68_150,r_146_57_161,0.86,1,162,161,92
143,seq135,r_63_13_186,r_136_106_110,r_136_106_110,0.61,76,186,110,92
5,r_191_292_146,seq24,seq109,r_191_292_146,0.77,0,146,146,92
46,r_242_37_105,r_28_29_103,r_223_118_7,r_242_37_105,1.0,0,105,105,92
42,r_107_227_66,seq100,r_223_118_7,r_107_227_66,0.98,1,67,66,92
99,r_254_263_47,r_114_212_133,seq71,r_254_263_47,1.0,0,47,47,92
45,r_1_148_173,r_98_58_91,r_73_96_86,r_1_148_173,0.56,-82,91,173,92
19,r_91_68_150,r_65_183_193,seq291,r_91_68_150,0.47,0,150,150,92
69,r_295_285_57,seq290,seq41,r_295_285_57,1.0,1,58,57,92
38,r_201_128_84,r_2_163_139,seq66,r_2_163_139,1.0,-14,125,139,92
95,r_108_194_110,seq251,r_217_124_111,r_108_194_110,0.6,2,112,110,92
66,r_12_204_153,r_296_123_95,r_149_238_56,r_12_204_153,1.0,-58,95,153,92
31,r_208_32_67,r_259_280_107,r_271_268_49,r_208_32_67,1.0,0,67,67,92
41,r_232_10_106,r_0_87_143,r_249_224_106,r_232_10_106,1.0,0,106,106,92
67,r_136_106_110,seq151,seq135,r_136_106_110,0.86,1,111,110,92
96,r_2_163_139,r_62_26_17,r_93_121_44,r_2_163_139,1.0,0,139,139,92
3,r_85_142_155,seq34,r_239_47_16,r_85_142_155,0.74,1,156,155,92
96,r_2_163_139,r_216_112_116,r_62_26_17,r_62_26_17,0.75,2,19,17,92
26,r_59_237_104,r_53_211_141,r_22_49_146,r_53_211_141,0.53,0,141,141,92
27,r_140_230_52,r_217_124_111,seq71,r_140_230_52,0.98,0,52,52,92
198,seq297,r_250_229_84,r_1_148_173,r_250_229_84,1.0,0,84,84,92
78,r_114_212_133,r_14_178_103,seq139,r_114_212_133,1.0,0,133,133,92
63,r_22_49_146,seq262,r_59_237_104,r_22_49_146,0.74,2,148,146,92
73,r_216_112_116,seq240,r_143_172_32,r_216_112_116,0.97,1,117,116,92
11,r_160_88_103,r_287_200_128,r_198_154_62,r_160_88_103,0.59,0,103,103,92
169,seq218,r_271_268_49,r_52_226_10,r_271_268_49,1.0,0,49,49,92
57,r_98_58_91,r_1_148_173,seq137,r_98_58_91,0.92,0,91,91,92
106,seq24,r_191_292_146,r_170_209_73,r_170_209_73,0.86,23,96,73,92
36,r_62_26_17,r_252_3_16,r_2_163_139,r_62_26_17,0.99,0,17,17,92
6,r_77_267_130,seq233,seq219,r_77_267_130,0.87,0,130,130,92
85,r_259_280_107,r_182_187_159,seq135,r_259_280_107,0.97,0,107,107,92
36,r_62_26_17,r_2_163_139,r_235_78_115,r_62_26_17,0.96,108,125,17,92
49,r_234_193_12,r_85_142_155,seq18,r_234_193_12,0.8,0,12,12,92
4,r_143_172_32,seq79,seq253,r_143_172_32,1.0,0,32,32,92
172,seq221,r_27_164_108,r_59_237_104,r_27_164_108,1.0,0,108,108,92
51,r_74_113_191,r_134_181_54,r_116_231_38,r_74_113_191,0.99,-138,53,191,92
162,seq177,r_184_286_137,seq189,r_184_286_137,1.0,0,137,137,92
10,r_126_203_59,seq266,seq82,r_126_203_59,1.0,0,59,59,92
22,r_296_123_95,r_76_215_165,r_223_118_7,r_76_215_165,0.91,0,165,165,92
2,r_175_30_110,seq202,r_28_29_103,r_175_30_110,0.94,0,110,110,92
47,r_129_43_137,r_0_87_143,r_271_268_49,r_271_268_49,0.59,88,137,49,92
29,r_247_283_82,seq109,seq257,r_247_283_82,0.96,0,82,82,92
61,r_149_238_56,r_12_204_153,r_239_47_16,r_12_204_153,0.61,0,153,153,92
24,r_288_190_81,r_53_211_141,seq219,r_288_190_81,0.98,0,81,81,92
25,r_228_131_195,seq137,seq151,r_228_131_195,0.41,-45,150,195,92
33,r_269_174_154,seq72,r_140_230_52,r_269_174_154,0.7,0,154,154,92
90,r_70_36_21,r_160_88_103,r_125_186_102,r_70_36_21,0.92,0,21,21,92
50,r_105_19_164,r_63_13_186,r_223_118_7,r_105_19_164,0.78,0,164,164,92
61,r_149_238_56,r_191_292_146,r_12_204_153,r_149_238_56,0.99,0,56,56,92
58,r_83_5_108,r_223_118_7,seq240,r_83_5_108,0.91,0,108,108,92
70,r_235_78_115,seq291,seq20,r_235_78_115,0.74,0,115,115,92
65,r_25_35_67,r_184_286_137,r_62_26_17,r_25_35_67,0.99,0,67,67,92
66,r_12_204_153,r_149_238_56,r_250_229_84,r_12_204_153,1.0,0,153,153,92
56,r_116_231_38,seq120,r_74_113_191,r_116_231_38,0.97,0,38,38,92
32,r_217_124_111,seq189,r_108_194_110,r_217_124_111,1.0,1,112,111,92
38,r_201_128_84,r_75_195_92,r_2_163_139,r_201_128_84,0.95,0,84,84,92
52,r_92_33_129,seq213,seq156,r_92_33_129,1.0,0,129,129,92
93,r_134_181_54,r_74_113_191,seq40,r_134_181_54,1.0,0,54,54,92
77,r_27_164_108,seq221,r_52_226_10,r_27_164_108,0.99,0,108,108,92
196,seq290,r_110_255_199,r_191_292_146,r_191_292_146,0.71,41,187,146,92
55,r_75_195_92,r_288_190_81,r_140_230_52,r_75_195_92,0.68,2,94,92,92
34,r_249_224_106,r_65_183_193,r_232_10_106,r_249_224_106,0.99,2,108,106,92
14,r_52_226_10,r_110_255_199,seq218,r_52_226_10,0.86,2,12,10,92
75,r_76_215_165,seq139,r_296_123_95,r_296_123_95,1.0,4,99,95,92
48,r_271_268_49,seq218,seq34,r_271_268_49,1.0,0,49,49,92
1,r_150_61_31,r_1_148_173,seq165,r_150_61_31,1.0,0,31,31,92
60,r_287_200_128,seq40,seq298,r_287_200_128,0.99,0,128,128,92
81,r_11_276_146,seq137,seq298,r_11_276_146,0.97,0,146,146,92
17,r_9_80_124,r_63_13_186,r_264_4_83,r_264_4_83,0.85,43,126,83,92
94,r_205_6_61,r_89_196_133,seq278,r_205_6_61,1.0,0,61,61,92
40,r_153_225_29,r_260_192_37,seq86,r_260_192_37,0.48,-7,30,37,92
9,r_125_186_102,r_191_292_146,seq50,r_125_186_102,0.97,0,102,102,92
90,r_70_36_21,r_125_186_102,r_241_294_63,r_70_36_21,1.0,81,102,21,92
22,r_296_123_95,r_12_204_153,r_76_215_165,r_296_123_95,1.0,0,95,95,92
102,seq17,seq291,r_245_207_134,r_245_207_134,0.83,0,134,134,92
199,seq298,r_65_183_193,r_11_276_146,r_11_276_146,1.0,9,155,146,92
72,r_260_192_37,r_84_7_173,r_179_299_3,r_260_192_37,1.0,0,37,37,92
44,r_28_29_103,r_242_37_105,r_295_285_57,r_28_29_103,0.7,0,103,103,92
23,r_0_87_143,seq169,r_175_30_110,r_0_87_143,0.97,0,143,143,92
84,r_188_130_43,seq266,seq31,r_188_130_43,0.94,2,45,43,92
75,r_76_215_165,r_296_123_95,seq270,r_76_215_165,0.95,0,165,165,92
35,r_250_229_84,seq297,r_179_299_3,r_250_229_84,1.0,0,84,84,92
12,r_73_96_86,seq298,seq139,r_73_96_86,0.98,1,87,86,92
13,r_258_117_28,r_21_95_42,seq246,r_21_95_42,0.72,-12,30,42,92
199,seq298,r_73_96_86,r_65_183_193,r_73_96_86,1.0,1,87,86,92
30,r_220_265_144,r_32_29_187,r_237_159_85,r_220_265_144,0.84,0,144,144,93
36,r_244_119_136,seq38,r_87_161_67,r_87_161_67,1.0,79,146,67,93
92,r_203_167_83,r_244_119_136,r_16_37_51,r_244_119_136,0.93,-47,89,136,93
14,r_253_108_98,r_14_57_123,seq151,r_253_108_98,0.95,1,99,98,93
74,r_272_231_17,r_13_257_107,r_16_37_51,r_272_231_17,0.9,35,52,17,93
8,r_137_229_156,r_115_276_151,r_222_182_102,r_222_182_102,0.72,60,162,102,93
53,r_69_7_89,r_84_56_194,seq18,r_69_7_89,0.88,0,89,89,93
43,r_184_275_155,seq267,r_101_100_65,r_184_275_155,0.59,0,155,155,93
54,r_239_227_84,seq128,seq176,r_239_227_84,0.95,0,84,84,93
136,seq110,r_75_60_32,r_272_231_17,r_75_60_32,0.52,0,32,32,93
188,seq267,r_184_275_155,seq90,r_184_275_155,1.0,0,155,155,93
55,r_13_257_107,seq110,r_244_119_136,r_244_119_136,0.55,-17,119,136,93
86,r_207_200_84,r_294_65_119,seq280,r_207_200_84,0.99,0,84,84,93
1,r_148_270_183,seq26,r_98_271_95,r_98_271_95,1.0,88,183,95,93
5,r_105_17_110,r_132_34_41,r_244_119_136,r_105_17_110,0.87,3,113,110,93
42,r_87_161_67,r_210_39_112,seq120,r_87_161_67,0.75,0,67,67,93
111,seq38,r_244_119_136,r_256_224_133,r_256_224_133,1.0,13,146,133,93
93,r_114_245_16,r_148_270_183,seq238,r_114_245_16,0.89,-1,15,16,93
80,r_273_211_193,r_21_81_177,r_101_100_65,r_101_100_65,1.0,119,184,65,93
69,r_254_264_124,seq202,seq232,r_254_264_124,0.79,2,126,124,93
62,r_5_205_25,r_104_181_128,seq8,r_5_205_25,0.98,0,25,25,93
19,r_266_152_179,seq280,r_98_271_95,r_98_271_95,0.53,85,180,95,93
21,r_133_27_24,r_172_0_99,seq279,r_172_0_99,0.8,-69,30,99,93
95,r_196_50_107,seq204,r_253_108_98,r_196_50_107,0.91,3,110,107,93
66,r_138_6_90,seq212,r_68_48_45,r_138_6_90,0.95,0,90,90,93
24,r_109_158_193,r_4_228_75,r_75_60_32,r_4_228_75,0.59,-33,42,75,93
73,r_68_48_45,r_197_216_195,seq284,r_68_48_45,0.59,4,49,45,93
103,seq10,r_197_216_195,r_68_48_45,r_68_48_45,0.54,85,130,45,93
97,r_99_236_39,r_169_235_105,r_221_1_33,r_169_235_105,0.8,8,113,105,93
31,r_136_62_134,seq128,r_179_157_13,r_136_62_134,0.64,-58,76,134,93
129,seq92,r_82_145_62,r_4_228_75,r_82_145_62,0.98,17,79,62,93
41,r_21_81_177,r_273_211_193,r_104_181_128,r_104_181_128,1.0,56,184,128,93
67,r_51_298_78,seq126,seq267,r_51_298_78,0.91,2,80,78,93
110,seq36,seq72,r_89_73_105,r_89_73_105,0.9,18,123,105,93
89,r_118_208_179,seq250,r_4_228_75,r_4_228_75,1.0,104,179,75,93
3,r_294_65_119,seq284,r_125_146_14,r_294_65_119,0.88,0,119,119,93
90,r_296_289_70,r_169_235_105,r_68_48_45,r_296_289_70,0.99,1,71,70,93
91,r_179_157_13,r_247_213_136,r_136_62_134,r_179_157_13,0.95,0,13,13,93
72,r_28_46_177,seq284,r_101_100_65,r_101_100_65,0.97,115,180,65,93
179,seq233,r_104_181_128,r_16_37_51,r_16_37_51,0.94,89,140,51,93
35,r_268_189_51,r_89_73_105,seq204,r_268_189_51,1.0,2,53,51,93
59,r_156_206_50,seq74,seq120,r_156_206_50,0.98,5,55,50,93
78,r_32_29_187,seq49,r_244_119_136,r_244_119_136,0.77,53,189,136,93
0,r_79_287_174,r_249_234_194,seq141,r_79_287_174,0.45,0,174,174,93
63,r_111_140_76,r_286_33_196,r_247_213_136,r_111_140_76,0.63,4,80,76,93
11,r_258_219_90,seq120,seq139,r_258_219_90,0.99,0,90,90,93
20,r_130_78_73,r_104_181_128,r_155_83_5,r_130_78_73,0.87,1,74,73,93
13,r_201_164_114,seq147,r_40_54_108,r_201_164_114,0.98,0,114,114,93
82,r_23_282_39,r_258_219_90,seq70,r_23_282_39,0.97,3,42,39,93
98,r_210_39_112,seq45,seq67,r_210_39_112,0.96,2,114,112,93
15,r_237_159_85,r_244_119_136,r_221_1_33,r_237_159_85,0.61,5,90,85,93
48,r_165_292_118,seq53,r_101_100_65,r_101_100_65,0.95,58,123,65,93
33,r_293_107_14,r_148_270_183,seq106,r_293_107_14,0.85,0,14,14,93
6,r_101_100_65,seq284,seq123,r_101_100_65,0.95,0,65,65,93
85,r_3_251_122,seq151,r_132_34_41,r_3_251_122,0.61,6,128,122,93
99,r_222_182_102,seq123,seq67,r_222_182_102,0.69,1,103,102,93
45,r_22_66_44,r_246_144_145,r_247_213_136,r_22_66_44,1.0,1,45,44,93
28,r_125_146_14,r_133_27_24,seq58,r_125_146_14,0.88,3,17,14,93
27,r_14_57_123,seq45,seq280,r_14_57_123,0.87,0,123,123,93
75,r_169_235_105,r_99_236_39,r_244_119_136,r_169_235_105,0.76,2,107,105,93
172,seq209,r_41_190_142,seq259,r_41_190_142,0.96,-12,130,142,93
91,r_179_157_13,r_136_62_134,seq170,r_136_62_134,1.0,5,139,134,93
2,r_98_271_95,seq151,seq71,r_98_271_95,0.94,0,95,95,93
47,r_19_150_153,r_84_56_194,r_51_298_78,r_19_150_153,0.56,2,155,153,93
40,r_129_230_146,seq103,r_198_11_136,r_129_230_146,0.58,2,148,146,93
18,r_4_228_75,r_109_158_193,seq92,r_4_228_75,1.0,0,75,75,93
29,r_163_15_161,seq143,r_16_37_51,r_163_15_161,0.5,3,164,161,93
25,r_172_0_99,seq121,seq103,r_172_0_99,0.9,2,101,99,93
191,seq279,r_85_166_175,r_101_100_65,r_101_100_65,0.98,23,88,65,93
88,r_40_54_108,r_14_57_123,r_114_245_16,r_40_54_108,0.99,1,109,108,93
58,r_261_63_150,seq284,seq126,r_261_63_150,0.5,4,154,150,93
70,r_47_64_62,r_85_166_175,seq186,r_47_64_62,0.96,3,65,62,93
65,r_256_224_133,seq162,r_169_235_105,r_256_224_133,0.91,0,133,133,93
61,r_153_214_147,seq128,r_268_189_51,r_153_214_147,0.8,0,147,147,93
32,r_198_11_136,r_221_1_33,r_14_57_123,r_14_57_123,0.95,15,138,123,93
38,r_85_166_175,seq279,r_281_76_167,r_85_166_175,0.59,1,176,175,93
52,r_24_290_184,r_197_216_195,r_258_219_90,r_24_290_184,0.53,0,184,184,93
64,r_16_37_51,r_244_119_136,r_272_231_17,r_16_37_51,0.91,1,52,51,93
79,r_75_60_32,seq110,r_109_158_193,r_75_60_32,0.98,0,32,32,93
75,r_169_235_105,r_296_289_70,r_99_236_39,r_169_235_105,0.92,-34,71,105,93
97,r_99_236_39,r_4_228_75,r_169_235_105,r_99_236_39,0.8,0,39,39,93
60,r_185_142_183,seq174,r_101_100_65,r_101_100_65,0.77,119,184,65,93
81,r_93_86_105,r_281_76_167,seq299,r_93_86_105,0.98,0,105,105,93
168,seq194,r_137_229_156,r_263_183_87,r_263_183_87,0.98,71,158,87,93
94,r_263_183_87,seq55,seq194,r_263_183_87,0.97,0,87,87,93
145,seq128,r_153_214_147,seq170,r_153_214_147,0.99,0,147,147,93
96,r_91_248_144,seq58,r_244_119_136,r_91_248_144,0.68,1,145,144,93
31,r_136_62_134,r_179_157_13,r_130_78_73,r_136_62_134,0.66,5,139,134,93
123,seq71,r_246_144_145,r_98_271_95,r_98_271_95,0.68,10,105,95,93
22,r_42_285_152,r_155_83_5,r_68_48_45,r_42_285_152,0.72,-5,147,152,93
194,seq284,r_101_100_65,r_68_48_45,r_101_100_65,1.0,0,65,65,93
56,r_82_145_62,r_153_214_147,seq92,r_82_145_62,0.99,0,62,62,93
7,r_243_112_130,seq160,seq72,r_243_112_130,0.8,0,130,130,93
44,r_195_117_101,r_79_287_174,r_268_189_51,r_268_189_51,0.57,51,102,51,93
23,r_246_144_145,r_269_188_191,seq90,r_246_144_145,0.61,0,145,145,93
186,seq259,r_269_188_191,r_98_271_95,r_98_271_95,1.0,78,173,95,93
74,r_272_231_17,r_93_86_105,r_13_257_107,r_272_231_17,0.73,-2,15,17,93
12,r_41_190_142,seq209,seq160,r_41_190_142,0.91,1,143,142,93
26,r_217_20_58,r_210_39_112,seq139,r_217_20_58,0.97,0,58,58,93
53,r_86_17_35,r_148_14_176,r_162_259_2,r_86_17_35,0.97,4,39,35,94
23,r_183_251_28,r_250_161_84,seq193,r_183_251_28,1.0,0,28,28,94
92,r_94_175_167,seq107,r_248_138_119,r_94_175_167,0.68,0,167,167,94
61,r_162_259_2,r_213_297_93,r_86_17_35,r_162_259_2,0.98,49,51,2,94
14,r_160_69_159,seq59,seq165,r_160_69_159,0.75,2,161,159,94
43,r_121_120_65,r_181_127_145,seq210,r_121_120_65,0.76,15,80,65,94
146,seq139,seq11,r_263_52_96,r_263_52_96,0.97,10,106,96,94
116,seq53,r_217_125_115,r_293_264_52,r_217_125_115,1.0,-49,66,115,94
37,r_181_127_145,r_35_239_21,r_46_71_198,r_181_127_145,0.51,4,149,145,94
55,r_134_195_90,r_84_147_125,seq73,r_134_195_90,0.99,0,90,90,94
71,r_189_129_88,seq93,r_15_136_33,r_189_129_88,0.81,0,88,88,94
16,r_115_299_79,seq282,seq119,r_115_299_79,1.0,0,79,79,94
21,r_112_281_137,seq114,r_230_41_139,r_112_281_137,0.9,0,137,137,94
39,r_141_38_135,seq33,r_22_83_65,r_22_83_65,0.7,74,139,65,94
1,r_148_14_176,seq5,r_290_296_101,r_290_296_101,0.66,75,176,101,94
97,r_48_289_161,seq61,r_244_143_144,r_48_289_161,0.65,0,161,161,94
5,r_150_49_78,r_1_201_175,seq226,r_150_49_78,1.0,1,79,78,94
46,r_290_296_101,r_188_122_115,seq237,r_188_122_115,0.55,-14,101,115,94
80,r_159_110_64,seq73,seq88,r_159_110_64,1.0,0,64,64,94
33,r_37_278_59,seq42,seq139,r_37_278_59,1.0,0,59,59,94
19,r_270_20_74,r_171_279_160,seq156,r_270_20_74,1.0,1,75,74,94
73,r_7_116_36,seq184,seq282,r_7_116_36,0.99,1,37,36,94
47,r_182_205_49,r_194_221_176,r_45_224_14,r_182_205_49,0.88,3,52,49,94
95,r_185_199_154,seq91,seq85,r_185_199_154,0.82,-1,153,154,94
66,r_133_178_127,seq31,r_121_120_65,r_133_178_127,0.97,0,127,127,94
76,r_16_229_122,seq100,r_261_90_50,r_16_229_122,0.88,5,127,122,94
31,r_0_196_155,seq72,r_15_136_33,r_0_196_155,0.99,0,155,155,94
41,r_291_274_107,r_96_295_125,r_223_132_50,r_223_132_50,0.78,56,106,50,94
89,r_217_125_115,seq53,seq105,r_217_125_115,1.0,1,116,115,94
3,r_24_170_157,seq294,seq286,r_24_170_157,0.9,2,159,157,94
90,r_188_122_115,seq157,r_213_297_93,r_188_122_115,0.61,1,116,115,94
109,seq31,r_133_178_127,seq53,r_133_178_127,1.0,0,127,127,94
26,r_212_190_151,seq92,seq58,r_212_190_151,0.91,0,151,151,94
72,r_109_249_68,r_35_239_21,seq214,r_109_249_68,1.0,0,68,68,94
75,r_252_36_42,seq34,r_240_55_43,r_252_36_42,1.0,0,42,42,94
198,seq294,r_189_129_88,r_39_257_5,r_189_129_88,1.0,-7,81,88,94
4,r_128_172_63,seq234,r_102_146_48,r_128_172_63,1.0,0,63,63,94
50,r_87_103_35,r_235_273_148,seq30,r_87_103_35,0.86,4,39,35,94
78,r_174_75_150,r_230_41_139,r_128_172_63,r_174_75_150,0.69,0,150,150,94
0,r_8_111_107,r_0_196_155,r_168_62_5,r_8_111_107,0.98,-1,106,107,94
11,r_21_242_108,seq288,seq5,r_21_242_108,0.89,0,108,108,94
46,r_290_296_101,seq237,r_148_14_176,r_148_14_176,0.81,4,180,176,94
67,r_95_60_57,r_40_153_108,r_168_62_5,r_95_60_57,1.0,2,59,57,94
15,r_64_81_96,seq53,r_86_17_35,r_64_81_96,1.0,-1,95,96,94
63,r_65_101_34,r_235_273_148,seq91,r_235_273_148,0.89,-109,39,148,94
48,r_47_197_122,seq184,seq42,r_47_197_122,1.0,0,122,122,94
106,seq27,r_235_273_148,r_40_153_108,r_40_153_108,0.55,3,111,108,94
6,r_244_143_144,seq180,seq72,r_244_143_144,0.6,0,144,144,94
62,r_173_32_4,r_155_152_91,r_203_99_35,r_203_99_35,1.0,55,90,35,94
96,r_241_233_49,r_8_111_107,seq61,r_241_233_49,1.0,1,50,49,94
99,r_213_297_93,seq180,seq131,r_213_297_93,1.0,2,95,93,94
83,r_158_276_40,r_280_98_10,r_183_251_28,r_183_251_28,0.87,12,40,28,94
86,r_45_224_14,r_21_242_108,r_168_62_5,r_45_224_14,1.0,-1,13,14,94
2,r_22_83_65,r_217_125_115,r_1_201_175,r_22_83_65,1.0,0,65,65,94
25,r_3_108_31,r_24_170_157,seq288,r_3_108_31,0.87,0,31,31,94
142,seq119,seq88,r_115_299_79,r_115_299_79,1.0,18,97,79,94
40,r_96_295_125,seq9,r_218_267_57,r_218_267_57,1.0,71,128,57,94
93,r_151_166_27,seq266,r_39_257_5,r_151_166_27,0.99,2,29,27,94
105,seq26,r_164_283_150,r_218_267_57,r_218_267_57,0.99,97,154,57,94
74,r_171_279_160,seq67,seq57,r_171_279_160,0.89,0,160,160,94
18,r_12_78_188,seq215,r_225_56_38,r_225_56_38,0.99,150,188,38,94
195,seq282,r_115_299_79,r_255_18_44,r_115_299_79,1.0,0,79,79,94
20,r_218_267_57,r_134_195_90,r_70_104_56,r_218_267_57,1.0,0,57,57,94
59,r_118_243_39,r_265_246_155,r_35_239_21,r_118_243_39,1.0,1,40,39,94
127,seq73,seq177,r_134_195_90,r_134_195_90,1.0,1,91,90,94
69,r_29_82_37,r_16_229_122,seq119,r_29_82_37,1.0,0,37,37,94
13,r_225_56_38,r_22_83_65,seq231,r_225_56_38,1.0,2,40,38,94
64,r_6_202_115,seq165,r_64_81_96,r_6_202_115,0.58,1,116,115,94
88,r_230_41_139,r_174_75_150,r_112_281_137,r_230_41_139,0.89,11,150,139,94
58,r_84_147_125,seq210,r_87_103_35,r_84_147_125,0.91,2,127,125,94
44,r_261_90_50,seq107,r_7_116_36,r_7_116_36,0.95,19,55,36,94
65,r_126_4_107,seq19,seq149,r_126_4_107,0.93,0,107,107,94
68,r_40_153_108,seq85,seq27,r_40_153_108,0.99,0,108,108,94
70,r_254_292_18,r_24_170_157,seq107,r_254_292_18,0.93,-1,17,18,94
137,seq100,r_16_229_122,r_22_83_65,r_22_83_65,0.97,62,127,65,94
52,r_51_287_175,seq177,r_182_205_49,r_51_287_175,0.54,1,176,175,94
9,r_15_136_33,seq234,seq59,r_15_136_33,1.0,0,33,33,94
57,r_13_227_31,r_96_295_125,seq238,r_13_227_31,1.0,0,31,31,94
34,r_1_201_175,r_150_49_78,r_22_83_65,r_1_201_175,0.93,-96,79,175,94
124,seq67,r_171_279_160,seq163,r_171_279_160,0.95,-1,159,160,94
132,seq88,seq271,r_159_110_64,r_159_110_64,1.0,25,89,64,94
49,r_223_132_50,r_222_272_121,r_183_251_28,r_223_132_50,1.0,0,50,50,94
60,r_77_275_94,seq19,r_87_103_35,r_87_103_35,1.0,88,123,35,94
30,r_102_146_48,r_263_52_96,r_151_166_27,r_263_52_96,0.67,-48,48,96,94
17,r_248_138_119,r_148_14_176,r_159_110_64,r_148_14_176,0.98,-57,119,176,94
173,seq210,r_84_147_125,r_121_120_65,r_84_147_125,0.86,2,127,125,94
94,r_250_161_84,seq286,r_128_172_63,r_250_161_84,0.74,4,88,84,94
144,seq131,seq54,r_213_297_93,r_213_297_93,1.0,7,100,93,94
121,seq61,r_48_289_161,r_241_233_49,r_241_233_49,1.0,112,161,49,94
120,seq59,r_160_69_159,r_15_136_33,r_15_136_33,0.6,128,161,33,94
133,seq91,r_185_199_154,r_65_101_34,r_185_199_154,0.91,-1,153,154,94
22,r_106_284_83,r_155_152_91,seq277,r_106_284_83,1.0,0,83,83,94
184,seq238,seq214,r_13_227_31,r_13_227_31,1.0,10,41,31,94
10,r_89_207_37,seq11,seq34,r_89_207_37,1.0,0,37,37,94
56,r_263_52_96,seq154,seq139,r_263_52_96,0.88,0,96,96,94
7,r_222_272_121,seq88,r_2_169_38,r_222_272_121,1.0,0,121,121,94
175,seq215,r_12_78_188,r_150_49_78,r_150_49_78,1.0,110,188,78,94
27,r_135_123_36,r_115_299_79,seq27,r_135_123_36,0.99,1,37,36,94
186,seq247,r_235_273_148,r_135_123_36,r_135_123_36,0.57,113,149,36,94
42,r_2_169_38,r_21_242_108,r_10_80_18,r_21_242_108,0.88,-58,50,108,94
82,r_203_99_35,r_160_69_159,r_173_32_4,r_203_99_35,1.0,1,36,35,94
12,r_235_273_148,seq247,seq76,r_235_273_148,0.87,1,149,148,94
38,r_70_104_56,r_189_129_88,r_218_267_57,r_70_104_56,0.77,1,57,56,94
93,r_20_256_115,r_224_150_1,r_122_176_118,r_20_256_115,0.92,3,118,115,95
30,r_94_0_100,seq287,seq125,r_94_0_100,0.85,3,103,100,95
51,r_22_42_160,seq9,r_14_148_135,r_22_42_160,0.75,1,161,160,95
36,r_98_114_116,seq51,seq118,r_98_114_116,0.55,5,121,116,95
17,r_179_71_47,r_208_50_77,seq8,r_179_71_47,1.0,0,47,47,95
147,seq146,r_221_147_135,seq210,r_221_147_135,1.0,-5,130,135,95
8,r_5_271_181,r_261_33_164,r_184_281_172,r_261_33_164,0.35,17,181,164,95
43,r_100_254_88,seq95,seq278,r_100_254_88,0.96,0,88,88,95
67,r_160_129_33,seq161,r_108_53_6,r_108_53_6,0.77,36,42,6,95
87,r_72_77_40,r_58_64_169,seq198,r_72_77_40,0.98,0,40,40,95
53,r_196_87_34,r_39_195_136,seq235,r_196_87_34,1.0,2,36,34,95
55,r_102_289_150,seq95,r_183_61_149,r_102_289_150,0.75,0,150,150,95
71,r_73_246_73,r_10_3_139,r_132_214_15,r_73_246_73,1.0,0,73,73,95
16,r_45_55_166,seq210,r_234_17_119,r_45_55_166,0.77,0,166,166,95
21,r_48_143_128,seq8,seq68,r_48_143_128,0.71,0,128,128,95
39,r_90_76_109,r_123_286_15,r_296_74_12,r_90_76_109,1.0,1,110,109,95
1,r_285_219_54,r_5_271_181,r_203_168_13,r_285_219_54,0.77,10,64,54,95
38,r_149_126_44,r_113_202_118,seq99,r_149_126_44,0.93,4,48,44,95
13,r_132_214_15,r_133_252_98,seq65,r_132_214_15,0.89,0,15,15,95
5,r_155_193_86,r_192_142_55,r_23_292_171,r_155_193_86,1.0,0,86,86,95
46,r_39_195_136,seq125,r_238_244_76,r_238_244_76,0.66,60,136,76,95
98,r_56_178_100,r_82_225_150,r_10_3_139,r_56_178_100,1.0,51,151,100,95
60,r_81_105_24,r_216_75_183,r_16_280_72,r_16_280_72,1.0,3,75,72,95
80,r_140_135_132,r_159_211_136,r_220_263_79,r_159_211_136,0.77,-4,132,136,95
44,r_134_27_18,r_285_219_54,seq228,r_134_27_18,0.89,-1,17,18,95
45,r_16_280_72,seq156,r_81_105_24,r_16_280_72,1.0,0,72,72,95
95,r_242_44_143,seq151,seq28,r_242_44_143,0.78,0,143,143,95
66,r_269_249_185,seq230,r_69_185_142,r_269_249_185,0.29,0,185,185,95
41,r_288_38_99,r_166_41_41,r_160_129_33,r_288_38_99,1.0,0,99,99,95
89,r_192_142_55,r_155_193_86,r_296_74_12,r_155_193_86,0.9,-24,62,86,95
3,r_174_273_140,seq156,r_123_286_15,r_174_273_140,0.82,0,140,140,95
54,r_108_53_6,r_183_61_149,r_160_129_33,r_183_61_149,0.97,-90,59,149,95
4,r_234_17_119,r_32_177_53,r_283_180_16,r_234_17_119,0.94,0,119,119,95
22,r_82_225_150,r_56_178_100,r_159_211_136,r_82_225_150,0.99,0,150,150,95
4,r_234_17_119,r_220_263_79,r_32_177_53,r_234_17_119,0.93,-40,79,119,95
78,r_220_263_79,r_234_17_119,r_251_277_26,r_220_263_79,0.88,0,79,79,95
0,r_103_36_121,seq28,r_213_207_79,r_103_36_121,1.0,0,121,121,95
63,r_257_232_107,r_102_289_150,seq151,r_102_289_150,0.74,0,150,150,95
11,r_208_50_77,r_238_244_76,seq115,r_208_50_77,0.99,-1,76,77,95
86,r_204_110_41,r_166_41_41,seq51,r_204_110_41,0.76,1,42,41,95
20,r_221_147_135,seq146,r_103_36_121,r_221_147_135,0.67,0,135,135,95
98,r_56_178_100,seq109,r_82_225_150,r_56_178_100,0.87,0,100,100,95
56,r_23_292_171,r_155_193_86,r_165_199_10,r_23_292_171,0.99,0,171,171,95
15,r_133_252_98,r_226_137_130,seq99,r_133_252_98,0.99,0,98,98,95
48,r_163_282_107,seq29,r_32_177_53,r_163_282_107,0.65,0,107,107,95
57,r_57_106_52,seq278,seq66,r_57_106_52,0.48,11,63,52,95
106,seq15,r_14_148_135,r_296_74_12,r_14_148_135,0.8,2,137,135,95
13,r_132_214_15,seq65,r_73_246_73,r_73_246_73,1.0,29,102,73,95
6,r_69_185_142,seq212,r_296_74_12,r_69_185_142,0.93,0,142,142,95
99,r_63_259_98,seq294,seq290,r_63_259_98,0.94,0,98,98,95
5,r_155_193_86,r_23_292_171,r_182_138_166,r_155_193_86,0.93,85,171,86,95
28,r_70_275_17,r_48_143_128,seq293,r_70_275_17,0.99,-4,13,17,95
27,r_170_37_63,seq24,seq9,r_170_37_63,1.0,0,63,63,95
148,seq151,r_242_44_143,seq104,r_242_44_143,1.0,0,143,143,95
2,r_26_169_85,r_152_200_87,seq35,r_26_169_85,1.0,0,85,85,95
59,r_253_4_148,r_145_124_5,r_131_222_6,r_253_4_148,0.97,0,148,148,95
47,r_32_177_53,r_113_202_118,r_234_17_119,r_32_177_53,1.0,0,53,53,95
40,r_46_139_88,seq51,seq245,r_46_139_88,0.99,1,89,88,95
74,r_250_2_107,seq290,seq8,r_250_2_107,1.0,0,107,107,95
18,r_58_64_169,seq118,r_250_2_107,r_58_64_169,0.53,0,169,169,95
29,r_238_244_76,r_208_50_77,seq7,r_238_244_76,0.99,0,76,76,95
24,r_101_112_93,seq190,r_208_50_77,r_208_50_77,1.0,17,94,77,95
25,r_14_148_135,seq15,seq96,r_14_148_135,0.6,1,136,135,95
33,r_111_291_83,seq187,r_226_137_130,r_111_291_83,0.9,2,85,83,95
47,r_32_177_53,r_234_17_119,r_163_282_107,r_32_177_53,0.87,66,119,53,95
88,r_107_19_134,r_184_281_172,r_283_180_16,r_107_19_134,0.58,0,134,134,95
190,seq278,seq162,r_100_254_88,r_100_254_88,1.0,1,89,88,95
85,r_145_124_5,r_253_4_148,r_251_277_26,r_145_124_5,0.8,143,148,5,95
50,r_262_49_92,seq65,seq18,r_262_49_92,0.99,1,93,92,95
70,r_122_176_118,seq18,r_20_256_115,r_122_176_118,1.0,1,119,118,95
65,r_152_200_87,r_231_12_176,r_201_158_62,r_152_200_87,1.0,0,87,87,95
155,seq171,r_258_119_180,r_21_79_5,r_258_119_180,0.85,1,181,180,95
37,r_223_154_24,r_170_37_63,r_59_267_33,r_223_154_24,0.92,18,42,24,95
42,r_183_61_149,r_108_53_6,r_59_267_33,r_183_61_149,0.73,0,149,149,95
137,seq115,seq136,r_101_112_93,r_101_112_93,0.84,1,94,93,95
61,r_88_144_166,seq35,r_234_17_119,r_88_144_166,0.5,0,166,166,95
32,r_182_138_166,seq35,seq161,r_182_138_166,0.71,0,166,166,95
52,r_141_78_92,r_113_202_118,r_159_211_136,r_141_78_92,0.97,0,92,92,95
196,seq294,r_26_169_85,seq80,r_26_169_85,1.0,0,85,85,95
69,r_251_277_26,r_285_219_54,r_145_124_5,r_251_277_26,1.0,0,26,26,95
34,r_201_158_62,seq95,seq186,r_201_158_62,1.0,1,63,62,95
132,seq95,seq297,r_213_207_79,r_213_207_79,0.97,18,97,79,95
94,r_123_286_15,r_90_76_109,seq67,r_90_76_109,1.0,1,110,109,95
81,r_226_137_130,r_26_169_85,r_165_199_10,r_226_137_130,0.96,-119,11,130,95
22,r_82_225_150,seq245,r_56_178_100,r_56_178_100,0.65,10,110,100,95
60,r_81_105_24,seq186,r_216_75_183,r_81_105_24,0.88,0,24,24,95
91,r_113_202_118,seq8,r_285_219_54,r_113_202_118,1.0,0,118,118,95
77,r_59_267_33,r_14_148_135,seq24,r_59_267_33,1.0,3,36,33,95
49,r_233_266_164,seq8,r_46_139_88,r_233_266_164,0.78,0,164,164,95
72,r_216_75_183,r_81_105_24,r_132_214_15,r_216_75_183,0.68,0,183,183,95
56,r_23_292_171,r_141_78_92,r_155_193_86,r_23_292_171,1.0,-85,86,171,95
23,r_175_189_122,seq240,r_101_112_93,r_175_189_122,1.0,0,122,122,95
68,r_165_199_10,r_22_42_160,r_226_137_130,r_165_199_10,0.86,1,11,10,95
14,r_270_92_53,seq210,r_134_27_18,r_270_92_53,1.0,1,54,53,95
82,r_85_31_163,seq67,r_111_291_83,r_85_31_163,0.76,0,163,163,95
31,r_283_180_16,r_58_64_169,seq156,r_283_180_16,1.0,0,16,16,95
72,r_216_75_183,r_166_41_41,r_81_105_24,r_81_105_24,0.7,22,46,24,95
84,r_213_207_79,seq62,seq95,r_213_207_79,0.94,13,92,79,95
7,r_264_3_18,r_38_123_146,seq90,r_264_3_18,0.91,0,18,18,96
68,r_175_100_30,seq109,seq80,r_175_100_30,1.0,1,31,30,96
36,r_35_86_141,r_34_229_196,seq271,r_35_86_141,0.85,0,141,141,96
29,r_238_23_27,seq80,r_244_239_27,r_238_23_27,1.0,0,27,27,96
14,r_73_202_110,seq160,seq33,r_73_202_110,1.0,0,110,110,96
53,r_197_187_173,seq168,seq81,r_197_187_173,0.55,0,173,173,96
43,r_224_27_166,r_118_74_172,r_73_202_110,r_118_74_172,0.84,-6,166,172,96
86,r_199_88_135,r_151_159_62,r_32_51_5,r_199_88_135,0.99,1,136,135,96
25,r_248_152_24,r_270_69_6,r_134_269_80,r_248_152_24,0.67,0,24,24,96
54,r_240_277_159,seq120,r_250_70_106,r_240_277_159,0.76,1,160,159,96
83,r_162_258_84,seq16,seq66,r_162_258_84,1.0,1,85,84,96
37,r_143_156_117,seq252,seq274,r_143_156_117,0.96,7,124,117,96
59,r_237_102_89,seq81,seq11,r_237_102_89,1.0,0,89,89,96
19,r_203_83_29,r_215_107_146,seq31,r_215_107_146,0.96,-5,141,146,96
188,seq278,r_297_62_174,r_256_207_95,r_256_207_95,0.98,41,136,95,96
55,r_194_146_165,r_25_19_142,seq155,r_25_19_142,0.98,1,143,142,96
86,r_199_88_135,r_290_148_156,r_151_159_62,r_151_159_62,1.0,13,75,62,96
21,r_44_198_88,seq131,r_22_174_42,r_22_174_42,1.0,51,93,42,96
39,r_113_261_97,r_225_292_114,r_162_258_84,r_113_261_97,0.75,0,97,97,96
165,seq209,r_246_14_147,seq266,r_246_14_147,0.98,3,150,147,96
42,r_118_74_172,r_181_121_172,r_44_198_88,r_44_198_88,0.7,91,179,88,96
80,r_282_228_71,seq109,r_289_117_196,r_282_228_71,1.0,0,71,71,96
32,r_206_232_9,r_162_258_84,r_282_228_71,r_206_232_9,1.0,76,85,9,96
88,r_226_249_43,seq125,seq28,r_226_249_43,1.0,0,43,43,96
1,r_171_1_59,seq105,r_226_249_43,r_171_1_59,1.0,0,59,59,96
76,r_127_129_173,r_214_167_179,r_206_232_9,r_206_232_9,0.52,139,148,9,96
38,r_151_159_62,r_199_88_135,r_82_112_23,r_199_88_135,1.0,1,136,135,96
31,r_91_17_116,seq241,r_18_254_5,r_91_17_116,0.99,0,116,116,96
41,r_290_148_156,seq222,r_5_257_83,r_290_148_156,0.9,0,156,156,96
50,r_223_263_20,r_94_265_84,seq285,r_223_263_20,1.0,0,20,20,96
10,r_225_292_114,r_250_70_106,seq193,r_225_292_114,0.99,1,115,114,96
90,r_211_178_125,seq66,seq153,r_211_178_125,0.95,1,126,125,96
4,r_243_213_179,seq168,r_225_292_114,r_225_292_114,0.6,65,179,114,96
71,r_22_174_42,seq278,seq205,r_22_174_42,1.0,1,43,42,96
78,r_29_0_77,r_290_148_156,r_244_239_27,r_29_0_77,1.0,0,77,77,96
0,r_98_97_84,r_225_292_114,r_110_172_199,r_98_97_84,1.0,3,87,84,96
73,r_246_14_147,seq209,r_206_232_9,r_246_14_147,0.96,0,147,147,96
11,r_126_72_75,r_149_50_141,r_270_69_6,r_126_72_75,0.97,1,76,75,96
96,r_2_30_44,seq135,r_82_112_23,r_2_30_44,1.0,0,44,44,96
20,r_256_207_95,r_143_156_117,seq278,r_256_207_95,1.0,0,95,95,96
13,r_250_70_106,r_225_292_114,seq26,r_225_292_114,0.81,-6,108,114,96
163,seq196,r_114_68_186,r_204_140_68,r_204_140_68,1.0,6,74,68,96
98,r_182_78_166,r_184_119_64,r_203_83_29,r_203_83_29,0.59,137,166,29,96
15,r_176_96_83,seq205,seq259,r_176_96_83,1.0,2,85,83,96
166,seq216,r_214_167_179,r_206_232_9,r_214_167_179,0.64,0,179,179,96
25,r_248_152_24,r_134_269_80,r_186_79_41,r_248_152_24,0.99,19,43,24,96
35,r_59_10_17,seq271,seq9,r_59_10_17,1.0,-1,16,17,96
57,r_94_265_84,seq104,r_132_65_90,r_94_265_84,1.0,4,88,84,96
187,seq276,r_110_172_199,r_260_179_123,r_260_179_123,1.0,11,134,123,96
167,seq217,r_181_121_172,r_38_123_146,r_38_123_146,0.95,26,172,146,96
6,r_204_140_68,seq205,seq283,r_204_140_68,1.0,0,68,68,96
19,r_203_83_29,r_98_97_84,r_215_107_146,r_203_83_29,1.0,0,29,29,96
99,r_297_62_174,seq278,seq6,r_297_62_174,0.77,0,174,174,96
161,seq193,seq285,r_225_292_114,r_225_292_114,0.99,-2,112,114,96
8,r_210_95_25,r_297_62_174,seq39,r_210_95_25,1.0,0,25,25,96
27,r_132_65_90,seq180,r_94_265_84,r_94_265_84,0.93,6,90,84,96
51,r_215_107_146,r_203_83_29,r_199_88_135,r_215_107_146,0.62,0,146,146,96
87,r_150_231_90,r_34_229_196,r_130_142_76,r_150_231_90,0.99,0,90,90,96
92,r_7_85_16,r_34_229_196,r_270_69_6,r_34_229_196,0.61,-183,13,196,96
2,r_122_15_101,r_46_201_185,seq284,r_122_15_101,0.98,0,101,101,96
47,r_144_272_128,seq168,seq242,r_144_272_128,0.9,0,128,128,96
40,r_111_115_107,seq75,r_223_263_20,r_111_115_107,1.0,0,107,107,96
74,r_233_141_88,seq155,seq160,r_233_141_88,1.0,1,89,88,96
24,r_38_123_146,seq9,seq11,r_38_123_146,0.99,0,146,146,96
82,r_190_212_28,r_171_1_59,seq90,r_190_212_28,1.0,0,28,28,96
34,r_220_218_51,r_237_102_89,seq58,r_220_218_51,1.0,0,51,51,96
33,r_130_142_76,r_91_17_116,r_124_21_42,r_91_17_116,0.52,-40,76,116,96
3,r_47_45_29,r_240_277_159,seq13,r_47_45_29,0.94,0,29,29,96
17,r_280_164_38,r_171_1_59,seq296,r_280_164_38,1.0,0,38,38,96
64,r_57_145_101,seq76,r_44_198_88,r_57_145_101,0.95,0,101,101,96
190,seq283,r_114_68_186,r_204_140_68,r_204_140_68,1.0,7,75,68,96
58,r_219_191_102,seq161,r_291_71_5,r_219_191_102,1.0,2,104,102,96
65,r_25_19_142,seq24,r_101_99_130,r_25_19_142,0.95,1,143,142,96
16,r_82_112_23,seq296,seq222,r_82_112_23,0.62,0,23,23,96
137,seq120,r_240_277_159,seq147,r_240_277_159,1.0,1,160,159,96
38,r_151_159_62,seq283,r_199_88_135,r_151_159_62,1.0,0,62,62,96
52,r_114_68_186,seq196,r_44_198_88,r_114_68_186,0.42,0,186,186,96
44,r_124_21_42,r_57_145_101,seq278,r_124_21_42,1.0,0,42,42,96
77,r_48_170_162,seq252,r_122_15_101,r_122_15_101,0.68,63,164,101,96
66,r_244_239_27,r_124_21_42,seq168,r_244_239_27,0.93,0,27,27,96
154,seq166,r_46_201_185,r_32_51_5,r_46_201_185,0.21,0,185,185,96
69,r_230_173_29,r_124_21_42,r_223_263_20,r_230_173_29,0.96,0,29,29,96
75,r_260_179_123,seq43,seq276,r_260_179_123,0.96,0,123,123,96
89,r_134_269_80,r_248_152_24,seq284,r_134_269_80,0.99,0,80,80,96
60,r_298_103_145,seq37,r_47_45_29,r_298_103_145,1.0,0,145,145,96
45,r_18_254_5,r_40_273_3,r_91_17_116,r_91_17_116,1.0,29,145,116,96
173,seq242,seq205,r_144_272_128,r_144_272_128,1.0,25,153,128,96
94,r_46_201_185,seq166,r_42_169_147,r_42_169_147,0.96,38,185,147,96
144,seq147,r_54_185_124,seq262,r_54_185_124,0.62,2,126,124,96
9,r_181_121_172,r_118_74_172,r_91_17_116,r_91_17_116,0.99,63,179,116,96
145,seq153,seq255,r_211_178_125,r_211_178_125,0.98,1,126,125,96
51,r_215_107_146,r_34_229_196,r_203_83_29,r_203_83_29,0.99,6,35,29,96
22,r_42_169_147,seq252,r_244_239_27,r_42_169_147,0.9,0,147,147,96
102,seq9,r_38_123_146,r_221_55_106,r_38_123_146,1.0,-1,145,146,96
97,r_186_79_41,r_270_69_6,r_248_152_24,r_270_69_6,0.6,35,41,6,96
49,r_138_234_133,seq11,r_210_95_25,r_210_95_25,0.89,108,133,25,96
131,seq104,r_94_265_84,r_291_71_5,r_94_265_84,1.0,-2,82,84,96
23,r_101_99_130,seq80,r_25_19_142,r_101_99_130,0.94,5,135,130,96
108,seq24,r_25_19_142,seq158,r_25_19_142,0.99,1,143,142,96
89,r_134_269_80,r_114_68_186,r_248_152_24,r_248_152_24,0.95,23,47,24,96
79,r_36_177_79,r_122_15_101,seq268,r_36_177_79,1.0,0,79,79,96
183,seq268,r_246_14_147,r_36_177_79,r_36_177_79,0.93,6,85,79,96
46,r_89_61_27,r_204_140_68,seq157,r_89_61_27,1.0,0,27,27,96
84,r_49_200_95,seq90,seq252,r_49_200_95,0.91,2,97,95,96
93,r_259_146_172,seq242,r_56_200_59,r_56_200_59,1.0,116,175,59,97
30,r_211_171_186,r_22_218_130,r_291_93_181,r_22_218_130,1.0,0,130,130,97
36,r_33_138_65,seq269,seq68,r_33_138_65,1.0,0,65,65,97
92,r_75_98_114,seq235,r_279_23_109,r_279_23_109,0.67,6,115,109,97
8,r_194_80_97,r_31_212_105,r_94_250_73,r_194_80_97,1.0,0,97,97,97
53,r_127_196_140,seq34,seq213,r_127_196_140,0.98,0,140,140,97
54,r_88_260_127,r_104_35_133,seq103,r_88_260_127,0.96,2,129,127,97
83,r_292_19_153,r_287_217_179,r_144_230_46,r_287_217_179,0.58,-26,153,179,97
116,seq51,seq122,r_69_253_146,r_69_253_146,0.98,15,161,146,97
37,r_275_92_161,seq113,seq236,r_275_92_161,0.52,3,164,161,97
39,r_1_263_21,r_42_2_187,seq195,r_1_263_21,1.0,0,21,21,97
19,r_106_273_150,r_27_29_54,r_163_7_147,r_106_273_150,0.98,0,150,150,97
55,r_153_272_127,r_129_15_139,r_81_82_27,r_153_272_127,0.97,0,127,127,97
71,r_145_149_82,r_106_273_150,r_184_199_83,r_106_273_150,1.0,-67,83,150,97
86,r_262_99_156,seq277,r_194_80_97,r_262_99_156,0.91,0,156,156,97
16,r_233_110_86,r_284_251_7,seq266,r_233_110_86,0.62,2,88,86,97
21,r_63_32_183,seq124,r_287_217_179,r_63_32_183,0.32,0,183,183,97
97,r_256_76_99,r_172_210_186,seq193,r_256_76_99,0.92,-2,97,99,97
80,r_142_222_45,r_60_186_129,seq109,r_60_186_129,1.0,0,129,129,97
46,r_223_227_158,seq54,r_163_7_147,r_223_227_158,0.9,0,158,158,97
69,r_8_268_86,seq289,seq65,r_8_268_86,0.74,5,91,86,97
6,r_14_246_33,r_154_4_44,seq30,r_14_246_33,1.0,2,35,33,97
19,r_106_273_150,r_145_149_82,r_27_29_54,r_106_273_150,1.0,-67,83,150,97
70,r_206_244_53,r_127_196_140,seq113,r_206_244_53,0.96,0,53,53,97
153,seq173,r_10_252_148,r_111_86_41,r_111_86_41,0.87,108,149,41,97
95,r_17_55_64,r_72_226_117,r_163_7_147,r_17_55_64,0.96,0,64,64,97
66,r_48_28_160,r_287_217_179,r_62_248_26,r_48_28_160,0.54,4,164,160,97
76,r_288_255_159,seq283,r_163_7_147,r_288_255_159,0.89,0,159,159,97
31,r_104_35_133,r_88_260_127,seq264,r_104_35_133,0.96,0,133,133,97
67,r_239_3_175,seq103,seq5,r_239_3_175,0.4,0,175,175,97
23,r_150_116_26,r_243_180_195,seq299,r_150_116_26,0.53,0,26,26,97
72,r_296_118_153,seq283,r_132_247_2,r_296_118_153,0.79,0,153,153,97
179,seq235,r_75_98_114,r_169_102_68,r_169_102_68,1.0,12,80,68,97
58,r_144_230_46,r_88_260_127,seq235,r_144_230_46,0.99,0,46,46,97
73,r_10_252_148,seq173,r_249_168_12,r_10_252_148,0.68,1,149,148,97
2,r_39_164_35,r_14_246_33,r_88_260_127,r_88_260_127,1.0,-85,42,127,97
20,r_295_267_171,seq47,r_39_164_35,r_39_164_35,1.0,137,172,35,97
13,r_192_9_91,seq204,r_91_53_30,r_91_53_30,0.99,67,97,30,97
98,r_188_135_116,seq277,seq25,r_188_135_116,0.91,1,117,116,97
166,seq203,r_112_175_183,r_157_21_24,r_157_21_24,0.82,159,183,24,97
48,r_287_217_179,r_136_61_101,r_95_133_38,r_287_217_179,0.93,-76,103,179,97
57,r_279_23_109,seq207,seq264,r_279_23_109,0.94,0,109,109,97
2,r_39_164_35,r_88_260_127,r_211_171_186,r_88_260_127,1.0,2,129,127,97
15,r_77_201_43,r_119_232_141,seq16,r_77_201_43,1.0,0,43,43,97
134,seq103,r_239_3_175,r_88_260_127,r_88_260_127,0.99,51,178,127,97
10,r_27_29_54,r_106_273_150,r_256_76_99,r_27_29_54,0.95,96,150,54,97
27,r_94_250_73,r_284_251_7,seq299,r_94_250_73,0.87,2,75,73,97
87,r_134_84_103,seq264,seq16,r_134_84_103,1.0,0,103,103,97
90,r_240_278_55,seq143,r_154_4_44,r_240_278_55,0.92,0,55,55,97
47,r_121_6_66,seq160,r_62_248_26,r_121_6_66,1.0,2,68,66,97
60,r_130_294_35,seq87,seq159,r_130_294_35,0.89,0,35,35,97
40,r_31_212_105,seq41,seq122,r_31_212_105,1.0,0,105,105,97
74,r_64_190_169,seq280,r_132_247_2,r_64_190_169,0.44,0,169,169,97
29,r_129_15_139,seq71,r_69_253_146,r_69_253_146,0.98,9,155,146,97
195,seq290,seq177,r_67_83_86,r_67_83_86,1.0,0,86,86,97
25,r_156_245_132,r_10_252_148,r_192_9_91,r_156_245_132,1.0,1,133,132,97
33,r_56_200_59,seq65,seq44,r_56_200_59,1.0,1,60,59,97
48,r_287_217_179,r_95_133_38,seq12,r_287_217_179,0.6,0,179,179,97
88,r_220_141_64,r_127_196_140,r_8_268_86,r_127_196_140,0.82,-56,84,140,97
190,seq277,r_262_99_156,seq274,r_262_99_156,1.0,0,156,156,97
50,r_66_281_152,seq59,seq73,r_66_281_152,0.58,1,153,152,97
65,r_117_231_167,seq26,r_249_168_12,r_117_231_167,0.86,0,167,167,97
192,seq283,r_288_255_159,seq219,r_288_255_159,1.0,0,159,159,97
68,r_136_61_101,r_287_217_179,seq204,r_136_61_101,0.99,2,103,101,97
61,r_158_115_120,r_58_224_194,seq228,r_158_115_120,1.0,0,120,120,97
32,r_169_102_68,seq289,seq235,r_169_102_68,1.0,0,68,68,97
0,r_111_86_41,r_67_83_86,seq43,r_111_86_41,1.0,1,42,41,97
26,r_249_168_12,seq298,seq71,r_249_168_12,0.94,0,12,12,97
52,r_91_53_30,seq18,seq160,r_91_53_30,1.0,0,30,30,97
34,r_97_282_103,seq73,r_14_246_33,r_14_246_33,0.95,78,111,33,97
75,r_254_46_84,r_156_245_132,r_192_9_91,r_192_9_91,0.98,-7,84,91,97
62,r_95_133_38,r_262_99_156,seq297,r_95_133_38,1.0,0,38,38,97
81,r_57_176_102,r_262_99_156,r_206_244_53,r_57_176_102,0.96,0,102,102,97
17,r_37_13_66,seq181,seq20,r_37_13_66,0.97,-1,65,66,97
9,r_258_225_120,seq12,r_111_86_41,r_258_225_120,0.98,0,120,120,97
3,r_154_4_44,r_75_98_114,seq185,r_154_4_44,0.89,2,46,44,97
96,r_112_175_183,seq203,r_95_133_38,r_95_133_38,0.88,145,183,38,97
120,seq68,seq70,r_33_138_65,r_33_138_65,1.0,1,66,65,97
18,r_261_265_28,r_287_217_179,r_1_263_21,r_261_265_28,0.64,0,28,28,97
89,r_209_183_51,r_156_245_132,r_284_251_7,r_209_183_51,1.0,0,51,51,97
11,r_241_161_12,r_194_80_97,seq214,r_241_161_12,0.93,0,12,12,97
123,seq73,r_97_282_103,r_105_270_189,r_97_282_103,0.67,11,114,103,97
10,r_27_29_54,r_162_120_138,r_106_273_150,r_27_29_54,1.0,1,55,54,97
102,seq12,r_258_225_120,r_132_247_2,r_258_225_120,0.99,0,120,120,97
80,r_142_222_45,seq264,r_60_186_129,r_142_222_45,0.97,0,45,45,97
194,seq289,r_169_102_68,r_24_52_9,r_169_102_68,1.0,0,68,68,97
56,r_40_50_55,r_119_232_141,seq16,r_40_50_55,1.0,0,55,55,97
44,r_22_218_130,r_211_171_186,seq90,r_22_218_130,0.97,0,130,130,97
118,seq59,r_66_281_152,r_206_244_53,r_206_244_53,0.63,100,153,53,97
22,r_157_21_24,r_233_110_86,seq203,r_157_21_24,1.0,1,25,24,97
85,r_151_182_42,seq70,seq237,r_151_182_42,1.0,0,42,42,97
138,seq124,r_63_32_183,r_206_244_53,r_206_244_53,1.0,130,183,53,97
82,r_69_253_146,seq54,seq51,r_69_253_146,0.81,0,146,146,97
12,r_67_83_86,r_275_92_161,seq290,r_67_83_86,1.0,1,87,86,97
95,r_17_55_64,r_163_7_147,seq101,r_17_55_64,0.72,85,149,64,97
84,r_131_108_144,seq213,r_144_230_46,r_144_230_46,0.95,103,149,46,97
176,seq217,r_31_152_95,r_110_63_118,r_110_63_118,0.81,12,130,118,98
19,r_129_282_36,r_136_192_162,r_46_209_10,r_129_282_36,1.0,0,36,36,98
86,r_140_109_15,r_93_39_167,seq65,r_140_109_15,1.0,0,15,15,98
95,r_78_220_46,seq174,r_81_14_43,r_78_220_46,1.0,1,47,46,98
92,r_239_201_95,r_139_67_131,seq50,r_239_201_95,1.0,0,95,95,98
14,r_10_286_179,r_24_266_192,r_280_60_165,r_280_60_165,0.64,14,179,165,98
54,r_86_261_157,r_250_85_163,seq4,r_86_261_157,0.88,2,159,157,98
99,r_292_233_36,r_90_240_132,seq151,r_292_233_36,1.0,0,36,36,98
53,r_108_229_83,r_38_128_183,seq173,r_108_229_83,1.0,0,83,83,98
89,r_127_64_12,r_179_244_111,seq76,r_127_64_12,1.0,0,12,12,98
54,r_86_261_157,r_52_48_140,r_250_85_163,r_52_48_140,0.9,0,140,140,98
83,r_20_158_96,r_257_272_195,seq99,r_20_158_96,1.0,0,96,96,98
37,r_254_21_181,r_154_133_196,r_202_213_69,r_254_21_181,0.44,0,181,181,98
59,r_139_67_131,r_239_201_95,r_290_79_194,r_239_201_95,1.0,0,95,95,98
21,r_31_152_95,seq217,seq171,r_31_152_95,0.47,35,130,95,98
39,r_103_246_48,r_196_157_129,seq23,r_103_246_48,0.7,22,70,48,98
1,r_110_63_118,r_250_85_163,seq217,r_250_85_163,0.69,-44,119,163,98
97,r_26_289_137,seq260,seq132,r_26_289_137,0.95,1,138,137,98
5,r_53_112_172,seq76,r_129_282_36,r_53_112_172,0.72,0,172,172,98
104,seq4,seq7,r_86_261_157,r_86_261_157,1.0,1,158,157,98
46,r_199_263_144,r_6_138_129,r_230_83_107,r_230_83_107,0.95,25,132,107,98
42,r_87_270_102,r_154_133_196,r_140_109_15,r_87_270_102,1.0,0,102,102,98
80,r_41_19_78,r_277_97_97,seq208,r_41_19_78,0.69,2,80,78,98
59,r_139_67_131,r_290_79_194,seq61,r_139_67_131,0.9,0,131,131,98
69,r_49_231_81,r_168_143_120,r_81_14_43,r_168_143_120,0.56,-39,81,120,98
45,r_93_39_167,seq283,r_197_80_74,r_93_39_167,0.8,0,167,167,98
158,seq173,seq42,r_108_229_83,r_108_229_83,1.0,14,97,83,98
67,r_146_281_194,r_98_72_161,r_199_263_144,r_199_263_144,1.0,18,162,144,98
84,r_271_190_144,r_135_195_87,r_52_48_140,r_271_190_144,0.84,0,144,144,98
10,r_234_291_125,seq150,seq145,r_234_291_125,1.0,0,125,125,98
61,r_258_249_44,r_179_244_111,r_118_95_196,r_258_249_44,1.0,0,44,44,98
40,r_81_14_43,seq171,seq59,r_81_14_43,0.66,2,45,43,98
63,r_222_252_91,r_154_133_196,seq8,r_222_252_91,0.92,0,91,91,98
73,r_163_251_122,seq23,r_212_5_95,r_212_5_95,0.95,28,123,95,98
31,r_159_92_32,r_38_128_183,seq74,r_159_92_32,1.0,0,32,32,98
13,r_70_165_134,r_73_94_41,r_34_219_15,r_70_165_134,0.84,0,134,134,98
50,r_256_225_23,r_290_79_194,r_127_64_12,r_256_225_23,0.75,0,23,23,98
48,r_101_141_129,seq156,seq185,r_101_141_129,0.9,1,130,129,98
20,r_33_189_49,r_236_91_184,r_129_282_36,r_33_189_49,0.97,3,52,49,98
57,r_184_215_32,r_53_112_172,seq283,r_184_215_32,1.0,0,32,32,98
52,r_275_161_33,r_56_126_74,r_202_213_69,r_56_126_74,0.91,-4,70,74,98
36,r_181_203_17,seq3,r_170_164_3,r_181_203_17,1.0,0,17,17,98
6,r_119_137_115,seq28,seq23,r_119_137_115,0.8,0,115,115,98
62,r_280_60_165,seq156,r_239_201_95,r_239_201_95,1.0,74,169,95,98
85,r_56_126_74,seq156,r_69_134_5,r_56_126_74,1.0,0,74,74,98
27,r_250_85_163,seq208,seq174,r_250_85_163,0.83,1,164,163,98
87,r_29_55_118,r_86_261_157,seq260,r_29_55_118,0.96,1,119,118,98
2,r_230_83_107,r_110_63_118,r_11_232_13,r_230_83_107,0.95,0,107,107,98
105,seq7,r_176_117_170,r_124_9_104,r_124_9_104,0.83,42,146,104,98
65,r_205_105_38,r_265_191_158,seq156,r_205_105_38,0.96,0,38,38,98
18,r_245_183_118,r_176_117_170,r_73_94_41,r_245_183_118,0.99,0,118,118,98
24,r_136_192_162,seq37,r_265_191_158,r_136_192_162,0.93,0,162,162,98
25,r_297_160_177,seq268,r_93_39_167,r_297_160_177,0.68,0,177,177,98
33,r_106_82_91,seq264,r_41_19_78,r_106_82_91,1.0,1,92,91,98
82,r_34_219_15,r_245_183_118,r_136_192_162,r_34_219_15,0.95,3,18,15,98
82,r_34_219_15,r_136_192_162,r_70_165_134,r_34_219_15,0.94,140,155,15,98
88,r_98_72_161,r_146_281_194,seq167,r_98_72_161,0.56,1,162,161,98
66,r_255_228_47,r_154_133_196,r_205_105_38,r_255_228_47,0.54,0,47,47,98
58,r_265_191_158,seq47,r_136_192_162,r_136_192_162,0.97,2,164,162,98
70,r_212_5_95,seq37,r_243_296_64,r_212_5_95,0.89,0,95,95,98
192,seq283,r_93_39_167,r_184_215_32,r_184_215_32,0.81,92,124,32,98
68,r_40_178_64,r_224_107_173,seq216,r_40_178_64,1.0,0,64,64,98
23,r_22_123_33,r_118_95_196,seq216,r_22_123_33,0.99,0,33,33,98
38,r_235_193_77,r_212_5_95,seq3,r_235_193_77,1.0,0,77,77,98
77,r_170_164_3,r_168_143_120,r_181_203_17,r_170_164_3,0.68,71,74,3,98
70,r_212_5_95,r_243_296_64,r_163_251_122,r_163_251_122,1.0,-3,119,122,98
76,r_73_94_41,r_86_261_157,seq167,r_86_261_157,0.98,2,159,157,98
34,r_96_113_99,r_110_63_118,seq68,r_96_113_99,0.94,0,99,99,98
75,r_221_144_190,seq8,r_121_100_3,r_121_100_3,0.85,187,190,3,98
132,seq71,r_262_30_69,r_199_263_144,r_199_263_144,1.0,14,158,144,98
46,r_199_263_144,r_230_83_107,seq71,r_199_263_144,0.74,0,144,144,98
60,r_278_241_164,seq74,r_84_36_8,r_278_241_164,0.78,0,164,164,98
47,r_135_195_87,r_271_190_144,r_129_282_36,r_271_190_144,1.0,0,144,144,98
81,r_52_48_140,r_86_261_157,seq188,r_52_48_140,0.86,0,140,140,98
17,r_69_134_5,r_176_117_170,r_155_288_64,r_155_288_64,1.0,106,170,64,98
52,r_275_161_33,r_93_39_167,r_56_126_74,r_275_161_33,1.0,0,33,33,98
94,r_149_223_106,seq122,seq23,r_149_223_106,0.89,2,108,106,98
9,r_155_288_64,r_86_261_157,r_69_134_5,r_155_288_64,1.0,0,64,64,98
96,r_197_80_74,r_176_117_170,seq125,r_197_80_74,1.0,0,74,74,98
12,r_118_95_196,seq43,r_258_249_44,r_258_249_44,1.0,1,45,44,98
76,r_73_94_41,r_70_165_134,r_86_261_157,r_73_94_41,0.79,6,47,41,98
28,r_168_143_120,seq153,seq174,r_168_143_120,1.0,0,120,120,98
91,r_257_272_195,r_20_158_96,seq188,r_20_158_96,1.0,0,96,96,98
49,r_277_97_97,r_262_30_69,r_292_233_36,r_277_97_97,1.0,0,97,97,98
149,seq150,r_234_291_125,r_73_94_41,r_234_291_125,0.96,0,125,125,98
98,r_186_274_53,r_56_126_74,r_84_36_8,r_186_274_53,1.0,0,53,53,98
7,r_202_213_69,r_20_158_96,r_275_161_33,r_202_213_69,1.0,1,70,69,98
44,r_6_138_129,r_199_263_144,r_222_252_91,r_222_252_91,0.94,41,132,91,98
118,seq43,r_118_95_196,r_11_232_13,r_11_232_13,0.95,100,113,13,98
131,seq68,r_38_128_183,r_96_113_99,r_96_113_99,0.72,-2,97,99,98
138,seq99,r_236_91_184,r_20_158_96,r_20_158_96,1.0,13,109,96,98
79,r_196_157_129,r_24_266_192,r_186_274_53,r_186_274_53,1.0,106,159,53,98
74,r_116_18_23,r_110_63_118,seq35,r_116_18_23,0.83,2,25,23,98
8,r_11_232_13,r_110_63_118,seq37,r_11_232_13,1.0,0,13,13,98
4,r_66_298_37,r_106_82_91,seq61,r_66_298_37,0.7,0,37,37,98
84,r_271_190_144,seq57,r_135_195_87,r_271_190_144,0.31,-43,101,144,98
30,r_29_173_148,seq93,r_57_15_45,r_29_173_148,0.49,2,150,148,99
44,r_216_277_31,seq52,r_291_39_167,r_291_39_167,0.77,1,168,167,99
90,r_69_201_45,seq179,seq40,r_69_201_45,0.78,1,46,45,99
19,r_135_7_37,r_239_94_51,seq281,r_135_7_37,0.93,6,43,37,99
21,r_240_36_135,r_91_13_54,seq10,r_91_13_54,1.0,0,54,54,99
51,r_75_121_167,r_163_267_106,seq247,r_163_267_106,1.0,-9,97,106,99
36,r_263_34_147,seq290,r_175_58_135,r_263_34_147,1.0,0,147,147,99
14,r_210_56_78,r_175_58_135,seq207,r_210_56_78,1.0,0,78,78,99
53,r_32_185_88,r_184_160_132,seq297,r_32_185_88,1.0,0,88,88,99
59,r_83_0_38,r_47_124_123,r_257_74_170,r_47_124_123,0.56,-82,41,123,99
43,r_162_102_120,r_257_74_170,r_83_0_38,r_162_102_120,0.58,-15,105,120,99
83,r_22_120_77,seq109,seq274,r_22_120_77,0.94,1,78,77,99
105,seq27,seq79,r_233_196_150,r_233_196_150,1.0,11,161,150,99
55,r_218_142_153,r_113_170_124,seq187,r_113_170_124,0.7,0,124,124,99
16,r_80_81_64,seq250,r_91_13_54,r_91_13_54,1.0,11,65,54,99
39,r_20_127_123,seq60,seq64,r_20_127_123,0.89,0,123,123,99
1,r_252_251_82,seq132,r_53_188_30,r_252_251_82,1.0,0,82,82,99
97,r_296_85_87,r_175_58_135,r_174_46_17,r_296_85_87,1.0,0,87,87,99
5,r_25_9_116,seq297,seq134,r_25_9_116,0.99,0,116,116,99
46,r_150_226_68,r_83_0_38,r_233_196_150,r_150_226_68,1.0,0,68,68,99
42,r_280_261_88,r_20_127_123,r_178_181_152,r_280_261_88,1.0,0,88,88,99
80,r_273_191_108,seq297,seq111,r_273_191_108,0.91,0,108,108,99
166,seq199,r_38_144_118,r_31_84_10,r_31_84_10,0.74,1,11,10,99
45,r_209_140_57,r_66_270_10,seq148,r_209_140_57,1.0,0,57,57,99
72,r_53_188_30,r_180_189_166,seq214,r_53_188_30,1.0,1,31,30,99
62,r_82_166_16,r_252_251_82,seq141,r_82_166_16,0.98,0,16,16,99
184,seq255,r_298_204_188,r_272_232_31,r_272_232_31,1.0,138,169,31,99
68,r_229_126_35,seq111,seq118,r_229_126_35,0.99,2,37,35,99
31,r_103_133_169,seq182,r_240_36_135,r_103_133_169,0.78,0,169,169,99
41,r_256_193_84,seq242,seq71,r_256_193_84,1.0,0,84,84,99
89,r_284_288_121,r_236_212_155,r_104_137_54,r_104_137_54,0.99,67,121,54,99
76,r_225_119_10,r_238_222_95,r_155_26_185,r_225_119_10,0.77,0,10,10,99
3,r_106_41_147,seq30,r_263_34_147,r_263_34_147,0.83,3,150,147,99
10,r_237_3_158,seq35,r_256_193_84,r_237_3_158,0.59,0,158,158,99
47,r_145_282_12,r_239_94_51,r_225_119_10,r_145_282_12,0.81,0,12,12,99
127,seq95,r_107_206_41,r_174_46_17,r_174_46_17,1.0,2,19,17,99
26,r_244_23_180,seq292,r_29_173_148,r_244_23_180,0.7,0,180,180,99
93,r_12_215_113,r_83_0_38,r_138_45_164,r_138_45_164,0.56,-2,162,164,99
4,r_163_267_106,r_75_121_167,r_174_46_17,r_163_267_106,0.99,0,106,106,99
52,r_14_87_55,seq27,seq199,r_14_87_55,1.0,0,55,55,99
78,r_92_90_155,seq156,seq79,r_92_90_155,0.72,0,155,155,99
63,r_169_143_63,seq167,r_225_119_10,r_169_143_63,1.0,1,64,63,99
171,seq214,r_57_15_45,r_53_188_30,r_53_188_30,0.72,16,46,30,99
20,r_243_122_129,seq245,r_99_28_27,r_243_122_129,1.0,0,129,129,99
13,r_113_170_124,r_218_142_153,seq131,r_113_170_124,0.93,0,124,124,99
65,r_91_13_54,r_240_36_135,seq134,r_91_13_54,1.0,0,54,54,99
46,r_150_226_68,r_233_196_150,r_128_295_13,r_233_196_150,1.0,0,150,150,99
105,seq27,r_14_87_55,seq79,r_14_87_55,1.0,0,55,55,99
15,r_138_45_164,r_195_18_197,r_12_215_113,r_138_45_164,0.25,0,164,164,99
57,r_38_144_118,seq176,seq24,r_38_144_118,0.99,0,118,118,99
106,seq30,r_106_41_147,r_59_260_148,r_59_260_148,0.97,2,150,148,99
12,r_269_299_158,r_91_13_54,seq292,r_269_299_158,0.99,0,158,158,99
187,seq268,seq134,r_286_208_99,r_286_208_99,0.99,16,115,99,99
21,r_240_36_135,seq10,r_82_166_16,r_240_36_135,0.97,0,135,135,99
96,r_99_28_27,r_68_63_198,seq35,r_99_28_27,1.0,1,28,27,99
85,r_233_196_150,r_219_44_134,r_150_226_68,r_150_226_68,1.0,0,68,68,99
44,r_216_277_31,r_219_44_134,seq52,r_216_277_31,1.0,0,31,31,99
99,r_157_51_118,r_42_151_130,r_22_120_77,r_42_151_130,0.95,-12,118,130,99
161,seq182,r_103_133_169,r_184_160_132,r_184_160_132,0.62,37,169,132,99
45,r_209_140_57,r_113_170_124,r_66_270_10,r_66_270_10,0.86,1,11,10,99
172,seq217,r_72_149_102,seq52,r_72_149_102,1.0,-5,97,102,99
51,r_75_121_167,seq247,r_117_89_54,r_75_121_167,0.93,0,167,167,99
87,r_236_212_155,r_284_288_121,r_14_87_55,r_236_212_155,0.79,-34,121,155,99
79,r_257_74_170,r_83_0_38,seq217,r_83_0_38,0.58,133,171,38,99
67,r_128_295_13,seq220,r_11_202_26,r_128_295_13,0.64,2,15,13,99
2,r_172_192_44,r_243_122_129,seq294,r_172_192_44,0.87,0,44,44,99
41,r_256_193_84,seq71,r_237_3_158,r_237_3_158,1.0,10,168,158,99
59,r_83_0_38,r_257_74_170,r_162_102_120,r_257_74_170,0.96,1,171,170,99
37,r_155_26_185,r_128_295_13,r_225_119_10,r_225_119_10,0.9,0,10,10,99
195,seq290,r_243_122_129,r_2_279_69,r_2_279_69,0.52,28,97,69,99
66,r_272_232_31,r_273_191_108,seq255,r_272_232_31,1.0,0,31,31,99
18,r_117_89_54,r_269_299_158,seq156,r_117_89_54,0.92,0,54,54,99
24,r_190_6_61,r_106_41_147,r_99_28_27,r_190_6_61,1.0,0,61,61,99
84,r_66_270_10,r_209_140_57,r_57_15_45,r_209_140_57,1.0,-2,55,57,99
87,r_236_212_155,r_14_87_55,r_5_259_49,r_236_212_155,0.98,0,155,155,99
25,r_72_149_102,seq217,r_108_158_59,r_72_149_102,0.9,0,102,102,99
64,r_19_278_168,r_112_200_109,r_280_261_88,r_19_278_168,1.0,-60,108,168,99
88,r_291_39_167,seq79,r_216_277_31,r_216_277_31,0.57,137,168,31,99
85,r_233_196_150,r_150_226_68,seq27,r_233_196_150,1.0,0,150,150,99
50,r_59_260_148,seq109,seq297,r_59_260_148,0.66,0,148,148,99
58,r_112_200_109,r_19_278_168,seq60,r_112_200_109,1.0,-1,108,109,99
70,r_104_137_54,seq294,r_284_288_121,r_284_288_121,1.0,27,148,121,99
38,r_238_222_95,seq73,seq292,r_238_222_95,1.0,0,95,95,99
76,r_225_119_10,r_155_26_185,r_180_189_166,r_155_26_185,0.63,-1,184,185,99
73,r_31_84_10,r_283_37_158,seq199,r_31_84_10,0.99,0,10,10,99
34,r_276_16_153,seq294,r_227_61_89,r_227_61_89,0.87,66,155,89,99
69,r_5_259_49,r_243_122_129,seq182,r_5_259_49,1.0,0,49,49,99
6,r_239_94_51,seq289,seq141,r_239_94_51,1.0,0,51,51,99
64,r_19_278_168,r_280_261_88,seq49,r_19_278_168,0.89,0,168,168,99
75,r_178_181_152,r_103_133_169,r_280_261_88,r_280_261_88,1.0,63,151,88,99
132,seq109,r_59_260_148,r_115_221_72,r_115_221_72,0.98,74,146,72,99
48,r_55_65_49,seq10,r_175_58_135,r_55_65_49,1.0,0,49,49,99
60,r_105_231_163,seq141,r_162_102_120,r_105_231_163,0.74,0,163,163,99
150,seq156,r_92_90_155,r_117_89_54,r_117_89_54,0.97,43,97,54,99
81,r_62_8_120,r_47_124_123,seq176,r_62_8_120,0.97,0,120,120,99
168,seq207,seq148,r_210_56_78,r_210_56_78,1.0,22,100,78,99
94,r_184_160_132,seq281,seq182,r_184_160_132,0.93,1,133,132,99
9,r_286_208_99,seq77,seq268,r_286_208_99,0.93,-2,97,99,99
145,seq141,r_105_231_163,r_240_36_135,r_240_36_135,0.76,28,163,135,99
37,r_155_26_185,r_225_119_10,r_172_192_44,r_155_26_185,0.63,-1,184,185,99
22,r_47_124_123,seq49,seq30,r_47_124_123,0.98,0,123,123,99
91,r_115_221_72,seq21,r_69_201_45,r_115_221_72,0.86,0,72,72,99
49,r_219_44_134,r_233_196_150,seq214,r_219_44_134,0.93,0,134,134,99
27,r_11_202_26,r_180_189_166,r_128_295_13,r_11_202_26,0.89,16,42,26,99
149,seq154,r_183_246_182,r_172_192_44,r_172_192_44,1.0,139,183,44,99
7,r_283_37_158,r_265_96_193,r_106_41_147,r_283_37_158,0.67,0,158,158,99
23,r_2_279_69,seq97,seq290,r_2_279_69,1.0,0,69,69,99
55,r_218_142_153,seq187,r_263_34_147,r_218_142_153,0.64,4,157,153,99
35,r_42_151_130,r_298_204_188,seq214,r_42_151_130,0.99,0,130,130,99
12,r_269_299_158,seq159,r_91_13_54,r_91_13_54,1.0,6,60,54,99
79,r_257_74_170,r_162_102_120,r_83_0_38,r_83_0_38,0.84,17,55,38,99
74,r_57_15_45,seq214,r_66_270_10,r_57_15_45,0.82,1,46,45,99
199,seq297,r_273_191_108,r_32_185_88,r_32_185_88,0.64,9,97,88,99
