8,r_2_60_166,seq27,seq54,r_2_60_166,0.68,0,166,166,0
16,r_23_29_11,seq38,seq64,r_23_29_11,0.9,-1,10,11,0
10,r_17_52_143,r_44_25_111,r_43_73_49,r_17_52_143,0.83,0,143,143,0
3,r_43_73_49,seq24,r_17_52_143,r_17_52_143,0.88,1,144,143,0
19,r_42_45_116,r_16_20_182,seq9,r_42_45_116,0.93,0,116,116,0
11,r_19_35_104,r_0_37_14,r_16_20_182,r_0_37_14,0.58,-4,10,14,0
21,r_28_26_166,r_70_3_81,seq24,r_70_3_81,0.98,2,83,81,0
46,seq65,seq38,r_67_56_41,r_67_56_41,0.64,84,125,41,0
11,r_19_35_104,r_16_20_182,seq66,r_19_35_104,1.0,0,104,104,0
13,r_4_53_135,seq27,seq38,r_4_53_135,0.99,0,135,135,0
4,r_44_25_111,seq71,r_17_52_143,r_44_25_111,0.77,0,111,111,0
0,r_21_46_101,r_16_20_182,seq55,r_21_46_101,0.9,3,104,101,0
23,r_72_57_67,r_19_35_104,seq12,r_19_35_104,1.0,0,104,104,0
6,r_70_3_81,r_28_26_166,r_41_36_3,r_70_3_81,1.0,1,82,81,0
21,r_28_26_166,seq24,r_72_57_67,r_28_26_166,0.75,21,187,166,0
3,r_43_73_49,r_17_52_143,seq24,r_43_73_49,0.99,1,50,49,0
17,r_11_48_44,seq22,r_0_37_14,r_11_48_44,1.0,0,44,44,0
12,r_67_56_41,seq40,seq8,r_67_56_41,0.99,0,41,41,0
2,r_18_63_77,seq55,seq39,r_18_63_77,1.0,0,77,77,0
41,seq51,r_19_35_104,r_11_48_44,r_19_35_104,0.65,60,164,104,0
47,seq66,r_32_68_75,r_19_35_104,r_32_68_75,1.0,29,104,75,0
4,r_44_25_111,r_17_52_143,seq9,r_17_52_143,1.0,2,145,143,0
18,r_74_15_52,seq55,r_43_73_49,r_74_15_52,1.0,2,54,52,0
10,r_17_52_143,r_59_50_192,r_44_25_111,r_44_25_111,0.99,1,112,111,0
38,seq39,r_2_60_166,r_18_63_77,r_18_63_77,0.99,4,81,77,0
20,r_61_5_26,r_42_45_116,seq7,r_61_5_26,0.98,1,27,26,0
1,r_0_37_14,r_19_35_104,r_2_60_166,r_0_37_14,1.0,0,14,14,0
24,r_49_30_199,r_2_60_166,r_11_48_44,r_11_48_44,0.65,10,54,44,0
22,r_32_68_75,seq27,seq66,r_32_68_75,1.0,0,75,75,0
28,seq9,r_59_50_192,r_42_45_116,r_42_45_116,1.0,34,150,116,0
49,seq71,r_44_25_111,seq7,r_44_25_111,1.0,0,111,111,0
1,r_0_37_14,r_2_60_166,r_11_48_44,r_11_48_44,0.81,10,54,44,0
7,r_33_6_63,r_2_60_166,seq9,r_33_6_63,1.0,0,63,63,0
19,r_42_45_116,r_61_5_26,r_16_20_182,r_61_5_26,0.51,4,30,26,0
23,r_72_57_67,r_44_25_111,r_19_35_104,r_72_57_67,0.99,0,67,67,0
10,r_17_52_143,r_43_73_49,r_59_50_192,r_43_73_49,1.0,4,53,49,0
30,seq11,r_57_70_175,r_25_46_126,r_57_70_175,0.54,-63,112,175,1
14,r_57_70_175,seq53,seq60,r_57_70_175,0.62,0,175,175,1
8,r_51_62_144,r_57_70_175,seq50,r_51_62_144,0.88,0,144,144,1
37,seq21,r_24_42_127,seq50,r_24_42_127,0.98,26,153,127,1
16,r_45_31_81,r_24_42_127,r_64_72_58,r_45_31_81,0.98,0,81,81,1
21,r_34_17_158,r_27_67_175,r_18_68_67,r_18_68_67,0.6,91,158,67,1
39,seq29,r_5_3_130,r_18_68_67,r_18_68_67,1.0,21,88,67,1
1,r_18_68_67,seq7,seq60,r_18_68_67,1.0,0,67,67,1
5,r_6_9_182,seq33,r_48_14_79,r_48_14_79,1.0,103,182,79,1
46,seq52,r_48_14_79,seq33,r_48_14_79,1.0,1,80,79,1
24,r_55_44_11,r_27_67_175,seq12,r_55_44_11,0.95,0,11,11,1
45,seq50,seq16,r_51_62_144,r_51_62_144,1.0,0,144,144,1
19,r_24_42_127,seq16,r_58_0_174,r_24_42_127,0.62,2,129,127,1
41,seq33,r_6_9_182,r_66_8_142,r_66_8_142,0.99,40,182,142,1
3,r_54_30_69,r_6_9_182,seq7,r_54_30_69,1.0,0,69,69,1
10,r_5_3_130,r_66_8_142,seq26,r_5_3_130,0.7,2,132,130,1
4,r_27_67_175,r_34_17_158,r_58_0_174,r_27_67_175,0.64,-17,158,175,1
0,r_71_43_184,seq49,r_58_0_174,r_58_0_174,0.72,10,184,174,1
11,r_47_28_190,seq26,r_18_68_67,r_18_68_67,1.0,123,190,67,1
20,r_35_38_144,r_5_3_130,r_48_14_79,r_48_14_79,0.99,-1,78,79,1
13,r_64_72_58,r_34_17_158,r_45_31_81,r_64_72_58,0.97,3,61,58,1
48,seq60,r_66_8_142,r_18_68_67,r_18_68_67,1.0,36,103,67,1
31,seq12,r_25_46_126,r_55_44_11,r_55_44_11,1.0,2,13,11,1
6,r_73_59_29,r_23_40_166,seq16,r_73_59_29,0.82,0,29,29,1
27,seq4,r_57_70_175,seq53,r_57_70_175,0.92,-31,144,175,1
22,r_48_14_79,r_35_38_144,r_18_68_67,r_35_38_144,0.85,4,148,144,1
47,seq53,r_57_70_175,seq4,r_57_70_175,0.91,-31,144,175,1
18,r_65_69_168,seq19,r_34_17_158,r_65_69_168,0.41,-1,167,168,1
19,r_24_42_127,r_58_0_174,r_56_22_119,r_58_0_174,1.0,1,175,174,1
20,r_35_38_144,r_48_14_79,seq15,r_35_38_144,0.85,2,146,144,1
38,seq26,r_47_28_190,r_5_3_130,r_5_3_130,0.96,60,190,130,1
17,r_58_0_174,r_23_40_166,r_27_67_175,r_58_0_174,0.71,-7,167,174,1
9,r_63_41_22,r_56_22_119,seq32,r_63_41_22,0.82,0,22,22,1
22,r_48_14_79,r_18_68_67,r_6_9_182,r_6_9_182,0.83,2,184,182,1
22,r_48_14_79,seq52,r_35_38_144,r_48_14_79,1.0,-1,78,79,1
7,r_23_40_166,r_58_0_174,r_56_22_119,r_56_22_119,0.8,48,167,119,1
44,seq49,r_71_43_184,r_56_22_119,r_56_22_119,1.0,65,184,119,1
23,r_66_8_142,seq60,seq33,r_66_8_142,0.87,0,142,142,1
35,seq19,r_56_22_119,seq7,r_56_22_119,0.98,-16,103,119,1
12,r_56_22_119,seq19,seq26,r_56_22_119,0.89,0,119,119,1
14,r_26_23_117,seq49,r_69_34_24,r_26_23_117,0.82,1,118,117,2
8,r_47_54_112,r_24_22_30,seq49,r_47_54_112,0.92,0,112,112,2
15,r_59_6_34,r_66_53_153,r_2_20_175,r_59_6_34,0.89,0,34,34,2
1,r_7_36_153,seq25,r_46_62_49,r_7_36_153,0.87,0,153,153,2
18,r_8_48_187,r_66_53_153,r_13_3_49,r_13_3_49,0.86,-4,45,49,2
16,r_69_34_24,seq73,seq29,r_69_34_24,0.97,0,24,24,2
19,r_38_14_103,r_15_55_93,seq29,r_38_14_103,1.0,0,103,103,2
15,r_59_6_34,r_2_20_175,r_11_39_105,r_11_39_105,1.0,71,176,105,2
31,seq29,r_63_57_90,r_11_39_105,r_63_57_90,0.8,4,94,90,2
41,seq58,seq50,r_51_60_182,r_51_60_182,0.48,-2,180,182,2
4,r_5_65_194,r_51_60_182,r_18_43_87,r_18_43_87,1.0,-10,77,87,2
0,r_15_55_93,r_38_14_103,r_10_1_22,r_38_14_103,0.7,1,104,103,2
13,r_18_43_87,r_47_54_112,r_35_12_59,r_18_43_87,0.93,-4,83,87,2
21,r_37_41_19,seq56,r_67_42_101,r_67_42_101,1.0,80,181,101,2
10,r_10_1_22,r_16_9_127,r_67_42_101,r_10_1_22,0.94,106,128,22,2
17,r_46_62_49,seq56,seq27,r_46_62_49,1.0,0,49,49,2
22,r_16_9_127,r_10_1_22,r_66_53_153,r_16_9_127,0.79,1,128,127,2
3,r_21_45_53,r_66_53_153,seq30,r_21_45_53,1.0,0,53,53,2
24,r_11_39_105,seq29,r_59_6_34,r_11_39_105,0.78,1,106,105,2
11,r_35_12_59,r_7_36_153,seq31,r_35_12_59,0.6,0,59,59,2
2,r_17_44_46,r_11_39_105,r_38_14_103,r_17_44_46,1.0,0,46,46,2
20,r_2_20_175,r_59_6_34,seq71,r_2_20_175,0.43,0,175,175,2
21,r_37_41_19,seq30,seq56,r_37_41_19,0.9,5,24,19,2
46,seq71,r_13_3_49,r_35_12_59,r_13_3_49,0.76,1,50,49,2
31,seq29,r_11_39_105,r_38_14_103,r_11_39_105,0.57,1,106,105,2
9,r_67_42_101,seq64,r_37_41_19,r_67_42_101,0.95,1,102,101,2
7,r_13_3_49,seq71,r_8_48_187,r_13_3_49,0.99,1,50,49,2
20,r_2_20_175,seq30,r_59_6_34,r_2_20_175,0.85,-144,31,175,2
22,r_16_9_127,r_46_62_49,r_10_1_22,r_16_9_127,0.94,-102,25,127,2
23,r_24_22_30,r_47_54_112,r_66_53_153,r_47_54_112,0.99,0,112,112,2
17,r_46_62_49,seq27,r_7_36_153,r_7_36_153,1.0,-2,151,153,2
2,r_17_44_46,r_38_14_103,r_10_1_22,r_38_14_103,1.0,0,103,103,2
10,r_10_1_22,r_8_48_187,r_16_9_127,r_10_1_22,0.96,2,24,22,2
12,r_63_57_90,seq29,seq56,r_63_57_90,1.0,4,94,90,2
36,seq29,r_3_18_181,r_52_33_99,r_52_33_99,0.94,82,181,99,3
3,r_64_51_51,r_74_1_127,r_31_53_130,r_74_1_127,0.96,4,131,127,3
5,r_4_24_60,r_3_18_181,r_44_23_63,r_3_18_181,0.89,-122,59,181,3
16,r_15_57_65,r_10_67_112,seq9,r_15_57_65,0.86,3,68,65,3
21,r_56_72_103,seq50,r_71_34_29,r_56_72_103,0.99,3,106,103,3
1,r_49_13_135,seq9,seq6,r_49_13_135,0.81,0,135,135,3
45,seq50,r_56_72_103,seq63,r_56_72_103,0.99,3,106,103,3
11,r_71_34_29,seq45,seq6,r_71_34_29,0.85,2,31,29,3
20,r_20_66_170,r_52_33_99,seq62,r_52_33_99,0.83,-57,42,99,3
26,seq8,r_61_48_130,r_74_1_127,r_74_1_127,0.95,31,158,127,3
14,r_70_12_152,r_10_67_112,r_73_14_91,r_70_12_152,0.53,19,171,152,3
4,r_0_59_99,seq50,seq62,r_0_59_99,0.99,1,100,99,3
0,r_74_1_127,r_64_51_51,seq8,r_74_1_127,0.85,2,129,127,3
37,seq30,r_27_55_94,r_73_14_91,r_73_14_91,0.78,-46,45,91,3
6,r_10_67_112,seq21,r_70_12_152,r_10_67_112,0.5,-3,109,112,3
10,r_39_65_115,r_74_1_127,r_4_24_60,r_4_24_60,0.75,56,116,60,3
2,r_27_55_94,seq36,seq50,r_27_55_94,0.72,0,94,94,3
47,seq62,r_20_66_170,r_0_59_99,r_0_59_99,0.85,71,170,99,3
18,r_52_33_99,r_20_66_170,seq35,r_52_33_99,0.95,1,100,99,3
3,r_64_51_51,r_40_38_117,r_74_1_127,r_64_51_51,0.51,8,59,51,3
6,r_10_67_112,r_70_12_152,r_73_14_91,r_70_12_152,0.82,0,152,152,3
37,seq30,r_73_14_91,r_64_51_51,r_73_14_91,0.45,5,96,91,3
20,r_20_66_170,seq62,r_61_48_130,r_20_66_170,0.81,0,170,170,3
9,r_32_37_29,r_4_24_60,seq43,r_32_37_29,1.0,0,29,29,3
22,r_3_18_181,seq29,r_4_24_60,r_4_24_60,0.99,121,181,60,3
41,seq43,r_7_5_169,r_32_37_29,r_32_37_29,0.99,0,29,29,3
10,r_39_65_115,seq47,r_74_1_127,r_39_65_115,0.57,-78,37,115,3
44,seq47,r_69_2_100,seq50,r_69_2_100,1.0,0,100,100,3
36,seq34,r_28_19_179,r_29_10_19,r_28_19_179,0.75,2,181,179,4
16,r_15_23_43,seq41,r_26_21_74,r_26_21_74,1.0,0,74,74,4
16,r_15_23_43,r_11_38_64,seq41,r_15_23_43,0.95,0,43,43,4
6,r_29_10_19,seq0,r_65_74_166,r_65_74_166,1.0,4,170,166,4
19,r_53_39_156,seq60,seq49,r_53_39_156,0.79,1,157,156,4
21,r_27_70_143,r_47_5_137,seq9,r_27_70_143,0.91,-1,142,143,4
5,r_57_16_121,seq56,seq12,r_57_16_121,0.98,0,121,121,4
46,seq58,r_61_66_153,r_25_67_71,r_25_67_71,1.0,2,73,71,4
45,seq56,r_57_16_121,seq18,r_57_16_121,0.97,-5,116,121,4
3,r_28_19_179,seq34,r_72_36_120,r_72_36_120,0.85,61,181,120,4
10,r_31_30_82,seq58,seq35,r_31_30_82,0.97,1,83,82,4
4,r_61_66_153,seq58,r_11_38_64,r_11_38_64,0.99,93,157,64,4
0,r_4_54_116,seq58,seq3,r_4_54_116,0.55,1,117,116,4
20,r_20_52_125,seq17,seq22,r_20_52_125,0.82,0,125,125,4
13,r_45_42_170,seq71,r_4_54_116,r_45_42_170,0.49,0,170,170,4
15,r_6_62_143,seq41,seq12,r_6_62_143,0.87,0,143,143,4
19,r_53_39_156,r_63_51_49,seq60,r_63_51_49,1.0,0,49,49,4
11,r_1_43_57,r_28_19_179,seq58,r_1_43_57,0.95,0,57,57,4
2,r_72_36_120,seq17,r_25_67_71,r_72_36_120,0.97,1,121,120,4
47,seq60,r_53_39_156,seq71,r_53_39_156,0.8,1,157,156,4
24,r_11_38_64,r_72_36_120,seq41,r_11_38_64,0.95,1,65,64,4
43,seq49,r_27_70_143,r_53_39_156,r_53_39_156,0.5,-7,149,156,4
33,seq18,seq56,r_25_67_71,r_25_67_71,1.0,89,160,71,4
22,r_63_51_49,r_53_39_156,seq48,r_63_51_49,1.0,0,49,49,4
1,r_37_33_28,r_28_19_179,seq64,r_37_33_28,1.0,0,28,28,4
17,r_47_5_137,r_27_70_143,r_63_51_49,r_47_5_137,0.97,2,139,137,4
9,r_25_67_71,r_47_5_137,r_1_43_57,r_25_67_71,0.99,1,72,71,4
28,seq9,seq22,r_27_70_143,r_27_70_143,1.0,13,156,143,4
7,r_55_2_123,r_68_69_198,seq17,r_55_2_123,0.66,0,123,123,4
23,r_26_21_74,r_53_39_156,r_15_23_43,r_26_21_74,0.79,1,75,74,4
12,r_65_74_166,seq50,r_29_10_19,r_65_74_166,0.8,0,166,166,4
44,seq68,r_27_8_25,r_25_11_139,r_25_11_139,1.0,36,175,139,5
14,r_59_32_85,seq26,seq44,r_59_32_85,1.0,0,85,85,5
8,r_9_66_66,r_6_14_194,seq54,r_9_66_66,0.97,3,69,66,5
16,r_36_20_151,r_35_49_172,r_52_1_91,r_35_49_172,0.76,-21,151,172,5
1,r_42_53_124,r_23_12_146,seq69,r_42_53_124,1.0,0,124,124,5
5,r_50_13_80,seq68,seq56,r_50_13_80,1.0,0,80,80,5
25,seq17,seq57,r_35_49_172,r_35_49_172,0.7,5,177,172,5
45,seq69,r_25_11_139,r_42_53_124,r_42_53_124,1.0,19,143,124,5
19,r_25_11_139,seq69,seq68,r_25_11_139,0.63,1,140,139,5
21,r_4_0_37,r_16_10_65,r_7_19_64,r_4_0_37,0.54,28,65,37,5
3,r_22_41_43,seq70,seq54,r_22_41_43,1.0,0,43,43,5
31,seq37,r_3_34_106,seq57,r_3_34_106,1.0,0,106,106,5
10,r_16_10_65,r_59_32_85,seq69,r_16_10_65,0.9,6,71,65,5
4,r_40_31_116,r_6_14_194,r_27_8_25,r_40_31_116,0.91,0,116,116,5
20,r_47_28_177,seq60,seq29,r_47_28_177,0.72,-1,176,177,5
13,r_3_34_106,seq37,seq45,r_3_34_106,0.99,0,106,106,5
15,r_72_15_71,r_36_20_151,seq26,r_72_15_71,0.87,0,71,71,5
48,seq73,r_36_20_151,r_23_12_146,r_36_20_151,0.79,0,151,151,5
6,r_7_19_64,r_59_32_85,r_4_0_37,r_7_19_64,1.0,1,65,64,5
2,r_52_1_91,r_63_55_123,r_2_64_64,r_63_55_123,1.0,-31,92,123,5
40,seq60,r_47_28_177,r_35_49_172,r_47_28_177,0.53,1,178,177,5
18,r_2_64_64,r_23_12_146,seq26,r_2_64_64,1.0,0,64,64,5
25,seq17,r_23_12_146,seq57,r_23_12_146,0.56,-9,137,146,5
21,r_4_0_37,seq29,r_16_10_65,r_4_0_37,0.93,0,37,37,5
38,seq56,r_35_49_172,r_50_13_80,r_50_13_80,1.0,94,174,80,5
0,r_51_30_99,seq70,seq45,r_51_30_99,0.78,-78,21,99,5
9,r_21_61_167,r_35_49_172,r_51_30_99,r_21_61_167,0.73,2,169,167,5
12,r_27_8_25,r_25_11_139,seq68,r_27_8_25,0.6,0,25,25,5
22,r_63_55_123,r_23_12_146,seq74,r_63_55_123,1.0,0,123,123,5
49,seq74,seq67,r_63_55_123,r_63_55_123,0.99,0,123,123,5
7,r_23_12_146,seq17,seq73,r_23_12_146,0.56,0,146,146,5
44,seq68,r_50_13_80,r_27_8_25,r_50_13_80,1.0,-7,73,80,5
23,r_43_58_180,seq69,r_35_49_172,r_43_58_180,0.35,0,180,180,5
36,seq41,seq19,r_40_70_94,r_40_70_94,1.0,6,100,94,6
14,r_33_55_61,r_20_60_97,r_53_4_198,r_33_55_61,1.0,1,62,61,6
14,r_33_55_61,r_53_4_198,r_20_60_97,r_20_60_97,0.89,5,102,97,6
16,r_11_38_140,seq27,r_33_55_61,r_11_38_140,0.55,0,140,140,6
21,r_24_63_62,seq19,seq12,r_24_63_62,0.99,6,68,62,6
39,seq50,seq19,r_28_9_89,r_28_9_89,1.0,5,94,89,6
4,r_59_29_48,seq51,seq46,r_59_29_48,0.86,0,48,48,6
5,r_62_3_150,seq65,r_39_21_160,r_62_3_150,0.39,2,152,150,6
45,seq65,r_8_49_131,r_47_30_60,r_47_30_60,1.0,13,73,60,6
47,seq72,r_37_14_27,r_15_16_141,r_37_14_27,0.56,14,41,27,6
41,seq52,r_17_56_142,r_47_30_60,r_47_30_60,1.0,85,145,60,6
35,seq35,r_15_16_141,r_43_31_30,r_43_31_30,0.7,22,52,30,6
10,r_28_9_89,r_36_6_198,seq50,r_28_9_89,0.95,0,89,89,6
0,r_40_70_94,r_36_6_198,seq41,r_40_70_94,1.0,0,94,94,6
11,r_8_49_131,r_62_3_150,seq32,r_8_49_131,0.73,-2,129,131,6
46,seq71,r_36_6_198,r_66_25_48,r_66_25_48,1.0,4,52,48,6
15,r_23_44_160,seq41,r_28_9_89,r_28_9_89,1.0,72,161,89,6
48,seq73,seq32,r_17_56_142,r_17_56_142,0.75,-3,139,142,6
4,r_59_29_48,seq46,r_67_10_37,r_59_29_48,0.36,92,140,48,6
1,r_42_48_46,r_17_56_142,seq64,r_42_48_46,1.0,2,48,46,6
6,r_66_25_48,seq51,seq71,r_66_25_48,1.0,2,50,48,6
2,r_15_16_141,seq35,r_39_21_160,r_15_16_141,0.54,-10,131,141,6
20,r_69_7_56,seq19,seq72,r_69_7_56,1.0,1,57,56,6
24,r_37_14_27,seq72,seq27,r_37_14_27,1.0,2,29,27,6
17,r_43_31_30,r_58_2_78,seq35,r_43_31_30,0.99,0,30,30,6
38,seq46,seq12,r_24_63_62,r_24_63_62,0.71,72,134,62,6
34,seq32,r_20_60_97,seq0,r_20_60_97,0.79,0,97,97,6
47,seq72,r_69_7_56,r_58_2_78,r_58_2_78,1.0,1,79,78,6
9,r_47_30_60,r_53_4_198,seq65,r_47_30_60,1.0,0,60,60,6
22,r_58_2_78,seq12,seq72,r_58_2_78,1.0,1,79,78,6
47,seq72,r_15_16_141,r_69_7_56,r_69_7_56,0.58,-2,54,56,6
14,r_33_55_61,r_20_60_97,r_11_38_140,r_11_38_140,1.0,5,145,140,6
9,r_47_30_60,seq18,r_53_4_198,r_47_30_60,0.49,-34,26,60,6
7,r_53_4_198,r_47_30_60,r_33_55_61,r_53_4_198,1.0,-136,62,198,6
44,seq64,seq12,r_42_48_46,r_42_48_46,1.0,29,75,46,6
19,r_67_10_37,r_5_68_128,seq12,r_67_10_37,1.0,0,37,37,6
12,r_17_56_142,seq52,seq73,r_17_56_142,0.71,3,145,142,6
3,r_34_57_38,r_59_29_48,seq19,r_34_57_38,0.92,0,38,38,6
30,seq14,r_32_1_3,r_53_4_82,r_53_4_82,1.0,3,85,82,7
37,seq33,r_66_22_183,r_71_56_109,r_71_56_109,0.99,74,183,109,7
1,r_9_51_70,seq24,seq12,r_9_51_70,1.0,0,70,70,7
5,r_31_73_82,r_52_67_110,r_0_40_26,r_31_73_82,1.0,0,82,82,7
19,r_25_28_74,r_32_1_3,seq19,r_25_28_74,0.82,28,102,74,7
3,r_38_26_80,seq20,r_37_72_199,r_38_26_80,1.0,0,80,80,7
4,r_74_23_193,r_53_4_82,r_0_40_26,r_53_4_82,0.96,-1,81,82,7
13,r_52_67_110,seq10,r_21_47_164,r_52_67_110,0.98,1,111,110,7
20,r_44_43_11,r_25_28_74,seq24,r_44_43_11,0.8,0,11,11,7
15,r_37_72_199,r_34_15_144,r_38_26_80,r_38_26_80,1.0,24,104,80,7
48,seq62,r_8_65_155,seq16,r_8_65_155,0.7,0,155,155,7
36,seq24,r_9_51_70,r_2_64_16,r_9_51_70,0.93,-16,54,70,7
0,r_0_40_26,r_6_68_195,r_74_23_193,r_0_40_26,0.99,0,26,26,7
27,seq10,r_52_67_110,seq50,r_52_67_110,1.0,1,111,110,7
2,r_70_36_173,seq63,r_53_4_82,r_53_4_82,1.0,93,175,82,7
18,r_21_47_164,r_69_29_133,r_52_67_110,r_21_47_164,0.82,-53,111,164,7
24,r_69_29_133,seq24,seq3,r_69_29_133,1.0,0,133,133,7
32,seq17,r_6_68_195,r_9_51_70,r_9_51_70,1.0,11,81,70,7
34,seq19,seq20,r_25_28_74,r_25_28_74,0.61,8,82,74,7
9,r_53_4_82,r_74_23_193,seq14,r_53_4_82,1.0,0,82,82,7
17,r_2_64_16,r_8_65_155,r_44_43_11,r_2_64_16,0.87,0,16,16,7
7,r_8_65_155,seq62,r_11_55_55,r_8_65_155,0.4,0,155,155,7
23,r_59_49_127,seq35,r_53_4_82,r_59_49_127,0.8,0,127,127,7
10,r_27_30_9,r_71_56_109,seq20,r_27_30_9,0.98,2,11,9,7
35,seq20,r_38_26_80,r_27_30_9,r_38_26_80,1.0,0,80,80,7
12,r_66_22_183,seq33,seq10,r_66_22_183,0.49,0,183,183,7
8,r_54_47_102,seq69,r_70_67_121,r_54_47_102,1.0,3,105,102,8
22,r_42_61_22,r_30_6_21,r_70_67_121,r_42_61_22,1.0,4,26,22,8
15,r_44_68_36,seq28,r_0_26_162,r_44_68_36,1.0,-1,35,36,8
12,r_7_18_54,seq43,seq72,r_7_18_54,1.0,0,54,54,8
37,seq36,r_37_58_190,r_20_21_32,r_37_58_190,0.46,0,190,190,8
21,r_56_10_114,r_0_26_162,r_16_59_35,r_56_10_114,1.0,0,114,114,8
5,r_19_15_85,seq5,r_30_6_21,r_19_15_85,0.93,0,85,85,8
19,r_70_67_121,r_22_24_106,r_42_61_22,r_70_67_121,0.87,-14,107,121,8
15,r_44_68_36,r_0_26_162,r_52_50_92,r_44_68_36,0.73,94,130,36,8
28,seq13,seq41,r_62_40_5,r_62_40_5,0.99,13,18,5,8
23,r_0_26_162,r_56_10_114,r_44_68_36,r_0_26_162,0.64,-122,40,162,8
3,r_3_2_21,r_52_50_92,seq11,r_52_50_92,0.6,-69,23,92,8
10,r_66_63_114,seq38,r_0_26_162,r_66_63_114,0.75,58,172,114,8
20,r_30_6_21,r_42_61_22,seq65,r_30_6_21,0.95,4,25,21,8
40,seq41,seq13,r_62_40_5,r_62_40_5,0.95,12,17,5,8
4,r_4_48_95,seq14,r_71_9_27,r_4_48_95,0.71,0,95,95,8
0,r_74_60_120,r_70_67_121,seq73,r_70_67_121,0.62,-1,120,121,8
11,r_22_24_106,r_70_67_121,seq14,r_22_24_106,0.85,1,107,106,8
4,r_4_48_95,r_71_9_27,r_66_63_114,r_4_48_95,0.7,91,186,95,8
6,r_49_57_115,seq11,seq73,r_49_57_115,0.77,1,116,115,8
2,r_8_34_145,seq46,r_22_24_106,r_8_34_145,0.86,0,145,145,8
18,r_37_58_190,seq36,r_8_34_145,r_37_58_190,0.34,0,190,190,8
33,seq28,seq65,r_1_35_79,r_1_35_79,1.0,11,90,79,8
20,r_30_6_21,seq65,r_19_15_85,r_19_15_85,1.0,5,90,85,8
1,r_71_9_27,seq32,seq38,r_71_9_27,1.0,1,28,27,8
17,r_1_35_79,seq46,seq28,r_1_35_79,1.0,0,79,79,8
48,seq72,seq65,r_7_18_54,r_7_18_54,1.0,0,54,54,8
13,r_31_25_23,seq23,seq39,r_31_25_23,1.0,0,23,23,8
7,r_16_59_35,r_7_18_54,seq39,r_16_59_35,0.92,0,35,35,8
35,seq32,seq65,r_19_15_85,r_19_15_85,1.0,5,90,85,8
23,r_0_26_162,r_44_68_36,r_66_63_114,r_0_26_162,0.76,0,162,162,8
30,seq9,r_24_43_158,seq11,r_24_43_158,0.9,0,158,158,9
36,seq30,r_71_53_171,r_29_45_22,r_29_45_22,0.52,149,171,22,9
14,r_18_8_111,r_28_60_145,r_14_48_189,r_14_48_189,0.44,-78,111,189,9
37,seq31,r_42_67_89,r_35_62_91,r_42_67_89,1.0,0,89,89,9
3,r_69_36_151,seq64,r_28_60_145,r_28_60_145,0.59,7,152,145,9
21,r_42_67_89,seq31,seq59,r_42_67_89,1.0,0,89,89,9
1,r_12_47_125,seq1,r_37_50_57,r_37_50_57,1.0,70,127,57,9
5,r_28_60_145,r_18_8_111,r_35_62_91,r_18_8_111,0.87,0,111,111,9
4,r_72_26_46,r_35_62_91,seq3,r_72_26_46,1.0,0,46,46,9
22,r_14_48_189,r_18_8_111,r_35_62_91,r_14_48_189,0.85,0,189,189,9
10,r_21_49_81,r_44_40_3,r_35_62_91,r_21_49_81,0.86,0,81,81,9
14,r_18_8_111,r_14_48_189,r_69_36_151,r_18_8_111,0.52,79,190,111,9
16,r_37_50_57,r_24_43_158,r_44_40_3,r_37_50_57,0.47,0,57,57,9
20,r_70_13_67,seq68,r_37_50_57,r_70_13_67,1.0,0,67,67,9
15,r_71_53_171,seq30,r_57_38_70,r_57_38_70,0.77,101,171,70,9
19,r_29_45_22,r_28_60_145,seq30,r_29_45_22,0.99,0,22,22,9
27,seq3,seq20,r_72_26_46,r_72_26_46,1.0,22,68,46,9
33,seq16,r_37_50_57,r_39_55_39,r_37_50_57,1.0,-17,40,57,9
2,r_57_38_70,seq6,seq66,r_57_38_70,1.0,0,70,70,9
47,seq66,r_61_65_132,r_57_38_70,r_57_38_70,1.0,23,93,70,9
25,seq1,r_12_47_125,r_35_62_91,r_12_47_125,0.78,2,127,125,9
38,seq32,r_56_22_88,r_23_15_195,r_56_22_88,0.6,2,90,88,9
5,r_28_60_145,r_35_62_91,r_42_67_89,r_28_60_145,0.99,0,145,145,9
35,seq20,seq3,r_5_52_29,r_5_52_29,1.0,12,41,29,9
17,r_56_22_88,r_73_34_88,r_39_55_39,r_56_22_88,0.98,1,89,88,9
13,r_27_19_32,seq31,seq64,r_27_19_32,0.98,0,32,32,9
9,r_5_52_29,seq17,seq20,r_5_52_29,1.0,0,29,29,9
16,r_37_50_57,r_44_40_3,r_70_13_67,r_70_13_67,0.97,1,68,67,9
28,seq6,r_69_36_151,seq46,r_69_36_151,0.71,1,152,151,9
22,r_14_48_189,seq66,r_18_8_111,r_18_8_111,1.0,28,139,111,9
28,seq6,r_57_38_70,r_69_36_151,r_57_38_70,0.93,0,70,70,9
24,r_41_4_14,r_61_65_132,seq46,r_41_4_14,0.73,1,15,14,9
8,r_35_62_91,r_72_26_46,seq33,r_72_26_46,1.0,0,46,46,9
23,r_0_25_144,r_71_53_171,r_44_40_3,r_71_53_171,0.89,-28,143,171,9
8,r_35_62_91,seq33,seq31,r_35_62_91,0.61,11,102,91,9
12,r_73_34_88,r_56_22_88,seq30,r_73_34_88,0.97,1,89,88,9
8,r_10_63_101,r_0_71_125,r_52_6_166,r_0_71_125,0.92,-24,101,125,10
17,r_20_59_14,r_38_57_31,r_24_15_19,r_20_59_14,0.99,0,14,14,10
21,r_66_19_132,r_42_37_160,r_38_57_31,r_66_19_132,0.97,0,132,132,10
5,r_16_7_63,seq54,seq23,r_16_7_63,0.6,21,84,63,10
13,r_0_71_125,r_27_74_89,r_24_15_19,r_0_71_125,0.68,0,125,125,10
31,seq28,r_50_21_69,seq35,r_50_21_69,1.0,3,72,69,10
3,r_38_57_31,seq48,r_66_19_132,r_66_19_132,0.88,3,135,132,10
14,r_3_45_40,seq11,seq72,r_3_45_40,1.0,0,40,40,10
48,seq72,seq40,r_3_45_40,r_3_45_40,1.0,0,40,40,10
4,r_2_62_123,seq34,r_55_5_110,r_55_5_110,1.0,19,129,110,10
11,r_50_21_69,seq28,r_52_6_166,r_50_21_69,0.97,1,70,69,10
20,r_31_33_146,seq73,r_27_74_89,r_31_33_146,0.83,0,146,146,10
13,r_0_71_125,r_10_63_101,r_27_74_89,r_10_63_101,0.99,0,101,101,10
1,r_17_32_53,r_14_47_61,r_26_25_12,r_17_32_53,1.0,0,53,53,10
18,r_42_37_160,r_66_19_132,r_0_71_125,r_42_37_160,0.89,-28,132,160,10
15,r_26_25_12,seq41,seq11,r_26_25_12,0.99,0,12,12,10
27,seq11,r_3_45_40,r_26_25_12,r_3_45_40,0.93,0,40,40,10
18,r_42_37_160,r_0_71_125,r_50_21_69,r_42_37_160,0.82,1,161,160,10
22,r_52_6_166,seq69,r_50_21_69,r_50_21_69,0.88,1,70,69,10
10,r_39_13_21,r_24_15_19,seq12,r_39_13_21,0.77,0,21,21,10
49,seq73,r_31_33_146,seq23,r_31_33_146,1.0,-42,104,146,10
7,r_55_5_110,r_68_4_28,r_2_62_123,r_55_5_110,0.9,0,110,110,10
23,r_14_47_61,seq54,seq49,r_14_47_61,1.0,0,61,61,10
12,r_18_65_128,r_2_62_123,r_52_6_166,r_18_65_128,0.55,0,128,128,10
30,seq8,r_28_37_163,r_64_51_155,r_64_51_155,0.87,3,158,155,11
12,r_43_9_177,r_40_73_45,seq65,r_40_73_45,0.8,2,47,45,11
43,seq49,seq12,r_72_57_123,r_72_57_123,1.0,19,142,123,11
19,r_11_54_122,r_58_66_29,seq20,r_11_54_122,0.58,0,122,122,11
16,r_53_7_143,r_17_46_172,seq29,r_53_7_143,0.93,2,145,143,11
7,r_64_51_155,seq0,r_11_54_122,r_64_51_155,0.72,0,155,155,11
13,r_35_48_54,r_17_46_172,r_72_57_123,r_35_48_54,0.97,2,56,54,11
31,seq10,seq6,r_41_33_74,r_41_33_74,1.0,20,94,74,11
15,r_24_62_59,r_64_51_155,r_47_13_20,r_24_62_59,1.0,0,59,59,11
6,r_72_57_123,seq23,r_35_48_54,r_35_48_54,0.81,4,58,54,11
14,r_58_66_29,r_11_54_122,seq8,r_11_54_122,0.48,1,123,122,11
4,r_44_31_76,seq55,seq15,r_44_31_76,0.99,0,76,76,11
22,r_40_73_45,r_43_9_177,seq59,r_40_73_45,0.9,6,51,45,11
20,r_60_18_193,r_28_37_163,r_74_52_31,r_60_18_193,0.57,-123,70,193,11
0,r_22_71_178,r_21_14_168,seq12,r_22_71_178,0.72,-168,10,178,11
48,seq67,seq36,r_16_25_163,r_16_25_163,0.52,10,173,163,11
12,r_43_9_177,seq65,r_24_62_59,r_43_9_177,0.45,1,178,177,11
13,r_35_48_54,r_72_57_123,seq23,r_72_57_123,0.78,1,124,123,11
0,r_22_71_178,seq12,seq30,r_22_71_178,0.41,0,178,178,11
2,r_41_33_74,seq12,seq10,r_41_33_74,1.0,0,74,74,11
47,seq65,r_43_9_177,r_58_66_29,r_58_66_29,0.98,149,178,29,11
1,r_39_3_22,seq65,seq5,r_39_3_22,0.86,0,22,22,11
24,r_74_52_31,seq15,r_60_18_193,r_74_52_31,0.99,-2,29,31,11
19,r_11_54_122,seq8,r_58_66_29,r_58_66_29,1.0,12,41,29,11
6,r_72_57_123,r_35_48_54,seq49,r_72_57_123,1.0,0,123,123,11
21,r_61_32_181,seq2,seq6,r_61_32_181,0.81,1,182,181,11
17,r_28_37_163,r_60_18_193,r_72_57_123,r_28_37_163,0.59,-1,162,163,11
18,r_47_13_20,r_42_68_152,seq34,r_47_13_20,0.91,1,21,20,11
14,r_58_66_29,r_74_52_31,r_11_54_122,r_11_54_122,1.0,-87,35,122,11
7,r_64_51_155,r_24_62_59,seq0,r_24_62_59,0.98,1,60,59,11
23,r_27_70_110,seq29,seq8,r_27_70_110,0.98,0,110,110,11
45,seq53,r_57_27_65,r_30_44_101,r_30_44_101,0.99,3,104,101,12
30,seq15,r_36_46_130,seq12,r_36_46_130,0.98,0,130,130,12
14,r_36_46_130,seq15,seq50,r_36_46_130,0.99,0,130,130,12
39,seq35,seq3,r_57_27_65,r_57_27_65,1.0,31,96,65,12
1,r_32_31_151,r_40_72_57,seq38,r_32_31_151,0.89,8,159,151,12
1,r_32_31_151,seq21,r_40_72_57,r_40_72_57,1.0,3,60,57,12
21,r_60_14_24,r_13_48_173,r_52_59_114,r_60_14_24,0.92,-1,23,24,12
5,r_0_73_41,r_63_6_170,seq25,r_0_73_41,0.84,2,43,41,12
45,seq53,r_23_69_92,r_57_27_65,r_57_27_65,0.94,28,93,65,12
31,seq19,seq70,r_54_16_87,r_54_16_87,1.0,4,91,87,12
10,r_47_62_61,seq12,r_0_73_41,r_47_62_61,1.0,0,61,61,12
34,seq24,r_10_11_115,r_71_17_9,r_10_11_115,0.76,-77,38,115,12
26,seq3,r_68_29_166,seq35,r_68_29_166,0.39,-25,141,166,12
8,r_40_72_57,r_32_31_151,r_28_41_195,r_32_31_151,1.0,8,159,151,12
44,seq50,seq38,r_36_46_130,r_36_46_130,0.97,0,130,130,12
4,r_63_6_170,seq38,r_56_66_97,r_63_6_170,0.76,0,170,170,12
0,r_68_29_166,seq3,r_57_27_65,r_57_27_65,1.0,20,85,65,12
11,r_51_49_12,r_42_37_129,r_56_66_97,r_42_37_129,0.69,1,130,129,12
13,r_42_37_129,r_51_49_12,seq20,r_42_37_129,0.95,1,130,129,12
15,r_8_55_159,r_52_59_114,r_30_44_101,r_8_55_159,0.75,0,159,159,12
6,r_30_44_101,seq50,seq53,r_30_44_101,1.0,1,102,101,12
8,r_40_72_57,seq45,r_32_31_151,r_40_72_57,1.0,0,57,57,12
0,r_68_29_166,r_57_27_65,r_30_44_101,r_30_44_101,0.7,68,169,101,12
19,r_22_18_47,seq70,seq26,r_22_18_47,1.0,1,48,47,12
22,r_57_27_65,r_68_29_166,seq35,r_68_29_166,0.74,-25,141,166,12
2,r_67_9_153,r_54_16_87,seq15,r_54_16_87,1.0,1,88,87,12
18,r_23_69_92,seq53,seq74,r_23_69_92,1.0,1,93,92,12
24,r_13_48_173,r_60_14_24,seq3,r_60_14_24,0.43,151,175,24,12
25,seq1,r_10_11_115,r_71_17_9,r_10_11_115,0.95,1,116,115,12
43,seq45,r_40_72_57,seq70,r_40_72_57,0.77,0,57,57,12
5,r_0_73_41,seq25,r_47_62_61,r_47_62_61,1.0,13,74,61,12
17,r_54_16_87,seq12,seq19,r_54_16_87,1.0,0,87,87,12
9,r_10_11_115,seq1,seq39,r_10_11_115,1.0,1,116,115,12
22,r_57_27_65,seq74,r_68_29_166,r_57_27_65,1.0,1,66,65,12
7,r_61_2_101,seq39,seq45,r_61_2_101,0.99,1,102,101,12
44,seq50,r_30_44_101,seq38,r_30_44_101,0.96,2,103,101,12
23,r_56_66_97,r_36_46_130,r_51_49_12,r_36_46_130,0.78,-33,97,130,12
35,seq25,seq5,r_0_73_41,r_0_73_41,1.0,40,81,41,12
12,r_7_65_113,r_52_59_114,r_30_44_101,r_7_65_113,0.98,0,113,113,12
23,r_56_66_97,r_51_49_12,r_63_6_170,r_63_6_170,0.9,9,179,170,12
36,seq27,r_41_62_128,seq23,r_41_62_128,0.94,12,140,128,13
14,r_31_35_138,seq64,r_71_10_71,r_31_35_138,0.92,0,138,138,13
8,r_56_37_76,r_46_60_136,r_4_33_57,r_46_60_136,1.0,-60,76,136,13
3,r_71_10_71,r_26_51_171,r_31_35_138,r_71_10_71,0.75,100,171,71,13
16,r_65_2_180,seq11,r_56_37_76,r_56_37_76,1.0,104,180,76,13
21,r_61_38_93,seq69,seq12,r_61_38_93,0.84,1,94,93,13
24,r_4_33_57,seq5,r_15_22_122,r_4_33_57,0.58,0,57,57,13
42,seq50,r_46_60_136,r_1_40_136,r_1_40_136,1.0,4,140,136,13
9,r_32_28_17,seq23,seq64,r_32_28_17,0.88,0,17,17,13
19,r_72_19_130,r_53_55_194,r_17_70_58,r_72_19_130,0.55,1,131,130,13
11,r_8_68_133,r_32_28_17,r_20_18_147,r_20_18_147,0.7,1,148,147,13
37,seq29,seq23,r_57_63_45,r_57_63_45,1.0,3,48,45,13
3,r_71_10_71,seq13,r_26_51_171,r_71_10_71,0.99,0,71,71,13
10,r_42_36_190,r_24_52_180,r_32_28_17,r_24_52_180,0.3,10,190,180,13
11,r_8_68_133,seq73,r_32_28_17,r_32_28_17,0.87,25,42,17,13
20,r_26_51_171,r_44_34_106,r_71_10_71,r_26_51_171,0.97,-65,106,171,13
0,r_57_63_45,seq58,r_74_3_19,r_57_63_45,1.0,0,45,45,13
22,r_17_70_58,seq58,r_72_19_130,r_72_19_130,0.68,-3,127,130,13
18,r_44_34_106,r_26_51_171,seq58,r_44_34_106,1.0,0,106,106,13
29,seq12,seq5,r_61_38_93,r_61_38_93,0.62,-23,70,93,13
43,seq58,seq66,r_44_34_106,r_44_34_106,1.0,3,109,106,13
20,r_26_51_171,r_71_10_71,r_46_60_136,r_26_51_171,1.0,0,171,171,13
17,r_15_22_122,seq30,seq29,r_15_22_122,0.95,0,122,122,13
22,r_17_70_58,r_24_52_180,seq58,r_17_70_58,0.98,2,60,58,13
49,seq73,r_49_54_122,seq30,r_49_54_122,1.0,1,123,122,13
24,r_4_33_57,r_15_22_122,r_56_37_76,r_4_33_57,0.71,22,79,57,13
7,r_20_18_147,seq7,r_8_68_133,r_20_18_147,0.64,0,147,147,13
23,r_49_54_122,seq73,seq58,r_49_54_122,0.99,1,123,122,13
43,seq58,r_57_63_45,seq66,r_57_63_45,1.0,0,45,45,13
12,r_1_40_136,r_31_35_138,seq13,r_1_40_136,0.9,0,136,136,13
6,r_74_3_19,seq5,r_57_63_45,r_57_63_45,1.0,3,48,45,13
14,r_71_31_175,seq8,r_36_9_40,r_36_9_40,0.96,135,175,40,14
39,seq43,seq8,r_41_48_173,r_41_48_173,0.9,1,174,173,14
21,r_18_10_5,r_34_70_175,r_19_40_130,r_19_40_130,0.98,45,175,130,14
39,seq43,r_51_26_155,seq8,r_51_26_155,1.0,-17,138,155,14
1,r_34_70_175,r_18_10_5,r_33_60_9,r_34_70_175,0.38,0,175,175,14
8,r_4_5_197,r_71_31_175,r_12_59_21,r_4_5_197,0.95,-142,55,197,14
11,r_45_65_191,seq67,r_41_48_173,r_41_48_173,0.37,17,190,173,14
20,r_41_48_173,r_47_21_199,seq43,r_41_48_173,0.46,4,177,173,14
0,r_36_9_40,r_71_31_175,seq53,r_36_9_40,1.0,0,40,40,14
10,r_20_42_53,seq49,seq28,r_20_42_53,1.0,1,54,53,14
24,r_66_14_125,r_46_54_196,seq72,r_66_14_125,1.0,0,125,125,14
16,r_30_24_37,seq1,r_47_21_199,r_30_24_37,1.0,0,37,37,14
2,r_12_59_21,seq35,seq22,r_12_59_21,1.0,3,24,21,14
17,r_16_62_49,r_34_70_175,r_69_73_185,r_34_70_175,0.85,-92,83,175,14
5,r_61_74_57,r_45_65_191,r_36_9_40,r_61_74_57,0.93,0,57,57,14
9,r_13_11_186,seq67,r_52_29_109,r_52_29_109,0.87,79,188,109,14
22,r_55_6_165,seq64,r_12_59_21,r_55_6_165,0.6,0,165,165,14
28,seq8,r_51_26_155,seq43,r_51_26_155,1.0,-33,122,155,14
49,seq72,seq49,r_66_14_125,r_66_14_125,1.0,0,125,125,14
7,r_19_40_130,r_46_54_196,r_18_10_5,r_19_40_130,0.99,-1,129,130,14
41,seq49,r_20_42_53,seq2,r_20_42_53,1.0,2,55,53,14
12,r_0_39_79,r_47_21_199,seq3,r_0_39_79,0.83,0,79,79,14
36,seq32,r_18_74_28,r_46_65_39,r_46_65_39,1.0,99,138,39,15
8,r_2_52_95,r_40_64_158,seq30,r_40_64_158,0.73,-69,89,158,15
26,seq5,r_18_74_28,r_46_65_39,r_46_65_39,1.0,1,40,39,15
19,r_23_57_140,r_53_71_30,seq66,r_23_57_140,0.97,0,140,140,15
16,r_37_70_41,seq5,r_26_20_23,r_37_70_41,0.99,0,41,41,15
21,r_26_20_23,seq43,seq4,r_26_20_23,0.99,0,23,23,15
3,r_8_15_126,seq6,seq51,r_8_15_126,0.67,1,127,126,15
5,r_53_71_30,r_29_58_106,seq56,r_53_71_30,1.0,0,30,30,15
4,r_47_31_66,seq17,seq6,r_47_31_66,1.0,0,66,66,15
0,r_60_67_168,seq7,r_29_58_106,r_60_67_168,0.53,2,170,168,15
13,r_21_39_105,r_8_15_126,seq16,r_21_39_105,0.95,2,107,105,15
15,r_28_1_112,seq51,seq9,r_28_1_112,0.79,7,119,112,15
19,r_23_57_140,seq63,r_53_71_30,r_53_71_30,1.0,29,59,30,15
14,r_46_65_39,seq11,seq5,r_46_65_39,0.99,-3,36,39,15
2,r_27_49_117,seq51,seq34,r_27_49_117,0.64,-42,75,117,15
18,r_40_64_158,r_2_52_95,r_27_49_117,r_40_64_158,0.59,1,159,158,15
34,seq25,r_48_54_188,r_2_52_95,r_2_52_95,0.45,89,184,95,15
33,seq24,seq41,r_60_67_168,r_60_67_168,0.79,-4,164,168,15
17,r_35_14_96,r_60_67_168,r_61_38_158,r_61_38_158,0.54,-62,96,158,15
45,seq56,seq63,r_53_71_30,r_53_71_30,1.0,3,33,30,15
9,r_48_54_188,seq24,r_53_71_30,r_53_71_30,0.96,159,189,30,15
22,r_19_10_81,r_60_67_168,seq34,r_19_10_81,0.94,0,81,81,15
28,seq7,r_60_67_168,r_45_59_90,r_60_67_168,0.45,22,190,168,15
25,seq4,seq63,r_26_20_23,r_26_20_23,1.0,3,26,23,15
7,r_45_59_90,seq11,seq16,r_45_59_90,0.95,0,90,90,15
23,r_29_58_106,seq32,r_48_54_188,r_29_58_106,0.62,-22,84,106,15
12,r_42_55_71,seq62,r_46_65_39,r_42_55_71,1.0,0,71,71,15
23,r_29_58_106,r_48_54_188,r_60_67_168,r_48_54_188,0.54,0,188,188,15
22,r_63_33_177,r_68_9_143,r_53_2_22,r_53_2_22,0.98,4,26,22,16
21,r_71_73_118,seq3,seq0,r_71_73_118,0.98,0,118,118,16
5,r_37_56_154,seq8,r_48_69_152,r_37_56_154,0.43,1,155,154,16
7,r_28_62_21,r_29_46_163,seq43,r_29_46_163,0.48,-5,158,163,16
13,r_29_46_163,seq43,r_28_62_21,r_28_62_21,1.0,0,21,21,16
37,seq19,r_39_64_145,r_38_67_8,r_39_64_145,0.76,-109,36,145,16
20,r_53_2_22,r_58_47_190,r_63_33_177,r_53_2_22,0.99,0,22,22,16
3,r_42_25_154,seq18,r_27_10_82,r_42_25_154,0.92,0,154,154,16
10,r_39_64_145,seq19,r_53_2_22,r_39_64_145,0.64,0,145,145,16
8,r_36_65_44,r_27_10_82,r_16_22_131,r_27_10_82,0.65,82,164,82,16
16,r_20_41_28,r_45_35_111,r_27_10_82,r_20_41_28,0.96,83,111,28,16
6,r_23_44_58,r_29_46_163,r_20_41_28,r_23_44_58,1.0,0,58,58,16
4,r_27_10_82,r_68_9_143,r_20_41_28,r_20_41_28,0.95,-1,27,28,16
0,r_68_9_143,r_16_22_131,seq8,r_68_9_143,0.8,0,143,143,16
48,seq70,seq43,r_28_62_21,r_28_62_21,0.62,61,82,21,16
8,r_36_65_44,r_34_74_11,r_27_10_82,r_36_65_44,0.99,0,44,44,16
16,r_20_41_28,seq17,r_45_35_111,r_20_41_28,1.0,0,28,28,16
22,r_63_33_177,r_53_2_22,r_45_35_111,r_45_35_111,0.99,66,177,111,16
2,r_16_22_131,r_68_9_143,r_53_2_22,r_16_22_131,0.9,12,143,131,16
47,seq60,r_34_74_11,r_13_21_197,r_34_74_11,0.5,80,91,11,16
18,r_1_14_193,seq40,r_45_35_111,r_45_35_111,1.0,61,172,111,16
4,r_27_10_82,r_36_65_44,r_23_44_58,r_27_10_82,0.99,1,83,82,16
24,r_48_69_152,seq32,r_34_74_11,r_48_69_152,0.81,0,152,152,16
33,seq12,r_26_54_169,seq15,r_26_54_169,0.69,0,169,169,16
20,r_53_2_22,r_63_33_177,r_39_64_145,r_39_64_145,0.67,32,177,145,16
14,r_59_66_6,seq43,seq51,r_59_66_6,0.71,4,10,6,16
47,seq60,r_13_21_197,r_57_61_124,r_57_61_124,0.92,-4,120,124,16
7,r_28_62_21,seq60,r_29_46_163,r_28_62_21,0.84,0,21,21,16
9,r_26_54_169,seq12,r_57_61_124,r_57_61_124,0.65,45,169,124,16
4,r_27_10_82,r_20_41_28,r_36_65_44,r_27_10_82,0.73,-38,44,82,16
42,seq43,r_29_46_163,r_28_62_21,r_28_62_21,0.99,0,21,21,16
35,seq17,r_20_41_28,seq4,r_20_41_28,1.0,0,28,28,16
23,r_45_35_111,seq3,seq7,r_45_35_111,1.0,0,111,111,16
12,r_57_61_124,r_42_25_154,seq60,r_57_61_124,0.99,3,127,124,16
26,seq3,r_45_35_111,r_23_44_58,r_23_44_58,0.77,0,58,58,16
5,r_37_56_154,r_48_69_152,r_59_66_6,r_37_56_154,0.62,26,180,154,16
30,seq25,r_40_53_194,r_66_72_51,r_66_72_51,0.99,80,131,51,17
17,r_66_72_51,seq33,r_35_51_150,r_66_72_51,0.83,-1,50,51,17
14,r_16_55_13,r_48_52_50,seq58,r_48_52_50,0.96,8,58,50,17
12,r_28_18_179,r_35_51_150,r_61_70_127,r_28_18_179,0.92,1,180,179,17
13,r_48_52_50,r_36_2_146,r_16_55_13,r_16_55_13,0.98,-1,12,13,17
16,r_37_47_194,r_41_6_105,seq39,r_41_6_105,0.87,0,105,105,17
0,r_3_9_115,r_26_12_144,seq10,r_26_12_144,1.0,0,144,144,17
23,r_34_67_163,r_54_71_187,r_61_70_127,r_34_67_163,0.62,24,187,163,17
31,seq29,r_19_42_147,r_7_46_78,r_7_46_78,0.99,0,78,78,17
3,r_35_51_150,r_50_64_114,r_66_72_51,r_66_72_51,0.85,51,102,51,17
10,r_40_53_194,seq25,r_61_70_127,r_61_70_127,0.96,-1,126,127,17
16,r_37_47_194,seq39,r_35_51_150,r_35_51_150,1.0,12,162,150,17
4,r_19_42_147,seq63,seq39,r_19_42_147,0.51,1,148,147,17
0,r_3_9_115,seq60,r_26_12_144,r_3_9_115,0.8,0,115,115,17
19,r_15_65_45,seq39,seq44,r_15_65_45,1.0,0,45,45,17
11,r_26_12_144,r_54_71_187,r_0_17_29,r_0_17_29,0.58,114,143,29,17
20,r_14_13_119,r_54_71_187,r_66_72_51,r_14_13_119,0.88,1,120,119,17
15,r_7_46_78,seq23,seq29,r_7_46_78,1.0,-1,77,78,17
48,seq63,r_24_8_174,r_74_22_79,r_74_22_79,0.96,17,96,79,17
13,r_48_52_50,r_16_55_13,seq32,r_48_52_50,0.7,32,82,50,17
6,r_50_64_114,r_35_51_150,seq20,r_50_64_114,0.74,2,116,114,17
21,r_0_17_29,r_5_68_129,r_26_12_144,r_0_17_29,0.94,114,143,29,17
5,r_5_68_129,r_0_17_29,seq11,r_5_68_129,0.9,0,129,129,17
21,r_0_17_29,r_74_22_79,r_5_68_129,r_0_17_29,0.95,-1,28,29,17
2,r_61_70_127,seq44,r_40_53_194,r_61_70_127,1.0,-1,126,127,17
18,r_54_71_187,r_14_13_119,r_3_9_115,r_3_9_115,0.58,5,120,115,17
29,seq23,r_7_46_78,r_36_2_146,r_7_46_78,1.0,-5,73,78,17
24,r_74_22_79,seq23,seq63,r_74_22_79,1.0,0,79,79,17
14,r_16_55_13,r_54_71_187,r_48_52_50,r_48_52_50,0.82,-38,12,50,17
3,r_35_51_150,r_66_72_51,r_37_47_194,r_35_51_150,1.0,0,150,150,17
9,r_24_8_174,seq63,r_0_17_29,r_24_8_174,0.82,0,174,174,17
22,r_41_6_105,r_37_47_194,seq60,r_41_6_105,0.93,1,106,105,17
5,r_5_68_129,seq23,r_0_17_29,r_5_68_129,0.96,-102,27,129,17
7,r_21_4_111,seq32,seq60,r_21_4_111,0.92,0,111,111,17
23,r_34_67_163,r_28_18_179,r_54_71_187,r_28_18_179,0.58,-16,163,179,17
17,r_66_72_51,r_35_51_150,r_14_13_119,r_66_72_51,0.57,99,150,51,17
1,r_27_69_136,seq10,r_50_64_114,r_27_69_136,0.46,41,177,136,17
18,r_54_71_187,r_34_67_163,r_26_12_144,r_54_71_187,0.85,0,187,187,17
18,r_54_71_187,r_3_9_115,r_34_67_163,r_34_67_163,0.91,-1,162,163,17
12,r_28_18_179,r_34_67_163,r_35_51_150,r_28_18_179,0.48,-16,163,179,17
14,r_42_58_110,r_3_31_165,seq9,r_42_58_110,0.99,0,110,110,18
43,seq66,r_3_31_165,r_15_35_133,r_15_35_133,0.76,32,165,133,18
5,r_26_17_16,r_49_57_120,r_18_6_134,r_26_17_16,0.91,0,16,16,18
16,r_7_23_94,r_74_29_199,seq2,r_7_23_94,0.84,2,96,94,18
21,r_56_41_142,seq70,r_26_17_16,r_56_41_142,0.59,7,149,142,18
1,r_74_29_199,r_7_23_94,seq67,r_7_23_94,1.0,-16,78,94,18
24,r_16_10_28,r_65_30_172,seq34,r_16_10_28,1.0,0,28,28,18
42,seq63,seq61,r_55_37_169,r_55_37_169,0.56,-58,111,169,18
6,r_46_28_35,seq66,seq2,r_46_28_35,1.0,0,35,35,18
22,r_38_45_140,r_14_22_189,r_49_57_120,r_49_57_120,0.61,69,189,120,18
10,r_14_22_189,r_54_36_163,r_38_45_140,r_38_45_140,0.73,23,163,140,18
4,r_65_30_172,seq11,seq33,r_65_30_172,0.61,1,173,172,18
11,r_54_36_163,r_14_22_189,r_5_53_191,r_14_22_189,0.66,-26,163,189,18
20,r_18_6_134,r_26_17_16,r_49_57_120,r_18_6_134,0.34,5,139,134,18
15,r_62_44_106,r_55_37_169,r_46_28_35,r_62_44_106,1.0,0,106,106,18
10,r_14_22_189,r_38_45_140,r_51_24_44,r_38_45_140,0.54,49,189,140,18
7,r_64_60_74,r_59_4_141,seq25,r_64_60_74,0.72,62,136,74,18
12,r_51_24_44,seq8,r_20_43_171,r_51_24_44,0.51,77,121,44,18
5,r_26_17_16,r_18_6_134,r_56_41_142,r_26_17_16,0.66,137,153,16,18
0,r_49_57_120,seq11,seq0,r_49_57_120,0.74,1,121,120,18
27,seq2,r_5_53_191,r_7_23_94,r_7_23_94,0.78,4,98,94,18
18,r_55_37_169,r_62_44_106,r_20_43_171,r_62_44_106,0.6,-9,97,106,18
33,seq21,r_38_45_140,r_55_37_169,r_38_45_140,1.0,0,140,140,18
6,r_46_28_35,seq2,r_62_44_106,r_62_44_106,1.0,22,128,106,18
12,r_51_24_44,r_49_57_120,seq8,r_51_24_44,1.0,0,44,44,18
17,r_40_52_87,seq11,r_55_37_169,r_40_52_87,0.99,0,87,87,18
22,r_38_45_140,seq21,r_14_22_189,r_38_45_140,0.88,0,140,140,18
37,seq34,r_38_45_140,r_16_10_28,r_16_10_28,1.0,3,31,28,18
7,r_64_60_74,seq68,r_59_4_141,r_64_60_74,0.78,3,77,74,18
0,r_49_57_120,r_51_24_44,seq11,r_51_24_44,1.0,-8,36,44,18
23,r_3_31_165,seq66,r_72_32_8,r_72_32_8,0.26,157,165,8,18
30,seq15,r_17_28_42,r_12_6_69,r_12_6_69,1.0,0,69,69,19
36,seq33,r_12_6_69,seq0,r_12_6_69,0.93,-3,66,69,19
14,r_44_55_130,seq24,r_30_9_16,r_44_55_130,1.0,-1,129,130,19
1,r_4_53_180,seq33,r_42_46_43,r_42_46_43,0.98,-1,42,43,19
37,seq37,r_49_62_154,seq11,r_49_62_154,0.71,1,155,154,19
7,r_17_28_42,seq15,seq1,r_17_28_42,0.89,0,42,42,19
21,r_42_46_43,r_18_2_198,r_4_53_180,r_42_46_43,1.0,0,43,43,19
19,r_64_29_147,r_49_62_154,r_34_19_125,r_64_29_147,0.61,0,147,147,19
1,r_4_53_180,r_42_46_43,r_64_29_147,r_4_53_180,0.59,0,180,180,19
46,seq68,r_41_3_83,seq7,r_41_3_83,0.97,0,83,83,19
5,r_26_52_48,r_63_45_52,r_17_28_42,r_17_28_42,0.76,6,48,42,19
19,r_64_29_147,r_59_66_164,r_49_62_154,r_64_29_147,0.6,-116,31,147,19
3,r_59_66_164,r_56_71_199,seq7,r_59_66_164,0.61,0,164,164,19
10,r_27_60_111,r_49_62_154,seq72,r_27_60_111,1.0,0,111,111,19
4,r_49_62_154,r_27_60_111,seq37,r_27_60_111,0.96,0,111,111,19
13,r_74_61_125,seq47,seq73,r_74_61_125,0.93,2,127,125,19
46,seq68,seq7,r_49_62_154,r_49_62_154,0.64,0,154,154,19
48,seq72,r_35_39_47,r_27_60_111,r_27_60_111,1.0,1,112,111,19
6,r_41_3_83,seq68,r_31_65_29,r_41_3_83,1.0,0,83,83,19
21,r_42_46_43,r_4_53_180,r_69_5_101,r_42_46_43,0.35,139,182,43,19
11,r_14_43_30,r_63_45_52,seq73,r_14_43_30,0.52,28,58,30,19
20,r_30_9_16,r_74_61_125,seq1,r_30_9_16,0.86,-1,15,16,19
2,r_69_5_101,seq7,seq33,r_69_5_101,0.75,0,101,101,19
36,seq33,seq0,r_69_5_101,r_69_5_101,1.0,2,103,101,19
24,r_12_6_69,seq33,seq15,r_12_6_69,1.0,1,70,69,19
4,r_49_62_154,seq37,seq68,r_49_62_154,0.96,-1,153,154,19
11,r_14_43_30,seq67,r_63_45_52,r_14_43_30,0.59,-2,28,30,19
38,seq38,r_18_2_198,seq11,r_18_2_198,0.81,-22,176,198,19
15,r_31_65_29,seq8,seq47,r_31_65_29,1.0,-1,28,29,19
9,r_34_19_125,r_13_40_187,seq24,r_34_19_125,0.61,0,125,125,19
22,r_22_36_65,seq1,r_13_40_187,r_22_36_65,1.0,0,65,65,19
23,r_13_40_187,r_34_19_125,r_22_36_65,r_13_40_187,0.74,-122,65,187,19
17,r_35_39_47,seq72,seq48,r_35_39_47,0.56,-5,42,47,19
23,r_13_40_187,r_22_36_65,r_34_19_125,r_34_19_125,1.0,62,187,125,19
30,seq11,r_35_22_95,seq51,r_35_22_95,1.0,5,100,95,20
27,seq3,r_70_47_44,seq61,r_70_47_44,1.0,0,44,44,20
36,seq33,r_9_0_166,r_16_7_147,r_9_0_166,0.9,0,166,166,20
14,r_71_60_141,seq37,r_24_72_137,r_71_60_141,0.94,0,141,141,20
8,r_67_52_136,r_6_20_181,seq12,r_67_52_136,0.46,10,146,136,20
0,r_31_54_113,r_21_68_48,r_67_52_136,r_31_54_113,0.96,1,114,113,20
12,r_13_29_43,r_16_7_147,r_6_20_181,r_13_29_43,0.77,-1,42,43,20
21,r_6_20_181,r_67_52_136,r_27_26_79,r_27_26_79,1.0,67,146,79,20
1,r_64_17_192,seq14,r_49_66_99,r_49_66_99,1.0,26,125,99,20
5,r_24_72_137,seq41,r_56_4_71,r_24_72_137,0.9,0,137,137,20
46,seq63,r_15_42_157,r_56_4_71,r_56_4_71,0.68,7,78,71,20
21,r_6_20_181,r_27_26_79,r_13_29_43,r_27_26_79,0.6,106,185,79,20
41,seq48,seq18,r_21_68_48,r_21_68_48,0.78,33,81,48,20
3,r_15_42_157,r_59_30_145,r_35_22_95,r_35_22_95,0.92,52,147,95,20
16,r_21_68_48,r_31_54_113,r_73_55_2,r_31_54_113,1.0,1,114,113,20
0,r_31_54_113,r_27_26_79,r_21_68_48,r_31_54_113,0.88,-33,80,113,20
38,seq41,r_50_23_55,seq46,r_50_23_55,1.0,0,55,55,20
11,r_38_58_60,r_35_22_95,seq1,r_38_58_60,0.97,2,62,60,20
13,r_34_40_66,seq1,r_13_29_43,r_34_40_66,1.0,0,66,66,20
19,r_36_57_59,r_31_54_113,seq3,r_36_57_59,1.0,0,59,59,20
27,seq3,seq61,r_36_57_59,r_36_57_59,0.95,14,73,59,20
18,r_9_0_166,seq33,seq61,r_9_0_166,0.78,0,166,166,20
10,r_70_47_44,seq3,r_16_7_147,r_70_47_44,1.0,0,44,44,20
22,r_49_66_99,r_71_60_141,r_64_17_192,r_64_17_192,0.72,-93,99,192,20
0,r_31_54_113,r_67_52_136,seq8,r_31_54_113,0.62,36,149,113,20
3,r_15_42_157,r_35_22_95,r_32_39_184,r_35_22_95,0.73,62,157,95,20
17,r_16_7_147,r_56_4_71,r_70_47_44,r_16_7_147,1.0,-75,72,147,20
9,r_56_4_71,r_16_7_147,seq63,r_56_4_71,1.0,1,72,71,20
22,r_49_66_99,seq41,r_71_60_141,r_71_60_141,0.59,-67,74,141,20
28,seq8,seq33,r_16_7_147,r_16_7_147,0.53,8,155,147,20
2,r_50_23_55,seq41,seq48,r_50_23_55,0.95,0,55,55,20
7,r_59_30_145,r_15_42_157,seq25,r_59_30_145,0.98,0,145,145,20
23,r_35_22_95,seq11,r_15_42_157,r_35_22_95,0.9,0,95,95,20
35,seq25,seq37,r_59_30_145,r_59_30_145,0.65,2,147,145,20
16,r_21_68_48,seq11,r_31_54_113,r_21_68_48,0.79,1,49,48,20
23,r_35_22_95,r_15_42_157,r_24_72_137,r_35_22_95,0.78,62,157,95,20
8,r_58_30_143,r_53_20_95,r_28_17_43,r_58_30_143,0.95,-47,96,143,21
14,r_4_11_67,r_5_50_157,r_39_41_136,r_4_11_67,0.62,-8,59,67,21
16,r_48_34_90,r_53_20_95,seq57,r_48_34_90,1.0,0,90,90,21
21,r_5_50_157,r_4_11_67,r_2_68_37,r_2_68_37,0.99,40,77,37,21
5,r_26_40_84,r_33_1_121,seq15,r_33_1_121,0.98,-37,84,121,21
13,r_28_17_43,seq8,r_25_61_165,r_28_17_43,0.97,5,48,43,21
1,r_54_7_1,r_25_61_165,r_28_17_43,r_28_17_43,1.0,16,59,43,21
19,r_29_56_162,seq8,r_54_7_1,r_29_56_162,0.65,0,162,162,21
9,r_2_68_37,r_25_61_165,seq15,r_2_68_37,0.91,11,48,37,21
11,r_23_24_36,r_60_14_118,seq43,r_60_14_118,0.94,3,121,118,21
3,r_69_9_121,seq49,seq37,r_69_9_121,0.49,52,173,121,21
14,r_4_11_67,r_39_41_136,r_60_14_118,r_4_11_67,0.94,69,136,67,21
0,r_53_20_95,r_58_30_143,seq10,r_53_20_95,0.88,1,96,95,21
20,r_70_12_134,r_25_61_165,r_63_18_21,r_70_12_134,0.66,3,137,134,21
15,r_6_46_37,r_13_36_123,seq45,r_6_46_37,0.48,0,37,37,21
13,r_28_17_43,r_25_61_165,r_54_7_1,r_25_61_165,0.47,-5,160,165,21
6,r_31_64_151,r_54_7_1,seq21,r_31_64_151,0.51,5,156,151,21
10,r_13_36_123,r_0_22_178,seq43,r_13_36_123,1.0,0,123,123,21
27,seq10,r_55_19_158,r_53_20_95,r_53_20_95,0.89,43,138,95,21
2,r_55_19_158,seq52,r_13_36_123,r_13_36_123,0.84,38,161,123,21
40,seq52,r_55_19_158,seq3,r_55_19_158,0.67,3,161,158,21
18,r_33_1_121,r_60_14_118,seq44,r_33_1_121,1.0,0,121,121,21
24,r_25_61_165,r_70_12_134,r_28_17_43,r_25_61_165,0.89,-28,137,165,21
32,seq37,r_0_22_178,r_69_9_121,r_0_22_178,0.47,-96,82,178,21
10,r_13_36_123,r_6_46_37,r_0_22_178,r_6_46_37,0.74,1,38,37,21
4,r_63_18_21,seq47,seq59,r_63_18_21,1.0,0,21,21,21
29,seq21,r_2_68_37,r_31_64_151,r_2_68_37,0.98,11,48,37,21
17,r_16_38_167,seq32,r_58_30_143,r_16_38_167,0.83,0,167,167,21
22,r_39_41_136,r_4_11_67,seq37,r_39_41_136,0.98,0,136,136,21
11,r_23_24_36,seq45,r_60_14_118,r_23_24_36,1.0,0,36,36,21
42,seq59,seq35,r_63_18_21,r_63_18_21,1.0,14,35,21,21
7,r_60_14_118,r_33_1_121,r_4_11_67,r_33_1_121,0.96,0,121,121,21
35,seq44,r_0_22_178,r_69_9_121,r_0_22_178,0.76,0,178,178,21
12,r_0_22_178,seq44,r_54_7_1,r_0_22_178,0.63,0,178,178,21
2,r_6_44_111,r_55_22_121,seq74,r_6_44_111,0.58,49,160,111,22
14,r_55_22_121,r_73_64_130,r_54_19_122,r_54_19_122,0.72,-1,121,122,22
8,r_26_57_171,r_42_36_199,seq21,r_26_57_171,0.87,1,172,171,22
19,r_49_17_71,seq32,r_11_37_161,r_11_37_161,0.97,5,166,161,22
19,r_49_17_71,r_26_57_171,seq32,r_49_17_71,0.81,0,71,71,22
3,r_73_64_130,seq32,seq68,r_73_64_130,1.0,0,130,130,22
10,r_8_28_77,r_51_35_5,seq18,r_8_28_77,1.0,0,77,77,22
0,r_69_23_104,r_73_64_130,r_59_40_17,r_59_40_17,0.86,87,104,17,22
11,r_33_70_135,seq71,seq68,r_33_70_135,0.76,2,137,135,22
17,r_39_41_79,r_61_5_35,r_73_64_130,r_61_5_35,0.87,2,37,35,22
2,r_6_44_111,seq38,r_55_22_121,r_55_22_121,1.0,8,129,121,22
47,seq71,r_33_70_135,r_24_20_33,r_24_20_33,0.9,104,137,33,22
18,r_30_65_108,seq25,seq34,r_30_65_108,1.0,0,108,108,22
24,r_13_7_101,r_73_64_130,r_59_40_17,r_59_40_17,0.61,85,102,17,22
13,r_61_5_35,r_39_41_79,seq29,r_61_5_35,0.54,0,35,35,22
17,r_39_41_79,r_73_64_130,r_54_19_122,r_54_19_122,0.55,-43,79,122,22
21,r_24_20_33,r_73_64_130,r_51_35_5,r_24_20_33,0.99,0,33,33,22
9,r_11_37_161,seq29,r_49_17_71,r_11_37_161,0.93,0,161,161,22
22,r_54_19_122,r_30_65_108,r_39_41_79,r_54_19_122,1.0,-39,83,122,22
5,r_16_1_19,r_11_37_161,r_59_40_17,r_16_1_19,0.64,0,19,19,22
23,r_42_36_199,r_26_57_171,r_43_2_15,r_26_57_171,0.99,1,172,171,22
12,r_12_60_58,r_73_64_130,r_8_28_77,r_12_60_58,1.0,63,121,58,22
36,seq45,r_69_19_70,r_22_35_80,r_22_35_80,1.0,0,80,80,23
23,r_34_32_27,r_37_1_52,r_49_14_176,r_49_14_176,1.0,-148,28,176,23
29,seq15,r_72_42_44,seq74,r_72_42_44,0.99,2,46,44,23
37,seq46,r_62_58_179,seq41,r_62_58_179,0.59,-82,97,179,23
16,r_67_16_160,seq50,r_72_42_44,r_67_16_160,0.74,2,162,160,23
21,r_44_24_190,r_38_33_83,r_25_4_64,r_44_24_190,0.99,-120,70,190,23
14,r_72_42_44,seq55,r_60_54_180,r_72_42_44,0.97,0,44,44,23
11,r_49_14_176,r_34_32_27,seq71,r_49_14_176,0.72,1,177,176,23
0,r_27_31_35,seq15,r_34_32_27,r_27_31_35,0.78,0,35,35,23
15,r_28_56_30,r_57_68_106,seq64,r_28_56_30,1.0,0,30,30,23
31,seq30,seq12,r_22_35_80,r_22_35_80,1.0,21,101,80,23
3,r_25_4_64,seq74,r_44_24_190,r_25_4_64,1.0,0,64,64,23
10,r_73_20_133,seq52,r_11_26_80,r_73_20_133,1.0,0,133,133,23
14,r_72_42_44,r_60_54_180,r_8_65_69,r_8_65_69,0.93,111,180,69,23
1,r_37_1_52,r_62_58_179,r_34_32_27,r_37_1_52,0.78,0,52,52,23
18,r_22_35_80,r_37_1_52,r_62_58_179,r_37_1_52,1.0,0,52,52,23
19,r_62_58_179,r_37_1_52,seq46,r_62_58_179,0.8,-134,45,179,23
20,r_2_51_166,seq53,r_48_36_66,r_48_36_66,1.0,101,167,66,23
5,r_11_26_80,r_37_1_52,seq71,r_11_26_80,0.88,-33,47,80,23
12,r_8_65_69,r_60_54_180,r_72_42_44,r_60_54_180,0.66,-12,168,180,23
6,r_57_68_106,seq53,seq52,r_57_68_106,0.98,2,108,106,23
19,r_62_58_179,seq41,seq43,r_62_58_179,0.78,0,179,179,23
13,r_18_6_68,r_3_7_65,r_9_23_127,r_9_23_127,0.99,-4,123,127,23
22,r_60_54_180,r_8_65_69,r_29_17_35,r_8_65_69,0.38,111,180,69,23
2,r_38_33_83,seq41,seq52,r_38_33_83,1.0,2,85,83,23
40,seq52,r_73_20_133,r_38_33_83,r_38_33_83,0.7,8,91,83,23
24,r_48_36_66,seq64,seq63,r_48_36_66,1.0,0,66,66,23
25,seq5,r_8_65_69,seq74,r_8_65_69,1.0,0,69,69,23
11,r_49_14_176,r_73_20_133,r_34_32_27,r_34_32_27,0.62,3,30,27,23
19,r_62_58_179,r_11_26_80,seq41,r_62_58_179,0.51,-73,106,179,23
9,r_9_23_127,r_29_17_35,r_18_6_68,r_18_6_68,0.98,59,127,68,23
18,r_22_35_80,r_62_58_179,seq45,r_22_35_80,0.97,0,80,80,23
22,r_60_54_180,r_49_14_176,r_8_65_69,r_8_65_69,0.71,11,80,69,23
7,r_29_17_35,r_9_23_127,seq53,r_9_23_127,0.8,2,129,127,23
42,seq55,r_72_42_44,seq13,r_72_42_44,0.98,0,44,44,23
12,r_8_65_69,seq5,r_60_54_180,r_8_65_69,0.9,2,71,69,23
23,r_34_32_27,r_49_14_176,r_37_1_52,r_34_32_27,0.9,150,177,27,23
8,r_71_66_88,seq48,seq24,r_71_66_88,1.0,0,88,88,24
5,r_5_1_22,seq73,seq52,r_5_1_22,1.0,0,22,22,24
16,r_68_51_64,seq42,seq73,r_68_51_64,1.0,0,64,64,24
21,r_8_53_83,seq30,r_5_1_22,r_8_53_83,0.97,0,83,83,24
0,r_7_10_49,seq56,seq17,r_7_10_49,1.0,0,49,49,24
19,r_0_40_109,r_2_39_107,r_49_72_27,r_49_72_27,0.65,81,108,27,24
15,r_45_63_58,r_26_44_82,seq67,r_45_63_58,1.0,1,59,58,24
11,r_26_44_82,r_5_1_22,r_0_40_109,r_26_44_82,0.78,0,82,82,24
3,r_59_19_108,seq28,r_26_44_82,r_59_19_108,1.0,1,109,108,24
8,r_71_66_88,seq24,r_43_37_140,r_43_37_140,1.0,16,156,140,24
11,r_26_44_82,r_45_63_58,r_5_1_22,r_26_44_82,0.63,-22,60,82,24
20,r_50_58_98,seq28,seq31,r_50_58_98,1.0,1,99,98,24
13,r_4_14_158,seq48,r_18_74_145,r_18_74_145,1.0,22,167,145,24
12,r_33_36_165,r_11_55_37,r_59_19_108,r_33_36_165,0.98,0,165,165,24
31,seq24,r_71_66_88,r_70_12_183,r_70_12_183,0.57,7,190,183,24
2,r_11_55_37,r_33_36_165,r_47_41_9,r_33_36_165,0.74,0,165,165,24
10,r_18_74_145,seq15,seq73,r_18_74_145,0.97,0,145,145,24
31,seq24,r_11_55_37,r_60_35_101,r_11_55_37,0.85,0,37,37,24
12,r_33_36_165,r_68_51_64,r_11_55_37,r_33_36_165,0.96,-122,43,165,24
17,r_49_72_27,r_50_58_98,seq38,r_49_72_27,0.96,1,28,27,24
18,r_23_22_94,seq30,r_49_72_27,r_23_22_94,0.99,0,94,94,24
24,r_3_57_120,seq42,r_5_1_22,r_3_57_120,0.99,0,120,120,24
29,seq20,r_34_9_66,seq54,r_34_9_66,1.0,-11,55,66,24
31,seq24,r_60_35_101,r_71_66_88,r_71_66_88,0.96,-5,83,88,24
11,r_26_44_82,r_0_40_109,r_59_19_108,r_26_44_82,1.0,27,109,82,24
38,seq42,r_68_51_64,r_47_41_9,r_68_51_64,1.0,0,64,64,24
34,seq30,r_60_35_101,r_34_9_66,r_34_9_66,1.0,35,101,66,24
27,seq15,r_18_74_145,r_26_44_82,r_18_74_145,1.0,1,146,145,24
2,r_11_55_37,seq24,r_33_36_165,r_11_55_37,1.0,0,37,37,24
9,r_70_12_183,seq54,seq24,r_70_12_183,0.8,-1,182,183,24
28,seq17,seq62,r_7_10_49,r_7_10_49,1.0,11,60,49,24
49,seq73,r_43_37_140,r_4_14_158,r_43_37_140,1.0,1,141,140,24
7,r_16_25_60,seq24,seq56,r_16_25_60,1.0,0,60,60,24
23,r_34_9_66,seq20,seq30,r_34_9_66,1.0,0,66,66,24
35,seq31,seq13,r_50_58_98,r_50_58_98,0.87,0,98,98,24
3,r_28_70_26,r_39_58_124,seq16,r_28_70_26,0.99,0,26,26,25
16,r_74_18_121,r_46_67_181,r_44_7_85,r_74_18_121,0.99,0,121,121,25
21,r_59_19_192,r_29_0_114,seq50,r_29_0_114,0.9,3,117,114,25
26,seq6,seq10,r_36_23_50,r_36_23_50,1.0,0,50,50,25
18,r_36_23_50,r_32_1_125,seq6,r_36_23_50,0.83,0,50,50,25
1,r_33_5_49,r_64_55_119,seq66,r_64_55_119,0.81,4,123,119,25
7,r_46_67_181,r_73_40_21,r_25_9_133,r_73_40_21,0.73,160,181,21,25
8,r_73_40_21,r_61_35_183,r_46_67_181,r_73_40_21,1.0,0,21,21,25
27,seq8,r_54_24_153,r_36_23_50,r_54_24_153,0.67,-41,112,153,25
17,r_42_11_39,seq8,seq72,r_42_11_39,1.0,1,40,39,25
8,r_73_40_21,r_46_67_181,seq34,r_46_67_181,0.84,0,181,181,25
14,r_44_7_85,seq66,r_17_13_15,r_44_7_85,0.99,0,85,85,25
0,r_25_9_133,r_69_56_136,r_42_11_39,r_69_56_136,0.66,-2,134,136,25
11,r_61_35_183,seq72,r_64_55_119,r_61_35_183,0.49,-1,182,183,25
20,r_39_58_124,seq62,seq26,r_39_58_124,0.98,0,124,124,25
13,r_30_41_114,seq22,r_29_0_114,r_30_41_114,0.91,0,114,114,25
15,r_2_48_188,seq65,r_36_23_50,r_36_23_50,1.0,139,189,50,25
12,r_17_13_15,seq14,r_44_7_85,r_44_7_85,0.99,3,88,85,25
1,r_33_5_49,seq34,r_64_55_119,r_33_5_49,1.0,0,49,49,25
2,r_29_0_114,r_59_19_192,r_17_13_15,r_29_0_114,0.72,3,117,114,25
4,r_64_55_119,r_44_7_85,r_33_5_49,r_64_55_119,1.0,-72,47,119,25
27,seq8,r_42_11_39,r_54_24_153,r_42_11_39,1.0,-1,38,39,25
24,r_68_4_154,seq3,seq15,r_68_4_154,0.61,0,154,154,25
19,r_20_21_10,r_54_24_153,seq52,r_20_21_10,0.92,0,10,10,25
12,r_17_13_15,r_54_24_153,seq14,r_17_13_15,0.39,4,19,15,25
36,seq34,r_33_5_49,r_73_40_21,r_33_5_49,0.57,-2,47,49,25
7,r_46_67_181,r_74_18_121,r_73_40_21,r_73_40_21,0.97,0,21,21,25
9,r_69_56_136,seq52,r_60_37_19,r_69_56_136,0.87,0,136,136,25
22,r_47_45_88,r_61_35_183,r_39_58_124,r_39_58_124,0.81,46,170,124,25
44,seq62,r_39_58_124,r_64_55_119,r_39_58_124,0.52,0,124,124,25
30,seq19,r_21_54_72,seq47,r_21_54_72,1.0,0,72,72,26
5,r_31_7_157,r_61_20_23,r_66_74_125,r_31_7_157,0.96,0,157,157,26
8,r_66_74_125,seq57,seq67,r_66_74_125,0.83,0,125,125,26
43,seq57,r_66_74_125,r_10_13_106,r_66_74_125,1.0,-10,115,125,26
21,r_21_54_72,seq19,seq4,r_21_54_72,1.0,0,72,72,26
39,seq47,r_1_26_74,seq19,r_1_26_74,1.0,1,75,74,26
1,r_63_48_69,seq59,seq57,r_63_48_69,1.0,0,69,69,26
5,r_31_7_157,r_33_72_118,r_61_20_23,r_33_72_118,0.65,1,119,118,26
25,seq2,r_30_9_19,seq4,r_30_9_19,0.71,28,47,19,26
34,seq37,seq4,r_25_27_119,r_25_27_119,1.0,1,120,119,26
3,r_33_72_118,r_31_7_157,seq52,r_33_72_118,0.84,0,118,118,26
10,r_40_6_85,r_11_22_98,seq2,r_40_6_85,1.0,0,85,85,26
26,seq4,r_0_15_143,r_21_54_72,r_21_54_72,0.76,71,143,72,26
4,r_29_16_158,r_42_5_167,seq14,r_42_5_167,0.8,-7,160,167,26
16,r_49_69_38,r_10_13_106,r_56_51_34,r_56_51_34,0.97,17,51,34,26
0,r_42_5_167,r_29_16_158,r_25_27_119,r_42_5_167,0.85,0,167,167,26
20,r_10_13_106,r_49_69_38,seq57,r_10_13_106,0.64,0,106,106,26
6,r_68_12_81,seq37,r_44_39_158,r_68_12_81,1.0,0,81,81,26
11,r_55_18_171,seq41,r_61_20_23,r_61_20_23,1.0,-2,21,23,26
22,r_46_62_46,r_49_69_38,seq50,r_46_62_46,0.93,-3,43,46,26
2,r_73_34_176,seq17,r_40_6_85,r_40_6_85,1.0,94,179,85,26
18,r_25_27_119,seq36,seq37,r_25_27_119,1.0,0,119,119,26
24,r_1_26_74,seq47,seq59,r_1_26_74,1.0,1,75,74,26
48,seq67,r_32_70_25,r_66_74_125,r_66_74_125,1.0,8,133,125,26
48,seq67,r_42_5_167,r_32_70_25,r_32_70_25,1.0,0,25,25,26
22,r_46_62_46,seq50,r_3_58_93,r_3_58_93,0.42,6,99,93,26
34,seq37,r_68_12_81,seq4,r_68_12_81,1.0,-5,76,81,26
17,r_24_28_115,seq41,seq17,r_24_28_115,1.0,0,115,115,26
9,r_61_20_23,r_73_34_176,r_55_18_171,r_61_20_23,0.99,-1,22,23,26
12,r_32_70_25,seq52,seq67,r_32_70_25,0.99,0,25,25,26
40,seq50,seq53,r_46_62_46,r_46_62_46,1.0,13,59,46,26
49,seq71,r_3_58_93,seq53,r_3_58_93,0.97,-26,67,93,26
14,r_56_51_34,r_30_9_19,r_49_69_38,r_56_51_34,0.94,1,35,34,26
25,seq2,seq4,r_40_6_85,r_40_6_85,0.93,1,86,85,26
23,r_3_58_93,seq71,r_46_62_46,r_46_62_46,1.0,43,89,46,26
35,seq38,r_42_5_167,seq19,r_42_5_167,0.78,1,168,167,26
13,r_65_69_82,r_48_68_24,seq4,r_65_69_82,1.0,0,82,82,27
14,r_10_34_70,r_66_73_135,seq72,r_10_34_70,0.97,0,70,70,27
8,r_46_31_146,seq47,seq37,r_46_31_146,0.65,0,146,146,27
43,seq55,r_32_70_81,seq61,r_32_70_81,1.0,0,81,81,27
17,r_49_30_5,r_8_41_176,r_5_38_169,r_49_30_5,0.94,167,172,5,27
31,seq18,r_63_2_110,r_64_21_72,r_63_2_110,1.0,-70,40,110,27
39,seq40,r_64_21_72,r_66_73_135,r_66_73_135,0.86,1,136,135,27
1,r_16_33_178,seq60,r_10_34_70,r_10_34_70,1.0,111,181,70,27
5,r_32_70_81,seq1,seq56,r_32_70_81,1.0,0,81,81,27
46,seq60,r_51_35_164,r_16_33_178,r_51_35_164,0.64,5,169,164,27
9,r_64_21_72,seq40,seq18,r_64_21_72,0.77,-41,31,72,27
24,r_66_73_135,r_26_54_27,seq40,r_66_73_135,0.99,0,135,135,27
19,r_5_38_169,seq7,r_49_30_5,r_5_38_169,0.63,0,169,169,27
37,seq29,r_48_68_24,seq37,r_48_68_24,0.81,1,25,24,27
38,seq37,seq29,r_46_31_146,r_46_31_146,0.99,0,146,146,27
3,r_51_35_164,seq60,r_36_71_169,r_51_35_164,0.67,5,169,164,27
10,r_27_12_107,r_66_73_135,r_13_44_46,r_27_12_107,1.0,1,108,107,27
12,r_19_50_53,seq20,r_48_68_24,r_48_68_24,1.0,12,36,24,27
4,r_26_54_27,r_43_45_122,r_27_12_107,r_26_54_27,0.95,0,27,27,27
11,r_9_28_70,r_8_41_176,r_10_34_70,r_9_28_70,0.62,0,70,70,27
20,r_43_45_122,r_49_30_5,r_62_11_15,r_43_45_122,0.98,0,122,122,27
48,seq72,seq60,r_10_34_70,r_10_34_70,1.0,17,87,70,27
4,r_26_54_27,r_27_12_107,seq23,r_27_12_107,1.0,1,108,107,27
21,r_13_44_46,r_46_31_146,r_27_12_107,r_13_44_46,0.66,62,108,46,27
2,r_67_42_185,seq22,r_8_41_176,r_8_41_176,0.59,9,185,176,27
40,seq47,r_46_31_146,r_39_6_50,r_46_31_146,0.97,0,146,146,27
16,r_3_17_45,seq60,r_39_6_50,r_3_17_45,1.0,0,45,45,27
24,r_66_73_135,r_10_34_70,r_26_54_27,r_10_34_70,0.55,0,70,70,27
18,r_62_11_15,seq52,seq14,r_62_11_15,0.87,4,19,15,27
13,r_65_69_82,seq0,r_48_68_24,r_48_68_24,0.97,7,31,24,27
15,r_39_6_50,r_8_41_176,r_3_17_45,r_3_17_45,0.94,8,53,45,27
33,seq22,r_67_42_185,r_46_31_146,r_46_31_146,0.76,39,185,146,27
6,r_48_68_24,seq29,r_19_50_53,r_48_68_24,1.0,1,25,24,27
17,r_49_30_5,r_43_45_122,r_8_41_176,r_43_45_122,0.96,0,122,122,27
21,r_13_44_46,seq60,r_46_31_146,r_13_44_46,1.0,0,46,46,27
22,r_36_71_169,r_8_41_176,r_51_35_164,r_36_71_169,0.62,0,169,169,27
7,r_8_41_176,r_36_71_169,seq60,r_8_41_176,0.5,0,176,176,27
23,r_63_2_110,seq18,seq1,r_63_2_110,0.98,0,110,110,27
3,r_42_53_50,r_18_14_112,r_54_21_42,r_18_14_112,1.0,0,112,112,28
21,r_17_58_110,seq19,r_33_74_92,r_17_58_110,1.0,0,110,110,28
1,r_18_14_112,r_42_53_50,seq44,r_18_14_112,1.0,0,112,112,28
7,r_34_60_61,r_73_7_105,seq13,r_34_60_61,0.71,44,105,61,28
45,seq61,r_70_52_139,seq69,r_70_52_139,1.0,3,142,139,28
19,r_8_2_158,seq44,r_3_4_46,r_3_4_46,1.0,118,164,46,28
10,r_10_28_156,seq46,seq16,r_10_28_156,0.56,2,158,156,28
4,r_33_74_92,r_48_67_127,r_17_58_110,r_33_74_92,1.0,2,94,92,28
15,r_62_56_166,seq46,seq32,r_62_56_166,0.79,0,166,166,28
17,r_22_5_49,r_18_14_112,seq19,r_22_5_49,0.99,2,51,49,28
6,r_55_68_184,seq49,r_41_64_4,r_55_68_184,0.46,0,184,184,28
2,r_54_21_42,r_37_29_29,r_73_7_105,r_73_7_105,1.0,11,116,105,28
3,r_42_53_50,seq47,r_18_14_112,r_42_53_50,0.99,0,50,50,28
36,seq32,seq16,r_62_56_166,r_62_56_166,0.56,-1,165,166,28
1,r_18_14_112,r_22_5_49,r_42_53_50,r_18_14_112,1.0,-61,51,112,28
2,r_54_21_42,seq32,r_37_29_29,r_54_21_42,0.99,2,44,42,28
36,seq32,r_54_21_42,seq16,r_54_21_42,0.62,3,45,42,28
40,seq46,r_62_56_166,r_37_29_29,r_62_56_166,0.68,-103,63,166,28
18,r_36_1_128,seq12,seq59,r_36_1_128,0.59,0,128,128,28
22,r_66_43_41,seq61,seq15,r_66_43_41,1.0,0,41,41,28
38,seq44,r_8_2_158,r_18_14_112,r_18_14_112,1.0,52,164,112,28
9,r_73_7_105,r_34_60_61,r_54_21_42,r_73_7_105,1.0,0,105,105,28
14,r_26_24_13,r_6_51_19,seq12,r_26_24_13,0.98,0,13,13,28
7,r_34_60_61,r_62_56_166,r_73_7_105,r_34_60_61,1.0,0,61,61,28
8,r_3_4_46,seq63,seq49,r_3_4_46,1.0,0,46,46,28
46,seq63,r_3_4_46,seq69,r_3_4_46,1.0,0,46,46,28
30,seq11,seq25,r_72_30_52,r_72_30_52,1.0,28,80,52,29
36,seq33,r_49_40_98,r_55_44_96,r_55_44_96,1.0,12,108,96,29
14,r_41_26_68,r_34_9_196,r_1_74_106,r_41_26_68,1.0,0,68,68,29
8,r_55_44_96,seq4,seq33,r_55_44_96,1.0,0,96,96,29
0,r_15_60_27,seq6,r_72_30_52,r_15_60_27,1.0,0,27,27,29
37,seq35,seq4,r_73_52_111,r_73_52_111,0.94,3,114,111,29
16,r_45_39_86,r_49_40_98,seq21,r_45_39_86,1.0,1,87,86,29
5,r_8_61_170,r_73_52_111,r_17_32_95,r_17_32_95,0.47,17,112,95,29
5,r_8_61_170,r_17_32_95,seq42,r_8_61_170,1.0,0,170,170,29
19,r_73_52_111,r_8_61_170,seq35,r_73_52_111,0.98,1,112,111,29
27,seq5,seq22,r_23_63_21,r_23_63_21,0.95,6,27,21,29
3,r_28_29_117,seq58,seq59,r_28_29_117,0.89,0,117,117,29
14,r_41_26_68,r_1_74_106,seq71,r_1_74_106,0.8,59,165,106,29
4,r_65_69_154,r_17_32_95,seq71,r_17_32_95,1.0,1,96,95,29
20,r_18_51_172,r_37_3_100,r_2_31_86,r_2_31_86,0.99,15,101,86,29
48,seq70,r_18_51_172,r_15_60_27,r_15_60_27,0.95,93,120,27,29
6,r_2_31_86,r_7_14_153,r_18_51_172,r_2_31_86,1.0,0,86,86,29
2,r_68_66_23,r_7_14_153,r_28_29_117,r_28_29_117,1.0,-4,113,117,29
13,r_72_30_52,r_18_51_172,r_15_60_27,r_15_60_27,1.0,2,29,27,29
2,r_68_66_23,seq33,r_7_14_153,r_68_66_23,1.0,0,23,23,29
17,r_64_24_52,seq0,seq6,r_64_24_52,1.0,1,53,52,29
35,seq25,r_53_27_47,seq11,r_53_27_47,1.0,1,48,47,29
22,r_17_32_95,r_8_61_170,r_19_13_70,r_17_32_95,0.49,74,169,95,29
29,seq10,r_47_56_104,seq38,r_47_56_104,1.0,-23,81,104,29
0,r_15_60_27,r_72_30_52,r_18_51_172,r_72_30_52,0.99,0,52,52,29
10,r_23_63_21,r_49_40_98,seq5,r_23_63_21,0.99,1,22,21,29
21,r_53_27_47,seq25,seq0,r_53_27_47,1.0,0,47,47,29
6,r_2_31_86,r_18_51_172,seq70,r_2_31_86,0.64,87,173,86,29
20,r_18_51_172,r_2_31_86,r_15_60_27,r_18_51_172,0.65,1,173,172,29
38,seq36,r_43_50_128,seq59,r_43_50_128,0.66,16,144,128,29
13,r_72_30_52,r_15_60_27,seq11,r_72_30_52,0.99,0,52,52,29
4,r_65_69_154,seq71,seq0,r_65_69_154,1.0,0,154,154,29
34,seq22,r_7_14_153,r_68_66_23,r_68_66_23,0.98,115,138,23,29
24,r_37_3_100,seq20,seq70,r_37_3_100,0.51,17,117,100,29
9,r_49_40_98,seq6,seq33,r_49_40_98,0.5,-8,90,98,29
22,r_17_32_95,r_65_69_154,r_8_61_170,r_17_32_95,1.0,1,96,95,29
49,seq71,r_65_69_154,seq6,r_65_69_154,0.97,0,154,154,29
7,r_1_74_106,r_17_32_95,r_41_26_68,r_1_74_106,0.99,-30,76,106,29
23,r_43_50_128,seq36,r_23_63_21,r_43_50_128,0.52,5,133,128,29
12,r_19_13_70,seq38,seq4,r_19_13_70,0.96,0,70,70,29
16,r_48_28_61,r_22_47_176,seq19,r_48_28_61,1.0,0,61,61,30
1,r_61_38_197,seq17,r_2_69_119,r_2_69_119,0.64,46,165,119,30
1,r_61_38_197,r_51_52_98,seq17,r_51_52_98,1.0,0,98,98,30
5,r_8_20_119,r_31_16_186,r_2_69_119,r_8_20_119,0.47,1,120,119,30
19,r_66_70_171,seq6,r_9_23_8,r_66_70_171,0.7,3,174,171,30
10,r_22_47_176,seq0,seq63,r_22_47_176,0.38,1,177,176,30
40,seq50,seq27,r_71_46_26,r_71_46_26,0.72,2,28,26,30
4,r_49_12_124,r_44_42_120,r_10_21_190,r_44_42_120,1.0,1,121,120,30
0,r_56_64_80,r_31_16_186,r_30_1_39,r_56_64_80,1.0,0,80,80,30
11,r_31_16_186,seq63,r_51_52_98,r_51_52_98,1.0,89,187,98,30
13,r_44_42_120,r_49_12_124,seq4,r_44_42_120,1.0,1,121,120,30
48,seq72,seq53,r_2_69_119,r_2_69_119,1.0,1,120,119,30
4,r_49_12_124,r_10_21_190,r_3_58_141,r_49_12_124,0.72,66,190,124,30
6,r_36_13_65,r_71_46_26,r_15_24_146,r_36_13_65,0.81,3,68,65,30
2,r_9_23_8,r_37_60_164,seq63,r_37_60_164,0.88,0,164,164,30
22,r_15_24_146,r_36_13_65,seq63,r_15_24_146,0.6,17,163,146,30
47,seq68,r_51_52_98,seq50,r_51_52_98,0.91,-34,64,98,30
15,r_30_1_39,seq14,r_49_12_124,r_30_1_39,0.57,0,39,39,30
24,r_45_26_97,r_8_20_119,seq59,r_45_26_97,1.0,1,98,97,30
6,r_36_13_65,r_15_24_146,seq55,r_15_24_146,0.54,9,155,146,30
17,r_2_69_119,r_22_47_176,seq72,r_2_69_119,1.0,1,120,119,30
9,r_11_35_140,seq53,r_2_69_119,r_2_69_119,1.0,23,142,119,30
22,r_15_24_146,r_45_26_97,r_36_13_65,r_36_13_65,0.63,26,91,65,30
7,r_39_40_36,r_56_64_80,seq19,r_39_40_36,1.0,0,36,36,30
14,r_54_7_35,r_56_64_80,r_32_67_42,r_32_67_42,0.59,-7,35,42,30
8,r_32_67_42,seq33,r_54_7_35,r_54_7_35,1.0,11,46,35,30
18,r_37_60_164,r_9_23_8,r_2_69_119,r_9_23_8,0.62,156,164,8,30
23,r_51_52_98,r_61_38_197,seq43,r_51_52_98,1.0,0,98,98,30
12,r_3_58_141,seq43,r_49_12_124,r_3_58_141,1.0,0,141,141,30
30,seq12,r_6_61_191,r_22_10_116,r_22_10_116,0.75,3,119,116,31
9,r_59_2_190,r_65_3_31,r_63_33_178,r_65_3_31,0.31,147,178,31,31
12,r_21_42_44,seq7,seq54,r_21_42_44,0.98,2,46,44,31
1,r_27_38_95,r_63_33_178,seq45,r_27_38_95,0.78,1,96,95,31
5,r_62_14_121,seq12,seq20,r_62_14_121,0.99,0,121,121,31
7,r_28_5_39,r_63_33_178,r_17_34_43,r_63_33_178,0.97,0,178,178,31
19,r_41_56_184,r_18_30_115,seq68,r_41_56_184,0.35,1,185,184,31
31,seq13,r_63_33_178,r_17_34_43,r_17_34_43,1.0,119,162,43,31
3,r_32_53_80,seq4,r_65_3_31,r_32_53_80,1.0,1,81,80,31
14,r_22_10_116,r_48_66_5,seq12,r_22_10_116,0.57,2,118,116,31
4,r_11_31_81,r_23_24_96,seq0,r_11_31_81,0.65,0,81,81,31
0,r_47_72_134,seq74,seq29,r_47_72_134,0.65,0,134,134,31
11,r_48_66_5,r_22_10_116,seq29,r_48_66_5,0.59,113,118,5,31
20,r_63_33_178,r_27_38_95,r_28_5_39,r_27_38_95,0.95,0,95,95,31
9,r_59_2_190,r_73_19_37,r_65_3_31,r_59_2_190,0.97,-153,37,190,31
46,seq68,r_65_3_31,seq1,r_65_3_31,0.76,20,51,31,31
7,r_28_5_39,seq1,r_63_33_178,r_28_5_39,0.9,8,47,39,31
14,r_22_10_116,r_11_31_81,r_48_66_5,r_22_10_116,0.64,-89,27,116,31
6,r_9_55_39,r_27_38_95,seq1,r_27_38_95,1.0,-48,47,95,31
18,r_37_25_106,seq29,r_18_30_115,r_37_25_106,1.0,2,108,106,31
17,r_17_34_43,seq0,seq13,r_17_34_43,1.0,0,43,43,31
24,r_23_24_96,seq13,seq44,r_23_24_96,0.99,0,96,96,31
33,seq20,seq57,r_62_14_121,r_62_14_121,0.96,8,129,121,31
20,r_63_33_178,r_28_5_39,r_59_2_190,r_63_33_178,0.55,0,178,178,31
21,r_73_19_37,r_59_2_190,seq7,r_73_19_37,1.0,0,37,37,31
2,r_18_30_115,r_41_56_184,r_65_3_31,r_65_3_31,1.0,6,37,31,31
9,r_59_2_190,r_63_33_178,r_22_10_116,r_59_2_190,0.66,0,190,190,31
16,r_65_3_31,seq68,r_18_30_115,r_65_3_31,1.0,2,33,31,31
22,r_69_52_111,seq54,seq49,r_69_52_111,0.99,1,112,111,31
10,r_64_39_50,r_27_38_95,seq74,r_27_38_95,1.0,-44,51,95,31
23,r_67_46_141,seq0,seq13,r_67_46_141,0.96,0,141,141,31
30,seq13,r_50_32_106,r_55_45_85,r_55_45_85,1.0,19,104,85,32
8,r_69_20_129,seq61,r_46_10_31,r_69_20_129,0.9,0,129,129,32
20,r_55_45_85,seq13,r_66_37_131,r_66_37_131,1.0,1,132,131,32
37,seq44,r_25_9_112,r_34_24_176,r_25_9_112,1.0,0,112,112,32
14,r_70_23_159,r_46_10_31,r_59_49_101,r_46_10_31,0.71,3,34,31,32
1,r_42_58_16,r_50_32_106,seq1,r_42_58_16,0.84,2,18,16,32
13,r_67_41_186,seq57,seq13,r_67_41_186,0.88,0,186,186,32
7,r_59_49_101,r_70_23_159,r_60_72_152,r_59_49_101,0.51,75,176,101,32
45,seq61,r_69_20_129,seq56,r_69_20_129,1.0,0,129,129,32
3,r_66_37_131,seq47,r_55_45_85,r_66_37_131,0.66,0,131,131,32
10,r_26_5_120,seq61,seq44,r_26_5_120,0.71,0,120,120,32
14,r_70_23_159,r_59_49_101,r_26_5_120,r_26_5_120,0.82,40,160,120,32
4,r_27_4_150,r_67_41_186,r_50_32_106,r_27_4_150,0.82,0,150,150,32
0,r_74_43_144,seq35,seq0,r_74_43_144,0.98,0,144,144,32
20,r_55_45_85,r_3_71_116,seq13,r_55_45_85,0.83,0,85,85,32
13,r_67_41_186,r_27_4_150,seq57,r_27_4_150,0.85,0,150,150,32
15,r_29_65_103,r_59_49_101,seq63,r_29_65_103,0.99,0,103,103,32
6,r_18_22_103,r_69_20_129,r_12_17_107,r_18_22_103,0.99,4,107,103,32
21,r_50_32_106,r_42_58_16,seq2,r_42_58_16,0.95,2,18,16,32
40,seq51,r_31_19_171,seq63,r_31_19_171,0.9,0,171,171,32
18,r_21_16_82,r_28_64_149,seq33,r_21_16_82,0.77,0,82,82,32
24,r_36_11_71,seq2,r_34_24_176,r_36_11_71,1.0,0,71,71,32
33,seq33,seq40,r_21_16_82,r_21_16_82,0.81,-2,80,82,32
38,seq47,r_66_37_131,r_54_6_197,r_66_37_131,0.64,0,131,131,32
2,r_30_38_41,r_12_17_107,seq7,r_12_17_107,0.95,-68,39,107,32
17,r_12_17_107,seq2,seq53,r_12_17_107,1.0,0,107,107,32
9,r_25_9_112,seq44,seq8,r_25_9_112,0.98,0,112,112,32
29,seq8,seq2,r_25_9_112,r_25_9_112,1.0,23,135,112,32
22,r_31_19_171,seq51,r_74_43_144,r_74_43_144,0.56,27,171,144,32
28,seq7,seq33,r_30_38_41,r_30_38_41,0.59,24,65,41,32
7,r_59_49_101,r_25_9_112,r_70_23_159,r_25_9_112,0.98,-9,103,112,32
5,r_46_10_31,r_70_23_159,r_54_6_197,r_46_10_31,0.98,3,34,31,32
12,r_60_72_152,seq51,r_59_49_101,r_60_72_152,0.74,0,152,152,32
8,r_11_27_66,seq63,seq4,r_11_27_66,1.0,1,67,66,33
49,seq72,seq25,r_60_44_42,r_60_44_42,1.0,16,58,42,33
26,seq6,r_22_0_17,r_5_52_124,r_5_52_124,1.0,3,127,124,33
21,r_57_9_167,r_42_17_92,r_59_73_107,r_42_17_92,1.0,0,92,92,33
19,r_41_10_13,r_2_49_31,seq58,r_41_10_13,0.84,-1,12,13,33
23,r_39_38_49,r_65_43_113,r_32_30_20,r_39_38_49,0.98,0,49,49,33
31,seq20,r_28_14_157,r_64_3_80,r_64_3_80,0.94,7,87,80,33
43,seq58,seq12,r_41_10_13,r_41_10_13,0.97,-1,12,13,33
11,r_62_18_27,r_64_3_80,seq63,r_62_18_27,0.93,0,27,27,33
15,r_32_30_20,r_11_27_66,seq47,r_32_30_20,0.99,0,20,20,33
22,r_2_49_31,seq70,r_53_1_187,r_2_49_31,0.98,3,34,31,33
5,r_22_0_17,r_11_27_66,seq6,r_22_0_17,0.92,0,17,17,33
4,r_68_26_64,seq47,seq67,r_68_26_64,1.0,0,64,64,33
13,r_35_19_81,r_65_43_113,r_66_23_51,r_66_23_51,0.88,2,53,51,33
6,r_65_43_113,r_39_38_49,r_2_49_31,r_65_43_113,0.99,-4,109,113,33
0,r_5_52_124,r_74_40_56,seq46,r_74_40_56,1.0,0,56,56,33
5,r_22_0_17,seq6,r_41_10_13,r_22_0_17,0.41,79,96,17,33
0,r_5_52_124,seq46,seq6,r_5_52_124,0.99,0,124,124,33
14,r_60_44_42,seq8,seq72,r_60_44_42,1.0,0,42,42,33
22,r_2_49_31,r_53_1_187,r_65_43_113,r_65_43_113,1.0,3,116,113,33
5,r_22_0_17,r_41_10_13,r_5_52_124,r_22_0_17,0.79,137,154,17,33
40,seq51,seq56,r_21_13_71,r_21_13_71,1.0,22,93,71,33
18,r_71_29_147,seq7,r_41_10_13,r_71_29_147,0.77,0,147,147,33
24,r_21_13_71,seq8,seq51,r_21_13_71,1.0,0,71,71,33
2,r_66_23_51,r_35_19_81,r_32_30_20,r_35_19_81,1.0,5,86,81,33
38,seq47,r_68_26_64,r_32_30_20,r_68_26_64,0.89,0,64,64,33
2,r_66_23_51,r_5_52_124,r_35_19_81,r_66_23_51,0.99,1,52,51,33
17,r_64_3_80,seq6,seq20,r_64_3_80,0.99,1,81,80,33
9,r_54_50_60,r_28_14_157,r_41_10_13,r_28_14_157,0.51,-74,83,157,33
11,r_62_18_27,seq63,r_35_19_81,r_35_19_81,1.0,-3,78,81,33
28,seq8,r_21_13_71,seq55,r_21_13_71,1.0,0,71,71,33
13,r_35_19_81,r_66_23_51,r_62_18_27,r_35_19_81,0.67,0,81,81,33
16,r_74_40_56,r_5_52_124,seq69,r_74_40_56,1.0,0,56,56,33
12,r_42_17_92,r_57_9_167,seq46,r_42_17_92,0.94,1,93,92,33
22,r_36_32_168,r_61_10_45,r_24_53_33,r_36_32_168,0.6,-124,44,168,34
9,r_17_31_181,r_26_60_49,r_4_48_87,r_17_31_181,0.75,0,181,181,34
26,seq8,r_22_62_19,r_49_64_82,r_49_64_82,0.71,15,97,82,34
14,r_51_27_85,seq14,r_7_57_9,r_51_27_85,1.0,0,85,85,34
8,r_25_12_75,r_4_48_87,seq43,r_25_12_75,0.96,0,75,75,34
4,r_29_45_32,r_4_48_87,r_56_11_62,r_56_11_62,0.6,-36,26,62,34
43,seq65,r_44_42_122,seq43,r_44_42_122,0.83,3,125,122,34
16,r_66_59_117,seq19,seq68,r_66_59_117,0.68,4,121,117,34
21,r_49_64_82,seq34,seq19,r_49_64_82,0.95,0,82,82,34
42,seq63,seq74,r_2_18_70,r_2_18_70,1.0,23,93,70,34
10,r_22_62_19,r_36_32_168,seq28,r_22_62_19,1.0,1,20,19,34
19,r_1_72_75,seq68,r_24_53_33,r_1_72_75,1.0,2,77,75,34
13,r_23_6_53,r_24_53_33,seq69,r_24_53_33,0.76,-11,22,33,34
13,r_23_6_53,seq69,r_26_60_49,r_23_6_53,0.99,0,53,53,34
1,r_24_53_33,r_23_6_53,r_36_32_168,r_24_53_33,0.84,2,35,33,34
31,seq19,r_66_59_117,r_49_64_82,r_49_64_82,0.89,46,128,82,34
3,r_4_48_87,r_50_67_112,seq41,r_4_48_87,0.75,0,87,87,34
26,seq8,r_2_18_70,r_22_62_19,r_2_18_70,0.72,-8,62,70,34
20,r_56_11_62,r_26_60_49,r_29_45_32,r_26_60_49,0.88,0,49,49,34
4,r_29_45_32,r_56_11_62,r_7_57_9,r_56_11_62,1.0,0,62,62,34
0,r_2_18_70,r_66_59_117,seq63,r_2_18_70,0.94,0,70,70,34
15,r_47_16_70,r_44_42_122,r_24_53_33,r_47_16_70,0.83,0,70,70,34
1,r_24_53_33,r_36_32_168,r_47_16_70,r_47_16_70,0.87,19,89,70,34
5,r_50_67_112,r_7_57_9,r_24_53_33,r_50_67_112,1.0,1,113,112,34
44,seq68,r_22_62_19,r_66_59_117,r_66_59_117,0.75,-14,103,117,34
22,r_36_32_168,r_24_53_33,r_55_37_127,r_36_32_168,0.61,0,168,168,34
2,r_3_40_114,seq69,r_44_42_122,r_3_40_114,0.22,13,127,114,34
5,r_50_67_112,r_4_48_87,r_7_57_9,r_7_57_9,0.71,1,10,9,34
12,r_61_10_45,seq9,seq33,r_61_10_45,0.54,27,72,45,34
24,r_39_5_96,seq28,r_61_10_45,r_39_5_96,0.96,0,96,96,34
12,r_61_10_45,seq33,r_39_5_96,r_39_5_96,1.0,0,96,96,34
6,r_7_57_9,r_50_67_112,r_51_27_85,r_7_57_9,0.99,104,113,9,34
38,seq43,r_44_42_122,r_25_12_75,r_25_12_75,0.98,6,81,75,34
20,r_56_11_62,r_29_45_32,seq33,r_56_11_62,1.0,0,62,62,34
33,seq28,r_39_5_96,r_22_62_19,r_22_62_19,0.58,-1,18,19,34
11,r_26_60_49,r_56_11_62,r_23_6_53,r_26_60_49,1.0,4,53,49,34
7,r_35_54_135,seq46,r_50_67_112,r_35_54_135,0.99,0,135,135,34
9,r_17_31_181,seq58,r_26_60_49,r_26_60_49,0.59,12,61,49,34
12,r_61_10_45,r_36_32_168,seq9,r_61_10_45,0.77,0,45,45,34
7,r_35_54_135,r_3_40_114,seq46,r_3_40_114,0.5,-19,95,114,34
17,r_72_49_44,seq54,seq47,r_72_49_44,1.0,1,45,44,35
8,r_48_45_155,seq54,r_66_15_84,r_48_45_155,0.78,1,156,155,35
14,r_17_2_34,r_16_7_110,r_20_25_143,r_17_2_34,0.99,0,34,34,35
21,r_31_50_126,seq46,r_20_25_143,r_31_50_126,0.93,0,126,126,35
1,r_60_33_128,seq21,r_27_52_127,r_60_33_128,0.99,0,128,128,35
5,r_3_41_139,r_20_25_143,seq8,r_3_41_139,0.61,0,139,139,35
46,seq64,r_42_9_159,r_20_25_143,r_42_9_159,0.99,-14,145,159,35
42,seq54,r_48_45_155,seq12,r_48_45_155,0.97,1,156,155,35
19,r_66_15_84,seq1,r_74_43_42,r_66_15_84,0.94,-5,79,84,35
31,seq21,r_60_33_128,seq73,r_60_33_128,0.86,1,129,128,35
3,r_57_19_21,r_60_33_128,seq61,r_57_19_21,0.97,2,23,21,35
10,r_65_67_112,seq29,r_71_51_109,r_65_67_112,0.97,0,112,112,35
4,r_6_40_94,r_60_33_128,seq12,r_6_40_94,1.0,1,95,94,35
0,r_10_36_152,r_42_9_159,seq29,r_10_36_152,0.48,-87,65,152,35
11,r_42_9_159,seq47,seq46,r_42_9_159,0.71,0,159,159,35
20,r_74_43_42,r_65_67_112,r_66_15_84,r_65_67_112,0.84,-27,85,112,35
13,r_39_44_145,seq46,r_60_33_128,r_39_44_145,0.58,0,145,145,35
15,r_27_52_127,r_42_9_159,r_17_2_34,r_27_52_127,0.74,-1,126,127,35
0,r_10_36_152,seq29,r_37_32_117,r_37_32_117,0.5,1,118,117,35
6,r_20_25_143,r_3_41_139,seq64,r_3_41_139,0.9,0,139,139,35
2,r_71_51_109,seq61,r_16_7_110,r_71_51_109,1.0,-1,108,109,35
16,r_28_30_44,seq62,seq0,r_28_30_44,1.0,1,45,44,35
18,r_37_32_117,seq26,r_10_36_152,r_37_32_117,0.57,1,118,117,35
29,seq12,seq35,r_6_40_94,r_6_40_94,1.0,4,98,94,35
32,seq22,r_14_55_167,seq54,r_14_55_167,0.54,1,168,167,35
31,seq21,seq73,r_16_7_110,r_16_7_110,0.5,70,180,110,35
9,r_16_7_110,seq56,r_71_51_109,r_71_51_109,0.83,1,110,109,35
35,seq26,r_37_32_117,seq13,r_37_32_117,1.0,0,117,117,35
18,r_37_32_117,r_10_36_152,seq29,r_10_36_152,0.97,7,159,152,35
0,r_10_36_152,r_37_32_117,seq62,r_10_36_152,1.0,0,152,152,35
18,r_24_58_20,seq37,r_19_39_2,r_24_58_20,1.0,0,20,20,36
36,seq37,seq36,r_41_5_80,r_41_5_80,0.88,0,80,80,36
14,r_54_12_79,seq55,r_63_48_34,r_63_48_34,0.47,46,80,34,36
8,r_26_21_169,r_46_2_106,seq22,r_46_2_106,0.65,-10,96,106,36
10,r_34_67_40,seq66,seq55,r_34_67_40,1.0,0,40,40,36
16,r_31_9_143,seq33,seq22,r_31_9_143,0.85,0,143,143,36
21,r_61_11_185,seq55,r_17_72_26,r_17_72_26,0.66,159,185,26,36
39,seq45,r_56_10_164,r_63_48_34,r_63_48_34,0.85,131,165,34,36
22,r_38_20_35,r_30_42_152,seq25,r_38_20_35,0.67,0,35,35,36
5,r_13_68_138,seq33,r_38_20_35,r_13_68_138,0.76,7,145,138,36
45,seq62,r_57_0_189,seq53,r_57_0_189,0.49,-94,95,189,36
13,r_17_72_26,r_30_42_152,seq51,r_17_72_26,1.0,0,26,26,36
7,r_63_48_34,seq36,seq60,r_63_48_34,1.0,0,34,34,36
8,r_26_21_169,seq22,seq18,r_26_21_169,0.99,0,169,169,36
0,r_30_42_152,seq18,r_38_20_35,r_38_20_35,0.47,117,152,35,36
11,r_57_0_189,seq62,r_38_20_35,r_57_0_189,0.28,0,189,189,36
20,r_46_2_106,r_26_21_169,r_54_12_79,r_46_2_106,0.97,0,106,106,36
15,r_50_47_159,seq1,seq33,r_50_47_159,0.66,0,159,159,36
46,seq66,r_34_67_40,r_26_21_169,r_34_67_40,1.0,-4,36,40,36
6,r_41_5_80,seq70,seq37,r_41_5_80,0.68,0,80,80,36
35,seq36,r_63_48_34,seq37,r_63_48_34,1.0,0,34,34,36
49,seq73,r_8_23_34,r_15_44_13,r_15_44_13,0.9,0,13,13,36
24,r_32_28_24,r_63_48_34,seq51,r_32_28_24,0.97,0,24,24,36
44,seq60,r_8_23_34,r_63_48_34,r_63_48_34,0.51,2,36,34,36
23,r_8_23_34,seq60,r_19_39_2,r_8_23_34,0.97,2,36,34,36
2,r_15_44_13,r_26_21_169,seq73,r_15_44_13,0.99,1,14,13,36
40,seq51,seq22,r_17_72_26,r_17_72_26,1.0,-1,25,26,36
9,r_49_59_66,seq70,r_19_39_2,r_49_59_66,0.96,0,66,66,36
28,seq18,r_30_42_152,r_19_39_2,r_30_42_152,0.76,0,152,152,36
12,r_56_10_164,seq45,r_30_42_152,r_30_42_152,0.43,12,164,152,36
30,seq19,r_12_35_185,r_22_6_38,r_22_6_38,0.58,149,187,38,37
18,r_54_68_91,r_47_28_41,seq50,r_47_28_41,0.99,-2,39,41,37
8,r_63_34_172,r_5_29_85,r_23_1_77,r_63_34_172,0.51,-84,88,172,37
16,r_4_10_101,r_23_1_77,r_24_27_72,r_4_10_101,0.94,-23,78,101,37
23,r_53_9_20,r_47_28_41,seq13,r_53_9_20,0.85,-1,19,20,37
5,r_74_11_93,seq58,r_47_28_41,r_74_11_93,1.0,0,93,93,37
4,r_14_69_78,r_38_45_72,r_23_1_77,r_38_45_72,0.84,-47,25,72,37
19,r_7_66_94,seq50,seq58,r_7_66_94,1.0,0,94,94,37
21,r_32_25_99,r_74_11_93,r_65_71_30,r_32_25_99,0.68,-69,30,99,37
14,r_65_71_30,seq18,r_14_69_78,r_65_71_30,0.52,129,159,30,37
41,seq51,r_46_49_180,r_54_68_91,r_46_49_180,0.71,-7,173,180,37
38,seq41,r_0_60_94,r_55_15_26,r_55_15_26,0.67,0,26,26,37
3,r_0_60_94,seq41,seq8,r_0_60_94,1.0,0,94,94,37
8,r_63_34_172,r_23_1_77,r_14_69_78,r_14_69_78,0.58,93,171,78,37
14,r_65_71_30,r_32_25_99,seq18,r_65_71_30,0.64,71,101,30,37
0,r_67_43_75,seq13,seq50,r_67_43_75,0.98,0,75,75,37
11,r_3_64_108,seq73,seq72,r_3_64_108,0.74,0,108,108,37
15,r_5_29_85,seq50,seq18,r_5_29_85,1.0,0,85,85,37
48,seq72,r_39_44_143,seq33,r_39_44_143,0.98,0,143,143,37
6,r_12_35_185,seq19,r_7_66_94,r_7_66_94,0.9,93,187,94,37
21,r_32_25_99,r_65_71_30,r_0_60_94,r_0_60_94,0.71,4,98,94,37
4,r_14_69_78,r_23_1_77,r_42_70_1,r_14_69_78,0.93,0,78,78,37
2,r_46_49_180,seq51,r_14_69_78,r_46_49_180,0.38,0,180,180,37
10,r_47_28_41,r_54_68_91,seq73,r_47_28_41,1.0,0,41,41,37
22,r_22_6_38,seq31,seq48,r_22_6_38,1.0,0,38,38,37
14,r_65_71_30,seq8,r_32_25_99,r_65_71_30,0.92,1,31,30,37
17,r_55_15_26,seq18,seq41,r_55_15_26,0.98,0,26,26,37
7,r_42_70_1,seq31,r_14_69_78,r_14_69_78,1.0,3,81,78,37
18,r_54_68_91,seq50,seq51,r_54_68_91,0.47,53,144,91,37
18,r_71_54_39,r_70_20_121,r_69_8_79,r_71_54_39,0.92,0,39,39,38
8,r_50_41_176,seq21,r_71_54_39,r_71_54_39,0.85,137,176,39,38
37,seq39,r_40_7_8,r_22_2_38,r_40_7_8,0.8,65,73,8,38
16,r_40_7_8,r_22_2_38,seq48,r_22_2_38,0.84,34,72,38,38
1,r_18_56_189,r_9_17_170,r_70_20_121,r_70_20_121,1.0,49,170,121,38
5,r_4_1_177,seq24,r_45_51_124,r_4_1_177,0.78,0,177,177,38
1,r_18_56_189,r_70_20_121,r_34_5_112,r_18_56_189,0.77,0,189,189,38
14,r_46_43_49,seq48,r_18_56_189,r_46_43_49,1.0,0,49,49,38
31,seq24,r_4_1_177,r_72_30_50,r_72_30_50,0.93,108,158,50,38
21,r_69_8_79,seq44,r_40_7_8,r_40_7_8,0.93,39,47,8,38
10,r_6_16_127,seq60,r_37_35_18,r_37_35_18,0.88,115,133,18,38
17,r_47_15_184,r_19_62_84,seq21,r_47_15_184,0.99,0,184,184,38
14,r_46_43_49,r_18_56_189,r_70_20_121,r_70_20_121,1.0,68,189,121,38
0,r_9_17_170,r_18_56_189,seq29,r_9_17_170,0.76,0,170,170,38
18,r_71_54_39,r_69_8_79,seq65,r_69_8_79,1.0,0,79,79,38
11,r_74_0_126,r_47_15_184,r_25_55_125,r_74_0_126,0.92,2,128,126,38
13,r_34_5_112,seq3,seq63,r_34_5_112,0.85,0,112,112,38
15,r_25_55_125,seq10,seq28,r_25_55_125,1.0,0,125,125,38
20,r_37_35_18,seq14,seq10,r_37_35_18,0.85,0,18,18,38
4,r_72_30_50,r_69_8_79,seq24,r_72_30_50,0.71,0,50,50,38
29,seq14,r_37_35_18,seq67,r_37_35_18,0.7,0,18,18,38
22,r_19_62_84,r_47_15_184,r_4_1_177,r_19_62_84,0.59,100,184,84,38
19,r_70_20_121,r_71_54_39,seq42,r_71_54_39,0.94,-1,38,39,38
2,r_68_73_159,seq60,seq14,r_68_73_159,0.82,0,159,159,38
25,seq3,r_34_5_112,seq59,r_34_5_112,0.91,5,117,112,38
21,r_69_8_79,r_71_54_39,r_70_20_121,r_69_8_79,0.89,0,79,79,38
34,seq29,seq38,r_66_31_57,r_66_31_57,1.0,4,61,57,38
24,r_61_23_24,r_40_7_8,seq29,r_61_23_24,1.0,1,25,24,38
3,r_33_58_32,seq42,seq64,r_33_58_32,1.0,0,32,32,38
21,r_69_8_79,seq65,r_71_54_39,r_71_54_39,0.99,2,41,39,38
19,r_70_20_121,seq42,r_69_8_79,r_69_8_79,0.93,1,80,79,38
17,r_47_15_184,r_74_0_126,r_19_62_84,r_47_15_184,0.68,-56,128,184,38
19,r_70_20_121,r_69_8_79,r_46_43_49,r_70_20_121,0.99,0,121,121,38
9,r_66_31_57,r_25_55_125,seq29,r_66_31_57,1.0,4,61,57,38
26,seq10,r_25_55_125,r_37_35_18,r_37_35_18,0.84,0,18,18,38
29,seq14,seq67,r_68_73_159,r_68_73_159,0.69,4,163,159,38
22,r_19_62_84,seq64,r_47_15_184,r_19_62_84,1.0,0,84,84,38
7,r_36_52_141,seq53,seq49,r_36_52_141,0.96,0,141,141,38
23,r_22_2_38,r_40_7_8,r_72_30_50,r_72_30_50,1.0,13,63,50,38
21,r_69_8_79,r_70_20_121,seq44,r_70_20_121,0.93,-2,119,121,38
36,seq41,r_57_54_97,seq24,r_57_54_97,1.0,-12,85,97,39
14,r_70_32_86,seq3,seq15,r_70_32_86,0.55,-12,74,86,39
16,r_34_44_151,r_6_21_195,seq51,r_34_44_151,0.82,0,151,151,39
21,r_12_43_74,seq46,seq63,r_12_43_74,0.95,0,74,74,39
1,r_6_21_195,r_34_44_151,r_55_56_89,r_34_44_151,1.0,0,151,151,39
1,r_6_21_195,r_55_56_89,r_34_44_151,r_55_56_89,0.64,-6,83,89,39
5,r_69_7_155,seq45,seq3,r_69_7_155,0.72,0,155,155,39
18,r_47_0_26,seq59,seq11,r_47_0_26,0.99,0,26,26,39
24,r_39_31_33,r_73_50_155,r_55_56_89,r_73_50_155,0.45,0,155,155,39
4,r_73_50_155,r_74_4_7,r_39_31_33,r_39_31_33,0.93,13,46,33,39
3,r_62_10_85,seq68,r_58_30_112,r_62_10_85,0.86,8,93,85,39
10,r_16_38_190,seq35,r_23_25_150,r_23_25_150,0.77,40,190,150,39
23,r_58_30_112,r_33_2_85,r_23_25_150,r_23_25_150,1.0,0,150,150,39
0,r_53_29_29,seq64,r_47_0_26,r_53_29_29,0.99,1,30,29,39
26,seq3,r_70_32_86,seq59,r_70_32_86,0.82,21,107,86,39
11,r_23_25_150,seq63,r_58_30_112,r_23_25_150,0.73,0,150,150,39
39,seq46,r_12_43_74,r_48_14_52,r_12_43_74,1.0,-25,49,74,39
33,seq27,seq66,r_13_60_27,r_13_60_27,1.0,-2,25,27,39
7,r_13_60_27,r_34_44_151,seq27,r_13_60_27,0.68,-1,26,27,39
4,r_73_50_155,r_39_31_33,r_33_2_85,r_73_50_155,0.9,0,155,155,39
6,r_33_2_85,r_19_52_100,seq20,r_19_52_100,0.61,-13,87,100,39
0,r_53_29_29,r_47_0_26,seq1,r_53_29_29,0.24,134,163,29,39
8,r_36_26_32,r_70_32_86,seq46,r_36_26_32,0.92,0,32,32,39
2,r_57_54_97,seq41,seq67,r_57_54_97,0.99,0,97,97,39
47,seq67,r_17_22_197,r_57_54_97,r_57_54_97,1.0,36,133,97,39
40,seq51,seq42,r_34_44_151,r_34_44_151,0.86,0,151,151,39
29,seq11,r_48_14_52,r_47_0_26,r_47_0_26,0.98,21,47,26,39
19,r_19_52_100,seq20,r_57_54_97,r_19_52_100,0.96,0,100,100,39
24,r_39_31_33,seq20,r_73_50_155,r_39_31_33,1.0,0,33,33,39
31,seq20,r_19_52_100,r_33_2_85,r_19_52_100,1.0,-13,87,100,39
17,r_71_28_169,seq64,r_69_7_155,r_71_28_169,0.57,0,169,169,39
13,r_48_14_52,seq11,r_36_26_32,r_36_26_32,0.99,17,49,32,39
31,seq20,r_39_31_33,r_19_52_100,r_39_31_33,0.95,-2,31,33,39
44,seq64,r_71_28_169,seq41,r_71_28_169,0.72,0,169,169,39
23,r_58_30_112,seq46,r_33_2_85,r_58_30_112,0.64,4,116,112,39
12,r_55_56_89,r_6_21_195,seq61,r_55_56_89,0.52,6,95,89,39
6,r_24_62_20,r_1_9_154,seq8,r_24_62_20,0.86,0,20,20,40
0,r_28_53_8,seq54,r_52_39_103,r_28_53_8,0.56,3,11,8,40
14,r_7_65_119,r_1_9_154,seq3,r_7_65_119,0.61,3,122,119,40
16,r_45_34_182,seq46,r_74_36_104,r_74_36_104,0.56,78,182,104,40
21,r_20_70_68,r_52_39_103,seq10,r_20_70_68,0.89,4,72,68,40
1,r_35_51_31,r_74_36_104,seq42,r_74_36_104,1.0,-4,100,104,40
5,r_25_37_72,r_74_36_104,r_19_38_124,r_25_37_72,0.82,3,75,72,40
45,seq67,r_18_11_127,r_21_22_91,r_18_11_127,0.65,0,127,127,40
10,r_0_12_13,r_35_51_31,seq3,r_0_12_13,0.99,0,13,13,40
3,r_60_23_161,seq33,seq46,r_60_23_161,0.88,0,161,161,40
8,r_52_39_103,r_2_44_27,seq61,r_52_39_103,0.57,1,104,103,40
4,r_17_69_103,seq66,seq42,r_17_69_103,1.0,1,104,103,40
7,r_1_9_154,r_52_39_103,seq67,r_1_9_154,0.89,0,154,154,40
20,r_41_58_135,r_1_9_154,r_17_69_103,r_1_9_154,0.97,-19,135,154,40
13,r_74_36_104,r_35_51_31,seq66,r_74_36_104,1.0,0,104,104,40
5,r_25_37_72,r_19_38_124,seq6,r_19_38_124,1.0,0,124,124,40
6,r_24_62_20,r_45_34_182,r_14_47_152,r_24_62_20,0.81,137,157,20,40
15,r_40_15_72,r_41_58_135,seq6,r_40_15_72,0.58,1,73,72,40
33,seq32,seq42,r_27_4_12,r_27_4_12,0.85,2,14,12,40
0,r_28_53_8,r_52_39_103,r_31_49_82,r_28_53_8,0.75,75,83,8,40
8,r_52_39_103,r_20_70_68,r_2_44_27,r_2_44_27,0.61,-2,25,27,40
18,r_19_38_124,seq6,r_25_37_72,r_25_37_72,0.73,1,73,72,40
24,r_50_13_92,seq66,seq33,r_50_13_92,0.64,1,93,92,40
25,seq3,r_21_22_91,seq10,r_21_22_91,0.84,-18,73,91,40
6,r_24_62_20,seq8,r_45_34_182,r_24_62_20,0.41,85,105,20,40
32,seq29,seq48,r_19_38_124,r_19_38_124,1.0,1,125,124,40
25,seq3,seq10,r_7_65_119,r_7_65_119,0.98,13,132,119,40
17,r_21_22_91,seq3,seq67,r_21_22_91,0.73,0,91,91,40
9,r_2_44_27,r_40_15_72,r_28_53_8,r_2_44_27,0.78,-1,26,27,40
12,r_27_4_12,r_17_69_103,seq32,r_27_4_12,0.41,0,12,12,40
7,r_1_9_154,r_41_58_135,r_52_39_103,r_1_9_154,0.7,-20,134,154,40
18,r_19_38_124,r_25_37_72,seq29,r_19_38_124,0.96,0,124,124,40
8,r_36_19_170,r_40_45_184,r_44_4_132,r_44_4_132,0.98,50,182,132,41
37,seq47,r_59_11_112,seq57,r_59_11_112,0.54,0,112,112,41
20,r_10_12_157,r_50_3_101,r_29_28_23,r_29_28_23,0.98,13,36,23,41
16,r_46_52_62,seq64,seq57,r_46_52_62,1.0,0,62,62,41
1,r_21_69_86,r_50_3_101,r_17_73_121,r_21_69_86,0.98,0,86,86,41
5,r_8_30_101,r_50_3_101,seq51,r_8_30_101,1.0,1,102,101,41
46,seq64,r_46_52_62,r_16_55_27,r_46_52_62,0.84,0,62,62,41
42,seq58,seq64,r_16_55_27,r_16_55_27,1.0,87,114,27,41
23,r_14_56_75,r_44_4_132,seq63,r_44_4_132,1.0,2,134,132,41
19,r_68_42_133,r_2_1_199,r_71_0_7,r_68_42_133,0.77,0,133,133,41
15,r_29_28_23,r_21_69_86,r_10_12_157,r_21_69_86,1.0,0,86,86,41
1,r_21_69_86,seq7,seq64,r_21_69_86,0.42,90,176,86,41
11,r_16_55_27,seq64,seq58,r_16_55_27,0.48,89,116,27,41
3,r_18_43_3,r_40_45_184,seq62,r_18_43_3,0.35,182,185,3,41
10,r_40_45_184,r_18_43_3,r_10_12_157,r_40_45_184,0.36,1,185,184,41
15,r_29_28_23,r_27_60_129,r_21_69_86,r_29_28_23,0.59,0,23,23,41
14,r_23_54_189,r_71_0_7,r_29_28_23,r_29_28_23,0.53,166,189,23,41
0,r_44_4_132,r_32_65_64,r_27_60_129,r_32_65_64,0.75,0,64,64,41
13,r_71_0_7,r_23_54_189,r_68_42_133,r_68_42_133,0.99,3,136,133,41
6,r_32_65_64,r_44_4_132,r_50_3_101,r_32_65_64,1.0,1,65,64,41
18,r_38_33_22,seq24,r_37_48_5,r_38_33_22,0.92,0,22,22,41
0,r_44_4_132,r_14_56_75,seq9,r_44_4_132,1.0,4,136,132,41
29,seq15,r_40_45_184,r_59_11_112,r_59_11_112,0.88,37,149,112,41
4,r_22_20_38,seq72,seq26,r_22_20_38,0.62,5,43,38,41
24,r_59_11_112,seq47,seq15,r_59_11_112,0.92,0,112,112,41
11,r_16_55_27,r_40_45_184,seq64,r_16_55_27,1.0,1,28,27,41
17,r_37_48_5,seq26,r_38_33_22,r_38_33_22,0.82,12,34,22,41
2,r_17_73_121,r_35_6_50,r_71_0_7,r_35_6_50,0.66,2,52,50,41
2,r_17_73_121,r_21_69_86,seq49,r_17_73_121,1.0,0,121,121,41
22,r_35_6_50,r_17_73_121,seq39,r_35_6_50,0.83,0,50,50,41
32,seq26,r_37_48_5,r_22_20_38,r_22_20_38,0.94,-9,29,38,41
9,r_74_70_174,seq66,r_32_65_64,r_32_65_64,0.8,110,174,64,41
1,r_21_69_86,r_17_73_121,seq7,r_17_73_121,0.96,9,130,121,41
23,r_14_56_75,seq24,r_44_4_132,r_14_56_75,1.0,0,75,75,41
2,r_17_73_121,r_71_0_7,r_21_69_86,r_21_69_86,0.85,8,94,86,41
12,r_50_3_101,seq61,r_32_65_64,r_32_65_64,0.96,34,98,64,41
0,r_44_4_132,r_27_60_129,r_14_56_75,r_14_56_75,0.82,1,76,75,41
18,r_73_67_59,seq22,seq0,r_73_67_59,1.0,0,59,59,42
20,r_49_27_12,r_15_30_187,r_20_23_41,r_49_27_12,0.98,0,12,12,42
9,r_44_39_135,r_51_3_62,r_31_10_43,r_44_39_135,1.0,-92,43,135,42
9,r_44_39_135,r_31_10_43,seq40,r_44_39_135,0.98,1,136,135,42
8,r_38_21_182,seq35,r_34_28_15,r_38_21_182,0.43,0,182,182,42
16,r_8_74_77,seq72,r_62_24_6,r_8_74_77,1.0,1,78,77,42
21,r_19_1_101,seq41,seq72,r_19_1_101,1.0,0,101,101,42
39,seq40,r_16_46_160,r_44_39_135,r_44_39_135,0.89,25,160,135,42
6,r_48_47_155,seq58,r_59_25_49,r_48_47_155,0.57,0,155,155,42
46,seq60,r_69_9_101,r_62_24_6,r_69_9_101,0.94,0,101,101,42
19,r_15_30_187,seq41,r_44_39_135,r_44_39_135,0.81,53,188,135,42
3,r_20_23_41,r_49_27_12,seq37,r_20_23_41,0.99,1,42,41,42
10,r_5_7_104,r_48_47_155,r_62_24_6,r_5_7_104,1.0,3,107,104,42
4,r_32_70_85,r_52_36_163,r_49_27_12,r_32_70_85,1.0,0,85,85,42
0,r_16_46_160,seq40,r_69_9_101,r_16_46_160,0.83,0,160,160,42
13,r_51_3_62,r_44_39_135,seq41,r_51_3_62,1.0,1,63,62,42
15,r_52_36_163,seq2,seq6,r_52_36_163,0.5,0,163,163,42
20,r_49_27_12,r_20_23_41,r_48_47_155,r_20_23_41,0.67,1,42,41,42
6,r_48_47_155,r_5_7_104,seq58,r_48_47_155,0.58,-48,107,155,42
3,r_20_23_41,r_16_46_160,r_49_27_12,r_49_27_12,0.94,0,12,12,42
5,r_34_28_15,seq41,r_29_65_79,r_29_65_79,1.0,19,98,79,42
27,seq4,r_53_43_152,r_69_9_101,r_69_9_101,0.92,20,121,101,42
2,r_54_42_68,r_16_46_160,r_73_67_59,r_54_42_68,0.71,0,68,68,42
38,seq37,seq14,r_20_23_41,r_20_23_41,1.0,24,65,41,42
1,r_31_10_43,r_69_9_101,r_44_39_135,r_31_10_43,1.0,0,43,43,42
1,r_31_10_43,r_44_39_135,r_73_67_59,r_44_39_135,0.61,-34,101,135,42
17,r_59_25_49,r_53_43_152,r_48_47_155,r_59_25_49,0.59,108,157,49,42
20,r_49_27_12,r_48_47_155,r_32_70_85,r_32_70_85,0.75,0,85,85,42
22,r_53_43_152,seq4,r_50_68_4,r_53_43_152,0.74,-53,99,152,42
49,seq72,r_64_71_161,r_19_1_101,r_19_1_101,0.88,56,157,101,42
7,r_29_65_79,seq11,r_34_28_15,r_29_65_79,1.0,1,80,79,42
12,r_69_9_101,seq60,seq4,r_69_9_101,0.99,0,101,101,42
5,r_34_28_15,r_51_3_62,seq41,r_34_28_15,0.77,0,15,15,42
8,r_55_57_75,r_53_17_161,r_51_56_163,r_55_57_75,1.0,0,75,75,43
3,r_27_47_46,seq63,r_33_58_143,r_33_58_143,1.0,32,175,143,43
26,seq10,seq36,r_6_20_17,r_6_20_17,0.97,35,52,17,43
21,r_26_44_160,r_2_5_137,r_51_56_163,r_2_5_137,0.74,0,137,137,43
1,r_53_17_161,seq66,seq28,r_53_17_161,0.67,0,161,161,43
7,r_59_69_101,r_8_30_8,r_16_67_148,r_59_69_101,0.94,0,101,101,43
22,r_3_40_40,seq36,r_6_20_17,r_6_20_17,0.8,19,36,17,43
19,r_49_46_108,seq23,r_51_56_163,r_49_46_108,0.99,0,108,108,43
11,r_8_30_8,r_59_69_101,seq66,r_59_69_101,0.97,0,101,101,43
14,r_41_18_14,r_72_1_92,seq64,r_41_18_14,0.5,0,14,14,43
10,r_15_39_90,r_51_56_163,r_16_67_148,r_15_39_90,1.0,0,90,90,43
8,r_55_57_75,r_51_56_163,r_24_0_125,r_24_0_125,1.0,14,139,125,43
5,r_6_20_17,r_45_11_118,r_3_40_40,r_6_20_17,0.96,0,17,17,43
4,r_24_0_125,seq25,r_55_57_75,r_24_0_125,0.99,0,125,125,43
0,r_72_1_92,r_48_71_178,seq23,r_72_1_92,1.0,1,93,92,43
20,r_50_22_108,seq36,r_51_56_163,r_50_22_108,0.96,0,108,108,43
13,r_51_56_163,r_15_39_90,r_26_44_160,r_15_39_90,1.0,0,90,90,43
15,r_70_73_97,r_51_56_163,r_37_74_137,r_70_73_97,0.99,0,97,97,43
35,seq32,r_3_40_40,r_24_0_125,r_3_40_40,0.48,-15,25,40,43
13,r_51_56_163,r_26_44_160,r_49_46_108,r_26_44_160,0.71,0,160,160,43
2,r_14_19_3,r_33_58_143,seq28,r_33_58_143,1.0,-6,137,143,43
18,r_2_5_137,r_26_44_160,seq25,r_2_5_137,0.5,2,139,137,43
24,r_9_35_101,seq54,seq31,r_9_35_101,0.36,11,112,101,43
46,seq63,r_16_67_148,r_41_18_14,r_41_18_14,0.7,17,31,14,43
7,r_59_69_101,r_72_1_92,r_8_30_8,r_59_69_101,0.48,-87,14,101,43
35,seq32,r_24_0_125,seq10,r_24_0_125,0.61,-59,66,125,43
20,r_50_22_108,r_51_56_163,r_24_0_125,r_24_0_125,0.83,39,164,125,43
17,r_4_68_154,seq60,r_16_67_148,r_16_67_148,0.63,6,154,148,43
3,r_27_47_46,r_9_35_101,seq63,r_27_47_46,1.0,0,46,46,43
49,seq66,r_53_17_161,seq52,r_53_17_161,0.75,-10,151,161,43
23,r_45_11_118,seq7,r_70_73_97,r_45_11_118,0.52,0,118,118,43
21,r_26_44_160,r_51_56_163,seq36,r_26_44_160,0.58,0,160,160,43
12,r_33_58_143,r_14_19_3,r_16_67_148,r_33_58_143,0.81,0,143,143,43
15,r_1_61_178,r_68_17_112,r_44_65_122,r_1_61_178,0.99,1,179,178,44
14,r_20_13_105,seq8,seq74,r_20_13_105,0.33,8,113,105,44
46,seq69,r_24_29_106,r_40_58_154,r_24_29_106,0.78,2,108,106,44
39,seq45,r_10_63_21,seq6,r_10_63_21,0.88,3,24,21,44
31,seq25,r_28_59_125,r_49_19_83,r_28_59_125,1.0,-14,111,125,44
3,r_66_0_164,r_14_50_87,seq16,r_66_0_164,0.62,0,164,164,44
10,r_23_31_171,seq11,seq48,r_23_31_171,0.72,0,171,171,44
19,r_40_58_154,r_32_15_24,seq11,r_40_58_154,0.83,-131,23,154,44
44,seq57,seq48,r_10_63_21,r_10_63_21,1.0,0,21,21,44
0,r_24_29_106,seq69,seq26,r_24_29_106,0.97,2,108,106,44
37,seq41,r_20_13_105,r_46_71_30,r_46_71_30,1.0,4,34,30,44
11,r_52_12_182,seq16,seq21,r_52_12_182,0.52,0,182,182,44
22,r_3_64_53,seq21,r_32_15_24,r_3_64_53,1.0,0,53,53,44
15,r_1_61_178,r_37_2_152,r_68_17_112,r_68_17_112,0.79,42,154,112,44
6,r_68_17_112,seq48,seq8,r_68_17_112,0.98,0,112,112,44
13,r_5_43_19,r_9_34_196,r_55_4_4,r_5_43_19,0.44,0,19,19,44
4,r_10_63_21,seq45,seq57,r_10_63_21,1.0,0,21,21,44
17,r_51_38_162,r_70_33_199,seq69,r_51_38_162,0.87,0,162,162,44
18,r_32_15_24,r_40_58_154,r_3_64_53,r_32_15_24,0.96,24,48,24,44
9,r_37_2_152,r_1_61_178,seq11,r_37_2_152,0.92,2,154,152,44
7,r_14_50_87,r_66_0_164,seq72,r_66_0_164,1.0,0,164,164,44
24,r_46_71_30,r_3_64_53,seq41,r_46_71_30,0.99,1,31,30,44
12,r_28_59_125,seq36,seq8,r_28_59_125,0.84,0,125,125,44
30,seq13,r_16_30_129,r_74_43_68,r_74_43_68,1.0,3,71,68,45
2,r_8_9_146,r_0_25_56,r_15_5_73,r_15_5_73,0.99,3,76,73,45
8,r_65_58_110,seq72,seq23,r_65_58_110,0.84,6,116,110,45
16,r_47_64_162,seq10,seq37,r_47_64_162,0.44,0,162,162,45
5,r_71_40_153,seq26,r_63_38_185,r_71_40_153,0.44,23,176,153,45
2,r_8_9_146,r_15_5_73,seq52,r_8_9_146,0.98,7,153,146,45
0,r_27_33_41,seq39,seq3,r_27_33_41,0.54,61,102,41,45
11,r_0_25_56,r_8_9_146,r_49_31_87,r_49_31_87,0.67,-9,78,87,45
3,r_54_61_187,r_16_30_129,r_11_32_39,r_16_30_129,0.41,58,187,129,45
10,r_74_43_68,seq39,seq13,r_74_43_68,0.99,0,68,68,45
4,r_15_5_73,seq22,r_8_9_146,r_15_5_73,1.0,0,73,73,45
9,r_24_6_33,r_71_40_153,r_63_38_185,r_24_6_33,0.79,6,39,33,45
13,r_42_41_101,r_65_58_110,r_74_43_68,r_65_58_110,0.46,-9,101,110,45
15,r_69_51_198,r_18_56_101,r_63_38_185,r_18_56_101,1.0,1,102,101,45
4,r_15_5_73,r_8_9_146,r_14_4_134,r_15_5_73,0.67,79,152,73,45
6,r_63_38_185,r_24_6_33,r_71_40_153,r_63_38_185,0.53,0,185,185,45
0,r_27_33_41,seq20,seq39,r_27_33_41,0.78,3,44,41,45
18,r_18_56_101,r_69_51_198,r_27_33_41,r_69_51_198,0.94,-96,102,198,45
25,seq1,r_7_45_128,r_27_33_41,r_7_45_128,0.61,0,128,128,45
31,seq17,r_60_21_28,r_69_51_198,r_60_21_28,1.0,2,30,28,45
1,r_60_21_28,seq17,seq12,r_60_21_28,0.99,0,28,28,45
17,r_16_30_129,r_54_61_187,r_74_43_68,r_74_43_68,1.0,64,132,68,45
31,seq17,r_69_51_198,r_65_58_110,r_65_58_110,1.0,79,189,110,45
22,r_49_31_87,r_71_40_153,r_0_25_56,r_49_31_87,0.54,0,87,87,45
11,r_0_25_56,seq1,r_8_9_146,r_0_25_56,0.82,0,56,56,45
7,r_62_50_97,seq2,seq22,r_62_50_97,0.71,-8,89,97,45
44,seq55,r_35_34_127,seq53,r_35_34_127,1.0,2,129,127,45
23,r_35_34_127,seq55,seq22,r_35_34_127,0.63,2,129,127,45
42,seq52,r_57_28_58,r_48_36_147,r_57_28_58,0.59,1,59,58,45
22,r_49_31_87,r_0_25_56,r_15_5_73,r_49_31_87,0.75,27,114,87,45
2,r_8_9_146,r_65_58_110,r_0_25_56,r_8_9_146,0.48,-101,45,146,45
36,seq30,seq21,r_69_39_88,r_69_39_88,1.0,4,92,88,46
22,r_11_7_9,r_52_47_39,seq21,r_11_7_9,0.52,43,52,9,46
22,r_11_7_9,r_69_39_88,seq14,r_69_39_88,0.69,57,145,88,46
16,r_42_58_25,seq72,seq8,r_42_58_25,1.0,0,25,25,46
21,r_73_0_113,seq68,r_15_28_48,r_73_0_113,0.99,1,114,113,46
1,r_37_57_175,seq22,r_40_74_90,r_40_74_90,1.0,85,175,90,46
5,r_40_74_90,seq72,seq8,r_40_74_90,0.99,0,90,90,46
31,seq17,r_20_1_104,seq22,r_20_1_104,1.0,6,110,104,46
3,r_69_39_88,seq18,seq30,r_69_39_88,0.98,0,88,88,46
8,r_6_27_7,seq55,seq18,r_6_27_7,0.31,95,102,7,46
11,r_29_70_14,seq10,seq5,r_29_70_14,0.97,0,14,14,46
20,r_20_1_104,seq17,r_41_12_5,r_20_1_104,0.56,1,105,104,46
15,r_46_19_121,r_71_62_198,r_15_28_48,r_46_19_121,0.86,0,121,121,46
42,seq45,r_69_39_88,r_26_3_110,r_26_3_110,0.53,0,110,110,46
19,r_15_28_48,r_63_66_180,r_41_12_5,r_15_28_48,1.0,0,48,48,46
2,r_71_62_198,r_46_19_121,r_44_25_40,r_71_62_198,0.91,-78,120,198,46
25,seq5,r_65_4_104,r_29_70_14,r_29_70_14,1.0,-1,13,14,46
24,r_26_3_110,r_49_16_105,seq45,r_26_3_110,0.97,0,110,110,46
33,seq21,r_33_32_159,r_69_39_88,r_69_39_88,0.68,71,159,88,46
9,r_44_25_40,r_20_1_104,r_56_51_26,r_44_25_40,0.84,4,44,40,46
4,r_52_47_39,r_11_7_9,r_29_70_14,r_52_47_39,0.99,3,42,39,46
32,seq18,r_2_23_143,seq43,r_2_23_143,0.99,-2,141,143,46
6,r_56_51_26,seq14,r_44_25_40,r_44_25_40,0.84,0,40,40,46
17,r_2_23_143,seq18,seq34,r_2_23_143,0.98,0,143,143,46
49,seq72,r_40_74_90,r_65_4_104,r_40_74_90,1.0,-8,82,90,46
7,r_33_32_159,seq21,seq60,r_33_32_159,0.91,0,159,159,46
18,r_41_12_5,seq10,r_15_28_48,r_15_28_48,1.0,19,67,48,46
23,r_63_66_180,seq8,seq18,r_63_66_180,0.52,0,180,180,46
40,seq43,seq40,r_24_74_111,r_24_74_111,1.0,72,183,111,47
30,seq14,seq30,r_59_39_77,r_59_39_77,1.0,37,114,77,47
20,r_60_15_12,r_25_32_57,seq14,r_60_15_12,0.92,0,12,12,47
36,seq31,r_59_39_77,r_49_64_60,r_49_64_60,0.77,17,77,60,47
8,r_44_55_106,r_0_50_136,r_69_47_65,r_44_55_106,0.91,1,107,106,47
43,seq58,r_33_56_153,r_24_74_111,r_24_74_111,1.0,35,146,111,47
5,r_22_36_156,r_20_38_151,r_44_55_106,r_22_36_156,0.61,0,156,156,47
16,r_25_32_57,r_12_8_122,seq3,r_25_32_57,0.9,1,58,57,47
21,r_13_11_100,seq42,r_24_74_111,r_24_74_111,0.81,6,117,111,47
1,r_59_39_77,seq31,seq14,r_59_39_77,0.88,0,77,77,47
5,r_22_36_156,r_17_26_99,r_20_38_151,r_17_26_99,0.53,0,99,99,47
7,r_12_8_122,seq43,seq7,r_12_8_122,0.98,4,126,122,47
19,r_20_38_151,seq31,r_59_39_77,r_59_39_77,0.75,73,150,77,47
41,seq46,seq5,r_23_53_60,r_23_53_60,1.0,7,67,60,47
4,r_17_26_99,r_22_36_156,seq30,r_17_26_99,0.84,1,100,99,47
23,r_63_48_74,seq43,r_20_38_151,r_63_48_74,0.43,36,110,74,47
11,r_1_6_85,seq7,seq61,r_1_6_85,0.91,-2,83,85,47
15,r_34_52_138,seq7,seq42,r_34_52_138,0.8,2,140,138,47
6,r_24_74_111,seq16,r_13_11_100,r_24_74_111,0.99,0,111,111,47
24,r_69_47_65,seq7,r_44_55_106,r_44_55_106,0.79,3,109,106,47
2,r_9_65_176,seq31,r_59_39_77,r_59_39_77,0.86,100,177,77,47
18,r_23_53_60,r_44_55_106,seq46,r_23_53_60,0.98,0,60,60,47
24,r_69_47_65,seq58,seq7,r_69_47_65,0.97,1,66,65,47
17,r_33_56_153,seq58,r_25_32_57,r_33_56_153,0.38,0,153,153,47
9,r_0_50_136,seq71,seq16,r_0_50_136,0.83,1,137,136,47
3,r_72_57_16,r_33_56_153,r_54_70_193,r_72_57_16,0.89,1,17,16,47
22,r_66_4_87,seq16,seq68,r_66_4_87,1.0,1,88,87,47
0,r_49_64_60,r_54_70_193,seq31,r_49_64_60,0.92,-12,48,60,47
7,r_12_8_122,r_25_32_57,seq43,r_12_8_122,0.74,-60,62,122,47
44,seq61,seq51,r_1_6_85,r_1_6_85,1.0,-1,84,85,47
23,r_63_48_74,r_17_26_99,seq43,r_63_48_74,0.69,-1,73,74,47
36,seq30,seq34,r_10_2_88,r_10_2_88,1.0,42,130,88,48
32,seq18,r_22_69_48,r_14_8_100,r_14_8_100,1.0,1,101,100,48
8,r_47_39_141,r_19_74_161,r_10_2_88,r_10_2_88,1.0,73,161,88,48
21,r_21_49_111,seq53,r_33_70_17,r_21_49_111,0.99,0,111,111,48
39,seq37,r_19_74_161,r_10_2_88,r_10_2_88,1.0,73,161,88,48
46,seq62,r_43_26_181,r_35_23_186,r_35_23_186,0.99,-4,182,186,48
19,r_66_7_81,seq18,seq30,r_66_7_81,0.59,0,81,81,48
3,r_35_23_186,seq60,r_54_32_159,r_54_32_159,0.98,28,187,159,48
10,r_44_56_177,seq68,r_14_8_100,r_14_8_100,0.97,79,179,100,48
26,seq6,seq31,r_52_42_129,r_52_42_129,1.0,7,136,129,48
4,r_52_42_129,r_19_74_161,seq6,r_52_42_129,0.9,0,129,129,48
0,r_38_41_67,r_28_17_3,seq68,r_38_41_67,0.99,2,69,67,48
11,r_4_36_185,r_54_32_159,seq15,r_54_32_159,0.26,14,173,159,48
20,r_1_29_75,r_19_74_161,r_28_17_3,r_1_29_75,0.96,0,75,75,48
6,r_57_72_143,r_47_39_141,seq51,r_57_72_143,0.73,3,146,143,48
1,r_22_69_48,r_44_56_177,seq18,r_44_56_177,0.69,-128,49,177,48
2,r_10_2_88,seq53,r_66_7_81,r_10_2_88,1.0,0,88,88,48
12,r_45_48_55,r_57_72_143,seq53,r_45_48_55,1.0,0,55,55,48
24,r_63_46_52,r_73_5_142,r_45_48_55,r_63_46_52,0.57,27,79,52,48
33,seq20,r_73_5_142,seq31,r_73_5_142,0.99,1,143,142,48
17,r_43_26_181,seq62,r_57_72_143,r_57_72_143,0.58,39,182,143,48
9,r_19_74_161,seq12,r_38_41_67,r_38_41_67,0.87,94,161,67,48
49,seq68,r_50_58_28,r_38_41_67,r_38_41_67,1.0,10,77,67,48
13,r_23_41_22,seq24,seq25,r_23_41_22,0.97,-4,18,22,49
14,r_17_66_92,seq49,seq34,r_17_66_92,0.82,2,94,92,49
8,r_37_15_177,r_35_9_120,r_39_27_171,r_39_27_171,0.46,6,177,171,49
19,r_73_60_84,r_32_55_153,r_42_19_144,r_42_19_144,1.0,11,155,144,49
16,r_7_52_96,r_45_2_180,seq44,r_7_52_96,1.0,1,97,96,49
5,r_13_56_100,seq34,seq20,r_13_56_100,0.99,2,102,100,49
19,r_73_60_84,r_12_18_149,r_32_55_153,r_73_60_84,0.66,1,85,84,49
3,r_3_46_123,seq54,r_32_55_153,r_3_46_123,0.98,1,124,123,49
11,r_16_50_41,seq20,seq28,r_16_50_41,1.0,0,41,41,49
20,r_0_53_151,r_42_19_144,r_38_10_6,r_0_53_151,0.41,-7,144,151,49
30,seq24,r_23_41_22,seq49,r_23_41_22,1.0,4,26,22,49
15,r_11_62_141,r_22_69_145,seq1,r_11_62_141,0.99,0,141,141,49
23,r_6_30_69,r_22_69_145,r_61_21_97,r_6_30_69,0.5,30,99,69,49
22,r_63_31_74,r_26_43_47,r_22_69_145,r_22_69_145,1.0,4,149,145,49
2,r_61_21_97,seq1,r_6_30_69,r_61_21_97,0.76,0,97,97,49
40,seq54,r_3_46_123,seq36,r_3_46_123,0.99,1,124,123,49
24,r_42_19_144,r_0_53_151,r_73_60_84,r_42_19_144,0.47,0,144,144,49
21,r_26_43_47,seq48,seq64,r_26_43_47,1.0,0,47,47,49
1,r_51_71_31,r_63_31_74,r_14_67_143,r_51_71_31,1.0,0,31,31,49
7,r_40_29_56,seq72,seq44,r_40_29_56,1.0,0,56,56,49
17,r_12_18_149,r_73_60_84,seq59,r_73_60_84,1.0,3,87,84,49
22,r_63_31_74,seq25,r_26_43_47,r_63_31_74,1.0,0,74,74,49
23,r_6_30_69,r_14_67_143,r_22_69_145,r_6_30_69,0.91,0,69,69,49
17,r_12_18_149,seq59,r_3_46_123,r_12_18_149,1.0,0,149,149,49
35,seq36,r_3_46_123,r_37_15_177,r_3_46_123,0.86,-44,79,123,49
12,r_45_2_180,r_7_52_96,seq47,r_7_52_96,1.0,1,97,96,49
36,seq44,r_40_29_56,r_7_52_96,r_7_52_96,1.0,14,110,96,49
8,r_31_35_61,seq0,seq9,r_31_35_61,1.0,0,61,61,50
16,r_11_74_153,seq50,r_51_1_4,r_11_74_153,0.62,1,154,153,50
21,r_42_49_190,r_25_22_77,seq30,r_42_49_190,0.81,-113,77,190,50
1,r_54_36_142,seq59,r_10_57_40,r_10_57_40,0.99,116,156,40,50
46,seq70,seq24,r_54_36_142,r_54_36_142,0.52,-13,129,142,50
43,seq62,seq67,r_4_32_32,r_4_32_32,1.0,0,32,32,50
45,seq67,seq62,r_28_17_107,r_28_17_107,0.82,40,147,107,50
15,r_12_53_56,r_46_14_85,seq39,r_46_14_85,1.0,-27,58,85,50
20,r_46_14_85,seq59,r_13_23_32,r_46_14_85,0.98,-2,83,85,50
3,r_68_26_63,seq73,r_13_23_32,r_68_26_63,0.99,0,63,63,50
10,r_25_22_77,r_42_49_190,seq73,r_25_22_77,1.0,0,77,77,50
4,r_10_57_40,r_45_44_177,seq24,r_10_57_40,1.0,1,41,40,50
0,r_45_44_177,seq40,seq9,r_45_44_177,0.67,2,179,177,50
13,r_52_64_173,seq63,r_25_22_77,r_52_64_173,0.63,0,173,173,50
20,r_46_14_85,r_12_53_56,seq59,r_46_14_85,0.63,-37,48,85,50
19,r_19_60_57,seq73,r_8_20_37,r_19_60_57,0.68,38,95,57,50
19,r_19_60_57,seq0,seq73,r_19_60_57,0.93,-2,55,57,50
19,r_19_60_57,r_8_20_37,r_25_22_77,r_8_20_37,0.7,76,113,37,50
40,seq50,r_11_74_153,r_41_5_189,r_11_74_153,0.84,1,154,153,50
18,r_43_37_97,seq47,r_48_21_83,r_43_37_97,1.0,2,99,97,50
17,r_8_20_37,r_12_53_56,seq2,r_8_20_37,1.0,1,38,37,50
25,seq0,r_13_23_32,r_4_32_32,r_13_23_32,0.78,62,94,32,50
38,seq40,r_45_44_177,r_28_17_107,r_28_17_107,0.59,72,179,107,50
48,seq72,r_28_17_107,r_58_18_20,r_58_18_20,0.97,3,23,20,50
2,r_13_23_32,r_42_49_190,seq16,r_13_23_32,1.0,-1,31,32,50
22,r_48_21_83,seq15,seq63,r_48_21_83,0.72,0,83,83,50
49,seq73,seq47,r_25_22_77,r_25_22_77,1.0,13,90,77,50
44,seq63,r_7_56_8,r_48_21_83,r_48_21_83,0.82,4,87,83,50
11,r_4_32_32,r_61_66_189,seq62,r_4_32_32,1.0,0,32,32,50
23,r_28_17_107,seq2,seq40,r_28_17_107,0.91,2,109,107,50
35,seq34,r_61_66_189,r_10_57_40,r_10_57_40,1.0,142,182,40,50
7,r_29_65_46,r_19_60_57,r_58_18_20,r_29_65_46,0.94,0,46,46,50
14,r_17_9_164,r_53_57_147,r_72_19_55,r_53_57_147,0.39,-33,114,147,51
23,r_43_50_53,seq15,seq35,r_43_50_53,0.91,1,54,53,51
49,seq74,seq1,r_72_19_55,r_72_19_55,1.0,0,55,55,51
16,r_11_13_155,seq21,r_44_25_188,r_11_13_155,0.63,-1,154,155,51
39,seq46,r_31_28_181,r_34_68_108,r_34_68_108,0.84,78,186,108,51
1,r_47_7_118,r_44_25_188,seq41,r_47_7_118,0.95,0,118,118,51
5,r_53_57_147,seq14,r_43_50_53,r_53_57_147,0.88,2,149,147,51
19,r_61_64_12,seq26,seq62,r_61_64_12,0.55,0,12,12,51
24,r_20_65_63,r_11_13_155,r_47_7_118,r_20_65_63,0.92,66,129,63,51
10,r_66_39_129,seq12,r_58_36_197,r_66_39_129,0.91,0,129,129,51
15,r_27_3_25,seq16,seq21,r_27_3_25,0.85,-6,19,25,51
0,r_34_68_108,r_30_37_188,seq23,r_34_68_108,0.85,0,108,108,51
11,r_58_36_197,r_30_37_188,r_66_39_129,r_66_39_129,0.99,3,132,129,51
13,r_0_32_129,seq12,seq21,r_0_32_129,0.87,0,129,129,51
8,r_29_10_18,r_42_45_197,seq63,r_29_10_18,0.93,-1,17,18,51
29,seq12,r_0_32_129,r_54_5_158,r_0_32_129,0.55,2,131,129,51
24,r_20_65_63,r_55_22_193,r_11_13_155,r_20_65_63,1.0,2,65,63,51
3,r_72_19_55,r_43_50_53,seq74,r_72_19_55,0.78,-1,54,55,51
17,r_44_25_188,r_47_7_118,r_54_5_158,r_47_7_118,0.84,0,118,118,51
9,r_55_22_193,r_20_65_63,seq52,r_20_65_63,1.0,2,65,63,51
17,r_44_25_188,r_54_5_158,r_11_13_155,r_44_25_188,0.57,-43,145,188,51
35,seq26,r_8_71_182,r_66_39_129,r_8_71_182,0.45,0,182,182,51
14,r_17_9_164,r_72_19_55,r_61_64_12,r_17_9_164,0.61,4,168,164,51
36,seq40,r_67_12_162,r_14_49_81,r_14_49_81,1.0,3,84,81,52
8,r_43_22_113,r_55_26_29,seq37,r_43_22_113,0.98,0,113,113,52
43,seq62,r_33_63_97,seq11,r_33_63_97,1.0,-29,68,97,52
2,r_60_64_59,seq52,r_5_6_9,r_60_64_59,1.0,0,59,59,52
16,r_25_7_112,r_61_39_130,seq40,r_25_7_112,0.59,1,113,112,52
39,seq46,seq74,r_68_29_47,r_68_29_47,0.94,84,131,47,52
5,r_55_26_29,r_43_22_113,r_13_65_8,r_43_22_113,0.81,2,115,113,52
19,r_23_58_109,seq21,r_60_64_59,r_23_58_109,1.0,1,110,109,52
3,r_35_10_85,r_43_22_113,seq32,r_35_10_85,1.0,0,85,85,52
0,r_50_18_181,r_2_66_108,r_38_4_107,r_2_66_108,1.0,0,108,108,52
11,r_31_8_181,seq37,r_50_18_181,r_50_18_181,0.85,0,181,181,52
20,r_61_39_130,r_25_7_112,r_57_34_191,r_61_39_130,0.61,-17,113,130,52
13,r_33_63_97,seq72,seq36,r_33_63_97,1.0,0,97,97,52
41,seq52,r_60_64_59,seq3,r_60_64_59,0.96,0,59,59,52
15,r_42_1_93,r_43_22_113,r_48_59_163,r_42_1_93,1.0,0,93,93,52
21,r_53_19_155,r_5_6_9,r_2_66_108,r_53_19_155,0.79,0,155,155,52
0,r_50_18_181,r_38_4_107,r_35_10_85,r_35_10_85,0.69,94,179,85,52
18,r_2_66_108,r_67_12_162,r_53_19_155,r_2_66_108,1.0,54,162,108,52
9,r_68_29_47,r_47_15_17,seq69,r_68_29_47,1.0,0,47,47,52
18,r_2_66_108,r_50_18_181,r_67_12_162,r_2_66_108,1.0,0,108,108,52
34,seq36,r_47_15_17,r_33_63_97,r_33_63_97,1.0,21,118,97,52
20,r_61_39_130,r_57_34_191,r_68_29_47,r_61_39_130,1.0,2,132,130,52
22,r_14_49_81,r_47_15_17,seq40,r_14_49_81,1.0,0,81,81,52
44,seq69,seq74,r_68_29_47,r_68_29_47,1.0,108,155,47,52
17,r_5_6_9,r_53_19_155,r_60_64_59,r_60_64_59,0.61,96,155,59,52
35,seq37,r_31_8_181,r_43_22_113,r_43_22_113,0.99,68,181,113,52
14,r_65_27_170,r_12_47_142,seq41,r_12_47_142,0.82,2,144,142,53
8,r_39_25_181,seq24,r_0_71_193,r_39_25_181,0.53,0,181,181,53
37,seq44,r_33_7_182,r_36_11_36,r_36_11_36,0.9,62,98,36,53
21,r_19_5_172,seq44,r_1_51_77,r_19_5_172,0.64,0,172,172,53
1,r_62_69_64,seq42,r_4_21_18,r_62_69_64,0.93,14,78,64,53
5,r_56_30_115,seq10,r_15_70_51,r_15_70_51,1.0,74,125,51,53
7,r_4_21_18,r_2_61_136,r_62_69_64,r_2_61_136,0.64,2,138,136,53
19,r_53_60_93,r_62_69_64,seq49,r_53_60_93,0.95,0,93,93,53
2,r_14_46_61,r_15_70_51,seq74,r_15_70_51,1.0,0,51,51,53
31,seq24,r_39_25_181,r_17_16_102,r_17_16_102,0.99,67,169,102,53
3,r_58_22_130,r_39_25_181,r_48_3_64,r_58_22_130,0.96,-3,127,130,53
10,r_12_47_142,r_65_27_170,seq57,r_12_47_142,0.57,2,144,142,53
26,seq8,seq45,r_55_29_56,r_55_29_56,1.0,10,66,56,53
16,r_15_70_51,r_14_46_61,seq45,r_15_70_51,1.0,0,51,51,53
0,r_17_16_102,seq49,r_58_22_130,r_17_16_102,0.92,0,102,102,53
15,r_48_3_64,r_2_61_136,seq23,r_48_3_64,1.0,2,66,64,53
6,r_34_43_173,seq23,r_17_16_102,r_17_16_102,0.86,75,177,102,53
22,r_2_61_136,r_62_69_64,seq66,r_2_61_136,1.0,2,138,136,53
20,r_55_29_56,seq10,seq8,r_55_29_56,0.88,1,57,56,53
28,seq10,r_55_29_56,seq72,r_55_29_56,0.87,1,57,56,53
0,r_17_16_102,r_58_22_130,seq24,r_58_22_130,0.95,0,130,130,53
38,seq45,seq8,r_15_70_51,r_15_70_51,1.0,15,66,51,53
24,r_36_11_36,seq66,seq44,r_36_11_36,1.0,1,37,36,53
17,r_26_37_108,seq23,r_4_21_18,r_4_21_18,0.51,93,111,18,53
9,r_1_51_77,r_26_37_108,seq35,r_1_51_77,1.0,0,77,77,53
22,r_2_61_136,r_48_3_64,r_62_69_64,r_2_61_136,0.94,-70,66,136,53
7,r_4_21_18,r_59_28_154,r_2_61_136,r_4_21_18,0.58,18,36,18,53
18,r_38_63_171,seq6,r_20_31_123,r_38_63_171,0.56,0,171,171,53
35,seq41,r_65_27_170,r_20_31_123,r_65_27_170,0.45,-11,159,170,53
14,r_32_26_151,seq43,r_24_64_152,r_32_26_151,0.76,0,151,151,54
8,r_46_4_27,seq18,seq11,r_46_4_27,0.58,53,80,27,54
37,seq41,r_50_54_123,r_60_13_123,r_50_54_123,1.0,2,125,123,54
16,r_53_9_70,seq8,r_15_3_90,r_15_3_90,1.0,58,148,90,54
5,r_63_49_153,r_47_28_2,r_52_30_25,r_47_28_2,0.64,151,153,2,54
3,r_71_29_26,r_15_3_90,seq74,r_15_3_90,0.57,-66,24,90,54
13,r_19_21_1,r_53_9_70,r_69_25_188,r_19_21_1,0.32,50,51,1,54
2,r_61_39_50,r_50_54_123,r_24_64_152,r_61_39_50,0.96,0,50,50,54
19,r_47_28_2,r_63_49_153,r_36_0_77,r_36_0_77,0.96,76,153,77,54
10,r_15_3_90,r_36_0_77,r_33_27_122,r_36_0_77,0.56,-6,71,77,54
20,r_52_30_25,r_23_16_111,seq8,r_52_30_25,1.0,0,25,25,54
26,seq5,r_33_27_122,r_32_26_151,r_32_26_151,0.95,4,155,151,54
4,r_24_64_152,r_33_27_122,r_61_39_50,r_61_39_50,1.0,20,70,50,54
0,r_7_2_88,seq18,seq45,r_7_2_88,0.93,1,89,88,54
11,r_36_0_77,r_15_3_90,r_47_28_2,r_36_0_77,1.0,0,77,77,54
25,seq1,r_7_2_88,r_55_73_78,r_7_2_88,0.77,-29,59,88,54
4,r_24_64_152,r_61_39_50,r_32_26_151,r_32_26_151,0.86,4,155,151,54
2,r_61_39_50,r_24_64_152,r_33_27_122,r_61_39_50,0.65,105,155,50,54
10,r_15_3_90,r_33_27_122,r_53_9_70,r_33_27_122,0.57,-31,91,122,54
18,r_67_34_104,seq12,seq10,r_67_34_104,0.98,0,104,104,54
29,seq11,seq18,r_46_4_27,r_46_4_27,0.56,53,80,27,54
24,r_50_54_123,seq41,r_24_64_152,r_50_54_123,0.92,2,125,123,54
38,seq43,r_32_26_151,seq70,r_32_26_151,0.91,3,154,151,54
17,r_20_48_146,r_63_49_153,seq11,r_63_49_153,0.63,-7,146,153,54
9,r_33_27_122,seq5,r_61_39_50,r_61_39_50,1.0,105,155,50,54
28,seq10,r_69_25_188,r_67_34_104,r_67_34_104,0.69,0,104,104,54
12,r_55_73_78,seq18,seq1,r_55_73_78,0.53,1,79,78,54
8,r_47_26_131,seq64,seq31,r_47_26_131,0.73,0,131,131,55
3,r_0_37_167,r_10_63_198,r_27_66_35,r_27_66_35,1.0,0,35,35,55
15,r_51_48_32,seq31,r_27_66_35,r_51_48_32,0.99,3,35,32,55
3,r_0_37_167,r_27_66_35,r_30_28_145,r_0_37_167,0.77,1,168,167,55
16,r_22_41_73,r_65_70_191,seq20,r_22_41_73,0.78,2,75,73,55
21,r_19_23_127,seq40,r_35_6_66,r_19_23_127,0.62,0,127,127,55
1,r_45_13_24,seq11,r_52_42_91,r_52_42_91,1.0,-2,89,91,55
5,r_57_58_135,seq49,seq24,r_57_58_135,0.79,3,138,135,55
19,r_21_16_156,seq11,r_15_2_130,r_21_16_156,0.91,0,156,156,55
41,seq53,r_21_16_156,r_72_1_106,r_21_16_156,0.92,-18,138,156,55
10,r_4_33_149,seq17,seq49,r_4_33_149,0.83,0,149,149,55
0,r_73_18_168,seq9,r_21_16_156,r_73_18_168,0.66,1,169,168,55
20,r_69_68_168,seq62,r_36_50_25,r_36_50_25,0.59,143,168,25,55
4,r_27_66_35,r_0_37_167,r_51_48_32,r_0_37_167,0.98,1,168,167,55
7,r_36_50_25,seq53,seq14,r_36_50_25,0.98,0,25,25,55
31,seq17,r_45_13_24,r_4_33_149,r_45_13_24,1.0,0,24,24,55
2,r_30_28_145,seq39,r_38_74_146,r_38_74_146,0.55,0,146,146,55
47,seq64,r_47_26_131,seq49,r_47_26_131,0.69,0,131,131,55
40,seq49,r_57_58_135,seq64,r_57_58_135,0.75,3,138,135,55
25,seq3,r_52_42_91,seq9,r_52_42_91,1.0,2,93,91,55
6,r_10_63_198,r_0_37_167,r_45_13_24,r_45_13_24,1.0,1,25,24,55
1,r_45_13_24,seq17,seq11,r_45_13_24,1.0,0,24,24,55
4,r_27_66_35,seq14,r_0_37_167,r_27_66_35,1.0,1,36,35,55
17,r_59_34_81,r_19_23_127,seq40,r_19_23_127,1.0,9,136,127,55
17,r_59_34_81,r_35_6_66,r_19_23_127,r_59_34_81,0.65,0,81,81,55
25,seq3,seq9,r_0_37_167,r_0_37_167,0.78,22,189,167,55
9,r_52_42_91,seq3,r_45_13_24,r_52_42_91,0.97,0,91,91,55
31,seq17,r_4_33_149,seq9,r_4_33_149,0.99,-10,139,149,55
23,r_35_6_66,r_59_34_81,seq62,r_59_34_81,0.52,-6,75,81,55
12,r_72_1_106,r_21_16_156,seq53,r_21_16_156,0.73,9,165,156,55
30,seq23,r_58_12_181,r_21_2_176,r_21_2_176,0.45,6,182,176,56
2,r_14_62_15,seq10,seq53,r_14_62_15,0.96,0,15,15,56
14,r_39_31_172,r_34_73_86,seq54,r_34_73_86,0.66,-10,76,86,56
16,r_58_12_181,seq23,r_29_13_39,r_29_13_39,0.97,143,182,39,56
22,r_42_51_35,r_6_26_58,seq11,r_42_51_35,1.0,0,35,35,56
5,r_34_73_86,r_39_31_172,r_67_56_17,r_39_31_172,0.55,-96,76,172,56
1,r_29_13_39,r_19_38_143,seq20,r_29_13_39,1.0,0,39,39,56
19,r_67_56_17,r_47_18_185,r_34_73_86,r_67_56_17,0.56,58,75,17,56
15,r_71_5_30,seq55,seq68,r_71_5_30,1.0,0,30,30,56
10,r_33_32_189,seq66,r_17_72_144,r_33_32_189,0.49,0,189,189,56
24,r_1_41_198,r_6_26_58,r_36_35_53,r_6_26_58,1.0,-5,53,58,56
14,r_39_31_172,seq54,r_29_13_39,r_39_31_172,0.89,0,172,172,56
4,r_3_44_80,r_58_12_181,seq65,r_3_44_80,0.99,1,81,80,56
13,r_8_74_65,seq20,seq60,r_8_74_65,1.0,0,65,65,56
48,seq69,r_47_18_185,r_28_64_176,r_28_64_176,0.84,11,187,176,56
36,seq48,seq55,r_40_9_19,r_40_9_19,0.99,35,54,19,56
6,r_17_72_144,r_67_56_17,seq63,r_17_72_144,0.85,0,144,144,56
9,r_40_9_19,seq68,seq48,r_40_9_19,1.0,0,19,19,56
18,r_61_30_169,seq43,seq69,r_61_30_169,0.58,2,171,169,56
29,seq20,seq49,r_29_13_39,r_29_13_39,1.0,86,125,39,56
33,seq37,r_50_7_185,r_47_18_185,r_47_18_185,0.59,0,185,185,56
28,seq11,r_19_38_143,r_42_51_35,r_42_51_35,0.76,0,35,35,56
34,seq43,r_61_30_169,r_29_13_39,r_29_13_39,0.98,131,170,39,56
17,r_50_7_185,seq37,r_14_62_15,r_50_7_185,0.27,0,185,185,56
7,r_28_64_176,seq59,seq0,r_28_64_176,0.68,0,176,176,56
23,r_19_38_143,seq11,seq23,r_19_38_143,1.0,0,143,143,56
12,r_16_22_106,r_1_41_198,seq68,r_16_22_106,1.0,0,106,106,56
20,r_36_35_53,seq49,r_1_41_198,r_36_35_53,0.92,1,54,53,56
30,seq19,r_26_40_133,seq43,r_26_40_133,0.99,0,133,133,57
14,r_64_41_91,r_28_59_163,seq29,r_28_59_163,0.97,-37,126,163,57
22,r_2_57_26,r_9_45_81,seq72,r_2_57_26,0.63,0,26,26,57
3,r_13_0_37,r_16_74_189,seq36,r_13_0_37,0.56,-2,35,37,57
21,r_14_32_196,seq42,r_23_67_79,r_23_67_79,0.91,10,89,79,57
39,seq42,r_69_37_153,r_61_38_98,r_69_37_153,0.98,1,154,153,57
45,seq63,r_66_10_178,r_9_45_81,r_9_45_81,1.0,10,91,81,57
1,r_30_49_36,r_14_32_196,r_18_58_85,r_30_49_36,0.66,-1,35,36,57
10,r_9_45_81,seq43,seq63,r_9_45_81,1.0,1,82,81,57
1,r_30_49_36,r_18_58_85,r_28_59_163,r_18_58_85,0.99,1,86,85,57
16,r_33_8_164,r_25_55_35,seq20,r_33_8_164,0.42,0,164,164,57
11,r_31_12_70,seq68,seq35,r_31_12_70,1.0,-1,69,70,57
20,r_26_40_133,seq19,r_18_58_85,r_26_40_133,0.93,0,133,133,57
13,r_18_58_85,r_30_49_36,seq4,r_18_58_85,0.99,0,85,85,57
15,r_52_6_2,r_47_24_119,seq20,r_52_6_2,0.37,110,112,2,57
1,r_30_49_36,r_28_59_163,r_61_38_98,r_28_59_163,0.6,-27,136,163,57
4,r_25_55_35,r_33_8_164,seq34,r_33_8_164,0.93,-1,163,164,57
6,r_69_37_153,seq42,r_9_45_81,r_69_37_153,0.83,1,154,153,57
0,r_71_56_45,seq62,seq68,r_71_56_45,0.99,-1,44,45,57
16,r_33_8_164,seq20,r_66_10_178,r_66_10_178,0.78,0,178,178,57
24,r_54_3_130,seq4,seq39,r_54_3_130,0.89,0,130,130,57
32,seq21,r_16_74_189,r_13_0_37,r_16_74_189,0.54,0,189,189,57
38,seq39,seq43,r_54_3_130,r_54_3_130,1.0,14,144,130,57
17,r_16_74_189,r_13_0_37,seq21,r_16_74_189,0.51,-123,66,189,57
9,r_23_67_79,seq17,r_14_32_196,r_23_67_79,0.92,4,83,79,57
16,r_33_8_164,seq27,r_25_55_35,r_25_55_35,1.0,0,35,35,57
28,seq15,r_28_59_163,seq72,r_28_59_163,1.0,0,163,163,57
4,r_25_55_35,seq21,r_33_8_164,r_25_55_35,1.0,0,35,35,57
44,seq62,r_54_3_130,r_47_24_119,r_54_3_130,0.94,-5,125,130,57
23,r_46_50_106,r_54_3_130,seq44,r_46_50_106,0.99,2,108,106,57
17,r_16_74_189,seq21,r_18_58_85,r_16_74_189,0.6,0,189,189,57
12,r_65_22_165,seq68,r_47_24_119,r_65_22_165,0.84,0,165,165,57
5,r_48_53_15,r_7_1_10,seq68,r_48_53_15,0.97,0,15,15,57
8,r_53_31_139,r_20_47_96,r_4_16_82,r_53_31_139,0.99,-43,96,139,58
14,r_37_54_106,r_50_57_56,seq3,r_37_54_106,1.0,0,106,106,58
21,r_18_0_139,r_35_42_108,r_44_1_89,r_44_1_89,0.6,6,95,89,58
5,r_35_42_108,r_18_0_139,seq62,r_35_42_108,0.98,1,109,108,58
46,seq55,r_6_71_71,r_61_33_90,r_61_33_90,0.73,7,97,90,58
47,seq62,r_35_42_108,r_53_31_139,r_53_31_139,0.95,23,162,139,58
19,r_40_11_98,r_44_1_89,seq52,r_44_1_89,0.96,9,98,89,58
41,seq38,r_7_72_122,r_30_65_72,r_7_72_122,0.55,-57,65,122,58
3,r_20_47_96,r_53_31_139,seq8,r_20_47_96,1.0,0,96,96,58
10,r_28_64_129,seq45,seq38,r_28_64_129,0.99,0,129,129,58
0,r_50_57_56,seq22,r_6_71_71,r_50_57_56,0.69,15,71,56,58
13,r_7_72_122,seq38,seq10,r_7_72_122,0.93,2,124,122,58
46,seq55,r_61_33_90,r_48_63_187,r_61_33_90,0.43,97,187,90,58
15,r_6_71_71,seq55,r_50_57_56,r_6_71_71,1.0,0,71,71,58
16,r_56_60_47,r_44_1_89,seq27,r_56_60_47,1.0,0,47,47,58
6,r_70_29_140,seq13,seq15,r_70_29_140,0.98,0,140,140,58
25,seq2,r_46_34_179,r_68_58_23,r_68_58_23,1.0,4,27,23,58
22,r_61_33_90,r_4_16_82,r_50_57_56,r_61_33_90,0.63,66,156,90,58
2,r_17_43_88,seq51,seq45,r_17_43_88,1.0,0,88,88,58
47,seq62,r_40_11_98,r_35_42_108,r_35_42_108,0.97,6,114,108,58
18,r_4_16_82,r_40_11_98,seq22,r_4_16_82,1.0,0,82,82,58
24,r_44_1_89,r_40_11_98,seq45,r_44_1_89,0.99,16,105,89,58
21,r_18_0_139,r_44_1_89,seq25,r_18_0_139,1.0,0,139,139,58
14,r_37_54_106,r_36_66_100,r_50_57_56,r_37_54_106,0.49,-48,58,106,58
1,r_68_58_23,r_6_71_71,seq2,r_68_58_23,1.0,0,23,23,58
9,r_41_14_126,seq27,r_30_65_72,r_41_14_126,1.0,1,127,126,58
22,r_61_33_90,seq13,r_4_16_82,r_61_33_90,0.99,0,90,90,58
28,seq8,seq39,r_20_47_96,r_20_47_96,1.0,4,100,96,58
7,r_30_65_72,r_7_72_122,r_41_14_126,r_30_65_72,1.0,54,126,72,58
44,seq51,r_17_43_88,seq10,r_17_43_88,1.0,-7,81,88,58
8,r_53_31_139,r_4_16_82,seq62,r_53_31_139,1.0,0,139,139,58
23,r_12_74_161,seq10,r_18_0_139,r_12_74_161,0.87,1,162,161,58
12,r_48_63_187,seq9,seq55,r_48_63_187,0.37,0,187,187,58
36,seq33,r_10_57_162,r_60_8_99,r_60_8_99,0.8,-28,71,99,59
14,r_60_8_99,seq55,seq69,r_60_8_99,1.0,0,99,99,59
16,r_61_17_104,r_24_46_144,seq64,r_61_17_104,0.96,9,113,104,59
1,r_31_32_124,r_70_14_149,r_66_65_112,r_31_32_124,0.73,2,126,124,59
46,seq64,r_63_56_122,seq9,r_63_56_122,0.98,3,125,122,59
18,r_23_47_43,seq7,seq30,r_23_47_43,0.99,2,45,43,59
45,seq55,r_60_8_99,seq53,r_60_8_99,1.0,0,99,99,59
19,r_13_37_94,seq2,seq74,r_13_37_94,1.0,0,94,94,59
3,r_67_50_38,r_66_65_112,r_44_73_96,r_67_50_38,0.87,2,40,38,59
26,seq1,r_59_6_16,r_5_35_77,r_5_35_77,1.0,5,82,77,59
11,r_40_21_130,seq64,r_31_32_124,r_31_32_124,0.63,10,134,124,59
20,r_29_43_86,r_11_27_153,seq68,r_29_43_86,0.56,0,86,86,59
13,r_63_56_122,seq64,seq1,r_63_56_122,0.57,3,125,122,59
6,r_24_46_144,r_3_58_160,seq7,r_24_46_144,0.82,0,144,144,59
27,seq2,r_13_37_94,seq64,r_13_37_94,1.0,0,94,94,59
0,r_44_73_96,r_67_50_38,seq69,r_44_73_96,0.95,2,98,96,59
2,r_3_58_160,r_24_46_144,r_31_32_124,r_3_58_160,0.93,-15,145,160,59
24,r_66_65_112,seq54,r_31_32_124,r_66_65_112,0.92,13,125,112,59
35,seq30,seq51,r_23_47_43,r_23_47_43,1.0,14,57,43,59
25,seq0,r_4_48_104,r_62_28_199,r_4_48_104,1.0,0,104,104,59
23,r_70_14_149,r_44_73_96,seq51,r_70_14_149,0.47,0,149,149,59
0,r_44_73_96,seq22,r_67_50_38,r_67_50_38,0.7,4,42,38,59
17,r_5_35_77,r_72_71_136,seq1,r_5_35_77,0.97,0,77,77,59
9,r_49_36_21,seq18,seq30,r_49_36_21,0.83,0,21,21,59
36,seq33,r_60_8_99,r_39_12_103,r_60_8_99,0.9,0,99,99,59
22,r_39_12_103,seq22,seq33,r_39_12_103,0.86,10,113,103,59
3,r_67_50_38,r_44_73_96,seq22,r_44_73_96,1.0,2,98,96,59
7,r_11_27_153,seq7,seq22,r_11_27_153,0.72,3,156,153,59
44,seq54,r_66_65_112,r_59_6_16,r_66_65_112,0.97,1,113,112,59
23,r_70_14_149,r_31_32_124,r_44_73_96,r_44_73_96,0.63,30,126,96,59
12,r_4_48_104,seq0,seq26,r_4_48_104,1.0,0,104,104,59
14,r_51_59_156,seq21,r_71_17_20,r_51_59_156,0.89,-2,154,156,60
8,r_39_3_174,seq27,seq26,r_39_3_174,0.71,0,174,174,60
31,seq19,r_41_38_34,seq5,r_41_38_34,1.0,1,35,34,60
3,r_41_38_34,seq19,r_47_20_198,r_41_38_34,1.0,1,35,34,60
37,seq30,r_47_20_198,r_72_55_100,r_72_55_100,1.0,16,116,100,60
16,r_9_33_117,r_71_17_20,r_64_56_29,r_9_33_117,0.97,0,117,117,60
22,r_61_74_35,r_72_55_100,seq16,r_61_74_35,0.87,0,35,35,60
5,r_1_52_120,r_34_35_77,seq18,r_34_35_77,1.0,1,78,77,60
46,seq65,r_25_46_84,r_66_12_33,r_25_46_84,0.82,1,85,84,60
24,r_2_67_152,r_29_15_6,r_25_46_84,r_2_67_152,0.9,0,152,152,60
19,r_34_35_77,r_1_52_120,r_64_56_29,r_34_35_77,0.85,1,78,77,60
11,r_71_17_20,r_29_15_6,r_51_59_156,r_71_17_20,0.93,129,149,20,60
15,r_66_12_33,seq10,seq53,r_66_12_33,0.99,-3,30,33,60
0,r_31_11_101,seq53,seq10,r_31_11_101,0.83,1,102,101,60
11,r_71_17_20,r_9_33_117,r_29_15_6,r_71_17_20,0.95,97,117,20,60
13,r_64_56_29,r_63_44_32,r_34_35_77,r_34_35_77,0.96,0,77,77,60
10,r_23_8_56,r_2_67_152,seq16,r_23_8_56,1.0,0,56,56,60
48,seq69,seq10,r_31_11_101,r_31_11_101,0.92,52,153,101,60
12,r_29_15_6,r_2_67_152,seq37,r_29_15_6,0.63,146,152,6,60
6,r_32_48_93,r_2_67_152,r_6_57_64,r_6_57_64,0.72,15,79,64,60
27,seq10,seq69,r_31_11_101,r_31_11_101,0.95,31,132,101,60
2,r_6_57_64,r_32_48_93,r_29_15_6,r_32_48_93,1.0,0,93,93,60
2,r_6_57_64,seq26,r_32_48_93,r_6_57_64,0.99,0,64,64,60
29,seq16,seq21,r_23_8_56,r_23_8_56,1.0,8,64,56,60
25,seq4,r_54_7_187,r_41_38_34,r_41_38_34,1.0,153,187,34,60
20,r_63_44_32,r_51_59_156,seq69,r_63_44_32,1.0,0,32,32,60
6,r_32_48_93,r_6_57_64,r_49_70_93,r_32_48_93,0.65,0,93,93,60
24,r_2_67_152,r_23_8_56,r_29_15_6,r_2_67_152,0.69,-138,14,152,60
17,r_25_46_84,seq65,seq58,r_25_46_84,0.78,1,85,84,60
9,r_54_7_187,seq4,r_1_52_120,r_54_7_187,0.31,0,187,187,60
44,seq53,seq68,r_66_12_33,r_66_12_33,1.0,105,138,33,60
23,r_72_55_100,seq58,seq30,r_72_55_100,1.0,0,100,100,60
17,r_0_34_86,seq5,r_11_73_14,r_11_73_14,0.73,8,22,14,61
3,r_11_73_14,r_63_68_145,r_14_74_194,r_11_73_14,0.4,75,89,14,61
16,r_17_3_121,r_30_44_130,r_0_34_86,r_17_3_121,0.97,0,121,121,61
21,r_35_69_193,r_29_57_100,seq5,r_29_57_100,0.97,0,100,100,61
39,seq46,seq22,r_6_1_67,r_6_1_67,1.0,5,72,67,61
1,r_36_54_148,r_20_18_190,r_52_48_131,r_52_48_131,0.81,23,154,131,61
5,r_66_53_67,r_20_18_190,r_36_54_148,r_66_53_67,0.96,76,143,67,61
24,r_37_10_65,r_58_67_155,r_29_57_100,r_37_10_65,0.44,92,157,65,61
19,r_29_57_100,r_35_69_193,seq16,r_29_57_100,1.0,0,100,100,61
15,r_72_40_70,seq23,r_20_18_190,r_20_18_190,0.37,-23,167,190,61
10,r_62_28_141,r_35_69_193,r_29_57_100,r_35_69_193,0.75,-52,141,193,61
3,r_11_73_14,r_14_74_194,seq59,r_11_73_14,0.59,127,141,14,61
4,r_32_65_168,r_9_21_36,r_20_18_190,r_9_21_36,0.59,132,168,36,61
0,r_15_45_183,seq31,r_6_1_67,r_15_45_183,0.34,-3,180,183,61
11,r_30_44_130,r_17_3_121,r_20_18_190,r_17_3_121,0.98,1,122,121,61
20,r_6_1_67,r_20_18_190,seq46,r_6_1_67,0.97,3,70,67,61
13,r_13_51_76,r_37_10_65,seq23,r_37_10_65,0.99,4,69,65,61
15,r_72_40_70,seq64,seq23,r_72_40_70,1.0,0,70,70,61
6,r_58_67_155,r_43_12_129,r_37_10_65,r_37_10_65,0.93,3,68,65,61
2,r_7_2_127,seq27,seq5,r_7_2_127,0.87,8,135,127,61
18,r_52_48_131,seq31,r_36_54_148,r_52_48_131,0.88,0,131,131,61
3,r_11_73_14,seq59,r_58_67_155,r_58_67_155,0.62,5,160,155,61
24,r_37_10_65,r_13_51_76,r_58_67_155,r_37_10_65,0.94,0,65,65,61
25,seq5,seq24,r_7_2_127,r_7_2_127,0.95,-4,123,127,61
17,r_0_34_86,r_11_73_14,seq64,r_0_34_86,0.7,-27,59,86,61
6,r_58_67_155,r_37_10_65,r_11_73_14,r_58_67_155,0.46,4,159,155,61
14,r_55_42_13,r_7_2_127,seq23,r_55_42_13,0.77,-1,12,13,61
3,r_11_73_14,seq46,r_63_68_145,r_11_73_14,0.88,7,21,14,61
22,r_63_68_145,seq59,r_7_2_127,r_63_68_145,0.39,11,156,145,61
7,r_43_12_129,r_52_48_131,r_0_34_86,r_43_12_129,0.96,2,131,129,61
23,r_38_4_116,seq49,seq60,r_38_4_116,0.96,0,116,116,61
36,seq40,r_12_57_66,seq17,r_12_57_66,1.0,0,66,66,62
4,r_67_28_72,r_60_39_121,r_9_0_97,r_9_0_97,0.73,0,97,97,62
8,r_30_43_181,seq68,r_36_20_152,r_36_20_152,0.95,29,181,152,62
10,r_71_19_26,r_36_20_152,r_27_3_196,r_71_19_26,1.0,0,26,26,62
1,r_60_39_121,seq34,seq54,r_60_39_121,0.78,2,123,121,62
7,r_73_64_152,r_42_21_5,seq7,r_73_64_152,0.5,11,163,152,62
9,r_69_18_17,r_60_39_121,seq26,r_69_18_17,0.97,0,17,17,62
19,r_44_4_177,seq50,r_5_10_43,r_5_10_43,0.88,134,177,43,62
14,r_70_45_17,seq74,seq53,r_70_45_17,0.74,-3,14,17,62
3,r_13_61_174,seq16,r_69_18_17,r_13_61_174,0.63,0,174,174,62
15,r_56_72_22,seq63,seq55,r_56_72_22,1.0,1,23,22,62
43,seq55,r_59_51_167,r_56_72_22,r_56_72_22,0.84,2,24,22,62
16,r_42_21_5,r_73_64_152,r_56_72_22,r_56_72_22,0.5,140,162,22,62
4,r_67_28_72,seq37,r_60_39_121,r_60_39_121,0.71,-49,72,121,62
13,r_8_47_184,seq58,r_56_72_22,r_56_72_22,0.88,162,184,22,62
48,seq68,r_30_43_181,r_56_72_22,r_56_72_22,0.95,159,181,22,62
12,r_5_10_43,seq52,seq34,r_5_10_43,1.0,0,43,43,62
2,r_36_20_152,seq50,r_38_22_88,r_38_22_88,1.0,0,88,88,62
40,seq52,seq50,r_59_51_167,r_59_51_167,1.0,7,174,167,62
18,r_38_22_88,seq24,r_36_20_152,r_38_22_88,1.0,0,88,88,62
29,seq16,r_13_61_174,seq74,r_13_61_174,0.92,4,178,174,62
24,r_6_1_103,seq25,seq17,r_6_1_103,0.98,0,103,103,62
32,seq25,r_6_1_103,r_69_18_17,r_6_1_103,0.99,0,103,103,62
20,r_41_15_121,seq53,seq40,r_41_15_121,0.7,-2,119,121,62
22,r_33_32_96,r_30_43_181,r_69_18_17,r_33_32_96,0.92,0,96,96,62
11,r_27_3_196,r_38_22_88,r_71_19_26,r_27_3_196,0.99,-151,45,196,62
49,seq74,r_66_29_193,r_41_15_121,r_41_15_121,0.84,46,167,121,62
23,r_12_57_66,seq40,seq2,r_12_57_66,1.0,0,66,66,62
1,r_60_39_121,seq54,seq24,r_60_39_121,0.41,34,155,121,62
14,r_69_43_155,seq47,r_63_68_62,r_63_68_62,0.65,104,166,62,63
37,seq30,seq47,r_6_48_132,r_6_48_132,0.73,7,139,132,63
1,r_55_27_88,r_31_1_124,seq2,r_31_1_124,0.61,-29,95,124,63
20,r_18_8_73,r_40_38_35,r_63_68_62,r_18_8_73,1.0,6,79,73,63
22,r_33_7_12,r_54_28_134,seq67,r_33_7_12,0.97,3,15,12,63
46,seq67,r_26_39_199,r_33_7_12,r_33_7_12,0.97,8,20,12,63
20,r_18_8_73,r_73_59_10,r_40_38_35,r_18_8_73,0.92,-40,33,73,63
3,r_54_28_134,seq3,seq71,r_54_28_134,0.57,0,134,134,63
26,seq3,r_54_28_134,seq70,r_54_28_134,0.92,0,134,134,63
12,r_40_38_35,r_36_56_190,r_18_8_73,r_40_38_35,0.96,1,36,35,63
8,r_6_48_132,r_32_42_173,seq19,r_6_48_132,0.7,-102,30,132,63
0,r_0_58_142,seq71,r_13_72_152,r_0_58_142,0.39,15,157,142,63
13,r_24_17_161,seq37,seq70,r_24_17_161,0.39,-4,157,161,63
15,r_13_72_152,seq60,r_0_58_142,r_13_72_152,0.83,1,153,152,63
6,r_14_51_27,r_24_17_161,seq60,r_14_51_27,0.9,2,29,27,63
47,seq70,r_41_25_171,r_32_42_173,r_41_25_171,0.55,1,172,171,63
18,r_52_44_126,r_54_28_134,seq15,r_52_44_126,0.54,1,127,126,63
24,r_23_9_189,seq29,r_52_44_126,r_52_44_126,0.83,63,189,126,63
44,seq60,r_13_72_152,r_14_51_27,r_14_51_27,0.97,-2,25,27,63
32,seq19,r_6_48_132,r_52_44_126,r_6_48_132,0.66,1,133,132,63
12,r_40_38_35,r_18_8_73,seq47,r_18_8_73,0.91,6,79,73,63
2,r_45_5_57,seq15,seq11,r_45_5_57,1.0,-3,54,57,63
11,r_64_35_83,r_32_42_173,seq53,r_32_42_173,0.62,-153,20,173,63
17,r_65_12_80,r_63_68_62,r_64_35_83,r_65_12_80,0.98,8,88,80,63
23,r_31_1_124,r_55_27_88,r_64_35_83,r_31_1_124,0.71,0,124,124,63
30,seq21,r_11_51_155,r_15_34_72,r_15_34_72,0.97,83,155,72,64
36,seq37,seq23,r_58_50_72,r_58_50_72,1.0,8,80,72,64
21,r_25_18_47,seq47,seq53,r_25_18_47,0.99,1,48,47,64
22,r_27_52_166,seq17,seq21,r_27_52_166,0.87,0,166,166,64
8,r_14_9_190,r_74_71_161,r_26_40_150,r_14_9_190,0.33,-29,161,190,64
3,r_15_34_72,r_11_51_155,seq21,r_11_51_155,1.0,0,155,155,64
16,r_22_54_70,r_14_9_190,seq10,r_22_54_70,0.99,0,70,70,64
5,r_20_56_64,seq23,r_5_29_1,r_20_56_64,1.0,0,64,64,64
46,seq66,r_28_72_122,r_5_29_1,r_5_29_1,0.51,123,124,1,64
42,seq59,r_14_9_190,seq7,r_14_9_190,0.43,-49,141,190,64
9,r_48_46_48,seq23,seq30,r_48_46_48,1.0,0,48,48,64
31,seq23,r_20_56_64,seq37,r_20_56_64,1.0,-26,38,64,64
3,r_15_34_72,seq70,r_11_51_155,r_15_34_72,0.81,0,72,72,64
10,r_11_51_155,seq21,r_60_3_19,r_11_51_155,0.57,0,155,155,64
12,r_8_42_36,r_15_34_72,r_32_31_25,r_8_42_36,1.0,0,36,36,64
4,r_26_40_150,seq47,r_14_9_190,r_26_40_150,0.99,0,150,150,64
11,r_16_39_139,r_27_52_166,r_43_19_135,r_27_52_166,0.98,-26,140,166,64
8,r_14_9_190,r_26_40_150,seq36,r_14_9_190,1.0,0,190,190,64
20,r_68_4_118,seq23,seq33,r_68_4_118,0.88,0,118,118,64
13,r_74_71_161,r_14_9_190,r_16_39_139,r_74_71_161,0.69,0,161,161,64
15,r_65_57_189,r_27_52_166,r_5_29_1,r_27_52_166,0.91,0,166,166,64
15,r_65_57_189,r_5_29_1,seq69,r_65_57_189,0.98,0,189,189,64
40,seq47,r_28_72_122,r_5_29_1,r_5_29_1,0.59,102,103,1,64
18,r_2_41_120,r_16_39_139,r_60_3_19,r_2_41_120,0.82,2,122,120,64
29,seq17,r_27_52_166,r_5_29_1,r_27_52_166,0.99,1,167,166,64
24,r_73_64_1,r_20_56_64,seq37,r_20_56_64,1.0,0,64,64,64
33,seq33,seq45,r_68_4_118,r_68_4_118,1.0,21,139,118,64
4,r_26_40_150,r_14_9_190,seq7,r_14_9_190,1.0,-2,188,190,64
0,r_60_3_19,r_32_31_25,seq35,r_60_3_19,0.6,0,19,19,64
32,seq30,r_49_6_198,r_48_46_48,r_48_46_48,1.0,11,59,48,64
2,r_32_31_25,seq37,seq0,r_32_31_25,1.0,0,25,25,64
22,r_27_52_166,r_16_39_139,seq17,r_16_39_139,0.87,-2,137,139,64
49,seq70,r_15_34_72,r_28_72_122,r_15_34_72,1.0,0,72,72,64
7,r_58_50_72,seq35,seq37,r_58_50_72,1.0,0,72,72,64
23,r_13_55_60,r_43_19_135,r_15_34_72,r_43_19_135,1.0,-72,63,135,64
41,seq53,seq10,r_25_18_47,r_25_18_47,0.99,10,57,47,64
44,seq62,r_24_1_7,r_60_3_19,r_60_3_19,0.95,9,28,19,64
30,seq19,r_16_7_131,r_42_58_94,r_42_58_94,0.81,-2,92,94,65
14,r_37_53_138,r_16_7_131,r_6_39_33,r_37_53_138,0.95,0,138,138,65
8,r_45_56_110,seq59,r_6_39_33,r_45_56_110,0.7,0,110,110,65
48,seq69,r_65_18_180,r_6_39_33,r_6_39_33,1.0,0,33,33,65
16,r_61_15_65,seq21,seq55,r_61_15_65,1.0,1,66,65,65
1,r_12_30_100,r_16_7_131,r_65_18_180,r_12_30_100,0.72,2,102,100,65
5,r_65_18_180,seq9,seq17,r_65_18_180,0.53,0,180,180,65
46,seq67,r_16_7_131,seq62,r_16_7_131,0.98,6,137,131,65
45,seq62,r_16_7_131,seq67,r_16_7_131,1.0,6,137,131,65
37,seq32,r_27_74_138,r_73_13_20,r_73_13_20,0.97,1,21,20,65
15,r_44_3_38,r_61_15_65,seq34,r_44_3_38,0.94,4,42,38,65
19,r_29_66_155,seq5,r_11_47_54,r_11_47_54,1.0,94,148,54,65
31,seq21,seq68,r_11_47_54,r_11_47_54,1.0,8,62,54,65
3,r_51_48_171,r_35_10_197,r_11_47_54,r_51_48_171,0.76,0,171,171,65
11,r_11_47_54,seq9,seq21,r_11_47_54,1.0,1,55,54,65
4,r_49_38_148,seq62,seq19,r_49_38_148,0.48,-84,64,148,65
28,seq9,r_65_18_180,r_33_28_12,r_33_28_12,0.78,13,25,12,65
20,r_14_4_171,seq8,r_51_48_171,r_14_4_171,0.72,0,171,171,65
13,r_70_63_123,seq8,seq25,r_70_63_123,0.99,0,123,123,65
4,r_49_38_148,seq19,seq26,r_49_38_148,0.99,0,148,148,65
0,r_73_13_20,r_57_2_18,seq32,r_73_13_20,1.0,0,20,20,65
9,r_50_46_38,r_65_18_180,r_73_13_20,r_65_18_180,0.8,-143,37,180,65
10,r_6_39_33,r_54_20_52,r_33_28_12,r_6_39_33,0.99,0,33,33,65
21,r_57_2_18,r_73_13_20,seq25,r_57_2_18,0.93,0,18,18,65
2,r_27_74_138,seq32,r_6_39_33,r_27_74_138,0.92,1,139,138,65
18,r_0_43_108,seq17,r_6_39_33,r_0_43_108,1.0,0,108,108,65
24,r_16_7_131,r_37_53_138,seq8,r_16_7_131,0.81,6,137,131,65
43,seq59,seq34,r_12_30_100,r_12_30_100,0.83,-35,65,100,65
1,r_12_30_100,r_65_18_180,r_0_43_108,r_12_30_100,0.52,23,123,100,65
22,r_35_10_197,r_51_48_171,r_44_3_38,r_44_3_38,0.9,133,171,38,65
12,r_33_28_12,r_54_20_52,seq9,r_33_28_12,1.0,0,12,12,65
7,r_24_64_178,seq8,r_51_48_171,r_24_64_178,0.67,0,178,178,65
23,r_42_58_94,r_51_48_171,seq19,r_42_58_94,0.94,-1,93,94,65
35,seq26,r_65_18_180,r_49_38_148,r_49_38_148,0.58,1,149,148,65
8,r_38_7_75,seq6,r_3_66_34,r_38_7_75,0.99,0,75,75,66
10,r_33_16_141,r_30_5_69,r_15_73_9,r_33_16_141,0.79,-131,10,141,66
21,r_67_58_146,seq11,seq56,r_67_58_146,0.94,0,146,146,66
39,seq34,r_61_17_92,r_23_62_83,r_61_17_92,0.93,2,94,92,66
1,r_15_73_9,r_33_16_141,r_22_59_94,r_22_59_94,0.82,42,136,94,66
5,r_22_59_94,r_30_5_69,r_15_73_9,r_30_5_69,0.94,-1,68,69,66
32,seq13,r_71_60_64,r_24_51_12,r_71_60_64,0.93,-14,50,64,66
18,r_42_4_35,seq21,seq2,r_42_4_35,1.0,0,35,35,66
45,seq64,seq47,r_57_1_85,r_57_1_85,1.0,27,112,85,66
19,r_74_29_114,seq12,seq8,r_74_29_114,0.99,0,114,114,66
13,r_46_36_184,r_52_53_116,seq19,r_52_53_116,1.0,2,118,116,66
39,seq34,r_23_62_83,r_49_54_176,r_49_54_176,0.96,1,177,176,66
41,seq43,r_37_28_108,seq6,r_37_28_108,0.9,-7,101,108,66
3,r_30_5_69,r_33_16_141,seq14,r_30_5_69,1.0,0,69,69,66
16,r_49_54_176,r_3_66_34,seq34,r_3_66_34,0.62,143,177,34,66
4,r_70_48_175,seq45,r_37_28_108,r_37_28_108,0.53,67,175,108,66
0,r_57_1_85,r_46_36_184,seq64,r_57_1_85,1.0,0,85,85,66
26,seq2,seq68,r_42_4_35,r_42_4_35,1.0,0,35,35,66
11,r_40_63_186,seq14,r_37_28_108,r_40_63_186,0.44,0,186,186,66
20,r_44_26_117,seq47,r_46_36_184,r_44_26_117,0.84,1,118,117,66
13,r_46_36_184,r_57_1_85,r_52_53_116,r_57_1_85,1.0,0,85,85,66
15,r_61_17_92,seq34,r_57_1_85,r_61_17_92,0.96,4,96,92,66
12,r_3_66_34,r_49_54_176,r_38_7_75,r_3_66_34,0.89,102,136,34,66
13,r_46_36_184,seq19,seq72,r_46_36_184,0.99,0,184,184,66
2,r_37_28_108,seq43,seq11,r_37_28_108,0.86,1,109,108,66
24,r_35_20_74,seq11,seq47,r_35_20_74,0.95,0,74,74,66
16,r_49_54_176,r_42_4_35,r_3_66_34,r_49_54_176,0.8,-139,37,176,66
25,seq0,seq11,r_33_16_141,r_33_16_141,0.57,-71,70,141,66
33,seq14,r_40_63_186,r_30_5_69,r_30_5_69,1.0,102,171,69,66
7,r_27_10_16,r_30_5_69,seq18,r_27_10_16,0.79,0,16,16,66
20,r_44_26_117,r_46_36_184,seq65,r_46_36_184,0.97,-5,179,184,66
12,r_3_66_34,r_44_26_117,r_49_54_176,r_3_66_34,1.0,3,37,34,66
14,r_24_51_12,r_57_1_85,seq13,r_24_51_12,1.0,0,12,12,66
17,r_39_50_136,seq18,r_23_62_83,r_39_50_136,0.79,-2,134,136,66
9,r_23_62_83,seq34,r_39_50_136,r_39_50_136,1.0,1,137,136,66
22,r_71_60_64,seq9,r_22_59_94,r_71_60_64,1.0,1,65,64,66
23,r_52_53_116,r_46_36_184,r_71_60_64,r_52_53_116,0.81,2,118,116,66
36,seq21,r_42_4_35,r_55_31_110,r_42_4_35,0.97,0,35,35,66
35,seq19,r_46_36_184,r_44_26_117,r_44_26_117,0.97,65,182,117,66
30,seq11,r_14_2_151,r_58_44_2,r_14_2_151,0.97,-21,130,151,67
8,r_5_21_129,r_70_31_84,r_60_8_73,r_60_8_73,0.97,3,76,73,67
5,r_62_71_12,r_63_32_137,seq54,r_62_71_12,0.86,0,12,12,67
37,seq35,seq55,r_5_21_129,r_5_21_129,0.8,1,130,129,67
2,r_50_45_33,r_51_1_194,seq0,r_50_45_33,1.0,0,33,33,67
19,r_59_69_95,r_60_8_73,r_72_67_166,r_72_67_166,0.95,1,167,166,67
46,seq55,r_14_2_151,r_58_44_2,r_14_2_151,1.0,0,151,151,67
1,r_27_28_39,r_68_48_175,seq33,r_27_28_39,1.0,0,39,39,67
45,seq54,seq26,r_18_30_83,r_18_30_83,1.0,57,140,83,67
19,r_59_69_95,seq0,r_60_8_73,r_59_69_95,0.67,0,95,95,67
3,r_74_57_65,r_70_31_84,seq64,r_74_57_65,1.0,1,66,65,67
10,r_63_32_137,seq22,r_50_45_33,r_63_32_137,0.97,0,137,137,67
16,r_52_12_10,seq6,seq29,r_52_12_10,0.38,130,140,10,67
48,seq65,seq16,r_41_23_49,r_41_23_49,1.0,3,52,49,67
8,r_5_21_129,r_60_8_73,seq35,r_5_21_129,1.0,0,129,129,67
0,r_56_36_169,seq34,seq53,r_56_36_169,0.74,0,169,169,67
20,r_72_67_166,seq0,r_59_69_95,r_59_69_95,1.0,71,166,95,67
15,r_61_25_156,seq53,r_41_23_49,r_41_23_49,0.97,107,156,49,67
27,seq6,r_68_48_175,r_66_47_186,r_68_48_175,0.96,0,175,175,67
47,seq64,seq38,r_74_57_65,r_74_57_65,1.0,18,83,65,67
40,seq39,r_43_9_152,seq49,r_43_9_152,0.98,1,153,152,67
18,r_19_3_126,seq10,seq73,r_19_3_126,1.0,0,126,126,67
29,seq10,r_19_3_126,r_15_20_68,r_19_3_126,0.98,1,127,126,67
32,seq22,r_63_32_137,seq73,r_63_32_137,0.99,0,137,137,67
9,r_24_13_30,seq65,seq40,r_24_13_30,1.0,0,30,30,67
12,r_60_8_73,r_5_21_129,r_59_69_95,r_5_21_129,0.73,1,130,129,67
21,r_41_23_49,r_61_25_156,seq65,r_41_23_49,0.99,0,49,49,67
22,r_70_31_84,r_5_21_129,r_59_69_95,r_70_31_84,0.92,44,128,84,67
7,r_18_30_83,r_56_36_169,seq54,r_18_30_83,1.0,0,83,83,67
44,seq53,r_61_25_156,seq73,r_61_25_156,0.95,0,156,156,67
41,seq40,seq34,r_24_13_30,r_24_13_30,1.0,1,31,30,67
23,r_15_20_68,r_68_48_175,seq10,r_68_48_175,0.81,-97,78,175,67
12,r_60_8_73,seq33,r_5_21_129,r_60_8_73,1.0,0,73,73,67
36,seq31,r_74_7_9,seq17,r_74_7_9,0.66,53,62,9,68
14,r_68_62_144,r_24_19_167,r_29_55_134,r_29_55_134,0.53,11,145,134,68
11,r_56_51_113,r_25_18_63,r_54_8_133,r_54_8_133,0.99,-3,130,133,68
23,r_12_39_23,seq64,seq13,r_12_39_23,0.92,0,23,23,68
6,r_52_35_98,r_59_26_23,r_29_55_134,r_52_35_98,0.51,54,152,98,68
37,seq32,r_54_8_133,r_29_55_134,r_54_8_133,0.63,8,141,133,68
45,seq58,r_23_65_127,seq14,r_23_65_127,0.55,16,143,127,68
16,r_50_61_194,seq10,r_63_15_139,r_50_61_194,0.26,-42,152,194,68
21,r_23_65_127,r_21_5_189,seq33,r_21_5_189,0.51,-61,128,189,68
39,seq37,r_63_15_139,r_69_38_7,r_63_15_139,0.74,-37,102,139,68
1,r_29_55_134,seq33,r_52_35_98,r_52_35_98,0.56,41,139,98,68
46,seq64,seq71,r_70_42_33,r_70_42_33,1.0,89,122,33,68
45,seq58,r_59_26_23,r_23_65_127,r_23_65_127,0.51,-16,111,127,68
10,r_59_26_23,r_56_51_113,r_16_67_188,r_59_26_23,0.98,-3,20,23,68
19,r_25_18_63,r_34_60_104,seq45,r_25_18_63,1.0,0,63,63,68
15,r_21_5_189,seq4,r_57_53_21,r_21_5_189,1.0,0,189,189,68
3,r_20_36_83,seq3,r_70_42_33,r_20_36_83,1.0,0,83,83,68
11,r_56_51_113,seq3,r_25_18_63,r_56_51_113,0.63,0,113,113,68
0,r_46_6_7,r_49_9_153,seq33,r_46_6_7,0.71,3,10,7,68
15,r_21_5_189,r_23_65_127,seq4,r_23_65_127,0.92,1,128,127,68
13,r_28_30_30,r_34_60_104,seq2,r_34_60_104,1.0,0,104,104,68
6,r_52_35_98,seq33,r_59_26_23,r_59_26_23,0.57,78,101,23,68
10,r_59_26_23,r_16_67_188,r_29_55_134,r_16_67_188,0.57,0,188,188,68
27,seq2,r_43_27_159,seq41,r_43_27_159,1.0,0,159,159,68
12,r_16_67_188,r_54_8_133,r_59_26_23,r_59_26_23,0.85,-3,20,23,68
2,r_54_8_133,seq32,r_56_51_113,r_54_8_133,0.7,0,133,133,68
18,r_24_19_167,r_68_62_144,seq37,r_68_62_144,0.67,-10,134,144,68
29,seq4,r_21_5_189,r_69_38_7,r_69_38_7,0.56,182,189,7,68
24,r_34_60_104,r_25_18_63,r_28_30_30,r_34_60_104,0.84,-40,64,104,68
18,r_24_19_167,seq37,r_46_6_7,r_24_19_167,0.62,5,172,167,68
32,seq13,seq41,r_12_39_23,r_12_39_23,0.99,55,78,23,68
24,r_34_60_104,r_28_30_30,seq4,r_34_60_104,0.9,0,104,104,68
49,seq73,seq33,r_66_47_72,r_66_47_72,1.0,6,78,72,68
7,r_66_47_72,seq41,seq73,r_66_47_72,0.99,1,73,72,68
44,seq48,r_49_9_153,seq2,r_49_9_153,1.0,0,153,153,68
8,r_70_42_33,seq1,seq64,r_70_42_33,1.0,0,33,33,68
13,r_28_30_30,r_21_5_189,r_34_60_104,r_28_30_30,0.91,0,30,30,68
30,seq14,r_39_28_193,r_47_31_135,r_47_31_135,0.99,30,165,135,69
14,r_47_31_135,seq2,seq14,r_47_31_135,0.75,1,136,135,69
5,r_67_63_25,seq17,seq3,r_67_63_25,0.94,1,26,25,69
8,r_11_8_101,seq45,seq30,r_11_8_101,0.99,0,101,101,69
43,seq58,seq32,r_49_9_78,r_49_9_78,1.0,3,81,78,69
16,r_39_28_193,r_7_5_181,r_47_31_135,r_47_31_135,0.89,47,182,135,69
1,r_27_21_61,seq12,seq52,r_27_21_61,0.74,1,62,61,69
46,seq64,r_22_18_173,r_56_36_127,r_56_36_127,0.99,3,130,127,69
21,r_4_40_35,seq14,seq32,r_4_40_35,1.0,1,36,35,69
10,r_33_38_20,r_67_63_25,seq30,r_33_38_20,0.95,0,20,20,69
7,r_54_1_84,r_27_21_61,r_0_35_26,r_54_1_84,0.9,-26,58,84,69
4,r_44_46_178,seq68,r_4_40_35,r_4_40_35,0.91,145,180,35,69
11,r_62_66_160,seq59,seq13,r_62_66_160,0.42,-1,159,160,69
20,r_73_29_125,seq53,r_22_18_173,r_73_29_125,0.88,1,126,125,69
6,r_10_25_37,r_22_18_173,r_50_69_67,r_50_69_67,0.95,2,69,67,69
15,r_56_36_127,r_49_9_78,r_42_71_52,r_56_36_127,0.99,-51,76,127,69
2,r_19_43_35,r_27_21_61,seq53,r_19_43_35,0.99,5,40,35,69
0,r_42_71_52,r_44_46_178,r_56_36_127,r_42_71_52,0.98,4,56,52,69
19,r_70_24_67,r_33_38_20,seq34,r_33_38_20,0.96,0,20,20,69
20,r_73_29_125,r_22_18_173,r_56_36_127,r_22_18_173,0.72,4,177,173,69
0,r_42_71_52,r_56_36_127,seq45,r_56_36_127,1.0,2,129,127,69
22,r_22_18_173,r_73_29_125,r_10_25_37,r_22_18_173,0.8,4,177,173,69
17,r_0_35_26,r_44_46_178,r_54_1_84,r_0_35_26,1.0,1,27,26,69
18,r_7_5_181,r_39_28_193,seq12,r_7_5_181,0.46,1,182,181,69
24,r_16_51_98,seq32,seq59,r_16_51_98,0.98,1,99,98,69
7,r_54_1_84,r_0_35_26,r_27_21_61,r_54_1_84,0.73,1,85,84,69
6,r_10_25_37,seq14,r_22_18_173,r_10_25_37,0.83,2,39,37,69
3,r_15_55_51,seq30,seq2,r_15_55_51,0.99,0,51,51,69
9,r_50_69_67,seq3,r_10_25_37,r_50_69_67,1.0,0,67,67,69
22,r_22_18_173,seq64,r_73_29_125,r_73_29_125,0.98,-3,122,125,69
44,seq59,seq14,r_16_51_98,r_16_51_98,0.97,3,101,98,69
23,r_49_9_78,r_56_36_127,seq58,r_49_9_78,0.97,0,78,78,69
17,r_0_35_26,r_54_1_84,seq12,r_54_1_84,0.84,5,89,84,69
35,seq32,seq58,r_4_40_35,r_4_40_35,1.0,43,78,35,69
12,r_26_65_64,seq72,seq6,r_26_65_64,1.0,0,64,64,69
15,r_56_36_127,r_42_71_52,seq64,r_56_36_127,1.0,0,127,127,69
36,seq32,seq73,r_17_11_61,r_17_11_61,1.0,2,63,61,70
1,r_59_15_11,r_47_57_53,seq3,r_59_15_11,0.99,0,11,11,70
43,seq52,seq55,r_60_56_104,r_60_56_104,1.0,0,104,104,70
37,seq38,r_20_62_83,r_30_48_19,r_20_62_83,1.0,-2,81,83,70
16,r_19_64_102,seq7,r_20_62_83,r_19_64_102,1.0,1,103,102,70
21,r_60_56_104,seq1,seq52,r_60_56_104,1.0,0,104,104,70
39,seq41,r_68_40_191,r_36_72_125,r_36_72_125,0.66,62,187,125,70
5,r_29_4_148,r_33_71_9,r_20_62_83,r_20_62_83,1.0,6,89,83,70
42,seq50,seq3,r_61_6_50,r_61_6_50,1.0,84,134,50,70
45,seq63,r_18_74_133,seq69,r_18_74_133,0.86,0,133,133,70
19,r_70_2_88,seq50,r_35_5_194,r_70_2_88,1.0,0,88,88,70
0,r_61_6_50,r_20_62_83,seq50,r_61_6_50,0.64,0,50,50,70
6,r_47_57_53,r_60_56_104,seq7,r_47_57_53,0.99,0,53,53,70
18,r_43_14_14,r_19_64_102,seq63,r_43_14_14,0.73,-2,12,14,70
41,seq49,r_34_25_70,seq65,r_34_25_70,1.0,0,70,70,70
5,r_29_4_148,r_20_62_83,r_0_26_137,r_20_62_83,0.81,65,148,83,70
3,r_17_11_61,seq65,seq32,r_17_11_61,1.0,0,61,61,70
8,r_54_42_22,seq13,seq69,r_54_42_22,1.0,1,23,22,70
26,seq3,r_31_22_86,r_59_15_11,r_31_22_86,1.0,-26,60,86,70
4,r_34_25_70,seq49,seq45,r_34_25_70,1.0,0,70,70,70
11,r_66_10_100,seq23,seq73,r_66_10_100,1.0,0,100,100,70
20,r_20_62_83,seq38,r_29_4_148,r_20_62_83,1.0,0,83,83,70
13,r_35_5_194,seq55,r_70_2_88,r_70_2_88,0.99,0,88,88,70
15,r_31_22_86,seq3,seq1,r_31_22_86,1.0,-1,85,86,70
22,r_58_37_120,r_43_14_14,seq9,r_43_14_14,0.46,141,155,14,70
2,r_18_74_133,seq63,r_20_62_83,r_18_74_133,0.98,0,133,133,70
20,r_20_62_83,r_29_4_148,r_18_74_133,r_20_62_83,0.98,58,141,83,70
24,r_30_48_19,seq52,seq38,r_30_48_19,0.63,0,19,19,70
22,r_58_37_120,seq1,r_43_14_14,r_58_37_120,0.66,0,120,120,70
49,seq73,seq32,r_66_10_100,r_66_10_100,1.0,2,102,100,70
23,r_0_26_137,seq28,r_47_57_53,r_0_26_137,1.0,0,137,137,70
7,r_25_61_113,seq60,r_3_42_75,r_25_61_113,0.8,-2,111,113,71
14,r_19_35_137,seq74,seq23,r_19_35_137,0.79,1,138,137,71
8,r_54_70_185,seq56,seq16,r_54_70_185,0.35,-69,116,185,71
19,r_64_5_76,r_27_36_178,seq71,r_27_36_178,0.44,-19,159,178,71
9,r_28_37_14,seq40,seq8,r_28_37_14,0.98,0,14,14,71
16,r_15_58_197,r_69_46_175,r_10_67_116,r_10_67_116,1.0,33,149,116,71
1,r_10_67_116,seq66,r_15_58_197,r_10_67_116,1.0,0,116,116,71
5,r_24_43_79,seq23,seq56,r_24_43_79,1.0,0,79,79,71
19,r_64_5_76,seq56,r_27_36_178,r_64_5_76,0.87,0,76,76,71
41,seq51,r_49_11_128,seq34,r_49_11_128,0.92,-44,84,128,71
3,r_44_13_89,seq23,r_18_59_70,r_44_13_89,1.0,0,89,89,71
10,r_27_36_178,seq71,r_14_65_141,r_14_65_141,0.6,45,186,141,71
8,r_54_70_185,seq16,r_14_65_141,r_14_65_141,0.57,45,186,141,71
15,r_38_52_197,r_10_67_116,r_53_39_11,r_38_52_197,0.83,-178,19,197,71
4,r_14_65_141,seq40,r_53_39_11,r_14_65_141,0.71,-1,140,141,71
20,r_47_1_137,seq23,r_17_50_83,r_47_1_137,0.56,1,138,137,71
22,r_53_39_11,seq62,r_38_52_197,r_53_39_11,0.93,0,11,11,71
2,r_49_11_128,seq51,seq23,r_49_11_128,0.46,-35,93,128,71
47,seq71,r_27_36_178,r_28_37_14,r_28_37_14,0.95,96,110,14,71
18,r_69_46_175,r_3_42_75,r_15_58_197,r_3_42_75,1.0,-5,70,75,71
24,r_3_42_75,r_69_46_175,seq72,r_3_42_75,1.0,1,76,75,71
6,r_41_22_47,r_19_35_137,r_17_50_83,r_41_22_47,0.95,63,110,47,71
17,r_17_50_83,seq72,seq62,r_17_50_83,0.9,0,83,83,71
0,r_0_12_31,seq32,r_53_39_11,r_0_12_31,0.98,0,31,31,71
7,r_25_61_113,r_47_1_137,seq60,r_25_61_113,0.41,-21,92,113,71
18,r_69_46_175,r_15_58_197,r_30_63_101,r_69_46_175,0.5,4,179,175,71
23,r_31_55_96,r_4_68_185,seq48,r_31_55_96,0.9,1,97,96,71
12,r_7_73_91,seq66,r_3_42_75,r_7_73_91,1.0,0,91,91,71
6,r_41_22_47,r_54_70_185,r_19_35_137,r_41_22_47,0.96,1,48,47,71
14,r_44_50_61,seq49,seq59,r_44_50_61,1.0,0,61,61,72
8,r_10_67_117,r_8_1_86,r_47_33_77,r_10_67_117,0.99,0,117,117,72
16,r_65_46_183,r_54_58_39,seq11,r_65_46_183,0.35,1,184,183,72
21,r_8_1_86,r_10_67_117,seq2,r_10_67_117,0.99,-37,80,117,72
1,r_36_39_84,r_73_23_158,seq21,r_36_39_84,0.86,0,84,84,72
19,r_73_23_158,r_52_66_4,r_47_33_77,r_52_66_4,0.52,156,160,4,72
3,r_12_71_62,r_55_51_178,seq59,r_12_71_62,0.76,50,112,62,72
15,r_18_70_34,r_26_35_98,r_54_58_39,r_18_70_34,0.91,2,36,34,72
0,r_26_35_98,r_47_33_77,seq21,r_47_33_77,1.0,-11,66,77,72
11,r_20_42_80,seq41,seq2,r_20_42_80,0.97,0,80,80,72
13,r_52_66_4,r_73_23_158,seq5,r_73_23_158,0.41,11,169,158,72
12,r_61_25_98,r_36_39_84,r_54_58_39,r_61_25_98,0.73,-5,93,98,72
10,r_54_58_39,r_65_46_183,r_18_70_34,r_54_58_39,0.7,0,39,39,72
6,r_3_34_76,r_29_15_120,seq72,r_29_15_120,0.98,-23,97,120,72
4,r_0_43_18,r_44_50_61,seq41,r_0_43_18,1.0,1,19,18,72
17,r_29_15_120,r_3_34_76,seq68,r_29_15_120,0.99,0,120,120,72
22,r_47_33_77,r_26_35_98,seq45,r_47_33_77,1.0,1,78,77,72
12,r_61_25_98,r_56_37_197,r_36_39_84,r_56_37_197,0.52,-145,52,197,72
47,seq65,seq61,r_3_73_22,r_3_73_22,1.0,0,22,22,73
14,r_39_5_155,r_47_19_184,r_11_63_31,r_39_5_155,0.65,0,155,155,73
37,seq40,seq69,r_24_10_107,r_24_10_107,1.0,75,182,107,73
24,r_72_74_182,seq18,r_8_26_6,r_8_26_6,0.49,169,175,6,73
19,r_24_10_107,r_60_50_152,seq40,r_24_10_107,0.98,0,107,107,73
10,r_51_58_172,seq15,r_6_29_153,r_6_29_153,0.96,19,172,153,73
26,seq2,seq38,r_11_63_31,r_11_63_31,0.97,142,173,31,73
4,r_20_22_92,seq64,seq21,r_20_22_92,0.99,0,92,92,73
11,r_37_25_114,r_7_34_137,r_8_26_6,r_37_25_114,0.51,4,118,114,73
20,r_47_19_184,r_39_5_155,seq0,r_39_5_155,0.53,0,155,155,73
20,r_47_19_184,seq0,r_68_9_9,r_47_19_184,0.64,1,185,184,73
12,r_67_14_179,r_3_73_22,r_20_22_92,r_3_73_22,0.52,157,179,22,73
13,r_41_56_131,r_3_73_22,seq42,r_41_56_131,1.0,0,131,131,73
6,r_6_29_153,seq64,r_60_50_152,r_6_29_153,0.7,0,153,153,73
18,r_3_73_22,r_72_74_182,r_67_14_179,r_3_73_22,0.93,0,22,22,73
8,r_27_16_57,r_4_57_118,seq38,r_27_16_57,1.0,0,57,57,73
12,r_67_14_179,seq61,r_3_73_22,r_3_73_22,0.99,0,22,22,73
2,r_4_57_118,r_1_30_120,r_8_26_6,r_4_57_118,0.7,4,122,118,73
40,seq45,seq32,r_1_30_120,r_1_30_120,0.67,0,120,120,73
38,seq42,seq17,r_41_56_131,r_41_56_131,0.9,18,149,131,73
24,r_72_74_182,r_3_73_22,seq18,r_3_73_22,0.56,1,23,22,73
17,r_1_30_120,r_4_57_118,seq45,r_4_57_118,0.61,4,122,118,73
9,r_7_34_137,r_37_25_114,r_70_28_39,r_7_34_137,0.62,1,138,137,73
0,r_11_63_31,seq55,seq64,r_11_63_31,0.98,0,31,31,73
7,r_59_46_86,seq42,seq36,r_59_46_86,1.0,0,86,86,73
18,r_3_73_22,r_67_14_179,seq31,r_67_14_179,0.63,0,179,179,73
13,r_41_56_131,seq44,r_3_73_22,r_41_56_131,0.41,-103,28,131,73
36,seq38,seq2,r_27_16_57,r_27_16_57,1.0,2,59,57,73
23,r_12_66_11,r_3_73_22,seq33,r_12_66_11,0.52,0,11,11,73
43,seq60,r_10_18_184,seq46,r_10_18_184,0.96,0,184,184,74
37,seq45,r_14_25_25,r_20_52_112,r_20_52_112,1.0,3,115,112,74
21,r_10_18_184,seq60,seq34,r_10_18_184,0.4,0,184,184,74
1,r_58_74_189,r_62_32_187,r_17_12_91,r_62_32_187,0.43,2,189,187,74
5,r_8_6_177,seq63,r_37_59_57,r_8_6_177,0.48,0,177,177,74
7,r_20_52_112,seq45,r_54_55_142,r_54_55_142,0.99,-1,141,142,74
3,r_33_71_79,seq72,seq38,r_33_71_79,0.59,0,79,79,74
0,r_51_31_108,seq63,seq57,r_51_31_108,0.69,0,108,108,74
11,r_17_12_91,seq46,seq65,r_17_12_91,0.96,0,91,91,74
20,r_41_15_124,seq73,seq57,r_41_15_124,0.91,0,124,124,74
13,r_37_59_57,seq29,seq35,r_37_59_57,1.0,7,64,57,74
48,seq72,seq29,r_17_12_91,r_17_12_91,1.0,7,98,91,74
6,r_1_39_141,seq35,seq4,r_1_39_141,0.52,0,141,141,74
2,r_2_30_175,seq38,r_43_66_159,r_2_30_175,0.62,0,175,175,74
18,r_19_22_142,seq21,r_53_48_72,r_19_22_142,0.63,0,142,142,74
33,seq34,r_43_66_159,seq63,r_43_66_159,0.98,0,159,159,74
24,r_14_25_25,seq45,seq3,r_14_25_25,0.6,0,25,25,74
17,r_53_48_72,r_10_18_184,seq49,r_10_18_184,0.77,-79,105,184,74
9,r_11_69_98,r_14_25_25,seq13,r_11_69_98,1.0,1,99,98,74
44,seq63,r_51_31_108,seq34,r_51_31_108,0.75,0,108,108,74
23,r_62_32_187,r_58_74_189,r_51_31_108,r_58_74_189,0.54,-1,188,189,74
35,seq38,r_2_30_175,r_61_42_10,r_2_30_175,0.97,0,175,175,74
22,r_40_24_46,seq13,seq27,r_40_24_46,0.8,1,47,46,74
8,r_4_24_99,seq10,r_35_13_17,r_4_24_99,1.0,1,100,99,75
22,r_28_5_78,r_18_34_59,seq15,r_18_34_59,1.0,0,59,59,75
15,r_33_55_36,r_18_34_59,seq69,r_18_34_59,0.7,-15,44,59,75
1,r_8_64_70,seq19,seq66,r_8_64_70,0.49,-1,69,70,75
49,seq73,r_27_65_33,r_40_67_61,r_40_67_61,0.95,24,85,61,75
46,seq68,seq62,r_26_17_29,r_26_17_29,1.0,113,142,29,75
3,r_61_14_22,seq60,r_42_45_189,r_61_14_22,1.0,2,24,22,75
10,r_63_46_48,r_33_55_36,r_35_13_17,r_63_46_48,1.0,0,48,48,75
19,r_18_34_59,r_28_5_78,r_40_67_61,r_28_5_78,0.58,-12,66,78,75
2,r_6_21_51,seq3,seq62,r_6_21_51,1.0,0,51,51,75
31,seq19,r_72_48_159,r_28_5_78,r_72_48_159,0.98,1,160,159,75
6,r_39_71_52,r_35_13_17,seq15,r_39_71_52,1.0,0,52,52,75
0,r_26_17_29,seq70,seq56,r_26_17_29,1.0,1,30,29,75
20,r_36_25_34,seq15,seq66,r_36_25_34,0.81,15,49,34,75
14,r_59_44_24,seq73,seq70,r_59_44_24,1.0,0,24,24,75
4,r_53_51_96,r_58_57_159,r_36_25_34,r_53_51_96,1.0,4,100,96,75
6,r_39_71_52,r_6_21_51,r_35_13_17,r_35_13_17,0.99,0,17,17,75
11,r_42_45_189,seq3,r_61_14_22,r_61_14_22,0.95,52,74,22,75
13,r_7_16_65,seq3,seq11,r_7_16_65,1.0,0,65,65,75
5,r_0_30_106,r_39_71_52,r_61_14_22,r_0_30_106,1.0,0,106,106,75
29,seq12,r_50_74_40,seq73,r_50_74_40,0.63,3,43,40,75
43,seq60,r_35_13_17,r_2_54_15,r_35_13_17,0.79,0,17,17,75
9,r_27_65_33,seq12,seq22,r_27_65_33,1.0,2,35,33,75
21,r_50_74_40,seq12,seq70,r_50_74_40,1.0,0,40,40,75
42,seq56,seq62,r_26_17_29,r_26_17_29,1.0,12,41,29,75
16,r_35_13_17,seq69,r_39_71_52,r_35_13_17,0.96,0,17,17,75
47,seq69,seq60,r_33_55_36,r_33_55_36,0.55,67,103,36,75
24,r_72_48_159,seq19,r_27_65_33,r_72_48_159,0.96,1,160,159,75
25,seq3,seq23,r_61_14_22,r_61_14_22,0.89,158,180,22,75
5,r_0_30_106,seq15,r_39_71_52,r_39_71_52,1.0,5,57,52,75
17,r_2_54_15,seq56,seq60,r_2_54_15,0.95,0,15,15,75
44,seq62,seq38,r_6_21_51,r_6_21_51,1.0,47,98,51,75
23,r_58_57_159,seq49,r_35_13_17,r_58_57_159,0.93,0,159,159,75
16,r_35_13_17,r_39_71_52,r_63_46_48,r_35_13_17,0.99,35,52,17,75
12,r_40_67_61,seq19,r_18_34_59,r_40_67_61,0.54,0,61,61,75
23,r_2_10_190,r_58_12_123,seq9,r_58_12_123,0.87,67,190,123,76
36,seq37,r_24_5_155,r_70_3_133,r_70_3_133,0.49,14,147,133,76
6,r_55_63_152,seq35,r_57_46_31,r_57_46_31,1.0,1,32,31,76
14,r_24_5_155,seq37,seq60,r_24_5_155,0.72,4,159,155,76
19,r_15_14_33,r_16_62_27,r_17_38_122,r_17_38_122,0.99,1,123,122,76
21,r_16_62_27,r_4_1_82,r_54_72_73,r_54_72_73,1.0,32,105,73,76
1,r_74_20_62,r_28_31_159,r_49_64_33,r_74_20_62,0.95,0,62,62,76
12,r_67_41_31,seq22,seq51,r_67_41_31,0.94,0,31,31,76
16,r_57_46_31,r_55_63_152,seq35,r_55_63_152,0.83,0,152,152,76
4,r_28_31_159,r_13_48_183,r_4_1_82,r_28_31_159,0.62,0,159,159,76
0,r_19_23_74,seq6,r_42_73_36,r_19_23_74,1.0,0,74,74,76
11,r_44_52_122,seq6,seq39,r_44_52_122,0.87,0,122,122,76
17,r_49_64_33,seq45,r_74_20_62,r_74_20_62,1.0,31,93,62,76
20,r_54_72_73,seq47,r_16_62_27,r_54_72_73,1.0,0,73,73,76
13,r_66_30_35,r_58_12_123,seq6,r_66_30_35,0.97,2,37,35,76
2,r_70_3_133,r_27_36_78,seq37,r_70_3_133,0.97,0,133,133,76
27,seq8,r_58_12_123,r_74_20_62,r_74_20_62,1.0,75,137,62,76
19,r_15_14_33,seq33,r_16_62_27,r_15_14_33,0.55,1,34,33,76
39,seq45,r_17_38_122,r_49_64_33,r_49_64_33,0.67,8,41,33,76
18,r_34_43_10,seq9,r_16_62_27,r_34_43_10,0.76,4,14,10,76
2,r_70_3_133,r_61_50_46,r_27_36_78,r_61_50_46,1.0,-2,44,46,76
40,seq47,r_54_72_73,seq69,r_54_72_73,0.98,0,73,73,76
24,r_17_38_122,seq11,r_15_14_33,r_17_38_122,0.85,3,125,122,76
6,r_55_63_152,r_57_46_31,r_27_36_78,r_57_46_31,0.42,121,152,31,76
18,r_34_43_10,seq8,r_15_14_33,r_34_43_10,0.51,158,168,10,76
22,r_29_0_48,seq68,r_67_41_31,r_29_0_48,1.0,0,48,48,76
23,r_2_10_190,r_17_38_122,seq37,r_2_10_190,0.56,-165,25,190,76
41,seq51,seq32,r_67_41_31,r_67_41_31,1.0,2,33,31,76
7,r_13_48_183,seq7,r_74_20_62,r_13_48_183,0.84,0,183,183,76
7,r_13_48_183,r_28_31_159,seq7,r_13_48_183,0.48,-25,158,183,76
16,r_57_46_31,r_15_14_33,r_55_63_152,r_57_46_31,1.0,0,31,31,76
35,seq35,r_55_63_152,r_57_46_31,r_57_46_31,0.6,121,152,31,76
23,r_2_10_190,seq37,r_58_12_123,r_58_12_123,0.69,-6,117,123,76
30,seq16,r_56_61_158,seq18,r_56_61_158,1.0,0,158,158,77
6,r_19_49_32,r_36_47_172,seq26,r_19_49_32,0.94,0,32,32,77
14,r_74_14_138,r_56_61_158,r_45_57_98,r_56_61_158,0.7,-20,138,158,77
8,r_9_10_78,seq8,r_27_69_117,r_9_10_78,0.99,0,78,78,77
28,seq12,r_66_46_176,r_72_31_89,r_72_31_89,0.83,1,90,89,77
23,r_7_63_31,r_36_47_172,r_62_2_178,r_7_63_31,1.0,1,32,31,77
4,r_45_57_98,seq42,r_74_14_138,r_74_14_138,1.0,1,139,138,77
21,r_72_31_89,seq26,r_64_35_7,r_72_31_89,0.46,-12,77,89,77
39,seq39,seq4,r_22_15_130,r_22_15_130,0.98,4,134,130,77
1,r_6_37_119,seq34,r_9_10_78,r_6_37_119,0.9,0,119,119,77
33,seq26,r_64_35_7,r_43_25_34,r_43_25_34,1.0,4,38,34,77
11,r_5_41_198,seq42,r_21_20_33,r_21_20_33,1.0,0,33,33,77
42,seq48,r_68_24_86,seq16,r_68_24_86,1.0,-31,55,86,77
19,r_27_69_117,seq52,r_9_10_78,r_9_10_78,1.0,43,121,78,77
17,r_53_73_15,r_64_35_7,r_62_2_178,r_53_73_15,0.94,5,20,15,77
28,seq12,r_30_1_38,r_66_46_176,r_30_1_38,1.0,1,39,38,77
26,seq8,r_9_10_78,r_66_46_176,r_9_10_78,1.0,0,78,78,77
4,r_45_57_98,seq23,seq42,r_45_57_98,0.98,0,98,98,77
0,r_56_61_158,seq16,seq42,r_56_61_158,0.84,0,158,158,77
20,r_70_60_151,seq29,seq13,r_70_60_151,0.78,0,151,151,77
13,r_36_47_172,seq65,r_43_25_34,r_43_25_34,0.68,133,167,34,77
15,r_22_15_130,r_5_41_198,seq39,r_22_15_130,0.97,0,130,130,77
21,r_72_31_89,r_64_35_7,seq12,r_72_31_89,0.84,5,94,89,77
7,r_30_1_38,seq12,seq71,r_30_1_38,1.0,1,39,38,77
9,r_64_35_7,r_53_73_15,seq28,r_64_35_7,0.61,13,20,7,77
18,r_38_17_60,r_22_15_130,r_7_63_31,r_38_17_60,1.0,0,60,60,77
24,r_68_24_86,seq48,r_43_25_34,r_68_24_86,0.98,2,88,86,77
16,r_3_44_21,r_45_57_98,seq42,r_3_44_21,0.97,2,23,21,77
38,seq34,r_6_37_119,r_55_50_54,r_6_37_119,1.0,0,119,119,77
3,r_21_20_33,r_55_50_54,r_5_41_198,r_21_20_33,1.0,0,33,33,77
22,r_0_51_112,seq33,seq71,r_0_51_112,0.74,1,113,112,77
49,seq71,seq23,r_30_1_38,r_30_1_38,1.0,26,64,38,77
35,seq29,r_70_60_151,seq34,r_70_60_151,0.96,0,151,151,77
5,r_43_25_34,r_6_37_119,seq26,r_43_25_34,1.0,0,34,34,77
30,seq17,r_57_7_69,r_31_66_19,r_57_7_69,0.99,0,69,69,78
40,seq40,r_70_30_74,r_64_15_25,r_70_30_74,0.81,-16,58,74,78
14,r_11_50_73,seq13,seq71,r_11_50_73,1.0,2,75,73,78
17,r_38_32_56,r_68_14_146,r_67_56_133,r_67_56_133,0.96,0,133,133,78
2,r_26_28_62,seq0,seq8,r_26_28_62,0.91,-4,58,62,78
19,r_64_15_25,seq40,r_59_42_128,r_59_42_128,1.0,11,139,128,78
19,r_64_15_25,r_68_14_146,seq40,r_64_15_25,0.96,3,28,25,78
21,r_54_60_153,seq10,seq22,r_54_60_153,0.62,0,153,153,78
1,r_68_14_146,seq24,seq33,r_68_14_146,0.51,0,146,146,78
5,r_9_27_65,r_12_39_104,seq62,r_9_27_65,1.0,1,66,65,78
42,seq52,r_36_46_185,r_54_60_153,r_54_60_153,0.64,32,185,153,78
11,r_48_6_11,r_9_27_65,seq8,r_48_6_11,0.96,0,11,11,78
0,r_31_66_19,r_57_7_69,seq17,r_57_7_69,1.0,0,69,69,78
4,r_58_73_58,seq13,r_21_45_42,r_21_45_42,0.43,75,117,42,78
8,r_5_1_13,seq19,r_41_51_40,r_41_51_40,0.71,3,43,40,78
3,r_70_30_74,seq40,seq10,r_70_30_74,0.98,0,74,74,78
4,r_58_73_58,seq10,seq13,r_58_73_58,0.97,0,58,58,78
26,seq4,r_43_2_159,r_12_39_104,r_12_39_104,0.95,41,145,104,78
9,r_57_7_69,seq17,r_31_66_19,r_31_66_19,0.92,6,25,19,78
7,r_49_25_161,seq22,r_31_66_19,r_49_25_161,0.86,0,161,161,78
2,r_26_28_62,seq8,r_12_39_104,r_12_39_104,1.0,0,104,104,78
20,r_12_39_104,seq29,r_26_28_62,r_12_39_104,1.0,0,104,104,78
32,seq19,r_23_63_41,r_5_1_13,r_23_63_41,0.64,-23,18,41,78
15,r_21_45_42,r_59_42_128,seq61,r_59_42_128,1.0,0,128,128,78
49,seq74,r_43_2_159,r_12_39_104,r_12_39_104,1.0,57,161,104,78
16,r_41_51_40,seq13,r_5_1_13,r_41_51_40,0.97,0,40,40,78
9,r_57_7_69,r_31_66_19,seq71,r_57_7_69,1.0,0,69,69,78
10,r_23_63_41,seq35,seq10,r_23_63_41,1.0,0,41,41,78
18,r_59_42_128,r_21_45_42,r_64_15_25,r_59_42_128,0.58,0,128,128,78
24,r_43_2_159,seq4,seq37,r_43_2_159,0.4,2,161,159,78
25,seq0,r_26_28_62,seq34,r_26_28_62,1.0,2,64,62,78
48,seq71,r_47_3_39,r_57_7_69,r_57_7_69,0.98,58,127,69,78
6,r_47_3_39,seq8,seq71,r_47_3_39,1.0,0,39,39,78
0,r_31_66_19,r_49_25_161,r_57_7_69,r_31_66_19,0.49,0,19,19,78
22,r_67_56_133,r_49_25_161,r_38_32_56,r_49_25_161,0.77,-28,133,161,78
13,r_72_65_48,r_68_14_146,seq33,r_72_65_48,0.74,-1,47,48,78
49,seq74,seq8,r_43_2_159,r_43_2_159,0.42,-123,36,159,78
7,r_49_25_161,r_67_56_133,seq22,r_67_56_133,0.91,0,133,133,78
23,r_16_20_178,seq8,r_70_30_74,r_70_30_74,0.47,108,182,74,78
8,r_5_1_13,seq17,seq19,r_5_1_13,0.82,0,13,13,78
27,seq8,r_16_20_178,r_48_6_11,r_48_6_11,0.99,0,11,11,78
30,seq11,seq22,r_40_71_89,r_40_71_89,1.0,0,89,89,79
8,r_10_7_107,seq5,seq23,r_10_7_107,1.0,0,107,107,79
16,r_0_32_95,seq19,seq6,r_0_32_95,0.99,1,96,95,79
21,r_45_39_118,r_47_48_156,seq29,r_45_39_118,0.98,1,119,118,79
1,r_47_48_156,r_45_39_118,seq51,r_45_39_118,1.0,1,119,118,79
5,r_50_64_89,r_49_41_186,seq61,r_50_64_89,1.0,0,89,89,79
42,seq51,r_47_48_156,r_40_71_89,r_40_71_89,0.98,38,127,89,79
4,r_49_41_186,r_10_7_107,r_50_64_89,r_49_41_186,0.61,0,186,186,79
19,r_40_71_89,seq61,seq11,r_40_71_89,1.0,1,90,89,79
2,r_12_67_21,r_43_57_165,seq15,r_12_67_21,1.0,0,21,21,79
11,r_21_68_9,seq4,r_73_44_76,r_73_44_76,1.0,6,82,76,79
39,seq31,r_8_28_26,r_56_46_70,r_56_46_70,0.51,43,113,70,79
41,seq37,seq74,r_40_71_89,r_40_71_89,1.0,8,97,89,79
3,r_43_57_165,r_49_41_186,r_56_46_70,r_56_46_70,0.6,95,165,70,79
14,r_8_28_26,seq3,seq31,r_8_28_26,0.88,-2,24,26,79
14,r_8_28_26,seq31,r_56_46_70,r_56_46_70,0.7,48,118,70,79
4,r_49_41_186,r_50_64_89,r_2_66_158,r_50_64_89,1.0,-28,61,89,79
0,r_1_65_89,r_25_53_197,seq5,r_1_65_89,0.78,7,96,89,79
4,r_49_41_186,r_2_66_158,r_10_7_107,r_10_7_107,0.86,39,146,107,79
6,r_56_46_70,r_40_71_89,r_20_13_105,r_56_46_70,0.91,0,70,70,79
22,r_72_18_87,r_49_41_186,r_10_7_107,r_72_18_87,0.61,99,186,87,79
6,r_56_46_70,r_8_28_26,r_43_57_165,r_43_57_165,0.97,0,165,165,79
18,r_73_44_76,seq62,r_21_68_9,r_73_44_76,1.0,0,76,76,79
38,seq29,seq6,r_45_39_118,r_45_39_118,1.0,-2,116,118,79
17,r_34_55_172,seq4,seq51,r_34_55_172,0.53,0,172,172,79
9,r_2_66_158,r_49_41_186,r_50_64_89,r_50_64_89,1.0,69,158,89,79
22,r_72_18_87,seq74,r_49_41_186,r_72_18_87,0.95,0,87,87,79
7,r_20_13_105,r_8_28_26,r_56_46_70,r_56_46_70,0.46,2,72,70,79
23,r_27_33_46,seq6,seq70,r_27_33_46,0.94,4,50,46,79
7,r_20_13_105,r_56_46_70,seq19,r_20_13_105,0.99,0,105,105,79
6,r_56_46_70,r_20_13_105,seq31,r_56_46_70,0.5,27,97,70,79
10,r_63_16_53,r_56_46_70,seq74,r_63_16_53,1.0,0,53,53,79
30,seq11,r_18_32_171,r_74_54_124,r_74_54_124,1.0,50,174,124,80
20,r_49_40_45,r_46_57_149,seq42,r_49_40_45,1.0,0,45,45,80
1,r_3_55_65,r_67_50_157,r_63_34_68,r_67_50_157,0.95,1,158,157,80
5,r_19_68_88,seq25,seq35,r_19_68_88,1.0,2,90,88,80
19,r_22_45_76,r_8_0_179,seq52,r_22_45_76,1.0,0,76,76,80
2,r_46_57_149,seq15,seq30,r_46_57_149,0.82,-15,134,149,80
13,r_8_0_179,r_22_45_76,seq33,r_22_45_76,0.98,-18,58,76,80
3,r_63_34_68,r_3_55_65,seq37,r_63_34_68,0.7,13,81,68,80
10,r_62_47_94,r_39_10_126,seq30,r_62_47_94,1.0,0,94,94,80
4,r_74_54_124,seq4,r_53_60_123,r_74_54_124,0.74,0,124,124,80
45,seq48,r_61_16_25,r_66_5_11,r_61_16_25,0.98,-1,24,25,80
0,r_53_60_123,seq20,seq65,r_53_60_123,0.9,1,124,123,80
15,r_14_38_78,r_19_68_88,seq15,r_14_38_78,1.0,2,80,78,80
48,seq65,seq26,r_53_60_123,r_53_60_123,1.0,61,184,123,80
38,seq31,r_66_5_11,r_41_69_20,r_41_69_20,0.97,8,28,20,80
2,r_46_57_149,r_24_7_78,seq15,r_46_57_149,0.62,-88,61,149,80
18,r_58_23_132,seq48,r_74_54_124,r_58_23_132,0.92,0,132,132,80
24,r_67_50_157,r_3_55_65,r_14_38_78,r_67_50_157,0.82,1,158,157,80
25,seq1,r_8_0_179,r_29_51_25,r_29_51_25,0.85,126,151,25,80
4,r_74_54_124,r_53_60_123,r_58_23_132,r_74_54_124,0.53,22,146,124,80
9,r_39_10_126,seq42,r_14_38_78,r_39_10_126,0.97,0,126,126,80
21,r_29_51_25,seq6,seq43,r_29_51_25,1.0,0,25,25,80
8,r_41_69_20,r_19_68_88,seq31,r_41_69_20,0.87,0,20,20,80
7,r_70_27_88,seq26,seq20,r_70_27_88,0.93,0,88,88,80
22,r_61_16_25,seq48,seq42,r_61_16_25,0.98,0,25,25,80
23,r_18_32_171,seq11,r_39_10_126,r_39_10_126,0.69,46,172,126,80
43,seq43,seq9,r_29_51_25,r_29_51_25,1.0,3,28,25,80
2,r_46_57_149,r_49_40_45,r_24_7_78,r_49_40_45,0.97,0,45,45,80
30,seq13,r_59_44_115,seq3,r_59_44_115,1.0,0,115,115,81
8,r_20_49_87,seq3,seq9,r_20_49_87,0.67,0,87,87,81
43,seq57,r_26_21_193,r_70_39_119,r_70_39_119,1.0,57,176,119,81
37,seq33,seq18,r_74_0_90,r_74_0_90,0.99,7,97,90,81
20,r_12_51_40,r_8_41_93,r_55_66_126,r_12_51_40,1.0,0,40,40,81
16,r_29_37_97,seq15,seq48,r_29_37_97,0.97,1,98,97,81
5,r_47_11_1,r_74_0_90,seq48,r_74_0_90,1.0,2,92,90,81
45,seq61,r_70_39_119,r_34_6_165,r_70_39_119,0.98,0,119,119,81
9,r_54_35_10,r_16_45_125,seq9,r_54_35_10,0.77,1,11,10,81
2,r_30_40_49,r_29_37_97,seq9,r_30_40_49,1.0,1,50,49,81
31,seq15,r_29_37_97,r_26_21_193,r_29_37_97,0.99,1,98,97,81
13,r_69_25_11,seq48,seq5,r_69_25_11,0.89,0,11,11,81
3,r_8_41_93,r_71_46_148,seq9,r_8_41_93,0.51,2,95,93,81
26,seq3,r_20_49_87,seq13,r_20_49_87,1.0,0,87,87,81
0,r_74_0_90,r_47_11_1,seq33,r_74_0_90,0.65,0,90,90,81
11,r_32_50_79,r_28_4_102,seq3,r_32_50_79,0.99,0,79,79,81
15,r_42_65_169,seq36,seq3,r_42_65_169,0.46,0,169,169,81
48,seq64,seq68,r_16_45_125,r_16_45_125,1.0,-1,124,125,81
6,r_16_45_125,r_42_65_169,seq64,r_16_45_125,0.91,0,125,125,81
24,r_24_73_72,r_28_4_102,seq1,r_28_4_102,0.87,-28,74,102,81
21,r_72_14_32,seq31,seq62,r_72_14_32,1.0,1,33,32,81
38,seq36,r_42_65_169,r_34_6_165,r_42_65_169,0.83,0,169,169,81
10,r_34_6_165,seq61,r_28_4_102,r_28_4_102,0.57,63,165,102,81
17,r_71_46_148,seq60,r_55_66_126,r_71_46_148,0.78,0,148,148,81
22,r_59_44_115,seq13,seq22,r_59_44_115,0.94,0,115,115,81
28,seq9,r_28_4_102,r_8_41_93,r_28_4_102,0.72,0,102,102,81
7,r_23_58_70,r_47_11_1,seq17,r_23_58_70,1.0,0,70,70,81
23,r_70_39_119,seq61,seq15,r_70_39_119,0.95,0,119,119,81
35,seq22,seq1,r_59_44_115,r_59_44_115,1.0,31,146,115,81
12,r_28_4_102,seq9,seq36,r_28_4_102,0.97,1,103,102,81
6,r_65_26_48,seq38,seq43,r_65_26_48,0.45,59,107,48,82
14,r_28_22_167,seq54,seq15,r_28_22_167,0.64,1,168,167,82
37,seq29,r_44_32_91,seq15,r_44_32_91,1.0,0,91,91,82
16,r_42_20_84,seq39,r_34_35_33,r_42_20_84,1.0,0,84,84,82
42,seq43,seq17,r_28_22_167,r_28_22_167,0.97,-1,166,167,82
7,r_27_69_41,r_34_35_33,r_36_40_140,r_36_40_140,0.8,11,151,140,82
45,seq54,r_28_22_167,seq45,r_28_22_167,0.91,-23,144,167,82
12,r_34_35_33,r_14_18_190,seq16,r_34_35_33,1.0,2,35,33,82
4,r_53_70_50,r_48_51_134,seq21,r_53_70_50,1.0,1,51,50,82
7,r_27_69_41,seq64,r_34_35_33,r_34_35_33,1.0,26,59,33,82
41,seq39,r_42_20_84,r_67_62_181,r_42_20_84,1.0,-16,68,84,82
10,r_23_49_144,seq29,seq39,r_23_49_144,0.95,0,144,144,82
11,r_36_40_140,r_48_51_134,r_27_69_41,r_27_69_41,0.7,102,143,41,82
20,r_31_72_66,r_42_20_84,seq6,r_31_72_66,1.0,0,66,66,82
13,r_44_32_91,seq29,r_24_4_8,r_44_32_91,1.0,0,91,91,82
15,r_66_13_134,seq11,r_24_4_8,r_66_13_134,0.83,0,134,134,82
6,r_65_26_48,r_9_55_152,seq38,r_65_26_48,0.43,43,91,48,82
2,r_24_4_8,r_7_47_197,r_66_13_134,r_66_13_134,0.99,0,134,134,82
27,seq6,seq43,r_31_72_66,r_31_72_66,1.0,13,79,66,82
1,r_48_51_134,r_53_70_50,r_36_40_140,r_53_70_50,1.0,1,51,50,82
41,seq39,r_67_62_181,r_9_55_152,r_9_55_152,1.0,7,159,152,82
40,seq38,r_14_18_190,r_12_52_21,r_12_52_21,1.0,5,26,21,82
18,r_57_37_102,r_74_61_50,r_59_56_7,r_57_37_102,0.88,-1,101,102,82
33,seq17,r_9_55_152,seq68,r_9_55_152,1.0,-14,138,152,82
24,r_73_5_24,seq6,seq1,r_73_5_24,0.78,2,26,24,82
32,seq16,seq64,r_34_35_33,r_34_35_33,1.0,36,69,33,82
3,r_12_52_21,r_7_47_197,seq38,r_12_52_21,1.0,0,21,21,82
47,seq64,r_27_69_41,r_34_35_33,r_34_35_33,1.0,26,59,33,82
21,r_7_47_197,r_12_52_21,r_24_4_8,r_12_52_21,0.82,0,21,21,82
26,seq1,r_14_18_190,r_73_5_24,r_73_5_24,0.84,-6,18,24,82
28,seq8,seq64,r_34_35_33,r_34_35_33,1.0,52,85,33,82
49,seq71,r_60_63_189,seq1,r_60_63_189,0.54,-75,114,189,82
23,r_3_50_94,seq21,seq17,r_3_50_94,1.0,1,95,94,82
36,seq35,r_9_57_160,seq55,r_9_57_160,0.94,-9,151,160,83
14,r_63_47_196,r_45_53_117,seq44,r_45_53_117,0.97,5,122,117,83
21,r_74_12_3,r_43_21_73,seq36,r_43_21_73,1.0,2,75,73,83
1,r_56_67_148,seq50,seq7,r_56_67_148,0.98,0,148,148,83
5,r_5_33_134,seq61,seq7,r_5_33_134,1.0,1,135,134,83
21,r_74_12_3,seq36,r_45_53_117,r_45_53_117,0.54,-5,112,117,83
46,seq65,r_71_40_118,seq55,r_71_40_118,0.7,2,120,118,83
19,r_68_1_117,r_25_66_123,r_28_13_75,r_25_66_123,0.63,-6,117,123,83
11,r_20_6_35,seq44,r_71_40_118,r_71_40_118,0.9,-3,115,118,83
11,r_20_6_35,seq55,seq44,r_20_6_35,0.98,0,35,35,83
3,r_8_39_151,seq17,r_63_47_196,r_8_39_151,0.95,0,151,151,83
24,r_23_62_163,seq55,seq30,r_23_62_163,1.0,0,163,163,83
0,r_29_11_182,seq48,seq70,r_29_11_182,0.59,0,182,182,83
18,r_64_54_26,r_28_13_75,r_22_19_142,r_64_54_26,0.98,1,27,26,83
20,r_28_13_75,seq24,seq59,r_28_13_75,1.0,0,75,75,83
13,r_25_66_123,r_68_1_117,r_22_19_142,r_25_66_123,0.99,-5,118,123,83
7,r_43_21_73,r_51_18_35,seq32,r_51_18_35,0.98,-9,26,35,83
15,r_45_53_117,r_63_47_196,r_74_12_3,r_45_53_117,0.57,5,122,117,83
9,r_46_38_66,seq55,r_25_66_123,r_46_38_66,0.8,121,187,66,83
7,r_43_21_73,seq32,seq15,r_43_21_73,1.0,2,75,73,83
22,r_42_41_59,r_51_18_35,r_9_57_160,r_9_57_160,0.76,0,160,160,83
2,r_69_49_134,r_23_62_163,r_43_21_73,r_23_62_163,0.87,-28,135,163,83
40,seq48,r_29_11_182,seq55,r_29_11_182,0.66,0,182,182,83
24,r_23_62_163,r_69_49_134,seq55,r_23_62_163,0.52,-28,135,163,83
48,seq72,seq70,r_60_4_133,r_60_4_133,1.0,5,138,133,83
47,seq70,seq72,r_29_11_182,r_29_11_182,0.93,-1,181,182,83
6,r_10_31_39,seq37,seq59,r_10_31_39,0.34,-3,36,39,83
9,r_46_38_66,seq32,r_64_54_26,r_46_38_66,0.91,-2,64,66,83
35,seq32,r_46_38_66,seq36,r_46_38_66,0.78,0,66,66,83
32,seq26,r_55_30_139,r_7_56_34,r_55_30_139,0.59,-108,31,139,84
37,seq40,r_45_42_137,r_27_62_17,r_45_42_137,0.92,5,142,137,84
39,seq47,seq0,r_70_48_100,r_70_48_100,1.0,20,120,100,84
1,r_17_38_86,r_6_11_26,seq19,r_17_38_86,0.95,0,86,86,84
11,r_24_4_153,r_16_71_58,r_58_10_26,r_24_4_153,0.99,-128,25,153,84
13,r_33_12_54,seq52,r_7_56_34,r_33_12_54,0.83,-3,51,54,84
24,r_58_10_26,r_24_4_153,r_17_38_86,r_17_38_86,0.67,67,153,86,84
19,r_28_3_117,r_37_57_179,seq23,r_28_3_117,0.77,4,121,117,84
4,r_22_54_46,seq34,seq18,r_22_54_46,0.99,0,46,46,84
11,r_24_4_153,r_58_10_26,seq20,r_24_4_153,0.98,0,153,153,84
3,r_14_36_171,r_66_32_193,r_58_10_26,r_66_32_193,0.52,-17,176,193,84
10,r_37_57_179,r_67_39_1,r_24_4_153,r_37_57_179,0.48,0,179,179,84
26,seq8,r_70_48_100,seq49,r_70_48_100,1.0,-2,98,100,84
18,r_61_53_33,r_55_30_139,r_44_5_93,r_55_30_139,0.99,-115,24,139,84
21,r_16_71_58,r_24_4_153,seq0,r_16_71_58,1.0,0,58,58,84
24,r_58_10_26,r_17_38_86,r_14_36_171,r_58_10_26,0.61,143,169,26,84
20,r_67_39_1,r_37_57_179,r_65_64_173,r_65_64_173,0.66,6,179,173,84
15,r_66_32_193,r_14_36_171,r_67_39_1,r_14_36_171,0.66,5,176,171,84
27,seq15,seq23,r_1_21_94,r_1_21_94,1.0,13,107,94,84
47,seq69,r_61_53_33,seq15,r_61_53_33,0.81,3,36,33,84
2,r_46_13_175,seq74,seq31,r_46_13_175,0.46,0,175,175,84
25,seq0,seq47,r_16_71_58,r_16_71_58,1.0,3,61,58,84
33,seq29,r_55_30_139,seq63,r_55_30_139,1.0,0,139,139,84
24,r_58_10_26,r_44_5_93,r_24_4_153,r_58_10_26,1.0,0,26,26,84
1,r_17_38_86,seq19,r_55_30_139,r_55_30_139,1.0,0,139,139,84
0,r_2_50_53,r_16_71_58,seq59,r_2_50_53,1.0,1,54,53,84
34,seq31,seq23,r_46_13_175,r_46_13_175,0.51,2,177,175,84
17,r_6_11_26,r_17_38_86,r_9_25_74,r_17_38_86,0.98,0,86,86,84
14,r_7_56_34,seq52,seq26,r_7_56_34,0.81,-3,31,34,84
49,seq74,r_46_13_175,r_1_21_94,r_1_21_94,1.0,83,177,94,84
7,r_70_48_100,seq8,seq47,r_70_48_100,1.0,0,100,100,84
12,r_1_21_94,r_24_4_153,seq15,r_1_21_94,0.88,1,95,94,84
9,r_0_67_55,seq37,seq7,r_0_67_55,0.99,0,55,55,85
14,r_72_33_108,seq65,r_41_23_49,r_41_23_49,0.98,63,112,49,85
43,seq48,r_63_19_164,r_43_61_67,r_43_61_67,1.0,3,70,67,85
16,r_31_56_64,seq44,seq25,r_31_56_64,1.0,0,64,64,85
21,r_43_61_67,r_59_47_97,seq48,r_43_61_67,1.0,1,68,67,85
1,r_18_5_9,r_68_36_161,r_38_39_141,r_38_39_141,0.84,20,161,141,85
5,r_63_19_164,seq48,r_2_49_196,r_63_19_164,0.46,-85,79,164,85
46,seq55,r_71_35_177,r_59_47_97,r_59_47_97,0.98,80,177,97,85
15,r_8_73_142,seq44,r_18_5_9,r_8_73_142,0.99,1,143,142,85
11,r_41_23_49,r_38_39_141,r_72_33_108,r_72_33_108,0.67,35,143,108,85
0,r_2_49_196,seq48,r_63_19_164,r_63_19_164,0.4,-66,98,164,85
13,r_40_3_173,r_9_64_10,r_62_11_112,r_62_11_112,1.0,0,112,112,85
15,r_8_73_142,r_58_29_182,seq44,r_8_73_142,0.42,-64,78,142,85
12,r_34_15_136,r_2_49_196,r_63_19_164,r_63_19_164,0.46,-23,141,164,85
13,r_40_3_173,r_62_11_112,seq65,r_40_3_173,0.95,1,174,173,85
11,r_41_23_49,seq37,r_38_39_141,r_41_23_49,1.0,0,49,49,85
22,r_59_47_97,r_72_33_108,r_0_67_55,r_59_47_97,0.94,1,98,97,85
5,r_63_19_164,r_2_49_196,r_34_15_136,r_63_19_164,0.46,-5,159,164,85
3,r_9_64_10,seq24,r_10_60_4,r_10_60_4,0.72,6,10,4,85
9,r_0_67_55,seq21,seq37,r_0_67_55,0.46,-20,35,55,85
10,r_38_39_141,r_41_23_49,r_18_5_9,r_38_39_141,0.55,2,143,141,85
2,r_30_74_183,seq7,r_2_49_196,r_2_49_196,0.53,-13,183,196,85
18,r_62_11_112,seq25,r_40_3_173,r_62_11_112,0.99,2,114,112,85
24,r_54_70_121,r_68_36_161,r_62_11_112,r_54_70_121,0.78,2,123,121,85
17,r_57_32_180,r_58_29_182,r_31_56_64,r_31_56_64,1.0,116,180,64,85
10,r_38_39_141,seq4,r_41_23_49,r_41_23_49,0.99,1,50,49,85
22,r_59_47_97,r_43_61_67,r_72_33_108,r_43_61_67,0.94,1,68,67,85
28,seq12,r_68_36_161,r_8_73_142,r_8_73_142,0.93,19,161,142,85
18,r_62_11_112,r_40_3_173,r_26_45_169,r_62_11_112,0.97,62,174,112,85
23,r_68_36_161,seq12,r_43_61_67,r_43_61_67,1.0,94,161,67,85
35,seq22,r_46_1_163,seq52,r_46_1_163,0.73,-55,108,163,85
12,r_34_15_136,seq48,r_2_49_196,r_34_15_136,0.34,-57,79,136,85
30,seq12,r_53_47_166,r_20_50_143,r_20_50_143,0.62,9,152,143,86
14,r_72_30_80,seq19,r_41_39_63,r_41_39_63,0.55,17,80,63,86
5,r_20_50_143,seq54,seq12,r_20_50_143,0.53,0,143,143,86
6,r_28_52_44,r_34_57_57,seq0,r_28_52_44,0.89,0,44,44,86
11,r_11_38_50,r_73_70_80,seq43,r_11_38_50,1.0,0,50,50,86
19,r_27_25_184,r_41_39_63,seq12,r_41_39_63,0.7,97,160,63,86
15,r_8_5_18,r_22_48_187,r_64_74_169,r_8_5_18,0.58,143,161,18,86
22,r_22_48_187,r_46_65_90,r_8_5_18,r_22_48_187,0.96,-168,19,187,86
41,seq51,r_64_74_169,r_41_39_63,r_41_39_63,1.0,107,170,63,86
3,r_64_74_169,seq51,r_8_5_18,r_8_5_18,0.68,152,170,18,86
4,r_40_10_60,seq44,seq4,r_40_10_60,1.0,0,60,60,86
0,r_41_39_63,r_64_74_169,r_72_30_80,r_72_30_80,0.67,1,81,80,86
0,r_41_39_63,r_27_25_184,r_64_74_169,r_41_39_63,0.7,3,66,63,86
13,r_46_65_90,seq29,seq45,r_46_65_90,1.0,1,91,90,86
9,r_63_49_55,seq1,r_28_52_44,r_63_49_55,1.0,0,55,55,86
21,r_3_69_28,r_53_47_166,seq17,r_3_69_28,1.0,0,28,28,86
27,seq2,r_36_55_188,seq26,r_36_55_188,0.67,0,188,188,86
22,r_22_48_187,r_8_5_18,r_35_58_97,r_35_58_97,1.0,90,187,97,86
2,r_34_57_57,r_28_52_44,r_14_67_95,r_28_52_44,0.8,0,44,44,86
47,seq66,seq51,r_72_30_80,r_72_30_80,1.0,4,84,80,86
18,r_36_55_188,seq2,r_35_58_97,r_35_58_97,0.95,91,188,97,86
15,r_8_5_18,r_6_15_197,r_22_48_187,r_8_5_18,0.97,0,18,18,86
35,seq29,r_22_48_187,r_8_5_18,r_22_48_187,0.64,-26,161,187,86
17,r_53_47_166,seq12,seq19,r_53_47_166,0.26,12,178,166,86
28,seq4,seq19,r_40_10_60,r_40_10_60,1.0,2,62,60,86
7,r_33_18_97,seq44,r_11_38_50,r_33_18_97,0.99,-5,92,97,86
11,r_11_38_50,seq43,r_33_18_97,r_33_18_97,0.96,-1,96,97,86
10,r_9_37_11,r_34_57_57,seq1,r_9_37_11,1.0,0,11,11,86
35,seq29,r_46_65_90,r_22_48_187,r_46_65_90,1.0,1,91,90,86
12,r_23_21_189,r_6_15_197,r_28_52_44,r_6_15_197,0.33,-8,189,197,86
8,r_7_15_61,seq28,seq39,r_7_15_61,1.0,0,61,61,87
3,r_25_63_11,r_45_22_197,r_12_54_11,r_25_63_11,0.97,0,11,11,87
19,r_1_17_78,r_25_63_11,r_43_27_42,r_1_17_78,0.67,1,79,78,87
21,r_56_71_100,seq55,r_35_72_149,r_56_71_100,1.0,0,100,100,87
46,seq66,r_60_37_172,r_70_8_115,r_60_37_172,0.32,0,172,172,87
42,seq55,r_56_71_100,r_6_51_26,r_56_71_100,0.66,0,100,100,87
44,seq62,r_43_27_42,r_46_2_11,r_43_27_42,1.0,-3,39,42,87
10,r_18_41_136,seq68,r_12_54_11,r_18_41_136,0.92,0,136,136,87
15,r_46_2_11,r_56_71_100,seq62,r_46_2_11,0.43,0,11,11,87
4,r_6_51_26,r_42_59_57,seq55,r_6_51_26,1.0,1,27,26,87
11,r_36_20_75,seq40,seq0,r_36_20_75,1.0,1,76,75,87
5,r_12_54_11,seq11,r_25_63_11,r_25_63_11,0.52,0,11,11,87
20,r_5_33_189,seq40,r_21_58_101,r_21_58_101,0.99,2,103,101,87
4,r_6_51_26,seq55,r_74_10_94,r_74_10_94,0.98,1,95,94,87
6,r_21_58_101,r_74_10_94,r_5_33_189,r_21_58_101,0.82,0,101,101,87
2,r_74_10_94,r_21_58_101,r_6_51_26,r_6_51_26,0.53,73,99,26,87
45,seq64,r_69_31_194,r_3_49_18,r_3_49_18,1.0,18,36,18,87
25,seq0,seq39,r_36_20_75,r_36_20_75,1.0,21,96,75,87
19,r_1_17_78,seq48,r_25_63_11,r_25_63_11,1.0,0,11,11,87
27,seq11,r_70_8_115,r_43_27_42,r_43_27_42,1.0,7,49,42,87
46,seq66,r_70_8_115,r_23_32_182,r_23_32_182,0.71,2,184,182,87
9,r_13_44_158,r_61_9_121,seq53,r_61_9_121,0.95,2,123,121,87
9,r_13_44_158,seq53,seq24,r_13_44_158,0.7,-1,157,158,87
22,r_23_32_182,seq57,seq66,r_23_32_182,0.34,0,182,182,87
7,r_61_9_121,r_13_44_158,seq26,r_61_9_121,0.98,2,123,121,87
23,r_30_16_162,r_70_8_115,r_43_27_42,r_43_27_42,1.0,31,73,42,87
35,seq39,seq0,r_7_15_61,r_7_15_61,1.0,11,72,61,87
17,r_43_27_42,seq0,seq11,r_43_27_42,1.0,0,42,42,87
8,r_25_2_139,r_52_53_176,seq22,r_52_53_176,0.68,-36,140,176,88
16,r_49_67_62,seq1,r_69_61_191,r_49_67_62,1.0,0,62,62,88
1,r_52_53_176,r_55_29_192,seq21,r_55_29_192,0.55,-15,177,192,88
0,r_24_7_23,seq12,seq17,r_24_7_23,0.91,1,24,23,88
9,r_14_0_97,r_68_71_124,r_38_32_111,r_14_0_97,0.87,20,117,97,88
31,seq16,seq40,r_68_71_124,r_68_71_124,0.82,4,128,124,88
3,r_69_61_191,r_68_71_124,r_49_67_62,r_69_61_191,0.5,-124,67,191,88
5,r_54_28_17,seq56,seq3,r_54_28_17,1.0,0,17,17,88
4,r_72_5_191,r_69_61_191,r_14_0_97,r_14_0_97,0.99,20,117,97,88
11,r_38_32_111,seq58,r_14_0_97,r_38_32_111,0.99,0,111,111,88
13,r_18_11_94,seq4,seq56,r_18_11_94,0.95,0,94,94,88
15,r_68_71_124,r_69_61_191,seq16,r_68_71_124,0.99,0,124,124,88
27,seq4,r_18_11_94,seq47,r_18_11_94,1.0,4,98,94,88
2,r_19_31_84,seq58,seq21,r_19_31_84,0.86,0,84,84,88
24,r_65_48_170,r_69_61_191,r_26_43_145,r_69_61_191,0.75,-21,170,191,88
25,seq1,r_49_67_62,seq21,r_49_67_62,1.0,4,66,62,88
25,seq1,seq21,r_9_10_181,r_9_10_181,0.44,1,182,181,88
32,seq17,r_35_33_161,r_24_7_23,r_24_7_23,0.64,3,26,23,88
9,r_14_0_97,seq37,r_68_71_124,r_14_0_97,0.86,-3,94,97,88
22,r_15_8_127,r_55_29_192,r_14_0_97,r_15_8_127,0.75,0,127,127,88
49,seq64,r_35_33_161,r_49_67_62,r_49_67_62,1.0,10,72,62,88
26,seq3,r_45_41_101,r_54_28_17,r_54_28_17,1.0,12,29,17,88
7,r_55_29_192,r_52_53_176,r_73_74_156,r_52_53_176,0.54,-20,156,176,88
30,seq7,r_48_72_99,r_12_10_168,r_48_72_99,1.0,0,99,99,89
8,r_35_60_63,r_45_46_4,r_43_50_41,r_35_60_63,1.0,3,66,63,89
3,r_43_50_41,r_1_26_105,r_54_28_29,r_43_50_41,0.97,7,48,41,89
16,r_48_72_99,seq7,r_69_53_169,r_48_72_99,1.0,1,100,99,89
21,r_55_30_69,seq24,seq4,r_55_30_69,0.83,4,73,69,89
1,r_36_42_74,seq5,seq56,r_36_42_74,1.0,0,74,74,89
5,r_62_9_6,seq33,r_49_44_85,r_49_44_85,0.87,19,104,85,89
46,seq56,seq71,r_36_42_74,r_36_42_74,1.0,19,93,74,89
10,r_63_70_172,seq56,r_21_73_81,r_21_73_81,1.0,16,97,81,89
16,r_48_72_99,r_69_53_169,r_23_25_60,r_69_53_169,0.73,0,169,169,89
20,r_1_26_105,seq2,seq39,r_1_26_105,0.99,2,107,105,89
48,seq65,r_29_59_53,seq7,r_29_59_53,0.92,4,57,53,89
48,seq65,r_15_11_7,r_12_10_168,r_15_11_7,0.52,146,153,7,89
0,r_45_46_4,r_35_60_63,seq17,r_35_60_63,1.0,-7,56,63,89
13,r_54_28_29,seq33,r_43_50_41,r_54_28_29,1.0,0,29,29,89
17,r_38_58_55,seq37,seq8,r_38_58_55,0.57,4,59,55,89
10,r_63_70_172,r_21_73_81,r_19_67_8,r_63_70_172,0.7,0,172,172,89
27,seq4,seq40,r_55_30_69,r_55_30_69,1.0,3,72,69,89
4,r_22_16_23,seq32,seq2,r_22_16_23,1.0,1,24,23,89
0,r_45_46_4,seq17,r_68_14_111,r_68_14_111,1.0,0,111,111,89
18,r_23_25_60,seq18,r_19_67_8,r_23_25_60,1.0,0,60,60,89
19,r_29_59_53,r_48_72_99,r_57_64_11,r_29_59_53,0.91,-12,41,53,89
48,seq65,seq7,r_15_11_7,r_15_11_7,0.54,111,118,7,89
4,r_22_16_23,seq2,seq0,r_22_16_23,0.56,39,62,23,89
5,r_62_9_6,r_49_44_85,r_63_70_172,r_49_44_85,0.62,55,140,85,89
24,r_57_64_11,seq24,seq5,r_57_64_11,0.8,-1,10,11,89
22,r_68_14_111,seq0,r_45_46_4,r_68_14_111,0.88,0,111,111,89
7,r_21_73_81,r_12_10_168,r_63_70_172,r_21_73_81,1.0,0,81,81,89
23,r_69_53_169,r_62_9_6,r_48_72_99,r_48_72_99,0.79,1,100,99,89
12,r_66_34_129,seq17,r_74_3_52,r_66_34_129,0.8,0,129,129,89
23,r_69_53_169,r_48_72_99,r_20_27_3,r_69_53_169,0.99,0,169,169,89
30,seq17,r_25_20_87,seq59,r_25_20_87,0.71,-15,72,87,90
16,r_11_7_62,seq58,r_33_54_168,r_11_7_62,1.0,0,62,62,90
7,r_62_3_6,r_24_48_181,r_21_8_147,r_62_3_6,0.56,143,149,6,90
15,r_16_37_42,r_60_40_160,r_12_5_31,r_16_37_42,1.0,0,42,42,90
19,r_38_10_159,seq30,seq45,r_38_10_159,0.9,0,159,159,90
8,r_33_54_168,r_56_67_85,r_11_7_62,r_33_54_168,0.84,-105,63,168,90
41,seq52,seq59,r_29_14_121,r_29_14_121,0.71,7,128,121,90
30,seq17,r_23_71_190,r_70_74_135,r_70_74_135,0.54,5,140,135,90
29,seq13,seq44,r_41_27_12,r_41_27_12,0.99,9,21,12,90
10,r_70_74_135,seq50,seq17,r_70_74_135,0.92,0,135,135,90
36,seq44,seq13,r_61_19_29,r_61_19_29,1.0,0,29,29,90
26,seq4,r_36_73_172,r_24_48_181,r_24_48_181,0.69,0,181,181,90
16,r_11_7_62,r_33_54_168,r_1_57_33,r_33_54_168,0.97,3,171,168,90
4,r_66_32_195,r_29_14_121,seq35,r_29_14_121,1.0,-29,92,121,90
0,r_21_8_147,seq68,r_62_3_6,r_62_3_6,0.78,141,147,6,90
11,r_56_67_85,seq44,r_62_3_6,r_56_67_85,1.0,0,85,85,90
12,r_61_19_29,r_29_14_121,seq44,r_61_19_29,1.0,0,29,29,90
13,r_23_71_190,seq17,r_29_14_121,r_29_14_121,0.92,-2,119,121,90
20,r_41_27_12,seq45,r_0_43_17,r_41_27_12,0.97,-1,11,12,90
48,seq68,r_21_8_147,r_36_73_172,r_36_73_172,0.97,-7,165,172,90
13,r_23_71_190,r_29_14_121,seq64,r_29_14_121,0.87,69,190,121,90
6,r_25_20_87,seq17,r_12_5_31,r_25_20_87,1.0,0,87,87,90
2,r_29_14_121,r_23_71_190,r_34_63_163,r_29_14_121,0.66,61,182,121,90
5,r_12_5_31,seq39,seq30,r_12_5_31,0.96,1,32,31,90
22,r_47_42_190,r_62_3_6,r_29_14_121,r_62_3_6,0.32,184,190,6,90
2,r_29_14_121,r_66_32_195,r_23_71_190,r_29_14_121,0.85,0,121,121,90
47,seq65,r_60_40_160,r_1_57_33,r_1_57_33,0.64,129,162,33,90
21,r_0_43_17,seq22,r_41_27_12,r_0_43_17,1.0,-1,16,17,90
8,r_33_54_168,r_11_7_62,seq51,r_33_54_168,0.89,1,169,168,90
24,r_1_57_33,seq50,seq65,r_1_57_33,0.64,1,34,33,90
9,r_60_40_160,seq65,seq58,r_60_40_160,0.66,3,163,160,90
39,seq50,r_36_73_172,seq9,r_36_73_172,0.6,12,184,172,90
23,r_31_15_56,seq59,r_12_5_31,r_31_15_56,0.99,0,56,56,90
8,r_33_54_168,r_29_14_121,r_56_67_85,r_33_54_168,0.84,-130,38,168,90
44,seq58,r_11_7_62,r_60_40_160,r_11_7_62,0.58,1,63,62,90
30,seq21,seq34,r_72_49_50,r_72_49_50,1.0,12,62,50,91
18,r_20_16_15,seq2,r_29_51_124,r_20_16_15,0.86,1,16,15,91
17,r_28_9_22,r_26_3_160,seq14,r_28_9_22,0.87,0,22,22,91
16,r_19_17_149,r_12_30_195,seq73,r_19_17_149,0.74,3,152,149,91
21,r_22_18_33,r_1_32_162,seq33,r_1_32_162,0.44,5,167,162,91
1,r_44_58_69,seq24,seq2,r_44_58_69,1.0,1,70,69,91
5,r_45_5_79,seq11,seq31,r_45_5_79,0.99,0,79,79,91
12,r_46_7_34,seq15,seq24,r_46_7_34,1.0,0,34,34,91
19,r_12_30_195,seq34,r_62_25_30,r_62_25_30,1.0,32,62,30,91
23,r_72_49_50,seq73,seq21,r_72_49_50,0.99,1,51,50,91
3,r_66_59_98,seq15,seq73,r_66_59_98,0.82,7,105,98,91
8,r_10_27_22,r_39_64_179,r_57_42_18,r_39_64_179,0.68,0,179,179,91
14,r_39_64_179,r_10_27_22,seq74,r_39_64_179,0.53,0,179,179,91
20,r_26_3_160,r_44_58_69,r_1_32_162,r_44_58_69,0.75,-1,68,69,91
13,r_60_56_194,r_29_51_124,r_13_55_89,r_13_55_89,1.0,36,125,89,91
15,r_13_55_89,r_37_48_116,r_60_56_194,r_13_55_89,0.93,1,90,89,91
20,r_26_3_160,r_28_9_22,r_44_58_69,r_26_3_160,0.79,-136,24,160,91
8,r_10_27_22,r_44_58_69,r_39_64_179,r_39_64_179,0.91,-157,22,179,91
10,r_37_48_116,r_0_71_115,seq2,r_37_48_116,0.5,-58,58,116,91
27,seq11,r_45_5_79,r_72_49_50,r_45_5_79,0.55,0,79,79,91
2,r_8_61_119,r_39_64_179,seq40,r_8_61_119,0.98,0,119,119,91
24,r_38_65_88,seq69,seq40,r_38_65_88,1.0,0,88,88,91
25,seq2,r_36_67_166,r_44_58_69,r_44_58_69,0.88,37,106,69,91
14,r_39_64_179,r_8_61_119,r_10_27_22,r_39_64_179,0.65,-149,30,179,91
20,r_26_3_160,r_1_32_162,r_8_61_119,r_26_3_160,0.57,1,161,160,91
18,r_20_16_15,r_29_51_124,r_46_7_34,r_20_16_15,0.97,47,62,15,91
6,r_35_4_39,r_66_59_98,seq63,r_35_4_39,0.87,1,40,39,91
7,r_62_25_30,seq43,r_12_30_195,r_62_25_30,1.0,0,30,30,91
9,r_29_51_124,r_60_56_194,seq6,r_29_51_124,0.55,1,125,124,91
28,seq14,seq53,r_28_9_22,r_28_9_22,0.95,1,23,22,91
22,r_36_67_166,seq6,seq23,r_36_67_166,0.8,0,166,166,91
42,seq53,r_0_71_115,seq31,r_0_71_115,0.95,-56,59,115,91
10,r_37_48_116,seq2,seq73,r_37_48_116,1.0,0,116,116,91
19,r_23_51_57,r_50_8_113,r_19_10_47,r_50_8_113,1.0,1,114,113,92
8,r_28_37_178,r_7_38_117,seq2,r_7_38_117,0.99,-29,88,117,92
3,r_19_10_47,seq3,r_56_13_26,r_19_10_47,0.98,1,48,47,92
37,seq34,r_74_64_95,r_62_5_146,r_62_5_146,0.82,0,146,146,92
1,r_45_11_188,r_19_10_47,r_63_44_176,r_45_11_188,0.9,0,188,188,92
1,r_45_11_188,r_35_31_118,r_19_10_47,r_45_11_188,0.93,-63,125,188,92
42,seq48,r_73_25_170,r_35_31_118,r_35_31_118,1.0,5,123,118,92
26,seq3,r_19_10_47,seq9,r_19_10_47,1.0,2,49,47,92
10,r_63_44_176,seq29,seq2,r_63_44_176,0.61,1,177,176,92
8,r_28_37_178,seq2,r_60_32_58,r_28_37_178,0.63,1,179,178,92
0,r_74_64_95,seq34,r_19_10_47,r_19_10_47,1.0,52,99,47,92
5,r_12_49_40,seq2,seq46,r_12_49_40,1.0,0,40,40,92
13,r_7_38_117,r_28_37_178,r_39_0_39,r_7_38_117,0.96,0,117,117,92
6,r_41_59_135,r_73_25_170,r_36_69_31,r_36_69_31,0.97,125,156,31,92
11,r_57_26_49,r_28_37_178,seq20,r_57_26_49,1.0,0,49,49,92
27,seq4,r_6_53_143,seq52,r_6_53_143,0.82,-67,76,143,92
24,r_68_21_46,seq33,seq42,r_68_21_46,1.0,0,46,46,92
2,r_35_31_118,r_45_11_188,seq48,r_35_31_118,1.0,3,121,118,92
20,r_60_32_58,r_16_27_3,r_71_24_102,r_71_24_102,1.0,36,138,102,92
32,seq20,r_1_72_59,r_57_26_49,r_57_26_49,0.87,10,59,49,92
38,seq42,seq46,r_68_21_46,r_68_21_46,1.0,15,61,46,92
21,r_1_72_59,r_23_51_57,r_68_21_46,r_1_72_59,1.0,-2,57,59,92
12,r_50_8_113,r_23_51_57,seq47,r_50_8_113,0.67,1,114,113,92
36,seq33,r_68_21_46,r_65_55_78,r_68_21_46,1.0,1,47,46,92
18,r_56_13_26,seq30,seq18,r_56_13_26,0.99,2,28,26,92
7,r_62_5_146,r_28_37_178,seq34,r_62_5_146,0.87,3,149,146,92
23,r_71_24_102,r_15_40_156,r_60_32_58,r_71_24_102,0.99,0,102,102,92
20,r_60_32_58,r_28_37_178,r_16_27_3,r_60_32_58,1.0,0,58,58,92
12,r_50_8_113,seq18,r_23_51_57,r_23_51_57,1.0,15,72,57,92
19,r_23_51_57,r_1_72_59,r_50_8_113,r_23_51_57,0.99,0,57,57,92
14,r_39_0_39,r_15_40_156,seq67,r_39_0_39,0.62,0,39,39,92
30,seq15,r_56_21_146,seq33,r_56_21_146,0.89,2,148,146,93
8,r_11_16_118,r_49_39_91,r_67_35_37,r_11_16_118,0.93,-35,83,118,93
22,r_71_69_63,r_22_43_112,seq66,r_22_43_112,0.59,-53,59,112,93
6,r_60_58_143,seq6,seq73,r_60_58_143,0.92,2,145,143,93
3,r_53_68_22,r_49_39_91,r_67_35_37,r_49_39_91,1.0,-8,83,91,93
2,r_67_35_37,seq27,r_53_68_22,r_67_35_37,0.97,-1,36,37,93
21,r_56_21_146,seq15,seq4,r_56_21_146,0.68,5,151,146,93
39,seq31,r_57_1_177,r_67_35_37,r_67_35_37,0.54,140,177,37,93
15,r_61_17_17,r_34_28_103,seq41,r_61_17_17,1.0,0,17,17,93
5,r_42_74_94,r_60_58_143,seq70,r_60_58_143,0.89,-48,95,143,93
6,r_60_58_143,r_57_1_177,seq6,r_57_1_177,0.56,-52,125,177,93
11,r_22_43_112,r_45_5_49,seq27,r_22_43_112,1.0,1,113,112,93
19,r_45_5_49,r_51_36_35,r_22_43_112,r_45_5_49,0.86,0,49,49,93
3,r_53_68_22,r_67_35_37,r_49_39_91,r_49_39_91,0.78,-68,23,91,93
46,seq54,seq26,r_52_13_22,r_52_13_22,0.96,12,34,22,93
16,r_72_12_59,seq26,seq4,r_72_12_59,0.49,63,122,59,93
26,seq6,seq70,r_67_35_37,r_67_35_37,0.94,5,42,37,93
4,r_23_8_177,seq32,r_60_58_143,r_23_8_177,0.47,1,178,177,93
0,r_47_0_155,r_37_48_172,seq27,r_47_0_155,0.69,3,158,155,93
20,r_34_28_103,seq73,seq19,r_34_28_103,0.99,2,105,103,93
13,r_64_14_60,seq20,seq7,r_64_14_60,1.0,1,61,60,93
17,r_51_36_35,r_23_8_177,r_45_5_49,r_51_36_35,0.76,0,35,35,93
29,seq10,r_56_21_146,r_22_43_112,r_56_21_146,0.51,-120,26,146,93
6,r_60_58_143,r_62_63_86,r_57_1_177,r_60_58_143,0.5,-57,86,143,93
18,r_52_13_22,r_51_36_35,seq38,r_52_13_22,1.0,1,23,22,93
2,r_67_35_37,r_53_68_22,seq27,r_67_35_37,0.55,-14,23,37,93
27,seq7,seq26,r_64_14_60,r_64_14_60,1.0,8,68,60,93
0,r_47_0_155,r_23_8_177,r_37_48_172,r_47_0_155,0.34,-14,141,155,93
22,r_71_69_63,seq66,r_11_16_118,r_11_16_118,1.0,2,120,118,93
47,seq66,r_71_69_63,r_11_16_118,r_11_16_118,1.0,0,118,118,93
40,seq32,r_23_8_177,r_37_48_172,r_37_48_172,0.72,6,178,172,93
24,r_62_63_86,r_60_58_143,r_3_55_31,r_62_63_86,0.56,0,86,86,93
19,r_45_5_49,seq30,r_52_13_22,r_52_13_22,0.63,2,24,22,93
25,seq4,r_46_2_197,r_56_21_146,r_56_21_146,0.68,6,152,146,93
29,seq10,r_22_43_112,seq9,r_22_43_112,1.0,-40,72,112,93
16,r_72_12_59,r_23_8_177,seq26,r_72_12_59,0.79,0,59,59,93
19,r_45_5_49,r_52_13_22,r_51_36_35,r_45_5_49,0.6,-14,35,49,93
9,r_49_39_91,r_11_16_118,r_45_5_49,r_49_39_91,0.63,0,91,91,93
19,r_45_5_49,r_22_43_112,r_49_39_91,r_45_5_49,0.97,61,110,49,93
46,seq54,r_52_13_22,r_64_14_60,r_64_14_60,0.9,10,70,60,93
38,seq30,r_64_14_60,r_46_2_197,r_64_14_60,0.67,126,186,60,93
8,r_11_16_118,r_67_35_37,r_71_69_63,r_11_16_118,1.0,0,118,118,93
17,r_51_36_35,r_52_13_22,r_23_8_177,r_51_36_35,0.5,-20,15,35,93
49,seq73,r_34_28_103,seq29,r_34_28_103,1.0,2,105,103,93
11,r_22_43_112,r_71_69_63,r_45_5_49,r_45_5_49,1.0,3,52,49,93
38,seq30,r_51_36_35,r_64_14_60,r_64_14_60,0.57,111,171,60,93
19,r_30_11_84,r_41_23_156,r_0_48_1,r_41_23_156,0.97,0,156,156,94
16,r_66_73_189,r_55_26_158,seq58,r_66_73_189,0.66,-33,156,189,94
1,r_39_67_68,r_50_9_170,r_33_62_180,r_39_67_68,0.52,111,179,68,94
1,r_39_67_68,r_45_15_190,r_50_9_170,r_39_67_68,0.76,0,68,68,94
5,r_0_48_1,r_63_59_151,r_70_28_111,r_0_48_1,0.5,151,152,1,94
46,seq58,r_64_31_108,seq3,r_64_31_108,1.0,0,108,108,94
19,r_30_11_84,r_33_62_180,r_41_23_156,r_30_11_84,0.93,0,84,84,94
10,r_44_27_46,r_46_43_4,seq32,r_44_27_46,0.99,0,46,46,94
45,seq56,seq21,r_5_2_20,r_5_2_20,0.84,35,55,20,94
10,r_44_27_46,seq32,r_20_13_57,r_20_13_57,0.88,4,61,57,94
31,seq16,seq17,r_12_22_52,r_12_22_52,1.0,34,86,52,94
14,r_61_14_14,r_57_60_120,r_45_15_190,r_61_14_14,0.88,0,14,14,94
3,r_63_59_151,r_0_48_1,r_44_27_46,r_63_59_151,0.95,2,153,151,94
4,r_55_26_158,r_35_72_130,r_66_73_189,r_35_72_130,0.85,2,132,130,94
15,r_25_53_38,r_39_67_68,seq47,r_25_53_38,1.0,2,40,38,94
11,r_54_69_125,r_50_9_170,r_12_22_52,r_54_69_125,0.58,1,126,125,94
20,r_64_31_108,seq58,seq24,r_64_31_108,0.99,0,108,108,94
13,r_45_15_190,r_39_67_68,r_61_14_14,r_39_67_68,0.67,0,68,68,94
0,r_5_2_20,r_30_11_84,seq56,r_5_2_20,1.0,0,20,20,94
13,r_45_15_190,r_61_14_14,r_49_19_176,r_61_14_14,0.65,175,189,14,94
6,r_57_60_120,seq56,r_20_13_57,r_20_13_57,0.83,69,126,57,94
16,r_66_73_189,seq58,r_55_26_158,r_55_26_158,0.64,31,189,158,94
2,r_35_72_130,r_55_26_158,seq29,r_35_72_130,0.88,2,132,130,94
29,seq7,r_8_52_174,seq40,r_8_52_174,0.98,0,174,174,94
24,r_33_62_180,r_30_11_84,seq29,r_30_11_84,1.0,0,84,84,94
41,seq40,r_8_52_174,seq51,r_8_52_174,0.9,-131,43,174,94
8,r_20_13_57,seq42,r_44_27_46,r_20_13_57,0.99,1,58,57,94
17,r_8_52_174,seq7,r_30_11_84,r_30_11_84,0.98,90,174,84,94
43,seq47,r_12_22_52,seq42,r_12_22_52,1.0,-2,50,52,94
9,r_74_36_90,r_54_69_125,seq42,r_74_36_90,1.0,0,90,90,94
18,r_12_22_52,seq6,seq16,r_12_22_52,0.99,1,53,52,94
4,r_55_26_158,r_66_73_189,r_63_59_151,r_55_26_158,0.95,0,158,158,94
22,r_50_9_170,r_54_69_125,r_49_19_176,r_54_69_125,0.88,1,126,125,94
23,r_41_23_156,r_30_11_84,r_25_53_38,r_41_23_156,1.0,0,156,156,94
7,r_49_19_176,r_50_9_170,seq68,r_49_19_176,0.52,0,176,176,94
23,r_41_23_156,r_63_59_151,r_30_11_84,r_30_11_84,1.0,18,102,84,94
42,seq42,r_20_13_57,seq47,r_20_13_57,1.0,2,59,57,94
22,r_50_9_170,r_49_19_176,seq6,r_50_9_170,0.99,1,171,170,94
35,seq24,r_57_60_120,r_64_31_108,r_64_31_108,1.0,1,109,108,94
12,r_70_28_111,r_55_26_158,r_0_48_1,r_70_28_111,1.0,0,111,111,94
8,r_62_9_95,seq28,r_29_34_21,r_62_9_95,1.0,1,96,95,95
22,r_12_10_66,r_66_46_53,seq56,r_66_46_53,1.0,1,54,53,95
12,r_66_46_53,r_12_10_66,r_16_45_195,r_66_46_53,1.0,1,54,53,95
21,r_27_68_175,r_54_32_71,r_29_34_21,r_27_68_175,0.9,-104,71,175,95
7,r_33_58_141,r_18_5_25,seq59,r_33_58_141,0.77,0,141,141,95
0,r_41_38_50,seq60,seq30,r_41_38_50,1.0,0,50,50,95
15,r_18_5_25,r_33_58_141,seq22,r_18_5_25,0.69,98,123,25,95
2,r_29_34_21,seq19,r_27_68_175,r_29_34_21,0.97,0,21,21,95
3,r_7_71_142,r_16_45_195,seq64,r_7_71_142,0.66,3,145,142,95
10,r_40_35_156,seq6,seq22,r_40_35_156,0.65,1,157,156,95
14,r_20_2_55,seq37,r_7_71_142,r_7_71_142,0.63,2,144,142,95
4,r_61_13_152,seq14,r_18_5_25,r_61_13_152,0.57,-1,151,152,95
5,r_53_52_128,r_61_13_152,r_17_49_138,r_61_13_152,0.75,-1,151,152,95
13,r_17_49_138,r_72_70_118,r_54_32_71,r_54_32_71,0.85,50,121,71,95
48,seq67,r_23_11_107,seq36,r_23_11_107,1.0,0,107,107,95
16,r_55_25_40,r_33_58_141,seq67,r_55_25_40,1.0,0,40,40,95
6,r_31_74_62,seq14,seq28,r_31_74_62,1.0,0,62,62,95
21,r_27_68_175,r_29_34_21,seq19,r_27_68_175,0.69,0,175,175,95
2,r_29_34_21,r_27_68_175,r_42_15_77,r_42_15_77,1.0,91,168,77,95
45,seq60,r_41_38_50,seq28,r_41_38_50,1.0,0,50,50,95
47,seq64,seq37,r_7_71_142,r_7_71_142,0.97,2,144,142,95
18,r_72_70_118,r_17_49_138,seq8,r_72_70_118,0.75,3,121,118,95
29,seq14,r_31_74_62,r_61_13_152,r_31_74_62,1.0,0,62,62,95
20,r_65_51_57,seq22,seq30,r_65_51_57,1.0,0,57,57,95
24,r_42_15_77,seq57,r_29_34_21,r_42_15_77,1.0,0,77,77,95
15,r_18_5_25,r_40_35_156,r_33_58_141,r_18_5_25,0.88,0,25,25,95
45,seq60,seq28,r_40_35_156,r_40_35_156,0.55,26,182,156,95
7,r_33_58_141,r_55_25_40,r_18_5_25,r_33_58_141,0.98,-111,30,141,95
17,r_23_11_107,seq67,seq14,r_23_11_107,0.96,0,107,107,95
13,r_17_49_138,r_54_32_71,r_53_52_128,r_17_49_138,0.75,4,142,138,95
26,seq4,r_16_45_195,r_33_58_141,r_33_58_141,0.37,39,180,141,95
23,r_54_32_71,r_27_68_175,seq59,r_54_32_71,0.99,0,71,71,95
42,seq56,seq63,r_12_10_66,r_12_10_66,0.57,-48,18,66,95
19,r_26_39_39,r_31_74_62,seq0,r_26_39_39,0.97,1,40,39,95
14,r_20_2_55,seq30,seq37,r_20_2_55,1.0,0,55,55,95
23,r_67_9_18,seq57,seq38,r_67_9_18,1.0,0,18,18,96
14,r_8_37_107,r_63_50_118,r_47_59_43,r_47_59_43,1.0,64,107,43,96
8,r_22_41_171,r_7_4_191,seq5,r_7_4_191,0.49,-20,171,191,96
2,r_63_50_118,r_11_61_176,r_67_9_18,r_63_50_118,0.82,0,118,118,96
13,r_19_36_157,seq28,r_6_2_39,r_6_2_39,1.0,6,45,39,96
1,r_16_30_89,r_70_45_108,seq21,r_16_30_89,1.0,0,89,89,96
5,r_11_61_176,r_8_37_107,r_70_45_108,r_11_61_176,1.0,-68,108,176,96
21,r_18_35_98,r_64_20_76,r_52_39_38,r_18_35_98,0.39,61,159,98,96
20,r_47_59_43,seq23,seq10,r_47_59_43,1.0,0,43,43,96
41,seq55,r_31_29_125,r_24_62_128,r_31_29_125,1.0,1,126,125,96
3,r_3_43_126,seq38,seq0,r_3_43_126,0.97,0,126,126,96
10,r_64_20_76,seq44,r_6_2_39,r_64_20_76,0.75,1,77,76,96
4,r_48_53_157,seq26,r_16_30_89,r_16_30_89,1.0,68,157,89,96
48,seq72,r_27_32_78,r_63_50_118,r_27_32_78,0.63,118,196,78,96
12,r_66_51_176,r_11_61_176,r_6_2_39,r_66_51_176,0.58,0,176,176,96
13,r_19_36_157,r_6_2_39,r_63_50_118,r_19_36_157,0.91,0,157,157,96
6,r_70_45_108,r_48_53_157,r_11_61_176,r_70_45_108,0.9,0,108,108,96
5,r_11_61_176,r_70_45_108,seq15,r_11_61_176,0.85,0,176,176,96
0,r_6_2_39,r_19_36_157,r_64_20_76,r_6_2_39,0.91,78,117,39,96
2,r_63_50_118,r_8_37_107,r_11_61_176,r_8_37_107,0.87,1,108,107,96
18,r_14_25_161,seq15,r_63_50_118,r_14_25_161,0.94,-2,159,161,96
6,r_70_45_108,r_11_61_176,r_46_54_128,r_11_61_176,0.97,0,176,176,96
0,r_6_2_39,r_65_17_72,r_19_36_157,r_6_2_39,1.0,0,39,39,96
11,r_52_39_38,r_3_43_126,seq57,r_52_39_38,1.0,0,38,38,96
17,r_31_29_125,seq55,r_52_39_38,r_31_29_125,0.49,0,125,125,96
9,r_24_62_128,r_22_41_171,seq60,r_24_62_128,0.65,2,130,128,96
28,seq10,seq71,r_47_59_43,r_47_59_43,1.0,58,101,43,96
7,r_46_54_128,seq0,r_70_45_108,r_46_54_128,0.94,0,128,128,96
12,r_66_51_176,r_68_13_76,r_11_61_176,r_68_13_76,0.98,-7,69,76,96
30,seq15,r_23_32_77,r_11_56_107,r_23_32_77,0.93,1,78,77,97
8,r_61_37_105,seq57,seq39,r_61_37_105,0.75,0,105,105,97
43,seq50,r_38_55_141,seq64,r_38_55_141,0.31,16,157,141,97
37,seq30,r_34_62_96,r_22_67_47,r_22_67_47,0.96,49,96,47,97
16,r_34_62_96,seq30,seq64,r_34_62_96,0.93,0,96,96,97
1,r_3_51_176,seq69,seq12,r_3_51_176,0.59,0,176,176,97
46,seq57,r_61_37_105,seq12,r_61_37_105,0.88,0,105,105,97
42,seq48,r_25_1_117,r_58_20_107,r_25_1_117,1.0,0,117,117,97
6,r_40_10_16,seq16,r_49_0_14,r_49_0_14,0.66,42,56,14,97
21,r_44_54_32,r_46_63_191,r_34_62_96,r_44_54_32,0.98,0,32,32,97
23,r_7_71_114,seq17,seq12,r_7_71_114,0.99,0,114,114,97
3,r_58_20_107,r_8_68_134,seq48,r_8_68_134,1.0,-26,108,134,97
10,r_43_35_107,seq12,r_38_55_141,r_43_35_107,0.72,1,108,107,97
0,r_66_5_150,seq64,seq2,r_66_5_150,0.85,0,150,150,97
5,r_36_59_54,seq48,seq69,r_36_59_54,0.99,0,54,54,97
13,r_23_32_77,r_38_55_141,r_73_65_199,r_38_55_141,0.67,-63,78,141,97
17,r_60_19_83,r_23_32_77,r_22_67_47,r_22_67_47,0.38,64,111,47,97
15,r_24_33_129,r_66_5_150,seq45,r_24_33_129,1.0,0,129,129,97
21,r_44_54_32,r_34_62_96,r_22_67_47,r_22_67_47,0.37,76,123,47,97
22,r_73_65_199,r_38_55_141,r_13_42_4,r_13_42_4,0.63,8,12,4,97
22,r_73_65_199,r_13_42_4,r_23_32_77,r_73_65_199,0.8,-124,75,199,97
2,r_28_9_91,r_58_20_107,r_23_32_77,r_28_9_91,1.0,0,91,91,97
17,r_60_19_83,r_22_67_47,r_38_55_141,r_22_67_47,0.69,83,130,47,97
23,r_7_71_114,seq12,r_25_1_117,r_25_1_117,0.54,31,148,117,97
45,seq53,r_13_42_4,r_70_18_75,r_70_18_75,1.0,9,84,75,97
17,r_60_19_83,r_28_9_91,r_23_32_77,r_28_9_91,0.57,-7,84,91,97
18,r_22_67_47,seq17,seq30,r_22_67_47,1.0,1,48,47,97
9,r_70_18_75,r_7_71_114,seq53,r_70_18_75,0.96,0,75,75,97
28,seq12,r_43_35_107,r_7_71_114,r_7_71_114,0.9,-1,113,114,97
11,r_47_74_45,r_61_37_105,seq48,r_47_74_45,1.0,0,45,45,97
7,r_11_56_107,r_38_55_141,seq15,r_11_56_107,0.33,1,108,107,97
23,r_7_71_114,r_70_18_75,seq17,r_70_18_75,0.98,0,75,75,97
13,r_23_32_77,r_73_65_199,r_28_9_91,r_28_9_91,1.0,1,92,91,97
12,r_8_68_134,r_58_20_107,r_25_1_117,r_58_20_107,1.0,27,134,107,97
22,r_5_10_177,r_68_60_41,r_69_41_191,r_68_60_41,0.93,1,42,41,98
14,r_25_54_167,r_32_47_136,r_7_27_37,r_7_27_37,0.96,100,137,37,98
16,r_20_3_95,seq26,seq36,r_20_3_95,1.0,2,97,95,98
1,r_63_50_165,r_12_8_111,seq35,r_12_8_111,0.44,8,119,111,98
22,r_5_10_177,r_69_41_191,r_48_62_64,r_48_62_64,0.66,4,68,64,98
3,r_32_47_136,r_25_54_167,seq26,r_32_47_136,0.95,1,137,136,98
26,seq1,r_23_11_194,r_63_50_165,r_63_50_165,0.82,1,166,165,98
4,r_12_8_111,r_25_54_167,seq6,r_12_8_111,0.99,2,113,111,98
19,r_68_60_41,r_5_10_177,seq16,r_68_60_41,1.0,4,45,41,98
20,r_38_56_171,r_66_13_107,seq9,r_66_13_107,0.95,-10,97,107,98
48,seq64,seq46,r_32_47_136,r_32_47_136,0.95,0,136,136,98
15,r_7_27_37,r_69_41_191,seq51,r_7_27_37,1.0,0,37,37,98
0,r_71_52_44,r_43_70_99,seq21,r_71_52_44,0.58,0,44,44,98
27,seq6,r_72_2_61,r_44_14_9,r_72_2_61,0.76,0,61,61,98
2,r_57_31_122,r_58_34_180,r_45_67_14,r_57_31_122,0.78,1,123,122,98
18,r_18_73_117,r_25_54_167,r_17_74_32,r_18_73_117,0.89,2,119,117,98
29,seq16,r_4_22_183,r_68_60_41,r_68_60_41,1.0,49,90,41,98
24,r_17_74_32,seq36,r_25_54_167,r_25_54_167,0.8,12,179,167,98
1,r_63_50_165,seq35,seq1,r_63_50_165,0.59,-6,159,165,98
25,seq0,r_4_22_183,r_68_60_41,r_68_60_41,1.0,31,72,41,98
32,seq24,r_58_34_180,seq28,r_58_34_180,0.94,2,182,180,98
13,r_39_40_2,r_49_15_135,r_45_67_14,r_39_40_2,0.78,25,27,2,98
9,r_48_62_64,seq29,r_5_10_177,r_48_62_64,1.0,0,64,64,98
6,r_45_67_14,r_71_52_44,r_39_40_2,r_45_67_14,0.99,-3,11,14,98
7,r_49_15_135,r_39_40_2,r_32_47_136,r_49_15_135,0.5,7,142,135,98
23,r_66_13_107,r_38_56_171,seq36,r_66_13_107,0.87,1,108,107,98
27,seq6,r_44_14_9,r_12_8_111,r_12_8_111,1.0,2,113,111,98
35,seq29,r_48_62_64,seq46,r_48_62_64,0.99,0,64,64,98
14,r_25_54_167,r_7_27_37,r_17_74_32,r_25_54_167,0.97,0,167,167,98
12,r_72_2_61,seq6,seq9,r_72_2_61,1.0,0,61,61,98
14,r_37_10_143,seq23,seq74,r_37_10_143,0.86,2,145,143,99
16,r_60_51_131,r_53_30_182,r_55_57_108,r_55_57_108,0.63,24,132,108,99
1,r_17_32_160,seq64,seq74,r_17_32_160,0.89,0,160,160,99
5,r_16_54_102,r_60_51_131,seq7,r_60_51_131,0.61,-29,102,131,99
45,seq64,r_42_72_152,r_60_51_131,r_42_72_152,0.93,1,153,152,99
19,r_53_30_182,r_71_43_162,r_35_14_30,r_53_30_182,0.54,-151,31,182,99
4,r_41_48_12,r_6_26_192,r_60_51_131,r_41_48_12,0.81,0,12,12,99
10,r_31_38_118,seq29,seq44,r_31_38_118,0.93,0,118,118,99
11,r_0_20_55,r_6_26_192,seq40,r_0_20_55,1.0,0,55,55,99
20,r_71_43_162,seq33,r_15_11_75,r_15_11_75,1.0,87,162,75,99
15,r_25_70_171,r_55_57_108,seq27,r_55_57_108,0.94,-43,65,108,99
2,r_15_11_75,seq7,r_47_19_122,r_47_19_122,0.67,0,122,122,99
2,r_15_11_75,r_6_26_192,seq7,r_15_11_75,0.68,-5,70,75,99
24,r_55_57_108,r_24_36_93,r_60_51_131,r_24_36_93,1.0,12,105,93,99
6,r_4_66_25,seq29,seq40,r_4_66_25,0.9,0,25,25,99
0,r_35_14_30,seq50,r_53_30_182,r_35_14_30,0.78,-1,29,30,99
38,seq40,r_4_66_25,r_0_20_55,r_0_20_55,1.0,7,62,55,99
34,seq29,r_31_38_118,seq34,r_31_38_118,1.0,5,123,118,99
9,r_47_19_122,seq23,r_15_11_75,r_15_11_75,0.56,53,128,75,99
22,r_65_3_121,seq29,seq1,r_65_3_121,0.91,0,121,121,99
28,seq7,r_31_38_118,r_16_54_102,r_31_38_118,0.98,0,118,118,99
7,r_22_12_141,seq1,seq13,r_22_12_141,0.87,0,141,141,99
12,r_24_36_93,r_55_57_108,r_0_20_55,r_24_36_93,0.84,6,99,93,99
