4,r_88_23_182,seq114,seq75,r_88_23_182,0.79,-1,181,182,0
4,r_88_23_182,r_2_69_29,seq50,r_2_69_29,0.99,0,29,29,0
9,r_103_89_35,seq74,r_54_39_97,r_54_39_97,0.7,7,104,97,0
8,r_80_49_114,seq50,seq6,r_80_49_114,0.98,0,114,114,0
17,r_95_123_50,seq83,seq99,r_95_123_50,1.0,0,50,50,0
60,seq62,r_5_26_189,r_11_107_34,r_11_107_34,1.0,16,50,34,0
26,r_4_0_52,seq3,seq68,r_4_0_52,1.0,0,52,52,0
16,r_57_16_71,seq34,seq97,r_57_16_71,0.73,18,89,71,0
21,r_73_10_190,seq46,r_95_123_50,r_95_123_50,0.86,140,190,50,0
39,seq25,r_67_19_107,r_108_105_32,r_67_19_107,0.33,5,112,107,0
1,r_29_55_126,seq114,seq120,r_29_55_126,0.92,0,126,126,0
24,r_41_61_28,r_59_47_132,seq36,r_41_61_28,0.95,0,28,28,0
46,seq40,r_7_113_139,r_9_128_11,r_9_128_11,0.71,169,180,11,0
80,seq97,seq72,r_57_16_71,r_57_16_71,1.0,6,77,71,0
19,r_54_39_97,seq30,r_103_89_35,r_54_39_97,0.93,0,97,97,0
9,r_103_89_35,r_57_16_71,seq74,r_103_89_35,0.83,5,40,35,0
4,r_88_23_182,r_93_64_101,seq114,r_88_23_182,0.44,-28,154,182,0
41,seq30,r_54_39_97,seq28,r_54_39_97,0.59,37,134,97,0
10,r_8_98_17,seq94,seq97,r_8_98_17,0.99,0,17,17,0
89,seq114,r_29_55_126,seq96,r_29_55_126,0.77,0,126,126,0
28,r_2_69_29,r_88_23_182,seq13,r_2_69_29,0.98,0,29,29,0
3,r_59_47_132,r_101_32_99,r_11_107_34,r_59_47_132,0.54,2,134,132,0
0,r_122_90_63,seq65,seq51,r_122_90_63,0.99,0,63,63,0
11,r_14_81_119,seq37,seq6,r_14_81_119,0.99,0,119,119,0
13,r_27_66_76,seq104,seq117,r_27_66_76,1.0,0,76,76,0
15,r_5_26_189,seq60,r_2_69_29,r_2_69_29,0.77,160,189,29,0
4,r_88_23_182,seq50,r_93_64_101,r_93_64_101,0.64,33,134,101,0
62,seq68,seq75,r_4_0_52,r_4_0_52,0.91,11,63,52,0
62,seq68,r_4_0_52,r_93_64_101,r_93_64_101,1.0,1,102,101,0
27,r_93_64_101,r_7_113_139,seq68,r_93_64_101,1.0,2,103,101,0
2,r_67_19_107,seq25,seq20,r_67_19_107,0.77,1,108,107,0
18,r_33_110_183,seq17,r_95_123_50,r_95_123_50,0.7,134,184,50,0
29,r_7_113_139,seq40,seq104,r_7_113_139,0.46,2,141,139,0
44,seq36,seq117,r_41_61_28,r_41_61_28,1.0,-1,27,28,0
25,r_9_128_11,r_29_55_126,seq40,r_9_128_11,0.96,0,11,11,0
20,r_11_107_34,seq36,seq62,r_11_107_34,1.0,0,34,34,0
22,r_35_125_78,seq99,seq45,r_35_125_78,0.79,0,78,78,0
23,r_129_38_150,r_7_113_139,r_80_49_114,r_7_113_139,0.9,11,150,139,0
7,r_108_105_32,r_59_47_132,seq111,r_108_105_32,0.91,0,32,32,0
35,seq20,r_101_32_99,r_67_19_107,r_67_19_107,0.93,6,113,107,0
12,r_92_12_105,seq115,seq21,r_92_12_105,1.0,0,105,105,0
14,r_40_109_180,seq50,r_71_52_92,r_40_109_180,0.36,5,185,180,1
8,r_16_46_88,seq26,seq116,r_16_46_88,0.91,0,88,88,1
55,seq39,r_41_127_186,r_45_56_113,r_45_56_113,1.0,73,186,113,1
1,r_92_4_171,r_57_99_175,r_107_126_86,r_92_4_171,0.73,0,171,171,1
33,seq7,r_110_97_58,seq27,r_110_97_58,0.99,1,59,58,1
19,r_25_119_157,seq49,seq31,r_25_119_157,0.42,0,157,157,1
9,r_110_97_58,seq7,seq34,r_110_97_58,1.0,0,58,58,1
3,r_18_84_2,r_107_126_86,r_124_59_56,r_18_84_2,0.61,85,87,2,1
10,r_14_103_123,seq23,r_57_99_175,r_14_103_123,0.98,1,124,123,1
26,r_45_56_113,r_112_42_164,seq72,r_45_56_113,1.0,0,113,113,1
4,r_88_125_78,seq116,seq118,r_88_125_78,1.0,2,80,78,1
0,r_63_73_155,seq81,seq62,r_63_73_155,0.43,3,158,155,1
11,r_66_35_71,seq85,seq13,r_66_35_71,1.0,0,71,71,1
20,r_3_37_77,seq111,r_117_0_129,r_3_37_77,1.0,0,77,77,1
23,r_96_95_57,seq106,seq50,r_96_95_57,1.0,0,57,57,1
15,r_117_0_129,seq1,r_3_37_77,r_3_37_77,1.0,6,83,77,1
15,r_117_0_129,r_3_37_77,r_48_6_73,r_117_0_129,0.93,2,131,129,1
27,r_57_99_175,r_92_4_171,r_14_103_123,r_14_103_123,0.49,31,154,123,1
2,r_71_52_92,seq54,r_3_37_77,r_71_52_92,0.69,0,92,92,1
18,r_48_6_73,seq22,seq29,r_48_6_73,1.0,2,75,73,1
29,r_65_58_152,seq120,r_16_46_88,r_65_58_152,0.88,0,152,152,1
24,r_107_126_86,r_18_84_2,seq7,r_107_126_86,1.0,1,87,86,1
25,r_28_75_165,seq15,r_64_90_65,r_64_90_65,1.0,106,171,65,1
22,r_64_90_65,r_25_119_157,r_63_73_155,r_25_119_157,0.57,-119,38,157,1
68,seq69,seq118,r_51_60_81,r_51_60_81,1.0,1,82,81,1
21,r_124_59_56,seq26,r_18_84_2,r_124_59_56,1.0,0,56,56,1
33,seq7,seq27,r_107_126_86,r_107_126_86,0.69,2,88,86,1
53,seq34,seq113,r_110_97_58,r_110_97_58,0.79,-3,55,58,1
96,seq118,seq69,r_88_125_78,r_88_125_78,1.0,4,82,78,1
17,r_77_91_26,r_14_103_123,seq76,r_77_91_26,0.98,0,26,26,1
91,seq111,r_3_37_77,seq5,r_3_37_77,1.0,0,77,77,1
20,r_3_37_77,r_117_0_129,r_71_52_92,r_117_0_129,0.73,2,131,129,1
28,r_121_10_46,r_110_97_58,seq23,r_121_10_46,0.66,-18,28,46,1
7,r_33_36_93,r_65_58_152,seq54,r_33_36_93,0.99,1,94,93,1
12,r_51_60_81,seq67,seq69,r_51_60_81,0.99,0,81,81,1
22,r_64_90_65,r_63_73_155,seq120,r_64_90_65,0.47,0,65,65,1
30,seq128,r_19_76_180,r_79_10_68,r_79_10_68,1.0,14,82,68,2
92,seq116,r_71_56_111,seq109,r_71_56_111,1.0,0,111,111,2
71,seq80,r_69_32_140,r_91_31_7,r_69_32_140,0.65,-1,139,140,2
16,r_106_35_176,r_84_13_79,seq45,r_84_13_79,1.0,-18,61,79,2
1,r_69_32_140,r_20_6_122,seq80,r_20_6_122,0.85,1,123,122,2
14,r_75_39_42,seq52,seq67,r_75_39_42,1.0,1,43,42,2
5,r_28_18_112,seq129,r_99_82_83,r_28_18_112,0.93,2,114,112,2
76,seq88,r_108_24_134,r_20_6_122,r_20_6_122,0.63,12,134,122,2
25,r_55_94_14,r_1_72_114,seq51,r_55_94_14,0.78,0,14,14,2
3,r_77_102_184,seq47,r_55_94_14,r_55_94_14,0.81,171,185,14,2
16,r_106_35_176,seq45,r_57_36_133,r_106_35_176,0.49,0,176,176,2
4,r_57_36_133,seq93,seq80,r_57_36_133,0.75,10,143,133,2
0,r_1_72_114,seq15,r_71_56_111,r_1_72_114,1.0,0,114,114,2
20,r_61_104_144,seq93,r_84_13_79,r_61_104_144,0.81,0,144,144,2
13,r_119_97_62,seq54,seq15,r_119_97_62,1.0,1,63,62,2
15,r_21_44_59,r_34_112_196,r_75_39_42,r_75_39_42,0.98,21,63,42,2
12,r_50_60_67,r_17_0_182,r_119_97_62,r_17_0_182,0.81,0,182,182,2
6,r_17_0_182,seq25,r_50_60_67,r_50_60_67,1.0,11,78,67,2
27,r_71_56_111,seq116,seq47,r_71_56_111,1.0,0,111,111,2
11,r_38_85_57,r_77_102_184,seq83,r_38_85_57,0.99,0,57,57,2
4,r_57_36_133,seq80,r_106_35_176,r_106_35_176,0.97,1,177,176,2
18,r_79_10_68,seq45,seq128,r_79_10_68,1.0,0,68,68,2
29,r_99_82_83,r_71_56_111,seq3,r_99_82_83,0.96,2,85,83,2
24,r_124_23_98,r_77_102_184,seq93,r_124_23_98,0.97,6,104,98,2
6,r_17_0_182,r_50_60_67,seq2,r_17_0_182,0.72,0,182,182,2
26,r_14_16_39,seq4,r_1_72_114,r_14_16_39,0.99,0,39,39,2
17,r_108_24_134,seq88,seq129,r_108_24_134,0.67,0,134,134,2
9,r_103_121_15,r_17_0_182,seq113,r_103_121_15,0.99,0,15,15,2
1,r_69_32_140,seq80,seq101,r_69_32_140,0.79,1,141,140,2
26,r_14_16_39,r_1_72_114,r_119_97_62,r_14_16_39,0.79,62,101,39,2
22,r_84_13_79,r_106_35_176,seq7,r_84_13_79,0.91,0,79,79,2
28,r_27_8_164,seq86,seq4,r_27_8_164,0.56,9,173,164,2
52,seq47,r_77_102_184,r_91_31_7,r_91_31_7,0.97,6,13,7,2
89,seq113,seq92,r_103_121_15,r_103_121_15,1.0,29,44,15,2
7,r_20_6_122,r_69_32_140,seq88,r_20_6_122,0.95,1,123,122,2
12,r_50_60_67,seq129,r_17_0_182,r_50_60_67,1.0,0,67,67,2
51,seq43,seq53,r_41_98_181,r_41_98_181,0.81,3,184,181,3
14,r_56_32_153,seq19,seq23,r_56_32_153,0.76,0,153,153,3
8,r_51_104_100,seq58,seq52,r_51_104_100,1.0,0,100,100,3
54,seq52,seq54,r_51_104_100,r_51_104_100,1.0,25,125,100,3
59,seq58,r_24_29_150,seq46,r_24_29_150,1.0,0,150,150,3
5,r_80_96_174,seq54,r_39_74_16,r_39_74_16,0.86,6,22,16,3
1,r_116_71_141,r_56_32_153,r_0_40_106,r_56_32_153,1.0,-10,143,153,3
42,seq15,r_41_98_181,r_75_78_176,r_75_78_176,0.89,5,181,176,3
19,r_90_6_131,r_24_29_150,r_122_44_113,r_90_6_131,0.8,5,136,131,3
26,r_42_36_187,r_38_22_92,r_112_49_196,r_38_22_92,1.0,-39,53,92,3
67,seq73,seq58,r_38_22_92,r_38_22_92,1.0,9,101,92,3
18,r_13_84_33,r_129_31_172,seq68,r_13_84_33,1.0,0,33,33,3
10,r_24_29_150,seq58,seq1,r_24_29_150,0.78,0,150,150,3
23,r_35_20_127,seq59,r_129_31_172,r_129_31_172,0.99,4,176,172,3
4,r_121_63_73,seq1,seq86,r_121_63_73,1.0,0,73,73,3
0,r_87_101_183,seq16,r_38_22_92,r_38_22_92,1.0,92,184,92,3
13,r_27_21_147,seq125,seq9,r_27_21_147,0.7,0,147,147,3
98,seq125,r_27_21_147,seq16,r_27_21_147,1.0,0,147,147,3
15,r_122_44_113,seq57,seq55,r_122_44_113,0.91,0,113,113,3
57,seq55,seq58,r_122_44_113,r_122_44_113,0.9,12,125,113,3
6,r_62_60_102,r_128_64_168,seq57,r_62_60_102,0.96,0,102,102,3
27,r_38_22_92,r_42_36_187,seq58,r_38_22_92,0.99,0,92,92,3
29,r_30_45_123,r_41_98_181,seq37,r_30_45_123,0.8,0,123,123,3
24,r_75_78_176,seq117,seq15,r_75_78_176,0.57,0,176,176,3
3,r_124_118_29,r_87_101_183,seq23,r_124_118_29,0.97,0,29,29,3
11,r_39_74_16,r_0_40_106,r_80_96_174,r_39_74_16,0.95,0,16,16,3
50,seq37,seq120,r_30_45_123,r_30_45_123,0.84,9,132,123,3
75,seq86,seq54,r_121_63_73,r_121_63_73,1.0,35,108,73,3
17,r_108_95_135,seq68,seq33,r_108_95_135,0.93,0,135,135,3
9,r_0_40_106,seq58,seq57,r_0_40_106,0.95,2,108,106,3
26,r_42_36_187,r_112_49_196,r_128_64_168,r_42_36_187,0.63,0,187,187,3
22,r_25_28_182,r_112_49_196,seq4,r_112_49_196,0.52,-14,182,196,3
28,r_127_47_62,seq8,seq72,r_127_47_62,0.79,0,62,62,3
23,r_35_20_127,r_87_101_183,seq59,r_35_20_127,1.0,0,127,127,3
12,r_129_31_172,seq93,r_35_20_127,r_35_20_127,0.8,47,174,127,3
93,seq116,seq21,r_102_62_82,r_102_62_82,1.0,10,92,82,4
92,seq115,r_129_88_129,seq30,r_129_88_129,1.0,0,129,129,4
8,r_85_99_57,r_87_72_197,seq13,r_85_99_57,0.4,44,101,57,4
53,seq40,seq89,r_106_55_134,r_106_55_134,1.0,31,165,134,4
1,r_2_110_61,r_71_97_137,seq54,r_2_110_61,0.88,0,61,61,4
97,seq124,r_123_107_75,seq44,r_123_107_75,0.98,4,79,75,4
5,r_94_38_153,r_92_36_2,seq12,r_94_38_153,0.97,0,153,153,4
46,seq25,r_104_100_173,r_94_38_153,r_94_38_153,0.81,20,173,153,4
19,r_129_88_129,seq115,seq50,r_129_88_129,0.98,0,129,129,4
41,seq18,r_106_55_134,seq128,r_106_55_134,1.0,2,136,134,4
6,r_126_5_21,seq50,seq48,r_126_5_21,0.59,-4,17,21,4
0,r_92_36_2,r_94_38_153,seq35,r_94_38_153,0.97,0,153,153,4
73,seq74,r_49_26_183,r_6_58_155,r_6_58_155,0.68,28,183,155,4
11,r_117_114_160,seq12,r_66_19_54,r_117_114_160,0.86,0,160,160,4
13,r_106_55_134,seq18,seq40,r_106_55_134,0.91,2,136,134,4
27,r_102_62_82,seq73,seq116,r_102_62_82,0.99,0,82,82,4
9,r_20_103_51,r_104_100_173,seq74,r_20_103_51,1.0,2,53,51,4
20,r_93_84_13,seq115,seq23,r_93_84_13,0.99,0,13,13,4
15,r_119_75_32,r_85_99_57,seq50,r_119_75_32,0.93,1,33,32,4
29,r_15_59_130,seq41,seq1,r_15_59_130,0.98,2,132,130,4
24,r_70_33_71,r_91_60_198,seq47,r_70_33_71,1.0,1,72,71,4
64,seq54,seq39,r_2_110_61,r_2_110_61,1.0,5,66,61,4
21,r_120_17_47,seq121,r_126_5_21,r_126_5_21,0.58,36,57,21,4
60,seq47,r_49_26_183,r_70_33_71,r_70_33_71,1.0,9,80,71,4
17,r_71_97_137,r_2_110_61,r_14_28_181,r_2_110_61,1.0,0,61,61,4
2,r_90_52_37,r_6_58_155,seq22,r_90_52_37,0.97,0,37,37,4
22,r_6_58_155,seq128,r_70_33_71,r_6_58_155,0.78,2,157,155,4
28,r_123_107_75,seq124,seq46,r_123_107_75,0.96,0,75,75,4
7,r_112_37_112,seq78,seq81,r_112_37_112,0.92,0,112,112,4
23,r_104_100_173,seq25,r_66_19_54,r_104_100_173,0.81,0,173,173,4
17,r_71_97_137,r_14_28_181,seq105,r_71_97_137,1.0,1,138,137,4
12,r_16_29_180,r_87_72_197,seq63,r_87_72_197,0.25,-17,180,197,4
28,r_20_12_41,seq29,seq77,r_20_12_41,0.85,2,43,41,5
8,r_60_14_64,seq90,seq1,r_60_14_64,0.99,1,65,64,5
4,r_59_92_151,r_30_115_94,seq55,r_59_92_151,0.68,0,151,151,5
16,r_41_74_77,seq17,seq26,r_41_74_77,0.98,12,89,77,5
1,r_102_9_82,seq129,seq43,r_102_9_82,0.99,2,84,82,5
19,r_30_115_94,seq35,seq118,r_30_115_94,0.69,24,118,94,5
78,seq90,seq78,r_22_2_147,r_22_2_147,1.0,3,150,147,5
3,r_76_10_123,seq53,seq58,r_76_10_123,1.0,0,123,123,5
26,r_81_57_114,seq79,seq126,r_81_57_114,0.43,2,116,114,5
11,r_98_21_69,r_30_115_94,r_25_49_31,r_98_21_69,0.96,2,71,69,5
20,r_111_68_125,r_71_94_166,seq46,r_111_68_125,0.91,3,128,125,5
13,r_110_120_106,seq93,seq53,r_110_120_106,0.99,0,106,106,5
18,r_119_36_35,seq46,seq85,r_119_36_35,0.85,1,36,35,5
4,r_59_92_151,r_25_49_31,r_30_115_94,r_25_49_31,0.5,94,125,31,5
57,seq53,seq42,r_110_120_106,r_110_120_106,1.0,10,116,106,5
6,r_24_44_169,r_64_47_135,seq85,r_64_47_135,1.0,-33,102,135,5
5,r_108_16_53,r_110_120_106,seq34,r_108_16_53,1.0,0,53,53,5
2,r_71_94_166,r_111_68_125,r_6_5_9,r_111_68_125,0.76,3,128,125,5
33,seq8,r_106_4_180,r_22_2_147,r_22_2_147,1.0,34,181,147,5
50,seq40,seq32,r_64_47_135,r_64_47_135,1.0,23,158,135,5
0,r_86_105_46,r_106_4_180,seq88,r_86_105_46,0.7,8,54,46,5
52,seq43,seq1,r_102_9_82,r_102_9_82,1.0,6,88,82,5
2,r_71_94_166,r_6_5_9,seq70,r_71_94_166,0.89,0,166,166,5
9,r_64_47_135,r_24_44_169,seq32,r_64_47_135,1.0,0,135,135,5
14,r_25_49_31,r_76_10_123,r_98_21_69,r_25_49_31,0.99,0,31,31,5
4,r_59_92_151,seq118,r_25_49_31,r_25_49_31,0.98,4,35,31,5
7,r_27_116_83,seq42,seq32,r_27_116_83,1.0,0,83,83,5
23,r_15_45_146,r_114_73_3,seq23,r_15_45_146,0.49,7,153,146,5
12,r_75_18_110,seq79,seq46,r_75_18_110,0.94,0,110,110,5
8,r_92_82_88,seq111,seq125,r_92_82_88,0.98,0,88,88,6
22,r_59_24_29,r_57_129_189,seq8,r_59_24_29,0.75,-3,26,29,6
10,r_118_51_26,r_6_78_81,seq48,r_118_51_26,1.0,0,26,26,6
16,r_123_54_55,seq70,seq84,r_123_54_55,1.0,3,58,55,6
1,r_105_31_96,seq87,r_101_76_76,r_101_76_76,1.0,33,109,76,6
6,r_16_85_9,r_116_12_40,r_97_126_22,r_16_85_9,0.87,1,10,9,6
26,r_65_64_113,seq18,seq86,r_65_64_113,0.97,0,113,113,6
0,r_101_76_76,seq25,seq45,r_101_76_76,1.0,1,77,76,6
63,seq56,r_57_129_189,r_79_15_72,r_79_15_72,0.95,70,142,72,6
20,r_58_75_156,seq71,r_99_32_6,r_58_75_156,0.72,0,156,156,6
13,r_55_13_131,seq120,seq86,r_55_13_131,0.91,0,131,131,6
98,seq125,seq117,r_92_82_88,r_92_82_88,1.0,4,92,88,6
48,seq30,r_122_81_195,r_94_103_44,r_94_103_44,1.0,141,185,44,6
27,r_33_80_140,r_57_129_189,r_26_109_123,r_33_80_140,0.85,1,141,140,6
22,r_59_24_29,seq8,r_116_12_40,r_116_12_40,0.88,21,61,40,6
2,r_95_107_181,seq86,r_112_67_180,r_95_107_181,0.43,0,181,181,6
24,r_79_15_72,seq86,seq56,r_79_15_72,0.81,0,72,72,6
28,r_94_103_44,seq8,seq30,r_94_103_44,1.0,1,45,44,6
75,seq83,r_68_108_108,r_57_129_189,r_68_108_108,0.56,5,113,108,6
17,r_7_1_130,seq117,r_116_12_40,r_7_1_130,0.96,1,131,130,6
9,r_38_17_64,seq73,seq98,r_38_17_64,0.77,3,67,64,6
23,r_21_47_49,r_26_109_123,seq69,r_21_47_49,0.75,7,56,49,6
56,seq42,r_112_67_180,seq50,r_112_67_180,0.95,-3,177,180,6
7,r_68_108_108,seq83,seq114,r_68_108_108,0.94,-1,107,108,6
18,r_116_12_40,r_57_129_189,r_59_24_29,r_116_12_40,0.67,0,40,40,6
12,r_26_109_123,seq48,seq2,r_26_109_123,0.93,1,124,123,6
14,r_58_83_167,seq41,seq36,r_58_83_167,0.82,0,167,167,7
13,r_26_27_43,r_58_83_167,r_40_59_7,r_26_27_43,0.92,0,43,43,7
24,r_60_39_194,r_115_120_49,r_31_20_38,r_60_39_194,1.0,-145,49,194,7
16,r_99_86_58,r_89_10_147,r_3_49_184,r_99_86_58,1.0,0,58,58,7
1,r_13_21_34,seq73,seq2,r_13_21_34,1.0,2,36,34,7
2,r_115_120_49,r_60_39_194,seq41,r_115_120_49,1.0,0,49,49,7
3,r_125_95_168,seq61,seq126,r_125_95_168,0.44,12,180,168,7
10,r_3_49_184,seq12,r_99_86_58,r_99_86_58,1.0,25,83,58,7
72,seq76,seq127,r_121_18_55,r_121_18_55,1.0,49,104,55,7
78,seq85,r_43_33_108,seq1,r_43_33_108,1.0,0,108,108,7
11,r_116_22_81,r_124_37_101,r_121_18_55,r_116_22_81,1.0,1,82,81,7
20,r_66_48_152,seq41,seq93,r_66_48_152,0.84,1,153,152,7
98,seq126,r_29_112_146,r_125_95_168,r_125_95_168,0.5,1,169,168,7
79,seq87,seq11,r_43_33_108,r_43_33_108,1.0,13,121,108,7
6,r_43_33_108,seq85,seq87,r_43_33_108,1.0,0,108,108,7
70,seq73,r_13_21_34,seq45,r_13_21_34,1.0,0,34,34,7
85,seq98,seq47,r_105_9_75,r_105_9_75,0.86,15,90,75,7
99,seq127,seq15,r_116_22_81,r_116_22_81,1.0,9,90,81,7
27,r_8_101_69,r_29_112_146,r_115_120_49,r_29_112_146,0.74,-76,70,146,7
4,r_78_6_20,r_55_117_187,seq93,r_78_6_20,0.74,4,24,20,7
18,r_121_18_55,seq67,seq76,r_121_18_55,0.84,10,65,55,7
17,r_105_9_75,seq87,seq98,r_105_9_75,0.92,0,75,75,7
9,r_79_74_80,seq50,r_3_49_184,r_79_74_80,1.0,0,80,80,7
29,r_32_65_18,seq80,seq123,r_32_65_18,0.99,2,20,18,7
22,r_55_117_187,seq128,r_116_22_81,r_116_22_81,0.72,106,187,81,7
7,r_89_10_147,seq123,r_43_33_108,r_89_10_147,0.8,6,153,147,7
44,seq25,r_103_24_174,seq128,r_103_24_174,0.74,0,174,174,7
23,r_40_59_7,seq54,r_26_27_43,r_26_27_43,1.0,34,77,43,7
82,seq93,seq104,r_78_6_20,r_78_6_20,0.82,57,77,20,7
79,seq87,r_105_9_75,seq11,r_105_9_75,0.77,3,78,75,7
35,seq128,r_55_117_187,r_32_65_18,r_32_65_18,0.98,169,187,18,7
12,r_111_44_135,seq19,seq67,r_111_44_135,0.44,14,149,135,7
28,r_12_79_17,r_47_14_126,seq64,r_12_79_17,0.98,-1,16,17,8
8,r_95_76_130,r_38_32_180,seq22,r_95_76_130,0.58,8,138,130,8
43,seq30,r_83_49_174,r_0_70_132,r_0_70_132,0.87,42,174,132,8
16,r_37_33_138,seq28,seq22,r_37_33_138,0.78,0,138,138,8
21,r_31_55_86,r_126_94_113,seq28,r_31_55_86,0.98,-1,85,86,8
19,r_15_105_60,seq121,seq50,r_15_105_60,1.0,0,60,60,8
26,r_42_109_72,seq51,seq10,r_42_109_72,0.95,-1,71,72,8
4,r_0_70_132,seq129,seq30,r_0_70_132,0.99,0,132,132,8
29,r_13_82_57,r_11_116_90,r_37_33_138,r_13_82_57,0.99,0,57,57,8
20,r_53_8_52,seq89,seq129,r_53_8_52,1.0,0,52,52,8
6,r_38_32_180,r_95_76_130,r_16_29_78,r_16_29_78,0.99,104,182,78,8
0,r_47_14_126,r_42_109_72,r_53_8_52,r_47_14_126,0.47,6,132,126,8
27,r_87_57_80,seq23,r_46_3_87,r_46_3_87,1.0,1,88,87,8
51,seq50,seq107,r_15_105_60,r_15_105_60,1.0,43,103,60,8
51,seq50,r_18_67_38,seq107,r_18_67_38,0.98,-10,28,38,8
2,r_126_94_113,seq10,seq51,r_126_94_113,0.71,4,117,113,8
10,r_41_122_41,seq85,seq5,r_41_122_41,1.0,0,41,41,8
18,r_19_98_140,seq27,seq48,r_19_98_140,0.49,-76,64,140,8
24,r_26_25_122,r_37_33_138,seq21,r_26_25_122,1.0,0,122,122,8
98,seq124,r_113_9_196,r_52_17_11,r_52_17_11,0.99,1,12,11,8
29,r_13_82_57,r_37_33_138,r_46_3_87,r_13_82_57,0.94,46,103,57,8
25,r_52_17_11,r_46_3_87,seq124,r_52_17_11,0.97,0,11,11,8
11,r_18_67_38,seq50,seq100,r_18_67_38,1.0,0,38,38,8
60,seq64,r_74_73_135,r_12_79_17,r_74_73_135,0.49,-55,80,135,8
17,r_74_73_135,seq88,r_37_33_138,r_74_73_135,0.87,2,137,135,8
9,r_83_49_174,seq30,r_42_109_72,r_83_49_174,0.55,0,174,174,8
22,r_46_3_87,seq24,r_13_82_57,r_46_3_87,1.0,1,88,87,8
14,r_127_106_53,r_16_29_78,r_53_8_52,r_127_106_53,1.0,0,53,53,8
7,r_11_116_90,r_92_36_4,seq27,r_11_116_90,0.84,-9,81,90,8
18,r_19_98_140,seq48,seq5,r_19_98_140,0.82,-5,135,140,8
0,r_47_14_126,r_12_79_17,r_42_109_72,r_12_79_17,0.72,-1,16,17,8
82,seq100,r_37_33_138,r_53_8_52,r_53_8_52,0.74,28,80,52,8
12,r_16_29_78,seq21,seq91,r_16_29_78,1.0,0,78,78,8
18,r_44_17_15,r_127_78_12,seq23,r_44_17_15,0.7,0,15,15,9
36,seq9,seq10,r_62_86_84,r_62_86_84,1.0,4,88,84,9
16,r_97_68_196,seq39,r_120_116_24,r_120_116_24,1.0,3,27,24,9
54,seq32,r_49_118_172,r_47_65_2,r_49_118_172,0.66,0,172,172,9
21,r_50_98_65,seq95,seq21,r_50_98_65,1.0,0,65,65,9
1,r_54_100_77,r_47_65_2,seq42,r_54_100_77,1.0,0,77,77,9
97,seq122,r_126_110_171,r_47_65_2,r_126_110_171,0.56,0,171,171,9
5,r_82_72_190,seq21,r_117_106_118,r_117_106_118,0.78,72,190,118,9
22,r_121_59_76,r_54_100_77,r_37_71_36,r_121_59_76,0.53,51,127,76,9
3,r_5_35_61,seq24,seq99,r_5_35_61,1.0,0,61,61,9
10,r_45_124_159,seq129,seq56,r_45_124_159,0.68,1,160,159,9
26,r_126_110_171,seq122,r_92_89_29,r_126_110_171,0.54,0,171,171,9
6,r_90_80_58,r_12_63_166,seq29,r_90_80_58,1.0,0,58,58,9
14,r_120_116_24,seq4,seq19,r_120_116_24,1.0,0,24,24,9
11,r_34_11_121,r_82_72_190,r_37_71_36,r_34_11_121,0.98,2,123,121,9
20,r_62_86_84,seq93,seq9,r_62_86_84,1.0,1,85,84,9
13,r_13_25_152,seq22,seq29,r_13_25_152,0.65,0,152,152,9
64,seq48,seq93,r_51_52_156,r_51_52_156,0.94,4,160,156,9
19,r_127_78_12,seq79,seq28,r_127_78_12,0.87,6,18,12,9
28,r_81_119_40,seq93,seq20,r_81_119_40,1.0,0,40,40,9
29,r_87_88_88,seq8,seq55,r_87_88_88,0.94,0,88,88,9
27,r_67_73_31,r_54_100_77,seq125,r_67_73_31,0.99,1,32,31,9
24,r_117_106_118,seq23,seq33,r_117_106_118,0.98,1,119,118,9
34,seq129,r_45_124_159,seq26,r_45_124_159,1.0,1,160,159,9
15,r_92_89_29,seq20,seq27,r_92_89_29,0.91,-1,28,29,9
17,r_96_111_111,seq19,r_44_17_15,r_96_111_111,0.94,0,111,111,9
22,r_121_59_76,r_82_72_190,r_54_100_77,r_54_100_77,0.8,0,77,77,9
49,seq27,r_0_6_138,r_92_89_29,r_92_89_29,0.98,44,73,29,9
7,r_85_7_79,seq114,seq22,r_85_7_79,0.75,0,79,79,9
44,seq21,r_82_72_190,r_12_63_166,r_12_63_166,0.66,24,190,166,9
23,r_3_77_13,seq42,r_37_71_36,r_37_71_36,0.98,25,61,36,9
82,seq93,r_62_86_84,seq60,r_62_86_84,1.0,1,85,84,9
12,r_12_63_166,seq56,r_50_98_65,r_12_63_166,0.66,1,167,166,9
2,r_37_71_36,seq33,r_3_77_13,r_37_71_36,1.0,0,36,36,9
36,seq12,r_47_100_96,seq53,r_47_100_96,1.0,1,97,96,10
14,r_110_67_60,r_19_122_199,seq64,r_110_67_60,1.0,2,62,60,10
83,seq89,r_59_99_117,seq79,r_59_99_117,1.0,0,117,117,10
97,seq120,r_13_112_167,r_47_100_96,r_47_100_96,1.0,71,167,96,10
5,r_125_107_71,seq1,seq94,r_125_107_71,1.0,0,71,71,10
42,seq23,seq36,r_70_27_83,r_70_27_83,1.0,-3,80,83,10
26,r_68_96_47,seq21,seq72,r_68_96_47,0.98,1,48,47,10
17,r_60_86_20,r_92_84_35,seq25,r_60_86_20,1.0,0,20,20,10
10,r_33_61_180,seq52,r_48_11_135,r_48_11_135,0.87,45,180,135,10
15,r_88_116_30,r_111_7_190,seq52,r_88_116_30,0.89,6,36,30,10
4,r_129_93_61,seq1,seq128,r_129_93_61,1.0,1,62,61,10
11,r_74_91_114,seq66,seq113,r_74_91_114,0.99,0,114,114,10
20,r_70_27_83,r_19_122_199,seq36,r_70_27_83,1.0,0,83,83,10
13,r_47_100_96,seq12,seq120,r_47_100_96,0.84,1,97,96,10
18,r_57_30_69,seq9,seq39,r_57_30_69,0.75,0,69,69,10
24,r_28_81_111,r_101_22_186,seq39,r_28_81_111,0.98,1,112,111,10
25,r_59_99_117,seq89,seq26,r_59_99_117,0.99,0,117,117,10
70,seq69,seq29,r_125_107_71,r_125_107_71,1.0,73,144,71,10
32,seq5,seq117,r_57_30_69,r_57_30_69,0.71,30,99,69,10
2,r_78_90_25,r_127_6_115,seq119,r_78_90_25,0.83,0,25,25,10
9,r_124_2_160,seq66,seq12,r_124_2_160,0.67,0,160,160,10
56,seq43,r_57_30_69,r_92_84_35,r_92_84_35,0.52,28,63,35,10
7,r_105_0_67,seq64,seq10,r_105_0_67,0.9,0,67,67,10
44,seq25,r_127_6_115,r_60_86_20,r_60_86_20,0.99,139,159,20,10
0,r_92_84_35,r_110_67_60,seq43,r_92_84_35,1.0,1,36,35,10
84,seq94,seq34,r_125_107_71,r_125_107_71,1.0,38,109,71,10
28,r_2_126_42,r_12_73_150,r_47_112_112,r_2_126_42,1.0,1,43,42,11
36,seq9,r_96_27_194,r_43_115_104,r_43_115_104,0.66,27,131,104,11
14,r_118_41_89,seq52,r_123_53_84,r_118_41_89,0.96,3,92,89,11
55,seq44,seq3,r_76_95_29,r_76_95_29,0.94,102,131,29,11
86,seq104,r_21_32_80,seq45,r_21_32_80,0.45,1,81,80,11
21,r_56_31_113,r_26_57_168,r_98_64_103,r_56_31_113,0.64,0,113,113,11
39,seq15,seq34,r_8_33_85,r_8_33_85,0.99,53,138,85,11
27,r_12_73_150,r_82_92_182,r_26_57_168,r_12_73_150,0.63,32,182,150,11
61,seq54,seq24,r_86_113_83,r_86_113_83,1.0,13,96,83,11
26,r_98_64_103,seq36,r_56_31_113,r_98_64_103,0.84,13,116,103,11
4,r_43_115_104,r_35_66_100,seq9,r_43_115_104,0.61,-11,93,104,11
49,seq36,seq71,r_16_81_148,r_16_81_148,0.88,13,161,148,11
29,r_17_85_34,r_47_112_112,seq40,r_17_85_34,0.96,0,34,34,11
20,r_100_74_153,seq52,r_123_53_84,r_100_74_153,0.54,-8,145,153,11
13,r_21_32_80,seq104,seq3,r_21_32_80,0.65,-5,75,80,11
48,seq34,r_56_31_113,r_59_10_79,r_59_10_79,0.79,30,109,79,11
6,r_72_102_110,seq6,r_47_112_112,r_72_102_110,0.99,0,110,110,11
19,r_4_58_141,r_43_115_104,seq94,r_4_58_141,0.58,-119,22,141,11
2,r_93_109_163,seq37,seq54,r_93_109_163,0.51,0,163,163,11
24,r_128_22_69,seq36,seq5,r_128_22_69,0.98,4,73,69,11
64,seq62,r_120_129_137,r_119_107_165,r_120_129_137,0.89,1,138,137,11
61,seq54,r_55_46_56,seq24,r_55_46_56,1.0,0,56,56,11
19,r_4_58_141,seq94,r_43_115_104,r_4_58_141,0.5,-69,72,141,11
32,seq3,seq44,r_21_32_80,r_21_32_80,0.86,1,81,80,11
11,r_76_95_29,r_2_126_42,seq117,r_76_95_29,0.85,1,30,29,11
60,seq52,r_100_74_153,r_119_107_165,r_100_74_153,0.54,2,155,153,11
17,r_50_14_75,seq3,seq127,r_50_14_75,0.52,6,81,75,11
22,r_120_129_137,seq62,seq28,r_120_129_137,0.76,1,138,137,11
49,seq36,r_98_64_103,seq71,r_98_64_103,0.91,0,103,103,11
3,r_55_46_56,seq54,r_99_25_4,r_55_46_56,1.0,0,56,56,11
7,r_86_113_83,r_56_31_113,seq54,r_86_113_83,0.98,0,83,83,11
23,r_8_33_85,seq104,seq15,r_8_33_85,0.9,2,87,85,11
79,seq88,seq13,r_119_107_165,r_119_107_165,0.64,3,168,165,11
12,r_35_66_100,r_43_115_104,r_21_32_80,r_35_66_100,0.71,-2,98,100,11
94,seq117,r_50_14_75,r_76_95_29,r_76_95_29,0.51,1,30,29,11
14,r_17_86_136,seq63,seq29,r_17_86_136,0.39,-63,73,136,12
83,seq105,seq22,r_19_52_60,r_19_52_60,1.0,10,70,60,12
86,seq108,r_7_112_153,r_75_28_45,r_75_28_45,0.99,113,158,45,12
16,r_20_103_183,r_17_86_136,seq63,r_17_86_136,0.99,0,136,136,12
21,r_44_66_107,seq61,seq96,r_44_66_107,0.6,0,107,107,12
5,r_100_104_69,r_72_47_118,r_40_23_23,r_100_104_69,1.0,0,69,69,12
16,r_20_103_183,seq63,r_72_47_118,r_20_103_183,0.99,0,183,183,12
19,r_27_115_31,seq109,seq107,r_27_115_31,0.99,0,31,31,12
26,r_127_50_48,r_41_10_65,r_64_67_36,r_127_50_48,1.0,0,48,48,12
35,seq5,seq98,r_116_113_46,r_116_113_46,1.0,6,52,46,12
3,r_72_47_118,seq56,r_87_6_195,r_72_47_118,1.0,0,118,118,12
90,seq117,r_7_112_153,seq76,r_7_112_153,0.95,1,154,153,12
14,r_17_86_136,seq29,seq0,r_17_86_136,1.0,0,136,136,12
11,r_8_114_127,seq123,r_19_52_60,r_8_114_127,1.0,0,127,127,12
15,r_19_52_60,seq35,seq105,r_19_52_60,1.0,0,60,60,12
12,r_75_28_45,r_21_39_119,seq123,r_21_39_119,1.0,1,120,119,12
0,r_49_24_20,r_42_60_82,seq62,r_49_24_20,0.99,0,20,20,12
6,r_90_89_91,seq63,r_71_45_7,r_90_89_91,0.99,0,91,91,12
18,r_40_23_23,seq82,seq38,r_40_23_23,1.0,0,23,23,12
10,r_21_39_119,r_75_28_45,r_64_67_36,r_21_39_119,1.0,1,120,119,12
27,r_30_129_174,seq74,r_7_112_153,r_30_129_174,0.74,0,174,174,12
10,r_21_39_119,r_7_112_153,r_75_28_45,r_75_28_45,1.0,9,54,45,12
58,seq62,seq13,r_49_24_20,r_49_24_20,1.0,1,21,20,12
25,r_87_6_195,seq98,r_72_47_118,r_72_47_118,1.0,11,129,118,12
70,seq82,seq37,r_88_14_143,r_88_14_143,0.94,3,146,143,12
20,r_43_11_38,seq125,seq5,r_43_11_38,0.81,0,38,38,12
52,seq54,seq74,r_44_66_107,r_44_66_107,0.88,36,143,107,12
8,r_64_67_36,seq102,seq4,r_64_67_36,1.0,1,37,36,12
47,seq38,seq62,r_40_23_23,r_40_23_23,0.91,2,25,23,12
17,r_42_60_82,seq121,seq3,r_42_60_82,1.0,0,82,82,12
13,r_116_113_46,r_44_66_107,r_43_11_38,r_116_113_46,0.98,0,46,46,12
94,seq121,r_42_60_82,seq48,r_42_60_82,0.84,0,82,82,12
9,r_15_128_150,seq35,seq68,r_15_128_150,0.63,2,152,150,12
12,r_75_28_45,seq107,r_21_39_119,r_75_28_45,1.0,0,45,45,12
22,r_36_83_167,seq91,seq57,r_36_83_167,0.47,0,167,167,12
2,r_31_18_34,r_127_50_48,seq96,r_31_18_34,1.0,0,34,34,12
28,r_41_10_65,seq26,seq99,r_41_10_65,1.0,0,65,65,12
23,r_88_14_143,seq80,seq82,r_88_14_143,0.96,0,143,143,12
93,seq117,r_20_33_92,seq124,r_20_33_92,0.92,1,93,92,13
92,seq111,r_12_9_164,r_1_46_27,r_12_9_164,0.47,1,165,164,13
14,r_66_38_189,seq27,seq104,r_66_38_189,0.27,0,189,189,13
37,seq14,r_69_116_101,r_85_82_13,r_69_116_101,0.64,-29,72,101,13
16,r_44_45_153,seq39,seq70,r_44_45_153,0.94,0,153,153,13
5,r_53_123_166,seq98,seq110,r_53_123_166,0.73,0,166,166,13
18,r_1_46_27,seq29,seq105,r_1_46_27,0.87,-1,26,27,13
24,r_83_5_18,r_107_115_148,seq96,r_83_5_18,0.81,0,18,18,13
15,r_114_128_40,r_20_33_92,seq39,r_114_128_40,1.0,1,41,40,13
76,seq87,r_68_100_64,seq104,r_68_100_64,1.0,2,66,64,13
26,r_15_13_95,r_4_32_98,seq42,r_15_13_95,1.0,0,95,95,13
4,r_86_0_162,r_75_55_119,r_1_46_27,r_86_0_162,0.69,-42,120,162,13
21,r_85_82_13,seq18,seq14,r_85_82_13,1.0,0,13,13,13
0,r_4_32_98,seq35,seq65,r_4_32_98,0.97,0,98,98,13
20,r_12_9_164,seq111,seq127,r_12_9_164,0.47,0,164,164,13
6,r_75_55_119,r_86_0_162,seq54,r_75_55_119,0.96,1,120,119,13
90,seq109,seq16,r_121_71_29,r_121_71_29,1.0,19,48,29,13
27,r_121_71_29,r_12_9_164,seq109,r_121_71_29,0.99,0,29,29,13
2,r_21_113_73,seq42,seq65,r_21_113_73,1.0,5,78,73,13
29,r_20_33_92,seq117,seq48,r_20_33_92,0.98,1,93,92,13
25,r_47_94_68,seq102,seq92,r_47_94_68,1.0,1,69,68,13
57,seq56,seq92,r_99_49_43,r_99_49_43,1.0,7,50,43,13
58,seq57,seq111,r_112_30_96,r_112_30_96,0.54,48,144,96,13
4,r_86_0_162,r_1_46_27,seq8,r_86_0_162,0.98,0,162,162,13
65,seq65,seq93,r_21_113_73,r_21_113_73,1.0,16,89,73,13
83,seq97,r_4_32_98,seq26,r_4_32_98,0.98,-44,54,98,13
47,seq29,r_1_46_27,seq111,r_1_46_27,0.69,0,27,27,13
23,r_41_77_55,seq93,r_53_123_166,r_41_77_55,0.94,3,58,55,13
60,seq59,seq109,r_68_100_64,r_68_100_64,1.0,38,102,64,13
17,r_68_100_64,seq87,seq59,r_68_100_64,1.0,2,66,64,13
9,r_69_116_101,seq14,seq35,r_69_116_101,1.0,0,101,101,13
23,r_41_77_55,r_53_123_166,r_79_90_100,r_41_77_55,0.73,55,110,55,13
22,r_79_90_100,seq25,r_41_77_55,r_79_90_100,1.0,0,100,100,13
28,r_112_30_96,r_86_0_162,seq124,r_112_30_96,1.0,0,96,96,13
49,seq35,r_36_37_152,r_69_116_101,r_69_116_101,0.91,33,134,101,13
82,seq96,seq92,r_83_5_18,r_83_5_18,0.96,22,40,18,13
79,seq92,seq7,r_47_94_68,r_47_94_68,1.0,29,97,68,13
35,seq8,seq65,r_61_101_83,r_61_101_83,1.0,19,102,83,13
12,r_36_37_152,seq35,seq58,r_36_37_152,0.95,1,153,152,13
92,seq114,r_117_102_174,r_54_26_30,r_54_26_30,0.95,122,152,30,14
14,r_16_75_182,seq34,r_119_46_102,r_119_46_102,1.0,81,183,102,14
86,seq106,r_101_64_160,r_25_5_151,r_25_5_151,0.76,9,160,151,14
16,r_127_78_142,seq67,seq77,r_127_78_142,0.56,0,142,142,14
2,r_45_51_46,seq12,r_15_10_98,r_45_51_46,0.74,5,51,46,14
10,r_86_43_13,r_98_113_116,seq42,r_86_43_13,0.88,0,13,13,14
90,seq111,seq60,r_124_74_122,r_124_74_122,0.99,3,125,122,14
26,r_49_70_149,r_92_96_190,r_69_79_31,r_49_70_149,0.92,0,149,149,14
20,r_98_113_116,r_91_118_155,seq4,r_98_113_116,0.98,0,116,116,14
13,r_59_93_130,seq90,seq33,r_59_93_130,0.47,30,160,130,14
57,seq42,seq122,r_86_43_13,r_86_43_13,0.86,35,48,13,14
6,r_119_46_102,seq39,r_86_43_13,r_119_46_102,1.0,0,102,102,14
12,r_61_110_18,seq42,r_91_118_155,r_61_110_18,0.86,0,18,18,14
10,r_86_43_13,seq42,r_119_46_102,r_119_46_102,1.0,1,103,102,14
27,r_21_107_74,seq71,seq4,r_21_107_74,1.0,0,74,74,14
19,r_69_79_31,r_119_46_102,seq123,r_69_79_31,0.62,3,34,31,14
18,r_101_64_160,seq106,r_22_3_2,r_22_3_2,0.51,158,160,2,14
29,r_28_55_84,seq34,seq90,r_28_55_84,0.99,0,84,84,14
50,seq34,r_28_55_84,r_16_75_182,r_28_55_84,1.0,0,84,84,14
17,r_100_82_126,r_91_118_155,seq4,r_100_82_126,0.98,1,127,126,14
9,r_124_74_122,seq4,seq111,r_124_74_122,1.0,0,122,122,14
50,seq34,r_16_75_182,r_50_83_180,r_16_75_182,0.5,4,186,182,14
96,seq122,seq42,r_86_43_13,r_86_43_13,0.79,90,103,13,14
23,r_54_26_30,seq42,seq114,r_54_26_30,1.0,0,30,30,14
28,r_97_116_86,seq17,seq30,r_97_116_86,1.0,4,90,86,14
7,r_117_102_174,seq114,r_100_82_126,r_117_102_174,0.46,1,175,174,14
93,seq116,r_54_69_86,r_38_34_80,r_54_69_86,1.0,-3,83,86,15
51,seq29,seq51,r_99_82_150,r_99_82_150,1.0,4,154,150,15
14,r_52_85_130,seq5,r_70_107_97,r_52_85_130,0.83,0,130,130,15
3,r_106_127_161,r_104_24_60,seq19,r_106_127_161,1.0,2,163,161,15
16,r_44_6_83,seq30,seq27,r_44_6_83,1.0,0,83,83,15
1,r_94_108_63,r_50_62_140,seq23,r_94_108_63,1.0,-1,62,63,15
21,r_77_25_31,r_106_127_161,seq49,r_77_25_31,1.0,0,31,31,15
19,r_38_34_80,seq68,seq116,r_38_34_80,0.48,3,83,80,15
27,r_20_56_43,seq48,seq30,r_20_56_43,0.47,131,174,43,15
27,r_20_56_43,r_110_31_175,seq48,r_20_56_43,0.95,0,43,43,15
3,r_106_127_161,seq80,r_104_24_60,r_104_24_60,1.0,5,65,60,15
0,r_117_35_160,seq98,r_104_24_60,r_104_24_60,0.63,104,164,60,15
63,seq53,seq98,r_81_105_101,r_81_105_101,1.0,17,118,101,15
11,r_54_69_86,seq27,seq49,r_54_69_86,0.92,0,86,86,15
20,r_112_15_164,r_93_45_194,seq13,r_112_15_164,0.82,0,164,164,15
13,r_26_72_94,seq12,seq8,r_26_72_94,0.41,0,94,94,15
46,seq19,seq13,r_106_127_161,r_106_127_161,1.0,3,164,161,15
15,r_99_82_150,r_2_123_166,seq29,r_99_82_150,0.81,2,152,150,15
6,r_50_62_140,seq122,seq13,r_50_62_140,0.98,1,141,140,15
29,r_114_87_183,seq65,r_112_15_164,r_112_15_164,0.92,21,185,164,15
24,r_2_123_166,r_39_129_79,r_94_108_63,r_2_123_166,0.85,0,166,166,15
70,seq64,seq98,r_96_101_68,r_96_101_68,1.0,24,92,68,15
61,seq49,r_110_31_175,seq90,r_110_31_175,0.9,0,175,175,15
28,r_37_124_35,seq76,seq126,r_37_124_35,1.0,-1,34,35,15
4,r_125_100_41,seq0,seq57,r_125_100_41,0.61,-5,36,41,15
17,r_70_107_97,seq28,seq17,r_70_107_97,1.0,0,97,97,15
9,r_96_101_68,seq116,seq64,r_96_101_68,0.83,0,68,68,15
22,r_66_22_118,seq67,seq16,r_66_22_118,1.0,0,118,118,15
7,r_81_105_101,seq18,seq53,r_81_105_101,1.0,0,101,101,15
23,r_104_24_60,seq10,r_106_127_161,r_104_24_60,1.0,0,60,60,15
65,seq57,seq48,r_125_100_41,r_125_100_41,0.59,-5,36,41,15
23,r_104_24_60,r_106_127_161,r_117_35_160,r_104_24_60,0.9,103,163,60,15
93,seq119,seq68,r_88_76_80,r_88_76_80,1.0,5,85,80,16
17,r_102_5_57,seq94,r_85_37_106,r_102_5_57,0.99,0,57,57,16
43,seq27,seq46,r_42_41_78,r_42_41_78,1.0,37,115,78,16
2,r_36_33_59,seq120,seq68,r_36_33_59,1.0,0,59,59,16
19,r_113_8_30,seq71,r_0_89_81,r_0_89_81,1.0,14,95,81,16
71,seq77,seq80,r_55_35_113,r_55_35_113,1.0,11,124,113,16
21,r_20_2_92,seq7,seq125,r_20_2_92,0.9,1,93,92,16
1,r_103_56_118,seq10,seq40,r_103_56_118,1.0,0,118,118,16
5,r_55_35_113,seq78,seq77,r_55_35_113,0.98,1,114,113,16
66,seq69,r_28_83_148,r_0_89_81,r_0_89_81,0.95,2,83,81,16
6,r_14_91_21,r_55_35_113,seq32,r_14_91_21,0.76,0,21,21,16
67,seq71,seq69,r_0_89_81,r_0_89_81,1.0,13,94,81,16
3,r_31_25_74,seq74,seq109,r_31_25_74,1.0,0,74,74,16
27,r_70_3_107,seq40,r_45_49_94,r_70_3_107,0.91,1,108,107,16
14,r_123_16_16,r_98_60_119,seq80,r_123_16_16,1.0,0,16,16,16
26,r_51_95_67,r_24_4_195,seq38,r_51_95_67,1.0,0,67,67,16
72,seq78,r_55_35_113,seq6,r_55_35_113,1.0,3,116,113,16
4,r_85_37_106,seq115,seq38,r_85_37_106,0.83,-3,103,106,16
11,r_0_89_81,seq50,seq69,r_0_89_81,0.99,1,82,81,16
20,r_42_41_78,r_70_3_107,seq27,r_42_41_78,1.0,0,78,78,16
9,r_28_83_148,r_0_89_81,seq62,r_28_83_148,0.94,1,149,148,16
19,r_113_8_30,r_117_65_164,seq71,r_113_8_30,0.92,-3,27,30,16
13,r_45_49_94,seq62,r_0_89_81,r_45_49_94,0.83,5,99,94,16
15,r_23_90_151,r_84_57_13,seq82,r_23_90_151,0.73,0,151,151,16
27,r_70_3_107,r_42_41_78,seq40,r_42_41_78,0.98,-1,77,78,16
18,r_99_17_112,seq50,r_102_5_57,r_99_17_112,0.99,2,114,112,16
29,r_24_4_195,seq66,r_9_73_100,r_9_73_100,1.0,17,117,100,16
24,r_64_15_168,seq125,seq100,r_64_15_168,0.63,1,169,168,16
25,r_9_73_100,r_129_116_133,r_24_4_195,r_9_73_100,1.0,1,101,100,16
33,seq7,r_20_2_92,r_84_57_13,r_20_2_92,0.99,-23,69,92,16
16,r_97_101_48,seq44,seq19,r_97_101_48,0.92,0,48,48,16
61,seq62,r_45_49_94,seq94,r_45_49_94,1.0,5,99,94,16
69,seq74,r_31_25_74,seq48,r_31_25_74,0.93,-21,53,74,16
81,seq100,r_129_116_133,r_102_5_57,r_102_5_57,0.95,51,108,57,16
9,r_28_83_148,seq69,r_0_89_81,r_0_89_81,1.0,13,94,81,16
22,r_98_60_119,seq68,seq118,r_98_60_119,0.97,0,119,119,16
28,r_30_96_124,seq112,r_45_49_94,r_30_96_124,0.91,0,124,124,16
91,seq115,r_85_37_106,r_102_5_57,r_102_5_57,1.0,60,117,57,16
49,seq40,r_70_3_107,r_103_56_118,r_103_56_118,0.65,0,118,118,16
7,r_129_116_133,seq118,seq87,r_129_116_133,0.88,0,133,133,16
23,r_88_76_80,seq12,seq119,r_88_76_80,1.0,0,80,80,16
17,r_102_5_57,r_85_37_106,r_99_17_112,r_102_5_57,0.69,60,117,57,16
8,r_7_12_59,r_21_90_131,seq113,r_7_12_59,1.0,1,60,59,17
43,seq25,r_118_42_121,r_120_69_118,r_118_42_121,0.55,2,123,121,17
93,seq113,seq104,r_7_12_59,r_7_12_59,1.0,0,59,59,17
16,r_53_96_155,seq20,seq66,r_53_96_155,0.62,0,155,155,17
1,r_93_88_30,r_119_129_162,r_92_29_50,r_93_88_30,0.79,132,162,30,17
65,seq58,r_98_18_51,seq30,r_98_18_51,0.8,-22,29,51,17
29,r_60_19_33,seq36,seq17,r_60_19_33,0.96,0,33,33,17
11,r_92_29_50,r_79_109_159,r_93_88_30,r_92_29_50,1.0,0,50,50,17
15,r_67_114_41,r_119_129_162,seq49,r_67_114_41,0.94,0,41,41,17
72,seq71,r_110_1_194,r_101_16_21,r_101_16_21,1.0,0,21,21,17
20,r_101_16_21,seq11,seq71,r_101_16_21,0.98,1,22,21,17
10,r_118_42_121,seq26,seq37,r_118_42_121,0.79,2,123,121,17
26,r_117_62_77,r_56_44_184,seq66,r_117_62_77,0.94,-1,76,77,17
4,r_106_86_167,r_6_23_102,seq11,r_6_23_102,0.72,-4,98,102,17
0,r_22_73_185,seq39,r_98_18_51,r_22_73_185,0.28,1,186,185,17
13,r_81_2_104,seq95,seq20,r_81_2_104,0.83,2,106,104,17
4,r_106_86_167,seq11,r_93_88_30,r_106_86_167,0.71,-1,166,167,17
6,r_6_23_102,r_106_86_167,seq28,r_6_23_102,0.88,1,103,102,17
22,r_119_129_162,r_92_29_50,seq104,r_119_129_162,0.89,0,162,162,17
24,r_98_18_51,seq58,seq3,r_98_18_51,0.99,1,52,51,17
40,seq17,seq95,r_60_19_33,r_60_19_33,0.99,81,114,33,17
18,r_21_90_131,seq82,r_93_88_30,r_21_90_131,0.74,0,131,131,17
21,r_32_115_10,seq68,seq36,r_32_115_10,0.99,0,10,10,17
25,r_8_33_58,r_119_129_162,seq111,r_8_33_58,1.0,2,60,58,17
1,r_93_88_30,seq0,r_119_129_162,r_93_88_30,0.99,-1,29,30,17
19,r_100_35_28,seq37,r_8_33_58,r_8_33_58,0.98,26,84,58,17
52,seq39,r_22_73_185,seq126,r_22_73_185,0.79,1,186,185,17
28,r_72_99_45,seq41,seq27,r_72_99_45,1.0,0,45,45,17
32,seq3,seq36,r_98_18_51,r_98_18_51,0.91,2,53,51,17
19,r_100_35_28,seq104,seq37,r_100_35_28,0.95,-2,26,28,17
17,r_74_103_98,seq102,seq57,r_74_103_98,0.98,0,98,98,17
22,r_119_129_162,r_8_33_58,r_92_29_50,r_119_129_162,1.0,-112,50,162,17
7,r_120_69_118,r_79_109_159,seq25,r_79_109_159,0.48,-41,118,159,17
44,seq26,r_118_42_121,seq10,r_118_42_121,0.99,2,123,121,17
23,r_125_55_148,seq10,seq107,r_125_55_148,0.57,2,150,148,17
12,r_97_89_62,seq104,r_60_19_33,r_97_89_62,1.0,0,62,62,17
14,r_84_106_129,seq28,seq38,r_84_106_129,0.68,0,129,129,18
53,seq37,r_95_98_149,r_104_1_97,r_104_1_97,0.67,0,97,97,18
16,r_128_116_51,seq129,seq74,r_128_116_51,0.56,-8,43,51,18
37,seq12,r_104_1_97,seq85,r_104_1_97,1.0,1,98,97,18
71,seq74,r_83_33_193,r_128_116_51,r_128_116_51,0.92,10,61,51,18
1,r_90_69_160,seq94,r_21_57_21,r_90_69_160,0.74,1,161,160,18
5,r_112_29_130,seq75,seq66,r_112_29_130,0.93,4,134,130,18
13,r_77_113_13,seq30,r_111_18_104,r_77_113_13,0.99,0,13,13,18
19,r_101_24_84,seq66,seq27,r_101_24_84,1.0,2,86,84,18
95,seq121,seq10,r_5_11_53,r_5_11_53,1.0,102,155,53,18
66,seq66,r_101_24_84,r_83_33_193,r_101_24_84,0.97,2,86,84,18
3,r_118_73_106,r_13_45_128,seq75,r_118_73_106,0.98,2,108,106,18
24,r_21_57_21,r_120_65_65,seq70,r_21_57_21,1.0,0,21,21,18
26,r_104_1_97,seq12,seq37,r_104_1_97,1.0,0,97,97,18
72,seq75,r_112_29_130,r_118_73_106,r_118_73_106,0.87,24,130,106,18
27,r_5_11_53,seq75,seq121,r_5_11_53,1.0,-1,52,53,18
4,r_120_65_65,seq4,seq123,r_120_65_65,1.0,0,65,65,18
0,r_41_126_107,r_95_98_149,seq100,r_41_126_107,1.0,0,107,107,18
11,r_95_98_149,seq37,seq31,r_95_98_149,1.0,0,149,149,18
20,r_3_80_24,r_115_72_145,seq94,r_3_80_24,0.89,0,24,24,18
13,r_77_113_13,r_111_18_104,r_79_102_72,r_77_113_13,0.98,85,98,13,18
10,r_115_72_145,seq76,seq16,r_115_72_145,0.49,3,148,145,18
18,r_125_15_170,seq28,r_41_126_107,r_125_15_170,0.64,0,170,170,18
29,r_111_18_104,seq23,seq4,r_111_18_104,1.0,1,105,104,18
25,r_55_0_190,seq123,r_104_1_97,r_104_1_97,0.62,93,190,97,18
21,r_44_114_15,r_125_15_170,seq20,r_44_114_15,1.0,1,16,15,18
66,seq66,r_83_33_193,r_112_29_130,r_83_33_193,0.76,-59,134,193,18
8,r_25_107_58,r_48_17_93,r_128_116_51,r_25_107_58,1.0,0,58,58,18
17,r_40_62_155,seq31,seq12,r_40_62_155,0.74,0,155,155,18
9,r_13_45_128,r_59_89_180,r_60_49_124,r_13_45_128,0.99,0,128,128,18
22,r_64_54_73,seq66,seq91,r_64_54_73,1.0,0,73,73,18
10,r_115_72_145,r_3_80_24,seq76,r_3_80_24,0.89,-3,21,24,18
28,r_60_49_124,seq122,r_111_18_104,r_111_18_104,1.0,21,125,104,18
7,r_79_102_72,seq28,seq23,r_79_102_72,1.0,-1,71,72,18
23,r_50_52_136,seq100,r_112_29_130,r_50_52_136,0.91,2,138,136,18
12,r_48_17_93,seq99,seq27,r_48_17_93,1.0,0,93,93,18
54,seq48,r_12_10_134,seq74,r_12_10_134,0.89,1,135,134,19
1,r_2_70_85,seq87,seq79,r_2_70_85,1.0,1,86,85,19
5,r_80_17_6,seq127,r_60_108_94,r_60_108_94,0.71,-5,89,94,19
18,r_62_105_25,r_110_44_54,seq111,r_62_105_25,0.95,1,26,25,19
19,r_60_108_94,seq91,r_80_17_6,r_60_108_94,0.85,4,98,94,19
4,r_18_109_111,seq37,seq51,r_18_109_111,0.99,0,111,111,19
11,r_21_63_180,seq9,seq36,r_21_63_180,0.6,0,180,180,19
20,r_107_24_178,seq96,r_62_105_25,r_62_105_25,0.5,152,177,25,19
13,r_69_1_112,seq43,seq20,r_69_1_112,1.0,3,115,112,19
98,seq126,r_0_98_91,seq102,r_0_98_91,1.0,4,95,91,19
6,r_128_47_160,seq56,seq82,r_128_47_160,0.71,0,160,160,19
26,r_75_34_19,seq92,seq43,r_75_34_19,1.0,1,20,19,19
85,seq111,seq8,r_62_105_25,r_62_105_25,1.0,78,103,25,19
8,r_28_22_28,r_90_58_123,seq19,r_28_22_28,1.0,0,28,28,19
40,seq23,seq114,r_0_98_91,r_0_98_91,0.99,4,95,91,19
29,r_5_95_101,seq87,seq79,r_5_95_101,0.74,0,101,101,19
25,r_78_29_65,seq4,seq26,r_78_29_65,1.0,0,65,65,19
24,r_40_76_26,seq74,seq77,r_40_76_26,1.0,0,26,26,19
21,r_103_66_16,seq20,seq54,r_103_66_16,0.89,0,16,16,19
32,seq4,r_78_29_65,seq19,r_78_29_65,1.0,0,65,65,19
16,r_110_44_54,seq42,seq118,r_110_44_54,1.0,0,54,54,19
75,seq87,r_2_70_85,seq3,r_2_70_85,0.9,1,86,85,19
17,r_12_10_134,seq48,r_69_1_112,r_12_10_134,0.56,1,135,134,19
9,r_39_25_114,seq118,seq117,r_39_25_114,0.94,0,114,114,19
22,r_0_98_91,seq126,seq23,r_0_98_91,1.0,4,95,91,19
7,r_88_81_117,seq51,seq96,r_88_81_117,0.6,3,120,117,19
23,r_90_58_123,seq65,r_78_29_65,r_90_58_123,1.0,0,123,123,19
82,seq101,seq79,r_80_17_6,r_80_17_6,0.49,129,135,6,19
79,seq96,r_107_24_178,r_88_81_117,r_88_81_117,1.0,14,131,117,19
12,r_89_15_96,seq37,seq4,r_89_15_96,0.96,3,99,96,19
14,r_81_33_158,seq104,seq0,r_81_33_158,0.49,14,172,158,20
8,r_14_127_102,seq43,seq88,r_14_127_102,0.96,0,102,102,20
21,r_12_36_100,r_95_90_148,r_47_46_5,r_12_36_100,1.0,0,100,100,20
39,seq20,r_11_123_124,seq49,r_11_123_124,1.0,0,124,124,20
1,r_67_60_83,seq89,r_18_112_13,r_67_60_83,0.99,0,83,83,20
19,r_102_48_105,seq41,seq115,r_102_48_105,0.98,1,106,105,20
22,r_96_87_19,seq9,seq39,r_96_87_19,0.99,0,19,19,20
89,seq104,r_81_33_158,seq20,r_81_33_158,0.75,14,172,158,20
3,r_2_119_133,r_25_4_120,r_47_46_5,r_25_4_120,0.6,0,120,120,20
90,seq107,r_106_69_95,seq66,r_106_69_95,1.0,0,95,95,20
26,r_106_69_95,seq107,seq16,r_106_69_95,1.0,0,95,95,20
16,r_120_21_156,seq57,r_109_114_129,r_120_21_156,0.73,0,156,156,20
15,r_55_42_161,r_24_17_130,seq23,r_55_42_161,0.98,0,161,161,20
4,r_52_99_169,seq30,r_102_48_105,r_52_99_169,0.84,0,169,169,20
78,seq88,r_109_114_129,r_14_127_102,r_14_127_102,1.0,10,112,102,20
0,r_62_118_186,seq129,r_95_90_148,r_95_90_148,0.83,38,186,148,20
63,seq63,r_15_5_179,r_72_35_132,r_72_35_132,0.97,47,179,132,20
20,r_25_4_120,r_2_119_133,seq126,r_25_4_120,0.99,0,120,120,20
15,r_55_42_161,r_72_35_132,r_24_17_130,r_55_42_161,0.76,-28,133,161,20
50,seq39,seq34,r_96_87_19,r_96_87_19,1.0,4,23,19,20
27,r_110_1_56,seq129,seq80,r_110_1_56,0.9,0,56,56,20
10,r_40_61_39,seq19,seq88,r_40_61_39,0.55,2,41,39,20
18,r_11_123_124,seq20,r_96_87_19,r_11_123_124,0.77,0,124,124,20
29,r_74_45_111,seq115,seq6,r_74_45_111,0.81,0,111,111,20
24,r_24_17_130,seq117,r_110_1_56,r_24_17_130,1.0,3,133,130,20
88,seq103,seq59,r_64_27_143,r_64_27_143,0.99,3,146,143,20
80,seq91,r_109_114_129,r_18_112_13,r_18_112_13,0.96,4,17,13,20
32,seq3,r_53_10_64,seq30,r_53_10_64,1.0,0,64,64,20
52,seq41,r_102_48_105,seq80,r_102_48_105,1.0,1,106,105,20
81,seq92,r_64_27_143,r_47_46_5,r_64_27_143,0.99,0,143,143,20
3,r_2_119_133,r_47_46_5,r_13_105_74,r_2_119_133,0.96,2,135,133,20
94,seq117,r_24_17_130,seq70,r_24_17_130,1.0,3,133,130,20
9,r_13_105_74,seq50,seq43,r_13_105_74,1.0,1,75,74,20
17,r_18_112_13,seq31,seq91,r_18_112_13,0.55,0,13,13,20
28,r_64_27_143,seq92,seq103,r_64_27_143,0.95,0,143,143,20
7,r_53_10_64,seq3,seq49,r_53_10_64,1.0,0,64,64,20
44,seq30,r_52_99_169,seq3,r_52_99_169,0.97,0,169,169,20
23,r_72_35_132,r_55_42_161,seq63,r_72_35_132,0.92,1,133,132,20
84,seq97,seq54,r_110_1_56,r_110_1_56,0.54,71,127,56,20
8,r_16_122_151,seq83,seq78,r_16_122_151,0.78,0,151,151,21
86,seq99,seq6,r_55_80_73,r_55_80_73,1.0,22,95,73,21
16,r_96_94_66,seq41,seq13,r_96_94_66,1.0,0,66,66,21
1,r_91_30_84,seq124,seq75,r_91_30_84,0.97,1,85,84,21
46,seq31,seq83,r_26_14_106,r_26_14_106,1.0,6,112,106,21
10,r_93_102_113,r_61_112_138,seq90,r_93_102_113,0.99,0,113,113,21
90,seq104,r_115_128_12,r_29_82_63,r_29_82_63,1.0,6,69,63,21
26,r_61_112_138,r_93_102_113,seq4,r_93_102_113,0.82,0,113,113,21
4,r_114_23_120,seq54,seq8,r_114_23_120,0.43,0,120,120,21
0,r_35_42_91,seq34,seq21,r_35_42_91,0.97,1,92,91,21
19,r_65_56_37,r_116_113_119,seq54,r_116_113_119,1.0,-74,45,119,21
11,r_71_66_76,seq63,seq25,r_71_66_76,1.0,1,77,76,21
13,r_88_1_127,seq73,seq48,r_88_1_127,0.96,1,128,127,21
15,r_68_108_81,seq120,seq6,r_68_108_81,1.0,0,81,81,21
6,r_45_109_90,seq123,seq119,r_45_109_90,1.0,0,90,90,21
99,seq124,r_3_53_135,seq85,r_3_53_135,1.0,-79,56,135,21
26,r_61_112_138,seq4,seq48,r_61_112_138,0.96,2,140,138,21
3,r_98_19_44,r_12_47_87,seq63,r_98_19_44,1.0,1,45,44,21
29,r_55_80_73,seq10,seq99,r_55_80_73,1.0,0,73,73,21
24,r_26_14_106,r_114_23_120,seq31,r_26_14_106,0.98,0,106,106,21
70,seq74,r_43_28_107,seq32,r_43_28_107,1.0,-34,73,107,21
17,r_84_17_176,seq10,seq73,r_84_17_176,0.58,1,177,176,21
9,r_29_82_63,seq51,seq104,r_29_82_63,0.99,2,65,63,21
22,r_43_28_107,seq33,seq111,r_43_28_107,1.0,0,107,107,21
49,seq34,r_35_42_91,seq50,r_35_42_91,1.0,1,92,91,21
7,r_12_47_87,r_18_117_192,r_116_113_119,r_116_113_119,0.71,4,123,119,21
44,seq25,seq87,r_71_66_76,r_71_66_76,1.0,43,119,76,21
12,r_116_113_119,seq4,r_12_47_87,r_116_113_119,0.82,0,119,119,21
84,seq95,r_106_11_123,r_71_66_76,r_71_66_76,1.0,47,123,76,21
83,seq91,r_70_125_151,seq129,r_70_125_151,0.77,3,154,151,22
3,r_2_112_44,r_66_4_189,r_128_117_164,r_2_112_44,0.44,145,189,44,22
5,r_64_3_169,r_103_120_52,seq91,r_103_120_52,0.96,7,59,52,22
21,r_30_93_80,seq54,seq6,r_30_93_80,0.98,2,82,80,22
29,r_67_127_13,seq53,seq34,r_67_127_13,0.99,0,13,13,22
97,seq122,r_23_114_105,seq42,r_23_114_105,1.0,0,105,105,22
46,seq25,r_32_82_171,r_38_11_45,r_38_11_45,0.66,140,185,45,22
19,r_18_72_140,r_107_0_193,seq48,r_18_72_140,0.92,0,140,140,22
45,seq24,r_55_59_15,r_67_127_13,r_67_127_13,0.7,42,55,13,22
0,r_56_83_176,seq116,r_23_114_105,r_56_83_176,0.43,0,176,176,22
11,r_79_50_94,seq28,r_103_120_52,r_79_50_94,0.99,0,94,94,22
20,r_95_33_185,seq106,r_67_127_13,r_95_33_185,0.48,0,185,185,22
13,r_70_125_151,seq91,seq88,r_70_125_151,0.52,3,154,151,22
15,r_12_62_69,seq99,seq110,r_12_62_69,1.0,0,69,69,22
4,r_66_4_189,r_2_112_44,r_32_82_171,r_66_4_189,0.28,0,189,189,22
9,r_38_11_45,seq129,seq1,r_38_11_45,0.79,0,45,45,22
3,r_2_112_44,seq48,r_66_4_189,r_2_112_44,0.84,1,45,44,22
18,r_23_114_105,seq122,seq8,r_23_114_105,1.0,0,105,105,22
24,r_21_101_93,r_87_111_108,seq100,r_21_101_93,0.49,13,106,93,22
61,seq51,r_94_115_26,seq14,r_94_115_26,0.7,-3,23,26,22
32,seq6,seq86,r_30_93_80,r_30_93_80,0.88,0,80,80,22
34,seq8,seq7,r_23_114_105,r_23_114_105,1.0,0,105,105,22
94,seq110,r_77_43_192,r_12_62_69,r_12_62_69,1.0,33,102,69,22
2,r_73_41_40,seq8,seq86,r_73_41_40,0.98,-3,37,40,22
16,r_92_47_33,seq5,seq46,r_92_47_33,1.0,0,33,33,22
22,r_121_27_57,seq108,r_92_47_33,r_92_47_33,1.0,40,73,33,22
28,r_128_117_164,seq100,r_2_112_44,r_128_117_164,0.23,-18,146,164,22
4,r_66_4_189,seq17,r_2_112_44,r_66_4_189,0.77,-144,45,189,22
7,r_113_26_124,seq34,r_103_120_52,r_113_26_124,0.98,0,124,124,22
23,r_74_65_144,r_39_75_152,seq1,r_39_75_152,0.91,-8,144,152,22
12,r_39_75_152,r_70_125_151,seq85,r_70_125_151,0.54,1,152,151,22
14,r_103_120_52,r_64_3_169,seq51,r_103_120_52,0.95,0,52,52,22
1,r_94_115_26,seq51,r_67_127_13,r_94_115_26,0.97,0,26,26,22
51,seq39,seq30,r_51_20_48,r_51_20_48,0.99,37,85,48,23
14,r_15_127_89,seq79,seq105,r_15_127_89,0.9,1,90,89,23
83,seq95,r_5_108_187,r_19_13_87,r_19_13_87,1.0,101,188,87,23
11,r_93_90_13,r_77_81_58,r_120_104_1,r_93_90_13,0.92,-3,10,13,23
16,r_76_58_190,seq24,r_106_48_60,r_76_58_190,0.41,-33,157,190,23
1,r_36_121_136,seq119,seq0,r_36_121_136,0.73,4,140,136,23
97,seq119,r_36_121_136,r_102_78_39,r_36_121_136,0.62,-2,134,136,23
21,r_29_25_31,seq53,seq10,r_29_25_31,0.99,0,31,31,23
80,seq91,r_106_48_60,seq82,r_106_48_60,0.57,14,74,60,23
10,r_19_13_87,seq118,r_43_34_23,r_19_13_87,0.8,0,87,87,23
26,r_103_110_74,r_84_68_46,seq24,r_103_110_74,1.0,0,74,74,23
4,r_106_48_60,seq91,r_77_81_58,r_106_48_60,0.86,1,61,60,23
0,r_102_78_39,seq70,r_99_57_171,r_99_57_171,0.62,13,184,171,23
15,r_5_108_187,seq95,r_47_3_32,r_47_3_32,0.86,156,188,32,23
96,seq118,seq63,r_21_114_104,r_21_114_104,0.55,31,135,104,23
3,r_51_20_48,seq128,seq39,r_51_20_48,0.47,2,50,48,23
66,seq67,seq124,r_54_71_45,r_54_71_45,1.0,14,59,45,23
5,r_47_3_32,seq24,seq8,r_47_3_32,1.0,0,32,32,23
45,seq24,r_76_58_190,r_103_110_74,r_103_110_74,0.58,-21,53,74,23
29,r_38_45_75,seq96,seq82,r_38_45_75,0.83,8,83,75,23
36,seq10,seq63,r_29_25_31,r_29_25_31,1.0,3,34,31,23
24,r_26_87_121,r_32_37_10,r_93_90_13,r_26_87_121,0.68,0,121,121,23
25,r_66_80_71,seq23,seq17,r_66_80_71,0.98,2,73,71,23
28,r_54_71_45,seq86,seq67,r_54_71_45,1.0,1,46,45,23
65,seq64,r_52_101_189,r_66_80_71,r_66_80_71,0.95,119,190,71,23
20,r_43_34_23,seq86,r_19_13_87,r_19_13_87,1.0,21,108,87,23
45,seq24,r_47_3_32,r_76_58_190,r_47_3_32,0.61,6,38,32,23
8,r_77_81_58,seq116,r_106_48_60,r_77_81_58,0.85,0,58,58,23
26,r_103_110_74,seq24,r_31_65_134,r_31_65_134,1.0,36,170,134,23
96,seq118,r_19_13_87,seq63,r_19_13_87,0.98,-6,81,87,23
22,r_113_42_107,r_62_115_149,seq79,r_113_42_107,0.81,0,107,107,23
20,r_43_34_23,seq91,seq86,r_43_34_23,1.0,0,23,23,23
7,r_122_125_124,r_99_57_171,seq107,r_99_57_171,0.7,-47,124,171,23
14,r_20_128_79,r_43_39_76,seq22,r_43_39_76,0.92,0,76,76,24
8,r_3_16_102,r_115_108_53,r_20_128_79,r_3_16_102,0.79,2,104,102,24
55,seq57,seq118,r_96_71_55,r_96_71_55,1.0,14,69,55,24
7,r_96_71_55,seq64,seq57,r_96_71_55,1.0,0,55,55,24
91,seq112,seq35,r_117_119_12,r_117_119_12,0.98,11,23,12,24
19,r_104_89_65,r_70_87_73,seq18,r_104_89_65,1.0,2,67,65,24
45,seq35,seq112,r_5_11_26,r_5_11_26,1.0,0,26,26,24
10,r_29_126_165,seq15,seq31,r_29_126_165,0.65,0,165,165,24
11,r_5_11_26,r_46_125_103,seq35,r_5_11_26,0.92,0,26,26,24
2,r_90_27_17,seq100,seq60,r_90_27_17,0.8,-1,16,17,24
78,seq94,r_45_2_189,r_80_37_8,r_45_2_189,0.44,-8,181,189,24
0,r_43_39_76,r_20_128_79,seq129,r_43_39_76,1.0,0,76,76,24
20,r_50_69_141,seq106,r_110_86_56,r_50_69_141,0.53,-6,135,141,24
3,r_56_78_52,seq14,seq60,r_56_78_52,0.99,-3,49,52,24
13,r_19_9_197,seq28,r_4_53_47,r_4_53_47,0.94,16,63,47,24
15,r_72_38_118,seq129,seq55,r_72_38_118,0.42,-3,115,118,24
16,r_117_119_12,r_36_92_13,seq112,r_117_119_12,0.87,0,12,12,24
27,r_42_59_143,seq129,r_3_16_102,r_42_59_143,0.78,0,143,143,24
87,seq106,r_50_69_141,r_104_89_65,r_104_89_65,1.0,83,148,65,24
74,seq85,r_56_78_52,r_30_97_36,r_56_78_52,1.0,0,52,52,24
18,r_116_10_149,r_83_0_199,seq49,r_116_10_149,0.96,0,149,149,24
1,r_110_86_56,seq75,seq21,r_110_86_56,0.98,2,58,56,24
24,r_26_58_131,seq40,seq102,r_26_58_131,0.58,0,131,131,24
67,seq75,r_110_86_56,seq1,r_110_86_56,1.0,2,58,56,24
25,r_70_87_73,seq49,r_25_13_33,r_25_13_33,1.0,38,71,33,24
28,r_4_53_47,r_83_0_199,r_19_9_197,r_4_53_47,0.92,-1,46,47,24
29,r_36_92_13,r_117_119_12,seq100,r_36_92_13,0.88,-1,12,13,24
9,r_124_32_157,seq15,seq23,r_124_32_157,0.57,0,157,157,24
22,r_46_125_103,seq60,r_104_89_65,r_46_125_103,0.54,2,105,103,24
4,r_25_13_33,r_56_78_52,r_70_87_73,r_25_13_33,0.99,0,33,33,24
26,r_30_97_36,r_110_86_56,seq85,r_30_97_36,0.91,0,36,36,24
6,r_7_48_9,r_5_11_26,seq79,r_7_48_9,0.9,3,12,9,24
35,seq15,r_29_126_165,seq8,r_29_126_165,1.0,0,165,165,24
84,seq102,seq100,r_26_58_131,r_26_58_131,0.71,0,131,131,24
36,seq7,r_55_107_180,r_78_53_138,r_78_53_138,0.96,42,180,138,25
14,r_100_125_101,seq51,r_80_20_16,r_80_20_16,0.46,108,124,16,25
8,r_78_53_138,seq97,seq67,r_78_53_138,0.96,0,138,138,25
18,r_37_54_34,r_60_102_179,seq44,r_37_54_34,1.0,0,34,34,25
26,r_99_79_22,seq82,seq45,r_99_79_22,1.0,-1,21,22,25
45,seq18,r_75_58_100,r_119_96_8,r_119_96_8,0.53,19,27,8,25
21,r_103_3_175,r_60_102_179,seq12,r_103_3_175,0.66,0,175,175,25
87,seq93,seq27,r_117_108_54,r_117_108_54,1.0,2,56,54,25
19,r_90_21_102,seq36,r_29_68_36,r_90_21_102,0.68,0,102,102,25
89,seq97,r_78_53_138,seq48,r_78_53_138,1.0,0,138,138,25
16,r_80_20_16,seq12,r_100_125_101,r_100_125_101,0.81,4,105,101,25
1,r_88_95_51,r_78_53_138,r_10_46_94,r_88_95_51,0.87,1,52,51,25
11,r_60_102_179,r_103_3_175,r_117_108_54,r_103_3_175,0.59,0,175,175,25
13,r_112_56_91,r_90_21_102,seq128,r_112_56_91,1.0,0,91,91,25
15,r_127_64_140,seq12,r_28_89_62,r_28_89_62,1.0,65,127,62,25
23,r_122_110_13,seq118,seq52,r_122_110_13,0.99,0,13,13,25
27,r_121_30_46,seq16,seq25,r_121_30_46,1.0,0,46,46,25
10,r_115_98_41,seq17,seq61,r_115_98_41,0.91,-8,33,41,25
57,seq39,seq5,r_29_68_36,r_29_68_36,1.0,-1,35,36,25
16,r_80_20_16,r_99_79_22,seq12,r_80_20_16,1.0,1,17,16,25
2,r_28_89_62,seq52,seq51,r_28_89_62,1.0,0,62,62,25
40,seq12,r_127_64_140,r_80_20_16,r_80_20_16,0.67,118,134,16,25
29,r_38_69_17,seq8,r_49_105_181,r_38_69_17,0.98,0,17,17,25
66,seq52,r_28_89_62,r_122_110_13,r_28_89_62,1.0,-5,57,62,25
69,seq61,r_117_108_54,r_115_98_41,r_117_108_54,0.68,-17,37,54,25
58,seq40,r_34_109_110,seq25,r_34_109_110,1.0,-39,71,110,25
65,seq51,r_100_125_101,r_28_89_62,r_28_89_62,1.0,10,72,62,25
38,seq9,r_60_102_179,seq26,r_60_102_179,0.46,0,179,179,25
9,r_117_108_54,seq35,seq93,r_117_108_54,0.99,-3,51,54,25
31,seq128,r_124_120_79,seq11,r_124_120_79,1.0,-20,59,79,25
50,seq26,seq47,r_124_120_79,r_124_120_79,0.55,54,133,79,25
50,seq26,r_29_68_36,seq47,r_29_68_36,1.0,-1,35,36,25
28,r_91_22_127,seq128,r_75_58_100,r_91_22_127,0.99,0,127,127,25
4,r_29_68_36,seq26,seq39,r_29_68_36,0.99,-1,35,36,25
7,r_124_120_79,seq128,seq26,r_124_120_79,0.87,0,79,79,25
35,seq6,r_75_58_100,r_41_42_5,r_75_58_100,0.37,39,139,100,25
12,r_34_109_110,r_74_15_31,r_117_108_54,r_74_15_31,1.0,81,112,31,25
97,seq116,r_28_89_62,seq24,r_28_89_62,0.99,-16,46,62,25
25,r_1_42_17,seq50,r_114_26_178,r_1_42_17,0.8,1,18,17,26
92,seq102,r_33_104_176,r_27_123_82,r_27_123_82,1.0,-2,80,82,26
8,r_113_112_179,seq67,seq7,r_113_112_179,0.62,0,179,179,26
0,r_103_72_27,r_48_25_197,seq31,r_103_72_27,1.0,0,27,27,26
86,seq95,r_89_91_142,seq43,r_89_91_142,1.0,0,142,142,26
16,r_28_38_108,seq119,r_0_125_199,r_28_38_108,1.0,1,109,108,26
21,r_120_106_159,r_0_125_199,r_59_115_38,r_0_125_199,0.67,-38,161,199,26
1,r_11_51_144,seq39,r_103_72_27,r_103_72_27,0.59,120,147,27,26
5,r_89_91_142,seq95,r_15_35_109,r_89_91_142,0.91,0,142,142,26
66,seq63,seq119,r_59_115_38,r_59_115_38,1.0,50,88,38,26
3,r_41_124_161,seq94,r_65_18_90,r_41_124_161,0.72,0,161,161,26
34,seq7,seq43,r_113_112_179,r_113_112_179,0.77,2,181,179,26
4,r_33_104_176,seq102,r_41_124_161,r_41_124_161,0.54,16,177,161,26
11,r_121_8_156,seq127,seq95,r_121_8_156,0.96,0,156,156,26
40,seq19,seq40,r_54_122_71,r_54_122_71,0.63,15,86,71,26
20,r_54_122_71,r_3_105_114,seq50,r_54_122_71,0.9,0,71,71,26
13,r_5_87_84,seq126,seq67,r_5_87_84,0.94,2,86,84,26
15,r_117_75_135,r_89_91_142,seq39,r_117_75_135,0.76,1,136,135,26
6,r_15_35_109,seq119,r_46_76_37,r_46_76_37,1.0,72,109,37,26
0,r_103_72_27,seq31,r_11_51_144,r_11_51_144,0.7,3,147,144,26
24,r_59_115_38,r_114_26_178,seq9,r_59_115_38,1.0,0,38,38,26
29,r_27_123_82,seq40,seq102,r_27_123_82,1.0,0,82,82,26
50,seq37,seq16,r_24_10_60,r_24_10_60,0.41,12,72,60,26
9,r_100_47_51,seq128,seq40,r_100_47_51,1.0,0,51,51,26
81,seq88,r_70_109_128,seq62,r_70_109_128,1.0,0,128,128,26
17,r_3_105_114,seq37,seq74,r_3_105_114,0.96,0,114,114,26
25,r_1_42_17,r_114_26_178,r_65_18_90,r_1_42_17,0.45,89,106,17,26
40,seq19,r_54_122_71,r_100_47_51,r_100_47_51,0.47,90,141,51,26
27,r_116_118_42,r_24_10_60,seq68,r_116_118_42,1.0,0,42,42,26
7,r_0_125_199,r_120_106_159,r_28_38_108,r_0_125_199,0.88,-53,146,199,26
23,r_65_18_90,seq73,r_1_42_17,r_65_18_90,0.76,5,95,90,26
19,r_46_76_37,r_89_91_142,seq61,r_46_76_37,1.0,0,37,37,26
35,seq9,r_58_36_181,r_24_10_60,r_58_36_181,0.67,-5,176,181,26
12,r_114_26_178,seq71,r_0_125_199,r_114_26_178,0.55,0,178,178,26
49,seq42,seq23,r_7_69_18,r_7_69_18,1.0,0,18,18,27
9,r_129_24_34,r_126_31_184,r_6_33_52,r_6_33_52,0.5,132,184,52,27
14,r_47_9_189,seq96,r_53_103_80,r_53_103_80,0.91,109,189,80,27
12,r_126_31_184,r_34_81_95,r_129_24_34,r_34_81_95,0.98,-41,54,95,27
37,seq20,r_3_109_109,r_53_103_80,r_53_103_80,1.0,89,169,80,27
55,seq52,r_123_104_177,r_53_103_80,r_53_103_80,1.0,97,177,80,27
16,r_79_114_84,seq66,seq32,r_79_114_84,1.0,0,84,84,27
21,r_124_51_104,seq21,r_129_24_34,r_124_51_104,1.0,0,104,104,27
39,seq22,r_128_70_8,r_14_82_46,r_14_82_46,1.0,15,61,46,27
1,r_53_103_80,seq99,seq64,r_53_103_80,0.98,0,80,80,27
9,r_129_24_34,seq94,r_126_31_184,r_129_24_34,0.92,-3,31,34,27
80,seq95,seq42,r_34_81_95,r_34_81_95,1.0,2,97,95,27
2,r_7_69_18,r_97_27_75,seq42,r_7_69_18,0.81,0,18,18,27
22,r_14_82_46,r_47_9_189,seq22,r_14_82_46,1.0,0,46,46,27
95,seq119,seq43,r_97_27_75,r_97_27_75,1.0,92,167,75,27
3,r_97_27_75,seq21,seq76,r_97_27_75,1.0,0,75,75,27
10,r_29_12_48,r_3_109_109,r_88_102_76,r_88_102_76,1.0,18,94,76,27
90,seq111,seq94,r_115_25_91,r_115_25_91,1.0,40,131,91,27
26,r_89_44_147,seq54,seq61,r_89_44_147,0.92,0,147,147,27
4,r_88_102_76,seq98,r_29_12_48,r_88_102_76,1.0,1,77,76,27
0,r_115_25_91,seq32,seq111,r_115_25_91,1.0,0,91,91,27
20,r_34_81_95,r_126_31_184,seq95,r_34_81_95,0.95,0,95,95,27
13,r_3_109_109,seq20,r_88_102_76,r_88_102_76,1.0,45,121,76,27
12,r_126_31_184,r_129_24_34,seq15,r_126_31_184,0.73,0,184,184,27
6,r_35_106_182,seq61,r_7_69_18,r_7_69_18,0.91,164,182,18,27
18,r_16_17_137,seq76,seq96,r_16_17_137,0.64,0,137,137,27
58,seq56,r_19_45_106,seq96,r_19_45_106,0.99,0,106,106,27
28,r_117_63_35,r_79_114_84,seq120,r_117_63_35,0.95,0,35,35,27
15,r_6_33_52,r_35_106_182,seq80,r_6_33_52,1.0,0,52,52,27
17,r_19_45_106,seq56,seq100,r_19_45_106,0.92,0,106,106,27
23,r_4_72_68,seq48,seq55,r_4_72_68,0.98,1,69,68,27
36,seq12,r_117_67_135,seq85,r_117_67_135,0.9,0,135,135,28
14,r_81_94_170,r_53_110_167,r_7_79_106,r_53_110_167,0.64,1,168,167,28
3,r_36_44_171,r_102_126_84,r_34_27_62,r_36_44_171,0.93,0,171,171,28
1,r_102_126_84,r_36_44_171,seq31,r_36_44_171,0.98,-2,169,171,28
1,r_102_126_84,seq15,r_36_44_171,r_102_126_84,1.0,0,84,84,28
19,r_72_20_187,seq92,r_107_106_63,r_107_106_63,0.91,124,187,63,28
27,r_114_80_6,seq62,r_53_110_167,r_53_110_167,0.95,-1,166,167,28
49,seq31,r_23_5_146,r_59_118_11,r_59_118_11,1.0,0,11,11,28
76,seq89,seq28,r_52_129_150,r_52_129_150,0.94,3,153,150,28
16,r_70_37_19,seq28,seq56,r_70_37_19,0.94,1,20,19,28
67,seq69,r_23_5_146,seq31,r_23_5_146,0.66,-3,143,146,28
3,r_36_44_171,seq56,r_102_126_84,r_102_126_84,1.0,15,99,84,28
10,r_74_120_169,r_47_112_192,seq32,r_74_120_169,0.71,2,171,169,28
26,r_39_61_85,seq45,seq16,r_39_61_85,1.0,0,85,85,28
12,r_59_118_11,seq73,seq31,r_59_118_11,1.0,0,11,11,28
4,r_117_67_135,seq12,r_22_46_80,r_22_46_80,0.72,55,135,80,28
78,seq91,r_7_79_106,r_114_80_6,r_7_79_106,0.99,-4,102,106,28
0,r_7_79_106,seq91,seq111,r_7_79_106,0.9,0,106,106,28
11,r_63_75_76,seq98,seq55,r_63_75_76,0.91,0,76,76,28
13,r_23_5_146,seq69,seq100,r_23_5_146,0.81,0,146,146,28
15,r_41_51_66,seq26,seq2,r_41_51_66,1.0,0,66,66,28
64,seq62,r_7_79_106,r_114_80_6,r_7_79_106,0.97,-48,58,106,28
17,r_50_108_31,seq32,seq2,r_50_108_31,1.0,0,31,31,28
70,seq77,seq1,r_99_54_37,r_99_54_37,0.97,0,37,37,28
47,seq28,seq89,r_97_58_39,r_97_58_39,0.88,33,72,39,28
40,seq16,r_53_110_167,r_39_61_85,r_39_61_85,0.58,80,165,85,28
18,r_30_83_110,seq17,seq122,r_30_83_110,1.0,0,110,110,28
29,r_22_46_80,r_47_112_192,seq92,r_22_46_80,0.95,0,80,80,28
25,r_34_27_62,seq43,seq28,r_34_27_62,1.0,1,63,62,28
9,r_97_58_39,r_47_112_192,seq28,r_97_58_39,1.0,2,41,39,28
32,seq2,seq57,r_41_51_66,r_41_51_66,1.0,0,66,66,28
27,r_114_80_6,r_7_79_106,seq62,r_7_79_106,0.79,-48,58,106,28
24,r_99_54_37,seq56,seq77,r_99_54_37,1.0,0,37,37,28
7,r_127_6_56,seq82,seq49,r_127_6_56,1.0,0,56,56,28
22,r_52_129_150,seq103,seq89,r_52_129_150,0.52,0,150,150,28
79,seq92,r_72_20_187,r_22_46_80,r_22_46_80,1.0,29,109,80,28
8,r_9_122_101,seq86,seq50,r_9_122_101,0.76,5,106,101,29
12,r_96_41_42,seq10,seq23,r_96_41_42,0.93,0,42,42,29
16,r_80_66_171,seq71,seq1,r_80_66_171,0.49,6,177,171,29
21,r_57_17_79,r_14_59_191,seq36,r_57_17_79,0.99,-1,78,79,29
15,r_119_43_48,seq70,seq10,r_119_43_48,1.0,0,48,48,29
36,seq10,r_96_41_42,r_93_87_38,r_93_87_38,0.97,0,38,38,29
19,r_112_85_72,r_52_30_176,seq16,r_112_85_72,0.8,1,73,72,29
67,seq74,r_129_40_162,seq81,r_129_40_162,0.86,-79,83,162,29
27,r_51_65_35,r_6_105_93,seq127,r_51_65_35,1.0,0,35,35,29
26,r_13_58_106,seq99,seq81,r_13_58_106,0.93,2,108,106,29
63,seq70,seq2,r_6_105_93,r_6_105_93,1.0,15,108,93,29
20,r_123_54_142,seq22,seq98,r_123_54_142,0.8,4,146,142,29
6,r_129_40_162,seq92,r_96_41_42,r_129_40_162,0.64,1,163,162,29
14,r_79_42_99,seq50,seq86,r_79_42_99,0.96,0,99,99,29
2,r_101_61_135,seq55,seq98,r_101_61_135,0.64,1,136,135,29
3,r_78_3_28,seq109,r_14_59_191,r_78_3_28,1.0,0,28,28,29
74,seq86,r_9_122_101,r_79_42_99,r_79_42_99,0.57,3,102,99,29
18,r_6_105_93,seq23,r_121_48_90,r_6_105_93,0.63,0,93,93,29
29,r_121_48_90,seq125,seq70,r_121_48_90,1.0,1,91,90,29
24,r_91_106_102,seq84,r_112_85_72,r_112_85_72,0.97,30,102,72,29
25,r_28_18_195,r_12_26_185,r_75_44_178,r_75_44_178,0.75,7,185,178,29
64,seq71,r_80_66_171,r_39_104_86,r_39_104_86,0.93,91,177,86,29
50,seq36,seq29,r_57_17_79,r_57_17_79,1.0,70,149,79,29
0,r_37_49_20,seq67,seq113,r_37_49_20,0.95,-1,19,20,29
10,r_38_25_33,seq34,seq50,r_38_25_33,0.91,-1,32,33,29
61,seq68,r_31_60_150,seq67,r_31_60_150,0.62,-4,146,150,29
77,seq92,r_129_40_162,r_13_58_106,r_13_58_106,0.86,43,149,106,29
4,r_93_87_38,seq7,seq10,r_93_87_38,1.0,0,38,38,29
9,r_12_26_185,r_28_18_195,r_80_66_171,r_80_66_171,0.64,14,185,171,29
22,r_15_5_136,seq63,r_57_17_79,r_15_5_136,0.83,0,136,136,29
48,seq34,r_38_25_33,seq86,r_38_25_33,0.94,-1,32,33,29
13,r_14_59_191,r_57_17_79,r_78_3_28,r_78_3_28,0.62,0,28,28,29
23,r_52_30_176,r_112_85_72,r_80_66_171,r_112_85_72,0.67,1,73,72,29
82,seq99,r_13_58_106,seq23,r_13_58_106,0.63,2,108,106,29
23,r_52_30_176,r_80_66_171,r_112_85_72,r_80_66_171,0.42,-3,168,171,29
93,seq117,r_127_32_124,seq4,r_127_32_124,1.0,0,124,124,30
30,seq1,r_51_91_176,r_92_115_59,r_92_115_59,1.0,1,60,59,30
5,r_58_47_26,seq9,seq113,r_58_47_26,0.99,0,26,26,30
8,r_78_106_3,r_124_90_108,r_29_69_71,r_78_106_3,1.0,78,81,3,30
43,seq23,seq40,r_39_10_107,r_39_10_107,1.0,-1,106,107,30
14,r_128_72_34,r_51_91_176,seq27,r_128_72_34,1.0,0,34,34,30
16,r_11_61_76,r_37_17_168,seq36,r_11_61_76,0.61,0,76,76,30
21,r_6_53_93,seq56,seq48,r_6_53_93,1.0,0,93,93,30
1,r_71_16_83,seq40,seq52,r_71_16_83,1.0,0,83,83,30
29,r_31_79_16,r_124_90_108,seq14,r_31_79_16,1.0,0,16,16,30
10,r_70_45_147,seq12,seq123,r_70_45_147,0.93,0,147,147,30
20,r_129_94_47,seq35,seq80,r_129_94_47,1.0,0,47,47,30
26,r_112_44_159,r_68_107_174,r_58_47_26,r_112_44_159,0.58,0,159,159,30
4,r_39_10_107,seq33,seq23,r_39_10_107,0.99,0,107,107,30
11,r_68_107_174,seq52,r_124_90_108,r_68_107_174,0.75,0,174,174,30
2,r_43_118_33,r_68_107_174,seq83,r_43_118_33,0.96,9,42,33,30
13,r_124_90_108,seq36,seq40,r_124_90_108,0.89,0,108,108,30
15,r_29_69_71,seq23,r_78_106_3,r_29_69_71,0.94,0,71,71,30
0,r_110_108_20,r_57_25_184,seq14,r_110_108_20,1.0,0,20,20,30
91,seq113,r_5_3_149,r_58_47_26,r_58_47_26,0.95,18,44,26,30
85,seq99,r_116_0_117,seq123,r_116_0_117,1.0,0,117,117,30
27,r_116_0_117,seq99,seq24,r_116_0_117,0.96,0,117,117,30
18,r_101_7_79,seq27,seq8,r_101_7_79,1.0,-1,78,79,30
24,r_87_34_65,seq21,seq9,r_87_34_65,0.65,0,65,65,30
34,seq9,r_26_54_17,r_87_34_65,r_87_34_65,0.98,47,112,65,30
37,seq14,seq22,r_110_108_20,r_110_108_20,1.0,0,20,20,30
17,r_122_75_98,seq86,seq36,r_122_75_98,0.65,-2,96,98,30
9,r_37_17_168,r_11_61_76,r_77_109_80,r_11_61_76,0.74,2,78,76,30
23,r_92_115_59,r_101_7_79,seq1,r_92_115_59,1.0,0,59,59,30
6,r_26_54_17,r_71_16_83,seq9,r_26_54_17,0.98,-1,16,17,30
7,r_82_28_90,seq42,r_58_47_26,r_58_47_26,0.83,74,100,26,30
35,seq12,r_70_45_147,seq4,r_70_45_147,1.0,0,147,147,30
12,r_5_3_149,seq113,r_116_0_117,r_116_0_117,1.0,33,150,117,30
84,seq98,r_43_118_33,seq21,r_43_118_33,0.48,74,107,33,30
93,seq111,r_102_116_129,seq13,r_102_116_129,0.55,0,129,129,31
9,r_113_125_181,seq6,r_18_31_198,r_18_31_198,0.6,-17,181,198,31
8,r_32_27_141,seq74,seq70,r_32_27_141,0.57,1,142,141,31
10,r_55_36_29,r_59_107_138,seq9,r_59_107_138,0.77,-98,40,138,31
59,seq49,seq1,r_22_115_79,r_22_115_79,1.0,0,79,79,31
16,r_26_7_114,r_113_125_181,seq104,r_26_7_114,0.89,0,114,114,31
1,r_22_115_79,r_102_116_129,seq49,r_22_115_79,0.99,1,80,79,31
88,seq104,seq0,r_26_7_114,r_26_7_114,0.97,0,114,114,31
24,r_102_116_129,seq13,r_126_96_93,r_102_116_129,0.98,0,129,129,31
19,r_29_101_175,r_113_125_181,r_66_53_34,r_113_125_181,0.56,-7,174,181,31
31,seq1,seq86,r_61_75_81,r_61_75_81,1.0,28,109,81,31
29,r_47_58_21,seq89,seq63,r_47_58_21,0.85,0,21,21,31
3,r_50_103_98,seq63,seq78,r_50_103_98,1.0,1,99,98,31
72,seq73,r_68_83_173,r_29_101_175,r_29_101_175,0.84,2,177,175,31
14,r_48_76_25,r_113_125_181,seq6,r_48_76_25,0.5,110,135,25,31
0,r_71_10_86,seq118,seq79,r_71_10_86,0.98,1,87,86,31
13,r_109_4_57,r_18_31_198,seq120,r_109_4_57,0.99,4,61,57,31
18,r_126_96_93,seq8,seq120,r_126_96_93,0.96,-14,79,93,31
6,r_61_75_81,r_68_83_173,seq1,r_61_75_81,0.96,0,81,81,31
27,r_124_30_125,seq78,seq70,r_124_30_125,0.85,4,129,125,31
53,seq38,seq8,r_59_107_138,r_59_107_138,0.8,-5,133,138,31
2,r_12_46_135,seq62,seq3,r_12_46_135,0.4,0,135,135,31
40,seq13,r_102_116_129,seq111,r_102_116_129,0.68,0,129,129,31
14,r_48_76_25,r_117_114_39,r_113_125_181,r_48_76_25,0.69,0,25,25,31
18,r_126_96_93,r_55_36_29,seq8,r_126_96_93,0.61,-46,47,93,31
11,r_34_2_28,r_71_10_86,seq89,r_34_2_28,0.93,0,28,28,31
88,seq104,r_117_114_39,seq0,r_117_114_39,0.94,1,40,39,31
34,seq6,r_113_125_181,r_48_76_25,r_48_76_25,0.89,130,155,25,31
17,r_19_72_63,seq40,seq3,r_19_72_63,0.99,3,66,63,31
94,seq118,r_71_10_86,seq70,r_71_10_86,1.0,1,87,86,31
9,r_113_125_181,r_26_7_114,seq6,r_26_7_114,1.0,0,114,114,31
28,r_84_82_166,seq28,r_18_31_198,r_84_82_166,0.32,3,169,166,31
80,seq89,seq15,r_34_2_28,r_34_2_28,0.92,10,38,28,31
7,r_80_64_46,r_81_87_197,seq98,r_80_64_46,1.0,0,46,46,31
8,r_58_106_87,seq52,seq87,r_58_106_87,0.98,2,89,87,32
30,seq128,seq115,r_96_24_16,r_96_24_16,0.94,2,18,16,32
37,seq13,r_28_60_186,r_82_57_116,r_82_57_116,0.99,16,132,116,32
16,r_82_57_116,seq8,seq13,r_82_57_116,0.95,0,116,116,32
21,r_102_2_119,r_64_123_92,r_19_104_70,r_102_2_119,0.61,-22,97,119,32
29,r_12_61_20,seq107,seq13,r_12_61_20,0.8,-7,13,20,32
1,r_27_9_163,r_59_39_64,r_19_104_70,r_27_9_163,0.93,1,164,163,32
1,r_27_9_163,seq68,r_59_39_64,r_59_39_64,0.89,15,79,64,32
5,r_64_123_92,r_102_2_119,r_5_93_22,r_64_123_92,0.92,5,97,92,32
42,seq22,r_19_104_70,seq52,r_19_104_70,0.88,5,75,70,32
10,r_59_39_64,seq48,seq21,r_59_39_64,0.98,0,64,64,32
42,seq22,seq52,r_54_108_110,r_54_108_110,1.0,4,114,110,32
26,r_73_32_60,r_98_78_59,r_97_109_41,r_97_109_41,0.98,29,70,41,32
8,r_58_106_87,seq87,r_89_41_177,r_89_41_177,0.9,1,178,177,32
0,r_97_109_41,seq52,seq29,r_97_109_41,0.95,0,41,41,32
14,r_36_45_23,r_6_17_48,r_12_61_20,r_6_17_48,0.97,-24,24,48,32
4,r_112_119_77,seq56,seq122,r_112_119_77,0.96,0,77,77,32
11,r_19_104_70,seq22,seq118,r_19_104_70,0.98,5,75,70,32
20,r_28_60_186,seq13,r_112_119_77,r_112_119_77,0.58,109,186,77,32
6,r_54_108_110,seq40,seq22,r_54_108_110,0.94,0,110,110,32
19,r_55_46_29,r_98_78_59,seq128,r_55_46_29,1.0,0,29,29,32
15,r_110_95_17,r_64_123_92,seq124,r_110_95_17,0.83,-4,13,17,32
12,r_6_17_48,r_14_23_138,seq56,r_6_17_48,1.0,0,48,48,32
18,r_77_80_121,seq116,r_19_104_70,r_77_80_121,0.97,0,121,121,32
24,r_15_33_89,seq53,seq40,r_15_33_89,0.51,0,89,89,32
25,r_14_23_138,seq29,r_19_104_70,r_14_23_138,0.89,0,138,138,32
2,r_5_93_22,r_6_17_48,seq16,r_5_93_22,0.96,0,22,22,32
7,r_96_24_16,r_64_123_92,seq128,r_96_24_16,0.93,-3,13,16,32
96,seq122,seq76,r_112_119_77,r_112_119_77,1.0,29,106,77,32
22,r_90_99_97,seq16,seq69,r_90_99_97,0.79,1,98,97,32
28,r_89_41_177,seq76,r_58_106_87,r_58_106_87,0.49,91,178,87,32
23,r_70_11_91,seq62,seq56,r_70_11_91,1.0,0,91,91,32
21,r_102_2_119,r_19_104_70,r_59_39_64,r_102_2_119,0.88,1,120,119,32
30,seq0,r_68_94_119,seq1,r_68_94_119,1.0,0,119,119,33
14,r_47_100_69,seq25,r_64_36_68,r_47_100_69,1.0,0,69,69,33
1,r_75_15_195,r_72_74_98,seq29,r_72_74_98,0.45,-48,50,98,33
16,r_6_79_165,seq50,r_3_85_33,r_6_79_165,0.82,0,165,165,33
21,r_30_76_152,seq49,r_31_12_111,r_30_76_152,0.98,0,152,152,33
48,seq35,r_30_76_152,r_3_85_33,r_3_85_33,0.73,1,34,33,33
19,r_78_110_100,seq11,r_111_44_92,r_111_44_92,1.0,17,109,92,33
76,seq86,r_119_99_169,seq60,r_119_99_169,0.98,-20,149,169,33
10,r_40_109_123,seq25,seq96,r_40_109_123,0.99,0,123,123,33
26,r_92_115_121,r_88_4_196,seq101,r_92_115_121,1.0,0,121,121,33
4,r_119_99_169,seq86,seq21,r_119_99_169,0.74,0,169,169,33
78,seq90,r_117_38_126,seq96,r_117_38_126,0.74,0,126,126,33
20,r_111_44_92,seq127,r_78_110_100,r_111_44_92,1.0,0,92,92,33
13,r_68_94_119,seq0,r_64_36_68,r_68_94_119,1.0,0,119,119,33
15,r_87_13_179,seq103,r_106_108_94,r_87_13_179,0.57,0,179,179,33
6,r_31_12_111,seq80,seq73,r_31_12_111,0.56,8,119,111,33
62,seq59,seq49,r_39_71_64,r_39_71_64,1.0,3,67,64,33
99,seq127,r_111_44_92,seq62,r_111_44_92,1.0,-19,73,92,33
5,r_8_114_49,seq128,seq54,r_8_114_49,1.0,1,50,49,33
27,r_72_74_98,seq112,seq53,r_72_74_98,1.0,0,98,98,33
2,r_7_77_70,seq67,seq1,r_7_77_70,0.7,0,70,70,33
18,r_88_4_196,r_92_115_121,seq83,r_92_115_121,1.0,1,122,121,33
68,seq67,r_7_77_70,r_91_24_189,r_7_77_70,0.68,3,73,70,33
23,r_3_85_33,seq83,seq35,r_3_85_33,1.0,0,33,33,33
17,r_32_19_143,seq45,r_129_97_23,r_129_97_23,1.0,134,157,23,33
28,r_39_71_64,seq61,seq59,r_39_71_64,1.0,0,64,64,33
7,r_64_36_68,seq90,seq50,r_64_36_68,1.0,0,68,68,33
11,r_42_10_51,r_47_100_69,seq20,r_42_10_51,0.63,1,52,51,33
12,r_93_2_38,r_64_36_68,seq107,r_93_2_38,1.0,0,38,38,33
30,seq0,r_127_83_171,r_103_125_129,r_103_125_129,1.0,42,171,129,34
51,seq39,r_123_8_176,seq44,r_123_8_176,0.55,2,178,176,34
28,r_89_88_21,r_40_17_157,seq18,r_89_88_21,1.0,0,21,21,34
83,seq94,r_40_17_157,seq67,r_40_17_157,0.82,0,157,157,34
16,r_2_62_154,seq76,seq64,r_2_62_154,0.6,0,154,154,34
1,r_28_104_112,seq85,seq21,r_28_104_112,0.96,0,112,112,34
4,r_105_31_152,r_54_75_94,r_38_35_17,r_105_31_152,0.93,1,153,152,34
10,r_12_98_175,seq86,r_111_118_75,r_111_118_75,1.0,100,175,75,34
26,r_43_112_118,r_82_59_132,seq26,r_43_112_118,0.63,0,118,118,34
72,seq77,r_12_98_175,r_69_53_55,r_69_53_55,1.0,49,104,55,34
4,r_105_31_152,seq102,r_54_75_94,r_54_75_94,0.99,11,105,94,34
0,r_5_95_126,r_87_41_151,seq9,r_5_95_126,0.74,2,128,126,34
11,r_111_118_75,seq7,seq116,r_111_118_75,1.0,0,75,75,34
20,r_54_75_94,seq9,seq68,r_54_75_94,0.99,0,94,94,34
13,r_40_17_157,seq94,r_105_31_152,r_40_17_157,0.85,0,157,157,34
48,seq32,r_87_41_151,r_34_66_111,r_34_66_111,0.74,54,165,111,34
6,r_22_78_65,seq4,seq93,r_22_78_65,1.0,1,66,65,34
29,r_1_29_50,seq46,r_38_35_17,r_1_29_50,1.0,0,50,50,34
8,r_110_52_28,r_127_83_171,seq4,r_110_52_28,0.99,0,28,28,34
2,r_126_20_101,r_123_8_176,seq55,r_126_20_101,0.86,0,101,101,34
18,r_123_8_176,seq39,r_127_83_171,r_123_8_176,0.54,0,176,176,34
24,r_103_125_129,seq107,seq0,r_103_125_129,0.98,0,129,129,34
25,r_97_25_44,seq21,r_12_98_175,r_97_25_44,1.0,0,44,44,34
21,r_69_53_55,r_23_128_80,r_97_25_44,r_69_53_55,1.0,1,56,55,34
19,r_106_70_30,r_49_122_47,seq55,r_106_70_30,0.83,5,35,30,34
15,r_49_122_47,r_12_98_175,seq18,r_49_122_47,0.93,0,47,47,34
17,r_36_30_140,r_40_17_157,seq120,r_36_30_140,0.64,0,140,140,34
25,r_97_25_44,r_12_98_175,r_69_53_55,r_97_25_44,0.76,70,114,44,34
5,r_19_74_20,r_82_59_132,seq79,r_19_74_20,1.0,0,20,20,34
9,r_23_128_80,seq102,seq96,r_23_128_80,1.0,0,80,80,34
22,r_82_59_132,seq42,seq15,r_82_59_132,0.52,4,136,132,34
7,r_127_83_171,seq0,r_36_30_140,r_36_30_140,0.67,31,171,140,34
23,r_63_113_182,seq56,r_87_41_151,r_63_113_182,0.19,0,182,182,34
82,seq93,seq84,r_22_78_65,r_22_78_65,1.0,8,73,65,34
35,seq7,r_111_118_75,seq65,r_111_118_75,1.0,0,75,75,34
5,r_35_50_26,r_121_125_30,seq26,r_35_50_26,0.97,0,26,26,35
8,r_94_22_159,seq48,seq9,r_94_22_159,0.56,0,159,159,35
25,r_80_96_54,seq38,seq81,r_80_96_54,0.65,1,55,54,35
55,seq43,r_44_2_133,seq56,r_44_2_133,0.64,0,133,133,35
16,r_67_115_99,r_11_114_187,r_52_54_75,r_67_115_99,0.62,5,104,99,35
21,r_17_5_82,seq29,seq3,r_17_5_82,0.99,0,82,82,35
1,r_109_32_185,seq128,r_94_22_159,r_94_22_159,0.97,29,188,159,35
74,seq81,r_124_73_43,r_80_96_54,r_124_73_43,1.0,1,44,43,35
95,seq118,r_16_92_132,seq42,r_16_92_132,0.91,2,134,132,35
3,r_63_24_127,r_11_114_187,seq20,r_63_24_127,0.99,1,128,127,35
10,r_78_99_89,seq65,r_52_54_75,r_52_54_75,0.86,29,104,75,35
26,r_11_114_187,seq86,r_44_2_133,r_44_2_133,0.46,54,187,133,35
13,r_105_71_23,seq98,seq19,r_105_71_23,0.94,2,25,23,35
4,r_34_102_73,seq21,seq120,r_34_102_73,1.0,0,73,73,35
0,r_14_59_64,seq108,seq65,r_14_59_64,0.99,1,65,64,35
20,r_16_92_132,seq118,seq19,r_16_92_132,0.53,2,134,132,35
15,r_66_51_144,seq12,r_80_96_54,r_66_51_144,0.52,1,145,144,35
29,r_124_73_43,seq81,r_94_22_159,r_124_73_43,0.99,0,43,43,35
27,r_31_100_153,seq75,r_63_24_127,r_31_100_153,0.62,3,156,153,35
2,r_40_4_104,seq108,seq6,r_40_4_104,0.98,0,104,104,35
18,r_88_45_96,seq21,seq108,r_88_45_96,0.97,0,96,96,35
24,r_52_54_75,seq93,seq21,r_52_54_75,1.0,-4,71,75,35
33,seq6,seq21,r_40_4_104,r_40_4_104,1.0,55,159,104,35
6,r_61_103_8,r_11_114_187,seq56,r_11_114_187,0.87,-46,141,187,35
29,r_124_73_43,r_94_22_159,r_72_18_52,r_124_73_43,0.87,21,64,43,35
7,r_44_2_133,seq43,seq30,r_44_2_133,0.73,0,133,133,35
23,r_106_77_180,seq76,r_94_22_159,r_94_22_159,0.84,22,181,159,35
93,seq117,seq92,r_8_34_92,r_8_34_92,0.88,0,92,92,36
8,r_29_19_95,seq4,seq51,r_29_19_95,0.87,0,95,95,36
53,seq41,r_59_71_190,r_15_69_35,r_15_69_35,1.0,155,190,35,36
1,r_72_116_71,seq4,seq40,r_72_116_71,0.95,0,71,71,36
97,seq125,r_55_27_196,r_107_44_27,r_107_44_27,0.98,153,180,27,36
14,r_128_83_49,seq36,seq17,r_128_83_49,0.99,-3,46,49,36
66,seq129,r_55_27_196,r_107_44_27,r_107_44_27,0.99,153,180,27,36
3,r_5_122_54,seq117,seq30,r_5_122_54,0.74,-10,44,54,36
10,r_32_14_67,r_109_90_140,seq108,r_32_14_67,1.0,0,67,67,36
19,r_35_62_24,seq48,seq26,r_35_62_24,0.95,-1,23,24,36
90,seq108,seq13,r_123_49_20,r_123_49_20,0.84,52,72,20,36
0,r_50_73_62,seq26,seq75,r_50_73_62,1.0,0,62,62,36
11,r_59_71_190,seq41,r_68_98_124,r_68_98_124,0.75,66,190,124,36
15,r_3_46_176,seq11,r_35_62_24,r_3_46_176,0.71,0,176,176,36
23,r_65_111_13,r_72_116_71,seq85,r_65_111_13,0.81,2,15,13,36
20,r_55_27_196,seq91,seq129,r_55_27_196,0.59,-148,48,196,36
21,r_100_18_14,seq2,seq57,r_100_18_14,1.0,0,14,14,36
27,r_8_34_92,seq52,seq117,r_8_34_92,0.86,0,92,92,36
87,seq102,r_33_6_123,seq7,r_33_6_123,0.98,6,129,123,36
2,r_79_10_148,seq97,seq70,r_79_10_148,0.93,1,149,148,36
18,r_109_90_140,seq88,r_39_47_81,r_109_90_140,0.96,0,140,140,36
24,r_121_113_69,seq13,seq81,r_121_113_69,0.99,0,69,69,36
25,r_43_112_169,r_94_42_103,seq12,r_43_112_169,0.57,0,169,169,36
68,seq75,seq12,r_50_73_62,r_50_73_62,1.0,5,67,62,36
75,seq85,r_39_47_81,r_65_111_13,r_65_111_13,0.64,89,102,13,36
6,r_107_44_27,seq117,seq129,r_107_44_27,1.0,0,27,27,36
22,r_33_6_123,seq102,seq0,r_33_6_123,0.75,6,129,123,36
28,r_124_20_156,seq120,r_5_122_54,r_124_20_156,0.32,3,159,156,36
5,r_123_49_20,r_72_116_71,seq108,r_123_49_20,0.73,-1,19,20,36
4,r_15_69_35,seq1,seq67,r_15_69_35,0.98,0,35,35,36
7,r_104_103_150,seq13,r_33_6_123,r_104_103_150,0.85,2,152,150,36
60,seq57,r_3_46_176,r_100_18_14,r_100_18_14,1.0,1,15,14,36
12,r_68_98_124,seq70,seq88,r_68_98_124,0.95,0,124,124,36
92,seq112,r_33_75_62,r_54_70_5,r_33_75_62,1.0,0,62,62,37
8,r_126_63_171,r_47_74_135,r_7_95_22,r_126_63_171,0.6,-33,138,171,37
16,r_57_89_165,seq52,r_7_95_22,r_57_89_165,0.9,0,165,165,37
21,r_109_18_145,seq86,r_10_19_153,r_109_18_145,0.81,2,147,145,37
5,r_47_74_135,r_126_63_171,seq78,r_126_63_171,0.66,-33,138,171,37
11,r_119_42_64,r_61_93_45,seq82,r_119_42_64,0.71,-39,25,64,37
19,r_105_111_157,seq125,seq59,r_105_111_157,0.68,7,164,157,37
8,r_126_63_171,r_7_95_22,r_61_93_45,r_126_63_171,0.92,1,172,171,37
89,seq103,r_96_118_129,r_54_70_5,r_96_118_129,0.92,0,129,129,37
3,r_10_19_153,seq116,r_109_18_145,r_10_19_153,0.5,2,155,153,37
10,r_48_81_97,seq43,seq53,r_48_81_97,1.0,1,98,97,37
26,r_33_75_62,seq112,seq86,r_33_75_62,1.0,0,62,62,37
0,r_113_120_169,seq91,r_84_15_29,r_113_120_169,0.6,1,170,169,37
18,r_17_4_23,r_27_37_71,seq101,r_17_4_23,1.0,0,23,23,37
15,r_61_93_45,r_119_42_64,seq56,r_61_93_45,1.0,0,45,45,37
99,seq127,r_126_63_171,r_96_118_129,r_96_118_129,0.94,21,150,129,37
2,r_25_64_143,seq86,seq35,r_25_64_143,0.76,0,143,143,37
47,seq35,r_27_37_71,seq107,r_27_37_71,1.0,2,73,71,37
29,r_87_28_176,seq92,seq80,r_87_28_176,0.72,0,176,176,37
24,r_104_8_89,seq24,r_54_70_5,r_104_8_89,0.92,0,89,89,37
25,r_68_40_158,seq3,seq110,r_68_40_158,0.88,0,158,158,37
33,seq3,r_68_40_158,r_54_70_5,r_68_40_158,0.81,0,158,158,37
70,seq72,r_47_74_135,r_119_42_64,r_119_42_64,1.0,20,84,64,37
1,r_84_15_29,seq72,seq82,r_84_15_29,0.99,0,29,29,37
60,seq56,seq38,r_61_93_45,r_61_93_45,1.0,51,96,45,37
17,r_106_124_150,seq125,r_115_31_2,r_106_124_150,0.66,1,151,150,37
27,r_12_83_52,seq86,r_7_95_22,r_12_83_52,0.99,1,53,52,37
28,r_27_37_71,seq35,seq3,r_27_37_71,1.0,2,73,71,37
7,r_96_118_129,seq103,seq127,r_96_118_129,1.0,0,129,129,37
23,r_14_20_126,seq39,seq101,r_14_20_126,0.94,1,127,126,37
82,seq92,r_87_28_176,r_25_64_143,r_25_64_143,0.81,33,176,143,37
6,r_7_95_22,r_36_121_163,r_108_55_67,r_7_95_22,0.83,1,23,22,37
79,seq86,r_25_64_143,r_33_75_62,r_33_75_62,0.92,81,143,62,37
12,r_16_128_148,r_10_19_153,r_84_15_29,r_84_15_29,0.86,123,152,29,37
11,r_119_42_64,seq82,seq72,r_119_42_64,1.0,0,64,64,37
8,r_7_10_97,seq41,seq44,r_7_10_97,0.97,2,99,97,38
21,r_49_104_100,seq65,seq98,r_49_104_100,0.9,-4,96,100,38
24,r_114_96_31,seq120,seq119,r_114_96_31,0.98,-3,28,31,38
19,r_109_118_12,r_24_46_132,seq35,r_109_118_12,0.98,0,12,12,38
76,seq85,r_83_60_116,seq36,r_83_60_116,1.0,-3,113,116,38
3,r_28_51_184,seq117,r_83_60_116,r_28_51_184,0.38,0,184,184,38
17,r_72_126_40,seq88,seq41,r_72_126_40,1.0,0,40,40,38
10,r_99_4_188,seq23,r_2_62_71,r_2_62_71,0.58,119,190,71,38
4,r_25_33_136,seq57,r_72_126_40,r_25_33_136,0.95,0,136,136,38
0,r_37_20_179,seq44,r_122_15_101,r_122_15_101,0.98,80,181,101,38
48,seq39,r_63_80_148,r_5_32_15,r_5_32_15,1.0,11,26,15,38
20,r_73_53_70,seq45,seq21,r_73_53_70,0.95,5,75,70,38
5,r_5_32_15,r_89_103_193,seq39,r_5_32_15,0.99,-1,14,15,38
13,r_122_15_101,seq50,seq45,r_122_15_101,1.0,-1,100,101,38
15,r_12_106_60,r_121_90_119,seq65,r_12_106_60,0.98,0,60,60,38
6,r_121_90_119,seq38,seq67,r_121_90_119,1.0,0,119,119,38
27,r_83_60_116,seq85,seq77,r_83_60_116,0.99,2,118,116,38
2,r_24_46_132,seq64,r_49_104_100,r_24_46_132,0.98,0,132,132,38
47,seq38,r_121_90_119,r_63_80_148,r_121_90_119,0.88,0,119,119,38
18,r_78_100_114,seq23,seq65,r_78_100_114,1.0,0,114,114,38
29,r_22_29_81,seq112,seq128,r_22_29_81,1.0,5,86,81,38
7,r_116_129_32,r_72_126_40,seq57,r_116_129_32,1.0,-4,28,32,38
11,r_27_47_43,seq59,seq120,r_27_47_43,1.0,0,43,43,38
65,seq65,r_49_104_100,r_12_106_60,r_12_106_60,0.96,38,98,60,38
1,r_91_124_38,seq9,r_72_126_40,r_72_126_40,0.75,-2,38,40,38
45,seq35,seq97,r_109_118_12,r_109_118_12,1.0,0,12,12,38
94,seq117,r_28_51_184,r_116_129_32,r_116_129_32,0.99,152,184,32,38
22,r_2_62_71,seq120,seq67,r_2_62_71,1.0,0,71,71,38
28,r_102_75_141,r_37_20_179,seq79,r_102_75_141,0.99,0,141,141,38
33,seq9,r_91_124_38,seq65,r_91_124_38,0.53,11,49,38,38
56,seq50,r_122_15_101,seq67,r_122_15_101,1.0,-1,100,101,38
23,r_13_70_82,seq74,seq120,r_13_70_82,1.0,1,83,82,38
84,seq98,seq74,r_49_104_100,r_49_104_100,1.0,19,119,100,38
28,r_48_83_43,seq62,r_99_116_160,r_48_83_43,1.0,0,43,43,39
6,r_34_74_84,seq84,seq114,r_34_74_84,0.93,0,84,84,39
14,r_66_54_136,r_100_0_55,r_63_126_51,r_66_54_136,0.84,0,136,136,39
29,r_75_28_44,r_29_45_75,seq69,r_75_28_44,1.0,1,45,44,39
8,r_71_42_97,seq3,seq46,r_71_42_97,1.0,0,97,97,39
54,seq40,r_77_64_102,r_72_104_190,r_72_104_190,0.24,-88,102,190,39
83,seq96,r_81_91_113,seq3,r_81_91_113,1.0,0,113,113,39
16,r_58_118_111,seq90,seq18,r_58_118_111,0.93,1,112,111,39
39,seq17,seq26,r_29_45_75,r_29_45_75,0.69,1,76,75,39
1,r_15_22_53,r_128_111_151,seq24,r_128_111_151,1.0,0,151,151,39
24,r_115_11_41,seq32,seq26,r_115_11_41,1.0,0,41,41,39
19,r_124_27_87,seq24,seq18,r_124_27_87,1.0,0,87,87,39
0,r_100_0_55,r_44_82_115,r_66_54_136,r_100_0_55,0.63,-12,43,55,39
89,seq106,r_68_112_157,seq94,r_68_112_157,0.8,4,161,157,39
3,r_19_13_166,seq12,r_59_37_107,r_59_37_107,0.99,62,169,107,39
5,r_61_30_23,r_100_0_55,seq10,r_61_30_23,0.6,48,71,23,39
26,r_59_37_107,seq24,seq114,r_59_37_107,1.0,0,107,107,39
4,r_7_121_86,seq129,seq1,r_7_121_86,1.0,-1,85,86,39
21,r_73_60_12,r_61_30_23,seq4,r_73_60_12,0.76,1,13,12,39
11,r_81_91_113,seq96,seq40,r_81_91_113,1.0,0,113,113,39
20,r_29_45_75,seq102,seq17,r_29_45_75,0.96,0,75,75,39
13,r_110_65_129,seq90,seq125,r_110_65_129,0.53,4,133,129,39
6,r_34_74_84,r_100_0_55,seq84,r_100_0_55,0.81,13,68,55,39
68,seq69,seq95,r_75_28_44,r_75_28_44,0.96,9,53,44,39
2,r_99_116_160,r_48_83_43,seq3,r_99_116_160,0.52,3,163,160,39
46,seq26,seq35,r_115_11_41,r_115_11_41,0.99,10,51,41,39
0,r_100_0_55,r_66_54_136,seq10,r_66_54_136,1.0,-7,129,136,39
9,r_79_103_20,r_72_104_190,seq84,r_79_103_20,1.0,0,20,20,39
1,r_15_22_53,seq62,r_128_111_151,r_15_22_53,1.0,0,53,53,39
79,seq92,seq1,r_113_14_150,r_113_14_150,0.84,-16,134,150,39
2,r_99_116_160,seq43,r_48_83_43,r_48_83_43,1.0,32,75,43,39
47,seq31,r_113_14_150,r_16_9_104,r_16_9_104,0.86,46,150,104,39
48,seq32,r_115_11_41,seq47,r_115_11_41,1.0,4,45,41,39
25,r_87_108_137,seq4,r_7_121_86,r_87_108_137,0.85,0,137,137,39
5,r_61_30_23,r_68_112_157,r_100_0_55,r_61_30_23,1.0,0,23,23,39
96,seq122,r_58_118_111,seq47,r_58_118_111,0.99,-1,110,111,39
18,r_128_111_151,seq24,r_15_22_53,r_15_22_53,1.0,0,53,53,39
28,r_48_83_43,r_99_116_160,seq43,r_99_116_160,0.82,5,165,160,39
22,r_113_14_150,seq31,seq92,r_113_14_150,0.76,0,150,150,39
54,seq40,r_72_104_190,r_81_91_113,r_81_91_113,0.93,1,114,113,39
7,r_16_9_104,seq6,seq31,r_16_9_104,1.0,0,104,104,39
18,r_128_111_151,r_15_22_53,seq52,r_128_111_151,0.93,0,151,151,39
23,r_77_64_102,seq40,seq20,r_77_64_102,0.82,0,102,102,39
14,r_4_75_137,seq16,r_59_94_55,r_4_75_137,1.0,0,137,137,40
8,r_24_61_110,seq100,seq103,r_24_61_110,1.0,0,110,110,40
83,seq103,seq49,r_24_61_110,r_24_61_110,1.0,13,123,110,40
86,seq106,seq28,r_113_70_111,r_113_70_111,1.0,27,138,111,40
1,r_71_34_87,seq88,seq82,r_71_34_87,0.98,-1,86,87,40
46,seq25,r_64_87_176,r_118_1_58,r_118_1_58,1.0,35,93,58,40
16,r_55_13_25,r_59_94_55,seq58,r_55_13_25,1.0,-1,24,25,40
19,r_39_47_109,seq48,r_81_108_44,r_39_47_109,1.0,0,109,109,40
13,r_93_53_34,r_24_61_110,r_59_94_55,r_93_53_34,1.0,0,34,34,40
3,r_11_40_81,seq105,r_81_108_44,r_11_40_81,1.0,0,81,81,40
10,r_79_120_123,seq45,r_90_56_119,r_79_120_123,0.97,1,124,123,40
26,r_113_70_111,seq15,seq3,r_113_70_111,0.94,0,111,111,40
78,seq88,r_71_34_87,seq51,r_71_34_87,1.0,-13,74,87,40
0,r_81_108_44,seq14,r_11_40_81,r_11_40_81,1.0,5,86,81,40
21,r_118_1_58,seq74,seq25,r_118_1_58,1.0,0,58,58,40
11,r_31_33_117,seq46,seq10,r_31_33_117,0.67,3,120,117,40
22,r_96_78_35,seq26,seq86,r_96_78_35,1.0,-3,32,35,40
15,r_90_56_119,seq65,seq26,r_90_56_119,1.0,0,119,119,40
57,seq45,r_79_120_123,r_59_94_55,r_79_120_123,0.9,1,124,123,40
5,r_19_0_6,seq25,r_99_115_155,r_99_115_155,0.72,0,155,155,40
2,r_89_62_115,seq60,r_55_13_25,r_55_13_25,1.0,109,134,25,40
40,seq17,r_9_35_156,seq92,r_9_35_156,0.86,4,160,156,40
18,r_7_97_160,seq86,r_79_120_123,r_7_97_160,0.79,3,163,160,40
29,r_9_35_156,seq17,seq2,r_9_35_156,0.95,2,158,156,40
24,r_69_38_191,r_98_54_148,r_81_108_44,r_98_54_148,1.0,0,148,148,40
25,r_64_87_176,seq25,seq37,r_64_87_176,0.51,0,176,176,40
20,r_123_107_19,r_118_1_58,seq57,r_123_107_19,0.91,0,19,19,40
77,seq86,r_7_97_160,r_96_78_35,r_96_78_35,0.92,-3,32,35,40
61,seq50,r_9_35_156,seq92,r_9_35_156,0.88,2,158,156,40
9,r_99_115_155,seq58,r_19_0_6,r_99_115_155,0.89,0,155,155,40
6,r_77_129_16,r_39_47_109,seq119,r_77_129_16,0.99,0,16,16,40
7,r_125_66_122,seq41,seq65,r_125_66_122,1.0,0,122,122,40
23,r_98_54_148,r_69_38_191,r_89_62_115,r_98_54_148,0.96,0,148,148,40
64,seq57,r_81_108_44,r_123_107_19,r_123_107_19,1.0,0,19,19,40
12,r_91_36_162,seq126,seq14,r_91_36_162,0.77,0,162,162,40
51,seq41,r_105_93_80,seq115,r_105_93_80,1.0,2,82,80,41
14,r_62_39_79,seq66,r_55_110_3,r_62_39_79,0.47,47,126,79,41
53,seq44,r_108_53_119,seq94,r_108_53_119,1.0,1,120,119,41
5,r_105_93_80,seq41,seq26,r_105_93_80,1.0,2,82,80,41
2,r_22_45_191,r_113_4_176,seq42,r_22_45_191,0.54,-41,150,191,41
2,r_22_45_191,r_12_68_51,seq42,r_12_68_51,0.92,0,51,51,41
31,seq5,seq58,r_111_37_75,r_111_37_75,1.0,34,109,75,41
16,r_33_0_29,r_96_8_138,r_77_64_30,r_33_0_29,0.99,0,29,29,41
67,seq66,r_62_39_79,seq125,r_62_39_79,0.65,80,159,79,41
3,r_112_79_107,r_95_128_180,seq32,r_112_79_107,0.95,0,107,107,41
10,r_6_76_93,seq90,seq46,r_6_76_93,0.99,0,93,93,41
2,r_22_45_191,r_105_93_80,r_113_4_176,r_105_93_80,0.68,27,107,80,41
11,r_70_129_76,r_1_97_116,seq126,r_70_129_76,1.0,0,76,76,41
22,r_12_68_51,r_22_45_191,seq32,r_12_68_51,1.0,0,51,51,41
23,r_43_81_40,r_19_35_189,seq49,r_43_81_40,1.0,1,41,40,41
20,r_7_51_52,r_70_129_76,seq30,r_70_129_76,0.96,-14,62,76,41
25,r_77_64_30,r_6_76_93,r_33_0_29,r_33_0_29,0.61,3,32,29,41
21,r_61_117_44,seq30,r_3_15_150,r_3_15_150,1.0,6,156,150,41
27,r_21_122_118,seq25,seq27,r_21_122_118,0.99,0,118,118,41
24,r_111_37_75,seq73,seq5,r_111_37_75,1.0,0,75,75,41
29,r_101_80_33,r_102_54_98,seq47,r_101_80_33,1.0,2,35,33,41
50,seq40,r_29_71_136,seq11,r_29_71_136,1.0,0,136,136,41
55,seq47,seq42,r_101_80_33,r_101_80_33,1.0,18,51,33,41
80,seq89,r_61_117_44,seq49,r_61_117_44,0.8,7,51,44,41
32,seq10,r_55_110_3,seq58,r_55_110_3,0.49,111,114,3,41
21,r_61_117_44,seq89,seq30,r_61_117_44,0.83,7,51,44,41
26,r_38_116_57,seq27,seq115,r_38_116_57,1.0,0,57,57,41
81,seq90,r_6_76_93,seq13,r_6_76_93,1.0,0,93,93,41
17,r_3_15_150,r_96_8_138,r_108_53_119,r_108_53_119,0.55,19,138,119,41
2,r_22_45_191,seq42,r_105_93_80,r_22_45_191,0.66,-95,96,191,41
28,r_1_97_116,seq119,seq65,r_1_97_116,0.92,0,116,116,41
91,seq115,seq89,r_38_116_57,r_38_116_57,1.0,7,64,57,41
57,seq49,seq23,r_43_81_40,r_43_81_40,1.0,6,46,40,41
17,r_3_15_150,r_108_53_119,r_61_117_44,r_3_15_150,0.91,2,152,150,41
7,r_102_54_98,seq24,seq2,r_102_54_98,0.81,5,103,98,41
12,r_96_8_138,r_3_15_150,seq78,r_96_8_138,0.97,1,139,138,41
14,r_10_36_183,seq113,r_72_102_15,r_10_36_183,0.69,0,183,183,42
7,r_72_102_15,r_38_43_148,seq39,r_72_102_15,1.0,0,15,15,42
16,r_51_81_171,seq116,seq32,r_51_81_171,0.64,2,173,171,42
21,r_80_82_75,r_11_97_149,seq35,r_80_82_75,1.0,0,75,75,42
5,r_128_4_195,r_14_84_77,r_115_25_70,r_115_25_70,0.91,1,71,70,42
46,seq35,seq101,r_80_82_75,r_80_82_75,1.0,7,82,75,42
90,seq113,r_10_36_183,r_89_44_22,r_89_44_22,0.98,1,23,22,42
80,seq95,r_88_19_62,seq7,r_88_19_62,0.72,94,156,62,42
66,seq65,seq109,r_38_43_148,r_38_43_148,1.0,3,151,148,42
4,r_103_91_135,seq52,seq35,r_103_91_135,0.81,7,142,135,42
0,r_41_73_124,seq24,seq39,r_41_73_124,0.75,0,124,124,42
11,r_37_22_87,seq96,seq50,r_37_22_87,1.0,0,87,87,42
13,r_38_43_148,seq111,seq65,r_38_43_148,0.88,0,148,148,42
15,r_71_129_175,seq116,r_76_74_134,r_76_74_134,0.65,42,176,134,42
6,r_88_19_62,seq95,seq96,r_88_19_62,0.73,0,62,62,42
22,r_89_44_22,r_76_74_134,seq113,r_89_44_22,0.99,0,22,22,42
27,r_115_25_70,seq42,r_128_4_195,r_115_25_70,1.0,0,70,70,42
12,r_106_30_41,seq92,seq7,r_106_30_41,1.0,0,41,41,42
18,r_14_84_77,r_128_4_195,r_9_28_55,r_9_28_55,1.0,12,67,55,42
29,r_11_97_149,seq17,seq59,r_11_97_149,0.98,0,149,149,42
24,r_117_3_79,seq50,seq83,r_117_3_79,0.79,0,79,79,42
25,r_63_21_128,seq5,r_72_102_15,r_72_102_15,0.6,117,132,15,42
88,seq111,r_38_43_148,seq68,r_38_43_148,0.92,-5,143,148,42
77,seq92,r_106_30_41,seq86,r_106_30_41,1.0,-4,37,41,42
68,seq67,seq64,r_118_69_125,r_118_69_125,0.51,11,136,125,42
32,seq7,r_88_19_62,r_106_30_41,r_106_30_41,1.0,21,62,41,42
19,r_1_100_50,seq23,seq26,r_1_100_50,0.75,0,50,50,42
17,r_75_0_170,seq17,r_103_91_135,r_75_0_170,0.6,0,170,170,42
28,r_6_105_78,seq39,seq125,r_6_105_78,1.0,0,78,78,42
84,seq107,seq67,r_79_54_34,r_79_54_34,0.57,131,165,34,42
49,seq42,r_115_25_70,r_126_98_140,r_115_25_70,1.0,0,70,70,42
16,r_5_1_16,r_127_39_127,seq105,r_5_1_16,0.58,-1,15,16,43
14,r_74_17_81,seq13,seq69,r_74_17_81,0.96,0,81,81,43
8,r_63_57_175,seq118,r_82_111_70,r_63_57_175,0.74,0,175,175,43
43,seq25,r_112_15_95,seq94,r_112_15_95,1.0,-17,78,95,43
42,seq24,r_84_65_52,seq11,r_84_65_52,1.0,0,52,52,43
59,seq54,r_100_8_141,seq115,r_100_8_141,1.0,0,141,141,43
2,r_32_48_33,r_100_8_141,r_45_72_126,r_32_48_33,1.0,0,33,33,43
55,seq49,seq97,r_5_1_16,r_5_1_16,0.52,133,149,16,43
71,seq75,seq19,r_2_113_56,r_2_113_56,0.99,68,124,56,43
1,r_45_72_126,seq61,seq7,r_45_72_126,0.99,1,127,126,43
31,seq4,r_120_107_163,seq30,r_120_107_163,0.95,0,163,163,43
3,r_2_113_56,seq41,seq75,r_2_113_56,0.78,6,62,56,43
10,r_102_96_79,r_66_21_151,seq125,r_102_96_79,1.0,0,79,79,43
2,r_32_48_33,r_45_72_126,r_84_65_52,r_32_48_33,0.68,53,86,33,43
11,r_101_20_55,r_120_107_163,seq52,r_101_20_55,1.0,0,55,55,43
0,r_62_79_104,r_91_128_176,seq26,r_62_79_104,0.92,1,105,104,43
20,r_91_128_176,seq7,r_74_17_81,r_91_128_176,0.57,0,176,176,43
98,seq124,r_82_111_70,seq42,r_82_111_70,1.0,4,74,70,43
15,r_120_107_163,seq4,seq125,r_120_107_163,0.65,0,163,163,43
17,r_84_65_52,seq24,r_32_48_33,r_84_65_52,1.0,0,52,52,43
6,r_127_39_127,seq53,seq29,r_127_39_127,0.58,0,127,127,43
99,seq125,seq11,r_102_96_79,r_102_96_79,0.98,2,81,79,43
18,r_85_58_187,r_27_103_195,r_5_1_16,r_85_58_187,0.21,2,189,187,43
24,r_82_111_70,seq124,seq35,r_82_111_70,1.0,3,73,70,43
58,seq53,r_127_39_127,seq106,r_127_39_127,0.81,0,127,127,43
32,seq6,seq78,r_95_34_100,r_95_34_100,1.0,21,121,100,43
34,seq10,seq78,r_60_47_82,r_60_47_82,1.0,33,115,82,43
94,seq118,r_63_57_175,seq18,r_63_57_175,0.79,0,175,175,43
28,r_95_34_100,seq99,seq10,r_95_34_100,0.96,1,101,100,43
44,seq26,seq73,r_62_79_104,r_62_79_104,1.0,8,112,104,43
23,r_116_46_143,seq108,r_45_72_126,r_45_72_126,1.0,19,145,126,43
19,r_3_121_37,seq4,seq18,r_3_121_37,1.0,0,37,37,43
12,r_60_47_82,seq14,seq10,r_60_47_82,0.99,0,82,82,43
51,seq31,r_83_17_186,r_41_69_187,r_83_17_186,0.32,0,186,186,44
14,r_35_46_96,seq84,r_100_79_43,r_35_46_96,0.89,1,97,96,44
8,r_22_3_61,seq61,seq102,r_22_3_61,1.0,1,62,61,44
43,seq20,seq5,r_117_24_85,r_117_24_85,0.98,0,85,85,44
3,r_107_99_34,seq26,seq72,r_107_99_34,1.0,1,35,34,44
13,r_100_79_43,r_121_104_102,seq115,r_100_79_43,1.0,0,43,43,44
59,seq52,r_124_85_155,seq6,r_124_85_155,0.54,0,155,155,44
21,r_63_55_68,seq86,seq19,r_63_55_68,1.0,0,68,68,44
69,seq66,r_51_37_145,r_92_128_195,r_51_37_145,0.91,0,145,145,44
11,r_87_2_50,r_101_96_185,r_119_33_6,r_87_2_50,1.0,0,50,50,44
19,r_90_129_147,seq95,r_121_104_102,r_121_104_102,0.99,48,150,102,44
41,seq18,seq108,r_50_40_41,r_50_40_41,0.98,34,75,41,44
50,seq30,r_117_24_85,r_119_33_6,r_117_24_85,0.61,-65,20,85,44
26,r_117_24_85,seq25,seq20,r_117_24_85,1.0,0,85,85,44
18,r_11_23_37,r_83_17_186,seq84,r_11_23_37,0.88,12,49,37,44
4,r_97_15_151,seq38,seq59,r_97_15_151,0.91,0,151,151,44
78,seq80,seq14,r_93_70_79,r_93_70_79,1.0,14,93,79,44
63,seq59,seq108,r_67_122_54,r_67_122_54,1.0,11,65,54,44
20,r_42_36_130,seq21,r_67_122_54,r_42_36_130,0.84,0,130,130,44
33,seq5,r_50_40_41,seq9,r_50_40_41,1.0,0,41,41,44
15,r_111_44_133,r_103_32_119,r_93_70_79,r_111_44_133,0.57,-12,121,133,44
85,seq95,r_90_129_147,r_103_32_119,r_103_32_119,1.0,31,150,119,44
27,r_124_85_155,seq52,r_91_94_94,r_124_85_155,0.96,0,155,155,44
2,r_91_94_94,r_90_129_147,seq13,r_91_94_94,1.0,0,94,94,44
10,r_50_40_41,seq5,seq108,r_50_40_41,1.0,0,41,41,44
25,r_51_37_145,seq66,seq120,r_51_37_145,0.73,0,145,145,44
29,r_67_122_54,r_117_24_85,seq59,r_67_122_54,1.0,2,56,54,44
52,seq38,r_97_15_151,seq64,r_97_15_151,1.0,0,151,151,44
69,seq66,r_92_128_195,r_56_7_83,r_56_7_83,0.57,83,166,83,44
15,r_111_44_133,r_93_70_79,seq81,r_93_70_79,0.55,54,133,79,44
13,r_100_79_43,seq115,r_35_46_96,r_35_46_96,1.0,2,98,96,44
17,r_34_16_115,seq6,seq115,r_34_16_115,0.98,0,115,115,44
34,seq6,r_50_40_41,r_97_15_151,r_97_15_151,0.9,16,167,151,44
9,r_76_57_64,seq81,seq105,r_76_57_64,0.48,11,75,64,44
22,r_93_70_79,seq13,seq39,r_93_70_79,0.97,0,79,79,44
5,r_125_127_49,seq113,seq116,r_125_127_49,1.0,0,49,49,44
79,seq81,r_76_57_64,r_111_44_133,r_111_44_133,1.0,14,147,133,44
12,r_121_104_102,seq116,seq88,r_121_104_102,1.0,0,102,102,44
14,r_77_78_63,seq14,r_93_72_94,r_93_72_94,0.89,1,95,94,45
8,r_122_0_148,seq46,seq28,r_122_0_148,0.78,0,148,148,45
19,r_127_103_182,r_75_2_82,r_126_60_26,r_127_103_182,0.55,0,182,182,45
86,seq101,seq17,r_105_111_123,r_105_111_123,1.0,4,127,123,45
39,seq17,r_1_95_107,seq101,r_1_95_107,1.0,0,107,107,45
1,r_41_106_112,seq109,seq74,r_41_106_112,0.92,0,112,112,45
5,r_121_53_190,seq46,r_100_26_157,r_121_53_190,0.54,0,190,190,45
46,seq28,seq5,r_19_112_34,r_19_112_34,1.0,114,148,34,45
19,r_127_103_182,seq74,r_75_2_82,r_75_2_82,1.0,2,84,82,45
3,r_93_72_94,seq107,r_77_78_63,r_93_72_94,0.99,0,94,94,45
10,r_61_34_93,r_7_6_177,r_90_94_7,r_7_6_177,0.73,1,178,177,45
70,seq74,r_19_112_34,seq92,r_19_112_34,1.0,-2,32,34,45
72,seq79,r_67_12_116,seq28,r_67_12_116,0.97,0,116,116,45
0,r_96_102_80,seq59,seq117,r_96_102_80,0.94,4,84,80,45
20,r_18_66_184,seq8,seq9,r_18_66_184,0.37,0,184,184,45
13,r_82_73_60,seq92,seq86,r_82_73_60,1.0,0,60,60,45
15,r_32_68_154,seq119,r_75_2_82,r_32_68_154,0.94,0,154,154,45
21,r_29_11_50,seq110,seq70,r_29_11_50,1.0,0,50,50,45
6,r_75_2_82,seq25,r_127_103_182,r_75_2_82,1.0,0,82,82,45
12,r_126_60_26,r_19_112_34,seq76,r_126_60_26,1.0,0,26,26,45
99,seq125,r_23_10_100,seq3,r_23_10_100,1.0,-10,90,100,45
16,r_19_112_34,seq74,seq28,r_19_112_34,1.0,0,34,34,45
27,r_114_116_141,seq86,seq8,r_114_116_141,1.0,0,141,141,45
2,r_105_111_123,seq85,seq101,r_105_111_123,1.0,1,124,123,45
18,r_23_10_100,seq125,seq5,r_23_10_100,0.86,0,100,100,45
29,r_4_88_89,r_44_55_150,seq21,r_4_88_89,0.53,2,91,89,45
6,r_75_2_82,r_127_103_182,r_32_68_154,r_32_68_154,0.61,28,182,154,45
77,seq85,r_105_111_123,seq20,r_105_111_123,0.99,6,129,123,45
34,seq8,r_18_66_184,r_114_116_141,r_114_116_141,0.99,43,184,141,45
17,r_1_95_107,seq17,r_23_10_100,r_1_95_107,0.98,2,109,107,45
9,r_100_26_157,seq54,seq27,r_100_26_157,0.42,0,157,157,45
18,r_23_10_100,seq5,r_1_95_107,r_1_95_107,0.47,21,128,107,45
22,r_7_6_177,r_61_34_93,seq54,r_7_6_177,0.68,1,178,177,45
28,r_67_12_116,seq79,seq21,r_67_12_116,1.0,0,116,116,45
7,r_45_63_185,seq56,r_41_106_112,r_45_63_185,0.56,0,185,185,45
36,seq9,r_0_88_112,seq63,r_0_88_112,1.0,0,112,112,46
14,r_4_118_140,r_95_114_186,seq86,r_4_118_140,0.8,1,141,140,46
8,r_33_47_132,seq80,seq30,r_33_47_132,0.92,2,134,132,46
21,r_124_38_114,seq85,seq39,r_124_38_114,1.0,0,114,114,46
1,r_54_17_74,seq30,seq57,r_54_17_74,0.98,4,78,74,46
27,r_51_94_23,r_1_15_152,seq104,r_51_94_23,0.97,0,23,23,46
19,r_0_88_112,seq9,seq87,r_0_88_112,0.98,0,112,112,46
10,r_74_48_188,seq10,seq68,r_74_48_188,0.37,0,188,188,46
26,r_76_50_134,seq22,seq67,r_76_50_134,0.99,0,134,134,46
78,seq86,seq69,r_4_118_140,r_4_118_140,0.75,1,141,140,46
20,r_1_15_152,seq67,seq27,r_1_15_152,0.9,0,152,152,46
13,r_26_60_100,r_5_71_82,r_54_17_74,r_5_71_82,0.52,1,83,82,46
15,r_81_99_150,seq25,seq21,r_81_99_150,0.57,4,154,150,46
48,seq30,r_54_17_74,r_73_90_127,r_54_17_74,1.0,4,78,74,46
17,r_98_105_33,seq87,seq25,r_98_105_33,1.0,0,33,33,46
6,r_79_82_163,seq69,r_120_91_95,r_79_82_163,0.44,4,167,163,46
2,r_65_16_148,seq9,seq97,r_65_16_148,0.81,0,148,148,46
18,r_66_113_113,seq93,seq70,r_66_113_113,0.99,1,114,113,46
24,r_73_90_127,seq30,r_103_121_30,r_73_90_127,0.68,0,127,127,46
68,seq68,r_19_8_174,seq63,r_19_8_174,0.96,-83,91,174,46
77,seq85,r_19_8_174,r_103_121_30,r_103_121_30,0.88,144,174,30,46
11,r_103_121_30,seq59,seq63,r_103_121_30,1.0,0,30,30,46
94,seq116,r_19_8_174,seq128,r_19_8_174,0.98,-71,103,174,46
0,r_61_75_21,seq129,seq70,r_61_75_21,0.99,0,21,21,46
9,r_42_45_185,seq3,r_52_108_109,r_52_108_109,0.94,76,185,109,46
22,r_127_24_103,seq6,seq72,r_127_24_103,0.88,7,110,103,46
48,seq30,r_73_90_127,r_33_47_132,r_73_90_127,0.73,0,127,127,46
28,r_29_28_83,r_52_108_109,seq3,r_29_28_83,1.0,0,83,83,46
84,seq97,seq72,r_65_16_148,r_65_16_148,0.97,5,153,148,46
13,r_26_60_100,r_54_17_74,seq40,r_26_60_100,0.98,0,100,100,46
49,seq31,r_26_60_100,r_127_24_103,r_26_60_100,0.97,-4,96,100,46
7,r_120_91_95,seq93,seq25,r_120_91_95,0.97,0,95,95,46
23,r_52_108_109,seq64,seq7,r_52_108_109,1.0,1,110,109,46
12,r_109_123_158,r_19_8_174,seq96,r_109_123_158,0.65,0,158,158,46
84,seq97,r_5_71_82,seq72,r_5_71_82,1.0,-10,72,82,46
14,r_36_120_45,r_52_27_27,seq105,r_36_120_45,1.0,0,45,45,47
83,seq105,seq10,r_118_102_10,r_118_102_10,1.0,1,11,10,47
17,r_63_4_14,seq21,seq106,r_63_4_14,1.0,0,14,14,47
1,r_57_20_121,r_13_97_183,r_11_15_111,r_13_97_183,1.0,-61,122,183,47
80,seq98,seq26,r_6_86_101,r_6_86_101,0.87,7,108,101,47
19,r_113_83_70,seq107,seq18,r_113_83_70,1.0,1,71,70,47
5,r_51_108_52,seq23,r_117_50_19,r_117_50_19,0.66,33,52,19,47
95,seq122,r_24_56_188,r_101_34_63,r_101_34_63,1.0,125,188,63,47
3,r_71_55_131,seq77,seq58,r_71_55_131,0.84,3,134,131,47
11,r_69_61_96,seq116,seq37,r_69_61_96,1.0,0,96,96,47
13,r_44_92_74,seq106,seq22,r_44_92_74,1.0,0,74,74,47
21,r_53_67_124,seq22,r_51_108_52,r_51_108_52,0.82,1,53,52,47
12,r_117_50_19,r_53_67_124,r_51_108_52,r_53_67_124,1.0,-32,92,124,47
6,r_11_15_111,r_80_19_152,seq93,r_11_15_111,0.9,0,111,111,47
21,r_53_67_124,r_51_108_52,r_101_34_63,r_53_67_124,0.98,0,124,124,47
27,r_45_89_94,seq128,seq33,r_45_89_94,1.0,1,95,94,47
12,r_117_50_19,r_12_129_76,r_53_67_124,r_117_50_19,0.99,1,20,19,47
4,r_12_129_76,r_9_0_46,seq121,r_9_0_46,0.97,3,49,46,47
2,r_101_34_63,seq28,seq122,r_101_34_63,1.0,0,63,63,47
29,r_6_86_101,seq39,seq98,r_6_86_101,0.87,6,107,101,47
85,seq107,r_113_83_70,seq121,r_113_83_70,1.0,-17,53,70,47
24,r_118_102_10,seq37,seq105,r_118_102_10,0.96,0,10,10,47
9,r_84_88_166,seq90,seq37,r_84_88_166,0.97,1,167,166,47
22,r_82_5_116,seq32,r_57_20_121,r_82_5_116,0.77,20,136,116,47
23,r_76_94_88,r_80_19_152,seq58,r_76_94_88,0.85,1,89,88,47
35,seq8,r_30_60_184,seq31,r_30_60_184,0.47,2,186,184,47
93,seq118,r_38_124_188,r_83_111_166,r_83_111_166,0.92,22,188,166,48
14,r_92_72_88,r_16_40_106,seq67,r_16_40_106,0.91,-17,89,106,48
8,r_16_40_106,seq103,r_14_60_68,r_16_40_106,0.83,1,107,106,48
53,seq36,seq105,r_3_71_118,r_3_71_118,0.96,2,120,118,48
83,seq99,seq53,r_35_52_89,r_35_52_89,0.93,2,91,89,48
37,seq12,seq53,r_41_5_148,r_41_5_148,0.69,-2,146,148,48
21,r_83_111_166,seq76,seq118,r_83_111_166,0.86,0,166,166,48
46,seq26,r_21_119_51,seq30,r_21_119_51,0.36,98,149,51,48
95,seq121,r_6_78_160,r_45_77_64,r_45_77_64,0.66,87,151,64,48
10,r_69_115_107,seq108,r_95_44_36,r_69_115_107,0.97,1,108,107,48
0,r_38_124_188,seq118,seq22,r_38_124_188,0.41,0,188,188,48
11,r_39_9_153,r_58_89_157,r_95_44_36,r_39_9_153,0.49,2,155,153,48
23,r_68_63_41,r_98_80_102,seq76,r_68_63_41,0.81,0,41,41,48
13,r_98_80_102,seq19,seq56,r_98_80_102,0.98,2,104,102,48
15,r_84_23_63,r_38_124_188,seq46,r_84_23_63,1.0,0,63,63,48
57,seq46,seq13,r_84_23_63,r_84_23_63,1.0,1,64,63,48
6,r_35_52_89,seq28,seq12,r_35_52_89,0.73,3,92,89,48
2,r_14_60_68,r_35_52_89,seq0,r_35_52_89,1.0,-18,71,89,48
87,seq106,r_98_80_102,r_79_107_19,r_98_80_102,0.66,-63,39,102,48
18,r_45_77_64,seq24,seq121,r_45_77_64,0.97,0,64,64,48
24,r_101_25_114,seq67,r_95_44_36,r_101_25_114,0.75,0,114,114,48
25,r_81_42_183,seq28,seq43,r_81_42_183,0.67,0,183,183,48
20,r_21_119_51,seq30,seq26,r_21_119_51,0.57,-13,38,51,48
3,r_79_107_19,seq48,r_95_44_36,r_95_44_36,0.57,40,76,36,48
3,r_79_107_19,r_66_100_14,seq48,r_79_107_19,0.72,2,21,19,48
4,r_95_44_36,r_21_119_51,seq19,r_95_44_36,0.77,0,36,36,48
17,r_58_89_157,seq0,seq59,r_58_89_157,0.53,0,157,157,48
94,seq120,r_112_55_132,seq74,r_112_55_132,1.0,-43,89,132,48
9,r_3_71_118,seq11,seq36,r_3_71_118,0.89,4,122,118,48
22,r_102_49_113,seq76,seq70,r_102_49_113,0.91,3,116,113,48
28,r_41_5_148,seq1,seq12,r_41_5_148,0.67,-2,146,148,48
7,r_6_78_160,seq121,r_95_44_36,r_6_78_160,0.62,0,160,160,48
12,r_112_55_132,seq120,seq1,r_112_55_132,0.99,0,132,132,48
5,r_24_56_51,r_110_72_118,seq64,r_24_56_51,1.0,0,51,51,49
28,r_113_28_15,seq124,seq108,r_113_28_15,0.86,0,15,15,49
14,r_79_86_128,seq87,r_65_78_75,r_79_86_128,0.61,1,129,128,49
16,r_111_85_101,seq125,seq114,r_111_85_101,0.97,0,101,101,49
21,r_128_90_127,seq45,seq39,r_128_90_127,0.95,2,129,127,49
1,r_23_5_174,seq12,seq1,r_23_5_174,0.74,2,176,174,49
19,r_126_0_184,seq96,r_71_62_109,r_71_62_109,0.62,75,184,109,49
87,seq108,r_7_77_173,r_113_28_15,r_7_77_173,0.57,-114,59,173,49
3,r_110_72_118,seq45,r_107_102_13,r_110_72_118,0.51,2,120,118,49
90,seq117,seq69,r_35_8_57,r_35_8_57,1.0,7,64,57,49
26,r_116_36_136,seq33,r_107_102_13,r_116_36_136,0.54,0,136,136,49
4,r_65_78_75,seq21,seq84,r_65_78_75,1.0,1,76,75,49
0,r_81_76_144,seq125,r_3_38_25,r_81_76_144,0.55,0,144,144,49
11,r_63_20_67,seq106,seq87,r_63_20_67,0.99,0,67,67,49
20,r_60_59_140,r_99_34_180,seq127,r_60_59_140,0.97,0,140,140,49
13,r_51_100_87,r_126_0_184,seq101,r_51_100_87,1.0,0,87,87,49
6,r_15_13_123,seq39,seq58,r_15_13_123,0.91,0,123,123,49
18,r_47_14_141,seq125,seq74,r_47_14_141,0.95,1,142,141,49
29,r_109_41_179,seq40,r_95_112_94,r_95_112_94,0.98,88,182,94,49
25,r_35_8_57,seq29,seq117,r_35_8_57,1.0,7,64,57,49
65,seq58,seq42,r_15_13_123,r_15_13_123,0.99,20,143,123,49
8,r_68_89_37,seq9,seq125,r_68_89_37,1.0,0,37,37,49
24,r_18_97_34,r_103_43_56,seq33,r_18_97_34,1.0,0,34,34,49
2,r_82_104_53,r_47_14_141,seq96,r_82_104_53,0.88,0,53,53,49
17,r_27_92_171,seq50,r_65_78_75,r_65_78_75,1.0,96,171,75,49
9,r_103_43_56,seq87,seq17,r_103_43_56,0.97,4,60,56,49
56,seq45,r_110_72_118,seq10,r_110_72_118,0.92,2,120,118,49
23,r_95_112_94,seq49,seq9,r_95_112_94,1.0,0,94,94,49
82,seq96,r_126_0_184,r_82_104_53,r_82_104_53,0.83,131,184,53,49
10,r_3_38_25,r_51_100_87,seq45,r_51_100_87,0.92,-60,27,87,49
12,r_71_62_109,seq69,seq2,r_71_62_109,1.0,0,109,109,49
84,seq101,seq94,r_51_100_87,r_51_100_87,1.0,18,105,87,49
14,r_83_32_42,seq74,seq101,r_83_32_42,0.43,33,75,42,50
5,r_24_23_27,r_71_30_182,seq108,r_24_23_27,0.93,-1,26,27,50
8,r_88_7_77,seq116,seq90,r_88_7_77,0.84,0,77,77,50
1,r_87_56_61,seq50,seq40,r_87_56_61,0.67,-1,60,61,50
20,r_97_60_192,r_85_129_190,r_24_23_27,r_97_60_192,0.55,-89,103,192,50
0,r_20_92_138,r_27_34_100,r_37_68_32,r_20_92_138,0.97,0,138,138,50
95,seq116,r_88_7_77,seq70,r_88_7_77,0.97,0,77,77,50
76,seq86,seq116,r_20_92_138,r_20_92_138,0.6,-2,136,138,50
2,r_8_81_31,seq9,r_125_28_24,r_8_81_31,0.99,-2,29,31,50
26,r_47_123_121,seq61,seq16,r_47_123_121,0.89,2,123,121,50
4,r_127_62_124,seq2,seq119,r_127_62_124,0.67,8,132,124,50
51,seq39,seq86,r_91_19_169,r_91_19_169,0.9,-10,159,169,50
0,r_20_92_138,seq4,r_27_34_100,r_27_34_100,1.0,24,124,100,50
13,r_80_22_174,seq90,r_97_60_192,r_80_22_174,0.37,1,175,174,50
6,r_125_28_24,seq99,seq33,r_125_28_24,1.0,0,24,24,50
29,r_10_13_26,seq15,seq102,r_10_13_26,0.98,0,26,26,50
15,r_65_52_132,r_69_42_97,r_110_49_28,r_65_52_132,0.84,0,132,132,50
19,r_110_49_28,seq84,seq9,r_110_49_28,0.97,1,29,28,50
10,r_37_68_32,r_96_3_44,seq116,r_37_68_32,0.82,1,33,32,50
40,seq15,r_10_13_26,seq46,r_10_13_26,0.96,0,26,26,50
18,r_35_45_79,seq17,seq33,r_35_45_79,0.73,1,80,79,50
25,r_27_34_100,seq124,seq67,r_27_34_100,1.0,-1,99,100,50
77,seq89,r_85_129_190,r_71_30_182,r_85_129_190,0.31,-9,181,190,50
20,r_97_60_192,r_24_23_27,r_80_22_174,r_97_60_192,0.54,-17,175,192,50
22,r_78_58_103,seq108,r_76_48_4,r_78_58_103,0.95,3,106,103,50
27,r_105_120_41,r_78_58_103,r_110_49_28,r_105_120_41,0.97,0,41,41,50
6,r_127_101_22,seq57,seq87,r_127_101_22,1.0,0,22,22,51
92,seq116,seq42,r_90_110_72,r_90_110_72,1.0,29,101,72,51
13,r_20_13_52,r_23_34_129,seq108,r_20_13_52,1.0,0,52,52,51
71,seq81,seq11,r_112_113_57,r_112_113_57,1.0,37,94,57,51
21,r_117_25_160,seq100,r_121_17_89,r_117_25_160,0.38,-70,90,160,51
5,r_23_34_129,r_16_78_104,seq123,r_16_78_104,0.97,0,104,104,51
19,r_86_120_68,seq51,r_12_46_21,r_86_120_68,0.93,0,68,68,51
3,r_10_97_152,seq114,seq62,r_10_97_152,0.92,0,152,152,51
4,r_65_73_87,seq126,seq48,r_65_73_87,0.96,0,87,87,51
20,r_90_110_72,seq111,seq116,r_90_110_72,0.86,0,72,72,51
15,r_14_66_181,seq111,r_59_45_85,r_59_45_85,0.79,96,181,85,51
27,r_69_89_46,seq11,seq82,r_69_89_46,0.7,9,55,46,51
99,seq126,seq18,r_16_78_104,r_16_78_104,0.99,7,111,104,51
21,r_117_25_160,r_121_17_89,seq51,r_117_25_160,0.96,2,162,160,51
99,seq126,r_1_106_73,seq18,r_1_106_73,1.0,0,73,73,51
8,r_9_47_44,seq43,seq58,r_9_47_44,0.89,0,44,44,51
87,seq108,seq114,r_20_13_52,r_20_13_52,1.0,15,67,52,51
2,r_56_75_194,r_121_17_89,seq21,r_121_17_89,0.56,2,91,89,51
9,r_28_67_47,seq92,seq88,r_28_67_47,1.0,0,47,47,51
53,seq43,r_9_47_44,r_54_39_16,r_9_47_44,0.4,3,47,44,51
0,r_12_46_21,seq71,r_86_120_68,r_86_120_68,0.66,-4,64,68,51
18,r_121_17_89,r_56_75_194,r_117_25_160,r_121_17_89,0.53,2,91,89,51
24,r_37_26_98,r_23_34_129,seq43,r_37_26_98,1.0,3,101,98,51
11,r_15_6_43,seq29,seq102,r_15_6_43,1.0,0,43,43,51
25,r_1_106_73,seq126,seq38,r_1_106_73,0.96,0,73,73,51
64,seq62,r_91_64_179,r_10_97_152,r_10_97_152,0.87,28,180,152,51
42,seq24,r_54_39_16,r_9_47_44,r_9_47_44,0.41,86,130,44,51
17,r_59_45_85,seq94,seq21,r_59_45_85,0.94,0,85,85,51
0,r_12_46_21,seq60,seq71,r_12_46_21,0.93,0,21,21,51
28,r_70_96_127,seq29,r_28_67_47,r_70_96_127,0.98,0,127,127,51
1,r_112_113_57,seq41,seq81,r_112_113_57,1.0,0,57,57,51
7,r_16_78_104,r_23_34_129,seq33,r_16_78_104,0.64,0,104,104,51
18,r_121_17_89,r_117_25_160,seq100,r_117_25_160,0.99,2,162,160,51
23,r_49_27_50,r_95_40_173,seq44,r_49_27_50,1.0,0,50,50,51
53,seq43,r_54_39_16,r_37_26_98,r_37_26_98,1.0,5,103,98,51
82,seq100,r_117_25_160,r_121_17_89,r_117_25_160,0.48,2,162,160,51
30,seq4,r_0_29_108,seq120,r_0_29_108,1.0,0,108,108,52
14,r_59_1_140,r_112_35_160,r_94_64_67,r_112_35_160,0.74,-20,140,160,52
8,r_81_49_143,seq79,r_69_45_47,r_81_49_143,0.96,0,143,143,52
71,seq82,r_74_98_192,r_103_116_63,r_103_116_63,1.0,12,75,63,52
21,r_2_72_128,seq120,seq110,r_2_72_128,0.91,0,128,128,52
5,r_86_38_119,r_58_46_78,seq91,r_58_46_78,0.95,0,78,78,52
13,r_23_6_51,r_0_29_108,seq63,r_23_6_51,1.0,0,51,51,52
95,seq120,r_2_72_128,seq4,r_2_72_128,1.0,0,128,128,52
3,r_0_29_108,seq4,seq18,r_0_29_108,1.0,0,108,108,52
10,r_112_35_160,seq123,seq12,r_112_35_160,0.83,0,160,160,52
26,r_26_7_76,r_96_76_135,seq110,r_26_7_76,1.0,0,76,76,52
18,r_69_45_47,seq56,seq10,r_69_45_47,1.0,2,49,47,52
4,r_94_64_67,r_74_98_192,r_85_66_130,r_74_98_192,0.86,-121,71,192,52
0,r_92_3_120,seq80,seq56,r_92_3_120,0.93,0,120,120,52
98,seq125,r_103_116_63,seq79,r_103_116_63,1.0,1,64,63,52
15,r_33_48_148,seq39,seq125,r_33_48_148,0.82,3,151,148,52
4,r_94_64_67,r_85_66_130,r_59_1_140,r_94_64_67,0.85,74,141,67,52
27,r_103_116_63,seq125,seq82,r_103_116_63,0.96,0,63,63,52
2,r_105_99_167,seq5,r_36_54_146,r_105_99_167,0.91,1,168,167,52
40,seq17,r_107_77_193,r_15_84_35,r_15_84_35,1.0,77,112,35,52
25,r_102_126_162,seq110,r_96_76_135,r_102_126_162,0.75,0,162,162,52
58,seq56,seq22,r_92_3_120,r_92_3_120,1.0,1,121,120,52
5,r_86_38_119,seq91,r_23_6_51,r_86_38_119,1.0,0,119,119,52
9,r_51_44_112,seq42,seq78,r_51_44_112,0.99,0,112,112,52
98,seq125,seq79,r_33_48_148,r_33_48_148,0.89,16,164,148,52
22,r_73_25_62,r_107_77_193,r_53_52_105,r_73_25_62,1.0,0,62,62,52
28,r_36_54_146,seq10,r_51_44_112,r_36_54_146,0.93,0,146,146,52
7,r_58_46_78,r_86_38_119,seq41,r_58_46_78,0.99,0,78,78,52
23,r_85_66_130,r_53_52_105,r_94_64_67,r_85_66_130,0.27,-59,71,130,52
12,r_128_122_109,seq22,seq47,r_128_122_109,1.0,0,109,109,52
23,r_85_66_130,r_94_64_67,seq63,r_85_66_130,0.86,1,131,130,52
1,r_15_84_35,r_33_48_148,seq17,r_15_84_35,0.96,5,40,35,52
8,r_80_28_197,r_49_10_162,seq6,r_49_10_162,0.8,-10,152,162,53
83,seq96,r_33_68_156,r_86_116_154,r_86_116_154,0.74,2,156,154,53
11,r_111_61_10,seq48,seq94,r_111_61_10,1.0,0,10,10,53
16,r_1_122_94,seq7,seq59,r_1_122_94,0.93,0,94,94,53
76,seq85,seq119,r_121_30_100,r_121_30_100,1.0,1,101,100,53
39,seq22,r_92_72_132,seq36,r_92_72_132,0.62,-32,100,132,53
3,r_15_97_172,seq4,seq93,r_15_97_172,0.74,0,172,172,53
26,r_121_30_100,seq59,seq85,r_121_30_100,1.0,0,100,100,53
4,r_92_72_132,seq54,seq2,r_92_72_132,0.97,0,132,132,53
0,r_13_129_141,seq9,seq7,r_13_129_141,0.7,1,142,141,53
20,r_33_68_156,seq96,r_128_16_14,r_128_16_14,0.69,142,156,14,53
13,r_67_87_126,r_92_72_132,seq59,r_67_87_126,0.91,0,126,126,53
6,r_127_99_129,seq42,seq48,r_127_99_129,0.96,0,129,129,53
15,r_51_37_60,r_113_21_38,seq57,r_51_37_60,0.94,-15,45,60,53
51,seq41,r_86_116_154,r_47_71_61,r_47_71_61,0.97,-4,57,61,53
27,r_47_71_61,r_15_97_172,seq41,r_47_71_61,1.0,1,62,61,53
18,r_74_25_185,r_101_77_192,r_111_61_10,r_111_61_10,0.9,175,185,10,53
29,r_8_70_93,seq123,r_120_3_7,r_8_70_93,0.96,4,97,93,53
25,r_0_115_87,seq79,r_11_45_21,r_0_115_87,0.53,0,87,87,53
21,r_18_56_48,seq85,seq91,r_18_56_48,1.0,-1,47,48,53
34,seq7,r_1_122_94,seq109,r_1_122_94,1.0,-27,67,94,53
14,r_113_21_38,seq44,r_89_66_3,r_113_21_38,0.82,-6,32,38,53
22,r_78_108_190,seq125,r_89_66_3,r_78_108_190,0.43,0,190,190,53
79,seq91,seq29,r_18_56_48,r_18_56_48,1.0,1,49,48,53
28,r_49_10_162,r_80_28_197,r_47_71_61,r_49_10_162,0.83,0,162,162,53
81,seq94,r_31_14_186,r_111_61_10,r_111_61_10,0.88,9,19,10,53
7,r_126_32_130,r_19_62_92,seq20,r_126_32_130,0.96,2,132,130,53
23,r_76_107_109,r_15_97_172,seq42,r_76_107_109,0.98,0,109,109,53
17,r_11_45_21,r_15_97_172,seq58,r_11_45_21,0.42,0,21,21,53
8,r_9_107_169,seq19,seq62,r_9_107_169,0.73,0,169,169,54
18,r_2_59_16,r_57_111_145,r_41_34_11,r_2_59_16,0.99,0,16,16,54
83,seq92,r_112_45_186,r_31_120_133,r_112_45_186,0.5,0,186,186,54
21,r_116_8_84,seq110,seq19,r_116_8_84,1.0,0,84,84,54
1,r_87_100_155,seq3,r_124_85_40,r_87_100_155,0.44,2,157,155,54
5,r_55_72_74,seq73,seq40,r_55_72_74,1.0,2,76,74,54
19,r_35_49_182,seq39,r_101_121_152,r_101_121_152,0.45,30,182,152,54
29,r_41_34_11,r_112_45_186,r_2_59_16,r_2_59_16,0.64,0,16,16,54
90,seq110,r_116_8_84,seq17,r_116_8_84,1.0,-5,79,84,54
7,r_42_83_57,seq4,seq70,r_42_83_57,1.0,0,57,57,54
4,r_118_106_91,seq20,seq19,r_118_106_91,0.63,1,92,91,54
0,r_57_111_145,seq65,seq48,r_57_111_145,0.75,0,145,145,54
15,r_124_85_40,r_21_99_146,seq7,r_124_85_40,0.82,0,40,40,54
73,seq73,r_55_72_74,seq48,r_55_72_74,1.0,2,76,74,54
11,r_126_98_127,r_71_27_149,seq4,r_126_98_127,0.65,2,129,127,54
20,r_66_103_101,r_50_5_111,seq110,r_66_103_101,0.98,0,101,101,54
48,seq26,r_21_99_146,seq110,r_21_99_146,0.99,2,148,146,54
6,r_112_45_186,seq92,seq80,r_112_45_186,0.25,0,186,186,54
13,r_52_102_20,seq29,r_31_120_133,r_52_102_20,0.96,-4,16,20,54
27,r_86_56_59,r_21_99_146,seq51,r_86_56_59,0.84,6,65,59,54
25,r_90_108_135,r_21_99_146,seq73,r_90_108_135,0.69,4,139,135,54
68,seq65,r_57_111_145,seq81,r_57_111_145,1.0,0,145,145,54
61,seq51,seq7,r_86_56_59,r_86_56_59,1.0,42,101,59,54
32,seq3,r_87_100_155,seq17,r_87_100_155,0.56,2,157,155,54
77,seq80,r_79_44_104,r_118_106_91,r_79_44_104,0.98,0,104,104,54
60,seq48,seq73,r_68_109_150,r_68_109_150,0.72,-1,149,150,54
9,r_50_5_111,seq47,seq93,r_50_5_111,1.0,0,111,111,54
96,seq122,r_37_58_141,r_126_98_127,r_37_58_141,0.5,0,141,141,54
22,r_79_44_104,seq80,seq110,r_79_44_104,0.96,0,104,104,54
28,r_14_89_166,seq18,seq128,r_14_89_166,0.63,0,166,166,54
73,seq73,seq48,r_90_108_135,r_90_108_135,0.64,1,136,135,54
23,r_68_109_150,seq22,seq48,r_68_109_150,0.69,2,152,150,54
30,seq1,seq123,r_88_2_71,r_88_2_71,1.0,7,78,71,55
51,seq39,seq56,r_40_0_173,r_40_0_173,0.87,2,175,173,55
83,seq92,seq45,r_12_58_50,r_12_58_50,0.7,66,116,50,55
71,seq75,seq123,r_103_69_68,r_103_69_68,0.97,11,79,68,55
21,r_100_70_133,seq47,seq76,r_100_70_133,0.9,0,133,133,55
39,seq21,r_125_63_91,seq76,r_125_63_91,0.87,1,92,91,55
80,seq85,seq65,r_67_127_12,r_67_127_12,0.32,157,169,12,55
2,r_35_111_21,r_73_87_58,seq129,r_35_111_21,1.0,0,21,21,55
95,seq119,r_16_128_128,seq50,r_16_128_128,1.0,0,128,128,55
22,r_72_120_112,r_67_127_12,seq83,r_67_127_12,0.44,88,100,12,55
3,r_16_128_128,seq119,seq30,r_16_128_128,0.91,0,128,128,55
28,r_96_126_45,r_66_36_195,r_67_127_12,r_67_127_12,0.47,8,20,12,55
26,r_74_4_125,seq41,seq29,r_74_4_125,0.94,2,127,125,55
8,r_93_108_35,r_9_113_143,r_72_120_112,r_72_120_112,1.0,77,189,112,55
11,r_116_51_48,r_24_10_161,seq105,r_116_51_48,1.0,0,48,48,55
4,r_11_57_149,seq118,seq105,r_11_57_149,0.9,0,149,149,55
0,r_17_89_75,r_67_127_12,seq124,r_17_89_75,0.99,0,75,75,55
22,r_72_120_112,seq83,r_93_108_35,r_72_120_112,0.96,0,112,112,55
15,r_88_2_71,seq15,seq1,r_88_2_71,1.0,0,71,71,55
6,r_13_114_176,r_3_79_191,seq83,r_3_79_191,0.51,-14,177,191,55
8,r_93_108_35,seq39,r_9_113_143,r_93_108_35,1.0,0,35,35,55
10,r_9_113_143,r_93_108_35,seq15,r_9_113_143,0.47,0,143,143,55
27,r_125_63_91,r_52_60_77,r_74_4_125,r_52_60_77,0.98,0,77,77,55
47,seq30,seq46,r_16_128_128,r_16_128_128,1.0,9,137,128,55
18,r_3_79_191,r_13_114_176,r_73_87_58,r_73_87_58,1.0,64,122,58,55
29,r_8_64_103,r_67_127_12,seq82,r_8_64_103,1.0,0,103,103,55
24,r_94_59_59,seq56,r_61_109_34,r_94_59_59,0.68,6,65,59,55
25,r_103_69_68,seq122,seq97,r_103_69_68,0.95,1,69,68,55
10,r_9_113_143,r_12_58_50,r_93_108_35,r_93_108_35,1.0,3,38,35,55
17,r_40_0_173,seq124,seq39,r_40_0_173,0.4,0,173,173,55
94,seq118,r_11_57_149,seq6,r_11_57_149,0.99,0,149,149,55
9,r_95_117_105,seq99,r_115_34_57,r_95_117_105,0.93,4,109,105,55
1,r_61_109_34,seq123,r_94_59_59,r_61_109_34,0.99,23,57,34,55
5,r_115_34_57,r_24_10_161,seq122,r_115_34_57,0.98,1,58,57,55
27,r_125_63_91,r_74_4_125,seq39,r_125_63_91,0.98,0,91,91,55
23,r_52_60_77,r_125_63_91,r_67_127_12,r_67_127_12,0.91,65,77,12,55
20,r_73_87_58,r_100_70_133,r_3_79_191,r_73_87_58,1.0,0,58,58,55
27,r_106_117_144,r_103_20_154,r_47_111_84,r_106_117_144,0.44,-58,86,144,56
8,r_34_75_120,seq6,seq74,r_34_75_120,0.92,0,120,120,56
55,seq41,r_103_20_154,r_40_115_7,r_103_20_154,0.9,1,155,154,56
21,r_47_111_84,r_68_29_91,r_106_117_144,r_47_111_84,0.99,0,84,84,56
1,r_100_101_180,seq21,seq80,r_100_101_180,0.49,2,182,180,56
5,r_103_20_154,seq41,seq11,r_103_20_154,0.77,1,155,154,56
42,seq19,r_128_104_164,r_91_60_30,r_128_104_164,0.87,0,164,164,56
12,r_91_60_30,r_68_29_91,seq11,r_91_60_30,0.73,0,30,30,56
28,r_79_81_44,r_68_29_91,r_113_83_48,r_79_81_44,1.0,0,44,44,56
3,r_119_129_156,seq56,r_113_83_48,r_113_83_48,1.0,117,165,48,56
10,r_52_31_126,r_108_27_193,r_16_9_60,r_52_31_126,0.96,3,129,126,56
26,r_2_18_34,r_65_30_182,r_68_29_91,r_68_29_91,0.74,91,182,91,56
20,r_108_27_193,r_52_31_126,r_79_81_44,r_108_27_193,0.54,-64,129,193,56
13,r_68_29_91,r_47_111_84,seq69,r_47_111_84,0.95,-3,81,84,56
21,r_47_111_84,r_106_117_144,r_40_115_7,r_106_117_144,0.83,1,145,144,56
27,r_106_117_144,r_47_111_84,r_93_36_112,r_106_117_144,0.99,1,145,144,56
27,r_106_117_144,r_55_107_77,r_103_20_154,r_55_107_77,0.63,-1,76,77,56
6,r_58_42_25,seq24,seq72,r_58_42_25,1.0,0,25,25,56
18,r_82_121_36,r_100_101_180,r_8_46_32,r_82_121_36,1.0,1,37,36,56
68,seq69,seq14,r_68_29_91,r_68_29_91,0.69,4,95,91,56
23,r_90_51_33,r_34_75_120,r_8_46_32,r_90_51_33,0.95,0,33,33,56
24,r_127_57_197,seq12,r_58_42_25,r_58_42_25,1.0,0,25,25,56
9,r_89_5_73,seq1,seq76,r_89_5_73,0.84,0,73,73,56
22,r_55_107_77,r_106_117_144,seq50,r_55_107_77,0.99,0,77,77,56
85,seq96,seq10,r_66_97_10,r_66_97_10,1.0,4,14,10,56
0,r_113_83_48,r_89_5_73,r_108_27_193,r_113_83_48,1.0,0,48,48,56
7,r_78_54_97,seq35,seq70,r_78_54_97,1.0,0,97,97,56
11,r_8_46_32,seq74,seq56,r_8_46_32,0.99,0,32,32,56
6,r_88_25_31,r_53_37_97,seq7,r_88_25_31,0.97,1,32,31,57
22,r_35_105_17,r_85_77_109,seq86,r_35_105_17,1.0,0,17,17,57
39,seq17,seq74,r_33_61_133,r_33_61_133,0.99,12,145,133,57
1,r_70_43_74,seq7,r_85_77_109,r_70_43_74,0.53,13,87,74,57
19,r_41_60_106,seq84,r_49_96_90,r_49_96_90,0.55,8,98,90,57
66,seq78,r_45_4_62,seq14,r_45_4_62,1.0,2,64,62,57
26,r_23_34_45,seq82,seq50,r_23_34_45,1.0,3,48,45,57
3,r_54_26_158,seq48,seq13,r_54_26_158,0.65,0,158,158,57
72,seq86,seq12,r_35_105_17,r_35_105_17,1.0,1,18,17,57
0,r_85_77_109,seq62,r_20_47_35,r_85_77_109,0.93,0,109,109,57
11,r_53_37_97,seq13,seq90,r_53_37_97,1.0,0,97,97,57
66,seq78,seq14,r_0_116_117,r_0_116_117,1.0,0,117,117,57
98,seq126,seq89,r_28_103_153,r_28_103_153,0.58,1,154,153,57
15,r_32_73_146,seq12,r_70_43_74,r_70_43_74,0.75,72,146,74,57
57,seq65,seq125,r_45_4_62,r_45_4_62,1.0,9,71,62,57
21,r_99_117_39,seq56,seq122,r_99_117_39,0.92,1,40,39,57
1,r_70_43_74,r_85_77_109,r_2_16_123,r_70_43_74,0.99,49,123,74,57
2,r_28_103_153,seq76,seq126,r_28_103_153,0.31,0,153,153,57
47,seq50,seq1,r_23_34_45,r_23_34_45,1.0,8,53,45,57
40,seq22,r_2_16_123,seq92,r_2_16_123,1.0,-13,110,123,57
24,r_0_116_117,seq31,seq78,r_0_116_117,0.99,0,117,117,57
25,r_124_64_129,seq52,r_45_4_62,r_124_64_129,0.64,0,129,129,57
5,r_97_83_18,seq12,seq95,r_97_83_18,0.77,0,18,18,57
4,r_121_38_38,r_45_4_62,seq92,r_121_38_38,1.0,0,38,38,57
17,r_33_61_133,seq51,seq17,r_33_61_133,0.96,0,133,133,57
10,r_71_18_47,r_2_16_123,seq56,r_71_18_47,0.56,0,47,47,57
9,r_2_16_123,seq22,r_70_43_74,r_2_16_123,1.0,0,123,123,57
16,r_20_47_35,r_36_11_184,seq106,r_20_47_35,0.86,0,35,35,57
28,r_72_107_92,seq27,seq98,r_72_107_92,1.0,1,93,92,57
7,r_29_44_82,seq17,seq106,r_29_44_82,0.99,4,86,82,57
23,r_45_4_62,seq78,seq65,r_45_4_62,1.0,0,62,62,57
12,r_49_96_90,r_28_103_153,seq40,r_49_96_90,0.9,0,90,90,57
30,seq1,seq37,r_123_96_28,r_123_96_28,1.0,47,75,28,58
51,seq36,r_52_76_117,r_60_48_62,r_52_76_117,0.54,4,121,117,58
94,seq118,seq54,r_107_71_18,r_107_71_18,1.0,7,25,18,58
16,r_125_72_144,seq122,seq55,r_125_72_144,0.94,0,144,144,58
21,r_52_76_117,seq79,seq45,r_52_76_117,0.91,2,119,117,58
1,r_46_27_127,seq31,seq8,r_46_27_127,0.81,0,127,127,58
15,r_84_106_41,r_20_110_158,seq114,r_84_106_41,1.0,0,41,41,58
3,r_20_110_158,seq13,r_57_119_109,r_20_110_158,0.69,0,158,158,58
26,r_92_39_84,seq85,seq26,r_92_39_84,0.99,0,84,84,58
4,r_128_25_151,r_74_38_149,seq31,r_128_25_151,0.57,0,151,151,58
13,r_87_67_112,seq44,seq10,r_87_67_112,1.0,0,112,112,58
10,r_123_96_28,r_66_42_135,seq37,r_123_96_28,1.0,0,28,28,58
6,r_57_119_109,seq14,seq122,r_57_119_109,0.99,0,109,109,58
20,r_107_71_18,r_64_15_199,seq118,r_107_71_18,1.0,0,18,18,58
5,r_11_0_50,r_4_41_169,seq70,r_11_0_50,1.0,0,50,50,58
18,r_66_42_135,r_56_97_173,r_95_63_13,r_66_42_135,0.85,1,136,135,58
29,r_60_48_62,seq75,seq31,r_60_48_62,0.97,1,63,62,58
52,seq37,seq1,r_123_96_28,r_123_96_28,1.0,17,45,28,58
50,seq35,r_111_100_138,seq31,r_111_100_138,0.98,0,138,138,58
61,seq55,seq70,r_125_72_144,r_125_72_144,0.96,-1,143,144,58
2,r_129_88_24,seq55,r_107_71_18,r_129_88_24,1.0,1,25,24,58
75,seq85,r_92_39_84,r_104_93_6,r_92_39_84,1.0,0,84,84,58
17,r_16_69_120,seq89,seq10,r_16_69_120,0.99,0,120,120,58
12,r_18_43_58,seq86,seq61,r_18_43_58,0.81,0,58,58,58
7,r_101_23_71,r_66_42_135,seq126,r_66_42_135,0.85,-63,72,135,58
23,r_74_38_149,r_128_25_151,r_107_71_18,r_74_38_149,0.87,1,150,149,58
8,r_95_63_13,seq10,seq124,r_95_63_13,0.99,0,13,13,58
28,r_77_7_23,r_65_104_149,seq39,r_77_7_23,0.78,4,27,23,59
14,r_89_121_119,seq31,seq29,r_89_121_119,0.95,0,119,119,59
9,r_35_5_34,r_67_43_190,seq15,r_35_5_34,1.0,0,34,34,59
37,seq12,r_110_103_181,seq122,r_110_103_181,0.71,-28,153,181,59
55,seq47,r_125_9_193,seq71,r_125_9_193,0.88,-29,164,193,59
21,r_32_126_189,seq118,r_23_24_51,r_23_24_51,0.71,139,190,51,59
97,seq123,r_36_74_184,seq42,r_36_74_184,0.51,0,184,184,59
19,r_56_73_76,seq86,seq119,r_56_73_76,1.0,0,76,76,59
67,seq68,r_17_116_151,seq127,r_17_116_151,0.98,0,151,151,59
26,r_33_8_81,r_69_40_96,seq31,r_33_8_81,1.0,1,82,81,59
1,r_23_24_51,seq61,seq85,r_23_24_51,0.99,1,52,51,59
73,seq81,r_58_38_172,r_82_54_83,r_82_54_83,0.99,91,174,83,59
39,seq15,seq53,r_35_5_34,r_35_5_34,1.0,15,49,34,59
20,r_30_41_3,r_69_40_96,seq34,r_69_40_96,0.94,0,96,96,59
13,r_83_128_104,r_93_78_78,seq63,r_83_128_104,0.99,0,104,104,59
6,r_69_40_96,r_30_41_3,r_59_28_38,r_69_40_96,0.46,0,96,96,59
29,r_94_97_43,seq16,seq95,r_94_97_43,1.0,0,43,43,59
27,r_58_38_172,seq81,r_17_116_151,r_58_38_172,0.37,2,174,172,59
16,r_59_28_38,r_52_117_59,seq4,r_59_28_38,1.0,1,39,38,59
2,r_17_116_151,seq68,seq46,r_17_116_151,0.67,0,151,151,59
18,r_82_54_83,r_67_43_190,seq75,r_82_54_83,0.99,1,84,83,59
24,r_93_78_78,r_83_128_104,r_96_27_124,r_83_128_104,0.91,-21,83,104,59
25,r_18_120_128,seq37,r_88_44_90,r_88_44_90,1.0,38,128,90,59
3,r_52_117_59,seq129,seq101,r_52_117_59,1.0,0,59,59,59
70,seq76,r_99_60_125,seq6,r_99_60_125,0.99,0,125,125,59
16,r_59_28_38,seq4,r_69_40_96,r_69_40_96,1.0,-1,95,96,59
75,seq85,seq115,r_23_24_51,r_23_24_51,1.0,27,78,51,59
17,r_102_108_68,seq16,seq25,r_102_108_68,0.99,2,70,68,59
22,r_110_103_181,seq12,r_83_128_104,r_110_103_181,0.56,0,181,181,59
84,seq101,seq79,r_52_117_59,r_52_117_59,1.0,1,60,59,59
14,r_82_79_160,seq54,r_27_15_110,r_82_79_160,0.91,0,160,160,60
8,r_116_83_134,seq16,seq62,r_116_83_134,0.93,0,134,134,60
5,r_14_125_42,r_33_118_24,seq34,r_33_118_24,0.58,110,134,24,60
19,r_60_39_19,r_27_15_110,seq95,r_27_15_110,1.0,1,111,110,60
16,r_2_3_25,r_116_83_134,seq120,r_2_3_25,1.0,1,26,25,60
1,r_27_15_110,r_60_39_19,seq46,r_27_15_110,0.99,1,111,110,60
97,seq120,r_101_38_171,r_44_119_161,r_101_38_171,0.5,-9,162,171,60
76,seq85,seq80,r_94_67_98,r_94_67_98,1.0,0,98,98,60
10,r_18_53_109,seq31,r_44_119_161,r_18_53_109,0.38,0,109,109,60
26,r_22_87_123,seq46,r_9_100_62,r_9_100_62,1.0,-2,60,62,60
16,r_2_3_25,seq120,r_44_119_161,r_44_119_161,0.88,12,173,161,60
4,r_44_119_161,seq122,r_2_3_25,r_2_3_25,1.0,135,160,25,60
0,r_26_59_145,seq114,seq117,r_26_59_145,0.63,2,147,145,60
1,r_27_15_110,r_7_99_95,r_60_39_19,r_60_39_19,1.0,-3,16,19,60
15,r_98_10_79,seq122,seq16,r_98_10_79,1.0,0,79,79,60
19,r_60_39_19,r_43_72_119,r_27_15_110,r_60_39_19,1.0,-1,18,19,60
6,r_32_121_107,seq56,seq74,r_32_121_107,0.72,0,107,107,60
10,r_18_53_109,r_44_119_161,r_43_72_119,r_18_53_109,0.66,10,119,109,60
37,seq16,r_116_83_134,seq88,r_116_83_134,0.93,-82,52,134,60
27,r_124_61_117,seq114,r_22_87_123,r_124_61_117,0.96,6,123,117,60
18,r_70_6_188,seq120,seq5,r_70_6_188,0.42,-11,177,188,60
29,r_103_35_179,seq93,r_91_30_90,r_103_35_179,0.28,4,183,179,60
25,r_94_67_98,seq19,seq85,r_94_67_98,1.0,0,98,98,60
20,r_9_100_62,seq120,r_22_87_123,r_9_100_62,1.0,-6,56,62,60
20,r_9_100_62,r_22_87_123,seq86,r_22_87_123,0.96,0,123,123,60
5,r_14_125_42,seq57,r_33_118_24,r_14_125_42,0.49,40,82,42,60
17,r_104_71_69,seq40,seq8,r_104_71_69,1.0,0,69,69,60
5,r_14_125_42,r_104_71_69,seq57,r_14_125_42,0.99,-1,41,42,60
26,r_22_87_123,r_9_100_62,r_124_61_117,r_22_87_123,1.0,0,123,123,60
22,r_43_72_119,seq58,r_18_53_109,r_43_72_119,1.0,0,119,119,60
7,r_91_30_90,r_124_61_117,seq84,r_91_30_90,0.92,13,103,90,60
23,r_7_99_95,r_27_15_110,seq88,r_7_99_95,1.0,0,95,95,60
26,r_125_62_27,r_89_96_122,seq126,r_125_62_27,1.0,0,27,27,61
30,seq1,r_18_116_117,seq69,r_18_116_117,0.97,0,117,117,61
36,seq11,r_20_123_166,seq43,r_20_123_166,0.84,0,166,166,61
12,r_28_14_44,seq39,r_73_115_46,r_28_14_44,0.6,2,46,44,61
92,seq109,seq84,r_70_27_89,r_70_27_89,0.84,3,92,89,61
16,r_70_27_89,r_16_111_137,seq66,r_16_111_137,0.65,-42,95,137,61
21,r_113_72_72,seq31,seq84,r_113_72_72,0.65,2,74,72,61
5,r_36_55_128,seq90,r_89_96_122,r_89_96_122,1.0,5,127,122,61
19,r_20_123_166,seq11,seq74,r_20_123_166,0.54,0,166,166,61
31,seq2,seq78,r_16_111_137,r_16_111_137,1.0,14,151,137,61
3,r_89_96_122,seq37,seq48,r_89_96_122,0.85,1,123,122,61
10,r_112_82_102,r_22_26_152,seq102,r_22_26_152,0.72,-41,111,152,61
72,seq78,r_61_13_187,r_16_111_137,r_16_111_137,1.0,49,186,137,61
4,r_117_67_130,seq52,r_113_72_72,r_117_67_130,0.53,0,130,130,61
0,r_16_111_137,r_70_27_89,r_106_12_101,r_16_111_137,0.38,-31,106,137,61
20,r_129_107_169,r_128_97_2,r_70_27_89,r_129_107_169,0.78,-1,168,169,61
99,seq126,seq54,r_125_62_27,r_125_62_27,1.0,1,28,27,61
6,r_3_25_124,r_117_67_130,seq53,r_3_25_124,0.77,0,124,124,61
69,seq74,r_75_122_25,r_20_123_166,r_20_123_166,0.49,-1,165,166,61
1,r_73_115_46,r_70_27_89,r_125_62_27,r_73_115_46,0.48,3,49,46,61
18,r_100_56_115,r_20_123_166,seq38,r_100_56_115,0.98,0,115,115,61
0,r_16_111_137,r_106_12_101,seq2,r_16_111_137,0.94,0,137,137,61
24,r_71_42_94,seq124,seq59,r_71_42_94,0.9,0,94,94,61
34,seq8,r_5_9_134,seq31,r_5_9_134,0.68,0,134,134,61
23,r_0_108_43,r_23_95_108,r_65_104_6,r_0_108_43,1.0,0,43,43,61
29,r_106_12_101,r_16_111_137,seq68,r_16_111_137,1.0,-1,136,137,61
60,seq52,r_117_67_130,seq80,r_117_67_130,1.0,0,130,130,61
9,r_23_95_108,seq85,seq105,r_23_95_108,1.0,1,109,108,61
14,r_41_86_51,seq74,r_73_115_46,r_73_115_46,0.44,7,53,46,61
91,seq105,seq38,r_23_95_108,r_23_95_108,1.0,10,118,108,61
7,r_18_116_117,seq1,seq29,r_18_116_117,0.94,0,117,117,61
22,r_75_122_25,r_3_25_124,seq74,r_75_122_25,0.89,-2,23,25,61
35,seq10,seq80,r_71_42_94,r_71_42_94,1.0,13,107,94,61
23,r_0_108_43,r_65_104_6,r_5_9_134,r_5_9_134,1.0,0,134,134,61
26,r_117_10_43,r_58_59_156,seq124,r_117_10_43,1.0,1,44,43,62
14,r_37_78_62,seq7,r_122_86_36,r_37_78_62,0.93,0,62,62,62
8,r_70_84_129,seq64,r_74_85_59,r_70_84_129,0.86,1,130,129,62
54,seq42,r_19_0_162,r_26_61_101,r_26_61_101,1.0,61,162,101,62
16,r_1_125_157,r_116_45_93,r_37_78_62,r_1_125_157,0.67,0,157,157,62
1,r_36_127_143,r_116_45_93,seq40,r_36_127_143,0.9,4,147,143,62
19,r_26_61_101,seq56,seq24,r_26_61_101,0.97,0,101,101,62
27,r_81_90_171,seq30,seq47,r_81_90_171,0.61,-14,157,171,62
28,r_38_115_46,seq128,seq57,r_38_115_46,0.94,-2,44,46,62
76,seq72,r_126_46_126,r_11_95_84,r_11_95_84,1.0,1,85,84,62
3,r_87_8_70,seq112,seq93,r_87_8_70,1.0,0,70,70,62
0,r_13_2_76,seq20,seq28,r_13_2_76,1.0,0,76,76,62
11,r_123_79_111,seq69,r_126_46_126,r_123_79_111,1.0,4,115,111,62
20,r_126_46_126,seq72,r_123_79_111,r_123_79_111,1.0,16,127,111,62
10,r_82_5_29,r_100_18_108,seq102,r_82_5_29,0.98,-1,28,29,62
15,r_113_62_96,r_12_97_114,seq54,r_113_62_96,0.63,0,96,96,62
48,seq33,seq4,r_19_0_162,r_19_0_162,0.45,-109,53,162,62
99,seq124,seq112,r_117_10_43,r_117_10_43,1.0,28,71,43,62
4,r_96_22_11,r_100_18_108,seq9,r_96_22_11,0.75,39,50,11,62
29,r_122_86_36,seq14,seq32,r_122_86_36,1.0,0,36,36,62
2,r_16_77_120,seq48,seq50,r_16_77_120,0.94,0,120,120,62
18,r_6_29_107,seq32,seq9,r_6_29_107,0.93,0,107,107,62
25,r_12_97_114,r_116_45_93,seq15,r_12_97_114,0.97,1,115,114,62
24,r_99_114_26,seq49,seq4,r_99_114_26,1.0,0,26,26,62
70,seq64,r_70_84_129,seq43,r_70_84_129,1.0,1,130,129,62
17,r_74_85_59,seq15,seq67,r_74_85_59,0.99,1,60,59,62
9,r_103_21_60,seq32,seq60,r_103_21_60,1.0,0,60,60,62
22,r_116_45_93,r_36_127_143,seq104,r_36_127_143,0.99,4,147,143,62
7,r_11_95_84,seq41,seq72,r_11_95_84,1.0,0,84,84,62
23,r_19_0_162,seq42,r_99_114_26,r_19_0_162,0.89,0,162,162,62
23,r_58_118_190,r_16_38_130,r_27_93_90,r_58_118_190,0.42,-172,18,190,63
14,r_108_22_176,seq6,r_45_120_108,r_108_22_176,0.6,0,176,176,63
8,r_33_71_86,seq107,r_63_92_2,r_33_71_86,0.99,0,86,86,63
21,r_41_124_125,seq57,r_27_93_90,r_41_124_125,0.96,0,125,125,63
1,r_77_70_116,r_99_29_185,seq6,r_77_70_116,0.93,0,116,116,63
97,seq125,seq18,r_121_75_62,r_121_75_62,0.99,2,64,62,63
5,r_60_91_187,seq26,r_112_47_56,r_60_91_187,0.34,0,187,187,63
46,seq21,seq105,r_102_49_117,r_102_49_117,0.99,10,127,117,63
69,seq67,seq127,r_45_120_108,r_45_120_108,1.0,0,108,108,63
23,r_58_118_190,r_27_93_90,seq13,r_58_118_190,0.54,-146,44,190,63
97,seq125,r_121_75_62,r_78_97_138,r_78_97_138,1.0,5,143,138,63
3,r_35_20_89,seq6,seq44,r_35_20_89,0.99,0,89,89,63
26,r_128_42_98,seq82,seq32,r_128_42_98,0.92,0,98,98,63
2,r_80_81_14,r_99_29_185,r_65_87_13,r_80_81_14,1.0,-1,13,14,63
4,r_103_25_120,seq26,seq19,r_103_25_120,0.94,1,121,120,63
0,r_39_129_129,r_102_49_117,r_90_115_30,r_90_115_30,0.81,88,118,30,63
11,r_16_38_130,seq11,r_69_24_83,r_16_38_130,0.97,1,131,130,63
13,r_102_49_117,r_39_129_129,r_63_92_2,r_102_49_117,0.96,2,119,117,63
98,seq126,r_102_49_117,seq64,r_102_49_117,0.56,-34,83,117,63
15,r_4_53_164,seq107,r_80_81_14,r_4_53_164,0.64,0,164,164,63
25,r_112_47_56,seq105,seq43,r_112_47_56,0.97,0,56,56,63
6,r_63_92_2,seq105,r_33_71_86,r_33_71_86,0.99,3,89,86,63
99,seq127,seq59,r_69_24_83,r_69_24_83,1.0,26,109,83,63
28,r_31_88_12,r_9_68_23,seq96,r_31_88_12,0.83,-1,11,12,63
18,r_111_66_94,seq96,r_94_123_50,r_111_66_94,0.53,3,97,94,63
29,r_45_120_108,seq86,seq67,r_45_120_108,0.93,0,108,108,63
24,r_69_24_83,seq101,seq127,r_69_24_83,0.99,0,83,83,63
68,seq64,r_94_123_50,r_39_129_129,r_94_123_50,1.0,-11,39,50,63
88,seq107,r_4_53_164,seq36,r_4_53_164,0.91,0,164,164,63
39,seq12,seq36,r_16_38_130,r_16_38_130,0.6,19,149,130,63
20,r_90_115_30,r_39_129_129,seq8,r_39_129_129,1.0,1,130,129,63
23,r_58_118_190,seq1,r_103_25_120,r_103_25_120,0.67,70,190,120,63
19,r_94_123_50,seq64,seq101,r_94_123_50,1.0,0,50,50,63
86,seq105,r_112_47_56,r_63_92_2,r_112_47_56,1.0,0,56,56,63
68,seq64,r_39_129_129,r_80_81_14,r_39_129_129,0.87,-26,103,129,63
34,seq6,r_108_22_176,r_77_70_116,r_77_70_116,0.9,60,176,116,63
9,r_121_75_62,r_63_92_2,seq125,r_121_75_62,1.0,3,65,62,63
17,r_65_87_13,r_16_38_130,r_80_81_14,r_65_87_13,0.9,0,13,13,63
20,r_90_115_30,seq72,r_39_129_129,r_90_115_30,0.68,1,31,30,63
27,r_0_40_42,seq84,seq11,r_0_40_42,0.87,0,42,42,63
10,r_100_56_27,seq5,seq89,r_100_56_27,0.99,-2,25,27,63
7,r_78_97_138,seq107,seq125,r_78_97_138,0.78,0,138,138,63
22,r_9_68_23,r_0_40_42,seq26,r_9_68_23,0.89,0,23,23,63
12,r_27_93_90,seq122,r_9_68_23,r_27_93_90,1.0,0,90,90,63
0,r_39_129_129,r_90_115_30,r_77_70_116,r_39_129_129,0.65,1,130,129,63
28,r_87_16_15,r_94_81_125,seq36,r_87_16_15,0.75,0,15,15,64
37,seq12,r_61_2_63,seq101,r_61_2_63,1.0,1,64,63,64
16,r_33_31_116,seq66,seq108,r_33_31_116,0.95,0,116,116,64
80,seq92,r_90_62_141,r_85_18_29,r_90_62_141,0.67,-8,133,141,64
21,r_28_4_33,r_71_86_101,seq113,r_71_86_101,0.98,-65,36,101,64
19,r_61_2_63,seq12,seq69,r_61_2_63,0.96,1,64,63,64
66,seq69,r_47_80_148,r_61_2_63,r_61_2_63,0.57,40,103,63,64
26,r_47_80_148,seq69,seq68,r_47_80_148,0.59,-2,146,148,64
11,r_116_53_48,seq60,seq51,r_116_53_48,0.74,0,48,48,64
4,r_71_86_101,r_15_56_193,r_49_26_176,r_71_86_101,0.96,2,103,101,64
0,r_52_1_127,seq84,seq126,r_52_1_127,0.99,0,127,127,64
63,seq66,r_33_31_116,r_0_100_74,r_33_31_116,0.91,0,116,116,64
29,r_115_20_41,r_15_56_193,seq69,r_15_56_193,0.56,-152,41,193,64
5,r_43_58_54,r_54_13_173,seq48,r_43_58_54,0.88,0,54,54,64
20,r_10_8_62,seq23,seq76,r_10_8_62,1.0,0,62,62,64
15,r_90_62_141,seq92,seq9,r_90_62_141,0.94,0,141,141,64
10,r_129_96_58,r_15_56_193,seq23,r_129_96_58,1.0,1,59,58,64
18,r_17_78_106,r_52_1_127,seq101,r_17_78_106,0.98,1,107,106,64
24,r_85_18_29,r_47_80_148,seq92,r_85_18_29,0.91,0,29,29,64
25,r_49_26_176,r_118_97_114,r_71_86_101,r_71_86_101,1.0,7,108,101,64
1,r_42_44_37,r_90_62_141,seq113,r_42_44_37,0.96,0,37,37,64
32,seq5,seq66,r_70_32_134,r_70_32_134,0.99,5,139,134,64
7,r_123_98_140,r_19_46_1,seq117,r_19_46_1,0.77,140,141,1,64
22,r_99_119_25,seq9,seq69,r_99_119_25,0.99,0,25,25,64
23,r_70_32_134,seq103,seq5,r_70_32_134,0.94,0,134,134,64
35,seq9,seq39,r_90_62_141,r_90_62_141,1.0,0,141,141,64
12,r_94_81_125,seq66,seq14,r_94_81_125,0.92,0,125,125,64
84,seq103,r_70_32_134,seq68,r_70_32_134,1.0,-69,65,134,64
93,seq116,r_18_31_162,r_17_81_83,r_18_31_162,1.0,0,162,162,65
30,seq0,seq82,r_36_102_152,r_36_102_152,0.98,5,157,152,65
21,r_106_62_76,r_12_110_153,seq122,r_106_62_76,0.58,0,76,76,65
1,r_48_63_86,seq53,seq33,r_48_63_86,1.0,0,86,86,65
5,r_83_21_133,seq88,seq4,r_83_21_133,0.99,0,133,133,65
42,seq20,seq28,r_119_58_26,r_119_58_26,1.0,78,104,26,65
0,r_77_11_49,seq29,r_51_90_39,r_77_11_49,1.0,0,49,49,65
19,r_113_57_173,seq117,seq88,r_113_57_173,0.66,0,173,173,65
67,seq64,seq35,r_77_11_49,r_77_11_49,1.0,80,129,49,65
3,r_61_112_98,seq28,r_126_85_14,r_61_112_98,1.0,0,98,98,65
20,r_23_50_114,r_86_79_159,seq26,r_23_50_114,0.77,0,114,114,65
6,r_108_121_178,seq97,r_41_87_10,r_41_87_10,0.84,163,173,10,65
85,seq98,seq34,r_114_13_121,r_114_13_121,0.99,38,159,121,65
12,r_41_87_10,r_60_71_156,seq91,r_41_87_10,0.98,0,10,10,65
2,r_60_71_156,seq75,r_2_123_19,r_60_71_156,0.93,0,156,156,65
18,r_114_13_121,seq26,seq98,r_114_13_121,0.98,0,121,121,65
29,r_36_102_152,seq34,seq0,r_36_102_152,0.69,0,152,152,65
24,r_86_79_159,seq124,r_99_5_56,r_86_79_159,0.94,0,159,159,65
33,seq4,seq94,r_83_21_133,r_83_21_133,1.0,3,136,133,65
42,seq20,r_119_58_26,r_36_102_152,r_36_102_152,0.77,16,168,152,65
27,r_67_39_58,seq15,r_17_81_83,r_67_39_58,1.0,0,58,58,65
94,seq117,r_113_57_173,r_119_58_26,r_119_58_26,0.7,147,173,26,65
96,seq122,seq15,r_106_62_76,r_106_62_76,0.92,0,76,76,65
11,r_51_90_39,seq26,seq19,r_51_90_39,0.95,-3,36,39,65
9,r_119_58_26,r_83_21_133,seq53,r_119_58_26,1.0,0,26,26,65
13,r_99_5_56,seq3,r_74_37_47,r_99_5_56,0.6,-18,38,56,65
23,r_38_44_122,seq33,seq25,r_38_44_122,1.0,0,122,122,65
14,r_74_37_47,r_12_110_153,r_99_5_56,r_74_37_47,0.83,-9,38,47,65
14,r_8_66_94,seq76,seq82,r_8_66_94,0.98,0,94,94,66
8,r_64_36_118,seq22,seq65,r_64_36_118,1.0,0,118,118,66
43,seq27,r_57_80_107,seq21,r_57_80_107,1.0,0,107,107,66
1,r_13_40_32,seq27,seq24,r_13_40_32,1.0,0,32,32,66
20,r_14_6_37,r_96_48_146,r_5_47_147,r_14_6_37,0.95,2,39,37,66
16,r_83_2_109,seq30,seq33,r_83_2_109,0.99,1,110,109,66
21,r_17_69_112,seq92,seq52,r_17_69_112,0.63,3,115,112,66
39,seq19,r_70_38_93,r_128_73_51,r_70_38_93,1.0,0,93,93,66
5,r_55_61_189,seq76,r_96_48_146,r_55_61_189,0.35,0,189,189,66
29,r_113_34_29,seq7,seq58,r_113_34_29,0.97,3,32,29,66
19,r_81_20_194,seq76,r_63_108_83,r_63_108_83,1.0,24,107,83,66
66,seq76,r_55_61_189,r_63_108_83,r_63_108_83,1.0,65,148,83,66
97,seq123,r_68_100_62,r_127_56_53,r_68_100_62,1.0,123,185,62,66
3,r_101_51_131,seq32,seq114,r_101_51_131,0.98,2,133,131,66
11,r_67_26_54,seq21,seq125,r_67_26_54,1.0,1,55,54,66
4,r_96_48_146,seq1,seq116,r_96_48_146,0.77,0,146,146,66
62,seq65,seq124,r_64_36_118,r_64_36_118,1.0,5,123,118,66
99,seq125,r_72_79_179,r_67_26_54,r_67_26_54,1.0,6,60,54,66
27,r_54_85_139,seq22,seq105,r_54_85_139,0.95,8,147,139,66
2,r_57_80_107,seq27,r_14_6_37,r_57_80_107,1.0,0,107,107,66
28,r_5_47_147,seq82,r_14_6_37,r_14_6_37,0.98,3,40,37,66
74,seq90,seq82,r_68_100_62,r_68_100_62,1.0,4,66,62,66
25,r_63_108_83,seq71,seq12,r_63_108_83,1.0,0,83,83,66
20,r_14_6_37,r_5_47_147,r_57_80_107,r_57_80_107,0.95,41,148,107,66
68,seq82,r_5_47_147,r_68_100_62,r_68_100_62,0.83,21,83,62,66
15,r_99_46_26,seq90,seq37,r_99_46_26,0.94,0,26,26,66
60,seq59,r_72_79_179,seq32,r_72_79_179,0.99,0,179,179,66
59,seq58,seq35,r_113_34_29,r_113_34_29,0.91,14,43,29,66
17,r_72_79_179,seq59,seq7,r_72_79_179,0.51,0,179,179,66
28,r_5_47_147,r_14_6_37,r_13_40_32,r_5_47_147,0.94,1,148,147,66
22,r_41_121_134,seq22,r_25_126_21,r_41_121_134,0.93,0,134,134,66
10,r_25_126_21,seq71,seq117,r_25_126_21,0.84,0,21,21,66
91,seq116,r_68_100_62,seq118,r_68_100_62,0.99,0,62,62,66
0,r_127_56_53,r_70_38_93,seq98,r_127_56_53,0.99,0,53,53,66
7,r_18_60_132,seq10,seq71,r_18_60_132,0.75,6,138,132,66
23,r_16_53_157,seq37,seq77,r_16_53_157,0.84,0,157,157,66
82,seq105,seq82,r_54_85_139,r_54_85_139,0.57,-13,126,139,66
12,r_68_100_62,seq116,seq90,r_68_100_62,1.0,0,62,62,66
0,r_127_56_53,seq98,r_70_38_93,r_70_38_93,1.0,2,95,93,66
36,seq11,r_70_8_165,r_105_80_79,r_105_80_79,0.6,86,165,79,67
9,r_124_59_70,seq46,seq79,r_124_59_70,0.79,0,70,70,67
14,r_105_80_79,seq58,seq99,r_105_80_79,0.98,0,79,79,67
10,r_82_106_50,seq56,seq13,r_82_106_50,0.66,-10,40,50,67
16,r_77_72_156,seq11,r_18_102_75,r_77_72_156,0.62,1,157,156,67
19,r_16_97_92,r_73_108_29,seq36,r_16_97_92,0.44,11,103,92,67
66,seq54,seq27,r_78_55_122,r_78_55_122,1.0,10,132,122,67
76,seq79,r_118_71_150,r_124_59_70,r_124_59_70,1.0,11,81,70,67
41,seq17,r_78_55_122,seq52,r_78_55_122,1.0,-25,97,122,67
3,r_120_67_163,seq94,seq101,r_120_67_163,0.76,0,163,163,67
4,r_33_38_141,seq81,r_64_104_140,r_64_104_140,0.75,3,143,140,67
13,r_28_100_120,seq9,r_57_22_188,r_28_100_120,0.99,0,120,120,67
15,r_78_55_122,seq17,seq54,r_78_55_122,0.99,1,123,122,67
85,seq94,r_120_67_163,r_118_71_150,r_120_67_163,0.86,0,163,163,67
27,r_128_2_170,seq90,r_105_80_79,r_128_2_170,0.64,0,170,170,67
25,r_73_108_29,seq10,r_16_97_92,r_73_108_29,0.44,-4,25,29,67
18,r_64_104_140,seq58,r_33_38_141,r_64_104_140,0.9,1,141,140,67
6,r_84_88_54,r_105_80_79,seq6,r_84_88_54,0.95,0,54,54,67
34,seq9,r_28_100_120,r_117_109_129,r_28_100_120,0.85,6,126,120,67
25,r_73_108_29,r_16_97_92,r_116_30_31,r_73_108_29,0.56,118,147,29,67
22,r_60_1_179,r_126_85_199,r_118_71_150,r_118_71_150,0.46,31,181,150,67
5,r_116_30_31,seq31,r_57_22_188,r_116_30_31,0.99,0,31,31,67
23,r_115_42_164,seq14,r_39_65_6,r_115_42_164,0.6,-6,158,164,67
12,r_37_103_173,r_118_71_150,seq26,r_118_71_150,0.26,22,172,150,67
13,r_58_109_18,seq90,seq119,r_58_109_18,0.88,0,18,18,68
53,seq129,r_96_122_178,r_76_24_48,r_76_24_48,0.98,86,134,48,68
37,seq12,r_11_23_103,seq32,r_11_23_103,1.0,-6,97,103,68
3,r_112_41_6,seq34,r_78_69_117,r_112_41_6,0.31,121,127,6,68
51,seq36,seq44,r_50_21_80,r_50_21_80,1.0,0,80,80,68
55,seq43,r_116_64_95,seq34,r_116_64_95,0.98,0,95,95,68
43,seq27,r_67_39_105,r_68_38_17,r_68_38_17,0.84,10,27,17,68
5,r_4_98_179,seq114,r_79_113_58,r_4_98_179,0.45,0,179,179,68
24,r_67_39_105,r_4_98_179,r_127_101_170,r_4_98_179,0.51,0,179,179,68
19,r_78_69_117,seq104,r_112_41_6,r_78_69_117,0.72,2,119,117,68
95,seq118,r_96_122_178,r_11_23_103,r_11_23_103,1.0,14,117,103,68
10,r_68_38_17,r_117_89_90,seq27,r_68_38_17,0.96,0,17,17,68
90,seq105,seq65,r_79_113_58,r_79_113_58,1.0,20,78,58,68
12,r_85_56_50,seq48,seq72,r_85_56_50,1.0,1,51,50,68
20,r_50_21_80,r_117_89_90,r_54_94_155,r_50_21_80,0.53,0,80,80,68
15,r_62_40_61,seq120,r_58_109_18,r_62_40_61,1.0,2,63,61,68
6,r_117_89_90,seq19,seq17,r_117_89_90,1.0,0,90,90,68
66,seq65,seq105,r_79_113_58,r_79_113_58,1.0,1,59,58,68
49,seq33,seq121,r_22_18_54,r_22_18_54,1.0,0,54,54,68
21,r_79_113_58,r_78_69_117,seq65,r_79_113_58,0.96,1,59,58,68
59,seq48,r_54_94_155,seq31,r_54_94_155,1.0,0,155,155,68
18,r_57_6_84,r_96_122_178,seq34,r_57_6_84,1.0,1,85,84,68
4,r_47_126_43,seq115,seq110,r_47_126_43,1.0,0,43,43,68
24,r_67_39_105,seq45,r_4_98_179,r_67_39_105,0.74,1,106,105,68
25,r_106_92_110,seq73,seq12,r_106_92_110,1.0,0,110,110,68
70,seq72,seq16,r_85_56_50,r_85_56_50,1.0,39,89,50,68
2,r_76_24_48,seq28,seq129,r_76_24_48,1.0,0,48,48,68
20,r_50_21_80,r_54_94_155,seq51,r_54_94_155,1.0,0,155,155,68
59,seq48,r_85_56_50,r_54_94_155,r_85_56_50,1.0,1,51,50,68
51,seq36,r_11_23_103,seq44,r_11_23_103,0.59,-62,41,103,68
17,r_22_18_54,seq17,seq33,r_22_18_54,1.0,0,54,54,68
40,seq17,r_22_18_54,r_79_113_58,r_22_18_54,0.98,0,54,54,68
22,r_11_23_103,seq12,seq118,r_11_23_103,0.97,0,103,103,68
28,r_100_3_65,seq31,seq102,r_100_3_65,1.0,0,65,65,68
7,r_1_2_152,seq93,seq32,r_1_2_152,0.63,0,152,152,68
23,r_54_94_155,seq51,r_50_21_80,r_50_21_80,1.0,2,82,80,68
23,r_54_94_155,r_50_21_80,r_85_56_50,r_54_94_155,1.0,0,155,155,68
8,r_45_89_146,seq91,r_115_80_5,r_45_89_146,0.96,0,146,146,69
37,seq11,r_68_127_178,r_7_110_1,r_68_127_178,0.97,0,178,178,69
3,r_114_9_60,r_15_129_127,seq40,r_15_129_127,1.0,0,127,127,69
21,r_28_86_104,seq58,seq32,r_28_86_104,1.0,0,104,104,69
1,r_15_129_127,r_114_9_60,seq122,r_15_129_127,1.0,0,127,127,69
1,r_15_129_127,seq40,r_114_9_60,r_114_9_60,1.0,1,61,60,69
13,r_88_47_41,seq12,seq0,r_88_47_41,1.0,0,41,41,69
80,seq91,r_45_89_146,seq95,r_45_89_146,0.72,2,148,146,69
69,seq67,seq38,r_112_20_121,r_112_20_121,0.99,5,126,121,69
17,r_93_60_36,seq32,r_117_85_61,r_117_85_61,1.0,0,61,61,69
11,r_65_59_98,seq90,r_44_94_7,r_65_59_98,0.49,-22,76,98,69
66,seq58,r_114_9_60,seq87,r_114_9_60,1.0,1,61,60,69
29,r_81_125_19,r_116_61_196,seq63,r_81_125_19,0.95,2,21,19,69
3,r_114_9_60,seq58,r_15_129_127,r_114_9_60,0.94,1,61,60,69
4,r_82_24_167,seq76,r_88_47_41,r_88_47_41,0.66,126,167,41,69
0,r_56_106_123,seq76,seq2,r_56_106_123,0.66,3,126,123,69
63,seq54,r_73_101_129,r_64_84_85,r_64_84_85,0.68,44,129,85,69
15,r_64_84_85,seq50,seq54,r_64_84_85,1.0,0,85,85,69
19,r_42_34_20,seq16,seq5,r_42_34_20,1.0,0,20,20,69
27,r_19_23_108,seq62,seq16,r_19_23_108,1.0,0,108,108,69
2,r_123_6_78,seq26,seq92,r_123_6_78,1.0,0,78,78,69
6,r_1_30_100,seq95,seq67,r_1_30_100,0.89,-2,98,100,69
18,r_68_127_178,seq11,seq95,r_68_127_178,0.63,0,178,178,69
24,r_112_20_121,r_73_101_129,seq67,r_112_20_121,0.56,2,123,121,69
17,r_93_60_36,r_82_24_167,seq32,r_93_60_36,0.97,2,38,36,69
25,r_39_105_11,r_77_100_119,seq109,r_39_105_11,0.65,0,11,11,69
81,seq92,seq46,r_123_6_78,r_123_6_78,1.0,5,83,78,69
9,r_77_100_119,seq55,r_81_125_19,r_77_100_119,1.0,0,119,119,69
34,seq5,r_27_31_150,r_42_34_20,r_42_34_20,0.98,1,21,20,69
22,r_117_85_61,seq109,r_93_60_36,r_117_85_61,1.0,2,63,61,69
28,r_25_99_160,seq128,r_42_34_20,r_42_34_20,0.45,145,165,20,69
14,r_4_66_12,r_88_47_41,seq54,r_4_66_12,0.93,1,13,12,69
7,r_27_31_150,seq5,seq108,r_27_31_150,0.95,0,150,150,69
90,seq109,r_117_85_61,r_39_105_11,r_117_85_61,0.81,-48,13,61,69
25,r_61_90_34,seq19,seq85,r_61_90_34,0.6,-6,28,34,70
71,seq75,seq3,r_105_38_100,r_105_38_100,1.0,18,118,100,70
16,r_15_24_144,seq66,seq31,r_15_24_144,0.94,3,147,144,70
1,r_65_60_62,r_0_79_74,r_28_1_116,r_0_79_74,1.0,-8,66,74,70
5,r_34_120_109,r_81_109_196,r_9_14_126,r_34_120_109,0.72,1,110,109,70
29,r_62_102_32,seq41,r_78_93_4,r_62_102_32,0.98,0,32,32,70
6,r_23_32_155,seq89,r_99_12_50,r_99_12_50,1.0,-6,44,50,70
70,seq74,r_119_91_73,r_9_14_126,r_9_14_126,0.47,-83,43,126,70
70,seq74,r_9_14_126,r_13_115_92,r_13_115_92,0.52,-5,87,92,70
41,seq27,r_50_4_161,seq10,r_50_4_161,0.98,-14,147,161,70
23,r_92_42_40,r_119_91_73,seq44,r_92_42_40,1.0,0,40,40,70
28,r_50_4_161,r_2_8_112,r_17_57_56,r_50_4_161,0.63,0,161,161,70
10,r_2_8_112,seq67,seq101,r_2_8_112,0.94,1,113,112,70
67,seq69,seq66,r_78_93_4,r_78_93_4,0.74,24,28,4,70
26,r_105_38_100,seq110,seq75,r_105_38_100,1.0,1,101,100,70
4,r_33_72_69,seq128,seq82,r_33_72_69,1.0,-1,68,69,70
0,r_22_26_135,seq52,seq67,r_22_26_135,0.95,2,137,135,70
20,r_13_115_92,seq87,seq74,r_13_115_92,0.94,0,92,92,70
57,seq49,seq69,r_0_79_74,r_0_79_74,1.0,-2,72,74,70
27,r_0_79_74,seq75,seq49,r_0_79_74,0.98,-2,72,74,70
7,r_119_91_73,seq29,seq86,r_119_91_73,1.0,-1,72,73,70
18,r_88_94_123,seq44,r_65_60_62,r_88_94_123,0.86,2,125,123,70
24,r_73_16_130,seq43,seq30,r_73_16_130,0.93,0,130,130,70
6,r_23_32_155,r_99_12_50,r_111_98_49,r_23_32_155,0.84,0,155,155,70
3,r_17_57_56,seq5,seq55,r_17_57_56,0.99,-2,54,56,70
75,seq82,seq70,r_33_72_69,r_33_72_69,1.0,89,158,69,70
60,seq55,seq66,r_17_57_56,r_17_57_56,0.95,16,72,56,70
17,r_56_53_89,seq66,seq39,r_56_53_89,0.8,5,94,89,70
9,r_6_114_80,seq3,r_33_72_69,r_6_114_80,0.89,0,80,80,70
22,r_107_7_169,seq87,r_17_57_56,r_17_57_56,0.93,115,171,56,70
28,r_50_4_161,r_123_51_125,r_2_8_112,r_123_51_125,0.49,0,125,125,70
12,r_123_51_125,r_50_4_161,seq113,r_123_51_125,0.98,0,125,125,70
7,r_119_91_73,r_92_42_40,seq29,r_92_42_40,1.0,0,40,40,70
21,r_99_12_50,seq129,seq89,r_99_12_50,0.79,-6,44,50,70
8,r_104_71_47,seq27,r_89_117_180,r_104_71_47,0.99,0,47,47,71
33,seq3,r_129_101_39,seq35,r_129_101_39,1.0,-4,35,39,71
18,r_24_100_32,r_10_60_68,seq28,r_24_100_32,1.0,0,32,32,71
16,r_90_115_21,r_89_117_180,seq4,r_90_115_21,0.96,0,21,21,71
26,r_89_117_180,seq75,r_104_71_47,r_104_71_47,1.0,0,47,47,71
52,seq31,seq2,r_129_101_39,r_129_101_39,1.0,0,39,39,71
1,r_122_39_55,seq81,seq124,r_122_39_55,1.0,0,55,55,71
17,r_129_101_39,seq3,seq97,r_129_101_39,1.0,0,39,39,71
3,r_43_69_93,seq37,seq75,r_43_69_93,0.99,-2,91,93,71
8,r_104_71_47,r_89_117_180,r_79_38_122,r_79_38_122,0.86,58,180,122,71
54,seq33,r_25_36_29,seq13,r_25_36_29,1.0,1,30,29,71
4,r_109_82_127,seq76,seq35,r_109_82_127,0.98,1,128,127,71
78,seq76,r_109_82_127,seq26,r_109_82_127,1.0,1,128,127,71
73,seq68,seq53,r_47_106_95,r_47_106_95,1.0,0,95,95,71
13,r_127_23_72,seq12,seq5,r_127_23_72,0.95,0,72,72,71
15,r_47_106_95,seq18,seq68,r_47_106_95,1.0,0,95,95,71
35,seq5,r_77_126_41,seq20,r_77_126_41,0.98,-4,37,41,71
6,r_10_60_68,seq84,seq121,r_10_60_68,1.0,1,69,68,71
27,r_107_103_78,seq74,r_127_23_72,r_107_103_78,1.0,0,78,78,71
12,r_46_111_50,r_83_112_1,r_29_40_49,r_83_112_1,0.98,40,41,1,71
10,r_25_36_29,seq33,seq123,r_25_36_29,1.0,0,29,29,71
24,r_92_67_150,seq61,seq18,r_92_67_150,0.66,0,150,150,71
25,r_119_9_139,seq96,seq84,r_119_9_139,0.99,0,139,139,71
9,r_77_126_41,seq5,r_8_57_113,r_77_126_41,1.0,0,41,41,71
35,seq5,seq20,r_127_23_72,r_127_23_72,0.99,0,72,72,71
88,seq98,r_47_106_95,seq7,r_47_106_95,1.0,-30,65,95,71
77,seq75,r_89_117_180,r_43_69_93,r_43_69_93,0.83,55,148,93,71
26,r_89_117_180,r_104_71_47,r_113_41_135,r_89_117_180,0.58,0,180,180,71
34,seq4,seq30,r_90_115_21,r_90_115_21,1.0,0,21,21,71
22,r_17_78_62,r_8_57_113,seq84,r_17_78_62,1.0,1,63,62,71
56,seq35,seq3,r_109_82_127,r_109_82_127,0.99,11,138,127,71
23,r_79_38_122,seq26,r_104_71_47,r_79_38_122,0.91,2,124,122,71
5,r_86_59_52,r_79_38_122,seq7,r_79_38_122,0.98,-73,49,122,71
2,r_45_11_36,seq63,seq84,r_45_11_36,1.0,0,36,36,71
30,seq128,seq19,r_65_109_87,r_65_109_87,1.0,7,94,87,72
51,seq34,seq46,r_58_87_50,r_58_87_50,1.0,20,70,50,72
14,r_50_59_100,seq46,seq57,r_50_59_100,1.0,0,100,100,72
8,r_124_60_94,seq105,seq74,r_124_60_94,0.75,10,104,94,72
37,seq12,r_1_5_104,r_43_110_117,r_43_110_117,1.0,1,118,117,72
22,r_102_112_17,seq28,seq32,r_102_112_17,1.0,0,17,17,72
26,r_44_47_40,r_73_38_98,seq17,r_44_47_40,0.98,0,40,40,72
16,r_115_107_70,seq28,seq85,r_115_107_70,1.0,0,70,70,72
21,r_3_98_171,seq85,r_119_67_45,r_119_67_45,0.91,126,171,45,72
5,r_78_26_108,seq57,seq91,r_78_26_108,0.98,0,108,108,72
66,seq66,r_58_87_50,r_44_47_40,r_44_47_40,0.92,0,40,40,72
76,seq85,r_3_98_171,r_115_107_70,r_115_107_70,1.0,65,135,70,72
3,r_94_52_183,r_43_110_117,seq117,r_43_110_117,0.86,1,118,117,72
10,r_21_106_121,seq57,r_124_60_94,r_21_106_121,1.0,0,121,121,72
90,seq111,r_68_96_173,r_73_38_98,r_68_96_173,0.54,-85,88,173,72
3,r_94_52_183,seq117,seq22,r_94_52_183,0.73,-9,174,183,72
4,r_129_75_128,seq45,seq97,r_129_75_128,1.0,0,128,128,72
11,r_1_5_104,seq12,seq127,r_1_5_104,0.79,5,109,104,72
20,r_43_110_117,r_94_52_183,seq12,r_43_110_117,1.0,0,117,117,72
15,r_65_109_87,seq40,seq128,r_65_109_87,0.94,0,87,87,72
98,seq125,r_62_118_64,seq2,r_62_118_64,1.0,-6,58,64,72
0,r_119_67_45,seq61,seq76,r_119_67_45,0.99,0,45,45,72
47,seq28,r_115_107_70,seq121,r_115_107_70,1.0,0,70,70,72
29,r_42_33_159,seq17,seq125,r_42_33_159,0.92,0,159,159,72
24,r_4_37_116,seq69,seq101,r_4_37_116,1.0,0,116,116,72
57,seq46,r_50_59_100,r_29_14_11,r_50_59_100,0.59,-74,26,100,72
40,seq17,r_42_33_159,r_44_47_40,r_44_47_40,0.6,0,40,40,72
25,r_103_79_71,r_1_5_104,seq8,r_103_79_71,0.99,0,71,71,72
47,seq28,seq121,r_71_0_167,r_71_0_167,0.89,10,177,167,72
34,seq8,seq56,r_103_79_71,r_103_79_71,1.0,5,76,71,72
27,r_48_25_36,r_94_52_183,r_11_23_13,r_48_25_36,1.0,0,36,36,72
17,r_95_122_96,r_54_36_144,seq63,r_95_122_96,1.0,5,101,96,72
18,r_11_23_13,r_115_107_70,seq6,r_11_23_13,1.0,0,13,13,72
96,seq121,r_54_36_144,seq7,r_54_36_144,0.99,0,144,144,72
28,r_16_84_83,seq46,seq40,r_16_84_83,1.0,1,84,83,72
56,seq45,r_129_75_128,seq55,r_129_75_128,1.0,1,129,128,72
23,r_54_36_144,seq121,seq61,r_54_36_144,0.86,0,144,144,72
12,r_62_118_64,seq125,seq18,r_62_118_64,1.0,0,64,64,72
19,r_77_129_36,seq9,seq92,r_77_129_36,1.0,0,36,36,73
5,r_106_111_51,seq67,seq34,r_106_111_51,1.0,0,51,51,73
14,r_72_63_132,seq91,seq59,r_72_63_132,0.9,0,132,132,73
53,seq49,seq48,r_17_61_35,r_17_61_35,1.0,118,153,35,73
16,r_28_89_94,seq60,seq95,r_28_89_94,1.0,0,94,94,73
1,r_14_47_80,seq3,seq15,r_14_47_80,1.0,1,81,80,73
21,r_90_31_32,seq120,seq69,r_90_31_32,1.0,0,32,32,73
39,seq15,seq38,r_14_47_80,r_14_47_80,1.0,4,84,80,73
6,r_16_32_31,seq120,seq76,r_16_32_31,1.0,0,31,31,73
69,seq76,r_7_5_175,r_16_32_31,r_16_32_31,1.0,-1,30,31,73
3,r_2_19_159,r_82_40_189,seq46,r_2_19_159,0.82,0,159,159,73
10,r_70_13_84,seq62,seq10,r_70_13_84,1.0,-1,83,84,73
26,r_24_42_88,seq30,seq124,r_24_42_88,1.0,-1,87,88,73
4,r_101_73_105,seq48,r_43_25_195,r_101_73_105,1.0,0,105,105,73
0,r_27_29_96,r_43_25_195,seq126,r_27_29_96,1.0,0,96,96,73
73,seq85,r_82_40_189,r_37_64_54,r_37_64_54,1.0,135,189,54,73
11,r_96_8_187,seq128,r_101_73_105,r_101_73_105,0.6,82,187,105,73
20,r_66_114_117,seq48,r_90_31_32,r_66_114_117,0.94,4,121,117,73
15,r_1_36_183,r_57_123_122,seq121,r_57_123_122,1.0,0,122,122,73
46,seq34,r_83_112_75,r_106_111_51,r_106_111_51,1.0,0,51,51,73
99,seq126,seq9,r_27_29_96,r_27_29_96,1.0,20,116,96,73
27,r_127_103_90,seq99,seq23,r_127_103_90,1.0,0,90,90,73
29,r_82_40_189,seq85,r_7_5_175,r_7_5_175,0.73,14,189,175,73
24,r_86_54_72,r_33_81_155,seq99,r_86_54_72,0.54,4,76,72,73
25,r_35_18_82,seq26,seq91,r_35_18_82,0.92,-1,81,82,73
77,seq92,r_83_112_75,r_77_129_36,r_77_129_36,1.0,1,37,36,73
61,seq62,r_70_13_84,seq48,r_70_13_84,1.0,-1,83,84,73
28,r_17_61_35,r_127_103_90,r_77_129_36,r_17_61_35,0.99,0,35,35,73
9,r_57_123_122,r_1_36_183,r_27_29_96,r_57_123_122,1.0,0,122,122,73
22,r_83_112_75,seq92,seq50,r_83_112_75,0.55,0,75,75,73
91,seq116,r_79_115_103,seq58,r_79_115_103,0.98,-2,101,103,73
7,r_79_115_103,seq116,seq26,r_79_115_103,0.59,2,105,103,73
44,seq26,r_35_18_82,seq107,r_35_18_82,1.0,-15,67,82,73
23,r_119_100_81,seq122,seq41,r_119_100_81,1.0,0,81,81,73
63,seq67,r_106_111_51,seq85,r_106_111_51,1.0,-2,49,51,73
65,seq69,r_57_123_122,r_90_31_32,r_90_31_32,0.56,1,33,32,73
12,r_55_45_66,seq15,r_77_129_36,r_55_45_66,1.0,-3,63,66,73
97,seq123,r_57_39_198,r_89_117_26,r_89_117_26,1.0,26,52,26,74
12,r_17_69_57,seq68,seq36,r_17_69_57,1.0,0,57,57,74
36,seq9,r_49_16_139,seq1,r_49_16_139,1.0,-28,111,139,74
8,r_48_25_140,seq52,seq38,r_48_25_140,0.79,0,140,140,74
53,seq38,r_44_86_111,seq63,r_44_86_111,1.0,0,111,111,74
83,seq95,r_60_78_75,seq93,r_60_78_75,1.0,0,75,75,74
55,seq42,seq77,r_20_98_35,r_20_98_35,1.0,89,124,35,74
21,r_49_16_139,r_122_85_165,seq58,r_49_16_139,0.57,1,140,139,74
1,r_55_19_142,r_120_26_97,seq84,r_120_26_97,0.96,0,97,97,74
24,r_89_117_26,seq87,seq123,r_89_117_26,0.99,1,27,26,74
19,r_11_4_98,seq63,r_120_26_97,r_11_4_98,0.99,0,98,98,74
67,seq63,r_11_4_98,seq38,r_11_4_98,1.0,0,98,98,74
3,r_120_26_97,r_55_19_142,r_11_4_98,r_11_4_98,0.85,-1,97,98,74
10,r_122_85_165,seq9,r_120_26_97,r_122_85_165,0.61,0,165,165,74
90,seq105,r_50_62_188,r_60_78_75,r_60_78_75,1.0,113,188,75,74
26,r_60_78_75,seq95,seq105,r_60_78_75,1.0,0,75,75,74
78,seq84,r_55_19_142,r_115_56_114,r_115_56_114,0.81,28,142,114,74
20,r_90_15_104,seq106,seq82,r_90_15_104,0.98,0,104,104,74
13,r_72_118_197,r_114_23_175,r_65_119_135,r_72_118_197,0.62,-53,144,197,74
15,r_13_129_81,seq93,seq45,r_13_129_81,1.0,0,81,81,74
71,seq68,r_17_69_57,seq38,r_17_69_57,1.0,0,57,57,74
6,r_76_40_162,seq5,r_91_113_61,r_91_113_61,1.0,103,164,61,74
27,r_44_86_111,seq38,seq1,r_44_86_111,1.0,0,111,111,74
29,r_71_88_79,seq46,seq61,r_71_88_79,1.0,0,79,79,74
25,r_126_128_159,r_76_40_162,seq68,r_126_128_159,0.68,0,159,159,74
64,seq58,seq123,r_49_16_139,r_49_16_139,0.67,-1,138,139,74
9,r_50_62_188,seq105,r_120_26_97,r_120_26_97,0.67,91,188,97,74
17,r_121_70_13,seq99,seq53,r_121_70_13,0.99,0,13,13,74
28,r_115_56_114,seq36,seq84,r_115_56_114,0.7,0,114,114,74
1,r_55_19_142,seq84,seq37,r_55_19_142,1.0,0,142,142,74
7,r_91_113_61,seq1,seq93,r_91_113_61,0.98,1,62,61,74
23,r_103_24_181,seq30,seq77,r_103_24_181,0.68,0,181,181,74
0,r_7_29_16,r_20_98_35,seq5,r_20_98_35,0.88,-19,16,35,74
2,r_20_98_35,seq111,seq42,r_20_98_35,1.0,1,36,35,74
5,r_100_124_55,seq38,seq105,r_100_124_55,0.99,0,55,55,74
51,seq38,r_85_108_129,seq105,r_85_108_129,1.0,1,130,129,75
14,r_100_60_115,r_41_40_134,r_16_66_137,r_100_60_115,1.0,0,115,115,75
53,seq129,seq74,r_98_43_91,r_98_43_91,1.0,21,112,91,75
43,seq24,seq110,r_9_49_95,r_9_49_95,0.95,14,109,95,75
1,r_116_47_112,seq12,seq27,r_116_47_112,1.0,0,112,112,75
22,r_79_96_36,seq97,seq80,r_79_96_36,1.0,0,36,36,75
24,r_86_103_23,seq50,r_29_112_109,r_29_112_109,0.98,1,110,109,75
19,r_92_15_143,seq120,seq22,r_92_15_143,0.94,0,143,143,75
66,seq67,r_70_121_120,seq59,r_70_121_120,1.0,2,122,120,75
3,r_29_112_109,r_25_19_161,r_86_103_23,r_29_112_109,0.82,0,109,109,75
10,r_6_91_131,seq84,seq38,r_6_91_131,0.93,0,131,131,75
26,r_95_68_122,seq129,seq13,r_95_68_122,0.97,0,122,122,75
0,r_25_19_161,seq93,seq7,r_25_19_161,0.84,0,161,161,75
20,r_71_11_107,seq119,seq107,r_71_11_107,0.99,0,107,107,75
15,r_76_23_88,r_99_77_194,r_5_18_24,r_76_23_88,1.0,1,89,88,75
12,r_41_40_134,r_61_35_191,seq42,r_41_40_134,0.96,0,134,134,75
6,r_9_49_95,r_56_57_5,seq24,r_9_49_95,0.94,0,95,95,75
13,r_72_45_14,seq107,seq63,r_72_45_14,1.0,0,14,14,75
17,r_78_104_86,r_100_60_115,seq28,r_100_60_115,1.0,0,115,115,75
27,r_85_108_129,seq38,r_100_60_115,r_85_108_129,0.95,1,130,129,75
24,r_86_103_23,r_100_60_115,seq50,r_86_103_23,0.87,1,24,23,75
4,r_5_18_24,seq74,seq36,r_5_18_24,1.0,0,24,24,75
74,seq84,r_6_91_131,r_16_66_137,r_6_91_131,0.98,0,131,131,75
25,r_52_26_169,seq22,r_29_112_109,r_29_112_109,0.59,56,165,109,75
16,r_125_32_47,seq58,seq34,r_125_32_47,0.97,1,48,47,75
64,seq64,seq107,r_70_121_120,r_70_121_120,0.99,22,142,120,75
2,r_48_51_46,r_85_108_129,r_72_45_14,r_48_51_46,1.0,2,48,46,75
17,r_78_104_86,seq22,r_100_60_115,r_78_104_86,0.9,0,86,86,75
28,r_70_121_120,seq67,seq64,r_70_121_120,0.91,2,122,120,75
7,r_98_43_91,seq22,seq129,r_98_43_91,1.0,1,92,91,75
12,r_41_40_134,r_100_60_115,r_61_35_191,r_100_60_115,0.67,-33,82,115,75
14,r_41_51_175,seq22,r_119_0_66,r_119_0_66,1.0,110,176,66,76
8,r_109_123_152,r_6_127_150,seq22,r_109_123_152,0.48,4,156,152,76
37,seq13,r_16_58_55,r_45_121_37,r_45_121_37,1.0,-2,35,37,76
26,r_5_92_39,r_98_63_144,seq74,r_98_63_144,0.73,-97,47,144,76
86,seq94,r_79_88_173,r_98_63_144,r_98_63_144,0.89,15,159,144,76
16,r_9_39_170,r_117_48_176,seq25,r_9_39_170,0.54,0,170,170,76
97,seq118,r_89_100_188,seq55,r_89_100_188,0.51,1,189,188,76
80,seq78,seq28,r_116_122_101,r_116_122_101,0.57,34,135,101,76
10,r_16_58_55,seq84,r_6_127_150,r_6_127_150,0.58,-93,57,150,76
19,r_6_127_150,r_109_123_152,r_93_99_146,r_6_127_150,0.43,6,156,150,76
13,r_90_82_26,seq1,r_50_115_91,r_50_115_91,0.47,-65,26,91,76
27,r_45_121_37,r_20_42_43,seq13,r_45_121_37,1.0,-2,35,37,76
62,seq55,r_64_83_86,seq114,r_64_83_86,1.0,-29,57,86,76
20,r_116_122_101,seq15,seq19,r_116_122_101,1.0,0,101,101,76
48,seq26,seq91,r_50_115_91,r_50_115_91,1.0,13,104,91,76
13,r_90_82_26,r_50_115_91,seq111,r_50_115_91,0.94,0,91,91,76
6,r_107_95_117,seq19,r_103_120_106,r_107_95_117,1.0,0,117,117,76
29,r_117_48_176,r_9_39_170,r_107_95_117,r_107_95_117,0.67,59,176,117,76
24,r_38_27_184,seq34,seq78,r_38_27_184,0.41,0,184,184,76
25,r_119_0_66,seq18,seq73,r_119_0_66,1.0,0,66,66,76
17,r_76_102_90,seq57,r_52_29_45,r_52_29_45,0.82,45,90,45,76
5,r_37_97_48,r_125_43_2,seq36,r_37_97_48,0.6,9,57,48,76
9,r_103_120_106,seq74,seq71,r_103_120_106,0.92,0,106,106,76
41,seq18,r_119_0_66,seq15,r_119_0_66,0.99,-15,51,66,76
22,r_61_80_134,seq14,seq17,r_61_80_134,0.62,0,134,134,76
28,r_50_115_91,seq66,seq26,r_50_115_91,0.79,0,91,91,76
4,r_52_29_45,seq8,seq59,r_52_29_45,1.0,0,45,45,76
7,r_98_63_144,seq111,seq94,r_98_63_144,0.74,0,144,144,76
23,r_2_86_145,seq59,seq70,r_2_86_145,0.82,1,146,145,76
11,r_20_42_43,r_41_51_175,seq73,r_20_42_43,0.91,-4,39,43,76
12,r_64_83_86,seq55,seq12,r_64_83_86,1.0,0,86,86,76
27,r_32_12_47,seq103,seq125,r_32_12_47,1.0,-3,44,47,77
9,r_22_26_17,r_86_3_172,r_105_84_167,r_22_26_17,0.56,155,172,17,77
14,r_83_56_110,seq92,seq103,r_83_56_110,0.66,2,112,110,77
8,r_124_66_190,seq50,r_45_117_64,r_45_117_64,1.0,126,190,64,77
22,r_80_6_52,r_119_65_181,seq28,r_80_6_52,1.0,0,52,52,77
16,r_30_19_65,r_38_7_168,seq57,r_30_19_65,1.0,3,68,65,77
21,r_9_110_191,r_108_20_143,seq53,r_108_20_143,0.94,3,146,143,77
5,r_119_65_181,seq49,r_115_67_148,r_115_67_148,0.79,33,181,148,77
7,r_38_7_168,seq16,seq116,r_38_7_168,0.71,4,172,168,77
9,r_22_26_17,seq47,r_86_3_172,r_22_26_17,0.99,0,17,17,77
19,r_27_99_87,r_61_90_161,seq35,r_27_99_87,0.93,0,87,87,77
18,r_95_31_12,seq125,seq127,r_95_31_12,0.84,0,12,12,77
3,r_104_129_112,seq103,seq118,r_104_129_112,0.92,0,112,112,77
10,r_45_117_64,seq52,seq78,r_45_117_64,1.0,0,64,64,77
26,r_108_20_143,r_9_110_191,r_122_43_141,r_9_110_191,0.9,-45,146,191,77
0,r_76_96_105,seq21,seq112,r_76_96_105,0.98,3,108,105,77
13,r_62_123_88,r_98_17_196,seq46,r_62_123_88,1.0,0,88,88,77
4,r_86_3_172,r_22_26_17,seq18,r_22_26_17,0.51,155,172,17,77
57,seq49,r_119_65_181,r_104_129_112,r_104_129_112,0.92,69,181,112,77
29,r_128_106_31,seq2,seq107,r_128_106_31,1.0,0,31,31,77
4,r_86_3_172,r_115_67_148,r_22_26_17,r_22_26_17,0.96,2,19,17,77
87,seq103,seq57,r_83_56_110,r_83_56_110,0.98,60,170,110,77
2,r_61_90_161,seq51,r_27_99_87,r_27_99_87,0.69,74,161,87,77
97,seq125,r_124_66_190,r_70_40_44,r_70_40_44,1.0,0,44,44,77
24,r_77_85_128,seq118,seq82,r_77_85_128,0.91,3,131,128,77
25,r_91_111_189,seq51,seq39,r_91_111_189,0.46,1,190,189,77
12,r_70_40_44,r_62_123_88,seq125,r_70_40_44,0.97,0,44,44,77
60,seq52,r_45_117_64,seq25,r_45_117_64,1.0,-2,62,64,77
17,r_115_67_148,seq60,seq15,r_115_67_148,0.95,1,149,148,77
28,r_105_84_167,r_9_110_191,seq121,r_105_84_167,0.56,2,169,167,77
7,r_38_7_168,r_30_19_65,seq16,r_30_19_65,0.74,3,68,65,77
23,r_1_29_132,seq21,seq49,r_1_29_132,0.9,0,132,132,77
93,seq116,r_79_129_121,seq112,r_79_129_121,1.0,0,121,121,78
51,seq35,r_103_46_154,seq3,r_103_46_154,0.83,3,157,154,78
8,r_62_6_71,seq70,seq86,r_62_6_71,0.96,0,71,71,78
10,r_54_100_119,r_111_85_159,seq44,r_54_100_119,0.65,-8,111,119,78
1,r_23_57_39,seq18,seq122,r_23_57_39,1.0,0,39,39,78
89,seq109,r_22_5_190,r_103_46_154,r_103_46_154,0.89,3,157,154,78
34,seq4,r_61_121_45,r_81_1_6,r_61_121_45,1.0,-19,26,45,78
31,seq128,r_111_85_159,r_115_36_73,r_115_36_73,1.0,86,159,73,78
89,seq109,r_113_99_138,r_22_5_190,r_22_5_190,0.63,-116,74,190,78
10,r_54_100_119,seq119,r_111_85_159,r_111_85_159,0.46,-75,84,159,78
72,seq76,r_17_28_176,r_58_89_88,r_58_89_88,1.0,88,176,88,78
4,r_56_27_107,seq83,r_20_37_197,r_56_27_107,0.58,4,111,107,78
78,seq86,seq0,r_62_6_71,r_62_6_71,1.0,35,106,71,78
0,r_79_129_121,seq116,seq98,r_79_129_121,0.71,0,121,121,78
11,r_17_28_176,seq76,seq59,r_17_28_176,0.3,0,176,176,78
20,r_8_95_82,r_49_19_158,seq25,r_8_95_82,1.0,1,83,82,78
13,r_113_99_138,seq116,r_61_121_45,r_61_121_45,0.86,96,141,45,78
15,r_93_69_127,seq29,seq59,r_93_69_127,0.52,1,128,127,78
6,r_103_46_154,seq35,seq109,r_103_46_154,0.84,3,157,154,78
27,r_71_126_83,r_20_37_197,seq102,r_71_126_83,1.0,0,83,83,78
18,r_48_73_58,seq31,seq44,r_48_73_58,1.0,2,60,58,78
24,r_81_1_6,r_58_89_88,r_13_21_55,r_81_1_6,1.0,82,88,6,78
25,r_30_104_188,seq112,r_13_21_55,r_13_21_55,0.98,134,189,55,78
77,seq83,r_56_27_107,seq39,r_56_27_107,0.94,10,117,107,78
18,r_48_73_58,seq44,r_96_34_81,r_96_34_81,0.93,4,85,81,78
21,r_61_121_45,r_111_85_159,seq2,r_61_121_45,1.0,1,46,45,78
22,r_22_5_190,seq16,r_79_129_121,r_79_129_121,0.89,69,190,121,78
28,r_115_36_73,seq9,seq128,r_115_36_73,1.0,0,73,73,78
2,r_13_21_55,seq16,r_81_1_6,r_13_21_55,1.0,0,55,55,78
7,r_58_89_88,r_81_1_6,seq101,r_58_89_88,1.0,0,88,88,78
12,r_111_85_159,seq128,seq39,r_111_85_159,0.77,0,159,159,78
8,r_50_106_63,seq73,r_91_55_21,r_50_106_63,1.0,0,63,63,79
83,seq97,r_101_52_159,seq107,r_101_52_159,0.83,1,160,159,79
71,seq73,r_50_106_63,seq25,r_50_106_63,1.0,0,63,63,79
16,r_129_48_129,seq109,seq114,r_129_48_129,1.0,0,129,129,79
21,r_58_100_72,seq60,r_9_7_116,r_58_100_72,0.93,0,72,72,79
1,r_34_72_155,seq45,r_112_67_137,r_34_72_155,0.81,0,155,155,79
5,r_43_27_133,r_9_7_116,seq20,r_9_7_116,0.72,0,116,116,79
19,r_65_93_169,seq10,r_80_86_36,r_80_86_36,0.7,134,170,36,79
9,r_110_4_40,seq54,seq75,r_110_4_40,1.0,0,40,40,79
48,seq29,seq31,r_44_11_14,r_44_11_14,1.0,0,14,14,79
31,seq128,seq60,r_116_74_86,r_116_74_86,0.96,8,94,86,79
5,r_43_27_133,seq20,r_5_82_7,r_43_27_133,0.77,1,134,133,79
89,seq109,r_129_48_129,seq19,r_129_48_129,1.0,0,129,129,79
3,r_123_98_69,r_34_72_155,seq89,r_123_98_69,1.0,0,69,69,79
10,r_49_21_130,seq3,r_69_59_82,r_69_59_82,1.0,43,125,82,79
4,r_77_56_144,seq40,seq121,r_77_56_144,0.91,0,144,144,79
6,r_76_78_17,seq53,seq71,r_76_78_17,0.99,0,17,17,79
78,seq89,seq47,r_123_98_69,r_123_98_69,1.0,29,98,69,79
0,r_104_14_91,seq19,r_117_92_50,r_117_92_50,0.97,41,91,50,79
11,r_15_26_84,seq35,seq25,r_15_26_84,1.0,0,84,84,79
12,r_117_92_50,r_34_72_155,seq113,r_117_92_50,1.0,0,50,50,79
13,r_9_7_116,r_43_27_133,r_15_26_84,r_9_7_116,0.61,0,116,116,79
18,r_80_86_36,r_101_52_159,seq40,r_80_86_36,1.0,0,36,36,79
15,r_116_74_86,seq39,seq128,r_116_74_86,0.94,0,86,86,79
23,r_112_67_137,seq81,r_34_72_155,r_34_72_155,0.96,1,156,155,79
62,seq57,r_112_67_137,r_32_85_26,r_112_67_137,0.56,-77,60,137,79
27,r_37_42_64,r_49_21_130,seq53,r_37_42_64,1.0,0,64,64,79
70,seq71,seq75,r_76_78_17,r_76_78_17,0.99,20,37,17,79
29,r_101_52_159,seq97,seq45,r_101_52_159,0.69,1,160,159,79
24,r_115_127_121,r_101_52_159,r_80_86_36,r_101_52_159,1.0,-33,126,159,79
25,r_30_68_188,seq88,seq22,r_30_68_188,0.39,-1,187,188,79
77,seq88,r_122_1_149,seq10,r_122_1_149,0.87,0,149,149,79
2,r_32_85_26,seq16,seq57,r_32_85_26,0.77,-1,25,26,79
21,r_58_100_72,r_9_7_116,seq24,r_9_7_116,1.0,0,116,116,79
22,r_122_1_149,seq88,r_76_78_17,r_76_78_17,0.86,132,149,17,79
28,r_69_59_82,seq54,seq0,r_69_59_82,0.99,-2,80,82,79
91,seq113,seq28,r_117_92_50,r_117_92_50,1.0,27,77,50,79
49,seq31,seq16,r_79_38_75,r_79_38_75,1.0,7,82,75,79
17,r_91_55_21,seq46,seq53,r_91_55_21,0.7,0,21,21,79
35,seq10,r_65_93_169,seq20,r_65_93_169,0.99,1,170,169,79
1,r_14_88_46,r_101_91_81,seq24,r_14_88_46,0.97,0,46,46,80
55,seq39,r_99_6_185,r_123_118_38,r_123_118_38,0.61,5,43,38,80
21,r_25_80_73,seq129,seq45,r_25_80_73,0.96,1,74,73,80
5,r_99_6_185,seq26,r_33_106_199,r_33_106_199,0.71,-12,187,199,80
80,seq82,seq24,r_112_76_97,r_112_76_97,0.54,5,102,97,80
33,seq3,r_116_4_23,r_122_17_144,r_122_17_144,1.0,19,163,144,80
27,r_52_77_35,r_14_88_46,seq129,r_52_77_35,1.0,0,35,35,80
3,r_21_92_82,seq13,r_25_80_73,r_21_92_82,1.0,0,82,82,80
26,r_48_60_131,seq127,seq26,r_48_60_131,0.92,2,133,131,80
4,r_22_108_122,seq111,seq83,r_22_108_122,0.95,0,122,122,80
13,r_97_36_65,r_81_87_193,seq59,r_97_36_65,0.94,2,67,65,80
48,seq26,r_99_6_185,seq39,r_99_6_185,0.4,2,187,185,80
20,r_67_78_52,seq43,seq61,r_67_78_52,1.0,0,52,52,80
14,r_123_118_38,seq68,seq39,r_123_118_38,0.95,-2,36,38,80
6,r_109_62_136,seq61,r_101_91_81,r_109_62_136,0.98,0,136,136,80
85,seq93,r_58_71_182,r_101_91_81,r_101_91_81,1.0,17,98,81,80
19,r_66_107_53,r_109_62_136,seq41,r_66_107_53,1.0,2,55,53,80
7,r_53_86_41,seq95,r_81_87_193,r_53_86_41,0.87,0,41,41,80
2,r_122_17_144,r_34_50_157,seq3,r_122_17_144,0.7,4,148,144,80
34,seq5,r_14_88_46,r_23_46_19,r_23_46_19,0.63,0,19,19,80
29,r_101_91_81,seq5,seq93,r_101_91_81,0.87,13,94,81,80
24,r_102_28_129,r_81_87_193,r_112_76_97,r_112_76_97,0.75,45,142,97,80
18,r_23_46_19,seq29,seq5,r_23_46_19,0.88,0,19,19,80
16,r_84_103_48,seq8,seq74,r_84_103_48,1.0,0,48,48,80
17,r_112_76_97,seq64,seq82,r_112_76_97,0.7,5,102,97,80
9,r_9_96_181,seq128,r_14_88_46,r_9_96_181,0.35,2,183,181,80
33,seq3,seq128,r_116_4_23,r_116_4_23,0.98,0,23,23,80
57,seq41,seq8,r_66_107_53,r_66_107_53,1.0,0,53,53,80
22,r_116_4_23,r_81_87_193,seq3,r_116_4_23,0.91,0,23,23,80
35,seq128,r_9_96_181,seq95,r_9_96_181,0.51,2,183,181,80
12,r_34_50_157,seq110,seq100,r_34_50_157,0.49,1,158,157,80
8,r_81_87_193,r_97_36_65,r_53_86_41,r_53_86_41,0.99,1,42,41,80
37,seq128,r_8_120_198,r_106_30_134,r_106_30_134,0.98,2,136,134,81
20,r_50_127_30,seq128,seq63,r_50_127_30,0.93,-4,26,30,81
16,r_115_95_128,seq85,seq55,r_115_95_128,0.99,0,128,128,81
21,r_47_72_155,seq3,r_83_81_44,r_47_72_155,0.88,1,156,155,81
1,r_67_40_180,r_108_129_34,seq4,r_108_129_34,0.66,147,181,34,81
5,r_73_75_154,seq33,r_89_74_48,r_73_75_154,0.75,0,154,154,81
76,seq79,r_106_30_134,seq29,r_106_30_134,0.99,0,134,134,81
41,seq17,r_8_120_198,r_103_32_57,r_103_32_57,1.0,119,176,57,81
3,r_7_123_121,seq9,r_34_14_83,r_34_14_83,1.0,38,121,83,81
22,r_108_129_34,r_22_125_2,r_67_40_180,r_108_129_34,0.81,0,34,34,81
15,r_107_44_15,r_103_32_57,r_8_120_198,r_107_44_15,0.99,0,15,15,81
26,r_2_122_130,r_22_125_2,seq38,r_2_122_130,0.57,0,130,130,81
4,r_66_15_105,seq48,seq68,r_66_15_105,0.61,4,109,105,81
15,r_107_44_15,r_8_120_198,seq128,r_107_44_15,0.44,50,65,15,81
78,seq85,r_115_95_128,seq4,r_115_95_128,1.0,0,128,128,81
6,r_106_30_134,seq79,seq128,r_106_30_134,0.96,0,134,134,81
2,r_34_14_83,seq21,r_7_123_121,r_34_14_83,0.53,47,130,83,81
8,r_103_32_57,seq35,seq17,r_103_32_57,1.0,0,57,57,81
2,r_34_14_83,seq70,seq21,r_34_14_83,1.0,0,83,83,81
40,seq16,seq3,r_86_87_72,r_86_87_72,0.98,0,72,72,81
18,r_86_87_72,seq112,seq16,r_86_87_72,1.0,0,72,72,81
29,r_114_10_76,r_66_15_105,r_82_62_33,r_114_10_76,0.93,4,80,76,81
24,r_25_88_67,r_92_28_95,seq48,r_92_28_95,0.67,-26,69,95,81
25,r_118_37_64,seq17,seq54,r_118_37_64,1.0,1,65,64,81
19,r_80_56_56,r_7_123_121,seq97,r_80_56_56,1.0,0,56,56,81
88,seq105,seq5,r_82_62_33,r_82_62_33,0.94,35,68,33,81
11,r_65_57_59,r_7_123_121,seq3,r_65_57_59,1.0,0,59,59,81
70,seq63,seq5,r_50_127_30,r_50_127_30,0.98,31,61,30,81
27,r_82_62_33,r_34_14_83,seq105,r_82_62_33,0.58,1,34,33,81
14,r_69_64_21,seq27,seq35,r_69_64_21,0.99,2,23,21,81
10,r_83_81_44,seq5,seq39,r_83_81_44,1.0,0,44,44,81
77,seq84,r_78_98_184,r_73_75_154,r_73_75_154,0.59,31,185,154,81
53,seq35,r_103_32_57,r_69_64_21,r_103_32_57,0.89,0,57,57,81
9,r_78_98_184,seq84,r_83_81_44,r_83_81_44,0.59,141,185,44,81
28,r_92_28_95,seq91,r_22_125_2,r_92_28_95,0.68,9,104,95,81
7,r_22_125_2,r_2_122_130,r_92_28_95,r_22_125_2,0.8,128,130,2,81
23,r_51_49_86,seq54,seq17,r_51_49_86,1.0,0,86,86,81
17,r_93_60_42,r_66_15_105,seq53,r_93_60_42,0.99,0,42,42,81
51,seq29,r_78_36_3,r_129_10_61,r_129_10_61,1.0,4,65,61,82
14,r_115_7_74,seq6,seq4,r_115_7_74,1.0,0,74,74,82
8,r_127_82_69,seq6,seq23,r_127_82_69,0.98,0,69,69,82
53,seq32,r_114_46_186,r_127_82_69,r_127_82_69,0.99,119,188,69,82
43,seq17,r_107_3_149,r_30_93_71,r_30_93_71,0.98,79,150,71,82
94,seq110,seq116,r_53_39_12,r_53_39_12,0.98,17,29,12,82
16,r_97_118_156,seq79,r_27_28_62,r_27_28_62,1.0,94,156,62,82
21,r_58_102_106,seq23,r_124_92_89,r_58_102_106,1.0,0,106,106,82
1,r_81_62_170,seq101,r_75_108_100,r_81_62_170,0.66,0,170,170,82
5,r_75_108_100,seq119,r_24_51_15,r_75_108_100,1.0,0,100,100,82
46,seq21,r_113_59_153,r_127_82_69,r_127_82_69,0.78,85,154,69,82
19,r_84_63_162,r_122_43_167,r_113_59_153,r_122_43_167,0.91,-5,162,167,82
28,r_98_83_155,r_87_69_32,r_24_51_15,r_98_83_155,1.0,-137,18,155,82
2,r_87_69_32,r_30_93_71,r_96_95_1,r_87_69_32,0.98,0,32,32,82
41,seq14,seq6,r_123_44_85,r_123_44_85,0.51,-4,81,85,82
17,r_53_39_12,seq35,seq110,r_53_39_12,1.0,0,12,12,82
26,r_129_10_61,seq6,seq29,r_129_10_61,1.0,0,61,61,82
11,r_19_125_102,r_113_59_153,seq4,r_19_125_102,1.0,0,102,102,82
20,r_124_92_89,seq26,seq49,r_124_92_89,1.0,0,89,89,82
15,r_107_3_149,seq17,seq34,r_107_3_149,0.97,1,150,149,82
48,seq23,r_58_102_106,seq52,r_58_102_106,1.0,0,106,106,82
62,seq48,r_37_120_11,seq1,r_37_120_11,0.58,109,120,11,82
0,r_24_51_15,r_98_83_155,r_75_108_100,r_75_108_100,0.75,55,155,100,82
3,r_96_95_1,seq74,r_87_69_32,r_87_69_32,1.0,18,50,32,82
27,r_122_43_167,r_84_63_162,seq23,r_84_63_162,0.8,4,166,162,82
74,seq71,r_70_65_145,seq64,r_70_65_145,0.98,3,148,145,82
24,r_123_44_85,r_96_95_1,seq14,r_123_44_85,0.75,0,85,85,82
0,r_24_51_15,seq0,r_98_83_155,r_24_51_15,0.98,0,15,15,82
25,r_27_28_62,seq90,seq85,r_27_28_62,1.0,0,62,62,82
9,r_114_46_186,seq32,r_70_65_145,r_114_46_186,0.54,0,186,186,82
28,r_98_83_155,r_24_51_15,seq22,r_98_83_155,0.88,0,155,155,82
22,r_15_111_92,seq6,seq79,r_15_111_92,0.69,-2,90,92,82
23,r_113_59_153,seq21,seq64,r_113_59_153,0.94,1,154,153,82
12,r_30_93_71,seq40,seq17,r_30_93_71,1.0,1,72,71,82
14,r_120_19_45,r_51_110_48,seq37,r_120_19_45,1.0,0,45,45,83
55,seq38,r_30_80_176,r_24_82_122,r_24_82_122,0.47,1,123,122,83
16,r_10_70_185,seq86,r_14_56_85,r_14_56_85,0.74,100,185,85,83
21,r_99_43_84,seq4,seq52,r_99_43_84,1.0,0,84,84,83
18,r_78_95_50,r_45_47_54,seq84,r_78_95_50,1.0,0,50,50,83
1,r_121_36_170,seq0,r_120_19_45,r_121_36_170,0.72,0,170,170,83
5,r_44_58_132,seq124,seq73,r_44_58_132,0.98,0,132,132,83
80,seq91,r_60_123_192,r_14_56_85,r_14_56_85,1.0,18,103,85,83
19,r_101_118_123,r_90_29_198,r_51_110_48,r_90_29_198,1.0,-74,124,198,83
76,seq84,seq104,r_78_95_50,r_78_95_50,1.0,14,64,50,83
26,r_50_66_23,r_101_118_123,seq7,r_50_66_23,1.0,0,23,23,83
41,seq15,seq32,r_111_31_72,r_111_31_72,1.0,0,72,72,83
6,r_67_75_55,r_108_125_126,seq63,r_67_75_55,1.0,0,55,55,83
3,r_30_80_176,seq112,seq128,r_30_80_176,0.6,0,176,176,83
27,r_9_77_14,r_121_36_170,seq34,r_121_36_170,0.5,-155,15,170,83
11,r_51_110_48,seq102,seq0,r_51_110_48,1.0,0,48,48,83
0,r_108_125_126,seq55,seq23,r_108_125_126,1.0,0,126,126,83
20,r_14_56_85,seq49,seq91,r_14_56_85,0.97,0,85,85,83
13,r_61_98_174,seq124,r_93_87_169,r_61_98_174,0.52,0,174,174,83
15,r_24_82_122,seq115,seq38,r_24_82_122,0.86,1,123,122,83
12,r_42_68_142,r_62_1_66,seq59,r_42_68_142,1.0,0,142,142,83
2,r_111_31_72,seq83,seq15,r_111_31_72,1.0,0,72,72,83
29,r_40_127_120,seq72,seq41,r_40_127_120,0.97,0,120,120,83
24,r_28_33_109,seq59,seq72,r_28_33_109,0.83,0,109,109,83
25,r_90_29_198,r_101_118_123,seq79,r_101_118_123,1.0,1,124,123,83
68,seq65,seq79,r_54_88_37,r_54_88_37,1.0,20,57,37,83
70,seq73,r_42_68_142,seq96,r_42_68_142,1.0,-34,108,142,83
9,r_45_47_54,seq21,seq107,r_45_47_54,1.0,0,54,54,83
22,r_26_69_60,seq63,seq76,r_26_69_60,1.0,1,61,60,83
28,r_100_5_75,r_28_33_109,seq49,r_100_5_75,1.0,0,75,75,83
91,seq112,r_30_80_176,r_24_82_122,r_24_82_122,0.84,49,171,122,83
7,r_62_1_66,r_99_43_84,seq73,r_62_1_66,0.89,3,69,66,83
8,r_71_53_33,r_42_68_142,seq55,r_71_53_33,0.99,0,33,33,83
85,seq102,r_51_110_48,seq85,r_51_110_48,1.0,0,48,48,83
12,r_42_68_142,seq73,r_62_1_66,r_62_1_66,1.0,2,68,66,83
4,r_54_88_37,r_121_36_170,seq65,r_54_88_37,1.0,0,37,37,83
91,seq115,r_67_88_63,r_113_52_10,r_67_88_63,0.97,-13,50,63,84
14,r_71_82_91,seq90,seq6,r_71_82_91,0.96,0,91,91,84
88,seq106,seq50,r_85_96_37,r_85_96_37,0.91,0,37,37,84
54,seq47,r_5_19_158,seq17,r_5_19_158,0.99,2,160,158,84
3,r_8_111_11,seq23,seq24,r_8_111_11,1.0,0,11,11,84
1,r_7_55_94,seq24,seq17,r_7_55_94,0.99,0,94,94,84
7,r_40_34_26,r_124_126_159,r_46_70_72,r_46_70_72,0.7,87,159,72,84
18,r_26_107_13,seq11,seq78,r_26_107_13,1.0,-1,12,13,84
89,seq109,seq50,r_129_32_105,r_129_32_105,1.0,21,126,105,84
71,seq78,r_65_28_35,r_26_107_13,r_26_107_13,1.0,-1,12,13,84
12,r_14_87_84,r_5_19_158,seq91,r_14_87_84,0.57,7,91,84,84
26,r_119_83_90,seq2,seq102,r_119_83_90,1.0,0,90,90,84
92,seq116,r_129_32_105,r_36_112_16,r_129_32_105,0.68,-51,54,105,84
4,r_46_70_72,r_14_87_84,seq74,r_46_70_72,1.0,0,72,72,84
13,r_67_88_63,seq115,seq24,r_67_88_63,1.0,0,63,63,84
7,r_40_34_26,seq91,r_124_126_159,r_40_34_26,0.94,0,26,26,84
15,r_129_32_105,seq116,seq100,r_129_32_105,0.95,0,105,105,84
2,r_124_126_159,r_27_76_32,r_40_34_26,r_40_34_26,0.85,0,26,26,84
0,r_62_35_21,r_71_82_91,seq104,r_62_35_21,0.5,-1,20,21,84
6,r_9_95_117,r_124_126_159,seq60,r_9_95_117,0.97,0,117,117,84
85,seq102,r_16_22_80,r_119_83_90,r_119_83_90,1.0,-2,88,90,84
2,r_124_126_159,r_40_34_26,seq29,r_124_126_159,0.87,0,159,159,84
21,r_57_66_28,seq1,seq41,r_57_66_28,0.99,0,28,28,84
27,r_51_13_62,r_129_32_105,seq2,r_51_13_62,0.82,0,62,62,84
29,r_10_21_133,seq30,r_65_28_35,r_10_21_133,0.98,0,133,133,84
82,seq99,r_79_108_188,r_113_52_10,r_113_52_10,0.96,18,28,10,84
16,r_85_96_37,seq73,seq106,r_85_96_37,1.0,0,37,37,84
25,r_58_86_110,seq29,r_85_96_37,r_58_86_110,0.97,1,111,110,84
10,r_31_63_44,r_118_114_144,r_85_96_37,r_31_63_44,1.0,0,44,44,84
68,seq74,r_92_68_186,r_46_70_72,r_46_70_72,1.0,114,186,72,84
38,seq17,r_5_19_158,r_7_55_94,r_7_55_94,0.47,59,153,94,84
9,r_113_52_10,r_129_32_105,seq99,r_113_52_10,1.0,0,10,10,84
17,r_36_112_16,seq64,seq116,r_36_112_16,1.0,0,16,16,84
22,r_5_19_158,seq47,r_118_114_144,r_5_19_158,0.96,1,159,158,84
28,r_79_108_188,seq99,seq74,r_79_108_188,0.36,1,189,188,84
23,r_118_114_144,seq53,seq127,r_118_114_144,0.89,1,145,144,84
42,seq24,r_65_28_35,r_8_111_11,r_8_111_11,1.0,7,18,11,84
12,r_14_87_84,r_46_70_72,r_5_19_158,r_46_70_72,0.96,-4,68,72,84
5,r_43_3_55,seq12,seq30,r_43_3_55,0.69,0,55,55,84
51,seq44,r_13_69_136,seq23,r_13_69_136,1.0,0,136,136,85
92,seq117,r_53_20_127,seq60,r_53_20_127,0.98,-24,103,127,85
8,r_40_73_165,seq30,seq41,r_40_73_165,0.88,0,165,165,85
3,r_107_29_58,seq94,r_103_71_170,r_103_71_170,0.68,9,179,170,85
71,seq78,r_26_112_172,r_61_7_98,r_61_7_98,0.96,74,172,98,85
21,r_97_67_171,seq6,seq51,r_97_67_171,0.76,0,171,171,85
19,r_10_15_130,r_40_73_165,seq88,r_10_15_130,0.98,0,130,130,85
95,seq123,r_109_120_97,seq129,r_109_120_97,1.0,0,97,97,85
27,r_93_55_44,seq43,seq21,r_93_55_44,1.0,1,45,44,85
10,r_26_112_172,seq78,seq66,r_26_112_172,0.68,0,172,172,85
16,r_114_80_36,seq33,seq64,r_114_80_36,1.0,0,36,36,85
26,r_3_79_179,r_97_67_171,seq6,r_97_67_171,0.85,-15,156,171,85
4,r_100_16_162,seq6,seq58,r_100_16_162,0.87,0,162,162,85
0,r_11_119_68,r_31_57_101,r_28_74_194,r_11_119_68,1.0,0,68,68,85
11,r_61_7_98,seq6,seq78,r_61_7_98,1.0,0,98,98,85
20,r_14_54_128,seq88,seq92,r_14_54_128,0.95,0,128,128,85
13,r_31_57_101,r_11_119_68,r_97_67_171,r_11_119_68,1.0,0,68,68,85
13,r_31_57_101,r_97_67_171,r_89_98_91,r_31_57_101,0.94,48,149,101,85
79,seq92,r_107_29_58,seq44,r_107_29_58,0.99,0,58,58,85
3,r_107_29_58,seq92,seq94,r_107_29_58,1.0,-1,57,58,85
79,seq92,seq44,r_14_54_128,r_14_54_128,1.0,18,146,128,85
2,r_109_120_97,r_27_35_129,r_5_108_23,r_5_108_23,0.92,74,97,23,85
15,r_128_85_39,r_40_73_165,seq62,r_128_85_39,1.0,0,39,39,85
29,r_70_118_164,seq87,r_0_1_139,r_0_1_139,0.73,25,164,139,85
25,r_27_35_129,seq123,seq4,r_27_35_129,1.0,0,129,129,85
33,seq6,r_100_16_162,r_3_79_179,r_100_16_162,0.96,2,164,162,85
96,seq124,r_11_119_68,seq66,r_11_119_68,0.71,-45,23,68,85
24,r_5_108_23,r_19_63_134,seq121,r_5_108_23,1.0,0,23,23,85
18,r_81_12_11,seq64,seq111,r_81_12_11,0.99,0,11,11,85
28,r_53_20_127,seq21,seq68,r_53_20_127,0.83,0,127,127,85
5,r_115_83_19,r_109_120_97,seq58,r_115_83_19,0.62,0,19,19,85
7,r_89_98_91,seq9,seq127,r_89_98_91,1.0,0,91,91,85
23,r_19_63_134,seq88,seq38,r_19_63_134,1.0,1,135,134,85
35,seq9,r_89_98_91,seq106,r_89_98_91,1.0,-12,79,91,85
12,r_103_71_170,seq78,r_107_29_58,r_107_29_58,0.99,111,169,58,85
14,r_79_11_119,seq19,r_128_109_121,r_79_11_119,1.0,0,119,119,86
86,seq102,r_35_104_71,seq9,r_35_104_71,1.0,0,71,71,86
16,r_35_104_71,seq102,seq122,r_35_104_71,1.0,0,71,71,86
21,r_128_109_121,r_0_78_133,seq43,r_128_109_121,0.95,0,121,121,86
1,r_119_17_101,seq18,seq92,r_119_17_101,1.0,0,101,101,86
5,r_100_26_116,seq18,seq71,r_100_26_116,1.0,0,116,116,86
69,seq71,r_65_5_193,r_100_26_116,r_100_26_116,1.0,24,140,116,86
19,r_4_60_82,r_126_55_170,seq16,r_126_55_170,0.78,-58,112,170,86
95,seq118,r_0_78_133,r_85_125_68,r_85_125_68,1.0,72,140,68,86
66,seq68,r_65_5_193,r_51_113_78,r_51_113_78,1.0,2,80,78,86
41,seq19,r_79_11_119,seq21,r_79_11_119,0.86,0,119,119,86
3,r_30_81_182,r_51_113_78,seq14,r_51_113_78,0.53,50,128,78,86
10,r_126_55_170,r_4_60_82,seq44,r_4_60_82,0.46,15,97,82,86
90,seq111,r_119_17_101,seq77,r_119_17_101,1.0,0,101,101,86
3,r_30_81_182,seq14,r_101_108_50,r_30_81_182,0.97,3,185,182,86
26,r_47_50_123,seq77,r_51_113_78,r_47_50_123,0.99,0,123,123,86
32,seq6,r_41_32_61,seq14,r_41_32_61,0.99,-37,24,61,86
4,r_53_8_198,r_24_3_129,r_100_26_116,r_100_26_116,0.99,15,131,116,86
0,r_24_3_129,r_53_8_198,r_119_17_101,r_119_17_101,0.99,30,131,101,86
73,seq77,r_47_50_123,seq49,r_47_50_123,1.0,0,123,123,86
20,r_124_15_109,r_61_46_149,seq57,r_124_15_109,1.0,0,109,109,86
13,r_121_99_177,seq36,seq28,r_121_99_177,0.72,0,177,177,86
15,r_73_88_156,seq93,seq39,r_73_88_156,0.86,0,156,156,86
94,seq116,seq28,r_58_95_19,r_58_95_19,1.0,5,24,19,86
10,r_126_55_170,seq44,r_24_3_129,r_126_55_170,0.56,4,174,170,86
17,r_58_95_19,seq42,seq116,r_58_95_19,1.0,0,19,19,86
2,r_87_96_97,seq10,seq97,r_87_96_97,1.0,1,98,97,86
47,seq31,r_110_66_105,seq127,r_110_66_105,1.0,-2,103,105,86
18,r_61_46_149,seq7,r_25_52_11,r_61_46_149,0.92,1,150,149,86
24,r_41_32_61,seq93,seq54,r_41_32_61,1.0,0,61,61,86
50,seq36,r_121_99_177,r_101_108_50,r_101_108_50,1.0,127,177,50,86
9,r_101_108_50,r_35_104_71,seq36,r_101_108_50,1.0,0,50,50,86
8,r_107_129_36,seq97,seq43,r_107_129_36,0.82,4,40,36,86
28,r_51_113_78,r_30_81_182,seq68,r_51_113_78,1.0,0,78,78,86
91,seq112,seq16,r_37_86_131,r_37_86_131,0.84,-1,130,131,86
7,r_85_125_68,r_107_129_36,seq118,r_85_125_68,1.0,0,68,68,86
23,r_117_74_176,seq34,seq80,r_117_74_176,0.55,0,176,176,86
12,r_110_66_105,seq31,r_85_125_68,r_110_66_105,0.99,0,105,105,86
30,seq0,r_40_34_170,seq43,r_40_34_170,0.32,6,176,170,87
14,r_73_128_90,seq2,r_3_48_88,r_3_48_88,0.99,22,110,88,87
8,r_29_88_106,seq35,seq5,r_29_88_106,1.0,0,106,106,87
19,r_109_38_138,r_102_33_49,r_47_23_139,r_109_38_138,1.0,1,139,138,87
86,seq107,r_6_103_158,seq75,r_6_103_158,0.71,-20,138,158,87
16,r_3_48_88,seq16,r_73_128_90,r_3_48_88,1.0,0,88,88,87
1,r_50_9_156,seq53,seq91,r_50_9_156,0.77,0,156,156,87
5,r_69_110_137,r_62_125_72,seq108,r_62_125_72,1.0,-3,69,72,87
69,seq79,r_55_42_172,r_69_110_137,r_69_110_137,0.66,23,160,137,87
66,seq75,r_6_103_158,seq107,r_6_103_158,0.59,2,160,158,87
10,r_31_59_66,seq45,r_95_82_26,r_31_59_66,0.99,0,66,66,87
26,r_61_15_189,seq20,r_73_128_90,r_61_15_189,0.41,0,189,189,87
20,r_102_33_49,seq91,seq45,r_102_33_49,1.0,0,49,49,87
0,r_49_36_124,seq76,seq19,r_49_36_124,0.78,1,125,124,87
13,r_41_28_118,seq39,seq81,r_41_28_118,0.96,0,118,118,87
15,r_14_1_65,r_109_38_138,r_4_21_198,r_109_38_138,0.62,-75,63,138,87
85,seq106,r_18_46_120,r_11_77_62,r_11_77_62,0.96,48,110,62,87
19,r_109_38_138,r_14_1_65,r_102_33_49,r_102_33_49,0.95,0,49,49,87
12,r_95_82_26,r_18_46_120,seq16,r_95_82_26,0.97,0,26,26,87
5,r_69_110_137,seq108,seq129,r_69_110_137,0.91,2,139,137,87
87,seq108,r_69_110_137,seq123,r_69_110_137,0.97,2,139,137,87
2,r_6_103_158,seq75,seq53,r_6_103_158,0.31,2,160,158,87
18,r_55_42_172,seq79,seq27,r_55_42_172,0.59,4,176,172,87
29,r_62_125_72,r_69_110_137,seq122,r_62_125_72,0.99,0,72,72,87
23,r_92_63_21,seq2,seq22,r_92_63_21,0.97,-4,17,21,87
4,r_94_124_44,r_29_88_106,seq127,r_94_124_44,1.0,-1,43,44,87
24,r_58_98_131,seq54,seq12,r_58_98_131,0.89,0,131,131,87
25,r_18_46_120,seq106,seq20,r_18_46_120,0.99,1,121,120,87
33,seq5,seq2,r_29_88_106,r_29_88_106,1.0,15,121,106,87
50,seq37,r_55_42_172,r_69_110_137,r_69_110_137,0.72,23,160,137,87
52,seq43,r_49_36_124,seq0,r_49_36_124,0.98,2,126,124,87
17,r_40_34_170,seq0,r_69_110_137,r_69_110_137,0.96,37,174,137,87
84,seq104,r_32_90_52,seq0,r_32_90_52,0.94,-12,40,52,87
21,r_32_90_52,seq104,seq123,r_32_90_52,1.0,0,52,52,87
9,r_114_119_180,seq30,seq108,r_114_119_180,0.45,1,181,180,87
22,r_47_23_139,seq106,r_109_38_138,r_47_23_139,0.9,-1,138,139,87
56,seq53,r_50_9_156,seq78,r_50_9_156,1.0,0,156,156,87
14,r_70_13_48,seq101,r_24_53_45,r_70_13_48,0.75,-3,45,48,88
27,r_41_65_13,seq27,seq68,r_41_65_13,0.46,108,121,13,88
54,seq44,r_42_118_73,seq40,r_42_118_73,0.74,2,75,73,88
37,seq9,r_12_46_170,r_88_45_101,r_88_45_101,1.0,10,111,101,88
1,r_79_39_81,r_95_75_115,seq35,r_79_39_81,0.98,0,81,81,88
23,r_34_126_44,seq61,seq99,r_34_126_44,1.0,0,44,44,88
19,r_95_75_115,r_79_39_81,seq44,r_79_39_81,1.0,-18,63,81,88
66,seq68,seq27,r_41_65_13,r_41_65_13,1.0,123,136,13,88
12,r_23_49_34,seq98,seq81,r_23_49_34,0.94,-3,31,34,88
31,seq1,r_12_46_170,r_88_45_101,r_88_45_101,1.0,10,111,101,88
3,r_33_83_172,seq103,seq113,r_33_83_172,0.54,1,173,172,88
90,seq103,r_33_83_172,r_79_39_81,r_79_39_81,0.91,92,173,81,88
26,r_57_50_145,seq109,seq11,r_57_50_145,0.88,0,145,145,88
0,r_88_45_101,seq92,seq9,r_88_45_101,1.0,0,101,101,88
20,r_12_46_170,seq1,r_24_53_45,r_12_46_170,0.54,0,170,170,88
15,r_85_106_155,seq10,seq89,r_85_106_155,0.76,0,155,155,88
6,r_108_123_112,r_66_104_154,r_79_39_81,r_66_104_154,0.91,-42,112,154,88
69,seq129,seq90,r_110_37_19,r_110_37_19,0.98,5,24,19,88
27,r_41_65_13,r_79_39_81,seq19,r_41_65_13,0.99,0,13,13,88
5,r_24_53_45,seq0,seq5,r_24_53_45,0.43,82,127,45,88
17,r_110_37_19,r_59_69_26,seq129,r_110_37_19,1.0,0,19,19,88
2,r_66_104_154,seq10,seq18,r_66_104_154,0.93,0,154,154,88
4,r_21_38_25,seq77,seq103,r_21_38_25,0.65,-1,24,25,88
74,seq80,r_26_93_166,seq11,r_26_93_166,0.99,-18,148,166,88
29,r_4_17_78,r_88_45_101,seq35,r_4_17_78,0.74,0,78,78,88
27,r_41_65_13,seq19,seq27,r_41_65_13,0.48,58,71,13,88
24,r_42_118_73,seq44,r_127_73_46,r_42_118_73,0.89,0,73,73,88
11,r_127_73_46,r_66_104_154,seq47,r_66_104_154,0.76,-111,43,154,88
25,r_28_114_92,seq27,r_34_126_44,r_34_126_44,1.0,48,92,44,88
19,r_95_75_115,seq44,seq29,r_95_75_115,0.98,2,117,115,88
86,seq99,seq101,r_34_126_44,r_34_126_44,1.0,6,50,44,88
5,r_24_53_45,seq43,seq0,r_24_53_45,0.93,12,57,45,88
9,r_36_31_82,r_57_50_145,r_59_69_26,r_36_31_82,0.99,-5,77,82,88
18,r_112_15_11,seq64,seq77,r_112_15_11,0.99,-1,10,11,88
22,r_54_96_61,r_36_31_82,seq113,r_54_96_61,1.0,0,61,61,88
28,r_8_86_119,seq56,seq10,r_8_86_119,0.55,13,132,119,88
10,r_111_116_37,seq47,seq27,r_111_116_37,1.0,0,37,37,88
7,r_26_93_166,seq80,seq22,r_26_93_166,0.78,0,166,166,88
21,r_122_109_54,r_99_34_140,seq43,r_122_109_54,0.82,0,54,54,89
14,r_114_3_126,seq48,seq20,r_114_3_126,0.98,0,126,126,89
71,seq69,r_129_7_113,seq28,r_129_7_113,0.61,0,113,113,89
26,r_77_60_52,seq13,seq107,r_77_60_52,1.0,0,52,52,89
16,r_16_37_138,seq1,seq9,r_16_37_138,0.94,0,138,138,89
1,r_14_2_139,r_55_38_146,r_126_125_71,r_55_38_146,0.59,-7,139,146,89
5,r_55_38_146,r_118_46_185,seq106,r_55_38_146,0.95,0,146,146,89
27,r_71_90_23,seq9,seq121,r_71_90_23,1.0,0,23,23,89
6,r_67_47_42,seq84,seq26,r_67_47_42,1.0,0,42,42,89
45,seq21,r_74_64_74,r_83_70_24,r_74_64_74,0.71,0,74,74,89
66,seq57,seq15,r_68_111_43,r_68_111_43,1.0,17,60,43,89
10,r_93_25_123,r_118_46_185,seq4,r_93_25_123,0.98,0,123,123,89
18,r_110_86_58,r_127_73_155,seq6,r_110_86_58,1.0,-1,57,58,89
19,r_83_70_24,r_30_88_125,seq100,r_83_70_24,1.0,-1,23,24,89
20,r_79_24_26,r_102_104_85,seq22,r_79_24_26,1.0,-1,25,26,89
11,r_54_124_65,r_14_2_139,seq115,r_54_124_65,1.0,0,65,65,89
2,r_68_111_43,seq32,seq57,r_68_111_43,1.0,0,43,43,89
13,r_74_64_74,seq21,seq26,r_74_64_74,1.0,0,74,74,89
87,seq100,seq6,r_83_70_24,r_83_70_24,1.0,11,35,24,89
0,r_99_34_140,r_41_103_37,seq52,r_99_34_140,1.0,0,140,140,89
29,r_118_46_185,seq43,r_41_103_37,r_118_46_185,0.65,0,185,185,89
24,r_126_125_71,seq44,seq85,r_126_125_71,1.0,0,71,71,89
8,r_35_128_27,seq11,seq12,r_35_128_27,0.96,2,29,27,89
25,r_127_73_155,seq20,r_62_80_181,r_127_73_155,0.56,10,165,155,89
64,seq53,seq115,r_83_70_24,r_83_70_24,0.99,65,89,24,89
0,r_99_34_140,r_122_109_54,r_41_103_37,r_99_34_140,0.99,-86,54,140,89
58,seq43,r_118_46_185,r_122_109_54,r_122_109_54,1.0,131,185,54,89
64,seq53,r_83_70_24,seq33,r_83_70_24,0.3,165,189,24,89
17,r_45_72_69,seq121,seq85,r_45_72_69,1.0,0,69,69,89
9,r_66_36_86,seq22,seq121,r_66_36_86,1.0,-1,85,86,89
22,r_0_112_100,seq4,seq116,r_0_112_100,1.0,0,100,100,89
28,r_30_88_125,seq78,r_61_96_81,r_30_88_125,0.98,0,125,125,89
7,r_102_104_85,seq48,seq29,r_102_104_85,1.0,4,89,85,89
44,seq20,r_127_73_155,r_114_3_126,r_114_3_126,0.78,29,155,126,89
3,r_41_103_37,seq106,seq11,r_41_103_37,1.0,0,37,37,89
12,r_61_96_81,seq97,seq95,r_61_96_81,1.0,0,81,81,89
14,r_90_109_95,r_32_80_59,seq96,r_32_80_59,1.0,1,60,59,90
8,r_107_88_111,seq37,seq22,r_107_88_111,0.98,1,112,111,90
43,seq22,seq64,r_107_88_111,r_107_88_111,1.0,3,114,111,90
22,r_14_62_22,seq15,seq28,r_14_62_22,0.93,4,26,22,90
16,r_9_125_128,seq50,seq25,r_9_125_128,0.58,1,129,128,90
21,r_32_80_59,r_90_109_95,r_48_120_6,r_48_120_6,0.82,54,60,6,90
46,seq25,seq63,r_9_125_128,r_9_125_128,0.89,1,129,128,90
10,r_105_122_43,r_40_87_87,seq33,r_105_122_43,0.9,0,43,43,90
26,r_104_108_141,seq100,seq31,r_104_108_141,0.72,0,141,141,90
4,r_12_78_79,seq7,r_32_80_59,r_12_78_79,1.0,2,81,79,90
0,r_36_39_82,seq2,seq18,r_36_39_82,0.92,0,82,82,90
11,r_76_41_113,seq24,seq23,r_76_41_113,0.57,7,120,113,90
20,r_26_114_65,seq100,seq86,r_26_114_65,1.0,1,66,65,90
13,r_16_110_180,seq42,r_94_95_40,r_16_110_180,0.68,-3,177,180,90
85,seq96,seq69,r_8_35_42,r_8_35_42,1.0,42,84,42,90
68,seq66,r_4_112_24,r_94_95_40,r_94_95_40,0.42,1,41,40,90
2,r_91_44_54,r_90_109_95,seq57,r_91_44_54,0.94,12,66,54,90
24,r_129_38_17,seq25,seq124,r_129_38_17,0.66,0,17,17,90
18,r_0_84_89,seq54,seq77,r_0_84_89,0.69,8,97,89,90
29,r_52_5_61,seq75,seq60,r_52_5_61,1.0,1,62,61,90
68,seq66,r_94_95_40,r_126_99_73,r_126_99_73,0.98,2,75,73,90
9,r_94_95_40,r_79_56_182,seq66,r_94_95_40,0.96,1,41,40,90
7,r_127_59_19,r_13_27_196,seq3,r_127_59_19,1.0,-3,16,19,90
64,seq60,r_13_27_196,r_52_5_61,r_52_5_61,1.0,31,92,61,90
3,r_65_47_39,r_105_122_43,seq53,r_65_47_39,0.94,2,41,39,90
12,r_4_112_24,seq18,seq98,r_4_112_24,1.0,1,25,24,90
14,r_90_109_95,seq96,r_48_120_6,r_90_109_95,0.99,0,95,95,90
23,r_128_97_90,seq63,r_94_95_40,r_128_97_90,0.99,0,90,90,90
5,r_71_30_41,seq46,seq6,r_71_30_41,0.97,8,49,41,90
9,r_94_95_40,seq66,r_128_97_90,r_128_97_90,0.97,0,90,90,90
17,r_8_35_42,r_13_27_196,seq96,r_8_35_42,0.99,0,42,42,90
36,seq12,r_14_49_163,r_7_122_86,r_7_122_86,1.0,69,155,86,91
8,r_27_58_19,seq75,seq78,r_27_58_19,0.98,0,19,19,91
14,r_106_32_116,seq85,seq19,r_106_32_116,0.83,4,120,116,91
21,r_45_64_112,r_44_39_143,seq25,r_44_39_143,0.56,-30,113,143,91
5,r_47_110_105,r_45_64_112,seq28,r_47_110_105,0.96,1,106,105,91
11,r_108_18_33,seq1,r_76_70_27,r_108_18_33,0.85,0,33,33,91
15,r_30_63_46,r_77_57_188,seq48,r_77_57_188,0.86,-9,179,188,91
95,seq115,r_21_26_168,r_72_81_120,r_72_81_120,0.87,54,174,120,91
10,r_95_117_186,seq107,r_3_94_133,r_3_94_133,0.94,54,187,133,91
26,r_11_80_187,r_95_117_186,r_7_122_86,r_95_117_186,0.26,1,187,186,91
16,r_61_120_31,seq111,r_14_49_163,r_14_49_163,0.86,5,168,163,91
4,r_76_70_27,r_45_64_112,seq65,r_76_70_27,1.0,0,27,27,91
20,r_66_0_173,seq59,seq60,r_66_0_173,0.44,1,174,173,91
13,r_34_97_158,seq69,r_101_23_100,r_34_97_158,0.67,0,158,158,91
98,seq121,r_14_49_163,seq15,r_14_49_163,0.87,-10,153,163,91
16,r_61_120_31,r_55_73_34,seq111,r_61_120_31,0.79,1,32,31,91
57,seq52,r_14_49_163,r_7_122_86,r_7_122_86,0.98,69,155,86,91
6,r_14_49_163,seq121,r_61_120_31,r_61_120_31,0.77,132,163,31,91
62,seq62,r_127_123_174,r_3_94_133,r_3_94_133,0.97,16,149,133,91
0,r_55_73_34,r_21_26_168,seq118,r_55_73_34,1.0,0,34,34,91
27,r_5_98_148,seq59,seq90,r_5_98_148,0.98,0,148,148,91
2,r_42_9_66,seq13,seq24,r_42_9_66,1.0,0,66,66,91
18,r_33_89_111,r_5_98_148,seq36,r_33_89_111,0.72,6,117,111,91
29,r_119_126_153,r_14_49_163,seq87,r_119_126_153,0.63,0,153,153,91
24,r_3_94_133,seq35,seq62,r_3_94_133,0.96,0,133,133,91
25,r_77_57_188,seq48,r_30_63_46,r_30_63_46,1.0,18,64,46,91
32,seq6,r_14_49_163,r_7_122_86,r_7_122_86,1.0,11,97,86,91
63,seq65,seq28,r_108_18_33,r_108_18_33,1.0,9,42,33,91
38,seq15,r_14_49_163,r_7_122_86,r_7_122_86,0.95,77,163,86,91
15,r_30_63_46,seq28,r_77_57_188,r_30_63_46,1.0,0,46,46,91
60,seq59,r_5_98_148,seq112,r_5_98_148,0.99,0,148,148,91
25,r_77_57_188,r_30_63_46,r_101_23_100,r_77_57_188,0.73,2,190,188,91
9,r_82_41_85,r_14_49_163,seq86,r_82_41_85,0.92,3,88,85,91
22,r_127_123_174,seq62,r_27_58_19,r_127_123_174,0.53,2,176,174,91
28,r_44_39_143,seq78,r_3_94_133,r_44_39_143,0.57,1,144,143,91
7,r_101_23_100,seq111,seq29,r_101_23_100,0.93,0,100,100,91
44,seq24,r_2_43_199,r_42_9_66,r_42_9_66,1.0,2,68,66,91
23,r_7_122_86,seq22,seq6,r_7_122_86,0.97,3,89,86,91
12,r_72_81_120,r_95_117_186,seq8,r_72_81_120,0.82,0,120,120,91
6,r_33_103_31,r_82_52_153,seq11,r_33_103_31,0.87,1,32,31,92
14,r_116_61_94,seq80,seq53,r_116_61_94,0.94,-6,88,94,92
29,r_25_81_46,seq128,seq127,r_25_81_46,0.86,0,46,46,92
8,r_89_36_116,seq0,seq66,r_89_36_116,1.0,0,116,116,92
53,seq39,r_82_52_153,r_118_21_125,r_82_52_153,0.97,-29,124,153,92
16,r_86_77_133,seq28,r_40_83_80,r_86_77_133,0.96,0,133,133,92
1,r_9_99_70,seq17,seq122,r_9_99_70,0.93,0,70,70,92
5,r_107_41_117,r_82_52_153,seq128,r_107_41_117,0.78,0,117,117,92
17,r_43_35_28,r_33_103_31,seq67,r_43_35_28,0.69,-8,20,28,92
67,seq59,r_104_126_166,r_38_13_20,r_104_126_166,1.0,0,166,166,92
89,seq102,seq28,r_30_47_85,r_30_47_85,1.0,19,104,85,92
3,r_124_125_41,seq4,seq119,r_124_125_41,0.89,-1,40,41,92
10,r_40_83_80,seq59,seq58,r_40_83_80,0.99,0,80,80,92
28,r_38_13_20,r_86_77_133,seq59,r_38_13_20,0.86,0,20,20,92
11,r_64_45_164,seq63,r_101_8_14,r_64_45_164,0.58,2,166,164,92
13,r_84_113_82,seq67,seq94,r_84_113_82,0.55,1,83,82,92
15,r_70_37_190,seq112,r_43_35_28,r_43_35_28,0.7,162,190,28,92
18,r_93_100_13,r_118_21_125,seq1,r_93_100_13,0.66,9,22,13,92
21,r_101_8_14,r_93_100_13,seq7,r_101_8_14,0.97,0,14,14,92
27,r_30_47_85,seq54,seq102,r_30_47_85,1.0,0,85,85,92
25,r_96_32_38,r_84_113_82,seq114,r_96_32_38,0.87,0,38,38,92
72,seq67,r_84_113_82,r_43_35_28,r_43_35_28,0.61,-8,20,28,92
64,seq55,r_118_21_125,seq16,r_118_21_125,0.99,2,127,125,92
26,r_110_29_42,r_108_111_92,seq53,r_110_29_42,0.96,-4,38,42,92
67,seq59,r_40_83_80,r_104_126_166,r_40_83_80,0.96,-26,54,80,92
23,r_108_111_92,seq58,r_87_19_40,r_108_111_92,0.95,0,92,92,92
7,r_87_19_40,seq7,seq69,r_87_19_40,0.95,0,40,40,92
22,r_66_18_35,seq28,seq60,r_66_18_35,1.0,0,35,35,93
5,r_53_126_120,seq93,r_66_18_35,r_53_126_120,0.98,1,121,120,93
46,seq29,r_90_74_178,seq35,r_90_74_178,0.97,0,178,178,93
61,seq56,seq25,r_5_95_15,r_5_95_15,0.98,12,27,15,93
14,r_105_118_20,seq44,seq71,r_105_118_20,0.87,0,20,20,93
16,r_108_15_19,r_89_48_59,seq13,r_108_15_19,0.8,1,20,19,93
17,r_59_8_110,r_40_81_10,seq127,r_40_81_10,0.87,105,115,10,93
3,r_68_52_174,seq16,r_5_95_15,r_5_95_15,0.79,159,174,15,93
10,r_106_64_83,seq62,r_58_38_74,r_106_64_83,1.0,0,83,83,93
90,seq113,r_39_111_80,r_51_97_9,r_39_111_80,1.0,0,80,80,93
26,r_32_128_197,r_94_103_176,r_66_18_35,r_66_18_35,0.61,141,176,35,93
0,r_9_37_116,seq61,seq91,r_9_37_116,0.99,0,116,116,93
45,seq28,r_66_18_35,r_96_26_4,r_66_18_35,0.96,0,35,35,93
11,r_21_45_180,seq33,seq99,r_21_45_180,0.32,1,181,180,93
20,r_67_2_135,seq87,r_124_116_55,r_67_2_135,0.95,0,135,135,93
15,r_89_48_59,r_94_103_176,seq16,r_89_48_59,1.0,1,60,59,93
57,seq46,r_0_120_173,seq98,r_0_120_173,0.97,0,173,173,93
6,r_94_103_176,r_32_128_197,seq6,r_32_128_197,0.51,-21,176,197,93
2,r_47_107_188,r_106_64_83,r_20_65_50,r_106_64_83,0.8,105,188,83,93
4,r_124_116_55,seq33,seq42,r_124_116_55,1.0,0,55,55,93
2,r_47_107_188,r_70_19_2,r_106_64_83,r_106_64_83,1.0,11,94,83,93
18,r_100_101_92,seq88,r_51_97_9,r_100_101_92,1.0,0,92,92,93
1,r_27_76_57,r_94_103_176,r_51_97_9,r_27_76_57,1.0,1,58,57,93
29,r_84_3_139,seq35,seq11,r_84_3_139,0.92,0,139,139,93
24,r_90_74_178,seq23,seq93,r_90_74_178,0.78,0,178,178,93
33,seq7,seq125,r_51_97_9,r_51_97_9,0.98,56,65,9,93
13,r_20_65_50,seq34,seq62,r_20_65_50,0.98,0,50,50,93
23,r_40_81_10,r_47_107_188,seq91,r_40_81_10,0.99,0,10,10,93
17,r_59_8_110,r_58_38_74,r_40_81_10,r_58_38_74,1.0,1,75,74,93
9,r_39_111_80,seq113,seq114,r_39_111_80,1.0,0,80,80,93
28,r_58_38_74,r_47_107_188,r_70_19_2,r_47_107_188,0.87,0,188,188,93
12,r_5_95_15,seq11,seq56,r_5_95_15,1.0,0,15,15,93
62,seq60,r_27_76_57,r_66_18_35,r_27_76_57,0.74,-3,54,57,93
28,r_58_38_74,r_59_8_110,r_47_107_188,r_58_38_74,0.98,0,74,74,93
91,seq114,r_21_45_180,r_39_111_80,r_39_111_80,1.0,9,89,80,93
49,seq33,r_21_45_180,r_39_111_80,r_39_111_80,1.0,101,181,80,93
7,r_0_120_173,seq46,r_59_8_110,r_0_120_173,0.79,0,173,173,93
82,seq93,r_53_126_120,r_47_107_188,r_53_126_120,0.98,0,120,120,93
79,seq88,r_100_101_92,seq86,r_100_101_92,1.0,0,92,92,93
50,seq42,r_33_9_59,r_53_17_38,r_53_17_38,0.98,11,49,38,94
8,r_20_13_35,seq5,seq107,r_20_13_35,0.4,42,77,35,94
53,seq48,seq52,r_109_30_93,r_109_30_93,1.0,54,147,93,94
16,r_64_80_149,seq37,r_109_30_93,r_109_30_93,0.86,56,149,93,94
21,r_1_74_109,seq81,seq48,r_1_74_109,1.0,1,110,109,94
1,r_33_9_59,seq110,r_54_96_4,r_33_9_59,0.71,52,111,59,94
5,r_109_30_93,seq103,r_22_26_36,r_109_30_93,1.0,0,93,93,94
1,r_33_9_59,r_54_96_4,r_63_34_19,r_33_9_59,0.39,98,157,59,94
22,r_63_34_19,r_45_38_73,seq110,r_63_34_19,0.97,0,19,19,94
95,seq122,seq11,r_45_38_73,r_45_38_73,1.0,3,76,73,94
66,seq70,r_10_59_165,seq84,r_10_59_165,0.7,0,165,165,94
26,r_12_41_131,r_33_9_59,r_54_96_4,r_54_96_4,0.78,44,48,4,94
10,r_95_100_134,seq99,seq110,r_95_100_134,0.91,1,135,134,94
15,r_51_123_11,seq97,seq115,r_51_123_11,0.82,0,11,11,94
4,r_112_47_1,seq90,r_78_72_107,r_78_72_107,0.96,-3,104,107,94
0,r_28_128_102,seq56,seq0,r_28_128_102,0.98,0,102,102,94
48,seq39,r_2_116_163,seq40,r_2_116_163,0.62,0,163,163,94
6,r_6_105_77,seq8,r_19_106_198,r_6_105_77,1.0,0,77,77,94
7,r_82_98_24,r_33_9_59,seq103,r_82_98_24,0.99,0,24,24,94
27,r_86_65_112,r_19_106_198,seq58,r_86_65_112,0.99,0,112,112,94
2,r_45_38_73,r_21_44_81,seq122,r_45_38_73,1.0,0,73,73,94
18,r_61_94_128,seq40,r_4_29_6,r_61_94_128,1.0,0,128,128,94
25,r_21_44_81,seq50,r_6_105_77,r_21_44_81,1.0,0,81,81,94
33,seq5,seq7,r_36_93_104,r_36_93_104,0.88,33,137,104,94
58,seq56,r_28_128_102,seq104,r_28_128_102,0.99,0,102,102,94
11,r_53_17_38,r_2_116_163,seq42,r_53_17_38,0.97,0,38,38,94
3,r_89_73_30,seq84,seq81,r_89_73_30,1.0,1,31,30,94
60,seq58,seq104,r_86_65_112,r_86_65_112,1.0,27,139,112,94
17,r_54_96_4,r_33_9_59,r_53_17_38,r_53_17_38,1.0,115,153,38,94
9,r_75_77_90,seq25,seq113,r_75_77_90,0.48,21,111,90,94
14,r_118_67_31,r_2_116_163,r_19_106_198,r_118_67_31,1.0,1,32,31,94
26,r_12_41_131,r_54_96_4,r_6_105_77,r_12_41_131,0.62,0,131,131,94
28,r_119_14_68,r_33_9_59,seq46,r_119_14_68,1.0,1,69,68,94
19,r_78_72_107,seq97,r_112_47_1,r_78_72_107,0.48,-49,58,107,94
35,seq8,seq113,r_109_30_93,r_109_30_93,1.0,17,110,93,94
12,r_19_106_198,r_86_65_112,r_21_44_81,r_19_106_198,0.92,-84,114,198,94
8,r_94_33_135,seq31,seq7,r_94_33_135,0.8,1,136,135,95
39,seq18,r_77_72_78,seq15,r_77_72_78,0.95,-8,70,78,95
1,r_61_29_141,seq87,r_99_79_144,r_99_79_144,0.99,4,148,144,95
5,r_63_120_106,r_82_70_148,seq18,r_63_120_106,0.96,2,108,106,95
66,seq66,seq28,r_3_6_96,r_3_6_96,1.0,9,105,96,95
2,r_126_73_32,seq52,r_68_117_6,r_126_73_32,1.0,0,32,32,95
3,r_36_10_68,r_57_74_87,seq110,r_36_10_68,1.0,0,68,68,95
10,r_24_64_81,seq85,seq9,r_24_64_81,1.0,0,81,81,95
9,r_93_124_16,seq44,seq38,r_93_124_16,1.0,0,16,16,95
26,r_49_95_73,r_111_84_183,r_76_100_150,r_49_95_73,0.95,0,73,73,95
15,r_43_22_40,r_82_70_148,r_93_124_16,r_43_22_40,1.0,0,40,40,95
73,seq80,r_2_5_177,seq129,r_2_5_177,0.63,0,177,177,95
11,r_2_5_177,seq80,r_63_120_106,r_63_120_106,0.9,71,177,106,95
20,r_3_6_96,seq15,seq66,r_3_6_96,1.0,0,96,96,95
6,r_34_16_75,seq98,seq60,r_34_16_75,0.92,0,75,75,95
39,seq18,seq15,r_63_120_106,r_63_120_106,0.98,13,119,106,95
27,r_57_74_87,seq26,seq85,r_57_74_87,1.0,-1,86,87,95
29,r_54_105_21,r_76_100_150,seq98,r_54_105_21,1.0,1,22,21,95
18,r_111_84_183,seq116,r_82_70_148,r_82_70_148,0.82,35,183,148,95
24,r_107_118_157,seq113,seq45,r_107_118_157,0.94,1,158,157,95
25,r_99_79_144,seq58,r_61_29_141,r_99_79_144,0.95,1,145,144,95
38,seq15,r_3_6_96,seq18,r_3_6_96,1.0,0,96,96,95
34,seq9,seq86,r_24_64_81,r_24_64_81,1.0,-1,80,81,95
19,r_13_59_35,seq4,seq58,r_13_59_35,0.94,0,35,35,95
23,r_21_17_20,seq89,seq116,r_21_17_20,0.92,0,20,20,95
17,r_102_19_153,seq48,r_13_59_35,r_102_19_153,0.76,0,153,153,95
26,r_49_95_73,r_76_100_150,seq109,r_76_100_150,1.0,1,151,150,95
52,seq44,r_93_124_16,seq51,r_93_124_16,0.76,0,16,16,95
16,r_123_12_33,seq28,r_82_70_148,r_123_12_33,1.0,0,33,33,95
28,r_76_100_150,r_49_95_73,r_122_91_100,r_76_100_150,0.92,1,151,150,95
28,r_76_100_150,r_115_55_93,r_49_95_73,r_49_95_73,0.52,1,74,73,95
56,seq48,r_102_19_153,r_61_29_141,r_102_19_153,0.66,0,153,153,95
7,r_77_72_78,seq18,seq20,r_77_72_78,1.0,0,78,78,95
12,r_115_55_93,r_76_100_150,seq50,r_115_55_93,0.97,1,94,93,95
93,seq115,seq106,r_126_52_97,r_126_52_97,1.0,28,125,97,96
17,r_75_69_165,seq125,r_42_1_178,r_42_1_178,0.67,-149,29,178,96
14,r_83_108_120,seq46,seq117,r_83_108_120,0.96,0,120,120,96
53,seq41,r_124_107_110,r_50_119_9,r_124_107_110,0.89,4,114,110,96
7,r_112_65_15,r_14_11_107,r_120_9_1,r_112_65_15,0.99,0,15,15,96
23,r_123_129_31,seq5,seq37,r_123_129_31,1.0,0,31,31,96
3,r_60_57_184,r_100_113_95,r_38_16_29,r_60_57_184,0.52,0,184,184,96
87,seq103,r_58_127_16,r_126_52_97,r_58_127_16,0.79,-4,12,16,96
71,seq77,r_126_52_97,r_100_113_95,r_126_52_97,1.0,0,97,97,96
16,r_94_101_159,seq114,r_31_53_91,r_31_53_91,1.0,1,92,91,96
21,r_88_67_143,seq95,r_63_71_119,r_88_67_143,0.99,0,143,143,96
1,r_22_6_85,seq55,seq10,r_22_6_85,1.0,1,86,85,96
19,r_40_29_101,seq33,seq114,r_40_29_101,1.0,2,103,101,96
3,r_60_57_184,r_126_52_97,r_100_113_95,r_126_52_97,1.0,0,97,97,96
10,r_93_2_88,seq95,seq35,r_93_2_88,1.0,0,88,88,96
26,r_20_62_167,r_94_101_159,seq48,r_20_62_167,0.62,-6,161,167,96
72,seq78,seq4,r_104_87_137,r_104_87_137,1.0,27,164,137,96
16,r_94_101_159,r_31_53_91,r_120_9_1,r_94_101_159,0.88,2,161,159,96
0,r_126_52_97,r_60_57_184,seq115,r_126_52_97,1.0,0,97,97,96
11,r_124_107_110,seq41,seq89,r_124_107_110,0.99,4,114,110,96
99,seq125,r_42_1_178,r_83_108_120,r_83_108_120,1.0,25,145,120,96
13,r_104_87_137,seq25,seq78,r_104_87_137,0.98,0,137,137,96
57,seq46,r_83_108_120,r_120_9_1,r_83_108_120,1.0,0,120,120,96
6,r_14_11_107,seq26,seq39,r_14_11_107,1.0,1,108,107,96
24,r_63_71_119,seq117,seq25,r_63_71_119,0.99,1,120,119,96
8,r_38_16_29,seq47,seq13,r_38_16_29,0.75,0,29,29,96
25,r_19_84_152,seq117,r_40_29_101,r_19_84_152,0.71,0,152,152,96
29,r_96_36_56,seq106,seq27,r_96_36_56,1.0,0,56,56,96
15,r_54_128_26,seq30,seq82,r_54_128_26,1.0,1,27,26,96
52,seq39,seq21,r_14_11_107,r_14_11_107,1.0,56,163,107,96
12,r_58_127_16,seq103,seq44,r_58_127_16,0.87,0,16,16,96
99,seq125,r_75_69_165,r_42_1_178,r_42_1_178,0.47,-157,21,178,96
87,seq103,r_8_111_87,r_100_113_95,r_8_111_87,0.9,70,157,87,96
9,r_74_91_84,seq95,r_38_16_29,r_74_91_84,1.0,0,84,84,96
28,r_31_53_91,r_94_101_159,r_40_29_101,r_94_101_159,1.0,2,161,159,96
22,r_8_111_87,r_124_107_110,seq7,r_8_111_87,1.0,0,87,87,96
28,r_31_53_91,r_60_57_184,r_94_101_159,r_31_53_91,0.99,0,91,91,96
89,seq106,r_96_36_56,seq115,r_96_36_56,1.0,0,56,56,96
17,r_75_69_165,r_42_1_178,r_54_128_26,r_75_69_165,0.87,0,165,165,96
82,seq95,r_88_67_143,seq4,r_88_67_143,1.0,0,143,143,96
35,seq10,seq90,r_22_6_85,r_22_6_85,1.0,5,90,85,96
27,r_50_119_9,r_54_128_26,seq41,r_50_119_9,0.99,5,14,9,96
5,r_59_56_34,r_100_113_95,seq12,r_59_56_34,1.0,0,34,34,96
14,r_82_87_74,seq31,r_36_127_52,r_82_87_74,1.0,0,74,74,97
16,r_32_75_97,r_85_51_132,seq89,r_32_75_97,0.99,2,99,97,97
1,r_101_73_71,seq9,r_21_102_51,r_101_73_71,0.99,0,71,71,97
5,r_10_26_117,r_99_24_183,r_27_28_111,r_10_26_117,0.6,14,131,117,97
46,seq35,r_52_106_96,seq2,r_52_106_96,0.4,-2,94,96,97
19,r_94_37_104,r_85_51_132,r_52_106_96,r_94_37_104,0.63,0,104,104,97
31,seq1,r_7_118_162,seq119,r_7_118_162,1.0,0,162,162,97
3,r_108_88_105,seq105,seq117,r_108_88_105,0.8,0,105,105,97
10,r_70_103_100,seq29,r_12_14_95,r_70_103_100,0.86,0,100,100,97
26,r_85_51_132,seq92,seq16,r_85_51_132,0.99,0,132,132,97
16,r_32_75_97,seq89,r_7_118_162,r_7_118_162,0.98,3,165,162,97
4,r_52_106_96,seq35,r_94_37_104,r_94_37_104,1.0,0,104,104,97
78,seq92,r_85_51_132,seq17,r_85_51_132,1.0,0,132,132,97
11,r_5_13_87,r_85_51_132,r_63_116_3,r_5_13_87,0.87,1,88,87,97
1,r_101_73_71,r_21_102_51,seq112,r_101_73_71,0.6,39,110,71,97
6,r_22_18_118,seq54,r_66_20_38,r_22_18_118,0.99,1,119,118,97
13,r_66_20_38,r_27_28_111,seq86,r_66_20_38,1.0,1,39,38,97
24,r_71_15_180,r_6_78_150,r_22_18_118,r_71_15_180,0.96,0,180,180,97
27,r_12_14_95,r_22_18_118,seq4,r_12_14_95,0.99,0,95,95,97
87,seq110,seq89,r_32_75_97,r_32_75_97,1.0,75,172,97,97
18,r_76_72_178,seq117,seq100,r_76_72_178,0.22,-2,176,178,97
24,r_71_15_180,r_114_64_151,r_6_78_150,r_71_15_180,0.71,-29,151,180,97
58,seq54,r_22_18_118,seq69,r_22_18_118,0.95,2,120,118,97
20,r_6_78_150,seq19,seq69,r_6_78_150,1.0,0,150,150,97
21,r_109_81_37,r_76_72_178,r_63_116_3,r_109_81_37,1.0,0,37,37,97
29,r_36_127_52,seq48,seq56,r_36_127_52,0.82,0,52,52,97
29,r_36_127_52,seq56,r_82_87_74,r_82_87_74,1.0,6,80,74,97
17,r_7_118_162,seq1,r_32_75_97,r_7_118_162,0.92,0,162,162,97
11,r_5_13_87,r_63_116_3,r_22_18_118,r_22_18_118,0.9,21,139,118,97
91,seq117,r_76_72_178,r_21_102_51,r_21_102_51,0.64,22,73,51,97
56,seq49,seq90,r_27_28_111,r_27_28_111,0.67,3,114,111,97
7,r_114_64_151,r_71_15_180,seq67,r_114_64_151,0.8,0,151,151,97
44,seq31,r_82_87_74,seq112,r_82_87_74,1.0,1,75,74,97
23,r_46_91_19,seq9,seq25,r_46_91_19,1.0,2,21,19,97
12,r_11_23_109,r_7_118_162,seq3,r_11_23_109,0.99,0,109,109,97
92,seq110,r_59_21_129,r_42_92_85,r_42_92_85,0.98,49,134,85,98
14,r_42_92_85,r_76_112_167,seq110,r_42_92_85,1.0,0,85,85,98
83,seq96,r_99_116_107,seq64,r_99_116_107,0.99,-10,97,107,98
86,seq102,r_127_25_162,r_28_16_64,r_28_16_64,0.94,3,67,64,98
21,r_28_16_64,r_58_118_67,seq102,r_28_16_64,1.0,0,64,64,98
5,r_120_114_79,seq38,r_22_14_127,r_120_114_79,0.5,-11,68,79,98
13,r_53_124_58,seq11,seq72,r_53_124_58,1.0,0,58,58,98
31,seq6,r_37_103_163,seq43,r_37_103_163,0.97,-23,140,163,98
3,r_59_21_129,seq110,seq73,r_59_21_129,0.55,5,134,129,98
10,r_63_49_159,seq77,seq29,r_63_49_159,0.65,0,159,159,98
26,r_76_112_167,r_42_92_85,seq69,r_42_92_85,0.61,0,85,85,98
4,r_36_24_173,seq18,r_71_125_94,r_36_24_173,0.68,1,174,173,98
0,r_37_103_163,seq6,r_5_17_41,r_37_103_163,0.85,4,167,163,98
29,r_1_90_34,r_127_25_162,seq74,r_1_90_34,0.72,0,34,34,98
11,r_66_52_39,r_120_114_79,seq12,r_66_52_39,1.0,1,40,39,98
27,r_126_56_115,seq15,seq64,r_126_56_115,0.99,0,115,115,98
81,seq89,seq81,r_100_3_21,r_100_3_21,1.0,0,21,21,98
2,r_97_47_60,seq82,seq20,r_97_47_60,1.0,1,61,60,98
18,r_127_25_162,seq102,seq74,r_127_25_162,0.94,2,164,162,98
25,r_8_121_172,seq12,seq9,r_8_121_172,0.51,5,177,172,98
9,r_5_17_41,seq102,seq72,r_5_17_41,1.0,0,41,41,98
6,r_93_128_25,seq34,seq41,r_93_128_25,1.0,0,25,25,98
19,r_39_79_14,seq32,seq77,r_39_79_14,0.93,-1,13,14,98
38,seq15,r_126_56_115,seq74,r_126_56_115,1.0,0,115,115,98
26,r_76_112_167,seq69,r_120_114_79,r_76_112_167,0.45,-9,158,167,98
22,r_99_116_107,seq96,r_58_118_67,r_99_116_107,1.0,0,107,107,98
28,r_50_4_157,seq19,r_58_118_67,r_50_4_157,0.5,1,158,157,98
36,seq12,r_8_121_172,r_66_52_39,r_66_52_39,1.0,1,40,39,98
17,r_100_3_21,seq85,seq89,r_100_3_21,1.0,0,21,21,98
23,r_70_104_38,r_103_10_77,seq8,r_70_104_38,0.97,0,38,38,99
36,seq12,r_125_117_174,r_76_45_55,r_76_45_55,0.46,49,104,55,99
14,r_116_118_123,r_11_15_164,r_18_39_41,r_116_118_123,0.98,0,123,123,99
20,r_128_94_32,seq91,r_27_31_81,r_27_31_81,1.0,-2,79,81,99
16,r_11_15_164,seq122,seq6,r_11_15_164,0.53,2,166,164,99
21,r_125_117_174,seq60,r_18_39_41,r_18_39_41,0.69,133,174,41,99
25,r_107_57_39,seq61,r_128_94_32,r_107_57_39,0.99,1,40,39,99
1,r_67_85_96,seq115,r_74_97_152,r_74_97_152,1.0,6,158,152,99
1,r_67_85_96,seq8,seq115,r_67_85_96,1.0,1,97,96,99
5,r_75_121_134,seq73,seq12,r_75_121_134,0.57,0,134,134,99
29,r_129_68_31,r_74_97_152,seq53,r_129_68_31,0.88,1,32,31,99
46,seq29,r_49_20_149,seq23,r_49_20_149,0.97,-25,124,149,99
15,r_18_39_41,seq26,r_46_22_198,r_18_39_41,1.0,0,41,41,99
15,r_18_39_41,r_46_22_198,r_116_118_123,r_116_118_123,1.0,34,157,123,99
76,seq80,r_111_42_186,r_49_20_149,r_49_20_149,0.72,6,155,149,99
89,seq102,r_111_42_186,r_51_98_1,r_51_98_1,0.59,186,187,1,99
10,r_108_1_66,seq35,seq78,r_108_1_66,1.0,0,66,66,99
0,r_36_50_85,seq124,seq106,r_36_50_85,1.0,1,86,85,99
11,r_82_93_128,seq13,seq92,r_82_93_128,0.98,1,129,128,99
26,r_55_32_103,r_33_64_56,r_128_94_32,r_55_32_103,0.87,-52,51,103,99
13,r_111_42_186,seq102,r_76_45_55,r_76_45_55,0.63,132,187,55,99
74,seq78,seq92,r_108_1_66,r_108_1_66,1.0,0,66,66,99
18,r_49_20_149,seq29,seq80,r_49_20_149,0.65,0,149,149,99
24,r_103_10_77,seq91,seq72,r_103_10_77,0.92,0,77,77,99
64,seq60,r_125_117_174,seq21,r_125_117_174,0.87,0,174,174,99
20,r_128_94_32,seq25,seq91,r_128_94_32,1.0,0,32,32,99
36,seq12,r_76_45_55,r_75_121_134,r_75_121_134,0.65,2,136,134,99
26,r_55_32_103,r_128_94_32,seq53,r_55_32_103,1.0,1,104,103,99
6,r_33_64_56,r_55_32_103,seq25,r_33_64_56,0.96,-5,51,56,99
75,seq79,seq6,r_76_45_55,r_76_45_55,0.73,13,68,55,99
7,r_76_45_55,seq8,r_101_90_36,r_101_90_36,1.0,20,56,36,99
94,seq115,seq41,r_67_85_96,r_67_85_96,1.0,8,104,96,99
9,r_27_31_81,r_75_121_134,r_128_94_32,r_27_31_81,0.42,0,81,81,99
28,r_46_22_198,r_63_2_193,r_18_39_41,r_18_39_41,1.0,44,85,41,99
17,r_101_90_36,seq41,seq79,r_101_90_36,1.0,0,36,36,99
