20,r_71_72_12,seq131,r_51_136_152,r_71_72_12,0.96,0,12,12,0
9,r_7_76_51,r_110_74_166,r_29_27_126,r_7_76_51,0.93,115,166,51,0
92,seq111,r_110_74_166,r_29_27_126,r_29_27_126,0.89,16,142,126,0
14,r_20_126_178,r_43_77_132,seq50,r_43_77_132,0.99,1,133,132,0
8,r_54_135_127,seq25,r_6_17_47,r_54_135_127,0.98,1,128,127,0
83,seq84,r_121_82_121,seq92,r_121_82_121,0.58,1,122,121,0
37,r_18_104_112,r_110_74_166,seq117,r_18_104_112,0.95,0,112,112,0
14,r_20_126_178,seq50,r_96_127_163,r_20_126_178,0.88,3,181,178,0
16,r_107_125_122,r_51_136_152,r_91_93_85,r_107_125_122,0.96,1,123,122,0
39,r_110_74_166,r_18_104_112,r_139_80_65,r_139_80_65,0.7,47,112,65,0
5,r_51_136_152,r_107_125_122,seq118,r_107_125_122,1.0,-22,100,122,0
20,r_71_72_12,r_51_136_152,r_6_17_47,r_6_17_47,0.96,18,65,47,0
19,r_96_127_163,r_40_101_169,seq66,r_96_127_163,0.8,1,164,163,0
85,seq88,r_12_26_34,seq132,r_12_26_34,1.0,0,34,34,0
38,r_6_17_47,seq95,r_71_72_12,r_6_17_47,1.0,0,47,47,0
76,seq66,r_86_39_181,r_96_127_163,r_96_127_163,0.51,18,181,163,0
13,r_49_41_62,r_133_59_146,seq16,r_49_41_62,0.94,-4,58,62,0
31,r_43_77_132,r_20_126_178,seq97,r_43_77_132,0.94,1,133,132,0
10,r_114_15_161,seq8,seq33,r_114_15_161,0.67,1,162,161,0
1,r_36_137_9,r_89_73_128,r_12_26_34,r_36_137_9,0.99,56,65,9,0
26,r_130_75_111,r_113_105_184,seq24,r_113_105_184,0.69,-72,112,184,0
4,r_121_82_121,seq84,seq92,r_121_82_121,0.58,7,128,121,0
78,seq70,r_40_101_169,seq78,r_40_101_169,0.78,3,172,169,0
39,r_110_74_166,r_139_80_65,r_18_104_112,r_110_74_166,1.0,0,166,166,0
69,seq52,seq124,r_69_5_42,r_69_5_42,1.0,2,44,42,0
2,r_94_103_40,r_91_93_85,r_108_58_27,r_94_103_40,1.0,0,40,40,0
36,r_108_58_27,r_114_15_161,r_37_2_105,r_37_2_105,0.93,6,111,105,0
11,r_91_93_85,r_94_103_40,seq19,r_94_103_40,0.66,4,44,40,0
27,r_139_80_65,seq0,r_7_76_51,r_139_80_65,1.0,0,65,65,0
36,r_108_58_27,r_130_75_111,r_114_15_161,r_108_58_27,1.0,0,27,27,0
47,seq8,r_133_59_146,r_37_2_105,r_37_2_105,0.92,5,110,105,0
18,r_29_27_126,seq120,seq111,r_29_27_126,1.0,0,126,126,0
24,r_37_2_105,seq35,r_108_58_27,r_37_2_105,1.0,0,105,105,0
25,r_89_73_128,seq81,seq19,r_89_73_128,0.95,0,128,128,0
33,r_3_42_158,seq98,seq35,r_3_42_158,0.47,0,158,158,0
61,seq34,seq118,r_54_135_127,r_54_135_127,1.0,6,133,127,0
28,r_12_26_34,seq88,r_36_137_9,r_12_26_34,1.0,0,34,34,0
34,r_53_90_99,r_114_15_161,seq62,r_53_90_99,0.9,4,103,99,0
9,r_7_76_51,r_51_136_152,r_110_74_166,r_7_76_51,1.0,0,51,51,0
32,r_21_106_20,r_121_82_121,seq30,r_21_106_20,0.79,-1,19,20,0
15,r_64_112_26,r_29_27_126,seq115,r_64_112_26,0.97,0,26,26,0
52,seq19,r_49_41_62,r_89_73_128,r_89_73_128,1.0,1,129,128,0
11,r_91_93_85,seq19,seq120,r_91_93_85,1.0,0,85,85,0
56,seq25,r_54_135_127,seq92,r_54_135_127,1.0,-7,120,127,0
35,r_113_105_184,seq28,r_51_136_152,r_51_136_152,0.93,36,188,152,0
12,r_9_11_119,r_51_136_152,seq95,r_9_11_119,1.0,1,120,119,0
30,r_82_60_118,seq18,r_123_64_15,r_123_64_15,0.77,107,122,15,1
36,r_37_69_66,r_82_60_118,seq39,r_37_69_66,1.0,0,66,66,1
5,r_130_102_49,r_120_132_159,r_113_13_158,r_130_102_49,0.94,2,51,49,1
91,seq97,seq104,r_68_19_14,r_68_19_14,0.99,0,14,14,1
14,r_95_55_93,seq65,seq78,r_95_55_93,1.0,1,94,93,1
8,r_98_42_199,r_26_111_11,r_15_23_60,r_98_42_199,0.72,-137,62,199,1
54,seq33,r_83_94_150,r_59_112_137,r_59_112_137,0.38,-27,110,137,1
54,seq33,r_59_112_137,r_2_21_173,r_2_21_173,0.61,-20,153,173,1
55,seq35,r_113_13_158,seq46,r_113_13_158,1.0,1,159,158,1
16,r_113_13_158,r_12_119_61,r_130_102_49,r_113_13_158,0.63,-97,61,158,1
21,r_134_110_90,r_113_13_158,r_6_29_50,r_134_110_90,0.89,2,92,90,1
1,r_53_34_156,r_101_106_188,r_68_19_14,r_68_19_14,0.91,135,149,14,1
46,seq138,r_107_14_69,r_12_119_61,r_12_119_61,0.78,9,70,61,1
80,seq77,r_76_103_42,r_108_80_70,r_108_80_70,1.0,39,109,70,1
19,r_11_133_110,seq28,r_98_42_199,r_11_133_110,0.99,2,112,110,1
66,seq50,r_83_94_150,r_107_14_69,r_107_14_69,0.95,92,161,69,1
39,r_85_92_100,r_123_64_15,seq0,r_85_92_100,0.88,3,103,100,1
3,r_99_121_157,seq38,r_76_103_42,r_99_121_157,0.52,2,159,157,1
10,r_107_14_69,seq138,seq30,r_107_14_69,0.99,1,70,69,1
16,r_113_13_158,r_130_102_49,seq38,r_113_13_158,0.94,1,159,158,1
78,seq72,seq1,r_59_112_137,r_59_112_137,0.83,25,162,137,1
0,r_125_137_175,r_115_10_67,r_53_34_156,r_53_34_156,0.98,19,175,156,1
20,r_59_112_137,seq30,seq72,r_59_112_137,0.81,0,137,137,1
33,r_123_64_15,r_11_133_110,r_68_19_14,r_123_64_15,0.65,-1,14,15,1
13,r_68_19_14,r_59_112_137,r_123_64_15,r_59_112_137,0.74,-123,14,137,1
5,r_130_102_49,r_113_13_158,seq46,r_113_13_158,1.0,1,159,158,1
29,r_6_29_50,r_9_124_87,r_75_17_124,r_6_29_50,0.79,0,50,50,1
2,r_2_21_173,r_26_111_11,r_113_13_158,r_2_21_173,0.51,-4,169,173,1
40,seq0,r_128_91_174,r_85_92_100,r_85_92_100,0.89,76,176,100,1
24,r_4_49_161,seq47,seq122,r_4_49_161,0.39,2,163,161,1
25,r_118_62_146,seq41,r_123_64_15,r_118_62_146,0.92,1,147,146,1
88,seq90,seq40,r_117_100_31,r_117_100_31,1.0,13,44,31,1
64,seq47,seq7,r_31_66_36,r_31_66_36,0.98,2,38,36,1
32,r_20_96_130,seq22,r_130_102_49,r_20_96_130,1.0,0,130,130,1
38,r_128_91_174,seq0,r_9_124_87,r_9_124_87,1.0,89,176,87,1
52,seq28,r_11_133_110,seq39,r_11_133_110,1.0,2,112,110,1
34,r_108_80_70,seq89,r_115_10_67,r_108_80_70,0.99,0,70,70,1
60,seq41,r_118_62_146,seq129,r_118_62_146,0.49,1,147,146,1
27,r_31_66_36,r_125_137_175,seq47,r_31_66_36,0.96,0,36,36,1
17,r_83_94_150,seq50,r_95_55_93,r_95_55_93,0.96,68,161,93,1
9,r_27_74_138,seq0,seq65,r_27_74_138,0.75,1,139,138,1
31,r_75_17_124,r_6_29_50,seq46,r_75_17_124,0.94,3,127,124,1
31,r_75_17_124,r_81_24_1,r_6_29_50,r_6_29_50,1.0,1,51,50,1
29,r_6_29_50,r_75_17_124,r_134_110_90,r_6_29_50,0.99,78,128,50,1
22,r_26_111_11,r_2_21_173,seq89,r_26_111_11,0.56,153,164,11,1
28,r_15_23_60,r_32_45_183,r_98_42_199,r_15_23_60,0.74,0,60,60,1
56,seq36,r_32_45_183,r_4_49_161,r_4_49_161,0.65,22,183,161,1
7,r_9_124_87,r_20_96_130,seq7,r_9_124_87,0.96,3,90,87,1
44,seq7,seq47,r_9_124_87,r_9_124_87,1.0,14,101,87,1
23,r_115_10_67,seq43,seq44,r_115_10_67,0.47,33,100,67,1
39,r_85_92_100,seq104,r_123_64_15,r_123_64_15,0.99,18,33,15,1
79,seq73,seq138,r_12_119_61,r_12_119_61,1.0,32,93,61,1
12,r_120_132_159,r_139_71_48,r_117_100_31,r_120_132_159,0.59,0,159,159,1
30,r_6_83_108,seq81,seq24,r_6_83_108,1.0,0,108,108,2
26,r_79_14_70,r_33_128_64,r_48_111_175,r_79_14_70,0.64,41,111,70,2
25,r_18_51_24,seq108,r_12_137_84,r_18_51_24,1.0,4,28,24,2
43,seq132,r_33_128_64,r_126_84_14,r_126_84_14,0.54,70,84,14,2
24,r_105_72_59,r_96_102_141,seq34,r_105_72_59,1.0,0,59,59,2
16,r_26_106_192,seq136,r_29_23_62,r_29_23_62,1.0,21,83,62,2
21,r_96_102_141,seq124,r_119_116_121,r_96_102_141,0.98,-1,140,141,2
39,r_41_91_113,seq30,seq43,r_41_91_113,0.6,0,113,113,2
1,r_53_25_7,seq134,r_100_110_72,r_100_110_72,1.0,35,107,72,2
97,seq136,r_26_106_192,r_29_23_62,r_29_23_62,1.0,12,74,62,2
26,r_79_14_70,r_48_111_175,seq8,r_48_111_175,0.64,-6,169,175,2
5,r_87_117_142,seq76,seq98,r_87_117_142,0.94,0,142,142,2
19,r_61_122_67,r_135_27_135,r_12_137_84,r_12_137_84,1.0,22,106,84,2
18,r_123_129_18,seq37,seq80,r_123_129_18,1.0,0,18,18,2
31,r_67_133_109,r_69_13_199,seq9,r_67_133_109,1.0,0,109,109,2
67,seq44,seq92,r_19_56_75,r_19_56_75,1.0,20,95,75,2
27,r_115_85_35,r_87_117_142,r_53_25_7,r_115_85_35,1.0,0,35,35,2
26,r_79_14_70,seq10,r_33_128_64,r_79_14_70,1.0,2,72,70,2
4,r_100_110_72,seq32,r_53_25_7,r_100_110_72,1.0,0,72,72,2
0,r_131_93_151,seq98,seq113,r_131_93_151,0.95,0,151,151,2
6,r_119_116_121,seq34,seq130,r_119_116_121,0.99,1,122,121,2
22,r_97_138_11,r_11_120_191,seq81,r_97_138_11,1.0,0,11,11,2
29,r_48_111_175,r_79_14_70,seq92,r_48_111_175,0.86,-2,173,175,2
2,r_88_104_105,seq112,r_33_128_64,r_88_104_105,0.99,1,106,105,2
40,seq0,r_1_107_92,seq92,r_1_107_92,1.0,-26,66,92,2
74,seq63,r_19_56_75,r_68_54_6,r_19_56_75,1.0,0,75,75,2
29,r_48_111_175,r_135_27_135,r_79_14_70,r_79_14_70,1.0,64,134,70,2
37,r_55_65_39,seq34,seq74,r_55_65_39,1.0,0,39,39,2
33,r_16_20_163,seq80,r_19_56_75,r_19_56_75,0.99,88,163,75,2
12,r_47_99_32,r_16_20_163,seq46,r_47_99_32,0.99,0,32,32,2
58,seq32,r_100_110_72,seq89,r_100_110_72,1.0,0,72,72,2
3,r_58_71_54,r_69_13_199,seq66,r_58_71_54,1.0,0,54,54,2
32,r_29_23_62,seq64,seq9,r_29_23_62,1.0,1,63,62,2
75,seq64,r_29_23_62,r_97_138_11,r_29_23_62,0.96,0,62,62,2
17,r_135_27_135,r_48_111_175,seq5,r_135_27_135,0.63,-1,134,135,2
25,r_18_51_24,r_12_137_84,seq101,r_12_137_84,1.0,-9,75,84,2
9,r_19_56_75,seq63,seq44,r_19_56_75,1.0,0,75,75,2
7,r_60_103_38,r_4_139_40,r_123_129_18,r_123_129_18,1.0,20,38,18,2
28,r_1_107_92,r_47_99_32,r_29_23_62,r_29_23_62,0.52,92,154,62,2
28,r_1_107_92,seq5,r_47_99_32,r_1_107_92,0.9,2,94,92,2
23,r_114_118_81,seq31,r_53_25_7,r_114_118_81,0.92,0,81,81,2
71,seq50,seq130,r_123_129_18,r_123_129_18,0.98,41,59,18,2
35,r_33_128_64,r_119_116_121,seq125,r_119_116_121,1.0,-55,66,121,2
30,r_97_136_103,r_111_102_196,seq16,r_97_136_103,1.0,0,103,103,3
14,r_75_129_112,seq19,r_9_55_52,r_9_55_52,0.66,66,118,52,3
8,r_124_5_143,r_137_95_125,seq4,r_137_95_125,0.95,-10,115,125,3
37,r_127_83_56,seq18,seq12,r_127_83_56,1.0,1,57,56,3
22,r_21_48_186,r_71_0_162,r_92_34_43,r_92_34_43,0.59,16,59,43,3
19,r_105_35_147,seq19,r_89_56_8,r_105_35_147,1.0,1,148,147,3
55,seq27,r_65_43_67,seq20,r_65_43_67,1.0,-1,66,67,3
21,r_77_123_108,seq69,seq45,r_77_123_108,0.95,1,109,108,3
15,r_2_82_16,r_75_129_112,r_30_25_64,r_2_82_16,0.96,1,17,16,3
5,r_58_103_134,r_54_53_57,r_52_96_54,r_52_96_54,1.0,80,134,54,3
66,seq47,seq31,r_9_55_52,r_9_55_52,0.99,0,52,52,3
16,r_15_128_38,seq69,r_2_82_16,r_15_128_38,0.95,0,38,38,3
39,r_33_23_161,r_89_56_8,seq132,r_33_23_161,0.62,0,161,161,3
31,r_42_122_22,seq93,seq106,r_42_122_22,1.0,0,22,22,3
35,r_9_55_52,r_110_80_121,seq47,r_9_55_52,0.93,0,52,52,3
10,r_79_125_176,seq16,r_70_107_60,r_70_107_60,1.0,116,176,60,3
26,r_119_14_150,r_30_25_64,seq18,r_30_25_64,0.62,88,152,64,3
8,r_124_5_143,seq4,seq50,r_124_5_143,0.88,0,143,143,3
4,r_70_107_60,r_44_6_180,r_2_82_16,r_70_107_60,0.97,0,60,60,3
73,seq66,r_44_6_180,r_52_96_54,r_52_96_54,1.0,126,180,54,3
13,r_121_49_129,seq45,r_65_43_67,r_65_43_67,1.0,86,153,67,3
15,r_2_82_16,r_30_25_64,r_70_107_60,r_70_107_60,1.0,5,65,60,3
85,seq90,r_15_128_38,seq134,r_15_128_38,0.95,-12,26,38,3
2,r_92_34_43,r_21_48_186,r_33_23_161,r_92_34_43,0.54,141,184,43,3
6,r_54_53_57,seq51,r_58_103_134,r_58_103_134,0.61,-106,28,134,3
36,r_65_43_67,r_52_96_54,r_121_49_129,r_121_49_129,0.4,32,161,129,3
97,seq117,r_54_53_57,r_52_96_54,r_52_96_54,1.0,0,54,54,3
22,r_21_48_186,r_92_34_43,r_116_1_32,r_92_34_43,0.44,143,186,43,3
2,r_92_34_43,r_135_126_170,r_21_48_186,r_92_34_43,0.98,1,44,43,3
47,seq16,r_79_125_176,r_97_136_103,r_97_136_103,0.98,73,176,103,3
74,seq67,r_135_126_170,seq11,r_135_126_170,1.0,-75,95,170,3
1,r_131_85_59,seq39,seq74,r_131_85_59,0.99,-1,58,59,3
33,r_44_6_180,seq66,seq29,r_44_6_180,0.56,0,180,180,3
88,seq94,r_71_0_162,r_33_23_161,r_33_23_161,0.6,3,164,161,3
70,seq59,r_135_126_170,r_110_80_121,r_135_126_170,0.99,0,170,170,3
3,r_99_60_55,r_121_49_129,seq86,r_99_60_55,0.99,-1,54,55,3
83,seq86,r_110_80_121,r_99_60_55,r_99_60_55,1.0,-1,54,55,3
38,r_139_108_88,r_71_0_162,seq31,r_139_108_88,0.6,0,88,88,3
34,r_40_10_80,seq36,seq66,r_40_10_80,0.7,1,81,80,3
75,seq69,r_77_123_108,seq134,r_77_123_108,0.76,1,109,108,3
39,r_33_23_161,r_52_96_54,r_89_56_8,r_33_23_161,0.6,-150,11,161,3
9,r_133_22_119,seq106,seq46,r_133_22_119,0.94,2,121,119,3
56,seq28,r_115_68_77,seq50,r_115_68_77,1.0,0,77,77,3
17,r_89_56_8,r_33_23_161,r_105_35_147,r_89_56_8,0.84,152,160,8,3
12,r_115_68_77,seq28,seq31,r_115_68_77,0.99,0,77,77,3
30,r_37_25_62,r_26_139_196,seq120,r_37_25_62,1.0,0,62,62,4
36,r_79_45_146,seq101,r_76_96_150,r_79_45_146,0.86,0,146,146,4
12,r_127_10_79,r_70_28_33,r_4_129_39,r_127_10_79,0.9,-46,33,79,4
0,r_138_66_55,r_71_132_85,r_4_129_39,r_138_66_55,1.0,0,55,55,4
25,r_91_31_46,r_124_104_134,seq110,r_91_31_46,1.0,2,48,46,4
8,r_54_90_169,r_111_30_195,r_93_131_57,r_111_30_195,0.26,-26,169,195,4
90,seq107,seq130,r_50_53_25,r_50_53_25,0.99,12,37,25,4
37,r_24_58_96,r_49_78_158,seq5,r_24_58_96,1.0,0,96,96,4
16,r_44_51_21,r_17_0_176,seq113,r_44_51_21,0.93,0,21,21,4
39,r_34_116_145,seq16,seq110,r_34_116_145,0.88,4,149,145,4
97,seq120,seq113,r_37_25_62,r_37_25_62,1.0,3,65,62,4
5,r_13_102_77,seq65,r_50_53_25,r_13_102_77,0.99,1,78,77,4
69,seq57,r_9_23_166,r_138_66_55,r_138_66_55,1.0,112,167,55,4
31,r_71_132_85,seq136,seq88,r_71_132_85,1.0,0,85,85,4
92,seq113,seq120,r_74_108_29,r_74_108_29,1.0,-2,27,29,4
41,seq2,r_35_60_89,seq62,r_35_60_89,1.0,-1,88,89,4
3,r_35_60_89,seq2,seq136,r_35_60_89,0.99,0,89,89,4
1,r_70_28_33,r_127_10_79,seq98,r_70_28_33,1.0,0,33,33,4
26,r_85_115_99,r_9_23_166,seq16,r_85_115_99,0.98,6,105,99,4
72,seq64,r_69_63_186,r_70_28_33,r_70_28_33,1.0,133,166,33,4
98,seq123,r_48_100_125,r_33_21_51,r_33_21_51,0.94,5,56,51,4
4,r_4_129_39,r_9_23_166,r_138_66_55,r_138_66_55,0.99,19,74,55,4
32,r_43_12_38,seq88,r_50_53_25,r_43_12_38,0.97,1,39,38,4
13,r_49_78_158,seq101,r_70_28_33,r_70_28_33,0.89,126,159,33,4
15,r_109_125_74,seq38,seq1,r_109_125_74,0.99,-2,72,74,4
48,seq130,seq29,r_22_80_58,r_22_80_58,1.0,35,93,58,4
6,r_121_112_75,r_13_102_77,seq113,r_121_112_75,0.97,0,75,75,4
17,r_22_80_58,seq38,seq130,r_22_80_58,1.0,1,59,58,4
27,r_76_96_150,r_4_129_39,r_79_45_146,r_76_96_150,0.89,0,150,150,4
61,seq38,r_33_21_51,r_73_122_11,r_73_122_11,0.48,96,107,11,4
2,r_124_104_134,r_69_63_186,r_137_77_22,r_124_104_134,0.91,1,135,134,4
18,r_9_23_166,seq57,r_71_132_85,r_9_23_166,0.55,1,167,166,4
29,r_56_61_65,seq16,seq52,r_56_61_65,1.0,0,65,65,4
92,seq113,r_74_108_29,r_121_112_75,r_121_112_75,1.0,61,136,75,4
61,seq38,r_73_122_11,r_33_21_51,r_73_122_11,0.58,145,156,11,4
21,r_50_53_25,r_73_122_11,seq107,r_50_53_25,0.95,-1,24,25,4
61,seq38,r_22_80_58,r_109_125_74,r_22_80_58,0.99,5,63,58,4
34,r_128_40_162,seq118,seq39,r_128_40_162,0.38,8,170,162,4
28,r_33_21_51,r_111_30_195,seq123,r_33_21_51,0.99,2,53,51,4
81,seq89,r_81_86_154,r_56_61_65,r_56_61_65,0.94,26,91,65,4
22,r_135_87_101,seq92,r_94_97_8,r_135_87_101,0.84,0,101,101,4
7,r_81_86_154,seq52,r_91_31_46,r_81_86_154,0.88,2,156,154,4
82,seq92,r_135_87_101,seq134,r_135_87_101,1.0,0,101,101,4
33,r_74_108_29,seq1,seq113,r_74_108_29,0.97,0,29,29,4
36,r_15_131_80,r_74_126_194,seq24,r_15_131_80,0.99,2,82,80,5
14,r_36_93_120,seq61,seq51,r_36_93_120,1.0,0,120,120,5
8,r_70_27_68,r_32_13_185,seq51,r_70_27_68,1.0,1,69,68,5
43,seq4,seq113,r_127_107_91,r_127_107_91,1.0,6,97,91,5
37,r_102_67_192,seq8,r_21_82_147,r_21_82_147,0.98,-1,146,147,5
55,seq28,seq43,r_12_48_62,r_12_48_62,1.0,1,63,62,5
21,r_63_22_154,seq52,seq26,r_63_22_154,0.65,1,155,154,5
39,r_97_29_59,seq6,seq38,r_97_29_59,0.95,1,60,59,5
46,seq8,r_77_16_89,r_102_67_192,r_77_16_89,1.0,0,89,89,5
19,r_20_53_153,seq23,seq7,r_20_53_153,0.85,0,153,153,5
76,seq68,r_71_42_61,seq24,r_71_42_61,1.0,0,61,61,5
31,r_100_132_129,seq37,r_77_16_89,r_100_132_129,1.0,0,129,129,5
30,r_59_134_19,r_54_10_18,seq19,r_59_134_19,1.0,1,20,19,5
3,r_9_1_64,seq92,seq61,r_9_1_64,1.0,1,65,64,5
26,r_71_42_61,seq68,r_69_3_7,r_71_42_61,1.0,0,61,61,5
11,r_77_16_89,seq8,seq52,r_77_16_89,1.0,0,89,89,5
20,r_101_94_60,r_84_95_124,r_135_85_20,r_101_94_60,0.95,0,60,60,5
15,r_79_115_55,seq28,seq25,r_79_115_55,1.0,0,55,55,5
0,r_21_82_147,r_127_107_91,r_129_62_41,r_129_62_41,0.54,4,45,41,5
13,r_90_75_166,seq19,r_120_88_35,r_90_75_166,0.99,1,167,166,5
46,seq8,r_102_67_192,r_5_39_105,r_5_39_105,1.0,3,108,105,5
28,r_65_91_12,seq26,r_74_126_194,r_65_91_12,0.89,1,13,12,5
0,r_21_82_147,r_129_62_41,r_102_67_192,r_21_82_147,0.9,-1,146,147,5
27,r_108_119_21,seq99,seq98,r_108_119_21,0.99,0,21,21,5
10,r_129_62_41,r_21_82_147,seq128,r_21_82_147,0.72,0,147,147,5
2,r_12_48_62,seq124,seq28,r_12_48_62,1.0,0,62,62,5
10,r_129_62_41,seq0,r_21_82_147,r_129_62_41,1.0,0,41,41,5
18,r_56_33_107,seq24,r_97_29_59,r_97_29_59,0.98,5,64,59,5
29,r_32_13_185,seq106,r_59_134_19,r_59_134_19,0.61,166,185,19,5
25,r_133_121_101,r_36_93_120,r_127_107_91,r_127_107_91,0.93,10,101,91,5
33,r_72_89_160,seq111,seq64,r_72_89_160,0.92,1,161,160,5
68,seq51,seq4,r_70_27_68,r_70_27_68,1.0,5,73,68,5
32,r_55_116_72,seq128,r_108_119_21,r_55_116_72,1.0,0,72,72,5
38,r_84_95_124,seq81,r_12_48_62,r_12_48_62,0.78,63,125,62,5
6,r_5_39_105,r_120_88_35,seq125,r_5_39_105,0.58,-69,36,105,5
18,r_56_33_107,r_97_29_59,seq136,r_56_33_107,0.96,0,107,107,5
34,r_49_112_184,seq105,r_12_48_62,r_12_48_62,1.0,122,184,62,5
17,r_104_34_114,seq52,r_70_27_68,r_104_34_114,1.0,0,114,114,5
1,r_135_85_20,r_127_107_91,seq26,r_135_85_20,0.9,1,21,20,5
9,r_138_18_179,seq26,seq98,r_138_18_179,0.34,-52,127,179,5
22,r_78_73_106,seq96,r_9_1_64,r_78_73_106,0.56,0,106,106,5
7,r_120_88_35,r_5_39_105,seq81,r_120_88_35,0.89,1,36,35,5
1,r_135_85_20,seq26,r_101_94_60,r_101_94_60,0.78,1,61,60,5
85,seq99,r_108_119_21,seq7,r_108_119_21,0.87,0,21,21,5
23,r_127_107_91,r_32_13_185,seq4,r_127_107_91,1.0,1,92,91,5
12,r_2_87_84,seq6,seq7,r_2_87_84,1.0,0,84,84,5
5,r_58_40_39,seq0,seq128,r_58_40_39,1.0,0,39,39,5
45,seq6,seq41,r_71_66_43,r_71_66_43,1.0,0,43,43,6
36,r_119_62_113,r_107_102_152,seq89,r_119_62_113,0.96,1,114,113,6
92,seq105,r_107_102_152,r_8_2_52,r_8_2_52,0.95,22,74,52,6
14,r_53_81_93,r_57_101_138,r_134_68_40,r_53_81_93,0.81,-1,92,93,6
8,r_93_64_115,seq100,seq116,r_93_64_115,0.92,0,115,115,6
54,seq21,r_42_1_65,seq27,r_42_1_65,0.99,3,68,65,6
21,r_137_77_171,seq5,seq60,r_137_77_171,0.39,0,171,171,6
39,r_78_73_133,r_63_50_8,seq31,r_78_73_133,0.72,2,135,133,6
1,r_123_74_142,r_139_58_55,r_107_102_152,r_139_58_55,0.53,97,152,55,6
34,r_122_36_28,seq89,seq75,r_122_36_28,0.98,1,29,28,6
13,r_34_12_21,r_57_101_138,r_117_38_11,r_34_12_21,1.0,0,21,21,6
41,seq128,r_17_111_188,r_32_112_53,r_32_112_53,1.0,64,117,53,6
3,r_106_91_89,seq10,seq31,r_106_91_89,0.98,1,90,89,6
10,r_115_65_176,seq89,seq13,r_115_65_176,0.31,4,180,176,6
26,r_118_98_98,seq14,r_20_45_72,r_118_98_98,1.0,1,99,98,6
4,r_42_1_65,seq21,seq110,r_42_1_65,1.0,0,65,65,6
0,r_20_45_72,r_87_61_108,r_123_74_142,r_20_45_72,0.65,1,73,72,6
16,r_121_22_57,r_107_102_152,seq130,r_121_22_57,1.0,0,57,57,6
11,r_35_85_141,seq27,r_8_2_52,r_8_2_52,0.87,89,141,52,6
20,r_29_52_155,seq28,r_53_81_93,r_53_81_93,0.81,62,155,93,6
15,r_107_102_152,seq11,r_123_74_142,r_107_102_152,0.7,0,152,152,6
30,r_8_2_52,r_42_1_65,seq105,r_8_2_52,1.0,0,52,52,6
56,seq25,r_57_101_138,r_7_114_22,r_7_114_22,0.81,0,22,22,6
13,r_34_12_21,r_117_38_11,r_94_72_88,r_94_72_88,1.0,14,102,88,6
22,r_7_114_22,seq37,seq25,r_7_114_22,1.0,0,22,22,6
29,r_71_66_43,r_23_125_183,seq6,r_71_66_43,1.0,0,43,43,6
5,r_139_58_55,r_123_74_142,r_20_45_72,r_139_58_55,0.6,87,142,55,6
19,r_32_112_53,seq19,seq60,r_32_112_53,1.0,0,53,53,6
27,r_131_15_87,seq49,seq110,r_131_15_87,1.0,-1,86,87,6
25,r_3_138_34,r_123_74_142,seq84,r_3_138_34,1.0,0,34,34,6
74,seq60,r_17_111_188,r_137_77_171,r_137_77_171,0.74,17,188,171,6
18,r_87_61_108,r_126_47_151,r_20_45_72,r_126_47_151,1.0,-43,108,151,6
1,r_123_74_142,seq39,r_139_58_55,r_139_58_55,0.97,3,58,55,6
33,r_126_47_151,seq37,seq136,r_126_47_151,0.87,0,151,151,6
9,r_134_68_40,seq136,seq18,r_134_68_40,0.99,4,44,40,6
37,r_117_38_11,r_23_125_183,r_34_12_21,r_34_12_21,0.92,17,38,21,6
65,seq39,r_123_74_142,r_20_45_72,r_20_45_72,0.78,43,115,72,6
38,r_17_111_188,seq60,r_93_64_115,r_93_64_115,0.74,73,188,115,6
2,r_99_51_54,seq0,seq37,r_99_51_54,1.0,0,54,54,6
0,r_20_45_72,r_123_74_142,r_87_61_108,r_20_45_72,0.95,36,108,72,6
53,seq19,r_32_112_53,r_20_45_72,r_32_112_53,0.96,4,57,53,6
17,r_76_79_92,seq75,r_134_68_40,r_76_79_92,0.84,1,93,92,6
31,r_63_50_8,r_78_73_133,seq109,r_78_73_133,0.93,17,150,133,6
28,r_23_125_183,r_117_38_11,r_42_1_65,r_23_125_183,0.45,0,183,183,6
5,r_139_58_55,seq59,r_123_74_142,r_139_58_55,0.93,3,58,55,6
7,r_57_101_138,seq110,r_16_127_196,r_57_101_138,0.89,1,139,138,6
44,seq5,r_137_77_171,seq11,r_137_77_171,0.62,0,171,171,6
23,r_94_72_88,r_87_61_108,r_34_12_21,r_94_72_88,0.98,4,92,88,6
35,r_97_43_31,r_107_102_152,seq124,r_97_43_31,1.0,0,31,31,6
12,r_44_9_172,seq10,seq135,r_44_9_172,0.65,1,173,172,6
40,seq129,seq2,r_78_95_132,r_78_95_132,0.72,-15,117,132,7
30,r_54_79_101,seq67,r_81_135_103,r_81_135_103,0.94,6,109,103,7
23,r_100_13_38,seq2,seq57,r_100_13_38,1.0,0,38,38,7
36,r_107_128_189,seq31,seq42,r_107_128_189,0.39,1,190,189,7
18,r_101_53_16,r_78_95_132,seq43,r_78_95_132,0.75,-116,16,132,7
14,r_123_77_190,r_90_110_66,seq126,r_90_110_66,1.0,-7,59,66,7
59,seq134,seq137,r_121_62_153,r_121_62_153,0.96,3,156,153,7
86,seq96,seq2,r_78_95_132,r_78_95_132,0.88,14,146,132,7
39,r_5_40_111,r_109_136_183,seq34,r_5_40_111,1.0,0,111,111,7
5,r_15_21_93,seq91,r_101_53_16,r_101_53_16,0.96,77,93,16,7
46,seq137,seq113,r_81_135_103,r_81_135_103,0.99,2,105,103,7
32,r_87_115_98,r_109_136_183,r_11_119_35,r_87_115_98,0.98,0,98,98,7
45,seq8,r_39_76_82,r_32_92_86,r_32_92_86,0.7,0,86,86,7
10,r_37_65_48,r_23_130_130,seq24,r_37_65_48,1.0,0,48,48,7
19,r_132_89_146,seq42,seq67,r_132_89_146,0.67,0,146,146,7
65,seq45,r_17_52_5,r_72_26_180,r_72_26_180,0.54,2,182,180,7
2,r_29_114_49,seq3,seq126,r_29_114_49,1.0,0,49,49,7
25,r_9_88_179,r_112_59_47,seq42,r_112_59_47,1.0,0,47,47,7
40,seq129,r_72_26_180,seq2,r_72_26_180,0.68,-151,29,180,7
35,r_125_20_11,seq64,seq102,r_125_20_11,0.9,0,11,11,7
31,r_121_62_153,r_32_92_86,r_39_76_82,r_121_62_153,1.0,-67,86,153,7
41,seq2,seq96,r_105_28_87,r_105_28_87,1.0,15,102,87,7
3,r_78_95_132,seq41,seq96,r_78_95_132,0.78,0,132,132,7
90,seq102,seq131,r_27_86_52,r_27_86_52,1.0,100,152,52,7
26,r_72_26_180,seq30,seq45,r_72_26_180,0.71,0,180,180,7
16,r_11_119_35,r_85_104_13,r_87_115_98,r_87_115_98,1.0,35,133,98,7
14,r_123_77_190,seq126,seq19,r_123_77_190,0.54,0,190,190,7
4,r_81_135_103,seq41,r_54_79_101,r_81_135_103,0.93,1,104,103,7
20,r_90_110_66,r_123_77_190,seq94,r_90_110_66,1.0,0,66,66,7
13,r_68_118_196,seq16,seq33,r_68_118_196,0.43,-68,128,196,7
22,r_103_47_24,seq139,seq35,r_103_47_24,0.53,8,32,24,7
15,r_48_70_63,seq137,seq102,r_48_70_63,1.0,1,64,63,7
6,r_73_97_106,seq67,r_90_110_66,r_73_97_106,0.58,0,106,106,7
62,seq42,r_132_89_146,r_9_88_179,r_132_89_146,0.71,0,146,146,7
85,seq94,seq35,r_90_110_66,r_90_110_66,1.0,1,67,66,7
2,r_29_114_49,seq126,seq8,r_29_114_49,0.43,73,122,49,7
99,seq126,r_123_77_190,r_109_136_183,r_109_136_183,0.54,-1,182,183,7
1,r_27_86_52,r_73_97_106,r_82_93_112,r_27_86_52,0.95,1,53,52,7
12,r_85_104_13,seq8,seq46,r_85_104_13,1.0,0,13,13,7
29,r_36_51_138,seq41,seq6,r_36_51_138,0.38,0,138,138,7
27,r_50_10_33,seq43,r_103_47_24,r_50_10_33,0.95,-1,32,33,7
24,r_32_92_86,r_121_62_153,seq8,r_32_92_86,1.0,0,86,86,7
33,r_23_130_130,r_82_93_112,r_101_53_16,r_23_130_130,1.0,0,130,130,7
58,seq35,seq94,r_103_47_24,r_103_47_24,0.71,7,31,24,7
38,r_109_136_183,seq6,seq126,r_109_136_183,0.56,0,183,183,7
57,seq34,r_17_52_5,r_5_40_111,r_5_40_111,1.0,3,114,111,7
34,r_105_28_87,seq42,seq2,r_105_28_87,0.99,0,87,87,7
9,r_120_18_51,seq25,seq43,r_120_18_51,1.0,0,51,51,7
0,r_112_59_47,r_9_88_179,r_82_93_112,r_112_59_47,1.0,0,47,47,7
17,r_133_127_141,seq58,r_125_20_11,r_133_127_141,0.91,0,141,141,7
31,r_121_62_153,r_39_76_82,seq134,r_121_62_153,1.0,0,153,153,7
32,r_87_115_98,r_1_0_20,r_109_136_183,r_1_0_20,0.8,0,20,20,7
16,r_11_119_35,seq45,r_85_104_13,r_11_119_35,1.0,0,35,35,7
28,r_12_138_137,r_133_127_141,r_71_7_3,r_12_138_137,0.9,0,137,137,7
8,r_1_0_20,r_87_115_98,seq3,r_1_0_20,1.0,0,20,20,7
7,r_39_76_82,seq8,seq25,r_39_76_82,1.0,0,82,82,7
18,r_101_53_16,seq43,r_23_130_130,r_23_130_130,1.0,13,143,130,7
65,seq45,r_11_119_35,seq19,r_11_119_35,0.85,0,35,35,7
93,seq107,r_138_27_108,seq18,r_138_27_108,0.86,11,119,108,8
23,r_22_110_52,r_32_37_144,seq13,r_22_110_52,1.0,0,52,52,8
30,r_6_116_121,seq26,seq71,r_6_116_121,1.0,0,121,121,8
36,r_9_35_137,seq93,seq21,r_9_35_137,0.63,1,138,137,8
92,seq106,r_89_129_145,seq112,r_89_129_145,1.0,0,145,145,8
8,r_118_20_99,seq87,r_124_50_194,r_118_20_99,0.61,1,100,99,8
39,r_111_70_148,seq15,seq18,r_111_70_148,0.43,1,149,148,8
5,r_63_83_61,seq130,seq84,r_63_83_61,1.0,0,61,61,8
33,r_123_100_163,r_113_105_20,r_120_8_141,r_113_105_20,0.96,143,163,20,8
76,seq66,seq23,r_113_105_20,r_113_105_20,1.0,73,93,20,8
16,r_113_105_20,seq2,r_123_100_163,r_113_105_20,1.0,0,20,20,8
3,r_32_37_144,seq112,r_65_122_86,r_65_122_86,0.8,60,146,86,8
16,r_113_105_20,r_123_100_163,seq43,r_123_100_163,0.91,0,163,163,8
4,r_60_121_161,seq13,seq52,r_60_121_161,0.81,0,161,161,8
0,r_16_30_179,r_136_56_190,r_10_132_4,r_136_56_190,0.56,-11,179,190,8
63,seq38,r_53_0_73,seq28,r_53_0_73,1.0,0,73,73,8
11,r_89_129_145,seq106,r_3_99_100,r_89_129_145,0.98,1,146,145,8
96,seq115,r_81_102_49,r_39_76_37,r_39_76_37,0.9,-2,35,37,8
38,r_81_102_49,seq15,r_58_97_151,r_81_102_49,0.84,2,51,49,8
15,r_49_128_125,r_16_30_179,seq2,r_16_30_179,0.53,-54,125,179,8
62,seq36,r_94_40_115,r_25_31_14,r_94_40_115,0.61,-37,78,115,8
33,r_123_100_163,seq43,r_113_105_20,r_113_105_20,1.0,11,31,20,8
35,r_47_92_13,r_51_80_111,seq71,r_47_92_13,0.75,11,24,13,8
18,r_53_0_73,seq38,seq87,r_53_0_73,1.0,2,75,73,8
24,r_55_119_142,seq36,r_53_0_73,r_55_119_142,0.85,0,142,142,8
25,r_94_40_115,seq36,r_63_83_61,r_94_40_115,1.0,1,116,115,8
70,seq52,seq29,r_60_121_161,r_60_121_161,0.74,1,162,161,8
8,r_118_20_99,r_124_50_194,r_111_70_148,r_111_70_148,0.45,-10,138,148,8
65,seq43,seq23,r_113_105_20,r_113_105_20,1.0,73,93,20,8
21,r_39_76_37,r_55_119_142,seq115,r_39_76_37,0.9,0,37,37,8
32,r_125_101_134,r_120_8_141,r_3_99_100,r_125_101_134,0.67,0,134,134,8
79,seq71,r_47_92_13,r_6_116_121,r_6_116_121,0.87,0,121,121,8
17,r_78_33_95,seq52,seq54,r_78_33_95,1.0,1,96,95,8
9,r_65_122_86,seq13,seq5,r_65_122_86,0.98,0,86,86,8
22,r_3_99_100,seq71,seq13,r_3_99_100,1.0,0,100,100,8
7,r_51_80_111,seq54,r_3_99_100,r_51_80_111,0.97,0,111,111,8
27,r_25_31_14,seq91,seq36,r_25_31_14,1.0,0,14,14,8
12,r_138_27_108,seq107,seq44,r_138_27_108,0.96,4,112,108,8
8,r_118_20_99,r_111_70_148,r_104_77_197,r_118_20_99,0.53,88,187,99,8
30,r_52_105_160,seq101,r_122_21_56,r_52_105_160,0.71,2,162,160,9
9,r_13_59_12,r_139_99_126,r_93_98_194,r_13_59_12,0.99,0,12,12,9
8,r_17_111_164,r_132_15_140,seq54,r_132_15_140,0.74,2,142,140,9
16,r_3_118_189,seq43,r_122_21_56,r_122_21_56,0.4,133,189,56,9
21,r_132_15_140,r_17_111_164,seq75,r_132_15_140,0.85,2,142,140,9
1,r_96_5_97,r_95_129_155,seq120,r_96_5_97,0.97,0,97,97,9
97,seq120,seq45,r_96_5_97,r_96_5_97,0.99,0,97,97,9
5,r_83_78_176,r_93_98_194,r_122_21_56,r_83_78_176,0.66,0,176,176,9
34,r_110_8_72,seq31,r_103_49_15,r_103_49_15,0.54,118,133,15,9
37,r_109_65_26,seq48,seq12,r_109_65_26,1.0,0,26,26,9
26,r_47_113_49,r_63_32_84,r_70_91_30,r_47_113_49,1.0,4,53,49,9
31,r_95_129_155,r_96_5_97,r_83_78_176,r_96_5_97,1.0,0,97,97,9
89,seq101,r_52_105_160,r_60_126_11,r_52_105_160,0.64,2,162,160,9
8,r_17_111_164,seq54,r_119_73_17,r_17_111_164,0.83,0,164,164,9
23,r_50_2_40,r_83_78_176,r_7_30_125,r_50_2_40,0.76,0,40,40,9
3,r_139_99_126,r_74_123_147,seq10,r_139_99_126,1.0,0,126,126,9
17,r_94_46_10,r_13_59_12,r_119_73_17,r_119_73_17,0.99,7,24,17,9
78,seq71,seq31,r_11_20_54,r_11_20_54,1.0,32,86,54,9
0,r_63_32_84,r_24_37_110,seq107,r_24_37_110,1.0,-32,78,110,9
63,seq41,r_58_106_153,r_122_21_56,r_122_21_56,1.0,99,155,56,9
11,r_24_37_110,r_1_27_191,seq0,r_24_37_110,0.82,0,110,110,9
20,r_35_125_112,seq28,seq16,r_35_125_112,0.99,0,112,112,9
13,r_68_36_148,seq75,seq18,r_68_36_148,0.95,1,149,148,9
25,r_122_21_56,seq84,r_115_77_13,r_122_21_56,0.99,0,56,56,9
6,r_87_88_129,r_3_118_189,r_7_30_125,r_3_118_189,0.65,-60,129,189,9
2,r_119_73_17,r_63_32_84,r_94_46_10,r_119_73_17,0.74,0,17,17,9
23,r_50_2_40,r_7_30_125,seq116,r_7_30_125,0.91,-44,81,125,9
24,r_138_86_4,r_93_98_194,r_119_73_17,r_119_73_17,1.0,7,24,17,9
47,seq10,seq23,r_139_99_126,r_139_99_126,0.99,8,134,126,9
18,r_81_6_78,seq14,r_11_20_54,r_81_6_78,0.53,1,79,78,9
29,r_112_62_177,seq84,r_55_134_41,r_55_134_41,0.99,138,179,41,9
4,r_55_134_41,r_58_106_153,seq48,r_55_134_41,0.99,2,43,41,9
67,seq48,r_55_134_41,r_74_123_147,r_74_123_147,0.96,13,160,147,9
33,r_39_90_109,seq92,r_47_113_49,r_39_90_109,1.0,2,111,109,9
39,r_93_98_194,r_83_78_176,r_13_59_12,r_13_59_12,0.99,0,12,12,9
32,r_7_30_125,seq16,r_87_88_129,r_7_30_125,0.99,3,128,125,9
38,r_25_44_166,seq89,seq40,r_25_44_166,0.74,0,166,166,9
35,r_115_77_13,r_83_78_176,seq41,r_115_77_13,1.0,0,13,13,9
14,r_72_97_20,r_94_46_10,seq14,r_72_97_20,0.55,-8,12,20,9
10,r_60_126_11,r_11_20_54,seq38,r_60_126_11,0.84,1,12,11,9
31,r_95_129_155,r_83_78_176,r_131_133_192,r_131_133_192,0.58,-37,155,192,9
12,r_103_49_15,seq45,r_72_97_20,r_103_49_15,1.0,1,16,15,9
15,r_11_20_54,seq84,seq71,r_11_20_54,1.0,0,54,54,9
22,r_121_9_127,seq66,seq31,r_121_9_127,0.93,1,128,127,9
7,r_74_123_147,r_58_106_153,seq130,r_74_123_147,0.94,0,147,147,9
30,r_24_92_79,seq77,r_49_86_31,r_24_92_79,1.0,1,80,79,10
36,r_72_40_95,r_53_79_3,r_2_56_131,r_72_40_95,0.79,0,95,95,10
9,r_61_35_51,r_76_139_170,r_78_31_21,r_76_139_170,0.98,0,170,170,10
8,r_131_85_198,r_108_90_164,seq89,r_108_90_164,0.91,-30,134,164,10
11,r_108_90_164,r_0_45_8,seq34,r_108_90_164,0.85,0,164,164,10
28,r_49_86_31,seq67,seq102,r_49_86_31,0.57,1,32,31,10
37,r_138_133_169,r_29_16_183,r_98_126_18,r_29_16_183,0.3,-13,170,183,10
19,r_78_31_21,r_65_136_185,r_61_35_51,r_61_35_51,0.5,134,185,51,10
1,r_95_54_123,r_12_36_187,seq107,r_95_54_123,1.0,2,125,123,10
46,seq13,r_7_71_136,r_1_4_100,r_1_4_100,1.0,38,138,100,10
80,seq93,r_1_4_100,r_101_23_11,r_1_4_100,0.98,-5,95,100,10
32,r_76_139_170,r_61_35_51,r_1_4_100,r_76_139_170,0.69,0,170,170,10
36,r_72_40_95,r_2_56_131,seq20,r_2_56_131,0.97,0,131,131,10
69,seq64,r_29_16_183,r_65_136_185,r_29_16_183,0.59,0,183,183,10
27,r_65_136_185,r_78_31_21,seq64,r_65_136_185,0.43,0,185,185,10
18,r_0_45_8,r_120_104_52,r_108_90_164,r_0_45_8,0.85,4,12,8,10
31,r_74_41_149,seq37,seq6,r_74_41_149,0.54,0,149,149,10
71,seq67,r_95_54_123,r_47_75_148,r_95_54_123,0.83,-47,76,123,10
4,r_12_36_187,r_95_54_123,r_120_104_52,r_12_36_187,0.82,-63,124,187,10
0,r_15_60_75,seq130,r_61_35_51,r_15_60_75,0.61,0,75,75,10
11,r_108_90_164,r_135_96_147,r_0_45_8,r_108_90_164,0.84,-17,147,164,10
20,r_10_32_175,seq114,r_98_126_18,r_10_32_175,0.79,0,175,175,10
4,r_12_36_187,r_120_104_52,seq116,r_12_36_187,0.96,0,187,187,10
14,r_106_58_50,seq89,seq13,r_106_58_50,1.0,-2,48,50,10
6,r_132_111_182,r_53_79_3,seq5,r_132_111_182,0.58,1,183,182,10
33,r_128_129_22,r_11_68_57,seq8,r_128_129_22,0.72,-1,21,22,10
27,r_65_136_185,r_76_139_170,r_78_31_21,r_78_31_21,0.61,47,68,21,10
26,r_118_17_55,r_61_35_51,seq107,r_118_17_55,1.0,-1,54,55,10
3,r_120_104_52,r_132_111_182,seq22,r_120_104_52,1.0,0,52,52,10
40,seq130,r_15_60_75,seq62,r_15_60_75,0.98,0,75,75,10
29,r_121_110_61,r_108_90_164,seq48,r_121_110_61,1.0,1,62,61,10
25,r_91_134_62,r_1_4_100,seq26,r_1_4_100,1.0,-38,62,100,10
64,seq51,r_47_75_148,r_63_88_58,r_63_88_58,1.0,103,161,58,10
44,seq8,seq42,r_128_129_22,r_128_129_22,0.99,3,25,22,10
21,r_101_23_11,r_131_85_198,seq93,r_101_23_11,1.0,0,11,11,10
32,r_76_139_170,seq59,r_61_35_51,r_76_139_170,0.84,-103,67,170,10
38,r_2_56_131,r_27_80_97,r_72_40_95,r_72_40_95,0.82,-2,93,95,10
86,seq107,r_132_111_182,r_118_17_55,r_118_17_55,1.0,1,56,55,10
5,r_98_126_18,seq37,seq109,r_98_126_18,1.0,3,21,18,10
34,r_11_68_57,seq89,seq25,r_11_68_57,0.99,0,57,57,10
79,seq89,r_11_68_57,r_0_45_8,r_11_68_57,0.97,0,57,57,10
17,r_135_96_147,r_108_90_164,seq22,r_135_96_147,0.61,0,147,147,10
9,r_61_35_51,r_50_21_189,r_76_139_170,r_50_21_189,0.73,-129,60,189,10
38,r_2_56_131,r_72_40_95,seq82,r_2_56_131,1.0,0,131,131,10
7,r_1_4_100,seq93,r_106_58_50,r_1_4_100,0.99,0,100,100,10
18,r_0_45_8,r_108_90_164,seq89,r_108_90_164,0.91,-30,134,164,10
23,r_9_57_116,seq39,seq125,r_9_57_116,1.0,0,116,116,10
35,r_47_75_148,seq51,seq67,r_47_75_148,0.63,13,161,148,10
19,r_78_31_21,seq89,r_65_136_185,r_78_31_21,0.97,0,21,21,10
93,seq112,r_122_20_77,r_99_11_9,r_122_20_77,0.99,0,77,77,11
30,r_119_56_95,seq35,r_15_14_34,r_119_56_95,0.69,0,95,95,11
92,seq110,r_113_95_132,r_122_20_77,r_122_20_77,0.81,17,94,77,11
8,r_3_94_74,seq60,seq0,r_3_94_74,0.93,0,74,74,11
53,seq21,seq42,r_93_67_165,r_93_67_165,0.95,5,170,165,11
83,seq91,r_123_34_186,seq100,r_123_34_186,0.8,-106,80,186,11
37,r_75_121_89,seq101,seq133,r_75_121_89,1.0,2,91,89,11
36,r_134_30_11,r_15_14_34,r_61_65_6,r_134_30_11,1.0,0,11,11,11
21,r_8_32_117,seq102,seq35,r_8_32_117,0.77,1,118,117,11
19,r_84_5_97,r_26_24_129,seq107,r_84_5_97,0.91,0,97,97,11
32,r_68_104_47,r_80_138_123,seq127,r_68_104_47,1.0,0,47,47,11
95,seq115,r_118_132_163,seq2,r_118_132_163,0.59,0,163,163,11
0,r_96_4_65,r_73_50_43,seq131,r_73_50_43,0.83,0,43,43,11
31,r_53_116_158,seq35,r_75_121_89,r_53_116_158,0.58,0,158,158,11
14,r_78_48_22,r_122_20_77,seq38,r_78_48_22,0.97,0,22,22,11
10,r_80_138_123,seq92,seq19,r_80_138_123,0.94,0,123,123,11
90,seq107,r_123_34_186,r_84_5_97,r_84_5_97,0.97,5,102,97,11
43,seq131,r_96_4_65,seq0,r_96_4_65,0.99,0,65,65,11
26,r_12_111_116,seq66,r_87_41_79,r_12_111_116,0.97,0,116,116,11
72,seq64,r_118_132_163,seq2,r_118_132_163,0.68,0,163,163,11
4,r_74_45_113,seq76,seq54,r_74_45_113,0.99,0,113,113,11
20,r_122_20_77,seq112,seq110,r_122_20_77,1.0,0,77,77,11
29,r_26_24_129,seq89,seq69,r_26_24_129,0.99,4,133,129,11
13,r_77_129_109,seq38,seq16,r_77_129_109,0.96,0,109,109,11
12,r_93_67_165,r_124_46_51,seq21,r_93_67_165,0.71,0,165,165,11
6,r_97_109_135,seq44,seq36,r_97_109_135,0.95,2,137,135,11
27,r_120_49_10,seq128,r_61_65_6,r_120_49_10,0.91,3,13,10,11
99,seq127,seq57,r_68_104_47,r_68_104_47,1.0,54,101,47,11
18,r_90_1_108,r_71_105_3,r_3_94_74,r_90_1_108,0.74,0,108,108,11
29,r_26_24_129,r_84_5_97,seq89,r_84_5_97,1.0,0,97,97,11
11,r_73_50_43,r_96_4_65,seq42,r_73_50_43,0.97,0,43,43,11
25,r_7_136_176,seq57,seq2,r_7_136_176,0.57,0,176,176,11
33,r_88_130_90,r_75_121_89,r_47_28_55,r_88_130_90,0.98,0,90,90,11
8,r_3_94_74,seq0,r_90_1_108,r_90_1_108,0.99,4,112,108,11
65,seq42,seq21,r_73_50_43,r_73_50_43,1.0,31,74,43,11
23,r_124_46_51,r_74_45_113,seq103,r_124_46_51,1.0,2,53,51,11
38,r_22_27_188,seq17,r_82_63_153,r_82_63_153,0.74,35,188,153,11
52,seq19,seq31,r_80_138_123,r_80_138_123,0.93,2,125,123,11
77,seq76,r_74_45_113,r_96_4_65,r_96_4_65,0.51,31,96,65,11
34,r_82_63_153,seq102,seq91,r_82_63_153,0.88,1,154,153,11
39,r_47_28_55,seq127,seq100,r_47_28_55,1.0,0,55,55,11
22,r_52_81_151,r_88_130_90,r_61_65_6,r_52_81_151,0.95,0,151,151,11
22,r_52_81_151,seq60,r_88_130_90,r_88_130_90,0.78,39,129,90,11
28,r_118_132_163,r_123_34_186,seq139,r_123_34_186,0.54,-23,163,186,11
0,r_96_4_65,seq131,seq76,r_96_4_65,1.0,0,65,65,11
7,r_113_95_132,seq133,seq128,r_113_95_132,0.84,0,132,132,11
82,seq89,r_26_24_129,r_59_98_122,r_26_24_129,0.52,-1,128,129,11
35,r_87_41_79,seq72,seq101,r_87_41_79,0.99,0,79,79,11
5,r_15_14_34,r_22_27_188,seq38,r_15_14_34,1.0,0,34,34,11
12,r_93_67_165,seq69,r_124_46_51,r_124_46_51,1.0,39,90,51,11
79,seq86,seq48,r_105_92_19,r_105_92_19,1.0,3,22,19,12
36,r_96_81_101,r_8_77_70,r_57_26_136,r_8_77_70,1.0,0,70,70,12
9,r_80_0_179,r_13_47_23,seq15,r_80_0_179,0.86,0,179,179,12
0,r_6_11_48,r_49_69_159,r_9_63_82,r_49_69_159,0.62,-104,55,159,12
14,r_57_26_136,seq35,seq123,r_57_26_136,0.4,2,138,136,12
8,r_60_83_172,seq44,r_42_104_198,r_60_83_172,0.21,1,173,172,12
21,r_120_97_15,r_82_20_79,seq137,r_120_97_15,1.0,0,15,15,12
5,r_71_30_185,seq55,r_82_20_79,r_82_20_79,0.66,107,186,79,12
19,r_64_138_196,r_79_75_129,r_13_47_23,r_79_75_129,0.81,-14,115,129,12
3,r_9_63_82,r_129_43_143,r_85_45_121,r_9_63_82,0.61,4,86,82,12
35,r_13_47_23,seq2,r_64_138_196,r_13_47_23,0.9,-4,19,23,12
72,seq62,r_102_25_168,seq130,r_102_25_168,0.6,0,168,168,12
47,seq137,r_5_12_166,r_120_97_15,r_120_97_15,1.0,0,15,15,12
11,r_19_66_4,r_46_65_167,r_82_20_79,r_46_65_167,0.84,-14,153,167,12
20,r_22_131_90,seq40,seq123,r_22_131_90,1.0,0,90,90,12
13,r_5_12_166,seq139,seq2,r_5_12_166,0.54,0,166,166,12
15,r_34_18_80,seq114,seq39,r_34_18_80,0.74,-17,63,80,12
31,r_121_113_13,r_41_76_177,seq139,r_121_113_13,0.96,0,13,13,12
99,seq126,r_57_26_136,r_85_45_121,r_85_45_121,0.98,0,121,121,12
0,r_6_11_48,r_9_63_82,seq62,r_6_11_48,0.44,92,140,48,12
87,seq99,r_49_69_159,r_94_54_63,r_94_54_63,0.99,5,68,63,12
3,r_9_63_82,r_85_45_121,seq62,r_85_45_121,1.0,0,121,121,12
34,r_103_33_53,r_72_70_112,seq118,r_103_33_53,0.98,0,53,53,12
2,r_94_54_63,seq67,seq99,r_94_54_63,0.98,0,63,63,12
28,r_136_58_41,seq21,seq61,r_136_58_41,0.99,0,41,41,12
18,r_72_70_112,r_85_45_121,seq23,r_85_45_121,0.98,-9,112,121,12
29,r_102_25_168,r_79_75_129,r_13_47_23,r_102_25_168,0.58,-53,115,168,12
36,r_96_81_101,r_57_26_136,r_13_47_23,r_96_81_101,1.0,0,101,101,12
25,r_50_110_58,r_42_104_198,seq1,r_50_110_58,0.78,2,60,58,12
33,r_46_65_167,r_19_66_4,r_42_104_198,r_19_66_4,0.52,163,167,4,12
68,seq55,r_71_30_185,r_72_70_112,r_72_70_112,0.64,74,186,112,12
24,r_105_92_19,r_22_131_90,seq86,r_105_92_19,0.73,0,19,19,12
32,r_79_75_129,r_49_69_159,seq21,r_79_75_129,1.0,0,129,129,12
17,r_108_53_164,seq133,seq62,r_108_53_164,0.78,1,165,164,12
9,r_80_0_179,r_79_75_129,r_13_47_23,r_79_75_129,0.77,-38,91,129,12
22,r_49_69_159,r_102_25_168,r_82_20_79,r_102_25_168,0.95,-9,159,168,12
56,seq27,seq137,r_107_10_57,r_107_10_57,1.0,25,82,57,12
44,seq133,r_108_53_164,seq48,r_108_53_164,0.99,-2,162,164,12
23,r_85_45_121,r_72_70_112,seq126,r_85_45_121,0.97,-1,120,121,12
29,r_102_25_168,r_13_47_23,seq24,r_102_25_168,1.0,0,168,168,12
6,r_107_10_57,r_49_69_159,seq139,r_107_10_57,1.0,0,57,57,12
12,r_31_117_36,seq109,r_129_43_143,r_31_117_36,0.48,75,111,36,12
30,r_48_31_77,seq75,r_78_38_47,r_48_31_77,0.99,0,77,77,13
14,r_123_58_192,r_109_101_176,r_121_82_63,r_121_82_63,1.0,14,77,63,13
8,r_33_83_98,seq107,seq7,r_33_83_98,1.0,3,101,98,13
13,r_27_52_52,seq55,seq128,r_27_52_52,0.9,0,52,52,13
37,r_122_43_85,seq114,seq139,r_122_43_85,1.0,0,85,85,13
26,r_78_38_47,r_109_101_176,seq7,r_78_38_47,1.0,0,47,47,13
5,r_23_45_187,seq44,r_35_50_38,r_35_50_38,1.0,149,187,38,13
32,r_35_50_38,r_12_54_71,r_126_64_189,r_35_50_38,1.0,0,38,38,13
20,r_41_67_53,seq8,seq53,r_41_67_53,1.0,0,53,53,13
69,seq53,r_117_127_168,r_41_67_53,r_41_67_53,0.99,6,59,53,13
34,r_126_64_189,seq131,r_35_50_38,r_35_50_38,1.0,16,54,38,13
35,r_24_66_22,r_27_52_52,seq51,r_24_66_22,0.94,0,22,22,13
41,seq1,r_59_30_191,r_104_57_125,r_104_57_125,0.72,5,130,125,13
3,r_94_36_82,r_73_91_154,seq139,r_94_36_82,0.92,0,82,82,13
10,r_137_92_108,seq4,seq34,r_137_92_108,0.98,0,108,108,13
29,r_16_61_28,seq56,seq87,r_16_61_28,1.0,0,28,28,13
4,r_116_88_112,seq77,r_122_43_85,r_116_88_112,0.98,2,114,112,13
73,seq139,r_47_98_185,r_122_43_85,r_122_43_85,1.0,15,100,85,13
15,r_111_113_115,r_99_62_156,seq133,r_111_113_115,0.97,1,116,115,13
16,r_42_74_32,r_73_91_154,seq37,r_42_74_32,1.0,0,32,32,13
6,r_47_98_185,seq139,r_28_19_33,r_47_98_185,0.48,0,185,185,13
68,seq51,r_65_102_165,r_24_66_22,r_24_66_22,1.0,0,22,22,13
27,r_65_102_165,seq20,seq18,r_65_102_165,0.7,0,165,165,13
87,seq95,r_65_102_165,r_12_54_71,r_12_54_71,0.82,92,163,71,13
1,r_136_10_10,r_0_130_195,seq100,r_136_10_10,0.97,0,10,10,13
2,r_39_97_87,r_47_98_185,seq17,r_39_97_87,0.96,0,87,87,13
47,seq7,r_99_62_156,r_33_83_98,r_33_83_98,0.8,58,156,98,13
39,r_68_32_58,seq14,seq129,r_68_32_58,1.0,0,58,58,13
18,r_121_82_63,seq107,r_123_58_192,r_121_82_63,1.0,0,63,63,13
24,r_73_91_154,seq2,r_63_25_95,r_73_91_154,0.6,0,154,154,13
25,r_9_80_147,seq18,seq114,r_9_80_147,0.92,0,147,147,13
38,r_124_3_40,r_73_91_154,r_28_19_33,r_28_19_33,0.69,42,75,33,13
36,r_28_19_33,r_0_130_195,r_124_3_40,r_28_19_33,1.0,0,33,33,13
21,r_112_71_51,seq100,seq110,r_112_71_51,1.0,0,51,51,13
60,seq133,seq100,r_111_113_115,r_111_113_115,1.0,2,117,115,13
17,r_109_101_176,seq26,r_24_66_22,r_24_66_22,0.6,154,176,22,13
22,r_12_54_71,seq17,seq95,r_12_54_71,1.0,0,71,71,13
28,r_115_81_118,seq37,seq60,r_115_81_118,0.99,1,119,118,13
71,seq56,r_16_61_28,r_123_58_192,r_16_61_28,0.93,1,29,28,13
7,r_13_90_184,r_59_30_191,r_65_102_165,r_65_102_165,0.68,19,184,165,13
23,r_63_25_95,r_137_92_108,seq129,r_137_92_108,1.0,-10,98,108,13
12,r_104_57_125,seq134,seq1,r_104_57_125,0.84,1,126,125,13
36,r_57_89_187,seq7,r_136_45_27,r_136_45_27,0.72,161,188,27,14
23,r_82_53_39,r_90_122_158,seq115,r_82_53_39,0.88,-11,28,39,14
14,r_46_124_127,seq68,seq123,r_46_124_127,1.0,0,127,127,14
8,r_28_77_119,seq31,seq93,r_28_77_119,1.0,0,119,119,14
54,seq27,r_84_51_194,r_90_122_158,r_90_122_158,0.73,26,184,158,14
37,r_95_65_78,seq43,seq106,r_95_65_78,1.0,0,78,78,14
98,seq126,r_67_104_197,r_92_121_4,r_92_121_4,0.72,12,16,4,14
26,r_97_79_48,r_69_20_167,seq135,r_97_79_48,0.96,-1,47,48,14
24,r_134_48_58,r_69_20_167,seq23,r_134_48_58,0.99,1,59,58,14
55,seq31,r_28_77_119,r_84_51_194,r_28_77_119,1.0,0,119,119,14
15,r_69_20_167,r_58_131_199,r_136_45_27,r_69_20_167,0.86,3,170,167,14
86,seq106,r_39_119_143,seq129,r_39_119_143,1.0,0,143,143,14
21,r_90_122_158,seq38,seq31,r_90_122_158,0.94,0,158,158,14
97,seq123,seq18,r_46_124_127,r_46_124_127,1.0,10,137,127,14
5,r_110_56_124,seq23,seq107,r_110_56_124,0.61,1,125,124,14
11,r_136_45_27,seq107,seq11,r_136_45_27,0.97,0,27,27,14
10,r_17_105_178,seq34,r_28_77_119,r_28_77_119,0.67,62,181,119,14
33,r_25_75_12,seq11,seq115,r_25_75_12,0.99,1,13,12,14
47,seq11,r_0_76_49,r_136_45_27,r_136_45_27,0.88,0,27,27,14
4,r_132_117_120,seq127,seq18,r_132_117_120,0.94,0,120,120,14
63,seq44,r_72_80_137,r_39_119_143,r_39_119_143,0.78,17,160,143,14
19,r_19_74_28,r_57_89_187,seq38,r_19_74_28,1.0,-1,27,28,14
13,r_60_139_73,r_84_51_194,r_62_30_139,r_60_139_73,0.87,0,73,73,14
15,r_69_20_167,r_39_119_143,r_58_131_199,r_39_119_143,0.9,0,143,143,14
57,seq34,r_17_105_178,r_112_133_37,r_112_133_37,0.97,139,176,37,14
13,r_60_139_73,r_62_30_139,r_97_79_48,r_62_30_139,1.0,2,141,139,14
6,r_128_9_123,seq38,r_136_45_27,r_128_9_123,1.0,0,123,123,14
2,r_72_80_137,seq38,seq78,r_72_80_137,0.36,-77,60,137,14
94,seq115,seq99,r_82_53_39,r_82_53_39,0.99,-18,21,39,14
74,seq78,r_72_80_137,r_26_130_150,r_26_130_150,0.54,4,154,150,14
18,r_22_5_132,r_62_30_139,seq43,r_22_5_132,0.8,0,132,132,14
29,r_55_96_163,seq66,seq21,r_55_96_163,0.62,0,163,163,14
34,r_62_30_139,r_60_139_73,seq106,r_62_30_139,0.98,4,143,139,14
25,r_39_119_143,r_69_20_167,seq37,r_39_119_143,0.95,0,143,143,14
20,r_70_42_19,r_16_63_53,seq107,r_16_63_53,0.92,-34,19,53,14
58,seq37,seq100,r_39_119_143,r_39_119_143,0.72,22,165,143,14
1,r_112_133_37,r_26_130_150,seq107,r_112_133_37,1.0,0,37,37,14
34,r_62_30_139,seq135,r_60_139_73,r_60_139_73,1.0,9,82,73,14
32,r_16_63_53,r_110_56_124,seq66,r_16_63_53,1.0,0,53,53,14
81,seq135,r_62_30_139,r_97_79_48,r_97_79_48,0.95,92,140,48,14
31,r_87_14_8,seq38,r_98_102_61,r_98_102_61,0.99,3,64,61,14
17,r_98_102_61,seq129,r_87_14_8,r_98_102_61,0.95,0,61,61,14
22,r_26_130_150,r_55_96_163,r_19_74_28,r_26_130_150,0.5,0,150,150,14
62,seq43,r_95_65_78,r_52_125_157,r_95_65_78,1.0,-24,54,78,14
28,r_52_125_157,seq32,seq12,r_52_125_157,0.92,0,157,157,14
55,seq31,r_84_51_194,r_90_122_158,r_90_122_158,0.86,0,158,158,14
82,seq93,seq54,r_28_77_119,r_28_77_119,1.0,6,125,119,14
30,r_128_96_164,seq106,seq15,r_128_96_164,0.78,0,164,164,15
51,seq20,r_30_43_111,r_24_69_102,r_30_43_111,1.0,-1,110,111,15
18,r_119_72_20,r_26_84_151,seq123,r_119_72_20,0.98,0,20,20,15
14,r_30_43_111,seq20,seq120,r_30_43_111,0.99,-1,110,111,15
14,r_30_43_111,seq120,r_80_113_25,r_30_43_111,0.49,38,149,111,15
71,seq73,seq16,r_108_137_41,r_108_137_41,0.59,45,86,41,15
39,r_124_98_120,seq4,r_39_89_1,r_124_98_120,1.0,0,120,120,15
5,r_90_50_81,r_95_66_122,seq4,r_90_50_81,0.68,3,84,81,15
35,r_58_35_45,r_124_98_120,seq16,r_58_35_45,1.0,0,45,45,15
19,r_112_117_183,r_39_89_1,r_51_41_7,r_51_41_7,0.62,176,183,7,15
15,r_5_114_33,r_57_76_166,r_31_132_91,r_31_132_91,0.94,53,144,91,15
1,r_74_28_46,seq16,seq88,r_74_28_46,1.0,1,47,46,15
31,r_40_6_69,r_34_52_157,r_83_92_197,r_40_6_69,1.0,0,69,69,15
8,r_126_17_23,r_90_50_81,seq67,r_126_17_23,1.0,0,23,23,15
4,r_8_46_134,seq14,r_83_92_197,r_8_46_134,0.72,0,134,134,15
11,r_34_52_157,r_128_96_164,r_108_137_41,r_34_52_157,0.68,0,157,157,15
13,r_31_132_91,seq62,r_5_114_33,r_31_132_91,1.0,1,92,91,15
31,r_40_6_69,r_83_92_197,r_10_134_94,r_10_134_94,0.96,18,112,94,15
48,seq15,r_9_3_123,r_21_2_54,r_21_2_54,0.85,69,123,54,15
27,r_0_37_26,seq136,seq29,r_0_37_26,0.95,0,26,26,15
70,seq70,r_102_131_193,r_94_47_57,r_94_47_57,0.99,-2,55,57,15
6,r_95_66_122,r_90_50_81,seq7,r_95_66_122,1.0,-9,113,122,15
67,seq64,r_74_28_46,r_104_56_31,r_74_28_46,0.99,1,47,46,15
0,r_57_76_166,r_5_114_33,r_80_113_25,r_57_76_166,0.87,-2,164,166,15
3,r_94_47_57,r_31_132_91,seq70,r_94_47_57,1.0,0,57,57,15
12,r_108_137_41,seq67,seq73,r_108_137_41,0.95,2,43,41,15
87,seq106,r_128_96_164,r_36_1_175,r_128_96_164,0.95,1,165,164,15
15,r_5_114_33,r_112_117_183,r_57_76_166,r_5_114_33,1.0,0,33,33,15
20,r_21_2_54,r_83_92_197,seq85,r_21_2_54,1.0,1,55,54,15
25,r_44_65_70,seq49,seq25,r_44_65_70,1.0,0,70,70,15
99,seq127,seq93,r_80_113_25,r_80_113_25,1.0,9,34,25,15
50,seq18,r_118_71_174,seq107,r_118_71_174,0.61,-42,132,174,15
32,r_135_13_184,seq68,r_112_117_183,r_112_117_183,0.56,1,184,183,15
38,r_9_3_123,seq15,r_104_56_31,r_9_3_123,1.0,0,123,123,15
29,r_54_129_44,r_31_132_91,r_10_134_94,r_54_129_44,0.83,0,44,44,15
17,r_33_97_58,seq48,r_128_96_164,r_33_97_58,0.83,20,78,58,15
9,r_32_138_85,r_135_13_184,seq81,r_32_138_85,1.0,0,85,85,15
0,r_57_76_166,r_9_3_123,r_5_114_33,r_5_114_33,1.0,-2,31,33,15
29,r_54_129_44,r_10_134_94,r_80_113_25,r_54_129_44,0.45,105,149,44,15
22,r_24_69_102,seq99,seq70,r_24_69_102,0.65,6,108,102,15
28,r_10_134_94,seq100,r_40_6_69,r_40_6_69,0.97,31,100,69,15
10,r_80_113_25,r_26_84_151,seq127,r_80_113_25,0.96,0,25,25,15
7,r_39_89_1,r_112_117_183,r_124_98_120,r_124_98_120,1.0,63,183,120,15
44,seq136,seq122,r_53_79_142,r_53_79_142,0.94,2,144,142,15
48,seq15,r_21_2_54,r_128_96_164,r_128_96_164,0.67,-1,163,164,15
17,r_33_97_58,r_128_96_164,seq86,r_128_96_164,0.99,1,165,164,15
16,r_104_56_31,r_21_2_54,seq64,r_21_2_54,0.88,-23,31,54,15
30,r_131_7_176,seq133,r_56_51_34,r_131_7_176,0.63,0,176,176,16
59,seq42,r_105_44_189,r_38_119_17,r_38_119_17,0.98,0,17,17,16
36,r_89_12_76,seq49,seq133,r_89_12_76,1.0,0,76,76,16
6,r_59_50_66,r_3_16_137,r_104_129_15,r_104_129_15,0.83,5,20,15,16
14,r_117_2_84,seq100,seq108,r_117_2_84,1.0,0,84,84,16
8,r_91_33_58,r_123_23_68,seq96,r_123_23_68,0.96,-7,61,68,16
55,seq30,seq47,r_115_94_64,r_115_94_64,1.0,24,88,64,16
86,seq97,r_28_101_117,seq122,r_28_101_117,1.0,0,117,117,16
16,r_134_136_151,seq10,seq97,r_134_136_151,0.61,0,151,151,16
39,r_115_94_64,seq130,seq30,r_115_94_64,1.0,0,64,64,16
1,r_107_9_77,seq75,seq120,r_107_9_77,1.0,0,77,77,16
80,seq84,r_115_94_64,seq122,r_115_94_64,0.4,80,144,64,16
5,r_52_112_72,seq84,r_90_57_123,r_52_112_72,0.98,0,72,72,16
42,seq130,r_34_125_97,seq4,r_34_125_97,1.0,0,97,97,16
31,r_116_40_101,r_132_135_33,r_5_82_25,r_5_82_25,0.97,4,29,25,16
69,seq67,r_68_31_181,seq114,r_68_31_181,0.98,1,182,181,16
5,r_52_112_72,r_90_57_123,seq110,r_90_57_123,1.0,0,123,123,16
95,seq120,seq106,r_107_9_77,r_107_9_77,1.0,27,104,77,16
38,r_48_113_150,r_59_50_66,r_5_82_25,r_48_113_150,0.99,0,150,150,16
33,r_56_51_34,seq21,seq20,r_56_51_34,0.95,-1,33,34,16
89,seq103,seq0,r_34_125_97,r_34_125_97,1.0,14,111,97,16
3,r_137_81_154,seq53,seq14,r_137_81_154,0.98,0,154,154,16
10,r_93_138_162,seq92,seq110,r_93_138_162,0.59,0,162,162,16
9,r_38_119_17,r_5_82_25,seq42,r_38_119_17,0.99,-1,16,17,16
72,seq72,r_90_57_123,r_52_112_72,r_52_112_72,0.55,51,123,72,16
0,r_34_125_97,seq130,seq103,r_34_125_97,1.0,0,97,97,16
63,seq49,r_89_12_76,seq110,r_89_12_76,1.0,-5,71,76,16
11,r_74_62_103,seq14,seq76,r_74_62_103,0.5,-3,100,103,16
20,r_95_32_155,seq92,seq39,r_95_32_155,0.86,0,155,155,16
15,r_71_55_132,r_65_11_87,seq83,r_65_11_87,0.77,-7,80,87,16
13,r_87_36_52,seq72,seq8,r_87_36_52,1.0,1,53,52,16
4,r_5_82_25,seq83,r_48_113_150,r_48_113_150,0.99,1,151,150,16
57,seq37,seq85,r_71_55_132,r_71_55_132,0.99,10,142,132,16
12,r_105_44_189,r_18_78_109,seq100,r_105_44_189,0.75,0,189,189,16
6,r_59_50_66,r_48_113_150,r_111_22_147,r_59_50_66,0.99,84,150,66,16
2,r_104_129_15,r_131_7_176,r_59_50_66,r_104_129_15,0.99,2,17,15,16
2,r_104_129_15,r_59_50_66,r_123_23_68,r_104_129_15,0.95,54,69,15,16
27,r_18_78_109,seq20,r_58_43_91,r_58_43_91,1.0,19,110,91,16
25,r_19_41_51,r_107_9_77,seq39,r_19_41_51,1.0,0,51,51,16
4,r_5_82_25,seq128,seq83,r_5_82_25,1.0,-1,24,25,16
18,r_123_23_68,r_71_55_132,r_104_129_15,r_123_23_68,1.0,2,70,68,16
24,r_65_11_87,r_71_55_132,seq108,r_65_11_87,1.0,0,87,87,16
6,r_59_50_66,r_104_129_15,r_48_113_150,r_59_50_66,1.0,0,66,66,16
15,r_71_55_132,seq83,seq37,r_71_55_132,1.0,1,133,132,16
32,r_90_57_123,seq72,seq10,r_90_57_123,0.98,1,124,123,16
38,r_48_113_150,seq130,r_59_50_66,r_59_50_66,1.0,3,69,66,16
34,r_58_43_91,r_68_31_181,r_18_78_109,r_58_43_91,0.96,0,91,91,16
75,seq76,seq80,r_74_62_103,r_74_62_103,0.75,-1,102,103,16
18,r_123_23_68,r_104_129_15,r_29_102_100,r_29_102_100,0.63,27,127,100,16
17,r_3_16_137,seq39,seq8,r_3_16_137,0.95,0,137,137,16
26,r_132_135_33,r_116_40_101,r_93_138_162,r_116_40_101,0.6,-68,33,101,16
26,r_132_135_33,r_93_138_162,seq73,r_93_138_162,0.99,-11,151,162,16
31,r_116_40_101,r_5_82_25,r_18_78_109,r_116_40_101,1.0,0,101,101,16
28,r_28_101_117,seq97,seq45,r_28_101_117,0.98,0,117,117,16
7,r_111_22_147,seq96,r_59_50_66,r_111_22_147,0.58,0,147,147,16
23,r_68_31_181,seq67,r_71_55_132,r_68_31_181,0.51,1,182,181,16
12,r_105_44_189,seq106,r_18_78_109,r_18_78_109,0.38,17,126,109,16
84,seq92,r_95_32_155,r_1_121_8,r_95_32_155,0.94,0,155,155,16
24,r_17_97_36,seq43,r_23_2_17,r_17_97_36,0.75,0,36,36,17
36,r_24_105_144,seq39,seq25,r_24_105_144,0.9,0,144,144,17
8,r_98_11_159,seq90,seq45,r_98_11_159,0.56,0,159,159,17
54,seq21,seq52,r_35_27_88,r_35_27_88,1.0,0,88,88,17
9,r_84_92_143,r_94_85_104,r_122_34_129,r_84_92_143,0.98,1,144,143,17
37,r_75_117_153,seq10,r_24_105_144,r_24_105_144,0.98,11,155,144,17
38,r_23_2_17,r_55_3_192,seq123,r_23_2_17,0.86,-1,16,17,17
86,seq90,r_98_11_159,r_12_71_7,r_98_11_159,0.64,0,159,159,17
21,r_65_125_95,seq29,r_40_64_181,r_65_125_95,0.66,1,96,95,17
5,r_122_34_129,seq67,seq32,r_122_34_129,0.99,0,129,129,17
19,r_94_85_104,seq36,seq59,r_94_85_104,1.0,0,104,104,17
15,r_118_16_157,seq72,r_120_137_158,r_118_16_157,0.82,2,159,157,17
16,r_30_112_30,r_118_16_157,seq32,r_30_112_30,1.0,0,30,30,17
76,seq67,r_122_34_129,seq133,r_122_34_129,1.0,0,129,129,17
11,r_108_136_136,r_104_99_173,r_94_85_104,r_104_99_173,0.62,3,176,173,17
15,r_118_16_157,r_30_112_30,seq72,r_30_112_30,1.0,0,30,30,17
67,seq50,r_75_117_153,r_20_73_21,r_20_73_21,0.98,141,162,21,17
31,r_20_73_21,r_118_16_157,seq49,r_20_73_21,1.0,0,21,21,17
3,r_103_44_168,seq100,r_12_71_7,r_103_44_168,0.46,0,168,168,17
10,r_55_3_192,r_33_53_147,r_18_0_116,r_55_3_192,0.89,-45,147,192,17
12,r_62_81_51,seq15,seq60,r_62_81_51,1.0,0,51,51,17
4,r_82_69_123,r_98_11_159,r_54_5_45,r_98_11_159,0.99,-36,123,159,17
29,r_124_46_41,r_37_102_130,seq72,r_37_102_130,0.51,-89,41,130,17
20,r_35_27_88,seq132,seq21,r_35_27_88,1.0,0,88,88,17
13,r_8_111_125,r_22_135_187,seq52,r_8_111_125,1.0,0,125,125,17
94,seq115,seq139,r_6_74_19,r_6_74_19,1.0,25,44,19,17
6,r_22_135_187,r_8_111_125,seq31,r_8_111_125,0.92,-16,109,125,17
41,seq129,r_6_74_19,r_54_5_45,r_6_74_19,0.76,31,50,19,17
7,r_101_107_44,r_24_105_144,seq10,r_101_107_44,0.99,0,44,44,17
33,r_40_64_181,r_65_125_95,seq67,r_40_64_181,0.56,0,181,181,17
27,r_120_137_158,seq89,seq130,r_120_137_158,0.79,-2,156,158,17
2,r_1_70_85,r_75_117_153,seq139,r_1_70_85,1.0,0,85,85,17
34,r_54_5_45,r_55_3_192,r_82_69_123,r_82_69_123,1.0,1,124,123,17
25,r_13_48_138,seq32,seq72,r_13_48_138,0.97,1,139,138,17
33,r_40_64_181,r_98_11_159,r_65_125_95,r_40_64_181,0.47,-49,132,181,17
91,seq109,r_13_48_138,r_42_91_6,r_13_48_138,0.53,-97,41,138,17
32,r_18_0_116,r_22_135_187,r_55_3_192,r_18_0_116,1.0,0,116,116,17
81,seq139,seq115,r_1_70_85,r_1_70_85,1.0,2,87,85,17
17,r_77_83_77,seq95,seq39,r_77_83_77,0.99,-1,76,77,17
9,r_84_92_143,r_68_66_118,r_94_85_104,r_84_92_143,0.78,-26,117,143,17
22,r_68_66_118,r_84_92_143,seq60,r_68_66_118,1.0,0,118,118,17
18,r_113_51_25,seq132,seq87,r_113_51_25,1.0,0,25,25,17
14,r_106_26_14,seq58,seq31,r_106_26_14,1.0,-1,13,14,17
34,r_54_5_45,r_82_69_123,r_55_3_192,r_54_5_45,0.97,1,46,45,17
0,r_104_99_173,r_108_136_136,seq58,r_104_99_173,0.9,1,174,173,17
49,seq10,r_75_117_153,r_101_107_44,r_101_107_44,1.0,81,125,44,17
56,seq29,r_65_125_95,seq72,r_65_125_95,0.87,11,106,95,17
44,seq4,r_37_102_130,seq78,r_37_102_130,1.0,0,130,130,17
23,r_33_53_147,r_55_3_192,seq4,r_33_53_147,0.77,0,147,147,17
41,seq129,r_54_5_45,r_63_28_167,r_63_28_167,0.76,0,167,167,17
35,r_63_28_167,seq49,seq129,r_63_28_167,0.92,0,167,167,17
23,r_47_54_51,seq75,seq6,r_47_54_51,1.0,1,52,51,18
37,r_52_72_53,r_66_109_154,r_4_131_55,r_4_131_55,0.8,1,56,55,18
30,r_2_67_130,seq100,r_69_11_33,r_69_11_33,1.0,121,154,33,18
3,r_83_77_177,r_58_24_26,seq138,r_58_24_26,0.55,151,177,26,18
21,r_30_9_133,r_76_81_136,seq45,r_30_9_133,0.99,0,133,133,18
1,r_27_117_75,r_20_32_80,r_13_43_17,r_13_43_17,0.64,58,75,17,18
5,r_111_37_164,r_83_77_177,r_53_35_31,r_111_37_164,0.97,0,164,164,18
80,seq92,seq28,r_63_7_128,r_63_7_128,1.0,8,136,128,18
22,r_102_23_103,r_46_120_58,r_13_43_17,r_46_120_58,0.99,0,58,58,18
32,r_68_71_61,r_30_9_133,r_38_91_191,r_30_9_133,1.0,0,133,133,18
69,seq60,r_110_103_98,seq98,r_110_103_98,0.93,0,98,98,18
36,r_106_74_44,r_82_19_109,seq1,r_106_74_44,1.0,0,44,44,18
18,r_69_11_33,seq48,r_10_3_168,r_69_11_33,1.0,0,33,33,18
10,r_86_116_110,seq122,r_47_54_51,r_47_54_51,1.0,59,110,51,18
0,r_33_108_86,r_113_39_24,r_125_22_72,r_113_39_24,0.73,105,129,24,18
24,r_62_12_21,seq17,seq137,r_62_12_21,0.98,0,21,21,18
26,r_82_19_109,seq65,seq137,r_82_19_109,0.82,0,109,109,18
8,r_58_24_26,r_83_77_177,r_121_73_49,r_121_73_49,0.93,128,177,49,18
0,r_33_108_86,seq59,r_113_39_24,r_33_108_86,0.59,-1,85,86,18
11,r_125_22_72,seq40,seq95,r_125_22_72,1.0,0,72,72,18
22,r_102_23_103,r_13_43_17,r_128_84_76,r_102_23_103,0.99,7,110,103,18
13,r_13_43_17,seq85,r_27_117_75,r_27_117_75,1.0,5,80,75,18
7,r_128_84_76,seq90,r_102_23_103,r_102_23_103,0.73,23,126,103,18
62,seq45,r_113_39_24,seq79,r_113_39_24,0.93,-1,23,24,18
13,r_13_43_17,seq95,seq85,r_13_43_17,0.83,-3,14,17,18
41,seq1,seq17,r_106_74_44,r_106_74_44,1.0,2,46,44,18
4,r_4_131_55,r_93_133_56,r_52_72_53,r_4_131_55,1.0,0,55,55,18
12,r_101_134_43,r_10_3_168,seq48,r_101_134_43,1.0,0,43,43,18
35,r_10_3_168,r_101_134_43,r_69_11_33,r_10_3_168,1.0,-134,34,168,18
48,seq137,seq124,r_62_12_21,r_62_12_21,1.0,1,22,21,18
96,seq122,r_86_116_110,r_113_39_24,r_113_39_24,0.89,14,38,24,18
31,r_113_39_24,seq45,seq122,r_113_39_24,1.0,-1,23,24,18
38,r_129_34_193,r_102_23_103,r_13_43_17,r_102_23_103,0.95,-47,56,103,18
2,r_123_51_180,seq8,r_27_117_75,r_27_117_75,1.0,111,186,75,18
3,r_83_77_177,r_111_37_164,r_58_24_26,r_58_24_26,0.85,2,28,26,18
74,seq75,r_47_54_51,seq114,r_47_54_51,1.0,1,52,51,18
29,r_110_103_98,seq60,seq132,r_110_103_98,1.0,0,98,98,18
34,r_46_120_58,r_102_23_103,seq59,r_46_120_58,1.0,0,58,58,18
35,r_10_3_168,r_69_11_33,r_125_22_72,r_125_22_72,0.69,96,168,72,18
25,r_63_7_128,seq61,seq92,r_63_7_128,0.96,0,128,128,18
33,r_20_32_80,seq79,r_69_11_33,r_20_32_80,0.94,0,80,80,18
32,r_68_71_61,r_27_117_75,r_30_9_133,r_30_9_133,0.68,-72,61,133,18
8,r_58_24_26,r_38_91_191,r_83_77_177,r_38_91_191,0.55,-165,26,191,18
15,r_53_35_31,r_110_103_98,seq6,r_53_35_31,0.85,0,31,31,18
17,r_66_109_154,seq138,seq40,r_66_109_154,0.95,0,154,154,18
9,r_78_136_87,r_66_109_154,r_128_84_76,r_78_136_87,1.0,0,87,87,18
95,seq119,r_25_139_192,r_41_87_32,r_41_87_32,1.0,-1,31,32,18
62,seq45,seq79,r_30_9_133,r_30_9_133,1.0,1,134,133,18
28,r_76_81_136,seq100,r_63_7_128,r_76_81_136,0.76,0,136,136,18
7,r_128_84_76,r_33_108_86,seq90,r_128_84_76,0.68,0,76,76,18
18,r_69_11_33,r_10_3_168,r_2_67_130,r_10_3_168,0.81,2,170,168,18
19,r_41_87_32,r_83_77_177,seq119,r_41_87_32,1.0,-2,30,32,18
16,r_121_73_49,seq16,r_58_24_26,r_121_73_49,1.0,0,49,49,18
20,r_93_133_56,r_4_131_55,seq95,r_4_131_55,0.89,-1,54,55,18
30,r_89_87_91,r_8_118_129,seq134,r_89_87_91,0.99,0,91,91,19
8,r_88_81_155,seq20,r_19_45_46,r_19_45_46,1.0,2,48,46,19
36,r_96_95_175,seq29,r_11_78_106,r_11_78_106,1.0,69,175,106,19
41,seq2,seq105,r_18_93_156,r_18_93_156,0.99,6,162,156,19
39,r_100_9_75,seq105,r_63_56_125,r_100_9_75,0.57,3,78,75,19
14,r_82_21_196,r_48_109_44,r_104_32_8,r_82_21_196,0.56,-150,46,196,19
27,r_120_117_25,r_18_93_156,seq49,r_120_117_25,0.97,0,25,25,19
9,r_75_84_149,r_124_99_82,seq112,r_124_99_82,1.0,-42,40,82,19
66,seq49,r_101_22_172,r_5_68_97,r_5_68_97,0.97,75,172,97,19
16,r_122_0_17,r_19_45_46,r_75_84_149,r_122_0_17,1.0,1,18,17,19
10,r_138_115_177,seq42,r_11_78_106,r_11_78_106,1.0,35,141,106,19
10,r_138_115_177,r_11_78_106,seq6,r_138_115_177,0.79,2,179,177,19
26,r_65_127_189,seq128,r_124_99_82,r_124_99_82,0.93,107,189,82,19
8,r_88_81_155,r_19_45_46,r_1_80_43,r_88_81_155,0.86,0,155,155,19
16,r_122_0_17,r_75_84_149,r_54_133_66,r_122_0_17,0.65,132,149,17,19
14,r_82_21_196,r_104_32_8,r_48_109_44,r_48_109_44,0.51,113,157,44,19
4,r_15_135_168,r_77_114_36,r_139_73_88,r_15_135_168,0.77,0,168,168,19
11,r_11_78_106,seq94,r_63_56_125,r_11_78_106,0.99,0,106,106,19
20,r_63_56_125,seq42,r_104_32_8,r_104_32_8,0.77,120,128,8,19
13,r_139_73_88,seq43,seq134,r_139_73_88,0.78,0,88,88,19
6,r_33_57_188,seq3,r_136_53_151,r_136_53_151,0.73,37,188,151,19
41,seq2,r_19_45_46,seq126,r_19_45_46,0.99,0,46,46,19
40,seq128,r_65_127_189,seq36,r_65_127_189,0.9,0,189,189,19
18,r_124_99_82,r_75_84_149,seq52,r_124_99_82,1.0,1,83,82,19
29,r_110_12_72,seq40,seq103,r_110_12_72,0.86,-4,68,72,19
24,r_106_132_87,seq67,r_77_114_36,r_106_132_87,1.0,0,87,87,19
33,r_39_51_115,r_44_10_1,seq47,r_39_51_115,0.96,0,115,115,19
2,r_19_45_46,seq105,r_116_131_41,r_19_45_46,0.97,0,46,46,19
50,seq26,seq119,r_1_80_43,r_1_80_43,0.87,17,60,43,19
65,seq47,r_65_127_189,r_39_51_115,r_39_51_115,0.83,10,125,115,19
68,seq52,seq103,r_124_99_82,r_124_99_82,1.0,14,96,82,19
38,r_8_118_129,seq76,r_23_90_133,r_23_90_133,0.98,28,161,133,19
25,r_48_109_44,r_82_21_196,seq20,r_48_109_44,0.68,6,50,44,19
77,seq67,r_106_132_87,seq123,r_106_132_87,1.0,-27,60,87,19
34,r_27_79_173,seq103,seq7,r_27_79_173,0.9,0,173,173,19
1,r_116_131_41,r_44_10_1,seq111,r_116_131_41,1.0,0,41,41,19
22,r_23_90_133,r_113_91_166,seq38,r_23_90_133,0.71,0,133,133,19
0,r_1_80_43,seq6,seq26,r_1_80_43,0.92,3,46,43,19
7,r_136_53_151,r_96_95_175,r_100_9_75,r_100_9_75,0.59,76,151,75,19
23,r_77_114_36,r_15_135_168,r_106_132_87,r_106_132_87,0.97,36,123,87,19
12,r_5_68_97,r_14_55_120,r_120_117_25,r_5_68_97,0.94,1,98,97,19
3,r_24_98_38,r_19_45_46,r_74_125_4,r_24_98_38,1.0,0,38,38,19
30,r_75_30_86,seq22,seq101,r_75_30_86,1.0,0,86,86,20
18,r_77_20_58,r_60_70_145,seq110,r_77_20_58,1.0,1,59,58,20
31,r_130_8_39,seq19,seq63,r_130_8_39,1.0,0,39,39,20
36,r_32_72_157,r_24_46_164,r_90_21_116,r_32_72_157,0.69,0,157,157,20
17,r_106_131_45,r_66_29_19,seq48,r_106_131_45,0.97,-16,29,45,20
14,r_11_27_142,seq48,seq138,r_11_27_142,0.94,0,142,142,20
37,r_87_88_80,r_120_67_110,r_108_114_57,r_87_88_80,0.99,-1,79,80,20
16,r_80_43_123,r_9_0_140,seq58,r_80_43_123,0.98,2,125,123,20
1,r_82_86_184,seq57,r_18_7_181,r_18_7_181,0.61,4,185,181,20
38,r_115_78_48,seq111,seq13,r_115_78_48,0.96,0,48,48,20
5,r_41_96_88,seq123,seq113,r_41_96_88,0.95,0,88,88,20
29,r_42_50_33,seq94,seq79,r_42_50_33,0.94,0,33,33,20
21,r_85_112_18,seq5,seq3,r_85_112_18,1.0,1,19,18,20
3,r_51_127_75,seq93,seq79,r_51_127_75,0.97,0,75,75,20
26,r_59_44_139,seq138,seq26,r_59_44_139,1.0,0,139,139,20
4,r_122_97_178,seq136,r_51_127_75,r_51_127_75,1.0,103,178,75,20
11,r_45_99_102,seq26,seq92,r_45_99_102,0.89,0,102,102,20
23,r_108_114_57,r_2_133_159,seq22,r_108_114_57,0.98,0,57,57,20
33,r_90_21_116,r_120_67_110,seq33,r_90_21_116,0.71,-17,99,116,20
15,r_120_67_110,r_87_88_80,seq47,r_87_88_80,0.91,-1,79,80,20
48,seq13,r_18_7_181,r_115_78_48,r_115_78_48,0.82,49,97,48,20
34,r_137_16_54,r_75_30_86,seq58,r_137_16_54,1.0,1,55,54,20
6,r_9_0_140,seq69,r_106_131_45,r_9_0_140,0.68,0,140,140,20
85,seq101,seq33,r_75_30_86,r_75_30_86,0.99,13,99,86,20
41,seq3,r_61_52_151,r_85_112_18,r_85_112_18,0.75,8,26,18,20
27,r_18_7_181,seq36,r_82_86_184,r_18_7_181,0.75,0,181,181,20
7,r_116_37_41,seq121,seq36,r_116_37_41,1.0,0,41,41,20
2,r_61_52_151,seq138,r_4_17_89,r_61_52_151,0.94,0,151,151,20
81,seq94,r_42_50_33,seq33,r_42_50_33,0.84,-2,31,33,20
20,r_62_10_52,r_51_127_75,seq3,r_62_10_52,0.85,5,57,52,20
58,seq36,r_18_7_181,r_116_37_41,r_116_37_41,0.85,78,119,41,20
70,seq69,r_9_0_140,r_134_39_37,r_9_0_140,1.0,0,140,140,20
0,r_66_29_19,r_106_131_45,seq1,r_66_29_19,0.86,0,19,19,20
35,r_128_104_29,seq13,r_85_112_18,r_128_104_29,0.98,0,29,29,20
24,r_28_14_11,r_130_8_39,r_134_39_37,r_28_14_11,0.8,1,12,11,20
75,seq79,seq13,r_51_127_75,r_51_127_75,1.0,1,76,75,20
39,r_135_54_62,seq26,seq22,r_135_54_62,1.0,-7,55,62,20
94,seq119,r_4_17_89,r_108_114_57,r_108_114_57,0.95,30,87,57,20
9,r_91_34_66,r_82_86_184,r_130_8_39,r_91_34_66,1.0,-1,65,66,20
69,seq68,seq73,r_51_127_75,r_51_127_75,0.6,66,141,75,20
22,r_4_17_89,seq119,r_61_52_151,r_61_52_151,0.73,2,153,151,20
44,seq136,r_122_97_178,r_109_129_141,r_122_97_178,0.74,0,178,178,20
8,r_134_39_37,seq117,r_28_14_11,r_28_14_11,0.82,22,33,11,20
12,r_60_70_145,r_24_46_164,seq105,r_24_46_164,0.61,-19,145,164,20
9,r_89_45_12,r_47_107_84,seq32,r_89_45_12,0.76,0,12,12,21
36,r_105_13_108,seq23,seq19,r_105_13_108,0.99,0,108,108,21
53,seq18,seq109,r_25_122_72,r_25_122_72,1.0,59,131,72,21
37,r_85_33_128,r_88_82_70,r_57_62_193,r_88_82_70,0.71,-8,62,70,21
31,r_14_27_40,r_86_129_189,r_126_44_112,r_14_27_40,1.0,0,40,40,21
55,seq20,seq135,r_48_114_164,r_48_114_164,0.91,10,174,164,21
1,r_48_114_164,r_34_16_28,seq20,r_48_114_164,0.94,0,164,164,21
69,seq50,seq43,r_88_82_70,r_88_82_70,0.65,5,75,70,21
21,r_91_55_21,r_26_67_33,r_63_38_19,r_63_38_19,0.99,3,22,19,21
15,r_103_138_60,seq101,r_125_68_121,r_125_68_121,0.76,2,123,121,21
8,r_63_38_19,seq133,r_91_55_21,r_91_55_21,0.99,0,21,21,21
2,r_26_67_33,seq31,seq90,r_26_67_33,1.0,-1,32,33,21
10,r_78_71_13,r_6_132_56,seq124,r_78_71_13,0.84,0,13,13,21
3,r_6_132_56,r_99_93_16,seq135,r_6_132_56,1.0,4,60,56,21
26,r_121_118_150,seq46,seq115,r_121_118_150,0.98,1,151,150,21
4,r_65_21_62,r_100_5_190,seq24,r_65_21_62,1.0,0,62,62,21
29,r_126_44_112,r_103_138_60,r_14_27_40,r_126_44_112,0.92,-59,53,112,21
20,r_47_107_84,seq72,seq94,r_47_107_84,1.0,0,84,84,21
30,r_52_17_27,r_65_21_62,r_85_33_128,r_52_17_27,0.81,-1,26,27,21
13,r_10_98_166,seq69,r_99_93_16,r_10_98_166,0.53,0,166,166,21
15,r_103_138_60,r_126_44_112,seq101,r_103_138_60,0.98,1,61,60,21
27,r_60_123_140,r_77_59_142,seq31,r_60_123_140,0.85,0,140,140,21
30,r_52_17_27,r_85_33_128,seq117,r_85_33_128,1.0,-2,126,128,21
22,r_34_16_28,r_48_114_164,seq61,r_34_16_28,0.62,136,164,28,21
57,seq24,r_99_93_16,r_87_102_20,r_87_102_20,1.0,0,20,20,21
6,r_30_66_47,r_88_82_70,r_126_44_112,r_30_66_47,1.0,0,47,47,21
18,r_58_137_134,r_22_36_191,seq29,r_58_137_134,0.71,2,136,134,21
5,r_49_75_10,r_64_136_69,seq133,r_49_75_10,0.98,0,10,10,21
24,r_80_119_93,r_100_5_190,seq54,r_80_119_93,1.0,0,93,93,21
33,r_86_129_189,seq81,seq115,r_86_129_189,0.51,1,190,189,21
70,seq54,seq2,r_80_119_93,r_80_119_93,1.0,4,97,93,21
6,r_30_66_47,r_126_44_112,r_51_95_95,r_30_66_47,0.91,60,107,47,21
32,r_139_40_113,seq37,seq97,r_139_40_113,0.98,0,113,113,21
34,r_88_82_70,r_85_33_128,seq50,r_85_33_128,0.86,-58,70,128,21
1,r_48_114_164,seq18,r_34_16_28,r_34_16_28,0.99,0,28,28,21
23,r_87_102_20,r_26_67_33,seq24,r_87_102_20,1.0,0,20,20,21
75,seq72,r_47_107_84,seq135,r_47_107_84,1.0,-14,70,84,21
94,seq115,r_125_68_121,seq127,r_125_68_121,0.99,2,123,121,21
22,r_34_16_28,r_88_82_70,r_48_114_164,r_34_16_28,1.0,0,28,28,21
96,seq117,r_57_62_193,r_52_17_27,r_52_17_27,0.89,144,171,27,21
31,r_14_27_40,r_126_44_112,r_30_66_47,r_126_44_112,0.98,0,112,112,21
37,r_85_33_128,r_57_62_193,seq79,r_85_33_128,0.99,0,128,128,21
72,seq61,seq109,r_34_16_28,r_34_16_28,0.71,31,59,28,21
91,seq108,r_51_95_95,seq39,r_51_95_95,1.0,0,95,95,21
7,r_25_122_72,r_100_5_190,seq18,r_25_122_72,1.0,1,73,72,21
79,seq135,r_121_118_150,r_6_132_56,r_6_132_56,0.86,70,126,56,21
35,r_77_59_142,seq32,seq11,r_77_59_142,0.94,0,142,142,21
12,r_15_112_151,r_100_5_190,seq31,r_15_112_151,0.48,0,151,151,21
29,r_126_44_112,r_14_27_40,seq128,r_126_44_112,1.0,0,112,112,21
84,seq90,r_53_110_171,r_26_67_33,r_26_67_33,1.0,142,175,33,21
38,r_78_72_146,seq33,r_18_8_34,r_18_8_34,1.0,0,34,34,22
36,r_19_14_149,seq2,seq17,r_19_14_149,0.82,0,149,149,22
19,r_139_69_13,r_42_27_192,r_5_12_184,r_139_69_13,0.97,2,15,13,22
66,seq58,seq2,r_132_55_103,r_132_55_103,0.95,66,169,103,22
54,seq23,r_82_101_154,seq85,r_82_101_154,1.0,0,154,154,22
35,r_32_44_10,seq43,r_6_29_182,r_32_44_10,0.91,0,10,10,22
37,r_62_80_58,r_66_138_48,r_10_87_93,r_10_87_93,1.0,2,95,93,22
30,r_66_138_48,seq56,r_62_80_58,r_62_80_58,1.0,7,65,58,22
19,r_139_69_13,r_5_12_184,seq112,r_5_12_184,0.46,0,184,184,22
29,r_52_102_51,seq56,r_132_55_103,r_52_102_51,0.99,0,51,51,22
97,seq125,seq4,r_57_74_72,r_57_74_72,1.0,4,76,72,22
7,r_18_8_34,r_78_72_146,r_68_63_44,r_78_72_146,0.99,0,146,146,22
21,r_68_63_44,seq95,r_18_8_34,r_68_63_44,1.0,1,45,44,22
65,seq56,r_52_102_51,r_66_138_48,r_52_102_51,1.0,0,51,51,22
30,r_66_138_48,r_42_27_192,seq56,r_42_27_192,0.63,-142,50,192,22
27,r_5_12_184,r_139_69_13,seq95,r_5_12_184,0.83,0,184,184,22
20,r_31_136_43,seq22,seq128,r_31_136_43,1.0,0,43,43,22
66,seq58,r_36_15_63,seq2,r_36_15_63,0.64,2,65,63,22
38,r_78_72_146,r_18_8_34,r_66_138_48,r_78_72_146,1.0,0,146,146,22
41,seq1,r_42_27_192,r_36_15_63,r_36_15_63,1.0,97,160,63,22
89,seq110,r_9_20_65,r_37_49_115,r_9_20_65,1.0,0,65,65,22
3,r_38_115_66,seq4,r_52_102_51,r_38_115_66,1.0,0,66,66,22
10,r_36_15_63,seq58,r_54_123_132,r_36_15_63,1.0,1,64,63,22
18,r_54_123_132,r_36_15_63,seq21,r_54_123_132,0.99,0,132,132,22
90,seq112,r_5_12_184,seq17,r_5_12_184,0.55,-51,133,184,22
37,r_62_80_58,r_38_115_66,r_66_138_48,r_62_80_58,0.99,1,59,58,22
4,r_37_49_115,seq110,seq2,r_37_49_115,0.95,0,115,115,22
78,seq92,seq59,r_132_55_103,r_132_55_103,1.0,0,103,103,22
11,r_132_55_103,seq11,seq92,r_132_55_103,1.0,0,103,103,22
13,r_97_130_135,seq60,seq11,r_97_130_135,0.86,1,136,135,22
15,r_89_40_148,seq137,seq128,r_89_40_148,0.96,2,150,148,22
48,seq128,seq0,r_31_136_43,r_31_136_43,1.0,38,81,43,22
62,seq45,r_124_133_164,seq113,r_124_133_164,0.73,0,164,164,22
10,r_36_15_63,r_54_123_132,r_16_28_123,r_54_123_132,0.8,0,132,132,22
27,r_5_12_184,r_94_90_97,r_139_69_13,r_94_90_97,0.98,0,97,97,22
2,r_111_120_191,seq4,r_57_74_72,r_57_74_72,1.0,41,113,72,22
47,seq137,r_89_40_148,seq85,r_89_40_148,1.0,2,150,148,22
74,seq76,r_126_119_152,seq11,r_126_119_152,0.85,-34,118,152,22
18,r_54_123_132,r_42_27_192,r_36_15_63,r_36_15_63,1.0,32,95,63,22
24,r_16_28_123,seq7,r_36_15_63,r_36_15_63,1.0,63,126,63,22
35,r_32_44_10,r_6_29_182,r_91_79_36,r_32_44_10,0.58,121,131,10,22
25,r_122_48_76,r_124_133_164,seq129,r_122_48_76,1.0,0,76,76,22
33,r_96_26_110,seq129,seq30,r_96_26_110,1.0,0,110,110,22
70,seq64,r_42_27_192,r_53_47_18,r_53_47_18,0.94,122,140,18,22
6,r_6_29_182,r_32_44_10,seq71,r_6_29_182,0.49,0,182,182,22
32,r_9_20_65,seq110,seq70,r_9_20_65,1.0,0,65,65,22
16,r_131_83_54,r_89_40_148,seq113,r_131_83_54,0.99,0,54,54,22
34,r_126_119_152,seq76,seq71,r_126_119_152,0.9,0,152,152,22
6,r_6_29_182,seq33,r_32_44_10,r_32_44_10,0.64,5,15,10,22
1,r_50_86_15,r_89_40_148,seq60,r_50_86_15,0.88,-1,14,15,22
17,r_94_90_97,r_5_12_184,r_66_138_48,r_94_90_97,0.9,0,97,97,22
71,seq65,r_6_29_182,r_91_79_36,r_91_79_36,0.94,0,36,36,22
9,r_41_39_155,seq7,r_132_55_103,r_41_39_155,0.71,0,155,155,22
26,r_53_47_18,seq65,seq64,r_53_47_18,1.0,0,18,18,22
7,r_18_8_34,seq1,r_78_72_146,r_18_8_34,1.0,1,35,34,22
29,r_52_102_51,r_132_55_103,r_38_115_66,r_52_102_51,0.98,21,72,51,22
22,r_57_74_72,r_97_130_135,seq125,r_57_74_72,1.0,0,72,72,22
28,r_88_109_114,seq129,r_50_86_15,r_88_109_114,1.0,0,114,114,22
49,seq11,r_132_55_103,seq25,r_132_55_103,1.0,0,103,103,22
89,seq110,r_37_49_115,seq93,r_37_49_115,1.0,0,115,115,22
23,r_82_101_154,seq23,r_9_20_65,r_9_20_65,0.81,89,154,65,22
12,r_34_105_130,seq98,r_50_86_15,r_34_105_130,0.8,0,130,130,22
39,r_91_79_36,r_34_105_130,seq65,r_91_79_36,1.0,0,36,36,22
36,r_110_42_78,r_98_51_86,r_106_65_47,r_110_42_78,1.0,0,78,78,23
37,r_68_2_55,r_92_93_165,r_139_77_58,r_68_2_55,1.0,0,55,55,23
14,r_76_0_109,seq31,seq66,r_76_0_109,0.8,2,111,109,23
8,r_114_132_88,seq120,r_46_35_28,r_114_132_88,1.0,1,89,88,23
16,r_21_19_116,r_14_136_145,r_139_77_58,r_139_77_58,0.52,58,116,58,23
21,r_62_81_143,seq29,r_75_124_20,r_75_124_20,0.68,124,144,20,23
30,r_85_95_23,r_11_12_59,seq72,r_85_95_23,0.98,0,23,23,23
1,r_28_50_113,seq30,r_46_35_28,r_46_35_28,0.8,76,104,28,23
5,r_48_49_141,seq104,seq20,r_48_49_141,0.94,0,141,141,23
32,r_106_65_47,r_92_93_165,r_125_33_89,r_125_33_89,0.74,76,165,89,23
69,seq57,r_14_136_145,r_36_86_93,r_14_136_145,1.0,0,145,145,23
19,r_122_117_175,seq94,r_106_65_47,r_106_65_47,0.99,130,177,47,23
32,r_106_65_47,seq4,r_92_93_165,r_106_65_47,1.0,0,47,47,23
11,r_46_35_28,r_1_70_97,r_135_133_91,r_46_35_28,1.0,69,97,28,23
6,r_88_101_34,r_130_90_151,seq67,r_88_101_34,1.0,0,34,34,23
39,r_123_5_63,seq25,seq22,r_123_5_63,0.97,-38,25,63,23
17,r_60_7_18,seq54,seq115,r_60_7_18,0.95,2,20,18,23
89,seq102,r_92_93_165,r_125_33_89,r_125_33_89,0.97,2,91,89,23
10,r_1_70_97,r_84_103_71,r_46_35_28,r_46_35_28,0.89,43,71,28,23
13,r_10_59_171,r_71_24_72,seq6,r_71_24_72,0.99,1,73,72,23
15,r_98_51_86,r_110_42_78,r_60_7_18,r_110_42_78,0.55,0,78,78,23
10,r_1_70_97,r_46_35_28,r_123_5_63,r_1_70_97,0.96,0,97,97,23
57,seq29,r_62_81_143,seq100,r_62_81_143,0.97,1,144,143,23
74,seq67,seq105,r_88_101_34,r_88_101_34,1.0,4,38,34,23
13,r_10_59_171,seq6,r_123_5_63,r_10_59_171,0.43,0,171,171,23
0,r_92_93_165,r_106_65_47,r_75_124_20,r_92_93_165,0.79,0,165,165,23
27,r_14_136_145,seq57,r_131_118_66,r_14_136_145,0.84,0,145,145,23
9,r_75_124_20,r_1_70_97,seq128,r_75_124_20,0.91,0,20,20,23
51,seq18,r_139_77_58,r_75_124_20,r_139_77_58,1.0,115,173,58,23
24,r_53_63_24,r_92_93_165,seq23,r_53_63_24,1.0,0,24,24,23
2,r_116_45_73,seq100,seq138,r_116_45_73,1.0,1,74,73,23
18,r_127_52_172,seq104,r_46_35_28,r_46_35_28,0.99,147,175,28,23
29,r_131_118_66,seq119,seq43,r_131_118_66,0.44,5,71,66,23
25,r_58_109_110,seq8,seq107,r_58_109_110,0.81,3,113,110,23
7,r_121_113_19,r_62_81_143,seq69,r_121_113_19,1.0,1,20,19,23
33,r_130_90_151,seq20,r_11_12_59,r_130_90_151,0.62,2,153,151,23
54,seq23,r_131_118_66,r_53_63_24,r_53_63_24,1.0,0,24,24,23
0,r_92_93_165,r_68_2_55,r_106_65_47,r_92_93_165,0.99,-111,54,165,23
58,seq30,r_28_50_113,seq4,r_28_50_113,0.55,8,121,113,23
65,seq43,seq6,r_131_118_66,r_131_118_66,0.69,-2,64,66,23
11,r_46_35_28,r_88_101_34,r_1_70_97,r_1_70_97,0.77,-69,28,97,23
38,r_44_56_106,seq66,seq47,r_44_56_106,0.75,2,108,106,23
20,r_89_91_27,r_11_12_59,seq78,r_89_91_27,0.92,0,27,27,23
34,r_125_33_89,seq31,r_106_65_47,r_125_33_89,1.0,0,89,89,23
22,r_73_27_124,r_11_12_59,r_44_56_106,r_11_12_59,0.96,66,125,59,23
28,r_71_24_72,r_10_59_171,seq126,r_71_24_72,0.95,1,73,72,23
23,r_13_34_43,seq100,seq97,r_13_34_43,0.99,5,48,43,23
35,r_84_103_71,r_1_70_97,seq67,r_1_70_97,1.0,-26,71,97,23
26,r_139_77_58,seq22,r_68_2_55,r_68_2_55,0.7,3,58,55,23
30,r_10_96_76,r_71_69_93,seq66,r_10_96_76,1.0,0,76,76,24
36,r_134_59_195,seq26,r_127_76_70,r_127_76_70,1.0,16,86,70,24
37,r_92_11_91,seq86,r_127_76_70,r_92_11_91,0.99,0,91,91,24
24,r_27_47_57,r_21_91_71,seq32,r_27_47_57,1.0,0,57,57,24
5,r_9_30_140,seq104,seq14,r_9_30_140,0.88,0,140,140,24
31,r_19_28_38,seq87,seq66,r_19_28_38,1.0,0,38,38,24
8,r_49_124_44,seq66,seq60,r_49_124_44,1.0,-1,43,44,24
67,seq58,r_94_70_177,r_127_76_70,r_127_76_70,0.6,27,97,70,24
1,r_85_63_51,r_29_56_97,r_129_121_80,r_85_63_51,1.0,29,80,51,24
3,r_93_123_96,seq23,seq78,r_93_123_96,0.94,0,96,96,24
10,r_31_18_186,seq4,r_29_56_97,r_31_18_186,0.33,0,186,186,24
26,r_29_56_97,seq73,seq20,r_29_56_97,1.0,2,99,97,24
12,r_6_22_50,r_34_136_74,r_126_119_40,r_6_22_50,0.69,1,51,50,24
0,r_62_51_131,seq88,r_85_63_51,r_85_63_51,0.92,80,131,51,24
63,seq46,r_42_90_158,r_93_123_96,r_93_123_96,0.98,61,157,96,24
82,seq88,r_134_59_195,seq14,r_134_59_195,0.68,-18,177,195,24
11,r_129_121_80,seq137,r_85_63_51,r_129_121_80,1.0,-1,79,80,24
15,r_80_40_157,seq83,seq104,r_80_40_157,0.62,0,157,157,24
35,r_115_139_25,seq95,r_29_56_97,r_115_139_25,0.98,0,25,25,24
1,r_85_63_51,r_101_74_191,r_29_56_97,r_85_63_51,0.81,3,54,51,24
6,r_111_48_108,seq67,seq45,r_111_48_108,0.5,0,108,108,24
88,seq106,r_80_40_157,r_126_119_40,r_126_119_40,1.0,-1,39,40,24
79,seq83,r_80_40_157,r_98_131_49,r_98_131_49,0.82,-8,41,49,24
47,seq14,r_1_61_171,r_9_30_140,r_9_30_140,0.55,2,142,140,24
18,r_103_89_121,seq2,seq68,r_103_89_121,0.9,0,121,121,24
29,r_13_130_172,seq138,r_84_64_31,r_13_130_172,0.66,0,172,172,24
35,r_115_139_25,r_29_56_97,r_6_22_50,r_29_56_97,1.0,3,100,97,24
33,r_50_77_166,seq20,r_24_65_143,r_24_65_143,1.0,2,145,143,24
39,r_84_64_31,r_94_70_177,seq67,r_84_64_31,1.0,-1,30,31,24
14,r_37_105_10,r_41_114_135,seq107,r_37_105_10,0.98,0,10,10,24
32,r_135_53_103,seq67,seq23,r_135_53_103,1.0,0,103,103,24
38,r_16_38_150,seq99,seq87,r_16_38_150,0.82,0,150,150,24
52,seq132,seq20,r_24_65_143,r_24_65_143,0.99,14,157,143,24
34,r_127_76_70,seq52,r_49_124_44,r_49_124_44,0.74,25,69,44,24
89,seq107,r_9_30_140,r_37_105_10,r_37_105_10,1.0,1,11,10,24
9,r_41_114_135,seq5,r_21_91_71,r_21_91_71,1.0,80,151,71,24
42,seq3,r_126_119_40,seq87,r_126_119_40,1.0,-1,39,40,24
19,r_126_119_40,seq3,seq106,r_126_119_40,0.99,-1,39,40,24
22,r_24_65_143,seq35,r_50_77_166,r_24_65_143,0.72,0,143,143,24
7,r_34_136_74,seq99,seq52,r_34_136_74,0.96,-5,69,74,24
23,r_21_91_71,seq68,r_41_114_135,r_21_91_71,1.0,0,71,71,24
82,seq88,r_62_51_131,r_134_59_195,r_134_59_195,0.66,-56,139,195,24
30,r_13_125_145,seq31,seq30,r_13_125_145,0.39,12,157,145,25
36,r_99_67_193,seq28,r_78_72_20,r_78_72_20,1.0,112,132,20,25
83,seq81,seq75,r_139_68_120,r_139_68_120,1.0,11,131,120,25
37,r_37_111_161,seq136,seq31,r_37_111_161,0.97,0,161,161,25
14,r_57_105_34,seq18,seq134,r_57_105_34,1.0,0,34,34,25
13,r_58_63_150,r_110_121_115,seq12,r_58_63_150,0.99,2,152,150,25
16,r_54_4_71,seq24,r_78_72_20,r_54_4_71,1.0,0,71,71,25
21,r_119_103_168,seq48,r_13_125_145,r_119_103_168,0.86,0,168,168,25
39,r_66_11_97,seq32,seq1,r_66_11_97,1.0,0,97,97,25
97,seq114,r_27_64_146,seq3,r_27_64_146,0.65,3,149,146,25
5,r_0_88_73,r_20_137_110,seq41,r_0_88_73,1.0,1,74,73,25
46,seq136,r_37_111_161,seq86,r_37_111_161,0.99,-1,160,161,25
42,seq3,r_122_82_136,seq114,r_122_82_136,1.0,-28,108,136,25
69,seq47,seq18,r_89_22_83,r_89_22_83,1.0,16,99,83,25
24,r_92_95_129,r_44_8_12,r_93_98_65,r_44_8_12,0.3,127,139,12,25
25,r_89_22_83,r_120_132_58,seq47,r_89_22_83,0.7,0,83,83,25
38,r_36_116_17,seq131,seq61,r_36_116_17,0.96,0,17,17,25
2,r_78_72_20,r_58_63_150,r_99_67_193,r_78_72_20,1.0,1,21,20,25
11,r_15_70_182,seq129,seq35,r_15_70_182,0.45,-1,181,182,25
28,r_44_8_12,seq134,r_92_95_129,r_44_8_12,0.68,6,18,12,25
66,seq42,r_115_7_144,r_73_50_72,r_73_50_72,0.91,72,144,72,25
3,r_130_76_101,r_139_68_120,r_89_22_83,r_130_76_101,1.0,0,101,101,25
10,r_9_94_178,seq129,r_53_17_19,r_9_94_178,0.62,0,178,178,25
78,seq69,r_51_49_109,seq80,r_51_49_109,1.0,0,109,109,25
0,r_115_7_144,seq42,seq24,r_115_7_144,0.97,0,144,144,25
13,r_58_63_150,seq112,r_110_121_115,r_110_121_115,1.0,0,115,115,25
8,r_45_109_51,r_74_127_159,r_19_128_75,r_45_109_51,0.96,0,51,51,25
6,r_73_50_72,r_119_103_168,seq42,r_73_50_72,1.0,0,72,72,25
33,r_43_6_54,r_15_70_182,seq18,r_43_6_54,1.0,0,54,54,25
23,r_139_68_120,r_9_94_178,seq81,r_139_68_120,0.97,0,120,120,25
2,r_78_72_20,r_99_67_193,r_54_4_71,r_54_4_71,1.0,43,114,71,25
4,r_53_17_19,seq97,seq2,r_53_17_19,0.95,0,19,19,25
18,r_51_49_109,seq69,seq24,r_51_49_109,0.99,0,109,109,25
29,r_110_121_115,r_37_111_161,r_58_63_150,r_110_121_115,0.96,0,115,115,25
8,r_45_109_51,r_19_128_75,seq42,r_19_128_75,0.96,0,75,75,25
25,r_89_22_83,seq131,r_120_132_58,r_120_132_58,0.99,8,66,58,25
58,seq31,r_13_125_145,seq26,r_13_125_145,0.56,12,157,145,25
65,seq41,seq65,r_0_88_73,r_0_88_73,1.0,71,144,73,25
32,r_27_64_146,seq114,r_84_10_1,r_27_64_146,0.65,3,149,146,25
44,seq134,seq104,r_57_105_34,r_57_105_34,1.0,3,37,34,25
27,r_120_132_58,r_83_60_175,seq114,r_120_132_58,1.0,0,58,58,25
29,r_110_121_115,r_58_63_150,r_36_116_17,r_58_63_150,1.0,-2,148,150,25
81,seq79,seq5,r_102_107_38,r_102_107_38,0.96,-18,20,38,25
24,r_92_95_129,seq33,r_44_8_12,r_92_95_129,0.58,-96,33,129,25
9,r_74_127_159,r_119_103_168,r_27_64_146,r_74_127_159,0.94,1,160,159,25
1,r_19_128_75,r_45_109_51,seq79,r_19_128_75,1.0,0,75,75,25
19,r_102_107_38,r_0_88_73,seq79,r_0_88_73,1.0,-34,39,73,25
22,r_138_117_133,seq129,seq131,r_138_117_133,1.0,0,133,133,25
11,r_15_70_182,r_43_6_54,seq129,r_43_6_54,0.67,2,56,54,25
1,r_19_128_75,r_115_7_144,r_45_109_51,r_45_109_51,0.67,6,57,51,25
7,r_123_124_164,seq2,r_93_98_65,r_123_124_164,0.87,1,165,164,25
23,r_139_68_120,r_130_76_101,r_9_94_178,r_130_76_101,0.97,0,101,101,25
35,r_38_71_122,seq87,seq26,r_38_71_122,0.61,2,124,122,25
12,r_122_82_136,seq16,seq81,r_122_82_136,0.96,2,138,136,25
93,seq105,r_56_14_174,r_22_59_128,r_22_59_128,1.0,48,176,128,26
30,r_127_51_139,seq58,seq30,r_127_51_139,0.64,1,140,139,26
25,r_5_113_97,r_53_70_148,r_35_2_49,r_35_2_49,1.0,-1,48,49,26
8,r_139_27_166,r_79_88_194,seq45,r_139_27_166,0.84,1,167,166,26
42,seq4,seq45,r_34_48_38,r_34_48_38,1.0,19,57,38,26
55,seq25,r_74_100_162,seq135,r_74_100_162,0.82,0,162,162,26
37,r_62_134_51,seq94,seq42,r_62_134_51,0.96,0,51,51,26
21,r_22_59_128,seq72,seq105,r_22_59_128,0.99,2,130,128,26
39,r_68_80_62,r_131_111_96,seq10,r_68_80_62,1.0,1,63,62,26
5,r_129_136_89,seq58,r_68_80_62,r_68_80_62,1.0,32,94,62,26
25,r_5_113_97,r_35_2_49,seq30,r_5_113_97,1.0,0,97,97,26
69,seq50,seq133,r_64_76_53,r_64_76_53,0.76,30,83,53,26
22,r_86_107_110,seq9,r_63_52_147,r_86_107_110,0.64,25,135,110,26
19,r_121_24_145,seq58,r_65_23_48,r_121_24_145,0.64,0,145,145,26
31,r_90_132_164,seq72,r_86_107_110,r_86_107_110,0.91,62,172,110,26
3,r_74_100_162,seq25,seq137,r_74_100_162,0.87,0,162,162,26
10,r_131_111_96,r_68_80_62,seq9,r_131_111_96,0.99,1,97,96,26
26,r_125_130_67,r_115_29_85,seq49,r_125_130_67,1.0,0,67,67,26
72,seq57,r_120_102_181,r_118_12_146,r_118_12_146,0.66,35,181,146,26
36,r_35_2_49,seq92,r_5_113_97,r_35_2_49,1.0,0,49,49,26
4,r_79_88_194,r_139_27_166,seq16,r_139_27_166,0.95,1,167,166,26
0,r_56_14_174,seq105,seq8,r_56_14_174,0.7,2,176,174,26
11,r_7_18_111,r_118_12_146,r_5_113_97,r_7_18_111,0.98,2,113,111,26
20,r_120_102_181,seq57,r_19_84_5,r_19_84_5,0.66,176,181,5,26
13,r_1_101_183,seq87,r_124_110_45,r_124_110_45,0.57,138,183,45,26
15,r_64_76_53,seq133,seq50,r_64_76_53,0.78,30,83,53,26
14,r_65_23_48,seq106,seq26,r_65_23_48,1.0,0,48,48,26
6,r_77_109_74,seq78,r_64_76_53,r_77_109_74,0.76,1,75,74,26
62,seq40,r_89_36_69,seq137,r_89_36_69,0.75,7,76,69,26
28,r_34_48_38,seq73,seq4,r_34_48_38,1.0,0,38,38,26
27,r_118_12_146,seq32,seq57,r_118_12_146,0.79,0,146,146,26
2,r_0_103_163,seq42,r_19_84_5,r_19_84_5,0.82,162,167,5,26
24,r_20_104_137,seq75,seq50,r_20_104_137,0.45,4,141,137,26
33,r_61_71_81,r_53_70_148,seq42,r_61_71_81,0.99,0,81,81,26
64,seq42,r_0_103_163,seq137,r_0_103_163,0.53,4,167,163,26
68,seq49,seq128,r_125_130_67,r_125_130_67,1.0,2,69,67,26
38,r_115_29_85,seq30,r_126_33_27,r_115_29_85,0.89,3,88,85,26
77,seq72,seq44,r_81_37_83,r_81_37_83,1.0,37,120,83,26
34,r_63_52_147,seq41,r_86_107_110,r_86_107_110,0.82,39,149,110,26
9,r_81_37_83,r_69_85_115,seq72,r_81_37_83,0.99,1,84,83,26
36,r_35_2_49,r_5_113_97,seq91,r_5_113_97,0.99,0,97,97,26
22,r_86_107_110,r_69_85_115,seq9,r_86_107_110,0.37,0,110,110,26
23,r_39_13_106,r_74_100_162,r_125_130_67,r_39_13_106,0.96,0,106,106,26
35,r_43_112_169,seq72,r_126_33_27,r_126_33_27,0.41,145,172,27,26
12,r_69_85_115,r_86_107_110,r_131_111_96,r_69_85_115,0.83,13,128,115,26
7,r_124_110_45,seq75,seq49,r_124_110_45,1.0,0,45,45,26
29,r_123_114_11,r_46_67_182,seq58,r_123_114_11,1.0,4,15,11,26
84,seq91,r_53_70_148,r_121_24_145,r_121_24_145,0.61,3,148,145,26
30,r_60_4_150,r_68_108_190,r_58_136_81,r_60_4_150,0.91,1,151,150,27
36,r_61_63_90,r_60_4_150,seq127,r_61_63_90,0.99,0,90,90,27
14,r_121_122_103,seq57,seq50,r_121_122_103,0.97,0,103,103,27
8,r_56_120_106,seq132,r_64_82_68,r_64_82_68,0.47,38,106,68,27
70,seq57,r_79_116_79,r_43_112_25,r_43_112_25,0.99,-13,12,25,27
37,r_44_15_80,seq29,r_26_95_8,r_44_15_80,0.9,0,80,80,27
59,seq38,r_84_114_129,seq90,r_84_114_129,1.0,0,129,129,27
16,r_66_110_164,seq124,r_79_116_79,r_66_110_164,0.83,0,164,164,27
21,r_40_113_82,seq96,seq87,r_40_113_82,1.0,0,82,82,27
2,r_36_129_134,r_80_133_39,seq101,r_36_129_134,0.85,0,134,134,27
29,r_59_135_36,r_64_82_68,seq50,r_59_135_36,0.85,2,38,36,27
66,seq50,r_19_46_161,r_121_122_103,r_121_122_103,0.82,29,132,103,27
39,r_80_133_39,r_36_129_134,r_138_99_96,r_80_133_39,1.0,96,135,39,27
28,r_97_37_158,r_69_70_54,seq17,r_97_37_158,0.57,-37,121,158,27
3,r_125_128_132,r_16_92_152,r_56_120_106,r_125_128_132,0.7,0,132,132,27
17,r_86_104_33,r_36_129_134,seq107,r_86_104_33,1.0,-1,32,33,27
10,r_64_82_68,seq124,seq65,r_64_82_68,1.0,0,68,68,27
19,r_2_94_24,seq91,seq89,r_2_94_24,1.0,0,24,24,27
2,r_36_129_134,r_86_104_33,seq103,r_86_104_33,0.76,-4,29,33,27
1,r_73_23_16,r_137_126_109,seq31,r_73_23_16,1.0,0,16,16,27
20,r_5_130_88,seq27,seq132,r_5_130_88,1.0,1,89,88,27
13,r_32_41_66,r_28_74_20,r_18_93_63,r_28_74_20,1.0,48,68,20,27
22,r_98_6_31,seq3,r_20_100_3,r_98_6_31,1.0,1,32,31,27
15,r_138_99_96,seq76,seq103,r_138_99_96,1.0,0,96,96,27
25,r_69_70_54,seq13,seq85,r_69_70_54,0.98,2,56,54,27
27,r_19_46_161,seq50,seq10,r_19_46_161,0.79,0,161,161,27
82,seq89,r_125_128_132,r_2_94_24,r_2_94_24,1.0,0,24,24,27
87,seq102,r_28_74_20,r_25_105_35,r_25_105_35,1.0,29,64,35,27
39,r_80_133_39,seq35,r_36_129_134,r_80_133_39,1.0,2,41,39,27
18,r_16_92_152,seq0,seq124,r_16_92_152,0.6,0,152,152,27
24,r_58_136_81,r_125_128_132,seq21,r_58_136_81,0.97,0,81,81,27
32,r_18_93_63,seq75,seq124,r_18_93_63,1.0,1,64,63,27
38,r_28_74_20,r_32_41_66,seq31,r_32_41_66,1.0,2,68,66,27
52,seq27,r_5_130_88,seq119,r_5_130_88,1.0,1,89,88,27
34,r_134_1_71,r_5_130_88,seq31,r_134_1_71,1.0,1,72,71,27
9,r_78_83_99,seq119,seq31,r_78_83_99,1.0,0,99,99,27
35,r_25_105_35,r_68_108_190,seq102,r_25_105_35,1.0,0,35,35,27
23,r_54_67_59,seq33,seq109,r_54_67_59,1.0,0,59,59,27
96,seq119,r_78_83_99,r_20_100_3,r_78_83_99,1.0,1,100,99,27
91,seq109,r_79_116_79,r_54_67_59,r_54_67_59,1.0,44,103,59,27
2,r_36_129_134,seq103,r_80_133_39,r_80_133_39,0.7,10,49,39,27
0,r_24_9_48,r_54_67_59,r_43_112_25,r_43_112_25,1.0,23,48,25,27
8,r_56_120_106,r_64_82_68,r_125_128_132,r_125_128_132,0.96,17,149,132,27
28,r_97_37_158,seq17,r_69_70_54,r_69_70_54,0.91,10,64,54,27
55,seq31,r_125_128_132,r_73_23_16,r_73_23_16,1.0,5,21,16,27
55,seq31,r_73_23_16,r_78_83_99,r_78_83_99,1.0,29,128,99,27
30,r_53_73_151,seq12,seq7,r_53_73_151,0.93,0,151,151,28
36,r_54_39_132,seq32,seq136,r_54_39_132,0.98,0,132,132,28
14,r_130_59_113,seq43,seq26,r_130_59_113,0.59,0,113,113,28
8,r_100_85_118,seq41,seq7,r_100_85_118,1.0,0,118,118,28
27,r_132_51_12,r_106_97_56,seq76,r_132_51_12,0.81,0,12,12,28
83,seq87,seq40,r_106_97_56,r_106_97_56,1.0,14,70,56,28
71,seq138,r_70_45_168,r_19_111_45,r_19_111_45,0.98,123,168,45,28
16,r_71_29_123,seq117,seq27,r_71_29_123,1.0,0,123,123,28
39,r_102_103_124,r_54_39_132,seq80,r_102_103_124,0.98,3,127,124,28
5,r_2_119_107,seq82,seq69,r_2_119_107,1.0,0,107,107,28
31,r_9_24_26,seq84,seq110,r_9_24_26,1.0,0,26,26,28
41,seq1,r_42_118_98,r_49_125_97,r_49_125_97,0.96,10,107,97,28
3,r_52_133_61,r_83_64_176,seq20,r_52_133_61,1.0,1,62,61,28
10,r_68_96_81,seq34,r_109_126_182,r_68_96_81,1.0,1,82,81,28
35,r_49_125_97,r_93_63_41,seq1,r_49_125_97,0.71,-12,85,97,28
4,r_115_104_174,seq80,r_52_133_61,r_52_133_61,0.63,113,174,61,28
78,seq78,r_86_131_190,r_47_62_94,r_47_62_94,1.0,96,190,94,28
11,r_44_67_121,r_70_45_168,seq32,r_44_67_121,0.64,1,122,121,28
20,r_30_50_122,r_115_104_174,r_106_97_56,r_30_50_122,0.55,0,122,122,28
13,r_14_134_159,seq92,seq32,r_14_134_159,0.73,0,159,159,28
32,r_79_66_18,r_106_97_56,seq57,r_79_66_18,1.0,0,18,18,28
15,r_123_60_116,seq69,r_93_63_41,r_123_60_116,0.98,0,116,116,28
48,seq139,seq78,r_47_62_94,r_47_62_94,1.0,37,131,94,28
57,seq27,seq32,r_71_29_123,r_71_29_123,1.0,14,137,123,28
23,r_48_114_13,seq20,seq99,r_48_114_13,0.74,0,13,13,28
6,r_65_107_117,r_16_4_127,seq76,r_65_107_117,0.71,3,120,117,28
0,r_106_97_56,r_47_62_94,seq91,r_106_97_56,1.0,0,56,56,28
19,r_112_6_20,seq76,seq56,r_112_6_20,0.97,2,22,20,28
10,r_68_96_81,r_109_126_182,seq46,r_109_126_182,0.98,0,182,182,28
35,r_49_125_97,r_108_127_34,r_93_63_41,r_108_127_34,0.98,0,34,34,28
22,r_109_126_182,r_68_96_81,r_102_103_124,r_109_126_182,0.62,0,182,182,28
2,r_47_62_94,r_89_23_197,seq78,r_47_62_94,1.0,-1,93,94,28
18,r_37_135_106,seq124,seq21,r_37_135_106,0.95,0,106,106,28
24,r_72_120_3,r_83_64_176,r_53_73_151,r_53_73_151,0.9,25,176,151,28
25,r_83_64_176,r_52_133_61,r_72_120_3,r_52_133_61,1.0,-11,50,61,28
17,r_108_127_34,r_49_125_97,seq99,r_108_127_34,1.0,0,34,34,28
81,seq82,r_2_119_107,r_61_58_71,r_2_119_107,0.87,0,107,107,28
25,r_83_64_176,r_72_120_3,r_108_127_34,r_83_64_176,0.76,0,176,176,28
9,r_70_45_168,r_35_8_49,r_14_134_159,r_70_45_168,0.91,0,168,168,28
9,r_70_45_168,r_44_67_121,r_35_8_49,r_70_45_168,0.81,-46,122,168,28
38,r_35_8_49,seq77,r_19_111_45,r_35_8_49,1.0,0,49,49,28
22,r_109_126_182,seq101,r_68_96_81,r_68_96_81,1.0,3,84,81,28
33,r_19_111_45,r_68_96_81,r_35_8_49,r_19_111_45,1.0,4,49,45,28
79,seq80,r_115_104_174,r_102_103_124,r_102_103_124,1.0,35,159,124,28
12,r_55_11_111,seq56,r_79_66_18,r_55_11_111,0.56,-1,110,111,28
94,seq110,seq43,r_9_24_26,r_9_24_26,1.0,4,30,26,28
93,seq107,r_15_79_174,r_63_104_83,r_63_104_83,0.99,91,174,83,29
8,r_34_49_131,seq1,seq126,r_34_49_131,0.69,1,132,131,29
54,seq27,r_109_56_113,seq40,r_109_56_113,0.99,0,113,113,29
37,r_63_104_83,seq125,seq107,r_63_104_83,1.0,0,83,83,29
86,seq94,r_132_66_138,seq28,r_132_66_138,0.55,25,163,138,29
21,r_26_108_185,r_133_16_115,r_130_127_59,r_26_108_185,0.94,-70,115,185,29
2,r_85_75_35,r_97_19_195,seq17,r_85_75_35,1.0,0,35,35,29
24,r_91_60_125,seq73,seq27,r_91_60_125,1.0,0,125,125,29
19,r_31_36_87,seq135,seq17,r_31_36_87,1.0,1,88,87,29
39,r_130_127_59,r_26_108_185,r_111_18_7,r_130_127_59,0.54,129,188,59,29
14,r_23_112_26,r_133_16_115,seq122,r_23_112_26,1.0,0,26,26,29
3,r_11_89_118,seq71,seq51,r_11_89_118,1.0,0,118,118,29
26,r_129_37_73,seq100,seq134,r_129_37_73,0.73,0,73,73,29
0,r_14_57_139,seq137,seq139,r_14_57_139,0.97,0,139,139,29
99,seq126,seq17,r_34_49_131,r_34_49_131,1.0,1,132,131,29
13,r_133_16_115,r_26_108_185,seq82,r_133_16_115,0.91,0,115,115,29
15,r_96_55_123,seq100,seq62,r_96_55_123,0.69,10,133,123,29
23,r_52_95_24,seq42,seq125,r_52_95_24,0.99,0,24,24,29
21,r_26_108_185,r_130_127_59,r_4_5_44,r_26_108_185,0.52,3,188,185,29
99,seq126,r_74_67_36,seq17,r_74_67_36,0.99,-1,35,36,29
36,r_2_59_6,r_48_118_28,r_113_54_177,r_48_118_28,0.48,88,116,28,29
27,r_115_43_102,r_15_79_174,r_23_112_26,r_15_79_174,0.81,-72,102,174,29
97,seq122,r_97_19_195,r_23_112_26,r_23_112_26,1.0,28,54,26,29
4,r_113_54_177,r_4_5_44,r_2_59_6,r_4_5_44,0.58,5,49,44,29
1,r_4_5_44,r_133_16_115,r_46_68_42,r_4_5_44,1.0,5,49,44,29
25,r_92_32_189,seq139,r_4_5_44,r_4_5_44,0.58,145,189,44,29
33,r_13_21_127,seq17,seq25,r_13_21_127,0.9,2,129,127,29
6,r_72_45_39,seq17,seq107,r_72_45_39,0.96,0,39,39,29
88,seq100,r_96_55_123,seq106,r_96_55_123,0.41,10,133,123,29
39,r_130_127_59,r_92_32_189,r_26_108_185,r_130_127_59,0.99,0,59,59,29
50,seq17,seq58,r_31_36_87,r_31_36_87,1.0,4,91,87,29
32,r_15_79_174,seq107,seq40,r_15_79_174,0.54,0,174,174,29
29,r_9_117_12,r_113_54_177,seq58,r_9_117_12,0.9,0,12,12,29
22,r_64_90_48,r_47_50_191,r_48_118_28,r_64_90_48,1.0,0,48,48,29
10,r_46_68_42,r_47_50_191,seq101,r_46_68_42,1.0,0,42,42,29
34,r_22_33_162,r_26_108_185,r_133_16_115,r_133_16_115,0.59,47,162,115,29
17,r_132_66_138,seq94,r_131_38_41,r_131_38_41,1.0,107,148,41,29
16,r_74_67_36,seq126,r_119_65_33,r_74_67_36,0.94,-1,35,36,29
5,r_111_18_7,r_133_16_115,r_48_118_28,r_133_16_115,1.0,-57,58,115,29
18,r_131_38_41,r_11_89_118,seq106,r_131_38_41,1.0,0,41,41,29
24,r_91_60_125,r_133_16_115,seq73,r_133_16_115,0.81,-57,58,115,29
89,seq101,seq44,r_46_68_42,r_46_68_42,1.0,2,44,42,29
7,r_109_56_113,seq27,seq61,r_109_56_113,1.0,0,113,113,29
38,r_119_65_33,r_85_75_35,seq103,r_119_65_33,0.99,0,33,33,29
12,r_93_77_155,seq78,r_105_99_181,r_93_77_155,0.6,0,155,155,29
36,r_126_96_117,seq114,r_22_11_6,r_126_96_117,0.96,0,117,117,30
14,r_15_128_162,seq98,seq54,r_15_128_162,0.78,0,162,162,30
54,seq25,r_59_117_124,seq119,r_59_117_124,1.0,0,124,124,30
83,seq93,r_32_112_123,seq2,r_32_112_123,0.99,0,123,123,30
37,r_129_39_106,seq105,seq63,r_129_39_106,0.97,0,106,106,30
16,r_124_52_150,r_33_34_185,r_95_55_111,r_124_52_150,0.84,0,150,150,30
21,r_7_56_173,seq102,r_95_55_111,r_95_55_111,0.99,62,173,111,30
39,r_32_112_123,seq93,seq50,r_32_112_123,1.0,0,123,123,30
1,r_3_69_82,r_92_68_80,r_48_91_53,r_3_69_82,1.0,-3,79,82,30
6,r_53_94_43,r_43_20_85,seq135,r_43_20_85,0.93,-41,44,85,30
80,seq81,seq58,r_61_17_37,r_61_17_37,1.0,39,76,37,30
43,seq5,seq29,r_9_87_48,r_9_87_48,1.0,1,49,48,30
30,r_101_0_34,seq28,seq60,r_101_0_34,1.0,0,34,34,30
10,r_89_136_47,r_84_122_17,seq16,r_89_136_47,0.53,-30,17,47,30
3,r_12_110_78,seq58,r_22_11_6,r_12_110_78,1.0,0,78,78,30
90,seq105,r_42_30_87,seq19,r_42_30_87,1.0,-5,82,87,30
26,r_59_117_124,seq25,seq98,r_59_117_124,0.99,0,124,124,30
0,r_133_80_60,seq90,r_84_122_17,r_133_80_60,1.0,0,60,60,30
11,r_121_78_153,r_57_37_152,r_14_138_64,r_57_37_152,0.39,1,153,152,30
20,r_134_107_89,seq54,r_84_122_17,r_134_107_89,1.0,0,89,89,30
15,r_51_73_115,r_88_85_157,seq21,r_51_73_115,1.0,-1,114,115,30
34,r_48_91_53,r_57_37_152,r_3_69_82,r_48_91_53,0.97,36,89,53,30
27,r_132_27_61,seq38,seq23,r_132_27_61,0.76,5,66,61,30
34,r_48_91_53,r_95_55_111,r_57_37_152,r_48_91_53,0.94,0,53,53,30
2,r_95_55_111,seq102,r_44_74_56,r_44_74_56,0.73,54,110,56,30
40,seq2,r_32_112_123,seq38,r_32_112_123,1.0,0,123,123,30
18,r_42_30_87,seq105,seq99,r_42_30_87,0.99,0,87,87,30
24,r_88_85_157,r_15_128_162,seq31,r_88_85_157,0.33,1,158,157,30
33,r_14_138_64,seq45,seq102,r_14_138_64,1.0,0,64,64,30
65,seq54,r_134_107_89,seq137,r_134_107_89,1.0,0,89,89,30
61,seq40,seq130,r_84_122_17,r_84_122_17,0.99,65,82,17,30
38,r_57_37_152,seq111,seq38,r_57_37_152,0.71,0,152,152,30
22,r_9_87_48,seq130,seq5,r_9_87_48,1.0,0,48,48,30
10,r_89_136_47,seq16,r_84_122_17,r_89_136_47,0.98,0,47,47,30
4,r_116_125_57,seq16,seq102,r_116_125_57,0.53,0,57,57,30
60,seq38,r_132_27_61,seq93,r_132_27_61,0.85,5,66,61,30
17,r_41_10_10,r_8_120_189,seq99,r_41_10_10,0.99,1,11,10,30
9,r_8_120_189,seq36,r_43_20_85,r_43_20_85,0.79,104,189,85,30
28,r_22_11_6,r_86_46_3,r_12_110_78,r_12_110_78,1.0,34,112,78,30
32,r_61_17_37,seq16,seq81,r_61_17_37,1.0,0,37,37,30
60,seq38,seq93,r_57_37_152,r_57_37_152,1.0,0,152,152,30
35,r_92_68_80,r_3_69_82,seq103,r_92_68_80,1.0,0,80,80,30
12,r_6_66_187,seq90,seq114,r_6_66_187,0.36,0,187,187,30
14,r_137_81_135,r_108_103_170,seq73,r_137_81_135,0.87,0,135,135,31
37,r_117_37_123,seq115,r_56_125_197,r_117_37_123,0.8,2,125,123,31
30,r_138_9_39,r_119_4_86,seq127,r_138_9_39,0.98,0,39,39,31
86,seq96,r_90_82_188,r_63_110_100,r_63_110_100,1.0,88,188,100,31
16,r_99_139_92,r_126_25_160,seq13,r_99_139_92,0.62,3,95,92,31
21,r_84_28_101,r_43_75_4,seq79,r_84_28_101,0.78,-7,94,101,31
1,r_46_7_165,r_90_82_188,seq94,r_46_7_165,0.69,0,165,165,31
5,r_86_97_178,seq78,seq115,r_86_97_178,0.58,1,179,178,31
19,r_129_80_69,seq1,seq121,r_129_80_69,0.99,0,69,69,31
31,r_65_116_109,seq32,seq50,r_65_116_109,0.99,2,111,109,31
75,seq73,seq94,r_137_81_135,r_137_81_135,1.0,7,142,135,31
3,r_42_35_194,r_86_97_178,seq26,r_86_97_178,0.54,-61,117,178,31
10,r_23_16_156,seq41,seq62,r_23_16_156,0.76,1,157,156,31
28,r_123_44_52,seq69,seq83,r_123_44_52,1.0,0,52,52,31
26,r_122_136_112,seq5,r_0_39_10,r_122_136_112,0.99,1,113,112,31
4,r_33_30_161,r_90_82_188,r_22_29_120,r_33_30_161,0.9,0,161,161,31
0,r_47_72_140,r_3_48_6,seq131,r_3_48_6,0.52,134,140,6,31
13,r_92_133_97,r_137_81_135,seq15,r_137_81_135,0.91,-38,97,135,31
98,seq121,seq5,r_129_80_69,r_129_80_69,1.0,79,148,69,31
15,r_111_91_96,r_43_75_4,seq26,r_111_91_96,0.99,0,96,96,31
6,r_135_104_73,seq102,seq79,r_135_104_73,0.71,11,84,73,31
8,r_74_113_22,r_42_35_194,seq79,r_74_113_22,1.0,0,22,22,31
2,r_43_75_4,r_111_91_96,seq5,r_111_91_96,0.81,0,96,96,31
36,r_0_39_10,r_36_53_185,r_58_59_7,r_0_39_10,0.78,0,10,10,31
24,r_52_87_87,seq73,seq32,r_52_87_87,1.0,0,87,87,31
32,r_63_110_100,seq2,seq1,r_63_110_100,0.97,1,101,100,31
38,r_22_29_120,seq134,r_123_44_52,r_22_29_120,1.0,0,120,120,31
34,r_98_34_116,seq5,seq93,r_98_34_116,0.9,0,116,116,31
75,seq73,r_52_87_87,seq94,r_52_87_87,1.0,0,87,87,31
17,r_90_82_188,seq96,r_17_70_154,r_90_82_188,0.35,0,188,188,31
9,r_31_132_56,r_23_16_156,seq32,r_23_16_156,0.55,-89,67,156,31
28,r_123_44_52,seq83,r_22_29_120,r_22_29_120,1.0,10,130,120,31
22,r_61_12_114,seq94,r_43_75_4,r_61_12_114,0.97,2,116,114,31
2,r_43_75_4,seq5,r_61_12_114,r_61_12_114,0.91,10,124,114,31
7,r_6_89_50,seq14,seq78,r_6_89_50,1.0,0,50,50,31
20,r_71_20_29,r_137_81_135,seq64,r_137_81_135,0.49,-104,31,135,31
23,r_119_4_86,seq134,r_31_132_56,r_119_4_86,1.0,0,86,86,31
22,r_61_12_114,r_43_75_4,seq128,r_61_12_114,0.65,50,164,114,31
35,r_19_18_90,r_61_12_114,seq131,r_19_18_90,0.97,1,91,90,31
12,r_17_70_154,seq67,seq120,r_17_70_154,0.83,0,154,154,31
84,seq94,r_61_12_114,seq73,r_61_12_114,1.0,0,114,114,31
34,r_105_67_75,r_38_71_128,r_21_92_133,r_105_67_75,1.0,57,132,75,32
14,r_3_113_107,r_38_71_128,r_2_35_64,r_38_71_128,0.98,-21,107,128,32
8,r_19_26_177,seq40,r_36_134_96,r_36_134_96,1.0,81,177,96,32
4,r_120_41_53,seq59,r_22_98_171,r_120_41_53,1.0,0,53,53,32
83,seq84,seq133,r_83_99_126,r_83_99_126,0.99,10,136,126,32
37,r_54_103_116,seq20,seq102,r_54_103_116,0.84,0,116,116,32
26,r_112_25_70,r_130_66_47,r_27_9_199,r_130_66_47,0.92,-7,40,47,32
5,r_21_92_133,seq74,r_105_67_75,r_105_67_75,0.99,56,131,75,32
9,r_137_81_141,r_125_1_183,seq20,r_137_81_141,0.61,-30,111,141,32
16,r_114_58_42,seq5,r_22_98_171,r_114_58_42,1.0,0,42,42,32
15,r_106_96_63,seq7,r_21_92_133,r_106_96_63,0.74,-5,58,63,32
0,r_123_117_50,r_121_118_97,r_88_34_193,r_123_117_50,0.96,0,50,50,32
15,r_106_96_63,r_21_92_133,seq116,r_21_92_133,0.89,2,135,133,32
66,seq51,r_121_118_97,seq69,r_121_118_97,1.0,-9,88,97,32
31,r_125_1_183,seq59,r_36_134_96,r_36_134_96,0.85,79,175,96,32
3,r_129_115_174,seq13,r_21_92_133,r_21_92_133,0.69,44,177,133,32
10,r_48_18_138,r_22_98_171,seq68,r_48_18_138,0.59,2,140,138,32
72,seq65,r_109_131_136,seq12,r_109_131_136,1.0,1,137,136,32
16,r_114_58_42,r_22_98_171,r_121_118_97,r_121_118_97,0.84,70,167,97,32
73,seq139,r_19_26_177,r_112_25_70,r_112_25_70,1.0,0,70,70,32
11,r_38_71_128,r_136_73_142,r_105_67_75,r_105_67_75,1.0,1,76,75,32
20,r_17_63_119,r_14_124_127,r_130_66_47,r_17_63_119,1.0,0,119,119,32
4,r_120_41_53,r_22_98_171,r_53_15_106,r_120_41_53,0.95,119,172,53,32
6,r_53_15_106,seq110,r_120_41_53,r_53_15_106,0.88,1,107,106,32
21,r_22_98_171,r_120_41_53,seq12,r_22_98_171,0.9,1,172,171,32
27,r_30_128_143,seq116,seq110,r_30_128_143,0.74,1,144,143,32
69,seq57,r_137_81_141,r_62_97_10,r_137_81_141,0.35,-11,130,141,32
1,r_88_34_193,r_120_41_53,r_123_117_50,r_123_117_50,0.72,8,58,50,32
24,r_36_134_96,r_75_55_122,seq46,r_36_134_96,1.0,0,96,96,32
25,r_83_99_126,r_22_98_171,seq84,r_83_99_126,0.99,1,127,126,32
26,r_112_25_70,r_27_9_199,seq139,r_112_25_70,0.99,0,70,70,32
33,r_109_131_136,seq65,r_21_92_133,r_109_131_136,0.98,0,136,136,32
11,r_38_71_128,r_105_67_75,seq20,r_38_71_128,0.99,4,132,128,32
21,r_22_98_171,r_48_18_138,r_120_41_53,r_120_41_53,0.98,2,55,53,32
50,seq20,r_54_103_116,r_38_71_128,r_54_103_116,0.36,11,127,116,32
32,r_121_118_97,seq51,seq108,r_121_118_97,1.0,0,97,97,32
38,r_2_35_64,seq56,seq60,r_2_35_64,1.0,0,64,64,32
34,r_105_67_75,r_19_26_177,r_38_71_128,r_105_67_75,1.0,1,76,75,32
9,r_137_81_141,seq20,seq59,r_137_81_141,0.81,0,141,141,32
17,r_127_29_162,seq68,r_61_77_6,r_127_29_162,0.85,0,162,162,32
9,r_137_81_141,r_54_103_116,r_125_1_183,r_125_1_183,0.45,-101,82,183,32
22,r_75_55_122,seq135,seq78,r_75_55_122,0.64,1,123,122,32
28,r_104_138_152,seq37,seq31,r_104_138_152,0.6,10,162,152,32
7,r_86_122_112,seq37,r_49_70_192,r_86_122_112,0.72,-2,110,112,32
23,r_136_73_142,r_129_115_174,seq116,r_136_73_142,0.55,0,142,142,32
12,r_14_124_127,seq78,r_112_25_70,r_112_25_70,0.81,57,127,70,32
36,r_130_66_47,r_112_25_70,seq7,r_112_25_70,0.69,-22,48,70,32
93,seq115,r_126_50_168,r_110_38_126,r_110_38_126,0.83,41,167,126,33
30,r_31_11_131,r_76_54_119,seq22,r_76_54_119,0.9,-59,60,119,33
17,r_88_39_37,seq66,seq102,r_88_39_37,0.94,10,47,37,33
8,r_33_2_73,seq34,r_109_128_39,r_33_2_73,0.6,0,73,73,33
54,seq22,r_130_80_115,seq84,r_130_80_115,1.0,-1,114,115,33
2,r_85_93_104,r_26_12_57,r_48_45_21,r_26_12_57,0.92,1,58,57,33
46,seq8,r_41_40_86,r_124_46_128,r_124_46_128,0.77,2,130,128,33
16,r_41_40_86,r_114_120_111,seq13,r_41_40_86,0.97,0,86,86,33
21,r_61_117_116,seq8,seq132,r_61_117_116,0.96,0,116,116,33
39,r_90_81_76,r_129_18_197,seq59,r_90_81_76,1.0,0,76,76,33
1,r_74_108_165,r_126_50_168,r_130_80_115,r_130_80_115,0.98,50,165,115,33
27,r_27_23_59,seq62,seq44,r_27_23_59,0.98,0,59,59,33
46,seq8,r_61_117_116,r_41_40_86,r_41_40_86,0.9,30,116,86,33
80,seq84,r_76_54_119,seq22,r_76_54_119,1.0,0,119,119,33
19,r_106_112_160,seq47,seq16,r_106_112_160,0.71,0,160,160,33
7,r_26_12_57,r_85_93_104,seq65,r_26_12_57,1.0,1,58,57,33
31,r_82_58_70,seq66,seq132,r_82_58_70,0.52,12,82,70,33
10,r_79_32_108,r_106_112_160,seq34,r_79_32_108,0.99,0,108,108,33
14,r_48_45_21,r_88_39_37,r_85_93_104,r_48_45_21,0.93,0,21,21,33
22,r_64_53_24,r_61_117_116,r_24_67_74,r_24_67_74,0.56,-9,65,74,33
14,r_48_45_21,r_85_93_104,r_7_131_1,r_85_93_104,1.0,0,104,104,33
4,r_114_120_111,seq49,r_64_53_24,r_114_120_111,0.97,1,112,111,33
78,seq77,r_24_67_74,seq97,r_24_67_74,1.0,0,74,74,33
0,r_134_25_127,seq0,r_56_103_34,r_134_25_127,0.98,0,127,127,33
63,seq47,r_106_112_160,r_85_93_104,r_85_93_104,0.73,56,160,104,33
2,r_85_93_104,r_48_45_21,seq47,r_85_93_104,1.0,0,104,104,33
73,seq66,seq4,r_90_81_76,r_90_81_76,0.99,64,140,76,33
11,r_35_42_148,seq62,seq133,r_35_42_148,0.73,0,148,148,33
20,r_15_10_152,seq6,seq37,r_15_10_152,0.82,2,154,152,33
15,r_105_137_166,seq49,r_79_32_108,r_79_32_108,0.98,59,167,108,33
62,seq44,seq0,r_27_23_59,r_27_23_59,1.0,36,95,59,33
26,r_55_89_58,r_101_138_61,r_134_25_127,r_134_25_127,0.87,-68,59,127,33
70,seq62,r_27_23_59,r_35_42_148,r_27_23_59,1.0,0,59,59,33
30,r_31_11_131,seq22,seq71,r_31_11_131,0.76,1,132,131,33
18,r_124_46_128,seq0,seq8,r_124_46_128,0.92,2,130,128,33
29,r_76_54_119,seq84,r_114_120_111,r_76_54_119,1.0,0,119,119,33
24,r_126_50_168,seq115,r_130_80_115,r_126_50_168,0.78,1,169,168,33
25,r_78_111_137,seq95,seq99,r_78_111_137,0.95,0,137,137,33
33,r_101_138_61,r_85_93_104,seq132,r_101_138_61,1.0,2,63,61,33
70,seq62,r_35_42_148,r_88_39_37,r_35_42_148,0.91,-15,133,148,33
47,seq9,r_56_103_34,r_121_68_171,r_121_68_171,0.49,-2,169,171,33
28,r_121_68_171,seq36,r_75_91_18,r_75_91_18,0.87,16,34,18,33
32,r_73_43_102,seq95,seq94,r_73_43_102,1.0,-1,101,102,33
37,r_98_14_27,seq17,seq47,r_98_14_27,0.94,0,27,27,33
9,r_130_80_115,seq22,seq59,r_130_80_115,0.98,-1,114,115,33
26,r_55_89_58,r_134_25_127,seq63,r_134_25_127,1.0,0,127,127,33
22,r_64_53_24,seq51,r_61_117_116,r_64_53_24,0.81,1,25,24,33
23,r_110_38_126,seq1,seq115,r_110_38_126,0.98,0,126,126,33
6,r_75_91_18,r_61_117_116,r_121_68_171,r_75_91_18,0.83,5,23,18,33
35,r_24_67_74,seq77,r_64_53_24,r_24_67_74,0.99,0,74,74,33
12,r_7_131_1,r_85_93_104,seq6,r_85_93_104,1.0,0,104,104,33
84,seq95,r_78_111_137,r_33_2_73,r_33_2_73,0.99,64,137,73,33
30,r_0_14_173,r_9_81_63,seq136,r_0_14_173,0.49,-101,72,173,34
51,seq132,r_77_22_101,seq21,r_77_22_101,0.59,-1,100,101,34
20,r_59_45_37,r_106_87_99,seq110,r_59_45_37,1.0,0,37,37,34
36,r_116_5_177,seq103,r_77_22_101,r_77_22_101,0.59,79,180,101,34
14,r_77_22_101,seq132,seq8,r_77_22_101,0.48,-1,100,101,34
7,r_61_2_134,r_13_129_179,r_58_65_96,r_13_129_179,1.0,0,179,179,34
37,r_9_81_63,r_0_14_173,seq48,r_0_14_173,0.45,-95,78,173,34
16,r_108_127_115,seq31,seq105,r_108_127_115,0.98,0,115,115,34
39,r_94_111_2,r_42_99_172,seq4,r_42_99_172,0.57,1,173,172,34
1,r_19_20_160,seq39,seq60,r_19_20_160,0.65,0,160,160,34
69,seq57,seq131,r_130_115_61,r_130_115_61,1.0,34,95,61,34
19,r_41_16_72,seq23,seq105,r_41_16_72,0.94,0,72,72,34
31,r_42_99_172,r_94_111_2,r_77_22_101,r_42_99_172,0.67,1,173,172,34
89,seq103,r_116_5_177,r_137_134_126,r_137_134_126,1.0,54,180,126,34
37,r_9_81_63,seq48,r_89_15_92,r_89_15_92,0.95,0,92,92,34
22,r_49_91_65,r_67_27_151,r_58_65_96,r_49_91_65,1.0,38,103,65,34
29,r_35_118_27,r_41_16_72,seq52,r_35_118_27,0.93,1,28,27,34
4,r_55_114_68,seq92,seq39,r_55_114_68,1.0,0,68,68,34
78,seq76,r_107_104_190,seq69,r_107_104_190,0.89,0,190,190,34
26,r_100_79_33,r_77_22_101,seq113,r_100_79_33,0.77,2,35,33,34
11,r_101_78_114,seq73,r_59_45_37,r_101_78_114,0.64,0,114,114,34
98,seq124,r_116_5_177,r_3_82_60,r_3_82_60,1.0,11,71,60,34
15,r_25_43_152,seq138,seq131,r_25_43_152,0.9,0,152,152,34
0,r_75_28_19,r_107_104_190,r_50_30_86,r_50_30_86,1.0,0,86,86,34
8,r_18_54_16,r_75_28_19,seq62,r_18_54_16,0.9,0,16,16,34
2,r_107_104_190,seq76,r_94_111_2,r_94_111_2,0.66,188,190,2,34
18,r_50_30_86,r_42_99_172,r_75_28_19,r_50_30_86,1.0,0,86,86,34
24,r_89_15_92,r_77_22_101,r_9_81_63,r_89_15_92,1.0,0,92,92,34
25,r_13_129_179,r_0_14_173,r_61_2_134,r_61_2_134,0.86,9,143,134,34
33,r_106_87_99,seq1,seq37,r_106_87_99,0.96,0,99,99,34
64,seq136,r_67_27_151,r_49_91_65,r_49_91_65,0.87,86,151,65,34
0,r_75_28_19,r_112_6_79,r_107_104_190,r_75_28_19,0.93,0,19,19,34
25,r_13_129_179,r_61_2_134,r_19_20_160,r_13_129_179,0.55,1,180,179,34
32,r_137_134_126,r_67_27_151,seq103,r_137_134_126,0.98,1,127,126,34
38,r_3_82_60,seq69,seq124,r_3_82_60,0.92,4,64,60,34
75,seq71,r_49_91_65,seq74,r_49_91_65,1.0,0,65,65,34
55,seq33,r_13_129_179,r_0_14_173,r_0_14_173,0.65,-129,44,173,34
17,r_86_38_130,r_116_5_177,r_59_45_37,r_116_5_177,0.95,-46,131,177,34
9,r_85_40_78,seq12,seq131,r_85_40_78,0.89,2,80,78,34
27,r_139_83_22,seq7,seq73,r_139_83_22,0.99,0,22,22,34
96,seq121,r_58_65_96,seq21,r_58_65_96,1.0,1,97,96,34
22,r_49_91_65,seq71,r_67_27_151,r_49_91_65,0.98,0,65,65,34
34,r_72_26_45,r_125_102_48,seq105,r_72_26_45,1.0,1,46,45,34
7,r_61_2_134,r_68_63_132,r_13_129_179,r_13_129_179,0.95,-39,140,179,34
23,r_64_128_149,seq105,seq34,r_64_128_149,0.98,0,149,149,34
35,r_112_6_79,seq44,r_59_45_37,r_112_6_79,1.0,0,79,79,34
12,r_67_27_151,seq136,r_86_38_130,r_67_27_151,0.96,0,151,151,34
30,r_123_57_25,seq1,r_81_36_186,r_123_57_25,0.88,-1,24,25,35
14,r_83_76_124,seq96,r_37_111_111,r_37_111_111,0.69,13,124,111,35
8,r_37_111_111,r_2_106_153,r_44_138_96,r_44_138_96,0.66,15,111,96,35
53,seq22,r_125_87_103,r_98_128_10,r_125_87_103,0.82,1,104,103,35
3,r_4_72_48,r_2_106_153,seq96,r_4_72_48,1.0,0,48,48,35
37,r_90_3_128,seq73,r_137_126_166,r_90_3_128,0.93,0,128,128,35
16,r_112_75_57,seq132,seq17,r_112_75_57,1.0,1,58,57,35
21,r_95_69_175,seq104,r_98_128_10,r_95_69_175,0.42,1,176,175,35
39,r_85_46_92,seq58,seq12,r_85_46_92,1.0,2,94,92,35
89,seq103,r_134_18_123,r_45_127_95,r_134_18_123,0.83,3,126,123,35
19,r_118_79_24,seq11,seq17,r_118_79_24,0.97,-1,23,24,35
90,seq104,r_95_69_175,r_119_35_98,r_119_35_98,0.94,78,176,98,35
26,r_137_126_166,r_2_106_153,r_90_3_128,r_90_3_128,1.0,20,148,128,35
4,r_114_91_83,r_134_18_123,seq108,r_114_91_83,1.0,3,86,83,35
11,r_44_138_96,seq7,seq70,r_44_138_96,0.97,1,97,96,35
29,r_53_59_54,seq132,seq109,r_53_59_54,0.62,3,57,54,35
31,r_54_64_6,r_20_15_69,r_30_19_26,r_30_19_26,1.0,1,27,26,35
13,r_28_25_168,seq115,r_51_136_179,r_28_25_168,0.39,1,169,168,35
15,r_135_77_67,r_120_116_171,seq94,r_135_77_67,0.88,109,176,67,35
6,r_20_15_69,r_134_18_123,r_112_75_57,r_112_75_57,0.72,14,71,57,35
0,r_30_19_26,seq139,r_54_64_6,r_30_19_26,1.0,0,26,26,35
84,seq96,seq132,r_4_72_48,r_4_72_48,1.0,5,53,48,35
30,r_123_57_25,r_81_36_186,r_120_116_171,r_120_116_171,0.49,18,189,171,35
22,r_43_130_32,r_120_116_171,r_133_31_12,r_120_116_171,0.89,-46,125,171,35
25,r_45_127_95,seq17,seq103,r_45_127_95,0.36,23,118,95,35
22,r_43_130_32,seq10,r_120_116_171,r_43_130_32,0.9,6,38,32,35
32,r_125_87_103,seq22,r_85_46_92,r_125_87_103,0.84,1,104,103,35
38,r_120_116_171,seq74,r_123_57_25,r_123_57_25,0.71,147,172,25,35
77,seq74,r_120_116_171,seq99,r_120_116_171,0.63,1,172,171,35
34,r_134_18_123,seq103,r_37_111_111,r_37_111_111,0.98,15,126,111,35
37,r_90_3_128,r_137_126_166,seq48,r_137_126_166,1.0,0,166,166,35
17,r_2_106_153,r_137_126_166,r_112_75_57,r_112_75_57,0.73,96,153,57,35
26,r_137_126_166,r_90_3_128,r_30_19_26,r_90_3_128,0.62,38,166,128,35
28,r_119_35_98,r_45_127_95,seq21,r_119_35_98,0.9,0,98,98,35
7,r_33_60_64,r_117_105_1,r_85_46_92,r_33_60_64,0.99,27,91,64,35
44,seq5,r_13_40_181,r_117_105_1,r_13_40_181,0.71,2,183,181,35
23,r_81_36_186,r_123_57_25,r_133_31_12,r_133_31_12,0.86,177,189,12,35
12,r_41_47_170,seq17,r_9_52_15,r_9_52_15,0.56,158,173,15,35
30,r_120_31_125,seq118,seq124,r_120_31_125,0.94,3,128,125,36
51,seq13,r_115_116_80,seq44,r_115_116_80,1.0,-17,63,80,36
17,r_69_126_122,r_71_46_53,r_112_84_136,r_71_46_53,1.0,-6,47,53,36
33,r_122_55_54,seq133,r_77_48_3,r_122_55_54,0.46,-19,35,54,36
14,r_36_109_188,seq83,r_25_137_138,r_25_137_138,0.54,50,188,138,36
8,r_121_103_173,r_50_61_168,seq2,r_121_103_173,0.83,0,173,173,36
37,r_16_110_144,seq66,r_88_76_130,r_16_110_144,0.82,0,144,144,36
21,r_6_32_93,r_50_61_168,seq8,r_6_32_93,0.69,0,93,93,36
39,r_81_22_149,seq128,r_105_65_64,r_81_22_149,0.78,1,150,149,36
1,r_71_46_53,seq85,r_79_123_62,r_79_123_62,0.72,115,177,62,36
5,r_106_57_113,r_5_94_189,seq107,r_106_57_113,0.93,1,114,113,36
7,r_114_39_63,r_101_92_151,seq59,r_101_92_151,0.97,-16,135,151,36
45,seq135,r_5_94_189,seq18,r_5_94_189,0.71,-41,148,189,36
78,seq72,r_75_68_180,r_89_132_49,r_89_132_49,0.85,-6,43,49,36
65,seq43,r_114_39_63,r_117_90_59,r_117_90_59,1.0,0,59,59,36
27,r_5_94_189,r_130_34_41,r_17_45_29,r_5_94_189,0.65,0,189,189,36
1,r_71_46_53,r_69_126_122,seq85,r_69_126_122,0.51,-67,55,122,36
38,r_130_34_41,r_5_94_189,r_41_14_161,r_5_94_189,0.56,0,189,189,36
31,r_113_73_68,seq42,r_105_65_64,r_113_73_68,1.0,0,68,68,36
15,r_75_68_180,r_106_57_113,seq29,r_75_68_180,0.99,0,180,180,36
7,r_114_39_63,seq43,r_101_92_151,r_114_39_63,0.66,-4,59,63,36
41,seq129,r_33_4_89,r_130_34_41,r_130_34_41,0.92,39,80,41,36
19,r_125_54_23,r_114_39_63,seq38,r_125_54_23,1.0,0,23,23,36
0,r_17_45_29,r_74_26_97,seq70,r_17_45_29,0.8,-12,17,29,36
26,r_88_76_130,r_75_68_180,r_41_14_161,r_88_76_130,0.9,1,131,130,36
4,r_50_61_168,r_121_103_173,r_89_132_49,r_121_103_173,0.6,-3,170,173,36
11,r_115_116_80,seq13,seq124,r_115_116_80,1.0,-2,78,80,36
2,r_89_132_49,r_5_94_189,seq72,r_89_132_49,0.88,-6,43,49,36
20,r_47_10_96,seq8,r_130_34_41,r_130_34_41,1.0,77,118,41,36
98,seq124,seq20,r_120_31_125,r_120_31_125,1.0,-4,121,125,36
15,r_75_68_180,r_88_76_130,r_106_57_113,r_106_57_113,0.69,20,133,113,36
62,seq38,r_6_32_93,r_125_54_23,r_125_54_23,1.0,0,23,23,36
85,seq87,seq24,r_105_65_64,r_105_65_64,1.0,1,65,64,36
51,seq13,seq44,r_67_96_152,r_67_96_152,0.85,1,153,152,36
22,r_3_131_43,r_36_109_188,seq23,r_3_131_43,1.0,0,43,43,36
18,r_105_65_64,seq37,seq87,r_105_65_64,0.93,3,67,64,36
29,r_117_90_59,seq44,seq43,r_117_90_59,1.0,1,60,59,36
25,r_101_92_151,r_114_39_63,r_17_45_29,r_101_92_151,0.56,0,151,151,36
68,seq51,r_50_61_168,r_111_21_31,r_111_21_31,0.92,138,169,31,36
34,r_33_4_89,seq129,seq8,r_33_4_89,0.84,-9,80,89,36
9,r_25_137_138,r_77_48_3,seq87,r_25_137_138,0.95,1,139,138,36
36,r_1_28_40,seq118,r_17_45_29,r_1_28_40,1.0,1,41,40,36
44,seq134,seq104,r_79_123_62,r_79_123_62,1.0,30,92,62,36
23,r_79_123_62,r_114_39_63,seq134,r_79_123_62,1.0,0,62,62,36
17,r_69_126_122,r_112_84_136,seq107,r_69_126_122,0.78,6,128,122,36
82,seq83,r_74_26_97,seq91,r_74_26_97,1.0,-1,96,97,36
27,r_5_94_189,r_89_132_49,r_130_34_41,r_130_34_41,0.95,0,41,41,36
38,r_130_34_41,r_122_55_54,r_5_94_189,r_130_34_41,0.99,0,41,41,36
35,r_74_26_97,seq83,r_125_54_23,r_74_26_97,0.95,0,97,97,36
12,r_77_48_3,r_25_137_138,r_122_55_54,r_25_137_138,0.94,1,139,138,36
30,r_54_103_132,seq31,seq12,r_54_103_132,0.63,1,133,132,37
6,r_22_59_20,r_36_116_105,seq47,r_22_59_20,0.8,0,20,20,37
8,r_42_120_135,r_45_1_142,seq136,r_42_120_135,0.71,3,138,135,37
4,r_85_82_8,seq16,seq44,r_85_82_8,0.82,2,10,8,37
37,r_53_71_63,seq81,seq96,r_53_71_63,1.0,0,63,63,37
39,r_9_88_115,seq12,seq139,r_9_88_115,0.61,2,117,115,37
5,r_70_13_70,r_45_1_142,r_36_116_105,r_36_116_105,0.78,-34,71,105,37
46,seq12,r_9_88_115,r_129_117_193,r_9_88_115,0.99,2,117,115,37
46,seq12,r_129_117_193,r_54_103_132,r_54_103_132,0.49,14,146,132,37
56,seq33,seq12,r_63_111_48,r_63_111_48,1.0,-1,47,48,37
7,r_68_131_121,r_49_25_13,r_28_0_11,r_68_131_121,0.7,1,122,121,37
19,r_45_1_142,seq95,r_129_117_193,r_45_1_142,0.77,0,142,142,37
26,r_40_11_197,r_53_71_63,r_85_82_8,r_53_71_63,0.98,-10,53,63,37
31,r_7_55_104,r_127_20_133,seq47,r_7_55_104,0.89,-1,103,104,37
5,r_70_13_70,r_36_116_105,r_137_62_84,r_70_13_70,0.47,19,89,70,37
58,seq44,r_53_71_63,r_85_82_8,r_53_71_63,0.63,-39,24,63,37
3,r_129_117_193,r_38_114_97,r_37_39_196,r_38_114_97,0.92,-7,90,97,37
10,r_124_29_137,seq65,seq125,r_124_29_137,0.55,0,137,137,37
0,r_66_77_22,r_104_23_77,seq30,r_66_77_22,0.78,1,23,22,37
11,r_4_119_54,seq125,seq89,r_4_119_54,1.0,1,55,54,37
12,r_48_5_24,r_61_98_184,seq136,r_48_5_24,0.83,0,24,24,37
16,r_35_75_57,r_129_117_193,seq87,r_35_75_57,1.0,0,57,57,37
15,r_104_23_77,seq110,seq106,r_104_23_77,0.99,2,79,77,37
57,seq134,r_127_20_133,r_83_3_17,r_127_20_133,0.56,-13,120,133,37
85,seq95,r_45_1_142,r_102_101_72,r_102_101_72,1.0,70,142,72,37
34,r_49_25_13,r_53_71_63,r_37_39_196,r_49_25_13,0.94,3,16,13,37
2,r_43_41_143,seq87,seq27,r_43_41_143,0.73,1,144,143,37
24,r_102_101_72,seq81,seq50,r_102_101_72,1.0,0,72,72,37
38,r_28_0_11,r_49_25_13,seq92,r_28_0_11,0.92,0,11,11,37
25,r_38_114_97,r_129_117_193,r_109_21_6,r_38_114_97,0.92,0,97,97,37
33,r_130_121_101,seq47,r_37_39_196,r_130_121_101,0.88,0,101,101,37
27,r_83_3_17,r_4_119_54,seq134,r_83_3_17,0.65,1,18,17,37
88,seq100,seq27,r_137_62_84,r_137_62_84,1.0,5,89,84,37
20,r_99_133_38,seq58,seq52,r_99_133_38,1.0,0,38,38,37
61,seq50,r_45_1_142,r_102_101_72,r_102_101_72,1.0,55,127,72,37
32,r_8_67_191,r_61_98_184,r_36_116_105,r_8_67_191,0.34,-3,188,191,37
29,r_63_111_48,seq76,seq33,r_63_111_48,0.98,0,48,48,37
60,seq47,r_108_15_81,r_7_55_104,r_7_55_104,1.0,17,121,104,37
17,r_109_21_6,seq96,r_38_114_97,r_38_114_97,0.97,14,111,97,37
9,r_127_20_133,seq136,r_102_101_72,r_102_101_72,0.58,62,134,72,37
18,r_78_94_52,seq96,seq58,r_78_94_52,0.8,1,53,52,37
7,r_68_131_121,seq27,r_49_25_13,r_49_25_13,0.76,22,35,13,37
28,r_72_26_141,seq69,r_42_120_135,r_72_26_141,0.86,0,141,141,37
23,r_61_98_184,r_8_67_191,r_22_59_20,r_22_59_20,0.46,168,188,20,37
79,seq87,r_43_41_143,r_35_75_57,r_35_75_57,0.87,87,144,57,37
35,r_138_34_62,seq73,seq123,r_138_34_62,0.92,0,62,62,37
92,seq116,r_105_67_176,r_63_123_163,r_63_123_163,0.48,13,176,163,38
14,r_44_138_118,r_63_123_163,r_33_48_83,r_44_138_118,0.93,1,119,118,38
8,r_72_85_76,r_114_5_10,r_82_30_29,r_114_5_10,0.95,66,76,10,38
86,seq98,r_51_29_127,seq45,r_51_29_127,1.0,-28,99,127,38
16,r_12_69_170,seq8,seq2,r_12_69_170,0.55,0,170,170,38
21,r_37_100_96,seq130,r_64_79_89,r_37_100_96,0.99,0,96,96,38
39,r_57_96_63,r_109_104_187,seq13,r_57_96_63,1.0,0,63,63,38
18,r_91_46_49,seq0,r_114_5_10,r_91_46_49,1.0,1,50,49,38
24,r_93_89_7,seq66,r_80_32_152,r_80_32_152,0.52,8,160,152,38
5,r_80_32_152,seq35,r_14_126_147,r_80_32_152,0.88,0,152,152,38
37,r_94_102_21,seq19,seq71,r_94_102_21,0.91,0,21,21,38
12,r_106_42_184,r_84_133_97,r_105_67_176,r_105_67_176,0.63,2,178,176,38
24,r_93_89_7,r_62_60_122,seq66,r_62_60_122,0.99,2,124,122,38
27,r_117_70_103,r_73_90_190,r_9_136_65,r_9_136_65,0.8,125,190,65,38
38,r_73_90_190,r_117_70_103,r_87_76_3,r_87_76_3,0.79,187,190,3,38
62,seq34,r_62_60_122,r_114_5_10,r_62_60_122,1.0,-66,56,122,38
80,seq71,seq130,r_94_102_21,r_94_102_21,0.67,18,39,21,38
10,r_92_129_156,seq121,seq49,r_92_129_156,0.59,0,156,156,38
72,seq49,seq21,r_92_129_156,r_92_129_156,0.82,6,162,156,38
63,seq35,r_80_32_152,r_41_31_73,r_41_31_73,0.96,79,152,73,38
11,r_84_133_97,r_92_129_156,seq131,r_84_133_97,0.96,0,97,97,38
13,r_9_136_65,seq45,seq135,r_9_136_65,1.0,0,65,65,38
15,r_101_59_78,r_114_5_10,seq116,r_101_59_78,0.99,1,79,78,38
48,seq137,r_97_55_181,r_33_48_83,r_33_48_83,1.0,99,182,83,38
6,r_33_48_83,r_80_32_152,seq22,r_33_48_83,0.95,0,83,83,38
27,r_117_70_103,seq137,r_73_90_190,r_117_70_103,1.0,0,103,103,38
2,r_41_31_73,seq17,seq134,r_41_31_73,1.0,1,74,73,38
29,r_64_79_89,seq78,seq22,r_64_79_89,1.0,0,89,89,38
25,r_4_10_114,r_112_99_9,seq8,r_4_10_114,0.99,1,115,114,38
33,r_25_26_177,r_125_54_198,seq132,r_25_26_177,0.64,0,177,177,38
34,r_128_108_14,r_80_32_152,seq66,r_128_108_14,0.99,0,14,14,38
70,seq45,r_9_136_65,seq98,r_9_136_65,1.0,1,66,65,38
65,seq134,r_110_81_95,r_41_31_73,r_41_31_73,1.0,34,107,73,38
38,r_73_90_190,seq122,r_117_70_103,r_117_70_103,1.0,22,125,103,38
17,r_56_7_124,r_112_99_9,seq17,r_56_7_124,0.98,0,124,124,38
31,r_62_60_122,r_93_89_7,r_112_99_9,r_62_60_122,0.78,0,122,122,38
7,r_20_83_142,r_125_54_198,seq6,r_20_83_142,0.81,0,142,142,38
23,r_65_115_165,seq43,seq130,r_65_115_165,0.74,0,165,165,38
98,seq124,r_12_69_170,r_82_30_29,r_82_30_29,0.72,-19,10,29,38
12,r_106_42_184,seq98,r_84_133_97,r_84_133_97,1.0,53,150,97,38
84,seq78,r_64_79_89,r_82_30_29,r_64_79_89,0.77,2,91,89,38
14,r_103_15_132,r_69_19_148,seq40,r_103_15_132,0.95,0,132,132,39
21,r_130_111_17,seq94,seq10,r_130_111_17,1.0,0,17,17,39
8,r_48_105_164,seq119,r_72_73_147,r_48_105_164,0.8,1,165,164,39
37,r_90_17_86,r_48_105_164,seq94,r_48_105_164,0.76,-76,88,164,39
1,r_69_19_148,r_103_15_132,r_16_49_122,r_69_19_148,0.8,-16,132,148,39
5,r_121_110_76,seq95,seq51,r_121_110_76,1.0,0,76,76,39
19,r_60_42_130,seq65,seq39,r_60_42_130,0.98,2,132,130,39
95,seq118,r_7_57_143,r_125_63_179,r_7_57_143,0.99,0,143,143,39
66,seq54,r_12_50_138,seq82,r_12_50_138,0.99,1,139,138,39
26,r_115_20_55,seq34,seq106,r_115_20_55,1.0,1,56,55,39
31,r_117_46_149,r_7_57_143,seq34,r_7_57_143,0.86,-2,141,143,39
10,r_56_24_112,seq86,seq2,r_56_24_112,0.93,0,112,112,39
83,seq95,r_121_110_76,seq54,r_121_110_76,0.98,-20,56,76,39
32,r_70_29_39,r_125_63_179,r_38_61_84,r_70_29_39,1.0,0,39,39,39
20,r_102_22_169,seq92,r_7_57_143,r_102_22_169,0.67,1,170,169,39
13,r_16_49_122,seq65,seq98,r_16_49_122,0.54,5,127,122,39
15,r_127_120_105,seq1,seq37,r_127_120_105,1.0,0,105,105,39
0,r_125_63_179,seq44,seq31,r_125_63_179,0.38,-10,169,179,39
27,r_64_77_178,seq34,r_59_13_5,r_64_77_178,0.41,7,185,178,39
2,r_7_57_143,seq118,r_103_15_132,r_7_57_143,0.71,0,143,143,39
39,r_55_25_21,r_53_6_195,seq26,r_55_25_21,1.0,-1,20,21,39
74,seq83,r_72_73_147,r_59_13_5,r_72_73_147,0.96,0,147,147,39
18,r_4_3_78,seq51,seq134,r_4_3_78,1.0,0,78,78,39
24,r_11_27_87,r_58_89_173,seq26,r_11_27_87,1.0,0,87,87,39
11,r_78_97_43,r_45_21_64,r_53_6_195,r_53_6_195,1.0,-152,43,195,39
25,r_76_133_107,seq68,seq23,r_76_133_107,1.0,1,108,107,39
51,seq26,r_55_25_21,r_11_27_87,r_11_27_87,1.0,8,95,87,39
70,seq65,r_16_49_122,r_45_21_64,r_45_21_64,1.0,37,101,64,39
3,r_132_112_15,seq82,seq1,r_132_112_15,1.0,0,15,15,39
0,r_125_63_179,r_70_29_39,seq44,r_70_29_39,1.0,0,39,39,39
17,r_71_30_75,r_69_19_148,seq109,r_71_30_75,1.0,0,75,75,39
9,r_74_67_111,seq2,r_4_3_78,r_74_67_111,0.81,0,111,111,39
1,r_69_19_148,r_16_49_122,r_56_24_112,r_69_19_148,0.87,2,150,148,39
22,r_45_21_64,seq136,seq65,r_45_21_64,1.0,0,64,64,39
28,r_72_73_147,seq83,seq54,r_72_73_147,0.92,0,147,147,39
51,seq26,seq109,r_55_25_21,r_55_25_21,0.56,31,52,21,39
7,r_0_18_154,seq2,r_66_116_4,r_0_18_154,0.45,0,154,154,39
23,r_91_123_161,seq65,seq104,r_91_123_161,0.56,7,168,161,39
35,r_129_5_85,seq83,seq51,r_129_5_85,1.0,0,85,85,39
12,r_12_50_138,seq54,seq9,r_12_50_138,0.96,1,139,138,39
30,r_8_119_105,seq5,r_127_36_180,r_8_119_105,0.73,5,110,105,40
36,r_81_128_70,seq27,seq125,r_81_128_70,1.0,1,71,70,40
13,r_19_121_127,r_69_59_19,seq87,r_19_121_127,0.6,-103,24,127,40
8,r_85_133_65,r_15_75_168,seq138,r_85_133_65,0.95,0,65,65,40
37,r_72_18_155,r_40_137_163,seq27,r_72_18_155,0.78,-2,153,155,40
71,seq138,r_74_139_187,r_85_133_65,r_85_133_65,0.98,122,187,65,40
16,r_127_36_180,seq54,r_8_119_105,r_127_36_180,0.43,-104,76,180,40
21,r_41_11_62,seq126,seq57,r_41_11_62,1.0,0,62,62,40
1,r_17_29_86,seq87,seq58,r_17_29_86,0.87,0,86,86,40
5,r_3_32_79,r_82_49_91,r_44_113_11,r_3_32_79,0.42,0,79,79,40
35,r_132_16_27,r_3_32_79,seq63,r_132_16_27,0.94,3,30,27,40
76,seq67,seq34,r_26_90_88,r_26_90_88,0.99,8,96,88,40
39,r_48_22_17,r_40_137_163,r_45_98_7,r_40_137_163,0.75,1,164,163,40
31,r_106_80_130,r_60_120_147,seq126,r_106_80_130,0.95,1,131,130,40
67,seq54,r_127_36_180,seq126,r_127_36_180,0.76,-12,168,180,40
6,r_61_46_31,r_17_29_86,r_82_49_91,r_61_46_31,0.97,0,31,31,40
10,r_108_109_55,seq87,seq31,r_108_109_55,0.98,11,66,55,40
16,r_127_36_180,r_8_119_105,r_82_49_91,r_127_36_180,0.59,-3,177,180,40
14,r_56_70_24,r_96_24_162,seq2,r_56_70_24,1.0,0,24,24,40
4,r_60_120_147,r_106_80_130,r_25_95_119,r_60_120_147,0.7,-16,131,147,40
78,seq71,r_96_24_162,r_86_88_9,r_96_24_162,0.78,0,162,162,40
0,r_15_75_168,r_85_133_65,r_117_116_63,r_15_75_168,0.93,-103,65,168,40
11,r_97_37_125,r_47_110_148,seq68,r_97_37_125,0.84,5,130,125,40
39,r_48_22_17,r_9_131_166,r_40_137_163,r_48_22_17,0.92,-3,14,17,40
20,r_78_77_134,seq57,seq87,r_78_77_134,0.37,2,136,134,40
4,r_60_120_147,r_25_95_119,seq14,r_25_95_119,0.84,31,150,119,40
98,seq125,seq31,r_81_128_70,r_81_128_70,1.0,2,72,70,40
15,r_0_130_74,seq14,seq136,r_0_130_74,1.0,0,74,74,40
48,seq13,r_101_115_192,r_25_95_119,r_25_95_119,0.91,13,132,119,40
25,r_69_59_19,r_19_121_127,seq79,r_69_59_19,0.82,1,20,19,40
13,r_19_121_127,seq87,seq5,r_19_121_127,0.97,0,127,127,40
38,r_40_137_163,r_48_22_17,seq111,r_48_22_17,0.59,147,164,17,40
27,r_84_4_54,seq129,seq2,r_84_4_54,1.0,2,56,54,40
99,seq126,r_41_11_62,r_8_119_105,r_41_11_62,1.0,0,62,62,40
42,seq5,seq51,r_19_121_127,r_19_121_127,0.89,3,130,127,40
0,r_15_75_168,r_117_116_63,r_81_128_70,r_117_116_63,0.51,111,174,63,40
91,seq111,seq65,r_1_92_126,r_1_92_126,0.79,6,132,126,40
23,r_44_113_11,r_50_107_128,seq66,r_44_113_11,0.85,1,12,11,40
30,r_8_119_105,r_127_36_180,seq126,r_8_119_105,0.68,72,177,105,40
18,r_25_95_119,r_9_131_166,seq13,r_25_95_119,0.79,0,119,119,40
29,r_1_92_126,seq53,seq111,r_1_92_126,0.81,0,126,126,40
33,r_26_90_88,r_82_49_91,seq67,r_82_49_91,0.68,-2,89,91,40
70,seq58,r_82_49_91,r_17_29_86,r_82_49_91,0.86,1,92,91,40
6,r_61_46_31,r_82_49_91,r_17_29_86,r_61_46_31,0.66,61,92,31,40
32,r_117_116_63,seq138,r_15_75_168,r_117_116_63,0.97,2,65,63,40
38,r_40_137_163,r_64_99_131,r_48_22_17,r_40_137_163,0.57,-23,140,163,40
9,r_45_98_7,seq58,r_64_99_131,r_64_99_131,0.76,2,133,131,40
22,r_82_49_91,seq58,seq35,r_82_49_91,1.0,1,92,91,40
28,r_64_99_131,r_40_137_163,r_45_98_7,r_64_99_131,0.65,9,140,131,40
7,r_6_91_99,seq111,seq102,r_6_91_99,0.94,4,103,99,40
4,r_60_120_147,seq14,r_9_131_166,r_60_120_147,0.44,16,163,147,40
12,r_50_107_128,seq38,seq102,r_50_107_128,0.88,0,128,128,40
26,r_40_14_27,seq48,seq93,r_40_14_27,1.0,0,27,27,41
92,seq110,seq2,r_114_53_115,r_114_53_115,0.76,0,115,115,41
8,r_103_46_186,seq121,r_85_86_133,r_85_86_133,0.55,53,186,133,41
87,seq97,seq15,r_137_73_33,r_137_73_33,1.0,7,40,33,41
37,r_123_115_77,seq77,seq6,r_123_115_77,0.99,2,79,77,41
39,r_34_100_90,seq15,seq2,r_34_100_90,0.97,0,90,90,41
97,seq121,r_103_46_186,seq42,r_103_46_186,0.62,0,186,186,41
21,r_11_50_57,r_117_54_18,r_83_70_76,r_83_70_76,1.0,12,88,76,41
5,r_134_80_96,r_127_69_179,seq94,r_134_80_96,1.0,1,97,96,41
46,seq8,seq138,r_85_86_133,r_85_86_133,1.0,3,136,133,41
80,seq84,r_18_0_163,seq6,r_18_0_163,0.99,-59,104,163,41
19,r_127_69_179,seq130,r_58_107_126,r_127_69_179,0.65,1,180,179,41
27,r_38_9_50,seq30,seq29,r_38_9_50,1.0,1,51,50,41
20,r_137_73_33,r_78_49_172,seq97,r_137_73_33,1.0,0,33,33,41
67,seq52,r_62_37_65,r_123_115_77,r_123_115_77,0.87,54,131,77,41
67,seq52,r_135_59_48,r_62_37_65,r_135_59_48,1.0,0,48,48,41
3,r_82_75_66,r_57_108_136,r_117_54_18,r_82_75_66,1.0,1,67,66,41
34,r_135_59_48,seq52,seq56,r_135_59_48,1.0,0,48,48,41
72,seq67,seq15,r_96_106_72,r_96_106_72,1.0,0,72,72,41
22,r_116_124_124,seq64,seq88,r_116_124_124,1.0,0,124,124,41
78,seq79,r_20_101_174,r_135_59_48,r_135_59_48,1.0,126,174,48,41
0,r_18_0_163,seq36,seq109,r_18_0_163,0.77,0,163,163,41
11,r_58_107_126,seq136,seq56,r_58_107_126,0.99,0,126,126,41
15,r_33_35_171,seq23,seq84,r_33_35_171,0.62,-1,170,171,41
6,r_83_70_76,r_41_4_84,r_11_50_57,r_83_70_76,0.98,1,77,76,41
62,seq36,r_18_0_163,seq6,r_18_0_163,0.98,0,163,163,41
30,r_87_55_36,r_135_59_48,seq76,r_87_55_36,0.73,4,40,36,41
40,seq128,seq60,r_43_47_83,r_43_47_83,0.95,45,128,83,41
74,seq130,r_127_69_179,r_85_86_133,r_85_86_133,0.98,47,180,133,41
29,r_78_49_172,seq68,r_40_14_27,r_78_49_172,0.47,2,174,172,41
24,r_20_101_174,seq79,r_105_44_134,r_20_101_174,0.42,0,174,174,41
25,r_85_86_133,seq94,seq8,r_85_86_133,0.99,0,133,133,41
33,r_72_63_128,seq109,r_43_47_83,r_72_63_128,0.52,5,133,128,41
7,r_104_5_170,r_98_112_116,r_114_53_115,r_104_5_170,0.85,0,170,170,41
32,r_65_1_102,seq8,seq30,r_65_1_102,1.0,0,102,102,41
38,r_10_125_160,r_78_49_172,seq6,r_10_125_160,0.61,2,162,160,41
52,seq17,r_98_112_116,seq7,r_98_112_116,0.92,1,117,116,41
21,r_11_50_57,seq138,r_117_54_18,r_11_50_57,0.99,0,57,57,41
81,seq88,seq136,r_116_124_124,r_116_124_124,1.0,0,124,124,41
17,r_114_53_115,seq3,seq110,r_114_53_115,0.89,0,115,115,41
37,r_123_115_77,seq6,r_105_44_134,r_105_44_134,1.0,17,151,134,41
22,r_116_124_124,r_41_4_84,seq64,r_41_4_84,1.0,0,84,84,41
28,r_98_112_116,seq17,r_104_5_170,r_98_112_116,0.81,0,116,116,41
91,seq109,r_72_63_128,seq132,r_72_63_128,0.52,5,133,128,41
56,seq23,r_57_108_136,seq76,r_57_108_136,1.0,0,136,136,41
7,r_104_5_170,seq110,r_98_112_116,r_98_112_116,0.72,1,117,116,41
23,r_96_106_72,r_41_4_84,seq67,r_96_106_72,0.96,1,73,72,41
82,seq89,seq15,r_117_54_18,r_117_54_18,1.0,56,74,18,41
35,r_26_71_131,seq68,seq15,r_26_71_131,0.84,0,131,131,41
12,r_57_108_136,seq23,seq131,r_57_108_136,0.95,1,137,136,41
93,seq110,r_75_102_124,seq63,r_75_102_124,0.82,12,136,124,42
6,r_67_91_20,seq131,seq35,r_67_91_20,1.0,0,20,20,42
92,seq109,r_90_101_64,r_73_44_80,r_90_101_64,0.81,0,64,64,42
14,r_4_62_199,r_8_11_127,r_52_32_105,r_4_62_199,0.92,-89,110,199,42
8,r_83_15_140,seq43,seq60,r_83_15_140,0.81,1,141,140,42
7,r_103_120_31,seq69,seq17,r_103_120_31,0.99,0,31,31,42
54,seq20,r_9_26_133,seq43,r_9_26_133,1.0,0,133,133,42
37,r_76_100_69,seq81,seq35,r_76_100_69,1.0,0,69,69,42
28,r_55_88_38,seq94,r_65_86_63,r_65_86_63,0.88,21,84,63,42
15,r_34_87_22,seq2,r_16_48_115,r_34_87_22,0.77,0,22,22,42
16,r_61_111_102,r_46_77_134,seq53,r_61_111_102,1.0,0,102,102,42
1,r_116_58_175,r_73_44_80,seq6,r_116_58_175,0.68,5,180,175,42
1,r_116_58_175,r_8_11_127,r_73_44_80,r_8_11_127,0.99,-17,110,127,42
5,r_121_22_147,seq107,seq133,r_121_22_147,0.88,1,148,147,42
19,r_90_101_64,seq109,r_112_24_29,r_90_101_64,1.0,0,64,64,42
66,seq43,r_83_15_140,r_134_135_32,r_83_15_140,0.7,-77,63,140,42
31,r_52_32_105,seq35,r_4_62_199,r_52_32_105,1.0,0,105,105,42
20,r_119_37_35,r_61_111_102,seq105,r_119_37_35,0.63,-2,33,35,42
3,r_27_117_187,seq105,seq20,r_27_117_187,0.38,0,187,187,42
4,r_132_78_139,seq123,seq124,r_132_78_139,0.98,0,139,139,42
0,r_29_113_130,seq82,seq2,r_29_113_130,0.98,1,131,130,42
73,seq63,r_68_71_106,seq110,r_68_71_106,1.0,-15,91,106,42
11,r_10_115_150,seq72,seq0,r_10_115_150,0.89,0,150,150,42
85,seq94,r_16_48_115,r_55_88_38,r_55_88_38,0.89,6,44,38,42
91,seq108,seq41,r_51_1_15,r_51_1_15,0.8,29,44,15,42
29,r_104_56_12,r_112_24_29,seq81,r_104_56_12,0.99,2,14,12,42
28,r_55_88_38,r_112_24_29,seq94,r_55_88_38,1.0,0,38,38,42
15,r_34_87_22,r_16_48_115,r_57_64_61,r_57_64_61,0.68,15,76,61,42
36,r_51_1_15,r_67_91_20,seq108,r_51_1_15,1.0,0,15,15,42
2,r_65_86_63,r_132_78_139,r_55_88_38,r_65_86_63,0.96,1,64,63,42
18,r_125_19_168,seq85,r_104_56_12,r_125_19_168,0.69,0,168,168,42
25,r_16_48_115,seq42,seq41,r_16_48_115,0.51,3,118,115,42
33,r_8_11_127,r_116_58_175,seq30,r_8_11_127,0.98,0,127,127,42
70,seq53,seq131,r_61_111_102,r_61_111_102,1.0,6,108,102,42
32,r_99_92_145,r_70_36_97,seq110,r_99_92_145,0.93,0,145,145,42
34,r_9_26_133,seq20,seq81,r_9_26_133,0.91,0,133,133,42
24,r_134_135_32,r_9_26_133,seq43,r_9_26_133,0.81,-99,34,133,42
17,r_95_39_131,seq131,seq42,r_95_39_131,0.76,0,131,131,42
9,r_46_77_134,seq126,r_57_64_61,r_46_77_134,0.81,0,134,134,42
96,seq123,r_132_78_139,seq33,r_132_78_139,1.0,0,139,139,42
22,r_57_64_61,seq20,r_34_87_22,r_57_64_61,1.0,1,62,61,42
23,r_59_18_71,r_27_117_187,r_90_101_64,r_59_18_71,1.0,1,72,71,42
82,seq85,r_125_19_168,r_76_100_69,r_76_100_69,1.0,99,168,69,42
35,r_68_71_106,seq63,seq118,r_68_71_106,1.0,0,106,106,42
39,r_97_3_42,seq124,seq105,r_97_3_42,1.0,0,42,42,42
36,r_120_73_153,seq79,seq46,r_120_73_153,0.89,0,153,153,43
16,r_39_118_14,seq106,r_56_69_98,r_39_118_14,0.97,0,14,14,43
14,r_71_86_107,seq52,r_98_128_63,r_71_86_107,0.99,0,107,107,43
8,r_47_10_112,seq1,seq49,r_47_10_112,1.0,0,112,112,43
4,r_67_75_51,seq88,seq130,r_67_75_51,0.99,2,53,51,43
37,r_8_114_179,seq59,r_94_18_89,r_94_18_89,1.0,92,181,89,43
5,r_84_63_74,r_56_69_98,seq19,r_84_63_74,0.97,0,74,74,43
15,r_23_42_41,r_65_58_167,seq52,r_23_42_41,1.0,1,42,41,43
0,r_17_76_49,r_11_117_92,r_23_42_41,r_11_117_92,0.95,-43,49,92,43
19,r_105_37_102,seq130,seq108,r_105_37_102,0.42,4,106,102,43
31,r_11_117_92,seq49,seq25,r_11_117_92,1.0,1,93,92,43
21,r_66_133_20,r_56_69_98,seq96,r_66_133_20,0.92,0,20,20,43
10,r_15_27_173,seq87,seq122,r_15_27_173,0.61,0,173,173,43
28,r_60_57_33,r_105_37_102,seq49,r_60_57_33,1.0,0,33,33,43
26,r_110_125_76,seq5,r_39_118_14,r_110_125_76,1.0,0,76,76,43
16,r_39_118_14,r_56_69_98,r_94_18_89,r_39_118_14,0.92,86,100,14,43
78,seq85,r_100_61_183,seq54,r_100_61_183,0.42,2,185,183,43
11,r_7_97_61,seq38,seq25,r_7_97_61,1.0,0,61,61,43
20,r_112_111_147,r_40_115_161,r_45_29_58,r_40_115_161,0.86,-14,147,161,43
13,r_138_26_170,seq12,r_15_27_173,r_138_26_170,0.78,5,175,170,43
3,r_132_14_45,seq109,seq103,r_132_14_45,1.0,5,50,45,43
2,r_16_9_185,seq21,r_138_26_170,r_138_26_170,0.64,15,185,170,43
35,r_45_29_58,seq49,r_112_111_147,r_112_111_147,0.99,0,147,147,43
25,r_64_41_136,seq30,seq28,r_64_41_136,0.93,0,136,136,43
33,r_40_115_161,seq30,r_84_63_74,r_84_63_74,0.98,91,165,74,43
88,seq103,seq121,r_132_14_45,r_132_14_45,0.99,61,106,45,43
32,r_116_82_166,seq59,r_94_18_89,r_94_18_89,1.0,80,169,89,43
38,r_100_61_183,r_74_99_182,r_68_50_148,r_100_61_183,0.54,-1,182,183,43
34,r_68_50_148,seq135,seq5,r_68_50_148,0.99,0,148,148,43
75,seq79,r_120_73_153,r_94_18_89,r_94_18_89,0.97,64,153,89,43
9,r_56_69_98,r_55_80_141,seq49,r_56_69_98,0.98,2,100,98,43
22,r_74_99_182,r_100_61_183,r_94_18_89,r_94_18_89,1.0,93,182,89,43
56,seq30,r_64_41_136,r_94_18_89,r_94_18_89,0.69,47,136,89,43
7,r_94_18_89,r_100_61_183,seq30,r_94_18_89,1.0,0,89,89,43
23,r_34_113_115,seq5,seq43,r_34_113_115,1.0,0,115,115,43
35,r_45_29_58,seq109,seq49,r_45_29_58,0.99,3,61,58,43
12,r_91_13_120,r_40_115_161,seq127,r_40_115_161,0.83,-41,120,161,43
30,r_62_137_28,seq33,seq21,r_62_137_28,0.99,0,28,28,43
30,r_136_134_190,r_46_5_162,r_17_13_153,r_136_134_190,0.37,-25,165,190,44
36,r_18_67_124,seq53,seq49,r_18_67_124,1.0,0,124,124,44
16,r_107_115_87,r_126_106_144,seq85,r_126_106_144,0.7,-130,14,144,44
14,r_17_13_153,seq116,r_136_134_190,r_17_13_153,0.36,0,153,153,44
79,seq80,seq0,r_99_28_97,r_99_28_97,0.95,9,106,97,44
8,r_34_131_107,seq101,r_64_132_167,r_34_131_107,0.91,1,108,107,44
38,r_86_91_32,seq4,seq93,r_86_91_32,0.5,-7,25,32,44
37,r_46_5_162,r_136_134_190,r_99_28_97,r_46_5_162,0.46,0,162,162,44
21,r_105_12_113,seq137,seq8,r_105_12_113,0.87,0,113,113,44
29,r_15_24_13,r_126_106_144,r_98_77_3,r_15_24_13,0.86,0,13,13,44
1,r_59_50_22,r_120_124_177,r_29_69_62,r_29_69_62,1.0,115,177,62,44
30,r_136_134_190,r_17_13_153,seq119,r_136_134_190,0.82,0,190,190,44
15,r_58_3_178,seq9,r_6_84_142,r_58_3_178,0.82,1,179,178,44
66,seq53,seq61,r_7_81_24,r_7_81_24,1.0,72,96,24,44
31,r_36_70_75,r_58_3_178,r_127_37_68,r_127_37_68,1.0,4,72,68,44
10,r_89_26_165,seq8,r_66_30_10,r_89_26_165,0.6,0,165,165,44
26,r_64_132_167,seq40,r_34_131_107,r_34_131_107,1.0,7,114,107,44
23,r_120_124_177,r_16_68_133,r_59_50_22,r_59_50_22,0.87,20,42,22,44
17,r_7_81_24,seq19,seq53,r_7_81_24,0.97,0,24,24,44
4,r_94_87_64,seq137,seq61,r_94_87_64,1.0,0,64,64,44
0,r_96_62_103,seq101,seq71,r_96_62_103,0.94,0,103,103,44
73,seq71,seq44,r_96_62_103,r_96_62_103,1.0,17,120,103,44
5,r_52_42_39,r_17_13_153,seq90,r_52_42_39,1.0,1,40,39,44
20,r_99_28_97,seq56,seq80,r_99_28_97,1.0,0,97,97,44
13,r_127_37_68,r_120_124_177,r_36_70_75,r_127_37_68,1.0,1,69,68,44
16,r_107_115_87,r_59_50_22,r_66_30_10,r_107_115_87,1.0,0,87,87,44
15,r_58_3_178,r_36_70_75,seq9,r_58_3_178,0.68,-101,77,178,44
6,r_125_108_66,r_22_73_143,r_15_24_13,r_15_24_13,0.85,58,71,13,44
97,seq119,r_35_65_116,r_51_20_98,r_35_65_116,0.63,-16,100,116,44
16,r_107_115_87,seq85,r_59_50_22,r_59_50_22,0.91,17,39,22,44
83,seq90,seq8,r_52_42_39,r_52_42_39,0.96,2,41,39,44
47,seq9,r_58_3_178,r_127_37_68,r_127_37_68,1.0,113,181,68,44
40,seq0,seq90,r_35_65_116,r_35_65_116,0.97,26,142,116,44
1,r_59_50_22,seq48,r_120_124_177,r_59_50_22,0.96,0,22,22,44
24,r_51_20_98,r_64_132_167,seq119,r_51_20_98,0.97,-5,93,98,44
25,r_23_43_117,r_35_65_116,seq122,r_23_43_117,0.96,2,119,117,44
70,seq61,seq53,r_94_87_64,r_94_87_64,1.0,32,96,64,44
8,r_34_131_107,r_64_132_167,r_125_108_66,r_64_132_167,1.0,0,167,167,44
9,r_2_113_53,seq119,seq122,r_2_113_53,0.99,1,54,53,44
26,r_64_132_167,r_34_131_107,seq130,r_64_132_167,1.0,0,167,167,44
34,r_35_65_116,r_23_43_117,seq78,r_35_65_116,0.89,3,119,116,44
7,r_123_83_43,r_16_68_133,seq31,r_123_83_43,1.0,0,43,43,44
2,r_29_69_62,seq9,r_59_50_22,r_29_69_62,0.99,1,63,62,44
33,r_66_30_10,r_99_28_97,seq135,r_66_30_10,0.69,0,10,10,44
50,seq19,r_7_81_24,seq33,r_7_81_24,0.9,0,24,24,44
35,r_6_84_142,seq95,seq32,r_6_84_142,0.92,0,142,142,44
12,r_100_103_69,seq137,seq116,r_100_103_69,0.99,0,69,69,44
2,r_29_69_62,r_25_14_36,seq9,r_25_14_36,0.9,0,36,36,44
23,r_120_124_177,r_59_50_22,r_96_62_103,r_120_124_177,0.74,0,177,177,44
93,seq114,r_46_72_90,r_25_24_164,r_46_72_90,0.71,-30,60,90,45
30,r_117_77_64,r_16_35_32,seq136,r_117_77_64,0.68,59,123,64,45
14,r_95_88_107,r_21_92_134,seq36,r_21_92_134,0.67,-27,107,134,45
8,r_129_27_140,r_8_98_168,seq40,r_129_27_140,1.0,0,140,140,45
43,seq4,r_80_48_125,seq73,r_80_48_125,1.0,0,125,125,45
37,r_1_11_83,r_130_116_94,seq105,r_1_11_83,0.89,1,84,83,45
16,r_20_64_124,seq126,seq0,r_20_64_124,0.95,0,124,124,45
21,r_21_92_134,r_95_88_107,r_9_3_39,r_9_3_39,0.61,32,71,39,45
39,r_63_69_91,seq53,r_67_75_6,r_63_69_91,0.9,1,92,91,45
1,r_9_3_39,r_21_92_134,seq62,r_21_92_134,1.0,0,134,134,45
5,r_22_139_73,seq31,seq49,r_22_139_73,1.0,0,73,73,45
80,seq87,r_117_77_64,seq79,r_117_77_64,0.75,5,69,64,45
32,r_56_32_171,r_19_125_92,seq114,r_19_125_92,0.68,83,175,92,45
69,seq57,r_8_98_168,seq55,r_8_98_168,0.96,1,169,168,45
9,r_29_52_51,seq36,seq18,r_29_52_51,1.0,1,52,51,45
76,seq76,r_7_127_170,seq102,r_7_127_170,0.8,1,171,170,45
31,r_60_14_69,seq73,seq122,r_60_14_69,1.0,0,69,69,45
67,seq54,seq122,r_130_116_94,r_130_116_94,1.0,6,100,94,45
23,r_43_71_26,seq49,seq36,r_43_71_26,1.0,0,26,26,45
4,r_33_97_74,seq45,seq107,r_33_97_74,1.0,0,74,74,45
0,r_16_35_32,r_117_77_64,seq79,r_117_77_64,0.7,5,69,64,45
11,r_130_116_94,r_7_127_170,seq54,r_130_116_94,1.0,0,94,94,45
20,r_8_98_168,seq57,r_130_116_94,r_130_116_94,1.0,75,169,94,45
15,r_103_132_89,seq17,r_104_28_71,r_103_132_89,1.0,0,89,89,45
27,r_47_81_138,r_1_11_83,seq59,r_47_81_138,0.98,1,139,138,45
6,r_101_78_166,seq102,r_9_3_39,r_101_78_166,0.58,0,166,166,45
21,r_21_92_134,r_9_3_39,r_63_69_91,r_21_92_134,0.95,0,134,134,45
85,seq102,r_101_78_166,seq76,r_101_78_166,0.82,0,166,166,45
99,seq126,r_20_64_124,r_104_28_71,r_20_64_124,0.72,-38,86,124,45
27,r_47_81_138,r_108_121_101,r_1_11_83,r_47_81_138,0.7,-49,89,138,45
2,r_5_68_189,seq126,r_16_35_32,r_16_35_32,0.66,157,189,32,45
54,seq36,r_29_52_51,r_43_71_26,r_43_71_26,0.51,0,26,26,45
93,seq114,r_25_24_164,r_56_32_171,r_25_24_164,0.75,1,165,164,45
18,r_26_10_128,seq93,seq138,r_26_10_128,1.0,0,128,128,45
24,r_128_134_56,seq39,r_95_88_107,r_95_88_107,0.8,12,119,107,45
54,seq36,r_43_71_26,r_95_88_107,r_95_88_107,0.89,-23,84,107,45
39,r_63_69_91,r_67_75_6,r_21_92_134,r_21_92_134,1.0,1,135,134,45
65,seq51,seq40,r_108_121_101,r_108_121_101,1.0,18,119,101,45
25,r_135_85_58,r_137_124_79,seq53,r_135_85_58,0.98,0,58,58,45
32,r_56_32_171,seq62,r_19_125_92,r_19_125_92,0.93,11,103,92,45
1,r_9_3_39,seq62,r_101_78_166,r_9_3_39,0.59,139,178,39,45
28,r_19_125_92,r_56_32_171,seq136,r_56_32_171,0.94,4,175,171,45
7,r_108_121_101,seq83,seq51,r_108_121_101,1.0,1,102,101,45
23,r_43_71_26,seq36,r_128_134_56,r_128_134_56,0.66,51,107,56,45
1,r_9_3_39,r_63_69_91,r_21_92_134,r_9_3_39,0.6,1,40,39,45
93,seq102,seq86,r_71_85_105,r_71_85_105,0.98,8,113,105,46
36,r_69_42_109,r_16_49_117,r_135_98_59,r_135_98_59,1.0,16,75,59,46
8,r_32_66_188,seq131,r_40_83_72,r_32_66_188,0.42,-1,187,188,46
43,seq131,r_32_66_188,r_71_85_105,r_71_85_105,0.93,84,189,105,46
37,r_106_78_189,seq12,seq58,r_106_78_189,0.21,1,190,189,46
86,seq81,seq51,r_117_55_85,r_117_55_85,1.0,13,98,85,46
16,r_50_74_158,seq120,r_37_48_11,r_37_48_11,1.0,150,161,11,46
97,seq120,r_50_74_158,r_79_97_65,r_79_97_65,1.0,96,161,65,46
68,seq46,r_71_85_105,r_8_112_39,r_71_85_105,0.9,-61,44,105,46
35,r_135_98_59,seq131,seq27,r_135_98_59,1.0,0,59,59,46
21,r_127_104_21,seq80,seq24,r_127_104_21,0.84,11,32,21,46
13,r_124_94_51,r_69_42_109,seq54,r_124_94_51,1.0,0,51,51,46
2,r_134_114_50,r_116_103_110,seq87,r_134_114_50,1.0,0,50,50,46
3,r_73_125_167,r_40_83_72,r_47_63_156,r_73_125_167,0.99,0,167,167,46
31,r_21_139_56,r_84_13_126,seq123,r_21_139_56,0.47,14,70,56,46
67,seq45,r_15_4_137,seq1,r_15_4_137,1.0,0,137,137,46
36,r_69_42_109,r_135_98_59,r_82_72_6,r_69_42_109,0.91,0,109,109,46
38,r_110_7_45,seq9,seq86,r_110_7_45,1.0,0,45,45,46
3,r_73_125_167,r_84_13_126,r_40_83_72,r_40_83_72,0.63,45,117,72,46
10,r_100_25_145,seq26,seq18,r_100_25_145,0.94,0,145,145,46
0,r_117_55_85,seq19,seq81,r_117_55_85,1.0,0,85,85,46
11,r_71_85_105,seq24,seq102,r_71_85_105,0.99,3,108,105,46
15,r_84_13_126,r_73_125_167,r_21_139_56,r_73_125_167,0.98,-38,129,167,46
57,seq24,r_71_85_105,r_127_104_21,r_71_85_105,0.99,-15,90,105,46
19,r_56_118_199,seq61,r_92_108_60,r_92_108_60,1.0,-1,59,60,46
6,r_10_39_61,r_32_66_188,seq35,r_10_39_61,1.0,0,61,61,46
62,seq35,r_33_3_97,r_105_30_23,r_105_30_23,1.0,0,23,23,46
27,r_76_65_151,r_47_63_156,seq0,r_76_65_151,0.98,0,151,151,46
87,seq86,seq31,r_110_7_45,r_110_7_45,1.0,16,61,45,46
4,r_126_2_49,r_117_55_85,seq54,r_126_2_49,0.64,1,50,49,46
18,r_79_97_65,r_11_93_194,seq120,r_79_97_65,0.98,0,65,65,46
29,r_89_101_181,seq43,r_73_125_167,r_89_101_181,0.54,0,181,181,46
25,r_15_4_137,seq45,seq6,r_15_4_137,0.97,0,137,137,46
58,seq26,r_100_25_145,seq38,r_100_25_145,0.99,0,145,145,46
32,r_116_103_110,seq58,seq122,r_116_103_110,0.81,1,111,110,46
13,r_124_94_51,seq54,r_40_83_72,r_124_94_51,0.59,44,95,51,46
75,seq58,r_116_103_110,r_5_34_161,r_116_103_110,1.0,1,111,110,46
26,r_37_48_11,r_84_13_126,seq61,r_37_48_11,0.74,-1,10,11,46
17,r_111_91_157,seq17,seq132,r_111_91_157,0.76,0,157,157,46
22,r_47_63_156,r_75_28_129,seq38,r_47_63_156,0.79,0,156,156,46
7,r_5_34_161,seq58,r_127_104_21,r_5_34_161,0.72,0,161,161,46
23,r_40_83_72,seq52,r_73_125_167,r_40_83_72,0.81,12,84,72,46
23,r_40_83_72,r_73_125_167,r_16_49_117,r_40_83_72,0.96,95,167,72,46
36,r_135_132_106,seq55,r_110_114_25,r_110_114_25,0.82,87,112,25,47
8,r_48_34_74,seq96,seq75,r_48_34_74,0.54,1,75,74,47
16,r_110_114_25,r_88_128_64,seq113,r_110_114_25,1.0,0,25,25,47
86,seq93,r_90_97_140,r_127_2_94,r_127_2_94,0.99,76,170,94,47
39,r_90_97_140,seq93,r_98_82_65,r_98_82_65,1.0,82,147,65,47
1,r_69_5_96,seq77,r_57_121_76,r_69_5_96,0.75,0,96,96,47
5,r_88_128_64,seq37,seq91,r_88_128_64,0.97,1,65,64,47
19,r_59_23_88,seq73,r_110_114_25,r_59_23_88,0.67,-5,83,88,47
62,seq42,r_6_49_168,r_18_134_16,r_18_134_16,1.0,0,16,16,47
63,seq45,r_59_23_88,r_52_74_36,r_52_74_36,1.0,1,37,36,47
97,seq137,r_89_104_193,r_131_117_114,r_131_117_114,1.0,1,115,114,47
3,r_10_129_146,r_102_31_165,r_136_72_12,r_102_31_165,0.63,-18,147,165,47
26,r_118_79_180,seq7,r_92_83_51,r_118_79_180,0.45,0,180,180,47
0,r_38_21_183,seq94,r_48_34_74,r_48_34_74,0.67,110,184,74,47
11,r_68_33_128,r_6_49_168,r_70_105_69,r_70_105_69,0.9,61,130,69,47
20,r_70_105_69,r_86_0_198,seq46,r_70_105_69,0.96,0,69,69,47
13,r_120_39_148,seq40,r_48_34_74,r_120_39_148,0.71,0,148,148,47
98,seq122,r_6_49_168,r_27_19_84,r_27_19_84,1.0,84,168,84,47
15,r_98_82_65,seq91,seq41,r_98_82_65,1.0,0,65,65,47
6,r_6_49_168,seq122,r_135_132_106,r_6_49_168,0.63,0,168,168,47
23,r_18_134_16,r_131_117_114,seq42,r_18_134_16,1.0,0,16,16,47
85,seq91,r_98_82_65,r_88_128_64,r_98_82_65,0.51,0,65,65,47
46,seq139,r_38_21_183,r_61_124_52,r_61_124_52,1.0,-1,51,52,47
31,r_133_44_49,seq137,seq91,r_133_44_49,1.0,-1,48,49,47
37,r_61_124_52,r_43_125_195,seq139,r_61_124_52,1.0,0,52,52,47
27,r_11_123_83,seq41,seq3,r_11_123_83,1.0,0,83,83,47
18,r_108_119_17,r_92_83_51,r_18_134_16,r_92_83_51,0.78,-34,17,51,47
2,r_131_117_114,r_86_0_198,seq137,r_131_117_114,0.59,0,114,114,47
24,r_102_31_165,seq14,seq77,r_102_31_165,0.79,0,165,165,47
25,r_65_85_121,seq113,r_52_74_36,r_65_85_121,0.59,0,121,121,47
66,seq51,seq29,r_92_83_51,r_92_83_51,1.0,2,53,51,47
32,r_43_125_195,r_81_99_110,r_47_116_4,r_81_99_110,1.0,0,110,110,47
38,r_15_63_82,seq14,seq84,r_15_63_82,1.0,0,82,82,47
34,r_57_121_76,r_43_125_195,seq37,r_57_121_76,0.88,-1,75,76,47
9,r_92_83_51,seq113,seq51,r_92_83_51,0.9,0,51,51,47
34,r_57_121_76,seq37,r_69_5_96,r_69_5_96,1.0,0,96,96,47
60,seq40,r_120_39_148,seq77,r_120_39_148,0.88,0,148,148,47
17,r_27_19_84,seq46,seq42,r_27_19_84,1.0,0,84,84,47
97,seq137,r_133_44_49,r_89_104_193,r_133_44_49,0.94,2,51,49,47
22,r_127_2_94,seq60,seq55,r_127_2_94,1.0,0,94,94,47
7,r_52_74_36,seq29,seq45,r_52_74_36,1.0,0,36,36,47
49,seq14,r_102_31_165,r_48_34_74,r_102_31_165,0.98,0,165,165,47
35,r_81_99_110,r_43_125_195,seq109,r_81_99_110,1.0,0,110,110,47
12,r_86_0_198,r_131_117_114,seq77,r_131_117_114,0.96,0,114,114,47
93,seq114,seq117,r_9_95_107,r_9_95_107,1.0,0,107,107,48
9,r_91_51_186,seq114,seq50,r_91_51_186,0.77,0,186,186,48
14,r_106_122_165,seq86,seq31,r_106_122_165,0.55,0,165,165,48
8,r_26_135_137,seq90,r_27_52_87,r_26_135_137,0.68,2,139,137,48
11,r_104_97_167,r_102_14_65,seq72,r_104_97_167,0.98,0,167,167,48
25,r_96_85_57,seq13,r_124_28_30,r_96_85_57,1.0,0,57,57,48
1,r_67_18_42,seq34,seq111,r_67_18_42,1.0,0,42,42,48
37,r_0_81_123,seq56,seq22,r_0_81_123,0.71,0,123,123,48
55,seq36,r_102_14_65,seq25,r_102_14_65,1.0,0,65,65,48
21,r_12_101_100,seq117,seq130,r_12_101_100,0.94,0,100,100,48
39,r_110_79_154,seq130,r_96_85_57,r_96_85_57,1.0,99,156,57,48
24,r_125_40_40,r_39_129_153,seq86,r_125_40_40,1.0,1,41,40,48
69,seq58,r_138_7_94,seq50,r_138_7_94,1.0,0,94,94,48
7,r_84_6_155,r_19_137_80,r_100_44_130,r_84_6_155,1.0,0,155,155,48
19,r_27_52_87,seq48,seq89,r_27_52_87,1.0,0,87,87,48
29,r_124_28_30,r_12_101_100,seq16,r_124_28_30,0.99,0,30,30,48
15,r_62_66_16,r_19_137_80,seq90,r_19_137_80,0.68,-59,21,80,48
3,r_69_20_68,r_115_134_85,r_120_45_195,r_120_45_195,1.0,-127,68,195,48
10,r_102_14_65,seq36,r_104_97_167,r_102_14_65,1.0,0,65,65,48
4,r_60_2_145,seq83,seq31,r_60_2_145,0.83,0,145,145,48
18,r_131_98_52,r_17_77_1,r_67_18_42,r_17_77_1,0.71,51,52,1,48
0,r_115_134_85,seq94,r_17_77_1,r_115_134_85,1.0,0,85,85,48
11,r_104_97_167,r_39_129_153,r_102_14_65,r_102_14_65,1.0,70,135,65,48
20,r_11_92_175,seq73,r_71_1_48,r_71_1_48,0.4,127,175,48,48
13,r_9_95_107,seq13,seq114,r_9_95_107,1.0,0,107,107,48
56,seq37,seq8,r_59_24_108,r_59_24_108,1.0,3,111,108,48
36,r_99_33_54,r_59_24_108,seq119,r_99_33_54,0.91,0,54,54,48
6,r_107_116_90,seq86,seq25,r_107_116_90,1.0,0,90,90,48
94,seq117,seq87,r_21_64_34,r_21_64_34,1.0,21,55,34,48
16,r_21_64_34,r_115_134_85,seq117,r_21_64_34,1.0,0,34,34,48
10,r_102_14_65,r_104_97_167,r_132_4_159,r_102_14_65,0.51,102,167,65,48
27,r_128_139_82,seq70,seq34,r_128_139_82,0.95,0,82,82,48
87,seq90,r_26_135_137,r_62_66_16,r_26_135_137,0.99,2,139,137,48
40,seq130,r_110_79_154,r_12_101_100,r_12_101_100,0.99,56,156,100,48
33,r_132_4_159,seq16,r_102_14_65,r_132_4_159,0.91,0,159,159,48
64,seq50,r_30_105_151,seq58,r_30_105_151,0.92,0,151,151,48
88,seq93,r_120_45_195,r_69_20_68,r_69_20_68,1.0,95,163,68,48
32,r_138_7_94,seq58,seq15,r_138_7_94,1.0,-1,93,94,48
38,r_19_137_80,seq13,seq10,r_19_137_80,1.0,1,81,80,48
75,seq73,r_100_44_130,seq15,r_100_44_130,1.0,1,131,130,48
17,r_41_5_131,seq31,r_125_40_40,r_41_5_131,0.66,5,136,131,48
5,r_108_118_18,r_128_139_82,seq29,r_108_118_18,0.98,2,20,18,48
56,seq37,r_71_1_48,seq8,r_71_1_48,1.0,0,48,48,48
22,r_100_44_130,seq73,seq56,r_100_44_130,0.83,1,131,130,48
28,r_133_61_74,seq86,seq29,r_133_61_74,1.0,1,75,74,48
49,seq25,seq36,r_107_116_90,r_107_116_90,1.0,0,90,90,48
23,r_71_1_48,seq37,seq35,r_71_1_48,1.0,0,48,48,48
7,r_84_6_155,seq111,r_19_137_80,r_19_137_80,1.0,18,98,80,48
35,r_59_24_108,seq35,seq37,r_59_24_108,1.0,0,108,108,48
12,r_120_45_195,seq93,r_30_105_151,r_30_105_151,0.99,6,157,151,48
36,r_27_19_77,r_129_22_134,r_56_11_81,r_27_19_77,0.98,4,81,77,49
29,r_37_88_25,r_113_104_23,seq8,r_37_88_25,0.8,2,27,25,49
14,r_103_73_110,seq95,r_99_58_120,r_99_58_120,1.0,6,126,120,49
8,r_60_86_119,seq51,seq100,r_60_86_119,1.0,0,119,119,49
16,r_59_102_78,r_87_91_156,seq82,r_59_102_78,1.0,1,79,78,49
21,r_32_7_71,seq119,seq48,r_32_7_71,1.0,0,71,71,49
22,r_31_123_35,r_81_72_111,seq21,r_31_123_35,0.67,0,35,35,49
5,r_30_125_48,r_92_53_130,seq126,r_30_125_48,1.0,0,48,48,49
31,r_43_83_139,seq34,seq17,r_43_83_139,0.89,0,139,139,49
3,r_136_45_155,seq137,r_49_135_55,r_136_45_155,0.97,0,155,155,49
10,r_130_121_126,seq44,r_37_88_25,r_130_121_126,0.76,0,126,126,49
26,r_23_64_83,r_129_22_134,seq138,r_23_64_83,0.66,2,85,83,49
4,r_129_22_134,seq137,seq97,r_129_22_134,0.86,1,135,134,49
78,seq84,r_111_90_146,seq95,r_111_90_146,0.98,-63,83,146,49
20,r_139_10_118,seq39,seq47,r_139_10_118,0.66,1,119,118,49
13,r_40_115_177,seq62,seq46,r_40_115_177,0.4,0,177,177,49
55,seq29,r_4_85_56,seq106,r_4_85_56,0.53,96,152,56,49
15,r_111_90_146,seq84,seq65,r_111_90_146,0.6,2,148,146,49
57,seq34,r_43_83_139,r_38_79_109,r_38_79_109,0.88,30,139,109,49
62,seq46,r_56_11_81,seq89,r_56_11_81,1.0,0,81,81,49
27,r_77_112_101,seq46,seq26,r_77_112_101,1.0,1,102,101,49
18,r_56_11_81,seq46,r_27_19_77,r_56_11_81,1.0,0,81,81,49
24,r_28_3_137,seq100,seq16,r_28_3_137,0.97,-2,135,137,49
35,r_76_128_3,seq137,seq65,r_76_128_3,0.47,162,165,3,49
25,r_92_53_130,seq15,r_132_67_2,r_92_53_130,1.0,0,130,130,49
68,seq137,r_129_22_134,seq17,r_129_22_134,1.0,-15,119,134,49
32,r_38_79_109,seq68,seq34,r_38_79_109,0.95,0,109,109,49
17,r_81_72_111,r_31_123_35,seq29,r_31_123_35,1.0,0,35,35,49
9,r_0_107_159,seq97,r_23_64_83,r_0_107_159,0.86,2,161,159,49
28,r_54_33_136,seq16,seq65,r_54_33_136,0.52,8,144,136,49
7,r_98_105_97,r_54_33_136,r_30_125_48,r_30_125_48,0.8,50,98,48,49
23,r_71_12_64,seq48,r_30_125_48,r_71_12_64,1.0,0,64,64,49
19,r_49_135_55,r_56_11_81,seq100,r_56_11_81,0.51,-23,58,81,49
17,r_81_72_111,seq29,seq100,r_81_72_111,0.96,0,111,111,49
12,r_99_58_120,seq82,r_103_73_110,r_99_58_120,0.98,0,120,120,49
55,seq29,r_81_72_111,r_4_85_56,r_81_72_111,0.89,-11,100,111,49
36,r_39_61_185,seq109,seq4,r_39_61_185,0.43,0,185,185,50
98,seq125,seq41,r_47_77_20,r_47_77_20,0.95,23,43,20,50
10,r_120_93_40,r_7_22_171,seq41,r_120_93_40,1.0,0,40,40,50
37,r_88_59_132,seq40,seq100,r_88_59_132,0.95,1,133,132,50
19,r_104_51_172,r_53_68_42,r_127_27_13,r_53_68_42,0.93,132,174,42,50
16,r_42_98_98,r_131_67_162,r_122_107_67,r_122_107_67,1.0,31,98,67,50
21,r_31_63_128,seq56,seq29,r_31_63_128,0.96,0,128,128,50
39,r_131_67_162,seq58,r_122_107_67,r_122_107_67,1.0,95,162,67,50
1,r_49_28_77,seq95,seq58,r_49_28_77,0.66,12,89,77,50
5,r_139_80_113,seq54,seq82,r_139_80_113,1.0,0,113,113,50
33,r_110_78_32,seq114,r_90_23_147,r_110_78_32,1.0,0,32,32,50
2,r_46_65_10,r_90_23_147,seq43,r_46_65_10,0.99,0,10,10,50
35,r_113_62_35,r_36_89_36,r_110_78_32,r_113_62_35,0.98,1,36,35,50
22,r_36_89_36,r_113_62_35,r_42_98_98,r_36_89_36,1.0,0,36,36,50
19,r_104_51_172,r_133_30_64,r_53_68_42,r_104_51_172,1.0,-107,65,172,50
15,r_133_30_64,r_79_117_179,seq132,r_79_117_179,0.74,1,180,179,50
33,r_110_78_32,r_90_23_147,r_81_1_34,r_90_23_147,0.99,-25,122,147,50
9,r_90_23_147,r_110_78_32,seq66,r_90_23_147,0.99,0,147,147,50
27,r_79_117_179,r_133_30_64,r_64_128_109,r_79_117_179,0.66,2,181,179,50
60,seq41,seq125,r_120_93_40,r_120_93_40,1.0,3,43,40,50
3,r_3_101_144,seq17,r_49_28_77,r_3_101_144,0.77,1,145,144,50
90,seq109,r_39_61_185,r_108_83_72,r_108_83_72,1.0,113,185,72,50
23,r_7_22_171,r_120_93_40,seq4,r_120_93_40,0.83,2,42,40,50
0,r_0_34_61,r_131_67_162,r_127_27_13,r_0_34_61,0.75,4,65,61,50
20,r_122_107_67,seq82,seq115,r_122_107_67,1.0,0,67,67,50
15,r_133_30_64,r_104_51_172,r_79_117_179,r_133_30_64,1.0,1,65,64,50
4,r_53_68_42,r_104_51_172,r_106_130_90,r_106_130_90,0.98,13,103,90,50
57,seq37,r_9_74_100,r_64_128_109,r_9_74_100,0.69,2,102,100,50
6,r_106_130_90,seq105,r_53_68_42,r_106_130_90,1.0,0,90,90,50
27,r_79_117_179,seq55,r_133_30_64,r_133_30_64,1.0,2,66,64,50
54,seq25,r_90_23_147,r_81_1_34,r_81_1_34,0.94,1,35,34,50
22,r_36_89_36,r_42_98_98,r_76_35_37,r_76_35_37,0.51,120,157,37,50
18,r_9_74_100,seq37,seq54,r_9_74_100,0.69,2,102,100,50
29,r_32_20_155,seq54,seq138,r_32_20_155,0.79,0,155,155,50
4,r_53_68_42,r_124_15_173,r_104_51_172,r_53_68_42,1.0,1,43,42,50
24,r_18_103_80,r_90_23_147,r_8_72_15,r_90_23_147,1.0,-51,96,147,50
32,r_127_27_13,r_3_101_144,seq21,r_127_27_13,0.98,0,13,13,50
25,r_99_11_104,seq13,seq86,r_99_11_104,1.0,0,104,104,50
65,seq52,seq84,r_53_68_42,r_53_68_42,1.0,44,86,42,50
31,r_81_1_34,seq115,seq25,r_81_1_34,1.0,0,34,34,50
38,r_108_83_72,seq21,seq13,r_108_83_72,1.0,0,72,72,50
9,r_90_23_147,r_18_103_80,r_110_78_32,r_110_78_32,0.78,64,96,32,50
8,r_47_77_20,r_88_59_132,seq125,r_47_77_20,1.0,0,20,20,50
7,r_16_26_84,seq121,seq6,r_16_26_84,1.0,1,85,84,50
44,seq6,r_12_87_2,r_16_26_84,r_16_26_84,1.0,9,93,84,50
14,r_76_35_37,seq134,r_127_27_13,r_76_35_37,0.99,1,38,37,50
12,r_124_15_173,seq43,r_137_136_125,r_124_15_173,0.64,0,173,173,50
4,r_55_61_23,r_104_96_154,seq7,r_55_61_23,0.89,-1,22,23,51
30,r_104_96_154,seq99,seq137,r_104_96_154,0.78,1,155,154,51
36,r_81_109_61,r_59_62_86,seq70,r_81_109_61,1.0,0,61,61,51
14,r_59_62_86,r_81_109_61,r_106_132_191,r_81_109_61,0.99,0,61,61,51
8,r_29_32_116,seq78,r_13_116_155,r_29_32_116,0.69,1,117,116,51
43,seq6,r_129_80_103,r_49_122_28,r_129_80_103,1.0,0,103,103,51
5,r_51_14_12,seq7,seq19,r_51_14_12,0.98,0,12,12,51
54,seq24,seq115,r_72_90_122,r_72_90_122,0.93,1,123,122,51
37,r_9_100_91,seq105,r_33_23_181,r_9_100_91,1.0,0,91,91,51
26,r_120_107_21,r_15_16_139,seq115,r_120_107_21,0.98,0,21,21,51
19,r_4_52_164,seq137,r_118_20_162,r_4_52_164,0.91,1,165,164,51
39,r_121_79_114,seq99,seq102,r_121_79_114,0.9,3,117,114,51
52,seq19,r_0_139_152,r_51_14_12,r_51_14_12,0.9,2,14,12,51
80,seq78,r_29_32_116,r_136_25_7,r_29_32_116,1.0,1,117,116,51
32,r_136_25_7,r_29_32_116,seq114,r_29_32_116,1.0,-15,101,116,51
19,r_4_52_164,r_30_91_78,seq137,r_30_91_78,0.94,7,85,78,51
41,seq130,seq92,r_2_22_113,r_2_22_113,1.0,12,125,113,51
3,r_101_123_115,seq73,seq134,r_101_123_115,0.99,0,115,115,51
10,r_67_54_66,r_104_96_154,seq57,r_67_54_66,1.0,0,66,66,51
22,r_13_116_155,r_29_32_116,seq36,r_13_116_155,1.0,0,155,155,51
12,r_66_97_11,r_118_20_162,seq21,r_66_97_11,0.87,0,11,11,51
0,r_33_23_181,r_101_123_115,r_9_100_91,r_33_23_181,0.93,-77,104,181,51
63,seq43,seq102,r_129_80_103,r_129_80_103,1.0,6,109,103,51
73,seq68,seq78,r_138_113_120,r_138_113_120,1.0,1,121,120,51
20,r_30_91_78,r_4_52_164,r_120_107_21,r_30_91_78,0.72,7,85,78,51
13,r_133_39_69,seq35,r_48_112_29,r_48_112_29,0.54,53,82,29,51
15,r_95_71_88,seq69,r_136_25_7,r_95_71_88,0.94,1,89,88,51
0,r_33_23_181,r_9_100_91,r_13_116_155,r_9_100_91,0.95,90,181,91,51
27,r_84_85_95,seq93,seq70,r_84_85_95,1.0,0,95,95,51
25,r_124_98_27,r_29_32_116,seq3,r_124_98_27,0.99,0,27,27,51
1,r_128_31_10,seq76,seq92,r_128_31_10,0.77,0,10,10,51
34,r_82_65_83,seq88,r_40_11_182,r_82_65_83,0.62,43,126,83,51
2,r_129_80_103,seq6,seq43,r_129_80_103,1.0,0,103,103,51
74,seq69,r_95_71_88,seq18,r_95_71_88,1.0,0,88,88,51
29,r_2_22_113,seq35,seq130,r_2_22_113,0.81,0,113,113,51
24,r_50_44_65,r_95_71_88,seq134,r_50_44_65,1.0,0,65,65,51
95,seq115,seq28,r_120_107_21,r_120_107_21,1.0,3,24,21,51
8,r_29_32_116,r_13_116_155,r_42_89_70,r_13_116_155,1.0,0,155,155,51
38,r_127_74_188,seq125,r_72_90_122,r_127_74_188,0.3,0,188,188,51
34,r_82_65_83,seq3,seq88,r_82_65_83,0.95,0,83,83,51
60,seq37,seq102,r_42_89_70,r_42_89_70,1.0,3,73,70,51
94,seq114,r_29_32_116,r_136_25_7,r_29_32_116,0.99,-15,101,116,51
9,r_42_89_70,seq108,seq37,r_42_89_70,1.0,0,70,70,51
96,seq117,r_15_16_139,seq21,r_15_16_139,0.98,1,140,139,51
37,r_9_100_91,r_33_23_181,r_15_16_139,r_9_100_91,0.58,90,181,91,51
22,r_13_116_155,seq37,r_29_32_116,r_29_32_116,0.73,1,117,116,51
28,r_138_113_120,seq60,seq68,r_138_113_120,1.0,0,120,120,51
14,r_59_62_86,r_106_132_191,seq105,r_59_62_86,0.96,0,86,86,51
23,r_72_90_122,seq10,seq24,r_72_90_122,0.9,2,124,122,51
33,r_48_112_29,r_29_32_116,r_133_39_69,r_48_112_29,0.96,0,29,29,51
14,r_38_51_29,seq10,seq98,r_38_51_29,1.0,0,29,29,52
30,r_52_25_62,seq26,r_30_57_198,r_52_25_62,1.0,1,63,62,52
44,seq10,seq70,r_35_112_101,r_35_112_101,1.0,19,120,101,52
0,r_43_125_28,r_127_68_54,seq71,r_43_125_28,0.79,0,28,28,52
16,r_77_54_16,r_119_6_165,seq39,r_77_54_16,0.91,0,16,16,52
36,r_74_95_170,seq13,seq88,r_74_95_170,0.45,7,177,170,52
32,r_32_114_46,seq36,seq55,r_32_114_46,1.0,0,46,46,52
8,r_105_42_157,seq110,r_84_102_118,r_105_42_157,0.74,0,157,157,52
43,seq136,r_121_20_173,seq26,r_121_20_173,0.58,2,175,173,52
37,r_104_59_154,r_116_96_185,seq56,r_104_59_154,0.92,0,154,154,52
1,r_16_8_187,r_44_3_1,r_100_65_100,r_16_8_187,0.36,0,187,187,52
5,r_82_139_71,r_30_57_198,seq75,r_82_139_71,1.0,0,71,71,52
54,seq36,r_32_114_46,r_126_66_6,r_32_114_46,0.94,0,46,46,52
46,seq13,r_74_95_170,r_104_59_154,r_104_59_154,0.99,23,177,154,52
66,seq55,r_129_131_160,r_32_114_46,r_32_114_46,0.94,33,79,46,52
35,r_60_132_23,seq88,seq123,r_60_132_23,0.94,-1,22,23,52
3,r_107_86_129,seq10,r_133_76_109,r_107_86_129,0.67,0,129,129,52
10,r_133_76_109,seq46,r_43_125_28,r_133_76_109,0.87,0,109,109,52
56,seq39,seq47,r_77_54_16,r_77_54_16,1.0,5,21,16,52
4,r_128_24_63,seq7,seq2,r_128_24_63,0.95,1,64,63,52
26,r_22_67_33,r_128_24_63,r_77_54_16,r_22_67_33,0.83,2,35,33,52
38,r_137_62_175,r_84_102_118,r_15_9_143,r_137_62_175,0.82,1,176,175,52
11,r_30_57_198,r_82_139_71,r_52_25_62,r_82_139_71,0.64,0,71,71,52
6,r_21_109_82,seq53,seq46,r_21_109_82,0.99,0,82,82,52
27,r_73_45_66,seq106,seq75,r_73_45_66,1.0,1,67,66,52
2,r_63_34_184,r_30_57_198,r_116_96_185,r_63_34_184,0.29,2,186,184,52
18,r_100_65_100,r_11_130_142,seq81,r_11_130_142,0.74,-36,106,142,52
24,r_116_96_185,r_11_130_142,r_63_34_184,r_63_34_184,0.44,1,185,184,52
33,r_35_112_101,seq69,seq10,r_35_112_101,0.83,0,101,101,52
44,seq10,r_38_51_29,seq70,r_38_51_29,1.0,1,30,29,52
38,r_137_62_175,r_15_9_143,r_84_102_118,r_84_102_118,0.89,33,151,118,52
75,seq75,seq122,r_73_45_66,r_73_45_66,1.0,6,72,66,52
73,seq71,seq69,r_43_125_28,r_43_125_28,1.0,11,39,28,52
15,r_127_68_54,seq122,r_126_66_6,r_127_68_54,0.99,0,54,54,52
22,r_27_134_172,seq55,r_97_23_94,r_97_23_94,1.0,78,172,94,52
7,r_93_90_132,seq28,seq75,r_93_90_132,0.97,0,132,132,52
23,r_97_23_94,r_105_42_157,r_100_65_100,r_97_23_94,0.96,2,96,94,52
12,r_5_99_104,seq37,seq58,r_5_99_104,1.0,0,104,104,52
28,r_24_34_15,r_130_11_188,seq48,r_24_34_15,1.0,0,15,15,53
8,r_12_124_151,seq35,seq89,r_12_124_151,0.93,0,151,151,53
83,seq89,seq135,r_12_124_151,r_12_124_151,1.0,2,153,151,53
37,r_39_93_135,seq5,r_107_59_128,r_107_59_128,0.64,7,135,128,53
16,r_1_82_190,seq54,r_107_59_128,r_1_82_190,0.26,0,190,190,53
1,r_43_111_164,seq50,seq35,r_43_111_164,0.95,0,164,164,53
33,r_60_126_58,seq104,seq21,r_60_126_58,1.0,1,59,58,53
32,r_41_4_66,r_81_85_139,seq16,r_41_4_66,0.63,65,131,66,53
35,r_28_70_49,r_46_64_176,seq129,r_28_70_49,1.0,1,50,49,53
24,r_110_13_65,r_102_84_55,seq5,r_110_13_65,0.6,-47,18,65,53
39,r_69_106_161,r_130_11_188,seq45,r_69_106_161,0.58,-118,43,161,53
19,r_55_56_147,seq112,seq54,r_55_56_147,0.98,1,148,147,53
39,r_69_106_161,seq45,r_133_92_70,r_133_92_70,0.88,91,161,70,53
31,r_109_40_125,seq83,seq32,r_109_40_125,1.0,-1,124,125,53
67,seq50,r_43_111_164,seq38,r_43_111_164,0.99,-75,89,164,53
27,r_127_42_16,seq129,seq115,r_127_42_16,0.99,1,17,16,53
22,r_62_18_31,r_78_113_43,seq103,r_62_18_31,1.0,3,34,31,53
26,r_8_71_74,seq80,seq117,r_8_71_74,1.0,0,74,74,53
78,seq79,r_128_2_105,seq57,r_128_2_105,1.0,1,106,105,53
0,r_107_59_128,seq68,seq135,r_107_59_128,0.99,0,128,128,53
63,seq44,r_107_59_128,seq68,r_107_59_128,0.89,-9,119,128,53
11,r_25_119_183,seq52,seq38,r_25_119_183,0.26,1,184,183,53
2,r_73_114_154,r_130_11_188,r_88_136_42,r_88_136_42,1.0,1,43,42,53
13,r_130_11_188,seq36,r_121_123_37,r_121_123_37,1.0,151,188,37,53
6,r_76_14_171,seq75,r_78_113_43,r_76_14_171,0.8,0,171,171,53
2,r_73_114_154,r_88_136_42,r_39_93_135,r_73_114_154,0.93,0,154,154,53
4,r_102_84_55,seq135,seq27,r_102_84_55,1.0,0,55,55,53
36,r_88_136_42,r_73_114_154,r_78_113_43,r_73_114_154,1.0,0,154,154,53
10,r_46_64_176,seq27,seq135,r_46_64_176,0.51,2,178,176,53
74,seq68,r_107_59_128,seq44,r_107_59_128,0.87,0,128,128,53
18,r_30_65_199,seq36,r_128_2_105,r_128_2_105,1.0,23,128,105,53
29,r_66_19_71,r_26_139_144,seq49,r_66_19_71,1.0,0,71,71,53
24,r_110_13_65,seq5,r_28_70_49,r_110_13_65,1.0,0,65,65,53
25,r_128_2_105,seq79,r_30_65_199,r_128_2_105,1.0,1,106,105,53
70,seq54,r_1_82_190,r_55_56_147,r_55_56_147,1.0,43,190,147,53
32,r_41_4_66,seq135,r_81_85_139,r_41_4_66,1.0,4,70,66,53
38,r_94_77_118,seq6,seq23,r_94_77_118,0.82,4,122,118,53
77,seq75,r_76_14_171,r_26_139_144,r_76_14_171,0.92,0,171,171,53
36,r_88_136_42,seq52,r_73_114_154,r_88_136_42,1.0,0,42,42,53
91,seq103,seq104,r_62_18_31,r_62_18_31,1.0,0,31,31,53
34,r_7_122_3,seq134,r_133_92_70,r_133_92_70,1.0,2,72,70,53
17,r_133_92_70,seq5,r_7_122_3,r_133_92_70,1.0,1,71,70,53
98,seq118,r_39_93_135,r_121_123_37,r_121_123_37,1.0,2,39,37,53
10,r_46_64_176,r_28_70_49,seq27,r_28_70_49,0.74,6,55,49,53
23,r_10_22_158,seq138,r_78_113_43,r_10_22_158,0.82,1,159,158,53
14,r_121_123_37,r_69_106_161,seq118,r_121_123_37,1.0,1,38,37,53
12,r_51_125_85,seq95,seq31,r_51_125_85,1.0,1,86,85,53
36,r_8_2_61,seq123,r_62_4_34,r_62_4_34,0.48,33,67,34,54
6,r_71_130_3,r_75_40_23,r_110_135_20,r_71_130_3,0.95,17,20,3,54
33,r_62_4_34,r_128_23_76,r_46_49_84,r_62_4_34,0.96,1,35,34,54
8,r_92_97_107,seq39,seq5,r_92_97_107,0.99,0,107,107,54
43,seq5,seq22,r_92_97_107,r_92_97_107,0.96,6,113,107,54
30,r_36_87_38,r_137_134_100,seq90,r_36_87_38,0.56,0,38,38,54
54,seq32,r_33_96_196,r_3_24_52,r_33_96_196,0.82,-77,119,196,54
37,r_78_13_165,r_137_134_100,r_133_112_163,r_137_134_100,0.96,-1,99,100,54
22,r_124_126_57,r_92_97_107,seq38,r_124_126_57,0.68,0,57,57,54
19,r_46_49_84,r_71_130_3,r_3_24_52,r_46_49_84,0.43,67,151,84,54
21,r_100_107_120,seq79,r_124_126_57,r_100_107_120,0.58,-1,119,120,54
39,r_68_83_171,seq136,r_25_116_21,r_68_83_171,0.62,1,172,171,54
97,seq122,seq73,r_139_94_74,r_139_94_74,1.0,7,81,74,54
5,r_133_112_163,r_120_81_198,r_105_93_30,r_133_112_163,0.75,0,163,163,54
19,r_46_49_84,r_125_86_99,r_71_130_3,r_71_130_3,0.87,81,84,3,54
15,r_111_12_139,r_132_30_11,seq80,r_111_12_139,0.97,0,139,139,54
16,r_25_116_21,r_121_42_79,seq21,r_25_116_21,0.74,-1,20,21,54
67,seq53,r_128_23_76,seq14,r_128_23_76,1.0,-9,67,76,54
28,r_6_56_29,r_3_24_52,r_133_112_163,r_6_56_29,1.0,0,29,29,54
13,r_132_30_11,r_3_24_52,r_111_12_139,r_132_30_11,0.92,0,11,11,54
3,r_137_134_100,r_78_13_165,seq35,r_137_134_100,0.98,0,100,100,54
10,r_125_86_99,r_46_49_84,r_102_101_172,r_46_49_84,0.61,0,84,84,54
14,r_58_77_16,r_120_81_198,seq76,r_58_77_16,1.0,0,16,16,54
26,r_61_54_101,r_27_67_133,r_3_24_52,r_61_54_101,0.99,0,101,101,54
4,r_15_82_185,seq48,r_133_112_163,r_133_112_163,0.96,22,185,163,54
0,r_3_24_52,r_33_96_196,r_61_54_101,r_61_54_101,1.0,1,102,101,54
38,r_31_72_55,r_139_94_74,seq38,r_31_72_55,1.0,0,55,55,54
87,seq90,r_120_81_198,r_36_87_38,r_36_87_38,0.77,-5,33,38,54
20,r_11_37_157,seq16,r_75_40_23,r_11_37_157,0.86,1,158,157,54
13,r_132_30_11,r_111_12_139,r_121_42_79,r_132_30_11,0.64,128,139,11,54
33,r_62_4_34,r_46_49_84,r_8_2_61,r_46_49_84,1.0,0,84,84,54
2,r_139_94_74,r_120_81_198,seq122,r_139_94_74,1.0,1,75,74,54
32,r_105_93_30,r_11_37_157,seq17,r_105_93_30,1.0,-3,27,30,54
18,r_102_101_172,seq88,r_3_24_52,r_3_24_52,0.8,120,172,52,54
29,r_103_20_108,seq53,seq18,r_103_20_108,0.93,1,109,108,54
35,r_109_26_43,r_118_99_47,seq88,r_109_26_43,0.98,14,57,43,54
25,r_128_23_76,seq53,seq59,r_128_23_76,1.0,-5,71,76,54
88,seq91,seq76,r_125_86_99,r_125_86_99,1.0,10,109,99,54
17,r_27_67_133,seq80,seq10,r_27_67_133,0.98,0,133,133,54
15,r_111_12_139,r_92_97_107,r_132_30_11,r_132_30_11,0.48,1,12,11,54
48,seq17,seq34,r_105_93_30,r_105_93_30,1.0,-3,27,30,54
34,r_121_42_79,seq73,r_132_30_11,r_121_42_79,0.99,2,81,79,54
31,r_118_99_47,seq80,seq79,r_118_99_47,0.9,0,47,47,54
11,r_110_135_20,r_27_67_133,r_71_130_3,r_110_135_20,1.0,0,20,20,54
17,r_27_67_133,r_61_54_101,seq80,r_61_54_101,0.94,0,101,101,54
10,r_125_86_99,r_102_101_172,seq91,r_125_86_99,0.83,3,102,99,54
51,seq21,seq38,r_25_116_21,r_25_116_21,0.74,-3,18,21,54
9,r_29_9_8,r_100_107_120,seq19,r_29_9_8,0.73,2,10,8,54
27,r_75_40_23,r_71_130_3,seq73,r_75_40_23,0.93,-1,22,23,54
37,r_78_13_165,r_133_112_163,r_118_99_47,r_118_99_47,0.43,119,166,47,54
28,r_6_56_29,r_133_112_163,r_103_20_108,r_6_56_29,0.61,134,163,29,54
12,r_65_44_12,r_11_37_157,seq39,r_65_44_12,0.86,0,12,12,54
56,seq35,seq59,r_137_134_100,r_137_134_100,1.0,10,110,100,54
7,r_1_7_81,r_33_96_196,seq50,r_1_7_81,1.0,0,81,81,54
44,seq136,r_68_83_171,seq48,r_68_83_171,0.68,1,172,171,54
36,r_113_52_187,seq9,r_49_47_45,r_49_47_45,0.76,144,189,45,55
83,seq90,r_24_95_143,r_103_28_39,r_103_28_39,0.98,62,101,39,55
54,seq31,r_18_106_170,seq90,r_18_106_170,1.0,-1,169,170,55
30,r_60_71_11,seq120,seq94,r_60_71_11,0.93,1,12,11,55
21,r_89_96_3,seq36,r_27_132_138,r_89_96_3,0.31,135,138,3,55
39,r_32_123_101,r_40_100_190,seq59,r_32_123_101,1.0,0,101,101,55
1,r_135_111_145,r_137_12_164,seq51,r_135_111_145,0.78,0,145,145,55
15,r_7_4_17,seq0,seq73,r_7_4_17,0.99,0,17,17,55
5,r_17_46_87,r_27_132_138,seq59,r_17_46_87,1.0,3,90,87,55
7,r_24_95_143,r_18_106_170,r_137_12_164,r_24_95_143,0.82,24,167,143,55
12,r_40_100_190,r_33_70_132,seq114,r_40_100_190,0.97,0,190,190,55
16,r_19_107_42,r_135_111_145,seq10,r_19_107_42,1.0,0,42,42,55
38,r_109_69_34,r_54_37_158,seq139,r_109_69_34,1.0,1,35,34,55
14,r_13_55_55,r_6_121_112,seq42,r_13_55_55,1.0,1,56,55,55
96,seq120,seq88,r_138_30_44,r_138_30_44,1.0,-4,40,44,55
10,r_104_66_93,r_21_110_130,seq86,r_104_66_93,0.74,2,95,93,55
29,r_105_117_27,r_13_55_55,seq44,r_105_117_27,1.0,1,28,27,55
26,r_25_74_149,r_61_125_35,seq38,r_61_125_35,0.96,0,35,35,55
11,r_27_132_138,r_2_68_162,r_89_96_3,r_2_68_162,0.85,-24,138,162,55
20,r_35_58_188,seq50,r_25_74_149,r_25_74_149,0.73,39,188,149,55
37,r_72_85_22,r_6_121_112,seq88,r_72_85_22,0.95,0,22,22,55
48,seq14,r_3_56_74,seq133,r_3_56_74,1.0,0,74,74,55
0,r_49_47_45,seq42,seq16,r_49_47_45,0.92,0,45,45,55
6,r_63_75_126,r_122_64_196,seq115,r_63_75_126,0.87,-2,124,126,55
27,r_130_80_32,seq136,seq39,r_130_80_32,0.97,1,33,32,55
0,r_49_47_45,seq16,r_116_15_179,r_49_47_45,0.33,135,180,45,55
23,r_61_125_35,r_25_74_149,seq41,r_61_125_35,0.96,0,35,35,55
47,seq139,r_24_95_143,r_109_69_34,r_109_69_34,1.0,2,36,34,55
34,r_138_30_44,r_17_46_87,seq120,r_138_30_44,0.99,0,44,44,55
2,r_81_98_129,r_35_58_188,seq129,r_81_98_129,0.92,0,129,129,55
18,r_34_11_78,seq44,seq59,r_34_11_78,0.95,0,78,78,55
24,r_118_131_119,seq127,seq16,r_118_131_119,0.83,0,119,119,55
82,seq88,seq120,r_72_85_22,r_72_85_22,1.0,6,28,22,55
25,r_116_15_179,seq48,r_49_47_45,r_49_47_45,0.85,134,179,45,55
33,r_6_121_112,seq59,seq94,r_6_121_112,0.98,0,112,112,55
64,seq48,r_116_15_179,r_103_28_39,r_103_28_39,0.92,39,78,39,55
32,r_97_8_137,seq53,seq90,r_97_8_137,0.59,1,138,137,55
19,r_103_28_39,seq86,seq48,r_103_28_39,1.0,0,39,39,55
28,r_3_56_74,seq14,seq9,r_3_56_74,0.99,0,74,74,55
35,r_76_23_113,seq51,seq16,r_76_23_113,0.94,0,113,113,55
12,r_40_100_190,seq86,r_33_70_132,r_33_70_132,0.92,5,137,132,55
27,r_8_12_43,seq29,seq16,r_8_12_43,1.0,1,44,43,56
36,r_92_10_144,r_109_32_165,r_77_35_65,r_92_10_144,0.76,1,145,144,56
14,r_27_37_90,seq31,r_108_111_34,r_108_111_34,0.95,61,95,34,56
30,r_28_54_46,seq31,r_53_6_19,r_28_54_46,0.78,1,47,46,56
3,r_108_111_34,r_64_103_37,r_27_37_90,r_27_37_90,0.63,10,100,90,56
59,seq31,r_27_37_90,r_55_50_81,r_55_50_81,0.94,14,95,81,56
86,seq95,r_44_42_159,r_96_61_28,r_96_61_28,1.0,131,159,28,56
16,r_23_48_112,seq49,seq74,r_23_48_112,0.47,5,117,112,56
21,r_110_113_108,r_75_71_22,seq76,r_110_113_108,0.5,3,111,108,56
5,r_44_42_159,seq95,r_4_47_8,r_4_47_8,0.55,151,159,8,56
78,seq76,r_64_103_37,r_110_113_108,r_110_113_108,0.7,-10,98,108,56
69,seq52,seq1,r_70_115_110,r_70_115_110,1.0,16,126,110,56
19,r_21_105_182,seq0,r_97_17_114,r_21_105_182,0.39,1,183,182,56
11,r_15_67_97,seq99,r_75_71_22,r_15_67_97,1.0,0,97,97,56
2,r_14_11_57,seq36,r_96_61_28,r_14_11_57,1.0,0,57,57,56
31,r_55_50_81,seq39,seq31,r_55_50_81,1.0,0,81,81,56
10,r_97_17_114,seq7,r_75_71_22,r_97_17_114,0.96,1,115,114,56
42,seq2,r_8_12_43,seq52,r_8_12_43,0.92,5,48,43,56
4,r_77_35_65,seq68,r_53_6_19,r_77_35_65,1.0,0,65,65,56
12,r_34_125_21,r_132_84_191,seq1,r_34_125_21,0.98,0,21,21,56
13,r_75_71_22,r_110_113_108,r_97_17_114,r_75_71_22,0.66,91,113,22,56
33,r_64_103_37,r_77_35_65,r_108_111_34,r_108_111_34,0.62,5,39,34,56
34,r_133_82_56,r_25_104_99,r_130_72_89,r_133_82_56,1.0,0,56,56,56
12,r_34_125_21,seq1,r_73_66_104,r_73_66_104,1.0,22,126,104,56
6,r_70_115_110,r_117_59_151,seq52,r_70_115_110,1.0,0,110,110,56
62,seq39,r_25_104_99,r_100_118_7,r_25_104_99,0.95,-21,78,99,56
85,seq93,r_23_48_112,r_38_88_106,r_38_88_106,1.0,7,113,106,56
17,r_96_61_28,r_23_48_112,seq40,r_96_61_28,0.89,0,28,28,56
37,r_57_43_53,seq91,seq7,r_57_43_53,1.0,0,53,53,56
1,r_130_72_89,seq136,r_133_82_56,r_133_82_56,0.61,2,58,56,56
29,r_25_104_99,seq39,seq45,r_25_104_99,0.95,0,99,99,56
25,r_38_88_106,seq3,seq93,r_38_88_106,1.0,0,106,106,56
11,r_15_67_97,r_34_125_21,seq99,r_34_125_21,0.87,-4,17,21,56
57,seq29,r_8_12_43,seq52,r_8_12_43,1.0,1,44,43,56
38,r_85_69_174,seq1,r_110_113_108,r_110_113_108,0.76,66,174,108,56
77,seq74,r_65_79_166,r_23_48_112,r_65_79_166,0.84,1,167,166,56
22,r_112_121_18,r_25_104_99,seq7,r_112_121_18,0.98,0,18,18,56
34,r_133_82_56,r_130_72_89,seq86,r_133_82_56,0.67,38,94,56,56
28,r_131_60_63,seq76,seq137,r_131_60_63,1.0,0,63,63,56
7,r_73_66_104,seq31,r_34_125_21,r_73_66_104,0.99,0,104,104,56
23,r_109_32_165,seq119,r_38_88_106,r_38_88_106,0.94,59,165,106,56
3,r_108_111_34,r_109_32_165,r_64_103_37,r_108_111_34,1.0,3,37,34,56
35,r_46_94_91,r_109_32_165,seq128,r_46_94_91,1.0,0,91,91,56
1,r_130_72_89,r_133_82_56,seq68,r_130_72_89,0.91,1,90,89,56
30,r_80_83_157,seq102,seq60,r_80_83_157,0.87,0,157,157,57
51,seq18,r_94_101_190,r_103_111_117,r_103_111_117,1.0,14,131,117,57
36,r_66_123_64,seq49,r_87_40_113,r_66_123_64,0.77,0,64,64,57
0,r_99_139_9,r_136_39_84,r_77_56_137,r_99_139_9,0.99,2,11,9,57
14,r_15_23_125,seq49,r_4_104_60,r_15_23_125,0.88,0,125,125,57
8,r_54_112_115,r_80_83_157,seq34,r_54_112_115,0.5,0,115,115,57
37,r_27_133_95,seq106,seq63,r_27_133_95,1.0,0,95,95,57
16,r_52_67_141,seq45,r_136_39_84,r_52_67_141,1.0,1,142,141,57
21,r_73_79_82,seq37,seq137,r_73_79_82,1.0,0,82,82,57
39,r_32_93_77,seq0,seq86,r_32_93_77,1.0,-1,76,77,57
1,r_103_111_117,r_80_83_157,seq18,r_103_111_117,0.98,1,118,117,57
97,seq137,seq20,r_73_79_82,r_73_79_82,1.0,50,132,82,57
5,r_136_39_84,r_71_2_169,seq8,r_136_39_84,0.73,0,84,84,57
36,r_66_123_64,r_87_40_113,seq109,r_87_40_113,0.97,-25,88,113,57
20,r_53_50_85,r_99_139_9,r_26_72_105,r_26_72_105,0.98,17,122,105,57
19,r_10_36_86,r_41_28_199,seq47,r_10_36_86,1.0,0,86,86,57
15,r_77_56_137,r_99_139_9,seq49,r_77_56_137,0.96,0,137,137,57
11,r_90_130_13,r_4_104_60,seq106,r_90_130_13,0.96,0,13,13,57
75,seq63,seq51,r_103_111_117,r_103_111_117,0.45,-65,52,117,57
89,seq106,r_27_133_95,r_90_130_13,r_27_133_95,0.98,-20,75,95,57
3,r_85_64_187,seq89,r_82_78_50,r_82_78_50,0.97,139,189,50,57
15,r_77_56_137,r_73_79_82,r_99_139_9,r_99_139_9,0.66,2,11,9,57
38,r_87_40_113,r_66_123_64,r_31_61_14,r_87_40_113,0.95,0,113,113,57
20,r_53_50_85,r_71_2_169,r_99_139_9,r_53_50_85,0.96,1,86,85,57
13,r_35_88_155,seq127,r_95_98_72,r_35_88_155,0.71,0,155,155,57
6,r_121_108_79,r_52_67_141,seq120,r_121_108_79,1.0,0,79,79,57
99,seq127,r_35_88_155,seq33,r_35_88_155,1.0,0,155,155,57
0,r_99_139_9,r_77_56_137,r_53_50_85,r_99_139_9,0.54,128,137,9,57
4,r_107_125_180,seq119,r_71_2_169,r_107_125_180,0.9,0,180,180,57
87,seq102,r_80_83_157,r_84_62_12,r_80_83_157,0.74,0,157,157,57
26,r_31_61_14,r_32_93_77,r_84_62_12,r_31_61_14,0.94,1,15,14,57
31,r_118_42_24,r_94_101_190,seq45,r_118_42_24,1.0,-1,23,24,57
22,r_74_76_76,seq16,r_121_108_79,r_74_76_76,0.46,81,157,76,57
40,seq0,r_32_93_77,seq127,r_32_93_77,1.0,-5,72,77,57
29,r_100_25_151,seq86,r_77_56_137,r_100_25_151,0.52,0,151,151,57
24,r_82_78_50,r_103_111_117,seq65,r_82_78_50,0.98,0,50,50,57
25,r_5_30_122,seq49,seq113,r_5_30_122,0.98,0,122,122,57
33,r_26_72_105,seq16,r_53_50_85,r_26_72_105,0.92,0,105,105,57
70,seq57,r_124_11_177,r_5_30_122,r_5_30_122,0.98,59,181,122,57
65,seq47,seq21,r_10_36_86,r_10_36_86,1.0,3,89,86,57
68,seq51,seq63,r_31_61_14,r_31_61_14,0.56,58,72,14,57
38,r_87_40_113,seq89,r_66_123_64,r_66_123_64,0.98,14,78,64,57
34,r_75_91_159,seq97,r_5_30_122,r_5_30_122,1.0,41,163,122,57
75,seq63,r_103_111_117,r_27_133_95,r_27_133_95,0.55,0,95,95,57
60,seq38,r_71_2_169,r_5_30_122,r_5_30_122,0.98,47,169,122,57
17,r_46_115_143,seq114,seq129,r_46_115_143,0.52,0,143,143,57
9,r_94_101_190,seq18,r_121_108_79,r_121_108_79,0.87,111,190,79,57
22,r_74_76_76,seq21,seq16,r_74_76_76,1.0,-1,75,76,57
23,r_95_98_72,r_100_25_151,seq135,r_95_98_72,0.59,0,72,72,57
35,r_4_104_60,r_69_59_1,seq48,r_4_104_60,0.68,58,118,60,57
27,r_84_62_12,r_117_12_189,r_31_61_14,r_31_61_14,0.78,0,14,14,57
12,r_17_29_152,seq60,seq0,r_17_29_152,0.97,1,153,152,57
30,r_136_56_159,seq131,seq60,r_136_56_159,0.86,0,159,159,58
36,r_80_31_122,r_75_1_147,seq13,r_80_31_122,0.97,0,122,122,58
8,r_62_105_119,seq22,seq27,r_62_105_119,0.97,0,119,119,58
55,seq36,seq117,r_114_72_103,r_114_72_103,1.0,7,110,103,58
16,r_118_126_188,seq26,r_80_31_122,r_118_126_188,0.37,0,188,188,58
39,r_134_119_63,r_84_110_149,seq30,r_134_119_63,1.0,0,63,63,58
14,r_11_10_44,r_129_86_195,seq117,r_11_10_44,0.99,-1,43,44,58
13,r_88_93_116,seq83,r_64_44_39,r_64_44_39,1.0,9,48,39,58
32,r_65_94_53,r_11_10_44,r_114_72_103,r_114_72_103,1.0,70,173,103,58
10,r_0_120_20,r_11_10_44,seq83,r_0_120_20,1.0,0,20,20,58
15,r_113_92_42,seq7,r_25_70_4,r_113_92_42,1.0,-1,41,42,58
19,r_58_66_19,seq13,seq55,r_58_66_19,1.0,0,19,19,58
66,seq50,r_16_6_155,r_99_133_62,r_99_133_62,0.99,116,178,62,58
37,r_38_74_26,seq2,seq5,r_38_74_26,1.0,0,26,26,58
31,r_89_18_93,r_132_76_151,seq111,r_89_18_93,1.0,0,93,93,58
67,seq51,r_32_21_84,seq131,r_32_21_84,1.0,0,84,84,58
3,r_16_6_155,seq50,seq7,r_16_6_155,0.37,2,157,155,58
25,r_125_121_45,r_98_61_88,seq96,r_125_121_45,0.98,0,45,45,58
0,r_98_61_88,seq116,seq22,r_98_61_88,1.0,0,88,88,58
11,r_35_85_138,r_97_123_142,r_32_21_84,r_35_85_138,1.0,0,138,138,58
68,seq55,seq36,r_58_66_19,r_58_66_19,1.0,2,21,19,58
35,r_64_44_39,seq59,r_88_93_116,r_64_44_39,1.0,0,39,39,58
13,r_88_93_116,r_64_44_39,r_34_54_51,r_88_93_116,1.0,2,118,116,58
6,r_32_21_84,seq51,r_134_119_63,r_32_21_84,1.0,0,84,84,58
99,seq127,seq48,r_0_120_20,r_0_120_20,0.53,114,134,20,58
27,r_97_123_142,seq95,r_14_15_33,r_97_123_142,1.0,0,142,142,58
74,seq68,seq111,r_137_4_82,r_137_4_82,1.0,38,120,82,58
18,r_132_76_151,r_103_139_199,seq26,r_103_139_199,0.71,-46,153,199,58
24,r_114_72_103,seq111,seq36,r_114_72_103,1.0,3,106,103,58
35,r_64_44_39,r_88_93_116,r_99_133_62,r_64_44_39,0.53,79,118,39,58
33,r_3_17_129,seq39,seq42,r_3_17_129,0.99,0,129,129,58
50,seq26,r_84_110_149,r_132_76_151,r_84_110_149,0.69,4,153,149,58
58,seq40,seq33,r_98_61_88,r_98_61_88,1.0,8,96,88,58
2,r_101_47_21,seq40,r_103_139_199,r_101_47_21,1.0,1,22,21,58
38,r_90_135_66,seq117,seq73,r_90_135_66,0.91,1,67,66,58
81,seq83,seq45,r_0_120_20,r_0_120_20,1.0,0,20,20,58
17,r_137_4_82,seq5,seq68,r_137_4_82,0.97,0,82,82,58
43,seq7,r_113_92_42,seq26,r_113_92_42,0.89,-7,35,42,58
26,r_14_15_33,seq59,seq55,r_14_15_33,1.0,0,33,33,58
9,r_52_69_181,seq5,r_58_66_19,r_52_69_181,0.6,-3,178,181,58
26,r_14_15_33,seq55,r_97_123_142,r_97_123_142,1.0,10,152,142,58
96,seq116,r_98_61_88,seq71,r_98_61_88,1.0,-21,67,88,58
28,r_99_133_62,r_103_139_199,r_64_44_39,r_99_133_62,1.0,1,63,62,58
7,r_84_110_149,seq26,r_129_86_195,r_84_110_149,0.95,0,149,149,58
20,r_34_54_51,seq30,seq2,r_34_54_51,0.92,0,51,51,58
97,seq116,r_132_30_57,seq98,r_132_30_57,1.0,1,58,57,59
26,r_17_136_26,seq63,seq27,r_17_136_26,1.0,0,26,26,59
4,r_21_62_29,r_82_125_78,seq7,r_21_62_29,0.84,0,29,29,59
36,r_95_55_62,r_75_22_38,r_85_99_169,r_95_55_62,0.97,0,62,62,59
21,r_122_92_144,r_75_22_38,r_139_15_45,r_139_15_45,1.0,3,48,45,59
83,seq83,seq23,r_139_15_45,r_139_15_45,1.0,18,63,45,59
37,r_121_28_191,r_18_8_77,r_84_93_106,r_18_8_77,0.88,-5,72,77,59
39,r_88_79_64,seq91,r_25_123_101,r_88_79_64,0.94,0,64,64,59
1,r_82_125_78,r_52_107_159,seq134,r_82_125_78,0.97,2,80,78,59
37,r_121_28_191,r_84_93_106,r_20_37_3,r_84_93_106,0.84,7,113,106,59
29,r_26_58_56,r_68_71_68,seq39,r_26_58_56,1.0,2,58,56,59
39,r_88_79_64,r_25_123_101,r_126_104_122,r_88_79_64,0.54,79,143,64,59
36,r_95_55_62,r_85_99_169,r_18_8_77,r_95_55_62,0.63,22,84,62,59
3,r_84_93_106,r_121_28_191,seq12,r_84_93_106,0.96,-3,103,106,59
78,seq69,r_131_101_176,r_68_71_68,r_68_71_68,1.0,15,83,68,59
0,r_18_8_77,r_121_28_191,r_95_55_62,r_18_8_77,0.93,-8,69,77,59
11,r_38_49_118,r_126_104_122,r_70_3_17,r_70_3_17,0.32,101,118,17,59
13,r_11_14_67,r_25_123_101,r_70_3_17,r_11_14_67,0.71,4,71,67,59
15,r_85_99_169,seq48,r_121_28_191,r_121_28_191,0.56,-21,170,191,59
6,r_87_120_87,seq78,seq45,r_87_120_87,0.52,3,90,87,59
21,r_122_92_144,r_139_15_45,seq60,r_122_92_144,0.58,0,144,144,59
2,r_139_15_45,r_122_92_144,r_17_136_26,r_122_92_144,1.0,-19,125,144,59
27,r_44_73_185,seq78,r_54_67_11,r_54_67_11,0.98,175,186,11,59
87,seq96,r_65_77_161,r_102_31_86,r_102_31_86,1.0,23,109,86,59
33,r_132_30_57,seq116,seq61,r_132_30_57,1.0,1,58,57,59
25,r_68_71_68,seq78,seq69,r_68_71_68,0.81,1,69,68,59
86,seq91,r_139_15_45,r_5_119_7,r_139_15_45,1.0,0,45,45,59
34,r_43_117_8,r_5_119_7,seq78,r_43_117_8,0.39,80,88,8,59
75,seq61,r_88_79_64,r_132_30_57,r_132_30_57,0.57,6,63,57,59
60,seq39,seq124,r_26_58_56,r_26_58_56,1.0,27,83,56,59
81,seq78,r_68_71_68,r_44_73_185,r_68_71_68,1.0,1,69,68,59
18,r_127_138_21,r_81_46_174,r_5_119_7,r_127_138_21,0.97,0,21,21,59
9,r_126_104_122,r_38_49_118,r_88_79_64,r_88_79_64,1.0,54,118,64,59
28,r_81_46_174,seq76,r_132_30_57,r_132_30_57,1.0,117,174,57,59
7,r_100_24_114,seq118,r_127_138_21,r_100_24_114,0.95,0,114,114,59
18,r_127_138_21,r_5_119_7,r_100_24_114,r_100_24_114,1.0,9,123,114,59
23,r_102_31_86,seq110,seq89,r_102_31_86,1.0,0,86,86,59
12,r_108_74_160,seq80,seq16,r_108_74_160,0.26,4,164,160,59
2,r_139_15_45,seq91,r_122_92_144,r_139_15_45,1.0,0,45,45,59
32,r_13_55_151,seq72,r_69_24_31,r_13_55_151,0.99,0,151,151,60
36,r_29_130_156,r_126_83_186,seq97,r_29_130_156,0.78,1,157,156,60
92,seq106,r_27_73_96,seq26,r_27_73_96,0.99,4,100,96,60
14,r_110_65_175,r_109_41_79,seq0,r_109_41_79,0.86,5,84,79,60
8,r_77_82_140,seq134,seq57,r_77_82_140,0.89,0,140,140,60
43,seq3,r_108_93_131,seq72,r_108_93_131,0.98,-20,111,131,60
73,seq66,r_47_31_46,r_58_6_27,r_47_31_46,0.62,1,47,46,60
86,seq97,r_49_102_78,r_29_130_156,r_29_130_156,0.85,1,157,156,60
37,r_91_116_70,r_81_30_150,seq59,r_91_116_70,0.88,0,70,70,60
86,seq97,seq100,r_49_102_78,r_49_102_78,0.98,6,84,78,60
21,r_9_123_126,seq3,seq5,r_9_123_126,0.9,0,126,126,60
5,r_50_92_69,seq72,seq100,r_50_92_69,0.97,0,69,69,60
80,seq76,r_133_121_173,r_47_31_46,r_47_31_46,1.0,122,168,46,60
69,seq59,r_126_83_186,r_91_116_70,r_91_116_70,0.8,21,91,70,60
45,seq5,r_11_22_179,r_90_99_97,r_90_99_97,1.0,83,180,97,60
31,r_11_22_179,seq5,r_95_48_11,r_95_48_11,0.72,169,180,11,60
89,seq103,r_23_137_189,r_101_85_2,r_101_85_2,0.53,188,190,2,60
10,r_49_102_78,seq3,seq97,r_49_102_78,0.85,0,78,78,60
90,seq104,r_126_83_186,r_58_6_27,r_58_6_27,0.77,159,186,27,60
72,seq64,r_90_99_97,r_75_12_93,r_90_99_97,1.0,0,97,97,60
14,r_110_65_175,seq0,seq2,r_110_65_175,0.51,0,175,175,60
4,r_132_42_115,seq38,r_49_102_78,r_49_102_78,0.85,42,120,78,60
0,r_90_99_97,seq64,seq66,r_90_99_97,1.0,0,97,97,60
11,r_108_93_131,seq3,seq20,r_108_93_131,0.89,0,131,131,60
3,r_58_6_27,seq10,seq104,r_58_6_27,0.99,9,36,27,60
20,r_96_56_63,seq103,seq20,r_96_56_63,1.0,0,63,63,60
13,r_27_73_96,seq106,seq76,r_27_73_96,0.99,0,96,96,60
16,r_69_24_31,r_109_41_79,r_117_88_52,r_69_24_31,1.0,1,32,31,60
6,r_8_128_128,r_75_12_93,r_49_102_78,r_8_128_128,0.77,0,128,128,60
10,r_49_102_78,seq97,r_8_128_128,r_8_128_128,1.0,15,143,128,60
27,r_115_127_145,seq40,seq15,r_115_127_145,0.8,6,151,145,60
24,r_16_78_72,seq3,seq25,r_16_78_72,0.55,0,72,72,60
64,seq46,r_115_127_145,seq40,r_115_127_145,0.93,6,151,145,60
61,seq40,r_115_127_145,seq0,r_115_127_145,1.0,6,151,145,60
25,r_95_48_11,r_23_137_189,seq138,r_95_48_11,0.79,0,11,11,60
77,seq72,r_50_92_69,seq3,r_50_92_69,1.0,0,69,69,60
34,r_39_119_75,seq131,seq103,r_39_119_75,1.0,0,75,75,60
30,r_136_52_15,r_81_30_150,r_117_88_52,r_136_52_15,0.98,0,15,15,60
2,r_47_31_46,seq66,seq76,r_47_31_46,1.0,1,47,46,60
17,r_126_83_186,seq104,r_87_84_119,r_126_83_186,0.56,0,186,186,60
9,r_23_137_189,seq103,r_47_31_46,r_47_31_46,1.0,144,190,46,60
99,seq138,seq79,r_95_48_11,r_95_48_11,0.94,7,18,11,60
22,r_67_44_185,r_126_83_186,seq74,r_67_44_185,0.47,1,186,185,60
28,r_117_88_52,seq54,r_136_52_15,r_117_88_52,0.58,22,74,52,60
73,seq66,r_58_6_27,r_90_99_97,r_90_99_97,1.0,21,118,97,60
7,r_109_41_79,r_110_65_175,seq20,r_109_41_79,0.97,0,79,79,60
39,r_118_86_47,r_16_78_72,seq131,r_118_86_47,1.0,1,48,47,60
35,r_19_124_90,seq100,seq28,r_19_124_90,0.91,0,90,90,60
12,r_35_62_142,seq37,r_50_92_69,r_35_62_142,0.99,0,142,142,60
8,r_114_85_67,r_47_97_188,r_118_32_25,r_114_85_67,1.0,0,67,67,61
43,seq3,r_63_80_66,seq7,r_63_80_66,1.0,0,66,66,61
17,r_55_28_22,r_18_50_41,r_120_42_145,r_120_42_145,0.69,-123,22,145,61
16,r_128_134_111,r_124_71_187,r_63_80_66,r_128_134_111,0.98,0,111,111,61
1,r_62_135_151,r_124_71_187,seq6,r_62_135_151,0.63,1,152,151,61
86,seq98,r_105_89_149,r_138_14_39,r_138_14_39,0.99,2,41,39,61
5,r_59_116_45,r_114_85_67,seq52,r_114_85_67,0.92,-24,43,67,61
19,r_105_89_149,seq136,r_78_12_115,r_105_89_149,0.74,0,149,149,61
11,r_44_58_156,r_36_37_133,r_46_108_131,r_46_108_131,1.0,25,156,131,61
30,r_113_45_36,r_4_127_64,seq132,r_113_45_36,1.0,0,36,36,61
89,seq101,r_139_16_104,seq104,r_139_16_104,0.68,3,107,104,61
3,r_84_30_88,r_91_109_97,r_59_116_45,r_91_109_97,0.86,-9,88,97,61
10,r_63_80_66,seq3,seq35,r_63_80_66,0.95,0,66,66,61
9,r_60_15_20,r_44_58_156,seq52,r_60_15_20,0.79,-4,16,20,61
90,seq104,r_62_135_151,seq67,r_62_135_151,1.0,1,152,151,61
36,r_54_122_16,r_46_108_131,seq106,r_54_122_16,0.65,0,16,16,61
26,r_66_5_157,r_115_57_116,seq111,r_115_57_116,0.99,0,116,116,61
14,r_120_42_145,seq95,r_55_28_22,r_55_28_22,1.0,2,24,22,61
14,r_120_42_145,r_55_28_22,r_113_45_36,r_113_45_36,0.89,117,153,36,61
73,seq69,r_41_21_85,seq24,r_41_21_85,0.78,23,108,85,61
11,r_44_58_156,r_87_126_63,r_36_37_133,r_44_58_156,0.52,-95,61,156,61
66,seq49,seq100,r_115_57_116,r_115_57_116,1.0,2,118,116,61
13,r_91_109_97,r_36_37_133,r_103_23_95,r_91_109_97,1.0,0,97,97,61
48,seq136,r_105_89_149,r_138_14_39,r_138_14_39,1.0,110,149,39,61
73,seq69,seq24,r_64_72_137,r_64_72_137,0.85,11,148,137,61
6,r_103_23_95,seq119,r_91_109_97,r_91_109_97,1.0,5,102,97,61
38,r_31_25_27,r_41_21_85,seq92,r_31_25_27,0.94,1,28,27,61
27,r_47_97_188,seq13,seq106,r_47_97_188,0.48,0,188,188,61
30,r_113_45_36,seq132,r_120_42_145,r_113_45_36,0.56,106,142,36,61
82,seq92,r_130_81_19,r_31_25_27,r_31_25_27,1.0,0,27,27,61
2,r_46_108_131,seq65,seq2,r_46_108_131,0.91,0,131,131,61
18,r_96_82_93,seq90,seq6,r_96_82_93,1.0,0,93,93,61
96,seq119,r_130_81_19,r_118_32_25,r_118_32_25,1.0,1,26,25,61
25,r_124_71_187,seq104,r_103_23_95,r_124_71_187,0.49,0,187,187,61
39,r_4_127_64,seq106,seq39,r_4_127_64,0.99,-7,57,64,61
32,r_64_72_137,seq17,seq69,r_64_72_137,0.63,6,143,137,61
34,r_53_19_108,r_129_107_154,seq117,r_53_19_108,0.66,-8,100,108,61
21,r_18_50_41,seq26,seq56,r_18_50_41,1.0,0,41,41,61
15,r_118_32_25,seq133,seq119,r_118_32_25,0.96,1,26,25,61
81,seq90,r_96_82_93,r_84_30_88,r_96_82_93,0.76,0,93,93,61
22,r_78_12_115,seq39,r_41_21_85,r_78_12_115,0.47,2,117,115,61
28,r_29_10_160,seq52,seq136,r_29_10_160,0.82,1,161,160,61
7,r_115_57_116,r_66_5_157,seq49,r_115_57_116,1.0,0,116,116,61
23,r_41_21_85,seq69,seq110,r_41_21_85,0.72,-5,80,85,61
68,seq52,r_138_14_39,r_59_116_45,r_138_14_39,0.94,-6,33,39,61
17,r_55_28_22,r_120_42_145,seq9,r_55_28_22,0.47,131,153,22,61
48,seq136,r_138_14_39,r_29_10_160,r_29_10_160,0.86,11,171,160,61
35,r_87_126_63,r_44_58_156,seq131,r_87_126_63,0.95,0,63,63,61
26,r_66_5_157,seq111,r_31_25_27,r_66_5_157,0.91,0,157,157,61
12,r_139_16_104,seq101,r_31_25_27,r_139_16_104,0.67,1,105,104,61
24,r_138_14_39,r_29_10_160,seq98,r_138_14_39,1.0,0,39,39,61
30,r_12_76_158,r_66_21_180,seq53,r_12_76_158,0.72,0,158,158,62
51,seq16,r_109_92_153,r_138_100_6,r_109_92_153,0.93,-45,108,153,62
92,seq111,r_130_136_108,r_57_120_72,r_57_120_72,1.0,9,81,72,62
8,r_17_22_119,seq89,seq62,r_17_22_119,0.96,3,122,119,62
56,seq25,r_14_41_38,r_61_118_9,r_61_118_9,0.79,1,10,9,62
54,seq23,seq126,r_82_84_93,r_82_84_93,1.0,73,166,93,62
83,seq89,r_17_22_119,r_14_41_38,r_17_22_119,0.98,-33,86,119,62
15,r_104_87_48,r_94_9_94,seq20,r_94_9_94,0.83,-59,35,94,62
37,r_57_120_72,seq24,seq111,r_57_120_72,1.0,-1,71,72,62
24,r_69_119_16,seq26,seq52,r_69_119_16,1.0,0,16,16,62
16,r_68_38_182,seq28,seq27,r_68_38_182,0.56,0,182,182,62
21,r_33_79_58,r_74_60_71,seq50,r_74_60_71,0.98,-10,61,71,62
39,r_80_40_66,seq48,seq139,r_80_40_66,1.0,0,66,66,62
1,r_113_19_127,r_66_21_180,r_31_107_107,r_31_107_107,0.95,60,167,107,62
35,r_39_32_60,r_66_21_180,seq111,r_39_32_60,1.0,-1,59,60,62
45,seq5,seq112,r_137_121_57,r_137_121_57,1.0,43,100,57,62
19,r_15_0_92,r_66_21_180,seq11,r_15_0_92,1.0,0,92,92,62
3,r_2_67_109,seq62,seq48,r_2_67_109,0.98,1,110,109,62
10,r_6_54_67,r_109_92_153,seq42,r_6_54_67,1.0,0,67,67,62
26,r_94_9_94,r_51_30_134,seq85,r_94_9_94,1.0,0,94,94,62
4,r_109_92_153,seq16,r_65_90_132,r_109_92_153,1.0,0,153,153,62
0,r_73_103_102,seq134,seq44,r_73_103_102,0.91,2,104,102,62
99,seq126,seq23,r_65_90_132,r_65_90_132,1.0,4,136,132,62
20,r_74_60_71,r_125_83_173,seq28,r_74_60_71,1.0,1,72,71,62
13,r_127_29_121,r_135_64_143,seq126,r_127_29_121,0.96,0,121,121,62
48,seq10,r_93_101_166,seq58,r_93_101_166,1.0,-101,65,166,62
33,r_66_21_180,seq27,r_73_103_102,r_66_21_180,0.82,2,182,180,62
6,r_135_64_143,seq27,seq52,r_135_64_143,0.98,1,144,143,62
76,seq63,r_33_79_58,r_75_116_10,r_75_116_10,0.98,1,11,10,62
27,r_77_36_154,seq13,r_138_100_6,r_77_36_154,0.9,0,154,154,62
2,r_86_37_149,r_65_90_132,r_33_79_58,r_65_90_132,0.57,0,132,132,62
18,r_71_131_88,seq44,seq114,r_71_131_88,0.95,0,88,88,62
29,r_31_107_107,r_109_92_153,seq27,r_31_107_107,0.85,0,107,107,62
22,r_35_59_59,r_8_133_190,seq49,r_35_59_59,0.62,-18,41,59,62
25,r_51_30_134,seq49,r_138_100_6,r_51_30_134,0.72,0,134,134,62
33,r_66_21_180,r_113_19_127,seq27,r_113_19_127,0.43,3,130,127,62
28,r_75_116_10,seq52,seq63,r_75_116_10,0.99,0,10,10,62
50,seq13,r_77_36_154,seq27,r_77_36_154,1.0,0,154,154,62
58,seq27,r_135_64_143,seq13,r_135_64_143,1.0,1,144,143,62
65,seq46,seq63,r_137_121_57,r_137_121_57,0.94,58,115,57,62
32,r_130_136_108,seq111,r_138_100_6,r_130_136_108,0.76,5,113,108,62
77,seq139,seq126,r_80_40_66,r_80_40_66,1.0,5,71,66,62
17,r_82_84_93,seq3,seq23,r_82_84_93,1.0,0,93,93,62
9,r_70_122_96,seq28,seq128,r_70_122_96,1.0,0,96,96,62
2,r_86_37_149,r_33_79_58,r_65_90_132,r_86_37_149,0.56,1,150,149,62
11,r_137_121_57,r_15_0_92,seq5,r_137_121_57,1.0,1,58,57,62
36,r_60_102_57,r_130_47_133,seq79,r_60_102_57,0.84,5,62,57,63
53,seq21,r_61_12_1,r_80_31_69,r_80_31_69,1.0,3,72,69,63
43,seq3,r_18_96_175,r_44_97_62,r_44_97_62,1.0,2,64,62,63
8,r_130_47_133,r_60_102_57,r_50_88_19,r_130_47_133,0.94,-102,31,133,63
59,seq32,seq4,r_100_49_83,r_100_49_83,1.0,21,104,83,63
16,r_50_88_19,seq128,r_130_47_133,r_50_88_19,0.95,0,19,19,63
21,r_56_122_171,seq51,seq45,r_56_122_171,0.3,7,178,171,63
39,r_120_111_79,r_61_12_1,seq23,r_120_111_79,0.65,-13,66,79,63
1,r_77_8_116,seq19,r_62_29_14,r_77_8_116,1.0,0,116,116,63
32,r_101_7_16,r_18_96_175,r_24_138_90,r_101_7_16,1.0,0,16,16,63
5,r_121_48_126,r_17_85_105,r_67_119_13,r_121_48_126,0.84,-19,107,126,63
42,seq2,r_18_96_175,r_24_138_90,r_24_138_90,1.0,16,106,90,63
80,seq75,r_89_98_77,seq45,r_89_98_77,0.48,24,101,77,63
32,r_101_7_16,r_24_138_90,seq132,r_24_138_90,1.0,0,90,90,63
19,r_78_137_78,seq20,seq23,r_78_137_78,0.82,6,84,78,63
31,r_33_5_99,r_9_34_118,r_60_102_57,r_33_5_99,0.56,0,99,99,63
10,r_22_118_146,r_62_29_14,seq45,r_22_118_146,0.82,0,146,146,63
0,r_104_0_30,seq69,seq128,r_104_0_30,1.0,0,30,30,63
26,r_89_98_77,seq75,seq81,r_89_98_77,0.76,11,88,77,63
8,r_130_47_133,r_50_88_19,r_60_102_57,r_50_88_19,0.52,114,133,19,63
16,r_50_88_19,r_130_47_133,r_131_68_119,r_50_88_19,0.48,114,133,19,63
4,r_110_14_158,seq84,r_130_47_133,r_110_14_158,0.3,-22,136,158,63
5,r_121_48_126,r_67_119_13,seq63,r_121_48_126,0.85,2,128,126,63
11,r_80_31_69,seq4,seq21,r_80_31_69,1.0,0,69,69,63
3,r_67_119_13,seq84,seq54,r_67_119_13,0.96,0,13,13,63
20,r_17_85_105,r_121_48_126,seq136,r_17_85_105,0.74,3,108,105,63
15,r_24_138_90,seq55,seq2,r_24_138_90,1.0,0,90,90,63
25,r_30_39_20,seq73,seq128,r_30_39_20,0.91,0,20,20,63
99,seq127,r_92_66_52,r_10_46_71,r_10_46_71,1.0,1,72,71,63
18,r_44_97_62,seq15,seq3,r_44_97_62,1.0,0,62,62,63
29,r_18_96_175,seq2,r_67_119_13,r_18_96_175,0.51,1,176,175,63
64,seq42,r_18_96_175,r_44_97_62,r_44_97_62,1.0,44,106,62,63
61,seq38,seq2,r_25_126_148,r_25_126_148,1.0,2,150,148,63
38,r_25_126_148,r_62_29_14,seq38,r_25_126_148,0.73,0,148,148,63
30,r_74_108_15,r_92_66_52,seq95,r_74_108_15,0.98,0,15,15,63
4,r_110_14_158,r_130_47_133,seq4,r_110_14_158,0.61,0,158,158,63
9,r_10_46_71,r_80_31_69,seq127,r_10_46_71,1.0,0,71,71,63
96,seq116,r_58_106_186,r_86_43_120,r_58_106_186,0.44,-8,178,186,63
17,r_53_1_18,r_121_48_126,seq20,r_53_1_18,1.0,-2,16,18,63
22,r_131_68_119,r_139_76_195,r_50_88_19,r_131_68_119,0.65,0,119,119,63
28,r_58_106_186,r_123_109_196,r_80_31_69,r_80_31_69,0.91,119,188,69,63
2,r_125_6_54,r_89_98_77,seq117,r_125_6_54,0.98,1,55,54,63
23,r_100_49_83,seq129,seq32,r_100_49_83,1.0,0,83,83,63
35,r_9_34_118,seq54,r_80_31_69,r_9_34_118,0.56,0,118,118,63
23,r_127_48_101,r_37_29_132,r_103_113_51,r_103_113_51,1.0,1,52,51,64
30,r_14_117_124,r_99_46_148,seq94,r_14_117_124,0.98,0,124,124,64
33,r_98_23_52,r_109_25_54,seq9,r_98_23_52,1.0,-1,51,52,64
36,r_73_52_81,r_136_129_160,r_10_21_154,r_73_52_81,0.82,73,154,81,64
38,r_55_120_111,r_49_96_73,r_70_78_86,r_55_120_111,0.98,0,111,111,64
14,r_72_12_135,seq9,r_49_96_73,r_49_96_73,0.8,65,138,73,64
8,r_59_54_88,seq38,seq22,r_59_54_88,1.0,1,89,88,64
16,r_108_47_133,r_136_129_160,seq134,r_136_129_160,0.77,-26,134,160,64
21,r_70_78_86,seq7,seq94,r_70_78_86,1.0,1,87,86,64
1,r_32_133_68,seq104,seq35,r_32_133_68,1.0,0,68,68,64
28,r_136_129_160,r_50_114_37,r_77_112_49,r_136_129_160,0.97,0,160,160,64
25,r_50_114_37,seq35,seq42,r_50_114_37,1.0,0,37,37,64
69,seq51,r_95_71_180,r_130_122_42,r_130_122_42,1.0,138,180,42,64
12,r_103_113_51,r_127_48_101,r_37_29_132,r_103_113_51,0.6,53,104,51,64
19,r_10_21_154,r_63_76_128,r_37_29_132,r_63_76_128,0.89,0,128,128,64
0,r_4_100_185,r_0_53_45,r_73_52_81,r_0_53_45,1.0,-2,43,45,64
10,r_83_33_79,seq134,r_50_114_37,r_83_33_79,0.84,0,79,79,64
23,r_127_48_101,r_103_113_51,seq35,r_127_48_101,0.89,0,101,101,64
24,r_69_26_22,r_124_3_175,r_103_113_51,r_103_113_51,1.0,17,68,51,64
12,r_103_113_51,r_109_25_54,r_127_48_101,r_103_113_51,1.0,0,51,51,64
39,r_97_132_31,r_108_47_133,seq60,r_97_132_31,1.0,0,31,31,64
20,r_24_137_123,r_14_117_124,r_80_111_36,r_24_137_123,0.79,0,123,123,64
37,r_66_102_39,r_59_54_88,seq35,r_66_102_39,1.0,-2,37,39,64
65,seq42,r_108_47_133,r_50_114_37,r_50_114_37,1.0,0,37,37,64
6,r_49_96_73,seq27,r_55_120_111,r_49_96_73,1.0,0,73,73,64
62,seq39,r_14_117_124,seq104,r_14_117_124,1.0,0,124,124,64
29,r_80_111_36,seq13,seq2,r_80_111_36,0.85,-7,29,36,64
0,r_4_100_185,r_73_52_81,r_98_23_52,r_73_52_81,0.38,104,185,81,64
32,r_105_15_15,r_124_3_175,seq18,r_105_15_15,0.95,0,15,15,64
63,seq40,r_130_122_42,seq60,r_130_122_42,1.0,-11,31,42,64
2,r_95_71_180,seq51,seq64,r_95_71_180,0.56,0,180,180,64
3,r_5_67_28,seq18,seq106,r_5_67_28,1.0,0,28,28,64
24,r_69_26_22,r_108_47_133,r_124_3_175,r_69_26_22,0.85,0,22,22,64
18,r_124_3_175,seq56,r_50_114_37,r_50_114_37,0.99,138,175,37,64
27,r_77_112_49,seq91,r_136_129_160,r_136_129_160,0.99,2,162,160,64
17,r_63_76_128,seq39,r_68_57_140,r_63_76_128,0.64,32,160,128,64
70,seq56,r_124_3_175,seq11,r_124_3_175,0.95,0,175,175,64
27,r_77_112_49,r_10_21_154,seq65,r_77_112_49,1.0,0,49,49,64
19,r_10_21_154,r_37_29_132,r_73_52_81,r_10_21_154,0.96,1,155,154,64
4,r_130_122_42,seq40,seq36,r_130_122_42,1.0,0,42,42,64
61,seq38,r_59_54_88,seq64,r_59_54_88,0.98,2,90,88,64
38,r_55_120_111,seq36,r_49_96_73,r_49_96_73,1.0,1,74,73,64
34,r_68_57_140,seq118,r_63_76_128,r_68_57_140,0.95,1,141,140,64
13,r_89_139_32,seq1,seq115,r_89_139_32,0.97,-5,27,32,64
90,seq106,r_124_3_175,r_5_67_28,r_5_67_28,1.0,1,29,28,64
59,seq36,seq90,r_130_122_42,r_130_122_42,1.0,1,43,42,64
6,r_49_96_73,r_55_120_111,r_130_122_42,r_55_120_111,1.0,0,111,111,64
17,r_63_76_128,r_10_21_154,seq39,r_63_76_128,0.82,0,128,128,64
9,r_61_16_100,r_24_137_123,seq79,r_61_16_100,0.97,0,100,100,64
26,r_88_74_4,seq115,r_108_47_133,r_88_74_4,0.4,134,138,4,64
22,r_37_29_132,seq9,r_32_133_68,r_32_133_68,1.0,82,150,68,64
28,r_136_129_160,r_108_47_133,r_50_114_37,r_50_114_37,0.99,97,134,37,64
91,seq110,r_99_46_148,seq65,r_99_46_148,1.0,0,148,148,64
11,r_0_53_45,r_4_100_185,r_105_15_15,r_0_53_45,1.0,0,45,45,64
56,seq30,r_138_107_115,seq2,r_138_107_115,1.0,-55,60,115,64
7,r_99_46_148,seq110,r_97_132_31,r_99_46_148,0.93,0,148,148,64
84,seq91,seq65,r_77_112_49,r_77_112_49,1.0,69,118,49,64
33,r_7_109_50,r_70_135_82,r_73_127_199,r_7_109_50,1.0,1,51,50,65
36,r_12_90_171,r_65_76_169,r_38_31_102,r_12_90_171,0.44,0,171,171,65
9,r_66_105_11,seq0,r_118_103_37,r_118_103_37,1.0,87,124,37,65
25,r_46_62_117,seq133,r_84_110_42,r_84_110_42,0.99,6,48,42,65
14,r_95_71_152,r_125_136_176,r_122_57_77,r_95_71_152,0.96,0,152,152,65
37,r_2_100_158,seq129,seq61,r_2_100_158,0.75,0,158,158,65
2,r_55_87_33,seq130,seq0,r_55_87_33,1.0,0,33,33,65
30,r_94_49_12,r_65_76_169,seq0,r_94_49_12,0.87,0,12,12,65
16,r_59_64_115,r_101_98_174,seq75,r_59_64_115,0.99,0,115,115,65
39,r_22_128_67,seq133,seq137,r_22_128_67,1.0,2,69,67,65
5,r_139_14_151,seq91,r_125_136_176,r_139_14_151,0.86,0,151,151,65
46,seq129,r_2_100_158,seq20,r_2_100_158,0.95,0,158,158,65
9,r_66_105_11,seq61,seq0,r_66_105_11,1.0,0,11,11,65
78,seq61,seq117,r_2_100_158,r_2_100_158,1.0,1,159,158,65
76,seq58,r_44_48_130,seq119,r_44_48_130,1.0,0,130,130,65
31,r_88_39_111,seq68,seq114,r_88_39_111,1.0,1,112,111,65
3,r_70_135_82,r_121_107_163,r_77_80_62,r_70_135_82,1.0,0,82,82,65
10,r_121_107_163,seq114,r_102_126_164,r_121_107_163,0.62,0,163,163,65
26,r_77_80_62,seq86,r_70_135_82,r_70_135_82,1.0,5,87,82,65
0,r_111_6_41,seq1,seq67,r_111_6_41,1.0,0,41,41,65
23,r_84_110_42,r_88_39_111,r_46_62_117,r_84_110_42,1.0,0,42,42,65
11,r_33_93_184,seq53,r_108_43_22,r_33_93_184,0.52,0,184,184,65
20,r_10_81_101,seq60,seq16,r_10_81_101,0.99,0,101,101,65
13,r_97_36_93,seq28,seq58,r_97_36_93,1.0,-2,91,93,65
15,r_23_9_133,seq132,seq0,r_23_9_133,1.0,0,133,133,65
57,seq21,seq13,r_134_41_104,r_134_41_104,0.93,30,134,104,65
6,r_122_57_77,r_134_41_104,r_7_109_50,r_122_57_77,1.0,0,77,77,65
8,r_108_43_22,r_55_87_33,seq27,r_108_43_22,0.54,0,22,22,65
74,seq53,r_33_93_184,r_44_48_130,r_44_48_130,0.99,39,169,130,65
18,r_69_96_60,seq138,seq114,r_69_96_60,1.0,0,60,60,65
29,r_85_17_147,seq16,r_10_81_101,r_10_81_101,0.96,1,102,101,65
24,r_44_48_130,seq58,seq53,r_44_48_130,0.98,0,130,130,65
12,r_4_99_31,r_70_135_82,seq130,r_70_135_82,0.74,-50,32,82,65
29,r_85_17_147,r_10_81_101,seq27,r_85_17_147,1.0,1,148,147,65
61,seq28,r_102_126_164,r_38_31_102,r_102_126_164,0.82,-79,85,164,65
32,r_125_136_176,r_95_71_152,r_139_14_151,r_125_136_176,0.92,-24,152,176,65
34,r_134_41_104,r_2_100_158,seq21,r_134_41_104,0.91,7,111,104,65
21,r_118_103_37,r_23_9_133,r_66_105_11,r_118_103_37,1.0,1,38,37,65
81,seq68,r_88_39_111,r_125_136_176,r_88_39_111,0.95,1,112,111,65
25,r_46_62_117,r_84_110_42,r_134_41_104,r_46_62_117,1.0,0,117,117,65
96,seq119,r_65_76_169,r_97_36_93,r_97_36_93,0.92,78,171,93,65
28,r_24_92_95,seq26,seq19,r_24_92_95,1.0,0,95,95,65
7,r_101_98_174,r_33_93_184,r_97_36_93,r_33_93_184,0.42,-10,174,184,65
19,r_89_83_30,seq27,r_4_99_31,r_89_83_30,0.94,0,30,30,65
35,r_3_37_159,r_102_126_164,r_84_110_42,r_3_37_159,0.77,1,160,159,65
23,r_84_110_42,r_46_62_117,r_7_109_50,r_46_62_117,0.99,0,117,117,65
8,r_124_8_47,seq36,r_131_79_166,r_124_8_47,1.0,0,47,47,66
18,r_118_96_20,r_55_35_21,seq102,r_118_96_20,0.97,0,20,20,66
36,r_92_54_175,seq31,r_23_38_56,r_23_38_56,1.0,120,176,56,66
14,r_88_53_96,seq45,seq75,r_88_53_96,1.0,0,96,96,66
13,r_10_93_42,r_131_79_166,seq133,r_10_93_42,1.0,1,43,42,66
37,r_63_51_68,seq81,seq44,r_63_51_68,0.99,0,68,68,66
71,seq74,r_34_109_139,r_95_69_25,r_95_69_25,0.83,62,87,25,66
16,r_59_22_174,seq16,r_34_109_139,r_34_109_139,0.52,1,140,139,66
21,r_57_67_77,r_76_29_193,seq129,r_57_67_77,1.0,0,77,77,66
39,r_94_116_82,seq113,seq72,r_94_116_82,0.81,38,120,82,66
5,r_100_39_128,seq113,seq103,r_100_39_128,0.87,0,128,128,66
58,seq40,seq45,r_17_37_133,r_17_37_133,0.83,1,134,133,66
80,seq98,r_34_109_139,r_43_20_114,r_43_20_114,0.67,25,139,114,66
4,r_95_69_25,seq62,seq137,r_95_69_25,1.0,0,25,25,66
69,seq68,seq133,r_55_35_21,r_55_35_21,0.87,38,59,21,66
12,r_14_49_31,r_5_135_32,seq19,r_14_49_31,0.93,0,31,31,66
31,r_130_85_172,r_132_33_192,r_58_4_165,r_130_85_172,0.73,0,172,172,66
11,r_99_18_134,r_131_79_166,seq45,r_99_18_134,0.97,0,134,134,66
16,r_59_22_174,r_34_109_139,r_0_107_105,r_59_22_174,0.74,0,174,174,66
25,r_65_41_107,r_23_38_56,r_124_8_47,r_65_41_107,0.9,-51,56,107,66
6,r_17_37_133,seq123,seq40,r_17_37_133,0.96,0,133,133,66
26,r_78_70_92,seq133,r_55_35_21,r_55_35_21,0.78,38,59,21,66
25,r_65_41_107,r_124_8_47,seq47,r_65_41_107,1.0,0,107,107,66
40,seq129,r_73_42_196,r_57_67_77,r_57_67_77,1.0,71,148,77,66
27,r_5_135_32,r_14_49_31,seq114,r_14_49_31,0.58,1,32,31,66
60,seq45,seq40,r_99_18_134,r_99_18_134,0.96,0,134,134,66
58,seq40,r_0_107_105,seq45,r_0_107_105,0.54,0,105,105,66
68,seq62,seq6,r_10_93_42,r_10_93_42,1.0,73,115,42,66
38,r_0_107_105,seq40,seq136,r_0_107_105,1.0,0,105,105,66
34,r_46_108_137,seq16,seq56,r_46_108_137,0.97,1,138,137,66
60,seq45,r_88_53_96,seq40,r_88_53_96,0.63,4,100,96,66
96,seq123,r_17_37_133,seq102,r_17_37_133,1.0,0,133,133,66
28,r_26_106_61,seq125,seq97,r_26_106_61,0.85,0,61,61,66
3,r_23_38_56,r_65_41_107,seq47,r_23_38_56,0.58,0,56,56,66
7,r_43_20_114,seq24,seq7,r_43_20_114,1.0,1,115,114,66
35,r_55_35_21,seq44,seq68,r_55_35_21,1.0,0,21,21,66
93,seq115,seq65,r_47_49_71,r_47_49_71,1.0,12,83,71,67
40,seq128,r_54_108_112,r_130_66_165,r_130_66_165,0.63,7,172,165,67
30,r_81_29_124,seq125,seq27,r_81_29_124,0.99,1,125,124,67
36,r_92_84_3,seq13,seq120,r_92_84_3,0.53,134,137,3,67
92,seq114,r_129_102_141,r_124_90_113,r_124_90_113,0.55,29,142,113,67
29,r_63_31_46,seq134,seq3,r_63_31_46,0.99,0,46,46,67
8,r_124_90_113,seq83,seq114,r_124_90_113,0.96,0,113,113,67
36,r_92_84_3,seq120,r_34_79_164,r_34_79_164,0.53,13,177,164,67
31,r_112_136_192,r_67_50_180,r_21_38_43,r_21_38_43,1.0,0,43,43,67
12,r_67_50_180,r_113_73_155,r_23_117_64,r_67_50_180,0.52,1,181,180,67
86,seq97,r_57_58_9,r_110_19_48,r_110_19_48,1.0,34,82,48,67
16,r_80_77_188,seq134,r_86_0_99,r_86_0_99,1.0,6,105,99,67
1,r_135_33_111,r_25_100_118,r_26_37_38,r_135_33_111,0.96,0,111,111,67
5,r_25_100_118,seq132,r_62_91_14,r_25_100_118,0.94,0,118,118,67
95,seq119,r_1_15_171,r_25_100_118,r_25_100_118,1.0,55,173,118,67
24,r_110_19_48,r_130_66_165,seq2,r_110_19_48,1.0,0,48,48,67
10,r_23_117_64,r_41_53_70,seq83,r_23_117_64,1.0,1,65,64,67
14,r_26_37_38,r_80_77_188,r_22_101_80,r_26_37_38,0.99,2,40,38,67
26,r_126_17_86,seq6,seq99,r_126_17_86,1.0,0,86,86,67
16,r_80_77_188,r_86_0_99,seq20,r_80_77_188,0.51,0,188,188,67
14,r_26_37_38,r_22_101_80,r_135_33_111,r_135_33_111,1.0,12,123,111,67
4,r_8_45_107,r_34_79_164,r_87_107_104,r_8_45_107,1.0,1,108,107,67
78,seq83,r_124_90_113,r_23_117_64,r_23_117_64,0.45,49,113,64,67
0,r_111_60_98,seq20,r_7_75_1,r_111_60_98,1.0,1,99,98,67
11,r_47_49_71,seq120,seq115,r_47_49_71,1.0,0,71,71,67
15,r_72_11_156,r_67_50_180,r_86_0_99,r_72_11_156,0.79,0,156,156,67
6,r_116_98_121,r_113_73_155,seq35,r_116_98_121,0.98,1,122,121,67
13,r_62_91_14,r_87_107_104,seq13,r_62_91_14,0.98,0,14,14,67
28,r_39_40_17,r_41_53_70,seq139,r_39_40_17,0.93,0,17,17,67
27,r_36_46_185,r_74_85_158,seq120,r_74_85_158,0.99,0,158,158,67
34,r_86_0_99,r_48_123_151,seq134,r_48_123_151,0.99,-1,150,151,67
87,seq99,seq139,r_126_17_86,r_126_17_86,1.0,9,95,86,67
41,seq2,r_80_77_188,r_110_19_48,r_110_19_48,1.0,4,52,48,67
2,r_113_73_155,seq5,seq18,r_113_73_155,0.96,0,155,155,67
39,r_78_69_20,r_124_90_113,r_87_107_104,r_78_69_20,0.99,0,20,20,67
3,r_131_14_52,seq115,r_21_38_43,r_131_14_52,0.87,0,52,52,67
40,seq128,r_7_75_1,r_54_108_112,r_54_108_112,1.0,-1,111,112,67
18,r_10_103_105,r_36_46_185,seq89,r_10_103_105,1.0,0,105,105,67
17,r_21_38_43,r_126_17_86,r_112_136_192,r_21_38_43,0.62,0,43,43,67
25,r_52_127_73,seq55,seq24,r_52_127_73,1.0,0,73,73,67
33,r_22_101_80,seq13,r_26_37_38,r_22_101_80,0.93,4,84,80,67
61,seq35,seq109,r_116_98_121,r_116_98_121,1.0,16,137,121,67
32,r_1_15_171,seq119,r_113_73_155,r_113_73_155,0.8,18,173,155,67
34,r_86_0_99,seq55,r_48_123_151,r_86_0_99,0.95,0,99,99,67
81,seq89,seq51,r_10_103_105,r_10_103_105,1.0,0,105,105,67
9,r_48_123_151,r_80_77_188,seq94,r_48_123_151,0.89,0,151,151,67
96,seq120,r_36_46_185,r_124_90_113,r_124_90_113,0.81,72,185,113,67
27,r_36_46_185,seq120,seq6,r_36_46_185,0.95,0,185,185,67
7,r_41_53_70,r_23_117_64,seq105,r_23_117_64,0.98,1,65,64,67
44,seq5,r_116_98_121,r_57_58_9,r_116_98_121,0.7,1,122,121,67
23,r_34_79_164,seq3,r_92_84_3,r_34_79_164,0.81,0,164,164,67
35,r_74_85_158,r_36_46_185,seq9,r_74_85_158,0.67,0,158,158,67
12,r_67_50_180,r_72_11_156,r_113_73_155,r_67_50_180,0.63,-24,156,180,67
30,r_17_97_146,seq81,seq3,r_17_97_146,0.76,0,146,146,68
44,seq7,r_125_16_38,r_48_47_120,r_48_47_120,0.97,-1,119,120,68
4,r_130_100_12,r_66_33_49,seq67,r_130_100_12,1.0,1,13,12,68
14,r_34_50_68,r_19_71_73,seq81,r_34_50_68,0.93,1,69,68,68
8,r_123_1_63,r_113_111_149,r_12_128_163,r_123_1_63,1.0,3,66,63,68
43,seq134,r_21_93_98,r_54_11_61,r_54_11_61,0.87,12,73,61,68
37,r_29_122_152,seq51,r_34_50_68,r_29_122_152,0.8,0,152,152,68
19,r_12_128_163,r_123_1_63,seq10,r_12_128_163,0.82,1,164,163,68
86,seq101,r_48_47_120,r_19_71_73,r_19_71_73,1.0,2,75,73,68
21,r_76_74_69,r_109_112_127,seq101,r_76_74_69,1.0,1,70,69,68
1,r_90_56_116,r_83_14_156,r_22_139_43,r_90_56_116,0.87,0,116,116,68
24,r_63_131_27,r_109_112_127,seq43,r_63_131_27,0.7,1,28,27,68
5,r_82_104_141,seq116,seq28,r_82_104_141,0.7,5,146,141,68
18,r_39_136_35,r_45_64_102,seq55,r_39_136_35,1.0,0,35,35,68
15,r_37_42_42,seq7,seq134,r_37_42_42,1.0,0,42,42,68
19,r_12_128_163,r_9_26_83,r_123_1_63,r_123_1_63,0.87,21,84,63,68
31,r_125_16_38,seq61,seq7,r_125_16_38,1.0,0,38,38,68
76,seq81,r_17_97_146,r_34_50_68,r_34_50_68,0.99,78,146,68,68
67,seq62,r_48_47_120,r_90_56_116,r_90_56_116,0.93,19,135,116,68
3,r_69_27_81,r_29_122_152,seq73,r_69_27_81,1.0,1,82,81,68
10,r_113_111_149,seq80,r_48_47_120,r_113_111_149,0.83,0,149,149,68
9,r_66_33_49,seq44,seq49,r_66_33_49,1.0,0,49,49,68
26,r_9_26_83,r_12_128_163,r_84_60_40,r_9_26_83,0.83,1,84,83,68
8,r_123_1_63,r_12_128_163,r_21_93_98,r_123_1_63,0.47,107,170,63,68
16,r_59_32_154,r_121_94_54,r_90_56_116,r_59_32_154,0.89,0,154,154,68
0,r_54_11_61,r_69_27_81,r_37_42_42,r_54_11_61,0.98,0,61,61,68
63,seq138,seq13,r_109_112_127,r_109_112_127,1.0,21,148,127,68
11,r_38_135_60,seq78,seq102,r_38_135_60,1.0,0,60,60,68
20,r_0_4_67,seq101,r_121_94_54,r_0_4_67,1.0,0,67,67,68
13,r_109_112_127,seq36,seq138,r_109_112_127,0.81,1,128,127,68
2,r_25_52_44,r_19_71_73,seq115,r_19_71_73,0.55,-4,69,73,68
40,seq129,r_117_31_72,r_84_60_40,r_84_60_40,1.0,63,103,40,68
29,r_2_105_113,seq55,seq72,r_2_105_113,1.0,0,113,113,68
25,r_137_88_139,seq102,r_66_33_49,r_66_33_49,1.0,98,147,49,68
33,r_48_47_120,seq101,seq7,r_48_47_120,0.65,1,121,120,68
6,r_22_139_43,seq67,r_48_47_120,r_22_139_43,0.97,0,43,43,68
6,r_22_139_43,r_48_47_120,r_90_56_116,r_90_56_116,0.88,4,120,116,68
32,r_121_94_54,r_21_93_98,r_0_4_67,r_0_4_67,0.97,-1,66,67,68
36,r_84_60_40,r_48_47_120,seq129,r_84_60_40,1.0,2,42,40,68
34,r_83_14_156,r_90_56_116,seq132,r_90_56_116,0.98,1,117,116,68
16,r_59_32_154,r_5_70_164,r_121_94_54,r_121_94_54,1.0,5,59,54,68
17,r_19_71_73,seq73,seq101,r_19_71_73,1.0,0,73,73,68
94,seq115,r_5_70_164,r_0_4_67,r_0_4_67,1.0,99,166,67,68
34,r_83_14_156,seq132,r_17_97_146,r_83_14_156,1.0,0,156,156,68
56,seq36,r_109_112_127,seq10,r_109_112_127,1.0,1,128,127,68
7,r_96_65_115,seq72,seq43,r_96_65_115,1.0,0,115,115,68
23,r_21_93_98,seq134,r_123_1_63,r_123_1_63,0.78,35,98,63,68
82,seq92,r_17_97_146,r_123_1_63,r_123_1_63,1.0,54,117,63,68
35,r_119_58_110,r_45_64_102,seq61,r_119_58_110,0.92,2,112,110,68
51,seq19,r_48_28_135,seq53,r_48_28_135,1.0,1,136,135,69
8,r_54_4_74,seq113,seq136,r_54_4_74,1.0,0,74,74,69
37,r_114_104_76,seq84,seq66,r_114_104_76,1.0,0,76,76,69
19,r_128_18_12,r_129_86_118,r_40_38_102,r_128_18_12,1.0,107,119,12,69
16,r_50_115_160,seq64,seq34,r_50_115_160,0.88,1,161,160,69
21,r_60_31_142,r_50_115_160,r_42_16_55,r_60_31_142,0.68,1,143,142,69
39,r_40_38_102,r_111_99_104,r_128_18_12,r_40_38_102,0.69,0,102,102,69
1,r_9_106_78,seq7,r_46_92_11,r_9_106_78,1.0,2,80,78,69
5,r_73_33_168,seq87,seq138,r_73_33_168,0.87,0,168,168,69
19,r_128_18_12,r_124_88_175,r_129_86_118,r_128_18_12,1.0,0,12,12,69
20,r_63_109_100,seq52,r_102_22_19,r_102_22_19,0.96,1,20,19,69
45,seq7,r_9_106_78,seq113,r_9_106_78,0.99,2,80,78,69
26,r_43_119_170,seq53,r_139_89_39,r_139_89_39,1.0,138,177,39,69
67,seq61,r_112_11_49,r_46_92_11,r_112_11_49,1.0,0,49,49,69
78,seq77,r_23_26_82,r_85_32_114,r_85_32_114,0.99,7,121,114,69
0,r_118_49_110,r_5_80_129,seq0,r_118_49_110,0.85,0,110,110,69
94,seq110,r_124_88_175,r_131_21_56,r_131_21_56,1.0,3,59,56,69
11,r_111_99_104,r_40_38_102,r_29_27_75,r_40_38_102,0.94,3,105,102,69
13,r_47_122_117,r_5_80_129,r_128_18_12,r_47_122_117,0.59,0,117,117,69
48,seq138,r_69_120_187,r_73_33_168,r_73_33_168,0.97,19,187,168,69
36,r_102_22_19,r_23_26_82,r_63_109_100,r_102_22_19,1.0,0,19,19,69
34,r_12_93_112,r_42_16_55,seq34,r_42_16_55,0.93,0,55,55,69
3,r_139_89_39,seq6,seq2,r_139_89_39,1.0,0,39,39,69
6,r_129_86_118,seq68,seq110,r_129_86_118,0.99,1,119,118,69
55,seq34,r_63_109_100,r_50_115_160,r_50_115_160,0.96,11,171,160,69
36,r_102_22_19,r_63_109_100,seq52,r_63_109_100,1.0,0,100,100,69
10,r_124_88_175,r_126_100_21,r_56_17_111,r_126_100_21,0.74,155,176,21,69
27,r_69_120_187,seq138,r_12_93_112,r_12_93_112,1.0,75,187,112,69
38,r_131_21_56,r_5_80_129,seq110,r_131_21_56,1.0,0,56,56,69
2,r_123_3_90,r_56_17_111,r_5_80_129,r_123_3_90,0.86,1,91,90,69
74,seq71,r_85_32_114,seq53,r_85_32_114,0.99,2,116,114,69
29,r_85_32_114,seq71,seq77,r_85_32_114,0.97,2,116,114,69
24,r_56_17_111,r_43_119_170,seq58,r_56_17_111,0.46,5,116,111,69
10,r_124_88_175,r_42_16_55,r_126_100_21,r_124_88_175,1.0,-153,22,175,69
20,r_63_109_100,r_102_22_19,seq34,r_63_109_100,1.0,0,100,100,69
32,r_48_28_135,seq19,r_111_99_104,r_48_28_135,0.94,1,136,135,69
22,r_112_11_49,seq61,seq2,r_112_11_49,0.98,0,49,49,69
30,r_46_92_11,seq39,seq61,r_46_92_11,0.76,4,15,11,69
25,r_126_100_21,r_54_4_74,r_124_88_175,r_126_100_21,1.0,0,21,21,69
63,seq52,r_63_109_100,r_102_22_19,r_63_109_100,0.91,-48,52,100,69
34,r_12_93_112,seq34,r_69_120_187,r_12_93_112,1.0,0,112,112,69
25,r_126_100_21,r_124_88_175,r_129_86_118,r_129_86_118,0.84,58,176,118,69
9,r_20_10_173,seq24,r_75_15_35,r_75_15_35,0.85,139,174,35,69
13,r_47_122_117,r_128_18_12,r_114_104_76,r_128_18_12,0.79,126,138,12,69
96,seq116,seq74,r_42_16_55,r_42_16_55,1.0,0,55,55,69
4,r_75_15_35,r_112_11_49,seq87,r_75_15_35,1.0,0,35,35,69
28,r_44_134_26,r_42_16_55,seq87,r_42_16_55,0.92,-27,28,55,69
23,r_23_26_82,seq77,seq105,r_23_26_82,0.57,6,88,82,69
35,r_65_70_96,r_5_80_129,seq78,r_65_70_96,1.0,0,96,96,69
12,r_29_27_75,seq136,r_5_80_129,r_29_27_75,0.99,1,76,75,69
14,r_42_16_55,r_12_93_112,r_57_135_31,r_42_16_55,1.0,0,55,55,69
26,r_112_98_25,r_96_14_199,seq55,r_112_98_25,0.97,1,26,25,70
30,r_134_2_92,seq111,seq91,r_134_2_92,0.97,0,92,92,70
17,r_130_29_29,seq28,seq65,r_130_29_29,0.99,0,29,29,70
36,r_100_9_58,r_32_69_69,seq113,r_100_9_58,1.0,0,58,58,70
14,r_59_23_72,seq28,r_26_0_79,r_26_0_79,0.82,6,85,79,70
92,seq113,seq4,r_100_9_58,r_100_9_58,1.0,9,67,58,70
15,r_80_103_14,r_32_69_69,seq123,r_80_103_14,0.99,0,14,14,70
14,r_59_23_72,seq106,seq28,r_59_23_72,0.68,1,73,72,70
8,r_126_10_97,r_117_56_151,seq105,r_126_10_97,1.0,0,97,97,70
54,seq37,r_117_56_151,seq70,r_117_56_151,1.0,0,151,151,70
16,r_118_8_145,seq71,seq87,r_118_8_145,0.58,1,146,145,70
1,r_31_90_124,seq36,seq105,r_31_90_124,1.0,0,124,124,70
42,seq133,seq81,r_33_108_26,r_33_108_26,0.71,49,75,26,70
80,seq89,r_49_129_62,seq84,r_49_129_62,1.0,1,63,62,70
7,r_34_48_83,r_1_17_173,r_115_39_85,r_1_17_173,0.8,2,175,173,70
69,seq70,r_131_76_181,seq37,r_131_76_181,0.97,0,181,181,70
29,r_32_69_69,r_100_9_58,seq15,r_32_69_69,1.0,-11,58,69,70
19,r_128_40_125,seq68,seq123,r_128_40_125,1.0,0,125,125,70
31,r_18_110_84,seq55,r_33_108_26,r_18_110_84,1.0,0,84,84,70
97,seq123,r_118_8_145,r_80_103_14,r_80_103_14,0.87,0,14,14,70
77,seq84,r_33_108_26,seq89,r_33_108_26,0.68,0,26,26,70
72,seq75,r_115_39_85,r_97_101_8,r_115_39_85,1.0,2,87,85,70
27,r_119_139_51,seq65,seq72,r_119_139_51,0.98,1,52,51,70
4,r_49_129_62,seq89,seq21,r_49_129_62,1.0,0,62,62,70
73,seq78,r_25_51_192,r_86_5_101,r_86_5_101,1.0,76,177,101,70
2,r_1_17_173,r_61_20_48,r_34_48_83,r_1_17_173,0.87,-117,56,173,70
20,r_85_44_137,seq136,r_45_35_93,r_85_44_137,0.92,1,138,137,70
38,r_19_132_50,r_115_39_85,seq113,r_19_132_50,0.88,2,52,50,70
6,r_45_35_93,seq87,seq68,r_45_35_93,1.0,2,95,93,70
2,r_1_17_173,r_34_48_83,r_61_20_48,r_61_20_48,0.55,127,175,48,70
87,seq105,r_50_13_180,r_31_90_124,r_31_90_124,0.98,56,180,124,70
3,r_73_57_24,r_85_44_137,seq62,r_73_57_24,0.88,4,28,24,70
24,r_86_5_101,r_128_40_125,r_18_110_84,r_86_5_101,1.0,0,101,101,70
25,r_74_66_60,seq81,seq54,r_74_66_60,1.0,0,60,60,70
33,r_115_39_85,seq75,seq58,r_115_39_85,0.98,2,87,85,70
88,seq106,r_59_23_72,seq120,r_59_23_72,1.0,0,72,72,70
37,r_93_79_40,seq12,seq87,r_93_79_40,1.0,2,42,40,70
35,r_33_108_26,r_49_129_62,seq133,r_33_108_26,0.64,0,26,26,70
18,r_138_63_20,r_73_57_24,seq72,r_138_63_20,1.0,1,21,20,70
10,r_61_20_48,r_1_17_173,seq60,r_61_20_48,0.99,2,50,48,70
22,r_135_64_128,seq41,seq71,r_135_64_128,0.63,0,128,128,70
28,r_52_27_67,r_50_13_180,seq104,r_52_27_67,1.0,0,67,67,70
91,seq111,seq104,r_117_56_151,r_117_56_151,0.64,7,158,151,70
11,r_77_102_36,r_131_76_181,seq12,r_77_102_36,1.0,0,36,36,70
56,seq41,r_135_64_128,r_16_127_57,r_135_64_128,0.99,-4,124,128,70
7,r_34_48_83,seq58,r_1_17_173,r_34_48_83,0.86,21,104,83,70
44,seq7,r_11_116_182,seq92,r_11_116_182,0.63,-5,177,182,70
12,r_117_56_151,seq37,seq111,r_117_56_151,0.5,0,151,151,70
84,seq95,r_85_44_137,seq136,r_85_44_137,1.0,-5,132,137,70
51,seq19,r_54_103_168,r_110_46_101,r_110_46_101,0.95,67,168,101,71
8,r_110_46_101,seq30,seq19,r_110_46_101,0.97,1,102,101,71
36,r_60_71_24,r_138_117_45,r_56_44_177,r_60_71_24,1.0,0,24,24,71
37,r_14_78_132,seq87,seq58,r_14_78_132,0.95,0,132,132,71
3,r_69_47_87,r_56_44_177,r_129_10_159,r_56_44_177,0.74,2,179,177,71
71,seq58,r_56_44_177,r_14_78_132,r_14_78_132,0.96,16,148,132,71
16,r_137_76_66,seq127,seq51,r_137_76_66,1.0,0,66,66,71
21,r_49_18_186,r_90_83_17,r_29_104_93,r_49_18_186,0.25,0,186,186,71
1,r_63_96_104,r_23_112_154,seq68,r_63_96_104,0.98,0,104,104,71
97,seq124,seq39,r_123_4_100,r_123_4_100,1.0,14,114,100,71
5,r_54_103_168,seq19,seq111,r_54_103_168,0.67,0,168,168,71
46,seq8,r_23_112_154,r_1_32_54,r_1_32_54,1.0,48,102,54,71
80,seq87,r_14_78_132,r_81_88_61,r_81_88_61,0.87,71,132,61,71
0,r_23_112_154,r_1_32_54,r_9_130_80,r_23_112_154,0.98,0,154,154,71
19,r_29_104_93,seq57,r_2_3_162,r_2_3_162,0.85,7,169,162,71
3,r_69_47_87,seq30,r_56_44_177,r_69_47_87,0.98,0,87,87,71
90,seq111,seq16,r_54_103_168,r_54_103_168,0.99,4,172,168,71
26,r_100_43_141,seq113,r_64_109_73,r_100_43_141,0.69,1,142,141,71
14,r_98_12_10,r_61_126_85,seq19,r_61_126_85,1.0,0,85,85,71
4,r_75_62_134,r_54_103_168,seq0,r_54_103_168,0.45,-27,141,168,71
0,r_23_112_154,r_63_96_104,r_1_32_54,r_1_32_54,0.72,50,104,54,71
13,r_86_22_137,r_59_84_150,r_118_34_111,r_86_22_137,0.82,8,145,137,71
15,r_36_21_153,seq74,r_60_71_24,r_60_71_24,0.9,130,154,24,71
6,r_61_126_85,seq101,seq55,r_61_126_85,1.0,0,85,85,71
36,r_60_71_24,r_56_44_177,r_36_21_153,r_36_21_153,0.9,0,153,153,71
27,r_2_3_162,seq13,r_29_104_93,r_29_104_93,0.55,69,162,93,71
35,r_1_32_54,r_118_34_111,seq113,r_1_32_54,1.0,2,56,54,71
2,r_118_34_111,seq115,seq48,r_118_34_111,1.0,1,112,111,71
18,r_64_109_73,r_2_3_162,seq17,r_64_109_73,0.99,1,74,73,71
29,r_123_4_100,seq115,seq124,r_123_4_100,1.0,0,100,100,71
34,r_56_44_177,r_69_47_87,r_9_130_80,r_56_44_177,0.72,2,179,177,71
25,r_9_130_80,seq7,seq74,r_9_130_80,1.0,0,80,80,71
33,r_81_88_61,seq42,seq87,r_81_88_61,1.0,1,62,61,71
65,seq48,seq45,r_118_34_111,r_118_34_111,1.0,7,118,111,71
14,r_98_12_10,r_23_112_154,r_61_126_85,r_98_12_10,0.95,0,10,10,71
38,r_73_77_157,seq57,r_64_109_73,r_64_109_73,0.29,84,157,73,71
77,seq74,r_36_21_153,r_9_130_80,r_9_130_80,1.0,74,154,80,71
34,r_56_44_177,r_86_22_137,r_69_47_87,r_69_47_87,0.61,31,118,87,71
12,r_80_89_16,seq26,seq127,r_80_89_16,0.98,0,16,16,71
17,r_27_15_138,seq135,r_1_32_54,r_27_15_138,0.97,-1,137,138,71
9,r_121_97_8,r_5_93_68,r_35_11_14,r_35_11_14,0.53,25,39,14,71
30,r_35_11_14,seq13,r_138_117_45,r_138_117_45,0.99,20,65,45,71
22,r_90_83_17,r_49_18_186,seq131,r_90_83_17,0.53,172,189,17,71
28,r_59_84_150,r_56_44_177,r_63_96_104,r_59_84_150,0.84,0,150,150,71
91,seq113,r_100_43_141,r_1_32_54,r_1_32_54,0.99,26,80,54,71
56,seq30,r_69_47_87,seq139,r_69_47_87,0.98,0,87,87,71
7,r_102_50_136,seq53,seq101,r_102_50_136,0.81,2,138,136,71
23,r_138_117_45,r_73_77_157,r_35_11_14,r_138_117_45,0.98,2,47,45,71
84,seq99,r_72_122_195,r_9_130_80,r_9_130_80,1.0,75,155,80,71
30,r_114_13_106,r_105_100_186,seq47,r_105_100_186,0.77,-74,112,186,72
9,r_18_78_176,r_129_96_99,seq90,r_18_78_176,0.73,1,177,176,72
36,r_44_28_24,r_9_88_47,seq130,r_44_28_24,0.83,0,24,24,72
37,r_105_100_186,seq39,seq58,r_105_100_186,0.32,0,186,186,72
3,r_55_87_173,seq42,r_6_94_55,r_55_87_173,0.94,0,173,173,72
16,r_34_25_133,r_21_57_37,r_9_88_47,r_34_25_133,0.92,0,133,133,72
21,r_51_15_124,r_76_59_161,seq3,r_51_15_124,0.9,0,124,124,72
1,r_37_60_105,seq101,r_30_50_93,r_37_60_105,0.98,1,106,105,72
97,seq125,r_84_72_125,seq63,r_84_72_125,1.0,0,125,125,72
25,r_95_20_15,r_6_94_55,r_21_57_37,r_95_20_15,0.99,0,15,15,72
5,r_74_139_77,seq97,seq14,r_74_139_77,1.0,0,77,77,72
33,r_118_66_180,r_128_0_34,seq131,r_128_0_34,1.0,-2,32,34,72
19,r_33_81_165,seq49,r_120_108_75,r_120_108_75,0.81,90,165,75,72
39,r_21_57_37,r_35_41_113,r_95_20_15,r_95_20_15,0.66,13,28,15,72
33,r_118_66_180,seq131,r_74_139_77,r_118_66_180,0.57,1,181,180,72
24,r_132_80_49,r_129_96_99,seq104,r_132_80_49,1.0,-1,48,49,72
3,r_55_87_173,r_29_38_91,seq42,r_29_38_91,0.93,0,91,91,72
10,r_99_17_95,seq97,seq82,r_99_17_95,0.99,2,97,95,72
87,seq104,seq52,r_132_80_49,r_132_80_49,1.0,0,49,49,72
90,seq112,seq8,r_1_137_31,r_1_137_31,1.0,56,87,31,72
26,r_123_116_104,seq77,r_120_108_75,r_123_116_104,0.65,0,104,104,72
38,r_85_70_153,seq63,r_120_108_75,r_85_70_153,0.99,0,153,153,72
4,r_43_64_76,r_84_72_125,seq52,r_43_64_76,0.99,1,77,76,72
78,seq86,seq53,r_26_93_68,r_26_93_68,0.98,0,68,68,72
0,r_46_40_120,r_85_70_153,r_16_45_197,r_46_40_120,0.91,0,120,120,72
11,r_129_96_99,r_33_81_165,seq23,r_129_96_99,1.0,-1,98,99,72
20,r_102_54_78,seq23,seq32,r_102_54_78,1.0,0,78,78,72
14,r_9_88_47,seq10,seq125,r_9_88_47,0.98,1,48,47,72
57,seq32,seq138,r_102_54_78,r_102_54_78,1.0,52,130,78,72
85,seq131,r_118_66_180,r_120_108_75,r_120_108_75,1.0,2,77,75,72
6,r_6_94_55,r_114_13_106,seq61,r_6_94_55,0.94,-5,50,55,72
2,r_76_59_161,seq11,seq49,r_76_59_161,0.81,0,161,161,72
18,r_29_38_91,r_55_87_173,r_26_93_68,r_29_38_91,0.85,0,91,91,72
29,r_109_68_147,seq126,r_111_103_135,r_109_68_147,0.87,0,147,147,72
13,r_1_137_31,seq135,seq112,r_1_137_31,1.0,0,31,31,72
31,r_128_0_34,r_118_66_180,seq12,r_128_0_34,0.99,0,34,34,72
32,r_35_41_113,seq86,seq14,r_35_41_113,0.79,5,118,113,72
38,r_85_70_153,r_46_40_120,seq63,r_46_40_120,0.82,-2,118,120,72
77,seq82,r_62_48_134,r_99_17_95,r_99_17_95,1.0,12,107,95,72
86,seq101,r_37_60_105,seq58,r_37_60_105,0.99,-49,56,105,72
34,r_56_124_137,seq8,r_6_94_55,r_56_124_137,0.9,1,138,137,72
17,r_120_108_75,r_62_48_134,seq131,r_120_108_75,1.0,0,75,75,72
9,r_18_78_176,seq135,r_129_96_99,r_129_96_99,1.0,-5,94,99,72
28,r_134_110_163,r_16_45_197,seq39,r_134_110_163,0.72,0,163,163,72
67,seq58,r_26_93_68,seq101,r_26_93_68,0.73,-28,40,68,72
35,r_16_45_197,r_134_110_163,r_46_40_120,r_16_45_197,0.56,-75,122,197,72
12,r_26_93_68,seq58,seq86,r_26_93_68,0.98,0,68,68,72
93,seq120,r_34_18_123,seq136,r_34_18_123,1.0,-13,110,123,73
30,r_17_130_184,seq31,seq8,r_17_130_184,0.5,2,186,184,73
36,r_115_99_105,seq33,seq51,r_115_99_105,0.99,1,106,105,73
32,r_113_20_10,r_108_45_108,seq7,r_113_20_10,0.93,0,10,10,73
22,r_13_111_39,r_17_130_184,r_139_19_15,r_139_19_15,0.96,11,26,15,73
37,r_128_40_141,seq96,r_63_80_140,r_63_80_140,0.77,2,142,140,73
55,seq36,r_110_21_103,r_42_14_194,r_110_21_103,0.59,1,104,103,73
16,r_133_107_97,r_93_88_104,seq98,r_93_88_104,0.71,1,105,104,73
21,r_93_88_104,r_133_107_97,seq36,r_93_88_104,0.84,7,111,104,73
39,r_89_134_80,r_133_107_97,r_100_69_158,r_89_134_80,0.98,0,80,80,73
1,r_100_69_158,seq37,r_89_134_80,r_89_134_80,1.0,20,100,80,73
5,r_135_44_178,seq136,r_133_107_97,r_135_44_178,0.58,0,178,178,73
80,seq78,r_9_85_71,seq86,r_9_85_71,1.0,-1,70,71,73
19,r_9_85_71,seq78,seq81,r_9_85_71,0.99,0,71,71,73
66,seq51,seq55,r_115_99_105,r_115_99_105,1.0,12,117,105,73
38,r_6_129_135,seq10,r_94_90_120,r_6_129_135,0.83,0,135,135,73
39,r_89_134_80,r_100_69_158,seq37,r_100_69_158,1.0,0,158,158,73
31,r_103_24_159,seq65,seq132,r_103_24_159,0.93,0,159,159,73
3,r_3_71_112,seq28,r_56_27_88,r_3_71_112,1.0,0,112,112,73
10,r_76_83_160,seq8,r_103_24_159,r_103_24_159,0.89,10,169,159,73
34,r_22_74_36,r_56_27_88,r_127_109_30,r_56_27_88,0.93,-50,38,88,73
4,r_25_101_190,seq16,r_100_69_158,r_100_69_158,0.75,6,164,158,73
0,r_82_67_146,seq58,seq132,r_82_67_146,0.94,0,146,146,73
6,r_42_14_194,r_63_80_140,r_0_87_114,r_42_14_194,0.93,-54,140,194,73
74,seq62,r_102_106_187,r_3_71_112,r_3_71_112,0.99,36,148,112,73
27,r_0_87_114,seq28,seq65,r_0_87_114,1.0,1,115,114,73
87,seq136,r_135_44_178,seq120,r_135_44_178,0.85,-96,82,178,73
74,seq62,r_133_107_97,r_102_106_187,r_133_107_97,0.84,-28,69,97,73
18,r_94_90_120,seq7,seq121,r_94_90_120,0.98,0,120,120,73
29,r_26_92_98,r_3_71_112,seq5,r_26_92_98,1.0,1,99,98,73
25,r_63_80_140,r_42_14_194,seq28,r_63_80_140,0.96,0,140,140,73
33,r_137_131_154,seq68,r_9_85_71,r_9_85_71,0.92,83,154,71,73
11,r_139_19_15,r_135_44_178,r_13_111_39,r_139_19_15,1.0,1,16,15,73
2,r_77_95_47,seq31,seq126,r_77_95_47,1.0,-1,46,47,73
50,seq28,r_3_71_112,seq59,r_3_71_112,0.99,-52,60,112,73
1,r_100_69_158,r_25_101_190,seq16,r_25_101_190,0.97,0,190,190,73
53,seq33,r_115_99_105,r_117_84_6,r_115_99_105,0.88,-59,46,105,73
38,r_6_129_135,r_133_107_97,seq10,r_133_107_97,0.97,-27,70,97,73
1,r_100_69_158,r_89_134_80,r_25_101_190,r_100_69_158,0.99,0,158,158,73
75,seq65,r_103_24_159,r_0_87_114,r_0_87_114,0.8,45,159,114,73
17,r_56_27_88,seq48,seq10,r_56_27_88,0.95,0,88,88,73
94,seq121,seq31,r_94_90_120,r_94_90_120,1.0,5,125,120,73
9,r_52_15_113,seq98,r_56_27_88,r_52_15_113,0.8,8,121,113,73
55,seq36,r_135_44_178,r_93_88_104,r_135_44_178,0.6,-1,177,178,73
4,r_25_101_190,r_100_69_158,seq62,r_25_101_190,0.95,0,190,190,73
28,r_97_11_188,seq55,r_0_87_114,r_0_87_114,0.72,74,188,114,73
8,r_2_104_38,r_135_44_178,r_139_19_15,r_2_104_38,0.88,0,38,38,73
23,r_110_21_103,seq36,seq120,r_110_21_103,0.96,1,104,103,73
82,seq81,seq1,r_9_85_71,r_9_85_71,1.0,1,72,71,73
35,r_34_18_123,seq120,seq53,r_34_18_123,0.84,1,124,123,73
12,r_108_45_108,r_93_88_104,seq39,r_108_45_108,0.99,-1,107,108,73
93,seq117,r_73_136_69,r_25_23_3,r_73_136_69,1.0,1,70,69,74
30,r_34_5_192,seq118,r_6_87_111,r_6_87_111,1.0,34,145,111,74
92,seq115,r_79_105_167,r_73_136_69,r_73_136_69,0.93,40,109,69,74
14,r_21_43_82,r_19_47_142,r_34_5_192,r_21_43_82,0.85,3,85,82,74
8,r_48_69_88,seq104,seq131,r_48_69_88,0.95,1,89,88,74
37,r_35_77_80,seq78,seq56,r_35_77_80,1.0,0,80,80,74
2,r_101_71_59,seq28,r_124_29_18,r_101_71_59,0.95,0,59,59,74
2,r_101_71_59,r_124_29_18,seq100,r_101_71_59,0.51,58,117,59,74
39,r_130_64_163,seq31,seq132,r_130_64_163,0.35,0,163,163,74
1,r_122_49_119,r_79_105_167,seq15,r_79_105_167,0.93,-49,118,167,74
5,r_97_75_76,seq99,r_72_85_54,r_97_75_76,0.66,11,87,76,74
18,r_139_102_34,r_25_23_3,seq137,r_139_102_34,0.98,1,35,34,74
12,r_124_29_18,r_55_30_198,seq126,r_124_29_18,0.78,5,23,18,74
66,seq60,r_54_103_177,r_133_129_45,r_133_129_45,1.0,133,178,45,74
33,r_38_138_56,seq17,seq89,r_38_138_56,1.0,1,57,56,74
67,seq61,r_130_64_163,r_27_135_28,r_27_135_28,0.68,135,163,28,74
89,seq111,r_19_47_142,seq70,r_19_47_142,0.94,0,142,142,74
3,r_79_105_167,seq115,r_139_102_34,r_79_105_167,0.67,0,167,167,74
10,r_26_53_168,seq76,seq115,r_26_53_168,0.54,1,169,168,74
26,r_44_121_123,seq78,r_83_1_93,r_83_1_93,0.45,38,131,93,74
93,seq117,r_25_23_3,r_6_87_111,r_6_87_111,1.0,5,116,111,74
78,seq89,r_79_105_167,r_128_32_5,r_79_105_167,0.68,-128,39,167,74
31,r_33_106_131,seq78,seq17,r_33_106_131,0.95,0,131,131,74
20,r_6_87_111,seq100,seq117,r_6_87_111,0.98,0,111,111,74
15,r_73_136_69,seq117,seq115,r_73_136_69,1.0,1,70,69,74
7,r_133_129_45,seq118,seq60,r_133_129_45,0.95,3,48,45,74
19,r_72_85_54,r_39_12_47,r_97_75_76,r_72_85_54,0.44,22,76,54,74
6,r_19_47_142,seq111,r_62_40_187,r_19_47_142,0.84,0,142,142,74
85,seq104,r_80_14_169,r_35_77_80,r_35_77_80,1.0,21,101,80,74
9,r_27_135_28,r_80_14_169,seq36,r_27_135_28,0.94,0,28,28,74
74,seq78,r_35_77_80,r_44_121_123,r_35_77_80,1.0,0,80,80,74
29,r_84_123_155,seq137,r_27_135_28,r_27_135_28,0.71,130,158,28,74
24,r_94_22_98,seq17,seq81,r_94_22_98,0.95,0,98,98,74
25,r_13_2_162,seq108,r_51_116_121,r_13_2_162,0.76,0,162,162,74
50,seq17,seq16,r_33_106_131,r_33_106_131,0.97,3,134,131,74
32,r_54_103_177,seq60,seq81,r_54_103_177,0.36,1,178,177,74
38,r_80_14_169,seq8,r_112_68_53,r_112_68_53,0.79,120,173,53,74
0,r_39_12_47,r_112_68_53,seq9,r_112_68_53,0.97,-6,47,53,74
34,r_45_57_31,r_92_86_176,seq66,r_45_57_31,1.0,0,31,31,74
21,r_20_90_22,r_35_77_80,seq81,r_20_90_22,0.42,3,25,22,74
22,r_51_116_121,seq24,r_124_29_18,r_51_116_121,0.98,0,121,121,74
56,seq31,r_130_64_163,r_27_135_28,r_27_135_28,0.79,135,163,28,74
19,r_72_85_54,r_130_64_163,r_39_12_47,r_72_85_54,0.58,3,57,54,74
30,r_71_139_169,r_10_27_137,r_114_18_173,r_71_139_169,0.51,-32,137,169,75
36,r_136_109_93,seq122,r_39_67_16,r_136_109_93,1.0,0,93,93,75
33,r_78_120_35,r_105_55_182,r_130_128_184,r_78_120_35,1.0,0,35,35,75
8,r_20_22_99,seq73,seq48,r_20_22_99,1.0,0,99,99,75
22,r_123_103_122,r_121_66_188,r_72_36_181,r_123_103_122,0.82,58,180,122,75
1,r_29_59_100,seq54,seq53,r_29_59_100,1.0,0,100,100,75
20,r_113_15_19,r_110_137_61,r_13_95_151,r_110_137_61,0.97,0,61,61,75
5,r_13_95_151,r_105_55_182,r_28_33_92,r_28_33_92,0.8,61,153,92,75
25,r_77_97_37,seq94,seq87,r_77_97_37,1.0,0,37,37,75
19,r_3_117_179,r_114_18_173,r_68_1_68,r_68_1_68,1.0,105,173,68,75
31,r_93_46_193,seq122,r_58_51_143,r_58_51_143,0.43,-8,135,143,75
89,seq98,r_100_76_165,seq23,r_100_76_165,0.99,0,165,165,75
10,r_100_76_165,seq98,r_9_88_46,r_100_76_165,0.63,0,165,165,75
26,r_114_18_173,seq37,r_110_137_61,r_114_18_173,0.72,0,173,173,75
72,seq48,r_19_96_164,r_20_22_99,r_20_22_99,1.0,1,100,99,75
0,r_124_2_161,seq44,seq135,r_124_2_161,0.89,0,161,161,75
11,r_105_55_182,seq115,r_64_63_73,r_64_63_73,1.0,106,179,73,75
37,r_84_112_58,r_60_104_45,r_113_15_19,r_84_112_58,0.68,-12,46,58,75
30,r_71_139_169,r_114_18_173,r_123_103_122,r_71_139_169,0.92,0,169,169,75
6,r_130_128_184,r_78_120_35,seq0,r_130_128_184,0.88,0,184,184,75
41,seq129,seq87,r_4_83_11,r_4_83_11,1.0,15,26,11,75
4,r_52_79_12,r_30_70_104,seq119,r_52_79_12,0.58,7,19,12,75
87,seq92,seq86,r_28_33_92,r_28_33_92,0.99,-1,91,92,75
37,r_84_112_58,r_113_15_19,seq131,r_84_112_58,0.96,0,58,58,75
17,r_6_50_28,seq0,seq44,r_6_50_28,1.0,0,28,28,75
21,r_56_106_59,seq24,seq119,r_56_106_59,1.0,0,59,59,75
74,seq54,r_29_59_100,seq0,r_29_59_100,1.0,0,100,100,75
18,r_68_1_68,seq16,r_138_62_198,r_68_1_68,1.0,0,68,68,75
29,r_121_66_188,seq24,r_123_103_122,r_123_103_122,0.85,2,124,122,75
34,r_57_49_17,r_9_88_46,seq65,r_57_49_17,0.64,0,17,17,75
28,r_9_88_46,seq42,seq75,r_9_88_46,1.0,0,46,46,75
20,r_113_15_19,seq41,r_110_137_61,r_113_15_19,0.63,0,19,19,75
15,r_118_85_40,r_69_90_1,seq73,r_118_85_40,0.88,-2,38,40,75
58,seq31,seq48,r_138_62_198,r_138_62_198,0.72,-119,79,198,75
13,r_110_137_61,r_105_55_182,r_113_15_19,r_113_15_19,0.67,1,20,19,75
32,r_89_107_167,r_126_102_197,r_113_15_19,r_89_107_167,0.52,9,176,167,75
77,seq73,r_28_33_92,r_118_85_40,r_28_33_92,0.69,0,92,92,75
75,seq61,seq65,r_4_83_11,r_4_83_11,0.97,24,35,11,75
20,r_113_15_19,r_13_95_151,r_89_107_167,r_113_15_19,0.49,151,170,19,75
96,seq119,seq75,r_52_79_12,r_52_79_12,0.51,21,33,12,75
9,r_72_36_181,seq35,r_123_103_122,r_123_103_122,0.95,60,182,122,75
16,r_69_90_1,r_118_85_40,seq34,r_118_85_40,0.82,-5,35,40,75
29,r_121_66_188,r_123_103_122,r_124_2_161,r_121_66_188,0.47,0,188,188,75
22,r_123_103_122,seq43,r_121_66_188,r_123_103_122,0.97,0,122,122,75
56,seq25,r_19_96_164,seq26,r_19_96_164,1.0,0,164,164,75
7,r_28_33_92,seq73,seq92,r_28_33_92,0.97,0,92,92,75
23,r_58_51_143,seq75,r_93_46_193,r_58_51_143,0.38,6,149,143,75
13,r_110_137_61,r_113_15_19,seq12,r_110_137_61,1.0,0,61,61,75
35,r_19_96_164,seq25,r_64_63_73,r_64_63_73,0.99,91,164,73,75
12,r_64_63_73,seq82,seq41,r_64_63_73,1.0,0,73,73,75
27,r_39_67_16,r_56_106_59,seq35,r_39_67_16,0.66,-5,11,16,75
2,r_4_83_11,seq21,seq129,r_4_83_11,0.93,0,11,11,75
93,seq115,r_54_61_161,r_68_118_90,r_68_118_90,1.0,17,107,90,76
30,r_17_0_79,seq125,r_91_33_34,r_17_0_79,0.96,4,83,79,76
36,r_3_51_173,seq113,r_9_42_42,r_9_42_42,1.0,133,175,42,76
26,r_73_108_158,seq119,r_15_129_32,r_15_129_32,1.0,12,44,32,76
8,r_43_107_152,seq127,r_54_61_161,r_43_107_152,0.79,2,154,152,76
53,seq24,r_14_102_53,seq7,r_14_102_53,0.98,3,56,53,76
70,seq138,r_3_51_173,r_112_36_12,r_112_36_12,1.0,0,12,12,76
1,r_9_42_42,r_15_129_32,seq99,r_9_42_42,0.75,-10,32,42,76
21,r_54_61_161,seq115,r_43_107_152,r_43_107_152,0.61,11,163,152,76
39,r_63_35_75,seq22,seq104,r_63_35_75,1.0,1,76,75,76
5,r_28_53_182,seq55,r_139_81_16,r_28_53_182,0.33,0,182,182,76
32,r_31_76_172,r_9_42_42,seq115,r_31_76_172,0.51,5,177,172,76
23,r_25_136_44,seq46,seq64,r_25_136_44,1.0,0,44,44,76
19,r_90_41_100,seq16,seq106,r_90_41_100,1.0,0,100,100,76
33,r_72_95_66,r_117_39_187,r_139_81_16,r_117_39_187,0.5,-11,176,187,76
3,r_68_118_90,r_43_107_152,seq115,r_68_118_90,0.97,0,90,90,76
61,seq46,r_25_136_44,seq98,r_25_136_44,1.0,0,44,44,76
2,r_15_129_32,r_9_42_42,r_73_108_158,r_15_129_32,1.0,-3,29,32,76
16,r_112_36_12,seq138,r_26_100_51,r_26_100_51,1.0,34,85,51,76
20,r_124_30_108,seq133,seq44,r_124_30_108,1.0,2,110,108,76
15,r_65_62_174,seq44,seq4,r_65_62_174,0.65,2,176,174,76
1,r_9_42_42,r_31_76_172,r_90_41_100,r_90_41_100,1.0,77,177,100,76
17,r_26_100_51,r_78_121_181,r_112_36_12,r_26_100_51,1.0,1,52,51,76
16,r_112_36_12,r_21_13_149,seq138,r_112_36_12,0.99,0,12,12,76
13,r_139_81_16,r_66_27_60,seq93,r_139_81_16,0.96,0,16,16,76
2,r_15_129_32,r_73_108_158,seq119,r_73_108_158,0.97,2,160,158,76
4,r_92_88_199,seq64,r_40_8_19,r_40_8_19,1.0,9,28,19,76
27,r_21_13_149,seq116,r_97_50_33,r_21_13_149,0.83,0,149,149,76
29,r_40_8_19,r_73_108_158,r_92_88_199,r_40_8_19,1.0,-1,18,19,76
18,r_117_39_187,seq93,r_63_35_75,r_63_35_75,0.9,114,189,75,76
12,r_14_102_53,seq1,seq4,r_14_102_53,0.99,2,55,53,76
24,r_66_27_60,seq18,seq132,r_66_27_60,1.0,0,60,60,76
10,r_130_29_22,r_124_30_108,seq123,r_130_29_22,1.0,0,22,22,76
25,r_19_20_91,r_80_23_95,seq7,r_19_20_91,1.0,0,91,91,76
33,r_72_95_66,seq132,r_117_39_187,r_72_95_66,1.0,1,67,66,76
1,r_9_42_42,seq99,r_31_76_172,r_9_42_42,0.9,0,42,42,76
58,seq38,r_135_11_188,seq131,r_135_11_188,0.76,1,189,188,76
31,r_91_33_34,seq134,seq1,r_91_33_34,0.99,0,34,34,76
32,r_31_76_172,seq89,r_9_42_42,r_9_42_42,0.96,30,72,42,76
38,r_80_23_95,seq74,seq5,r_80_23_95,1.0,1,96,95,76
52,seq22,r_63_35_75,seq103,r_63_35_75,1.0,1,76,75,76
94,seq116,r_21_13_149,seq71,r_21_13_149,0.94,-2,147,149,76
9,r_110_75_77,r_65_62_174,r_109_48_14,r_110_75_77,1.0,0,77,77,76
26,r_73_108_158,r_15_129_32,seq128,r_73_108_158,0.66,2,160,158,76
22,r_111_122_186,seq57,r_9_42_42,r_111_122_186,0.29,3,189,186,76
28,r_120_56_162,seq93,seq46,r_120_56_162,0.79,1,163,162,76
44,seq4,seq34,r_14_102_53,r_14_102_53,0.97,10,63,53,76
82,seq93,r_120_56_162,r_72_95_66,r_72_95_66,0.99,78,144,66,76
35,r_135_11_188,seq38,r_9_42_42,r_135_11_188,0.43,1,189,188,76
30,r_95_5_166,r_27_123_195,r_120_6_126,r_120_6_126,0.98,44,170,126,77
36,r_124_88_121,seq134,seq67,r_124_88_121,0.99,0,121,121,77
92,seq108,seq85,r_45_48_1,r_45_48_1,0.67,132,133,1,77
14,r_15_126_92,seq59,seq108,r_15_126_92,1.0,0,92,92,77
8,r_98_122_68,seq28,r_100_57_23,r_98_122_68,1.0,1,69,68,77
43,seq3,r_64_4_176,r_74_113_109,r_74_113_109,0.87,67,176,109,77
52,seq28,r_98_122_68,r_112_131_7,r_98_122_68,0.73,-43,25,68,77
13,r_36_10_36,seq22,seq128,r_36_10_36,0.79,9,45,36,77
16,r_0_99_161,r_100_57_23,seq129,r_100_57_23,0.59,138,161,23,77
1,r_104_2_71,seq16,seq29,r_104_2_71,1.0,0,71,71,77
31,r_60_137_87,seq79,seq127,r_60_137_87,0.51,47,134,87,77
6,r_17_97_103,seq31,seq130,r_17_97_103,0.37,-68,35,103,77
19,r_11_20_63,seq127,seq16,r_11_20_63,1.0,0,63,63,77
6,r_17_97_103,seq130,seq31,r_17_97_103,0.44,-29,74,103,77
22,r_114_138_19,r_8_133_51,seq41,r_114_138_19,1.0,0,19,19,77
10,r_93_13_95,seq82,r_8_133_51,r_93_13_95,0.96,2,97,95,77
26,r_102_65_83,r_38_63_169,seq62,r_102_65_83,0.83,0,83,83,77
72,seq62,r_119_50_60,r_102_65_83,r_102_65_83,1.0,25,108,83,77
4,r_100_57_23,r_0_99_161,r_118_132_90,r_100_57_23,0.64,129,152,23,77
0,r_64_4_176,seq3,seq67,r_64_4_176,0.67,0,176,176,77
11,r_83_91_61,seq66,seq82,r_83_91_61,1.0,0,61,61,77
5,r_115_47_11,r_64_4_176,seq81,r_115_47_11,0.91,0,11,11,77
99,seq127,r_38_63_169,r_83_91_61,r_38_63_169,0.82,0,169,169,77
15,r_8_133_51,r_119_50_60,seq32,r_8_133_51,1.0,4,55,51,77
99,seq127,r_11_20_63,r_38_63_169,r_11_20_63,1.0,1,64,63,77
2,r_111_24_158,seq46,seq43,r_111_24_158,0.75,3,161,158,77
47,seq12,r_86_9_197,r_52_70_142,r_52_70_142,1.0,7,149,142,77
74,seq67,seq129,r_64_4_176,r_64_4_176,0.69,0,176,176,77
18,r_74_113_109,seq33,seq3,r_74_113_109,0.94,0,109,109,77
29,r_78_72_62,r_104_2_71,seq46,r_78_72_62,1.0,2,64,62,77
24,r_136_19_98,r_74_113_109,seq134,r_136_19_98,0.99,2,100,98,77
27,r_76_69_49,r_14_92_112,seq116,r_76_69_49,1.0,1,50,49,77
25,r_107_37_173,seq42,r_23_44_157,r_107_37_173,0.61,0,173,173,77
33,r_23_44_157,seq49,r_124_88_121,r_124_88_121,0.99,37,158,121,77
64,seq49,r_23_44_157,r_114_138_19,r_114_138_19,0.66,139,158,19,77
28,r_55_34_10,r_111_24_158,seq30,r_55_34_10,1.0,0,10,10,77
70,seq59,r_15_126_92,seq12,r_15_126_92,1.0,0,92,92,77
39,r_94_101_12,seq121,seq12,r_94_101_12,0.86,0,12,12,77
61,seq42,r_107_37_173,r_120_6_126,r_120_6_126,0.86,47,173,126,77
32,r_52_70_142,seq89,seq12,r_52_70_142,0.88,0,142,142,77
34,r_118_132_90,r_111_24_158,r_100_57_23,r_111_24_158,0.48,-68,90,158,77
38,r_35_21_22,r_64_4_176,seq128,r_35_21_22,1.0,1,23,22,77
17,r_90_7_113,seq89,r_136_19_98,r_90_7_113,0.56,0,113,113,77
6,r_17_97_103,seq31,seq116,r_17_97_103,0.58,0,103,103,77
7,r_14_92_112,seq85,r_119_50_60,r_14_92_112,0.63,6,118,112,77
23,r_119_50_60,seq62,r_14_92_112,r_119_50_60,0.55,88,148,60,77
30,r_21_75_121,seq116,seq111,r_21_75_121,0.9,1,122,121,78
20,r_128_81_35,seq111,r_132_122_41,r_128_81_35,0.96,0,35,35,78
36,r_123_76_86,r_6_11_143,seq72,r_6_11_143,1.0,-52,91,143,78
14,r_12_49_180,seq131,r_126_119_25,r_126_119_25,0.71,155,180,25,78
21,r_20_103_15,r_107_5_102,seq116,r_20_103_15,0.74,0,15,15,78
59,seq37,r_123_76_86,r_113_34_38,r_113_34_38,0.99,23,61,38,78
55,seq29,r_4_88_136,seq62,r_4_88_136,1.0,0,136,136,78
16,r_4_88_136,seq29,r_10_71_29,r_4_88_136,0.89,0,136,136,78
39,r_91_56_177,seq117,r_17_92_79,r_17_92_79,1.0,98,177,79,78
34,r_98_35_42,seq72,seq27,r_98_35_42,1.0,0,42,42,78
1,r_93_50_60,r_86_96_119,seq57,r_93_50_60,1.0,0,60,60,78
46,seq13,seq82,r_80_84_141,r_80_84_141,1.0,21,162,141,78
80,seq83,r_73_14_174,seq39,r_73_14_174,0.84,-19,155,174,78
32,r_113_34_38,r_79_70_156,seq37,r_113_34_38,1.0,0,38,38,78
95,seq116,r_21_75_121,r_20_103_15,r_21_75_121,0.99,-49,72,121,78
82,seq90,r_16_105_44,seq15,r_16_105_44,1.0,7,51,44,78
38,r_6_11_143,r_93_50_60,seq29,r_6_11_143,1.0,0,143,143,78
3,r_0_58_85,seq18,seq118,r_0_58_85,0.99,0,85,85,78
26,r_23_77_125,seq7,seq116,r_23_77_125,0.94,0,125,125,78
84,seq94,r_10_71_29,seq82,r_10_71_29,0.98,1,30,29,78
13,r_80_84_141,seq69,seq13,r_80_84_141,0.66,1,142,141,78
15,r_55_59_73,r_73_14_174,seq1,r_55_59_73,1.0,0,73,73,78
48,seq18,r_0_58_85,seq1,r_0_58_85,1.0,-4,81,85,78
19,r_10_71_29,seq94,seq19,r_10_71_29,1.0,0,29,29,78
37,r_66_31_40,r_53_32_138,seq1,r_66_31_40,0.71,4,44,40,78
74,seq67,r_40_64_155,seq43,r_40_64_155,0.9,0,155,155,78
18,r_102_41_63,seq9,seq25,r_102_41_63,1.0,-1,62,63,78
29,r_2_106_166,r_97_124_197,r_20_103_15,r_97_124_197,0.74,-30,167,197,78
24,r_65_8_169,r_120_3_178,r_127_89_61,r_127_89_61,0.79,108,169,61,78
25,r_86_96_119,r_93_50_60,seq136,r_93_50_60,0.97,0,60,60,78
28,r_114_139_48,seq112,seq117,r_114_139_48,1.0,0,48,48,78
65,seq45,seq94,r_17_92_79,r_17_92_79,1.0,0,79,79,78
38,r_6_11_143,r_123_76_86,r_93_50_60,r_93_50_60,1.0,38,98,60,78
77,seq72,seq125,r_123_76_86,r_123_76_86,0.54,-1,85,86,78
2,r_16_105_44,seq90,seq42,r_16_105_44,1.0,8,52,44,78
6,r_63_74_33,seq13,seq36,r_63_74_33,1.0,0,33,33,78
17,r_133_46_167,seq51,r_98_35_42,r_133_46_167,0.58,0,167,167,78
25,r_86_96_119,seq136,seq52,r_86_96_119,1.0,2,121,119,78
9,r_110_134_98,seq52,seq69,r_110_134_98,1.0,0,98,98,78
22,r_17_92_79,r_79_70_156,seq45,r_17_92_79,0.98,0,79,79,78
84,seq94,seq82,r_107_5_102,r_107_5_102,1.0,5,107,102,78
10,r_126_119_25,seq39,seq111,r_126_119_25,0.99,0,25,25,78
56,seq30,seq69,r_17_92_79,r_17_92_79,0.61,55,134,79,78
7,r_53_32_138,r_127_89_61,r_44_87_64,r_53_32_138,0.35,6,144,138,78
23,r_73_14_174,r_55_59_73,seq104,r_55_59_73,0.98,-2,71,73,78
35,r_107_5_102,seq118,seq94,r_107_5_102,1.0,3,105,102,78
12,r_137_22_157,r_120_3_178,r_126_119_25,r_137_22_157,0.88,0,157,157,78
30,r_77_35_111,r_54_33_85,r_124_31_179,r_54_33_85,1.0,0,85,85,79
23,r_44_14_37,r_45_128_194,seq43,r_44_14_37,0.93,1,38,37,79
20,r_111_69_123,r_22_97_36,r_136_58_29,r_111_69_123,1.0,-86,37,123,79
36,r_46_68_88,seq50,r_29_25_46,r_46_68_88,0.99,0,88,88,79
33,r_129_8_56,r_47_95_80,seq9,r_129_8_56,1.0,0,56,56,79
3,r_139_98_26,r_93_86_167,r_5_52_157,r_139_98_26,0.9,134,160,26,79
16,r_54_33_85,r_77_35_111,seq120,r_54_33_85,1.0,0,85,85,79
21,r_37_79_94,r_5_52_157,seq82,r_37_79_94,1.0,0,94,94,79
39,r_3_88_137,seq99,r_92_32_54,r_3_88_137,1.0,0,137,137,79
1,r_93_86_167,r_62_18_115,r_139_98_26,r_93_86_167,0.99,-51,116,167,79
97,seq123,r_53_121_190,r_47_95_80,r_47_95_80,1.0,110,190,80,79
15,r_96_122_58,seq57,r_67_108_2,r_96_122_58,1.0,0,58,58,79
9,r_66_81_48,seq57,seq134,r_66_81_48,1.0,0,48,48,79
66,seq50,r_46_68_88,seq21,r_46_68_88,1.0,0,88,88,79
31,r_19_137_146,seq131,seq135,r_19_137_146,0.9,0,146,146,79
1,r_93_86_167,r_139_98_26,r_11_118_129,r_93_86_167,1.0,0,167,167,79
30,r_77_35_111,r_124_31_179,r_90_40_40,r_77_35_111,0.58,5,116,111,79
14,r_90_40_40,r_19_137_146,seq4,r_90_40_40,1.0,0,40,40,79
26,r_45_128_194,r_138_17_161,seq1,r_138_17_161,0.99,-78,83,161,79
4,r_49_94_143,seq23,r_136_58_29,r_49_94_143,0.72,0,143,143,79
78,seq75,r_47_95_80,seq59,r_47_95_80,1.0,0,80,80,79
11,r_127_110_125,seq39,r_119_41_33,r_127_110_125,0.95,0,125,125,79
6,r_63_55_71,seq36,seq27,r_63_55_71,0.99,0,71,71,79
99,seq126,r_76_116_55,seq133,r_76_116_55,1.0,125,180,55,79
13,r_76_116_55,seq34,r_74_85_102,r_74_85_102,0.98,0,102,102,79
13,r_76_116_55,r_47_95_80,seq34,r_76_116_55,1.0,0,55,55,79
87,seq99,r_3_88_137,seq1,r_3_88_137,1.0,-50,87,137,79
29,r_62_18_115,r_93_86_167,r_29_25_46,r_62_18_115,1.0,1,116,115,79
25,r_109_30_118,seq134,seq120,r_109_30_118,0.4,-14,104,118,79
61,seq134,r_109_30_118,r_66_81_48,r_66_81_48,1.0,73,121,48,79
32,r_5_52_157,seq70,r_139_98_26,r_5_52_157,0.59,-1,156,157,79
38,r_138_17_161,r_45_128_194,r_51_24_158,r_138_17_161,0.86,0,161,161,79
52,seq16,r_109_30_118,r_29_25_46,r_29_25_46,1.0,24,70,46,79
27,r_67_108_2,r_63_55_71,r_96_122_58,r_63_55_71,0.77,-13,58,71,79
18,r_29_25_46,r_138_17_161,seq16,r_29_25_46,1.0,0,46,46,79
34,r_124_31_179,seq105,r_119_41_33,r_124_31_179,0.54,0,179,179,79
7,r_136_58_29,r_83_132_53,r_111_69_123,r_136_58_29,1.0,1,30,29,79
81,seq82,seq64,r_37_79_94,r_37_79_94,0.99,0,94,94,79
17,r_114_112_153,r_53_121_190,seq1,r_114_112_153,0.66,0,153,153,79
24,r_92_32_54,r_111_69_123,seq56,r_92_32_54,1.0,0,54,54,79
22,r_74_85_102,seq84,r_76_116_55,r_76_116_55,0.99,47,102,55,79
91,seq105,r_124_31_179,seq123,r_124_31_179,0.53,0,179,179,79
49,seq12,r_51_24_158,r_83_132_53,r_83_132_53,0.95,105,158,53,79
3,r_139_98_26,seq50,r_93_86_167,r_139_98_26,1.0,-1,25,26,79
82,seq84,r_74_85_102,r_129_8_56,r_129_8_56,1.0,33,89,56,79
10,r_83_132_53,seq26,seq12,r_83_132_53,1.0,0,53,53,79
19,r_22_97_36,r_111_69_123,r_67_108_2,r_22_97_36,1.0,1,37,36,79
35,r_51_24_158,seq12,seq50,r_51_24_158,0.68,0,158,158,79
12,r_47_95_80,seq75,r_111_69_123,r_47_95_80,1.0,0,80,80,79
2,r_119_41_33,seq78,seq130,r_119_41_33,0.85,3,36,33,79
30,r_118_127_137,seq133,seq85,r_118_127_137,0.77,0,137,137,80
92,seq110,r_94_75_93,seq87,r_94_75_93,1.0,0,93,93,80
8,r_42_125_86,seq10,seq133,r_42_125_86,1.0,0,86,86,80
16,r_40_16_188,r_88_41_176,r_0_65_126,r_0_65_126,1.0,62,188,126,80
21,r_61_86_146,seq6,r_42_125_86,r_61_86_146,0.84,0,146,146,80
1,r_89_70_185,seq14,r_4_105_121,r_4_105_121,0.73,64,185,121,80
39,r_60_120_16,r_58_29_83,seq106,r_58_29_83,0.62,-65,18,83,80
4,r_95_79_25,r_139_64_142,r_23_15_13,r_95_79_25,0.84,0,25,25,80
14,r_47_124_41,seq128,seq59,r_47_124_41,0.84,5,46,41,80
45,seq133,r_103_69_123,r_42_125_86,r_42_125_86,1.0,2,88,86,80
73,seq63,seq20,r_9_68_183,r_9_68_183,0.64,0,183,183,80
26,r_136_66_53,seq130,seq92,r_136_66_53,1.0,0,53,53,80
31,r_13_77_173,seq45,r_51_38_139,r_51_38_139,0.72,37,176,139,80
67,seq45,r_13_77_173,r_39_71_136,r_39_71_136,1.0,40,176,136,80
10,r_12_48_60,seq26,seq43,r_12_48_60,0.84,8,68,60,80
0,r_88_41_176,r_40_16_188,r_58_29_83,r_58_29_83,1.0,96,179,83,80
92,seq110,seq87,r_3_55_128,r_3_55_128,1.0,0,128,128,80
11,r_139_64_142,seq33,r_118_127_137,r_139_64_142,0.94,2,144,142,80
20,r_58_29_83,seq114,seq44,r_58_29_83,1.0,0,83,83,80
15,r_122_137_124,seq59,seq85,r_122_137_124,0.64,0,124,124,80
6,r_94_75_93,seq110,seq119,r_94_75_93,1.0,0,93,93,80
87,seq100,r_54_134_108,r_51_38_139,r_51_38_139,1.0,15,154,139,80
27,r_98_5_77,r_46_129_198,seq80,r_98_5_77,1.0,1,78,77,80
87,seq100,r_126_109_94,r_54_134_108,r_126_109_94,0.87,0,94,94,80
18,r_0_65_126,r_3_55_128,seq6,r_0_65_126,1.0,0,126,126,80
29,r_103_69_123,seq114,r_136_66_53,r_136_66_53,1.0,56,109,53,80
24,r_74_36_66,r_39_71_136,seq21,r_39_71_136,0.6,-69,67,136,80
33,r_4_105_121,seq43,seq53,r_4_105_121,0.99,0,121,121,80
50,seq14,r_112_82_138,r_52_24_75,r_52_24_75,1.0,63,138,75,80
38,r_108_90_80,seq92,seq34,r_108_90_80,1.0,0,80,80,80
81,seq85,seq128,r_118_127_137,r_118_127_137,0.9,16,153,137,80
17,r_3_55_128,seq44,seq110,r_3_55_128,0.98,0,128,128,80
94,seq113,r_9_68_183,r_4_105_121,r_4_105_121,0.99,63,184,121,80
9,r_39_71_136,seq138,seq45,r_39_71_136,0.98,0,136,136,80
22,r_54_134_108,seq132,seq49,r_54_134_108,0.84,-8,100,108,80
28,r_126_109_94,seq100,seq128,r_126_109_94,1.0,0,94,94,80
7,r_51_38_139,seq21,seq100,r_51_38_139,0.96,0,139,139,80
79,seq81,r_112_82_138,r_52_24_75,r_52_24_75,0.99,6,81,75,80
35,r_52_24_75,r_139_64_142,seq81,r_52_24_75,1.0,0,75,75,80
12,r_25_62_79,r_3_55_128,seq14,r_25_62_79,0.96,1,80,79,80
37,r_135_97_18,r_122_137_124,seq106,r_135_97_18,1.0,0,18,18,80
36,r_23_15_13,seq85,seq114,r_23_15_13,1.0,0,13,13,80
30,r_33_22_133,seq66,r_19_126_61,r_33_22_133,0.96,-1,132,133,81
51,seq21,r_84_6_96,r_112_4_156,r_84_6_96,1.0,-7,89,96,81
36,r_0_94_110,r_109_65_150,r_113_108_91,r_109_65_150,1.0,-40,110,150,81
53,seq24,r_64_132_83,r_90_78_75,r_90_78_75,0.81,8,83,75,81
1,r_109_65_150,seq28,r_10_56_100,r_109_65_150,1.0,2,152,150,81
16,r_10_56_100,seq82,seq105,r_10_56_100,0.58,5,105,100,81
21,r_39_135_191,seq17,seq82,r_39_135_191,0.45,-26,165,191,81
39,r_91_14_177,seq67,r_111_59_162,r_91_14_177,0.68,0,177,177,81
1,r_109_65_150,r_0_94_110,seq28,r_0_94_110,1.0,0,110,110,81
5,r_64_132_83,seq24,seq40,r_64_132_83,0.8,0,83,83,81
96,seq120,seq40,r_139_63_53,r_139_63_53,0.69,-5,48,53,81
2,r_110_92_10,r_109_65_150,seq88,r_110_92_10,0.94,0,10,10,81
11,r_84_6_96,seq8,r_95_114_172,r_95_114_172,0.97,0,172,172,81
9,r_115_29_58,r_83_12_71,r_31_50_112,r_115_29_58,0.97,0,58,58,81
3,r_90_78_75,r_89_11_193,seq24,r_90_78_75,0.95,0,75,75,81
10,r_112_4_156,r_76_18_86,seq21,r_76_18_86,1.0,0,86,86,81
73,seq67,r_91_14_177,r_19_126_61,r_19_126_61,1.0,102,163,61,81
11,r_84_6_96,seq21,seq8,r_84_6_96,1.0,0,96,96,81
13,r_113_108_91,seq97,r_61_138_44,r_113_108_91,1.0,1,92,91,81
57,seq34,r_104_71_159,r_54_26_146,r_54_26_146,0.56,13,159,146,81
6,r_35_53_183,seq99,r_128_15_39,r_128_15_39,1.0,27,66,39,81
20,r_27_38_48,r_95_114_172,seq82,r_95_114_172,0.83,-124,48,172,81
51,seq21,r_112_4_156,r_69_58_147,r_112_4_156,0.51,-11,145,156,81
10,r_112_4_156,seq21,seq9,r_112_4_156,0.96,0,156,156,81
27,r_111_59_162,r_31_50_112,seq28,r_31_50_112,0.37,59,171,112,81
31,r_131_30_13,r_64_132_83,seq62,r_131_30_13,0.75,1,14,13,81
18,r_136_130_142,seq7,r_113_108_91,r_136_130_142,0.51,1,143,142,81
37,r_128_15_39,r_112_4_156,r_35_53_183,r_128_15_39,0.93,0,39,39,81
25,r_81_52_84,seq106,seq2,r_81_52_84,0.74,7,91,84,81
29,r_74_44_54,seq77,seq85,r_74_44_54,1.0,1,55,54,81
32,r_139_63_53,r_39_135_191,seq45,r_139_63_53,0.92,5,58,53,81
6,r_35_53_183,r_128_15_39,r_54_26_146,r_128_15_39,0.46,146,185,39,81
38,r_83_12_71,seq16,seq88,r_83_12_71,0.99,0,71,71,81
34,r_69_58_147,seq133,seq21,r_69_58_147,0.62,15,162,147,81
17,r_122_1_77,seq75,seq21,r_122_1_77,0.92,-7,70,77,81
19,r_55_107_33,r_104_71_159,r_131_30_13,r_55_107_33,0.85,0,33,33,81
37,r_128_15_39,r_35_53_183,r_111_59_162,r_35_53_183,0.55,2,185,183,81
22,r_76_18_86,r_112_4_156,seq125,r_76_18_86,1.0,0,86,86,81
28,r_100_86_80,seq79,r_31_50_112,r_100_86_80,1.0,0,80,80,81
7,r_129_93_65,seq48,seq36,r_129_93_65,1.0,2,67,65,81
23,r_54_26_146,seq121,seq34,r_54_26_146,0.89,2,148,146,81
31,r_131_30_13,seq62,r_55_107_33,r_55_107_33,1.0,1,34,33,81
82,seq85,seq70,r_74_44_54,r_74_44_54,1.0,22,76,54,81
24,r_61_138_44,seq73,seq17,r_61_138_44,0.99,3,47,44,81
35,r_104_71_159,seq34,seq40,r_104_71_159,0.71,0,159,159,81
12,r_19_126_61,r_76_18_86,seq57,r_19_126_61,1.0,0,61,61,81
20,r_49_73_35,seq106,r_102_101_94,r_49_73_35,1.0,0,35,35,82
51,seq14,r_46_114_166,r_72_16_90,r_72_16_90,0.91,35,125,90,82
36,r_124_9_60,r_40_44_61,r_88_105_27,r_88_105_27,0.73,33,60,27,82
32,r_19_0_46,r_97_121_59,r_139_98_33,r_19_0_46,0.69,0,46,46,82
19,r_31_2_16,r_74_65_160,seq85,r_31_2_16,0.88,-1,15,16,82
14,r_82_86_150,r_25_99_159,seq81,r_82_86_150,0.99,0,150,150,82
8,r_133_3_89,seq23,seq29,r_133_3_89,1.0,1,90,89,82
37,r_88_105_27,seq118,r_96_83_17,r_96_83_17,1.0,0,17,17,82
30,r_97_121_59,r_122_38_85,seq126,r_122_38_85,0.62,-32,53,85,82
5,r_111_21_156,seq42,seq5,r_111_21_156,0.61,3,159,156,82
4,r_102_101_94,r_49_73_35,seq120,r_102_101_94,1.0,0,94,94,82
35,r_59_110_11,r_102_101_94,r_20_90_192,r_59_110_11,0.5,0,11,11,82
27,r_24_77_43,seq39,r_25_99_159,r_24_77_43,1.0,0,43,43,82
3,r_55_103_190,seq42,r_74_65_160,r_74_65_160,0.66,30,190,160,82
1,r_139_98_33,r_104_6_194,seq79,r_139_98_33,0.81,0,33,33,82
10,r_66_57_112,seq32,seq42,r_66_57_112,1.0,1,113,112,82
26,r_33_94_99,r_46_114_166,r_4_76_187,r_33_94_99,0.96,1,100,99,82
0,r_43_78_120,seq1,r_4_76_187,r_43_78_120,0.79,2,122,120,82
13,r_70_51_106,r_46_114_166,seq10,r_70_51_106,1.0,1,107,106,82
15,r_13_30_68,r_4_76_187,r_49_73_35,r_13_30_68,0.77,-3,65,68,82
1,r_139_98_33,seq79,r_19_0_46,r_19_0_46,0.98,0,46,46,82
6,r_72_16_90,r_82_86_150,seq14,r_72_16_90,0.92,0,90,90,82
39,r_122_38_85,seq8,seq53,r_122_38_85,0.99,0,85,85,82
99,seq126,seq81,r_97_121_59,r_97_121_59,1.0,89,148,59,82
34,r_40_44_61,seq50,seq34,r_40_44_61,0.64,-2,59,61,82
33,r_96_83_17,seq10,r_88_105_27,r_96_83_17,0.99,0,17,17,82
39,r_122_38_85,r_97_121_59,seq8,r_97_121_59,0.88,-6,53,59,82
65,seq42,r_55_103_190,r_43_78_120,r_43_78_120,0.89,70,190,120,82
11,r_89_117_28,seq5,seq113,r_89_117_28,0.96,0,28,28,82
38,r_46_114_166,seq14,r_116_95_174,r_46_114_166,0.92,0,166,166,82
60,seq34,seq112,r_40_44_61,r_40_44_61,0.91,9,70,61,82
17,r_26_127_119,seq29,r_22_119_73,r_26_127_119,1.0,0,119,119,82
9,r_116_95_174,seq138,r_46_114_166,r_46_114_166,0.91,10,176,166,82
20,r_49_73_35,r_102_101_94,r_13_30_68,r_49_73_35,0.98,59,94,35,82
28,r_131_7_92,r_46_114_166,seq36,r_131_7_92,0.86,2,94,92,82
4,r_102_101_94,r_82_86_150,r_49_73_35,r_49_73_35,1.0,0,35,35,82
23,r_109_135_97,r_82_86_150,seq29,r_109_135_97,1.0,0,97,97,82
12,r_45_87_172,seq50,r_102_101_94,r_45_87_172,0.65,0,172,172,82
2,r_63_52_53,r_104_6_194,seq118,r_63_52_53,0.78,-8,45,53,82
30,r_97_119_136,r_38_69_140,seq135,r_97_119_136,1.0,0,136,136,83
36,r_71_103_176,seq89,r_73_132_59,r_73_132_59,1.0,126,185,59,83
26,r_63_7_38,seq108,seq44,r_63_7_38,0.92,2,40,38,83
16,r_124_105_86,seq8,seq44,r_124_105_86,0.99,0,86,86,83
5,r_80_23_94,r_38_69_140,seq19,r_38_69_140,0.76,-39,101,140,83
8,r_72_9_54,seq60,r_48_84_33,r_72_9_54,0.87,5,59,54,83
20,r_21_55_43,r_138_77_156,seq111,r_21_55_43,0.6,0,43,43,83
31,r_117_41_72,seq40,seq106,r_117_41_72,0.77,6,78,72,83
89,seq94,r_75_91_128,r_97_119_136,r_97_119_136,0.99,13,149,136,83
10,r_30_49_166,seq8,r_51_102_87,r_30_49_166,0.37,1,167,166,83
72,seq60,r_72_9_54,r_80_23_94,r_80_23_94,0.53,39,133,94,83
65,seq42,r_27_76_56,seq61,r_27_76_56,1.0,0,56,56,83
4,r_125_107_151,seq39,r_75_91_128,r_75_91_128,0.81,25,153,128,83
0,r_37_116_99,seq106,seq108,r_37_116_99,0.85,1,100,99,83
63,seq39,r_125_107_151,r_51_102_87,r_51_102_87,0.65,66,153,87,83
13,r_51_102_87,r_78_95_165,seq39,r_51_102_87,0.71,10,97,87,83
15,r_98_16_155,seq62,seq121,r_98_16_155,0.93,2,157,155,83
27,r_73_132_59,seq44,seq65,r_73_132_59,1.0,1,60,59,83
25,r_100_47_21,r_117_41_72,seq17,r_100_47_21,0.82,6,27,21,83
14,r_122_118_35,r_120_11_17,r_1_101_184,r_122_118_35,0.84,7,42,35,83
47,seq135,r_78_95_165,r_97_119_136,r_97_119_136,0.55,30,166,136,83
24,r_3_2_14,r_78_95_165,seq131,r_3_2_14,0.51,3,17,14,83
18,r_43_53_123,seq29,seq40,r_43_53_123,1.0,0,123,123,83
29,r_123_67_164,seq35,seq18,r_123_67_164,0.81,0,164,164,83
1,r_127_28_29,r_13_104_69,seq88,r_127_28_29,0.95,0,29,29,83
61,seq35,r_123_67_164,seq64,r_123_67_164,1.0,0,164,164,83
38,r_25_136_160,seq115,r_72_9_54,r_25_136_160,0.84,0,160,160,83
34,r_13_104_69,seq137,seq36,r_13_104_69,1.0,0,69,69,83
3,r_1_101_184,seq61,r_122_118_35,r_122_118_35,0.98,-3,32,35,83
17,r_38_69_140,seq46,seq29,r_38_69_140,1.0,0,140,140,83
86,seq88,r_98_16_155,r_127_28_29,r_127_28_29,0.84,7,36,29,83
19,r_48_84_33,r_80_23_94,r_72_9_54,r_48_84_33,0.68,0,33,33,83
28,r_24_110_185,seq12,r_92_52_8,r_92_52_8,0.65,177,185,8,83
49,seq137,r_13_104_69,r_92_52_8,r_13_104_69,0.78,-5,64,69,83
32,r_27_76_56,seq42,seq83,r_27_76_56,1.0,0,56,56,83
23,r_75_91_128,seq94,r_125_107_151,r_75_91_128,0.64,21,149,128,83
33,r_20_31_19,r_37_116_99,seq87,r_20_31_19,0.84,0,19,19,83
35,r_26_22_92,seq93,seq8,r_26_22_92,1.0,-1,91,92,83
12,r_78_95_165,seq135,r_80_23_94,r_78_95_165,0.86,1,166,165,83
30,r_61_86_63,seq52,r_94_132_43,r_94_132_43,0.84,22,65,43,84
4,r_128_107_13,r_139_109_195,seq135,r_128_107_13,0.98,0,13,13,84
8,r_14_6_175,seq9,r_51_56_147,r_14_6_175,0.49,1,176,175,84
16,r_49_127_9,r_128_107_13,seq83,r_128_107_13,0.64,-3,10,13,84
20,r_74_26_48,r_134_110_161,seq8,r_74_26_48,0.47,-8,40,48,84
21,r_0_11_169,seq87,seq44,r_0_11_169,0.59,0,169,169,84
1,r_62_23_131,r_1_138_67,seq87,r_62_23_131,0.78,1,132,131,84
1,r_62_23_131,seq97,r_1_138_67,r_1_138_67,1.0,2,69,67,84
95,seq116,r_139_109_195,r_100_40_21,r_100_40_21,1.0,0,21,21,84
34,r_71_85_10,r_31_75_45,seq2,r_31_75_45,0.53,-35,10,45,84
15,r_54_58_114,r_68_47_180,r_134_110_161,r_54_58_114,0.98,68,182,114,84
32,r_29_55_17,r_79_38_194,r_31_75_45,r_31_75_45,0.52,12,57,45,84
25,r_19_108_193,r_25_122_15,seq125,r_19_108_193,0.84,-179,14,193,84
31,r_1_138_67,r_111_13_79,r_62_23_131,r_62_23_131,0.96,-63,68,131,84
14,r_25_122_15,r_19_108_193,seq70,r_25_122_15,0.99,-1,14,15,84
26,r_59_46_158,r_54_58_114,seq27,r_54_58_114,0.98,-42,72,114,84
0,r_92_123_148,seq48,seq133,r_92_123_148,0.87,1,149,148,84
39,r_31_75_45,seq70,r_29_55_17,r_31_75_45,0.99,0,45,45,84
11,r_30_57_72,r_63_12_143,r_71_85_10,r_30_57_72,1.0,0,72,72,84
15,r_54_58_114,r_59_46_158,r_68_47_180,r_54_58_114,0.89,1,115,114,84
25,r_19_108_193,seq125,r_137_50_49,r_137_50_49,1.0,6,55,49,84
27,r_117_7_162,r_31_75_45,r_54_58_114,r_31_75_45,0.8,24,69,45,84
29,r_137_50_49,r_111_13_79,r_19_108_193,r_137_50_49,1.0,0,49,49,84
2,r_77_99_181,seq17,r_1_138_67,r_1_138_67,1.0,115,182,67,84
24,r_63_12_143,seq67,seq131,r_63_12_143,0.79,0,143,143,84
37,r_94_132_43,r_74_26_48,seq130,r_94_132_43,1.0,-1,42,43,84
38,r_129_10_156,r_77_99_181,r_61_86_63,r_129_10_156,0.83,1,157,156,84
52,seq21,r_96_72_99,r_62_23_131,r_96_72_99,0.9,0,99,99,84
18,r_20_102_38,seq27,r_25_122_15,r_25_122_15,0.82,23,38,15,84
35,r_32_95_41,r_77_99_181,r_74_26_48,r_32_95_41,1.0,3,44,41,84
3,r_100_40_21,seq82,seq116,r_100_40_21,0.98,0,21,21,84
9,r_51_56_147,r_120_115_176,seq44,r_120_115_176,0.57,-29,147,176,84
26,r_59_46_158,seq27,seq113,r_59_46_158,0.98,0,158,158,84
31,r_1_138_67,r_62_23_131,r_79_38_194,r_62_23_131,0.65,12,143,131,84
28,r_73_124_137,seq98,r_101_18_198,r_73_124_137,0.98,0,137,137,84
27,r_117_7_162,r_54_58_114,r_30_57_72,r_117_7_162,0.86,-44,118,162,84
7,r_96_72_99,seq21,seq60,r_96_72_99,1.0,0,99,99,84
32,r_29_55_17,r_120_115_176,r_79_38_194,r_29_55_17,0.97,0,17,17,84
12,r_111_13_79,seq41,seq9,r_111_13_79,1.0,0,79,79,84
30,r_114_98_103,r_101_115_156,seq113,r_114_98_103,1.0,0,103,103,85
36,r_109_7_77,seq112,r_97_74_19,r_109_7_77,0.98,0,77,77,85
92,seq113,r_28_20_181,r_114_98_103,r_114_98_103,0.97,4,107,103,85
14,r_13_59_112,seq64,r_93_2_198,r_13_59_112,1.0,0,112,112,85
83,seq88,r_101_115_156,seq111,r_101_115_156,0.78,0,156,156,85
56,seq35,seq51,r_136_4_23,r_136_4_23,1.0,0,23,23,85
55,seq34,r_73_127_113,r_25_133_104,r_73_127_113,0.96,-17,96,113,85
16,r_63_22_61,r_99_86_169,r_83_56_60,r_63_22_61,1.0,0,61,61,85
39,r_55_19_90,seq102,seq47,r_55_19_90,1.0,0,90,90,85
69,seq53,r_17_110_79,r_18_125_20,r_18_125_20,0.43,60,80,20,85
3,r_99_86_169,r_63_22_61,r_132_122_12,r_63_22_61,0.64,-27,34,61,85
21,r_97_74_19,r_90_32_167,seq124,r_97_74_19,1.0,0,19,19,85
67,seq51,seq14,r_24_26_73,r_24_26_73,1.0,9,82,73,85
4,r_123_29_178,seq100,r_95_78_28,r_95_78_28,1.0,50,78,28,85
0,r_128_130_110,seq60,seq131,r_128_130_110,1.0,0,110,110,85
11,r_3_82_64,r_99_86_169,seq46,r_3_82_64,1.0,0,64,64,85
8,r_33_65_6,seq37,seq107,r_33_65_6,0.62,131,137,6,85
31,r_95_78_28,seq41,r_123_29_178,r_95_78_28,1.0,0,28,28,85
4,r_123_29_178,r_95_78_28,r_108_61_72,r_95_78_28,0.51,150,178,28,85
8,r_33_65_6,r_83_56_60,seq111,r_83_56_60,1.0,0,60,60,85
6,r_24_26_73,seq8,seq51,r_24_26_73,1.0,0,73,73,85
18,r_136_4_23,seq21,seq35,r_136_4_23,1.0,0,23,23,85
62,seq46,r_5_23_177,r_3_82_64,r_3_82_64,1.0,0,64,64,85
89,seq107,r_83_56_60,seq111,r_83_56_60,0.86,-17,43,60,85
74,seq64,r_13_59_112,r_31_42_10,r_13_59_112,0.74,0,112,112,85
29,r_73_127_113,seq34,r_40_117_108,r_73_127_113,1.0,0,113,113,85
5,r_31_42_10,seq52,seq87,r_31_42_10,0.91,0,10,10,85
24,r_92_71_100,seq129,seq124,r_92_71_100,1.0,0,100,100,85
19,r_62_80_51,seq121,seq52,r_62_80_51,0.98,0,51,51,85
25,r_28_20_181,r_73_127_113,r_83_56_60,r_28_20_181,0.69,-99,82,181,85
70,seq58,r_72_103_162,seq27,r_72_103_162,0.99,0,162,162,85
33,r_108_61_72,seq116,seq111,r_108_61_72,1.0,0,72,72,85
70,seq58,r_70_36_129,r_72_103_162,r_70_36_129,0.98,0,129,129,85
68,seq52,r_3_82_64,r_62_80_51,r_3_82_64,0.91,0,64,64,85
61,seq45,r_104_39_186,r_33_65_6,r_33_65_6,0.52,180,186,6,85
32,r_30_79_86,seq46,r_18_125_20,r_30_79_86,1.0,2,88,86,85
38,r_101_115_156,seq88,seq41,r_101_115_156,0.92,0,156,156,85
26,r_132_122_12,r_72_103_162,r_99_86_169,r_132_122_12,0.81,0,12,12,85
34,r_106_105_67,r_13_59_112,r_99_86_169,r_106_105_67,0.79,0,67,67,85
35,r_54_57_24,seq84,seq116,r_54_57_24,0.72,2,26,24,85
7,r_18_125_20,r_128_130_110,seq6,r_18_125_20,1.0,1,21,20,85
17,r_5_23_177,seq46,r_95_78_28,r_95_78_28,0.95,149,177,28,85
25,r_28_20_181,r_83_56_60,r_97_74_19,r_28_20_181,0.52,1,182,181,85
28,r_83_56_60,r_28_20_181,r_25_133_104,r_28_20_181,0.67,1,182,181,85
9,r_72_103_162,seq129,r_18_125_20,r_72_103_162,0.48,0,162,162,85
31,r_95_78_28,r_123_29_178,r_5_23_177,r_5_23_177,0.76,1,178,177,85
22,r_70_36_129,seq58,seq53,r_70_36_129,0.84,0,129,129,85
91,seq112,r_109_7_77,seq0,r_109_7_77,1.0,-5,72,77,85
43,seq6,r_17_110_79,r_18_125_20,r_18_125_20,1.0,2,22,20,85
82,seq87,r_13_59_112,r_31_42_10,r_13_59_112,0.83,-16,96,112,85
28,r_83_56_60,r_33_65_6,r_28_20_181,r_83_56_60,1.0,0,60,60,85
12,r_40_117_108,seq45,seq44,r_40_117_108,0.82,10,118,108,85
36,r_125_57_91,r_48_110_113,seq72,r_125_57_91,0.8,-3,88,91,86
14,r_130_77_71,r_48_110_113,seq32,r_130_77_71,1.0,0,71,71,86
8,r_116_4_130,seq18,seq109,r_116_4_130,0.82,0,130,130,86
30,r_119_51_56,r_34_2_173,seq0,r_119_51_56,1.0,0,56,56,86
37,r_80_134_115,r_64_101_163,seq37,r_80_134_115,1.0,0,115,115,86
16,r_131_19_182,seq55,r_48_110_113,r_131_19_182,0.46,0,182,182,86
21,r_5_25_96,seq60,seq128,r_5_25_96,0.99,1,97,96,86
97,seq120,seq37,r_54_44_94,r_54_44_94,1.0,11,105,94,86
5,r_40_79_72,r_54_44_94,seq32,r_40_79_72,0.92,0,72,72,86
27,r_74_29_54,r_48_110_113,seq124,r_74_29_54,1.0,0,54,54,86
11,r_127_49_168,r_46_59_105,seq62,r_127_49_168,0.99,1,169,168,86
40,seq0,seq138,r_119_51_56,r_119_51_56,1.0,0,56,56,86
38,r_24_67_79,r_87_133_165,r_76_14_43,r_87_133_165,0.82,-4,161,165,86
31,r_102_105_109,seq128,seq21,r_102_105_109,0.98,0,109,109,86
3,r_95_103_120,seq121,seq118,r_95_103_120,0.99,0,120,120,86
26,r_136_123_77,seq41,seq3,r_136_123_77,1.0,0,77,77,86
20,r_35_81_49,seq83,seq137,r_35_81_49,1.0,0,49,49,86
0,r_100_58_80,seq109,seq31,r_100_58_80,1.0,0,80,80,86
11,r_127_49_168,seq121,r_46_59_105,r_46_59_105,1.0,4,109,105,86
28,r_23_75_25,seq37,seq121,r_23_75_25,1.0,0,25,25,86
13,r_86_108_122,seq15,seq32,r_86_108_122,0.71,0,122,122,86
15,r_54_44_94,r_92_66_118,seq120,r_54_44_94,1.0,0,94,94,86
6,r_117_42_86,r_132_126_90,seq15,r_117_42_86,0.98,0,86,86,86
22,r_17_26_41,seq128,r_64_101_163,r_17_26_41,0.43,112,153,41,86
33,r_112_89_11,seq53,seq9,r_112_89_11,0.89,0,11,11,86
29,r_87_133_165,seq1,r_24_67_79,r_24_67_79,0.89,2,81,79,86
22,r_17_26_41,seq138,seq128,r_17_26_41,0.83,0,41,41,86
24,r_111_52_89,seq1,r_132_126_90,r_111_52_89,1.0,1,90,89,86
25,r_92_66_118,seq129,seq20,r_92_66_118,0.91,3,121,118,86
33,r_112_89_11,seq9,r_13_8_55,r_13_8_55,1.0,9,64,55,86
70,seq56,r_34_2_173,seq31,r_34_2_173,0.99,-22,151,173,86
38,r_24_67_79,r_95_103_120,r_87_133_165,r_95_103_120,0.9,-39,81,120,86
1,r_76_14_43,r_5_25_96,seq3,r_76_14_43,1.0,0,43,43,86
81,seq73,r_64_101_163,seq62,r_64_101_163,0.76,2,165,163,86
2,r_50_107_32,r_95_103_120,seq11,r_95_103_120,0.81,-83,37,120,86
9,r_46_59_105,seq94,seq68,r_46_59_105,0.96,0,105,105,86
29,r_87_133_165,r_24_67_79,seq21,r_87_133_165,0.84,0,165,165,86
7,r_48_110_113,r_125_57_91,seq20,r_48_110_113,0.77,-14,99,113,86
39,r_63_43_45,r_117_42_86,r_39_90_198,r_63_43_45,1.0,3,48,45,86
32,r_13_8_55,seq120,r_112_89_11,r_13_8_55,1.0,1,56,55,86
23,r_132_126_90,seq124,r_111_52_89,r_132_126_90,0.99,0,90,90,86
35,r_33_7_133,seq70,r_23_75_25,r_33_7_133,0.94,0,133,133,86
12,r_64_101_163,seq73,r_17_26_41,r_17_26_41,0.93,114,155,41,86
30,r_132_35_78,seq80,seq45,r_132_35_78,1.0,1,79,78,87
36,r_21_41_173,seq59,seq40,r_21_41_173,0.58,0,173,173,87
9,r_22_44_142,r_102_93_181,r_109_68_56,r_22_44_142,0.86,0,142,142,87
14,r_76_50_183,r_19_8_103,r_82_103_198,r_19_8_103,0.99,0,103,103,87
8,r_19_8_103,r_76_50_183,r_102_93_181,r_19_8_103,0.99,0,103,103,87
9,r_22_44_142,r_109_68_56,r_62_114_162,r_62_114_162,0.93,0,162,162,87
37,r_99_81_77,r_22_44_142,seq54,r_99_81_77,0.97,0,77,77,87
59,seq34,seq39,r_28_15_160,r_28_15_160,0.51,-4,156,160,87
16,r_98_85_65,seq16,r_1_63_49,r_98_85_65,1.0,0,65,65,87
39,r_135_64_132,r_77_6_159,seq80,r_135_64_132,0.98,0,132,132,87
2,r_94_10_18,r_49_36_38,seq66,r_94_10_18,0.98,0,18,18,87
19,r_106_101_83,seq91,seq17,r_106_101_83,0.93,2,85,83,87
66,seq46,r_28_15_160,r_30_12_1,r_28_15_160,0.88,-23,137,160,87
76,seq71,seq31,r_133_127_81,r_133_127_81,1.0,27,108,81,87
31,r_62_114_162,seq38,r_58_27_24,r_62_114_162,0.37,-82,80,162,87
23,r_49_36_38,seq137,seq110,r_49_36_38,0.99,2,40,38,87
95,seq119,r_1_63_49,r_125_115_148,r_1_63_49,1.0,0,49,49,87
26,r_24_107_104,seq45,r_62_114_162,r_24_107_104,0.92,0,104,104,87
14,r_76_50_183,r_82_103_198,r_19_8_103,r_76_50_183,0.53,0,183,183,87
35,r_11_129_17,seq31,seq3,r_11_129_17,0.93,0,17,17,87
4,r_113_78_154,seq29,seq2,r_113_78_154,0.68,0,154,154,87
0,r_55_111_133,seq54,seq131,r_55_111_133,0.92,0,133,133,87
11,r_32_52_147,seq138,seq128,r_32_52_147,1.0,0,147,147,87
13,r_112_122_102,seq3,r_99_81_77,r_112_122_102,0.97,1,103,102,87
15,r_25_33_189,seq120,r_84_47_95,r_25_33_189,0.51,0,189,189,87
57,seq29,r_113_78_154,seq42,r_113_78_154,1.0,0,154,154,87
6,r_77_6_159,r_135_64_132,r_102_93_181,r_135_64_132,0.77,0,132,132,87
21,r_1_63_49,r_108_48_167,r_98_85_65,r_1_63_49,0.83,27,76,49,87
31,r_62_114_162,r_58_27_24,r_24_107_104,r_24_107_104,0.54,1,105,104,87
73,seq66,r_125_115_148,r_94_10_18,r_94_10_18,0.72,9,27,18,87
74,seq67,seq16,r_109_68_56,r_109_68_56,1.0,47,103,56,87
18,r_125_115_148,seq104,r_112_122_102,r_125_115_148,0.67,0,148,148,87
1,r_109_68_56,r_126_86_197,seq67,r_109_68_56,1.0,2,58,56,87
25,r_133_127_81,seq104,seq71,r_133_127_81,1.0,0,81,81,87
47,seq138,r_32_52_147,seq16,r_32_52_147,0.97,-96,51,147,87
50,seq16,r_98_85_65,seq138,r_98_85_65,1.0,0,65,65,87
70,seq59,r_21_41_173,seq42,r_21_41_173,1.0,0,173,173,87
81,seq79,seq39,r_1_63_49,r_1_63_49,1.0,1,50,49,87
38,r_105_13_87,seq87,seq104,r_105_13_87,1.0,0,87,87,87
26,r_24_107_104,r_62_114_162,seq74,r_24_107_104,0.94,53,157,104,87
31,r_62_114_162,r_24_107_104,r_22_44_142,r_62_114_162,1.0,0,162,162,87
9,r_22_44_142,r_99_81_77,r_102_93_181,r_99_81_77,1.0,0,77,77,87
96,seq120,r_25_33_189,r_55_111_133,r_55_111_133,0.99,56,189,133,87
33,r_95_53_23,r_113_78_154,seq137,r_95_53_23,1.0,0,23,23,87
7,r_88_61_35,r_22_44_142,seq92,r_88_61_35,1.0,0,35,35,87
21,r_1_63_49,seq119,r_108_48_167,r_1_63_49,0.53,0,49,49,87
22,r_84_47_95,r_58_27_24,seq9,r_84_47_95,0.97,1,96,95,87
28,r_30_12_1,r_28_15_160,seq46,r_28_15_160,0.89,2,162,160,87
82,seq80,seq92,r_135_64_132,r_135_64_132,1.0,22,154,132,87
3,r_97_0_37,r_98_85_65,seq45,r_97_0_37,1.0,0,37,37,87
95,seq119,r_125_115_148,seq128,r_125_115_148,1.0,-22,126,148,87
37,r_68_86_59,seq117,seq90,r_68_86_59,0.95,-3,56,59,88
30,r_138_104_97,seq15,seq24,r_138_104_97,0.99,0,97,97,88
36,r_51_58_126,seq27,seq63,r_51_58_126,0.99,1,127,126,88
14,r_69_132_162,seq47,r_91_17_45,r_91_17_45,0.98,118,163,45,88
8,r_5_43_189,seq111,r_19_72_142,r_5_43_189,0.41,0,189,189,88
19,r_95_54_21,seq8,r_97_79_150,r_97_79_150,0.47,3,153,150,88
25,r_81_114_55,r_87_89_61,r_85_133_140,r_85_133_140,0.89,-85,55,140,88
71,seq65,r_48_94_193,r_127_1_113,r_127_1_113,1.0,33,146,113,88
39,r_127_1_113,seq8,seq65,r_127_1_113,0.91,0,113,113,88
6,r_85_133_140,r_116_37_194,r_81_114_55,r_81_114_55,1.0,1,56,55,88
12,r_29_9_33,r_115_38_108,seq136,r_29_9_33,0.99,1,34,33,88
52,seq22,seq46,r_33_42_154,r_33_42_154,0.39,0,154,154,88
27,r_91_17_45,seq117,r_69_132_162,r_69_132_162,0.54,4,166,162,88
31,r_45_61_171,seq129,r_124_64_158,r_45_61_171,0.39,0,171,171,88
90,seq111,r_5_43_189,r_20_2_12,r_5_43_189,0.38,-1,188,189,88
4,r_57_4_94,seq66,seq18,r_57_4_94,0.99,0,94,94,88
63,seq47,r_25_135_116,r_68_86_59,r_68_86_59,0.99,60,119,59,88
20,r_87_89_61,seq70,seq46,r_87_89_61,1.0,0,61,61,88
13,r_25_135_116,seq47,seq28,r_25_135_116,0.62,1,117,116,88
88,seq108,r_139_60_28,seq93,r_139_60_28,0.96,1,29,28,88
48,seq14,seq71,r_124_64_158,r_124_64_158,0.78,4,162,158,88
85,seq101,r_124_64_158,r_29_9_33,r_29_9_33,0.96,125,158,33,88
15,r_74_34_43,seq62,seq102,r_74_34_43,1.0,0,43,43,88
18,r_44_3_9,r_85_133_140,r_116_37_194,r_116_37_194,0.46,-106,88,194,88
29,r_131_122_183,seq75,seq88,r_131_122_183,0.53,0,183,183,88
52,seq22,r_91_17_45,r_5_43_189,r_91_17_45,0.87,0,45,45,88
34,r_139_60_28,seq108,seq101,r_139_60_28,1.0,0,28,28,88
32,r_16_110_137,r_131_122_183,r_138_104_97,r_16_110_137,0.99,0,137,137,88
38,r_35_10_148,r_85_133_140,r_74_34_43,r_85_133_140,0.81,9,149,140,88
93,seq117,r_68_86_59,r_91_17_45,r_91_17_45,0.88,1,46,45,88
19,r_95_54_21,r_97_79_150,seq8,r_97_79_150,0.55,-124,26,150,88
2,r_99_7_53,r_48_94_193,seq55,r_99_7_53,1.0,0,53,53,88
17,r_124_64_158,seq101,seq14,r_124_64_158,0.75,0,158,158,88
22,r_0_76_129,seq66,seq47,r_0_76_129,0.98,1,130,129,88
28,r_33_42_154,seq102,seq22,r_33_42_154,0.72,1,155,154,88
10,r_120_78_37,seq101,r_36_128_118,r_120_78_37,1.0,0,37,37,88
7,r_98_106_151,seq21,r_120_78_37,r_98_106_151,0.89,0,151,151,88
18,r_44_3_9,r_116_37_194,r_81_114_55,r_116_37_194,0.45,-5,189,194,88
23,r_20_2_12,r_5_43_189,r_85_133_140,r_20_2_12,0.43,132,144,12,88
1,r_92_53_20,r_138_104_97,seq118,r_92_53_20,1.0,0,20,20,88
6,r_40_44_22,r_5_30_88,seq29,r_40_44_22,1.0,0,22,22,89
36,r_37_46_150,seq111,seq59,r_37_46_150,0.97,0,150,150,89
14,r_42_91_108,seq38,seq29,r_42_91_108,0.99,1,109,108,89
53,seq22,r_5_30_88,r_124_69_94,r_124_69_94,1.0,15,109,94,89
83,seq85,r_124_69_94,seq82,r_124_69_94,1.0,-16,78,94,89
19,r_95_110_19,r_52_131_129,seq72,r_52_131_129,0.94,1,130,129,89
39,r_133_67_113,seq39,r_93_70_9,r_133_67_113,0.98,7,120,113,89
97,seq114,r_97_43_190,r_58_75_47,r_58_75_47,1.0,14,61,47,89
69,seq59,r_117_24_164,r_37_46_150,r_37_46_150,0.47,14,164,150,89
76,seq76,r_42_91_108,r_101_126_145,r_101_126_145,0.34,-75,70,145,89
31,r_117_24_164,seq59,r_63_118_30,r_117_24_164,0.55,0,164,164,89
10,r_92_36_122,seq32,seq102,r_92_36_122,1.0,0,122,122,89
26,r_26_1_72,seq22,seq39,r_26_1_72,1.0,1,73,72,89
4,r_113_48_86,seq104,seq89,r_113_48_86,1.0,3,89,86,89
0,r_73_55_93,seq15,seq56,r_73_55_93,0.92,0,93,93,89
20,r_16_34_136,seq12,r_52_131_129,r_16_34_136,0.71,2,138,136,89
15,r_10_135_141,seq111,r_124_69_94,r_10_135_141,0.9,2,143,141,89
13,r_103_20_37,seq123,seq33,r_103_20_37,1.0,0,37,37,89
0,r_73_55_93,seq56,r_101_126_145,r_101_126_145,0.99,1,146,145,89
1,r_99_53_54,seq78,seq112,r_99_53_54,1.0,0,54,54,89
19,r_95_110_19,r_98_137_58,r_52_131_129,r_95_110_19,0.99,-1,18,19,89
21,r_19_116_11,r_31_127_196,r_17_66_191,r_19_116_11,0.81,1,12,11,89
5,r_52_131_129,r_95_110_19,seq77,r_52_131_129,0.98,1,130,129,89
59,seq33,seq86,r_103_20_37,r_103_20_37,1.0,10,47,37,89
24,r_121_88_38,r_10_135_141,seq114,r_121_88_38,0.93,0,38,38,89
25,r_63_118_30,r_101_126_145,r_21_54_49,r_63_118_30,0.59,58,88,30,89
25,r_63_118_30,r_99_53_54,r_101_126_145,r_63_118_30,0.98,1,31,30,89
96,seq112,r_65_107_149,r_99_53_54,r_99_53_54,0.84,0,54,54,89
33,r_124_69_94,seq85,seq22,r_124_69_94,1.0,2,96,94,89
30,r_21_54_49,seq27,r_63_118_30,r_21_54_49,1.0,0,49,49,89
27,r_58_75_47,r_13_68_148,r_121_88_38,r_58_75_47,1.0,2,49,47,89
24,r_121_88_38,seq114,r_58_75_47,r_58_75_47,0.96,9,56,47,89
32,r_83_45_188,seq7,seq9,r_83_45_188,0.46,0,188,188,89
38,r_65_107_149,seq138,r_52_131_129,r_65_107_149,0.96,1,150,149,89
77,seq77,r_125_28_192,r_52_131_129,r_52_131_129,0.82,36,165,129,89
22,r_130_120_13,seq77,seq104,r_130_120_13,0.96,1,14,13,89
37,r_98_137_58,r_51_122_165,seq32,r_98_137_58,1.0,0,58,58,89
5,r_52_131_129,r_84_11_117,r_95_110_19,r_95_110_19,1.0,-1,18,19,89
17,r_5_30_88,seq22,r_103_20_37,r_103_20_37,1.0,53,90,37,89
9,r_17_66_191,r_42_91_108,r_19_116_11,r_42_91_108,0.89,-47,61,108,89
28,r_84_11_117,r_52_131_129,seq79,r_84_11_117,0.53,0,117,117,89
23,r_51_122_165,seq39,r_99_53_54,r_51_122_165,0.72,0,165,165,89
14,r_46_26_61,r_65_89_197,r_50_128_21,r_46_26_61,1.0,0,61,61,90
21,r_113_102_133,seq33,r_30_17_35,r_113_102_133,0.44,3,136,133,90
39,r_7_86_168,seq20,r_21_135_78,r_7_86_168,0.72,0,168,168,90
5,r_44_80_186,seq71,r_39_15_136,r_44_80_186,0.57,0,186,186,90
42,seq132,r_44_80_186,r_59_84_96,r_59_84_96,1.0,13,109,96,90
6,r_126_139_49,seq103,seq64,r_126_139_49,1.0,0,49,49,90
1,r_127_99_36,seq42,seq49,r_127_99_36,1.0,0,36,36,90
37,r_50_128_21,r_74_41_84,seq13,r_50_128_21,0.93,0,21,21,90
76,seq73,r_118_107_143,seq45,r_118_107_143,0.52,14,157,143,90
31,r_74_41_84,seq45,seq49,r_74_41_84,0.8,1,85,84,90
7,r_111_119_22,r_118_107_143,seq9,r_111_119_22,1.0,0,22,22,90
26,r_94_67_68,r_74_41_84,seq131,r_94_67_68,0.71,0,68,68,90
8,r_136_2_154,r_30_17_35,seq55,r_136_2_154,0.85,0,154,154,90
20,r_90_19_46,r_114_95_124,r_47_11_25,r_114_95_124,0.69,-75,49,124,90
0,r_114_95_124,seq36,seq33,r_114_95_124,0.98,0,124,124,90
11,r_35_110_114,r_65_89_197,seq66,r_35_110_114,0.44,2,116,114,90
10,r_6_138_28,r_38_27_100,r_47_11_25,r_6_138_28,1.0,0,28,28,90
15,r_117_75_75,seq69,seq43,r_117_75_75,1.0,0,75,75,90
48,seq13,seq115,r_46_26_61,r_46_26_61,1.0,56,117,61,90
19,r_22_130_29,seq82,r_32_61_87,r_22_130_29,0.94,0,29,29,90
59,seq43,r_122_52_177,r_117_75_75,r_117_75_75,0.63,0,75,75,90
8,r_136_2_154,seq49,r_30_17_35,r_30_17_35,1.0,10,45,35,90
27,r_39_15_136,seq25,r_108_81_89,r_108_81_89,0.99,50,139,89,90
34,r_8_121_132,r_57_34_26,r_22_130_29,r_22_130_29,0.93,4,33,29,90
80,seq82,seq96,r_124_78_5,r_124_78_5,0.71,32,37,5,90
18,r_116_31_73,r_7_86_168,seq123,r_7_86_168,0.7,-94,74,168,90
29,r_3_29_179,seq60,r_22_130_29,r_22_130_29,0.81,151,180,29,90
24,r_59_84_96,r_65_89_197,seq132,r_59_84_96,1.0,0,96,96,90
34,r_8_121_132,r_22_130_29,seq24,r_8_121_132,1.0,0,132,132,90
25,r_18_10_106,r_113_102_133,seq70,r_18_10_106,1.0,0,106,106,90
33,r_23_1_67,seq49,r_68_63_187,r_23_1_67,0.99,0,67,67,90
32,r_40_12_72,seq49,seq16,r_40_12_72,0.6,22,94,72,90
38,r_108_81_89,r_113_102_133,r_3_29_179,r_108_81_89,0.83,0,89,89,90
28,r_30_17_35,r_116_31_73,r_136_2_154,r_30_17_35,1.0,0,35,35,90
47,seq9,seq77,r_111_119_22,r_111_119_22,1.0,5,27,22,90
38,r_108_81_89,r_3_29_179,r_39_15_136,r_108_81_89,0.7,46,135,89,90
60,seq45,r_74_41_84,r_91_98_82,r_91_98_82,0.94,3,85,82,90
17,r_91_98_82,seq36,seq45,r_91_98_82,1.0,0,82,82,90
94,seq109,r_65_89_197,r_39_15_136,r_39_15_136,0.6,-4,132,136,90
9,r_122_52_177,seq131,r_117_75_75,r_117_75_75,0.93,102,177,75,90
28,r_30_17_35,r_136_2_154,r_113_102_133,r_30_17_35,0.8,119,154,35,90
49,seq14,r_48_101_99,seq79,r_48_101_99,0.76,0,99,99,90
23,r_32_61_87,r_39_15_136,r_22_130_29,r_32_61_87,0.85,7,94,87,90
12,r_48_101_99,seq14,seq100,r_48_101_99,0.82,0,99,99,90
4,r_47_11_25,seq62,r_6_138_28,r_47_11_25,0.77,12,37,25,90
30,r_71_58_175,seq101,r_126_21_89,r_71_58_175,0.72,0,175,175,91
36,r_129_47_76,r_26_69_129,seq92,r_129_47_76,1.0,0,76,76,91
2,r_39_32_15,r_31_110_178,seq109,r_39_32_15,1.0,0,15,15,91
92,seq103,seq22,r_37_115_142,r_37_115_142,1.0,0,142,142,91
26,r_90_130_13,r_66_38_50,seq17,r_90_130_13,1.0,0,13,13,91
21,r_61_114_111,r_45_136_23,r_27_29_10,r_61_114_111,0.94,0,111,111,91
39,r_67_111_186,seq4,r_126_21_89,r_67_111_186,0.4,0,186,186,91
1,r_99_51_162,seq86,seq76,r_99_51_162,0.84,1,163,162,91
5,r_116_96_155,r_9_88_189,seq95,r_116_96_155,0.88,0,155,155,91
45,seq8,seq95,r_128_50_122,r_128_50_122,1.0,17,139,122,91
6,r_27_29_10,r_56_73_43,r_31_110_178,r_31_110_178,0.99,-168,10,178,91
95,seq109,r_18_74_94,r_39_32_15,r_39_32_15,0.93,88,103,15,91
38,r_82_104_35,seq83,seq43,r_82_104_35,0.88,0,35,35,91
55,seq23,r_36_122_150,r_28_72_152,r_28_72_152,0.75,2,154,152,91
41,seq4,r_67_111_186,seq48,r_67_111_186,0.39,0,186,186,91
3,r_25_98_75,seq101,r_90_130_13,r_25_98_75,0.87,0,75,75,91
10,r_0_121_101,seq41,r_126_21_89,r_0_121_101,0.98,-4,97,101,91
8,r_26_69_129,r_129_47_76,seq127,r_129_47_76,1.0,-21,55,76,91
8,r_26_69_129,seq127,r_25_98_75,r_26_69_129,0.99,3,132,129,91
4,r_10_2_63,seq14,seq76,r_10_2_63,1.0,0,63,63,91
0,r_126_21_89,r_18_74_94,r_124_35_55,r_124_35_55,0.98,32,87,55,91
20,r_53_120_130,seq48,seq83,r_53_120_130,0.56,1,131,130,91
85,seq86,r_99_51_162,r_18_74_94,r_99_51_162,1.0,1,163,162,91
99,seq127,r_26_69_129,r_119_87_1,r_26_69_129,0.97,3,132,129,91
27,r_37_115_142,seq94,seq103,r_37_115_142,0.82,0,142,142,91
87,seq92,seq22,r_129_47_76,r_129_47_76,1.0,18,94,76,91
18,r_131_123_134,r_60_19_154,r_90_130_13,r_90_130_13,0.67,121,134,13,91
29,r_1_89_182,seq11,r_129_47_76,r_129_47_76,0.72,106,182,76,91
25,r_128_50_122,seq43,seq8,r_128_50_122,0.78,0,122,122,91
88,seq94,r_37_115_142,seq42,r_37_115_142,0.9,0,142,142,91
50,seq14,seq65,r_15_3_112,r_15_3_112,1.0,10,122,112,91
24,r_118_33_51,seq75,seq65,r_118_33_51,0.97,0,51,51,91
34,r_15_3_112,r_28_72_152,seq14,r_15_3_112,1.0,0,112,112,91
14,r_31_110_178,r_39_32_15,r_27_29_10,r_31_110_178,1.0,-166,12,178,91
28,r_28_72_152,seq34,seq23,r_28_72_152,0.93,1,153,152,91
91,seq101,r_71_58_175,seq4,r_71_58_175,0.92,1,176,175,91
23,r_49_100_69,seq132,r_66_38_50,r_49_100_69,1.0,0,69,69,91
17,r_56_73_43,seq22,r_66_38_50,r_56_73_43,0.48,67,110,43,91
60,seq134,r_66_38_50,seq52,r_66_38_50,1.0,-9,41,50,91
35,r_60_19_154,r_131_123_134,r_57_138_153,r_131_123_134,0.81,0,134,134,91
16,r_66_38_50,seq134,r_56_73_43,r_66_38_50,1.0,-1,49,50,91
12,r_93_107_84,seq13,seq139,r_93_107_84,0.96,2,86,84,91
17,r_56_73_43,seq113,seq22,r_56_73_43,1.0,-1,42,43,91
30,r_104_135_91,seq127,r_125_97_32,r_104_135_91,1.0,0,91,91,92
36,r_89_45_159,r_51_61_119,r_132_1_17,r_89_45_159,0.75,0,159,159,92
32,r_79_70_46,r_88_124_90,seq84,r_79_70_46,1.0,0,46,46,92
14,r_137_130_128,seq24,seq32,r_137_130_128,0.62,0,128,128,92
37,r_23_133_95,seq129,seq49,r_23_133_95,0.91,0,95,95,92
59,seq28,r_131_77_168,r_88_124_90,r_131_77_168,0.65,1,169,168,92
21,r_42_36_65,seq27,r_138_69_20,r_42_36_65,0.81,2,67,65,92
39,r_16_122_170,r_41_17_198,r_110_56_88,r_16_122_170,0.83,1,171,170,92
1,r_40_12_133,r_89_45_159,seq91,r_40_12_133,0.87,0,133,133,92
5,r_10_83_161,seq25,seq5,r_10_83_161,0.69,-9,152,161,92
19,r_108_99_103,r_8_11_64,seq136,r_8_11_64,0.93,12,76,64,92
66,seq39,r_76_72_185,r_101_105_67,r_101_105_67,1.0,28,95,67,92
41,seq129,r_23_133_95,seq82,r_23_133_95,1.0,3,98,95,92
3,r_113_62_116,seq91,seq27,r_113_62_116,0.96,0,116,116,92
90,seq103,seq37,r_8_11_64,r_8_11_64,0.97,39,103,64,92
26,r_41_17_198,r_16_122_170,r_40_12_133,r_40_12_133,0.96,38,171,133,92
13,r_138_69_20,r_8_11_64,r_59_118_101,r_138_69_20,0.88,5,25,20,92
4,r_8_11_64,r_108_99_103,seq103,r_108_99_103,0.81,-35,68,103,92
0,r_125_97_32,r_92_44_121,r_104_135_91,r_104_135_91,0.81,32,123,91,92
28,r_59_118_101,r_65_119_187,r_138_69_20,r_138_69_20,0.8,5,25,20,92
15,r_51_61_119,r_89_45_159,seq33,r_89_45_159,1.0,-36,123,159,92
2,r_114_86_40,r_117_100_181,r_31_50_4,r_114_86_40,1.0,0,40,40,92
57,seq25,r_10_83_161,r_113_62_116,r_113_62_116,0.88,20,136,116,92
33,r_85_43_73,seq53,r_59_118_101,r_59_118_101,0.93,24,125,101,92
13,r_138_69_20,r_59_118_101,r_42_36_65,r_138_69_20,0.84,81,101,20,92
22,r_132_1_17,r_88_124_90,r_76_72_185,r_132_1_17,0.73,5,22,17,92
40,seq0,r_93_6_131,seq98,r_93_6_131,0.68,47,178,131,92
85,seq91,r_113_62_116,seq52,r_113_62_116,1.0,0,116,116,92
27,r_92_44_121,r_125_97_32,r_46_54_98,r_46_54_98,0.93,25,123,98,92
22,r_132_1_17,r_76_72_185,r_89_45_159,r_89_45_159,0.86,10,169,159,92
74,seq60,r_26_73_132,r_108_99_103,r_108_99_103,0.95,29,132,103,92
29,r_93_6_131,seq116,seq5,r_93_6_131,0.75,1,132,131,92
24,r_131_77_168,seq28,seq60,r_131_77_168,0.63,1,169,168,92
33,r_85_43_73,r_137_130_128,seq53,r_85_43_73,0.99,1,74,73,92
19,r_108_99_103,seq136,seq60,r_108_99_103,0.97,0,103,103,92
38,r_26_73_132,seq60,seq15,r_26_73_132,0.57,0,132,132,92
60,seq30,seq37,r_79_70_46,r_79_70_46,1.0,77,123,46,92
17,r_117_100_181,seq55,r_114_86_40,r_114_86_40,1.0,141,181,40,92
25,r_31_50_4,r_8_11_64,r_114_86_40,r_31_50_4,0.73,64,68,4,92
9,r_46_54_98,seq126,seq96,r_46_54_98,1.0,0,98,98,92
28,r_59_118_101,r_138_69_20,r_85_43_73,r_85_43_73,0.83,28,101,73,92
91,seq107,r_26_73_132,r_108_99_103,r_108_99_103,0.96,29,132,103,92
7,r_78_21_109,seq53,seq126,r_78_21_109,0.97,0,109,109,92
23,r_7_109_177,r_117_100_181,seq116,r_117_100_181,0.46,-4,177,181,92
35,r_101_105_67,seq37,seq39,r_101_105_67,1.0,0,67,67,92
83,seq84,seq22,r_79_70_46,r_79_70_46,1.0,12,58,46,92
30,r_81_94_63,r_63_60_172,seq61,r_81_94_63,1.0,0,63,63,93
9,r_89_124_12,r_34_30_56,r_64_130_185,r_89_124_12,1.0,0,12,12,93
36,r_44_133_174,seq101,r_120_22_158,r_44_133_174,0.56,0,174,174,93
9,r_89_124_12,r_64_130_185,r_12_82_130,r_12_82_130,1.0,38,168,130,93
59,seq129,seq83,r_119_113_91,r_119_113_91,0.99,-2,89,91,93
86,seq97,r_63_60_172,r_58_19_94,r_58_19_94,0.88,61,155,94,93
1,r_58_19_94,r_51_132_149,r_28_62_17,r_28_62_17,0.5,78,95,17,93
96,seq123,r_49_65_93,r_14_121_7,r_49_65_93,0.7,-61,32,93,93
62,seq46,r_108_2_29,r_138_50_73,r_108_2_29,0.99,1,30,29,93
19,r_5_35_168,seq131,r_48_59_41,r_5_35_168,0.88,0,168,168,93
40,seq0,r_34_30_56,seq88,r_34_30_56,1.0,0,56,56,93
66,seq61,seq135,r_81_94_63,r_81_94_63,0.99,2,65,63,93
16,r_55_39_30,r_98_9_181,seq91,r_55_39_30,0.92,0,30,30,93
41,seq1,r_138_50_73,r_80_40_103,r_80_40_103,1.0,3,106,103,93
14,r_34_30_56,seq0,r_14_121_7,r_34_30_56,0.94,0,56,56,93
3,r_98_9_181,seq31,r_54_122_38,r_98_9_181,0.44,1,182,181,93
10,r_3_136_111,seq96,r_115_85_142,r_3_136_111,0.97,0,111,111,93
26,r_8_18_109,r_119_113_91,r_47_74_154,r_119_113_91,0.96,0,91,91,93
55,seq32,r_71_10_52,seq46,r_71_10_52,0.87,6,58,52,93
4,r_26_70_106,seq66,r_8_18_109,r_26_70_106,0.64,3,109,106,93
0,r_12_82_130,r_120_22_158,r_89_124_12,r_12_82_130,0.99,1,131,130,93
39,r_4_67_45,seq128,seq53,r_4_67_45,1.0,0,45,45,93
73,seq75,seq69,r_119_113_91,r_119_113_91,0.94,85,176,91,93
11,r_43_109_99,seq27,seq52,r_43_109_99,0.95,0,99,99,93
20,r_23_84_134,seq107,r_138_50_73,r_23_84_134,0.95,0,134,134,93
48,seq16,seq78,r_28_62_17,r_28_62_17,0.98,52,69,17,93
21,r_64_130_185,r_89_124_12,r_81_94_63,r_89_124_12,0.44,173,185,12,93
6,r_108_2_29,seq46,seq131,r_108_2_29,1.0,0,29,29,93
2,r_63_60_172,seq69,seq7,r_63_60_172,0.53,0,172,172,93
29,r_120_22_158,seq17,r_80_40_103,r_80_40_103,0.93,56,159,103,93
17,r_28_62_17,r_105_111_190,seq16,r_28_62_17,1.0,0,17,17,93
25,r_25_137_143,seq37,r_99_100_199,r_25_137_143,0.83,0,143,143,93
13,r_33_13_20,seq20,seq37,r_33_13_20,1.0,0,20,20,93
32,r_80_40_103,seq102,seq1,r_80_40_103,0.97,0,103,103,93
38,r_86_106_117,r_99_100_199,r_26_70_106,r_26_70_106,0.38,1,107,106,93
52,seq24,seq83,r_119_113_91,r_119_113_91,0.96,46,137,91,93
34,r_51_132_149,seq87,seq78,r_51_132_149,0.77,0,149,149,93
21,r_64_130_185,r_48_59_41,r_89_124_12,r_89_124_12,0.91,29,41,12,93
35,r_48_59_41,r_64_130_185,seq107,r_64_130_185,0.79,-144,41,185,93
5,r_54_122_38,seq6,seq46,r_54_122_38,0.95,0,38,38,93
15,r_71_10_52,seq32,seq125,r_71_10_52,0.88,2,54,52,93
38,r_86_106_117,r_26_70_106,seq1,r_26_70_106,0.87,12,118,106,93
26,r_8_18_109,r_47_74_154,r_26_70_106,r_8_18_109,0.95,0,109,109,93
22,r_103_45_98,seq6,seq76,r_103_45_98,0.88,1,99,98,93
28,r_119_113_91,r_8_18_109,seq6,r_119_113_91,0.86,0,91,91,93
49,seq17,r_120_22_158,seq125,r_120_22_158,0.6,1,159,158,93
56,seq36,r_105_111_190,seq42,r_105_111_190,0.5,0,190,190,93
7,r_49_65_93,seq123,seq11,r_49_65_93,1.0,0,93,93,93
12,r_99_100_199,seq102,r_25_137_143,r_25_137_143,0.92,3,146,143,93
30,r_22_42_177,seq43,r_86_104_43,r_86_104_43,0.92,134,177,43,94
36,r_40_4_93,r_102_34_71,seq64,r_40_4_93,0.99,0,93,93,94
8,r_131_138_63,seq134,seq80,r_131_138_63,0.93,4,67,63,94
37,r_98_23_161,seq87,seq122,r_98_23_161,0.94,0,161,161,94
16,r_85_108_131,r_54_36_136,r_133_84_133,r_85_108_131,0.88,0,131,131,94
39,r_6_95_91,r_102_34_71,seq107,r_6_95_91,0.99,0,91,91,94
25,r_16_24_16,r_66_53_98,seq122,r_16_24_16,0.88,0,16,16,94
32,r_110_117_15,r_66_53_98,r_86_104_43,r_110_117_15,0.95,83,98,15,94
77,seq77,r_65_8_120,r_126_44_13,r_126_44_13,1.0,1,14,13,94
3,r_133_84_133,seq33,r_85_108_131,r_85_108_131,0.52,11,142,131,94
10,r_55_79_85,r_85_108_131,r_82_75_92,r_55_79_85,1.0,2,87,85,94
26,r_137_103_117,seq39,r_113_67_20,r_137_103_117,0.98,0,117,117,94
14,r_26_94_12,r_32_59_130,seq89,r_32_59_130,0.68,2,132,130,94
4,r_49_41_26,r_12_74_148,seq43,r_12_74_148,1.0,-76,72,148,94
0,r_82_75_92,r_73_58_184,r_55_79_85,r_55_79_85,1.0,6,91,85,94
5,r_93_63_35,r_133_84_133,r_47_121_135,r_93_63_35,1.0,0,35,35,94
11,r_65_8_120,seq77,seq5,r_65_8_120,0.58,5,125,120,94
98,seq123,r_96_120_149,r_86_104_43,r_86_104_43,0.87,105,148,43,94
15,r_9_71_69,r_11_2_99,r_86_104_43,r_9_71_69,0.97,0,69,69,94
57,seq31,seq60,r_12_74_148,r_12_74_148,1.0,6,154,148,94
6,r_12_74_148,seq46,seq31,r_12_74_148,0.99,0,148,148,94
99,seq127,seq14,r_66_53_98,r_66_53_98,1.0,18,116,98,94
32,r_110_117_15,seq76,r_66_53_98,r_110_117_15,0.96,0,15,15,94
27,r_54_36_136,seq19,r_49_41_26,r_54_36_136,0.99,0,136,136,94
2,r_10_90_80,r_105_88_145,r_86_104_43,r_86_104_43,0.53,21,64,43,94
40,seq0,seq134,r_126_44_13,r_126_44_13,0.9,126,139,13,94
29,r_35_18_46,r_49_41_26,seq50,r_35_18_46,1.0,1,47,46,94
24,r_66_53_98,seq57,seq107,r_66_53_98,0.99,0,98,98,94
33,r_72_17_90,seq61,r_16_24_16,r_72_17_90,0.95,-1,89,90,94
64,seq46,r_12_74_148,seq43,r_12_74_148,0.99,0,148,148,94
58,seq33,r_133_84_133,seq114,r_133_84_133,0.93,9,142,133,94
70,seq60,seq45,r_13_111_109,r_13_111_109,0.99,2,111,109,94
72,seq62,seq101,r_86_104_43,r_86_104_43,1.0,10,53,43,94
38,r_13_111_109,r_47_121_135,seq60,r_13_111_109,0.72,10,119,109,94
1,r_86_104_43,r_137_103_117,r_136_78_169,r_136_78_169,0.85,-126,43,169,94
14,r_26_94_12,r_131_138_63,r_32_59_130,r_26_94_12,0.69,0,12,12,94
81,seq89,r_11_2_99,seq122,r_11_2_99,1.0,0,99,99,94
7,r_139_27_171,r_133_84_133,seq30,r_139_27_171,0.92,0,171,171,94
9,r_96_120_149,seq123,r_72_17_90,r_96_120_149,0.77,0,149,149,94
31,r_32_59_130,r_26_94_12,seq5,r_26_94_12,0.69,120,132,12,94
22,r_129_28_30,r_73_58_184,r_35_18_46,r_35_18_46,1.0,138,184,46,94
28,r_105_88_145,r_139_27_171,seq50,r_105_88_145,0.91,1,146,145,94
56,seq30,seq46,r_139_27_171,r_139_27_171,0.72,9,180,171,94
7,r_139_27_171,r_105_88_145,r_133_84_133,r_105_88_145,0.74,1,146,145,94
31,r_32_59_130,r_86_104_43,r_26_94_12,r_86_104_43,0.74,-31,12,43,94
23,r_11_2_99,seq89,seq20,r_11_2_99,0.99,0,99,99,94
35,r_68_125_164,r_49_41_26,r_11_2_99,r_68_125_164,0.57,1,165,164,94
12,r_113_67_20,r_133_84_133,r_137_103_117,r_137_103_117,1.0,4,121,117,94
19,r_41_131_187,seq46,r_133_74_44,r_133_74_44,1.0,-1,43,44,95
20,r_99_66_45,seq16,seq18,r_99_66_45,0.89,-8,37,45,95
36,r_64_102_131,r_41_131_187,seq127,r_64_102_131,0.64,0,131,131,95
39,r_112_137_66,r_56_62_88,seq128,r_112_137_66,0.77,22,88,66,95
14,r_130_81_170,r_58_119_115,r_47_10_144,r_58_119_115,1.0,1,116,115,95
37,r_6_92_96,r_63_138_188,r_25_76_159,r_63_138_188,0.81,-92,96,188,95
19,r_41_131_187,r_133_74_44,seq22,r_133_74_44,0.26,145,189,44,95
16,r_5_21_158,r_57_100_2,r_108_50_81,r_5_21_158,0.88,0,158,158,95
21,r_70_28_136,seq30,r_14_101_51,r_70_28_136,0.99,0,136,136,95
39,r_112_137_66,r_79_124_148,r_56_62_88,r_112_137_66,0.96,2,68,66,95
1,r_40_27_37,r_80_3_181,r_111_123_58,r_80_3_181,0.55,4,185,181,95
31,r_61_121_182,seq113,r_23_107_123,r_23_107_123,0.99,59,182,123,95
41,seq1,r_108_50_81,seq135,r_108_50_81,0.73,1,82,81,95
30,r_80_3_181,r_69_96_119,r_40_27_37,r_80_3_181,0.91,-148,33,181,95
1,r_40_27_37,seq12,r_80_3_181,r_80_3_181,0.6,-148,33,181,95
10,r_58_119_115,r_130_81_170,seq129,r_58_119_115,0.97,1,116,115,95
90,seq113,r_61_121_182,r_58_119_115,r_58_119_115,0.86,67,182,115,95
17,r_85_71_12,r_79_124_148,r_55_0_133,r_85_71_12,0.92,0,12,12,95
4,r_125_32_186,seq51,r_63_138_188,r_125_32_186,0.46,-112,74,186,95
0,r_11_7_128,seq114,seq60,r_11_7_128,0.54,7,135,128,95
34,r_34_89_29,r_108_50_81,seq52,r_34_89_29,0.98,1,30,29,95
15,r_63_138_188,seq35,r_25_76_159,r_25_76_159,0.92,29,188,159,95
8,r_14_101_51,seq26,seq83,r_14_101_51,1.0,0,51,51,95
4,r_125_32_186,r_63_138_188,r_65_75_139,r_125_32_186,0.53,-30,156,186,95
2,r_77_49_31,r_41_131_187,r_133_74_44,r_133_74_44,0.61,145,189,44,95
67,seq52,r_19_78_86,r_34_89_29,r_34_89_29,0.81,18,47,29,95
3,r_111_123_58,seq139,seq31,r_111_123_58,0.94,-1,57,58,95
23,r_55_0_133,r_70_28_136,r_85_71_12,r_85_71_12,1.0,0,12,12,95
27,r_25_76_159,seq15,r_6_92_96,r_6_92_96,0.78,63,159,96,95
30,r_80_3_181,r_40_27_37,seq51,r_40_27_37,0.3,148,185,37,95
41,seq1,seq135,r_69_96_119,r_69_96_119,0.94,42,161,119,95
74,seq73,seq113,r_44_103_76,r_44_103_76,1.0,31,107,76,95
18,r_69_96_119,r_80_3_181,seq1,r_69_96_119,0.98,0,119,119,95
29,r_19_78_86,seq52,seq16,r_19_78_86,0.58,0,86,86,95
24,r_56_62_88,seq110,r_112_137_66,r_112_137_66,0.87,1,67,66,95
25,r_33_17_70,r_80_3_181,seq1,r_33_17_70,1.0,-1,69,70,95
33,r_44_103_76,r_47_10_144,seq73,r_44_103_76,1.0,0,76,76,95
64,seq46,r_41_131_187,r_77_49_31,r_77_49_31,0.8,104,135,31,95
50,seq15,r_25_76_159,seq67,r_25_76_159,0.99,0,159,159,95
58,seq35,r_63_138_188,r_23_107_123,r_23_107_123,1.0,65,188,123,95
24,r_56_62_88,r_112_137_66,seq26,r_56_62_88,1.0,0,88,88,95
32,r_109_106_87,seq20,seq43,r_109_106_87,0.69,10,97,87,95
2,r_77_49_31,r_133_74_44,r_41_131_187,r_41_131_187,1.0,-156,31,187,95
9,r_23_107_123,seq110,seq53,r_23_107_123,0.94,0,123,123,95
22,r_4_24_161,seq60,r_77_49_31,r_4_24_161,0.54,-7,154,161,95
28,r_79_124_148,seq22,r_64_102_131,r_79_124_148,0.65,5,153,148,95
17,r_85_71_12,r_55_0_133,seq30,r_55_0_133,1.0,0,133,133,95
60,seq37,r_79_124_148,r_58_119_115,r_79_124_148,0.95,-3,145,148,95
35,r_108_50_81,seq1,seq82,r_108_50_81,1.0,1,82,81,95
12,r_88_8_124,r_47_10_144,seq45,r_88_8_124,0.89,1,125,124,95
23,r_55_0_133,r_85_71_12,seq120,r_55_0_133,1.0,0,133,133,95
30,r_84_4_71,seq104,r_119_16_53,r_119_16_53,0.92,17,70,53,96
8,r_27_19_79,seq89,seq92,r_27_19_79,1.0,0,79,79,96
55,seq35,seq123,r_38_5_130,r_38_5_130,0.67,-11,119,130,96
16,r_86_129_73,seq123,r_134_61_3,r_86_129_73,0.87,0,73,73,96
21,r_139_12_170,seq47,r_133_125_50,r_139_12_170,0.43,1,171,170,96
5,r_136_20_5,r_132_10_183,r_24_50_155,r_24_50_155,0.55,30,185,155,96
29,r_39_65_32,seq135,seq102,r_39_65_32,0.98,0,32,32,96
6,r_133_125_50,seq31,seq138,r_133_125_50,0.95,6,56,50,96
63,seq54,r_119_16_53,r_22_7_13,r_119_16_53,0.75,-12,41,53,96
45,seq138,r_1_105_91,r_133_125_50,r_1_105_91,0.76,-14,77,91,96
19,r_121_117_120,r_112_127_152,seq37,r_121_117_120,0.86,1,121,120,96
36,r_103_49_55,r_34_62_185,r_1_105_91,r_1_105_91,1.0,6,97,91,96
31,r_132_10_183,r_34_62_185,r_136_20_5,r_34_62_185,0.68,-112,73,185,96
69,seq68,r_14_66_192,r_72_23_9,r_72_23_9,0.95,3,12,9,96
3,r_40_32_8,r_86_129_73,seq29,r_86_129_73,0.68,4,77,73,96
20,r_1_105_91,seq138,r_103_49_55,r_1_105_91,1.0,0,91,91,96
15,r_110_95_61,r_139_12_170,seq31,r_110_95_61,0.98,0,61,61,96
12,r_34_62_185,r_103_49_55,r_121_117_120,r_34_62_185,0.3,0,185,185,96
97,seq123,seq83,r_33_17_45,r_33_17_45,1.0,14,59,45,96
13,r_90_107_36,r_132_10_183,seq31,r_90_107_36,1.0,0,36,36,96
39,r_55_87_41,seq104,seq57,r_55_87_41,0.99,0,41,41,96
91,seq113,seq124,r_81_70_48,r_81_70_48,1.0,6,54,48,96
2,r_130_59_139,seq29,seq88,r_130_59_139,0.93,0,139,139,96
18,r_24_50_155,seq21,r_103_49_55,r_24_50_155,0.75,3,158,155,96
25,r_69_63_162,seq108,r_55_87_41,r_69_63_162,0.59,0,162,162,96
27,r_81_70_48,seq31,seq113,r_81_70_48,1.0,1,49,48,96
76,seq83,seq123,r_131_41_42,r_131_41_42,1.0,0,42,42,96
65,seq57,r_44_94_127,r_55_87_41,r_55_87_41,1.0,51,92,41,96
37,r_131_41_42,r_119_16_53,seq83,r_131_41_42,1.0,0,42,42,96
12,r_34_62_185,r_132_10_183,r_103_49_55,r_34_62_185,0.51,-141,44,185,96
34,r_45_137_134,seq6,r_90_107_36,r_45_137_134,0.62,0,134,134,96
38,r_79_73_22,r_134_61_3,seq37,r_79_73_22,0.91,1,23,22,96
81,seq92,seq124,r_27_19_79,r_27_19_79,1.0,9,88,79,96
17,r_2_0_109,r_78_120_66,r_22_7_13,r_78_120_66,0.89,-1,65,66,96
31,r_132_10_183,r_136_20_5,r_40_32_8,r_132_10_183,0.35,0,183,183,96
28,r_51_64_59,seq122,seq6,r_51_64_59,0.98,1,60,59,96
14,r_22_7_13,r_14_66_192,seq54,r_14_66_192,0.7,-179,13,192,96
49,seq18,seq48,r_44_94_127,r_44_94_127,0.41,26,153,127,96
0,r_119_16_53,seq67,r_134_61_3,r_119_16_53,1.0,0,53,53,96
23,r_78_120_66,r_2_0_109,seq3,r_78_120_66,1.0,-1,65,66,96
35,r_25_42_145,r_98_111_187,seq76,r_25_42_145,0.73,0,145,145,96
7,r_33_17_45,r_24_50_155,seq123,r_33_17_45,0.98,0,45,45,96
30,r_12_137_90,seq110,r_36_53_22,r_12_137_90,0.89,0,90,90,97
18,r_52_7_59,seq46,seq129,r_52_7_59,1.0,0,59,59,97
14,r_27_10_66,r_80_21_132,seq108,r_27_10_66,1.0,0,66,66,97
37,r_90_31_70,seq133,seq46,r_90_31_70,1.0,0,70,70,97
16,r_40_85_72,seq18,seq95,r_40_85_72,0.83,14,86,72,97
1,r_123_62_93,r_58_87_156,r_139_29_6,r_123_62_93,0.94,0,93,93,97
46,seq135,r_81_104_145,r_50_79_55,r_50_79_55,0.6,40,95,55,97
7,r_94_97_57,r_114_66_173,seq133,r_94_97_57,0.97,-2,55,57,97
48,seq13,seq38,r_1_64_40,r_1_64_40,1.0,1,41,40,97
86,seq103,r_24_30_60,r_132_112_46,r_132_112_46,0.94,1,47,46,97
19,r_91_43_37,r_81_104_145,r_2_116_23,r_81_104_145,0.63,-69,76,145,97
52,seq18,r_8_102_141,r_36_53_22,r_36_53_22,1.0,0,22,22,97
21,r_2_116_23,r_23_117_41,seq127,r_2_116_23,0.54,-3,20,23,97
89,seq108,seq63,r_27_10_66,r_27_10_66,1.0,23,89,66,97
31,r_50_79_55,seq110,seq135,r_50_79_55,1.0,0,55,55,97
84,seq96,seq71,r_23_117_41,r_23_117_41,1.0,1,42,41,97
72,seq72,seq18,r_12_137_90,r_12_137_90,1.0,34,124,90,97
4,r_75_61_97,r_22_16_160,seq82,r_75_61_97,0.79,0,97,97,97
0,r_32_65_63,seq51,r_9_86_190,r_32_65_63,0.98,0,63,63,97
11,r_114_66_173,seq134,seq15,r_114_66_173,0.37,6,179,173,97
20,r_24_30_60,seq103,r_23_117_41,r_24_30_60,0.98,0,60,60,97
13,r_89_54_163,seq77,r_50_79_55,r_50_79_55,0.95,114,169,55,97
6,r_28_100_89,seq45,r_41_42_54,r_41_42_54,0.99,35,89,54,97
62,seq46,seq105,r_90_31_70,r_90_31_70,1.0,10,80,70,97
8,r_36_53_22,r_50_79_55,seq18,r_36_53_22,1.0,0,22,22,97
27,r_107_111_68,seq60,seq134,r_107_111_68,0.96,-1,67,68,97
79,seq84,r_58_87_156,r_81_104_145,r_81_104_145,0.99,4,149,145,97
22,r_139_29_6,seq133,r_123_62_93,r_123_62_93,1.0,22,115,93,97
10,r_23_117_41,r_9_86_190,seq96,r_23_117_41,0.95,0,41,41,97
12,r_1_64_40,seq82,seq13,r_1_64_40,1.0,0,40,40,97
29,r_58_87_156,r_123_62_93,seq82,r_123_62_93,1.0,0,93,93,97
24,r_101_19_186,seq128,r_75_61_97,r_75_61_97,0.93,90,187,97,97
25,r_22_16_160,seq127,r_123_62_93,r_123_62_93,1.0,69,162,93,97
64,seq51,r_32_65_63,seq119,r_32_65_63,1.0,-2,61,63,97
58,seq134,r_114_66_173,r_107_111_68,r_107_111_68,0.89,111,179,68,97
61,seq45,r_28_100_89,r_126_56_157,r_28_100_89,0.98,-4,85,89,97
28,r_41_42_54,r_9_86_190,r_1_64_40,r_41_42_54,1.0,0,54,54,97
38,r_39_138_146,r_9_86_190,seq14,r_39_138_146,0.81,1,147,146,97
36,r_132_112_46,seq84,seq103,r_132_112_46,1.0,1,47,46,97
33,r_33_48_27,r_99_120_198,seq127,r_33_48_27,1.0,0,27,27,97
79,seq84,r_132_112_46,r_58_87_156,r_132_112_46,1.0,1,47,46,97
29,r_58_87_156,seq82,r_11_130_158,r_11_130_158,0.88,2,160,158,97
35,r_57_109_45,seq6,seq68,r_57_109_45,0.58,108,153,45,97
36,r_126_53_135,seq69,r_124_78_25,r_126_53_135,0.99,0,135,135,98
14,r_14_4_82,seq122,r_54_64_38,r_14_4_82,1.0,0,82,82,98
8,r_50_77_138,seq82,r_40_104_129,r_50_77_138,0.97,0,138,138,98
53,seq17,seq30,r_120_112_56,r_120_112_56,1.0,0,56,56,98
43,seq132,r_96_12_125,seq34,r_96_12_125,0.91,-64,61,125,98
30,r_46_111_16,seq6,seq29,r_46_111_16,0.99,2,18,16,98
83,seq82,r_50_77_138,r_5_131_60,r_5_131_60,0.76,78,138,60,98
37,r_61_25_183,seq22,r_95_106_70,r_95_106_70,0.61,114,184,70,98
86,seq88,r_103_9_134,seq82,r_103_9_134,0.84,0,134,134,98
16,r_71_97_39,r_44_102_162,r_19_67_73,r_19_67_73,1.0,21,94,73,98
38,r_33_0_158,r_40_104_129,r_95_106_70,r_33_0_158,0.89,0,158,158,98
46,seq7,r_95_106_70,r_124_78_25,r_95_106_70,0.67,-1,69,70,98
42,seq3,r_37_86_140,r_41_62_196,r_37_86_140,0.52,18,158,140,98
80,seq76,r_44_102_162,r_70_85_123,r_70_85_123,0.8,39,162,123,98
19,r_57_116_137,r_100_20_185,r_70_85_123,r_57_116_137,0.97,0,137,137,98
38,r_33_0_158,r_5_131_60,r_68_27_154,r_33_0_158,0.6,-146,12,158,98
38,r_33_0_158,r_68_27_154,r_40_104_129,r_40_104_129,0.82,2,131,129,98
31,r_95_106_70,seq7,seq98,r_95_106_70,1.0,0,70,70,98
10,r_68_27_154,r_33_0_158,seq132,r_68_27_154,0.48,0,154,154,98
5,r_108_72_17,r_44_102_162,seq31,r_108_72_17,0.93,0,17,17,98
4,r_5_131_60,r_33_0_158,r_118_42_90,r_5_131_60,1.0,0,60,60,98
11,r_119_56_122,r_118_42_90,seq47,r_119_56_122,0.86,2,124,122,98
46,seq7,r_124_78_25,r_91_23_155,r_91_23_155,0.99,8,163,155,98
15,r_70_85_123,seq29,seq76,r_70_85_123,0.98,0,123,123,98
6,r_91_23_155,r_13_138_194,seq7,r_91_23_155,0.88,1,156,155,98
29,r_73_117_42,r_90_48_114,seq29,r_73_117_42,1.0,1,43,42,98
21,r_120_112_56,seq17,r_43_130_85,r_43_130_85,1.0,40,125,85,98
77,seq139,r_57_116_137,r_59_115_57,r_59_115_57,1.0,-1,56,57,98
30,r_46_111_16,seq29,r_63_2_131,r_63_2_131,1.0,2,133,131,98
24,r_124_78_25,seq21,seq10,r_124_78_25,1.0,-1,24,25,98
2,r_90_48_114,seq134,r_43_130_85,r_43_130_85,0.97,31,116,85,98
25,r_75_66_77,r_37_86_140,r_120_112_56,r_120_112_56,1.0,20,76,56,98
43,seq132,seq34,r_68_27_154,r_68_27_154,0.99,10,164,154,98
33,r_40_104_129,seq16,r_33_0_158,r_40_104_129,0.69,0,129,129,98
17,r_100_20_185,r_59_115_57,seq21,r_100_20_185,0.99,0,185,185,98
39,r_59_115_57,r_61_25_183,seq139,r_59_115_57,1.0,0,57,57,98
32,r_19_67_73,r_96_12_125,r_71_97_39,r_19_67_73,1.0,0,73,73,98
21,r_120_112_56,r_50_77_138,seq17,r_120_112_56,1.0,0,56,56,98
18,r_54_64_38,r_44_102_162,seq11,r_54_64_38,1.0,0,38,38,98
34,r_80_89_41,r_100_20_185,seq29,r_80_89_41,1.0,0,41,41,98
33,r_40_104_129,r_33_0_158,r_50_77_138,r_33_0_158,1.0,0,158,158,98
17,r_100_20_185,r_57_116_137,r_59_115_57,r_59_115_57,0.98,80,137,57,98
9,r_44_102_162,seq76,r_124_78_25,r_44_102_162,0.5,0,162,162,98
22,r_1_8_174,seq129,seq28,r_1_8_174,0.64,0,174,174,98
28,r_65_110_177,seq34,r_60_84_64,r_65_110_177,0.49,0,177,177,98
13,r_51_123_28,seq92,seq129,r_51_123_28,1.0,0,28,28,98
23,r_103_9_134,seq88,seq6,r_103_9_134,0.99,0,134,134,98
60,seq29,seq45,r_80_89_41,r_80_89_41,1.0,0,41,41,98
35,r_37_86_140,seq3,seq17,r_37_86_140,0.69,0,140,140,98
12,r_118_42_90,r_119_56_122,seq82,r_119_56_122,0.62,-15,107,122,98
30,r_93_72_144,seq99,seq25,r_93_72_144,0.66,0,144,144,99
14,r_95_122_86,seq126,r_10_15_172,r_95_122_86,0.91,7,93,86,99
8,r_66_133_75,r_79_92_88,seq20,r_66_133_75,0.98,0,75,75,99
43,seq11,seq83,r_97_3_63,r_97_3_63,1.0,16,79,63,99
37,r_103_115_117,seq69,seq24,r_103_115_117,0.68,12,129,117,99
16,r_42_94_166,seq64,r_43_44_71,r_42_94_166,0.56,1,167,166,99
21,r_79_92_88,r_75_55_70,r_38_124_171,r_75_55_70,0.79,34,104,70,99
39,r_38_124_171,seq102,r_131_120_129,r_131_120_129,0.67,42,171,129,99
21,r_79_92_88,r_38_124_171,r_30_109_141,r_38_124_171,0.47,-30,141,171,99
5,r_52_0_83,seq57,r_81_31_33,r_81_31_33,0.92,15,48,33,99
7,r_138_22_44,seq58,r_125_110_62,r_125_110_62,0.73,112,174,62,99
19,r_87_17_96,r_74_118_131,seq59,r_87_17_96,0.98,0,96,96,99
49,seq23,seq96,r_131_120_129,r_131_120_129,0.69,15,144,129,99
33,r_75_55_70,r_9_137_150,seq100,r_9_137_150,0.98,1,151,150,99
38,r_53_7_180,r_134_135_39,seq98,r_53_7_180,0.67,2,182,180,99
41,seq2,seq13,r_113_88_61,r_113_88_61,1.0,0,61,61,99
3,r_14_29_74,seq106,seq27,r_14_29_74,1.0,0,74,74,99
10,r_6_82_159,seq45,r_79_92_88,r_6_82_159,0.74,0,159,159,99
5,r_52_0_83,r_81_31_33,seq24,r_52_0_83,0.56,5,88,83,99
26,r_65_84_59,seq23,r_134_135_39,r_65_84_59,0.49,2,61,59,99
14,r_95_122_86,r_10_15_172,r_86_50_115,r_95_122_86,0.48,86,172,86,99
4,r_9_137_150,r_38_124_171,r_75_55_70,r_75_55_70,0.88,0,70,70,99
37,r_103_115_117,seq24,r_132_35_148,r_103_115_117,0.68,35,152,117,99
11,r_77_46_82,seq23,seq51,r_77_46_82,1.0,2,84,82,99
13,r_90_32_152,seq108,seq101,r_90_32_152,0.8,0,152,152,99
98,seq126,r_95_122_86,r_43_44_71,r_43_44_71,0.76,29,100,71,99
15,r_97_3_63,seq64,seq11,r_97_3_63,1.0,0,63,63,99
4,r_9_137_150,r_75_55_70,seq45,r_9_137_150,1.0,1,151,150,99
6,r_5_68_128,r_10_15_172,seq127,r_5_68_128,0.84,0,128,128,99
7,r_138_22_44,r_74_118_131,seq58,r_138_22_44,0.99,0,44,44,99
99,seq127,seq27,r_5_68_128,r_5_68_128,0.99,0,128,128,99
31,r_26_34_41,r_95_122_86,seq101,r_26_34_41,0.99,0,41,41,99
87,seq106,r_14_29_74,seq45,r_14_29_74,1.0,0,74,74,99
20,r_78_104_12,seq19,seq11,r_78_104_12,0.75,1,13,12,99
88,seq108,r_90_32_152,seq117,r_90_32_152,0.98,0,152,152,99
2,r_67_54_135,seq136,seq59,r_67_54_135,0.91,0,135,135,99
28,r_134_135_39,r_107_91_118,r_53_7_180,r_134_135_39,1.0,1,40,39,99
18,r_125_110_62,r_67_54_135,r_138_22_44,r_125_110_62,1.0,6,68,62,99
29,r_30_109_141,seq39,r_79_92_88,r_30_109_141,0.97,0,141,141,99
24,r_107_91_118,seq108,seq23,r_107_91_118,0.87,0,118,118,99
25,r_113_88_61,seq127,seq2,r_113_88_61,0.98,0,61,61,99
33,r_75_55_70,r_79_92_88,r_9_137_150,r_75_55_70,0.95,2,72,70,99
88,seq108,r_107_91_118,r_90_32_152,r_107_91_118,1.0,0,118,118,99
32,r_43_44_71,seq13,seq99,r_43_44_71,1.0,4,75,71,99
38,r_53_7_180,r_67_54_135,r_134_135_39,r_134_135_39,0.63,32,71,39,99
52,seq27,seq49,r_14_29_74,r_14_29_74,1.0,3,77,74,99
34,r_71_4_139,seq24,seq139,r_71_4_139,0.77,2,141,139,99
17,r_86_50_115,seq28,r_95_122_86,r_86_50_115,1.0,2,117,115,99
9,r_131_120_129,seq58,r_107_91_118,r_131_120_129,0.62,0,129,129,99
28,r_134_135_39,r_53_7_180,r_65_84_59,r_134_135_39,0.81,143,182,39,99
91,seq114,r_53_7_180,seq136,r_53_7_180,0.9,-67,113,180,99
49,seq23,r_77_46_82,seq96,r_77_46_82,0.76,5,87,82,99
47,seq19,r_78_104_12,r_26_34_41,r_26_34_41,0.81,3,44,41,99
12,r_10_15_172,r_86_50_115,r_6_82_159,r_10_15_172,1.0,0,172,172,99
12,r_10_15_172,r_5_68_128,r_86_50_115,r_10_15_172,0.91,-44,128,172,99
